Game Id;PlayerId;TeamId;Game Rating;SA;GA;SV;SV%;TOI;PIM
2493;166751;5;40;28;4;24;.857;3559000;0
2493;163423;26;0;0;0;0;.00nan;0;0
2493;172398;5;0;0;0;0;.00nan;0;0
2493;152835;26;76;30;2;28;.933;3600000;0
2494;166646;16;0;0;0;0;.00nan;0;0
2494;165582;24;66;31;3;28;.903;3600000;0
2494;50065;16;56;30;4;26;.867;3600000;0
2494;85727;24;0;0;0;0;.00nan;0;0
2495;67;11;0;0;0;0;.00nan;0;0
2495;187537;19;38;16;3;13;.813;3543000;0
2495;163565;19;0;0;0;0;.00nan;0;0
2495;45323;11;83;37;2;35;.946;3600000;0
2496;3928;15;80;22;1;21;.955;3600000;0
2496;5923;17;0;0;0;0;.00nan;0;0
2496;178413;17;66;35;4;31;.886;3600000;0
2496;59540;15;0;0;0;0;.00nan;0;0
2497;171838;31;88;35;2;33;.943;3600000;0
2497;175092;9;0;0;0;0;.00nan;0;0
2497;190106;9;65;31;3;28;.903;3573000;0
2497;152717;31;0;0;0;0;.00nan;0;0
2498;166646;16;0;0;0;0;.00nan;0;0
2498;183844;29;100;40;0;40;1.000;3600000;0
2498;37818;29;0;0;0;0;.00nan;0;0
2498;50065;16;69;28;2;26;.929;3517000;0
2499;172340;4182;88;31;2;29;.935;3600000;0
2499;184229;35;0;0;0;0;.00nan;0;0
2499;57338;35;60;35;4;31;.886;3600000;0
2499;147945;4182;0;0;0;0;.00nan;0;0
2500;185743;4838;0;0;0;0;.00nan;0;0
2500;85798;12;42;3;1;2;.667;923000;0
2500;91178;12;33;34;6;28;.824;2677000;0
2500;143749;4838;73;30;2;28;.933;3600000;0
2501;2059;23;0;0;0;0;.00nan;0;0
2501;167642;18;0;0;0;0;.00nan;0;0
2501;173727;18;56;23;3;20;.870;3514000;0
2501;78573;23;86;26;1;25;.962;3600000;0
2502;184770;22;0;0;0;0;.00nan;0;0
2502;77955;28;69;36;4;32;.889;3586000;0
2502;85437;28;0;0;0;0;.00nan;0;0
2502;143473;22;68;23;2;21;.913;3600000;0
2503;166591;20;75;34;3;31;.912;3600000;0
2503;3284;21;47;26;4;22;.846;3573000;0
2503;71565;20;0;0;0;0;.00nan;0;0
2503;143156;21;0;0;0;0;.00nan;0;0
2504;676;34;44;27;5;22;.815;3600000;0
2504;163195;0;0;0;0;0;.00nan;0;0
2504;78806;34;0;0;0;0;.00nan;0;0
2504;139409;0;78;30;2;28;.933;3600000;0
2505;18213;8;88;41;1;40;.976;3600000;0
2505;189644;8;0;0;0;0;.00nan;0;0
2505;174718;25;82;15;0;15;1.000;3600000;0
2505;148958;25;0;0;0;0;.00nan;0;0
2506;556;3;53;25;3;22;.880;3545000;0
2506;179344;3;0;0;0;0;.00nan;0;0
2506;190465;33;88;36;1;35;.972;3600000;0
2506;197038;33;0;0;0;0;.00nan;0;0
2507;67;11;55;4;0;4;1.000;382000;0
2507;163423;26;0;0;0;0;.00nan;0;0
2507;45323;11;43;36;6;30;.833;3218000;0
2507;152835;26;48;16;2;14;.875;3600000;0
2508;187537;19;88;54;4;50;.926;4200000;0
2508;163565;19;0;0;0;0;.00nan;0;0
2508;170977;30;0;0;0;0;.00nan;0;0
2508;86697;30;45;28;4;24;.857;4200000;0
2509;676;34;38;26;5;21;.808;3540000;0
2509;13337;32;0;0;0;0;.00nan;0;0
2509;20432;32;93;44;3;41;.932;3600000;0
2509;78806;34;0;0;0;0;.00nan;0;0
2510;187578;10;84;24;1;23;.958;3600000;0
2510;165582;24;0;0;0;0;.00nan;0;0
2510;85727;24;67;27;2;25;.926;3550000;0
2510;90164;10;0;0;0;0;.00nan;0;0
2511;166591;20;0;0;0;0;.00nan;0;0
2511;5923;17;0;0;0;0;.00nan;0;0
2511;178413;17;63;20;2;18;.900;3600000;0
2511;71565;20;89;38;3;35;.921;3600000;0
2512;556;3;41;19;4;15;.789;3600000;0
2512;184229;35;0;0;0;0;.00nan;0;0
2512;179344;3;0;0;0;0;.00nan;0;0
2512;57338;35;82;42;5;37;.881;3600000;0
2513;163423;26;0;0;0;0;.00nan;0;0
2513;183844;29;70;33;3;30;.909;3600000;0
2513;37818;29;0;0;0;0;.00nan;0;0
2513;152835;26;54;39;5;34;.872;3528000;0
2514;3284;21;91;45;3;42;.933;3600000;0
2514;184770;22;0;0;0;0;.00nan;0;0
2514;143156;21;0;0;0;0;.00nan;0;0
2514;143473;22;79;22;1;21;.955;3600000;0
2515;166751;5;57;40;4;36;.900;4200000;0
2515;163195;0;0;0;0;0;.00nan;0;0
2515;172398;5;0;0;0;0;.00nan;0;0
2515;139409;0;64;36;4;32;.889;4180000;0
2516;166646;16;0;0;0;0;.00nan;0;0
2516;175092;9;0;0;0;0;.00nan;0;0
2516;190106;9;54;39;5;34;.872;3600000;0
2516;50065;16;66;20;1;19;.950;3600000;0
2517;172340;4182;92;33;1;32;.970;3600000;0
2517;165582;24;0;0;0;0;.00nan;0;0
2517;85727;24;60;26;3;23;.885;3564000;0
2517;147945;4182;0;0;0;0;.00nan;0;0
2518;171838;31;12;27;7;20;.741;2936000;0
2518;190465;33;0;0;0;0;.00nan;0;0
2518;197038;33;69;32;3;29;.906;3600000;0
2518;152717;31;47;8;1;7;.875;664000;0
2519;168712;14;0;0;0;0;.00nan;0;0
2519;185034;14;100;29;1;28;.966;3600000;0
2519;77955;28;63;28;2;26;.929;3595000;0
2519;85437;28;0;0;0;0;.00nan;0;0
2520;67;11;0;0;0;0;.00nan;0;0
2520;18213;8;81;27;1;26;.963;3600000;0
2520;189644;8;0;0;0;0;.00nan;0;0
2520;45323;11;69;35;3;32;.914;3566000;0
2521;2059;23;0;0;0;0;.00nan;0;0
2521;167642;18;0;0;0;0;.00nan;0;0
2521;173727;18;53;25;3;22;.880;3600000;0
2521;78573;23;48;27;4;23;.852;3584000;0
2522;170977;30;0;0;0;0;.00nan;0;0
2522;85798;12;0;0;0;0;.00nan;0;0
2522;86697;30;55;28;4;24;.857;3600000;0
2522;91178;12;88;60;5;55;.917;3581000;0
2523;187537;19;94;40;2;38;.950;3751000;0
2523;163565;19;0;0;0;0;.00nan;0;0
2523;166381;27;0;0;0;0;.00nan;0;0
2523;175660;27;76;23;1;22;.957;3751000;0
2524;3928;15;98;36;1;35;.972;3600000;0
2524;185743;4838;0;0;0;0;.00nan;0;0
2524;59540;15;0;0;0;0;.00nan;0;0
2524;143749;4838;19;22;6;16;.727;3600000;0
2525;166751;5;0;0;0;0;.00nan;0;0
2525;5923;17;100;22;0;22;1.000;3600000;0
2525;172398;5;77;36;2;34;.944;3570000;0
2525;178413;17;0;0;0;0;.00nan;0;0
2526;3928;15;90;28;1;27;.964;3600000;0
2526;166381;27;0;0;0;0;.00nan;0;0
2526;175660;27;83;33;2;31;.939;3600000;0
2526;59540;15;0;0;0;0;.00nan;0;0
2527;3284;21;0;0;0;0;.00nan;0;0
2527;163195;0;0;0;0;0;.00nan;0;0
2527;139409;0;61;22;2;20;.909;4200000;0
2527;143156;21;61;23;2;21;.913;4185000;0
2528;556;3;100;33;0;33;1.000;3600000;0
2528;676;34;0;0;0;0;.00nan;0;0
2528;179344;3;0;0;0;0;.00nan;0;0
2528;78806;34;58;23;3;20;.870;3600000;0
2529;13337;32;0;0;0;0;.00nan;0;0
2529;20432;32;73;41;4;37;.902;3551000;0
2529;184770;22;0;0;0;0;.00nan;0;0
2529;143473;22;52;14;2;12;.857;3600000;0
2530;171838;31;0;0;0;0;.00nan;0;0
2530;166646;16;0;0;0;0;.00nan;0;0
2530;50065;16;28;21;5;16;.762;3651000;0
2530;152717;31;66;40;6;34;.850;3651000;0
2531;187578;10;0;0;0;0;.00nan;0;0
2531;172340;4182;0;0;0;0;.00nan;0;0
2531;90164;10;54;32;5;27;.844;3559000;0
2531;147945;4182;51;26;4;22;.846;3600000;0
2532;166751;5;66;26;2;24;.923;3851000;0
2532;172398;5;0;0;0;0;.00nan;0;0
2532;77955;28;87;42;3;39;.929;3851000;0
2532;85437;28;0;0;0;0;.00nan;0;0
2533;175092;9;0;0;0;0;.00nan;0;0
2533;190106;9;36;30;6;24;.800;3529000;0
2533;190465;33;76;47;4;43;.915;3600000;0
2533;197038;33;0;0;0;0;.00nan;0;0
2534;166591;20;0;0;0;0;.00nan;0;0
2534;2059;23;0;0;0;0;.00nan;0;0
2534;71565;20;71;44;5;39;.886;4057000;0
2534;78573;23;59;30;4;26;.867;4057000;0
2535;13337;32;83;34;2;32;.941;3600000;0
2535;168712;14;57;24;3;21;.875;3570000;0
2535;20432;32;0;0;0;0;.00nan;0;0
2535;185034;14;0;0;0;0;.00nan;0;0
2536;163423;26;0;0;0;0;.00nan;0;0
2536;167642;18;0;0;0;0;.00nan;0;0
2536;173727;18;97;43;2;41;.953;3600000;0
2536;152835;26;52;31;4;27;.871;3566000;0
2537;184229;35;0;0;0;0;.00nan;0;0
2537;185743;4838;0;0;0;0;.00nan;0;0
2537;57338;35;72;38;4;34;.895;3600000;0
2537;143749;4838;73;36;3;33;.917;3600000;0
2538;67;11;0;0;0;0;.00nan;0;0
2538;45323;11;44;49;7;42;.857;3600000;0
2538;85798;12;0;0;0;0;.00nan;0;0
2538;91178;12;83;27;1;26;.963;3600000;0
2539;3928;15;25;23;6;17;.739;3543000;0
2539;170977;30;0;0;0;0;.00nan;0;0
2539;59540;15;0;0;0;0;.00nan;0;0
2539;86697;30;49;37;5;32;.865;3600000;0
2540;187537;19;0;0;0;0;.00nan;0;0
2540;163565;19;70;39;4;35;.897;3600000;0
2540;174718;25;70;22;1;21;.955;3600000;0
2540;148958;25;0;0;0;0;.00nan;0;0
2541;187578;10;94;43;2;41;.953;4200000;0
2541;5923;17;0;0;0;0;.00nan;0;0
2541;178413;17;62;20;2;18;.900;4200000;0
2541;90164;10;0;0;0;0;.00nan;0;0
2542;163195;0;0;0;0;0;.00nan;0;0
2542;165582;24;0;0;0;0;.00nan;0;0
2542;85727;24;41;25;4;21;.840;3600000;0
2542;139409;0;62;44;5;39;.886;3583000;0
2543;172340;4182;90;28;1;27;.964;3600000;0
2543;77955;28;98;53;2;51;.962;3577000;0
2543;85437;28;0;0;0;0;.00nan;0;0
2543;147945;4182;0;0;0;0;.00nan;0;0
2544;556;3;88;30;1;29;.967;3600000;0
2544;171838;31;84;43;3;40;.930;3562000;0
2544;179344;3;0;0;0;0;.00nan;0;0
2544;152717;31;0;0;0;0;.00nan;0;0
2545;163423;26;0;0;0;0;.00nan;0;0
2545;184770;22;0;0;0;0;.00nan;0;0
2545;143473;22;94;31;1;30;.968;3600000;0
2545;152835;26;78;42;4;38;.905;3600000;0
2546;166591;20;0;0;0;0;.00nan;0;0
2546;167642;18;0;0;0;0;.00nan;0;0
2546;173727;18;76;29;2;27;.931;3600000;0
2546;71565;20;58;39;5;34;.872;3600000;0
2547;166751;5;40;28;5;23;.821;3572000;0
2547;2059;23;0;0;0;0;.00nan;0;0
2547;172398;5;0;0;0;0;.00nan;0;0
2547;78573;23;74;35;3;32;.914;3600000;0
2548;190465;33;0;0;0;0;.00nan;0;0
2548;185743;4838;0;0;0;0;.00nan;0;0
2548;197038;33;100;42;0;42;1.000;3600000;0
2548;143749;4838;60;24;3;21;.875;3600000;0
2549;13337;32;0;0;0;0;.00nan;0;0
2549;18213;8;78;34;3;31;.912;3571000;0
2549;20432;32;71;27;2;25;.926;3600000;0
2549;189644;8;0;0;0;0;.00nan;0;0
2550;187537;19;59;32;3;29;.906;3565000;0
2550;163565;19;0;0;0;0;.00nan;0;0
2550;184229;35;0;0;0;0;.00nan;0;0
2550;57338;35;74;20;1;19;.950;3600000;0
2551;166381;27;100;30;0;30;1.000;3600000;0
2551;174718;25;84;33;2;31;.939;3553000;0
2551;175660;27;0;0;0;0;.00nan;0;0
2551;148958;25;0;0;0;0;.00nan;0;0
2552;67;11;97;41;1;40;.976;3600000;0
2552;3928;15;37;18;4;14;.778;3600000;0
2552;45323;11;0;0;0;0;.00nan;0;0
2552;59540;15;0;0;0;0;.00nan;0;0
2553;166646;16;55;29;4;25;.862;3788000;0
2553;50065;16;0;0;0;0;.00nan;0;0
2553;85798;12;64;31;5;26;.839;3788000;0
2553;91178;12;0;0;0;0;.00nan;0;0
2554;183844;29;83;36;2;34;.944;3560000;0
2554;170977;30;0;0;0;0;.00nan;0;0
2554;37818;29;0;0;0;0;.00nan;0;0
2554;86697;30;100;37;1;36;.973;3600000;0
2555;3284;21;55;24;3;21;.875;3551000;0
2555;172340;4182;0;0;0;0;.00nan;0;0
2555;143156;21;0;0;0;0;.00nan;0;0
2555;147945;4182;78;29;2;27;.931;3600000;0
2556;676;34;64;29;3;26;.897;3564000;0
2556;168712;14;74;28;2;26;.929;3600000;0
2556;185034;14;0;0;0;0;.00nan;0;0
2556;78806;34;0;0;0;0;.00nan;0;0
2557;5923;17;0;0;0;0;.00nan;0;0
2557;163195;0;0;0;0;0;.00nan;0;0
2557;178413;17;41;27;5;22;.815;3573000;0
2557;139409;0;52;23;3;20;.870;3600000;0
2558;13337;32;0;0;0;0;.00nan;0;0
2558;166381;27;54;36;5;31;.861;3515000;0
2558;20432;32;93;49;3;46;.939;3600000;0
2558;175660;27;0;0;0;0;.00nan;0;0
2559;168712;14;83;33;2;31;.939;3914000;0
2559;185034;14;0;0;0;0;.00nan;0;0
2559;77955;28;66;27;3;24;.889;3914000;0
2559;85437;28;0;0;0;0;.00nan;0;0
2560;556;3;73;21;1;20;.952;3600000;0
2560;2059;23;0;0;0;0;.00nan;0;0
2560;179344;3;0;0;0;0;.00nan;0;0
2560;78573;23;73;43;4;39;.907;3600000;0
2561;187578;10;0;0;0;0;.00nan;0;0
2561;175092;9;60;20;2;18;.900;3600000;0
2561;190106;9;0;0;0;0;.00nan;0;0
2561;90164;10;72;46;4;42;.913;3517000;0
2562;171838;31;91;34;1;33;.971;3600000;0
2562;166751;5;37;36;6;30;.833;3336000;0
2562;172398;5;43;4;1;3;.750;264000;0
2562;152717;31;0;0;0;0;.00nan;0;0
2563;187537;19;58;46;6;40;.870;3600000;0
2563;166646;16;0;0;0;0;.00nan;0;0
2563;163565;19;0;0;0;0;.00nan;0;0
2563;50065;16;58;19;2;17;.895;3600000;0
2564;166591;20;0;0;0;0;.00nan;0;0
2564;174718;25;0;0;0;0;.00nan;0;0
2564;71565;20;81;47;4;43;.915;3600000;0
2564;148958;25;71;26;1;25;.962;3600000;0
2565;3284;21;0;0;0;0;.00nan;0;0
2565;190465;33;0;0;0;0;.00nan;0;0
2565;197038;33;87;38;2;36;.947;3600000;0
2565;143156;21;67;31;4;27;.871;3533000;0
2566;163423;26;0;0;0;0;.00nan;0;0
2566;170977;30;0;0;0;0;.00nan;0;0
2566;86697;30;74;31;3;28;.903;3591000;0
2566;152835;26;97;52;2;50;.962;3600000;0
2567;165582;24;63;39;5;34;.872;3724000;0
2567;18213;8;60;38;4;34;.895;3724000;0
2567;189644;8;0;0;0;0;.00nan;0;0
2567;85727;24;0;0;0;0;.00nan;0;0
2568;3928;15;0;0;0;0;.00nan;0;0
2568;59540;15;67;31;4;27;.871;3600000;0
2568;85798;12;0;0;0;0;.00nan;0;0
2568;91178;12;37;27;5;22;.815;3600000;0
2569;167642;18;0;0;0;0;.00nan;0;0
2569;173727;18;46;24;4;20;.833;3600000;0
2569;184229;35;0;0;0;0;.00nan;0;0
2569;57338;35;73;27;3;24;.889;3600000;0
2570;67;11;0;0;0;0;.00nan;0;0
2570;184770;22;0;0;0;0;.00nan;0;0
2570;45323;11;79;42;3;39;.929;3626000;0
2570;143473;22;41;9;2;7;.778;3626000;0
2571;183844;29;67;31;3;28;.903;3552000;0
2571;37818;29;0;0;0;0;.00nan;0;0
2571;185743;4838;0;0;0;0;.00nan;0;0
2571;143749;4838;89;30;1;29;.967;3600000;0
2572;163195;0;93;32;1;31;.969;3600000;0
2572;172340;4182;78;34;2;32;.941;3600000;0
2572;139409;0;0;0;0;0;.00nan;0;0
2572;147945;4182;0;0;0;0;.00nan;0;0
2573;166381;27;0;0;0;0;.00nan;0;0
2573;183844;29;57;3;0;3;1.000;519000;0
2573;175660;27;90;20;0;20;1.000;3600000;0
2573;37818;29;25;26;6;20;.769;3081000;0
2574;175092;9;0;0;0;0;.00nan;0;0
2574;190106;9;43;34;5;29;.853;3600000;0
2574;77955;28;32;36;7;29;.806;2672000;0
2574;85437;28;58;6;0;6;1.000;878000;0
2575;171838;31;59;32;4;28;.875;3556000;0
2575;187578;10;76;37;3;34;.919;3600000;0
2575;90164;10;0;0;0;0;.00nan;0;0
2575;152717;31;0;0;0;0;.00nan;0;0
2576;3284;21;66;36;4;32;.889;3600000;0
2576;166381;27;0;0;0;0;.00nan;0;0
2576;175660;27;100;28;0;28;1.000;3600000;0
2576;143156;21;0;0;0;0;.00nan;0;0
2577;5923;17;0;0;0;0;.00nan;0;0
2577;178413;17;73;10;0;10;1.000;3600000;0
2577;77955;28;0;0;0;0;.00nan;0;0
2577;85437;28;89;41;2;39;.951;3568000;0
2578;166751;5;93;47;3;44;.936;3600000;0
2578;3928;15;100;22;0;22;1.000;3600000;0
2578;172398;5;0;0;0;0;.00nan;0;0
2578;59540;15;0;0;0;0;.00nan;0;0
2579;676;34;62;25;2;23;.920;3600000;0
2579;175092;9;74;42;4;38;.905;3546000;0
2579;190106;9;0;0;0;0;.00nan;0;0
2579;78806;34;0;0;0;0;.00nan;0;0
2580;165582;24;0;0;0;0;.00nan;0;0
2580;174718;25;76;29;2;27;.931;3600000;0
2580;85727;24;64;38;4;34;.895;3558000;0
2580;148958;25;0;0;0;0;.00nan;0;0
2581;556;3;66;25;3;22;.880;3684000;0
2581;170977;30;0;0;0;0;.00nan;0;0
2581;179344;3;0;0;0;0;.00nan;0;0
2581;86697;30;69;33;4;29;.879;3684000;0
2582;168712;14;0;0;0;0;.00nan;0;0
2582;185034;14;63;42;5;37;.881;3600000;0
2582;85798;12;100;30;1;29;.967;3600000;0
2582;91178;12;0;0;0;0;.00nan;0;0
2583;67;11;0;0;0;0;.00nan;0;0
2583;163195;0;0;0;0;0;.00nan;0;0
2583;45323;11;38;28;5;23;.821;3600000;0
2583;139409;0;85;26;1;25;.962;3600000;0
2584;166646;16;73;26;2;24;.923;3600000;0
2584;183844;29;79;49;5;44;.898;3600000;0
2584;37818;29;0;0;0;0;.00nan;0;0
2584;50065;16;0;0;0;0;.00nan;0;0
2585;18213;8;52;30;4;26;.867;3600000;0
2585;184229;35;0;0;0;0;.00nan;0;0
2585;189644;8;0;0;0;0;.00nan;0;0
2585;57338;35;100;43;1;42;.977;3600000;0
2586;167642;18;0;0;0;0;.00nan;0;0
2586;173727;18;65;26;3;23;.885;3600000;0
2586;190465;33;72;52;6;46;.885;3294000;0
2586;197038;33;65;8;0;8;1.000;306000;0
2587;2059;23;0;0;0;0;.00nan;0;0
2587;163423;26;0;0;0;0;.00nan;0;0
2587;78573;23;72;48;6;42;.875;3600000;0
2587;152835;26;72;28;3;25;.893;3600000;0
2588;172340;4182;0;0;0;0;.00nan;0;0
2588;184770;22;0;0;0;0;.00nan;0;0
2588;143473;22;77;19;1;18;.947;3600000;0
2588;147945;4182;69;32;4;28;.875;3600000;0
2589;13337;32;0;0;0;0;.00nan;0;0
2589;20432;32;65;38;4;34;.895;3795000;0
2589;185743;4838;0;0;0;0;.00nan;0;0
2589;143749;4838;33;29;5;24;.828;3778000;0
2590;166591;20;100;41;1;40;.976;3600000;0
2590;187537;19;0;0;0;0;.00nan;0;0
2590;163565;19;60;26;3;23;.885;3515000;0
2590;71565;20;0;0;0;0;.00nan;0;0
2591;676;34;0;0;0;0;.00nan;0;0
2591;187578;10;0;0;0;0;.00nan;0;0
2591;78806;34;77;22;1;21;.955;3600000;0
2591;90164;10;80;44;3;41;.932;3600000;0
2592;166381;27;0;0;0;0;.00nan;0;0
2592;183844;29;72;49;6;43;.878;3600000;0
2592;175660;27;73;24;2;22;.917;3600000;0
2592;37818;29;0;0;0;0;.00nan;0;0
2593;67;11;56;5;0;5;1.000;406000;0
2593;3928;15;69;24;2;22;.917;3600000;0
2593;45323;11;45;54;7;47;.870;3194000;0
2593;59540;15;0;0;0;0;.00nan;0;0
2594;163195;0;0;0;0;0;.00nan;0;0
2594;184229;35;0;0;0;0;.00nan;0;0
2594;57338;35;85;35;2;33;.943;4200000;0
2594;139409;0;100;33;1;32;.970;4200000;0
2595;3284;21;52;36;4;32;.889;4200000;0
2595;175092;9;0;0;0;0;.00nan;0;0
2595;190106;9;94;51;4;47;.922;4200000;0
2595;143156;21;0;0;0;0;.00nan;0;0
2596;166591;20;0;0;0;0;.00nan;0;0
2596;190465;33;36;32;7;25;.781;3157000;0
2596;197038;33;51;2;0;2;1.000;443000;0
2596;71565;20;87;21;1;20;.952;3600000;0
2597;165582;24;45;36;6;30;.833;3600000;0
2597;85727;24;0;0;0;0;.00nan;0;0
2597;85798;12;0;0;0;0;.00nan;0;0
2597;91178;12;71;32;3;29;.906;3600000;0
2598;166751;5;84;34;2;32;.941;3600000;0
2598;172398;5;0;0;0;0;.00nan;0;0
2598;170977;30;0;0;0;0;.00nan;0;0
2598;86697;30;41;33;6;27;.818;3600000;0
2599;5923;17;0;0;0;0;.00nan;0;0
2599;178413;17;84;35;2;33;.943;4182000;0
2599;168712;14;75;32;2;30;.938;4200000;0
2599;185034;14;0;0;0;0;.00nan;0;0
2600;171838;31;0;0;0;0;.00nan;0;0
2600;174718;25;74;24;1;23;.958;3600000;0
2600;148958;25;0;0;0;0;.00nan;0;0
2600;152717;31;97;52;2;50;.962;3584000;0
2601;172340;4182;70;27;2;25;.926;3566000;0
2601;18213;8;99;33;1;32;.970;3600000;0
2601;189644;8;0;0;0;0;.00nan;0;0
2601;147945;4182;0;0;0;0;.00nan;0;0
2602;167642;18;64;40;4;36;.900;4200000;0
2602;173727;18;0;0;0;0;.00nan;0;0
2602;184770;22;0;0;0;0;.00nan;0;0
2602;143473;22;88;49;4;45;.918;4195000;0
2603;187537;19;71;29;2;27;.931;3600000;0
2603;166646;16;81;24;1;23;.958;3600000;0
2603;163565;19;0;0;0;0;.00nan;0;0
2603;50065;16;0;0;0;0;.00nan;0;0
2604;3928;15;50;26;4;22;.846;3563000;0
2604;170977;30;65;29;3;26;.897;3600000;0
2604;59540;15;0;0;0;0;.00nan;0;0
2604;86697;30;0;0;0;0;.00nan;0;0
2605;676;34;73;27;1;26;.963;3600000;0
2605;77955;28;79;41;3;38;.927;3564000;0
2605;78806;34;0;0;0;0;.00nan;0;0
2605;85437;28;0;0;0;0;.00nan;0;0
2606;187578;10;66;36;4;32;.889;3600000;0
2606;190465;33;56;12;1;11;.917;1407000;0
2606;197038;33;28;23;5;18;.783;2146000;0
2606;90164;10;0;0;0;0;.00nan;0;0
2607;13337;32;26;6;3;3;.500;455000;0
2607;20432;32;91;41;2;39;.951;3145000;0
2607;185743;4838;0;0;0;0;.00nan;0;0
2607;143749;4838;54;20;2;18;.900;3600000;0
2608;2059;23;33;33;6;27;.818;2727000;0
2608;18213;8;0;0;0;0;.00nan;0;0
2608;189644;8;84;16;0;16;1.000;3600000;0
2608;78573;23;68;12;0;12;1.000;873000;0
2609;166591;20;0;0;0;0;.00nan;0;0
2609;166381;27;0;0;0;0;.00nan;0;0
2609;175660;27;66;22;2;20;.909;3600000;0
2609;71565;20;76;45;4;41;.911;3558000;0
2610;67;11;0;0;0;0;.00nan;0;0
2610;556;3;72;19;2;17;.895;4200000;0
2610;179344;3;0;0;0;0;.00nan;0;0
2610;45323;11;98;50;2;48;.960;4200000;0
2611;163195;0;0;0;0;0;.00nan;0;0
2611;183844;29;48;35;5;30;.857;3574000;0
2611;37818;29;0;0;0;0;.00nan;0;0
2611;139409;0;66;20;2;18;.900;3600000;0
2612;3284;21;53;30;5;25;.833;3600000;0
2612;168712;14;0;0;0;0;.00nan;0;0
2612;185034;14;80;33;2;31;.939;3600000;0
2612;143156;21;0;0;0;0;.00nan;0;0
2613;184229;35;0;0;0;0;.00nan;0;0
2613;175092;9;64;33;3;30;.909;3600000;0
2613;190106;9;0;0;0;0;.00nan;0;0
2613;57338;35;44;28;5;23;.821;3523000;0
2614;171838;31;0;0;0;0;.00nan;0;0
2614;163423;26;0;0;0;0;.00nan;0;0
2614;152717;31;64;44;5;39;.886;3572000;0
2614;152835;26;65;31;4;27;.871;3600000;0
2615;5923;17;0;0;0;0;.00nan;0;0
2615;165582;24;0;0;0;0;.00nan;0;0
2615;178413;17;86;30;1;29;.967;3600000;0
2615;85727;24;89;40;2;38;.950;3564000;0
2616;2059;23;0;0;0;0;.00nan;0;0
2616;184770;22;0;0;0;0;.00nan;0;0
2616;78573;23;90;37;2;35;.946;3600000;0
2616;143473;22;68;31;3;28;.903;3600000;0
2617;187537;19;53;32;4;28;.875;3195000;0
2617;163565;19;32;10;3;7;.700;405000;0
2617;185743;4838;38;31;6;25;.806;3600000;0
2617;143749;4838;0;0;0;0;.00nan;0;0
2618;77955;28;64;41;5;36;.878;3600000;0
2618;85437;28;0;0;0;0;.00nan;0;0
2618;85798;12;0;0;0;0;.00nan;0;0
2618;91178;12;75;28;3;25;.893;3600000;0
2619;676;34;41;16;3;13;.813;4200000;0
2619;190465;33;72;35;3;32;.914;4200000;0
2619;197038;33;0;0;0;0;.00nan;0;0
2619;78806;34;0;0;0;0;.00nan;0;0
2620;187578;10;84;51;5;46;.902;3600000;0
2620;170977;30;0;0;0;0;.00nan;0;0
2620;86697;30;68;19;1;18;.947;3600000;0
2620;90164;10;0;0;0;0;.00nan;0;0
2621;172340;4182;63;27;2;25;.926;4200000;0
2621;167642;18;0;0;0;0;.00nan;0;0
2621;173727;18;83;36;2;34;.944;4200000;0
2621;147945;4182;0;0;0;0;.00nan;0;0
2622;556;3;70;30;2;28;.933;4007000;0
2622;183844;29;63;36;3;33;.917;4007000;0
2622;179344;3;0;0;0;0;.00nan;0;0
2622;37818;29;0;0;0;0;.00nan;0;0
2623;166591;20;63;38;4;34;.895;3560000;0
2623;3928;15;49;19;3;16;.842;3600000;0
2623;59540;15;0;0;0;0;.00nan;0;0
2623;71565;20;0;0;0;0;.00nan;0;0
2624;165582;24;40;36;5;31;.861;4200000;0
2624;166381;27;0;0;0;0;.00nan;0;0
2624;175660;27;38;35;5;30;.857;4200000;0
2624;85727;24;0;0;0;0;.00nan;0;0
2625;67;11;0;0;0;0;.00nan;0;0
2625;166751;5;87;23;1;22;.957;3600000;0
2625;172398;5;0;0;0;0;.00nan;0;0
2625;45323;11;42;36;6;30;.833;3600000;0
2626;163195;0;0;0;0;0;.00nan;0;0
2626;168712;14;81;31;1;30;.968;3600000;0
2626;185034;14;0;0;0;0;.00nan;0;0
2626;139409;0;61;26;3;23;.885;3535000;0
2627;184229;35;0;0;0;0;.00nan;0;0
2627;184770;22;0;0;0;0;.00nan;0;0
2627;57338;35;64;30;3;27;.900;3554000;0
2627;143473;22;73;24;1;23;.958;3600000;0
2628;3284;21;76;42;3;39;.929;3600000;0
2628;174718;25;94;23;0;23;1.000;3600000;0
2628;143156;21;0;0;0;0;.00nan;0;0
2628;148958;25;0;0;0;0;.00nan;0;0
2629;166646;16;0;0;0;0;.00nan;0;0
2629;13337;32;0;0;0;0;.00nan;0;0
2629;20432;32;92;45;3;42;.933;3600000;0
2629;50065;16;29;23;5;18;.783;3532000;0
2630;187537;19;0;0;0;0;.00nan;0;0
2630;163565;19;45;30;5;25;.833;3600000;0
2630;175092;9;95;49;1;48;.980;3600000;0
2630;190106;9;0;0;0;0;.00nan;0;0
2631;171838;31;66;30;3;27;.900;3600000;0
2631;185743;4838;0;0;0;0;.00nan;0;0
2631;143749;4838;76;27;2;25;.926;3600000;0
2631;152717;31;0;0;0;0;.00nan;0;0
2632;2059;23;0;0;0;0;.00nan;0;0
2632;163423;26;0;0;0;0;.00nan;0;0
2632;78573;23;81;27;1;26;.963;3951000;0
2632;152835;26;100;29;0;29;1.000;3951000;0
2633;166591;20;64;19;2;17;.895;3600000;0
2633;71565;20;0;0;0;0;.00nan;0;0
2633;77955;28;0;0;0;0;.00nan;0;0
2633;85437;28;74;50;4;46;.920;3600000;0
2634;172340;4182;0;0;0;0;.00nan;0;0
2634;174718;25;52;21;3;18;.857;3600000;0
2634;147945;4182;59;31;4;27;.871;3570000;0
2634;148958;25;0;0;0;0;.00nan;0;0
2635;18213;8;0;0;0;0;.00nan;0;0
2635;189644;8;75;25;1;24;.960;3600000;0
2635;85798;12;38;36;6;30;.833;3600000;0
2635;91178;12;0;0;0;0;.00nan;0;0
2636;13337;32;0;0;0;0;.00nan;0;0
2636;166381;27;0;0;0;0;.00nan;0;0
2636;20432;32;80;32;2;30;.938;4200000;0
2636;175660;27;66;28;2;26;.929;4200000;0
2637;171838;31;0;0;0;0;.00nan;0;0
2637;183844;29;100;34;0;34;1.000;3600000;0
2637;37818;29;0;0;0;0;.00nan;0;0
2637;152717;31;77;44;5;39;.886;3600000;0
2638;166751;5;66;39;3;36;.923;3566000;0
2638;3284;21;0;0;0;0;.00nan;0;0
2638;172398;5;0;0;0;0;.00nan;0;0
2638;143156;21;89;26;1;25;.962;3600000;0
2639;556;3;64;27;2;25;.926;3600000;0
2639;163195;0;0;0;0;0;.00nan;0;0
2639;179344;3;0;0;0;0;.00nan;0;0
2639;139409;0;45;31;5;26;.839;3600000;0
2640;3928;15;93;42;2;40;.952;3600000;0
2640;184770;22;49;25;4;21;.840;3548000;0
2640;59540;15;0;0;0;0;.00nan;0;0
2640;143473;22;0;0;0;0;.00nan;0;0
2641;5923;17;0;0;0;0;.00nan;0;0
2641;178413;17;62;28;3;25;.893;3600000;0
2641;185743;4838;0;0;0;0;.00nan;0;0
2641;143749;4838;65;36;4;32;.889;3584000;0
2642;187578;10;57;37;4;33;.892;3646000;0
2642;168712;14;0;0;0;0;.00nan;0;0
2642;185034;14;44;27;5;22;.815;3646000;0
2642;90164;10;0;0;0;0;.00nan;0;0
2643;676;34;58;33;4;29;.879;4200000;0
2643;190465;33;98;62;4;58;.935;4200000;0
2643;197038;33;0;0;0;0;.00nan;0;0
2643;78806;34;0;0;0;0;.00nan;0;0
2644;167642;18;0;0;0;0;.00nan;0;0
2644;173727;18;73;32;3;29;.906;3565000;0
2644;174718;25;0;0;0;0;.00nan;0;0
2644;148958;25;79;30;1;29;.967;3600000;0
2645;13337;32;75;44;4;40;.909;3632000;0
2645;20432;32;0;0;0;0;.00nan;0;0
2645;175092;9;0;0;0;0;.00nan;0;0
2645;190106;9;60;28;3;25;.893;3632000;0
2646;67;11;43;28;5;23;.821;3600000;0
2646;163423;26;0;0;0;0;.00nan;0;0
2646;45323;11;0;0;0;0;.00nan;0;0
2646;152835;26;81;27;1;26;.963;3600000;0
2647;187537;19;56;30;3;27;.900;3572000;0
2647;163565;19;0;0;0;0;.00nan;0;0
2647;184229;35;0;0;0;0;.00nan;0;0
2647;57338;35;82;30;1;29;.967;3600000;0
2648;2059;23;0;0;0;0;.00nan;0;0
2648;170977;30;0;0;0;0;.00nan;0;0
2648;78573;23;55;40;5;35;.875;3521000;0
2648;86697;30;63;30;3;27;.900;3600000;0
2649;166591;20;0;0;0;0;.00nan;0;0
2649;71565;20;71;38;4;34;.895;3600000;0
2649;77955;28;0;0;0;0;.00nan;0;0
2649;85437;28;88;27;1;26;.963;3600000;0
2650;676;34;0;0;0;0;.00nan;0;0
2650;18213;8;68;35;4;31;.886;3546000;0
2650;189644;8;0;0;0;0;.00nan;0;0
2650;78806;34;69;25;3;22;.880;3600000;0
2651;163423;26;0;0;0;0;.00nan;0;0
2651;167642;18;0;0;0;0;.00nan;0;0
2651;173727;18;68;25;2;23;.920;3600000;0
2651;152835;26;52;21;3;18;.857;3600000;0
2652;13337;32;0;0;0;0;.00nan;0;0
2652;20432;32;44;21;4;17;.810;3819000;0
2652;184229;35;0;0;0;0;.00nan;0;0
2652;57338;35;57;38;5;33;.868;3819000;0
2653;163195;0;0;0;0;0;.00nan;0;0
2653;183844;29;64;31;3;28;.903;3600000;0
2653;37818;29;0;0;0;0;.00nan;0;0
2653;139409;0;46;26;4;22;.846;3564000;0
2654;166751;5;100;35;0;35;1.000;3600000;0
2654;5923;17;0;0;0;0;.00nan;0;0
2654;172398;5;0;0;0;0;.00nan;0;0
2654;178413;17;68;27;2;25;.926;3559000;0
2655;166591;20;52;34;5;29;.853;3600000;0
2655;185743;4838;0;0;0;0;.00nan;0;0
2655;71565;20;0;0;0;0;.00nan;0;0
2655;143749;4838;64;23;2;21;.913;3600000;0
2656;18213;8;0;0;0;0;.00nan;0;0
2656;189644;8;56;24;3;21;.875;3600000;0
2656;175092;9;0;0;0;0;.00nan;0;0
2656;190106;9;79;40;4;36;.900;3600000;0
2657;171838;31;0;0;0;0;.00nan;0;0
2657;77955;28;55;24;3;21;.875;3577000;0
2657;85437;28;0;0;0;0;.00nan;0;0
2657;152717;31;74;23;1;22;.957;3600000;0
2658;187578;10;86;44;4;40;.909;3600000;0
2658;3284;21;90;30;1;29;.967;3600000;0
2658;90164;10;0;0;0;0;.00nan;0;0
2658;143156;21;0;0;0;0;.00nan;0;0
2659;3928;15;65;21;2;19;.905;3600000;0
2659;168712;14;68;39;4;35;.897;3585000;0
2659;185034;14;0;0;0;0;.00nan;0;0
2659;59540;15;0;0;0;0;.00nan;0;0
2660;556;3;96;34;2;32;.941;3600000;0
2660;166646;16;0;0;0;0;.00nan;0;0
2660;179344;3;0;0;0;0;.00nan;0;0
2660;50065;16;64;28;3;25;.893;3562000;0
2661;184770;22;0;0;0;0;.00nan;0;0
2661;190465;33;80;53;5;48;.906;3600000;0
2661;197038;33;0;0;0;0;.00nan;0;0
2661;143473;22;95;19;0;19;1.000;3600000;0
2662;67;11;0;0;0;0;.00nan;0;0
2662;172340;4182;31;31;6;25;.806;3600000;0
2662;45323;11;77;32;2;30;.938;3600000;0
2662;147945;4182;0;0;0;0;.00nan;0;0
2663;165582;24;0;0;0;0;.00nan;0;0
2663;170977;30;0;0;0;0;.00nan;0;0
2663;85727;24;50;36;5;31;.861;3600000;0
2663;86697;30;100;46;2;44;.957;3600000;0
2664;2059;23;0;0;0;0;.00nan;0;0
2664;174718;25;81;28;2;26;.929;4200000;0
2664;78573;23;100;46;2;44;.957;4200000;0
2664;148958;25;0;0;0;0;.00nan;0;0
2665;187537;19;92;27;1;26;.963;3600000;0
2665;163565;19;0;0;0;0;.00nan;0;0
2665;85798;12;0;0;0;0;.00nan;0;0
2665;91178;12;47;26;4;22;.846;3600000;0
2666;676;34;91;30;1;29;.967;3600000;0
2666;166646;16;66;34;4;30;.882;3600000;0
2666;50065;16;0;0;0;0;.00nan;0;0
2666;78806;34;0;0;0;0;.00nan;0;0
2667;187537;19;0;0;0;0;.00nan;0;0
2667;163565;19;54;34;4;30;.882;3600000;0
2667;166381;27;0;0;0;0;.00nan;0;0
2667;175660;27;50;26;3;23;.885;3600000;0
2668;556;3;49;1;0;1;1.000;240000;0
2668;3284;21;62;32;4;28;.875;3600000;0
2668;179344;3;30;28;6;22;.786;3316000;0
2668;143156;21;0;0;0;0;.00nan;0;0
2669;171838;31;0;0;0;0;.00nan;0;0
2669;166751;5;79;29;2;27;.931;3640000;0
2669;172398;5;0;0;0;0;.00nan;0;0
2669;152717;31;86;25;1;24;.960;3640000;0
2670;183844;29;51;38;5;33;.868;3600000;0
2670;174718;25;81;27;2;25;.926;3600000;0
2670;37818;29;0;0;0;0;.00nan;0;0
2670;148958;25;0;0;0;0;.00nan;0;0
2671;2059;23;0;0;0;0;.00nan;0;0
2671;167642;18;0;0;0;0;.00nan;0;0
2671;173727;18;51;32;4;28;.875;3600000;0
2671;78573;23;57;39;6;33;.846;3579000;0
2672;3928;15;54;11;2;9;.818;3600000;0
2672;59540;15;0;0;0;0;.00nan;0;0
2672;77955;28;0;0;0;0;.00nan;0;0
2672;85437;28;96;52;4;48;.923;3527000;0
2673;166751;5;0;0;0;0;.00nan;0;0
2673;172398;5;50;27;4;23;.852;3566000;0
2673;175092;9;79;40;3;37;.925;3600000;0
2673;190106;9;0;0;0;0;.00nan;0;0
2674;168712;14;0;0;0;0;.00nan;0;0
2674;185034;14;79;27;1;26;.963;3600000;0
2674;190465;33;50;33;4;29;.879;3600000;0
2674;197038;33;0;0;0;0;.00nan;0;0
2675;163195;0;0;0;0;0;.00nan;0;0
2675;184770;22;0;0;0;0;.00nan;0;0
2675;139409;0;40;37;6;31;.838;3600000;0
2675;143473;22;76;24;1;23;.958;3600000;0
2676;18213;8;39;21;4;17;.810;3600000;0
2676;184229;35;45;7;1;6;.857;1431000;0
2676;189644;8;0;0;0;0;.00nan;0;0
2676;57338;35;41;24;4;20;.833;2153000;0
2677;67;11;0;0;0;0;.00nan;0;0
2677;13337;32;0;0;0;0;.00nan;0;0
2677;20432;32;67;28;3;25;.893;4200000;0
2677;45323;11;67;33;3;30;.909;4200000;0
2678;172340;4182;90;52;3;49;.942;4200000;0
2678;163423;26;0;0;0;0;.00nan;0;0
2678;147945;4182;0;0;0;0;.00nan;0;0
2678;152835;26;67;31;3;28;.903;4200000;0
2679;165582;24;0;0;0;0;.00nan;0;0
2679;166381;27;0;0;0;0;.00nan;0;0
2679;175660;27;63;35;4;31;.886;4004000;0
2679;85727;24;48;36;5;31;.861;4004000;0
2680;676;34;67;33;3;30;.909;3600000;0
2680;78806;34;0;0;0;0;.00nan;0;0
2680;85798;12;0;0;0;0;.00nan;0;0
2680;91178;12;100;22;0;22;1.000;3600000;0
2681;166591;20;0;0;0;0;.00nan;0;0
2681;170977;30;80;31;2;29;.935;3600000;0
2681;71565;20;68;43;5;38;.884;3600000;0
2681;86697;30;0;0;0;0;.00nan;0;0
2682;171838;31;85;44;3;41;.932;3592000;0
2682;5923;17;0;0;0;0;.00nan;0;0
2682;178413;17;61;24;2;22;.917;3600000;0
2682;152717;31;0;0;0;0;.00nan;0;0
2683;556;3;68;30;2;28;.933;3600000;0
2683;187578;10;0;0;0;0;.00nan;0;0
2683;179344;3;0;0;0;0;.00nan;0;0
2683;90164;10;74;21;1;20;.952;3600000;0
2684;187537;19;95;44;2;42;.955;4200000;0
2684;163565;19;0;0;0;0;.00nan;0;0
2684;185743;4838;0;0;0;0;.00nan;0;0
2684;143749;4838;60;23;2;21;.913;4200000;0
2685;183844;29;72;20;1;19;.950;3600000;0
2685;168712;14;94;46;3;43;.935;3564000;0
2685;185034;14;0;0;0;0;.00nan;0;0
2685;37818;29;0;0;0;0;.00nan;0;0
2686;3284;21;99;25;0;25;1.000;3600000;0
2686;174718;25;70;41;4;37;.902;3600000;0
2686;143156;21;0;0;0;0;.00nan;0;0
2686;148958;25;0;0;0;0;.00nan;0;0
2687;163195;0;0;0;0;0;.00nan;0;0
2687;175092;9;86;27;1;26;.963;3600000;0
2687;190106;9;0;0;0;0;.00nan;0;0
2687;139409;0;73;33;3;30;.909;3577000;0
2688;184770;22;0;0;0;0;.00nan;0;0
2688;190465;33;0;0;0;0;.00nan;0;0
2688;197038;33;89;58;3;55;.948;3574000;0
2688;143473;22;69;19;1;18;.947;3600000;0
2689;2059;23;0;0;0;0;.00nan;0;0
2689;5923;17;64;20;2;18;.900;3600000;0
2689;178413;17;0;0;0;0;.00nan;0;0
2689;78573;23;50;31;5;26;.839;3600000;0
2690;166646;16;0;0;0;0;.00nan;0;0
2690;166751;5;78;33;2;31;.939;3570000;0
2690;172398;5;0;0;0;0;.00nan;0;0
2690;50065;16;100;33;0;33;1.000;3600000;0
2691;13337;32;0;0;0;0;.00nan;0;0
2691;18213;8;73;47;5;42;.894;3600000;0
2691;20432;32;87;33;1;32;.970;3600000;0
2691;189644;8;0;0;0;0;.00nan;0;0
2692;163423;26;0;0;0;0;.00nan;0;0
2692;184229;35;0;0;0;0;.00nan;0;0
2692;57338;35;61;23;3;20;.870;3774000;0
2692;152835;26;91;43;2;41;.953;3774000;0
2693;67;11;0;0;0;0;.00nan;0;0
2693;45323;11;46;26;4;22;.846;3549000;0
2693;85798;12;0;0;0;0;.00nan;0;0
2693;91178;12;74;22;2;20;.909;3600000;0
2694;165582;24;64;33;4;29;.879;3766000;0
2694;185743;4838;46;20;3;17;.850;3766000;0
2694;85727;24;0;0;0;0;.00nan;0;0
2694;143749;4838;0;0;0;0;.00nan;0;0
2695;167642;18;0;0;0;0;.00nan;0;0
2695;173727;18;65;41;5;36;.878;3600000;0
2695;170977;30;0;0;0;0;.00nan;0;0
2695;86697;30;81;20;1;19;.950;3600000;0
2696;190465;33;22;11;4;7;.636;591000;0
2696;197038;33;61;29;3;26;.897;3009000;0
2696;77955;28;0;0;0;0;.00nan;0;0
2696;85437;28;63;25;3;22;.880;3600000;0
2697;556;3;39;20;4;16;.800;3600000;0
2697;3928;15;76;23;1;22;.957;3600000;0
2697;179344;3;0;0;0;0;.00nan;0;0
2697;59540;15;0;0;0;0;.00nan;0;0
2698;676;34;0;0;0;0;.00nan;0;0
2698;187578;10;0;0;0;0;.00nan;0;0
2698;78806;34;75;28;2;26;.929;3539000;0
2698;90164;10;91;30;1;29;.967;3600000;0
2699;171838;31;0;0;0;0;.00nan;0;0
2699;172340;4182;47;31;5;26;.839;3600000;0
2699;147945;4182;0;0;0;0;.00nan;0;0
2699;152717;31;78;22;1;21;.955;3600000;0
2700;166591;20;0;0;0;0;.00nan;0;0
2700;166381;27;0;0;0;0;.00nan;0;0
2700;175660;27;62;21;2;19;.905;3600000;0
2700;71565;20;70;36;3;33;.917;3587000;0
2701;187537;19;50;31;5;26;.839;3553000;0
2701;163565;19;0;0;0;0;.00nan;0;0
2701;170977;30;0;0;0;0;.00nan;0;0
2701;86697;30;64;29;4;25;.862;3600000;0
2702;3284;21;78;37;3;34;.919;4068000;0
2702;163195;0;0;0;0;0;.00nan;0;0
2702;139409;0;100;48;2;46;.958;4068000;0
2702;143156;21;0;0;0;0;.00nan;0;0
2703;184229;35;0;0;0;0;.00nan;0;0
2703;174718;25;57;34;5;29;.853;3622000;0
2703;57338;35;45;39;6;33;.846;3622000;0
2703;148958;25;0;0;0;0;.00nan;0;0
2704;183844;29;56;30;3;27;.900;3580000;0
2704;175092;9;0;0;0;0;.00nan;0;0
2704;190106;9;87;33;2;31;.939;3600000;0
2704;37818;29;0;0;0;0;.00nan;0;0
2705;5923;17;0;0;0;0;.00nan;0;0
2705;172340;4182;0;0;0;0;.00nan;0;0
2705;178413;17;63;29;3;26;.897;3600000;0
2705;147945;4182;83;40;4;36;.900;3586000;0
2706;166751;5;88;28;1;27;.964;3600000;0
2706;3928;15;53;23;3;20;.870;3547000;0
2706;172398;5;0;0;0;0;.00nan;0;0
2706;59540;15;0;0;0;0;.00nan;0;0
2707;171838;31;84;43;3;40;.930;3600000;0
2707;2059;23;63;23;2;21;.913;3600000;0
2707;78573;23;0;0;0;0;.00nan;0;0
2707;152717;31;0;0;0;0;.00nan;0;0
2708;187578;10;87;56;3;53;.946;4091000;0
2708;168712;14;56;20;2;18;.900;4062000;0
2708;185034;14;0;0;0;0;.00nan;0;0
2708;90164;10;0;0;0;0;.00nan;0;0
2709;165582;24;0;0;0;0;.00nan;0;0
2709;77955;28;87;43;3;40;.930;3575000;0
2709;85437;28;0;0;0;0;.00nan;0;0
2709;85727;24;59;20;2;18;.900;3600000;0
2710;163423;26;0;0;0;0;.00nan;0;0
2710;13337;32;0;0;0;0;.00nan;0;0
2710;20432;32;61;32;4;28;.875;3600000;0
2710;152835;26;89;33;2;31;.939;3600000;0
2711;18213;8;87;21;0;21;1.000;4004000;0
2711;189644;8;0;0;0;0;.00nan;0;0
2711;85798;12;0;0;0;0;.00nan;0;0
2711;91178;12;94;40;1;39;.975;4004000;0
2712;67;11;0;0;0;0;.00nan;0;0
2712;167642;18;0;0;0;0;.00nan;0;0
2712;173727;18;76;23;1;22;.957;3600000;0
2712;45323;11;93;42;2;40;.952;3600000;0
2713;166591;20;63;35;5;30;.857;3564000;0
2713;185743;4838;0;0;0;0;.00nan;0;0
2713;71565;20;0;0;0;0;.00nan;0;0
2713;143749;4838;51;27;4;23;.852;3600000;0
2714;556;3;57;33;4;29;.879;3600000;0
2714;166646;16;0;0;0;0;.00nan;0;0
2714;179344;3;0;0;0;0;.00nan;0;0
2714;50065;16;71;23;1;22;.957;3600000;0
2715;174718;25;0;0;0;0;.00nan;0;0
2715;190465;33;96;51;3;48;.941;3564000;0
2715;197038;33;0;0;0;0;.00nan;0;0
2715;148958;25;77;24;1;23;.958;3600000;0
2716;2059;23;0;0;0;0;.00nan;0;0
2716;175092;9;56;35;4;31;.886;3534000;0
2716;190106;9;0;0;0;0;.00nan;0;0
2716;78573;23;73;26;2;24;.923;3600000;0
2717;3284;21;0;0;0;0;.00nan;0;0
2717;184770;22;0;0;0;0;.00nan;0;0
2717;143156;21;86;42;3;39;.929;3600000;0
2717;143473;22;28;15;4;11;.733;3553000;0
2718;166381;27;0;0;0;0;.00nan;0;0
2718;170977;30;0;0;0;0;.00nan;0;0
2718;175660;27;54;37;5;32;.865;3752000;0
2718;86697;30;55;29;4;25;.862;3752000;0
2719;167642;18;0;0;0;0;.00nan;0;0
2719;168712;14;62;35;4;31;.886;3562000;0
2719;173727;18;86;32;2;30;.938;3600000;0
2719;185034;14;0;0;0;0;.00nan;0;0
2720;67;11;58;46;6;40;.870;3600000;0
2720;45323;11;0;0;0;0;.00nan;0;0
2720;85798;12;0;0;0;0;.00nan;0;0
2720;91178;12;99;26;0;26;1.000;3600000;0
2721;183844;29;81;34;3;31;.912;3600000;0
2721;37818;29;0;0;0;0;.00nan;0;0
2721;77955;28;0;0;0;0;.00nan;0;0
2721;85437;28;27;25;6;19;.760;3600000;0
2722;3284;21;70;28;2;26;.929;3600000;0
2722;165582;24;89;42;3;39;.929;3600000;0
2722;85727;24;0;0;0;0;.00nan;0;0
2722;143156;21;0;0;0;0;.00nan;0;0
2723;172340;4182;71;29;2;27;.931;3600000;0
2723;175092;9;0;0;0;0;.00nan;0;0
2723;190106;9;80;35;3;32;.914;3545000;0
2723;147945;4182;0;0;0;0;.00nan;0;0
2724;187537;19;82;34;2;32;.941;3571000;0
2724;187578;10;0;0;0;0;.00nan;0;0
2724;163565;19;0;0;0;0;.00nan;0;0
2724;90164;10;97;37;1;36;.973;3600000;0
2725;13337;32;0;0;0;0;.00nan;0;0
2725;20432;32;87;47;4;43;.915;3569000;0
2725;174718;25;72;22;2;20;.909;3600000;0
2725;148958;25;0;0;0;0;.00nan;0;0
2726;163423;26;0;0;0;0;.00nan;0;0
2726;166381;27;0;0;0;0;.00nan;0;0
2726;175660;27;89;28;1;27;.964;3600000;0
2726;152835;26;94;48;3;45;.938;3551000;0
2727;166751;5;97;42;1;41;.976;3591000;0
2727;172398;5;0;0;0;0;.00nan;0;0
2727;18213;8;87;15;0;15;1.000;3600000;0
2727;189644;8;0;0;0;0;.00nan;0;0
2728;676;34;0;0;0;0;.00nan;0;0
2728;184229;35;0;0;0;0;.00nan;0;0
2728;57338;35;78;19;1;18;.947;3600000;0
2728;78806;34;68;40;3;37;.925;3569000;0
2729;556;3;82;34;2;32;.941;3565000;0
2729;170977;30;80;25;1;24;.960;3600000;0
2729;179344;3;0;0;0;0;.00nan;0;0
2729;86697;30;0;0;0;0;.00nan;0;0
2730;166591;20;0;0;0;0;.00nan;0;0
2730;3928;15;99;20;0;20;1.000;3600000;0
2730;59540;15;0;0;0;0;.00nan;0;0
2730;71565;20;78;56;5;51;.911;3600000;0
2731;67;11;0;0;0;0;.00nan;0;0
2731;167642;18;54;14;2;12;.857;3600000;0
2731;173727;18;0;0;0;0;.00nan;0;0
2731;45323;11;85;55;5;50;.909;3600000;0
2732;166381;27;38;43;7;36;.837;3600000;0
2732;175660;27;0;0;0;0;.00nan;0;0
2732;85798;12;0;0;0;0;.00nan;0;0
2732;91178;12;91;33;1;32;.970;3600000;0
2733;2059;23;57;38;5;33;.868;3550000;0
2733;168712;14;41;25;4;21;.840;2323000;0
2733;185034;14;64;7;0;7;1.000;1277000;0
2733;78573;23;0;0;0;0;.00nan;0;0
2734;5923;17;0;0;0;0;.00nan;0;0
2734;163195;0;0;0;0;0;.00nan;0;0
2734;178413;17;87;18;0;18;1.000;3600000;0
2734;139409;0;98;35;1;34;.971;3579000;0
2735;3284;21;59;28;4;24;.857;3600000;0
2735;13337;32;0;0;0;0;.00nan;0;0
2735;20432;32;99;42;1;41;.976;3600000;0
2735;143156;21;0;0;0;0;.00nan;0;0
2736;187537;19;66;43;5;38;.884;3875000;0
2736;163565;19;0;0;0;0;.00nan;0;0
2736;175092;9;0;0;0;0;.00nan;0;0
2736;190106;9;67;52;6;46;.885;3875000;0
2737;676;34;0;0;0;0;.00nan;0;0
2737;165582;24;0;0;0;0;.00nan;0;0
2737;78806;34;81;24;1;23;.958;3600000;0
2737;85727;24;74;49;5;44;.898;3600000;0
2738;166646;16;40;14;3;11;.786;3600000;0
2738;166751;5;100;36;0;36;1.000;3600000;0
2738;172398;5;0;0;0;0;.00nan;0;0
2738;50065;16;0;0;0;0;.00nan;0;0
2739;2059;23;0;0;0;0;.00nan;0;0
2739;172340;4182;0;0;0;0;.00nan;0;0
2739;78573;23;69;46;5;41;.891;4062000;0
2739;147945;4182;68;35;4;31;.886;4062000;0
2740;67;11;93;47;3;44;.936;3600000;0
2740;168712;14;81;19;1;18;.947;3600000;0
2740;185034;14;0;0;0;0;.00nan;0;0
2740;45323;11;0;0;0;0;.00nan;0;0
2741;556;3;84;40;2;38;.950;3563000;0
2741;179344;3;0;0;0;0;.00nan;0;0
2741;185743;4838;0;0;0;0;.00nan;0;0
2741;143749;4838;67;20;1;19;.950;3600000;0
2742;18213;8;53;39;5;34;.872;3600000;0
2742;189644;8;0;0;0;0;.00nan;0;0
2742;170977;30;0;0;0;0;.00nan;0;0
2742;86697;30;88;18;0;18;1.000;3600000;0
2743;171838;31;38;30;5;25;.833;3585000;0
2743;163195;0;60;30;3;27;.900;3600000;0
2743;139409;0;0;0;0;0;.00nan;0;0
2743;152717;31;0;0;0;0;.00nan;0;0
2744;184229;35;0;0;0;0;.00nan;0;0
2744;57338;35;100;30;0;30;1.000;3600000;0
2744;77955;28;69;26;2;24;.923;3600000;0
2744;85437;28;0;0;0;0;.00nan;0;0
2745;556;3;89;31;1;30;.968;3600000;0
2745;166381;27;0;0;0;0;.00nan;0;0
2745;179344;3;0;0;0;0;.00nan;0;0
2745;175660;27;69;27;2;25;.926;3576000;0
2746;5923;17;0;0;0;0;.00nan;0;0
2746;178413;17;48;17;3;14;.824;3788000;0
2746;190465;33;0;0;0;0;.00nan;0;0
2746;197038;33;87;42;2;40;.952;3788000;0
2747;166591;20;64;26;3;23;.885;3544000;0
2747;187537;19;68;26;2;24;.923;3600000;0
2747;163565;19;0;0;0;0;.00nan;0;0
2747;71565;20;0;0;0;0;.00nan;0;0
2748;166646;16;0;0;0;0;.00nan;0;0
2748;163423;26;0;0;0;0;.00nan;0;0
2748;50065;16;63;36;4;32;.889;4193000;0
2748;152835;26;57;34;4;30;.882;4200000;0
2749;166751;5;64;45;5;40;.889;3581000;0
2749;172398;5;0;0;0;0;.00nan;0;0
2749;167642;18;0;0;0;0;.00nan;0;0
2749;173727;18;51;30;4;26;.867;3600000;0
2750;183844;29;59;13;1;12;.923;3600000;0
2750;175092;9;0;0;0;0;.00nan;0;0
2750;190106;9;70;53;6;47;.887;3600000;0
2750;37818;29;0;0;0;0;.00nan;0;0
2751;3928;15;76;23;2;21;.913;3600000;0
2751;165582;24;75;32;3;29;.906;3583000;0
2751;59540;15;0;0;0;0;.00nan;0;0
2751;85727;24;0;0;0;0;.00nan;0;0
2752;172340;4182;86;28;1;27;.964;3600000;0
2752;168712;14;40;26;5;21;.808;1811000;0
2752;185034;14;35;18;4;14;.778;1789000;0
2752;147945;4182;0;0;0;0;.00nan;0;0
2753;676;34;0;0;0;0;.00nan;0;0
2753;184770;22;0;0;0;0;.00nan;0;0
2753;78806;34;92;35;1;34;.971;3600000;0
2753;143473;22;67;20;2;18;.900;3564000;0
2754;13337;32;0;0;0;0;.00nan;0;0
2754;20432;32;86;29;1;28;.966;3600000;0
2754;184229;35;0;0;0;0;.00nan;0;0
2754;57338;35;75;27;2;25;.926;3583000;0
2755;187578;10;56;46;6;40;.870;3600000;0
2755;3284;21;69;29;3;26;.897;3600000;0
2755;90164;10;0;0;0;0;.00nan;0;0
2755;143156;21;0;0;0;0;.00nan;0;0
2756;174718;25;54;30;4;26;.867;3600000;0
2756;85798;12;0;0;0;0;.00nan;0;0
2756;91178;12;92;22;0;22;1.000;3600000;0
2756;148958;25;0;0;0;0;.00nan;0;0
2757;67;11;34;5;2;3;.600;876000;0
2757;2059;23;0;0;0;0;.00nan;0;0
2757;45323;11;23;25;6;19;.760;2724000;0
2757;78573;23;66;16;1;15;.938;3600000;0
2758;18213;8;57;20;2;18;.900;4200000;0
2758;189644;8;0;0;0;0;.00nan;0;0
2758;185743;4838;0;0;0;0;.00nan;0;0
2758;143749;4838;100;42;2;40;.952;4200000;0
2759;171838;31;0;0;0;0;.00nan;0;0
2759;190465;33;67;27;2;25;.926;3600000;0
2759;197038;33;0;0;0;0;.00nan;0;0
2759;152717;31;70;37;3;34;.919;3582000;0
2760;166591;20;0;0;0;0;.00nan;0;0
2760;3284;21;0;0;0;0;.00nan;0;0
2760;71565;20;58;31;4;27;.871;3541000;0
2760;143156;21;90;34;2;32;.941;3600000;0
2761;187537;19;0;0;0;0;.00nan;0;0
2761;163565;19;47;27;4;23;.852;3600000;0
2761;165582;24;0;0;0;0;.00nan;0;0
2761;85727;24;100;44;1;43;.977;3600000;0
2762;166646;16;61;20;2;18;.900;3600000;0
2762;50065;16;0;0;0;0;.00nan;0;0
2762;77955;28;0;0;0;0;.00nan;0;0
2762;85437;28;61;53;6;47;.887;3600000;0
2763;166381;27;0;0;0;0;.00nan;0;0
2763;18213;8;0;0;0;0;.00nan;0;0
2763;189644;8;75;39;3;36;.923;4200000;0
2763;175660;27;63;24;3;21;.875;4200000;0
2764;556;3;0;0;0;0;.00nan;0;0
2764;167642;18;0;0;0;0;.00nan;0;0
2764;173727;18;63;27;3;24;.889;3600000;0
2764;179344;3;52;28;4;24;.857;3600000;0
2765;166751;5;81;28;2;26;.929;4200000;0
2765;172398;5;0;0;0;0;.00nan;0;0
2765;183844;29;95;44;2;42;.955;4200000;0
2765;37818;29;0;0;0;0;.00nan;0;0
2766;174718;25;63;35;4;31;.886;3538000;0
2766;184770;22;0;0;0;0;.00nan;0;0
2766;143473;22;57;19;2;17;.895;3600000;0
2766;148958;25;0;0;0;0;.00nan;0;0
2767;163423;26;0;0;0;0;.00nan;0;0
2767;85798;12;0;0;0;0;.00nan;0;0
2767;91178;12;66;32;4;28;.875;3523000;0
2767;152835;26;80;29;2;27;.931;3600000;0
2768;13337;32;0;0;0;0;.00nan;0;0
2768;20432;32;77;42;4;38;.905;3758000;0
2768;185743;4838;0;0;0;0;.00nan;0;0
2768;143749;4838;62;29;3;26;.897;3758000;0
2769;67;11;0;0;0;0;.00nan;0;0
2769;172340;4182;0;0;0;0;.00nan;0;0
2769;45323;11;67;45;5;40;.889;3600000;0
2769;147945;4182;65;20;2;18;.900;3600000;0
2770;2059;23;0;0;0;0;.00nan;0;0
2770;170977;30;0;0;0;0;.00nan;0;0
2770;78573;23;88;47;3;44;.936;4200000;0
2770;86697;30;81;31;3;28;.903;4200000;0
2771;3928;15;14;26;7;19;.731;3010000;0
2771;167642;18;0;0;0;0;.00nan;0;0
2771;173727;18;100;56;4;52;.929;3600000;0
2771;59540;15;51;3;0;3;1.000;590000;0
2772;166646;16;0;0;0;0;.00nan;0;0
2772;3284;21;92;31;1;30;.968;3600000;0
2772;50065;16;41;31;5;26;.839;3600000;0
2772;143156;21;0;0;0;0;.00nan;0;0
2773;676;34;0;0;0;0;.00nan;0;0
2773;163195;0;0;0;0;0;.00nan;0;0
2773;78806;34;60;41;5;36;.878;3600000;0
2773;139409;0;77;31;3;28;.903;3600000;0
2774;556;3;74;20;2;18;.900;3600000;0
2774;183844;29;69;32;4;28;.875;3558000;0
2774;179344;3;0;0;0;0;.00nan;0;0
2774;37818;29;0;0;0;0;.00nan;0;0
2775;165582;24;85;36;2;34;.944;4173000;0
2775;184770;22;0;0;0;0;.00nan;0;0
2775;85727;24;0;0;0;0;.00nan;0;0
2775;143473;22;81;36;3;33;.917;4173000;0
2776;166751;5;61;37;4;33;.892;3600000;0
2776;172398;5;0;0;0;0;.00nan;0;0
2776;184229;35;0;0;0;0;.00nan;0;0
2776;57338;35;97;25;0;25;1.000;3600000;0
2777;187578;10;0;0;0;0;.00nan;0;0
2777;77955;28;0;0;0;0;.00nan;0;0
2777;85437;28;81;28;2;26;.929;3600000;0
2777;90164;10;50;38;6;32;.842;3600000;0
2778;166591;20;0;0;0;0;.00nan;0;0
2778;168712;14;0;0;0;0;.00nan;0;0
2778;185034;14;70;32;2;30;.938;3913000;0
2778;71565;20;92;40;3;37;.925;3913000;0
2779;13337;32;0;0;0;0;.00nan;0;0
2779;18213;8;78;21;1;20;.952;3600000;0
2779;20432;32;81;38;3;35;.921;3555000;0
2779;189644;8;0;0;0;0;.00nan;0;0
2780;172340;4182;54;25;3;22;.880;3600000;0
2780;163423;26;0;0;0;0;.00nan;0;0
2780;147945;4182;0;0;0;0;.00nan;0;0
2780;152835;26;70;35;4;31;.886;3551000;0
2781;187537;19;56;36;5;31;.861;3600000;0
2781;163565;19;0;0;0;0;.00nan;0;0
2781;174718;25;66;17;1;16;.941;3600000;0
2781;148958;25;0;0;0;0;.00nan;0;0
2782;166381;27;0;0;0;0;.00nan;0;0
2782;175092;9;0;0;0;0;.00nan;0;0
2782;175660;27;59;24;3;21;.875;4200000;0
2782;190106;9;87;44;3;41;.932;4200000;0
2783;2059;23;0;0;0;0;.00nan;0;0
2783;78573;23;68;41;4;37;.902;4196000;0
2783;85798;12;46;34;5;29;.853;4196000;0
2783;91178;12;0;0;0;0;.00nan;0;0
2784;67;11;0;0;0;0;.00nan;0;0
2784;170977;30;0;0;0;0;.00nan;0;0
2784;45323;11;62;44;6;38;.864;3600000;0
2784;86697;30;39;16;3;13;.813;3600000;0
2785;163195;0;0;0;0;0;.00nan;0;0
2785;183844;29;0;0;0;0;.00nan;0;0
2785;37818;29;81;23;1;22;.957;3543000;0
2785;139409;0;100;28;0;28;1.000;3600000;0
2786;166591;20;73;38;3;35;.921;3578000;0
2786;184770;22;0;0;0;0;.00nan;0;0
2786;71565;20;0;0;0;0;.00nan;0;0
2786;143473;22;79;25;1;24;.960;3600000;0
2787;171838;31;0;0;0;0;.00nan;0;0
2787;166646;16;72;20;1;19;.950;3600000;0
2787;50065;16;0;0;0;0;.00nan;0;0
2787;152717;31;63;34;3;31;.912;3527000;0
2788;676;34;88;27;1;26;.963;3600000;0
2788;3284;21;70;36;4;32;.889;3600000;0
2788;78806;34;0;0;0;0;.00nan;0;0
2788;143156;21;0;0;0;0;.00nan;0;0
2789;163423;26;0;0;0;0;.00nan;0;0
2789;18213;8;77;36;3;33;.917;3761000;0
2789;189644;8;0;0;0;0;.00nan;0;0
2789;152835;26;73;25;2;23;.920;3761000;0
2790;187578;10;97;39;1;38;.974;4200000;0
2790;167642;18;0;0;0;0;.00nan;0;0
2790;173727;18;95;28;1;27;.964;4200000;0
2790;90164;10;0;0;0;0;.00nan;0;0
2791;166381;27;94;42;2;40;.952;3803000;0
2791;175660;27;0;0;0;0;.00nan;0;0
2791;185743;4838;0;0;0;0;.00nan;0;0
2791;143749;4838;74;25;1;24;.960;3803000;0
2792;170977;30;0;0;0;0;.00nan;0;0
2792;175092;9;0;0;0;0;.00nan;0;0
2792;190106;9;63;37;4;33;.892;3545000;0
2792;86697;30;75;36;3;33;.917;3600000;0
2793;165582;24;0;0;0;0;.00nan;0;0
2793;77955;28;100;42;0;42;1.000;3600000;0
2793;85437;28;0;0;0;0;.00nan;0;0
2793;85727;24;70;33;3;30;.909;3600000;0
2794;5923;17;0;0;0;0;.00nan;0;0
2794;178413;17;77;36;2;34;.944;4200000;0
2794;168712;14;0;0;0;0;.00nan;0;0
2794;185034;14;79;34;2;32;.941;4200000;0
2795;166751;5;57;29;4;25;.862;3600000;0
2795;3928;15;67;24;2;22;.917;3600000;0
2795;172398;5;0;0;0;0;.00nan;0;0
2795;59540;15;0;0;0;0;.00nan;0;0
2796;556;3;100;34;0;34;1.000;3600000;0
2796;184229;35;0;0;0;0;.00nan;0;0
2796;179344;3;0;0;0;0;.00nan;0;0
2796;57338;35;54;27;3;24;.889;3600000;0
2797;172340;4182;0;0;0;0;.00nan;0;0
2797;174718;25;67;27;3;24;.889;3562000;0
2797;147945;4182;66;22;2;20;.909;3600000;0
2797;148958;25;0;0;0;0;.00nan;0;0
2798;190465;33;76;24;1;23;.958;3047000;0
2798;197038;33;24;5;3;2;.400;526000;0
2798;85798;12;0;0;0;0;.00nan;0;0
2798;91178;12;74;27;3;24;.889;3600000;0
2799;67;11;0;0;0;0;.00nan;0;0
2799;2059;23;0;0;0;0;.00nan;0;0
2799;45323;11;70;35;5;30;.857;3600000;0
2799;78573;23;38;19;4;15;.789;3600000;0
2800;183844;29;56;40;6;34;.850;2621000;0
2800;184770;22;75;21;1;20;.952;3600000;0
2800;37818;29;64;14;0;14;1.000;979000;0
2800;143473;22;0;0;0;0;.00nan;0;0
2801;175092;9;79;35;3;32;.914;3600000;0
2801;190106;9;0;0;0;0;.00nan;0;0
2801;185743;4838;72;24;1;23;.958;3600000;0
2801;143749;4838;0;0;0;0;.00nan;0;0
2802;676;34;0;0;0;0;.00nan;0;0
2802;77955;28;55;31;4;27;.871;3559000;0
2802;78806;34;74;27;2;25;.926;3600000;0
2802;85437;28;0;0;0;0;.00nan;0;0
2803;171838;31;64;41;5;36;.878;3600000;0
2803;165582;24;58;30;4;26;.867;3600000;0
2803;85727;24;0;0;0;0;.00nan;0;0
2803;152717;31;0;0;0;0;.00nan;0;0
2804;166591;20;0;0;0;0;.00nan;0;0
2804;168712;14;47;13;2;11;.846;3514000;0
2804;185034;14;0;0;0;0;.00nan;0;0
2804;71565;20;100;41;0;41;1.000;3600000;0
2805;172340;4182;76;27;2;25;.926;3600000;0
2805;85798;12;67;29;3;26;.897;3581000;0
2805;91178;12;0;0;0;0;.00nan;0;0
2805;147945;4182;0;0;0;0;.00nan;0;0
2806;2059;23;66;32;3;29;.906;3586000;0
2806;170977;30;58;21;2;19;.905;3600000;0
2806;78573;23;0;0;0;0;.00nan;0;0
2806;86697;30;0;0;0;0;.00nan;0;0
2807;187537;19;79;25;1;24;.960;3600000;0
2807;163565;19;0;0;0;0;.00nan;0;0
2807;13337;32;0;0;0;0;.00nan;0;0
2807;20432;32;85;36;2;34;.944;3576000;0
2808;163195;0;0;0;0;0;.00nan;0;0
2808;190465;33;0;0;0;0;.00nan;0;0
2808;197038;33;99;34;1;33;.971;3600000;0
2808;139409;0;77;37;3;34;.919;3529000;0
2809;166646;16;58;20;2;18;.900;3600000;0
2809;18213;8;99;43;1;42;.977;3600000;0
2809;189644;8;0;0;0;0;.00nan;0;0
2809;50065;16;0;0;0;0;.00nan;0;0
2810;3284;21;85;46;4;42;.913;3600000;0
2810;3928;15;87;24;1;23;.958;3600000;0
2810;59540;15;0;0;0;0;.00nan;0;0
2810;143156;21;0;0;0;0;.00nan;0;0
2811;163423;26;0;0;0;0;.00nan;0;0
2811;184229;35;0;0;0;0;.00nan;0;0
2811;57338;35;78;27;2;25;.926;4200000;0
2811;152835;26;85;36;2;34;.944;4200000;0
2812;167642;18;0;0;0;0;.00nan;0;0
2812;166381;27;0;0;0;0;.00nan;0;0
2812;173727;18;68;26;2;24;.923;3600000;0
2812;175660;27;57;34;4;30;.882;3600000;0
2813;3284;21;0;0;0;0;.00nan;0;0
2813;183844;29;100;41;2;39;.951;3600000;0
2813;37818;29;0;0;0;0;.00nan;0;0
2813;143156;21;17;23;6;17;.739;3600000;0
2814;184770;22;0;0;0;0;.00nan;0;0
2814;77955;28;77;49;5;44;.898;3600000;0
2814;85437;28;0;0;0;0;.00nan;0;0
2814;143473;22;78;22;2;20;.909;3600000;0
2815;556;3;78;29;2;27;.931;3600000;0
2815;5923;17;0;0;0;0;.00nan;0;0
2815;178413;17;42;26;4;22;.846;3592000;0
2815;179344;3;0;0;0;0;.00nan;0;0
2816;166751;5;86;47;3;44;.936;4200000;0
2816;172398;5;0;0;0;0;.00nan;0;0
2816;85798;12;0;0;0;0;.00nan;0;0
2816;91178;12;71;30;3;27;.900;4200000;0
2817;187537;19;67;42;4;38;.905;3600000;0
2817;172340;4182;0;0;0;0;.00nan;0;0
2817;163565;19;0;0;0;0;.00nan;0;0
2817;147945;4182;53;24;3;21;.875;3600000;0
2818;187578;10;82;31;2;29;.935;3555000;0
2818;170977;30;0;0;0;0;.00nan;0;0
2818;86697;30;91;31;1;30;.968;3600000;0
2818;90164;10;0;0;0;0;.00nan;0;0
2819;676;34;47;29;5;24;.828;3851000;0
2819;168712;14;58;34;4;30;.882;3851000;0
2819;185034;14;0;0;0;0;.00nan;0;0
2819;78806;34;0;0;0;0;.00nan;0;0
2820;166591;20;0;0;0;0;.00nan;0;0
2820;3928;15;0;0;0;0;.00nan;0;0
2820;71565;20;63;45;6;39;.867;3600000;0
2820;139409;15;53;22;3;19;.864;3600000;0
2821;556;3;91;18;0;18;1.000;3600000;0
2821;179344;3;0;0;0;0;.00nan;0;0
2821;149452;31;69;42;4;38;.905;3600000;0
2821;152717;31;0;0;0;0;.00nan;0;0
2822;18213;8;71;19;1;18;.947;3600000;0
2822;189644;8;0;0;0;0;.00nan;0;0
2822;190465;33;70;43;4;39;.907;3600000;0
2822;197038;33;0;0;0;0;.00nan;0;0
2823;163423;26;0;0;0;0;.00nan;0;0
2823;165582;24;0;0;0;0;.00nan;0;0
2823;85727;24;88;34;2;32;.941;3600000;0
2823;152835;26;45;34;5;29;.853;3600000;0
2824;184229;35;0;0;0;0;.00nan;0;0
2824;174718;25;72;23;3;20;.870;3600000;0
2824;57338;35;70;38;4;34;.895;3600000;0
2824;148958;25;0;0;0;0;.00nan;0;0
2825;67;11;0;0;0;0;.00nan;0;0
2825;166646;16;0;0;0;0;.00nan;0;0
2825;45323;11;39;44;7;37;.841;3600000;0
2825;50065;16;60;26;3;23;.885;3600000;0
2826;166751;5;0;0;0;0;.00nan;0;0
2826;172398;5;26;24;6;18;.750;3600000;0
2826;13337;32;0;0;0;0;.00nan;0;0
2826;20432;32;86;35;2;33;.943;3600000;0
2827;187537;19;0;0;0;0;.00nan;0;0
2827;163565;19;93;45;3;42;.933;3600000;0
2827;167642;18;70;15;0;15;1.000;2516000;0
2827;173727;18;21;8;4;4;.500;1030000;0
2828;2059;23;0;0;0;0;.00nan;0;0
2828;166381;27;57;35;5;30;.857;3545000;0
2828;175660;27;0;0;0;0;.00nan;0;0
2828;78573;23;67;39;4;35;.897;3600000;0
2829;3284;21;100;29;1;28;.966;3600000;0
2829;175092;9;0;0;0;0;.00nan;0;0
2829;190106;9;92;41;2;39;.951;3544000;0
2829;143156;21;0;0;0;0;.00nan;0;0
2830;163195;0;0;0;0;0;.00nan;0;0
2830;184770;22;0;0;0;0;.00nan;0;0
2830;186573;0;100;57;2;55;.965;3600000;0
2830;143473;22;45;15;3;12;.800;3560000;0
2831;187578;10;77;21;1;20;.952;3600000;0
2831;179950;4838;0;0;0;0;.00nan;0;0
2831;90164;10;0;0;0;0;.00nan;0;0
2831;143749;4838;78;27;2;25;.926;3564000;0
2832;183844;29;0;0;0;0;.00nan;0;0
2832;170977;30;0;0;0;0;.00nan;0;0
2832;37818;29;78;47;4;43;.915;3518000;0
2832;86697;30;65;21;2;19;.905;3600000;0
2833;3928;15;0;0;0;0;.00nan;0;0
2833;168712;14;0;0;0;0;.00nan;0;0
2833;185034;14;69;44;4;40;.909;4200000;0
2833;139409;15;46;18;4;14;.778;4198000;0
2834;166646;16;0;0;0;0;.00nan;0;0
2834;163195;0;80;49;4;45;.918;3755000;0
2834;186573;0;0;0;0;0;.00nan;0;0
2834;50065;16;50;16;3;13;.813;3755000;0
2835;556;3;43;23;4;19;.826;3787000;0
2835;179344;3;0;0;0;0;.00nan;0;0
2835;175092;9;71;35;3;32;.914;3787000;0
2835;190106;9;0;0;0;0;.00nan;0;0
2836;676;34;89;48;3;45;.938;3920000;0
2836;166591;20;0;0;0;0;.00nan;0;0
2836;71565;20;91;41;2;39;.951;3920000;0
2836;78806;34;0;0;0;0;.00nan;0;0
2837;166751;5;51;32;4;28;.875;3515000;0
2837;172398;5;0;0;0;0;.00nan;0;0
2837;165582;24;0;0;0;0;.00nan;0;0
2837;85727;24;60;20;2;18;.900;3600000;0
2838;67;11;0;0;0;0;.00nan;0;0
2838;45323;11;75;37;3;34;.919;3593000;0
2838;149452;31;0;0;0;0;.00nan;0;0
2838;152717;31;84;33;2;31;.939;3600000;0
2839;163423;26;0;0;0;0;.00nan;0;0
2839;190465;33;38;28;5;23;.821;1817000;0
2839;197038;33;45;13;2;11;.846;1769000;0
2839;152835;26;49;34;5;29;.853;3600000;0
2840;18213;8;64;27;3;24;.889;3600000;0
2840;189644;8;0;0;0;0;.00nan;0;0
2840;77955;28;52;32;4;28;.875;3583000;0
2840;85437;28;0;0;0;0;.00nan;0;0
2841;167642;18;0;0;0;0;.00nan;0;0
2841;173727;18;87;27;1;26;.963;3600000;0
2841;184229;35;0;0;0;0;.00nan;0;0
2841;57338;35;77;28;2;26;.929;3546000;0
2842;13337;32;0;0;0;0;.00nan;0;0
2842;20432;32;91;44;2;42;.955;3849000;0
2842;85798;12;0;0;0;0;.00nan;0;0
2842;91178;12;93;31;1;30;.968;3849000;0
2843;172340;4182;0;0;0;0;.00nan;0;0
2843;174718;25;70;22;1;21;.955;3600000;0
2843;147945;4182;49;31;6;25;.806;3600000;0
2843;148958;25;0;0;0;0;.00nan;0;0
2844;187578;10;0;0;0;0;.00nan;0;0
2844;166381;27;59;18;2;16;.889;3546000;0
2844;175660;27;0;0;0;0;.00nan;0;0
2844;90164;10;95;31;1;30;.968;3600000;0
2845;187537;19;55;24;3;21;.875;3600000;0
2845;2059;23;0;0;0;0;.00nan;0;0
2845;163565;19;0;0;0;0;.00nan;0;0
2845;78573;23;56;42;5;37;.881;3544000;0
2846;3284;21;74;37;3;34;.919;3600000;0
2846;5923;17;0;0;0;0;.00nan;0;0
2846;178413;17;16;32;7;25;.781;3600000;0
2846;143156;21;0;0;0;0;.00nan;0;0
2847;676;34;0;0;0;0;.00nan;0;0
2847;170977;30;0;0;0;0;.00nan;0;0
2847;78806;34;98;33;1;32;.970;3554000;0
2847;86697;30;93;23;0;23;1.000;3600000;0
2848;166751;5;62;42;6;36;.857;3600000;0
2848;172398;5;0;0;0;0;.00nan;0;0
2848;174718;25;90;30;1;29;.967;3600000;0
2848;148958;25;0;0;0;0;.00nan;0;0
2849;166646;16;51;29;4;25;.862;3516000;0
2849;184229;35;0;0;0;0;.00nan;0;0
2849;50065;16;0;0;0;0;.00nan;0;0
2849;57338;35;84;36;2;34;.944;3600000;0
2850;163423;26;59;8;0;8;1.000;1077000;0
2850;184770;22;0;0;0;0;.00nan;0;0
2850;143473;22;70;24;2;22;.917;3600000;0
2850;152835;26;29;31;7;24;.774;2523000;0
2851;556;3;76;29;2;27;.931;3600000;0
2851;168712;14;49;1;0;1;1.000;241000;0
2851;179344;3;0;0;0;0;.00nan;0;0
2851;185034;14;66;42;5;37;.881;3359000;0
2852;3928;15;0;0;0;0;.00nan;0;0
2852;77955;28;75;53;5;48;.906;3587000;0
2852;85437;28;0;0;0;0;.00nan;0;0
2852;139409;15;54;21;3;18;.857;3600000;0
2853;163195;0;71;24;2;22;.917;3600000;0
2853;175092;9;0;0;0;0;.00nan;0;0
2853;190106;9;54;28;4;24;.857;3532000;0
2853;186573;0;0;0;0;0;.00nan;0;0
2854;67;11;0;0;0;0;.00nan;0;0
2854;5923;17;88;31;1;30;.968;3600000;0
2854;178413;17;0;0;0;0;.00nan;0;0
2854;45323;11;67;33;3;30;.909;3561000;0
2855;166591;20;0;0;0;0;.00nan;0;0
2855;165582;24;71;34;3;31;.912;3600000;0
2855;71565;20;66;43;5;38;.884;3545000;0
2855;85727;24;0;0;0;0;.00nan;0;0
2856;183844;29;0;0;0;0;.00nan;0;0
2856;37818;29;74;28;2;26;.929;3600000;0
2856;149452;31;81;42;3;39;.929;3571000;0
2856;152717;31;0;0;0;0;.00nan;0;0
2857;13337;32;0;0;0;0;.00nan;0;0
2857;18213;8;62;21;2;19;.905;3600000;0
2857;20432;32;100;42;1;41;.976;3600000;0
2857;189644;8;0;0;0;0;.00nan;0;0
2858;166381;27;0;0;0;0;.00nan;0;0
2858;175660;27;66;17;1;16;.941;3600000;0
2858;85798;12;0;0;0;0;.00nan;0;0
2858;91178;12;64;36;4;32;.889;3600000;0
2859;2059;23;0;0;0;0;.00nan;0;0
2859;172340;4182;59;19;2;17;.895;3600000;0
2859;78573;23;97;49;3;46;.939;3566000;0
2859;147945;4182;0;0;0;0;.00nan;0;0
2860;187537;19;70;31;3;28;.903;4200000;0
2860;187578;10;96;55;3;52;.945;4200000;0
2860;163565;19;0;0;0;0;.00nan;0;0
2860;90164;10;0;0;0;0;.00nan;0;0
2861;166646;16;0;0;0;0;.00nan;0;0
2861;190465;33;0;0;0;0;.00nan;0;0
2861;197038;33;97;45;2;43;.956;3547000;0
2861;50065;16;100;27;0;27;1.000;3600000;0
2862;170977;30;0;0;0;0;.00nan;0;0
2862;184770;22;52;26;4;22;.846;3858000;0
2862;86697;30;77;39;3;36;.923;3858000;0
2862;143473;22;0;0;0;0;.00nan;0;0
2863;3284;21;83;27;2;25;.926;4200000;0
2863;183844;29;94;41;2;39;.951;4200000;0
2863;37818;29;0;0;0;0;.00nan;0;0
2863;143156;21;0;0;0;0;.00nan;0;0
2864;163423;26;0;0;0;0;.00nan;0;0
2864;77955;28;0;0;0;0;.00nan;0;0
2864;85437;28;67;26;3;23;.885;3600000;0
2864;152835;26;80;14;0;14;1.000;3600000;0
2865;179950;4838;0;0;0;0;.00nan;0;0
2865;85798;12;45;49;7;42;.857;3334000;0
2865;91178;12;32;5;2;3;.600;266000;0
2865;143749;4838;95;39;2;37;.949;3600000;0
2866;166591;20;0;0;0;0;.00nan;0;0
2866;165582;24;0;0;0;0;.00nan;0;0
2866;71565;20;79;43;3;40;.930;3600000;0
2866;85727;24;89;36;2;34;.944;3600000;0
2867;166751;5;71;34;3;31;.912;3852000;0
2867;172398;5;0;0;0;0;.00nan;0;0
2867;174718;25;62;19;2;17;.895;3852000;0
2867;148958;25;0;0;0;0;.00nan;0;0
2868;67;11;0;0;0;0;.00nan;0;0
2868;175092;9;0;0;0;0;.00nan;0;0
2868;190106;9;71;20;1;19;.950;3600000;0
2868;45323;11;84;38;3;35;.921;3516000;0
2869;3928;15;0;0;0;0;.00nan;0;0
2869;184229;35;0;0;0;0;.00nan;0;0
2869;57338;35;81;41;3;38;.927;3600000;0
2869;139409;15;83;14;0;14;1.000;3600000;0
2870;187578;10;52;38;5;33;.868;3600000;0
2870;13337;32;0;0;0;0;.00nan;0;0
2870;20432;32;100;29;0;29;1.000;3600000;0
2870;90164;10;0;0;0;0;.00nan;0;0
2871;187537;19;61;8;0;8;1.000;1099000;0
2871;163565;19;25;25;6;19;.760;2478000;0
2871;18213;8;55;36;5;31;.861;3600000;0
2871;189644;8;0;0;0;0;.00nan;0;0
2872;163195;0;67;33;3;30;.909;3600000;0
2872;186573;0;0;0;0;0;.00nan;0;0
2872;77955;28;59;33;4;29;.879;3596000;0
2872;85437;28;0;0;0;0;.00nan;0;0
2873;3284;21;53;39;5;34;.872;3574000;0
2873;179950;4838;0;0;0;0;.00nan;0;0
2873;143156;21;0;0;0;0;.00nan;0;0
2873;143749;4838;84;38;3;35;.921;3600000;0
2874;5923;17;0;0;0;0;.00nan;0;0
2874;178413;17;80;38;3;35;.921;3600000;0
2874;184770;22;0;0;0;0;.00nan;0;0
2874;143473;22;94;22;0;22;1.000;3600000;0
2875;168712;14;68;31;3;28;.903;3550000;0
2875;170977;30;0;0;0;0;.00nan;0;0
2875;185034;14;0;0;0;0;.00nan;0;0
2875;86697;30;75;30;2;28;.933;3600000;0
2876;166646;16;0;0;0;0;.00nan;0;0
2876;163423;26;0;0;0;0;.00nan;0;0
2876;50065;16;69;15;1;14;.933;3600000;0
2876;152835;26;65;38;4;34;.895;3600000;0
2877;172340;4182;56;11;1;10;.909;3600000;0
2877;190465;33;0;0;0;0;.00nan;0;0
2877;197038;33;83;42;4;38;.905;3600000;0
2877;147945;4182;0;0;0;0;.00nan;0;0
2878;166381;27;64;28;3;25;.893;3590000;0
2878;175660;27;0;0;0;0;.00nan;0;0
2878;85798;12;0;0;0;0;.00nan;0;0
2878;91178;12;99;34;1;33;.971;3600000;0
2879;676;34;0;0;0;0;.00nan;0;0
2879;2059;23;0;0;0;0;.00nan;0;0
2879;78573;23;89;44;3;41;.932;3585000;0
2879;78806;34;52;15;2;13;.867;3600000;0
2880;556;3;91;38;2;36;.947;3600000;0
2880;179344;3;0;0;0;0;.00nan;0;0
2880;174718;25;45;29;5;24;.828;3600000;0
2880;148958;25;0;0;0;0;.00nan;0;0
2881;166751;5;72;34;3;31;.912;4200000;0
2881;172398;5;0;0;0;0;.00nan;0;0
2881;165582;24;0;0;0;0;.00nan;0;0
2881;85727;24;64;30;3;27;.900;4200000;0
2882;187537;19;84;35;2;33;.943;3600000;0
2882;163565;19;0;0;0;0;.00nan;0;0
2882;18213;8;63;28;3;25;.893;3568000;0
2882;189644;8;0;0;0;0;.00nan;0;0
2883;3928;15;0;0;0;0;.00nan;0;0
2883;167642;18;0;0;0;0;.00nan;0;0
2883;173727;18;100;27;0;27;1.000;3600000;0
2883;139409;15;93;30;1;29;.967;3555000;0
2884;183844;29;0;0;0;0;.00nan;0;0
2884;37818;29;100;24;0;24;1.000;3600000;0
2884;77955;28;80;45;4;41;.911;3600000;0
2884;85437;28;0;0;0;0;.00nan;0;0
2885;163195;0;88;41;3;38;.927;3600000;0
2885;170977;30;0;0;0;0;.00nan;0;0
2885;186573;0;0;0;0;0;.00nan;0;0
2885;86697;30;62;34;4;30;.882;3555000;0
2886;175092;9;19;10;4;6;.600;794000;0
2886;190106;9;83;31;2;29;.935;2806000;0
2886;179950;4838;0;0;0;0;.00nan;0;0
2886;143749;4838;66;23;2;21;.913;3600000;0
2887;5923;17;0;0;0;0;.00nan;0;0
2887;178413;17;57;17;2;15;.882;3600000;0
2887;149452;31;79;44;4;40;.909;3587000;0
2887;152717;31;0;0;0;0;.00nan;0;0
2888;187578;10;59;36;4;32;.889;3600000;0
2888;174718;25;65;31;3;28;.903;3600000;0
2888;90164;10;0;0;0;0;.00nan;0;0
2888;148958;25;0;0;0;0;.00nan;0;0
2889;3284;21;94;32;1;31;.969;3600000;0
2889;168712;14;0;0;0;0;.00nan;0;0
2889;185034;14;55;30;3;27;.900;3516000;0
2889;143156;21;0;0;0;0;.00nan;0;0
2890;166751;5;0;0;0;0;.00nan;0;0
2890;163423;26;0;0;0;0;.00nan;0;0
2890;172398;5;69;40;4;36;.900;3600000;0
2890;152835;26;85;31;1;30;.968;3600000;0
2891;166646;16;0;0;0;0;.00nan;0;0
2891;166381;27;0;0;0;0;.00nan;0;0
2891;175660;27;66;26;4;22;.846;3600000;0
2891;50065;16;77;27;1;26;.963;3600000;0
2892;166591;20;0;0;0;0;.00nan;0;0
2892;13337;32;0;0;0;0;.00nan;0;0
2892;20432;32;83;23;1;22;.957;3600000;0
2892;71565;20;81;43;4;39;.907;3600000;0
2893;3928;15;0;0;0;0;.00nan;0;0
2893;172340;4182;100;37;0;37;1.000;3600000;0
2893;139409;15;62;26;2;24;.923;3521000;0
2893;147945;4182;0;0;0;0;.00nan;0;0
2894;184229;35;0;0;0;0;.00nan;0;0
2894;57338;35;85;37;3;34;.919;3600000;0
2894;85798;12;0;0;0;0;.00nan;0;0
2894;91178;12;28;24;6;18;.750;3600000;0
2895;67;11;42;38;6;32;.842;3600000;0
2895;676;34;71;28;2;26;.929;3600000;0
2895;45323;11;0;0;0;0;.00nan;0;0
2895;78806;34;0;0;0;0;.00nan;0;0
2896;2059;23;0;0;0;0;.00nan;0;0
2896;190465;33;55;30;4;26;.867;3513000;0
2896;197038;33;0;0;0;0;.00nan;0;0
2896;78573;23;84;35;2;33;.943;3600000;0
2897;3284;21;0;0;0;0;.00nan;0;0
2897;18213;8;67;25;2;23;.920;3600000;0
2897;189644;8;0;0;0;0;.00nan;0;0
2897;143156;21;62;33;4;29;.879;3569000;0
2898;556;3;75;24;2;22;.917;3600000;0
2898;165582;24;0;0;0;0;.00nan;0;0
2898;179344;3;0;0;0;0;.00nan;0;0
2898;85727;24;58;27;3;24;.889;3600000;0
2899;167642;18;0;0;0;0;.00nan;0;0
2899;173727;18;45;25;5;20;.800;3548000;0
2899;190465;33;0;0;0;0;.00nan;0;0
2899;197038;33;89;50;4;46;.920;3600000;0
2900;13337;32;0;0;0;0;.00nan;0;0
2900;183844;29;0;0;0;0;.00nan;0;0
2900;20432;32;89;40;2;38;.950;3734000;0
2900;37818;29;60;16;1;15;.938;3734000;0
2901;676;34;0;0;0;0;.00nan;0;0
2901;172340;4182;100;39;2;37;.949;3660000;0
2901;78806;34;67;31;3;28;.903;3660000;0
2901;147945;4182;0;0;0;0;.00nan;0;0
2902;187537;19;75;34;3;31;.912;4027000;0
2902;163565;19;0;0;0;0;.00nan;0;0
2902;174718;25;0;0;0;0;.00nan;0;0
2902;148958;25;51;16;2;14;.875;4027000;0
2903;175092;9;0;0;0;0;.00nan;0;0
2903;190106;9;51;27;4;23;.852;3600000;0
2903;77955;28;52;39;7;32;.821;2547000;0
2903;85437;28;56;17;2;15;.882;1053000;0
2904;5923;17;0;0;0;0;.00nan;0;0
2904;163195;0;98;57;4;53;.930;3600000;0
2904;178413;17;66;17;2;15;.882;3600000;0
2904;186573;0;0;0;0;0;.00nan;0;0
2905;163423;26;0;0;0;0;.00nan;0;0
2905;149452;31;53;40;6;34;.850;2698000;0
2905;152717;31;51;9;1;8;.889;902000;0
2905;152835;26;66;24;2;22;.917;3600000;0
2906;187578;10;99;47;2;45;.957;3600000;0
2906;184770;22;0;0;0;0;.00nan;0;0
2906;90164;10;0;0;0;0;.00nan;0;0
2906;143473;22;47;18;3;15;.833;3575000;0
2907;168712;14;0;0;0;0;.00nan;0;0
2907;185034;14;58;35;4;31;.886;3552000;0
2907;179950;4838;0;0;0;0;.00nan;0;0
2907;143749;4838;95;39;2;37;.949;3600000;0
2908;166646;16;89;37;2;35;.946;3600000;0
2908;18213;8;0;0;0;0;.00nan;0;0
2908;189644;8;75;25;1;24;.960;3600000;0
2908;50065;16;0;0;0;0;.00nan;0;0
2909;166591;20;0;0;0;0;.00nan;0;0
2909;71565;20;68;34;3;31;.912;3524000;0
2909;85798;12;0;0;0;0;.00nan;0;0
2909;91178;12;68;19;1;18;.947;3600000;0
2910;67;11;0;0;0;0;.00nan;0;0
2910;166751;5;92;42;1;41;.976;3600000;0
2910;172398;5;0;0;0;0;.00nan;0;0
2910;45323;11;29;22;6;16;.727;3600000;0
2911;2059;23;0;0;0;0;.00nan;0;0
2911;3928;15;0;0;0;0;.00nan;0;0
2911;78573;23;64;49;5;44;.898;3538000;0
2911;139409;15;31;10;3;7;.700;3600000;0
2912;556;3;92;39;2;37;.949;4200000;0
2912;3284;21;92;34;2;32;.941;4155000;0
2912;179344;3;0;0;0;0;.00nan;0;0
2912;143156;21;0;0;0;0;.00nan;0;0
2913;676;34;84;35;2;33;.943;3600000;0
2913;167642;18;53;24;3;21;.875;3548000;0
2913;173727;18;0;0;0;0;.00nan;0;0
2913;78806;34;0;0;0;0;.00nan;0;0
2914;166646;16;0;0;0;0;.00nan;0;0
2914;187578;10;0;0;0;0;.00nan;0;0
2914;50065;16;62;14;1;13;.929;3600000;0
2914;90164;10;63;48;5;43;.896;3600000;0
2915;163423;26;0;0;0;0;.00nan;0;0
2915;175092;9;42;24;5;19;.792;3600000;0
2915;190106;9;0;0;0;0;.00nan;0;0
2915;152835;26;100;36;0;36;1.000;3600000;0
2916;184770;22;64;21;2;19;.905;3600000;0
2916;179950;4838;63;41;5;36;.878;3600000;0
2916;143473;22;0;0;0;0;.00nan;0;0
2916;143749;4838;0;0;0;0;.00nan;0;0
2917;166381;27;0;0;0;0;.00nan;0;0
2917;184229;35;0;0;0;0;.00nan;0;0
2917;175660;27;85;28;1;27;.964;3600000;0
2917;57338;35;76;26;2;24;.923;3572000;0
2918;67;11;73;28;2;26;.929;3600000;0
2918;190465;33;51;31;4;27;.871;3564000;0
2918;197038;33;0;0;0;0;.00nan;0;0
2918;45323;11;0;0;0;0;.00nan;0;0
2919;187537;19;0;0;0;0;.00nan;0;0
2919;163565;19;73;40;4;36;.900;3600000;0
2919;170977;30;0;0;0;0;.00nan;0;0
2919;86697;30;85;18;0;18;1.000;3600000;0
2920;13337;32;0;0;0;0;.00nan;0;0
2920;20432;32;73;39;5;34;.872;3578000;0
2920;77955;28;0;0;0;0;.00nan;0;0
2920;85437;28;47;19;3;16;.842;3600000;0
2921;168712;14;65;28;3;25;.893;3554000;0
2921;185034;14;0;0;0;0;.00nan;0;0
2921;149452;31;99;49;2;47;.959;3600000;0
2921;152717;31;0;0;0;0;.00nan;0;0
2922;163195;0;60;31;4;27;.871;3600000;0
2922;174718;25;78;27;1;26;.963;3600000;0
2922;186573;0;0;0;0;0;.00nan;0;0
2922;148958;25;0;0;0;0;.00nan;0;0
2923;172340;4182;77;41;4;37;.902;3637000;0
2923;85798;12;0;0;0;0;.00nan;0;0
2923;91178;12;58;38;5;33;.868;3637000;0
2923;147945;4182;0;0;0;0;.00nan;0;0
2924;184770;22;0;0;0;0;.00nan;0;0
2924;143473;22;98;21;0;21;1.000;3600000;0
2924;149452;31;0;0;0;0;.00nan;0;0
2924;152717;31;91;50;2;48;.960;3597000;0
2925;3928;15;0;0;0;0;.00nan;0;0
2925;5923;17;0;0;0;0;.00nan;0;0
2925;178413;17;42;41;6;35;.854;3600000;0
2925;139409;15;100;29;0;29;1.000;3600000;0
2926;13337;32;0;0;0;0;.00nan;0;0
2926;165582;24;67;28;3;25;.893;3600000;0
2926;20432;32;41;34;6;28;.824;3600000;0
2926;85727;24;0;0;0;0;.00nan;0;0
2927;166591;20;0;0;0;0;.00nan;0;0
2927;163423;26;0;0;0;0;.00nan;0;0
2927;71565;20;88;47;3;44;.936;3814000;0
2927;152835;26;55;17;2;15;.882;3814000;0
2928;163195;0;0;0;0;0;.00nan;0;0
2928;18213;8;61;28;4;24;.857;3709000;0
2928;189644;8;0;0;0;0;.00nan;0;0
2928;186573;0;83;40;3;37;.925;3696000;0
2929;166646;16;0;0;0;0;.00nan;0;0
2929;167642;18;0;0;0;0;.00nan;0;0
2929;173727;18;84;41;3;38;.927;4200000;0
2929;50065;16;58;26;3;23;.885;4200000;0
2930;67;11;0;0;0;0;.00nan;0;0
2930;556;3;100;28;0;28;1.000;3600000;0
2930;179344;3;0;0;0;0;.00nan;0;0
2930;45323;11;89;50;3;47;.940;3600000;0
2931;166751;5;100;27;0;27;1.000;3600000;0
2931;2059;23;0;0;0;0;.00nan;0;0
2931;172398;5;0;0;0;0;.00nan;0;0
2931;78573;23;66;25;2;23;.920;3556000;0
2932;187537;19;89;42;3;39;.929;3570000;0
2932;172340;4182;0;0;0;0;.00nan;0;0
2932;163565;19;0;0;0;0;.00nan;0;0
2932;147945;4182;71;28;2;26;.929;3600000;0
2933;184229;35;0;0;0;0;.00nan;0;0
2933;170977;30;0;0;0;0;.00nan;0;0
2933;57338;35;58;32;4;28;.875;3548000;0
2933;86697;30;58;23;3;20;.870;3600000;0
2934;165582;24;0;0;0;0;.00nan;0;0
2934;175092;9;0;0;0;0;.00nan;0;0
2934;190106;9;52;35;5;30;.857;3615000;0
2934;85727;24;53;39;6;33;.846;3615000;0
2935;676;34;75;29;3;26;.897;4200000;0
2935;183844;29;0;0;0;0;.00nan;0;0
2935;37818;29;73;39;3;36;.923;4200000;0
2935;78806;34;0;0;0;0;.00nan;0;0
2936;166381;27;64;19;2;17;.895;3560000;0
2936;168712;14;72;22;1;21;.955;3600000;0
2936;175660;27;0;0;0;0;.00nan;0;0
2936;185034;14;0;0;0;0;.00nan;0;0
2937;77955;28;0;0;0;0;.00nan;0;0
2937;85437;28;65;38;3;35;.921;3600000;0
2937;85798;12;0;0;0;0;.00nan;0;0
2937;91178;12;65;17;1;16;.941;3600000;0
2938;184229;35;0;0;0;0;.00nan;0;0
2938;179950;4838;0;0;0;0;.00nan;0;0
2938;57338;35;99;32;1;31;.969;3600000;0
2938;143749;4838;79;28;2;26;.929;3579000;0
2939;3928;15;0;0;0;0;.00nan;0;0
2939;163195;0;79;33;2;31;.939;3588000;0
2939;186573;0;0;0;0;0;.00nan;0;0
2939;139409;15;100;29;0;29;1.000;3600000;0
2940;166591;20;56;30;4;26;.867;3587000;0
2940;187578;10;70;25;2;23;.920;3600000;0
2940;71565;20;0;0;0;0;.00nan;0;0
2940;90164;10;0;0;0;0;.00nan;0;0
2941;3284;21;69;16;1;15;.938;3600000;0
2941;143156;21;0;0;0;0;.00nan;0;0
2941;149452;31;49;29;4;25;.862;3600000;0
2941;152717;31;0;0;0;0;.00nan;0;0
2942;172340;4182;54;17;2;15;.882;3600000;0
2942;190465;33;70;37;3;34;.919;3553000;0
2942;197038;33;0;0;0;0;.00nan;0;0
2942;147945;4182;0;0;0;0;.00nan;0;0
2943;5923;17;0;0;0;0;.00nan;0;0
2943;178413;17;82;41;2;39;.951;3600000;0
2943;18213;8;42;25;4;21;.840;3516000;0
2943;189644;8;0;0;0;0;.00nan;0;0
2944;166751;5;39;39;7;32;.821;3600000;0
2944;172398;5;0;0;0;0;.00nan;0;0
2944;167642;18;0;0;0;0;.00nan;0;0
2944;173727;18;91;16;0;16;1.000;3600000;0
2945;67;11;0;0;0;0;.00nan;0;0
2945;166646;16;0;0;0;0;.00nan;0;0
2945;45323;11;100;38;0;38;1.000;3600000;0
2945;50065;16;74;24;1;23;.958;3597000;0
2946;556;3;87;17;0;17;1.000;3600000;0
2946;2059;23;34;17;4;13;.765;1721000;0
2946;179344;3;0;0;0;0;.00nan;0;0
2946;78573;23;16;19;6;13;.684;1879000;0
2947;3928;15;0;0;0;0;.00nan;0;0
2947;163423;26;0;0;0;0;.00nan;0;0
2947;139409;15;77;21;1;20;.952;3600000;0
2947;152835;26;70;37;3;34;.919;3522000;0
2948;166381;27;51;28;4;24;.857;3600000;0
2948;175660;27;0;0;0;0;.00nan;0;0
2948;184770;22;0;0;0;0;.00nan;0;0
2948;143473;22;70;20;1;19;.950;3600000;0
2949;183844;29;0;0;0;0;.00nan;0;0
2949;168712;14;18;33;7;26;.788;3600000;0
2949;185034;14;0;0;0;0;.00nan;0;0
2949;37818;29;68;22;2;20;.909;3600000;0
2950;5923;17;90;30;1;29;.967;3583000;0
2950;178413;17;0;0;0;0;.00nan;0;0
2950;174718;25;100;34;0;34;1.000;3600000;0
2950;148958;25;0;0;0;0;.00nan;0;0
2951;13337;32;74;50;4;46;.920;4200000;0
2951;20432;32;0;0;0;0;.00nan;0;0
2951;170977;30;0;0;0;0;.00nan;0;0
2951;86697;30;60;30;4;26;.867;4200000;0
2952;187537;19;21;22;6;16;.727;3087000;0
2952;163565;19;66;10;0;10;1.000;450000;0
2952;77955;28;78;41;4;37;.902;3600000;0
2952;85437;28;0;0;0;0;.00nan;0;0
2953;2059;23;0;0;0;0;.00nan;0;0
2953;190465;33;0;0;0;0;.00nan;0;0
2953;197038;33;58;32;3;29;.906;3600000;0
2953;78573;23;67;33;4;29;.879;3600000;0
2954;183844;29;96;42;2;40;.952;4200000;0
2954;184770;22;71;27;2;25;.926;4200000;0
2954;37818;29;0;0;0;0;.00nan;0;0
2954;143473;22;0;0;0;0;.00nan;0;0
2955;676;34;92;25;0;25;1.000;3600000;0
2955;3284;21;30;31;6;25;.806;2152000;0
2955;78806;34;0;0;0;0;.00nan;0;0
2955;143156;21;55;11;1;10;.909;1448000;0
2956;168712;14;0;0;0;0;.00nan;0;0
2956;175092;9;0;0;0;0;.00nan;0;0
2956;190106;9;99;40;1;39;.975;3600000;0
2956;185034;14;67;27;2;25;.926;3594000;0
2957;166591;20;0;0;0;0;.00nan;0;0
2957;163195;0;75;23;2;21;.913;3766000;0
2957;186573;0;0;0;0;0;.00nan;0;0
2957;71565;20;92;39;1;38;.974;3766000;0
2958;165582;24;0;0;0;0;.00nan;0;0
2958;85727;24;71;29;3;26;.897;3545000;0
2958;149452;31;76;29;2;27;.931;3600000;0
2958;152717;31;0;0;0;0;.00nan;0;0
2959;184229;35;74;23;1;22;.957;3600000;0
2959;57338;35;0;0;0;0;.00nan;0;0
2959;85798;12;62;30;3;27;.900;3107000;0
2959;91178;12;38;15;3;12;.800;493000;0
2960;187578;10;86;43;3;40;.930;3600000;0
2960;163423;26;46;37;6;31;.838;3600000;0
2960;90164;10;0;0;0;0;.00nan;0;0
2960;152835;26;0;0;0;0;.00nan;0;0
2961;18213;8;68;30;3;27;.900;3596000;0
2961;189644;8;0;0;0;0;.00nan;0;0
2961;174718;25;83;30;2;28;.933;3600000;0
2961;148958;25;0;0;0;0;.00nan;0;0
2962;13337;32;0;0;0;0;.00nan;0;0
2962;20432;32;58;39;4;35;.897;3552000;0
2962;77955;28;0;0;0;0;.00nan;0;0
2962;85437;28;73;31;3;28;.903;3600000;0
2963;166751;5;88;28;1;27;.964;3600000;0
2963;172340;4182;47;20;3;17;.850;3600000;0
2963;172398;5;0;0;0;0;.00nan;0;0
2963;147945;4182;0;0;0;0;.00nan;0;0
2964;556;3;75;31;2;29;.935;3600000;0
2964;167642;18;0;0;0;0;.00nan;0;0
2964;173727;18;69;31;3;28;.903;3566000;0
2964;179344;3;0;0;0;0;.00nan;0;0
2965;67;11;0;0;0;0;.00nan;0;0
2965;179950;4838;0;0;0;0;.00nan;0;0
2965;45323;11;94;35;1;34;.971;3600000;0
2965;143749;4838;57;24;3;21;.875;3516000;0
2966;166646;16;89;28;2;26;.929;3600000;0
2966;2059;23;69;39;4;35;.897;3547000;0
2966;50065;16;0;0;0;0;.00nan;0;0
2966;78573;23;0;0;0;0;.00nan;0;0
2967;187578;10;0;0;0;0;.00nan;0;0
2967;3928;15;0;0;0;0;.00nan;0;0
2967;90164;10;69;51;5;46;.902;3600000;0
2967;139409;15;92;16;0;16;1.000;3600000;0
2968;676;34;83;29;3;26;.897;3600000;0
2968;166381;27;0;0;0;0;.00nan;0;0
2968;175660;27;54;37;5;32;.865;3570000;0
2968;78806;34;0;0;0;0;.00nan;0;0
2969;170977;30;0;0;0;0;.00nan;0;0
2969;85798;12;0;0;0;0;.00nan;0;0
2969;86697;30;78;13;0;13;1.000;3600000;0
2969;91178;12;98;49;2;47;.959;3593000;0
2970;187537;19;97;30;1;29;.967;3600000;0
2970;5923;17;0;0;0;0;.00nan;0;0
2970;163565;19;0;0;0;0;.00nan;0;0
2970;178413;17;61;24;3;21;.875;3576000;0
2971;163195;0;71;27;2;25;.926;3600000;0
2971;166381;27;77;49;5;44;.898;3600000;0
2971;175660;27;0;0;0;0;.00nan;0;0
2971;186573;0;0;0;0;0;.00nan;0;0
2972;165582;24;95;34;1;33;.971;3600000;0
2972;190465;33;80;37;3;34;.919;3592000;0
2972;197038;33;0;0;0;0;.00nan;0;0
2972;85727;24;0;0;0;0;.00nan;0;0
2973;184229;35;0;0;0;0;.00nan;0;0
2973;175092;9;0;0;0;0;.00nan;0;0
2973;190106;9;85;38;3;35;.921;3530000;0
2973;57338;35;79;25;1;24;.960;3600000;0
2974;67;11;0;0;0;0;.00nan;0;0
2974;174718;25;52;16;2;14;.875;3600000;0
2974;45323;11;76;39;3;36;.923;3600000;0
2974;148958;25;0;0;0;0;.00nan;0;0
2975;556;3;61;49;6;43;.878;3600000;0
2975;172340;4182;0;0;0;0;.00nan;0;0
2975;179344;3;0;0;0;0;.00nan;0;0
2975;147945;4182;83;28;2;26;.929;3600000;0
2976;183844;29;0;0;0;0;.00nan;0;0
2976;190465;33;0;0;0;0;.00nan;0;0
2976;37818;29;100;49;2;47;.959;3600000;0
2976;197038;33;66;37;3;34;.919;3556000;0
2977;3284;21;52;38;6;32;.842;3629000;0
2977;77955;28;0;0;0;0;.00nan;0;0
2977;85437;28;50;33;5;28;.848;3629000;0
2977;143156;21;0;0;0;0;.00nan;0;0
2978;187537;19;56;31;4;27;.871;3600000;0
2978;3928;15;0;0;0;0;.00nan;0;0
2978;163565;19;0;0;0;0;.00nan;0;0
2978;139409;15;91;31;1;30;.968;3600000;0
2979;676;34;25;6;3;3;.500;291000;0
2979;166591;20;0;0;0;0;.00nan;0;0
2979;71565;20;83;49;3;46;.939;3600000;0
2979;78806;34;55;12;1;11;.917;3233000;0
2980;166751;5;70;35;3;32;.914;3600000;0
2980;172398;5;0;0;0;0;.00nan;0;0
2980;18213;8;47;24;4;20;.833;3561000;0
2980;189644;8;0;0;0;0;.00nan;0;0
2981;184770;22;0;0;0;0;.00nan;0;0
2981;143473;22;38;15;4;11;.733;3600000;0
2981;149452;31;75;53;7;46;.868;3600000;0
2981;152717;31;0;0;0;0;.00nan;0;0
2982;167642;18;0;0;0;0;.00nan;0;0
2982;168712;14;91;34;1;33;.971;3600000;0
2982;173727;18;54;16;2;14;.875;3547000;0
2982;185034;14;0;0;0;0;.00nan;0;0
2983;2059;23;0;0;0;0;.00nan;0;0
2983;163423;26;0;0;0;0;.00nan;0;0
2983;78573;23;60;30;3;27;.900;3600000;0
2983;152835;26;58;28;4;24;.857;3544000;0
2984;166646;16;0;0;0;0;.00nan;0;0
2984;50065;16;59;27;3;24;.889;3600000;0
2984;85798;12;0;0;0;0;.00nan;0;0
2984;91178;12;62;33;4;29;.879;3556000;0
2985;5923;17;0;0;0;0;.00nan;0;0
2985;13337;32;0;0;0;0;.00nan;0;0
2985;178413;17;69;35;4;31;.886;3570000;0
2985;20432;32;93;38;3;35;.921;3600000;0
2986;170977;30;69;29;3;26;.897;3544000;0
2986;179950;4838;0;0;0;0;.00nan;0;0
2986;86697;30;0;0;0;0;.00nan;0;0
2986;143749;4838;68;27;2;25;.926;3600000;0
2987;163195;0;64;31;3;28;.903;3748000;0
2987;184229;35;0;0;0;0;.00nan;0;0
2987;186573;0;0;0;0;0;.00nan;0;0
2987;57338;35;77;33;2;31;.939;3748000;0
2988;187578;10;61;38;4;34;.895;3600000;0
2988;168712;14;0;0;0;0;.00nan;0;0
2988;185034;14;60;41;5;36;.878;3558000;0
2988;90164;10;0;0;0;0;.00nan;0;0
2989;67;11;0;0;0;0;.00nan;0;0
2989;179950;4838;72;30;3;27;.900;3568000;0
2989;45323;11;72;28;2;26;.929;3600000;0
2989;143749;4838;0;0;0;0;.00nan;0;0
2990;77955;28;63;39;4;35;.897;3584000;0
2990;85437;28;0;0;0;0;.00nan;0;0
2990;149452;31;81;37;3;34;.919;3600000;0
2990;152717;31;0;0;0;0;.00nan;0;0
2991;187578;10;38;14;3;11;.786;553000;0
2991;3284;21;39;29;5;24;.828;3600000;0
2991;90164;10;56;44;6;38;.864;3047000;0
2991;143156;21;0;0;0;0;.00nan;0;0
2992;556;3;84;25;1;24;.960;3600000;0
2992;18213;8;81;38;3;35;.921;3516000;0
2992;189644;8;0;0;0;0;.00nan;0;0
2992;179344;3;0;0;0;0;.00nan;0;0
2993;676;34;75;41;4;37;.902;3600000;0
2993;167642;18;0;0;0;0;.00nan;0;0
2993;173727;18;75;17;1;16;.941;3600000;0
2993;78806;34;0;0;0;0;.00nan;0;0
2994;166591;20;0;0;0;0;.00nan;0;0
2994;163423;26;0;0;0;0;.00nan;0;0
2994;71565;20;82;29;2;27;.931;3600000;0
2994;152835;26;47;26;4;22;.846;3569000;0
2995;3928;15;0;0;0;0;.00nan;0;0
2995;165582;24;50;28;4;24;.857;3553000;0
2995;85727;24;0;0;0;0;.00nan;0;0
2995;139409;15;75;30;2;28;.933;3600000;0
2996;187537;19;61;27;3;24;.889;3600000;0
2996;166751;5;100;30;0;30;1.000;3600000;0
2996;172398;5;0;0;0;0;.00nan;0;0
2996;163565;19;0;0;0;0;.00nan;0;0
2997;2059;23;0;0;0;0;.00nan;0;0
2997;174718;25;56;17;2;15;.882;3600000;0
2997;78573;23;54;39;5;34;.872;3600000;0
2997;148958;25;0;0;0;0;.00nan;0;0
2998;175092;9;0;0;0;0;.00nan;0;0
2998;190106;9;100;45;2;43;.956;4200000;0
2998;190465;33;78;33;2;31;.939;4200000;0
2998;197038;33;0;0;0;0;.00nan;0;0
2999;5923;17;0;0;0;0;.00nan;0;0
2999;178413;17;80;21;1;20;.952;3600000;0
2999;85798;12;25;7;3;4;.571;548000;0
2999;91178;12;43;31;6;25;.806;3052000;0
3000;172340;4182;100;36;0;36;1.000;3600000;0
3000;166381;27;72;23;1;22;.957;3583000;0
3000;175660;27;0;0;0;0;.00nan;0;0
3000;147945;4182;0;0;0;0;.00nan;0;0
3001;13337;32;0;0;0;0;.00nan;0;0
3001;20432;32;72;43;5;38;.884;3600000;0
3001;170977;30;0;0;0;0;.00nan;0;0
3001;86697;30;94;22;0;22;1.000;3600000;0
3002;166591;20;97;43;0;43;1.000;4200000;0
3002;163195;0;87;19;0;19;1.000;4200000;0
3002;186573;0;0;0;0;0;.00nan;0;0
3002;71565;20;0;0;0;0;.00nan;0;0
3003;167642;18;0;0;0;0;.00nan;0;0
3003;173727;18;97;33;1;32;.970;3600000;0
3003;184770;22;0;0;0;0;.00nan;0;0
3003;143473;22;57;18;2;16;.889;3580000;0
3004;183844;29;0;0;0;0;.00nan;0;0
3004;184229;35;0;0;0;0;.00nan;0;0
3004;37818;29;78;26;1;25;.962;3600000;0
3004;57338;35;100;36;0;36;1.000;3600000;0
3005;166646;16;0;0;0;0;.00nan;0;0
3005;175092;9;33;33;6;27;.818;3600000;0
3005;190106;9;0;0;0;0;.00nan;0;0
3005;50065;16;77;21;1;20;.952;3600000;0
3006;556;3;96;34;2;32;.941;4200000;0
3006;187537;19;63;30;2;28;.933;4200000;0
3006;163565;19;0;0;0;0;.00nan;0;0
3006;179344;3;0;0;0;0;.00nan;0;0
3007;163423;26;0;0;0;0;.00nan;0;0
3007;174718;25;84;24;1;23;.958;3600000;0
3007;148958;25;0;0;0;0;.00nan;0;0
3007;152835;26;61;33;4;29;.879;3600000;0
3008;3928;15;0;0;0;0;.00nan;0;0
3008;168712;14;84;49;4;45;.918;3549000;0
3008;185034;14;0;0;0;0;.00nan;0;0
3008;139409;15;94;37;2;35;.946;3600000;0
3009;3284;21;63;19;1;18;.947;3600000;0
3009;143156;21;0;0;0;0;.00nan;0;0
3009;149452;31;91;38;2;36;.947;3558000;0
3009;152717;31;0;0;0;0;.00nan;0;0
3010;183844;29;65;40;5;35;.875;3600000;0
3010;190465;33;20;24;6;18;.750;2615000;0
3010;37818;29;0;0;0;0;.00nan;0;0
3010;197038;33;63;10;0;10;1.000;932000;0
3011;676;34;65;19;2;17;.895;3600000;0
3011;163195;0;82;50;3;47;.940;3584000;0
3011;186573;0;0;0;0;0;.00nan;0;0
3011;78806;34;0;0;0;0;.00nan;0;0
3012;5923;17;0;0;0;0;.00nan;0;0
3012;165582;24;0;0;0;0;.00nan;0;0
3012;178413;17;61;32;4;28;.875;3555000;0
3012;85727;24;88;38;2;36;.947;3600000;0
3013;187578;10;100;35;0;35;1.000;3600000;0
3013;166751;5;20;9;4;5;.556;602000;0
3013;172398;5;51;16;2;14;.875;2998000;0
3013;90164;10;0;0;0;0;.00nan;0;0
3014;184770;22;71;22;1;21;.955;3600000;0
3014;77955;28;0;0;0;0;.00nan;0;0
3014;85437;28;98;56;2;54;.964;3600000;0
3014;143473;22;0;0;0;0;.00nan;0;0
3015;67;11;0;0;0;0;.00nan;0;0
3015;166381;27;23;22;6;16;.727;2209000;0
3015;175660;27;46;6;1;5;.833;1391000;0
3015;45323;11;28;26;5;21;.808;3600000;0
3016;166646;16;66;29;3;26;.897;3563000;0
3016;18213;8;64;20;2;18;.900;3600000;0
3016;189644;8;0;0;0;0;.00nan;0;0
3016;50065;16;0;0;0;0;.00nan;0;0
3017;13337;32;0;0;0;0;.00nan;0;0
3017;20432;32;71;33;3;30;.909;3650000;0
3017;85798;12;0;0;0;0;.00nan;0;0
3017;91178;12;69;34;4;30;.882;3650000;0
3018;172340;4182;71;23;2;21;.913;3600000;0
3018;179950;4838;0;0;0;0;.00nan;0;0
3018;143749;4838;51;34;5;29;.853;3600000;0
3018;147945;4182;0;0;0;0;.00nan;0;0
3019;2059;23;0;0;0;0;.00nan;0;0
3019;170977;30;0;0;0;0;.00nan;0;0
3019;78573;23;90;42;3;39;.929;3600000;0
3019;86697;30;100;23;0;23;1.000;3600000;0
3020;676;34;57;30;4;26;.867;2276000;0
3020;3284;21;66;22;1;21;.955;3600000;0
3020;78806;34;72;16;0;16;1.000;1324000;0
3020;143156;21;0;0;0;0;.00nan;0;0
3021;187578;10;79;59;6;53;.898;3600000;0
3021;184770;22;0;0;0;0;.00nan;0;0
3021;90164;10;0;0;0;0;.00nan;0;0
3021;143473;22;43;16;3;13;.813;3600000;0
3022;556;3;63;20;2;18;.900;3600000;0
3022;166751;5;66;35;4;31;.886;3513000;0
3022;172398;5;0;0;0;0;.00nan;0;0
3022;179344;3;0;0;0;0;.00nan;0;0
3023;5923;17;0;0;0;0;.00nan;0;0
3023;178413;17;68;24;2;22;.917;3600000;0
3023;149452;31;100;41;1;40;.976;3600000;0
3023;152717;31;0;0;0;0;.00nan;0;0
3024;183844;29;78;28;2;26;.929;3600000;0
3024;37818;29;0;0;0;0;.00nan;0;0
3024;77955;28;30;33;6;27;.818;2566000;0
3024;85437;28;71;15;0;15;1.000;1034000;0
3025;165582;24;0;0;0;0;.00nan;0;0
3025;168712;14;89;28;1;27;.964;3600000;0
3025;185034;14;0;0;0;0;.00nan;0;0
3025;85727;24;50;18;3;15;.833;3576000;0
3026;163195;0;98;38;1;37;.974;3947000;0
3026;190465;33;0;0;0;0;.00nan;0;0
3026;186573;0;0;0;0;0;.00nan;0;0
3026;197038;33;84;30;2;28;.933;3947000;0
3027;3928;15;0;0;0;0;.00nan;0;0
3027;163423;26;0;0;0;0;.00nan;0;0
3027;139409;15;58;26;3;23;.885;3547000;0
3027;152835;26;89;36;2;34;.944;3600000;0
3028;18213;8;72;28;2;26;.929;3600000;0
3028;189644;8;0;0;0;0;.00nan;0;0
3028;174718;25;70;18;1;17;.944;3600000;0
3028;148958;25;0;0;0;0;.00nan;0;0
3029;13337;32;0;0;0;0;.00nan;0;0
3029;20432;32;70;35;4;31;.886;3560000;0
3029;85798;12;0;0;0;0;.00nan;0;0
3029;91178;12;94;41;3;38;.927;3600000;0
3030;166646;16;0;0;0;0;.00nan;0;0
3030;184229;35;0;0;0;0;.00nan;0;0
3030;50065;16;63;23;3;20;.870;3579000;0
3030;57338;35;92;41;2;39;.951;3600000;0
3031;67;11;0;0;0;0;.00nan;0;0
3031;172340;4182;56;26;3;23;.885;3600000;0
3031;45323;11;65;43;4;39;.907;3600000;0
3031;147945;4182;0;0;0;0;.00nan;0;0
3032;187537;19;36;27;6;21;.778;1822000;0
3032;163565;19;63;28;3;25;.893;1778000;0
3032;166381;27;52;8;1;7;.875;3600000;0
3032;175660;27;0;0;0;0;.00nan;0;0
3033;170977;30;0;0;0;0;.00nan;0;0
3033;179950;4838;0;0;0;0;.00nan;0;0
3033;86697;30;75;23;1;22;.957;3600000;0
3033;143749;4838;98;52;3;49;.942;3566000;0
3034;3928;15;0;0;0;0;.00nan;0;0
3034;175092;9;0;0;0;0;.00nan;0;0
3034;190106;9;54;26;4;22;.846;3600000;0
3034;139409;15;93;30;1;29;.967;3600000;0
3035;166591;20;68;32;3;29;.906;3543000;0
3035;2059;23;0;0;0;0;.00nan;0;0
3035;71565;20;0;0;0;0;.00nan;0;0
3035;78573;23;83;24;1;23;.958;3600000;0
3036;187537;19;0;0;0;0;.00nan;0;0
3036;163565;19;55;27;3;24;.889;3573000;0
3036;179950;4838;88;29;1;28;.966;3600000;0
3036;143749;4838;0;0;0;0;.00nan;0;0
3037;167642;18;0;0;0;0;.00nan;0;0
3037;173727;18;71;26;2;24;.923;3600000;0
3037;170977;30;0;0;0;0;.00nan;0;0
3037;86697;30;21;20;5;15;.750;3600000;0
3038;3284;21;0;0;0;0;.00nan;0;0
3038;143156;21;48;22;3;19;.864;3600000;0
3038;149452;31;32;24;5;19;.792;3600000;0
3038;152717;31;0;0;0;0;.00nan;0;0
3039;163195;0;94;39;2;37;.949;4200000;0
3039;163423;26;0;0;0;0;.00nan;0;0
3039;186573;0;0;0;0;0;.00nan;0;0
3039;152835;26;73;27;2;25;.926;4200000;0
3040;556;3;61;29;3;26;.897;3544000;0
3040;179344;3;0;0;0;0;.00nan;0;0
3040;184770;22;0;0;0;0;.00nan;0;0
3040;143473;22;65;23;2;21;.913;3600000;0
3041;676;34;80;31;2;29;.935;3600000;0
3041;5923;17;0;0;0;0;.00nan;0;0
3041;178413;17;58;21;3;18;.857;3600000;0
3041;78806;34;0;0;0;0;.00nan;0;0
3042;187578;10;79;46;5;41;.891;3600000;0
3042;168712;14;64;25;2;23;.920;3600000;0
3042;185034;14;0;0;0;0;.00nan;0;0
3042;90164;10;0;0;0;0;.00nan;0;0
3043;166646;16;0;0;0;0;.00nan;0;0
3043;174718;25;84;24;1;23;.958;3600000;0
3043;50065;16;74;29;2;27;.931;3575000;0
3043;148958;25;0;0;0;0;.00nan;0;0
3044;18213;8;0;0;0;0;.00nan;0;0
3044;189644;8;87;31;1;30;.968;3600000;0
3044;85798;12;0;0;0;0;.00nan;0;0
3044;91178;12;57;27;4;23;.852;3600000;0
3045;13337;32;0;0;0;0;.00nan;0;0
3045;166381;27;0;0;0;0;.00nan;0;0
3045;20432;32;86;49;4;45;.918;3600000;0
3045;175660;27;80;21;1;20;.952;3600000;0
3046;67;11;0;0;0;0;.00nan;0;0
3046;166591;20;0;0;0;0;.00nan;0;0
3046;45323;11;77;40;3;37;.925;3546000;0
3046;71565;20;92;31;1;30;.968;3600000;0
3047;184229;35;0;0;0;0;.00nan;0;0
3047;190465;33;73;44;4;40;.909;3518000;0
3047;197038;33;0;0;0;0;.00nan;0;0
3047;57338;35;87;34;2;32;.941;3600000;0
3048;3284;21;60;33;4;29;.879;3600000;0
3048;77955;28;0;0;0;0;.00nan;0;0
3048;85437;28;100;38;1;37;.974;3600000;0
3048;143156;21;0;0;0;0;.00nan;0;0
3049;676;34;0;0;0;0;.00nan;0;0
3049;183844;29;0;0;0;0;.00nan;0;0
3049;37818;29;57;28;3;25;.893;3585000;0
3049;78806;34;70;21;1;20;.952;3600000;0
3050;556;3;0;0;0;0;.00nan;0;0
3050;179344;3;75;38;4;34;.895;3642000;0
3050;175092;9;72;54;5;49;.907;3642000;0
3050;190106;9;0;0;0;0;.00nan;0;0
3051;165582;24;98;55;4;51;.927;3600000;0
3051;18213;8;75;20;1;19;.950;3600000;0
3051;189644;8;0;0;0;0;.00nan;0;0
3051;85727;24;0;0;0;0;.00nan;0;0
3052;166751;5;0;0;0;0;.00nan;0;0
3052;172398;5;73;40;4;36;.900;3546000;0
3052;184770;22;65;30;3;27;.900;3600000;0
3052;143473;22;0;0;0;0;.00nan;0;0
3053;3928;15;0;0;0;0;.00nan;0;0
3053;139409;15;88;14;0;14;1.000;3600000;0
3053;149452;31;0;0;0;0;.00nan;0;0
3053;152717;31;97;41;2;39;.951;3584000;0
3054;187578;10;0;0;0;0;.00nan;0;0
3054;163423;26;0;0;0;0;.00nan;0;0
3054;90164;10;57;26;3;23;.885;3600000;0
3054;152835;26;48;26;4;22;.846;3576000;0
3055;167642;18;0;0;0;0;.00nan;0;0
3055;173727;18;64;35;4;31;.886;3600000;0
3055;179950;4838;0;0;0;0;.00nan;0;0
3055;143749;4838;45;33;5;28;.848;3600000;0
3056;184229;35;0;0;0;0;.00nan;0;0
3056;190465;33;0;0;0;0;.00nan;0;0
3056;197038;33;52;35;4;31;.886;3600000;0
3056;57338;35;100;25;0;25;1.000;3600000;0
3057;163195;0;82;36;4;32;.889;3600000;0
3057;183844;29;73;22;1;21;.955;3600000;0
3057;37818;29;0;0;0;0;.00nan;0;0
3057;186573;0;0;0;0;0;.00nan;0;0
3058;5923;17;0;0;0;0;.00nan;0;0
3058;178413;17;56;25;3;22;.880;3600000;0
3058;77955;28;11;28;8;20;.714;3120000;0
3058;85437;28;56;5;0;5;1.000;480000;0
3059;165582;24;0;0;0;0;.00nan;0;0
3059;168712;14;65;30;3;27;.900;3644000;0
3059;185034;14;0;0;0;0;.00nan;0;0
3059;85727;24;63;31;4;27;.871;3644000;0
3060;166751;5;53;30;3;27;.900;3545000;0
3060;172398;5;0;0;0;0;.00nan;0;0
3060;175092;9;0;0;0;0;.00nan;0;0
3060;190106;9;96;32;2;30;.938;3600000;0
3061;167642;18;0;0;0;0;.00nan;0;0
3061;166381;27;81;38;2;36;.947;4200000;0
3061;173727;18;64;24;2;22;.917;4200000;0
3061;175660;27;0;0;0;0;.00nan;0;0
3062;166591;20;0;0;0;0;.00nan;0;0
3062;172340;4182;100;23;0;23;1.000;3600000;0
3062;71565;20;97;45;2;43;.956;3600000;0
3062;147945;4182;0;0;0;0;.00nan;0;0
3063;170977;30;0;0;0;0;.00nan;0;0
3063;85798;12;0;0;0;0;.00nan;0;0
3063;86697;30;77;16;1;15;.938;3600000;0
3063;91178;12;58;35;5;30;.857;3600000;0
3064;166646;16;0;0;0;0;.00nan;0;0
3064;174718;25;75;31;2;29;.935;3600000;0
3064;50065;16;49;31;4;27;.871;3599000;0
3064;148958;25;0;0;0;0;.00nan;0;0
3065;67;11;90;46;2;44;.957;3545000;0
3065;187537;19;93;32;1;31;.969;3600000;0
3065;163565;19;0;0;0;0;.00nan;0;0
3065;45323;11;0;0;0;0;.00nan;0;0
3066;3284;21;91;21;0;21;1.000;3600000;0
3066;183844;29;75;34;3;31;.912;3600000;0
3066;37818;29;0;0;0;0;.00nan;0;0
3066;143156;21;0;0;0;0;.00nan;0;0
3067;3928;15;0;0;0;0;.00nan;0;0
3067;184770;22;0;0;0;0;.00nan;0;0
3067;139409;15;55;31;4;27;.871;3549000;0
3067;143473;22;80;28;2;26;.929;3600000;0
3068;187578;10;0;0;0;0;.00nan;0;0
3068;165582;24;69;38;4;34;.895;3600000;0
3068;85727;24;0;0;0;0;.00nan;0;0
3068;90164;10;100;38;2;36;.947;3600000;0
3069;174718;25;0;0;0;0;.00nan;0;0
3069;175092;9;0;0;0;0;.00nan;0;0
3069;190106;9;78;48;4;44;.917;3590000;0
3069;148958;25;64;19;2;17;.895;3600000;0
3070;172340;4182;92;24;1;23;.958;3600000;0
3070;190465;33;56;42;5;37;.881;3600000;0
3070;197038;33;0;0;0;0;.00nan;0;0
3070;147945;4182;0;0;0;0;.00nan;0;0
3071;166646;16;59;21;2;19;.905;3600000;0
3071;163423;26;77;49;5;44;.898;3301000;0
3071;50065;16;0;0;0;0;.00nan;0;0
3071;152835;26;24;5;3;2;.400;299000;0
3072;166751;5;67;23;2;21;.913;3600000;0
3072;172398;5;0;0;0;0;.00nan;0;0
3072;184229;35;0;0;0;0;.00nan;0;0
3072;57338;35;76;36;3;33;.917;3584000;0
3073;556;3;59;24;3;21;.875;3600000;0
3073;13337;32;55;36;5;31;.861;3577000;0
3073;20432;32;0;0;0;0;.00nan;0;0
3073;179344;3;0;0;0;0;.00nan;0;0
3074;168712;14;61;36;4;32;.889;3600000;0
3074;185034;14;0;0;0;0;.00nan;0;0
3074;85798;12;55;3;0;3;1.000;291000;0
3074;91178;12;46;34;6;28;.824;3303000;0
3075;166591;20;0;0;0;0;.00nan;0;0
3075;167642;18;97;25;0;25;1.000;3600000;0
3075;173727;18;0;0;0;0;.00nan;0;0
3075;71565;20;88;30;1;29;.967;3563000;0
3076;2059;23;0;0;0;0;.00nan;0;0
3076;5923;17;0;0;0;0;.00nan;0;0
3076;178413;17;62;25;3;22;.880;3600000;0
3076;78573;23;48;26;4;22;.846;3600000;0
3077;179950;4838;0;0;0;0;.00nan;0;0
3077;143749;4838;70;32;3;29;.906;3600000;0
3077;149452;31;0;0;0;0;.00nan;0;0
3077;152717;31;56;35;5;30;.857;3556000;0
3078;163195;0;66;49;5;44;.898;3600000;0
3078;170977;30;0;0;0;0;.00nan;0;0
3078;186573;0;0;0;0;0;.00nan;0;0
3078;86697;30;49;7;1;6;.857;3600000;0
3079;676;34;44;18;3;15;.833;3600000;0
3079;187578;10;53;26;4;22;.846;3578000;0
3079;78806;34;0;0;0;0;.00nan;0;0
3079;90164;10;0;0;0;0;.00nan;0;0
3080;166381;27;51;2;0;2;1.000;364000;0
3080;175660;27;30;28;6;22;.786;3212000;0
3080;149452;31;84;40;4;36;.900;3600000;0
3080;152717;31;0;0;0;0;.00nan;0;0
3081;165582;24;87;32;1;31;.969;3600000;0
3081;183844;29;0;0;0;0;.00nan;0;0
3081;37818;29;69;37;4;33;.892;3600000;0
3081;85727;24;0;0;0;0;.00nan;0;0
3082;175092;9;66;36;5;31;.861;3600000;0
3082;190106;9;0;0;0;0;.00nan;0;0
3082;77955;28;0;0;0;0;.00nan;0;0
3082;85437;28;78;36;3;33;.917;3600000;0
3083;166646;16;76;26;2;24;.923;3600000;0
3083;184770;22;0;0;0;0;.00nan;0;0
3083;50065;16;0;0;0;0;.00nan;0;0
3083;143473;22;68;33;3;30;.909;3553000;0
3084;166591;20;0;0;0;0;.00nan;0;0
3084;3284;21;72;19;1;18;.947;3600000;0
3084;71565;20;70;39;4;35;.897;3600000;0
3084;143156;21;0;0;0;0;.00nan;0;0
3085;174718;25;75;22;1;21;.955;3967000;0
3085;85798;12;0;0;0;0;.00nan;0;0
3085;91178;12;88;36;2;34;.944;3967000;0
3085;148958;25;0;0;0;0;.00nan;0;0
3086;166751;5;52;31;4;27;.871;3568000;0
3086;172398;5;0;0;0;0;.00nan;0;0
3086;190465;33;72;33;3;30;.909;3600000;0
3086;197038;33;0;0;0;0;.00nan;0;0
3087;172340;4182;57;17;2;15;.882;3600000;0
3087;163423;26;0;0;0;0;.00nan;0;0
3087;147945;4182;0;0;0;0;.00nan;0;0
3087;152835;26;65;41;4;37;.902;3577000;0
3088;2059;23;0;0;0;0;.00nan;0;0
3088;18213;8;13;20;7;13;.650;3967000;0
3088;189644;8;0;0;0;0;.00nan;0;0
3088;78573;23;61;44;6;38;.864;3950000;0
3089;13337;32;0;0;0;0;.00nan;0;0
3089;168712;14;54;30;5;25;.833;3620000;0
3089;20432;32;78;41;4;37;.902;3620000;0
3089;185034;14;0;0;0;0;.00nan;0;0
3090;67;11;0;0;0;0;.00nan;0;0
3090;5923;17;0;0;0;0;.00nan;0;0
3090;178413;17;98;33;2;31;.939;3797000;0
3090;45323;11;94;41;3;38;.927;3797000;0
3091;556;3;54;22;4;18;.818;3565000;0
3091;187537;19;90;38;2;36;.947;3600000;0
3091;163565;19;0;0;0;0;.00nan;0;0
3091;179344;3;0;0;0;0;.00nan;0;0
3092;163195;0;55;30;4;26;.867;3550000;0
3092;179950;4838;0;0;0;0;.00nan;0;0
3092;186573;0;0;0;0;0;.00nan;0;0
3092;143749;4838;60;27;3;24;.889;3600000;0
3093;184229;35;0;0;0;0;.00nan;0;0
3093;170977;30;0;0;0;0;.00nan;0;0
3093;57338;35;61;40;5;35;.875;3600000;0
3093;86697;30;89;16;0;16;1.000;3600000;0
3094;676;34;62;38;5;33;.868;3600000;0
3094;166646;16;0;0;0;0;.00nan;0;0
3094;50065;16;48;18;3;15;.833;3600000;0
3094;78806;34;0;0;0;0;.00nan;0;0
3095;187578;10;43;40;6;34;.850;3600000;0
3095;3928;15;0;0;0;0;.00nan;0;0
3095;90164;10;0;0;0;0;.00nan;0;0
3095;139409;15;77;22;1;21;.955;3600000;0
3096;166381;27;0;0;0;0;.00nan;0;0
3096;184229;35;0;0;0;0;.00nan;0;0
3096;175660;27;70;24;2;22;.917;3600000;0
3096;57338;35;49;37;6;31;.838;3600000;0
3097;166591;20;0;0;0;0;.00nan;0;0
3097;172340;4182;0;0;0;0;.00nan;0;0
3097;71565;20;64;30;3;27;.900;3580000;0
3097;147945;4182;73;25;1;24;.960;3600000;0
3098;556;3;81;16;0;16;1.000;3600000;0
3098;179344;3;0;0;0;0;.00nan;0;0
3098;85798;12;63;40;6;34;.850;2985000;0
3098;91178;12;65;12;0;12;1.000;615000;0
3099;166751;5;97;46;2;44;.957;3565000;0
3099;172398;5;0;0;0;0;.00nan;0;0
3099;183844;29;62;15;1;14;.933;3600000;0
3099;37818;29;0;0;0;0;.00nan;0;0
3100;3928;15;0;0;0;0;.00nan;0;0
3100;18213;8;82;33;2;31;.939;3559000;0
3100;189644;8;0;0;0;0;.00nan;0;0
3100;139409;15;90;17;0;17;1.000;3600000;0
3101;3284;21;42;27;5;22;.815;3522000;0
3101;190465;33;65;31;4;27;.871;3600000;0
3101;197038;33;0;0;0;0;.00nan;0;0
3101;143156;21;0;0;0;0;.00nan;0;0
3102;175092;9;0;0;0;0;.00nan;0;0
3102;184770;22;0;0;0;0;.00nan;0;0
3102;190106;9;55;34;4;30;.882;3562000;0
3102;143473;22;61;21;2;19;.905;3600000;0
3103;676;34;0;0;0;0;.00nan;0;0
3103;2059;23;0;0;0;0;.00nan;0;0
3103;78573;23;49;33;5;28;.848;3583000;0
3103;78806;34;61;29;3;26;.897;3600000;0
3104;165582;24;0;0;0;0;.00nan;0;0
3104;77955;28;0;0;0;0;.00nan;0;0
3104;85437;28;47;32;5;27;.844;3557000;0
3104;85727;24;73;31;3;28;.903;3600000;0
3105;170977;30;0;0;0;0;.00nan;0;0
3105;86697;30;55;18;2;16;.889;3538000;0
3105;149452;31;100;33;0;33;1.000;3600000;0
3105;152717;31;0;0;0;0;.00nan;0;0
3106;163423;26;0;0;0;0;.00nan;0;0
3106;174718;25;56;25;3;22;.880;4200000;0
3106;148958;25;0;0;0;0;.00nan;0;0
3106;152835;26;91;47;3;44;.936;4200000;0
3107;5923;17;0;0;0;0;.00nan;0;0
3107;167642;18;0;0;0;0;.00nan;0;0
3107;178413;17;74;54;6;48;.889;3945000;0
3107;173727;18;34;25;5;20;.800;3945000;0
3108;187537;19;100;44;1;43;.977;3600000;0
3108;163565;19;0;0;0;0;.00nan;0;0
3108;168712;14;78;38;3;35;.921;3568000;0
3108;185034;14;0;0;0;0;.00nan;0;0
3109;166646;16;41;24;4;20;.833;3600000;0
3109;172340;4182;67;25;3;22;.880;3600000;0
3109;50065;16;0;0;0;0;.00nan;0;0
3109;147945;4182;0;0;0;0;.00nan;0;0
3110;187578;10;92;56;3;53;.946;4200000;0
3110;179950;4838;0;0;0;0;.00nan;0;0
3110;90164;10;0;0;0;0;.00nan;0;0
3110;143749;4838;64;23;3;20;.870;4200000;0
3111;13337;32;0;0;0;0;.00nan;0;0
3111;20432;32;92;28;1;27;.964;3600000;0
3111;184229;35;0;0;0;0;.00nan;0;0
3111;57338;35;67;24;2;22;.917;3546000;0
3112;163195;0;85;45;2;43;.956;4200000;0
3112;166381;27;0;0;0;0;.00nan;0;0
3112;175660;27;80;31;2;29;.935;4200000;0
3112;186573;0;0;0;0;0;.00nan;0;0
3113;2059;23;0;0;0;0;.00nan;0;0
3113;184770;22;0;0;0;0;.00nan;0;0
3113;78573;23;79;53;4;49;.925;3600000;0
3113;143473;22;56;9;1;8;.889;3600000;0
3114;166591;20;97;49;3;46;.939;4196000;0
3114;165582;24;0;0;0;0;.00nan;0;0
3114;71565;20;0;0;0;0;.00nan;0;0
3114;85727;24;63;37;3;34;.919;4200000;0
3115;174718;25;58;20;2;18;.900;4200000;0
3115;190465;33;0;0;0;0;.00nan;0;0
3115;197038;33;100;43;2;41;.953;4200000;0
3115;148958;25;0;0;0;0;.00nan;0;0
3116;183844;29;51;2;0;2;1.000;887000;0
3116;37818;29;23;28;6;22;.786;2713000;0
3116;85798;12;0;0;0;0;.00nan;0;0
3116;91178;12;63;33;4;29;.879;3600000;0
3117;67;11;0;0;0;0;.00nan;0;0
3117;45323;11;49;32;5;27;.844;3600000;0
3117;77955;28;0;0;0;0;.00nan;0;0
3117;85437;28;100;23;0;23;1.000;3600000;0
3118;166751;5;73;45;4;41;.911;3563000;0
3118;172398;5;0;0;0;0;.00nan;0;0
3118;179950;4838;0;0;0;0;.00nan;0;0
3118;143749;4838;74;23;2;21;.913;3600000;0
3119;170977;30;0;0;0;0;.00nan;0;0
3119;86697;30;77;28;2;26;.929;3600000;0
3119;149452;31;62;29;4;25;.862;3600000;0
3119;152717;31;0;0;0;0;.00nan;0;0
3120;2059;23;84;33;2;31;.939;3600000;0
3120;168712;14;0;0;0;0;.00nan;0;0
3120;185034;14;53;24;4;20;.833;3557000;0
3120;78573;23;0;0;0;0;.00nan;0;0
3121;163423;26;55;4;0;4;1.000;478000;0
3121;166381;27;60;20;2;18;.900;3600000;0
3121;175660;27;0;0;0;0;.00nan;0;0
3121;152835;26;52;36;5;31;.861;3122000;0
3122;556;3;91;35;2;33;.943;3600000;0
3122;18213;8;0;0;0;0;.00nan;0;0
3122;189644;8;60;27;3;24;.889;3546000;0
3122;179344;3;0;0;0;0;.00nan;0;0
3123;3284;21;81;30;2;28;.933;3584000;0
3123;184229;35;0;0;0;0;.00nan;0;0
3123;57338;35;100;36;0;36;1.000;3600000;0
3123;143156;21;0;0;0;0;.00nan;0;0
3124;166646;16;0;0;0;0;.00nan;0;0
3124;167642;18;55;19;2;17;.895;1297000;0
3124;173727;18;43;28;5;23;.821;2303000;0
3124;50065;16;70;28;3;25;.893;3600000;0
3125;13337;32;0;0;0;0;.00nan;0;0
3125;183844;29;46;32;5;27;.844;3031000;0
3125;20432;32;72;16;1;15;.938;3600000;0
3125;37818;29;53;7;1;6;.857;569000;0
3126;5923;17;0;0;0;0;.00nan;0;0
3126;172340;4182;72;37;4;33;.892;3666000;0
3126;178413;17;77;34;3;31;.912;3666000;0
3126;147945;4182;0;0;0;0;.00nan;0;0
3127;166591;20;0;0;0;0;.00nan;0;0
3127;175092;9;0;0;0;0;.00nan;0;0
3127;190106;9;94;25;0;25;1.000;3600000;0
3127;71565;20;75;22;1;21;.955;3559000;0
3128;174718;25;53;20;3;17;.850;3600000;0
3128;190465;33;76;40;4;36;.900;3537000;0
3128;197038;33;0;0;0;0;.00nan;0;0
3128;148958;25;0;0;0;0;.00nan;0;0
3129;187537;19;56;27;4;23;.852;3600000;0
3129;163565;19;0;0;0;0;.00nan;0;0
3129;85798;12;40;45;7;38;.844;2883000;0
3129;91178;12;54;6;0;6;1.000;717000;0
3130;5923;17;54;5;0;5;1.000;1148000;0
3130;178413;17;8;17;6;11;.647;2449000;0
3130;77955;28;0;0;0;0;.00nan;0;0
3130;85437;28;66;42;5;37;.881;3600000;0
3131;163195;15;0;0;0;0;.00nan;0;0
3131;166381;27;90;43;3;40;.930;3567000;0
3131;175660;27;0;0;0;0;.00nan;0;0
3131;139409;15;74;21;1;20;.952;3600000;0
3132;167642;18;0;0;0;0;.00nan;0;0
3132;173727;18;53;25;3;22;.880;3600000;0
3132;186573;0;39;1;1;0;.000;283000;0
3132;59540;0;78;52;6;46;.885;3317000;0
3133;556;3;85;28;1;27;.964;3600000;0
3133;179344;3;0;0;0;0;.00nan;0;0
3133;179950;4838;0;0;0;0;.00nan;0;0
3133;143749;4838;73;23;2;21;.913;3552000;0
3134;170977;30;0;0;0;0;.00nan;0;0
3134;175092;9;76;51;5;46;.902;3600000;0
3134;190106;9;0;0;0;0;.00nan;0;0
3134;86697;30;100;34;0;34;1.000;3600000;0
3135;2059;23;0;0;0;0;.00nan;0;0
3135;165582;24;34;22;4;18;.818;3545000;0
3135;78573;23;68;30;3;27;.900;3600000;0
3135;85727;24;0;0;0;0;.00nan;0;0
3136;676;34;87;32;1;31;.969;3538000;0
3136;166751;5;100;26;0;26;1.000;3600000;0
3136;172398;5;0;0;0;0;.00nan;0;0
3136;78806;34;0;0;0;0;.00nan;0;0
3137;67;11;0;0;0;0;.00nan;0;0
3137;187578;10;0;0;0;0;.00nan;0;0
3137;45323;11;58;32;3;29;.906;3521000;0
3137;90164;10;81;29;1;28;.966;3600000;0
3138;168712;14;74;27;2;25;.926;3600000;0
3138;185034;14;0;0;0;0;.00nan;0;0
3138;149452;31;51;35;5;30;.857;3600000;0
3138;152717;31;0;0;0;0;.00nan;0;0
3139;18213;8;50;37;5;32;.865;3600000;0
3139;189644;8;0;0;0;0;.00nan;0;0
3139;184770;22;0;0;0;0;.00nan;0;0
3139;143473;22;100;25;0;25;1.000;3600000;0
3140;166646;16;0;0;0;0;.00nan;0;0
3140;184229;35;55;6;0;6;1.000;562000;0
3140;50065;16;43;17;3;14;.824;3600000;0
3140;57338;35;19;39;9;30;.769;3038000;0
3141;172340;4182;91;18;0;18;1.000;3600000;0
3141;13337;32;0;0;0;0;.00nan;0;0
3141;20432;32;65;39;5;34;.872;3600000;0
3141;147945;4182;0;0;0;0;.00nan;0;0
3142;187537;19;0;0;0;0;.00nan;0;0
3142;163565;19;52;33;4;29;.879;3566000;0
3142;183844;29;61;24;3;21;.875;3600000;0
3142;37818;29;0;0;0;0;.00nan;0;0
3143;163423;26;0;0;0;0;.00nan;0;0
3143;174718;25;0;0;0;0;.00nan;0;0
3143;148958;25;47;15;2;13;.867;3600000;0
3143;152835;26;98;52;3;49;.942;3586000;0
3144;166591;20;0;0;0;0;.00nan;0;0
3144;190465;33;98;33;1;32;.970;3600000;0
3144;197038;33;0;0;0;0;.00nan;0;0
3144;71565;20;75;30;2;28;.933;3565000;0
3145;187578;10;86;60;4;56;.933;3600000;0
3145;184770;22;0;0;0;0;.00nan;0;0
3145;90164;10;0;0;0;0;.00nan;0;0
3145;143473;22;67;18;1;17;.944;3600000;0
3146;2059;23;0;0;0;0;.00nan;0;0
3146;77955;28;0;0;0;0;.00nan;0;0
3146;78573;23;68;26;3;23;.885;3574000;0
3146;85437;28;57;16;2;14;.875;3600000;0
3147;5923;17;50;27;3;24;.889;3547000;0
3147;178413;17;0;0;0;0;.00nan;0;0
3147;170977;30;0;0;0;0;.00nan;0;0
3147;86697;30;91;35;2;33;.943;3600000;0
3148;556;3;73;39;3;36;.923;3600000;0
3148;676;34;100;33;0;33;1.000;3600000;0
3148;179344;3;0;0;0;0;.00nan;0;0
3148;78806;34;0;0;0;0;.00nan;0;0
3149;163195;15;0;0;0;0;.00nan;0;0
3149;165582;24;51;28;4;24;.857;3777000;0
3149;85727;24;0;0;0;0;.00nan;0;0
3149;139409;15;44;26;5;21;.808;3777000;0
3150;67;11;0;0;0;0;.00nan;0;0
3150;3284;21;57;26;3;23;.885;4200000;0
3150;45323;11;82;36;3;33;.917;4200000;0
3150;143156;21;0;0;0;0;.00nan;0;0
3151;179950;4838;0;0;0;0;.00nan;0;0
3151;186573;0;0;0;0;0;.00nan;0;0
3151;59540;0;81;35;3;32;.914;3600000;0
3151;143749;4838;75;28;2;26;.929;3600000;0
3152;167642;18;0;0;0;0;.00nan;0;0
3152;173727;18;82;16;0;16;1.000;3600000;0
3152;175092;9;0;0;0;0;.00nan;0;0
3152;190106;9;55;37;5;32;.865;3600000;0
3153;166751;5;95;37;2;35;.946;3600000;0
3153;172398;5;0;0;0;0;.00nan;0;0
3153;166381;27;77;23;1;22;.957;3600000;0
3153;175660;27;0;0;0;0;.00nan;0;0
3154;85798;12;64;29;3;26;.897;3600000;0
3154;91178;12;0;0;0;0;.00nan;0;0
3154;149452;31;78;41;4;37;.902;3551000;0
3154;152717;31;0;0;0;0;.00nan;0;0
3155;166591;20;50;1;0;1;1.000;296000;0
3155;184229;35;0;0;0;0;.00nan;0;0
3155;57338;35;82;30;2;28;.933;3600000;0
3155;71565;20;42;31;6;25;.806;3304000;0
3156;166646;16;81;24;1;23;.958;3600000;0
3156;174718;25;50;31;4;27;.871;3600000;0
3156;50065;16;0;0;0;0;.00nan;0;0
3156;148958;25;0;0;0;0;.00nan;0;0
3157;13337;32;0;0;0;0;.00nan;0;0
3157;20432;32;91;21;0;21;1.000;3600000;0
3157;190465;33;46;9;1;8;.889;1172000;0
3157;197038;33;28;24;6;18;.750;2428000;0
3158;163423;26;72;28;3;25;.893;3600000;0
3158;168712;14;43;32;6;26;.813;3600000;0
3158;185034;14;0;0;0;0;.00nan;0;0
3158;152835;26;0;0;0;0;.00nan;0;0
3159;183844;29;0;0;0;0;.00nan;0;0
3159;18213;8;78;25;1;24;.960;3600000;0
3159;189644;8;0;0;0;0;.00nan;0;0
3159;37818;29;60;29;3;26;.897;3543000;0
3160;187537;19;98;26;0;26;1.000;3600000;0
3160;172340;4182;68;25;2;23;.920;3522000;0
3160;163565;19;0;0;0;0;.00nan;0;0
3160;147945;4182;0;0;0;0;.00nan;0;0
3161;187578;10;0;0;0;0;.00nan;0;0
3161;184770;22;89;19;0;19;1.000;3600000;0
3161;90164;10;56;32;3;29;.906;3600000;0
3161;143473;22;0;0;0;0;.00nan;0;0
3162;186573;0;0;0;0;0;.00nan;0;0
3162;59540;0;72;21;1;20;.952;3600000;0
3162;149452;31;0;0;0;0;.00nan;0;0
3162;152717;31;88;50;4;46;.920;3600000;0
3163;676;34;56;22;3;19;.864;3564000;0
3163;183844;29;0;0;0;0;.00nan;0;0
3163;37818;29;82;34;2;32;.941;3600000;0
3163;78806;34;0;0;0;0;.00nan;0;0
3164;170977;30;0;0;0;0;.00nan;0;0
3164;77955;28;74;32;3;29;.906;3551000;0
3164;85437;28;0;0;0;0;.00nan;0;0
3164;86697;30;65;21;2;19;.905;3600000;0
3165;2059;23;0;0;0;0;.00nan;0;0
3165;3284;21;65;21;2;19;.905;3600000;0
3165;78573;23;70;38;3;35;.921;3600000;0
3165;143156;21;0;0;0;0;.00nan;0;0
3166;556;3;53;25;3;22;.880;3600000;0
3166;166381;27;74;40;4;36;.900;3600000;0
3166;179344;3;0;0;0;0;.00nan;0;0
3166;175660;27;0;0;0;0;.00nan;0;0
3167;163195;15;0;0;0;0;.00nan;0;0
3167;179950;4838;0;0;0;0;.00nan;0;0
3167;139409;15;67;16;1;15;.938;3600000;0
3167;143749;4838;92;56;4;52;.929;3600000;0
3168;168712;14;100;32;0;32;1.000;3600000;0
3168;185034;14;0;0;0;0;.00nan;0;0
3168;190465;33;70;29;3;26;.897;3600000;0
3168;197038;33;0;0;0;0;.00nan;0;0
3169;67;11;0;0;0;0;.00nan;0;0
3169;165582;24;88;32;1;31;.969;3600000;0
3169;45323;11;70;39;4;35;.897;3600000;0
3169;85727;24;0;0;0;0;.00nan;0;0
3170;175092;9;100;36;1;35;.972;3600000;0
3170;190106;9;0;0;0;0;.00nan;0;0
3170;85798;12;0;0;0;0;.00nan;0;0
3170;91178;12;60;22;2;20;.909;3570000;0
3171;166591;20;0;0;0;0;.00nan;0;0
3171;18213;8;60;21;3;18;.857;3600000;0
3171;189644;8;0;0;0;0;.00nan;0;0
3171;71565;20;86;50;4;46;.920;3552000;0
3172;187537;19;81;32;2;30;.938;3600000;0
3172;163423;26;0;0;0;0;.00nan;0;0
3172;163565;19;0;0;0;0;.00nan;0;0
3172;152835;26;80;28;1;27;.964;3600000;0
3173;67;11;0;0;0;0;.00nan;0;0
3173;184770;22;0;0;0;0;.00nan;0;0
3173;45323;11;52;57;8;49;.860;3600000;0
3173;143473;22;91;16;0;16;1.000;3600000;0
3174;5923;17;0;0;0;0;.00nan;0;0
3174;178413;17;75;22;1;21;.955;3600000;0
3174;85798;12;47;40;5;35;.875;3600000;0
3174;91178;12;0;0;0;0;.00nan;0;0
3175;187578;10;84;36;3;33;.917;3600000;0
3175;166381;27;46;5;1;4;.800;510000;0
3175;175660;27;37;30;6;24;.800;3090000;0
3175;90164;10;0;0;0;0;.00nan;0;0
3176;174718;25;54;24;3;21;.875;3553000;0
3176;179950;4838;84;35;2;33;.943;3600000;0
3176;143749;4838;0;0;0;0;.00nan;0;0
3176;148958;25;0;0;0;0;.00nan;0;0
3177;168712;14;67;40;5;35;.875;3600000;0
3177;184229;35;0;0;0;0;.00nan;0;0
3177;185034;14;0;0;0;0;.00nan;0;0
3177;57338;35;50;14;2;12;.857;3600000;0
3178;166646;16;0;0;0;0;.00nan;0;0
3178;170977;30;100;41;0;41;1.000;3600000;0
3178;50065;16;69;29;3;26;.897;3600000;0
3178;86697;30;0;0;0;0;.00nan;0;0
3179;172340;4182;56;27;4;23;.852;3600000;0
3179;13337;32;75;13;0;13;1.000;933000;0
3179;20432;32;34;26;6;20;.769;2667000;0
3179;147945;4182;0;0;0;0;.00nan;0;0
3180;167642;18;0;0;0;0;.00nan;0;0
3180;173727;18;100;28;0;28;1.000;3600000;0
3180;149452;31;48;38;6;32;.842;3600000;0
3180;152717;31;0;0;0;0;.00nan;0;0
3181;556;3;77;26;1;25;.962;3600000;0
3181;179344;3;0;0;0;0;.00nan;0;0
3181;186573;0;0;0;0;0;.00nan;0;0
3181;59540;0;85;36;2;34;.944;3600000;0
3182;676;34;0;0;0;0;.00nan;0;0
3182;175092;9;0;0;0;0;.00nan;0;0
3182;190106;9;45;31;5;26;.839;3600000;0
3182;78806;34;77;27;2;25;.926;3600000;0
3183;166646;16;53;20;3;17;.850;3600000;0
3183;50065;16;0;0;0;0;.00nan;0;0
3183;77955;28;0;0;0;0;.00nan;0;0
3183;85437;28;68;42;4;38;.905;3600000;0
3184;183844;29;0;0;0;0;.00nan;0;0
3184;37818;29;91;32;1;31;.969;3600000;0
3184;85798;12;0;0;0;0;.00nan;0;0
3184;91178;12;53;30;4;26;.867;3600000;0
3185;5923;17;0;0;0;0;.00nan;0;0
3185;178413;17;58;19;2;17;.895;4067000;0
3185;175092;9;81;44;3;41;.932;4067000;0
3185;190106;9;0;0;0;0;.00nan;0;0
3186;166591;20;0;0;0;0;.00nan;0;0
3186;174718;25;57;14;1;13;.929;3600000;0
3186;71565;20;77;44;4;40;.909;3600000;0
3186;148958;25;0;0;0;0;.00nan;0;0
3187;166751;5;75;23;1;22;.957;3600000;0
3187;172398;5;0;0;0;0;.00nan;0;0
3187;190465;33;0;0;0;0;.00nan;0;0
3187;197038;33;38;31;5;26;.839;3600000;0
3188;187578;10;52;35;5;30;.857;3600000;0
3188;18213;8;76;28;2;26;.929;3600000;0
3188;189644;8;0;0;0;0;.00nan;0;0
3188;90164;10;0;0;0;0;.00nan;0;0
3189;172340;4182;0;0;0;0;.00nan;0;0
3189;147945;4182;65;19;1;18;.947;3600000;0
3189;149452;31;49;27;4;23;.852;3600000;0
3189;152717;31;0;0;0;0;.00nan;0;0
3190;67;11;0;0;0;0;.00nan;0;0
3190;167642;18;0;0;0;0;.00nan;0;0
3190;173727;18;87;14;0;14;1.000;3600000;0
3190;45323;11;90;55;2;53;.964;3600000;0
3191;163423;26;53;11;1;10;.909;1347000;0
3191;179950;4838;0;0;0;0;.00nan;0;0
3191;143749;4838;79;30;2;28;.933;3600000;0
3191;152835;26;34;27;5;22;.815;2253000;0
3192;2059;23;16;35;8;27;.771;3600000;0
3192;13337;32;0;0;0;0;.00nan;0;0
3192;20432;32;60;39;5;34;.872;3600000;0
3192;78573;23;0;0;0;0;.00nan;0;0
3193;187537;19;70;48;5;43;.896;3600000;0
3193;163565;19;0;0;0;0;.00nan;0;0
3193;184770;22;0;0;0;0;.00nan;0;0
3193;143473;22;90;25;1;24;.960;3600000;0
3194;163195;15;0;0;0;0;.00nan;0;0
3194;186573;0;0;0;0;0;.00nan;0;0
3194;59540;0;99;49;1;48;.980;3600000;0
3194;139409;15;51;15;2;13;.867;3552000;0
3195;676;34;0;0;0;0;.00nan;0;0
3195;3284;21;0;0;0;0;.00nan;0;0
3195;78806;34;100;28;0;28;1.000;3600000;0
3195;143156;21;60;30;3;27;.900;3600000;0
3196;556;3;60;22;3;19;.864;3600000;0
3196;179344;3;0;0;0;0;.00nan;0;0
3196;190465;33;60;34;4;30;.882;3600000;0
3196;197038;33;0;0;0;0;.00nan;0;0
3197;166646;16;0;0;0;0;.00nan;0;0
3197;168712;14;71;36;3;33;.917;3519000;0
3197;185034;14;0;0;0;0;.00nan;0;0
3197;50065;16;96;30;1;29;.967;3600000;0
3198;166751;5;38;27;5;22;.815;3530000;0
3198;172398;5;0;0;0;0;.00nan;0;0
3198;77955;28;74;29;3;26;.897;3600000;0
3198;85437;28;0;0;0;0;.00nan;0;0
3199;166591;20;0;0;0;0;.00nan;0;0
3199;71565;20;61;34;4;30;.882;3564000;0
3199;85798;12;0;0;0;0;.00nan;0;0
3199;91178;12;79;35;3;32;.914;3600000;0
3200;163423;26;0;0;0;0;.00nan;0;0
3200;13337;32;58;2;0;2;1.000;461000;0
3200;20432;32;32;31;6;25;.806;3139000;0
3200;152835;26;80;24;1;23;.958;3600000;0
3201;5923;17;0;0;0;0;.00nan;0;0
3201;178413;17;100;29;0;29;1.000;3600000;0
3201;184229;35;0;0;0;0;.00nan;0;0
3201;57338;35;79;39;3;36;.923;3600000;0
3202;183844;29;82;29;1;28;.966;3600000;0
3202;175092;9;66;24;2;22;.917;3546000;0
3202;190106;9;0;0;0;0;.00nan;0;0
3202;37818;29;0;0;0;0;.00nan;0;0
3203;676;34;58;33;5;28;.848;3600000;0
3203;174718;25;16;26;7;19;.731;3559000;0
3203;78806;34;0;0;0;0;.00nan;0;0
3203;148958;25;0;0;0;0;.00nan;0;0
3204;2059;23;0;0;0;0;.00nan;0;0
3204;78573;23;73;28;2;26;.929;4200000;0
3204;149452;31;0;0;0;0;.00nan;0;0
3204;152717;31;67;30;2;28;.933;4200000;0
3205;187578;10;81;44;4;40;.909;3600000;0
3205;18213;8;17;17;6;11;.647;1828000;0
3205;189644;8;65;12;0;12;1.000;1714000;0
3205;90164;10;0;0;0;0;.00nan;0;0
3206;172340;4182;30;38;8;30;.789;3257000;0
3206;167642;18;0;0;0;0;.00nan;0;0
3206;173727;18;71;37;4;33;.892;3600000;0
3206;147945;4182;48;0;0;0;.00nan;343000;0
3207;166381;27;82;39;2;37;.949;3523000;0
3207;170977;30;0;0;0;0;.00nan;0;0
3207;175660;27;0;0;0;0;.00nan;0;0
3207;86697;30;100;26;0;26;1.000;3600000;0
3208;187537;19;89;31;1;30;.968;3600000;0
3208;163565;19;0;0;0;0;.00nan;0;0
3208;165582;24;52;21;3;18;.857;3527000;0
3208;85727;24;0;0;0;0;.00nan;0;0
3209;184770;22;0;0;0;0;.00nan;0;0
3209;179950;4838;0;0;0;0;.00nan;0;0
3209;143473;22;82;28;2;26;.929;3600000;0
3209;143749;4838;75;28;3;25;.893;3600000;0
3210;166591;20;83;29;2;27;.931;3600000;0
3210;5923;17;0;0;0;0;.00nan;0;0
3210;178413;17;45;21;3;18;.857;3600000;0
3210;71565;20;0;0;0;0;.00nan;0;0
3211;163195;15;0;0;0;0;.00nan;0;0
3211;190465;33;86;40;3;37;.925;3549000;0
3211;197038;33;0;0;0;0;.00nan;0;0
3211;139409;15;91;27;1;26;.963;3600000;0
3212;166751;5;0;0;0;0;.00nan;0;0
3212;172398;5;85;40;3;37;.925;3569000;0
3212;186573;0;0;0;0;0;.00nan;0;0
3212;59540;0;87;31;1;30;.968;3600000;0
3213;168712;14;0;0;0;0;.00nan;0;0
3213;174718;25;37;24;4;20;.833;3600000;0
3213;185034;14;95;36;1;35;.972;3600000;0
3213;148958;25;0;0;0;0;.00nan;0;0
3214;166381;27;0;0;0;0;.00nan;0;0
3214;175660;27;94;58;3;55;.948;4136000;0
3214;184770;22;77;29;2;27;.931;4136000;0
3214;143473;22;0;0;0;0;.00nan;0;0
3215;67;11;0;0;0;0;.00nan;0;0
3215;45323;11;58;24;3;21;.875;3544000;0
3215;149452;31;94;35;2;33;.943;3600000;0
3215;152717;31;0;0;0;0;.00nan;0;0
3216;183844;29;86;40;3;37;.925;4200000;0
3216;184229;35;0;0;0;0;.00nan;0;0
3216;37818;29;0;0;0;0;.00nan;0;0
3216;57338;35;72;37;3;34;.919;4200000;0
3217;676;34;0;0;0;0;.00nan;0;0
3217;187537;19;99;49;1;48;.980;3600000;0
3217;163565;19;0;0;0;0;.00nan;0;0
3217;78806;34;62;22;2;20;.909;3536000;0
3218;556;3;66;18;1;17;.944;3600000;0
3218;163423;26;0;0;0;0;.00nan;0;0
3218;179344;3;0;0;0;0;.00nan;0;0
3218;152835;26;52;39;5;34;.872;3600000;0
3219;13337;32;0;0;0;0;.00nan;0;0
3219;165582;24;0;0;0;0;.00nan;0;0
3219;20432;32;72;34;3;31;.912;3600000;0
3219;85727;24;100;28;0;28;1.000;3600000;0
3220;166646;16;0;0;0;0;.00nan;0;0
3220;2059;23;85;39;3;36;.923;3600000;0
3220;50065;16;28;23;5;18;.783;3540000;0
3220;78573;23;0;0;0;0;.00nan;0;0
3221;170977;30;0;0;0;0;.00nan;0;0
3221;179950;4838;0;0;0;0;.00nan;0;0
3221;86697;30;94;35;2;33;.943;3600000;0
3221;143749;4838;83;31;3;28;.903;3544000;0
3222;174718;25;0;0;0;0;.00nan;0;0
3222;186573;0;0;0;0;0;.00nan;0;0
3222;59540;0;44;25;5;20;.800;3600000;0
3222;148958;25;74;22;1;21;.955;3600000;0
3223;5923;17;97;21;0;21;1.000;3600000;0
3223;178413;17;0;0;0;0;.00nan;0;0
3223;175092;9;95;44;2;42;.955;3558000;0
3223;190106;9;0;0;0;0;.00nan;0;0
3224;166591;20;0;0;0;0;.00nan;0;0
3224;166751;5;59;31;4;27;.871;3600000;0
3224;172398;5;0;0;0;0;.00nan;0;0
3224;71565;20;78;23;1;22;.957;3600000;0
3225;187537;19;0;0;0;0;.00nan;0;0
3225;163565;19;68;41;4;37;.902;3808000;0
3225;168712;14;77;31;3;28;.903;3808000;0
3225;185034;14;0;0;0;0;.00nan;0;0
3226;187578;10;84;29;2;27;.931;3600000;0
3226;190465;33;58;29;3;26;.897;3548000;0
3226;197038;33;0;0;0;0;.00nan;0;0
3226;90164;10;0;0;0;0;.00nan;0;0
3227;172340;4182;90;31;1;30;.968;3600000;0
3227;18213;8;74;25;2;23;.920;3553000;0
3227;189644;8;0;0;0;0;.00nan;0;0
3227;147945;4182;0;0;0;0;.00nan;0;0
3228;3284;21;57;32;4;28;.875;3600000;0
3228;167642;18;0;0;0;0;.00nan;0;0
3228;173727;18;99;42;1;41;.976;3600000;0
3228;143156;21;0;0;0;0;.00nan;0;0
3229;166381;27;58;22;3;19;.864;3940000;0
3229;175660;27;0;0;0;0;.00nan;0;0
3229;77955;28;0;0;0;0;.00nan;0;0
3229;85437;28;73;35;4;31;.886;3940000;0
3230;170977;30;78;35;3;32;.914;3600000;0
3230;184770;22;0;0;0;0;.00nan;0;0
3230;86697;30;0;0;0;0;.00nan;0;0
3230;143473;22;94;21;0;21;1.000;3600000;0
3231;556;3;48;27;4;23;.852;3575000;0
3231;13337;32;0;0;0;0;.00nan;0;0
3231;20432;32;91;47;2;45;.957;3600000;0
3231;179344;3;0;0;0;0;.00nan;0;0
3232;184229;35;0;0;0;0;.00nan;0;0
3232;57338;35;90;18;0;18;1.000;3600000;0
3232;149452;31;77;44;4;40;.909;3600000;0
3232;152717;31;0;0;0;0;.00nan;0;0
3233;163195;15;0;0;0;0;.00nan;0;0
3233;183844;29;0;0;0;0;.00nan;0;0
3233;37818;29;65;42;4;38;.905;3600000;0
3233;139409;15;92;22;1;21;.955;3600000;0
3234;187578;10;0;0;0;0;.00nan;0;0
3234;85798;12;68;23;2;21;.913;3600000;0
3234;90164;10;69;39;4;35;.897;3600000;0
3234;91178;12;0;0;0;0;.00nan;0;0
3235;67;11;59;14;1;13;.929;1671000;0
3235;166646;16;48;14;2;12;.857;3600000;0
3235;45323;11;36;31;6;25;.806;1929000;0
3235;50065;16;0;0;0;0;.00nan;0;0
3236;2059;23;71;34;4;30;.882;3552000;0
3236;18213;8;0;0;0;0;.00nan;0;0
3236;189644;8;83;33;2;31;.939;3600000;0
3236;78573;23;0;0;0;0;.00nan;0;0
3237;179950;4838;48;26;4;22;.846;3600000;0
3237;77955;28;100;38;1;37;.974;3600000;0
3237;85437;28;0;0;0;0;.00nan;0;0
3237;143749;4838;0;0;0;0;.00nan;0;0
3238;676;34;0;0;0;0;.00nan;0;0
3238;163195;15;68;36;3;33;.917;3560000;0
3238;78806;34;72;30;2;28;.933;3600000;0
3238;139409;15;0;0;0;0;.00nan;0;0
3239;166591;20;0;0;0;0;.00nan;0;0
3239;186573;0;0;0;0;0;.00nan;0;0
3239;59540;0;86;22;1;21;.955;3600000;0
3239;71565;20;71;40;4;36;.900;3600000;0
3240;168712;14;72;24;1;23;.958;3600000;0
3240;175092;9;0;0;0;0;.00nan;0;0
3240;190106;9;61;33;4;29;.879;3600000;0
3240;185034;14;0;0;0;0;.00nan;0;0
3241;5923;17;89;37;3;34;.919;3600000;0
3241;183844;29;23;11;4;7;.636;1135000;0
3241;178413;17;0;0;0;0;.00nan;0;0
3241;37818;29;56;20;2;18;.900;2465000;0
3242;166751;5;26;12;4;8;.667;831000;0
3242;172398;5;52;21;2;19;.905;2769000;0
3242;13337;32;59;24;2;22;.917;3600000;0
3242;20432;32;0;0;0;0;.00nan;0;0
3243;166381;27;18;18;6;12;.667;2784000;0
3243;174718;25;74;41;4;37;.902;3600000;0
3243;175660;27;37;6;2;4;.667;816000;0
3243;148958;25;0;0;0;0;.00nan;0;0
3244;163423;26;0;0;0;0;.00nan;0;0
3244;190465;33;56;35;5;30;.857;3600000;0
3244;197038;33;0;0;0;0;.00nan;0;0
3244;152835;26;70;24;2;22;.917;3600000;0
3245;3284;21;56;25;3;22;.880;3600000;0
3245;172340;4182;67;36;4;32;.889;3600000;0
3245;143156;21;0;0;0;0;.00nan;0;0
3245;147945;4182;0;0;0;0;.00nan;0;0
3246;166646;16;0;0;0;0;.00nan;0;0
3246;167642;18;85;44;3;41;.932;4200000;0
3246;173727;18;0;0;0;0;.00nan;0;0
3246;50065;16;62;27;3;24;.889;4200000;0
3247;187537;19;87;63;5;58;.921;3600000;0
3247;163565;19;0;0;0;0;.00nan;0;0
3247;184770;22;0;0;0;0;.00nan;0;0
3247;143473;22;52;12;2;10;.833;3600000;0
3248;556;3;65;38;5;33;.868;3560000;0
3248;165582;24;0;0;0;0;.00nan;0;0
3248;179344;3;0;0;0;0;.00nan;0;0
3248;85727;24;60;29;4;25;.862;3600000;0
3249;179950;4838;0;0;0;0;.00nan;0;0
3249;85798;12;0;0;0;0;.00nan;0;0
3249;91178;12;100;35;0;35;1.000;3600000;0
3249;143749;4838;47;24;4;20;.833;3600000;0
3250;67;11;79;38;3;35;.921;3533000;0
3250;18213;8;76;20;1;19;.950;3600000;0
3250;189644;8;0;0;0;0;.00nan;0;0
3250;45323;11;0;0;0;0;.00nan;0;0
3251;166591;20;0;0;0;0;.00nan;0;0
3251;183844;29;74;32;2;30;.938;3600000;0
3251;37818;29;0;0;0;0;.00nan;0;0
3251;71565;20;67;35;3;32;.914;3600000;0
3252;187578;10;71;41;4;37;.902;3600000;0
3252;174718;25;29;29;6;23;.793;3514000;0
3252;90164;10;0;0;0;0;.00nan;0;0
3252;148958;25;0;0;0;0;.00nan;0;0
3253;163423;26;0;0;0;0;.00nan;0;0
3253;167642;18;0;0;0;0;.00nan;0;0
3253;173727;18;79;32;3;29;.906;3735000;0
3253;152835;26;67;34;4;30;.882;3735000;0
3254;170977;30;0;0;0;0;.00nan;0;0
3254;77955;28;0;0;0;0;.00nan;0;0
3254;85437;28;100;45;0;45;1.000;3600000;0
3254;86697;30;44;14;3;11;.786;3600000;0
3255;163195;15;0;0;0;0;.00nan;0;0
3255;13337;32;60;24;2;22;.917;1290000;0
3255;20432;32;26;20;5;15;.750;2310000;0
3255;139409;15;60;17;2;15;.882;3600000;0
3256;187537;19;0;0;0;0;.00nan;0;0
3256;163565;19;53;31;4;27;.871;3600000;0
3256;186573;0;95;31;1;30;.968;3600000;0
3256;59540;0;0;0;0;0;.00nan;0;0
3257;5923;17;0;0;0;0;.00nan;0;0
3257;178413;17;70;39;4;35;.897;3600000;0
3257;184770;22;66;20;1;19;.950;3600000;0
3257;143473;22;0;0;0;0;.00nan;0;0
3258;165582;24;47;43;6;37;.860;2676000;0
3258;175092;9;0;0;0;0;.00nan;0;0
3258;190106;9;22;30;7;23;.767;3600000;0
3258;85727;24;57;5;0;5;1.000;924000;0
3259;676;34;0;0;0;0;.00nan;0;0
3259;166751;5;68;44;5;39;.886;3563000;0
3259;172398;5;0;0;0;0;.00nan;0;0
3259;78806;34;42;17;3;14;.824;3600000;0
3260;184229;35;0;0;0;0;.00nan;0;0
3260;57338;35;85;20;1;19;.950;3600000;0
3260;149452;31;0;0;0;0;.00nan;0;0
3260;152717;31;73;36;4;32;.889;3600000;0
3261;556;3;75;36;3;33;.917;3600000;0
3261;168712;14;0;0;0;0;.00nan;0;0
3261;179344;3;0;0;0;0;.00nan;0;0
3261;185034;14;77;34;2;32;.941;3600000;0
3262;166381;27;0;0;0;0;.00nan;0;0
3262;175660;27;68;27;2;25;.926;3600000;0
3262;190465;33;65;36;3;33;.917;3548000;0
3262;197038;33;0;0;0;0;.00nan;0;0
3263;166646;16;42;20;4;16;.800;3539000;0
3263;172340;4182;96;37;2;35;.946;3600000;0
3263;50065;16;0;0;0;0;.00nan;0;0
3263;147945;4182;0;0;0;0;.00nan;0;0
3264;2059;23;93;43;3;40;.930;3561000;0
3264;3284;21;77;24;1;23;.958;3600000;0
3264;78573;23;0;0;0;0;.00nan;0;0
3264;143156;21;0;0;0;0;.00nan;0;0
3265;18213;8;98;39;2;37;.949;3889000;0
3265;189644;8;0;0;0;0;.00nan;0;0
3265;179950;4838;0;0;0;0;.00nan;0;0
3265;143749;4838;79;37;3;34;.919;3889000;0
3266;67;11;0;0;0;0;.00nan;0;0
3266;3284;21;0;0;0;0;.00nan;0;0
3266;45323;11;61;34;3;31;.912;3527000;0
3266;143156;21;87;26;1;25;.962;3600000;0
3267;5923;17;31;23;5;18;.783;3600000;0
3267;163423;26;0;0;0;0;.00nan;0;0
3267;178413;17;0;0;0;0;.00nan;0;0
3267;152835;26;77;32;2;30;.938;3600000;0
3268;3284;21;78;24;1;23;.958;3600000;0
3268;18213;8;55;19;2;17;.895;3554000;0
3268;189644;8;0;0;0;0;.00nan;0;0
3268;143156;21;0;0;0;0;.00nan;0;0
3269;67;11;0;0;0;0;.00nan;0;0
3269;170977;30;0;0;0;0;.00nan;0;0
3269;45323;11;80;43;3;40;.930;3600000;0
3269;86697;30;91;21;0;21;1.000;3600000;0
3270;5923;17;0;0;0;0;.00nan;0;0
3270;178413;17;43;34;5;29;.853;3600000;0
3270;186573;0;0;0;0;0;.00nan;0;0
3270;59540;0;95;36;1;35;.972;3600000;0
3271;163423;26;0;0;0;0;.00nan;0;0
3271;179950;4838;0;0;0;0;.00nan;0;0
3271;143749;4838;67;31;3;28;.903;3566000;0
3271;152835;26;55;19;2;17;.895;3600000;0
3272;166381;27;64;25;3;22;.880;3049000;0
3272;170977;30;0;0;0;0;.00nan;0;0
3272;175660;27;32;12;3;9;.750;551000;0
3272;86697;30;74;32;3;29;.906;3600000;0
3273;184770;22;0;0;0;0;.00nan;0;0
3273;85798;12;0;0;0;0;.00nan;0;0
3273;91178;12;84;36;2;34;.944;3528000;0
3273;143473;22;80;12;0;12;1.000;3600000;0
3274;168712;14;55;33;5;28;.848;4200000;0
3274;185034;14;0;0;0;0;.00nan;0;0
3274;149452;31;60;53;5;48;.906;4200000;0
3274;152717;31;0;0;0;0;.00nan;0;0
3275;172340;4182;96;41;3;38;.927;3545000;0
3275;183844;29;0;0;0;0;.00nan;0;0
3275;37818;29;86;31;1;30;.968;3600000;0
3275;147945;4182;0;0;0;0;.00nan;0;0
3276;174718;25;59;35;5;30;.857;3600000;0
3276;77955;28;64;5;0;5;1.000;553000;0
3276;85437;28;61;41;6;35;.854;2993000;0
3276;148958;25;0;0;0;0;.00nan;0;0
3277;2059;23;27;8;3;5;.625;302000;0
3277;163195;15;0;0;0;0;.00nan;0;0
3277;78573;23;74;32;3;29;.906;3298000;0
3277;139409;15;68;26;2;24;.923;3600000;0
3278;556;3;0;0;0;0;.00nan;0;0
3278;166591;20;0;0;0;0;.00nan;0;0
3278;179344;3;86;30;1;29;.967;3950000;0
3278;71565;20;89;38;2;36;.947;3950000;0
3279;676;34;66;18;1;17;.944;3600000;0
3279;78806;34;0;0;0;0;.00nan;0;0
3279;85798;12;83;33;2;31;.939;3547000;0
3279;91178;12;0;0;0;0;.00nan;0;0
3280;165582;24;0;0;0;0;.00nan;0;0
3280;184229;35;0;0;0;0;.00nan;0;0
3280;57338;35;77;23;1;22;.957;3746000;0
3280;85727;24;84;39;2;37;.949;3746000;0
3281;187578;10;56;31;4;27;.871;3526000;0
3281;175092;9;77;25;2;23;.920;3600000;0
3281;190106;9;0;0;0;0;.00nan;0;0
3281;90164;10;0;0;0;0;.00nan;0;0
3282;187537;19;59;33;4;29;.879;3557000;0
3282;163565;19;0;0;0;0;.00nan;0;0
3282;167642;18;0;0;0;0;.00nan;0;0
3282;173727;18;85;38;2;36;.947;3600000;0
3283;166751;5;70;45;5;40;.889;3600000;0
3283;172398;5;0;0;0;0;.00nan;0;0
3283;184770;22;0;0;0;0;.00nan;0;0
3283;143473;22;81;31;2;29;.935;3600000;0
3284;174718;25;69;19;1;18;.947;3600000;0
3284;148958;25;0;0;0;0;.00nan;0;0
3284;149452;31;0;0;0;0;.00nan;0;0
3284;152717;31;82;42;3;39;.929;3544000;0
3285;166646;16;0;0;0;0;.00nan;0;0
3285;190465;33;0;0;0;0;.00nan;0;0
3285;197038;33;74;37;4;33;.892;3600000;0
3285;50065;16;64;16;1;15;.938;3600000;0
3286;2059;23;55;48;7;41;.854;3600000;0
3286;183844;29;73;26;2;24;.923;3600000;0
3286;37818;29;0;0;0;0;.00nan;0;0
3286;78573;23;0;0;0;0;.00nan;0;0
3287;556;3;90;32;2;30;.938;3600000;0
3287;187578;10;48;29;5;24;.828;3600000;0
3287;179344;3;0;0;0;0;.00nan;0;0
3287;90164;10;0;0;0;0;.00nan;0;0
3288;676;34;0;0;0;0;.00nan;0;0
3288;172340;4182;60;34;5;29;.853;3600000;0
3288;78806;34;46;25;4;21;.840;3600000;0
3288;147945;4182;0;0;0;0;.00nan;0;0
3289;166591;20;0;0;0;0;.00nan;0;0
3289;184229;35;0;0;0;0;.00nan;0;0
3289;57338;35;68;41;5;36;.878;3600000;0
3289;71565;20;26;21;6;15;.714;3598000;0
3290;166751;5;0;0;0;0;.00nan;0;0
3290;172398;5;55;30;3;27;.900;3556000;0
3290;168712;14;74;28;2;26;.929;3600000;0
3290;185034;14;0;0;0;0;.00nan;0;0
3291;163195;15;0;0;0;0;.00nan;0;0
3291;85798;12;0;0;0;0;.00nan;0;0
3291;91178;12;60;37;4;33;.892;3555000;0
3291;139409;15;77;30;2;28;.933;3600000;0
3292;187537;19;53;30;4;26;.867;3600000;0
3292;163565;19;0;0;0;0;.00nan;0;0
3292;13337;32;0;0;0;0;.00nan;0;0
3292;20432;32;80;22;1;21;.955;3600000;0
3293;165582;24;0;0;0;0;.00nan;0;0
3293;190465;33;0;0;0;0;.00nan;0;0
3293;197038;33;99;40;1;39;.975;3600000;0
3293;85727;24;82;28;2;26;.929;3563000;0
3294;166646;16;41;47;7;40;.851;3600000;0
3294;184770;22;0;0;0;0;.00nan;0;0
3294;50065;16;0;0;0;0;.00nan;0;0
3294;143473;22;59;19;3;16;.842;3600000;0
3295;167642;18;0;0;0;0;.00nan;0;0
3295;166381;27;0;0;0;0;.00nan;0;0
3295;173727;18;58;37;5;32;.865;3515000;0
3295;175660;27;49;24;3;21;.875;3600000;0
3296;18213;8;77;33;2;31;.939;3558000;0
3296;189644;8;0;0;0;0;.00nan;0;0
3296;77955;28;0;0;0;0;.00nan;0;0
3296;85437;28;91;34;1;33;.971;3600000;0
3297;2059;23;45;43;7;36;.837;3600000;0
3297;186573;0;0;0;0;0;.00nan;0;0
3297;59540;0;81;29;2;27;.931;3600000;0
3297;78573;23;0;0;0;0;.00nan;0;0
3298;174718;25;59;28;3;25;.893;4126000;0
3298;175092;9;0;0;0;0;.00nan;0;0
3298;190106;9;62;34;4;30;.882;4126000;0
3298;148958;25;0;0;0;0;.00nan;0;0
3299;172340;4182;100;28;0;28;1.000;3600000;0
3299;168712;14;83;34;2;32;.941;3513000;0
3299;185034;14;0;0;0;0;.00nan;0;0
3299;147945;4182;0;0;0;0;.00nan;0;0
3300;187578;10;91;51;4;47;.922;3600000;0
3300;183844;29;91;21;0;21;1.000;3600000;0
3300;37818;29;0;0;0;0;.00nan;0;0
3300;90164;10;0;0;0;0;.00nan;0;0
3301;556;3;89;31;1;30;.968;3600000;0
3301;179344;3;0;0;0;0;.00nan;0;0
3301;85798;12;0;0;0;0;.00nan;0;0
3301;91178;12;77;38;4;34;.895;3600000;0
3302;676;34;0;0;0;0;.00nan;0;0
3302;163195;15;0;0;0;0;.00nan;0;0
3302;78806;34;58;32;5;27;.844;3600000;0
3302;139409;15;76;18;1;17;.944;3600000;0
3303;166751;5;80;30;1;29;.967;3600000;0
3303;3284;21;54;23;3;20;.870;3573000;0
3303;172398;5;0;0;0;0;.00nan;0;0
3303;143156;21;0;0;0;0;.00nan;0;0
3304;5923;17;0;0;0;0;.00nan;0;0
3304;178413;17;64;24;2;22;.917;3600000;0
3304;149452;31;0;0;0;0;.00nan;0;0
3304;152717;31;92;47;4;43;.915;3545000;0
3305;67;11;0;0;0;0;.00nan;0;0
3305;166591;20;0;0;0;0;.00nan;0;0
3305;45323;11;85;42;3;39;.929;3793000;0
3305;71565;20;61;33;4;29;.879;3776000;0
3306;165582;24;66;41;4;37;.902;3600000;0
3306;184229;35;0;0;0;0;.00nan;0;0
3306;57338;35;76;38;3;35;.921;3600000;0
3306;85727;24;0;0;0;0;.00nan;0;0
3307;163423;26;0;0;0;0;.00nan;0;0
3307;13337;32;0;0;0;0;.00nan;0;0
3307;20432;32;100;43;3;40;.930;3600000;0
3307;152835;26;67;36;4;32;.889;3578000;0
3308;167642;18;0;0;0;0;.00nan;0;0
3308;173727;18;72;27;2;25;.926;3773000;0
3308;179950;4838;86;29;1;28;.966;3773000;0
3308;143749;4838;0;0;0;0;.00nan;0;0
3309;18213;8;0;0;0;0;.00nan;0;0
3309;189644;8;67;27;2;25;.926;3600000;0
3309;175092;9;67;31;3;28;.903;3600000;0
3309;190106;9;0;0;0;0;.00nan;0;0
3310;187578;10;0;0;0;0;.00nan;0;0
3310;2059;23;0;0;0;0;.00nan;0;0
3310;78573;23;66;40;4;36;.900;3513000;0
3310;90164;10;90;47;2;45;.957;3600000;0
3311;67;11;0;0;0;0;.00nan;0;0
3311;676;34;0;0;0;0;.00nan;0;0
3311;45323;11;79;44;2;42;.955;4200000;0
3311;78806;34;80;26;2;24;.923;4200000;0
3312;172340;4182;74;43;4;39;.907;3539000;0
3312;184770;22;0;0;0;0;.00nan;0;0
3312;143473;22;70;25;2;23;.920;3600000;0
3312;147945;4182;0;0;0;0;.00nan;0;0
3313;166591;20;75;37;4;33;.892;3725000;0
3313;13337;32;0;0;0;0;.00nan;0;0
3313;20432;32;86;38;3;35;.921;3725000;0
3313;71565;20;0;0;0;0;.00nan;0;0
3314;187537;19;70;18;1;17;.944;3600000;0
3314;163565;19;0;0;0;0;.00nan;0;0
3314;190465;33;0;0;0;0;.00nan;0;0
3314;197038;33;63;33;4;29;.879;3600000;0
3315;166751;5;46;22;4;18;.818;3600000;0
3315;172398;5;0;0;0;0;.00nan;0;0
3315;183844;29;75;38;3;35;.921;3600000;0
3315;37818;29;0;0;0;0;.00nan;0;0
3316;179950;4838;60;8;0;8;1.000;1213000;0
3316;77955;28;0;0;0;0;.00nan;0;0
3316;85437;28;94;50;3;47;.940;3600000;0
3316;143749;4838;45;25;4;21;.840;2344000;0
3317;166381;27;67;20;1;19;.950;3600000;0
3317;175092;9;86;49;4;45;.918;3600000;0
3317;175660;27;0;0;0;0;.00nan;0;0
3317;190106;9;0;0;0;0;.00nan;0;0
3318;3284;21;48;33;5;28;.848;3600000;0
3318;5923;17;0;0;0;0;.00nan;0;0
3318;178413;17;65;25;2;23;.920;3600000;0
3318;143156;21;0;0;0;0;.00nan;0;0
3319;18213;8;62;25;3;22;.880;4040000;0
3319;189644;8;0;0;0;0;.00nan;0;0
3319;149452;31;95;45;2;43;.956;4040000;0
3319;152717;31;0;0;0;0;.00nan;0;0
3320;187578;10;76;28;2;26;.929;3600000;0
3320;85798;12;0;0;0;0;.00nan;0;0
3320;90164;10;0;0;0;0;.00nan;0;0
3320;91178;12;39;30;5;25;.833;3600000;0
3321;67;11;91;41;2;39;.951;3562000;0
3321;168712;14;78;24;1;23;.958;3600000;0
3321;185034;14;0;0;0;0;.00nan;0;0
3321;45323;11;0;0;0;0;.00nan;0;0
3322;163195;15;0;0;0;0;.00nan;0;0
3322;174718;25;58;28;4;24;.857;3592000;0
3322;139409;15;71;30;3;27;.900;3600000;0
3322;148958;25;0;0;0;0;.00nan;0;0
3323;676;34;79;38;2;36;.947;3566000;0
3323;163423;26;0;0;0;0;.00nan;0;0
3323;78806;34;0;0;0;0;.00nan;0;0
3323;152835;26;100;37;1;36;.973;3600000;0
3324;166646;16;56;19;2;17;.895;3600000;0
3324;2059;23;92;43;2;41;.953;3164000;0
3324;50065;16;0;0;0;0;.00nan;0;0
3324;78573;23;16;8;4;4;.500;436000;0
3325;167642;18;0;0;0;0;.00nan;0;0
3325;173727;18;33;17;4;13;.765;3600000;0
3325;186573;0;0;0;0;0;.00nan;0;0
3325;59540;0;100;59;1;58;.983;3600000;0
3326;556;3;100;35;1;34;.971;3600000;0
3326;165582;24;0;0;0;0;.00nan;0;0
3326;179344;3;0;0;0;0;.00nan;0;0
3326;85727;24;82;42;3;39;.929;3561000;0
3327;184229;35;48;28;4;24;.857;2999000;0
3327;170977;30;0;0;0;0;.00nan;0;0
3327;57338;35;24;12;4;8;.667;601000;0
3327;86697;30;47;24;4;20;.833;3600000;0
3328;13337;32;0;0;0;0;.00nan;0;0
3328;20432;32;97;40;2;38;.950;3600000;0
3328;190465;33;57;26;3;23;.885;3543000;0
3328;197038;33;0;0;0;0;.00nan;0;0
3329;67;11;0;0;0;0;.00nan;0;0
3329;183844;29;60;15;1;14;.933;3600000;0
3329;37818;29;0;0;0;0;.00nan;0;0
3329;45323;11;53;36;5;31;.861;3600000;0
3330;556;3;100;27;0;27;1.000;3600000;0
3330;179344;3;0;0;0;0;.00nan;0;0
3330;77955;28;0;0;0;0;.00nan;0;0
3330;85437;28;53;28;4;24;.857;3600000;0
3331;676;34;0;0;0;0;.00nan;0;0
3331;179950;4838;0;0;0;0;.00nan;0;0
3331;78806;34;61;39;5;34;.872;3570000;0
3331;143749;4838;60;29;4;25;.862;3600000;0
3332;175092;9;0;0;0;0;.00nan;0;0
3332;184770;22;0;0;0;0;.00nan;0;0
3332;190106;9;92;47;3;44;.936;4109000;0
3332;143473;22;51;18;2;16;.889;4109000;0
3333;5923;17;80;34;2;32;.941;3581000;0
3333;166381;27;0;0;0;0;.00nan;0;0
3333;178413;17;0;0;0;0;.00nan;0;0
3333;175660;27;98;23;0;23;1.000;3600000;0
3334;166751;5;83;30;2;28;.933;3600000;0
3334;172398;5;0;0;0;0;.00nan;0;0
3334;85798;12;0;0;0;0;.00nan;0;0
3334;91178;12;69;34;3;31;.912;3600000;0
3335;166591;20;0;0;0;0;.00nan;0;0
3335;71565;20;73;33;3;30;.909;3600000;0
3335;149452;31;0;0;0;0;.00nan;0;0
3335;152717;31;50;35;5;30;.857;3539000;0
3336;167642;18;0;0;0;0;.00nan;0;0
3336;18213;8;68;32;3;29;.906;3600000;0
3336;173727;18;91;39;2;37;.949;3600000;0
3336;189644;8;0;0;0;0;.00nan;0;0
3337;166646;16;42;27;5;22;.815;3600000;0
3337;165582;24;90;43;2;41;.953;3600000;0
3337;50065;16;0;0;0;0;.00nan;0;0
3337;85727;24;0;0;0;0;.00nan;0;0
3338;172340;4182;24;10;4;6;.600;845000;0
3338;170977;30;56;27;4;23;.852;3600000;0
3338;86697;30;0;0;0;0;.00nan;0;0
3338;147945;4182;71;23;1;22;.957;2721000;0
3339;163423;26;0;0;0;0;.00nan;0;0
3339;174718;25;0;0;0;0;.00nan;0;0
3339;148958;25;87;20;0;20;1.000;3600000;0
3339;152835;26;73;40;5;35;.875;3600000;0
3340;2059;23;40;27;5;22;.815;3627000;0
3340;186573;0;0;0;0;0;.00nan;0;0
3340;59540;0;44;33;6;27;.818;3627000;0
3340;78573;23;0;0;0;0;.00nan;0;0
3341;163195;15;0;0;0;0;.00nan;0;0
3341;13337;32;0;0;0;0;.00nan;0;0
3341;20432;32;68;53;7;46;.868;3600000;0
3341;139409;15;69;23;2;21;.913;3600000;0
3342;167642;18;0;0;0;0;.00nan;0;0
3342;173727;18;87;31;1;30;.968;3600000;0
3342;174718;25;0;0;0;0;.00nan;0;0
3342;148958;25;72;35;2;33;.943;3600000;0
3343;166646;16;57;32;4;28;.875;3792000;0
3343;5923;17;0;0;0;0;.00nan;0;0
3343;178413;17;86;46;3;43;.935;3826000;0
3343;50065;16;0;0;0;0;.00nan;0;0
3344;172340;4182;39;26;5;21;.808;3597000;0
3344;186573;0;0;0;0;0;.00nan;0;0
3344;59540;0;56;33;4;29;.879;3600000;0
3344;147945;4182;0;0;0;0;.00nan;0;0
3345;183844;29;100;36;2;34;.944;3600000;0
3345;179950;4838;0;0;0;0;.00nan;0;0
3345;37818;29;0;0;0;0;.00nan;0;0
3345;143749;4838;43;23;4;19;.826;3542000;0
3346;190465;33;0;0;0;0;.00nan;0;0
3346;197038;33;74;31;2;29;.935;3600000;0
3346;77955;28;0;0;0;0;.00nan;0;0
3346;85437;28;36;41;7;34;.829;3600000;0
3347;163423;26;0;0;0;0;.00nan;0;0
3347;18213;8;100;23;0;23;1.000;3600000;0
3347;189644;8;0;0;0;0;.00nan;0;0
3347;152835;26;54;35;5;30;.857;3600000;0
3348;556;3;69;28;2;26;.929;3591000;0
3348;166751;5;80;27;1;26;.963;3600000;0
3348;172398;5;0;0;0;0;.00nan;0;0
3348;179344;3;0;0;0;0;.00nan;0;0
3349;187578;10;0;0;0;0;.00nan;0;0
3349;175092;9;62;31;4;27;.871;3597000;0
3349;190106;9;0;0;0;0;.00nan;0;0
3349;90164;10;85;33;2;31;.939;3600000;0
3350;166381;27;0;0;0;0;.00nan;0;0
3350;175660;27;37;12;3;9;.750;3600000;0
3350;149452;31;62;45;5;40;.889;3600000;0
3350;152717;31;0;0;0;0;.00nan;0;0
3351;676;34;0;0;0;0;.00nan;0;0
3351;166591;20;0;0;0;0;.00nan;0;0
3351;71565;20;78;38;3;35;.921;3600000;0
3351;78806;34;49;23;4;19;.826;3568000;0
3352;2059;23;82;25;1;24;.960;3600000;0
3352;184229;35;0;0;0;0;.00nan;0;0
3352;57338;35;55;32;4;28;.875;3600000;0
3352;78573;23;0;0;0;0;.00nan;0;0
3353;3284;21;87;38;3;35;.921;3600000;0
3353;170977;30;0;0;0;0;.00nan;0;0
3353;86697;30;79;28;2;26;.929;3600000;0
3353;143156;21;0;0;0;0;.00nan;0;0
3354;187537;19;94;22;0;22;1.000;3600000;0
3354;163195;15;0;0;0;0;.00nan;0;0
3354;163565;19;0;0;0;0;.00nan;0;0
3354;139409;15;60;18;2;16;.889;3600000;0
3355;168712;14;0;0;0;0;.00nan;0;0
3355;184770;22;0;0;0;0;.00nan;0;0
3355;185034;14;78;30;2;28;.933;3545000;0
3355;143473;22;84;22;1;21;.955;3600000;0
3356;13337;32;0;0;0;0;.00nan;0;0
3356;20432;32;70;46;5;41;.891;3600000;0
3356;85798;12;45;23;4;19;.826;3600000;0
3356;91178;12;0;0;0;0;.00nan;0;0
3357;165582;24;0;0;0;0;.00nan;0;0
3357;179950;4838;77;36;3;33;.917;3600000;0
3357;85727;24;41;26;5;21;.808;3576000;0
3357;143749;4838;0;0;0;0;.00nan;0;0
3358;166381;27;0;0;0;0;.00nan;0;0
3358;175660;27;79;22;1;21;.955;3600000;0
3358;77955;28;0;0;0;0;.00nan;0;0
3358;85437;28;81;58;3;55;.948;3544000;0
3359;183844;29;21;26;6;20;.769;2784000;0
3359;174718;25;77;24;1;23;.958;3600000;0
3359;37818;29;47;8;1;7;.875;816000;0
3359;148958;25;0;0;0;0;.00nan;0;0
3360;18213;8;79;35;2;33;.943;3600000;0
3360;189644;8;0;0;0;0;.00nan;0;0
3360;149452;31;87;44;4;40;.909;3594000;0
3360;152717;31;0;0;0;0;.00nan;0;0
3361;2059;23;84;34;2;32;.941;3859000;0
3361;190465;33;94;34;1;33;.971;3859000;0
3361;197038;33;0;0;0;0;.00nan;0;0
3361;78573;23;0;0;0;0;.00nan;0;0
3362;67;11;0;0;0;0;.00nan;0;0
3362;186573;0;0;0;0;0;.00nan;0;0
3362;45323;11;58;31;4;27;.871;3673000;0
3362;59540;0;76;29;3;26;.897;3673000;0
3363;167642;18;0;0;0;0;.00nan;0;0
3363;13337;32;54;44;7;37;.841;3600000;0
3363;20432;32;0;0;0;0;.00nan;0;0
3363;173727;18;57;33;4;29;.879;3600000;0
3364;172340;4182;81;26;2;24;.923;3600000;0
3364;184229;35;0;0;0;0;.00nan;0;0
3364;57338;35;56;35;5;30;.857;3600000;0
3364;147945;4182;0;0;0;0;.00nan;0;0
3365;187537;19;65;44;5;39;.886;3600000;0
3365;163565;19;0;0;0;0;.00nan;0;0
3365;170977;30;0;0;0;0;.00nan;0;0
3365;86697;30;85;16;0;16;1.000;3600000;0
3366;166646;16;0;0;0;0;.00nan;0;0
3366;163195;15;0;0;0;0;.00nan;0;0
3366;50065;16;86;36;3;33;.917;3600000;0
3366;139409;15;100;28;0;28;1.000;3600000;0
3367;166751;5;95;55;3;52;.945;4200000;0
3367;5923;17;0;0;0;0;.00nan;0;0
3367;172398;5;0;0;0;0;.00nan;0;0
3367;178413;17;68;29;3;26;.897;4200000;0
3368;556;3;80;40;3;37;.925;3600000;0
3368;5923;17;27;31;6;25;.806;3600000;0
3368;178413;17;0;0;0;0;.00nan;0;0
3368;179344;3;0;0;0;0;.00nan;0;0
3369;174718;25;0;0;0;0;.00nan;0;0
3369;184770;22;55;29;3;26;.897;3580000;0
3369;143473;22;0;0;0;0;.00nan;0;0
3369;148958;25;92;32;1;31;.969;3600000;0
3370;165582;24;0;0;0;0;.00nan;0;0
3370;168712;14;77;33;2;31;.939;3967000;0
3370;185034;14;0;0;0;0;.00nan;0;0
3370;85727;24;82;48;3;45;.938;3967000;0
3371;676;34;0;0;0;0;.00nan;0;0
3371;187578;10;78;27;2;25;.926;3600000;0
3371;78806;34;72;30;3;27;.900;3527000;0
3371;90164;10;0;0;0;0;.00nan;0;0
3372;184229;35;74;30;3;27;.900;3994000;0
3372;190465;33;0;0;0;0;.00nan;0;0
3372;197038;33;91;54;4;50;.926;3994000;0
3372;57338;35;0;0;0;0;.00nan;0;0
3373;2059;23;0;0;0;0;.00nan;0;0
3373;78573;23;88;39;2;37;.949;3568000;0
3373;85798;12;0;0;0;0;.00nan;0;0
3373;91178;12;90;20;0;20;1.000;3600000;0
3374;187537;19;0;0;0;0;.00nan;0;0
3374;163423;26;0;0;0;0;.00nan;0;0
3374;163565;19;29;27;5;22;.815;3600000;0
3374;152835;26;65;21;2;19;.905;3600000;0
3375;3284;21;83;35;2;33;.943;3600000;0
3375;179950;4838;0;0;0;0;.00nan;0;0
3375;143156;21;0;0;0;0;.00nan;0;0
3375;143749;4838;64;33;4;29;.879;3559000;0
3376;175092;9;0;0;0;0;.00nan;0;0
3376;190106;9;81;27;1;26;.963;3600000;0
3376;77955;28;0;0;0;0;.00nan;0;0
3376;85437;28;72;28;2;26;.929;3567000;0
3377;166591;20;49;1;0;1;1.000;287000;0
3377;166646;16;96;20;0;20;1.000;3600000;0
3377;50065;16;0;0;0;0;.00nan;0;0
3377;71565;20;31;35;7;28;.800;3313000;0
3378;3284;21;0;0;0;0;.00nan;0;0
3378;166381;27;0;0;0;0;.00nan;0;0
3378;175660;27;65;22;2;20;.909;3754000;0
3378;143156;21;92;49;3;46;.939;3754000;0
3379;13337;32;0;0;0;0;.00nan;0;0
3379;20432;32;88;29;1;28;.966;3600000;0
3379;149452;31;49;44;7;37;.841;3316000;0
3379;152717;31;47;5;1;4;.800;284000;0
3380;167642;18;83;31;2;29;.935;4200000;0
3380;183844;29;78;32;2;30;.938;4200000;0
3380;173727;18;0;0;0;0;.00nan;0;0
3380;37818;29;0;0;0;0;.00nan;0;0
3381;556;3;41;27;5;22;.815;3600000;0
3381;163195;15;0;0;0;0;.00nan;0;0
3381;179344;3;0;0;0;0;.00nan;0;0
3381;139409;15;100;35;0;35;1.000;3600000;0
3382;186573;0;0;0;0;0;.00nan;0;0
3382;59540;0;86;29;1;28;.966;3619000;0
3382;85798;12;0;0;0;0;.00nan;0;0
3382;91178;12;70;24;2;22;.917;3619000;0
3383;676;34;42;31;5;26;.839;3686000;0
3383;184770;22;0;0;0;0;.00nan;0;0
3383;78806;34;0;0;0;0;.00nan;0;0
3383;143473;22;75;44;6;38;.864;3686000;0
3384;5923;17;0;0;0;0;.00nan;0;0
3384;178413;17;94;35;1;34;.971;3600000;0
3384;174718;25;39;34;5;29;.853;3600000;0
3384;148958;25;0;0;0;0;.00nan;0;0
3385;165582;24;0;0;0;0;.00nan;0;0
3385;175092;9;84;30;2;28;.933;3600000;0
3385;190106;9;0;0;0;0;.00nan;0;0
3385;85727;24;63;29;3;26;.897;3554000;0
3386;187578;10;62;22;2;20;.909;3557000;0
3386;166751;5;92;37;1;36;.973;3600000;0
3386;172398;5;0;0;0;0;.00nan;0;0
3386;90164;10;0;0;0;0;.00nan;0;0
3387;18213;8;100;34;1;33;.971;3600000;0
3387;168712;14;36;27;6;21;.778;3600000;0
3387;189644;8;0;0;0;0;.00nan;0;0
3387;185034;14;0;0;0;0;.00nan;0;0
3388;172340;4182;40;23;4;19;.826;3600000;0
3388;183844;29;0;0;0;0;.00nan;0;0
3388;37818;29;74;23;1;22;.957;3600000;0
3388;147945;4182;0;0;0;0;.00nan;0;0
3389;67;11;0;0;0;0;.00nan;0;0
3389;2059;23;68;28;3;25;.893;3600000;0
3389;45323;11;81;46;4;42;.913;3554000;0
3389;78573;23;0;0;0;0;.00nan;0;0
3390;187537;19;65;36;4;32;.889;3600000;0
3390;163565;19;0;0;0;0;.00nan;0;0
3390;149452;31;0;0;0;0;.00nan;0;0
3390;152717;31;60;40;5;35;.875;3595000;0
3391;163423;26;0;0;0;0;.00nan;0;0
3391;179950;4838;0;0;0;0;.00nan;0;0
3391;143749;4838;76;22;1;21;.955;3600000;0
3391;152835;26;57;25;3;22;.880;3542000;0
3392;3284;21;42;17;3;14;.824;3600000;0
3392;77955;28;0;0;0;0;.00nan;0;0
3392;85437;28;49;38;6;32;.842;3600000;0
3392;143156;21;0;0;0;0;.00nan;0;0
3393;166646;16;82;23;1;22;.957;3600000;0
3393;184229;35;0;0;0;0;.00nan;0;0
3393;50065;16;0;0;0;0;.00nan;0;0
3393;57338;35;79;41;4;37;.902;3600000;0
3394;167642;18;0;0;0;0;.00nan;0;0
3394;173727;18;84;14;0;14;1.000;3600000;0
3394;190465;33;0;0;0;0;.00nan;0;0
3394;197038;33;81;35;3;32;.914;3600000;0
3395;676;34;0;0;0;0;.00nan;0;0
3395;175092;9;0;0;0;0;.00nan;0;0
3395;190106;9;65;43;5;38;.884;3600000;0
3395;78806;34;79;35;2;33;.943;3600000;0
3396;166751;5;71;35;3;32;.914;3600000;0
3396;172398;5;0;0;0;0;.00nan;0;0
3396;168712;14;0;0;0;0;.00nan;0;0
3396;185034;14;31;20;4;16;.800;3543000;0
3397;166591;20;31;28;6;22;.786;2415000;0
3397;184770;22;0;0;0;0;.00nan;0;0
3397;71565;20;77;19;1;18;.947;1185000;0
3397;143473;22;88;13;0;13;1.000;3600000;0
3398;556;3;79;27;1;26;.963;3600000;0
3398;187578;10;30;22;5;17;.773;3600000;0
3398;179344;3;0;0;0;0;.00nan;0;0
3398;90164;10;0;0;0;0;.00nan;0;0
3399;163195;15;0;0;0;0;.00nan;0;0
3399;174718;25;0;0;0;0;.00nan;0;0
3399;139409;15;53;25;3;22;.880;3513000;0
3399;148958;25;94;35;1;34;.971;3600000;0
3400;85798;12;0;0;0;0;.00nan;0;0
3400;91178;12;61;18;2;16;.889;3600000;0
3400;149452;31;0;0;0;0;.00nan;0;0
3400;152717;31;90;55;5;50;.909;3600000;0
3401;18213;8;71;16;1;15;.938;3600000;0
3401;189644;8;0;0;0;0;.00nan;0;0
3401;186573;0;0;0;0;0;.00nan;0;0
3401;59540;0;65;43;6;37;.860;3600000;0
3402;187537;19;71;21;1;20;.952;3600000;0
3402;5923;17;0;0;0;0;.00nan;0;0
3402;163565;19;0;0;0;0;.00nan;0;0
3402;178413;17;75;34;2;32;.941;3600000;0
3403;2059;23;78;30;2;28;.933;3785000;0
3403;183844;29;80;38;3;35;.921;3785000;0
3403;37818;29;0;0;0;0;.00nan;0;0
3403;78573;23;0;0;0;0;.00nan;0;0
3404;172340;4182;60;27;3;24;.889;3573000;0
3404;167642;18;0;0;0;0;.00nan;0;0
3404;173727;18;69;27;2;25;.926;3600000;0
3404;147945;4182;0;0;0;0;.00nan;0;0
3405;67;11;0;0;0;0;.00nan;0;0
3405;190465;33;100;32;0;32;1.000;3600000;0
3405;197038;33;0;0;0;0;.00nan;0;0
3405;45323;11;59;32;3;29;.906;3600000;0
3406;163423;26;0;0;0;0;.00nan;0;0
3406;170977;30;0;0;0;0;.00nan;0;0
3406;86697;30;77;30;2;28;.933;3600000;0
3406;152835;26;34;24;5;19;.792;3600000;0
3407;166381;27;0;0;0;0;.00nan;0;0
3407;175660;27;62;24;2;22;.917;3600000;0
3407;179950;4838;0;0;0;0;.00nan;0;0
3407;143749;4838;64;32;3;29;.906;3576000;0
3408;676;34;79;25;1;24;.960;3600000;0
3408;166751;5;0;0;0;0;.00nan;0;0
3408;172398;5;76;39;3;36;.923;3564000;0
3408;78806;34;0;0;0;0;.00nan;0;0
3409;166591;20;0;0;0;0;.00nan;0;0
3409;165582;24;72;28;3;25;.893;3623000;0
3409;71565;20;65;25;2;23;.920;3623000;0
3409;85727;24;0;0;0;0;.00nan;0;0
3410;163195;15;0;0;0;0;.00nan;0;0
3410;77955;28;68;13;1;12;.923;947000;0
3410;85437;28;24;39;8;31;.795;2653000;0
3410;139409;15;64;24;2;22;.917;3600000;0
3411;3284;21;84;49;4;45;.918;3575000;0
3411;184770;22;47;20;3;17;.850;3600000;0
3411;143156;21;0;0;0;0;.00nan;0;0
3411;143473;22;0;0;0;0;.00nan;0;0
3412;166646;16;44;28;4;24;.857;4200000;0
3412;186573;0;87;54;4;50;.926;4200000;0
3412;50065;16;0;0;0;0;.00nan;0;0
3412;59540;0;0;0;0;0;.00nan;0;0
3413;13337;32;0;0;0;0;.00nan;0;0
3413;20432;32;80;38;3;35;.921;4200000;0
3413;184229;35;0;0;0;0;.00nan;0;0
3413;57338;35;49;27;3;24;.889;4200000;0
3414;163423;26;0;0;0;0;.00nan;0;0
3414;166381;27;54;16;2;14;.875;3600000;0
3414;175660;27;0;0;0;0;.00nan;0;0
3414;152835;26;84;47;4;43;.915;3550000;0
3415;187578;10;95;51;2;49;.961;3600000;0
3415;5923;17;0;0;0;0;.00nan;0;0
3415;178413;17;31;15;4;11;.733;3558000;0
3415;90164;10;0;0;0;0;.00nan;0;0
3416;168712;14;72;34;3;31;.912;3583000;0
3416;174718;25;81;26;1;25;.962;3600000;0
3416;185034;14;0;0;0;0;.00nan;0;0
3416;148958;25;0;0;0;0;.00nan;0;0
3417;167642;18;0;0;0;0;.00nan;0;0
3417;173727;18;72;31;3;28;.903;3758000;0
3417;179950;4838;0;0;0;0;.00nan;0;0
3417;143749;4838;80;43;4;39;.907;3758000;0
3418;67;11;0;0;0;0;.00nan;0;0
3418;183844;29;69;21;1;20;.952;3600000;0
3418;37818;29;0;0;0;0;.00nan;0;0
3418;45323;11;36;28;5;23;.821;3600000;0
3419;187578;10;0;0;0;0;.00nan;0;0
3419;186573;0;0;0;0;0;.00nan;0;0
3419;59540;0;47;25;4;21;.840;3870000;0
3419;90164;10;76;48;3;45;.938;3884000;0
3420;556;3;95;37;2;35;.946;3600000;0
3420;179344;3;0;0;0;0;.00nan;0;0
3420;77955;28;0;0;0;0;.00nan;0;0
3420;85437;28;41;29;5;24;.828;3600000;0
3421;13337;32;0;0;0;0;.00nan;0;0
3421;20432;32;82;41;3;38;.927;3600000;0
3421;175092;9;51;14;2;12;.857;1702000;0
3421;190106;9;31;26;6;20;.769;1898000;0
3422;166591;20;0;0;0;0;.00nan;0;0
3422;166751;5;68;31;4;27;.871;3902000;0
3422;172398;5;0;0;0;0;.00nan;0;0
3422;71565;20;60;27;3;24;.889;3902000;0
3423;187537;19;95;44;1;43;.977;4200000;0
3423;163565;19;0;0;0;0;.00nan;0;0
3423;149452;31;0;0;0;0;.00nan;0;0
3423;152717;31;87;33;1;32;.970;4200000;0
3424;163195;15;0;0;0;0;.00nan;0;0
3424;190465;33;72;28;2;26;.929;3600000;0
3424;197038;33;0;0;0;0;.00nan;0;0
3424;139409;15;74;34;3;31;.912;3556000;0
3425;5923;17;57;40;5;35;.875;3533000;0
3425;163423;26;0;0;0;0;.00nan;0;0
3425;178413;17;0;0;0;0;.00nan;0;0
3425;152835;26;100;48;3;45;.938;3600000;0
3426;18213;8;97;29;2;27;.931;4200000;0
3426;184229;35;0;0;0;0;.00nan;0;0
3426;189644;8;0;0;0;0;.00nan;0;0
3426;57338;35;82;32;2;30;.938;4200000;0
3427;172340;4182;97;33;1;32;.970;4200000;0
3427;179950;4838;98;38;1;37;.974;4200000;0
3427;143749;4838;0;0;0;0;.00nan;0;0
3427;147945;4182;0;0;0;0;.00nan;0;0
3428;174718;25;0;0;0;0;.00nan;0;0
3428;85798;12;83;42;3;39;.929;3849000;0
3428;91178;12;0;0;0;0;.00nan;0;0
3428;148958;25;82;34;2;32;.941;3849000;0
3429;2059;23;36;33;6;27;.818;2631000;0
3429;165582;24;0;0;0;0;.00nan;0;0
3429;78573;23;49;8;1;7;.875;969000;0
3429;85727;24;66;33;4;29;.879;3600000;0
3430;676;34;0;0;0;0;.00nan;0;0
3430;170977;30;0;0;0;0;.00nan;0;0
3430;78806;34;69;30;2;28;.933;3600000;0
3430;86697;30;60;27;3;24;.889;3600000;0
3431;3284;21;64;45;5;40;.889;3600000;0
3431;184770;22;0;0;0;0;.00nan;0;0
3431;143156;21;0;0;0;0;.00nan;0;0
3431;143473;22;64;24;3;21;.875;3600000;0
3432;167642;18;0;0;0;0;.00nan;0;0
3432;18213;8;39;9;2;7;.778;637000;0
3432;173727;18;60;13;1;12;.923;3600000;0
3432;189644;8;36;34;6;28;.824;2963000;0
3433;187537;19;58;35;5;30;.857;3600000;0
3433;163565;19;0;0;0;0;.00nan;0;0
3433;183844;29;57;30;4;26;.867;3600000;0
3433;37818;29;0;0;0;0;.00nan;0;0
3434;3284;21;0;0;0;0;.00nan;0;0
3434;163195;15;0;0;0;0;.00nan;0;0
3434;139409;15;57;15;2;13;.867;3600000;0
3434;143156;21;78;38;3;35;.921;3555000;0
3435;168712;14;79;14;0;14;1.000;3600000;0
3435;185034;14;0;0;0;0;.00nan;0;0
3435;186573;0;0;0;0;0;.00nan;0;0
3435;59540;0;82;30;2;28;.933;3586000;0
3436;556;3;100;41;0;41;1.000;3600000;0
3436;179344;3;0;0;0;0;.00nan;0;0
3436;175092;9;0;0;0;0;.00nan;0;0
3436;190106;9;81;37;2;35;.946;3516000;0
3437;166751;5;75;31;2;29;.935;4200000;0
3437;172398;5;0;0;0;0;.00nan;0;0
3437;77955;28;0;0;0;0;.00nan;0;0
3437;85437;28;77;38;2;36;.947;4200000;0
3438;13337;32;0;0;0;0;.00nan;0;0
3438;20432;32;75;29;2;27;.931;3600000;0
3438;149452;31;44;32;6;26;.813;3600000;0
3438;152717;31;0;0;0;0;.00nan;0;0
3439;184229;35;0;0;0;0;.00nan;0;0
3439;174718;25;0;0;0;0;.00nan;0;0
3439;57338;35;72;30;2;28;.933;3600000;0
3439;148958;25;43;21;3;18;.857;3591000;0
3440;163423;26;0;0;0;0;.00nan;0;0
3440;190465;33;53;34;4;30;.882;3600000;0
3440;197038;33;0;0;0;0;.00nan;0;0
3440;152835;26;67;29;3;26;.897;3600000;0
3441;166646;16;0;0;0;0;.00nan;0;0
3441;50065;16;76;30;2;28;.933;3600000;0
3441;85798;12;0;0;0;0;.00nan;0;0
3441;91178;12;85;40;3;37;.925;3600000;0
3442;67;11;0;0;0;0;.00nan;0;0
3442;165582;24;0;0;0;0;.00nan;0;0
3442;45323;11;56;34;4;30;.882;4200000;0
3442;85727;24;59;30;4;26;.867;4200000;0
3443;2059;23;82;23;1;22;.957;3600000;0
3443;179950;4838;0;0;0;0;.00nan;0;0
3443;78573;23;0;0;0;0;.00nan;0;0
3443;143749;4838;77;29;2;27;.931;3600000;0
3444;166381;27;0;0;0;0;.00nan;0;0
3444;170977;30;0;0;0;0;.00nan;0;0
3444;175660;27;61;20;3;17;.850;3600000;0
3444;86697;30;65;33;4;29;.879;3552000;0
3445;5923;17;0;0;0;0;.00nan;0;0
3445;13337;32;65;47;5;42;.894;3534000;0
3445;178413;17;74;35;3;32;.914;3600000;0
3445;20432;32;0;0;0;0;.00nan;0;0
3446;166591;20;0;0;0;0;.00nan;0;0
3446;187578;10;81;26;1;25;.962;3600000;0
3446;71565;20;77;39;3;36;.923;3524000;0
3446;90164;10;0;0;0;0;.00nan;0;0
3447;676;34;0;0;0;0;.00nan;0;0
3447;166381;27;79;34;2;32;.941;4200000;0
3447;175660;27;0;0;0;0;.00nan;0;0
3447;78806;34;75;34;2;32;.941;4128000;0
3448;163195;15;0;0;0;0;.00nan;0;0
3448;184229;35;0;0;0;0;.00nan;0;0
3448;57338;35;95;44;1;43;.977;4200000;0
3448;139409;15;84;25;1;24;.960;4199000;0
3449;183844;29;0;0;0;0;.00nan;0;0
3449;168712;14;54;26;3;23;.885;3600000;0
3449;185034;14;0;0;0;0;.00nan;0;0
3449;37818;29;48;30;4;26;.867;3558000;0
3450;67;11;48;37;5;32;.865;3592000;0
3450;167642;18;0;0;0;0;.00nan;0;0
3450;173727;18;58;22;3;19;.864;3600000;0
3450;45323;11;0;0;0;0;.00nan;0;0
3451;163423;26;0;0;0;0;.00nan;0;0
3451;85798;12;58;24;3;21;.875;3550000;0
3451;91178;12;0;0;0;0;.00nan;0;0
3451;152835;26;83;31;2;29;.935;3600000;0
3452;187537;19;56;19;2;17;.895;3600000;0
3452;163565;19;0;0;0;0;.00nan;0;0
3452;77955;28;0;0;0;0;.00nan;0;0
3452;85437;28;76;34;3;31;.912;3600000;0
3453;556;3;22;18;5;13;.722;3600000;0
3453;179344;3;0;0;0;0;.00nan;0;0
3453;186573;0;0;0;0;0;.00nan;0;0
3453;59540;0;100;56;2;54;.964;3600000;0
3454;166591;20;18;20;6;14;.700;1484000;0
3454;5923;17;77;33;2;31;.939;3600000;0
3454;178413;17;0;0;0;0;.00nan;0;0
3454;71565;20;48;22;3;19;.864;2116000;0
3455;166751;5;91;28;1;27;.964;3600000;0
3455;172398;5;0;0;0;0;.00nan;0;0
3455;175092;9;0;0;0;0;.00nan;0;0
3455;190106;9;73;38;3;35;.921;3539000;0
3456;184770;22;0;0;0;0;.00nan;0;0
3456;143473;22;74;19;1;18;.947;3600000;0
3456;149452;31;0;0;0;0;.00nan;0;0
3456;152717;31;96;50;4;46;.920;3600000;0
3457;166646;16;50;20;3;17;.850;3600000;0
3457;3284;21;57;44;5;39;.886;3600000;0
3457;50065;16;0;0;0;0;.00nan;0;0
3457;143156;21;0;0;0;0;.00nan;0;0
3458;170977;30;57;6;0;6;1.000;872000;0
3458;174718;25;57;29;4;25;.862;3600000;0
3458;86697;30;32;26;5;21;.808;2716000;0
3458;148958;25;0;0;0;0;.00nan;0;0
3459;18213;8;72;20;2;18;.900;3600000;0
3459;189644;8;0;0;0;0;.00nan;0;0
3459;190465;33;40;30;5;25;.833;3176000;0
3459;197038;33;35;12;3;9;.750;424000;0
3460;172340;4182;74;24;2;22;.917;3600000;0
3460;165582;24;0;0;0;0;.00nan;0;0
3460;85727;24;54;23;3;20;.870;3586000;0
3460;147945;4182;0;0;0;0;.00nan;0;0
3461;187578;10;83;43;3;40;.930;3600000;0
3461;13337;32;0;0;0;0;.00nan;0;0
3461;20432;32;45;29;5;24;.828;3600000;0
3461;90164;10;0;0;0;0;.00nan;0;0
3462;676;34;0;0;0;0;.00nan;0;0
3462;179950;4838;55;16;2;14;.875;3600000;0
3462;78806;34;75;47;5;42;.894;3600000;0
3462;143749;4838;0;0;0;0;.00nan;0;0
3463;184229;35;0;0;0;0;.00nan;0;0
3463;57338;35;82;25;1;24;.960;3600000;0
3463;77955;28;76;38;4;34;.895;3600000;0
3463;85437;28;0;0;0;0;.00nan;0;0
3464;170977;30;0;0;0;0;.00nan;0;0
3464;190465;33;0;0;0;0;.00nan;0;0
3464;197038;33;63;39;4;35;.897;3657000;0
3464;86697;30;35;23;5;18;.783;3657000;0
3465;2059;23;87;33;2;31;.939;3600000;0
3465;166381;27;0;0;0;0;.00nan;0;0
3465;175660;27;47;13;3;10;.769;3600000;0
3465;78573;23;0;0;0;0;.00nan;0;0
3466;167642;18;37;24;5;19;.792;3600000;0
3466;165582;24;31;23;6;17;.739;2961000;0
3466;173727;18;0;0;0;0;.00nan;0;0
3466;85727;24;38;6;2;4;.667;639000;0
3467;187537;19;100;31;1;30;.968;3600000;0
3467;3284;21;63;44;4;40;.909;3600000;0
3467;163565;19;0;0;0;0;.00nan;0;0
3467;143156;21;0;0;0;0;.00nan;0;0
3468;556;3;45;39;6;33;.846;3600000;0
3468;179344;3;0;0;0;0;.00nan;0;0
3468;184770;22;0;0;0;0;.00nan;0;0
3468;143473;22;89;28;1;27;.964;3600000;0
3469;166591;20;0;0;0;0;.00nan;0;0
3469;18213;8;47;26;5;21;.808;3780000;0
3469;189644;8;0;0;0;0;.00nan;0;0
3469;71565;20;67;31;4;27;.871;3780000;0
3470;183844;29;61;23;2;21;.913;3600000;0
3470;37818;29;0;0;0;0;.00nan;0;0
3470;149452;31;56;40;5;35;.875;3600000;0
3470;152717;31;0;0;0;0;.00nan;0;0
3471;166646;16;58;19;2;17;.895;3600000;0
3471;50065;16;0;0;0;0;.00nan;0;0
3471;85798;12;0;0;0;0;.00nan;0;0
3471;91178;12;51;45;6;39;.867;3600000;0
3472;67;11;0;0;0;0;.00nan;0;0
3472;172340;4182;0;0;0;0;.00nan;0;0
3472;45323;11;67;27;2;25;.926;4200000;0
3472;147945;4182;95;40;2;38;.950;4200000;0
3806;2059;23;0;0;0;0;.00nan;0;0
3806;183844;29;0;0;0;0;.00nan;0;0
3806;37818;29;37;27;5;22;.815;3600000;0
3806;78573;23;98;30;1;29;.967;3600000;0
3808;171838;31;93;45;2;43;.956;3600000;0
3808;13337;32;0;0;0;0;.00nan;0;0
3808;194264;31;0;0;0;0;.00nan;0;0
3808;20432;32;63;27;3;24;.889;3600000;0
3810;67;11;0;0;0;0;.00nan;0;0
3810;190465;33;0;0;0;0;.00nan;0;0
3810;197038;33;40;17;3;14;.824;3545000;0
3810;45323;11;75;31;2;29;.935;3600000;0
3812;166646;16;75;22;1;21;.955;3600000;0
3812;5923;17;0;0;0;0;.00nan;0;0
3812;166441;16;0;0;0;0;.00nan;0;0
3812;178413;17;84;41;2;39;.951;3569000;0
3814;166591;20;0;0;0;0;.00nan;0;0
3814;166751;5;65;33;4;29;.879;3593000;0
3814;172398;5;0;0;0;0;.00nan;0;0
3814;71565;20;81;33;2;31;.939;3600000;0
3816;192733;18;0;0;0;0;.00nan;0;0
3816;172340;4182;36;18;4;14;.778;3600000;0
3816;173727;18;99;38;1;37;.974;3600000;0
3816;169868;4182;0;0;0;0;.00nan;0;0
3818;3928;15;56;5;0;5;1.000;910000;0
3818;165582;24;0;0;0;0;.00nan;0;0
3818;75268;15;16;35;7;28;.800;2690000;0
3818;85727;24;93;44;2;42;.955;3600000;0
3820;163423;26;0;0;0;0;.00nan;0;0
3820;184770;22;0;0;0;0;.00nan;0;0
3820;143473;22;73;23;1;22;.957;3600000;0
3820;152835;26;72;36;3;33;.917;3541000;0
3822;187537;19;86;31;1;30;.968;3600000;0
3822;163565;19;0;0;0;0;.00nan;0;0
3822;166381;27;60;33;4;29;.879;3600000;0
3822;175660;27;0;0;0;0;.00nan;0;0
3824;187578;10;0;0;0;0;.00nan;0;0
3824;168712;14;64;30;3;27;.900;3600000;0
3824;185034;14;0;0;0;0;.00nan;0;0
3824;90164;10;90;49;4;45;.918;3600000;0
3826;163195;0;0;0;0;0;.00nan;0;0
3826;175092;9;64;34;3;31;.912;3567000;0
3826;190106;9;0;0;0;0;.00nan;0;0
3826;139409;0;62;23;2;21;.913;3600000;0
3828;179344;3;81;36;2;34;.944;3569000;0
3828;187295;4838;0;0;0;0;.00nan;0;0
3828;192457;3;0;0;0;0;.00nan;0;0
3828;143749;4838;92;33;1;32;.970;3600000;0
3830;18213;8;77;47;4;43;.915;3597000;0
3830;189644;8;0;0;0;0;.00nan;0;0
3830;85798;12;64;23;2;21;.913;3600000;0
3830;91178;12;0;0;0;0;.00nan;0;0
3832;31;21;0;0;0;0;.00nan;0;0
3832;57338;35;77;39;3;36;.923;3600000;0
3832;141998;35;0;0;0;0;.00nan;0;0
3832;143156;21;41;22;4;18;.818;3577000;0
3834;676;34;76;42;3;39;.929;3600000;0
3834;174718;25;0;0;0;0;.00nan;0;0
3834;78806;34;0;0;0;0;.00nan;0;0
3834;148958;25;73;26;2;24;.923;3600000;0
3836;170977;30;0;0;0;0;.00nan;0;0
3836;77955;28;97;42;2;40;.952;4200000;0
3836;85437;28;0;0;0;0;.00nan;0;0
3836;86697;30;86;44;2;42;.955;4200000;0
3838;190465;33;76;29;2;27;.931;3600000;0
3838;197038;33;0;0;0;0;.00nan;0;0
3838;57338;35;57;34;4;30;.882;3567000;0
3838;141998;35;0;0;0;0;.00nan;0;0
3840;18213;8;53;41;6;35;.854;3567000;0
3840;189644;8;0;0;0;0;.00nan;0;0
3840;187295;4838;0;0;0;0;.00nan;0;0
3840;143749;4838;45;28;5;23;.821;3600000;0
3842;187578;10;52;23;3;20;.870;3523000;0
3842;166381;27;0;0;0;0;.00nan;0;0
3842;175660;27;96;31;1;30;.968;3600000;0
3842;90164;10;0;0;0;0;.00nan;0;0
3844;179344;3;82;30;2;28;.933;3600000;0
3844;184770;22;0;0;0;0;.00nan;0;0
3844;192457;3;0;0;0;0;.00nan;0;0
3844;143473;22;59;25;3;22;.880;3547000;0
3846;192733;18;0;0;0;0;.00nan;0;0
3846;168712;14;49;35;6;29;.829;2778000;0
3846;173727;18;57;20;3;17;.850;3600000;0
3846;185034;14;59;8;0;8;1.000;822000;0
3848;172340;4182;98;40;1;39;.975;3592000;0
3848;169868;4182;0;0;0;0;.00nan;0;0
3848;174718;25;86;20;0;20;1.000;3600000;0
3848;148958;25;0;0;0;0;.00nan;0;0
3850;171838;31;49;30;5;25;.833;3600000;0
3850;163423;26;0;0;0;0;.00nan;0;0
3850;194264;31;0;0;0;0;.00nan;0;0
3850;152835;26;100;25;0;25;1.000;3600000;0
3852;31;21;0;0;0;0;.00nan;0;0
3852;5923;17;0;0;0;0;.00nan;0;0
3852;178413;17;99;42;1;41;.976;3600000;0
3852;143156;21;71;36;3;33;.917;3577000;0
3854;163195;0;0;0;0;0;.00nan;0;0
3854;175092;9;0;0;0;0;.00nan;0;0
3854;190106;9;74;33;3;30;.909;3810000;0
3854;139409;0;87;34;2;32;.941;3810000;0
3856;166646;16;47;8;1;7;.875;3600000;0
3856;166441;16;0;0;0;0;.00nan;0;0
3856;77955;28;68;12;0;12;1.000;1239000;0
3856;85437;28;42;37;6;31;.838;2361000;0
3858;165582;24;0;0;0;0;.00nan;0;0
3858;85727;24;63;44;5;39;.886;3600000;0
3858;85798;12;91;24;1;23;.958;3600000;0
3858;91178;12;0;0;0;0;.00nan;0;0
3860;67;11;0;0;0;0;.00nan;0;0
3860;183844;29;0;0;0;0;.00nan;0;0
3860;37818;29;73;25;2;23;.920;3600000;0
3860;45323;11;74;63;6;57;.905;3600000;0
3862;676;34;72;17;1;16;.941;3600000;0
3862;13337;32;0;0;0;0;.00nan;0;0
3862;20432;32;91;38;2;36;.947;3568000;0
3862;78806;34;0;0;0;0;.00nan;0;0
3864;166751;5;60;34;4;30;.882;3569000;0
3864;172398;5;0;0;0;0;.00nan;0;0
3864;170977;30;0;0;0;0;.00nan;0;0
3864;86697;30;47;16;3;13;.813;3600000;0
3866;187537;19;0;0;0;0;.00nan;0;0
3866;2059;23;0;0;0;0;.00nan;0;0
3866;163565;19;77;34;3;31;.912;3951000;0
3866;78573;23;76;34;2;32;.941;3951000;0
3868;166591;20;0;0;0;0;.00nan;0;0
3868;3928;15;98;21;0;21;1.000;3600000;0
3868;71565;20;98;53;1;52;.981;3591000;0
3868;75268;15;0;0;0;0;.00nan;0;0
3870;676;34;0;0;0;0;.00nan;0;0
3870;166646;16;40;22;4;18;.818;3562000;0
3870;50065;16;0;0;0;0;.00nan;0;0
3870;78806;34;84;35;2;33;.943;3600000;0
3872;192733;18;99;37;1;36;.973;3600000;0
3872;2059;23;79;27;2;25;.926;3593000;0
3872;173727;18;0;0;0;0;.00nan;0;0
3872;78573;23;0;0;0;0;.00nan;0;0
3874;5923;17;33;26;5;21;.808;3595000;0
3874;178413;17;0;0;0;0;.00nan;0;0
3874;168712;14;0;0;0;0;.00nan;0;0
3874;185034;14;88;45;3;42;.933;3600000;0
3876;187578;10;0;0;0;0;.00nan;0;0
3876;18213;8;0;0;0;0;.00nan;0;0
3876;189644;8;76;34;2;32;.941;3544000;0
3876;90164;10;90;34;1;33;.971;3600000;0
3878;31;21;78;38;3;35;.921;3600000;0
3878;172340;4182;0;0;0;0;.00nan;0;0
3878;169868;4182;36;31;6;25;.806;3600000;0
3878;143156;21;0;0;0;0;.00nan;0;0
3880;187295;4838;87;19;0;19;1.000;3600000;0
3880;77955;28;84;42;4;38;.905;3600000;0
3880;85437;28;0;0;0;0;.00nan;0;0
3880;143749;4838;0;0;0;0;.00nan;0;0
3882;556;3;74;33;3;30;.909;3514000;0
3882;170977;30;0;0;0;0;.00nan;0;0
3882;179344;3;0;0;0;0;.00nan;0;0
3882;86697;30;100;47;1;46;.979;3600000;0
3884;166591;20;64;37;3;34;.919;4200000;0
3884;183844;29;63;26;3;23;.885;4200000;0
3884;37818;29;0;0;0;0;.00nan;0;0
3884;71565;20;0;0;0;0;.00nan;0;0
3886;165582;24;29;6;3;3;.500;328000;0
3886;57338;35;0;0;0;0;.00nan;0;0
3886;85727;24;59;23;2;21;.913;3272000;0
3886;141998;35;54;29;4;25;.862;3600000;0
3888;67;11;58;30;3;27;.900;3514000;0
3888;190465;33;0;0;0;0;.00nan;0;0
3888;197038;33;84;22;1;21;.955;3600000;0
3888;45323;11;0;0;0;0;.00nan;0;0
3890;13337;32;72;29;2;27;.931;3600000;0
3890;20432;32;0;0;0;0;.00nan;0;0
3890;175092;9;63;41;5;36;.878;3600000;0
3890;190106;9;0;0;0;0;.00nan;0;0
3892;163195;0;62;38;4;34;.895;3600000;0
3892;174718;25;100;29;0;29;1.000;3600000;0
3892;139409;0;0;0;0;0;.00nan;0;0
3892;148958;25;0;0;0;0;.00nan;0;0
3894;184770;22;81;31;2;29;.935;3688000;0
3894;85798;12;0;0;0;0;.00nan;0;0
3894;91178;12;96;28;1;27;.964;3688000;0
3894;143473;22;0;0;0;0;.00nan;0;0
3896;171838;31;0;0;0;0;.00nan;0;0
3896;3928;15;39;9;3;6;.667;3600000;0
3896;194264;31;63;56;7;49;.875;3600000;0
3896;75268;15;0;0;0;0;.00nan;0;0
3898;166751;5;0;0;0;0;.00nan;0;0
3898;172398;5;59;37;5;32;.865;3600000;0
3898;166381;27;71;24;2;22;.917;3600000;0
3898;175660;27;0;0;0;0;.00nan;0;0
3900;187537;19;79;30;2;28;.933;3600000;0
3900;163423;26;0;0;0;0;.00nan;0;0
3900;163565;19;0;0;0;0;.00nan;0;0
3900;152835;26;58;32;4;28;.875;3513000;0
3902;556;3;89;42;3;39;.929;3568000;0
3902;187537;19;79;31;2;29;.935;3600000;0
3902;163565;19;0;0;0;0;.00nan;0;0
3902;179344;3;0;0;0;0;.00nan;0;0
3904;165582;24;0;0;0;0;.00nan;0;0
3904;174718;25;96;21;0;21;1.000;3600000;0
3904;85727;24;79;37;4;33;.892;3600000;0
3904;148958;25;0;0;0;0;.00nan;0;0
3906;187578;10;100;41;1;40;.976;3600000;0
3906;168712;14;56;24;3;21;.875;3600000;0
3906;185034;14;0;0;0;0;.00nan;0;0
3906;90164;10;0;0;0;0;.00nan;0;0
3908;166381;27;49;29;4;25;.862;3600000;0
3908;175660;27;0;0;0;0;.00nan;0;0
3908;85798;12;0;0;0;0;.00nan;0;0
3908;91178;12;71;17;1;16;.941;3600000;0
3910;166751;5;76;37;4;33;.892;3577000;0
3910;163423;26;0;0;0;0;.00nan;0;0
3910;172398;5;0;0;0;0;.00nan;0;0
3910;152835;26;80;31;2;29;.935;3600000;0
3912;170977;30;0;0;0;0;.00nan;0;0
3912;77955;28;99;31;1;30;.968;3600000;0
3912;85437;28;0;0;0;0;.00nan;0;0
3912;86697;30;69;21;2;19;.905;3581000;0
3914;183844;29;62;17;1;16;.941;1434000;0
3914;37818;29;51;42;6;36;.857;2166000;0
3914;187295;4838;46;18;3;15;.833;3600000;0
3914;143749;4838;0;0;0;0;.00nan;0;0
3916;3928;15;0;0;0;0;.00nan;0;0
3916;163195;0;0;0;0;0;.00nan;0;0
3916;75268;15;59;19;2;17;.895;3600000;0
3916;139409;0;72;33;3;30;.909;3561000;0
3918;18213;8;56;24;3;21;.875;3549000;0
3918;189644;8;0;0;0;0;.00nan;0;0
3918;190465;33;84;32;2;30;.938;3600000;0
3918;197038;33;0;0;0;0;.00nan;0;0
3920;31;21;0;0;0;0;.00nan;0;0
3920;166591;20;48;0;0;0;.00nan;459000;0
3920;71565;20;41;32;6;26;.813;3141000;0
3920;143156;21;76;30;2;28;.933;3600000;0
3922;2059;23;37;18;4;14;.778;3600000;0
3922;57338;35;91;33;1;32;.970;3600000;0
3922;78573;23;0;0;0;0;.00nan;0;0
3922;141998;35;0;0;0;0;.00nan;0;0
3924;192733;18;0;0;0;0;.00nan;0;0
3924;173727;18;72;17;1;16;.941;3600000;0
3924;184770;22;0;0;0;0;.00nan;0;0
3924;143473;22;74;41;3;38;.927;3544000;0
3926;676;34;63;21;2;19;.905;3600000;0
3926;175092;9;0;0;0;0;.00nan;0;0
3926;190106;9;79;42;4;38;.905;3600000;0
3926;78806;34;0;0;0;0;.00nan;0;0
3928;67;11;0;0;0;0;.00nan;0;0
3928;171838;31;92;45;3;42;.933;3547000;0
3928;194264;31;0;0;0;0;.00nan;0;0
3928;45323;11;63;21;2;19;.905;3600000;0
3930;5923;17;0;0;0;0;.00nan;0;0
3930;13337;32;0;0;0;0;.00nan;0;0
3930;178413;17;62;22;2;20;.909;3546000;0
3930;20432;32;100;35;1;34;.971;3600000;0
3932;166646;16;74;31;4;27;.871;4200000;0
3932;172340;4182;51;34;4;30;.882;4200000;0
3932;169868;4182;0;0;0;0;.00nan;0;0
3932;50065;16;0;0;0;0;.00nan;0;0
3934;67;11;65;30;3;27;.900;4200000;0
3934;175092;9;75;30;3;27;.900;4200000;0
3934;190106;9;0;0;0;0;.00nan;0;0
3934;45323;11;0;0;0;0;.00nan;0;0
3936;676;34;0;0;0;0;.00nan;0;0
3936;170977;30;0;0;0;0;.00nan;0;0
3936;78806;34;90;25;1;24;.960;3600000;0
3936;86697;30;63;36;3;33;.917;3587000;0
3938;5923;17;56;41;5;36;.878;3600000;0
3938;166381;27;0;0;0;0;.00nan;0;0
3938;178413;17;0;0;0;0;.00nan;0;0
3938;175660;27;72;26;2;24;.923;3600000;0
3940;556;3;50;3;0;3;1.000;365000;0
3940;179344;3;33;31;6;25;.806;3235000;0
3940;190465;33;0;0;0;0;.00nan;0;0
3940;197038;33;84;38;3;35;.921;3600000;0
3942;13337;32;56;27;3;24;.889;3600000;0
3942;18213;8;0;0;0;0;.00nan;0;0
3942;20432;32;0;0;0;0;.00nan;0;0
3942;189644;8;72;28;2;26;.929;3600000;0
3944;192733;18;68;20;1;19;.950;3600000;0
3944;2059;23;0;0;0;0;.00nan;0;0
3944;173727;18;0;0;0;0;.00nan;0;0
3944;78573;23;94;37;2;35;.946;3600000;0
3946;3928;15;46;20;3;17;.850;3600000;0
3946;75268;15;0;0;0;0;.00nan;0;0
3946;77955;28;22;28;7;21;.750;2422000;0
3946;85437;28;34;18;4;14;.778;1178000;0
3948;166591;20;86;47;4;43;.915;3600000;0
3948;174718;25;72;19;1;18;.947;3600000;0
3948;71565;20;0;0;0;0;.00nan;0;0
3948;148958;25;0;0;0;0;.00nan;0;0
3950;171838;31;0;0;0;0;.00nan;0;0
3950;187537;19;0;0;0;0;.00nan;0;0
3950;163565;19;62;16;1;15;.938;3600000;0
3950;194264;31;96;41;2;39;.951;3591000;0
3952;31;21;95;21;0;21;1.000;3600000;0
3952;166751;5;0;0;0;0;.00nan;0;0
3952;172398;5;76;51;5;46;.902;3600000;0
3952;143156;21;0;0;0;0;.00nan;0;0
3954;163195;0;49;25;4;21;.840;3976000;0
3954;184770;22;91;47;3;44;.936;3976000;0
3954;139409;0;0;0;0;0;.00nan;0;0
3954;143473;22;0;0;0;0;.00nan;0;0
3956;183844;29;33;19;4;15;.789;3863000;0
3956;37818;29;0;0;0;0;.00nan;0;0
3956;85798;12;75;44;5;39;.886;3863000;0
3956;91178;12;0;0;0;0;.00nan;0;0
3958;172340;4182;0;0;0;0;.00nan;0;0
3958;169868;4182;29;16;4;12;.750;3600000;0
3958;57338;35;0;0;0;0;.00nan;0;0
3958;141998;35;100;40;0;40;1.000;3600000;0
3960;163423;26;59;36;5;31;.861;3600000;0
3960;168712;14;0;0;0;0;.00nan;0;0
3960;185034;14;48;35;6;29;.829;3600000;0
3960;152835;26;0;0;0;0;.00nan;0;0
3962;187578;10;0;0;0;0;.00nan;0;0
3962;187295;4838;0;0;0;0;.00nan;0;0
3962;90164;10;41;32;5;27;.844;3600000;0
3962;143749;4838;84;31;2;29;.935;3600000;0
3964;166646;16;0;0;0;0;.00nan;0;0
3964;165582;24;56;35;4;31;.886;3600000;0
3964;50065;16;100;24;0;24;1.000;3600000;0
3964;85727;24;0;0;0;0;.00nan;0;0
3966;3928;15;0;0;0;0;.00nan;0;0
3966;75268;15;52;26;4;22;.846;3600000;0
3966;77955;28;55;39;5;34;.872;3548000;0
3966;85437;28;0;0;0;0;.00nan;0;0
3968;67;11;0;0;0;0;.00nan;0;0
3968;168712;14;0;0;0;0;.00nan;0;0
3968;185034;14;73;19;1;18;.947;3600000;0
3968;45323;11;45;32;5;27;.844;3600000;0
3970;18213;8;46;45;6;39;.867;2736000;0
3970;189644;8;61;18;2;16;.889;864000;0
3970;185743;4838;0;0;0;0;.00nan;0;0
3970;143749;4838;52;21;3;18;.857;3600000;0
3972;187578;10;31;30;6;24;.800;2981000;0
3972;57338;35;0;0;0;0;.00nan;0;0
3972;90164;10;49;2;0;2;1.000;619000;0
3972;141998;35;68;30;3;27;.900;3600000;0
3974;172340;4182;98;33;1;32;.970;3600000;0
3974;183844;29;0;0;0;0;.00nan;0;0
3974;169868;4182;0;0;0;0;.00nan;0;0
3974;37818;29;74;27;2;25;.926;3600000;0
3976;556;3;87;31;1;30;.968;3600000;0
3976;166381;27;0;0;0;0;.00nan;0;0
3976;179344;3;0;0;0;0;.00nan;0;0
3976;175660;27;80;32;2;30;.938;3576000;0
3978;171838;31;75;54;6;48;.889;3581000;0
3978;2059;23;40;20;4;16;.800;3600000;0
3978;194264;31;0;0;0;0;.00nan;0;0
3978;78573;23;0;0;0;0;.00nan;0;0
3980;163195;0;0;0;0;0;.00nan;0;0
3980;190465;33;79;34;2;32;.941;3600000;0
3980;197038;33;0;0;0;0;.00nan;0;0
3980;139409;0;24;28;7;21;.750;3600000;0
3982;31;21;99;51;2;49;.961;3600000;0
3982;174718;25;0;0;0;0;.00nan;0;0
3982;143156;21;0;0;0;0;.00nan;0;0
3982;148958;25;42;24;4;20;.833;3515000;0
3984;165582;24;0;0;0;0;.00nan;0;0
3984;175092;9;0;0;0;0;.00nan;0;0
3984;190106;9;100;63;2;61;.968;3600000;0
3984;85727;24;44;17;3;14;.824;3572000;0
3986;166751;5;59;30;4;26;.867;2081000;0
3986;163423;26;0;0;0;0;.00nan;0;0
3986;172398;5;48;15;2;13;.867;1519000;0
3986;152835;26;73;19;1;18;.947;3600000;0
3988;166646;16;0;0;0;0;.00nan;0;0
3988;13337;32;0;0;0;0;.00nan;0;0
3988;20432;32;86;39;3;36;.923;3737000;0
3988;50065;16;53;29;4;25;.862;3737000;0
3990;170977;30;99;41;1;40;.976;3600000;0
3990;85798;12;0;0;0;0;.00nan;0;0
3990;86697;30;0;0;0;0;.00nan;0;0
3990;91178;12;72;27;2;25;.926;3545000;0
3992;187537;19;84;24;1;23;.958;4200000;0
3992;5923;17;0;0;0;0;.00nan;0;0
3992;163565;19;0;0;0;0;.00nan;0;0
3992;178413;17;100;43;1;42;.977;4200000;0
3994;676;34;0;0;0;0;.00nan;0;0
3994;184770;22;0;0;0;0;.00nan;0;0
3994;78806;34;82;28;1;27;.964;3600000;0
3994;143473;22;77;35;3;32;.914;3600000;0
3996;192733;18;0;0;0;0;.00nan;0;0
3996;166591;20;56;24;4;20;.833;3600000;0
3996;173727;18;61;27;3;24;.889;3600000;0
3996;71565;20;0;0;0;0;.00nan;0;0
3998;13337;32;74;43;4;39;.907;3600000;0
3998;18213;8;0;0;0;0;.00nan;0;0
3998;20432;32;0;0;0;0;.00nan;0;0
3998;189644;8;69;18;1;17;.944;3600000;0
4000;168712;14;64;34;3;31;.912;3535000;0
4000;184770;22;82;25;1;24;.960;3600000;0
4000;185034;14;0;0;0;0;.00nan;0;0
4000;143473;22;0;0;0;0;.00nan;0;0
4002;187578;10;0;0;0;0;.00nan;0;0
4002;57338;35;74;27;2;25;.926;3600000;0
4002;90164;10;43;34;5;29;.853;3600000;0
4002;141998;35;0;0;0;0;.00nan;0;0
4004;3284;21;0;0;0;0;.00nan;0;0
4004;77955;28;0;0;0;0;.00nan;0;0
4004;85437;28;90;39;1;38;.974;4200000;0
4004;143156;21;94;31;1;30;.968;4200000;0
4006;166646;16;54;11;2;9;.818;3600000;0
4006;175092;9;29;27;6;21;.778;2102000;0
4006;190106;9;62;12;1;11;.917;1498000;0
4006;50065;16;0;0;0;0;.00nan;0;0
4008;676;34;83;26;1;25;.962;3600000;0
4008;183844;29;82;38;2;36;.947;3549000;0
4008;37818;29;0;0;0;0;.00nan;0;0
4008;78806;34;0;0;0;0;.00nan;0;0
4010;190465;33;0;0;0;0;.00nan;0;0
4010;185743;4838;50;30;4;26;.867;3546000;0
4010;197038;33;67;33;3;30;.909;3600000;0
4010;143749;4838;0;0;0;0;.00nan;0;0
4012;556;3;0;0;0;0;.00nan;0;0
4012;163195;0;61;26;2;24;.923;3600000;0
4012;179344;3;58;47;6;41;.872;3600000;0
4012;139409;0;0;0;0;0;.00nan;0;0
4014;165582;24;63;55;7;48;.873;3600000;0
4014;174718;25;71;21;2;19;.905;3600000;0
4014;85727;24;0;0;0;0;.00nan;0;0
4014;148958;25;0;0;0;0;.00nan;0;0
4016;3928;15;63;23;2;21;.913;4063000;0
4016;170977;30;0;0;0;0;.00nan;0;0
4016;59540;15;0;0;0;0;.00nan;0;0
4016;86697;30;94;54;3;51;.944;4063000;0
4018;171838;31;0;0;0;0;.00nan;0;0
4018;166751;5;64;38;4;34;.895;3600000;0
4018;172398;5;0;0;0;0;.00nan;0;0
4018;152717;31;100;31;0;31;1.000;3600000;0
4020;163423;26;0;0;0;0;.00nan;0;0
4020;85798;12;98;34;1;33;.971;3550000;0
4020;91178;12;0;0;0;0;.00nan;0;0
4020;152835;26;100;35;0;35;1.000;3600000;0
4022;67;11;45;35;6;29;.829;2967000;0
4022;166381;27;93;29;1;28;.966;3600000;0
4022;175660;27;0;0;0;0;.00nan;0;0
4022;45323;11;51;2;0;2;1.000;633000;0
4024;192733;18;64;39;4;35;.897;3535000;0
4024;172340;4182;0;0;0;0;.00nan;0;0
4024;173727;18;0;0;0;0;.00nan;0;0
4024;147945;4182;82;31;2;29;.935;3600000;0
4026;187537;19;0;0;0;0;.00nan;0;0
4026;2059;23;0;0;0;0;.00nan;0;0
4026;163565;19;69;33;3;30;.909;3584000;0
4026;78573;23;72;21;1;20;.952;3600000;0
4028;166591;20;0;0;0;0;.00nan;0;0
4028;5923;17;66;19;1;18;.947;3600000;0
4028;178413;17;0;0;0;0;.00nan;0;0
4028;71565;20;48;28;5;23;.821;3600000;0
4029;165744;53;98;34;1;33;.971;3900000;0
4029;183783;52;78;27;1;26;.963;3900000;0
4029;169323;53;0;0;0;0;.00nan;0;0
4029;185812;52;0;0;0;0;.00nan;0;0
4030;179950;4837;65;27;3;24;.889;3600000;0
4030;186495;47;0;0;0;0;.00nan;0;0
4030;187295;4837;0;0;0;0;.00nan;0;0
4030;86151;47;93;41;2;39;.951;3600000;0
4031;176938;62;94;22;0;22;1.000;3600000;0
4031;38276;62;0;0;0;0;.00nan;0;0
4031;43731;37;0;0;0;0;.00nan;0;0
4031;58037;37;95;52;4;48;.923;3600000;0
4032;848;45;69;37;4;33;.892;3569000;0
4032;178384;40;84;37;3;34;.919;3600000;0
4032;196495;45;0;0;0;0;.00nan;0;0
4032;85636;40;0;0;0;0;.00nan;0;0
4033;182780;60;0;0;0;0;.00nan;0;0
4033;183904;43;66;33;4;29;.879;3600000;0
4033;178612;43;0;0;0;0;.00nan;0;0
4033;170294;60;49;38;6;32;.842;3521000;0
4034;169868;48;0;0;0;0;.00nan;0;0
4034;181102;46;31;28;6;22;.786;3005000;0
4034;79280;46;51;3;0;3;1.000;523000;0
4034;142492;48;69;38;4;34;.895;3600000;0
4035;169154;44;0;0;0;0;.00nan;0;0
4035;170314;4619;66;17;1;16;.941;3900000;0
4035;176921;44;100;42;1;41;.976;3900000;0
4035;191813;4619;0;0;0;0;.00nan;0;0
4036;194264;41;0;0;0;0;.00nan;0;0
4036;169226;65;0;0;0;0;.00nan;0;0
4036;175084;65;98;21;0;21;1.000;3600000;0
4036;176060;41;65;33;3;30;.909;3600000;0
4037;181123;63;51;2;0;2;1.000;444000;0
4037;186527;59;0;0;0;0;.00nan;0;0
4037;192457;63;51;41;6;35;.854;3156000;0
4037;75268;59;80;25;1;24;.960;3600000;0
4038;192733;61;41;14;3;11;.786;3662000;0
4038;192776;54;70;38;4;34;.895;3662000;0
4038;-1;61;0;0;0;0;.00nan;0;0
4038;94615;54;0;0;0;0;.00nan;0;0
4039;57215;50;0;0;0;0;.00nan;0;0
4039;64722;49;65;31;3;28;.903;3600000;0
4039;79132;49;0;0;0;0;.00nan;0;0
4039;141998;50;82;10;0;10;1.000;3600000;0
4040;31;55;0;0;0;0;.00nan;0;0
4040;173699;36;72;24;1;23;.958;3600000;0
4040;176200;55;53;42;7;35;.833;3600000;0
4040;187362;36;0;0;0;0;.00nan;0;0
4041;165744;53;97;38;2;36;.947;3600000;0
4041;183783;52;43;32;5;27;.844;3600000;0
4041;169323;53;0;0;0;0;.00nan;0;0
4041;185812;52;0;0;0;0;.00nan;0;0
4042;4622;64;100;35;0;35;1.000;3600000;0
4042;168872;64;0;0;0;0;.00nan;0;0
4042;79141;42;0;0;0;0;.00nan;0;0
4042;149450;42;64;16;1;15;.938;3570000;0
4043;176938;62;87;33;1;32;.970;3900000;0
4043;38276;62;0;0;0;0;.00nan;0;0
4043;43731;37;0;0;0;0;.00nan;0;0
4043;58037;37;100;41;1;40;.976;3900000;0
4044;176915;38;0;0;0;0;.00nan;0;0
4044;47112;56;0;0;0;0;.00nan;0;0
4044;57207;56;49;27;4;23;.852;3600000;0
4044;141978;38;85;31;1;30;.968;3600000;0
4045;848;45;46;20;3;17;.850;3600000;0
4045;178384;40;75;26;2;24;.923;3600000;0
4045;196495;45;0;0;0;0;.00nan;0;0
4045;85636;40;0;0;0;0;.00nan;0;0
4046;182780;60;79;38;3;35;.921;3586000;0
4046;183904;43;55;16;2;14;.875;3600000;0
4046;178612;43;0;0;0;0;.00nan;0;0
4046;170294;60;0;0;0;0;.00nan;0;0
4047;188888;51;41;29;5;24;.828;2400000;0
4047;166441;58;0;0;0;0;.00nan;0;0
4047;38124;58;61;37;5;32;.865;3600000;0
4047;186573;51;56;12;1;11;.917;1200000;0
4048;192733;61;77;14;1;13;.929;3600000;0
4048;192776;54;47;39;6;33;.846;3600000;0
4048;-1;61;0;0;0;0;.00nan;0;0
4048;94615;54;0;0;0;0;.00nan;0;0
4049;194264;41;0;0;0;0;.00nan;0;0
4049;175912;57;50;23;4;19;.826;3600000;0
4049;176060;41;90;35;1;34;.971;3600000;0
4049;196372;57;0;0;0;0;.00nan;0;0
4050;31;55;52;3;0;3;1.000;429000;0
4050;176200;55;40;45;7;38;.844;3171000;0
4050;186527;59;0;0;0;0;.00nan;0;0
4050;75268;59;59;18;2;16;.889;3600000;0
4051;57215;50;0;0;0;0;.00nan;0;0
4051;64722;49;0;0;0;0;.00nan;0;0
4051;79132;49;100;41;1;40;.976;3600000;0
4051;141998;50;37;17;3;14;.824;3527000;0
4052;187699;39;56;21;3;18;.857;3900000;0
4052;181123;63;82;43;3;40;.930;3900000;0
4052;43928;39;0;0;0;0;.00nan;0;0
4052;192457;63;0;0;0;0;.00nan;0;0
4053;188888;51;76;29;2;27;.931;3573000;0
4053;176915;38;0;0;0;0;.00nan;0;0
4053;186573;51;0;0;0;0;.00nan;0;0
4053;141978;38;72;19;1;18;.947;3600000;0
4054;166441;58;0;0;0;0;.00nan;0;0
4054;38124;58;51;45;7;38;.844;3600000;0
4054;47112;56;0;0;0;0;.00nan;0;0
4054;57207;56;77;18;1;17;.944;3600000;0
4055;169868;48;0;0;0;0;.00nan;0;0
4055;181102;46;79;31;3;28;.903;3577000;0
4055;79280;46;0;0;0;0;.00nan;0;0
4055;142492;48;95;40;1;39;.975;3600000;0
4056;169154;44;0;0;0;0;.00nan;0;0
4056;170314;4619;68;24;2;22;.917;3600000;0
4056;176921;44;68;42;5;37;.881;3600000;0
4056;191813;4619;0;0;0;0;.00nan;0;0
4057;169226;65;0;0;0;0;.00nan;0;0
4057;175084;65;69;32;3;29;.906;3600000;0
4057;175912;57;42;36;6;30;.833;3600000;0
4057;196372;57;0;0;0;0;.00nan;0;0
4058;187699;39;99;41;1;40;.976;3600000;0
4058;173699;36;47;35;5;30;.857;3600000;0
4058;187362;36;0;0;0;0;.00nan;0;0
4058;43928;39;0;0;0;0;.00nan;0;0
4059;4622;64;50;41;6;35;.854;3600000;0
4059;168872;64;0;0;0;0;.00nan;0;0
4059;57215;50;0;0;0;0;.00nan;0;0
4059;141998;50;66;27;3;24;.889;3600000;0
4060;183904;43;66;16;1;15;.938;3600000;0
4060;178612;43;0;0;0;0;.00nan;0;0
4060;181123;63;55;34;5;29;.853;3600000;0
4060;192457;63;0;0;0;0;.00nan;0;0
4061;169226;65;0;0;0;0;.00nan;0;0
4061;175084;65;89;45;3;42;.933;3600000;0
4061;186527;59;0;0;0;0;.00nan;0;0
4061;75268;59;51;27;4;23;.852;3548000;0
4062;182780;60;0;0;0;0;.00nan;0;0
4062;169868;48;0;0;0;0;.00nan;0;0
4062;170294;60;97;24;0;24;1.000;3600000;0
4062;142492;48;85;33;2;31;.939;3565000;0
4063;31;55;69;26;1;25;.962;2428000;0
4063;188888;51;0;0;0;0;.00nan;0;0
4063;176200;55;27;12;4;8;.667;1172000;0
4063;186573;51;99;40;1;39;.975;3600000;0
4064;176938;62;66;33;4;29;.879;3600000;0
4064;38276;62;0;0;0;0;.00nan;0;0
4064;43731;37;0;0;0;0;.00nan;0;0
4064;58037;37;92;44;3;41;.932;3600000;0
4065;194264;41;63;32;3;29;.906;3600000;0
4065;183783;52;45;27;5;22;.815;3600000;0
4065;176060;41;0;0;0;0;.00nan;0;0
4065;185812;52;0;0;0;0;.00nan;0;0
4066;192733;61;80;27;1;26;.963;3706000;0
4066;178384;40;66;25;2;23;.920;3706000;0
4066;-1;61;0;0;0;0;.00nan;0;0
4066;85636;40;0;0;0;0;.00nan;0;0
4067;183904;43;45;16;3;13;.813;3600000;0
4067;178612;43;0;0;0;0;.00nan;0;0
4067;181123;63;55;54;7;47;.870;3600000;0
4067;192457;63;0;0;0;0;.00nan;0;0
4068;848;45;48;22;3;19;.864;3600000;0
4068;181102;46;0;0;0;0;.00nan;0;0
4068;196495;45;0;0;0;0;.00nan;0;0
4068;79280;46;100;27;0;27;1.000;3600000;0
4069;169226;65;0;0;0;0;.00nan;0;0
4069;175084;65;62;38;5;33;.868;3600000;0
4069;176915;38;76;26;1;25;.962;3600000;0
4069;141978;38;0;0;0;0;.00nan;0;0
4070;169154;44;0;0;0;0;.00nan;0;0
4070;170314;4619;64;39;5;34;.872;3600000;0
4070;176921;44;100;25;0;25;1.000;3600000;0
4070;191813;4619;0;0;0;0;.00nan;0;0
4071;166441;58;0;0;0;0;.00nan;0;0
4071;175912;57;0;0;0;0;.00nan;0;0
4071;196372;57;52;23;3;20;.870;3600000;0
4071;38124;58;40;48;7;41;.854;3600000;0
4072;182780;60;0;0;0;0;.00nan;0;0
4072;169868;48;48;29;5;24;.828;3554000;0
4072;170294;60;47;29;4;25;.862;3600000;0
4072;142492;48;0;0;0;0;.00nan;0;0
4073;169154;44;0;0;0;0;.00nan;0;0
4073;176921;44;93;48;3;45;.938;3900000;0
4073;179950;4837;41;10;3;7;.700;3900000;0
4073;187295;4837;0;0;0;0;.00nan;0;0
4074;183904;43;92;30;1;29;.967;3600000;0
4074;178612;43;0;0;0;0;.00nan;0;0
4074;47112;56;0;0;0;0;.00nan;0;0
4074;57207;56;88;40;3;37;.925;3600000;0
4075;173699;36;0;0;0;0;.00nan;0;0
4075;186527;59;63;22;2;20;.909;3794000;0
4075;187362;36;87;44;3;41;.932;3794000;0
4075;75268;59;0;0;0;0;.00nan;0;0
4076;31;55;0;0;0;0;.00nan;0;0
4076;188888;51;59;25;3;22;.880;3600000;0
4076;176200;55;41;24;4;20;.833;3557000;0
4076;186573;51;0;0;0;0;.00nan;0;0
4077;176938;62;0;0;0;0;.00nan;0;0
4077;38276;62;89;30;1;29;.967;3600000;0
4077;43731;37;67;41;4;37;.902;3600000;0
4077;58037;37;0;0;0;0;.00nan;0;0
4078;194264;41;0;0;0;0;.00nan;0;0
4078;166441;58;87;29;0;29;1.000;3167000;0
4078;176060;41;48;6;1;5;.833;3600000;0
4078;38124;58;38;12;3;9;.750;351000;0
4079;192733;61;0;0;0;0;.00nan;0;0
4079;178384;40;0;0;0;0;.00nan;0;0
4079;-1;61;66;29;2;27;.931;3900000;0
4079;85636;40;76;35;2;33;.943;3900000;0
4080;848;45;0;0;0;0;.00nan;0;0
4080;181102;46;41;24;4;20;.833;3562000;0
4080;196495;45;62;30;3;27;.900;3600000;0
4080;79280;46;0;0;0;0;.00nan;0;0
4081;57215;50;0;0;0;0;.00nan;0;0
4081;79141;42;0;0;0;0;.00nan;0;0
4081;141998;50;41;22;4;18;.818;3600000;0
4081;149450;42;67;17;1;16;.941;3600000;0
4082;169226;65;60;29;3;26;.897;3544000;0
4082;175084;65;0;0;0;0;.00nan;0;0
4082;176915;38;0;0;0;0;.00nan;0;0
4082;141978;38;83;30;1;29;.967;3600000;0
4083;192776;54;0;0;0;0;.00nan;0;0
4083;4622;64;52;37;5;32;.865;3528000;0
4083;168872;64;0;0;0;0;.00nan;0;0
4083;94615;54;61;39;4;35;.897;3600000;0
4084;187699;39;0;0;0;0;.00nan;0;0
4084;165744;53;0;0;0;0;.00nan;0;0
4084;169323;53;66;40;5;35;.875;3545000;0
4084;43928;39;77;24;4;20;.833;3600000;0
4085;186495;47;0;0;0;0;.00nan;0;0
4085;64722;49;0;0;0;0;.00nan;0;0
4085;79132;49;75;38;3;35;.921;3555000;0
4085;86151;47;77;23;1;22;.957;3600000;0
4086;183783;52;0;0;0;0;.00nan;0;0
4086;175912;57;71;37;3;34;.919;3757000;0
4086;196372;57;0;0;0;0;.00nan;0;0
4086;185812;52;65;28;2;26;.929;3757000;0
4087;176915;38;26;27;6;21;.778;2969000;0
4087;186527;59;0;0;0;0;.00nan;0;0
4087;75268;59;56;11;1;10;.909;3600000;0
4087;141978;38;58;7;0;7;1.000;631000;0
4088;4622;64;0;0;0;0;.00nan;0;0
4088;168872;64;69;50;5;45;.900;3600000;0
4088;57215;50;66;20;2;18;.900;3600000;0
4088;141998;50;0;0;0;0;.00nan;0;0
4089;166441;58;0;0;0;0;.00nan;0;0
4089;175912;57;0;0;0;0;.00nan;0;0
4089;196372;57;100;23;0;23;1.000;3600000;0
4089;38124;58;73;28;3;25;.893;3600000;0
4090;187699;39;78;30;3;27;.900;3600000;0
4090;165744;53;48;26;4;22;.846;3558000;0
4090;169323;53;0;0;0;0;.00nan;0;0
4090;43928;39;0;0;0;0;.00nan;0;0
4091;182780;60;73;36;4;32;.889;3600000;0
4091;170294;60;0;0;0;0;.00nan;0;0
4091;176938;62;38;23;5;18;.783;3546000;0
4091;38276;62;0;0;0;0;.00nan;0;0
4092;178384;40;85;48;4;44;.917;3600000;0
4092;179950;4837;0;0;0;0;.00nan;0;0
4092;187295;4837;80;26;1;25;.962;3600000;0
4092;85636;40;0;0;0;0;.00nan;0;0
4093;187699;39;79;40;3;37;.925;3716000;0
4093;43928;39;0;0;0;0;.00nan;0;0
4093;79141;42;0;0;0;0;.00nan;0;0
4093;149450;42;52;26;4;22;.846;3716000;0
4094;170314;4619;73;19;1;18;.947;3600000;0
4094;191813;4619;0;0;0;0;.00nan;0;0
4094;64722;49;0;0;0;0;.00nan;0;0
4094;79132;49;74;30;2;28;.933;3600000;0
4095;182780;60;0;0;0;0;.00nan;0;0
4095;170294;60;95;34;2;32;.941;3600000;0
4095;176938;62;0;0;0;0;.00nan;0;0
4095;38276;62;45;31;5;26;.839;3600000;0
4096;47112;56;78;33;2;31;.939;3600000;0
4096;57207;56;0;0;0;0;.00nan;0;0
4096;79141;42;53;22;3;19;.864;3555000;0
4096;149450;42;0;0;0;0;.00nan;0;0
4097;169154;44;62;9;0;9;1.000;1110000;0
4097;176921;44;20;29;6;23;.793;2490000;0
4097;186495;47;78;32;3;29;.906;3600000;0
4097;86151;47;0;0;0;0;.00nan;0;0
4098;848;45;89;27;1;26;.963;3600000;0
4098;4622;64;58;30;3;27;.900;3579000;0
4098;168872;64;0;0;0;0;.00nan;0;0
4098;196495;45;0;0;0;0;.00nan;0;0
4099;165744;53;91;34;1;33;.971;3600000;0
4099;169323;53;0;0;0;0;.00nan;0;0
4099;181123;63;2;34;9;25;.735;3123000;0
4099;192457;63;41;2;1;1;.500;477000;0
4100;192733;61;93;36;3;33;.917;3600000;0
4100;178384;40;0;0;0;0;.00nan;0;0
4100;-1;61;0;0;0;0;.00nan;0;0
4100;85636;40;52;47;6;41;.872;3600000;0
4101;183783;52;0;0;0;0;.00nan;0;0
4101;176915;38;47;17;3;14;.824;2536000;0
4101;185812;52;64;30;3;27;.900;3600000;0
4101;141978;38;25;15;4;11;.733;1064000;0
4102;187699;39;80;26;1;25;.962;3600000;0
4102;43928;39;0;0;0;0;.00nan;0;0
4102;47112;56;0;0;0;0;.00nan;0;0
4102;57207;56;66;32;3;29;.906;3515000;0
4103;165744;53;0;0;0;0;.00nan;0;0
4103;169323;53;66;45;5;40;.889;3600000;0
4103;186527;59;0;0;0;0;.00nan;0;0
4103;75268;59;49;11;2;9;.818;3600000;0
4104;188888;51;57;35;5;30;.857;3563000;0
4104;186573;51;0;0;0;0;.00nan;0;0
4104;43731;37;0;0;0;0;.00nan;0;0
4104;58037;37;57;20;3;17;.850;3600000;0
4105;194264;41;66;28;2;26;.929;3900000;0
4105;175912;57;71;25;2;23;.920;3885000;0
4105;176060;41;0;0;0;0;.00nan;0;0
4105;196372;57;0;0;0;0;.00nan;0;0
4106;178384;40;95;43;2;41;.953;3900000;0
4106;169154;44;0;0;0;0;.00nan;0;0
4106;176921;44;79;26;2;24;.923;3900000;0
4106;85636;40;0;0;0;0;.00nan;0;0
4107;183904;43;63;14;1;13;.929;3600000;0
4107;178612;43;0;0;0;0;.00nan;0;0
4107;181123;63;0;0;0;0;.00nan;0;0
4107;192457;63;98;57;2;55;.965;3580000;0
4108;848;45;48;20;3;17;.850;3600000;0
4108;192776;54;81;49;4;45;.918;3600000;0
4108;196495;45;0;0;0;0;.00nan;0;0
4108;94615;54;0;0;0;0;.00nan;0;0
4109;182780;60;0;0;0;0;.00nan;0;0
4109;170294;60;69;36;4;32;.889;3562000;0
4109;170314;4619;63;23;2;21;.913;3600000;0
4109;191813;4619;0;0;0;0;.00nan;0;0
4110;31;55;0;0;0;0;.00nan;0;0
4110;173699;36;70;26;2;24;.923;3600000;0
4110;176200;55;64;47;6;41;.872;3600000;0
4110;187362;36;0;0;0;0;.00nan;0;0
4111;181102;46;53;32;4;28;.875;3600000;0
4111;57215;50;52;38;5;33;.868;3559000;0
4111;79280;46;0;0;0;0;.00nan;0;0
4111;141998;50;0;0;0;0;.00nan;0;0
4112;179950;4837;61;20;2;18;.900;3600000;0
4112;187295;4837;0;0;0;0;.00nan;0;0
4112;64722;49;66;46;5;41;.891;3600000;0
4112;79132;49;0;0;0;0;.00nan;0;0
4113;187699;39;0;0;0;0;.00nan;0;0
4113;43928;39;39;22;4;18;.818;3600000;0
4113;47112;56;99;35;1;34;.971;3600000;0
4113;57207;56;0;0;0;0;.00nan;0;0
4114;169868;48;0;0;0;0;.00nan;0;0
4114;176938;62;48;19;3;16;.842;3900000;0
4114;38276;62;0;0;0;0;.00nan;0;0
4114;142492;48;89;44;3;41;.932;3900000;0
4115;165744;53;86;45;3;42;.933;3597000;0
4115;169323;53;0;0;0;0;.00nan;0;0
4115;186527;59;74;20;1;19;.950;3600000;0
4115;75268;59;0;0;0;0;.00nan;0;0
4116;4622;64;75;35;4;31;.886;3600000;0
4116;188888;51;0;0;0;0;.00nan;0;0
4116;168872;64;0;0;0;0;.00nan;0;0
4116;186573;51;69;43;5;38;.884;3600000;0
4117;166441;58;0;0;0;0;.00nan;0;0
4117;176915;38;0;0;0;0;.00nan;0;0
4117;38124;58;86;55;5;50;.909;3600000;0
4117;141978;38;58;14;1;13;.929;3600000;0
4118;848;45;0;0;0;0;.00nan;0;0
4118;196495;45;93;52;2;50;.962;3600000;0
4118;79141;42;0;0;0;0;.00nan;0;0
4118;149450;42;61;12;1;11;.917;3600000;0
4119;192776;54;0;0;0;0;.00nan;0;0
4119;43731;37;45;14;3;11;.786;3600000;0
4119;58037;37;0;0;0;0;.00nan;0;0
4119;94615;54;66;51;5;46;.902;3553000;0
4120;192733;61;77;34;3;31;.912;3900000;0
4120;-1;61;0;0;0;0;.00nan;0;0
4120;186495;47;0;0;0;0;.00nan;0;0
4120;86151;47;55;29;3;26;.897;3900000;0
4121;169226;65;0;0;0;0;.00nan;0;0
4121;175084;65;74;49;5;44;.898;3600000;0
4121;175912;57;0;0;0;0;.00nan;0;0
4121;196372;57;76;24;1;23;.958;3600000;0
4122;31;55;32;39;6;33;.846;3100000;0
4122;183904;43;84;24;1;23;.958;3600000;0
4122;178612;43;0;0;0;0;.00nan;0;0
4122;176200;55;57;6;0;6;1.000;500000;0
4123;181102;46;0;0;0;0;.00nan;0;0
4123;57215;50;0;0;0;0;.00nan;0;0
4123;79280;46;100;33;0;33;1.000;3600000;0
4123;141998;50;49;20;3;17;.850;3600000;0
4124;179950;4837;0;0;0;0;.00nan;0;0
4124;187295;4837;52;16;2;14;.875;3600000;0
4124;64722;49;0;0;0;0;.00nan;0;0
4124;79132;49;98;50;3;47;.940;3581000;0
4125;173699;36;0;0;0;0;.00nan;0;0
4125;181123;63;73;34;3;31;.912;3900000;0
4125;187362;36;72;37;3;34;.919;3900000;0
4125;192457;63;0;0;0;0;.00nan;0;0
4126;194264;41;0;0;0;0;.00nan;0;0
4126;183783;52;65;23;2;21;.913;3600000;0
4126;176060;41;54;29;3;26;.897;3600000;0
4126;185812;52;0;0;0;0;.00nan;0;0
4127;169868;48;88;36;2;34;.944;3579000;0
4127;176938;62;0;0;0;0;.00nan;0;0
4127;38276;62;77;22;1;21;.955;3600000;0
4127;142492;48;0;0;0;0;.00nan;0;0
4128;178384;40;83;34;2;32;.941;3600000;0
4128;170314;4619;57;34;4;30;.882;3541000;0
4128;191813;4619;0;0;0;0;.00nan;0;0
4128;85636;40;0;0;0;0;.00nan;0;0
4129;183783;52;0;0;0;0;.00nan;0;0
4129;176915;38;70;25;2;23;.920;3550000;0
4129;185812;52;98;37;1;36;.973;3600000;0
4129;141978;38;0;0;0;0;.00nan;0;0
4130;194264;41;71;39;3;36;.923;3575000;0
4130;166441;58;68;20;1;19;.950;3600000;0
4130;176060;41;0;0;0;0;.00nan;0;0
4130;38124;58;0;0;0;0;.00nan;0;0
4131;182780;60;0;0;0;0;.00nan;0;0
4131;169154;44;46;35;5;30;.857;3531000;0
4131;170294;60;60;28;3;25;.893;3600000;0
4131;176921;44;0;0;0;0;.00nan;0;0
4132;169226;65;72;39;3;36;.923;3580000;0
4132;175084;65;0;0;0;0;.00nan;0;0
4132;175912;57;99;39;1;38;.974;3600000;0
4132;196372;57;0;0;0;0;.00nan;0;0
4133;192733;61;0;0;0;0;.00nan;0;0
4133;-1;61;33;26;5;21;.808;3600000;0
4133;186495;47;69;20;2;18;.900;3600000;0
4133;86151;47;0;0;0;0;.00nan;0;0
4134;182780;60;65;34;4;30;.882;3900000;0
4134;170294;60;0;0;0;0;.00nan;0;0
4134;186495;47;0;0;0;0;.00nan;0;0
4134;86151;47;70;40;4;36;.900;3900000;0
4135;188888;51;97;48;3;45;.938;3551000;0
4135;186573;51;0;0;0;0;.00nan;0;0
4135;43731;37;0;0;0;0;.00nan;0;0
4135;58037;37;77;26;1;25;.962;3600000;0
4136;183904;43;0;0;0;0;.00nan;0;0
4136;178612;43;65;30;2;28;.933;3600000;0
4136;173699;36;29;8;3;5;.625;537000;0
4136;187362;36;65;37;4;33;.892;3063000;0
4137;31;55;0;0;0;0;.00nan;0;0
4137;176200;55;70;41;4;37;.902;3582000;0
4137;181123;63;78;35;3;32;.914;3600000;0
4137;192457;63;0;0;0;0;.00nan;0;0
4138;183783;52;51;28;3;25;.893;3900000;0
4138;169226;65;0;0;0;0;.00nan;0;0
4138;175084;65;54;32;3;29;.906;3900000;0
4138;185812;52;0;0;0;0;.00nan;0;0
4139;848;45;44;33;5;28;.848;3533000;0
4139;196495;45;0;0;0;0;.00nan;0;0
4139;79141;42;0;0;0;0;.00nan;0;0
4139;149450;42;57;25;3;22;.880;3600000;0
4140;182780;60;56;24;2;22;.917;3900000;0
4140;178384;40;97;48;2;46;.958;3900000;0
4140;170294;60;0;0;0;0;.00nan;0;0
4140;85636;40;0;0;0;0;.00nan;0;0
4141;192733;61;61;34;4;30;.882;3559000;0
4141;169868;48;0;0;0;0;.00nan;0;0
4141;-1;61;0;0;0;0;.00nan;0;0
4141;142492;48;85;33;2;31;.939;3600000;0
4142;165744;53;53;29;5;24;.828;3543000;0
4142;169323;53;0;0;0;0;.00nan;0;0
4142;170314;4619;77;34;3;31;.912;3600000;0
4142;191813;4619;0;0;0;0;.00nan;0;0
4143;188888;51;0;0;0;0;.00nan;0;0
4143;169226;65;0;0;0;0;.00nan;0;0
4143;175084;65;46;19;3;16;.842;3548000;0
4143;186573;51;74;21;1;20;.952;3600000;0
4144;169154;44;0;0;0;0;.00nan;0;0
4144;176921;44;100;37;1;36;.973;3600000;0
4144;176938;62;19;9;4;5;.556;2263000;0
4144;38276;62;50;6;1;5;.833;1337000;0
4145;187699;39;100;32;0;32;1.000;3600000;0
4145;183904;43;68;18;1;17;.944;3600000;0
4145;178612;43;0;0;0;0;.00nan;0;0
4145;43928;39;0;0;0;0;.00nan;0;0
4146;194264;41;52;2;0;2;1.000;265000;0
4146;166441;58;0;0;0;0;.00nan;0;0
4146;176060;41;13;24;6;18;.750;3335000;0
4146;38124;58;89;45;2;43;.956;3600000;0
4147;173699;36;49;20;3;17;.850;3600000;0
4147;181123;63;72;41;4;37;.902;3584000;0
4147;187362;36;0;0;0;0;.00nan;0;0
4147;192457;63;0;0;0;0;.00nan;0;0
4148;175912;57;63;16;1;15;.938;1555000;0
4148;196372;57;22;24;6;18;.750;2045000;0
4148;47112;56;0;0;0;0;.00nan;0;0
4148;57207;56;81;15;0;15;1.000;3600000;0
4149;4622;64;63;16;1;15;.938;3600000;0
4149;168872;64;0;0;0;0;.00nan;0;0
4149;64722;49;0;0;0;0;.00nan;0;0
4149;79132;49;97;45;2;43;.956;3578000;0
4150;183783;52;59;19;2;17;.895;3600000;0
4150;176915;38;0;0;0;0;.00nan;0;0
4150;185812;52;0;0;0;0;.00nan;0;0
4150;141978;38;59;34;3;31;.912;3549000;0
4151;182780;60;0;0;0;0;.00nan;0;0
4151;178384;40;49;2;0;2;1.000;406000;0
4151;170294;60;57;20;3;17;.850;3600000;0
4151;85636;40;70;47;6;41;.872;3194000;0
4152;179950;4837;86;33;1;32;.970;3600000;0
4152;186495;47;0;0;0;0;.00nan;0;0
4152;187295;4837;0;0;0;0;.00nan;0;0
4152;86151;47;65;35;4;31;.886;3559000;0
4153;165744;53;60;21;2;19;.905;1389000;0
4153;169323;53;26;29;6;23;.793;2211000;0
4153;170314;4619;80;33;2;31;.939;3600000;0
4153;191813;4619;0;0;0;0;.00nan;0;0
4154;188888;51;70;22;2;20;.909;3572000;0
4154;169226;65;79;26;1;25;.962;3600000;0
4154;175084;65;0;0;0;0;.00nan;0;0
4154;186573;51;0;0;0;0;.00nan;0;0
4155;169154;44;74;46;5;41;.891;3600000;0
4155;176921;44;0;0;0;0;.00nan;0;0
4155;176938;62;0;0;0;0;.00nan;0;0
4155;38276;62;50;14;2;12;.857;3600000;0
4156;176915;38;55;53;7;46;.868;3600000;0
4156;186527;59;0;0;0;0;.00nan;0;0
4156;75268;59;78;24;1;23;.958;3600000;0
4156;141978;38;0;0;0;0;.00nan;0;0
4157;848;45;99;48;1;47;.979;3600000;0
4157;196495;45;0;0;0;0;.00nan;0;0
4157;57215;50;0;0;0;0;.00nan;0;0
4157;141998;50;42;22;3;19;.864;3574000;0
4158;187699;39;27;20;6;14;.700;1568000;0
4158;183904;43;81;34;2;32;.941;3600000;0
4158;178612;43;0;0;0;0;.00nan;0;0
4158;43928;39;49;8;1;7;.875;2032000;0
4159;192776;54;5;38;9;29;.763;3600000;0
4159;181102;46;0;0;0;0;.00nan;0;0
4159;79280;46;79;18;1;17;.944;3600000;0
4159;94615;54;0;0;0;0;.00nan;0;0
4160;43731;37;0;0;0;0;.00nan;0;0
4160;58037;37;93;36;2;34;.944;3600000;0
4160;79141;42;54;24;4;20;.833;3548000;0
4160;149450;42;0;0;0;0;.00nan;0;0
4161;166441;58;0;0;0;0;.00nan;0;0
4161;175912;57;63;36;4;32;.889;3900000;0
4161;196372;57;0;0;0;0;.00nan;0;0
4161;38124;58;55;24;4;20;.833;3900000;0
4162;31;55;0;0;0;0;.00nan;0;0
4162;176200;55;97;44;2;42;.955;3600000;0
4162;181123;63;0;0;0;0;.00nan;0;0
4162;192457;63;19;23;6;17;.739;3600000;0
4163;4622;64;0;0;0;0;.00nan;0;0
4163;168872;64;58;26;3;23;.885;3600000;0
4163;64722;49;42;32;5;27;.844;3302000;0
4163;79132;49;53;2;0;2;1.000;220000;0
4164;194264;41;13;27;7;20;.741;3600000;0
4164;173699;36;0;0;0;0;.00nan;0;0
4164;176060;41;0;0;0;0;.00nan;0;0
4164;187362;36;70;18;1;17;.944;3600000;0
4165;183783;52;0;0;0;0;.00nan;0;0
4165;185812;52;68;29;2;27;.931;3600000;0
4165;47112;56;0;0;0;0;.00nan;0;0
4165;57207;56;66;30;3;27;.900;3596000;0
4166;175912;57;52;10;2;8;.800;286000;0
4166;196372;57;70;48;4;44;.917;3314000;0
4166;186527;59;61;14;1;13;.929;3600000;0
4166;75268;59;0;0;0;0;.00nan;0;0
4167;192733;61;92;35;2;33;.943;3579000;0
4167;169868;48;0;0;0;0;.00nan;0;0
4167;-1;61;0;0;0;0;.00nan;0;0
4167;142492;48;80;31;1;30;.968;3600000;0
4168;848;45;0;0;0;0;.00nan;0;0
4168;196495;45;74;28;2;26;.929;3900000;0
4168;57215;50;68;23;2;21;.913;3900000;0
4168;141998;50;0;0;0;0;.00nan;0;0
4169;192776;54;0;0;0;0;.00nan;0;0
4169;181102;46;71;21;1;20;.952;3600000;0
4169;79280;46;0;0;0;0;.00nan;0;0
4169;94615;54;44;41;6;35;.854;3600000;0
4170;178384;40;59;52;7;45;.865;2826000;0
4170;176938;62;79;20;1;19;.950;3600000;0
4170;38276;62;0;0;0;0;.00nan;0;0
4170;85636;40;58;6;0;6;1.000;774000;0
4171;31;55;49;1;0;1;1.000;321000;0
4171;176200;55;35;30;6;24;.800;3279000;0
4171;47112;56;74;17;1;16;.941;3600000;0
4171;57207;56;0;0;0;0;.00nan;0;0
4172;170314;4619;48;27;4;23;.852;3764000;0
4172;186495;47;94;46;3;43;.935;3779000;0
4172;191813;4619;0;0;0;0;.00nan;0;0
4172;86151;47;0;0;0;0;.00nan;0;0
4173;178384;40;73;60;6;54;.900;3600000;0
4173;176938;62;0;0;0;0;.00nan;0;0
4173;38276;62;60;16;2;14;.875;3600000;0
4173;85636;40;0;0;0;0;.00nan;0;0
4174;187699;39;72;28;2;26;.929;3600000;0
4174;43928;39;0;0;0;0;.00nan;0;0
4174;79141;42;0;0;0;0;.00nan;0;0
4174;149450;42;78;27;1;26;.963;3600000;0
4175;169154;44;0;0;0;0;.00nan;0;0
4175;176921;44;62;15;1;14;.933;3600000;0
4175;64722;49;0;0;0;0;.00nan;0;0
4175;79132;49;75;42;4;38;.905;3600000;0
4176;192776;54;98;54;2;52;.963;3541000;0
4176;57215;50;0;0;0;0;.00nan;0;0
4176;94615;54;0;0;0;0;.00nan;0;0
4176;141998;50;76;21;1;20;.952;3600000;0
4177;166441;58;0;0;0;0;.00nan;0;0
4177;175912;57;66;28;3;25;.893;3900000;0
4177;196372;57;0;0;0;0;.00nan;0;0
4177;38124;58;80;41;3;38;.927;3893000;0
4178;182780;60;0;0;0;0;.00nan;0;0
4178;170294;60;83;28;1;27;.964;3600000;0
4178;179950;4837;75;27;2;25;.926;3544000;0
4178;187295;4837;0;0;0;0;.00nan;0;0
4179;188888;51;0;0;0;0;.00nan;0;0
4179;186573;51;97;43;1;42;.977;3566000;0
4179;47112;56;0;0;0;0;.00nan;0;0
4179;57207;56;100;24;0;24;1.000;3600000;0
4180;194264;41;27;35;7;28;.800;2771000;0
4180;176060;41;36;13;3;10;.769;829000;0
4180;186527;59;0;0;0;0;.00nan;0;0
4180;75268;59;71;15;1;14;.933;3600000;0
4181;187699;39;91;32;2;30;.938;3600000;0
4181;43731;37;0;0;0;0;.00nan;0;0
4181;43928;39;0;0;0;0;.00nan;0;0
4181;58037;37;60;40;5;35;.875;3600000;0
4182;169154;44;0;0;0;0;.00nan;0;0
4182;176921;44;53;26;3;23;.885;3556000;0
4182;64722;49;0;0;0;0;.00nan;0;0
4182;79132;49;100;33;1;32;.970;3600000;0
4183;169226;65;73;34;3;31;.912;3694000;0
4183;175084;65;0;0;0;0;.00nan;0;0
4183;175912;57;61;28;4;24;.857;3694000;0
4183;196372;57;0;0;0;0;.00nan;0;0
4184;173699;36;0;0;0;0;.00nan;0;0
4184;181123;63;53;46;6;40;.870;3600000;0
4184;187362;36;77;28;2;26;.929;3600000;0
4184;192457;63;0;0;0;0;.00nan;0;0
4185;848;45;55;21;3;18;.857;3900000;0
4185;192776;54;74;37;3;34;.919;3900000;0
4185;196495;45;0;0;0;0;.00nan;0;0
4185;94615;54;0;0;0;0;.00nan;0;0
4186;169868;48;0;0;0;0;.00nan;0;0
4186;170314;4619;55;22;3;19;.864;3600000;0
4186;191813;4619;0;0;0;0;.00nan;0;0
4186;142492;48;45;53;8;45;.849;3600000;0
4187;192733;61;53;42;6;36;.857;3317000;0
4187;165744;53;0;0;0;0;.00nan;0;0
4187;169323;53;78;23;1;22;.957;3600000;0
4187;-1;61;55;3;0;3;1.000;283000;0
4188;31;55;0;0;0;0;.00nan;0;0
4188;183783;52;66;25;2;23;.920;3600000;0
4188;176200;55;58;51;6;45;.882;3600000;0
4188;185812;52;0;0;0;0;.00nan;0;0
4189;57215;50;95;41;1;40;.976;3600000;0
4189;79141;42;0;0;0;0;.00nan;0;0
4189;141998;50;0;0;0;0;.00nan;0;0
4189;149450;42;98;38;2;36;.947;3574000;0
4190;182780;60;0;0;0;0;.00nan;0;0
4190;170294;60;56;19;2;17;.895;3700000;0
4190;179950;4837;0;0;0;0;.00nan;0;0
4190;187295;4837;56;24;3;21;.875;3700000;0
4191;175912;57;0;0;0;0;.00nan;0;0
4191;196372;57;71;45;5;40;.889;3600000;0
4191;186527;59;40;21;4;17;.810;3600000;0
4191;75268;59;0;0;0;0;.00nan;0;0
4192;848;45;0;0;0;0;.00nan;0;0
4192;4622;64;100;26;0;26;1.000;3600000;0
4192;168872;64;0;0;0;0;.00nan;0;0
4192;196495;45;71;45;5;40;.889;3600000;0
4193;169868;48;22;35;8;27;.771;3182000;0
4193;186495;47;0;0;0;0;.00nan;0;0
4193;86151;47;47;19;3;16;.842;3600000;0
4193;142492;48;36;7;2;5;.714;418000;0
4194;187699;39;0;0;0;0;.00nan;0;0
4194;43731;37;78;39;4;35;.897;3600000;0
4194;43928;39;42;41;6;35;.854;3578000;0
4194;58037;37;0;0;0;0;.00nan;0;0
4195;194264;41;0;0;0;0;.00nan;0;0
4195;169226;65;0;0;0;0;.00nan;0;0
4195;175084;65;62;26;2;24;.923;3600000;0
4195;176060;41;59;32;3;29;.906;3600000;0
4196;166441;58;65;11;0;11;1.000;770000;0
4196;176915;38;63;22;2;20;.909;3600000;0
4196;38124;58;27;39;8;31;.795;2830000;0
4196;141978;38;0;0;0;0;.00nan;0;0
4197;170314;4619;0;0;0;0;.00nan;0;0
4197;176938;62;79;41;4;37;.902;3556000;0
4197;38276;62;0;0;0;0;.00nan;0;0
4197;191813;4619;72;26;3;23;.885;3600000;0
4198;57215;50;0;0;0;0;.00nan;0;0
4198;79141;42;42;27;4;23;.852;3600000;0
4198;141998;50;71;23;1;22;.957;3600000;0
4198;149450;42;0;0;0;0;.00nan;0;0
4199;173699;36;68;21;2;19;.905;3600000;0
4199;181123;63;0;0;0;0;.00nan;0;0
4199;187362;36;0;0;0;0;.00nan;0;0
4199;192457;63;48;30;5;25;.833;3600000;0
4200;31;55;86;36;3;33;.917;3597000;0
4200;183783;52;0;0;0;0;.00nan;0;0
4200;176200;55;0;0;0;0;.00nan;0;0
4200;185812;52;49;15;2;13;.867;3600000;0
4201;188888;51;76;36;2;34;.944;3600000;0
4201;186573;51;0;0;0;0;.00nan;0;0
4201;47112;56;0;0;0;0;.00nan;0;0
4201;57207;56;92;29;1;28;.966;3600000;0
4202;192776;54;100;39;0;39;1.000;3600000;0
4202;4622;64;45;32;6;26;.813;2347000;0
4202;168872;64;54;4;0;4;1.000;1253000;0
4202;94615;54;0;0;0;0;.00nan;0;0
4203;186495;47;55;19;3;16;.842;3900000;0
4203;64722;49;0;0;0;0;.00nan;0;0
4203;79132;49;68;35;3;32;.914;3900000;0
4203;86151;47;0;0;0;0;.00nan;0;0
4204;166441;58;62;30;3;27;.900;3549000;0
4204;176915;38;0;0;0;0;.00nan;0;0
4204;38124;58;0;0;0;0;.00nan;0;0
4204;141978;38;64;11;1;10;.909;3600000;0
4205;183904;43;78;24;1;23;.958;3600000;0
4205;178612;43;0;0;0;0;.00nan;0;0
4205;181102;46;0;0;0;0;.00nan;0;0
4205;79280;46;92;39;2;37;.949;3599000;0
4206;169154;44;0;0;0;0;.00nan;0;0
4206;176921;44;90;39;3;36;.923;3558000;0
4206;176938;62;0;0;0;0;.00nan;0;0
4206;38276;62;60;19;2;17;.895;3600000;0
4207;194264;41;69;43;5;38;.884;3600000;0
4207;169226;65;86;20;0;20;1.000;3600000;0
4207;175084;65;0;0;0;0;.00nan;0;0
4207;176060;41;0;0;0;0;.00nan;0;0
4208;192733;61;70;34;5;29;.853;3900000;0
4208;165744;53;59;34;5;29;.853;3900000;0
4208;169323;53;0;0;0;0;.00nan;0;0
4208;-1;61;0;0;0;0;.00nan;0;0
4209;183904;43;61;19;2;17;.895;3600000;0
4209;178612;43;0;0;0;0;.00nan;0;0
4209;181102;46;57;48;6;42;.875;2777000;0
4209;79280;46;69;10;0;10;1.000;823000;0
4210;31;55;0;0;0;0;.00nan;0;0
4210;176200;55;87;63;5;58;.921;3600000;0
4210;186527;59;0;0;0;0;.00nan;0;0
4210;75268;59;40;12;3;9;.750;3600000;0
4211;169868;48;0;0;0;0;.00nan;0;0
4211;179950;4837;0;0;0;0;.00nan;0;0
4211;187295;4837;72;24;2;22;.917;3656000;0
4211;142492;48;83;39;3;36;.923;3656000;0
4212;169868;48;74;46;4;42;.913;3600000;0
4212;179950;4837;100;27;0;27;1.000;3600000;0
4212;187295;4837;0;0;0;0;.00nan;0;0
4212;142492;48;0;0;0;0;.00nan;0;0
4213;4622;64;99;44;1;43;.977;3600000;0
4213;168872;64;0;0;0;0;.00nan;0;0
4213;43731;37;0;0;0;0;.00nan;0;0
4213;58037;37;55;24;3;21;.875;3600000;0
4214;194264;41;50;1;0;1;1.000;322000;0
4214;175912;57;75;24;1;23;.958;3600000;0
4214;176060;41;29;32;6;26;.813;3278000;0
4214;196372;57;0;0;0;0;.00nan;0;0
4215;178384;40;89;34;1;33;.971;3783000;0
4215;186495;47;0;0;0;0;.00nan;0;0
4215;85636;40;0;0;0;0;.00nan;0;0
4215;86151;47;81;29;2;27;.931;3783000;0
4216;183904;43;89;25;1;24;.960;3850000;0
4216;178612;43;0;0;0;0;.00nan;0;0
4216;47112;56;0;0;0;0;.00nan;0;0
4216;57207;56;100;30;0;30;1.000;3850000;0
4217;165744;53;98;48;3;45;.938;3542000;0
4217;169323;53;0;0;0;0;.00nan;0;0
4217;170314;4619;60;12;1;11;.917;3600000;0
4217;191813;4619;0;0;0;0;.00nan;0;0
4218;183783;52;44;38;6;32;.842;3600000;0
4218;176915;38;0;0;0;0;.00nan;0;0
4218;185812;52;0;0;0;0;.00nan;0;0
4218;141978;38;75;24;1;23;.958;3600000;0
4219;188888;51;0;0;0;0;.00nan;0;0
4219;181123;63;47;34;5;29;.853;3600000;0
4219;186573;51;87;30;1;29;.967;3600000;0
4219;192457;63;0;0;0;0;.00nan;0;0
4220;181102;46;0;0;0;0;.00nan;0;0
4220;47112;56;0;0;0;0;.00nan;0;0
4220;57207;56;80;23;1;22;.957;3600000;0
4220;79280;46;49;30;4;26;.867;3600000;0
4221;182780;60;0;0;0;0;.00nan;0;0
4221;178384;40;91;45;4;41;.911;3900000;0
4221;170294;60;43;23;4;19;.826;3900000;0
4221;85636;40;0;0;0;0;.00nan;0;0
4222;176915;38;91;46;3;43;.935;3600000;0
4222;186527;59;0;0;0;0;.00nan;0;0
4222;75268;59;77;12;0;12;1.000;3600000;0
4222;141978;38;0;0;0;0;.00nan;0;0
4223;166441;58;0;0;0;0;.00nan;0;0
4223;183904;43;81;13;0;13;1.000;3600000;0
4223;178612;43;0;0;0;0;.00nan;0;0
4223;38124;58;91;65;3;62;.954;3600000;0
4224;169154;44;0;0;0;0;.00nan;0;0
4224;169868;48;47;7;1;6;.857;286000;0
4224;176921;44;89;34;2;32;.941;3600000;0
4224;142492;48;22;35;7;28;.800;3314000;0
4225;183783;52;0;0;0;0;.00nan;0;0
4225;169226;65;82;28;1;27;.964;3600000;0
4225;175084;65;0;0;0;0;.00nan;0;0
4225;185812;52;36;17;3;14;.824;3547000;0
4226;192776;54;97;48;3;45;.938;3600000;0
4226;79141;42;0;0;0;0;.00nan;0;0
4226;94615;54;0;0;0;0;.00nan;0;0
4226;149450;42;46;18;4;14;.778;3554000;0
4227;165744;53;0;0;0;0;.00nan;0;0
4227;169323;53;54;18;2;16;.889;3600000;0
4227;170314;4619;55;31;4;27;.871;3563000;0
4227;191813;4619;0;0;0;0;.00nan;0;0
4228;192733;61;100;40;2;38;.950;3900000;0
4228;-1;61;0;0;0;0;.00nan;0;0
4228;176938;62;0;0;0;0;.00nan;0;0
4228;38276;62;57;19;2;17;.895;3900000;0
4229;173699;36;89;20;0;20;1.000;3600000;0
4229;175912;57;0;0;0;0;.00nan;0;0
4229;196372;57;83;31;1;30;.968;3576000;0
4229;187362;36;0;0;0;0;.00nan;0;0
4230;31;55;0;0;0;0;.00nan;0;0
4230;194264;41;0;0;0;0;.00nan;0;0
4230;176060;41;59;34;4;30;.882;3516000;0
4230;176200;55;88;35;2;33;.943;3600000;0
4231;43731;37;0;0;0;0;.00nan;0;0
4231;57215;50;94;33;2;31;.939;3600000;0
4231;58037;37;37;19;4;15;.789;3526000;0
4231;141998;50;0;0;0;0;.00nan;0;0
4232;186495;47;81;12;0;12;1.000;3600000;0
4232;64722;49;90;52;4;48;.923;3600000;0
4232;79132;49;0;0;0;0;.00nan;0;0
4232;86151;47;0;0;0;0;.00nan;0;0
4233;166441;58;59;35;4;31;.886;3600000;0
4233;38124;58;0;0;0;0;.00nan;0;0
4233;47112;56;0;0;0;0;.00nan;0;0
4233;57207;56;90;19;0;19;1.000;3600000;0
4234;176915;38;0;0;0;0;.00nan;0;0
4234;186527;59;0;0;0;0;.00nan;0;0
4234;75268;59;54;15;2;13;.867;3600000;0
4234;141978;38;53;30;4;26;.867;3589000;0
4235;188888;51;0;0;0;0;.00nan;0;0
4235;181123;63;74;47;4;43;.915;3600000;0
4235;186573;51;72;35;3;32;.914;3600000;0
4235;192457;63;0;0;0;0;.00nan;0;0
4236;31;55;85;25;1;24;.960;3600000;0
4236;194264;41;34;18;4;14;.778;3600000;0
4236;176060;41;0;0;0;0;.00nan;0;0
4236;176200;55;0;0;0;0;.00nan;0;0
4237;182780;60;68;26;3;23;.885;3857000;0
4237;178384;40;0;0;0;0;.00nan;0;0
4237;170294;60;0;0;0;0;.00nan;0;0
4237;85636;40;84;34;4;30;.882;3857000;0
4238;848;45;51;17;3;14;.824;3600000;0
4238;192776;54;44;31;6;25;.806;3089000;0
4238;196495;45;0;0;0;0;.00nan;0;0
4238;94615;54;42;3;1;2;.667;511000;0
4239;4622;64;89;51;4;47;.922;3516000;0
4239;168872;64;0;0;0;0;.00nan;0;0
4239;79141;42;60;20;2;18;.900;3600000;0
4239;149450;42;0;0;0;0;.00nan;0;0
4240;183783;52;100;31;0;31;1.000;3600000;0
4240;169226;65;0;0;0;0;.00nan;0;0
4240;175084;65;95;43;2;41;.953;3574000;0
4240;185812;52;0;0;0;0;.00nan;0;0
4241;192733;61;0;0;0;0;.00nan;0;0
4241;-1;61;91;40;2;38;.950;3600000;0
4241;176938;62;48;25;4;21;.840;3514000;0
4241;38276;62;0;0;0;0;.00nan;0;0
4242;43731;37;51;32;5;27;.844;3600000;0
4242;57215;50;0;0;0;0;.00nan;0;0
4242;58037;37;0;0;0;0;.00nan;0;0
4242;141998;50;94;41;2;39;.951;3600000;0
4243;187699;39;47;20;3;17;.850;3555000;0
4243;181102;46;84;35;2;33;.943;3600000;0
4243;43928;39;0;0;0;0;.00nan;0;0
4243;79280;46;0;0;0;0;.00nan;0;0
4244;186495;47;65;21;2;19;.905;3600000;0
4244;64722;49;0;0;0;0;.00nan;0;0
4244;79132;49;97;51;3;48;.941;3570000;0
4244;86151;47;0;0;0;0;.00nan;0;0
4245;183904;43;73;25;2;23;.920;3600000;0
4245;178612;43;0;0;0;0;.00nan;0;0
4245;173699;36;50;38;5;33;.868;3600000;0
4245;187362;36;0;0;0;0;.00nan;0;0
4246;169226;65;43;39;6;33;.846;3600000;0
4246;175084;65;0;0;0;0;.00nan;0;0
4246;186527;59;76;20;1;19;.950;3600000;0
4246;75268;59;0;0;0;0;.00nan;0;0
4247;4622;64;0;0;0;0;.00nan;0;0
4247;168872;64;29;47;8;39;.830;3600000;0
4247;79141;42;0;0;0;0;.00nan;0;0
4247;149450;42;69;19;1;18;.947;3600000;0
4248;848;45;0;0;0;0;.00nan;0;0
4248;192776;54;0;0;0;0;.00nan;0;0
4248;196495;45;92;40;3;37;.925;3900000;0
4248;94615;54;87;38;3;35;.921;3900000;0
4249;169154;44;58;21;2;19;.905;3600000;0
4249;169868;48;0;0;0;0;.00nan;0;0
4249;176921;44;0;0;0;0;.00nan;0;0
4249;142492;48;64;37;4;33;.892;3580000;0
4250;187699;39;0;0;0;0;.00nan;0;0
4250;181102;46;0;0;0;0;.00nan;0;0
4250;43928;39;86;15;0;15;1.000;3600000;0
4250;79280;46;64;31;3;28;.903;3600000;0
4251;165744;53;65;32;4;28;.875;3600000;0
4251;188888;51;92;34;1;33;.971;3600000;0
4251;169323;53;0;0;0;0;.00nan;0;0
4251;186573;51;0;0;0;0;.00nan;0;0
4252;178384;40;73;33;3;30;.909;3564000;0
4252;179950;4837;62;17;1;16;.941;3600000;0
4252;187295;4837;0;0;0;0;.00nan;0;0
4252;85636;40;0;0;0;0;.00nan;0;0
4253;169868;48;78;27;1;26;.963;3600000;0
4253;64722;49;89;20;0;20;1.000;3600000;0
4253;79132;49;0;0;0;0;.00nan;0;0
4253;142492;48;0;0;0;0;.00nan;0;0
4254;169154;44;0;0;0;0;.00nan;0;0
4254;176921;44;64;23;2;21;.913;3646000;0
4254;186495;47;0;0;0;0;.00nan;0;0
4254;86151;47;85;43;3;40;.930;3646000;0
4255;192733;61;85;49;5;44;.898;3600000;0
4255;170314;4619;85;26;1;25;.962;3600000;0
4255;-1;61;0;0;0;0;.00nan;0;0
4255;191813;4619;0;0;0;0;.00nan;0;0
4256;187699;39;0;0;0;0;.00nan;0;0
4256;166441;58;0;0;0;0;.00nan;0;0
4256;38124;58;93;56;4;52;.929;3599000;0
4256;43928;39;55;17;2;15;.882;3600000;0
4257;169868;48;0;0;0;0;.00nan;0;0
4257;64722;49;86;36;3;33;.917;3600000;0
4257;79132;49;0;0;0;0;.00nan;0;0
4257;142492;48;53;29;4;25;.862;3575000;0
4258;165744;53;36;11;3;8;.727;1652000;0
4258;188888;51;0;0;0;0;.00nan;0;0
4258;169323;53;35;17;4;13;.765;1948000;0
4258;186573;51;99;45;3;42;.933;3600000;0
4259;194264;41;0;0;0;0;.00nan;0;0
4259;169226;65;69;22;1;21;.955;3600000;0
4259;175084;65;0;0;0;0;.00nan;0;0
4259;176060;41;77;32;2;30;.938;3600000;0
4260;183783;52;74;32;2;30;.938;3600000;0
4260;176915;38;64;26;3;23;.885;3600000;0
4260;185812;52;0;0;0;0;.00nan;0;0
4260;141978;38;0;0;0;0;.00nan;0;0
4261;848;45;86;51;4;47;.922;3600000;0
4261;196495;45;0;0;0;0;.00nan;0;0
4261;79141;42;0;0;0;0;.00nan;0;0
4261;149450;42;79;15;0;15;1.000;3600000;0
4262;183904;43;50;8;1;7;.875;3600000;0
4262;178612;43;0;0;0;0;.00nan;0;0
4262;181123;63;56;50;6;44;.880;3063000;0
4262;192457;63;61;6;0;6;1.000;537000;0
4263;192776;54;97;55;3;52;.945;3600000;0
4263;181102;46;65;17;1;16;.941;3600000;0
4263;79280;46;0;0;0;0;.00nan;0;0
4263;94615;54;0;0;0;0;.00nan;0;0
4264;175912;57;64;29;3;26;.897;3594000;0
4264;196372;57;0;0;0;0;.00nan;0;0
4264;186527;59;0;0;0;0;.00nan;0;0
4264;75268;59;73;29;2;27;.931;3600000;0
4265;31;55;77;44;4;40;.909;2699000;0
4265;173699;36;69;17;1;16;.941;3600000;0
4265;176200;55;22;16;5;11;.688;901000;0
4265;187362;36;0;0;0;0;.00nan;0;0
4266;165744;53;56;6;0;6;1.000;491000;0
4266;183783;52;55;23;3;20;.870;3600000;0
4266;169323;53;64;36;4;32;.889;3069000;0
4266;185812;52;0;0;0;0;.00nan;0;0
4267;187699;39;54;18;3;15;.833;3600000;0
4267;188888;51;36;45;8;37;.822;3600000;0
4267;186573;51;0;0;0;0;.00nan;0;0
4267;43928;39;0;0;0;0;.00nan;0;0
4268;176938;62;0;0;0;0;.00nan;0;0
4268;38276;62;61;22;3;19;.864;3600000;0
4268;57215;50;0;0;0;0;.00nan;0;0
4268;141998;50;52;27;4;23;.852;3600000;0
4269;181102;46;0;0;0;0;.00nan;0;0
4269;43731;37;0;0;0;0;.00nan;0;0
4269;58037;37;62;22;3;19;.864;3528000;0
4269;79280;46;100;43;1;42;.977;3600000;0
4270;166441;58;59;21;2;19;.905;1411000;0
4270;169226;65;0;0;0;0;.00nan;0;0
4270;175084;65;74;20;1;19;.950;3600000;0
4270;38124;58;22;26;6;20;.769;2189000;0
4271;183904;43;62;20;2;18;.900;3600000;0
4271;178612;43;0;0;0;0;.00nan;0;0
4271;181123;63;58;43;5;38;.884;3600000;0
4271;192457;63;0;0;0;0;.00nan;0;0
4272;192776;54;72;41;5;36;.878;3600000;0
4272;79141;42;0;0;0;0;.00nan;0;0
4272;94615;54;0;0;0;0;.00nan;0;0
4272;149450;42;100;27;0;27;1.000;3600000;0
4273;4622;64;29;14;4;10;.714;1200000;0
4273;168872;64;85;39;2;37;.949;2340000;0
4273;170314;4619;48;23;4;19;.826;3600000;0
4273;191813;4619;0;0;0;0;.00nan;0;0
4274;192733;61;80;43;4;39;.907;3864000;0
4274;169154;44;0;0;0;0;.00nan;0;0
4274;-1;61;0;0;0;0;.00nan;0;0
4274;176921;44;34;25;5;20;.800;3864000;0
4275;194264;41;0;0;0;0;.00nan;0;0
4275;175912;57;82;15;0;15;1.000;3600000;0
4275;176060;41;73;40;4;36;.900;3600000;0
4275;196372;57;0;0;0;0;.00nan;0;0
4276;31;55;0;0;0;0;.00nan;0;0
4276;173699;36;55;32;4;28;.875;3600000;0
4276;176200;55;71;19;1;18;.947;3600000;0
4276;187362;36;0;0;0;0;.00nan;0;0
4277;179950;4837;0;0;0;0;.00nan;0;0
4277;186495;47;94;36;2;34;.944;3600000;0
4277;187295;4837;74;27;1;26;.963;3600000;0
4277;86151;47;0;0;0;0;.00nan;0;0
4278;169226;65;81;55;5;50;.909;3600000;0
4278;175084;65;0;0;0;0;.00nan;0;0
4278;186527;59;0;0;0;0;.00nan;0;0
4278;75268;59;61;11;1;10;.909;3600000;0
4279;182780;60;0;0;0;0;.00nan;0;0
4279;169868;48;0;0;0;0;.00nan;0;0
4279;170294;60;68;24;2;22;.917;3600000;0
4279;142492;48;41;41;6;35;.854;3600000;0
4280;165744;53;70;40;4;36;.900;3600000;0
4280;183783;52;0;0;0;0;.00nan;0;0
4280;169323;53;0;0;0;0;.00nan;0;0
4280;185812;52;36;24;5;19;.792;3581000;0
4281;176938;62;39;26;5;21;.808;3600000;0
4281;38276;62;0;0;0;0;.00nan;0;0
4281;57215;50;28;30;6;24;.800;2412000;0
4281;141998;50;53;5;0;5;1.000;1182000;0
4282;194264;41;26;25;6;19;.760;2974000;0
4282;176060;41;57;5;0;5;1.000;626000;0
4282;47112;56;0;0;0;0;.00nan;0;0
4282;57207;56;69;22;1;21;.955;3600000;0
4283;178384;40;84;26;1;25;.962;3600000;0
4283;64722;49;61;37;4;33;.892;3600000;0
4283;79132;49;0;0;0;0;.00nan;0;0
4283;85636;40;0;0;0;0;.00nan;0;0
4284;848;45;88;39;3;36;.923;3600000;0
4284;176915;38;49;1;0;1;1.000;421000;0
4284;196495;45;0;0;0;0;.00nan;0;0
4284;141978;38;35;30;6;24;.800;3179000;0
4285;166441;58;0;0;0;0;.00nan;0;0
4285;181123;63;0;0;0;0;.00nan;0;0
4285;38124;58;47;36;5;31;.861;3600000;0
4285;192457;63;74;20;1;19;.950;3600000;0
4286;192776;54;0;0;0;0;.00nan;0;0
4286;79141;42;0;0;0;0;.00nan;0;0
4286;94615;54;89;66;6;60;.909;3600000;0
4286;149450;42;42;11;2;9;.818;3600000;0
4287;4622;64;100;39;1;38;.974;3600000;0
4287;168872;64;0;0;0;0;.00nan;0;0
4287;170314;4619;0;0;0;0;.00nan;0;0
4287;191813;4619;52;18;2;16;.889;3592000;0
4288;192733;61;0;0;0;0;.00nan;0;0
4288;169154;44;73;37;4;33;.892;3600000;0
4288;-1;61;100;34;0;34;1.000;3600000;0
4288;176921;44;0;0;0;0;.00nan;0;0
4289;173699;36;0;0;0;0;.00nan;0;0
4289;175912;57;80;47;4;43;.915;3543000;0
4289;196372;57;0;0;0;0;.00nan;0;0
4289;187362;36;77;35;3;32;.914;3600000;0
4290;31;55;70;48;5;43;.896;3600000;0
4290;183904;43;57;13;1;12;.923;3600000;0
4290;178612;43;0;0;0;0;.00nan;0;0
4290;176200;55;0;0;0;0;.00nan;0;0
4291;186527;59;60;21;2;19;.905;3600000;0
4291;47112;56;0;0;0;0;.00nan;0;0
4291;57207;56;69;34;3;31;.912;3600000;0
4291;75268;59;0;0;0;0;.00nan;0;0
4292;182780;60;75;28;2;26;.929;3600000;0
4292;169868;48;34;13;3;10;.769;558000;0
4292;170294;60;0;0;0;0;.00nan;0;0
4292;142492;48;79;37;3;34;.919;3042000;0
4293;181102;46;45;5;1;4;.800;643000;0
4293;43731;37;0;0;0;0;.00nan;0;0
4293;58037;37;63;34;3;31;.912;3600000;0
4293;79280;46;34;28;6;22;.786;2957000;0
4294;178384;40;0;0;0;0;.00nan;0;0
4294;64722;49;0;0;0;0;.00nan;0;0
4294;79132;49;58;29;3;26;.897;3564000;0
4294;85636;40;75;32;2;30;.938;3600000;0
4295;848;45;0;0;0;0;.00nan;0;0
4295;176915;38;72;21;1;20;.952;3600000;0
4295;196495;45;98;24;0;24;1.000;3600000;0
4295;141978;38;0;0;0;0;.00nan;0;0
4296;187699;39;48;16;3;13;.813;3600000;0
4296;188888;51;0;0;0;0;.00nan;0;0
4296;186573;51;73;43;5;38;.884;3600000;0
4296;43928;39;0;0;0;0;.00nan;0;0
4297;169154;44;0;0;0;0;.00nan;0;0
4297;176921;44;62;19;2;17;.895;3600000;0
4297;64722;49;30;36;7;29;.806;3298000;0
4297;79132;49;48;0;0;0;.00nan;302000;0
4298;192733;61;0;0;0;0;.00nan;0;0
4298;-1;61;65;42;5;37;.881;3829000;0
4298;186495;47;0;0;0;0;.00nan;0;0
4298;86151;47;65;33;4;29;.879;3829000;0
4299;4622;64;87;29;1;28;.966;3600000;0
4299;168872;64;0;0;0;0;.00nan;0;0
4299;43731;37;0;0;0;0;.00nan;0;0
4299;58037;37;60;21;2;19;.905;3600000;0
4300;178384;40;73;44;5;39;.886;3600000;0
4300;185743;4837;0;0;0;0;.00nan;0;0
4300;187295;4837;82;19;1;18;.947;3600000;0
4300;85636;40;0;0;0;0;.00nan;0;0
4301;170314;4619;41;26;5;21;.808;2361000;0
4301;191813;4619;50;3;0;3;1.000;1217000;0
4301;57215;50;0;0;0;0;.00nan;0;0
4301;141998;50;55;28;4;24;.857;3600000;0
4302;173699;36;0;0;0;0;.00nan;0;0
4302;187362;36;93;34;2;32;.941;3600000;0
4302;47112;56;0;0;0;0;.00nan;0;0
4302;57207;56;55;35;5;30;.857;3600000;0
4303;183783;52;29;10;3;7;.700;334000;0
4303;176915;38;0;0;0;0;.00nan;0;0
4303;185812;52;65;28;3;25;.893;3266000;0
4303;141978;38;100;42;2;40;.952;3600000;0
4304;182780;60;0;0;0;0;.00nan;0;0
4304;183904;43;88;20;0;20;1.000;3600000;0
4304;178612;43;0;0;0;0;.00nan;0;0
4304;170294;60;73;42;3;39;.929;3600000;0
4305;185743;4837;71;25;2;23;.920;3632000;0
4305;187295;4837;0;0;0;0;.00nan;0;0
4305;57215;50;99;36;1;35;.972;3632000;0
4305;141998;50;0;0;0;0;.00nan;0;0
4306;181123;63;48;34;5;29;.853;3600000;0
4306;192457;63;0;0;0;0;.00nan;0;0
4306;47112;56;0;0;0;0;.00nan;0;0
4306;57207;56;84;19;0;19;1.000;3600000;0
4307;165744;53;29;8;3;5;.625;418000;0
4307;169323;53;97;38;0;38;1.000;3138000;0
4307;176915;38;0;0;0;0;.00nan;0;0
4307;141978;38;59;11;1;10;.909;3600000;0
4308;848;45;0;0;0;0;.00nan;0;0
4308;176938;62;0;0;0;0;.00nan;0;0
4308;196495;45;94;55;4;51;.927;3549000;0
4308;38276;62;54;19;3;16;.842;3600000;0
4309;43731;37;0;0;0;0;.00nan;0;0
4309;58037;37;89;31;2;29;.935;3544000;0
4309;79141;42;0;0;0;0;.00nan;0;0
4309;149450;42;80;26;1;25;.962;3600000;0
4310;171838;41;56;28;3;25;.893;3900000;0
4310;194264;41;0;0;0;0;.00nan;0;0
4310;166441;58;0;0;0;0;.00nan;0;0
4310;38124;58;100;49;3;46;.939;3900000;0
4311;178384;40;60;22;3;19;.864;3600000;0
4311;169868;48;54;48;7;41;.854;3600000;0
4311;85636;40;0;0;0;0;.00nan;0;0
4311;142492;48;0;0;0;0;.00nan;0;0
4312;192776;54;64;48;6;42;.875;3600000;0
4312;181102;46;0;0;0;0;.00nan;0;0
4312;79280;46;50;38;5;33;.868;3600000;0
4312;94615;54;0;0;0;0;.00nan;0;0
4313;169154;44;56;4;0;4;1.000;282000;0
4313;176921;44;55;38;6;32;.842;3318000;0
4313;186495;47;0;0;0;0;.00nan;0;0
4313;86151;47;85;23;1;22;.957;3600000;0
4314;169226;65;0;0;0;0;.00nan;0;0
4314;175084;65;95;51;3;48;.941;3573000;0
4314;59540;59;76;20;1;19;.950;3600000;0
4314;75268;59;0;0;0;0;.00nan;0;0
4315;183783;52;70;24;2;22;.917;3600000;0
4315;175912;57;0;0;0;0;.00nan;0;0
4315;196372;57;57;40;5;35;.875;3600000;0
4315;185812;52;0;0;0;0;.00nan;0;0
4316;31;55;0;0;0;0;.00nan;0;0
4316;187699;39;39;25;4;21;.840;3568000;0
4316;176200;55;99;43;2;41;.953;3600000;0
4316;43928;39;0;0;0;0;.00nan;0;0
4317;192733;61;85;36;2;34;.944;3600000;0
4317;-1;61;0;0;0;0;.00nan;0;0
4317;64722;49;34;32;6;26;.813;3201000;0
4317;79132;49;38;7;2;5;.714;399000;0
4318;182780;60;82;36;3;33;.917;3592000;0
4318;183904;43;82;31;2;29;.935;3600000;0
4318;178612;43;0;0;0;0;.00nan;0;0
4318;170294;60;0;0;0;0;.00nan;0;0
4319;185743;4837;45;20;3;17;.850;3570000;0
4319;187295;4837;0;0;0;0;.00nan;0;0
4319;57215;50;0;0;0;0;.00nan;0;0
4319;141998;50;86;28;1;27;.964;3600000;0
4320;181123;63;79;22;0;22;1.000;2405000;0
4320;192457;63;31;18;5;13;.722;1188000;0
4320;47112;56;0;0;0;0;.00nan;0;0
4320;57207;56;63;33;4;29;.879;3600000;0
4321;169226;65;0;0;0;0;.00nan;0;0
4321;175084;65;72;43;4;39;.907;3575000;0
4321;59540;59;64;26;2;24;.923;3600000;0
4321;75268;59;0;0;0;0;.00nan;0;0
4322;165744;53;68;24;2;22;.917;3600000;0
4322;169323;53;0;0;0;0;.00nan;0;0
4322;176915;38;76;19;1;18;.947;3600000;0
4322;141978;38;0;0;0;0;.00nan;0;0
4323;4622;64;59;35;5;30;.857;3900000;0
4323;168872;64;0;0;0;0;.00nan;0;0
4323;170314;4619;50;28;5;23;.821;3900000;0
4323;191813;4619;0;0;0;0;.00nan;0;0
4324;188888;51;0;0;0;0;.00nan;0;0
4324;173699;36;76;30;2;28;.933;3549000;0
4324;187362;36;0;0;0;0;.00nan;0;0
4324;86360;51;95;35;1;34;.971;3600000;0
4325;169154;44;34;30;6;24;.800;3191000;0
4325;176921;44;45;8;2;6;.750;409000;0
4325;186495;47;99;43;3;40;.930;3600000;0
4325;86151;47;0;0;0;0;.00nan;0;0
4326;848;45;88;44;4;40;.909;3600000;0
4326;176938;62;93;19;0;19;1.000;3600000;0
4326;196495;45;0;0;0;0;.00nan;0;0
4326;38276;62;0;0;0;0;.00nan;0;0
4327;171838;41;51;26;4;22;.846;3900000;0
4327;194264;41;0;0;0;0;.00nan;0;0
4327;166441;58;78;42;4;38;.905;3900000;0
4327;38124;58;0;0;0;0;.00nan;0;0
4328;43731;37;92;37;2;35;.946;3600000;0
4328;58037;37;0;0;0;0;.00nan;0;0
4328;79141;42;46;35;5;30;.857;3600000;0
4328;149450;42;0;0;0;0;.00nan;0;0
4329;31;55;87;42;2;40;.952;3554000;0
4329;187699;39;0;0;0;0;.00nan;0;0
4329;176200;55;0;0;0;0;.00nan;0;0
4329;43928;39;63;17;1;16;.941;3600000;0
4330;192733;61;80;32;2;30;.938;3564000;0
4330;-1;61;0;0;0;0;.00nan;0;0
4330;64722;49;0;0;0;0;.00nan;0;0
4330;79132;49;95;37;1;36;.973;3600000;0
4331;183783;52;0;0;0;0;.00nan;0;0
4331;175912;57;71;32;3;29;.906;3537000;0
4331;196372;57;0;0;0;0;.00nan;0;0
4331;185812;52;79;25;1;24;.960;3600000;0
4332;4622;64;46;23;3;20;.870;3287000;0
4332;168872;64;32;9;3;6;.667;313000;0
4332;170314;4619;0;0;0;0;.00nan;0;0
4332;191813;4619;78;31;2;29;.935;3600000;0
4333;188888;51;0;0;0;0;.00nan;0;0
4333;173699;36;0;0;0;0;.00nan;0;0
4333;187362;36;65;21;2;19;.905;3600000;0
4333;86360;51;73;45;5;40;.889;3600000;0
4334;178384;40;78;27;1;26;.963;3600000;0
4334;169868;48;0;0;0;0;.00nan;0;0
4334;85636;40;0;0;0;0;.00nan;0;0
4334;142492;48;72;37;3;34;.919;3526000;0
4335;192776;54;54;28;4;24;.857;3545000;0
4335;181102;46;0;0;0;0;.00nan;0;0
4335;79280;46;74;26;2;24;.923;3600000;0
4335;94615;54;0;0;0;0;.00nan;0;0
4336;166441;58;0;0;0;0;.00nan;0;0
4336;169226;65;76;26;1;25;.962;3600000;0
4336;175084;65;0;0;0;0;.00nan;0;0
4336;38124;58;80;39;4;35;.897;3600000;0
4337;848;45;57;18;2;16;.889;3600000;0
4337;192776;54;75;46;4;42;.913;3565000;0
4337;196495;45;0;0;0;0;.00nan;0;0
4337;94615;54;0;0;0;0;.00nan;0;0
4338;187699;39;69;24;2;22;.917;3530000;0
4338;43731;37;0;0;0;0;.00nan;0;0
4338;43928;39;0;0;0;0;.00nan;0;0
4338;58037;37;80;26;1;25;.962;3600000;0
4339;171838;41;66;32;3;29;.906;3600000;0
4339;188888;51;0;0;0;0;.00nan;0;0
4339;194264;41;0;0;0;0;.00nan;0;0
4339;86360;51;56;39;5;34;.872;3555000;0
4340;183904;43;86;30;2;28;.933;3900000;0
4340;178612;43;0;0;0;0;.00nan;0;0
4340;47112;56;0;0;0;0;.00nan;0;0
4340;57207;56;80;29;2;27;.931;3900000;0
4341;170314;4619;58;38;4;34;.895;3600000;0
4341;191813;4619;0;0;0;0;.00nan;0;0
4341;79141;42;0;0;0;0;.00nan;0;0
4341;149450;42;74;16;1;15;.938;3600000;0
4342;178384;40;80;37;2;35;.946;3600000;0
4342;169154;44;0;0;0;0;.00nan;0;0
4342;176921;44;74;21;1;20;.952;3600000;0
4342;85636;40;0;0;0;0;.00nan;0;0
4343;182780;60;0;0;0;0;.00nan;0;0
4343;170294;60;73;25;2;23;.920;3516000;0
4343;186495;47;0;0;0;0;.00nan;0;0
4343;86151;47;100;32;0;32;1.000;3600000;0
4344;43731;37;0;0;0;0;.00nan;0;0
4344;47112;56;0;0;0;0;.00nan;0;0
4344;57207;56;62;40;4;36;.900;3571000;0
4344;58037;37;74;34;3;31;.912;3600000;0
4345;169868;48;0;0;0;0;.00nan;0;0
4345;181102;46;0;0;0;0;.00nan;0;0
4345;79280;46;47;38;6;32;.842;3600000;0
4345;142492;48;70;30;2;28;.933;3600000;0
4346;176938;62;93;34;1;33;.971;3600000;0
4346;38276;62;0;0;0;0;.00nan;0;0
4346;64722;49;0;0;0;0;.00nan;0;0
4346;79132;49;81;46;4;42;.913;3600000;0
4347;848;45;92;60;3;57;.950;3600000;0
4347;196495;45;0;0;0;0;.00nan;0;0
4347;79141;42;0;0;0;0;.00nan;0;0
4347;149450;42;89;13;0;13;1.000;3600000;0
4348;171838;41;99;67;2;65;.970;3600000;0
4348;194264;41;0;0;0;0;.00nan;0;0
4348;183904;43;47;17;3;14;.824;3570000;0
4348;178612;43;0;0;0;0;.00nan;0;0
4349;166441;58;50;1;0;1;1.000;258000;0
4349;169226;65;0;0;0;0;.00nan;0;0
4349;175084;65;82;28;2;26;.929;3600000;0
4349;38124;58;58;52;7;45;.865;3342000;0
4350;169154;44;0;0;0;0;.00nan;0;0
4350;176921;44;56;23;2;21;.913;3900000;0
4350;185743;4837;92;31;2;29;.935;3900000;0
4350;187295;4837;0;0;0;0;.00nan;0;0
4351;165744;53;0;0;0;0;.00nan;0;0
4351;169323;53;53;24;3;21;.875;3791000;0
4351;181123;63;85;36;2;34;.944;3791000;0
4351;192457;63;0;0;0;0;.00nan;0;0
4352;192776;54;87;47;2;45;.957;3600000;0
4352;170314;4619;84;16;0;16;1.000;3600000;0
4352;191813;4619;0;0;0;0;.00nan;0;0
4352;94615;54;0;0;0;0;.00nan;0;0
4353;192733;61;100;28;0;28;1.000;3600000;0
4353;178384;40;79;46;4;42;.913;3600000;0
4353;-1;61;0;0;0;0;.00nan;0;0
4353;85636;40;0;0;0;0;.00nan;0;0
4354;31;55;0;0;0;0;.00nan;0;0
4354;176200;55;84;38;2;36;.947;3600000;0
4354;176915;38;0;0;0;0;.00nan;0;0
4354;141978;38;62;24;3;21;.875;3582000;0
4355;4622;64;79;34;2;32;.941;3600000;0
4355;168872;64;0;0;0;0;.00nan;0;0
4355;57215;50;37;22;4;18;.818;3530000;0
4355;141998;50;0;0;0;0;.00nan;0;0
4356;173699;36;0;0;0;0;.00nan;0;0
4356;187362;36;97;42;2;40;.952;3900000;0
4356;59540;59;76;20;2;18;.900;3900000;0
4356;75268;59;0;0;0;0;.00nan;0;0
4357;188888;51;0;0;0;0;.00nan;0;0
4357;183783;52;56;33;4;29;.879;3544000;0
4357;185812;52;0;0;0;0;.00nan;0;0
4357;86360;51;57;25;3;22;.880;3600000;0
4358;182780;60;85;29;1;28;.966;3600000;0
4358;170294;60;0;0;0;0;.00nan;0;0
4358;186495;47;0;0;0;0;.00nan;0;0
4358;86151;47;76;30;2;28;.933;3573000;0
4359;169154;44;93;41;3;38;.927;3900000;0
4359;176921;44;0;0;0;0;.00nan;0;0
4359;185743;4837;72;38;3;35;.921;3900000;0
4359;187295;4837;0;0;0;0;.00nan;0;0
4360;43731;37;65;37;4;33;.892;3573000;0
4360;47112;56;94;41;3;38;.927;3600000;0
4360;57207;56;0;0;0;0;.00nan;0;0
4360;58037;37;0;0;0;0;.00nan;0;0
4361;176938;62;0;0;0;0;.00nan;0;0
4361;38276;62;73;18;1;17;.944;3600000;0
4361;64722;49;25;7;3;4;.571;528000;0
4361;79132;49;85;37;2;35;.946;3072000;0
4362;188888;51;0;0;0;0;.00nan;0;0
4362;176915;38;92;34;1;33;.971;3600000;0
4362;86360;51;61;28;3;25;.893;3523000;0
4362;141978;38;0;0;0;0;.00nan;0;0
4363;848;45;0;0;0;0;.00nan;0;0
4363;196495;45;100;47;1;46;.979;3600000;0
4363;79141;42;0;0;0;0;.00nan;0;0
4363;149450;42;49;20;3;17;.850;3578000;0
4364;171838;41;86;43;3;40;.930;3593000;0
4364;194264;41;0;0;0;0;.00nan;0;0
4364;183904;43;0;0;0;0;.00nan;0;0
4364;178612;43;64;22;1;21;.955;3600000;0
4365;165744;53;93;22;0;22;1.000;3600000;0
4365;166441;58;21;27;6;21;.778;2389000;0
4365;169323;53;0;0;0;0;.00nan;0;0
4365;38124;58;56;16;2;14;.875;1211000;0
4366;192776;54;0;0;0;0;.00nan;0;0
4366;170314;4619;72;28;2;26;.929;3600000;0
4366;191813;4619;0;0;0;0;.00nan;0;0
4366;94615;54;66;47;5;42;.894;3600000;0
4367;192733;61;63;14;1;13;.929;3600000;0
4367;178384;40;75;34;3;31;.912;3535000;0
4367;-1;61;0;0;0;0;.00nan;0;0
4367;85636;40;0;0;0;0;.00nan;0;0
4368;175912;57;49;41;6;35;.854;3600000;0
4368;196372;57;0;0;0;0;.00nan;0;0
4368;59540;59;85;14;0;14;1.000;3600000;0
4368;75268;59;0;0;0;0;.00nan;0;0
4369;31;55;97;56;3;53;.946;3600000;0
4369;173699;36;100;22;0;22;1.000;3600000;0
4369;176200;55;0;0;0;0;.00nan;0;0
4369;187362;36;0;0;0;0;.00nan;0;0
4370;4622;64;0;0;0;0;.00nan;0;0
4370;168872;64;72;45;4;41;.911;3600000;0
4370;57215;50;0;0;0;0;.00nan;0;0
4370;141998;50;59;16;2;14;.875;3600000;0
4371;183783;52;0;0;0;0;.00nan;0;0
4371;169226;65;78;44;4;40;.909;3600000;0
4371;175084;65;0;0;0;0;.00nan;0;0
4371;185812;52;100;32;0;32;1.000;3600000;0
4372;169868;48;0;0;0;0;.00nan;0;0
4372;181102;46;0;0;0;0;.00nan;0;0
4372;79280;46;89;38;2;36;.947;3544000;0
4372;142492;48;68;20;1;19;.950;3600000;0
4373;165744;53;60;21;2;19;.905;3600000;0
4373;169323;53;0;0;0;0;.00nan;0;0
4373;176915;38;0;0;0;0;.00nan;0;0
4373;141978;38;56;27;3;24;.889;3553000;0
4374;187699;39;83;31;1;30;.968;3600000;0
4374;43731;37;65;23;2;21;.913;2572000;0
4374;43928;39;0;0;0;0;.00nan;0;0
4374;58037;37;22;10;4;6;.600;1028000;0
4375;31;55;0;0;0;0;.00nan;0;0
4375;173699;36;71;37;3;34;.919;3600000;0
4375;176200;55;77;53;5;48;.906;3565000;0
4375;187362;36;0;0;0;0;.00nan;0;0
4376;176938;62;61;24;3;21;.875;3552000;0
4376;38276;62;0;0;0;0;.00nan;0;0
4376;185743;4837;100;37;1;36;.973;3600000;0
4376;187295;4837;0;0;0;0;.00nan;0;0
4377;848;45;92;35;1;34;.971;3900000;0
4377;4622;64;100;31;1;30;.968;3900000;0
4377;168872;64;0;0;0;0;.00nan;0;0
4377;196495;45;0;0;0;0;.00nan;0;0
4378;182780;60;100;33;1;32;.970;3900000;0
4378;170294;60;0;0;0;0;.00nan;0;0
4378;186495;47;0;0;0;0;.00nan;0;0
4378;86151;47;78;18;1;17;.944;3900000;0
4379;43731;37;0;0;0;0;.00nan;0;0
4379;57215;50;0;0;0;0;.00nan;0;0
4379;58037;37;61;43;5;38;.884;3900000;0
4379;141998;50;66;41;5;36;.878;3900000;0
4380;169226;65;0;0;0;0;.00nan;0;0
4380;175084;65;44;24;4;20;.833;3540000;0
4380;176915;38;0;0;0;0;.00nan;0;0
4380;141978;38;84;33;2;31;.939;3600000;0
4381;165744;53;0;0;0;0;.00nan;0;0
4381;166441;58;0;0;0;0;.00nan;0;0
4381;169323;53;85;22;0;22;1.000;3600000;0
4381;38124;58;89;45;3;42;.933;3600000;0
4382;178384;40;51;28;4;24;.857;3545000;0
4382;169154;44;0;0;0;0;.00nan;0;0
4382;176921;44;58;30;3;27;.900;3600000;0
4382;85636;40;0;0;0;0;.00nan;0;0
4383;175912;57;0;0;0;0;.00nan;0;0
4383;196372;57;100;39;1;38;.974;3600000;0
4383;181123;63;62;28;3;25;.893;3515000;0
4383;192457;63;0;0;0;0;.00nan;0;0
4384;31;55;0;0;0;0;.00nan;0;0
4384;183783;52;0;0;0;0;.00nan;0;0
4384;176200;55;45;45;6;39;.867;3600000;0
4384;185812;52;67;20;2;18;.900;3600000;0
4385;188888;51;0;0;0;0;.00nan;0;0
4385;47112;56;0;0;0;0;.00nan;0;0
4385;57207;56;65;25;3;22;.880;3600000;0
4385;86360;51;53;28;4;24;.857;3600000;0
4386;165744;53;0;0;0;0;.00nan;0;0
4386;169323;53;63;37;4;33;.892;3600000;0
4386;59540;59;68;18;1;17;.944;3600000;0
4386;75268;59;0;0;0;0;.00nan;0;0
4387;188888;51;0;0;0;0;.00nan;0;0
4387;47112;56;86;27;1;26;.963;3600000;0
4387;57207;56;0;0;0;0;.00nan;0;0
4387;86360;51;77;42;4;38;.905;3600000;0
4388;43731;37;0;0;0;0;.00nan;0;0
4388;57215;50;0;0;0;0;.00nan;0;0
4388;58037;37;70;35;4;31;.886;3589000;0
4388;141998;50;77;34;3;31;.912;3600000;0
4389;171838;41;49;30;4;26;.867;3566000;0
4389;194264;41;0;0;0;0;.00nan;0;0
4389;181123;63;67;34;3;31;.912;3600000;0
4389;192457;63;0;0;0;0;.00nan;0;0
4390;166441;58;0;0;0;0;.00nan;0;0
4390;183904;43;66;21;2;19;.905;3600000;0
4390;178612;43;0;0;0;0;.00nan;0;0
4390;38124;58;58;59;9;50;.847;3600000;0
4391;181102;46;0;0;0;0;.00nan;0;0
4391;79141;42;0;0;0;0;.00nan;0;0
4391;79280;46;49;48;7;41;.854;3600000;0
4391;149450;42;57;11;1;10;.909;3600000;0
4392;187699;39;52;30;4;26;.867;3600000;0
4392;169226;65;61;39;5;34;.872;3543000;0
4392;175084;65;0;0;0;0;.00nan;0;0
4392;43928;39;0;0;0;0;.00nan;0;0
4393;848;45;88;21;0;21;1.000;3600000;0
4393;192776;54;78;48;5;43;.896;3600000;0
4393;196495;45;0;0;0;0;.00nan;0;0
4393;94615;54;0;0;0;0;.00nan;0;0
4394;192733;61;87;27;1;26;.963;3600000;0
4394;169868;48;0;0;0;0;.00nan;0;0
4394;-1;61;0;0;0;0;.00nan;0;0
4394;142492;48;46;35;5;30;.857;3600000;0
4395;182780;60;55;11;1;10;.909;1706000;0
4395;170294;60;23;12;4;8;.667;1855000;0
4395;64722;49;0;0;0;0;.00nan;0;0
4395;79132;49;84;54;4;50;.926;3600000;0
4396;183783;52;68;32;3;29;.906;3600000;0
4396;173699;36;47;41;6;35;.854;3600000;0
4396;185812;52;0;0;0;0;.00nan;0;0
4396;187362;36;0;0;0;0;.00nan;0;0
4397;165744;53;61;53;7;46;.868;3600000;0
4397;169323;53;0;0;0;0;.00nan;0;0
4397;59540;59;97;36;1;35;.972;3600000;0
4397;75268;59;0;0;0;0;.00nan;0;0
4398;4622;64;66;30;2;28;.933;3546000;0
4398;168872;64;0;0;0;0;.00nan;0;0
4398;57215;50;100;35;0;35;1.000;3600000;0
4398;141998;50;0;0;0;0;.00nan;0;0
4399;185743;4837;59;27;3;24;.889;3900000;0
4399;186495;47;84;43;3;40;.930;3900000;0
4399;187295;4837;0;0;0;0;.00nan;0;0
4399;86151;47;0;0;0;0;.00nan;0;0
4400;183904;43;100;27;0;27;1.000;3600000;0
4400;178612;43;0;0;0;0;.00nan;0;0
4400;176915;38;0;0;0;0;.00nan;0;0
4400;141978;38;76;44;4;40;.909;3600000;0
4401;166441;58;62;38;4;34;.895;3667000;0
4401;175912;57;59;30;3;27;.900;3667000;0
4401;196372;57;0;0;0;0;.00nan;0;0
4401;38124;58;0;0;0;0;.00nan;0;0
4402;169154;44;0;0;0;0;.00nan;0;0
4402;176921;44;80;48;4;44;.917;3522000;0
4402;176938;62;67;21;2;19;.905;3600000;0
4402;38276;62;0;0;0;0;.00nan;0;0
4403;848;45;96;22;0;22;1.000;3600000;0
4403;192776;54;0;0;0;0;.00nan;0;0
4403;196495;45;0;0;0;0;.00nan;0;0
4403;94615;54;74;51;5;46;.902;3600000;0
4404;178384;40;71;50;5;45;.900;3600000;0
4404;170314;4619;70;20;2;18;.900;3600000;0
4404;191813;4619;0;0;0;0;.00nan;0;0
4404;85636;40;0;0;0;0;.00nan;0;0
4405;192733;61;0;0;0;0;.00nan;0;0
4405;169868;48;60;47;5;42;.894;3600000;0
4405;-1;61;70;9;0;9;1.000;3600000;0
4405;142492;48;0;0;0;0;.00nan;0;0
4406;182780;60;0;0;0;0;.00nan;0;0
4406;170294;60;53;24;4;20;.833;3600000;0
4406;64722;49;20;11;4;7;.636;1192000;0
4406;79132;49;53;23;3;20;.870;2408000;0
4407;31;55;0;0;0;0;.00nan;0;0
4407;173699;36;0;0;0;0;.00nan;0;0
4407;176200;55;97;62;4;58;.935;3566000;0
4407;187362;36;53;15;3;12;.800;3600000;0
4408;183783;52;0;0;0;0;.00nan;0;0
4408;181123;63;52;3;0;3;1.000;278000;0
4408;185812;52;54;41;5;36;.878;3600000;0
4408;192457;63;48;37;6;31;.838;3305000;0
4409;192776;54;93;43;3;40;.930;3548000;0
4409;4622;64;0;0;0;0;.00nan;0;0
4409;168872;64;88;33;2;31;.939;3600000;0
4409;94615;54;0;0;0;0;.00nan;0;0
4410;176938;62;0;0;0;0;.00nan;0;0
4410;38276;62;38;25;5;20;.800;3559000;0
4410;186495;47;0;0;0;0;.00nan;0;0
4410;86151;47;67;33;3;30;.909;3600000;0
4411;171838;41;79;42;4;38;.905;3570000;0
4411;187699;39;55;22;2;20;.909;3600000;0
4411;194264;41;0;0;0;0;.00nan;0;0
4411;43928;39;0;0;0;0;.00nan;0;0
4412;175912;57;0;0;0;0;.00nan;0;0
4412;176915;38;61;19;3;16;.842;3600000;0
4412;196372;57;64;33;4;29;.879;3541000;0
4412;141978;38;0;0;0;0;.00nan;0;0
4413;181102;46;61;15;1;14;.933;1510000;0
4413;79141;42;0;0;0;0;.00nan;0;0
4413;79280;46;40;26;5;21;.808;2090000;0
4413;149450;42;69;18;1;17;.944;3600000;0
4414;31;55;51;49;6;43;.878;3600000;0
4414;169226;65;41;8;2;6;.750;999000;0
4414;175084;65;19;21;6;15;.714;2569000;0
4414;176200;55;0;0;0;0;.00nan;0;0
4415;4622;64;55;34;5;29;.853;3825000;0
4415;168872;64;0;0;0;0;.00nan;0;0
4415;181102;46;0;0;0;0;.00nan;0;0
4415;79280;46;68;35;4;31;.886;3825000;0
4416;43731;37;0;0;0;0;.00nan;0;0
4416;57215;50;87;28;2;26;.929;3600000;0
4416;58037;37;47;20;3;17;.850;3586000;0
4416;141998;50;0;0;0;0;.00nan;0;0
4417;182780;60;83;28;2;26;.929;3768000;0
4417;169154;44;0;0;0;0;.00nan;0;0
4417;170294;60;0;0;0;0;.00nan;0;0
4417;176921;44;76;32;3;29;.906;3768000;0
4418;169868;48;0;0;0;0;.00nan;0;0
4418;185743;4837;79;37;3;34;.919;3900000;0
4418;187295;4837;0;0;0;0;.00nan;0;0
4418;142492;48;93;49;3;46;.939;3900000;0
4419;178384;40;0;0;0;0;.00nan;0;0
4419;186495;47;0;0;0;0;.00nan;0;0
4419;85636;40;69;38;3;35;.921;3549000;0
4419;86151;47;82;21;1;20;.952;3600000;0
4420;848;45;76;49;5;44;.898;3600000;0
4420;196495;45;0;0;0;0;.00nan;0;0
4420;79141;42;0;0;0;0;.00nan;0;0
4420;149450;42;52;17;2;15;.882;3600000;0
4421;188888;51;0;0;0;0;.00nan;0;0
4421;181123;63;71;27;2;25;.926;3600000;0
4421;192457;63;0;0;0;0;.00nan;0;0
4421;86360;51;89;47;3;44;.936;3600000;0
4422;192776;54;82;65;6;59;.908;3600000;0
4422;170314;4619;26;12;4;8;.667;3600000;0
4422;191813;4619;0;0;0;0;.00nan;0;0
4422;94615;54;0;0;0;0;.00nan;0;0
4423;192733;61;0;0;0;0;.00nan;0;0
4423;-1;61;72;19;1;18;.947;3600000;0
4423;64722;49;0;0;0;0;.00nan;0;0
4423;79132;49;73;37;3;34;.919;3600000;0
4424;31;55;0;0;0;0;.00nan;0;0
4424;183904;43;80;17;1;16;.941;3600000;0
4424;178612;43;0;0;0;0;.00nan;0;0
4424;176200;55;64;36;4;32;.889;3600000;0
4425;43731;37;83;38;3;35;.921;3600000;0
4425;57215;50;0;0;0;0;.00nan;0;0
4425;58037;37;0;0;0;0;.00nan;0;0
4425;141998;50;29;28;6;22;.786;3600000;0
4426;187699;39;0;0;0;0;.00nan;0;0
4426;169226;65;54;33;4;29;.879;3551000;0
4426;175084;65;0;0;0;0;.00nan;0;0
4426;43928;39;55;21;3;18;.857;3600000;0
4427;182780;60;0;0;0;0;.00nan;0;0
4427;169154;44;52;32;5;27;.844;3600000;0
4427;170294;60;66;34;3;31;.912;3600000;0
4427;176921;44;0;0;0;0;.00nan;0;0
4428;183783;52;84;31;2;29;.935;3600000;0
4428;185812;52;0;0;0;0;.00nan;0;0
4428;47112;56;0;0;0;0;.00nan;0;0
4428;57207;56;39;23;4;19;.826;3535000;0
4429;165744;53;0;0;0;0;.00nan;0;0
4429;166441;58;0;0;0;0;.00nan;0;0
4429;169323;53;100;39;0;39;1.000;3600000;0
4429;38124;58;76;38;3;35;.921;3600000;0
4430;185743;4837;51;25;4;21;.840;3600000;0
4430;187295;4837;0;0;0;0;.00nan;0;0
4430;64722;49;0;0;0;0;.00nan;0;0
4430;79132;49;58;46;5;41;.891;3591000;0
4431;187699;39;71;24;2;22;.917;3600000;0
4431;43928;39;0;0;0;0;.00nan;0;0
4431;47112;56;66;33;3;30;.909;3545000;0
4431;57207;56;0;0;0;0;.00nan;0;0
4432;165744;53;0;0;0;0;.00nan;0;0
4432;166441;58;39;35;6;29;.829;3305000;0
4432;169323;53;47;25;4;21;.840;3600000;0
4432;38124;58;52;3;0;3;1.000;249000;0
4433;169868;48;0;0;0;0;.00nan;0;0
4433;176938;62;80;10;0;10;1.000;3600000;0
4433;38276;62;0;0;0;0;.00nan;0;0
4433;142492;48;85;60;5;55;.917;3600000;0
4434;171838;41;98;39;2;37;.949;3600000;0
4434;194264;41;0;0;0;0;.00nan;0;0
4434;59540;59;24;14;4;10;.714;3527000;0
4434;75268;59;0;0;0;0;.00nan;0;0
4435;192733;61;66;25;2;23;.920;3600000;0
4435;178384;40;55;29;4;25;.862;3547000;0
4435;-1;61;0;0;0;0;.00nan;0;0
4435;85636;40;0;0;0;0;.00nan;0;0
4436;848;45;0;0;0;0;.00nan;0;0
4436;181102;46;0;0;0;0;.00nan;0;0
4436;196495;45;100;33;1;32;.970;3900000;0
4436;79280;46;97;43;1;42;.977;3900000;0
4437;183783;52;0;0;0;0;.00nan;0;0
4437;183904;43;99;28;1;27;.964;3600000;0
4437;178612;43;0;0;0;0;.00nan;0;0
4437;185812;52;88;37;2;35;.946;3600000;0
4438;4622;64;61;42;5;37;.881;3584000;0
4438;168872;64;0;0;0;0;.00nan;0;0
4438;79141;42;0;0;0;0;.00nan;0;0
4438;149450;42;54;27;4;23;.852;3600000;0
4439;169226;65;0;0;0;0;.00nan;0;0
4439;175084;65;99;34;1;33;.971;3600000;0
4439;181123;63;66;34;3;31;.912;3521000;0
4439;192457;63;0;0;0;0;.00nan;0;0
4440;192776;54;93;49;2;47;.959;3900000;0
4440;170314;4619;72;23;2;21;.913;3900000;0
4440;191813;4619;0;0;0;0;.00nan;0;0
4440;94615;54;0;0;0;0;.00nan;0;0
4441;175912;57;67;37;3;34;.919;3900000;0
4441;176915;38;0;0;0;0;.00nan;0;0
4441;196372;57;0;0;0;0;.00nan;0;0
4441;141978;38;71;27;3;24;.889;3900000;0
4442;31;55;0;0;0;0;.00nan;0;0
4442;188888;51;0;0;0;0;.00nan;0;0
4442;176200;55;81;42;3;39;.929;3900000;0
4442;86360;51;70;31;3;28;.903;3900000;0
4443;4622;64;0;0;0;0;.00nan;0;0
4443;168872;64;79;56;4;52;.929;3600000;0
4443;79141;42;0;0;0;0;.00nan;0;0
4443;149450;42;38;25;5;20;.800;3578000;0
4444;185743;4837;0;0;0;0;.00nan;0;0
4444;186495;47;66;40;4;36;.900;3556000;0
4444;187295;4837;63;30;3;27;.900;3600000;0
4444;86151;47;0;0;0;0;.00nan;0;0
4445;169868;48;60;40;4;36;.900;3600000;0
4445;176938;62;76;16;1;15;.938;3600000;0
4445;38276;62;0;0;0;0;.00nan;0;0
4445;142492;48;0;0;0;0;.00nan;0;0
4446;192733;61;0;0;0;0;.00nan;0;0
4446;178384;40;98;33;0;33;1.000;3900000;0
4446;-1;61;100;29;0;29;1.000;3900000;0
4446;85636;40;0;0;0;0;.00nan;0;0
4447;169226;65;90;31;1;30;.968;3600000;0
4447;175084;65;0;0;0;0;.00nan;0;0
4447;176915;38;64;24;2;22;.917;3578000;0
4447;141978;38;0;0;0;0;.00nan;0;0
4448;848;45;85;28;1;27;.964;3600000;0
4448;181102;46;56;30;3;27;.900;3544000;0
4448;196495;45;0;0;0;0;.00nan;0;0
4448;79280;46;0;0;0;0;.00nan;0;0
4449;170314;4619;0;0;0;0;.00nan;0;0
4449;191813;4619;81;25;1;24;.960;3600000;0
4449;64722;49;49;46;7;39;.848;3215000;0
4449;79132;49;48;0;0;0;.00nan;385000;0
4450;175912;57;0;0;0;0;.00nan;0;0
4450;196372;57;96;50;2;48;.960;3900000;0
4450;59540;59;68;21;2;19;.905;3900000;0
4450;75268;59;0;0;0;0;.00nan;0;0
4451;31;55;91;33;2;31;.939;3600000;0
4451;176200;55;0;0;0;0;.00nan;0;0
4451;181123;63;0;0;0;0;.00nan;0;0
4451;192457;63;32;10;3;7;.700;3591000;0
4452;188888;51;0;0;0;0;.00nan;0;0
4452;173699;36;31;29;6;23;.793;3585000;0
4452;187362;36;0;0;0;0;.00nan;0;0
4452;86360;51;78;45;5;40;.889;3600000;0
4453;187699;39;0;0;0;0;.00nan;0;0
4453;43928;39;86;28;1;27;.964;3600000;0
4453;47112;56;0;0;0;0;.00nan;0;0
4453;57207;56;43;33;6;27;.818;3600000;0
4454;178384;40;81;48;4;44;.917;3600000;0
4454;185743;4837;86;16;0;16;1.000;3600000;0
4454;187295;4837;0;0;0;0;.00nan;0;0
4454;85636;40;0;0;0;0;.00nan;0;0
4455;169226;65;0;0;0;0;.00nan;0;0
4455;175084;65;51;45;6;39;.867;3600000;0
4455;59540;59;56;14;2;12;.857;3600000;0
4455;75268;59;0;0;0;0;.00nan;0;0
4456;187699;39;55;14;1;13;.929;3571000;0
4456;188888;51;0;0;0;0;.00nan;0;0
4456;43928;39;0;0;0;0;.00nan;0;0
4456;86360;51;100;44;0;44;1.000;3600000;0
4457;170314;4619;95;47;3;44;.936;3900000;0
4457;186495;47;71;31;3;28;.903;3900000;0
4457;191813;4619;0;0;0;0;.00nan;0;0
4457;86151;47;0;0;0;0;.00nan;0;0
4458;183783;52;65;44;4;40;.909;3900000;0
4458;176915;38;0;0;0;0;.00nan;0;0
4458;185812;52;0;0;0;0;.00nan;0;0
4458;141978;38;94;42;4;38;.905;3900000;0
4459;166441;58;0;0;0;0;.00nan;0;0
4459;173699;36;72;29;3;26;.897;3558000;0
4459;38124;58;70;27;2;25;.926;3600000;0
4459;187362;36;0;0;0;0;.00nan;0;0
4460;4622;64;0;0;0;0;.00nan;0;0
4460;168872;64;80;33;2;31;.939;3600000;0
4460;79141;42;85;32;1;31;.969;3600000;0
4460;149450;42;0;0;0;0;.00nan;0;0
4461;31;55;0;0;0;0;.00nan;0;0
4461;176200;55;50;40;5;35;.875;3600000;0
4461;181123;63;63;16;1;15;.938;3600000;0
4461;192457;63;0;0;0;0;.00nan;0;0
4462;192776;54;92;46;3;43;.935;3600000;0
4462;43731;37;0;0;0;0;.00nan;0;0
4462;58037;37;70;18;1;17;.944;3600000;0
4462;94615;54;0;0;0;0;.00nan;0;0
4463;171838;41;74;26;2;24;.923;3551000;0
4463;194264;41;0;0;0;0;.00nan;0;0
4463;175912;57;96;23;0;23;1.000;3600000;0
4463;196372;57;0;0;0;0;.00nan;0;0
4464;183904;43;63;26;3;23;.885;3554000;0
4464;178612;43;0;0;0;0;.00nan;0;0
4464;47112;56;0;0;0;0;.00nan;0;0
4464;57207;56;59;21;2;19;.905;3600000;0
4465;182780;60;72;18;1;17;.944;3600000;0
4465;169868;48;0;0;0;0;.00nan;0;0
4465;170294;60;0;0;0;0;.00nan;0;0
4465;142492;48;75;46;4;42;.913;3600000;0
4466;848;45;75;38;3;35;.921;3594000;0
4466;176938;62;91;26;1;25;.962;3600000;0
4466;196495;45;0;0;0;0;.00nan;0;0
4466;38276;62;0;0;0;0;.00nan;0;0
4467;169154;44;0;0;0;0;.00nan;0;0
4467;170314;4619;63;35;4;31;.886;3600000;0
4467;176921;44;39;30;5;25;.833;3577000;0
4467;191813;4619;0;0;0;0;.00nan;0;0
4468;192733;61;0;0;0;0;.00nan;0;0
4468;-1;61;71;39;3;36;.923;3549000;0
4468;185743;4837;65;20;2;18;.900;3600000;0
4468;187295;4837;0;0;0;0;.00nan;0;0
4469;182780;60;0;0;0;0;.00nan;0;0
4469;169868;48;76;42;3;39;.929;3900000;0
4469;170294;60;61;29;3;26;.897;3900000;0
4469;142492;48;0;0;0;0;.00nan;0;0
4470;4622;64;0;0;0;0;.00nan;0;0
4470;168872;64;64;32;3;29;.906;3600000;0
4470;43731;37;0;0;0;0;.00nan;0;0
4470;58037;37;58;45;5;40;.889;3588000;0
4471;31;55;0;0;0;0;.00nan;0;0
4471;183904;43;40;10;2;8;.800;3600000;0
4471;178612;43;0;0;0;0;.00nan;0;0
4471;176200;55;77;54;5;49;.907;3600000;0
4472;181102;46;0;0;0;0;.00nan;0;0
4472;57215;50;0;0;0;0;.00nan;0;0
4472;79280;46;54;30;4;26;.867;3543000;0
4472;141998;50;73;35;3;32;.914;3600000;0
4473;176915;38;0;0;0;0;.00nan;0;0
4473;181123;63;60;37;5;32;.865;3600000;0
4473;192457;63;0;0;0;0;.00nan;0;0
4473;141978;38;92;28;1;27;.964;3600000;0
4474;175912;57;97;50;2;48;.960;3552000;0
4474;196372;57;0;0;0;0;.00nan;0;0
4474;59540;59;100;23;0;23;1.000;3600000;0
4474;75268;59;0;0;0;0;.00nan;0;0
4475;186495;47;0;0;0;0;.00nan;0;0
4475;64722;49;0;0;0;0;.00nan;0;0
4475;79132;49;88;36;2;34;.944;3900000;0
4475;86151;47;68;17;2;15;.882;3900000;0
4476;169226;65;74;32;3;29;.906;3600000;0
4476;173699;36;100;29;0;29;1.000;3600000;0
4476;175084;65;0;0;0;0;.00nan;0;0
4476;187362;36;0;0;0;0;.00nan;0;0
4477;165744;53;0;0;0;0;.00nan;0;0
4477;183783;52;0;0;0;0;.00nan;0;0
4477;169323;53;100;39;0;39;1.000;3600000;0
4477;185812;52;78;32;1;31;.969;3543000;0
4478;4622;64;76;20;1;19;.950;3600000;0
4478;188888;51;55;4;0;4;1.000;410000;0
4478;168872;64;0;0;0;0;.00nan;0;0
4478;86360;51;51;34;6;28;.824;3190000;0
4479;171838;41;82;32;2;30;.938;3600000;0
4479;194264;41;0;0;0;0;.00nan;0;0
4479;59540;59;61;14;1;13;.929;3600000;0
4479;75268;59;0;0;0;0;.00nan;0;0
4480;178384;40;96;38;2;36;.947;3894000;0
4480;169154;44;0;0;0;0;.00nan;0;0
4480;176921;44;86;27;2;25;.926;3900000;0
4480;85636;40;0;0;0;0;.00nan;0;0
4481;848;45;81;34;3;31;.912;3600000;0
4481;176938;62;56;12;1;11;.917;3600000;0
4481;196495;45;0;0;0;0;.00nan;0;0
4481;38276;62;0;0;0;0;.00nan;0;0
4482;31;55;93;35;1;34;.971;3900000;0
4482;183904;43;82;29;1;28;.966;3900000;0
4482;178612;43;0;0;0;0;.00nan;0;0
4482;176200;55;0;0;0;0;.00nan;0;0
4483;166441;58;88;38;3;35;.921;2567000;0
4483;176915;38;62;26;2;24;.923;3600000;0
4483;38124;58;24;13;4;9;.692;1033000;0
4483;141978;38;0;0;0;0;.00nan;0;0
4484;192776;54;92;58;4;54;.931;3600000;0
4484;79141;42;0;0;0;0;.00nan;0;0
4484;94615;54;0;0;0;0;.00nan;0;0
4484;149450;42;100;27;0;27;1.000;3600000;0
4485;192733;61;93;54;3;51;.944;3692000;0
4485;-1;61;0;0;0;0;.00nan;0;0
4485;185743;4837;0;0;0;0;.00nan;0;0
4485;187295;4837;78;27;2;25;.926;3692000;0
4486;169226;65;0;0;0;0;.00nan;0;0
4486;175084;65;81;28;2;26;.929;3900000;0
4486;175912;57;0;0;0;0;.00nan;0;0
4486;196372;57;70;23;2;21;.913;3900000;0
4487;187699;39;77;33;2;31;.939;3600000;0
4487;43928;39;0;0;0;0;.00nan;0;0
4487;47112;56;0;0;0;0;.00nan;0;0
4487;57207;56;60;35;4;31;.886;3588000;0
4488;170314;4619;75;24;2;22;.917;3600000;0
4488;191813;4619;0;0;0;0;.00nan;0;0
4488;64722;49;74;41;4;37;.902;3513000;0
4488;79132;49;0;0;0;0;.00nan;0;0
4489;173699;36;100;23;0;23;1.000;3600000;0
4489;181123;63;0;0;0;0;.00nan;0;0
4489;187362;36;0;0;0;0;.00nan;0;0
4489;192457;63;92;43;2;41;.953;3592000;0
4490;165744;53;49;26;4;22;.846;3517000;0
4490;183783;52;77;29;2;27;.931;3600000;0
4490;169323;53;0;0;0;0;.00nan;0;0
4490;185812;52;0;0;0;0;.00nan;0;0
4491;188888;51;79;54;5;49;.907;3600000;0
4491;43731;37;0;0;0;0;.00nan;0;0
4491;58037;37;48;7;1;6;.857;3600000;0
4491;86360;51;0;0;0;0;.00nan;0;0
4492;165744;53;0;0;0;0;.00nan;0;0
4492;166441;58;88;44;3;41;.932;3414000;0
4492;169323;53;28;23;6;17;.739;3900000;0
4492;38124;58;30;9;3;6;.667;482000;0
4493;181102;46;0;0;0;0;.00nan;0;0
4493;57215;50;0;0;0;0;.00nan;0;0
4493;79280;46;78;30;2;28;.933;3600000;0
4493;141998;50;77;34;3;31;.912;3563000;0
4494;178384;40;82;46;4;42;.913;3668000;0
4494;169154;44;53;32;5;27;.844;3701000;0
4494;176921;44;0;0;0;0;.00nan;0;0
4494;85636;40;0;0;0;0;.00nan;0;0
4495;192776;54;0;0;0;0;.00nan;0;0
4495;79141;42;0;0;0;0;.00nan;0;0
4495;94615;54;100;47;0;47;1.000;3900000;0
4495;149450;42;71;13;0;13;1.000;3900000;0
4496;169868;48;0;0;0;0;.00nan;0;0
4496;186495;47;0;0;0;0;.00nan;0;0
4496;86151;47;56;21;3;18;.857;3600000;0
4496;142492;48;42;32;5;27;.844;3600000;0
4497;169868;48;0;0;0;0;.00nan;0;0
4497;186495;47;91;28;1;27;.964;3600000;0
4497;86151;47;0;0;0;0;.00nan;0;0
4497;142492;48;55;45;6;39;.867;3600000;0
4498;4622;64;88;43;3;40;.930;3586000;0
4498;168872;64;0;0;0;0;.00nan;0;0
4498;57215;50;83;30;1;29;.967;3600000;0
4498;141998;50;0;0;0;0;.00nan;0;0
4499;182780;60;0;0;0;0;.00nan;0;0
4499;170294;60;39;41;6;35;.854;3600000;0
4499;185743;4837;75;17;1;16;.941;3600000;0
4499;187295;4837;0;0;0;0;.00nan;0;0
4500;178384;40;82;50;5;45;.900;3600000;0
4500;170314;4619;61;19;2;17;.895;3600000;0
4500;191813;4619;0;0;0;0;.00nan;0;0
4500;85636;40;0;0;0;0;.00nan;0;0
4501;165744;53;100;38;0;38;1.000;3600000;0
4501;169323;53;0;0;0;0;.00nan;0;0
4501;176915;38;0;0;0;0;.00nan;0;0
4501;141978;38;57;22;3;19;.864;3600000;0
4502;192733;61;67;29;3;26;.897;3600000;0
4502;-1;61;0;0;0;0;.00nan;0;0
4502;64722;49;0;0;0;0;.00nan;0;0
4502;79132;49;50;34;5;29;.853;3583000;0
4503;187699;39;52;24;3;21;.875;3566000;0
4503;188888;51;0;0;0;0;.00nan;0;0
4503;43928;39;0;0;0;0;.00nan;0;0
4503;86360;51;81;29;2;27;.931;3600000;0
4504;171838;41;87;40;3;37;.925;3556000;0
4504;194264;41;0;0;0;0;.00nan;0;0
4504;59540;59;82;23;1;22;.957;3600000;0
4504;75268;59;0;0;0;0;.00nan;0;0
4505;178384;40;97;39;1;38;.974;3600000;0
4505;169868;48;38;28;5;23;.821;3600000;0
4505;85636;40;0;0;0;0;.00nan;0;0
4505;142492;48;0;0;0;0;.00nan;0;0
4506;4622;64;37;21;4;17;.810;3644000;0
4506;168872;64;0;0;0;0;.00nan;0;0
4506;64722;49;0;0;0;0;.00nan;0;0
4506;79132;49;74;50;5;45;.900;3644000;0
4507;848;45;0;0;0;0;.00nan;0;0
4507;196495;45;51;29;4;25;.862;3600000;0
4507;43731;37;0;0;0;0;.00nan;0;0
4507;58037;37;70;19;2;17;.895;3600000;0
4508;176938;62;77;37;3;34;.919;3600000;0
4508;38276;62;0;0;0;0;.00nan;0;0
4508;79141;42;0;0;0;0;.00nan;0;0
4508;149450;42;100;26;0;26;1.000;3600000;0
4509;192733;61;100;39;0;39;1.000;3600000;0
4509;169154;44;0;0;0;0;.00nan;0;0
4509;-1;61;0;0;0;0;.00nan;0;0
4509;176921;44;64;27;3;24;.889;3600000;0
4510;188888;51;0;0;0;0;.00nan;0;0
4510;181123;63;57;36;5;31;.861;3900000;0
4510;192457;63;0;0;0;0;.00nan;0;0
4510;86360;51;81;48;5;43;.896;3900000;0
4511;170314;4619;55;30;4;26;.867;3600000;0
4511;185743;4837;56;27;3;24;.889;3600000;0
4511;187295;4837;0;0;0;0;.00nan;0;0
4511;191813;4619;0;0;0;0;.00nan;0;0
4512;183783;52;59;33;4;29;.879;3600000;0
4512;175912;57;84;28;1;27;.964;3600000;0
4512;196372;57;0;0;0;0;.00nan;0;0
4512;185812;52;0;0;0;0;.00nan;0;0
4513;192776;54;74;20;1;19;.950;1754000;0
4513;57215;50;0;0;0;0;.00nan;0;0
4513;94615;54;26;21;5;16;.762;1846000;0
4513;141998;50;55;10;1;9;.900;3600000;0
4514;183904;43;74;25;1;24;.960;3600000;0
4514;178612;43;0;0;0;0;.00nan;0;0
4514;173699;36;53;35;5;30;.857;3600000;0
4514;187362;36;0;0;0;0;.00nan;0;0
4515;165744;53;89;42;2;40;.952;3858000;0
4515;169323;53;0;0;0;0;.00nan;0;0
4515;59540;59;85;38;3;35;.921;3858000;0
4515;75268;59;0;0;0;0;.00nan;0;0
4516;178384;40;65;35;4;31;.886;3576000;0
4516;169868;48;0;0;0;0;.00nan;0;0
4516;85636;40;0;0;0;0;.00nan;0;0
4516;142492;48;64;29;3;26;.897;3600000;0
4517;4622;64;0;0;0;0;.00nan;0;0
4517;168872;64;62;30;3;27;.900;3586000;0
4517;64722;49;79;26;1;25;.962;3600000;0
4517;79132;49;0;0;0;0;.00nan;0;0
4518;188888;51;86;33;1;32;.970;3600000;0
4518;181123;63;0;0;0;0;.00nan;0;0
4518;192457;63;68;29;3;26;.897;3511000;0
4518;86360;51;0;0;0;0;.00nan;0;0
4519;182780;60;0;0;0;0;.00nan;0;0
4519;170294;60;72;26;2;24;.923;3600000;0
4519;186495;47;0;0;0;0;.00nan;0;0
4519;86151;47;47;39;6;33;.846;3600000;0
4520;171838;41;66;33;3;30;.909;3543000;0
4520;194264;41;0;0;0;0;.00nan;0;0
4520;176915;38;0;0;0;0;.00nan;0;0
4520;141978;38;76;21;1;20;.952;3600000;0
4521;848;45;99;39;1;38;.974;3600000;0
4521;196495;45;0;0;0;0;.00nan;0;0
4521;43731;37;48;26;4;22;.846;3600000;0
4521;58037;37;0;0;0;0;.00nan;0;0
4522;181102;46;0;0;0;0;.00nan;0;0
4522;47112;56;0;0;0;0;.00nan;0;0
4522;57207;56;78;27;2;25;.926;3900000;0
4522;79280;46;91;40;2;38;.950;3900000;0
4523;176938;62;0;0;0;0;.00nan;0;0
4523;38276;62;51;25;3;22;.880;3557000;0
4523;79141;42;0;0;0;0;.00nan;0;0
4523;149450;42;74;24;1;23;.958;3600000;0
4524;192733;61;77;35;2;33;.943;3900000;0
4524;169154;44;72;27;2;25;.926;3900000;0
4524;-1;61;0;0;0;0;.00nan;0;0
4524;176921;44;0;0;0;0;.00nan;0;0
4525;170314;4619;58;33;4;29;.879;3888000;0
4525;185743;4837;0;0;0;0;.00nan;0;0
4525;187295;4837;67;39;4;35;.897;3900000;0
4525;191813;4619;0;0;0;0;.00nan;0;0
4526;169226;65;0;0;0;0;.00nan;0;0
4526;175084;65;68;29;3;26;.897;3600000;0
4526;175912;57;0;0;0;0;.00nan;0;0
4526;196372;57;42;35;5;30;.857;3546000;0
4527;192776;54;79;44;4;40;.909;3600000;0
4527;57215;50;72;20;1;19;.950;3600000;0
4527;94615;54;0;0;0;0;.00nan;0;0
4527;141998;50;0;0;0;0;.00nan;0;0
4528;31;55;0;0;0;0;.00nan;0;0
4528;187699;39;0;0;0;0;.00nan;0;0
4528;176200;55;81;45;3;42;.933;3600000;0
4528;43928;39;77;11;0;11;1.000;3600000;0
4529;183783;52;0;0;0;0;.00nan;0;0
4529;166441;58;0;0;0;0;.00nan;0;0
4529;38124;58;65;45;5;40;.889;3600000;0
4529;185812;52;84;12;0;12;1.000;3600000;0
4530;165744;53;0;0;0;0;.00nan;0;0
4530;169323;53;72;42;3;39;.929;3900000;0
4530;59540;59;54;19;3;16;.842;3900000;0
4530;75268;59;0;0;0;0;.00nan;0;0
4531;182780;60;50;28;4;24;.857;3600000;0
4531;170294;60;0;0;0;0;.00nan;0;0
4531;186495;47;59;23;3;20;.870;3600000;0
4531;86151;47;0;0;0;0;.00nan;0;0
4532;166441;58;42;39;6;33;.846;3600000;0
4532;176915;38;52;14;2;12;.857;3600000;0
4532;38124;58;0;0;0;0;.00nan;0;0
4532;141978;38;0;0;0;0;.00nan;0;0
4533;181102;46;94;27;0;27;1.000;3600000;0
4533;47112;56;68;27;2;25;.926;3551000;0
4533;57207;56;0;0;0;0;.00nan;0;0
4533;79280;46;0;0;0;0;.00nan;0;0
4534;169226;65;57;19;2;17;.895;3600000;0
4534;175084;65;0;0;0;0;.00nan;0;0
4534;175912;57;87;42;3;39;.929;3600000;0
4534;196372;57;0;0;0;0;.00nan;0;0
4535;31;55;96;42;2;40;.952;3557000;0
4535;187699;39;0;0;0;0;.00nan;0;0
4535;176200;55;0;0;0;0;.00nan;0;0
4535;43928;39;89;17;0;17;1.000;3600000;0
4536;183904;43;81;22;1;21;.955;3600000;0
4536;178612;43;0;0;0;0;.00nan;0;0
4536;173699;36;74;40;4;36;.900;3600000;0
4536;187362;36;0;0;0;0;.00nan;0;0
4537;171838;41;0;0;0;0;.00nan;0;0
4537;194264;41;69;36;3;33;.917;3900000;0
4537;183783;52;0;0;0;0;.00nan;0;0
4537;185812;52;53;26;3;23;.885;3900000;0
4538;192733;61;84;41;3;38;.927;3600000;0
4538;169154;44;0;0;0;0;.00nan;0;0
4538;-1;61;0;0;0;0;.00nan;0;0
4538;176921;44;73;30;2;28;.933;3600000;0
4539;181102;46;56;31;4;27;.871;3600000;0
4539;47112;56;0;0;0;0;.00nan;0;0
4539;57207;56;64;17;1;16;.941;3600000;0
4539;79280;46;0;0;0;0;.00nan;0;0
4540;3928;59;0;0;0;0;.00nan;0;0
4540;175912;57;92;57;4;53;.930;3600000;0
4540;196372;57;0;0;0;0;.00nan;0;0
4540;75268;59;52;20;3;17;.850;3600000;0
4541;43731;37;0;0;0;0;.00nan;0;0
4541;58037;37;68;22;3;19;.864;3600000;0
4541;79141;42;0;0;0;0;.00nan;0;0
4541;149450;42;48;28;4;24;.857;3594000;0
4542;183904;43;39;29;6;23;.793;3539000;0
4542;178612;43;0;0;0;0;.00nan;0;0
4542;173699;36;68;38;4;34;.895;3600000;0
4542;187362;36;0;0;0;0;.00nan;0;0
4543;170314;4619;0;0;0;0;.00nan;0;0
4543;186495;47;91;37;2;35;.946;3900000;0
4543;191813;4619;78;35;2;33;.943;3900000;0
4543;86151;47;0;0;0;0;.00nan;0;0
4544;169154;44;0;0;0;0;.00nan;0;0
4544;169868;48;60;21;2;19;.905;3600000;0
4544;176921;44;54;24;3;21;.875;3542000;0
4544;142492;48;0;0;0;0;.00nan;0;0
4545;182780;60;0;0;0;0;.00nan;0;0
4545;170294;60;72;15;1;14;.933;3600000;0
4545;64722;49;0;0;0;0;.00nan;0;0
4545;79132;49;62;58;8;50;.862;3600000;0
4546;169154;44;44;23;4;19;.826;3600000;0
4546;169868;48;0;0;0;0;.00nan;0;0
4546;176921;44;0;0;0;0;.00nan;0;0
4546;142492;48;77;38;3;35;.921;3600000;0
4547;165744;53;0;0;0;0;.00nan;0;0
4547;169323;53;81;32;3;29;.906;3705000;0
4547;181123;63;99;40;2;38;.950;3705000;0
4547;192457;63;0;0;0;0;.00nan;0;0
4548;176938;62;100;34;2;32;.941;3600000;0
4548;38276;62;0;0;0;0;.00nan;0;0
4548;186495;47;0;0;0;0;.00nan;0;0
4548;86151;47;53;21;3;18;.857;3600000;0
4549;192776;54;70;34;4;30;.882;3600000;0
4549;43731;37;0;0;0;0;.00nan;0;0
4549;58037;37;88;17;0;17;1.000;3600000;0
4549;94615;54;0;0;0;0;.00nan;0;0
4550;178384;40;90;55;5;50;.909;3600000;0
4550;79141;42;0;0;0;0;.00nan;0;0
4550;85636;40;0;0;0;0;.00nan;0;0
4550;149450;42;83;26;1;25;.962;3600000;0
4551;183904;43;81;21;1;20;.952;3600000;0
4551;178612;43;0;0;0;0;.00nan;0;0
4551;181102;46;42;25;4;21;.840;1107000;0
4551;79280;46;45;43;7;36;.837;2493000;0
4552;171838;41;65;32;3;29;.906;3600000;0
4552;194264;41;0;0;0;0;.00nan;0;0
4552;166441;58;0;0;0;0;.00nan;0;0
4552;38124;58;96;24;0;24;1.000;3600000;0
4553;183783;52;0;0;0;0;.00nan;0;0
4553;169226;65;81;32;2;30;.938;3600000;0
4553;175084;65;0;0;0;0;.00nan;0;0
4553;185812;52;90;39;3;36;.923;3600000;0
4554;848;45;97;44;2;42;.955;3548000;0
4554;170314;4619;71;21;1;20;.952;3600000;0
4554;196495;45;0;0;0;0;.00nan;0;0
4554;191813;4619;0;0;0;0;.00nan;0;0
4555;192733;61;88;36;2;34;.944;3583000;0
4555;-1;61;0;0;0;0;.00nan;0;0
4555;185743;4837;99;33;1;32;.970;3600000;0
4555;187295;4837;0;0;0;0;.00nan;0;0
4556;31;55;0;0;0;0;.00nan;0;0
4556;175912;57;67;30;3;27;.900;3600000;0
4556;176200;55;77;30;2;28;.933;3600000;0
4556;196372;57;0;0;0;0;.00nan;0;0
4557;187699;39;0;0;0;0;.00nan;0;0
4557;43928;39;67;30;3;27;.900;3600000;0
4557;47112;56;0;0;0;0;.00nan;0;0
4557;57207;56;55;29;4;25;.862;3600000;0
4558;188888;51;0;0;0;0;.00nan;0;0
4558;173699;36;78;27;2;25;.926;3600000;0
4558;187362;36;0;0;0;0;.00nan;0;0
4558;86360;51;76;42;4;38;.905;3600000;0
4559;182780;60;69;29;3;26;.897;3557000;0
4559;170294;60;0;0;0;0;.00nan;0;0
4559;64722;49;90;41;2;39;.951;3600000;0
4559;79132;49;0;0;0;0;.00nan;0;0
4560;192733;61;0;0;0;0;.00nan;0;0
4560;-1;61;63;47;6;41;.872;3650000;0
4560;185743;4837;0;0;0;0;.00nan;0;0
4560;187295;4837;40;28;5;23;.821;3650000;0
4561;3928;59;66;22;2;20;.909;3600000;0
4561;183783;52;67;57;6;51;.895;3600000;0
4561;185812;52;0;0;0;0;.00nan;0;0
4561;75268;59;0;0;0;0;.00nan;0;0
4562;165744;53;69;32;3;29;.906;3600000;0
4562;169323;53;0;0;0;0;.00nan;0;0
4562;181123;63;0;0;0;0;.00nan;0;0
4562;192457;63;47;27;4;23;.852;3583000;0
4563;176938;62;0;0;0;0;.00nan;0;0
4563;38276;62;46;21;4;17;.810;3600000;0
4563;186495;47;50;41;6;35;.854;3023000;0
4563;86151;47;66;9;0;9;1.000;577000;0
4564;192776;54;0;0;0;0;.00nan;0;0
4564;43731;37;0;0;0;0;.00nan;0;0
4564;58037;37;67;17;1;16;.941;3600000;0
4564;94615;54;91;55;4;51;.927;3600000;0
4565;171838;41;0;0;0;0;.00nan;0;0
4565;194264;41;74;36;4;32;.889;3900000;0
4565;169226;65;0;0;0;0;.00nan;0;0
4565;175084;65;73;43;4;39;.907;3900000;0
4566;178384;40;0;0;0;0;.00nan;0;0
4566;79141;42;0;0;0;0;.00nan;0;0
4566;85636;40;97;39;1;38;.974;3900000;0
4566;149450;42;61;16;1;15;.938;3900000;0
4567;183904;43;88;14;0;14;1.000;3600000;0
4567;178612;43;0;0;0;0;.00nan;0;0
4567;181102;46;55;41;6;35;.854;3600000;0
4567;79280;46;0;0;0;0;.00nan;0;0
4568;166441;58;0;0;0;0;.00nan;0;0
4568;176915;38;0;0;0;0;.00nan;0;0
4568;38124;58;98;51;2;49;.961;3600000;0
4568;141978;38;43;18;3;15;.833;3570000;0
4569;848;45;0;0;0;0;.00nan;0;0
4569;170314;4619;26;13;4;9;.692;1116000;0
4569;196495;45;82;43;3;40;.930;3600000;0
4569;191813;4619;65;18;1;17;.944;2398000;0
4570;31;55;41;24;4;20;.833;3513000;0
4570;188888;51;68;25;2;23;.920;3600000;0
4570;176200;55;0;0;0;0;.00nan;0;0
4570;86360;51;0;0;0;0;.00nan;0;0
4571;4622;64;63;27;3;24;.889;3600000;0
4571;168872;64;0;0;0;0;.00nan;0;0
4571;57215;50;0;0;0;0;.00nan;0;0
4571;141998;50;93;54;2;52;.963;3600000;0
4572;173699;36;0;0;0;0;.00nan;0;0
4572;175912;57;0;0;0;0;.00nan;0;0
4572;196372;57;74;30;3;27;.900;3900000;0
4572;187362;36;77;37;3;34;.919;3900000;0
4573;187699;39;0;0;0;0;.00nan;0;0
4573;43928;39;59;35;5;30;.857;3772000;0
4573;47112;56;0;0;0;0;.00nan;0;0
4573;57207;56;40;35;6;29;.829;3772000;0
4574;3928;59;72;23;1;22;.957;3600000;0
4574;169226;65;89;60;5;55;.917;3600000;0
4574;175084;65;0;0;0;0;.00nan;0;0
4574;75268;59;0;0;0;0;.00nan;0;0
4575;4622;64;0;0;0;0;.00nan;0;0
4575;168872;64;67;27;2;25;.926;3600000;0
4575;57215;50;68;36;3;33;.917;3562000;0
4575;141998;50;0;0;0;0;.00nan;0;0
4576;3928;59;55;15;2;13;.867;3600000;0
4576;176915;38;0;0;0;0;.00nan;0;0
4576;75268;59;0;0;0;0;.00nan;0;0
4576;141978;38;88;51;3;48;.941;3553000;0
4577;178384;40;79;40;4;36;.900;3600000;0
4577;186495;47;0;0;0;0;.00nan;0;0
4577;85636;40;0;0;0;0;.00nan;0;0
4577;86151;47;67;19;1;18;.947;3600000;0
4578;183783;52;60;19;2;17;.895;3589000;0
4578;175912;57;85;25;1;24;.960;3600000;0
4578;196372;57;0;0;0;0;.00nan;0;0
4578;185812;52;0;0;0;0;.00nan;0;0
4579;31;55;0;0;0;0;.00nan;0;0
4579;173699;36;23;21;5;16;.762;3600000;0
4579;176200;55;79;26;2;24;.923;3600000;0
4579;187362;36;0;0;0;0;.00nan;0;0
4580;848;45;0;0;0;0;.00nan;0;0
4580;196495;45;71;29;2;27;.931;3600000;0
4580;64722;49;0;0;0;0;.00nan;0;0
4580;79132;49;48;33;5;28;.848;3600000;0
4581;182780;60;0;0;0;0;.00nan;0;0
4581;169154;44;0;0;0;0;.00nan;0;0
4581;170294;60;92;23;0;23;1.000;3600000;0
4581;176921;44;51;45;6;39;.867;3600000;0
4582;192733;61;73;35;4;31;.886;3513000;0
4582;165744;53;0;0;0;0;.00nan;0;0
4582;169323;53;80;30;2;28;.933;3600000;0
4582;-1;61;0;0;0;0;.00nan;0;0
4583;176938;62;100;34;1;33;.971;3600000;0
4583;38276;62;0;0;0;0;.00nan;0;0
4583;185743;4837;0;0;0;0;.00nan;0;0
4583;187295;4837;88;34;2;32;.941;3579000;0
4584;182780;60;0;0;0;0;.00nan;0;0
4584;169154;44;84;32;2;30;.938;3600000;0
4584;170294;60;87;31;1;30;.968;3600000;0
4584;176921;44;0;0;0;0;.00nan;0;0
4585;192733;61;53;29;4;25;.862;3900000;0
4585;165744;53;61;28;4;24;.857;3900000;0
4585;169323;53;0;0;0;0;.00nan;0;0
4585;-1;61;0;0;0;0;.00nan;0;0
4586;178384;40;62;33;4;29;.879;3600000;0
4586;186495;47;95;34;1;33;.971;3600000;0
4586;85636;40;0;0;0;0;.00nan;0;0
4586;86151;47;0;0;0;0;.00nan;0;0
4587;176938;62;0;0;0;0;.00nan;0;0
4587;38276;62;38;11;3;8;.727;3677000;0
4587;185743;4837;99;41;2;39;.951;3677000;0
4587;187295;4837;0;0;0;0;.00nan;0;0
4588;166441;58;0;0;0;0;.00nan;0;0
4588;181123;63;42;34;5;29;.853;3600000;0
4588;38124;58;83;43;3;40;.930;3600000;0
4588;192457;63;0;0;0;0;.00nan;0;0
4589;848;45;75;25;2;23;.920;3600000;0
4589;196495;45;0;0;0;0;.00nan;0;0
4589;64722;49;0;0;0;0;.00nan;0;0
4589;79132;49;56;31;4;27;.871;3553000;0
4590;173699;36;81;41;3;38;.927;3626000;0
4590;187362;36;0;0;0;0;.00nan;0;0
4590;47112;56;0;0;0;0;.00nan;0;0
4590;57207;56;64;23;2;21;.913;3626000;0
4591;183783;52;0;0;0;0;.00nan;0;0
4591;169226;65;0;0;0;0;.00nan;0;0
4591;175084;65;99;27;0;27;1.000;3600000;0
4591;185812;52;98;36;1;35;.972;3567000;0
4592;188888;51;0;0;0;0;.00nan;0;0
4592;166441;58;0;0;0;0;.00nan;0;0
4592;38124;58;74;41;4;37;.902;3600000;0
4592;86360;51;85;21;1;20;.952;3600000;0
4593;169868;48;0;0;0;0;.00nan;0;0
4593;186495;47;0;0;0;0;.00nan;0;0
4593;86151;47;74;29;2;27;.931;3633000;0
4593;142492;48;87;45;3;42;.933;3633000;0
4594;171838;41;92;48;3;45;.938;3600000;0
4594;194264;41;0;0;0;0;.00nan;0;0
4594;176915;38;0;0;0;0;.00nan;0;0
4594;141978;38;95;17;0;17;1.000;3600000;0
4595;183904;43;78;22;1;21;.955;3600000;0
4595;178612;43;0;0;0;0;.00nan;0;0
4595;47112;56;0;0;0;0;.00nan;0;0
4595;57207;56;97;42;2;40;.952;3600000;0
4596;181102;46;44;5;1;4;.800;375000;0
4596;43731;37;0;0;0;0;.00nan;0;0
4596;58037;37;93;19;0;19;1.000;3600000;0
4596;79280;46;65;42;5;37;.881;3225000;0
4597;57215;50;0;0;0;0;.00nan;0;0
4597;79141;42;0;0;0;0;.00nan;0;0
4597;141998;50;88;37;3;34;.919;3900000;0
4597;149450;42;64;28;3;25;.893;3900000;0
4598;192776;54;98;48;1;47;.979;3900000;0
4598;4622;64;91;25;1;24;.960;3900000;0
4598;168872;64;0;0;0;0;.00nan;0;0
4598;94615;54;0;0;0;0;.00nan;0;0
4599;31;55;0;0;0;0;.00nan;0;0
4599;169226;65;0;0;0;0;.00nan;0;0
4599;175084;65;44;25;4;21;.840;3889000;0
4599;176200;55;72;39;4;35;.897;3900000;0
4600;178384;40;79;33;3;30;.909;3600000;0
4600;64722;49;0;0;0;0;.00nan;0;0
4600;79132;49;63;37;5;32;.865;3591000;0
4600;85636;40;0;0;0;0;.00nan;0;0
4601;173699;36;92;29;1;28;.966;3600000;0
4601;181123;63;0;0;0;0;.00nan;0;0
4601;187362;36;0;0;0;0;.00nan;0;0
4601;192457;63;83;46;4;42;.913;3600000;0
4602;182780;60;85;33;1;32;.970;3850000;0
4602;170294;60;0;0;0;0;.00nan;0;0
4602;170314;4619;93;39;2;37;.949;3850000;0
4602;191813;4619;0;0;0;0;.00nan;0;0
4603;169868;48;44;41;6;35;.854;3600000;0
4603;185743;4837;42;24;4;20;.833;3600000;0
4603;187295;4837;0;0;0;0;.00nan;0;0
4603;142492;48;0;0;0;0;.00nan;0;0
4604;183904;43;93;30;1;29;.967;3600000;0
4604;178612;43;0;0;0;0;.00nan;0;0
4604;47112;56;60;24;3;21;.875;3552000;0
4604;57207;56;0;0;0;0;.00nan;0;0
4605;171838;41;0;0;0;0;.00nan;0;0
4605;3928;59;83;10;0;10;1.000;3600000;0
4605;194264;41;41;46;7;39;.848;3600000;0
4605;75268;59;0;0;0;0;.00nan;0;0
4606;187699;39;0;0;0;0;.00nan;0;0
4606;165744;53;94;35;1;34;.971;3600000;0
4606;169323;53;0;0;0;0;.00nan;0;0
4606;43928;39;69;28;2;26;.929;3544000;0
4607;188888;51;89;28;1;27;.964;3900000;0
4607;166441;58;0;0;0;0;.00nan;0;0
4607;38124;58;84;33;1;32;.970;3900000;0
4607;86360;51;0;0;0;0;.00nan;0;0
4608;192733;61;100;60;3;57;.950;3600000;0
4608;-1;61;0;0;0;0;.00nan;0;0
4608;176938;62;36;17;4;13;.765;3573000;0
4608;38276;62;0;0;0;0;.00nan;0;0
4609;183783;52;0;0;0;0;.00nan;0;0
4609;176915;38;51;23;3;20;.870;3548000;0
4609;185812;52;69;22;1;21;.955;3600000;0
4609;141978;38;0;0;0;0;.00nan;0;0
4610;181102;46;39;30;5;25;.833;2748000;0
4610;43731;37;0;0;0;0;.00nan;0;0
4610;58037;37;79;28;2;26;.929;3600000;0
4610;79280;46;25;14;4;10;.714;852000;0
4611;57215;50;0;0;0;0;.00nan;0;0
4611;79141;42;0;0;0;0;.00nan;0;0
4611;141998;50;53;29;4;25;.862;3555000;0
4611;149450;42;56;14;2;12;.857;3600000;0
4612;169154;44;0;0;0;0;.00nan;0;0
4612;176921;44;99;42;1;41;.976;3600000;0
4612;186495;47;59;22;2;20;.909;3547000;0
4612;86151;47;0;0;0;0;.00nan;0;0
4613;175912;57;91;31;1;30;.968;3900000;0
4613;196372;57;0;0;0;0;.00nan;0;0
4613;181123;63;97;33;1;32;.970;3900000;0
4613;192457;63;0;0;0;0;.00nan;0;0
4614;848;45;48;25;4;21;.840;3900000;0
4614;192776;54;0;0;0;0;.00nan;0;0
4614;196495;45;0;0;0;0;.00nan;0;0
4614;94615;54;66;40;4;36;.900;3900000;0
4615;31;55;96;45;1;44;.978;3900000;0
4615;173699;36;65;14;1;13;.929;3900000;0
4615;176200;55;0;0;0;0;.00nan;0;0
4615;187362;36;0;0;0;0;.00nan;0;0
4616;178384;40;67;27;3;24;.889;3900000;0
4616;64722;49;91;44;3;41;.932;3900000;0
4616;79132;49;0;0;0;0;.00nan;0;0
4616;85636;40;0;0;0;0;.00nan;0;0
4617;182780;60;0;0;0;0;.00nan;0;0
4617;170294;60;91;43;4;39;.907;3600000;0
4617;170314;4619;44;29;5;24;.828;3542000;0
4617;191813;4619;0;0;0;0;.00nan;0;0
4618;187699;39;95;20;0;20;1.000;3600000;0
4618;165744;53;56;10;1;9;.900;930000;0
4618;169323;53;29;24;6;18;.750;2670000;0
4618;43928;39;0;0;0;0;.00nan;0;0
4619;192733;61;53;40;5;35;.875;3600000;0
4619;-1;61;0;0;0;0;.00nan;0;0
4619;176938;62;0;0;0;0;.00nan;0;0
4619;38276;62;69;22;2;20;.909;3600000;0
4620;169154;44;0;0;0;0;.00nan;0;0
4620;176921;44;100;26;0;26;1.000;3809000;0
4620;185743;4837;0;0;0;0;.00nan;0;0
4620;187295;4837;94;39;1;38;.974;3809000;0
4621;3928;59;83;15;0;15;1.000;3600000;0
4621;169226;65;96;46;3;43;.935;3600000;0
4621;175084;65;0;0;0;0;.00nan;0;0
4621;75268;59;0;0;0;0;.00nan;0;0
4622;183783;52;49;27;4;23;.852;3600000;0
4622;175912;57;0;0;0;0;.00nan;0;0
4622;196372;57;91;46;1;45;.978;3600000;0
4622;185812;52;0;0;0;0;.00nan;0;0
4623;848;45;0;0;0;0;.00nan;0;0
4623;196495;45;71;34;3;31;.912;3900000;0
4623;57215;50;0;0;0;0;.00nan;0;0
4623;141998;50;68;27;3;24;.889;3900000;0
4624;4622;64;54;28;3;25;.893;3566000;0
4624;168872;64;0;0;0;0;.00nan;0;0
4624;181102;46;0;0;0;0;.00nan;0;0
4624;79280;46;93;35;2;33;.943;3600000;0
4625;182780;60;0;0;0;0;.00nan;0;0
4625;170294;60;65;29;3;26;.897;3600000;0
4625;170314;4619;66;33;4;29;.879;3563000;0
4625;191813;4619;0;0;0;0;.00nan;0;0
4626;187699;39;80;26;1;25;.962;3900000;0
4626;188888;51;0;0;0;0;.00nan;0;0
4626;43928;39;0;0;0;0;.00nan;0;0
4626;86360;51;97;44;1;43;.977;3900000;0
4627;192776;54;68;45;5;40;.889;3600000;0
4627;43731;37;0;0;0;0;.00nan;0;0
4627;58037;37;61;19;2;17;.895;3600000;0
4627;94615;54;0;0;0;0;.00nan;0;0
4628;178384;40;61;35;4;31;.886;3600000;0
4628;186495;47;0;0;0;0;.00nan;0;0
4628;85636;40;0;0;0;0;.00nan;0;0
4628;86151;47;50;18;3;15;.833;3600000;0
4629;175912;57;67;26;2;24;.923;3600000;0
4629;176915;38;0;0;0;0;.00nan;0;0
4629;196372;57;0;0;0;0;.00nan;0;0
4629;141978;38;85;23;1;22;.957;3600000;0
4630;848;45;100;40;1;39;.975;3900000;0
4630;196495;45;0;0;0;0;.00nan;0;0
4630;57215;50;0;0;0;0;.00nan;0;0
4630;141998;50;74;23;1;22;.957;3900000;0
4631;183904;43;79;20;1;19;.950;3600000;0
4631;178612;43;0;0;0;0;.00nan;0;0
4631;173699;36;62;33;4;29;.879;3600000;0
4631;187362;36;0;0;0;0;.00nan;0;0
4632;4622;64;0;0;0;0;.00nan;0;0
4632;168872;64;66;44;4;40;.909;3528000;0
4632;181102;46;62;25;2;23;.920;3600000;0
4632;79280;46;0;0;0;0;.00nan;0;0
4633;47112;56;0;0;0;0;.00nan;0;0
4633;57207;56;37;29;5;24;.828;3600000;0
4633;79141;42;0;0;0;0;.00nan;0;0
4633;149450;42;73;20;1;19;.950;3600000;0
4634;192733;61;100;35;0;35;1.000;3600000;0
4634;-1;61;0;0;0;0;.00nan;0;0
4634;185743;4837;0;0;0;0;.00nan;0;0
4634;187295;4837;65;17;1;16;.941;3550000;0
4635;171838;41;57;24;3;21;.875;3548000;0
4635;194264;41;0;0;0;0;.00nan;0;0
4635;183783;52;0;0;0;0;.00nan;0;0
4635;185812;52;94;32;1;31;.969;3600000;0
4636;182780;60;0;0;0;0;.00nan;0;0
4636;170294;60;90;19;0;19;1.000;3600000;0
4636;185743;4837;87;25;1;24;.960;3600000;0
4636;187295;4837;0;0;0;0;.00nan;0;0
4637;171838;41;69;23;1;22;.957;3600000;0
4637;188888;51;0;0;0;0;.00nan;0;0
4637;194264;41;0;0;0;0;.00nan;0;0
4637;86360;51;43;33;5;28;.848;3600000;0
4638;43731;37;100;26;0;26;1.000;3600000;0
4638;47112;56;0;0;0;0;.00nan;0;0
4638;57207;56;86;43;3;40;.930;3600000;0
4638;58037;37;0;0;0;0;.00nan;0;0
4639;178384;40;100;70;2;68;.971;3900000;0
4639;176938;62;73;23;2;21;.913;3900000;0
4639;38276;62;0;0;0;0;.00nan;0;0
4639;85636;40;0;0;0;0;.00nan;0;0
4640;848;45;76;39;3;36;.923;3600000;0
4640;170314;4619;62;19;2;17;.895;3600000;0
4640;196495;45;0;0;0;0;.00nan;0;0
4640;191813;4619;0;0;0;0;.00nan;0;0
4641;183783;52;45;35;5;30;.857;3556000;0
4641;166441;58;0;0;0;0;.00nan;0;0
4641;38124;58;62;36;4;32;.889;3600000;0
4641;185812;52;0;0;0;0;.00nan;0;0
4642;192776;54;41;40;6;34;.850;3195000;0
4642;79141;42;0;0;0;0;.00nan;0;0
4642;94615;54;54;10;1;9;.900;405000;0
4642;149450;42;59;14;1;13;.929;3600000;0
4643;3928;59;74;21;1;20;.952;3600000;0
4643;169226;65;0;0;0;0;.00nan;0;0
4643;175084;65;73;50;5;45;.900;3600000;0
4643;75268;59;0;0;0;0;.00nan;0;0
4644;173699;36;67;24;2;22;.917;3600000;0
4644;181123;63;86;42;4;38;.905;3521000;0
4644;187362;36;0;0;0;0;.00nan;0;0
4644;192457;63;0;0;0;0;.00nan;0;0
4645;192733;61;82;29;2;27;.931;3600000;0
4645;169868;48;71;37;3;34;.919;3556000;0
4645;-1;61;0;0;0;0;.00nan;0;0
4645;142492;48;0;0;0;0;.00nan;0;0
4646;165744;53;45;24;5;19;.792;3600000;0
4646;169323;53;0;0;0;0;.00nan;0;0
4646;175912;57;93;41;1;40;.976;3600000;0
4646;196372;57;0;0;0;0;.00nan;0;0
4647;31;55;0;0;0;0;.00nan;0;0
4647;183904;43;70;16;1;15;.938;3600000;0
4647;178612;43;0;0;0;0;.00nan;0;0
4647;176200;55;77;49;4;45;.918;3600000;0
4648;186495;47;0;0;0;0;.00nan;0;0
4648;57215;50;0;0;0;0;.00nan;0;0
4648;86151;47;40;24;4;20;.833;3600000;0
4648;141998;50;63;52;7;45;.865;3600000;0
4649;169154;44;0;0;0;0;.00nan;0;0
4649;176921;44;48;23;3;20;.870;3600000;0
4649;64722;49;0;0;0;0;.00nan;0;0
4649;79132;49;46;32;5;27;.844;3580000;0
4650;182780;60;0;0;0;0;.00nan;0;0
4650;170294;60;35;30;5;25;.833;3600000;0
4650;185743;4837;0;0;0;0;.00nan;0;0
4650;187295;4837;58;19;2;17;.895;3600000;0
4651;3928;59;72;21;1;20;.952;3600000;0
4651;169226;65;76;52;5;47;.904;3600000;0
4651;175084;65;0;0;0;0;.00nan;0;0
4651;75268;59;0;0;0;0;.00nan;0;0
4652;4622;64;61;41;5;36;.878;3533000;0
4652;168872;64;0;0;0;0;.00nan;0;0
4652;79141;42;0;0;0;0;.00nan;0;0
4652;149450;42;80;33;3;30;.909;3600000;0
4653;171838;41;0;0;0;0;.00nan;0;0
4653;188888;51;100;32;0;32;1.000;3600000;0
4653;194264;41;76;22;1;21;.955;3593000;0
4653;86360;51;0;0;0;0;.00nan;0;0
4654;43731;37;74;25;1;24;.960;3599000;0
4654;47112;56;100;32;0;32;1.000;3600000;0
4654;57207;56;0;0;0;0;.00nan;0;0
4654;58037;37;0;0;0;0;.00nan;0;0
4655;178384;40;56;35;4;31;.886;3600000;0
4655;176938;62;0;0;0;0;.00nan;0;0
4655;38276;62;65;12;1;11;.917;3600000;0
4655;85636;40;0;0;0;0;.00nan;0;0
4656;848;45;0;0;0;0;.00nan;0;0
4656;170314;4619;92;23;0;23;1.000;3600000;0
4656;196495;45;73;35;3;32;.914;3600000;0
4656;191813;4619;0;0;0;0;.00nan;0;0
4657;187699;39;40;21;4;17;.810;3600000;0
4657;166441;58;62;45;5;40;.889;3555000;0
4657;38124;58;0;0;0;0;.00nan;0;0
4657;43928;39;0;0;0;0;.00nan;0;0
4658;183904;43;45;19;3;16;.842;3600000;0
4658;178612;43;0;0;0;0;.00nan;0;0
4658;181123;63;0;0;0;0;.00nan;0;0
4658;192457;63;62;56;7;49;.875;3600000;0
4659;192776;54;0;0;0;0;.00nan;0;0
4659;181102;46;71;25;2;23;.920;3894000;0
4659;79280;46;0;0;0;0;.00nan;0;0
4659;94615;54;75;39;2;37;.949;3900000;0
4660;192733;61;0;0;0;0;.00nan;0;0
4660;169868;48;0;0;0;0;.00nan;0;0
4660;-1;61;32;27;5;22;.815;3523000;0
4660;142492;48;78;45;3;42;.933;3600000;0
4661;165744;53;0;0;0;0;.00nan;0;0
4661;169323;53;94;34;1;33;.971;3600000;0
4661;175912;57;0;0;0;0;.00nan;0;0
4661;196372;57;81;45;4;41;.911;3600000;0
4662;186495;47;42;17;3;14;.824;3882000;0
4662;57215;50;100;56;3;53;.946;3900000;0
4662;86151;47;0;0;0;0;.00nan;0;0
4662;141998;50;0;0;0;0;.00nan;0;0
4663;169154;44;0;0;0;0;.00nan;0;0
4663;176921;44;33;26;5;21;.808;3600000;0
4663;64722;49;56;25;3;22;.880;3600000;0
4663;79132;49;0;0;0;0;.00nan;0;0
4664;31;55;33;31;6;25;.806;2654000;0
4664;173699;36;80;27;3;24;.889;3600000;0
4664;176200;55;35;10;3;7;.700;946000;0
4664;187362;36;0;0;0;0;.00nan;0;0
4665;183783;52;0;0;0;0;.00nan;0;0
4665;176915;38;0;0;0;0;.00nan;0;0
4665;185812;52;95;44;2;42;.955;3600000;0
4665;141978;38;55;24;3;21;.875;3543000;0
4666;4622;64;0;0;0;0;.00nan;0;0
4666;168872;64;100;38;1;37;.974;3600000;0
4666;181102;46;61;36;3;33;.917;3527000;0
4666;79280;46;0;0;0;0;.00nan;0;0
4667;187699;39;0;0;0;0;.00nan;0;0
4667;176915;38;57;40;6;34;.850;3226000;0
4667;43928;39;80;24;1;23;.958;3600000;0
4667;141978;38;49;1;0;1;1.000;374000;0
4668;165744;53;54;30;4;26;.867;3688000;0
4668;169226;65;0;0;0;0;.00nan;0;0
4668;169323;53;0;0;0;0;.00nan;0;0
4668;175084;65;61;41;5;36;.878;3688000;0
4669;170314;4619;97;52;3;49;.942;3900000;0
4669;191813;4619;0;0;0;0;.00nan;0;0
4669;79141;42;0;0;0;0;.00nan;0;0
4669;149450;42;66;27;3;24;.889;3900000;0
4670;169154;44;0;0;0;0;.00nan;0;0
4670;176921;44;100;48;3;45;.938;3600000;0
4670;176938;62;53;24;4;20;.833;3568000;0
4670;38276;62;0;0;0;0;.00nan;0;0
4671;192776;54;80;49;5;44;.898;3600000;0
4671;181102;46;67;16;1;15;.938;3600000;0
4671;79280;46;0;0;0;0;.00nan;0;0
4671;94615;54;0;0;0;0;.00nan;0;0
4672;185743;4837;59;12;1;11;.917;3600000;0
4672;187295;4837;0;0;0;0;.00nan;0;0
4672;64722;49;0;0;0;0;.00nan;0;0
4672;79132;49;97;44;2;42;.955;3597000;0
4673;3928;59;51;20;3;17;.850;3600000;0
4673;175912;57;64;43;5;38;.884;3600000;0
4673;196372;57;0;0;0;0;.00nan;0;0
4673;75268;59;0;0;0;0;.00nan;0;0
4674;169868;48;0;0;0;0;.00nan;0;0
4674;186495;47;0;0;0;0;.00nan;0;0
4674;86151;47;61;24;3;21;.875;3600000;0
4674;142492;48;73;40;4;36;.900;3574000;0
4675;171838;41;76;22;1;21;.955;3600000;0
4675;165744;53;0;0;0;0;.00nan;0;0
4675;194264;41;0;0;0;0;.00nan;0;0
4675;169323;53;61;33;3;30;.909;3567000;0
4676;183904;43;68;27;3;24;.889;3600000;0
4676;178612;43;0;0;0;0;.00nan;0;0
4676;173699;36;100;46;2;44;.957;3600000;0
4676;187362;36;0;0;0;0;.00nan;0;0
4677;166441;58;0;0;0;0;.00nan;0;0
4677;176915;38;0;0;0;0;.00nan;0;0
4677;38124;58;88;49;4;45;.918;3600000;0
4677;141978;38;89;24;1;23;.958;3600000;0
4678;31;55;0;0;0;0;.00nan;0;0
4678;176200;55;71;34;3;31;.912;3575000;0
4678;181123;63;85;31;1;30;.968;3600000;0
4678;192457;63;0;0;0;0;.00nan;0;0
4679;187699;39;52;21;3;18;.857;3600000;0
4679;183783;52;68;41;5;36;.878;3531000;0
4679;185812;52;0;0;0;0;.00nan;0;0
4679;43928;39;0;0;0;0;.00nan;0;0
4680;4622;64;0;0;0;0;.00nan;0;0
4680;188888;51;78;50;4;46;.920;3542000;0
4680;168872;64;76;26;2;24;.923;3600000;0
4680;86360;51;0;0;0;0;.00nan;0;0
4681;192733;61;91;51;4;47;.922;3600000;0
4681;182780;60;83;15;0;15;1.000;3600000;0
4681;170294;60;0;0;0;0;.00nan;0;0
4681;-1;61;0;0;0;0;.00nan;0;0
4682;3928;59;79;17;1;16;.941;3578000;0
4682;175912;57;100;32;0;32;1.000;3600000;0
4682;196372;57;0;0;0;0;.00nan;0;0
4682;75268;59;0;0;0;0;.00nan;0;0
4683;165744;53;97;45;3;42;.933;3515000;0
4683;169226;65;0;0;0;0;.00nan;0;0
4683;169323;53;0;0;0;0;.00nan;0;0
4683;175084;65;85;29;1;28;.966;3600000;0
4684;169868;48;54;25;3;22;.880;2414000;0
4684;186495;47;0;0;0;0;.00nan;0;0
4684;86151;47;57;20;3;17;.850;3600000;0
4684;142492;48;31;21;5;16;.762;1186000;0
4685;171838;41;69;42;4;38;.905;3543000;0
4685;194264;41;0;0;0;0;.00nan;0;0
4685;183783;52;0;0;0;0;.00nan;0;0
4685;185812;52;66;31;3;28;.903;3600000;0
4686;848;45;79;36;2;34;.944;3591000;0
4686;178384;40;76;25;1;24;.960;3600000;0
4686;196495;45;0;0;0;0;.00nan;0;0
4686;85636;40;0;0;0;0;.00nan;0;0
4687;183904;43;0;0;0;0;.00nan;0;0
4687;178612;43;54;15;2;13;.867;3600000;0
4687;181123;63;76;40;4;36;.900;3589000;0
4687;192457;63;0;0;0;0;.00nan;0;0
4688;166441;58;0;0;0;0;.00nan;0;0
4688;176915;38;0;0;0;0;.00nan;0;0
4688;38124;58;43;39;6;33;.846;3600000;0
4688;141978;38;55;21;3;18;.857;3600000;0
4689;181102;46;87;26;1;25;.962;3600000;0
4689;79141;42;0;0;0;0;.00nan;0;0
4689;79280;46;0;0;0;0;.00nan;0;0
4689;149450;42;26;25;5;20;.800;3600000;0
4690;169154;44;48;20;3;17;.850;1613000;0
4690;176921;44;25;16;5;11;.688;1987000;0
4690;176938;62;0;0;0;0;.00nan;0;0
4690;38276;62;67;21;2;19;.905;3600000;0
4691;192776;54;83;54;3;51;.944;3600000;0
4691;43731;37;0;0;0;0;.00nan;0;0
4691;58037;37;74;21;1;20;.952;3600000;0
4691;94615;54;0;0;0;0;.00nan;0;0
4692;170314;4619;0;0;0;0;.00nan;0;0
4692;191813;4619;67;18;1;17;.944;3600000;0
4692;64722;49;78;62;5;57;.919;3600000;0
4692;79132;49;0;0;0;0;.00nan;0;0
4693;31;55;0;0;0;0;.00nan;0;0
4693;176200;55;84;45;3;42;.933;3600000;0
4693;47112;56;33;28;6;22;.786;3600000;0
4693;57207;56;0;0;0;0;.00nan;0;0
4694;185743;4837;0;0;0;0;.00nan;0;0
4694;187295;4837;63;31;4;27;.871;3900000;0
4694;57215;50;0;0;0;0;.00nan;0;0
4694;141998;50;61;33;4;29;.879;3900000;0
4695;187699;39;100;39;1;38;.974;3600000;0
4695;173699;36;88;36;2;34;.944;3594000;0
4695;187362;36;0;0;0;0;.00nan;0;0
4695;43928;39;0;0;0;0;.00nan;0;0
4696;192733;61;54;33;4;29;.879;3600000;0
4696;182780;60;74;22;1;21;.955;3600000;0
4696;170294;60;0;0;0;0;.00nan;0;0
4696;-1;61;0;0;0;0;.00nan;0;0
4697;165744;53;0;0;0;0;.00nan;0;0
4697;169226;65;70;31;2;29;.935;3545000;0
4697;169323;53;96;32;1;31;.969;3600000;0
4697;175084;65;0;0;0;0;.00nan;0;0
4698;4622;64;78;25;2;23;.920;3600000;0
4698;188888;51;0;0;0;0;.00nan;0;0
4698;168872;64;0;0;0;0;.00nan;0;0
4698;86360;51;64;35;4;31;.886;3561000;0
4699;186495;47;59;20;2;18;.900;3600000;0
4699;64722;49;0;0;0;0;.00nan;0;0
4699;79132;49;64;44;5;39;.886;3600000;0
4699;86151;47;0;0;0;0;.00nan;0;0
4700;171838;41;0;0;0;0;.00nan;0;0
4700;194264;41;100;34;0;34;1.000;3600000;0
4700;175912;57;77;32;2;30;.938;3594000;0
4700;196372;57;0;0;0;0;.00nan;0;0
4701;848;45;0;0;0;0;.00nan;0;0
4701;178384;40;0;0;0;0;.00nan;0;0
4701;196495;45;56;47;6;41;.872;3514000;0
4701;85636;40;65;36;4;32;.889;3600000;0
4702;3928;59;79;33;2;31;.939;3600000;0
4702;176915;38;58;36;4;32;.889;3554000;0
4702;75268;59;0;0;0;0;.00nan;0;0
4702;141978;38;0;0;0;0;.00nan;0;0
4703;183904;43;54;17;2;15;.882;3600000;0
4703;178612;43;0;0;0;0;.00nan;0;0
4703;181123;63;0;0;0;0;.00nan;0;0
4703;192457;63;71;41;4;37;.902;3578000;0
4704;183783;52;59;23;3;20;.870;3600000;0
4704;166441;58;53;32;5;27;.844;3559000;0
4704;38124;58;0;0;0;0;.00nan;0;0
4704;185812;52;0;0;0;0;.00nan;0;0
4705;169154;44;75;35;3;32;.914;3625000;0
4705;169868;48;0;0;0;0;.00nan;0;0
4705;176921;44;0;0;0;0;.00nan;0;0
4705;142492;48;80;43;4;39;.907;3625000;0
4706;192776;54;0;0;0;0;.00nan;0;0
4706;181102;46;67;18;1;17;.944;3600000;0
4706;79280;46;0;0;0;0;.00nan;0;0
4706;94615;54;85;39;2;37;.949;3558000;0
4707;170314;4619;86;45;3;42;.933;3759000;0
4707;176938;62;80;36;4;32;.889;3764000;0
4707;38276;62;0;0;0;0;.00nan;0;0
4707;191813;4619;0;0;0;0;.00nan;0;0
4708;31;55;80;45;3;42;.933;3600000;0
4708;176200;55;0;0;0;0;.00nan;0;0
4708;47112;56;0;0;0;0;.00nan;0;0
4708;57207;56;75;9;0;9;1.000;3600000;0
4709;185743;4837;75;25;2;23;.920;3650000;0
4709;187295;4837;0;0;0;0;.00nan;0;0
4709;57215;50;84;37;3;34;.919;3650000;0
4709;141998;50;0;0;0;0;.00nan;0;0
4710;187699;39;0;0;0;0;.00nan;0;0
4710;173699;36;0;0;0;0;.00nan;0;0
4710;187362;36;65;31;3;28;.903;3558000;0
4710;43928;39;80;27;2;25;.926;3600000;0
4711;192733;61;23;24;6;18;.750;3600000;0
4711;-1;61;0;0;0;0;.00nan;0;0
4711;185743;4837;0;0;0;0;.00nan;0;0
4711;187295;4837;65;21;2;19;.905;3600000;0
4712;173699;36;80;33;3;30;.909;3551000;0
4712;187362;36;0;0;0;0;.00nan;0;0
4712;47112;56;0;0;0;0;.00nan;0;0
4712;57207;56;87;35;2;33;.943;3600000;0
4713;169868;48;61;52;7;45;.865;3600000;0
4713;170314;4619;55;23;3;20;.870;3600000;0
4713;191813;4619;0;0;0;0;.00nan;0;0
4713;142492;48;0;0;0;0;.00nan;0;0
4714;165744;53;60;13;1;12;.923;3600000;0
4714;188888;51;87;41;3;38;.927;3522000;0
4714;169323;53;0;0;0;0;.00nan;0;0
4714;86360;51;0;0;0;0;.00nan;0;0
4715;182780;60;0;0;0;0;.00nan;0;0
4715;170294;60;71;41;4;37;.902;3535000;0
4715;176938;62;100;37;2;35;.946;3600000;0
4715;38276;62;0;0;0;0;.00nan;0;0
4716;181102;46;94;51;3;48;.941;3616000;0
4716;43731;37;0;0;0;0;.00nan;0;0
4716;58037;37;54;18;2;16;.889;3616000;0
4716;79280;46;0;0;0;0;.00nan;0;0
4717;171838;41;0;0;0;0;.00nan;0;0
4717;3928;59;50;14;2;12;.857;3600000;0
4717;194264;41;71;51;5;46;.902;3600000;0
4717;75268;59;0;0;0;0;.00nan;0;0
4718;848;45;48;26;4;22;.846;3708000;0
4718;196495;45;0;0;0;0;.00nan;0;0
4718;64722;49;0;0;0;0;.00nan;0;0
4718;79132;49;69;43;5;38;.884;3708000;0
4719;183783;52;0;0;0;0;.00nan;0;0
4719;166441;58;0;0;0;0;.00nan;0;0
4719;38124;58;99;44;1;43;.977;3600000;0
4719;185812;52;63;25;2;23;.920;3563000;0
4720;178384;40;100;43;1;42;.977;3600000;0
4720;169154;44;0;0;0;0;.00nan;0;0
4720;176921;44;73;30;2;28;.933;3548000;0
4720;85636;40;0;0;0;0;.00nan;0;0
4721;169226;65;0;0;0;0;.00nan;0;0
4721;175084;65;90;27;1;26;.963;3600000;0
4721;176915;38;0;0;0;0;.00nan;0;0
4721;141978;38;49;30;5;25;.833;3600000;0
4722;31;55;0;0;0;0;.00nan;0;0
4722;176200;55;87;39;2;37;.949;3600000;0
4722;181123;63;40;21;4;17;.810;3529000;0
4722;192457;63;0;0;0;0;.00nan;0;0
4723;192776;54;83;32;2;30;.938;3859000;0
4723;57215;50;0;0;0;0;.00nan;0;0
4723;94615;54;0;0;0;0;.00nan;0;0
4723;141998;50;59;18;2;16;.889;3900000;0
4724;187699;39;100;33;1;32;.970;3900000;0
4724;183904;43;82;31;1;30;.968;3900000;0
4724;178612;43;0;0;0;0;.00nan;0;0
4724;43928;39;0;0;0;0;.00nan;0;0
4725;173699;36;0;0;0;0;.00nan;0;0
4725;187362;36;77;25;1;24;.960;3600000;0
4725;47112;56;65;23;3;20;.870;3522000;0
4725;57207;56;0;0;0;0;.00nan;0;0
4726;3928;59;51;8;1;7;.875;3600000;0
4726;166441;58;75;56;5;51;.911;3600000;0
4726;38124;58;0;0;0;0;.00nan;0;0
4726;75268;59;0;0;0;0;.00nan;0;0
4727;169868;48;0;0;0;0;.00nan;0;0
4727;170314;4619;0;0;0;0;.00nan;0;0
4727;191813;4619;75;19;1;18;.947;3822000;0
4727;142492;48;100;35;0;35;1.000;3822000;0
4728;178384;40;70;46;6;40;.870;2416000;0
4728;186495;47;0;0;0;0;.00nan;0;0
4728;85636;40;79;17;0;17;1.000;1184000;0
4728;86151;47;70;18;1;17;.944;3600000;0
4729;182780;60;75;35;3;32;.914;3515000;0
4729;170294;60;0;0;0;0;.00nan;0;0
4729;176938;62;0;0;0;0;.00nan;0;0
4729;38276;62;67;15;1;14;.933;3600000;0
4730;181102;46;79;43;3;40;.930;3526000;0
4730;43731;37;77;23;1;22;.957;3600000;0
4730;58037;37;0;0;0;0;.00nan;0;0
4730;79280;46;0;0;0;0;.00nan;0;0
4731;171838;41;62;35;4;31;.886;3558000;0
4731;194264;41;0;0;0;0;.00nan;0;0
4731;169226;65;57;25;3;22;.880;3600000;0
4731;175084;65;0;0;0;0;.00nan;0;0
4732;848;45;0;0;0;0;.00nan;0;0
4732;196495;45;54;16;2;14;.875;3600000;0
4732;64722;49;18;8;4;4;.500;523000;0
4732;79132;49;88;43;3;40;.930;3077000;0
4733;57215;50;67;46;5;41;.891;3543000;0
4733;79141;42;52;33;4;29;.879;3600000;0
4733;141998;50;0;0;0;0;.00nan;0;0
4733;149450;42;0;0;0;0;.00nan;0;0
4734;192776;54;46;33;5;28;.848;3058000;0
4734;4622;64;51;27;4;23;.852;3600000;0
4734;168872;64;0;0;0;0;.00nan;0;0
4734;94615;54;25;6;3;3;.500;542000;0
4735;192733;61;74;32;2;30;.938;3600000;0
4735;-1;61;0;0;0;0;.00nan;0;0
4735;185743;4837;30;40;8;32;.800;3351000;0
4735;187295;4837;55;4;0;4;1.000;249000;0
4736;175912;57;79;34;3;31;.912;3600000;0
4736;176915;38;64;26;2;24;.923;3600000;0
4736;196372;57;0;0;0;0;.00nan;0;0
4736;141978;38;0;0;0;0;.00nan;0;0
4737;31;55;59;29;4;25;.862;3600000;0
4737;176200;55;0;0;0;0;.00nan;0;0
4737;181123;63;0;0;0;0;.00nan;0;0
4737;192457;63;63;45;5;40;.889;3562000;0
4738;187699;39;0;0;0;0;.00nan;0;0
4738;183904;43;93;39;3;36;.923;3599000;0
4738;178612;43;0;0;0;0;.00nan;0;0
4738;43928;39;71;28;2;26;.929;3600000;0
4739;165744;53;0;0;0;0;.00nan;0;0
4739;188888;51;0;0;0;0;.00nan;0;0
4739;169323;53;60;28;3;25;.893;3600000;0
4739;86360;51;60;35;4;31;.886;3578000;0
4740;169868;48;0;0;0;0;.00nan;0;0
4740;181102;46;68;31;3;28;.903;3575000;0
4740;79280;46;0;0;0;0;.00nan;0;0
4740;142492;48;92;24;1;23;.958;3600000;0
4741;188888;51;0;0;0;0;.00nan;0;0
4741;43731;37;0;0;0;0;.00nan;0;0
4741;58037;37;71;19;1;18;.947;3600000;0
4741;86360;51;78;46;5;41;.891;3600000;0
4742;176938;62;50;28;4;24;.857;3600000;0
4742;38276;62;0;0;0;0;.00nan;0;0
4742;185743;4837;0;0;0;0;.00nan;0;0
4742;187295;4837;71;48;5;43;.896;3600000;0
4743;4622;64;77;39;4;35;.897;3600000;0
4743;168872;64;0;0;0;0;.00nan;0;0
4743;79141;42;0;0;0;0;.00nan;0;0
4743;149450;42;79;12;0;12;1.000;3600000;0
4744;192776;54;71;49;5;44;.898;3553000;0
4744;57215;50;76;35;4;31;.886;3600000;0
4744;94615;54;0;0;0;0;.00nan;0;0
4744;141998;50;0;0;0;0;.00nan;0;0
4745;31;55;0;0;0;0;.00nan;0;0
4745;176200;55;80;70;5;65;.929;3600000;0
4745;47112;56;0;0;0;0;.00nan;0;0
4745;57207;56;71;7;0;7;1.000;3600000;0
4746;169868;48;67;44;5;39;.886;3600000;0
4746;181102;46;69;39;4;35;.897;3600000;0
4746;79280;46;0;0;0;0;.00nan;0;0
4746;142492;48;0;0;0;0;.00nan;0;0
4747;176938;62;0;0;0;0;.00nan;0;0
4747;38276;62;45;32;5;27;.844;3575000;0
4747;185743;4837;49;21;3;18;.857;3600000;0
4747;187295;4837;0;0;0;0;.00nan;0;0
4748;166441;58;0;0;0;0;.00nan;0;0
4748;176915;38;0;0;0;0;.00nan;0;0
4748;38124;58;98;47;3;44;.936;3600000;0
4748;141978;38;63;11;1;10;.909;3600000;0
4749;192733;61;82;48;4;44;.917;3600000;0
4749;170314;4619;0;0;0;0;.00nan;0;0
4749;-1;61;0;0;0;0;.00nan;0;0
4749;191813;4619;55;22;3;19;.864;3600000;0
4750;187699;39;0;0;0;0;.00nan;0;0
4750;183783;52;56;35;4;31;.886;3544000;0
4750;185812;52;0;0;0;0;.00nan;0;0
4750;43928;39;83;33;2;31;.939;3600000;0
4751;173699;36;91;44;4;40;.909;3600000;0
4751;181123;63;0;0;0;0;.00nan;0;0
4751;187362;36;0;0;0;0;.00nan;0;0
4751;192457;63;69;19;1;18;.947;3600000;0
4752;192733;61;85;42;4;38;.905;3600000;0
4752;-1;61;0;0;0;0;.00nan;0;0
4752;186495;47;0;0;0;0;.00nan;0;0
4752;86151;47;100;29;0;29;1.000;3600000;0
4753;187699;39;74;22;1;21;.955;3600000;0
4753;43928;39;0;0;0;0;.00nan;0;0
4753;47112;56;0;0;0;0;.00nan;0;0
4753;57207;56;98;52;2;50;.962;3580000;0
4754;188888;51;0;0;0;0;.00nan;0;0
4754;43731;37;0;0;0;0;.00nan;0;0
4754;58037;37;94;19;0;19;1.000;3600000;0
4754;86360;51;79;53;5;48;.906;3600000;0
4755;171838;41;67;10;0;10;1.000;488000;0
4755;194264;41;59;39;5;34;.872;3112000;0
4755;183904;43;85;16;0;16;1.000;3600000;0
4755;178612;43;0;0;0;0;.00nan;0;0
4756;3928;59;54;20;3;17;.850;3600000;0
4756;169226;65;0;0;0;0;.00nan;0;0
4756;175084;65;44;34;5;29;.853;3600000;0
4756;75268;59;0;0;0;0;.00nan;0;0
4757;183783;52;0;0;0;0;.00nan;0;0
4757;181123;63;62;32;3;29;.906;3600000;0
4757;185812;52;89;19;0;19;1.000;3600000;0
4757;192457;63;0;0;0;0;.00nan;0;0
4758;192776;54;97;59;5;54;.915;3600000;0
4758;4622;64;66;23;2;21;.913;3600000;0
4758;168872;64;0;0;0;0;.00nan;0;0
4758;94615;54;0;0;0;0;.00nan;0;0
4759;848;45;59;38;5;33;.868;3600000;0
4759;196495;45;0;0;0;0;.00nan;0;0
4759;57215;50;0;0;0;0;.00nan;0;0
4759;141998;50;74;21;1;20;.952;3600000;0
4760;169154;44;0;0;0;0;.00nan;0;0
4760;176921;44;46;13;2;11;.846;3600000;0
4760;64722;49;0;0;0;0;.00nan;0;0
4760;79132;49;76;43;4;39;.907;3600000;0
4761;182780;60;0;0;0;0;.00nan;0;0
4761;169868;48;0;0;0;0;.00nan;0;0
4761;170294;60;50;12;2;10;.833;3600000;0
4761;142492;48;67;36;3;33;.917;3578000;0
4762;192733;61;33;29;6;23;.793;2099000;0
4762;-1;61;55;11;1;10;.909;1501000;0
4762;185743;4837;0;0;0;0;.00nan;0;0
4762;187295;4837;59;18;3;15;.833;3600000;0
4763;171838;41;66;51;7;44;.863;3600000;0
4763;3928;59;69;17;1;16;.941;3600000;0
4763;194264;41;0;0;0;0;.00nan;0;0
4763;75268;59;0;0;0;0;.00nan;0;0
4764;165744;53;61;29;3;26;.897;3600000;0
4764;169323;53;0;0;0;0;.00nan;0;0
4764;175912;57;81;30;2;28;.933;3600000;0
4764;196372;57;0;0;0;0;.00nan;0;0
4765;4622;64;0;0;0;0;.00nan;0;0
4765;188888;51;88;45;3;42;.933;3600000;0
4765;168872;64;51;30;4;26;.867;3566000;0
4765;86360;51;0;0;0;0;.00nan;0;0
4766;176938;62;87;25;2;23;.920;3569000;0
4766;38276;62;0;0;0;0;.00nan;0;0
4766;186495;47;0;0;0;0;.00nan;0;0
4766;86151;47;100;25;0;25;1.000;3600000;0
4767;31;55;0;0;0;0;.00nan;0;0
4767;166441;58;0;0;0;0;.00nan;0;0
4767;176200;55;60;28;3;25;.893;3556000;0
4767;38124;58;77;33;2;31;.939;3600000;0
4768;181102;46;87;48;4;44;.917;3600000;0
4768;79141;42;0;0;0;0;.00nan;0;0
4768;79280;46;0;0;0;0;.00nan;0;0
4768;149450;42;56;19;2;17;.895;3600000;0
4769;192776;54;98;46;1;45;.978;3600000;0
4769;43731;37;0;0;0;0;.00nan;0;0
4769;58037;37;89;15;0;15;1.000;3600000;0
4769;94615;54;0;0;0;0;.00nan;0;0
4770;178384;40;88;38;3;35;.921;3600000;0
4770;170314;4619;54;32;4;28;.875;3545000;0
4770;191813;4619;0;0;0;0;.00nan;0;0
4770;85636;40;0;0;0;0;.00nan;0;0
4771;848;45;0;0;0;0;.00nan;0;0
4771;196495;45;32;33;6;27;.818;3600000;0
4771;57215;50;73;24;1;23;.958;3600000;0
4771;141998;50;0;0;0;0;.00nan;0;0
4772;187699;39;0;0;0;0;.00nan;0;0
4772;176915;38;0;0;0;0;.00nan;0;0
4772;43928;39;61;31;4;27;.871;3562000;0
4772;141978;38;92;41;3;38;.927;3600000;0
4773;169154;44;67;13;1;12;.923;3600000;0
4773;176921;44;0;0;0;0;.00nan;0;0
4773;64722;49;83;44;4;40;.909;3600000;0
4773;79132;49;0;0;0;0;.00nan;0;0
4774;173699;36;94;47;4;43;.915;3600000;0
4774;187362;36;0;0;0;0;.00nan;0;0
4774;47112;56;30;28;6;22;.786;2836000;0
4774;57207;56;48;7;1;6;.857;764000;0
4775;183783;52;53;39;5;34;.872;3600000;0
4775;183904;43;72;23;2;21;.913;3600000;0
4775;178612;43;0;0;0;0;.00nan;0;0
4775;185812;52;0;0;0;0;.00nan;0;0
4776;176938;62;0;0;0;0;.00nan;0;0
4776;38276;62;68;32;3;29;.906;3600000;0
4776;185743;4837;47;36;6;30;.833;3600000;0
4776;187295;4837;0;0;0;0;.00nan;0;0
4777;3928;59;21;11;4;7;.636;1162000;0
4777;183904;43;0;0;0;0;.00nan;0;0
4777;178612;43;74;28;2;26;.929;3600000;0
4777;75268;59;67;20;1;19;.950;2438000;0
4778;165744;53;0;0;0;0;.00nan;0;0
4778;169323;53;52;19;2;17;.895;3600000;0
4778;175912;57;0;0;0;0;.00nan;0;0
4778;196372;57;79;43;3;40;.930;3571000;0
4779;4622;64;35;24;5;19;.792;3600000;0
4779;188888;51;0;0;0;0;.00nan;0;0
4779;168872;64;0;0;0;0;.00nan;0;0
4779;86360;51;65;47;6;41;.872;3596000;0
4780;178384;40;97;51;2;49;.961;3900000;0
4780;186495;47;0;0;0;0;.00nan;0;0
4780;85636;40;0;0;0;0;.00nan;0;0
4780;86151;47;63;19;2;17;.895;3900000;0
4781;171838;41;75;24;1;23;.958;2557000;0
4781;194264;41;23;11;4;7;.636;1031000;0
4781;169226;65;0;0;0;0;.00nan;0;0
4781;175084;65;36;17;4;13;.765;3600000;0
4782;173699;36;100;24;0;24;1.000;3600000;0
4782;181123;63;49;29;4;25;.862;3600000;0
4782;187362;36;0;0;0;0;.00nan;0;0
4782;192457;63;0;0;0;0;.00nan;0;0
4783;182780;60;0;0;0;0;.00nan;0;0
4783;169868;48;0;0;0;0;.00nan;0;0
4783;170294;60;42;14;3;11;.786;3600000;0
4783;142492;48;82;59;6;53;.898;3600000;0
4784;176915;38;0;0;0;0;.00nan;0;0
4784;47112;56;0;0;0;0;.00nan;0;0
4784;57207;56;90;34;2;32;.941;3600000;0
4784;141978;38;56;26;3;23;.885;3600000;0
4785;848;45;77;19;1;18;.947;3600000;0
4785;192776;54;82;38;4;34;.895;3600000;0
4785;196495;45;0;0;0;0;.00nan;0;0
4785;94615;54;0;0;0;0;.00nan;0;0
4786;181102;46;41;43;7;36;.837;3600000;0
4786;79141;42;0;0;0;0;.00nan;0;0
4786;79280;46;0;0;0;0;.00nan;0;0
4786;149450;42;54;18;3;15;.833;3600000;0
4787;187699;39;49;6;1;5;.833;599000;0
4787;181123;63;80;16;0;16;1.000;1233000;0
4787;43928;39;12;17;6;11;.647;2964000;0
4787;192457;63;36;38;6;32;.842;2367000;0
4788;170314;4619;0;0;0;0;.00nan;0;0
4788;185743;4837;72;30;2;28;.933;3900000;0
4788;187295;4837;0;0;0;0;.00nan;0;0
4788;191813;4619;74;29;2;27;.931;3900000;0
4789;43731;37;0;0;0;0;.00nan;0;0
4789;57215;50;0;0;0;0;.00nan;0;0
4789;58037;37;100;21;0;21;1.000;3600000;0
4789;141998;50;87;40;2;38;.950;3553000;0
4790;171838;41;67;56;7;49;.875;3600000;0
4790;3928;59;60;19;2;17;.895;3600000;0
4790;194264;41;0;0;0;0;.00nan;0;0
4790;75268;59;0;0;0;0;.00nan;0;0
4791;848;45;44;11;2;9;.818;3600000;0
4791;192776;54;100;37;1;36;.973;3600000;0
4791;196495;45;0;0;0;0;.00nan;0;0
4791;94615;54;0;0;0;0;.00nan;0;0
4792;183904;43;21;3;3;0;.000;382000;0
4792;178612;43;82;30;1;29;.967;3169000;0
4792;176915;38;0;0;0;0;.00nan;0;0
4792;141978;38;91;44;3;41;.932;3600000;0
4793;182780;60;0;0;0;0;.00nan;0;0
4793;169154;44;0;0;0;0;.00nan;0;0
4793;170294;60;69;18;1;17;.944;3600000;0
4793;176921;44;72;25;2;23;.920;3592000;0
4794;181123;63;96;38;1;37;.974;3600000;0
4794;192457;63;0;0;0;0;.00nan;0;0
4794;47112;56;0;0;0;0;.00nan;0;0
4794;57207;56;81;33;2;31;.939;3544000;0
4795;192733;61;97;35;1;34;.971;3600000;0
4795;-1;61;0;0;0;0;.00nan;0;0
4795;186495;47;0;0;0;0;.00nan;0;0
4795;86151;47;60;26;3;23;.885;3519000;0
4796;183783;52;0;0;0;0;.00nan;0;0
4796;166441;58;0;0;0;0;.00nan;0;0
4796;38124;58;71;58;7;51;.879;3600000;0
4796;185812;52;53;19;3;16;.842;3600000;0
4797;4622;64;95;49;3;46;.939;3600000;0
4797;168872;64;0;0;0;0;.00nan;0;0
4797;79141;42;0;0;0;0;.00nan;0;0
4797;149450;42;82;12;0;12;1.000;3600000;0
4798;178384;40;97;54;3;51;.944;3900000;0
4798;176938;62;58;22;3;19;.864;3900000;0
4798;38276;62;0;0;0;0;.00nan;0;0
4798;85636;40;0;0;0;0;.00nan;0;0
4799;183783;52;40;37;6;31;.838;3118000;0
4799;176915;38;0;0;0;0;.00nan;0;0
4799;185812;52;55;4;0;4;1.000;482000;0
4799;141978;38;64;25;2;23;.920;3600000;0
4800;187699;39;0;0;0;0;.00nan;0;0
4800;183904;43;56;22;3;19;.864;3600000;0
4800;178612;43;0;0;0;0;.00nan;0;0
4800;43928;39;82;50;4;46;.920;3581000;0
4801;169868;48;0;0;0;0;.00nan;0;0
4801;181102;46;69;24;2;22;.917;3600000;0
4801;79280;46;0;0;0;0;.00nan;0;0
4801;142492;48;74;38;3;35;.921;3600000;0
4802;169154;44;0;0;0;0;.00nan;0;0
4802;176921;44;100;35;0;35;1.000;3600000;0
4802;186495;47;0;0;0;0;.00nan;0;0
4802;86151;47;74;32;3;29;.906;3600000;0
4803;188888;51;0;0;0;0;.00nan;0;0
4803;169226;65;0;0;0;0;.00nan;0;0
4803;175084;65;73;34;4;30;.882;3600000;0
4803;86360;51;16;35;8;27;.771;3600000;0
4804;181123;63;53;7;1;6;.857;1406000;0
4804;192457;63;40;27;5;22;.815;2194000;0
4804;47112;56;0;0;0;0;.00nan;0;0
4804;57207;56;83;30;2;28;.933;3600000;0
4805;192776;54;94;49;2;47;.959;3673000;0
4805;57215;50;74;19;1;18;.947;3673000;0
4805;94615;54;0;0;0;0;.00nan;0;0
4805;141998;50;0;0;0;0;.00nan;0;0
4806;192733;61;100;29;0;29;1.000;3900000;0
4806;182780;60;0;0;0;0;.00nan;0;0
4806;170294;60;97;33;0;33;1.000;3900000;0
4806;-1;61;0;0;0;0;.00nan;0;0
4807;171838;41;95;36;2;34;.944;3600000;0
4807;194264;41;0;0;0;0;.00nan;0;0
4807;175912;57;71;34;3;31;.912;3548000;0
4807;196372;57;0;0;0;0;.00nan;0;0
4808;185743;4837;45;13;2;11;.846;3519000;0
4808;187295;4837;0;0;0;0;.00nan;0;0
4808;64722;49;0;0;0;0;.00nan;0;0
4808;79132;49;100;41;0;41;1.000;3600000;0
4809;31;55;0;0;0;0;.00nan;0;0
4809;173699;36;70;24;2;22;.917;3600000;0
4809;176200;55;87;45;3;42;.933;3600000;0
4809;187362;36;0;0;0;0;.00nan;0;0
4810;165744;53;58;26;3;23;.885;3559000;0
4810;166441;58;0;0;0;0;.00nan;0;0
4810;169323;53;0;0;0;0;.00nan;0;0
4810;38124;58;100;50;1;49;.980;3600000;0
4811;178384;40;60;50;6;44;.880;3600000;0
4811;176938;62;0;0;0;0;.00nan;0;0
4811;38276;62;66;4;0;4;1.000;3600000;0
4811;85636;40;0;0;0;0;.00nan;0;0
4812;43731;37;0;0;0;0;.00nan;0;0
4812;57215;50;0;0;0;0;.00nan;0;0
4812;58037;37;69;23;2;21;.913;3558000;0
4812;141998;50;99;38;1;37;.974;3600000;0
4813;171838;41;0;0;0;0;.00nan;0;0
4813;188888;51;79;23;2;21;.913;3600000;0
4813;194264;41;64;34;3;31;.912;3549000;0
4813;86360;51;0;0;0;0;.00nan;0;0
4814;176915;38;97;20;0;20;1.000;3600000;0
4814;181123;63;87;48;3;45;.938;3600000;0
4814;192457;63;0;0;0;0;.00nan;0;0
4814;141978;38;0;0;0;0;.00nan;0;0
4815;187699;39;83;31;1;30;.968;3600000;0
4815;183904;43;0;0;0;0;.00nan;0;0
4815;178612;43;52;22;3;19;.864;3527000;0
4815;43928;39;0;0;0;0;.00nan;0;0
4816;169868;48;93;48;3;45;.938;3600000;0
4816;181102;46;0;0;0;0;.00nan;0;0
4816;79280;46;97;23;0;23;1.000;3600000;0
4816;142492;48;0;0;0;0;.00nan;0;0
4817;4622;64;66;45;5;40;.889;3600000;0
4817;168872;64;0;0;0;0;.00nan;0;0
4817;79141;42;0;0;0;0;.00nan;0;0
4817;149450;42;61;18;2;16;.889;3600000;0
4818;848;45;79;26;1;25;.962;3600000;0
4818;192776;54;70;30;2;28;.933;3063000;0
4818;196495;45;0;0;0;0;.00nan;0;0
4818;94615;54;30;10;3;7;.700;537000;0
4819;169154;44;0;0;0;0;.00nan;0;0
4819;170314;4619;0;0;0;0;.00nan;0;0
4819;176921;44;49;32;5;27;.844;3600000;0
4819;191813;4619;100;39;0;39;1.000;3600000;0
4820;192733;61;91;36;1;35;.972;3600000;0
4820;182780;60;0;0;0;0;.00nan;0;0
4820;170294;60;53;25;3;22;.880;3577000;0
4820;-1;61;0;0;0;0;.00nan;0;0
4821;169226;65;86;31;2;29;.935;3600000;0
4821;175084;65;0;0;0;0;.00nan;0;0
4821;175912;57;0;0;0;0;.00nan;0;0
4821;196372;57;23;25;6;19;.760;3600000;0
4822;31;55;77;43;3;40;.930;3538000;0
4822;176200;55;0;0;0;0;.00nan;0;0
4822;47112;56;0;0;0;0;.00nan;0;0
4822;57207;56;84;20;1;19;.950;3600000;0
4823;185743;4837;0;0;0;0;.00nan;0;0
4823;187295;4837;66;15;1;14;.933;3600000;0
4823;64722;49;57;17;2;15;.882;1485000;0
4823;79132;49;37;29;6;23;.793;2115000;0
4824;3928;59;56;22;3;19;.864;3896000;0
4824;183783;52;0;0;0;0;.00nan;0;0
4824;185812;52;97;50;3;47;.940;3900000;0
4824;75268;59;0;0;0;0;.00nan;0;0
4825;3928;59;0;0;0;0;.00nan;0;0
4825;175912;57;63;39;5;34;.872;3341000;0
4825;196372;57;51;2;0;2;1.000;259000;0
4825;75268;59;50;12;2;10;.833;3600000;0
4826;165744;53;0;0;0;0;.00nan;0;0
4826;166441;58;82;51;4;47;.922;3587000;0
4826;169323;53;63;19;2;17;.895;3600000;0
4826;38124;58;0;0;0;0;.00nan;0;0
4827;848;45;0;0;0;0;.00nan;0;0
4827;4622;64;0;0;0;0;.00nan;0;0
4827;168872;64;63;45;5;40;.889;3538000;0
4827;196495;45;68;27;3;24;.889;3600000;0
4828;43731;37;64;29;2;27;.931;3597000;0
4828;58037;37;0;0;0;0;.00nan;0;0
4828;79141;42;0;0;0;0;.00nan;0;0
4828;149450;42;83;22;1;21;.955;3600000;0
4829;188888;51;0;0;0;0;.00nan;0;0
4829;169226;65;0;0;0;0;.00nan;0;0
4829;175084;65;86;32;1;31;.969;3600000;0
4829;86360;51;56;35;5;30;.857;3600000;0
4830;31;55;0;0;0;0;.00nan;0;0
4830;173699;36;73;25;2;23;.920;3600000;0
4830;176200;55;62;35;4;31;.886;3554000;0
4830;187362;36;0;0;0;0;.00nan;0;0
4831;182780;60;0;0;0;0;.00nan;0;0
4831;170294;60;51;29;4;25;.862;3600000;0
4831;176938;62;0;0;0;0;.00nan;0;0
4831;38276;62;96;22;0;22;1.000;3600000;0
4832;192733;61;81;28;1;27;.964;3600000;0
4832;169154;44;72;23;2;21;.913;3555000;0
4832;-1;61;0;0;0;0;.00nan;0;0
4832;176921;44;0;0;0;0;.00nan;0;0
4833;170314;4619;0;0;0;0;.00nan;0;0
4833;191813;4619;50;21;3;18;.857;3548000;0
4833;57215;50;70;30;2;28;.933;3600000;0
4833;141998;50;0;0;0;0;.00nan;0;0
4834;182780;60;70;48;6;42;.875;3600000;0
4834;170294;60;0;0;0;0;.00nan;0;0
4834;176938;62;0;0;0;0;.00nan;0;0
4834;38276;62;100;27;0;27;1.000;3600000;0
4835;185743;4837;0;0;0;0;.00nan;0;0
4835;187295;4837;68;24;2;22;.917;3600000;0
4835;64722;49;0;0;0;0;.00nan;0;0
4835;79132;49;72;43;4;39;.907;3600000;0
4836;173699;36;70;35;4;31;.886;3600000;0
4836;187362;36;0;0;0;0;.00nan;0;0
4836;47112;56;0;0;0;0;.00nan;0;0
4836;57207;56;94;29;1;28;.966;3600000;0
4837;3928;59;89;30;2;28;.933;3600000;0
4837;183904;43;59;24;3;21;.875;3569000;0
4837;178612;43;0;0;0;0;.00nan;0;0
4837;75268;59;0;0;0;0;.00nan;0;0
4838;187699;39;74;23;1;22;.957;3600000;0
4838;188888;51;32;35;7;28;.800;3600000;0
4838;43928;39;0;0;0;0;.00nan;0;0
4838;86360;51;0;0;0;0;.00nan;0;0
4839;192733;61;75;39;4;35;.897;3600000;0
4839;-1;61;0;0;0;0;.00nan;0;0
4839;186495;47;66;16;1;15;.938;3600000;0
4839;86151;47;0;0;0;0;.00nan;0;0
4840;848;45;81;49;4;45;.918;3600000;0
4840;196495;45;0;0;0;0;.00nan;0;0
4840;43731;37;0;0;0;0;.00nan;0;0
4840;58037;37;69;16;1;15;.938;3600000;0
4841;171838;41;92;42;3;39;.929;3600000;0
4841;165744;53;32;17;4;13;.765;3600000;0
4841;194264;41;0;0;0;0;.00nan;0;0
4841;169323;53;0;0;0;0;.00nan;0;0
4842;31;55;0;0;0;0;.00nan;0;0
4842;176200;55;65;29;2;27;.931;3545000;0
4842;181123;63;83;30;1;29;.967;3600000;0
4842;192457;63;0;0;0;0;.00nan;0;0
4843;170314;4619;21;25;6;19;.760;3178000;0
4843;191813;4619;48;0;0;0;.00nan;422000;0
4843;57215;50;0;0;0;0;.00nan;0;0
4843;141998;50;92;44;2;42;.955;3600000;0
4844;185743;4837;70;21;1;20;.952;3900000;0
4844;186495;47;0;0;0;0;.00nan;0;0
4844;187295;4837;0;0;0;0;.00nan;0;0
4844;86151;47;100;43;1;42;.977;3900000;0
4845;181123;63;86;49;5;44;.898;3600000;0
4845;192457;63;0;0;0;0;.00nan;0;0
4845;47112;56;0;0;0;0;.00nan;0;0
4845;57207;56;65;21;2;19;.905;3600000;0
4846;169868;48;0;0;0;0;.00nan;0;0
4846;176938;62;0;0;0;0;.00nan;0;0
4846;38276;62;47;19;3;16;.842;3600000;0
4846;142492;48;62;45;5;40;.889;3600000;0
4847;4622;64;78;19;2;17;.895;3600000;0
4847;188888;51;0;0;0;0;.00nan;0;0
4847;168872;64;0;0;0;0;.00nan;0;0
4847;86360;51;76;46;5;41;.891;3600000;0
4848;848;45;71;37;4;33;.892;3600000;0
4848;196495;45;0;0;0;0;.00nan;0;0
4848;43731;37;0;0;0;0;.00nan;0;0
4848;58037;37;86;25;1;24;.960;3600000;0
4849;171838;41;94;43;3;40;.930;3519000;0
4849;194264;41;0;0;0;0;.00nan;0;0
4849;183904;43;67;19;1;18;.947;3600000;0
4849;178612;43;0;0;0;0;.00nan;0;0
4850;178384;40;100;30;0;30;1.000;3600000;0
4850;64722;49;0;0;0;0;.00nan;0;0
4850;79132;49;94;47;4;43;.915;3600000;0
4850;85636;40;0;0;0;0;.00nan;0;0
4851;192776;54;89;52;3;49;.942;3600000;0
4851;79141;42;100;24;0;24;1.000;3600000;0
4851;94615;54;0;0;0;0;.00nan;0;0
4851;149450;42;0;0;0;0;.00nan;0;0
4852;169154;44;0;0;0;0;.00nan;0;0
4852;170314;4619;0;0;0;0;.00nan;0;0
4852;176921;44;47;26;4;22;.846;3631000;0
4852;191813;4619;69;38;5;33;.868;3643000;0
4853;169226;65;55;7;1;6;.857;1302000;0
4853;175084;65;20;25;6;19;.760;2298000;0
4853;175912;57;93;39;2;37;.949;3600000;0
4853;196372;57;0;0;0;0;.00nan;0;0
4854;31;55;84;37;2;35;.946;2500000;0
4854;187699;39;89;17;0;17;1.000;3600000;0
4854;176200;55;36;22;4;18;.818;1100000;0
4854;43928;39;0;0;0;0;.00nan;0;0
4855;166441;58;0;0;0;0;.00nan;0;0
4855;173699;36;76;19;1;18;.947;3600000;0
4855;38124;58;81;43;4;39;.907;3600000;0
4855;187362;36;0;0;0;0;.00nan;0;0
4856;165744;53;58;17;2;15;.882;3563000;0
4856;183783;52;99;39;1;38;.974;3600000;0
4856;169323;53;0;0;0;0;.00nan;0;0
4856;185812;52;0;0;0;0;.00nan;0;0
4857;182780;60;0;0;0;0;.00nan;0;0
4857;170294;60;63;20;1;19;.950;3600000;0
4857;185743;4837;0;0;0;0;.00nan;0;0
4857;187295;4837;56;21;3;18;.857;3538000;0
4858;181123;63;0;0;0;0;.00nan;0;0
4858;192457;63;79;41;3;38;.927;3563000;0
4858;47112;56;81;28;1;27;.964;3600000;0
4858;57207;56;0;0;0;0;.00nan;0;0
4859;4622;64;61;23;3;20;.870;3600000;0
4859;188888;51;32;39;7;32;.821;3600000;0
4859;168872;64;0;0;0;0;.00nan;0;0
4859;86360;51;0;0;0;0;.00nan;0;0
4860;192776;54;77;51;5;46;.902;3746000;0
4860;43731;37;26;15;4;11;.733;3746000;0
4860;58037;37;0;0;0;0;.00nan;0;0
4860;94615;54;0;0;0;0;.00nan;0;0
4861;178384;40;66;42;5;37;.881;3600000;0
4861;64722;49;40;22;4;18;.818;2204000;0
4861;79132;49;13;15;6;9;.600;1396000;0
4861;85636;40;0;0;0;0;.00nan;0;0
4862;173699;36;64;33;4;29;.879;3600000;0
4862;176915;38;94;31;1;30;.968;3600000;0
4862;187362;36;0;0;0;0;.00nan;0;0
4862;141978;38;0;0;0;0;.00nan;0;0
4863;3928;59;35;18;4;14;.778;3600000;0
4863;166441;58;78;57;6;51;.895;3600000;0
4863;38124;58;0;0;0;0;.00nan;0;0
4863;75268;59;0;0;0;0;.00nan;0;0
4864;181102;46;89;38;2;36;.947;3624000;0
4864;57215;50;0;0;0;0;.00nan;0;0
4864;79280;46;0;0;0;0;.00nan;0;0
4864;141998;50;100;37;1;36;.973;3624000;0
4865;192733;61;97;48;3;45;.938;3600000;0
4865;-1;61;0;0;0;0;.00nan;0;0
4865;186495;47;100;24;0;24;1.000;3600000;0
4865;86151;47;0;0;0;0;.00nan;0;0
4866;183904;43;62;17;1;16;.941;3600000;0
4866;178612;43;0;0;0;0;.00nan;0;0
4866;175912;57;0;0;0;0;.00nan;0;0
4866;196372;57;76;45;4;41;.911;3600000;0
4867;31;55;0;0;0;0;.00nan;0;0
4867;187699;39;100;20;0;20;1.000;3600000;0
4867;176200;55;50;40;5;35;.875;3600000;0
4867;43928;39;0;0;0;0;.00nan;0;0
4868;165744;53;0;0;0;0;.00nan;0;0
4868;183783;52;0;0;0;0;.00nan;0;0
4868;169323;53;60;22;2;20;.909;3703000;0
4868;185812;52;93;47;3;44;.936;3703000;0
4869;169868;48;0;0;0;0;.00nan;0;0
4869;176938;62;68;25;2;23;.920;3560000;0
4869;38276;62;0;0;0;0;.00nan;0;0
4869;142492;48;98;49;1;48;.980;3600000;0
4870;166441;58;0;0;0;0;.00nan;0;0
4870;176915;38;0;0;0;0;.00nan;0;0
4870;38124;58;52;38;5;33;.868;3600000;0
4870;141978;38;58;22;3;19;.864;3600000;0
4871;181102;46;0;0;0;0;.00nan;0;0
4871;57215;50;63;32;3;29;.906;3600000;0
4871;79280;46;35;25;5;20;.800;3567000;0
4871;141998;50;0;0;0;0;.00nan;0;0
4872;848;45;64;39;4;35;.897;3567000;0
4872;196495;45;0;0;0;0;.00nan;0;0
4872;79141;42;0;0;0;0;.00nan;0;0
4872;149450;42;59;15;2;13;.867;3600000;0
4873;182780;60;93;33;1;32;.970;3600000;0
4873;169154;44;0;0;0;0;.00nan;0;0
4873;170294;60;0;0;0;0;.00nan;0;0
4873;176921;44;68;34;3;31;.912;3600000;0
4874;171838;41;57;34;4;30;.882;3600000;0
4874;194264;41;0;0;0;0;.00nan;0;0
4874;169226;65;87;20;0;20;1.000;3600000;0
4874;175084;65;0;0;0;0;.00nan;0;0
4875;3928;59;0;0;0;0;.00nan;0;0
4875;175912;57;62;57;7;50;.877;3600000;0
4875;196372;57;0;0;0;0;.00nan;0;0
4875;75268;59;78;10;0;10;1.000;3600000;0
4876;188888;51;0;0;0;0;.00nan;0;0
4876;43731;37;0;0;0;0;.00nan;0;0
4876;58037;37;80;24;2;22;.917;3600000;0
4876;86360;51;90;47;3;44;.936;3593000;0
5182;182780;60;0;0;0;0;.00nan;0;0
5182;188888;51;47;37;6;31;.838;3080000;0
5182;170294;60;60;27;3;24;.889;3600000;0
5182;186573;51;63;11;0;11;1.000;520000;0
5184;192733;61;100;30;0;30;1.000;3600000;0
5184;4622;64;25;33;7;26;.788;3600000;0
5184;168872;64;0;0;0;0;.00nan;0;0
5184;-1;61;0;0;0;0;.00nan;0;0
5186;169226;65;0;0;0;0;.00nan;0;0
5186;170314;4619;55;32;4;28;.875;3600000;0
5186;175084;65;44;32;5;27;.844;3600000;0
5186;191813;4619;0;0;0;0;.00nan;0;0
5188;848;45;82;31;2;29;.935;3570000;0
5188;173699;36;81;21;1;20;.952;3600000;0
5188;196495;45;0;0;0;0;.00nan;0;0
5188;187362;36;0;0;0;0;.00nan;0;0
5190;183904;43;66;11;1;10;.909;3600000;0
5190;178612;43;0;0;0;0;.00nan;0;0
5190;64722;49;0;0;0;0;.00nan;0;0
5190;79132;49;93;54;4;50;.926;3600000;0
5192;181102;46;100;45;1;44;.978;3600000;0
5192;57215;50;0;0;0;0;.00nan;0;0
5192;79280;46;0;0;0;0;.00nan;0;0
5192;141998;50;50;14;2;12;.857;3597000;0
5194;175912;57;91;42;1;41;.976;3600000;0
5194;196372;57;0;0;0;0;.00nan;0;0
5194;47112;56;63;23;2;21;.913;3562000;0
5194;57207;56;0;0;0;0;.00nan;0;0
5196;181123;63;56;37;5;32;.865;3600000;0
5196;43731;37;0;0;0;0;.00nan;0;0
5196;192457;63;0;0;0;0;.00nan;0;0
5196;58037;37;97;21;0;21;1.000;3600000;0
5198;165744;53;55;27;3;24;.889;3516000;0
5198;169323;53;0;0;0;0;.00nan;0;0
5198;169868;48;93;32;1;31;.969;3600000;0
5198;142492;48;0;0;0;0;.00nan;0;0
5200;176915;38;79;36;3;33;.917;3600000;0
5200;179950;4837;39;30;6;24;.800;2793000;0
5200;187295;4837;62;5;0;5;1.000;807000;0
5200;141978;38;0;0;0;0;.00nan;0;0
5202;169154;44;0;0;0;0;.00nan;0;0
5202;176921;44;84;57;4;53;.930;3596000;0
5202;186527;59;0;0;0;0;.00nan;0;0
5202;75268;59;55;19;2;17;.895;3600000;0
5204;187699;39;52;24;3;21;.875;3532000;0
5204;186495;47;100;34;1;33;.971;3600000;0
5204;43928;39;0;0;0;0;.00nan;0;0
5204;86151;47;0;0;0;0;.00nan;0;0
5206;166441;58;46;5;1;4;.800;366000;0
5206;176938;62;100;33;0;33;1.000;3600000;0
5206;38124;58;73;54;4;50;.926;3234000;0
5206;38276;62;0;0;0;0;.00nan;0;0
5208;192776;54;54;28;3;25;.893;3575000;0
5208;183783;52;62;14;1;13;.929;3600000;0
5208;185812;52;0;0;0;0;.00nan;0;0
5208;94615;54;0;0;0;0;.00nan;0;0
5210;31;55;0;0;0;0;.00nan;0;0
5210;194264;41;49;30;6;24;.800;3600000;0
5210;176060;41;0;0;0;0;.00nan;0;0
5210;176200;55;55;27;3;24;.889;3600000;0
5212;178384;40;60;47;5;42;.894;3600000;0
5212;79141;42;0;0;0;0;.00nan;0;0
5212;85636;40;0;0;0;0;.00nan;0;0
5212;149450;42;65;23;2;21;.913;3600000;0
5213;2643;743;76;41;4;37;.902;3550000;0
5213;190570;3789;0;0;0;0;.00nan;0;0
5213;-1;743;0;0;0;0;.00nan;0;0
5213;85797;3789;77;35;3;32;.914;3600000;0
5214;2195;748;91;43;3;40;.930;3517000;0
5214;3359;751;0;0;0;0;.00nan;0;0
5214;67287;748;0;0;0;0;.00nan;0;0
5214;148788;751;94;28;1;27;.964;3600000;0
5215;31165;752;87;35;2;33;.943;3600000;0
5215;-1;2168;0;0;0;0;.00nan;0;0
5215;49935;2168;54;25;3;22;.880;3559000;0
5215;52204;752;0;0;0;0;.00nan;0;0
5216;195887;729;0;0;0;0;.00nan;0;0
5216;180110;1880;0;0;0;0;.00nan;0;0
5216;88646;729;73;26;2;24;.923;3600000;0
5216;148573;1880;100;25;0;25;1.000;3600000;0
5217;33044;739;74;26;2;24;.923;3600000;0
5217;202104;740;0;0;0;0;.00nan;0;0
5217;196698;740;85;42;4;38;.905;3600000;0
5217;-1;739;0;0;0;0;.00nan;0;0
5218;841;764;0;0;0;0;.00nan;0;0
5218;-1;764;78;44;3;41;.932;3572000;0
5218;-1;745;0;0;0;0;.00nan;0;0
5218;56565;745;94;38;2;36;.947;3600000;0
5219;1957;738;68;41;3;38;.927;3554000;0
5219;66993;741;93;40;2;38;.950;3600000;0
5219;82273;741;0;0;0;0;.00nan;0;0
5219;93324;738;0;0;0;0;.00nan;0;0
5220;180177;736;72;31;2;29;.935;3600000;0
5220;207184;734;0;0;0;0;.00nan;0;0
5220;196715;736;0;0;0;0;.00nan;0;0
5220;44526;734;58;30;3;27;.900;3600000;0
5221;178098;733;100;36;1;35;.972;3600000;0
5221;-1;747;0;0;0;0;.00nan;0;0
5221;67122;733;0;0;0;0;.00nan;0;0
5221;76405;747;84;35;2;33;.943;3545000;0
5222;3756;744;58;26;3;23;.885;3600000;0
5222;193790;744;0;0;0;0;.00nan;0;0
5222;207771;742;90;37;2;35;.946;3465000;0
5222;-1;742;26;7;3;4;.571;117000;0
5223;198736;749;0;0;0;0;.00nan;0;0
5223;190570;3789;0;0;0;0;.00nan;0;0
5223;85661;749;60;27;3;24;.889;3514000;0
5223;85797;3789;95;29;1;28;.966;3600000;0
5224;199033;737;0;0;0;0;.00nan;0;0
5224;8504;737;74;21;1;20;.952;3600000;0
5224;8505;732;0;0;0;0;.00nan;0;0
5224;195867;732;72;35;3;32;.914;3559000;0
5225;841;764;0;0;0;0;.00nan;0;0
5225;2643;743;56;19;2;17;.895;3600000;0
5225;-1;764;55;34;4;30;.882;3544000;0
5225;-1;743;0;0;0;0;.00nan;0;0
5226;3359;751;0;0;0;0;.00nan;0;0
5226;-1;2168;0;0;0;0;.00nan;0;0
5226;49935;2168;93;33;1;32;.970;3544000;0
5226;148788;751;84;15;0;15;1.000;3600000;0
5227;-1;747;45;15;2;13;.867;1722000;0
5227;33044;739;99;26;0;26;1.000;3600000;0
5227;-1;739;0;0;0;0;.00nan;0;0
5227;76405;747;18;21;6;15;.714;1878000;0
5228;180110;1880;0;0;0;0;.00nan;0;0
5228;207184;734;0;0;0;0;.00nan;0;0
5228;44526;734;84;25;1;24;.960;3600000;0
5228;148573;1880;58;20;2;18;.900;3548000;0
5229;202104;740;0;0;0;0;.00nan;0;0
5229;196698;740;85;56;5;51;.911;3600000;0
5229;-1;745;0;0;0;0;.00nan;0;0
5229;56565;745;74;22;1;21;.955;3600000;0
5230;195887;729;0;0;0;0;.00nan;0;0
5230;180177;736;33;29;6;23;.793;3010000;0
5230;196715;736;52;9;1;8;.889;590000;0
5230;88646;729;54;17;2;15;.882;3600000;0
5231;1957;738;61;13;1;12;.923;3563000;0
5231;178098;733;100;37;0;37;1.000;3600000;0
5231;67122;733;0;0;0;0;.00nan;0;0
5231;93324;738;0;0;0;0;.00nan;0;0
5232;3756;744;70;21;2;19;.905;3600000;0
5232;193790;744;0;0;0;0;.00nan;0;0
5232;31165;752;0;0;0;0;.00nan;0;0
5232;52204;752;27;33;7;26;.788;3600000;0
5233;190570;3789;0;0;0;0;.00nan;0;0
5233;207771;742;73;41;4;37;.902;3771000;0
5233;-1;742;0;0;0;0;.00nan;0;0
5233;85797;3789;66;32;3;29;.906;3771000;0
5234;2643;743;92;37;2;35;.946;3748000;0
5234;180110;1880;0;0;0;0;.00nan;0;0
5234;-1;743;0;0;0;0;.00nan;0;0
5234;148573;1880;74;34;3;31;.912;3748000;0
5235;1957;738;89;22;0;22;1.000;3600000;0
5235;207184;734;0;0;0;0;.00nan;0;0
5235;44526;734;65;39;4;35;.897;3600000;0
5235;93324;738;0;0;0;0;.00nan;0;0
5236;31165;752;0;0;0;0;.00nan;0;0
5236;-1;745;0;0;0;0;.00nan;0;0
5236;52204;752;66;39;5;34;.872;3652000;0
5236;56565;745;59;23;4;19;.826;3652000;0
5237;841;764;0;0;0;0;.00nan;0;0
5237;199033;737;0;0;0;0;.00nan;0;0
5237;8504;737;10;20;6;14;.700;3588000;0
5237;-1;764;59;43;5;38;.884;3600000;0
5238;595;732;0;0;0;0;.00nan;0;0
5238;8505;732;100;27;0;27;1.000;3600000;0
5238;202104;740;67;41;4;37;.902;3600000;0
5238;196698;740;0;0;0;0;.00nan;0;0
5239;195887;729;0;0;0;0;.00nan;0;0
5239;66993;741;100;37;1;36;.973;3869000;0
5239;82273;741;0;0;0;0;.00nan;0;0
5239;88646;729;75;30;2;28;.933;3869000;0
5240;-1;747;0;0;0;0;.00nan;0;0
5240;180177;736;0;0;0;0;.00nan;0;0
5240;74734;736;65;39;4;35;.897;3600000;0
5240;76405;747;57;21;2;19;.905;3600000;0
5241;198736;749;0;0;0;0;.00nan;0;0
5241;178098;733;99;40;1;39;.975;3600000;0
5241;67122;733;0;0;0;0;.00nan;0;0
5241;85661;749;82;33;3;30;.909;3575000;0
5242;2195;748;100;48;1;47;.979;3763000;0
5242;3756;744;77;28;2;26;.929;3763000;0
5242;193790;744;0;0;0;0;.00nan;0;0
5242;67287;748;0;0;0;0;.00nan;0;0
5243;33044;739;49;36;6;30;.833;3600000;0
5243;207771;742;0;0;0;0;.00nan;0;0
5243;-1;739;0;0;0;0;.00nan;0;0
5243;-1;742;96;44;2;42;.955;3600000;0
5244;3359;751;0;0;0;0;.00nan;0;0
5244;-1;2168;0;0;0;0;.00nan;0;0
5244;49935;2168;72;41;4;37;.902;3600000;0
5244;148788;751;73;18;1;17;.944;3600000;0
5245;2643;743;70;26;2;24;.923;3756000;0
5245;207184;734;0;0;0;0;.00nan;0;0
5245;44526;734;90;42;1;41;.976;3756000;0
5245;-1;743;0;0;0;0;.00nan;0;0
5246;199033;737;0;0;0;0;.00nan;0;0
5246;8504;737;64;17;1;16;.941;3600000;0
5246;202104;740;0;0;0;0;.00nan;0;0
5246;196698;740;66;52;5;47;.904;3600000;0
5247;595;732;91;28;1;27;.964;3600000;0
5247;1957;738;83;35;3;32;.914;3592000;0
5247;8505;732;0;0;0;0;.00nan;0;0
5247;93324;738;0;0;0;0;.00nan;0;0
5248;190570;3789;0;0;0;0;.00nan;0;0
5248;66993;741;0;0;0;0;.00nan;0;0
5248;82273;741;76;42;4;38;.905;3900000;0
5248;85797;3789;64;35;4;31;.886;3900000;0
5249;198736;749;0;0;0;0;.00nan;0;0
5249;180177;736;0;0;0;0;.00nan;0;0
5249;74734;736;85;32;2;30;.938;3756000;0
5249;85661;749;92;35;1;34;.971;3756000;0
5250;841;764;0;0;0;0;.00nan;0;0
5250;178098;733;89;37;2;35;.946;3600000;0
5250;-1;764;56;23;3;20;.870;3568000;0
5250;67122;733;0;0;0;0;.00nan;0;0
5251;2195;748;87;30;1;29;.967;3600000;0
5251;-1;2168;0;0;0;0;.00nan;0;0
5251;49935;2168;58;38;4;34;.895;3600000;0
5251;67287;748;0;0;0;0;.00nan;0;0
5252;33044;739;92;35;2;33;.943;3600000;0
5252;180110;1880;0;0;0;0;.00nan;0;0
5252;-1;739;0;0;0;0;.00nan;0;0
5252;148573;1880;41;26;5;21;.808;3600000;0
5253;-1;747;0;0;0;0;.00nan;0;0
5253;-1;745;0;0;0;0;.00nan;0;0
5253;56565;745;74;22;1;21;.955;3600000;0
5253;76405;747;77;34;3;31;.912;3533000;0
5254;3359;751;82;30;2;28;.933;3600000;0
5254;3756;744;44;21;4;17;.810;3557000;0
5254;193790;744;0;0;0;0;.00nan;0;0
5254;148788;751;0;0;0;0;.00nan;0;0
5255;178098;733;0;0;0;0;.00nan;0;0
5255;207771;742;0;0;0;0;.00nan;0;0
5255;-1;742;30;20;5;15;.750;3600000;0
5255;67122;733;94;44;2;42;.955;3600000;0
5256;190570;3789;0;0;0;0;.00nan;0;0
5256;207184;734;0;0;0;0;.00nan;0;0
5256;44526;734;83;42;4;38;.905;3734000;0
5256;85797;3789;44;30;5;25;.833;3734000;0
5257;2195;748;100;35;0;35;1.000;3600000;0
5257;-1;747;0;0;0;0;.00nan;0;0
5257;67287;748;0;0;0;0;.00nan;0;0
5257;76405;747;48;26;4;22;.846;3600000;0
5258;33044;739;39;25;5;20;.800;3600000;0
5258;-1;739;0;0;0;0;.00nan;0;0
5258;-1;2168;0;0;0;0;.00nan;0;0
5258;49935;2168;78;30;2;28;.933;3600000;0
5259;199033;737;0;0;0;0;.00nan;0;0
5259;8504;737;61;23;2;21;.913;3622000;0
5259;180110;1880;0;0;0;0;.00nan;0;0
5259;148573;1880;92;44;3;41;.932;3622000;0
5260;3756;744;62;31;3;28;.903;3600000;0
5260;193790;744;0;0;0;0;.00nan;0;0
5260;66993;741;99;44;1;43;.977;3600000;0
5260;82273;741;0;0;0;0;.00nan;0;0
5261;31165;752;0;0;0;0;.00nan;0;0
5261;207771;742;73;33;3;30;.909;3592000;0
5261;-1;742;0;0;0;0;.00nan;0;0
5261;52204;752;83;30;2;28;.933;3600000;0
5262;1957;738;22;11;4;7;.636;731000;0
5262;2643;743;61;23;3;20;.870;3600000;0
5262;-1;743;0;0;0;0;.00nan;0;0
5262;93324;738;70;23;1;22;.957;2822000;0
5263;199033;737;59;24;3;21;.875;3517000;0
5263;8504;737;0;0;0;0;.00nan;0;0
5263;207184;734;0;0;0;0;.00nan;0;0
5263;44526;734;100;36;1;35;.972;3600000;0
5264;595;732;95;33;1;32;.970;3600000;0
5264;198736;749;0;0;0;0;.00nan;0;0
5264;8505;732;0;0;0;0;.00nan;0;0
5264;85661;749;76;41;4;37;.902;3600000;0
5265;180177;736;0;0;0;0;.00nan;0;0
5265;202104;740;38;26;5;21;.808;2210000;0
5265;196698;740;60;15;1;14;.933;1390000;0
5265;74734;736;38;21;4;17;.810;3600000;0
5266;841;764;71;37;2;35;.946;3900000;0
5266;-1;764;0;0;0;0;.00nan;0;0
5266;-1;745;0;0;0;0;.00nan;0;0
5266;56565;745;71;26;2;24;.923;3900000;0
5267;195887;729;0;0;0;0;.00nan;0;0
5267;180110;1880;0;0;0;0;.00nan;0;0
5267;88646;729;59;37;4;33;.892;3591000;0
5267;148573;1880;69;32;3;29;.906;3600000;0
5268;33044;739;80;26;1;25;.962;3600000;0
5268;190570;3789;0;0;0;0;.00nan;0;0
5268;-1;739;0;0;0;0;.00nan;0;0
5268;85797;3789;62;40;4;36;.900;3600000;0
5269;3359;751;0;0;0;0;.00nan;0;0
5269;-1;747;0;0;0;0;.00nan;0;0
5269;76405;747;98;44;3;41;.932;3587000;0
5269;148788;751;74;26;2;24;.923;3600000;0
5270;2195;748;26;14;4;10;.714;1145000;0
5270;198736;749;0;0;0;0;.00nan;0;0
5270;67287;748;61;16;2;14;.875;2455000;0
5270;85661;749;89;35;3;32;.914;3600000;0
5271;207771;742;0;0;0;0;.00nan;0;0
5271;-1;742;85;24;1;23;.958;3600000;0
5271;-1;745;0;0;0;0;.00nan;0;0
5271;56565;745;55;40;6;34;.850;3600000;0
5272;595;732;77;28;2;26;.929;3600000;0
5272;8505;732;0;0;0;0;.00nan;0;0
5272;207184;734;0;0;0;0;.00nan;0;0
5272;44526;734;53;41;5;36;.878;3600000;0
5273;2643;743;67;32;3;29;.906;3600000;0
5273;31165;752;60;30;4;26;.867;3544000;0
5273;-1;743;0;0;0;0;.00nan;0;0
5273;52204;752;0;0;0;0;.00nan;0;0
5274;841;764;0;0;0;0;.00nan;0;0
5274;1957;738;61;38;4;34;.895;3544000;0
5274;-1;764;72;37;3;34;.919;3600000;0
5274;93324;738;0;0;0;0;.00nan;0;0
5275;178098;733;29;20;5;15;.750;3600000;0
5275;180177;736;0;0;0;0;.00nan;0;0
5275;67122;733;0;0;0;0;.00nan;0;0
5275;74734;736;85;35;3;32;.914;3600000;0
5276;3756;744;59;26;3;23;.885;3790000;0
5276;193790;744;0;0;0;0;.00nan;0;0
5276;66993;741;94;43;2;41;.953;3790000;0
5276;82273;741;0;0;0;0;.00nan;0;0
5277;33044;739;77;11;0;11;1.000;3600000;0
5277;202104;740;0;0;0;0;.00nan;0;0
5277;196698;740;92;52;4;48;.923;3600000;0
5277;-1;739;0;0;0;0;.00nan;0;0
5278;3359;751;0;0;0;0;.00nan;0;0
5278;180110;1880;61;22;2;20;.909;3600000;0
5278;148573;1880;0;0;0;0;.00nan;0;0
5278;148788;751;55;38;6;32;.842;3600000;0
5279;2195;748;65;30;2;28;.933;3579000;0
5279;66993;741;91;37;1;36;.973;3600000;0
5279;67287;748;0;0;0;0;.00nan;0;0
5279;82273;741;0;0;0;0;.00nan;0;0
5280;595;732;85;33;2;31;.939;3900000;0
5280;2643;743;91;44;2;42;.955;3900000;0
5280;8505;732;0;0;0;0;.00nan;0;0
5280;-1;743;0;0;0;0;.00nan;0;0
5281;198736;749;0;0;0;0;.00nan;0;0
5281;-1;2168;0;0;0;0;.00nan;0;0
5281;49935;2168;87;37;2;35;.946;3581000;0
5281;85661;749;96;36;1;35;.972;3600000;0
5282;180177;736;0;0;0;0;.00nan;0;0
5282;190570;3789;0;0;0;0;.00nan;0;0
5282;74734;736;96;57;4;53;.930;3600000;0
5282;85797;3789;98;35;2;33;.943;3600000;0
5283;199033;737;0;0;0;0;.00nan;0;0
5283;8504;737;62;18;2;16;.889;3600000;0
5283;207184;734;0;0;0;0;.00nan;0;0
5283;44526;734;85;49;4;45;.918;3584000;0
5284;207771;742;86;35;2;33;.943;3600000;0
5284;-1;742;0;0;0;0;.00nan;0;0
5284;-1;745;0;0;0;0;.00nan;0;0
5284;56565;745;69;41;4;37;.902;3520000;0
5285;841;764;0;0;0;0;.00nan;0;0
5285;3756;744;55;18;3;15;.833;3527000;0
5285;193790;744;0;0;0;0;.00nan;0;0
5285;-1;764;99;37;1;36;.973;3600000;0
5286;178098;733;77;45;4;41;.911;3600000;0
5286;195887;729;0;0;0;0;.00nan;0;0
5286;67122;733;0;0;0;0;.00nan;0;0
5286;88646;729;35;24;5;19;.792;3557000;0
5287;3359;751;0;0;0;0;.00nan;0;0
5287;202104;740;62;41;5;36;.878;3600000;0
5287;196698;740;0;0;0;0;.00nan;0;0
5287;148788;751;75;20;1;19;.950;3600000;0
5288;2643;743;42;18;3;15;.833;3581000;0
5288;178098;733;94;39;1;38;.974;3600000;0
5288;-1;743;0;0;0;0;.00nan;0;0
5288;67122;733;0;0;0;0;.00nan;0;0
5289;-1;2168;0;0;0;0;.00nan;0;0
5289;49935;2168;90;34;2;32;.941;3571000;0
5289;66993;741;100;28;0;28;1.000;3600000;0
5289;82273;741;0;0;0;0;.00nan;0;0
5290;199033;737;0;0;0;0;.00nan;0;0
5290;8504;737;51;27;4;23;.852;3600000;0
5290;190570;3789;0;0;0;0;.00nan;0;0
5290;85797;3789;50;33;5;28;.848;3571000;0
5291;33044;739;65;20;2;18;.900;3600000;0
5291;180177;736;0;0;0;0;.00nan;0;0
5291;-1;739;0;0;0;0;.00nan;0;0
5291;74734;736;75;46;4;42;.913;3589000;0
5292;3756;744;90;28;1;27;.964;3900000;0
5292;193790;744;0;0;0;0;.00nan;0;0
5292;207771;742;84;28;1;27;.964;3900000;0
5292;-1;742;0;0;0;0;.00nan;0;0
5293;595;732;73;20;2;18;.900;3900000;0
5293;8505;732;0;0;0;0;.00nan;0;0
5293;31165;752;0;0;0;0;.00nan;0;0
5293;52204;752;96;46;2;44;.957;3900000;0
5294;195887;729;0;0;0;0;.00nan;0;0
5294;180110;1880;0;0;0;0;.00nan;0;0
5294;88646;729;78;33;2;31;.939;3600000;0
5294;148573;1880;60;27;3;24;.889;3600000;0
5295;841;764;0;0;0;0;.00nan;0;0
5295;-1;764;100;28;0;28;1.000;3600000;0
5295;-1;745;0;0;0;0;.00nan;0;0
5295;56565;745;95;40;2;38;.950;3526000;0
5296;-1;747;51;35;5;30;.857;3562000;0
5296;207184;734;0;0;0;0;.00nan;0;0
5296;44526;734;71;32;3;29;.906;3600000;0
5296;76405;747;0;0;0;0;.00nan;0;0
5297;1957;738;78;33;1;32;.970;3900000;0
5297;199033;737;0;0;0;0;.00nan;0;0
5297;8504;737;91;34;1;33;.971;3900000;0
5297;33044;738;0;0;0;0;.00nan;0;0
5298;3756;744;97;27;1;26;.963;3900000;0
5298;193790;744;0;0;0;0;.00nan;0;0
5298;207771;742;0;0;0;0;.00nan;0;0
5298;-1;742;86;30;1;29;.967;3900000;0
5299;595;732;0;0;0;0;.00nan;0;0
5299;8505;732;52;10;1;9;.900;3600000;0
5299;178098;733;0;0;0;0;.00nan;0;0
5299;66245;733;94;64;5;59;.922;3600000;0
5300;31165;752;0;0;0;0;.00nan;0;0
5300;66993;741;90;35;1;34;.971;3546000;0
5300;82273;741;0;0;0;0;.00nan;0;0
5300;93324;752;100;30;0;30;1.000;3600000;0
5301;195887;729;0;0;0;0;.00nan;0;0
5301;202104;740;52;17;2;15;.882;1451000;0
5301;196698;740;34;30;6;24;.800;2149000;0
5301;88646;729;86;16;0;16;1.000;3600000;0
5302;-1;747;0;0;0;0;.00nan;0;0
5302;-1;739;0;0;0;0;.00nan;0;0
5302;76405;747;60;23;2;21;.913;3600000;0
5302;85670;739;62;34;4;30;.882;3600000;0
5303;190570;3789;0;0;0;0;.00nan;0;0
5303;-1;745;0;0;0;0;.00nan;0;0
5303;56565;745;100;38;0;38;1.000;3600000;0
5303;85797;3789;75;32;3;29;.906;3600000;0
5304;2195;748;25;7;3;4;.571;280000;0
5304;3359;751;48;20;3;17;.850;3600000;0
5304;67287;748;73;44;5;39;.886;3320000;0
5304;148788;751;0;0;0;0;.00nan;0;0
5305;841;764;0;0;0;0;.00nan;0;0
5305;165723;1880;26;13;4;9;.692;726000;0
5305;-1;764;80;24;1;23;.958;3600000;0
5305;148573;1880;33;27;6;21;.778;2874000;0
5306;180177;736;0;0;0;0;.00nan;0;0
5306;-1;2168;0;0;0;0;.00nan;0;0
5306;49935;2168;65;25;2;23;.920;3600000;0
5306;74734;736;79;35;3;32;.914;3553000;0
5307;198736;749;0;0;0;0;.00nan;0;0
5307;207184;734;0;0;0;0;.00nan;0;0
5307;44526;734;79;45;5;40;.889;3600000;0
5307;85661;749;89;25;1;24;.960;3600000;0
5308;1957;738;51;13;2;11;.846;3600000;0
5308;178098;733;84;40;3;37;.925;3600000;0
5308;33044;738;0;0;0;0;.00nan;0;0
5308;66245;733;0;0;0;0;.00nan;0;0
5309;3756;744;89;17;0;17;1.000;3600000;0
5309;193790;744;0;0;0;0;.00nan;0;0
5309;31165;752;70;41;4;37;.902;3600000;0
5309;93324;752;0;0;0;0;.00nan;0;0
5310;195887;729;0;0;0;0;.00nan;0;0
5310;207771;742;70;27;2;25;.926;3531000;0
5310;-1;742;0;0;0;0;.00nan;0;0
5310;88646;729;100;29;0;29;1.000;3600000;0
5311;-1;747;0;0;0;0;.00nan;0;0
5311;202104;740;62;38;4;34;.895;3566000;0
5311;196698;740;0;0;0;0;.00nan;0;0
5311;76405;747;62;31;3;28;.903;3600000;0
5312;207184;734;0;0;0;0;.00nan;0;0
5312;44526;734;81;45;5;40;.889;3600000;0
5312;-1;745;0;0;0;0;.00nan;0;0
5312;56565;745;21;25;6;19;.760;3543000;0
5313;199033;737;0;0;0;0;.00nan;0;0
5313;8504;737;66;39;5;34;.872;3900000;0
5313;190570;3789;0;0;0;0;.00nan;0;0
5313;85797;3789;54;38;5;33;.868;3900000;0
5314;2195;748;52;34;5;29;.853;3600000;0
5314;66993;741;0;0;0;0;.00nan;0;0
5314;67287;748;0;0;0;0;.00nan;0;0
5314;82273;741;61;27;3;24;.889;3600000;0
5315;3359;751;0;0;0;0;.00nan;0;0
5315;-1;2168;0;0;0;0;.00nan;0;0
5315;49935;2168;97;37;1;36;.973;3600000;0
5315;148788;751;63;22;2;20;.909;3567000;0
5316;841;764;0;0;0;0;.00nan;0;0
5316;180177;736;59;7;0;7;1.000;465000;0
5316;-1;764;60;17;2;15;.882;3600000;0
5316;74734;736;31;29;6;23;.793;3135000;0
5317;198736;749;0;0;0;0;.00nan;0;0
5317;-1;739;0;0;0;0;.00nan;0;0
5317;85661;749;70;33;3;30;.909;3600000;0
5317;85670;739;37;35;6;29;.829;3600000;0
5318;2643;743;85;21;1;20;.952;3600000;0
5318;31165;752;62;36;4;32;.889;3600000;0
5318;-1;743;0;0;0;0;.00nan;0;0
5318;93324;752;0;0;0;0;.00nan;0;0
5319;595;732;100;27;0;27;1.000;3600000;0
5319;1957;738;88;34;2;32;.941;3552000;0
5319;8505;732;0;0;0;0;.00nan;0;0
5319;33044;738;0;0;0;0;.00nan;0;0
5320;841;764;0;0;0;0;.00nan;0;0
5320;-1;764;48;24;4;20;.833;3548000;0
5320;-1;745;0;0;0;0;.00nan;0;0
5320;56565;745;74;34;3;31;.912;3600000;0
5321;199033;737;0;0;0;0;.00nan;0;0
5321;8504;737;66;18;1;17;.944;3600000;0
5321;207771;742;73;43;4;39;.907;3600000;0
5321;-1;742;0;0;0;0;.00nan;0;0
5322;-1;2168;0;0;0;0;.00nan;0;0
5322;49935;2168;49;27;4;23;.852;3561000;0
5322;66993;741;78;30;2;28;.933;3600000;0
5322;82273;741;0;0;0;0;.00nan;0;0
5323;3359;751;0;0;0;0;.00nan;0;0
5323;-1;739;0;0;0;0;.00nan;0;0
5323;85670;739;100;42;1;41;.976;3600000;0
5323;148788;751;72;29;2;27;.931;3557000;0
5324;198736;749;0;0;0;0;.00nan;0;0
5324;202104;740;0;0;0;0;.00nan;0;0
5324;196698;740;48;36;5;31;.861;3600000;0
5324;85661;749;100;31;0;31;1.000;3600000;0
5325;2195;748;94;35;1;34;.971;3600000;0
5325;3756;744;93;18;0;18;1.000;3600000;0
5325;193790;744;0;0;0;0;.00nan;0;0
5325;67287;748;0;0;0;0;.00nan;0;0
5326;195887;729;0;0;0;0;.00nan;0;0
5326;190570;3789;0;0;0;0;.00nan;0;0
5326;85797;3789;70;23;2;21;.913;3600000;0
5326;88646;729;68;37;4;33;.892;3580000;0
5327;1957;738;0;0;0;0;.00nan;0;0
5327;2643;743;79;33;2;31;.939;3596000;0
5327;33044;738;95;21;0;21;1.000;3600000;0
5327;-1;743;0;0;0;0;.00nan;0;0
5328;165723;1880;84;25;1;24;.960;3600000;0
5328;180177;736;84;52;4;48;.923;3600000;0
5328;74734;736;0;0;0;0;.00nan;0;0
5328;148573;1880;0;0;0;0;.00nan;0;0
5329;595;732;85;27;1;26;.963;3600000;0
5329;8505;732;0;0;0;0;.00nan;0;0
5329;178098;733;93;44;2;42;.955;3563000;0
5329;66245;733;0;0;0;0;.00nan;0;0
5330;207184;734;0;0;0;0;.00nan;0;0
5330;207771;742;0;0;0;0;.00nan;0;0
5330;44526;734;77;34;3;31;.912;3514000;0
5330;-1;742;77;23;1;22;.957;3600000;0
5331;3756;744;58;22;2;20;.909;3600000;0
5331;199033;737;0;0;0;0;.00nan;0;0
5331;8504;737;88;38;3;35;.921;3556000;0
5331;193790;744;0;0;0;0;.00nan;0;0
5332;-1;747;0;0;0;0;.00nan;0;0
5332;66993;741;69;18;1;17;.944;3600000;0
5332;76405;747;92;49;3;46;.939;3547000;0
5332;82273;741;0;0;0;0;.00nan;0;0
5333;3359;751;74;9;0;9;1.000;3600000;0
5333;202104;740;74;38;3;35;.921;3550000;0
5333;196698;740;0;0;0;0;.00nan;0;0
5333;148788;751;0;0;0;0;.00nan;0;0
5334;841;764;0;0;0;0;.00nan;0;0
5334;31165;752;63;35;3;32;.914;3600000;0
5334;-1;764;85;20;0;20;1.000;3600000;0
5334;93324;752;0;0;0;0;.00nan;0;0
5335;198736;749;0;0;0;0;.00nan;0;0
5335;-1;2168;0;0;0;0;.00nan;0;0
5335;49935;2168;96;42;1;41;.976;3600000;0
5335;85661;749;69;48;5;43;.896;3600000;0
5336;195887;729;0;0;0;0;.00nan;0;0
5336;180177;736;95;44;3;41;.932;3900000;0
5336;74734;736;0;0;0;0;.00nan;0;0
5336;88646;729;88;31;3;28;.903;3900000;0
5337;165723;1880;88;31;2;29;.935;3586000;0
5337;190570;3789;0;0;0;0;.00nan;0;0
5337;85797;3789;82;27;1;26;.963;3600000;0
5337;148573;1880;0;0;0;0;.00nan;0;0
5338;595;732;75;23;1;22;.957;3900000;0
5338;2643;743;100;44;1;43;.977;3900000;0
5338;8505;732;0;0;0;0;.00nan;0;0
5338;-1;743;0;0;0;0;.00nan;0;0
5339;178098;733;98;44;3;41;.932;3600000;0
5339;-1;745;0;0;0;0;.00nan;0;0
5339;56565;745;96;23;0;23;1.000;3600000;0
5339;66245;733;0;0;0;0;.00nan;0;0
5340;2195;748;84;27;1;26;.963;3600000;0
5340;-1;739;98;41;2;39;.951;3600000;0
5340;67287;748;0;0;0;0;.00nan;0;0
5340;85670;739;0;0;0;0;.00nan;0;0
5341;-1;747;0;0;0;0;.00nan;0;0
5341;207184;734;48;25;4;21;.840;3600000;0
5341;44526;734;0;0;0;0;.00nan;0;0
5341;76405;747;79;24;1;23;.958;3600000;0
5342;31165;752;80;35;2;33;.943;3600000;0
5342;207771;742;62;26;3;23;.885;3571000;0
5342;-1;742;0;0;0;0;.00nan;0;0
5342;93324;752;0;0;0;0;.00nan;0;0
5343;3359;751;64;24;2;22;.917;3900000;0
5343;-1;2168;0;0;0;0;.00nan;0;0
5343;49935;2168;82;38;2;36;.947;3900000;0
5343;148788;751;0;0;0;0;.00nan;0;0
5344;199033;737;0;0;0;0;.00nan;0;0
5344;8504;737;64;18;1;17;.944;3600000;0
5344;195887;729;0;0;0;0;.00nan;0;0
5344;88646;729;91;35;3;32;.914;3579000;0
5345;1957;738;0;0;0;0;.00nan;0;0
5345;184158;738;88;39;2;37;.949;3900000;0
5345;-1;745;0;0;0;0;.00nan;0;0
5345;56565;745;72;25;2;23;.920;3900000;0
5346;595;732;100;47;2;45;.957;3600000;0
5346;8505;732;0;0;0;0;.00nan;0;0
5346;165723;1880;69;36;4;32;.889;3526000;0
5346;148573;1880;0;0;0;0;.00nan;0;0
5347;841;764;0;0;0;0;.00nan;0;0
5347;-1;764;91;35;1;34;.971;3600000;0
5347;66993;741;25;33;6;27;.818;2913000;0
5347;82273;741;43;4;1;3;.750;687000;0
5348;3756;744;63;15;1;14;.933;3600000;0
5348;198736;749;0;0;0;0;.00nan;0;0
5348;193790;744;0;0;0;0;.00nan;0;0
5348;85661;749;87;51;4;47;.922;3600000;0
5349;2643;743;46;25;4;21;.840;3513000;0
5349;-1;747;0;0;0;0;.00nan;0;0
5349;-1;743;0;0;0;0;.00nan;0;0
5349;76405;747;77;32;2;30;.938;3600000;0
5350;2195;748;63;33;4;29;.879;3519000;0
5350;207184;734;0;0;0;0;.00nan;0;0
5350;44526;734;97;40;2;38;.950;3600000;0
5350;67287;748;0;0;0;0;.00nan;0;0
5351;178098;733;79;36;3;33;.917;3600000;0
5351;190570;3789;0;0;0;0;.00nan;0;0
5351;66245;733;0;0;0;0;.00nan;0;0
5351;85797;3789;94;23;0;23;1.000;3600000;0
5352;1957;738;0;0;0;0;.00nan;0;0
5352;184158;738;85;30;1;29;.967;3600000;0
5352;-1;2168;0;0;0;0;.00nan;0;0
5352;49935;2168;93;36;2;34;.944;3543000;0
5353;207184;734;0;0;0;0;.00nan;0;0
5353;44526;734;76;37;3;34;.919;3600000;0
5353;-1;739;0;0;0;0;.00nan;0;0
5353;85670;739;91;20;0;20;1.000;3600000;0
5354;31165;752;97;42;2;40;.952;3600000;0
5354;-1;745;0;0;0;0;.00nan;0;0
5354;56565;745;64;42;5;37;.881;3600000;0
5354;93324;752;0;0;0;0;.00nan;0;0
5355;207771;742;0;0;0;0;.00nan;0;0
5355;-1;742;87;40;2;38;.950;3600000;0
5355;66993;741;43;28;4;24;.857;3597000;0
5355;82273;741;0;0;0;0;.00nan;0;0
5356;165723;1880;51;15;2;13;.867;3594000;0
5356;202104;740;0;0;0;0;.00nan;0;0
5356;196698;740;90;32;1;31;.969;3600000;0
5356;148573;1880;0;0;0;0;.00nan;0;0
5357;199033;737;0;0;0;0;.00nan;0;0
5357;8504;737;73;14;1;13;.929;3600000;0
5357;180177;736;0;0;0;0;.00nan;0;0
5357;74734;736;80;51;4;47;.922;3600000;0
5358;841;764;73;36;3;33;.917;3900000;0
5358;3359;751;0;0;0;0;.00nan;0;0
5358;-1;764;0;0;0;0;.00nan;0;0
5358;148788;751;90;38;3;35;.921;3900000;0
5359;2643;743;66;32;4;28;.875;3724000;0
5359;195887;729;0;0;0;0;.00nan;0;0
5359;-1;743;0;0;0;0;.00nan;0;0
5359;88646;729;61;23;3;20;.870;3751000;0
5360;595;732;56;27;3;24;.889;3600000;0
5360;2195;748;35;7;3;4;.571;561000;0
5360;8505;732;0;0;0;0;.00nan;0;0
5360;67287;748;66;33;3;30;.909;3039000;0
5361;3756;744;66;18;1;17;.944;3600000;0
5361;193790;744;0;0;0;0;.00nan;0;0
5361;-1;747;0;0;0;0;.00nan;0;0
5361;76405;747;87;44;3;41;.932;3572000;0
5362;190570;3789;0;0;0;0;.00nan;0;0
5362;-1;2168;0;0;0;0;.00nan;0;0
5362;49935;2168;79;41;3;38;.927;3600000;0
5362;85797;3789;80;31;2;29;.935;3600000;0
5363;1957;738;0;0;0;0;.00nan;0;0
5363;184158;738;72;17;1;16;.941;3600000;0
5363;202104;740;97;46;2;44;.957;3544000;0
5363;196698;740;0;0;0;0;.00nan;0;0
5364;199033;737;0;0;0;0;.00nan;0;0
5364;8504;737;100;25;0;25;1.000;3600000;0
5364;-1;739;0;0;0;0;.00nan;0;0
5364;85670;739;88;45;3;42;.933;3600000;0
5365;207771;742;57;35;4;31;.886;3514000;0
5365;-1;742;0;0;0;0;.00nan;0;0
5365;66993;741;70;26;2;24;.923;3600000;0
5365;82273;741;0;0;0;0;.00nan;0;0
5366;3359;751;0;0;0;0;.00nan;0;0
5366;180177;736;0;0;0;0;.00nan;0;0
5366;74734;736;100;58;3;55;.948;3900000;0
5366;148788;751;59;28;3;25;.893;3900000;0
5367;841;764;66;12;0;12;1.000;2429000;0
5367;31165;752;72;32;3;29;.906;3600000;0
5367;-1;764;32;14;4;10;.714;1171000;0
5367;93324;752;0;0;0;0;.00nan;0;0
5368;178098;733;91;37;2;35;.946;3900000;0
5368;207184;734;0;0;0;0;.00nan;0;0
5368;44526;734;72;27;2;25;.926;3900000;0
5368;66245;733;0;0;0;0;.00nan;0;0
5369;2195;748;70;33;3;30;.909;3574000;0
5369;2643;743;97;43;2;41;.953;3600000;0
5369;-1;743;0;0;0;0;.00nan;0;0
5369;67287;748;0;0;0;0;.00nan;0;0
5370;595;732;50;29;4;25;.862;3558000;0
5370;8505;732;0;0;0;0;.00nan;0;0
5370;207184;734;81;39;3;36;.923;3600000;0
5370;44526;734;0;0;0;0;.00nan;0;0
5371;165723;1880;75;21;1;20;.952;3900000;0
5371;195887;729;0;0;0;0;.00nan;0;0
5371;88646;729;71;20;1;19;.950;3900000;0
5371;148573;1880;0;0;0;0;.00nan;0;0
5372;198736;749;0;0;0;0;.00nan;0;0
5372;-1;745;0;0;0;0;.00nan;0;0
5372;56565;745;52;22;3;19;.864;3660000;0
5372;85661;749;94;47;4;43;.915;3660000;0
5373;190570;3789;0;0;0;0;.00nan;0;0
5373;202104;740;0;0;0;0;.00nan;0;0
5373;196698;740;97;52;3;49;.942;3546000;0
5373;85797;3789;58;17;2;15;.882;3600000;0
5374;1957;738;0;0;0;0;.00nan;0;0
5374;199033;737;0;0;0;0;.00nan;0;0
5374;8504;737;52;21;4;17;.810;3600000;0
5374;184158;738;67;46;5;41;.891;3561000;0
5375;31165;752;0;0;0;0;.00nan;0;0
5375;207771;742;100;33;0;33;1.000;3600000;0
5375;-1;742;0;0;0;0;.00nan;0;0
5375;52204;752;74;26;2;24;.923;3517000;0
5376;3359;751;97;45;2;43;.956;3900000;0
5376;3756;744;82;30;2;28;.933;3900000;0
5376;193790;744;0;0;0;0;.00nan;0;0
5376;148788;751;0;0;0;0;.00nan;0;0
5377;178098;733;0;0;0;0;.00nan;0;0
5377;-1;2168;0;0;0;0;.00nan;0;0
5377;49935;2168;100;24;0;24;1.000;3600000;0
5377;66245;733;90;35;2;33;.943;3600000;0
5378;198736;749;97;34;2;32;.941;3600000;0
5378;-1;745;0;0;0;0;.00nan;0;0
5378;56565;745;66;38;4;34;.895;3549000;0
5378;85661;749;0;0;0;0;.00nan;0;0
5379;841;764;0;0;0;0;.00nan;0;0
5379;2195;748;0;0;0;0;.00nan;0;0
5379;-1;764;73;33;3;30;.909;3583000;0
5379;67287;748;84;29;2;27;.931;3600000;0
5380;595;732;97;26;0;26;1.000;3600000;0
5380;8505;732;0;0;0;0;.00nan;0;0
5380;-1;739;0;0;0;0;.00nan;0;0
5380;85670;739;97;41;1;40;.976;3594000;0
5381;180177;736;0;0;0;0;.00nan;0;0
5381;207184;734;0;0;0;0;.00nan;0;0
5381;44526;734;58;32;4;28;.875;3600000;0
5381;74734;736;80;32;2;30;.938;3600000;0
5382;165723;1880;98;32;1;31;.969;3900000;0
5382;195887;729;0;0;0;0;.00nan;0;0
5382;88646;729;100;37;1;36;.973;3900000;0
5382;148573;1880;0;0;0;0;.00nan;0;0
5383;-1;747;92;30;1;29;.967;3600000;0
5383;-1;745;0;0;0;0;.00nan;0;0
5383;56565;745;94;45;2;43;.956;3600000;0
5383;76405;747;0;0;0;0;.00nan;0;0
5384;31165;752;49;36;5;31;.861;3600000;0
5384;207771;742;79;26;1;25;.962;3600000;0
5384;-1;742;0;0;0;0;.00nan;0;0
5384;52204;752;0;0;0;0;.00nan;0;0
5385;3756;744;59;29;3;26;.897;3600000;0
5385;193790;744;0;0;0;0;.00nan;0;0
5385;66993;741;0;0;0;0;.00nan;0;0
5385;82273;741;67;47;5;42;.894;3591000;0
5386;2643;743;54;20;3;17;.850;3564000;0
5386;198736;749;0;0;0;0;.00nan;0;0
5386;-1;743;0;0;0;0;.00nan;0;0
5386;85661;749;99;36;1;35;.972;3600000;0
5387;841;764;0;0;0;0;.00nan;0;0
5387;-1;764;65;36;4;32;.889;3600000;0
5387;-1;2168;0;0;0;0;.00nan;0;0
5387;49935;2168;42;39;7;32;.821;3600000;0
5388;195887;729;80;32;2;30;.938;3600000;0
5388;-1;739;0;0;0;0;.00nan;0;0
5388;85670;739;50;27;4;23;.852;3545000;0
5388;88646;729;0;0;0;0;.00nan;0;0
5389;595;732;91;29;2;27;.931;3600000;0
5389;199033;737;0;0;0;0;.00nan;0;0
5389;8504;737;66;37;3;34;.919;3556000;0
5389;8505;732;0;0;0;0;.00nan;0;0
5390;207184;734;0;0;0;0;.00nan;0;0
5390;202104;740;0;0;0;0;.00nan;0;0
5390;196698;740;73;31;2;29;.935;3568000;0
5390;44526;734;100;22;0;22;1.000;3600000;0
5391;165723;1880;66;30;4;26;.867;3550000;0
5391;85797;3789;100;43;2;41;.953;3600000;0
5391;91742;3789;0;0;0;0;.00nan;0;0
5391;148573;1880;0;0;0;0;.00nan;0;0
5392;178098;733;65;33;3;30;.909;3600000;0
5392;180177;736;0;0;0;0;.00nan;0;0
5392;66245;733;0;0;0;0;.00nan;0;0
5392;74734;736;23;28;6;22;.786;3600000;0
5393;-1;747;0;0;0;0;.00nan;0;0
5393;-1;745;0;0;0;0;.00nan;0;0
5393;56565;745;70;21;1;20;.952;3608000;0
5393;76405;747;94;37;2;35;.946;3608000;0
5394;3756;744;54;18;2;16;.889;3600000;0
5394;193790;744;0;0;0;0;.00nan;0;0
5394;31165;752;51;36;5;31;.861;3600000;0
5394;52204;752;0;0;0;0;.00nan;0;0
5395;2643;743;53;29;5;24;.828;3588000;0
5395;198736;749;0;0;0;0;.00nan;0;0
5395;-1;743;0;0;0;0;.00nan;0;0
5395;85661;749;53;31;4;27;.871;3600000;0
5396;2195;748;62;24;2;22;.917;3678000;0
5396;207771;742;75;33;3;30;.909;3678000;0
5396;-1;742;0;0;0;0;.00nan;0;0
5396;67287;748;0;0;0;0;.00nan;0;0
5397;-1;739;0;0;0;0;.00nan;0;0
5397;-1;2168;0;0;0;0;.00nan;0;0
5397;49935;2168;91;22;0;22;1.000;3600000;0
5397;85670;739;49;16;2;14;.875;3600000;0
5398;595;732;71;22;2;20;.909;3600000;0
5398;8505;732;0;0;0;0;.00nan;0;0
5398;195887;729;0;0;0;0;.00nan;0;0
5398;88646;729;91;33;1;32;.970;3600000;0
5399;1957;738;0;0;0;0;.00nan;0;0
5399;184158;738;35;30;5;25;.833;3600000;0
5399;207184;734;0;0;0;0;.00nan;0;0
5399;44526;734;93;37;2;35;.946;3600000;0
5400;178098;733;41;35;6;29;.829;2197000;0
5400;66245;733;66;12;0;12;1.000;1403000;0
5400;66993;741;75;30;3;27;.900;3600000;0
5400;82273;741;0;0;0;0;.00nan;0;0
5401;841;764;0;0;0;0;.00nan;0;0
5401;3359;751;0;0;0;0;.00nan;0;0
5401;-1;764;87;45;2;43;.956;3900000;0
5401;148788;751;78;26;2;24;.923;3900000;0
5402;199033;737;0;0;0;0;.00nan;0;0
5402;8504;737;88;29;1;28;.966;3600000;0
5402;202104;740;74;46;4;42;.913;3600000;0
5402;196698;740;0;0;0;0;.00nan;0;0
5403;180177;736;0;0;0;0;.00nan;0;0
5403;74734;736;85;35;2;33;.943;3600000;0
5403;85797;3789;0;0;0;0;.00nan;0;0
5403;91742;3789;62;30;3;27;.900;3596000;0
5404;2643;743;57;24;3;21;.875;3548000;0
5404;-1;747;0;0;0;0;.00nan;0;0
5404;-1;743;0;0;0;0;.00nan;0;0
5404;76405;747;63;21;2;19;.905;3600000;0
5405;165723;1880;91;42;4;38;.905;3900000;0
5405;66993;741;0;0;0;0;.00nan;0;0
5405;82273;741;75;39;4;35;.897;3900000;0
5405;148573;1880;0;0;0;0;.00nan;0;0
5406;2195;748;57;27;3;24;.889;3598000;0
5406;-1;739;0;0;0;0;.00nan;0;0
5406;67287;748;0;0;0;0;.00nan;0;0
5406;85670;739;87;31;1;30;.968;3600000;0
5407;199033;737;0;0;0;0;.00nan;0;0
5407;8504;737;96;20;0;20;1.000;3600000;0
5407;-1;2168;0;0;0;0;.00nan;0;0
5407;49935;2168;95;37;1;36;.973;3600000;0
5408;3359;751;68;26;2;24;.923;3600000;0
5408;207771;742;60;37;5;32;.865;3600000;0
5408;-1;742;0;0;0;0;.00nan;0;0
5408;148788;751;0;0;0;0;.00nan;0;0
5409;178098;733;0;0;0;0;.00nan;0;0
5409;31165;752;0;0;0;0;.00nan;0;0
5409;52204;752;69;20;2;18;.900;3600000;0
5409;66245;733;97;68;4;64;.941;3600000;0
5410;1957;738;0;0;0;0;.00nan;0;0
5410;184158;738;54;23;3;20;.870;3600000;0
5410;202104;740;50;47;6;41;.872;3600000;0
5410;196698;740;0;0;0;0;.00nan;0;0
5411;841;764;0;0;0;0;.00nan;0;0
5411;3756;744;57;22;3;19;.864;3600000;0
5411;193790;744;0;0;0;0;.00nan;0;0
5411;-1;764;68;52;5;47;.904;3562000;0
5412;165723;1880;91;48;4;44;.917;3534000;0
5412;85797;3789;0;0;0;0;.00nan;0;0
5412;91742;3789;84;31;2;29;.935;3600000;0
5412;148573;1880;0;0;0;0;.00nan;0;0
5413;2643;743;53;35;6;29;.829;3600000;0
5413;-1;747;0;0;0;0;.00nan;0;0
5413;-1;743;0;0;0;0;.00nan;0;0
5413;76405;747;69;23;2;21;.913;3600000;0
5414;207184;734;0;0;0;0;.00nan;0;0
5414;44526;734;80;47;4;43;.915;3561000;0
5414;66993;741;76;30;2;28;.933;3600000;0
5414;82273;741;0;0;0;0;.00nan;0;0
5415;-1;745;0;0;0;0;.00nan;0;0
5415;56565;745;100;36;0;36;1.000;3600000;0
5415;85281;749;0;0;0;0;.00nan;0;0
5415;85661;749;80;29;2;27;.931;3529000;0
5416;595;732;0;0;0;0;.00nan;0;0
5416;8505;732;62;21;2;19;.905;3600000;0
5416;180177;736;0;0;0;0;.00nan;0;0
5416;74734;736;71;45;5;40;.889;3600000;0
5417;2195;748;71;32;3;29;.906;3600000;0
5417;199033;737;0;0;0;0;.00nan;0;0
5417;8504;737;46;26;4;22;.846;3600000;0
5417;67287;748;0;0;0;0;.00nan;0;0
5418;207771;742;88;33;2;31;.939;3600000;0
5418;-1;742;0;0;0;0;.00nan;0;0
5418;-1;2168;0;0;0;0;.00nan;0;0
5418;49935;2168;59;31;4;27;.871;3565000;0
5419;1957;738;0;0;0;0;.00nan;0;0
5419;184158;738;100;44;2;42;.955;3600000;0
5419;31165;752;0;0;0;0;.00nan;0;0
5419;52204;752;79;43;4;39;.907;3561000;0
5420;3756;744;56;9;1;8;.889;3600000;0
5420;193790;744;0;0;0;0;.00nan;0;0
5420;178098;733;98;71;3;68;.958;3575000;0
5420;66245;733;0;0;0;0;.00nan;0;0
5421;207184;734;0;0;0;0;.00nan;0;0
5421;44526;734;87;38;2;36;.947;3600000;0
5421;85797;3789;0;0;0;0;.00nan;0;0
5421;91742;3789;61;39;4;35;.897;3535000;0
5422;3359;751;96;19;0;19;1.000;3600000;0
5422;-1;739;0;0;0;0;.00nan;0;0
5422;85670;739;53;36;5;31;.861;3600000;0
5422;148788;751;0;0;0;0;.00nan;0;0
5423;-1;745;0;0;0;0;.00nan;0;0
5423;56565;745;47;45;6;39;.867;3600000;0
5423;66993;741;49;11;2;9;.818;3600000;0
5423;82273;741;0;0;0;0;.00nan;0;0
5424;595;732;88;32;1;31;.969;3600000;0
5424;8505;732;0;0;0;0;.00nan;0;0
5424;195887;729;0;0;0;0;.00nan;0;0
5424;88646;729;72;30;3;27;.900;3567000;0
5425;202104;740;0;0;0;0;.00nan;0;0
5425;196698;740;83;47;4;43;.915;3600000;0
5425;85281;749;0;0;0;0;.00nan;0;0
5425;85661;749;64;24;3;21;.875;3600000;0
5426;165723;1880;67;20;2;18;.900;3600000;0
5426;180177;736;0;0;0;0;.00nan;0;0
5426;74734;736;83;40;3;37;.925;3600000;0
5426;148573;1880;0;0;0;0;.00nan;0;0
5427;841;764;0;0;0;0;.00nan;0;0
5427;-1;747;0;0;0;0;.00nan;0;0
5427;-1;764;90;31;1;30;.968;3600000;0
5427;76405;747;79;35;2;33;.943;3562000;0
5428;3756;744;84;24;1;23;.958;3600000;0
5428;193790;744;0;0;0;0;.00nan;0;0
5428;207771;742;0;0;0;0;.00nan;0;0
5428;-1;742;63;39;4;35;.897;3600000;0
5429;195887;729;0;0;0;0;.00nan;0;0
5429;-1;739;0;0;0;0;.00nan;0;0
5429;85670;739;91;22;0;22;1.000;3600000;0
5429;88646;729;80;34;2;32;.941;3600000;0
5430;-1;745;71;35;3;32;.914;3600000;0
5430;-1;2168;0;0;0;0;.00nan;0;0
5430;49935;2168;42;25;4;21;.840;3600000;0
5430;56565;745;0;0;0;0;.00nan;0;0
5431;595;732;94;48;2;46;.958;3600000;0
5431;3359;751;80;32;3;29;.906;3560000;0
5431;8505;732;0;0;0;0;.00nan;0;0
5431;148788;751;0;0;0;0;.00nan;0;0
5432;66993;741;22;13;4;9;.692;878000;0
5432;82273;741;67;17;1;16;.941;2703000;0
5432;85281;749;0;0;0;0;.00nan;0;0
5432;85661;749;71;49;4;45;.918;3600000;0
5433;165723;1880;61;21;2;19;.905;3600000;0
5433;180177;736;0;0;0;0;.00nan;0;0
5433;74734;736;57;46;7;39;.848;3600000;0
5433;148573;1880;0;0;0;0;.00nan;0;0
5434;2195;748;68;21;1;20;.952;3600000;0
5434;178098;733;96;51;3;48;.941;3581000;0
5434;66245;733;0;0;0;0;.00nan;0;0
5434;67287;748;0;0;0;0;.00nan;0;0
5435;199033;737;0;0;0;0;.00nan;0;0
5435;8504;737;82;40;3;37;.925;3648000;0
5435;85797;3789;0;0;0;0;.00nan;0;0
5435;91742;3789;43;21;4;17;.810;3648000;0
5436;1957;738;0;0;0;0;.00nan;0;0
5436;184158;738;96;25;0;25;1.000;3600000;0
5436;207184;734;0;0;0;0;.00nan;0;0
5436;44526;734;67;40;4;36;.900;3600000;0
5437;841;764;0;0;0;0;.00nan;0;0
5437;207771;742;84;27;1;26;.963;3900000;0
5437;-1;764;100;40;1;39;.975;3900000;0
5437;-1;742;0;0;0;0;.00nan;0;0
5438;3756;744;86;18;0;18;1.000;3600000;0
5438;193790;744;0;0;0;0;.00nan;0;0
5438;-1;747;0;0;0;0;.00nan;0;0
5438;76405;747;89;42;3;39;.929;3600000;0
5439;2643;743;89;41;1;40;.976;3600000;0
5439;3359;751;0;0;0;0;.00nan;0;0
5439;-1;743;0;0;0;0;.00nan;0;0
5439;148788;751;66;31;3;28;.903;3573000;0
5440;195887;729;0;0;0;0;.00nan;0;0
5440;31165;752;0;0;0;0;.00nan;0;0
5440;52204;752;58;21;2;19;.905;3535000;0
5440;88646;729;96;21;0;21;1.000;3600000;0
5441;2195;748;65;28;2;26;.929;3900000;0
5441;-1;745;0;0;0;0;.00nan;0;0
5441;56565;745;80;31;2;29;.935;3900000;0
5441;67287;748;0;0;0;0;.00nan;0;0
5442;165723;1880;100;38;0;38;1.000;3900000;0
5442;-1;2168;0;0;0;0;.00nan;0;0
5442;49935;2168;90;26;0;26;1.000;3900000;0
5442;148573;1880;0;0;0;0;.00nan;0;0
5443;595;732;44;30;5;25;.833;3543000;0
5443;8505;732;0;0;0;0;.00nan;0;0
5443;-1;747;0;0;0;0;.00nan;0;0
5443;76405;747;57;32;4;28;.875;3600000;0
5444;202104;740;91;42;1;41;.976;3555000;0
5444;196698;740;0;0;0;0;.00nan;0;0
5444;66993;741;0;0;0;0;.00nan;0;0
5444;82273;741;79;14;0;14;1.000;3600000;0
5445;199033;737;0;0;0;0;.00nan;0;0
5445;8504;737;63;19;1;18;.947;3600000;0
5445;178098;733;0;0;0;0;.00nan;0;0
5445;66245;733;89;71;3;68;.958;3583000;0
5446;2643;743;0;0;0;0;.00nan;0;0
5446;-1;743;99;42;2;40;.952;3600000;0
5446;85797;3789;0;0;0;0;.00nan;0;0
5446;91742;3789;51;26;4;22;.846;3566000;0
5447;1957;738;0;0;0;0;.00nan;0;0
5447;184158;738;66;25;3;22;.880;3760000;0
5447;31165;752;47;29;4;25;.862;3760000;0
5447;52204;752;0;0;0;0;.00nan;0;0
5448;-1;739;0;0;0;0;.00nan;0;0
5448;-1;745;0;0;0;0;.00nan;0;0
5448;56565;745;88;39;3;36;.923;3600000;0
5448;85670;739;73;26;1;25;.962;3600000;0
5449;207184;734;0;0;0;0;.00nan;0;0
5449;44526;734;64;38;5;33;.868;3600000;0
5449;-1;2168;0;0;0;0;.00nan;0;0
5449;49935;2168;100;31;0;31;1.000;3600000;0
5450;2195;748;89;45;3;42;.933;3550000;0
5450;207771;742;0;0;0;0;.00nan;0;0
5450;-1;742;77;30;2;28;.933;3600000;0
5450;67287;748;0;0;0;0;.00nan;0;0
5451;180177;736;0;0;0;0;.00nan;0;0
5451;74734;736;61;30;3;27;.900;3565000;0
5451;85281;749;0;0;0;0;.00nan;0;0
5451;85661;749;90;30;1;29;.967;3600000;0
5452;3359;751;100;37;1;36;.973;3900000;0
5452;3756;744;74;29;1;28;.966;3900000;0
5452;193790;744;0;0;0;0;.00nan;0;0
5452;148788;751;0;0;0;0;.00nan;0;0
5453;199033;737;0;0;0;0;.00nan;0;0
5453;8504;737;83;15;0;15;1.000;3900000;0
5453;202104;740;0;0;0;0;.00nan;0;0
5453;196698;740;98;58;0;58;1.000;3900000;0
5454;841;764;0;0;0;0;.00nan;0;0
5454;-1;764;74;27;2;25;.926;3900000;0
5454;66993;741;0;0;0;0;.00nan;0;0
5454;82273;741;78;30;2;28;.933;3900000;0
5455;2195;748;79;28;1;27;.964;3600000;0
5455;2643;743;66;44;5;39;.886;3600000;0
5455;-1;743;0;0;0;0;.00nan;0;0
5455;67287;748;0;0;0;0;.00nan;0;0
5456;195887;729;0;0;0;0;.00nan;0;0
5456;-1;745;0;0;0;0;.00nan;0;0
5456;56565;745;83;28;2;26;.929;3900000;0
5456;88646;729;75;23;2;21;.913;3900000;0
5457;-1;747;87;30;1;29;.967;3600000;0
5457;180177;736;0;0;0;0;.00nan;0;0
5457;74734;736;65;23;2;21;.913;3600000;0
5457;76405;747;0;0;0;0;.00nan;0;0
5458;595;732;82;27;1;26;.963;3600000;0
5458;8505;732;0;0;0;0;.00nan;0;0
5458;31165;752;65;41;4;37;.902;3600000;0
5458;52204;752;0;0;0;0;.00nan;0;0
5459;178098;733;96;38;1;37;.974;3575000;0
5459;-1;739;0;0;0;0;.00nan;0;0
5459;66245;733;0;0;0;0;.00nan;0;0
5459;85670;739;91;16;0;16;1.000;3600000;0
5460;85281;749;0;0;0;0;.00nan;0;0
5460;85661;749;94;51;4;47;.922;3600000;0
5460;85797;3789;100;27;0;27;1.000;3600000;0
5460;91742;3789;0;0;0;0;.00nan;0;0
5461;3756;744;61;21;2;19;.905;3600000;0
5461;193790;744;0;0;0;0;.00nan;0;0
5461;-1;2168;71;10;0;10;1.000;881000;0
5461;49935;2168;53;42;6;36;.857;2719000;0
5462;207184;734;0;0;0;0;.00nan;0;0
5462;202104;740;0;0;0;0;.00nan;0;0
5462;196698;740;50;29;4;25;.862;3597000;0
5462;44526;734;55;16;2;14;.875;3600000;0
5463;841;764;0;0;0;0;.00nan;0;0
5463;207771;742;99;37;1;36;.973;3600000;0
5463;-1;764;51;33;4;29;.879;3600000;0
5463;-1;742;0;0;0;0;.00nan;0;0
5464;2195;748;76;29;2;27;.931;3900000;0
5464;31165;752;0;0;0;0;.00nan;0;0
5464;52204;752;100;40;2;38;.950;3900000;0
5464;67287;748;0;0;0;0;.00nan;0;0
5465;-1;747;0;0;0;0;.00nan;0;0
5465;76405;747;49;53;8;45;.849;3600000;0
5465;85797;3789;80;25;2;23;.920;3600000;0
5465;91742;3789;0;0;0;0;.00nan;0;0
5466;3359;751;65;16;1;15;.938;3600000;0
5466;180177;736;72;22;1;21;.955;1844000;0
5466;74734;736;19;27;6;21;.778;1756000;0
5466;148788;751;0;0;0;0;.00nan;0;0
5467;178098;733;0;0;0;0;.00nan;0;0
5467;66245;733;100;56;3;53;.946;3600000;0
5467;85281;749;0;0;0;0;.00nan;0;0
5467;85661;749;58;28;4;24;.857;3588000;0
5468;1957;738;0;0;0;0;.00nan;0;0
5468;184158;738;10;31;9;22;.710;3600000;0
5468;-1;2168;0;0;0;0;.00nan;0;0
5468;49935;2168;87;23;1;22;.957;3600000;0
5469;2643;743;70;30;2;28;.933;3600000;0
5469;-1;743;0;0;0;0;.00nan;0;0
5469;-1;745;0;0;0;0;.00nan;0;0
5469;56565;745;67;40;4;36;.900;3532000;0
5470;199033;737;0;0;0;0;.00nan;0;0
5470;8504;737;82;26;1;25;.962;3600000;0
5470;195887;729;0;0;0;0;.00nan;0;0
5470;88646;729;72;41;3;38;.927;3590000;0
5471;595;732;0;0;0;0;.00nan;0;0
5471;3756;744;90;30;1;29;.967;3600000;0
5471;8505;732;43;36;6;30;.833;3600000;0
5471;193790;744;0;0;0;0;.00nan;0;0
5472;207184;734;0;0;0;0;.00nan;0;0
5472;44526;734;93;42;2;40;.952;3841000;0
5472;66993;741;52;21;3;18;.857;3841000;0
5472;82273;741;0;0;0;0;.00nan;0;0
5473;165723;1880;53;19;2;17;.895;3600000;0
5473;202104;740;84;42;3;39;.929;3596000;0
5473;196698;740;0;0;0;0;.00nan;0;0
5473;148573;1880;0;0;0;0;.00nan;0;0
5474;841;764;74;27;2;25;.926;3600000;0
5474;207771;742;80;39;4;35;.897;3520000;0
5474;-1;764;0;0;0;0;.00nan;0;0
5474;-1;742;0;0;0;0;.00nan;0;0
5475;178098;733;52;33;5;28;.848;3600000;0
5475;-1;747;0;0;0;0;.00nan;0;0
5475;66245;733;0;0;0;0;.00nan;0;0
5475;76405;747;70;23;1;22;.957;3600000;0
5476;3359;751;0;0;0;0;.00nan;0;0
5476;85797;3789;59;31;4;27;.871;3731000;0
5476;91742;3789;0;0;0;0;.00nan;0;0
5476;148788;751;57;31;5;26;.839;3731000;0
5477;31165;752;65;25;2;23;.920;3557000;0
5477;-1;739;0;0;0;0;.00nan;0;0
5477;52204;752;0;0;0;0;.00nan;0;0
5477;85670;739;85;31;1;30;.968;3600000;0
5478;1957;738;0;0;0;0;.00nan;0;0
5478;2195;748;0;0;0;0;.00nan;0;0
5478;184158;738;36;29;5;24;.828;3600000;0
5478;67287;748;79;22;2;20;.909;3600000;0
5479;595;732;93;33;2;31;.939;3894000;0
5479;8505;732;0;0;0;0;.00nan;0;0
5479;-1;2168;0;0;0;0;.00nan;0;0
5479;49935;2168;90;35;2;33;.943;3900000;0
5480;3756;744;99;21;0;21;1.000;3600000;0
5480;193790;744;0;0;0;0;.00nan;0;0
5480;195887;729;0;0;0;0;.00nan;0;0
5480;88646;729;77;40;3;37;.925;3600000;0
5481;207771;742;97;31;1;30;.968;3900000;0
5481;-1;742;0;0;0;0;.00nan;0;0
5481;-1;745;0;0;0;0;.00nan;0;0
5481;56565;745;97;30;1;29;.967;3900000;0
5482;2643;743;64;34;3;31;.912;3544000;0
5482;-1;743;0;0;0;0;.00nan;0;0
5482;66993;741;84;36;2;34;.944;3600000;0
5482;82273;741;0;0;0;0;.00nan;0;0
5483;841;764;0;0;0;0;.00nan;0;0
5483;207184;734;0;0;0;0;.00nan;0;0
5483;44526;734;60;33;4;29;.879;3540000;0
5483;-1;764;84;29;2;27;.931;3600000;0
5484;-1;745;0;0;0;0;.00nan;0;0
5484;56565;745;89;22;0;22;1.000;3600000;0
5484;85281;749;0;0;0;0;.00nan;0;0
5484;85661;749;91;31;1;30;.968;3590000;0
5485;3359;751;70;23;2;21;.913;3600000;0
5485;178098;733;0;0;0;0;.00nan;0;0
5485;66245;733;68;40;5;35;.875;3600000;0
5485;148788;751;0;0;0;0;.00nan;0;0
5486;165723;1880;77;27;2;25;.926;3600000;0
5486;-1;739;0;0;0;0;.00nan;0;0
5486;85670;739;69;20;1;19;.950;3600000;0
5486;148573;1880;0;0;0;0;.00nan;0;0
5487;595;732;97;32;1;31;.969;3600000;0
5487;2195;748;100;36;0;36;1.000;3600000;0
5487;8505;732;0;0;0;0;.00nan;0;0
5487;67287;748;0;0;0;0;.00nan;0;0
5488;1957;738;0;0;0;0;.00nan;0;0
5488;184158;738;99;46;2;44;.957;3600000;0
5488;195887;729;0;0;0;0;.00nan;0;0
5488;88646;729;88;43;3;40;.930;3599000;0
5489;207771;742;0;0;0;0;.00nan;0;0
5489;-1;742;69;31;3;28;.903;3900000;0
5489;-1;2168;0;0;0;0;.00nan;0;0
5489;49935;2168;82;40;3;37;.925;3900000;0
5490;-1;747;0;0;0;0;.00nan;0;0
5490;31165;752;0;0;0;0;.00nan;0;0
5490;52204;752;73;43;4;39;.907;3900000;0
5490;76405;747;79;38;4;34;.895;3900000;0
5491;2643;743;62;25;3;22;.880;3558000;0
5491;202104;740;0;0;0;0;.00nan;0;0
5491;196698;740;99;36;1;35;.972;3600000;0
5491;-1;743;0;0;0;0;.00nan;0;0
5492;165723;1880;0;0;0;0;.00nan;0;0
5492;-1;739;0;0;0;0;.00nan;0;0
5492;85670;739;97;24;0;24;1.000;3600000;0
5492;148573;1880;81;37;3;34;.919;3600000;0
5493;180177;736;100;41;0;41;1.000;3600000;0
5493;66993;741;98;43;1;42;.977;3552000;0
5493;74734;736;0;0;0;0;.00nan;0;0
5493;82273;741;0;0;0;0;.00nan;0;0
5494;3756;744;68;24;2;22;.917;3600000;0
5494;193790;744;0;0;0;0;.00nan;0;0
5494;207184;734;0;0;0;0;.00nan;0;0
5494;44526;734;68;40;4;36;.900;3577000;0
5495;841;764;0;0;0;0;.00nan;0;0
5495;-1;764;32;29;5;24;.828;3555000;0
5495;85281;749;0;0;0;0;.00nan;0;0
5495;85661;749;60;24;3;21;.875;3600000;0
5496;595;732;82;32;2;30;.938;3530000;0
5496;8505;732;0;0;0;0;.00nan;0;0
5496;207184;734;100;31;0;31;1.000;3600000;0
5496;44526;734;0;0;0;0;.00nan;0;0
5497;195887;729;0;0;0;0;.00nan;0;0
5497;-1;745;0;0;0;0;.00nan;0;0
5497;56565;745;100;26;0;26;1.000;3600000;0
5497;88646;729;86;32;2;30;.938;3600000;0
5498;1957;738;0;0;0;0;.00nan;0;0
5498;199033;737;0;0;0;0;.00nan;0;0
5498;8504;737;100;24;0;24;1.000;3600000;0
5498;184158;738;65;43;5;38;.884;3600000;0
5499;3359;751;0;0;0;0;.00nan;0;0
5499;66993;741;0;0;0;0;.00nan;0;0
5499;82273;741;69;30;3;27;.900;3600000;0
5499;148788;751;55;38;5;33;.868;3543000;0
5500;2643;743;74;33;3;30;.909;3600000;0
5500;31165;752;65;38;4;34;.895;3548000;0
5500;-1;743;0;0;0;0;.00nan;0;0
5500;52204;752;0;0;0;0;.00nan;0;0
5501;2195;748;73;22;1;21;.955;3900000;0
5501;202104;740;0;0;0;0;.00nan;0;0
5501;196698;740;86;38;1;37;.974;3900000;0
5501;67287;748;0;0;0;0;.00nan;0;0
5502;165723;1880;72;29;3;26;.897;3562000;0
5502;-1;747;0;0;0;0;.00nan;0;0
5502;76405;747;68;25;2;23;.920;3600000;0
5502;148573;1880;0;0;0;0;.00nan;0;0
5503;180177;736;87;63;5;58;.921;3600000;0
5503;74734;736;0;0;0;0;.00nan;0;0
5503;85797;3789;94;21;0;21;1.000;3600000;0
5503;91742;3789;0;0;0;0;.00nan;0;0
5504;3756;744;82;25;1;24;.960;3600000;0
5504;193790;744;0;0;0;0;.00nan;0;0
5504;-1;2168;0;0;0;0;.00nan;0;0
5504;49935;2168;90;51;2;49;.961;3544000;0
5505;841;764;0;0;0;0;.00nan;0;0
5505;-1;764;77;23;1;22;.957;3600000;0
5505;85281;749;0;0;0;0;.00nan;0;0
5505;85661;749;81;34;2;32;.941;3600000;0
5506;2643;743;73;34;3;31;.912;3900000;0
5506;-1;743;0;0;0;0;.00nan;0;0
5506;-1;2168;0;0;0;0;.00nan;0;0
5506;49935;2168;77;38;3;35;.921;3900000;0
5507;199033;737;0;0;0;0;.00nan;0;0
5507;8504;737;100;27;0;27;1.000;3600000;0
5507;-1;739;0;0;0;0;.00nan;0;0
5507;85670;739;87;33;3;30;.909;3600000;0
5508;1957;738;0;0;0;0;.00nan;0;0
5508;184158;738;64;43;4;39;.907;3600000;0
5508;207771;742;95;23;0;23;1.000;3600000;0
5508;-1;742;0;0;0;0;.00nan;0;0
5509;3359;751;55;23;3;20;.870;3532000;0
5509;31165;752;0;0;0;0;.00nan;0;0
5509;52204;752;77;23;1;22;.957;3600000;0
5509;148788;751;0;0;0;0;.00nan;0;0
5510;2195;748;48;28;4;24;.857;3596000;0
5510;165723;1880;77;33;3;30;.909;3600000;0
5510;67287;748;0;0;0;0;.00nan;0;0
5510;148573;1880;0;0;0;0;.00nan;0;0
5511;595;732;74;25;2;23;.920;3900000;0
5511;8505;732;0;0;0;0;.00nan;0;0
5511;180177;736;0;0;0;0;.00nan;0;0
5511;74734;736;91;42;2;40;.952;3900000;0
5512;178098;733;78;39;3;36;.923;3598000;0
5512;202104;740;0;0;0;0;.00nan;0;0
5512;196698;740;69;27;2;25;.926;3600000;0
5512;66245;733;0;0;0;0;.00nan;0;0
5513;3756;744;73;27;2;25;.926;3900000;0
5513;193790;744;0;0;0;0;.00nan;0;0
5513;66993;741;76;31;2;29;.935;3900000;0
5513;82273;741;0;0;0;0;.00nan;0;0
5514;-1;745;0;0;0;0;.00nan;0;0
5514;56565;745;94;60;3;57;.950;3722000;0
5514;85797;3789;67;26;2;24;.923;3722000;0
5514;91742;3789;0;0;0;0;.00nan;0;0
5515;195887;729;0;0;0;0;.00nan;0;0
5515;207184;734;52;23;3;20;.870;3612000;0
5515;44526;734;0;0;0;0;.00nan;0;0
5515;88646;729;94;49;4;45;.918;3612000;0
5516;1957;738;77;37;3;34;.919;3600000;0
5516;2195;748;58;31;4;27;.871;3547000;0
5516;184158;738;0;0;0;0;.00nan;0;0
5516;67287;748;0;0;0;0;.00nan;0;0
5517;199033;747;33;33;6;27;.818;2391000;0
5517;8504;737;61;21;3;18;.857;3600000;0
5517;-1;747;56;12;1;11;.917;1209000;0
5517;76405;737;0;0;0;0;.00nan;0;0
5518;195887;729;0;0;0;0;.00nan;0;0
5518;207184;734;0;0;0;0;.00nan;0;0
5518;44526;734;78;43;3;40;.930;3567000;0
5518;88646;729;43;11;2;9;.818;3600000;0
5519;31165;752;69;33;3;30;.909;2600000;0
5519;52204;752;29;17;4;13;.765;1000000;0
5519;66993;741;60;30;4;26;.867;3600000;0
5519;82273;741;0;0;0;0;.00nan;0;0
5520;180177;736;0;0;0;0;.00nan;0;0
5520;202104;740;60;23;3;20;.870;3534000;0
5520;196698;740;0;0;0;0;.00nan;0;0
5520;74734;736;70;28;2;26;.929;3600000;0
5521;178098;733;69;67;7;60;.896;3600000;0
5521;-1;739;0;0;0;0;.00nan;0;0
5521;66245;733;0;0;0;0;.00nan;0;0
5521;85670;739;71;21;1;20;.952;3600000;0
5522;3359;751;0;0;0;0;.00nan;0;0
5522;3756;744;0;0;0;0;.00nan;0;0
5522;193790;744;75;35;2;33;.943;3900000;0
5522;148788;751;100;55;2;53;.964;3900000;0
5523;2643;743;51;24;3;21;.875;3600000;0
5523;-1;743;0;0;0;0;.00nan;0;0
5523;-1;2168;0;0;0;0;.00nan;0;0
5523;49935;2168;61;40;4;36;.900;3556000;0
5524;841;764;0;0;0;0;.00nan;0;0
5524;-1;764;99;46;3;43;.935;3600000;0
5524;85797;3789;0;0;0;0;.00nan;0;0
5524;91742;3789;39;22;4;18;.818;3552000;0
5525;165723;1880;97;34;1;33;.971;3600000;0
5525;31165;752;92;23;0;23;1.000;3600000;0
5525;52204;752;0;0;0;0;.00nan;0;0
5525;148573;1880;0;0;0;0;.00nan;0;0
5526;207184;734;0;0;0;0;.00nan;0;0
5526;44526;734;85;38;2;36;.947;3600000;0
5526;-1;739;0;0;0;0;.00nan;0;0
5526;85670;739;50;21;3;18;.857;3560000;0
5527;3359;751;44;17;3;14;.824;3600000;0
5527;207771;742;62;32;4;28;.875;3578000;0
5527;-1;742;0;0;0;0;.00nan;0;0
5527;148788;751;0;0;0;0;.00nan;0;0
5528;595;732;64;25;2;23;.920;3600000;0
5528;8505;732;0;0;0;0;.00nan;0;0
5528;178098;733;0;0;0;0;.00nan;0;0
5528;66245;733;87;40;3;37;.925;3600000;0
5529;8504;737;0;0;0;0;.00nan;0;0
5529;76405;737;68;19;1;18;.947;3600000;0
5529;85281;749;0;0;0;0;.00nan;0;0
5529;85661;749;70;28;2;26;.929;3565000;0
5530;2195;748;89;41;3;38;.927;3556000;0
5530;67287;748;0;0;0;0;.00nan;0;0
5530;85797;3789;74;23;2;21;.913;3600000;0
5530;91742;3789;0;0;0;0;.00nan;0;0
5531;1957;738;0;0;0;0;.00nan;0;0
5531;165723;1880;56;27;5;22;.815;3900000;0
5531;184158;738;32;33;5;28;.848;3900000;0
5531;148573;1880;0;0;0;0;.00nan;0;0
5532;3756;744;39;28;6;22;.786;3600000;0
5532;199033;747;48;7;1;6;.857;569000;0
5532;193790;744;0;0;0;0;.00nan;0;0
5532;-1;747;58;41;6;35;.854;2978000;0
5533;2643;743;90;39;2;37;.949;3600000;0
5533;-1;743;0;0;0;0;.00nan;0;0
5533;-1;745;0;0;0;0;.00nan;0;0
5533;56565;745;59;28;3;25;.893;3583000;0
5534;180177;736;0;0;0;0;.00nan;0;0
5534;66993;741;70;15;1;14;.933;3600000;0
5534;74734;736;98;59;4;55;.932;3600000;0
5534;82273;741;0;0;0;0;.00nan;0;0
5535;841;764;0;0;0;0;.00nan;0;0
5535;202104;740;75;46;4;42;.913;3900000;0
5535;196698;740;0;0;0;0;.00nan;0;0
5535;-1;764;60;33;4;29;.879;3900000;0
5536;33044;2168;0;0;0;0;.00nan;0;0
5536;207184;734;0;0;0;0;.00nan;0;0
5536;44526;734;50;34;5;29;.853;3600000;0
5536;49935;2168;68;25;1;24;.960;3600000;0
5537;1957;738;63;29;3;26;.897;3515000;0
5537;165723;1880;71;24;1;23;.958;3600000;0
5537;184158;738;0;0;0;0;.00nan;0;0
5537;148573;1880;0;0;0;0;.00nan;0;0
5538;3756;744;60;21;2;19;.905;3600000;0
5538;199033;747;77;48;4;44;.917;3580000;0
5538;193790;744;0;0;0;0;.00nan;0;0
5538;-1;747;0;0;0;0;.00nan;0;0
5539;3359;751;0;0;0;0;.00nan;0;0
5539;8504;737;0;0;0;0;.00nan;0;0
5539;76405;737;60;31;3;28;.903;3627000;0
5539;148788;751;57;31;4;27;.871;3627000;0
5540;178098;733;42;39;6;33;.846;3600000;0
5540;195887;729;0;0;0;0;.00nan;0;0
5540;66245;733;0;0;0;0;.00nan;0;0
5540;88646;729;59;20;2;18;.900;3600000;0
5541;595;732;88;24;1;23;.958;3600000;0
5541;8505;732;0;0;0;0;.00nan;0;0
5541;85281;749;65;46;5;41;.891;3600000;0
5541;85661;749;0;0;0;0;.00nan;0;0
5542;180177;736;0;0;0;0;.00nan;0;0
5542;-1;745;0;0;0;0;.00nan;0;0
5542;56565;745;55;28;3;25;.893;3625000;0
5542;74734;736;77;43;4;39;.907;3625000;0
5543;2643;743;68;45;6;39;.867;3600000;0
5543;207771;742;0;0;0;0;.00nan;0;0
5543;-1;742;72;30;3;27;.900;3600000;0
5543;-1;743;0;0;0;0;.00nan;0;0
5544;202104;740;73;30;2;28;.933;3600000;0
5544;196698;740;0;0;0;0;.00nan;0;0
5544;66993;741;80;22;1;21;.955;3600000;0
5544;82273;741;0;0;0;0;.00nan;0;0
5545;2195;748;0;0;0;0;.00nan;0;0
5545;207184;734;0;0;0;0;.00nan;0;0
5545;44526;734;56;37;5;32;.865;3544000;0
5545;67287;748;67;30;4;26;.867;3600000;0
5546;195887;729;0;0;0;0;.00nan;0;0
5546;33044;2168;0;0;0;0;.00nan;0;0
5546;49935;2168;80;31;2;29;.935;3900000;0
5546;88646;729;87;30;2;28;.933;3900000;0
5547;1957;738;0;0;0;0;.00nan;0;0
5547;184158;738;66;27;3;24;.889;3600000;0
5547;-1;739;0;0;0;0;.00nan;0;0
5547;85670;739;66;39;4;35;.897;3594000;0
5548;595;732;73;25;2;23;.920;3600000;0
5548;199033;747;0;0;0;0;.00nan;0;0
5548;8505;732;0;0;0;0;.00nan;0;0
5548;-1;747;78;41;3;38;.927;3548000;0
5549;8504;737;0;0;0;0;.00nan;0;0
5549;31165;752;96;50;2;48;.960;3900000;0
5549;52204;752;0;0;0;0;.00nan;0;0
5549;76405;737;47;11;2;9;.818;3900000;0
5550;3756;744;100;25;0;25;1.000;3600000;0
5550;198736;749;85;32;1;31;.969;3582000;0
5550;193790;744;0;0;0;0;.00nan;0;0
5550;93324;749;0;0;0;0;.00nan;0;0
5551;66993;741;76;32;3;29;.906;3600000;0
5551;82273;741;0;0;0;0;.00nan;0;0
5551;85797;3789;52;36;6;30;.833;3600000;0
5551;91742;3789;0;0;0;0;.00nan;0;0
5552;178098;733;0;0;0;0;.00nan;0;0
5552;165723;1880;44;27;5;22;.815;3522000;0
5552;66245;733;100;44;3;41;.932;3600000;0
5552;148573;1880;0;0;0;0;.00nan;0;0
5553;2195;748;80;25;1;24;.960;3600000;0
5553;195887;729;0;0;0;0;.00nan;0;0
5553;67287;748;0;0;0;0;.00nan;0;0
5553;88646;729;43;20;3;17;.850;3548000;0
5554;2643;743;85;28;1;27;.964;3600000;0
5554;202104;740;0;0;0;0;.00nan;0;0
5554;196698;740;85;34;2;32;.941;3582000;0
5554;-1;743;0;0;0;0;.00nan;0;0
5555;1957;738;0;0;0;0;.00nan;0;0
5555;184158;738;68;40;4;36;.900;3900000;0
5555;207771;742;0;0;0;0;.00nan;0;0
5555;-1;742;51;28;4;24;.857;3900000;0
5556;595;732;67;43;4;39;.907;3537000;0
5556;3359;751;64;26;2;24;.923;3600000;0
5556;8505;732;0;0;0;0;.00nan;0;0
5556;148788;751;0;0;0;0;.00nan;0;0
5557;178098;733;54;34;5;29;.853;2345000;0
5557;165723;1880;0;0;0;0;.00nan;0;0
5557;66245;733;58;7;0;7;1.000;1255000;0
5557;148573;1880;90;18;0;18;1.000;3600000;0
5558;180177;736;0;0;0;0;.00nan;0;0
5558;-1;739;0;0;0;0;.00nan;0;0
5558;74734;736;94;40;2;38;.950;3600000;0
5558;85670;739;60;30;3;27;.900;3571000;0
5559;841;764;0;0;0;0;.00nan;0;0
5559;31165;752;0;0;0;0;.00nan;0;0
5559;-1;764;48;22;3;19;.864;3550000;0
5559;52204;752;88;29;1;28;.966;3600000;0
5560;3756;744;87;44;3;41;.932;3511000;0
5560;198736;749;0;0;0;0;.00nan;0;0
5560;193790;744;0;0;0;0;.00nan;0;0
5560;93324;749;84;33;1;32;.970;3600000;0
5561;199033;747;48;7;1;6;.857;755000;0
5561;-1;747;55;39;6;33;.846;2845000;0
5561;85797;3789;0;0;0;0;.00nan;0;0
5561;91742;3789;97;22;0;22;1.000;3600000;0
5562;2643;743;70;39;3;36;.923;3596000;0
5562;-1;739;0;0;0;0;.00nan;0;0
5562;-1;743;0;0;0;0;.00nan;0;0
5562;85670;739;71;27;2;25;.926;3600000;0
5563;195887;729;54;22;3;19;.864;3600000;0
5563;202104;740;58;39;5;34;.872;3535000;0
5563;196698;740;0;0;0;0;.00nan;0;0
5563;88646;729;0;0;0;0;.00nan;0;0
5564;1957;738;0;0;0;0;.00nan;0;0
5564;178098;733;0;0;0;0;.00nan;0;0
5564;184158;738;51;19;3;16;.842;3600000;0
5564;66245;733;100;40;0;40;1.000;3600000;0
5565;8504;737;0;0;0;0;.00nan;0;0
5565;207184;734;0;0;0;0;.00nan;0;0
5565;44526;734;87;56;5;51;.911;3558000;0
5565;76405;737;60;20;3;17;.850;3600000;0
5566;3359;751;0;0;0;0;.00nan;0;0
5566;207771;742;78;36;3;33;.917;3600000;0
5566;-1;742;0;0;0;0;.00nan;0;0
5566;148788;751;76;28;2;26;.929;3600000;0
5567;165723;1880;0;0;0;0;.00nan;0;0
5567;-1;745;0;0;0;0;.00nan;0;0
5567;56565;745;42;29;5;24;.828;3600000;0
5567;148573;1880;93;38;2;36;.947;3600000;0
5568;31165;752;0;0;0;0;.00nan;0;0
5568;180177;736;0;0;0;0;.00nan;0;0
5568;52204;752;74;30;3;27;.900;3536000;0
5568;74734;736;84;31;2;29;.935;3600000;0
5569;841;764;0;0;0;0;.00nan;0;0
5569;33044;2168;0;0;0;0;.00nan;0;0
5569;-1;764;66;41;5;36;.878;3600000;0
5569;49935;2168;100;40;0;40;1.000;3600000;0
5570;2195;748;45;17;3;14;.824;3900000;0
5570;67287;748;0;0;0;0;.00nan;0;0
5570;85281;749;0;0;0;0;.00nan;0;0
5570;85661;749;74;40;3;37;.925;3900000;0
5571;199033;747;0;0;0;0;.00nan;0;0
5571;-1;747;94;37;2;35;.946;3600000;0
5571;66993;741;71;35;4;31;.886;3581000;0
5571;82273;741;0;0;0;0;.00nan;0;0
5572;2643;743;65;17;1;16;.941;3600000;0
5572;31165;752;39;42;6;36;.857;3264000;0
5572;-1;743;0;0;0;0;.00nan;0;0
5572;52204;752;48;0;0;0;.00nan;336000;0
5573;178098;733;0;0;0;0;.00nan;0;0
5573;195887;729;0;0;0;0;.00nan;0;0
5573;66245;733;86;35;1;34;.971;3549000;0
5573;88646;729;89;15;0;15;1.000;3600000;0
5574;3359;751;62;29;3;26;.897;3600000;0
5574;207184;734;0;0;0;0;.00nan;0;0
5574;44526;734;62;33;4;29;.879;3560000;0
5574;148788;751;0;0;0;0;.00nan;0;0
5575;8504;737;0;0;0;0;.00nan;0;0
5575;202104;740;0;0;0;0;.00nan;0;0
5575;196698;740;79;42;3;39;.929;3600000;0
5575;76405;737;97;20;0;20;1.000;3600000;0
5576;33044;2168;0;0;0;0;.00nan;0;0
5576;207771;742;0;0;0;0;.00nan;0;0
5576;-1;742;50;24;4;20;.833;3761000;0
5576;49935;2168;51;33;5;28;.848;3761000;0
5577;595;732;94;29;1;28;.966;3646000;0
5577;8505;732;0;0;0;0;.00nan;0;0
5577;-1;739;0;0;0;0;.00nan;0;0
5577;85670;739;85;34;2;32;.941;3669000;0
5578;165723;1880;100;31;0;31;1.000;3600000;0
5578;85797;3789;0;0;0;0;.00nan;0;0
5578;91742;3789;68;37;3;34;.919;3600000;0
5578;148573;1880;0;0;0;0;.00nan;0;0
5579;180177;736;0;0;0;0;.00nan;0;0
5579;-1;745;0;0;0;0;.00nan;0;0
5579;56565;745;44;22;4;18;.818;3590000;0
5579;74734;736;99;49;2;47;.959;3600000;0
5580;841;764;79;42;3;39;.929;3600000;0
5580;3756;744;38;20;4;16;.800;3569000;0
5580;193790;744;0;0;0;0;.00nan;0;0
5580;-1;764;0;0;0;0;.00nan;0;0
5581;178098;733;95;63;6;57;.905;3600000;0
5581;195887;729;0;0;0;0;.00nan;0;0
5581;66245;733;0;0;0;0;.00nan;0;0
5581;88646;729;64;15;1;14;.933;3600000;0
5582;199033;747;0;0;0;0;.00nan;0;0
5582;-1;747;73;23;2;21;.913;3748000;0
5582;85281;749;0;0;0;0;.00nan;0;0
5582;85661;749;99;41;1;40;.976;3748000;0
5583;2195;748;48;14;2;12;.857;3600000;0
5583;66993;741;34;36;6;30;.833;3600000;0
5583;67287;748;0;0;0;0;.00nan;0;0
5583;82273;741;0;0;0;0;.00nan;0;0
5584;1957;738;0;0;0;0;.00nan;0;0
5584;184158;738;78;30;2;28;.933;3555000;0
5584;-1;745;0;0;0;0;.00nan;0;0
5584;56565;745;100;33;0;33;1.000;3600000;0
5585;3359;751;0;0;0;0;.00nan;0;0
5585;207771;742;79;28;1;27;.964;3600000;0
5585;-1;742;0;0;0;0;.00nan;0;0
5585;148788;751;73;38;4;34;.895;3600000;0
5586;595;732;67;31;3;28;.903;3600000;0
5586;8505;732;0;0;0;0;.00nan;0;0
5586;33044;2168;0;0;0;0;.00nan;0;0
5586;49935;2168;66;44;6;38;.864;3600000;0
5587;202104;740;74;54;6;48;.889;3217000;0
5587;196698;740;45;5;1;4;.800;383000;0
5587;85797;3789;54;24;3;21;.875;3600000;0
5587;91742;3789;0;0;0;0;.00nan;0;0
5588;2643;743;66;31;3;28;.903;3578000;0
5588;-1;739;0;0;0;0;.00nan;0;0
5588;-1;743;0;0;0;0;.00nan;0;0
5588;85670;739;68;21;1;20;.952;3600000;0
5589;199033;747;0;0;0;0;.00nan;0;0
5589;-1;747;97;45;1;44;.978;3900000;0
5589;85281;749;0;0;0;0;.00nan;0;0
5589;85661;749;75;18;1;17;.944;3900000;0
5590;8504;737;0;0;0;0;.00nan;0;0
5590;180177;736;0;0;0;0;.00nan;0;0
5590;74734;736;100;50;0;50;1.000;3600000;0
5590;76405;737;70;19;1;18;.947;3559000;0
5591;31165;752;56;25;3;22;.880;3600000;0
5591;52204;752;0;0;0;0;.00nan;0;0
5591;66993;741;57;39;5;34;.872;3593000;0
5591;82273;741;0;0;0;0;.00nan;0;0
5592;841;764;0;0;0;0;.00nan;0;0
5592;2195;748;33;18;4;14;.778;2292000;0
5592;-1;764;50;25;4;21;.840;3900000;0
5592;67287;748;70;14;0;14;1.000;1608000;0
5593;195887;729;0;0;0;0;.00nan;0;0
5593;85797;3789;63;29;3;26;.897;3600000;0
5593;88646;729;89;45;4;41;.911;3588000;0
5593;91742;3789;0;0;0;0;.00nan;0;0
5594;3359;751;68;23;2;21;.913;3900000;0
5594;165723;1880;97;34;2;32;.941;3900000;0
5594;148573;1880;0;0;0;0;.00nan;0;0
5594;148788;751;0;0;0;0;.00nan;0;0
5595;1957;738;0;0;0;0;.00nan;0;0
5595;3756;744;64;25;2;23;.920;3546000;0
5595;193790;744;0;0;0;0;.00nan;0;0
5595;184158;738;95;22;0;22;1.000;3600000;0
5596;33044;2168;0;0;0;0;.00nan;0;0
5596;49935;2168;70;37;3;34;.919;3900000;0
5596;66993;741;76;33;3;30;.909;3900000;0
5596;82273;741;0;0;0;0;.00nan;0;0
5597;595;732;99;39;1;38;.974;3600000;0
5597;8505;732;0;0;0;0;.00nan;0;0
5597;-1;739;0;0;0;0;.00nan;0;0
5597;85670;739;81;30;2;28;.933;3573000;0
5598;2643;743;91;38;2;36;.947;3600000;0
5598;207184;734;0;0;0;0;.00nan;0;0
5598;44526;734;65;26;3;23;.885;3544000;0
5598;-1;743;0;0;0;0;.00nan;0;0
5599;8504;737;0;0;0;0;.00nan;0;0
5599;-1;745;0;0;0;0;.00nan;0;0
5599;56565;745;68;36;4;32;.889;3852000;0
5599;76405;737;74;35;3;32;.914;3852000;0
5600;841;764;0;0;0;0;.00nan;0;0
5600;207771;742;75;37;4;33;.892;3751000;0
5600;-1;764;54;25;3;22;.880;3751000;0
5600;-1;742;0;0;0;0;.00nan;0;0
5601;2195;748;75;19;1;18;.947;3600000;0
5601;31165;752;0;0;0;0;.00nan;0;0
5601;52204;752;60;22;2;20;.909;3582000;0
5601;67287;748;0;0;0;0;.00nan;0;0
5602;180177;736;0;0;0;0;.00nan;0;0
5602;202104;740;0;0;0;0;.00nan;0;0
5602;196698;740;69;36;4;32;.889;3587000;0
5602;74734;736;59;21;2;19;.905;3600000;0
5603;1957;738;0;0;0;0;.00nan;0;0
5603;184158;738;69;31;3;28;.903;3533000;0
5603;85797;3789;0;0;0;0;.00nan;0;0
5603;91742;3789;71;18;1;17;.944;3600000;0
5604;199033;747;0;0;0;0;.00nan;0;0
5604;-1;747;59;22;2;20;.909;3580000;0
5604;195887;729;0;0;0;0;.00nan;0;0
5604;88646;729;99;33;1;32;.970;3600000;0
5605;165723;1880;63;22;2;20;.909;3600000;0
5605;85281;749;51;3;0;3;1.000;336000;0
5605;85661;749;50;43;6;37;.860;3264000;0
5605;148573;1880;0;0;0;0;.00nan;0;0
5606;180177;736;0;0;0;0;.00nan;0;0
5606;207771;742;0;0;0;0;.00nan;0;0
5606;-1;742;91;19;0;19;1.000;3600000;0
5606;74734;736;98;41;1;40;.976;3575000;0
5607;3359;751;0;0;0;0;.00nan;0;0
5607;66993;741;91;43;2;41;.953;3600000;0
5607;82273;741;0;0;0;0;.00nan;0;0
5607;148788;751;52;22;3;19;.864;3538000;0
5608;841;764;0;0;0;0;.00nan;0;0
5608;31165;752;84;16;0;16;1.000;3600000;0
5608;-1;764;55;33;4;29;.879;3600000;0
5608;52204;752;0;0;0;0;.00nan;0;0
5609;595;732;91;33;1;32;.970;3600000;0
5609;8505;732;0;0;0;0;.00nan;0;0
5609;202104;740;73;38;3;35;.921;3600000;0
5609;196698;740;0;0;0;0;.00nan;0;0
5610;178098;733;0;0;0;0;.00nan;0;0
5610;-1;743;0;0;0;0;.00nan;0;0
5610;66245;733;71;48;5;43;.896;3600000;0
5610;93324;743;92;32;1;31;.969;3600000;0
5611;3756;744;76;28;2;26;.929;3900000;0
5611;193790;744;0;0;0;0;.00nan;0;0
5611;-1;745;0;0;0;0;.00nan;0;0
5611;56565;745;76;33;2;31;.939;3900000;0
5612;1957;738;55;43;6;37;.860;3154000;0
5612;184158;738;54;5;0;5;1.000;446000;0
5612;-1;739;0;0;0;0;.00nan;0;0
5612;85670;739;96;18;0;18;1.000;3600000;0
5613;199033;747;0;0;0;0;.00nan;0;0
5613;165723;1880;89;31;1;30;.968;3600000;0
5613;-1;747;65;43;4;39;.907;3600000;0
5613;148573;1880;0;0;0;0;.00nan;0;0
5614;195887;729;0;0;0;0;.00nan;0;0
5614;85281;749;0;0;0;0;.00nan;0;0
5614;85661;749;97;43;2;41;.953;3548000;0
5614;88646;729;96;26;0;26;1.000;3600000;0
5615;178098;733;0;0;0;0;.00nan;0;0
5615;33044;2168;0;0;0;0;.00nan;0;0
5615;49935;2168;43;24;4;20;.833;3600000;0
5615;66245;733;52;40;6;34;.850;3527000;0
5616;8504;737;43;4;1;3;.750;1373000;0
5616;76405;737;32;27;6;21;.778;2227000;0
5616;85797;3789;0;0;0;0;.00nan;0;0
5616;91742;3789;70;35;3;32;.914;3600000;0
5617;3359;751;97;42;2;40;.952;3578000;0
5617;207184;734;0;0;0;0;.00nan;0;0
5617;44526;734;86;32;1;31;.969;3600000;0
5617;148788;751;0;0;0;0;.00nan;0;0
5618;595;732;76;37;3;34;.919;3598000;0
5618;841;764;75;33;2;31;.939;3600000;0
5618;8505;732;0;0;0;0;.00nan;0;0
5618;-1;764;0;0;0;0;.00nan;0;0
5619;3756;744;61;13;1;12;.923;3600000;0
5619;193790;744;0;0;0;0;.00nan;0;0
5619;180177;736;0;0;0;0;.00nan;0;0
5619;74734;736;98;38;2;36;.947;3590000;0
5620;-1;743;0;0;0;0;.00nan;0;0
5620;-1;745;0;0;0;0;.00nan;0;0
5620;56565;745;65;34;3;31;.912;3567000;0
5620;93324;743;72;31;2;29;.935;3600000;0
5621;199033;747;0;0;0;0;.00nan;0;0
5621;-1;747;68;25;3;22;.880;3600000;0
5621;85281;749;0;0;0;0;.00nan;0;0
5621;85661;749;83;50;4;46;.920;3600000;0
5622;207771;742;0;0;0;0;.00nan;0;0
5622;-1;742;52;33;5;28;.848;3592000;0
5622;66993;741;64;32;3;29;.906;3600000;0
5622;82273;741;0;0;0;0;.00nan;0;0
5623;3359;751;0;0;0;0;.00nan;0;0
5623;195887;729;0;0;0;0;.00nan;0;0
5623;88646;729;51;29;4;25;.862;3600000;0
5623;148788;751;97;36;1;35;.972;3600000;0
5624;202104;740;53;25;3;22;.880;2675000;0
5624;196698;740;18;9;4;5;.556;925000;0
5624;-1;739;0;0;0;0;.00nan;0;0
5624;85670;739;51;22;3;19;.864;3600000;0
5625;2195;748;0;0;0;0;.00nan;0;0
5625;178098;733;0;0;0;0;.00nan;0;0
5625;66245;733;81;42;4;38;.905;3900000;0
5625;67287;748;53;26;4;22;.846;3900000;0
5626;1957;738;41;11;2;9;.818;1202000;0
5626;184158;738;35;39;6;33;.846;2398000;0
5626;85797;3789;0;0;0;0;.00nan;0;0
5626;91742;3789;100;27;0;27;1.000;3600000;0
5627;595;732;60;46;6;40;.870;3600000;0
5627;8504;737;0;0;0;0;.00nan;0;0
5627;8505;732;0;0;0;0;.00nan;0;0
5627;76405;737;88;29;1;28;.966;3600000;0
5628;3756;744;16;18;6;12;.667;2060000;0
5628;193790;744;67;14;0;14;1.000;1540000;0
5628;-1;743;0;0;0;0;.00nan;0;0
5628;93324;743;73;31;3;28;.903;3600000;0
5629;33044;2168;0;0;0;0;.00nan;0;0
5629;207771;742;73;24;2;22;.917;3600000;0
5629;-1;742;0;0;0;0;.00nan;0;0
5629;49935;2168;71;39;5;34;.872;3600000;0
5630;180177;736;0;0;0;0;.00nan;0;0
5630;207184;734;0;0;0;0;.00nan;0;0
5630;44526;734;80;25;3;22;.880;3600000;0
5630;74734;736;43;35;6;29;.829;3600000;0
5631;3359;751;75;32;3;29;.906;3900000;0
5631;85281;749;0;0;0;0;.00nan;0;0
5631;85661;749;64;28;3;25;.893;3900000;0
5631;148788;751;0;0;0;0;.00nan;0;0
5632;31165;752;82;30;2;28;.933;3600000;0
5632;-1;745;0;0;0;0;.00nan;0;0
5632;52204;752;0;0;0;0;.00nan;0;0
5632;56565;745;74;44;4;40;.909;3561000;0
5633;2195;748;83;28;1;27;.964;3900000;0
5633;66993;741;91;34;1;33;.971;3900000;0
5633;67287;748;0;0;0;0;.00nan;0;0
5633;82273;741;0;0;0;0;.00nan;0;0
5634;1957;738;0;0;0;0;.00nan;0;0
5634;199033;747;0;0;0;0;.00nan;0;0
5634;-1;747;7;31;8;23;.742;3600000;0
5634;184158;738;66;34;3;31;.912;3600000;0
5635;178098;733;0;0;0;0;.00nan;0;0
5635;202104;740;66;36;3;33;.917;3900000;0
5635;196698;740;0;0;0;0;.00nan;0;0
5635;66245;733;68;30;3;27;.900;3900000;0
5636;8504;737;0;0;0;0;.00nan;0;0
5636;165723;1880;88;33;2;31;.939;3600000;0
5636;76405;737;74;21;1;20;.952;3600000;0
5636;148573;1880;0;0;0;0;.00nan;0;0
5637;841;764;0;0;0;0;.00nan;0;0
5637;-1;739;0;0;0;0;.00nan;0;0
5637;-1;764;100;35;1;34;.971;3900000;0
5637;85670;739;91;30;1;29;.967;3900000;0
5638;3756;744;66;21;2;19;.905;3600000;0
5638;193790;744;0;0;0;0;.00nan;0;0
5638;207184;734;52;7;1;6;.857;281000;0
5638;44526;734;62;50;7;43;.860;3319000;0
5639;3359;751;0;0;0;0;.00nan;0;0
5639;-1;745;0;0;0;0;.00nan;0;0
5639;56565;745;80;45;4;41;.911;3600000;0
5639;148788;751;89;27;1;26;.963;3600000;0
5640;31165;752;89;29;1;28;.966;3900000;0
5640;180177;736;0;0;0;0;.00nan;0;0
5640;52204;752;0;0;0;0;.00nan;0;0
5640;74734;736;93;32;1;31;.969;3900000;0
5641;-1;743;77;42;4;38;.905;3579000;0
5641;66993;741;65;31;3;28;.903;3600000;0
5641;82273;741;0;0;0;0;.00nan;0;0
5641;93324;743;0;0;0;0;.00nan;0;0
5642;195887;729;0;0;0;0;.00nan;0;0
5642;33044;2168;0;0;0;0;.00nan;0;0
5642;49935;2168;80;32;2;30;.938;3900000;0
5642;88646;729;61;24;2;22;.917;3900000;0
5643;202104;740;0;0;0;0;.00nan;0;0
5643;196698;740;75;39;4;35;.897;3600000;0
5643;207771;742;65;13;1;12;.923;3600000;0
5643;-1;742;0;0;0;0;.00nan;0;0
5644;595;732;0;0;0;0;.00nan;0;0
5644;8505;732;58;42;5;37;.881;3600000;0
5644;-1;739;40;25;4;21;.840;2444000;0
5644;85670;739;26;12;4;8;.667;1156000;0
5645;8504;737;0;0;0;0;.00nan;0;0
5645;165723;1880;54;19;3;16;.842;3600000;0
5645;76405;737;79;35;2;33;.943;3600000;0
5645;148573;1880;0;0;0;0;.00nan;0;0
5646;841;764;0;0;0;0;.00nan;0;0
5646;-1;764;87;58;5;53;.914;3600000;0
5646;85797;3789;0;0;0;0;.00nan;0;0
5646;91742;3789;64;22;2;20;.909;3600000;0
5647;1957;738;0;0;0;0;.00nan;0;0
5647;184158;738;51;21;4;17;.810;3570000;0
5647;85281;749;0;0;0;0;.00nan;0;0
5647;85661;749;93;42;3;39;.929;3600000;0
5648;2195;748;52;25;3;22;.880;3572000;0
5648;199033;747;0;0;0;0;.00nan;0;0
5648;-1;747;90;39;2;37;.949;3600000;0
5648;67287;748;0;0;0;0;.00nan;0;0
5649;2195;748;0;0;0;0;.00nan;0;0
5649;33044;2168;0;0;0;0;.00nan;0;0
5649;49935;2168;62;30;4;26;.867;3600000;0
5649;67287;748;53;32;5;27;.844;3581000;0
5650;195887;729;0;0;0;0;.00nan;0;0
5650;-1;743;0;0;0;0;.00nan;0;0
5650;88646;729;69;32;3;29;.906;3600000;0
5650;93324;743;55;32;4;28;.875;3542000;0
5651;165723;1880;78;32;3;29;.906;3600000;0
5651;207184;734;52;4;0;4;1.000;443000;0
5651;44526;734;39;37;6;31;.838;3157000;0
5651;148573;1880;0;0;0;0;.00nan;0;0
5652;595;732;48;24;4;20;.833;3553000;0
5652;8505;732;0;0;0;0;.00nan;0;0
5652;-1;745;0;0;0;0;.00nan;0;0
5652;56565;745;69;34;3;31;.912;3600000;0
5653;207771;742;68;46;5;41;.891;3600000;0
5653;-1;742;0;0;0;0;.00nan;0;0
5653;85797;3789;0;0;0;0;.00nan;0;0
5653;91742;3789;72;25;2;23;.920;3600000;0
5654;1957;738;0;0;0;0;.00nan;0;0
5654;3359;751;0;0;0;0;.00nan;0;0
5654;184158;738;56;46;6;40;.870;3600000;0
5654;148788;751;82;26;1;25;.962;3600000;0
5655;180177;736;90;34;1;33;.971;3600000;0
5655;-1;739;0;0;0;0;.00nan;0;0
5655;74734;736;0;0;0;0;.00nan;0;0
5655;85670;739;85;40;2;38;.950;3600000;0
5656;178098;733;86;60;5;55;.917;3600000;0
5656;31165;752;82;12;0;12;1.000;3600000;0
5656;52204;752;0;0;0;0;.00nan;0;0
5656;66245;733;0;0;0;0;.00nan;0;0
5657;3756;744;75;8;0;8;1.000;3600000;0
5657;193790;744;0;0;0;0;.00nan;0;0
5657;202104;740;65;51;5;46;.902;3600000;0
5657;196698;740;0;0;0;0;.00nan;0;0
5658;2643;747;94;34;1;33;.971;3600000;0
5658;199033;747;0;0;0;0;.00nan;0;0
5658;85281;749;0;0;0;0;.00nan;0;0
5658;85661;749;57;25;3;22;.880;3555000;0
5659;195887;729;0;0;0;0;.00nan;0;0
5659;-1;739;0;0;0;0;.00nan;0;0
5659;85670;739;66;23;2;21;.913;3879000;0
5659;88646;729;75;40;3;37;.925;3879000;0
5660;-1;745;0;0;0;0;.00nan;0;0
5660;56565;745;54;25;3;22;.880;3600000;0
5660;66993;741;75;22;2;20;.909;3600000;0
5660;82273;741;0;0;0;0;.00nan;0;0
5661;8504;737;0;0;0;0;.00nan;0;0
5661;-1;743;80;29;1;28;.966;3600000;0
5661;76405;737;100;27;0;27;1.000;3600000;0
5661;93324;743;0;0;0;0;.00nan;0;0
5662;595;732;78;33;3;30;.909;3900000;0
5662;8505;732;0;0;0;0;.00nan;0;0
5662;207771;742;80;36;3;33;.917;3900000;0
5662;-1;742;0;0;0;0;.00nan;0;0
5663;3359;751;94;40;2;38;.950;3600000;0
5663;33044;2168;0;0;0;0;.00nan;0;0
5663;49935;2168;63;42;6;36;.857;3600000;0
5663;148788;751;0;0;0;0;.00nan;0;0
5664;165723;1880;63;24;3;21;.875;3900000;0
5664;180177;736;0;0;0;0;.00nan;0;0
5664;74734;736;100;37;3;34;.919;3900000;0
5664;148573;1880;0;0;0;0;.00nan;0;0
5665;841;764;0;0;0;0;.00nan;0;0
5665;202104;740;0;0;0;0;.00nan;0;0
5665;196698;740;75;39;4;35;.897;3600000;0
5665;-1;764;51;23;3;20;.870;3600000;0
5666;178098;733;74;43;4;39;.907;3557000;0
5666;66245;733;0;0;0;0;.00nan;0;0
5666;85797;3789;0;0;0;0;.00nan;0;0
5666;91742;3789;46;22;4;18;.818;3600000;0
5667;2643;747;48;28;4;24;.857;3600000;0
5667;199033;747;0;0;0;0;.00nan;0;0
5667;85281;749;100;31;0;31;1.000;3600000;0
5667;85661;749;0;0;0;0;.00nan;0;0
5668;3756;744;62;15;1;14;.933;3600000;0
5668;193790;744;0;0;0;0;.00nan;0;0
5668;31165;752;72;45;6;39;.867;3600000;0
5668;52204;752;0;0;0;0;.00nan;0;0
5669;2195;748;0;0;0;0;.00nan;0;0
5669;-1;743;0;0;0;0;.00nan;0;0
5669;67287;748;100;38;0;38;1.000;3600000;0
5669;93324;743;65;26;2;24;.923;3562000;0
5670;1957;738;49;19;3;16;.842;3600000;0
5670;178098;733;67;39;5;34;.872;3558000;0
5670;184158;738;0;0;0;0;.00nan;0;0
5670;66245;733;0;0;0;0;.00nan;0;0
5671;-1;739;96;62;2;60;.968;3900000;0
5671;85670;739;0;0;0;0;.00nan;0;0
5671;85797;3789;0;0;0;0;.00nan;0;0
5671;91742;3789;68;23;2;21;.913;3900000;0
5672;3359;751;0;0;0;0;.00nan;0;0
5672;-1;745;0;0;0;0;.00nan;0;0
5672;56565;745;73;38;4;34;.895;3600000;0
5672;148788;751;100;24;0;24;1.000;3600000;0
5673;8504;737;0;0;0;0;.00nan;0;0
5673;195887;729;61;8;0;8;1.000;547000;0
5673;76405;737;66;34;3;31;.912;3600000;0
5673;88646;729;63;35;5;30;.857;2997000;0
5674;595;732;69;23;2;21;.913;3600000;0
5674;8505;732;0;0;0;0;.00nan;0;0
5674;180177;736;0;0;0;0;.00nan;0;0
5674;74734;736;96;56;5;51;.911;3600000;0
5675;31165;752;60;32;4;28;.875;3550000;0
5675;33044;2168;0;0;0;0;.00nan;0;0
5675;49935;2168;74;30;2;28;.933;3600000;0
5675;52204;752;0;0;0;0;.00nan;0;0
5676;165723;1880;93;33;1;32;.970;3600000;0
5676;174898;1880;0;0;0;0;.00nan;0;0
5676;202104;740;0;0;0;0;.00nan;0;0
5676;196698;740;53;39;6;33;.846;3600000;0
5677;841;764;0;0;0;0;.00nan;0;0
5677;3756;744;76;20;1;19;.950;3600000;0
5677;193790;744;0;0;0;0;.00nan;0;0
5677;-1;764;75;39;4;35;.897;3600000;0
5678;2643;747;72;29;2;27;.931;3600000;0
5678;199033;747;0;0;0;0;.00nan;0;0
5678;85281;749;67;31;3;28;.903;3556000;0
5678;85661;749;0;0;0;0;.00nan;0;0
5679;2195;748;0;0;0;0;.00nan;0;0
5679;165723;1880;58;32;3;29;.906;3844000;0
5679;174898;1880;0;0;0;0;.00nan;0;0
5679;67287;748;73;45;4;41;.911;3844000;0
5680;595;732;88;35;2;33;.943;3595000;0
5680;8505;732;0;0;0;0;.00nan;0;0
5680;195887;729;0;0;0;0;.00nan;0;0
5680;88646;729;100;35;0;35;1.000;3600000;0
5681;841;764;0;0;0;0;.00nan;0;0
5681;-1;739;0;0;0;0;.00nan;0;0
5681;-1;764;98;55;4;51;.927;3600000;0
5681;85670;739;60;25;2;23;.920;3600000;0
5682;3359;751;0;0;0;0;.00nan;0;0
5682;-1;745;0;0;0;0;.00nan;0;0
5682;56565;745;54;22;3;19;.864;3522000;0
5682;148788;751;78;26;1;25;.962;3600000;0
5683;8504;737;0;0;0;0;.00nan;0;0
5683;178098;733;100;40;1;39;.975;3600000;0
5683;66245;733;0;0;0;0;.00nan;0;0
5683;76405;737;59;14;2;12;.857;3557000;0
5684;33044;2168;0;0;0;0;.00nan;0;0
5684;49935;2168;90;26;1;25;.962;3600000;0
5684;66993;741;0;0;0;0;.00nan;0;0
5684;82273;741;80;32;3;29;.906;3600000;0
5685;202104;740;100;45;1;44;.978;3900000;0
5685;196698;740;0;0;0;0;.00nan;0;0
5685;85797;3789;0;0;0;0;.00nan;0;0
5685;91742;3789;81;24;1;23;.958;3900000;0
5686;3756;744;63;19;2;17;.895;3600000;0
5686;193790;744;0;0;0;0;.00nan;0;0
5686;-1;743;0;0;0;0;.00nan;0;0
5686;93324;743;61;49;6;43;.878;3600000;0
5687;841;764;69;30;4;26;.867;3547000;0
5687;207184;734;0;0;0;0;.00nan;0;0
5687;44526;734;74;28;2;26;.929;3600000;0
5687;-1;764;0;0;0;0;.00nan;0;0
5688;2643;747;90;49;4;45;.918;3600000;0
5688;199033;747;0;0;0;0;.00nan;0;0
5688;207771;742;39;38;7;31;.816;3600000;0
5688;-1;742;0;0;0;0;.00nan;0;0
5689;31165;752;56;25;3;22;.880;3542000;0
5689;52204;752;0;0;0;0;.00nan;0;0
5689;85281;749;0;0;0;0;.00nan;0;0
5689;85661;749;81;31;2;29;.935;3600000;0
5690;1957;738;0;0;0;0;.00nan;0;0
5690;184158;738;97;46;3;43;.935;3900000;0
5690;180177;736;0;0;0;0;.00nan;0;0
5690;74734;736;87;44;3;41;.932;3900000;0
5691;165723;1880;52;31;4;27;.871;3512000;0
5691;174898;1880;0;0;0;0;.00nan;0;0
5691;33044;2168;0;0;0;0;.00nan;0;0
5691;49935;2168;60;24;2;22;.917;3600000;0
5692;8504;737;56;4;0;4;1.000;259000;0
5692;76405;737;40;34;6;28;.824;3341000;0
5692;85797;3789;0;0;0;0;.00nan;0;0
5692;91742;3789;69;33;3;30;.909;3600000;0
5693;595;732;75;25;1;24;.960;3600000;0
5693;8505;732;0;0;0;0;.00nan;0;0
5693;202104;740;0;0;0;0;.00nan;0;0
5693;196698;740;98;49;2;47;.959;3551000;0
5694;-1;739;0;0;0;0;.00nan;0;0
5694;56565;741;0;0;0;0;.00nan;0;0
5694;66993;741;75;36;3;33;.917;3600000;0
5694;85670;739;49;27;4;23;.852;3543000;0
5695;3359;751;75;33;3;30;.909;3600000;0
5695;-1;743;0;0;0;0;.00nan;0;0
5695;93324;743;65;39;4;35;.897;3543000;0
5695;148788;751;0;0;0;0;.00nan;0;0
5696;2195;748;79;22;1;21;.955;3600000;0
5696;207771;742;72;34;3;31;.912;3574000;0
5696;-1;742;0;0;0;0;.00nan;0;0
5696;67287;748;0;0;0;0;.00nan;0;0
5697;195887;729;0;0;0;0;.00nan;0;0
5697;85281;749;0;0;0;0;.00nan;0;0
5697;85661;749;98;42;1;41;.976;3900000;0
5697;88646;729;74;23;1;22;.957;3900000;0
5698;3756;744;67;26;2;24;.923;3551000;0
5698;193790;744;0;0;0;0;.00nan;0;0
5698;206313;745;0;0;0;0;.00nan;0;0
5698;-1;745;93;29;1;28;.966;3600000;0
5699;180177;736;70;34;3;31;.912;2630000;0
5699;207184;734;0;0;0;0;.00nan;0;0
5699;44526;734;53;33;5;28;.848;3600000;0
5699;74734;736;20;9;4;5;.556;913000;0
5700;1957;738;0;0;0;0;.00nan;0;0
5700;178098;733;25;26;6;20;.769;3148000;0
5700;184158;738;59;28;4;24;.857;3600000;0
5700;66245;733;51;2;0;2;1.000;393000;0
5701;31165;752;50;35;6;29;.829;2604000;0
5701;52204;752;64;10;0;10;1.000;973000;0
5701;85797;3789;0;0;0;0;.00nan;0;0
5701;91742;3789;59;29;4;25;.862;3600000;0
5702;202104;740;40;45;7;38;.844;3600000;0
5702;196698;740;0;0;0;0;.00nan;0;0
5702;-1;739;0;0;0;0;.00nan;0;0
5702;85670;739;100;24;0;24;1.000;3600000;0
5703;2643;747;0;0;0;0;.00nan;0;0
5703;199033;747;100;29;0;29;1.000;3600000;0
5703;56565;741;45;32;5;27;.844;3600000;0
5703;66993;741;0;0;0;0;.00nan;0;0
5704;841;764;0;0;0;0;.00nan;0;0
5704;202839;729;0;0;0;0;.00nan;0;0
5704;-1;764;66;21;2;19;.905;3545000;0
5704;88646;729;89;34;1;33;.971;3600000;0
5705;1957;738;35;18;4;14;.778;1735000;0
5705;3756;744;60;18;2;16;.889;3600000;0
5705;193790;744;0;0;0;0;.00nan;0;0
5705;184158;738;64;15;1;14;.933;1865000;0
5706;8504;737;0;0;0;0;.00nan;0;0
5706;207184;734;47;37;5;32;.865;3600000;0
5706;44526;734;0;0;0;0;.00nan;0;0
5706;76405;737;91;20;0;20;1.000;3600000;0
5707;206313;745;85;29;2;27;.931;3600000;0
5707;207771;742;66;41;4;37;.902;3549000;0
5707;-1;742;0;0;0;0;.00nan;0;0
5707;-1;745;0;0;0;0;.00nan;0;0
5708;595;732;80;24;1;23;.958;3600000;0
5708;8505;732;0;0;0;0;.00nan;0;0
5708;180177;736;0;0;0;0;.00nan;0;0
5708;74734;736;57;40;5;35;.875;3600000;0
5709;2195;748;53;26;4;22;.846;3799000;0
5709;3359;751;64;44;5;39;.886;3799000;0
5709;67287;748;0;0;0;0;.00nan;0;0
5709;148788;751;0;0;0;0;.00nan;0;0
5710;165723;1880;66;27;3;24;.889;3900000;0
5710;174898;1880;0;0;0;0;.00nan;0;0
5710;85281;749;0;0;0;0;.00nan;0;0
5710;85661;749;86;40;3;37;.925;3900000;0
5711;202104;740;0;0;0;0;.00nan;0;0
5711;196698;740;77;48;4;44;.917;3600000;0
5711;85797;3789;0;0;0;0;.00nan;0;0
5711;91742;3789;80;21;1;20;.952;3600000;0
5712;2643;747;85;33;1;32;.970;3600000;0
5712;199033;747;0;0;0;0;.00nan;0;0
5712;56565;741;70;29;2;27;.931;3575000;0
5712;82273;741;0;0;0;0;.00nan;0;0
5713;207771;742;48;49;7;42;.857;3600000;0
5713;-1;742;0;0;0;0;.00nan;0;0
5713;-1;743;74;26;1;25;.962;3600000;0
5713;93324;743;0;0;0;0;.00nan;0;0
5714;2195;748;0;0;0;0;.00nan;0;0
5714;33044;2168;0;0;0;0;.00nan;0;0
5714;49935;2168;100;27;0;27;1.000;3600000;0
5714;67287;748;60;24;3;21;.875;3600000;0
5715;207184;734;0;0;0;0;.00nan;0;0
5715;44526;734;88;44;4;40;.909;3600000;0
5715;202839;729;0;0;0;0;.00nan;0;0
5715;88646;729;87;23;1;22;.957;3600000;0
5716;1957;738;0;0;0;0;.00nan;0;0
5716;184158;738;65;21;2;19;.905;3600000;0
5716;180177;736;0;0;0;0;.00nan;0;0
5716;74734;736;55;26;3;23;.885;3557000;0
5717;206313;745;75;27;2;25;.926;3600000;0
5717;-1;739;0;0;0;0;.00nan;0;0
5717;-1;745;0;0;0;0;.00nan;0;0
5717;85670;739;68;24;1;23;.958;3600000;0
5718;595;732;80;44;3;41;.932;3548000;0
5718;8504;737;0;0;0;0;.00nan;0;0
5718;8505;732;0;0;0;0;.00nan;0;0
5718;76405;737;90;29;1;28;.966;3600000;0
5719;841;764;0;0;0;0;.00nan;0;0
5719;3359;751;0;0;0;0;.00nan;0;0
5719;-1;764;67;44;5;39;.886;3600000;0
5719;148788;751;26;28;6;22;.786;3561000;0
5720;165723;1880;77;24;1;23;.958;3600000;0
5720;31165;752;22;10;4;6;.600;1163000;0
5720;52204;752;59;21;2;19;.905;2437000;0
5720;66993;1880;0;0;0;0;.00nan;0;0
5721;3756;744;51;14;2;12;.857;3600000;0
5721;193790;744;0;0;0;0;.00nan;0;0
5721;178098;733;89;55;3;52;.945;3600000;0
5721;66245;733;0;0;0;0;.00nan;0;0
5722;56565;741;74;29;2;27;.931;3600000;0
5722;82273;741;0;0;0;0;.00nan;0;0
5722;85281;749;0;0;0;0;.00nan;0;0
5722;85661;749;60;37;5;32;.865;3600000;0
5723;195887;743;88;55;5;50;.909;3600000;0
5723;31165;752;70;31;2;29;.935;3600000;0
5723;52204;752;0;0;0;0;.00nan;0;0
5723;93324;743;0;0;0;0;.00nan;0;0
5724;841;764;0;0;0;0;.00nan;0;0
5724;174898;764;80;37;2;35;.946;3600000;0
5724;33044;2168;0;0;0;0;.00nan;0;0
5724;49935;2168;43;26;5;21;.808;3600000;0
5725;207771;729;64;43;5;38;.884;3600000;0
5725;202839;729;0;0;0;0;.00nan;0;0
5725;85797;3789;0;0;0;0;.00nan;0;0
5725;91742;3789;81;25;1;24;.960;3600000;0
5726;2195;748;0;0;0;0;.00nan;0;0
5726;206313;745;59;45;5;40;.889;3600000;0
5726;-1;745;0;0;0;0;.00nan;0;0
5726;67287;748;68;24;2;22;.917;3600000;0
5727;8504;737;0;0;0;0;.00nan;0;0
5727;-1;739;0;0;0;0;.00nan;0;0
5727;76405;737;93;41;3;38;.927;3900000;0
5727;85670;739;73;36;3;33;.917;3900000;0
5728;207184;734;0;0;0;0;.00nan;0;0
5728;44526;734;76;40;3;37;.925;3588000;0
5728;-1;742;0;0;0;0;.00nan;0;0
5728;88646;742;94;27;1;26;.963;3600000;0
5729;3756;744;60;13;1;12;.923;3600000;0
5729;193790;744;0;0;0;0;.00nan;0;0
5729;202104;740;63;48;5;43;.896;3600000;0
5729;196698;740;0;0;0;0;.00nan;0;0
5730;1957;738;0;0;0;0;.00nan;0;0
5730;165723;1880;0;0;0;0;.00nan;0;0
5730;184158;738;91;53;3;50;.943;3600000;0
5730;66993;1880;89;19;0;19;1.000;3600000;0
5731;178098;733;63;21;1;20;.952;2895000;0
5731;180177;736;0;0;0;0;.00nan;0;0
5731;66245;733;14;7;4;3;.429;705000;0
5731;74734;736;96;20;0;20;1.000;3600000;0
5732;56565;741;24;12;4;8;.667;1154000;0
5732;82273;741;47;16;2;14;.875;2446000;0
5732;85281;749;0;0;0;0;.00nan;0;0
5732;85661;749;79;39;4;35;.897;3600000;0
5733;2195;748;51;19;3;16;.842;3600000;0
5733;31165;752;65;35;4;31;.886;3600000;0
5733;52204;752;0;0;0;0;.00nan;0;0
5733;67287;748;0;0;0;0;.00nan;0;0
5734;2643;747;45;21;3;18;.857;3570000;0
5734;199033;747;0;0;0;0;.00nan;0;0
5734;207771;729;0;0;0;0;.00nan;0;0
5734;202839;729;76;25;2;23;.920;3600000;0
5735;33044;2168;0;0;0;0;.00nan;0;0
5735;49935;2168;100;35;0;35;1.000;3600000;0
5735;67294;737;0;0;0;0;.00nan;0;0
5735;76405;737;64;28;2;26;.929;3574000;0
5736;3359;751;53;27;4;23;.852;3573000;0
5736;85281;749;0;0;0;0;.00nan;0;0
5736;85661;749;91;38;2;36;.947;3600000;0
5736;148788;751;0;0;0;0;.00nan;0;0
5737;193790;740;0;0;0;0;.00nan;0;0
5737;178098;733;53;32;5;27;.844;3600000;0
5737;207184;740;60;28;3;25;.893;3600000;0
5737;66245;733;0;0;0;0;.00nan;0;0
5738;165723;1880;0;0;0;0;.00nan;0;0
5738;-1;742;0;0;0;0;.00nan;0;0
5738;66993;1880;67;33;4;29;.879;3600000;0
5738;88646;742;53;36;5;31;.861;3572000;0
5739;841;764;0;0;0;0;.00nan;0;0
5739;3756;744;46;30;5;25;.833;3538000;0
5739;174898;764;76;34;3;31;.912;3600000;0
5739;196698;744;0;0;0;0;.00nan;0;0
5740;595;732;87;29;2;27;.931;3582000;0
5740;8505;732;0;0;0;0;.00nan;0;0
5740;44526;734;99;41;1;40;.976;3600000;0
5740;-1;734;0;0;0;0;.00nan;0;0
5741;206313;745;52;10;1;9;.900;1529000;0
5741;202104;745;27;29;6;23;.793;2071000;0
5741;56565;741;87;40;2;38;.950;3600000;0
5741;82273;741;0;0;0;0;.00nan;0;0
5742;195887;743;0;0;0;0;.00nan;0;0
5742;85281;749;0;0;0;0;.00nan;0;0
5742;85661;749;40;26;5;21;.808;3600000;0
5742;93324;743;99;55;1;54;.982;3600000;0
5743;178098;733;0;0;0;0;.00nan;0;0
5743;207771;729;0;0;0;0;.00nan;0;0
5743;202839;729;69;17;1;16;.941;3600000;0
5743;66245;733;57;46;6;40;.870;3600000;0
5744;180177;736;0;0;0;0;.00nan;0;0
5744;74734;736;89;42;3;39;.929;3600000;0
5744;85797;3789;0;0;0;0;.00nan;0;0
5744;91742;3789;57;20;2;18;.900;3600000;0
5745;1957;738;0;0;0;0;.00nan;0;0
5745;2643;747;54;29;4;25;.862;3600000;0
5745;199033;747;0;0;0;0;.00nan;0;0
5745;184158;738;100;28;0;28;1.000;3600000;0
5746;-1;742;0;0;0;0;.00nan;0;0
5746;56565;741;92;41;3;38;.927;3551000;0
5746;82273;741;0;0;0;0;.00nan;0;0
5746;88646;742;100;34;2;32;.941;3600000;0
5747;3359;751;0;0;0;0;.00nan;0;0
5747;31165;752;63;48;6;42;.875;3600000;0
5747;52204;752;0;0;0;0;.00nan;0;0
5747;148788;751;83;37;3;34;.919;3600000;0
5748;193790;740;81;53;4;49;.925;3600000;0
5748;207184;740;0;0;0;0;.00nan;0;0
5748;67294;737;0;0;0;0;.00nan;0;0
5748;76405;737;64;16;1;15;.938;3600000;0
5749;3756;744;17;24;6;18;.750;2823000;0
5749;165723;1880;0;0;0;0;.00nan;0;0
5749;196698;744;55;4;0;4;1.000;777000;0
5749;66993;1880;100;26;0;26;1.000;3600000;0
5750;841;764;0;0;0;0;.00nan;0;0
5750;174898;764;48;20;3;17;.850;3600000;0
5750;33044;2168;0;0;0;0;.00nan;0;0
5750;49935;2168;94;21;0;21;1.000;3600000;0
5751;2195;748;0;0;0;0;.00nan;0;0
5751;206313;745;51;37;5;32;.865;3532000;0
5751;202104;745;0;0;0;0;.00nan;0;0
5751;67287;748;75;32;3;29;.906;3600000;0
5752;44526;734;100;28;0;28;1.000;3600000;0
5752;-1;739;0;0;0;0;.00nan;0;0
5752;-1;734;0;0;0;0;.00nan;0;0
5752;85670;739;72;34;3;31;.912;3600000;0
5753;3756;744;90;33;2;31;.939;3782000;0
5753;195887;743;0;0;0;0;.00nan;0;0
5753;196698;744;0;0;0;0;.00nan;0;0
5753;93324;743;90;33;1;32;.970;3782000;0
5754;165723;1880;0;0;0;0;.00nan;0;0
5754;207771;729;0;0;0;0;.00nan;0;0
5754;202839;729;99;44;2;42;.955;3600000;0
5754;66993;1880;32;24;5;19;.792;3600000;0
5755;44526;734;92;58;4;54;.931;3719000;0
5755;-1;734;0;0;0;0;.00nan;0;0
5755;85797;3789;0;0;0;0;.00nan;0;0
5755;91742;3789;56;21;3;18;.857;3719000;0
5756;180177;736;0;0;0;0;.00nan;0;0
5756;-1;739;100;45;0;45;1.000;3600000;0
5756;74734;736;77;30;2;28;.933;3512000;0
5756;85670;739;0;0;0;0;.00nan;0;0
5757;595;732;75;39;4;35;.897;3559000;0
5757;1957;738;0;0;0;0;.00nan;0;0
5757;8505;732;0;0;0;0;.00nan;0;0
5757;184158;738;88;39;3;36;.923;3600000;0
5758;31165;752;0;0;0;0;.00nan;0;0
5758;33044;2168;0;0;0;0;.00nan;0;0
5758;49935;2168;96;34;1;33;.971;3900000;0
5758;52204;752;91;32;1;31;.969;3900000;0
5759;193790;740;0;0;0;0;.00nan;0;0
5759;207184;740;58;43;5;38;.884;3526000;0
5759;-1;742;0;0;0;0;.00nan;0;0
5759;88646;742;81;38;3;35;.921;3600000;0
5760;841;764;0;0;0;0;.00nan;0;0
5760;174898;764;87;43;3;40;.930;3600000;0
5760;67294;737;0;0;0;0;.00nan;0;0
5760;76405;737;87;16;0;16;1.000;3600000;0
5761;178098;733;81;42;3;39;.929;3600000;0
5761;56565;741;100;28;0;28;1.000;3600000;0
5761;66245;733;0;0;0;0;.00nan;0;0
5761;82273;741;0;0;0;0;.00nan;0;0
5762;2643;747;96;39;1;38;.974;3900000;0
5762;3359;751;83;27;1;26;.963;3864000;0
5762;199033;747;0;0;0;0;.00nan;0;0
5762;148788;751;0;0;0;0;.00nan;0;0
5763;2195;748;0;0;0;0;.00nan;0;0
5763;67287;748;83;39;2;37;.949;3900000;0
5763;85281;749;0;0;0;0;.00nan;0;0
5763;85661;749;100;37;2;35;.946;3900000;0
5764;195887;743;0;0;0;0;.00nan;0;0
5764;33044;2168;0;0;0;0;.00nan;0;0
5764;49935;2168;99;45;1;44;.978;3600000;0
5764;93324;743;78;35;3;32;.914;3594000;0
5765;595;732;70;29;3;26;.897;3600000;0
5765;8505;732;0;0;0;0;.00nan;0;0
5765;85797;3789;0;0;0;0;.00nan;0;0
5765;91742;3789;53;32;5;27;.844;3515000;0
5766;1957;738;0;0;0;0;.00nan;0;0
5766;184158;738;95;22;1;21;.955;3900000;0
5766;180177;736;0;0;0;0;.00nan;0;0
5766;74734;736;97;62;1;61;.984;3900000;0
5767;165723;1880;0;0;0;0;.00nan;0;0
5767;-1;739;80;44;4;40;.909;3600000;0
5767;66993;1880;51;34;5;29;.853;3560000;0
5767;85670;739;0;0;0;0;.00nan;0;0
5768;3756;744;36;10;3;7;.700;570000;0
5768;206313;745;95;39;2;37;.949;3600000;0
5768;202104;745;0;0;0;0;.00nan;0;0
5768;196698;744;60;29;3;26;.897;3030000;0
5769;-1;742;0;0;0;0;.00nan;0;0
5769;67294;737;0;0;0;0;.00nan;0;0
5769;76405;737;69;38;5;33;.868;3600000;0
5769;88646;742;83;28;1;27;.964;3600000;0
5770;31165;752;41;38;6;32;.842;3262000;0
5770;44526;734;63;24;2;22;.917;3600000;0
5770;-1;734;0;0;0;0;.00nan;0;0
5770;52204;752;48;0;0;0;.00nan;338000;0
5771;841;764;0;0;0;0;.00nan;0;0
5771;174898;764;98;27;0;27;1.000;3600000;0
5771;56565;741;32;22;5;17;.773;2064000;0
5771;82273;741;51;28;4;24;.857;1536000;0
5772;2643;747;94;53;3;50;.943;3795000;0
5772;3359;751;0;0;0;0;.00nan;0;0
5772;199033;747;0;0;0;0;.00nan;0;0
5772;148788;751;57;32;4;28;.875;3795000;0
5773;193790;740;0;0;0;0;.00nan;0;0
5773;178098;733;0;0;0;0;.00nan;0;0
5773;207184;740;54;22;3;19;.864;3600000;0
5773;66245;733;57;38;5;33;.868;3551000;0
5774;2195;748;0;0;0;0;.00nan;0;0
5774;67287;748;71;26;2;24;.923;3900000;0
5774;85281;749;0;0;0;0;.00nan;0;0
5774;85661;749;84;36;2;34;.944;3900000;0
5775;-1;739;0;0;0;0;.00nan;0;0
5775;85670;739;96;58;2;56;.966;3900000;0
5775;85797;3789;0;0;0;0;.00nan;0;0
5775;91742;3789;67;17;2;15;.882;3900000;0
5776;595;732;90;35;2;33;.943;3600000;0
5776;1957;738;0;0;0;0;.00nan;0;0
5776;8505;732;0;0;0;0;.00nan;0;0
5776;184158;738;90;48;4;44;.917;3517000;0
5777;206313;745;0;0;0;0;.00nan;0;0
5777;202104;745;95;53;3;50;.943;3580000;0
5777;67294;737;0;0;0;0;.00nan;0;0
5777;76405;737;69;18;1;17;.944;3600000;0
5778;165723;1880;0;0;0;0;.00nan;0;0
5778;-1;742;0;0;0;0;.00nan;0;0
5778;66993;1880;53;17;2;15;.882;3514000;0
5778;88646;742;100;40;0;40;1.000;3600000;0
5779;207771;729;58;21;2;19;.905;3600000;0
5779;44526;734;71;52;5;47;.904;3600000;0
5779;202839;729;0;0;0;0;.00nan;0;0
5779;-1;734;0;0;0;0;.00nan;0;0
5780;2195;748;0;0;0;0;.00nan;0;0
5780;2643;747;82;50;3;47;.940;3900000;0
5780;199033;747;0;0;0;0;.00nan;0;0
5780;67287;748;83;34;3;31;.912;3900000;0
5781;31165;752;81;23;1;22;.957;3900000;0
5781;52204;752;0;0;0;0;.00nan;0;0
5781;56565;741;92;35;1;34;.971;3900000;0
5781;82273;741;0;0;0;0;.00nan;0;0
5782;193790;740;70;25;1;24;.960;3889000;0
5782;180177;736;0;0;0;0;.00nan;0;0
5782;207184;740;0;0;0;0;.00nan;0;0
5782;74734;736;62;18;2;16;.889;3889000;0
5783;841;764;0;0;0;0;.00nan;0;0
5783;174898;764;75;40;4;36;.900;3600000;0
5783;195887;743;0;0;0;0;.00nan;0;0
5783;93324;743;33;28;6;22;.786;3555000;0
5784;3359;751;70;38;3;35;.921;3600000;0
5784;85281;749;0;0;0;0;.00nan;0;0
5784;85661;749;96;24;0;24;1.000;3600000;0
5784;148788;751;0;0;0;0;.00nan;0;0
5785;595;732;92;39;3;36;.923;3600000;0
5785;8505;732;0;0;0;0;.00nan;0;0
5785;-1;739;0;0;0;0;.00nan;0;0
5785;85670;739;63;35;4;31;.886;3579000;0
5786;2195;748;74;27;2;25;.926;3900000;0
5786;2643;747;0;0;0;0;.00nan;0;0
5786;199033;747;95;44;2;42;.955;3900000;0
5786;67287;748;0;0;0;0;.00nan;0;0
5787;3756;744;85;27;2;25;.926;3600000;0
5787;206313;745;62;39;4;35;.897;3600000;0
5787;202104;745;0;0;0;0;.00nan;0;0
5787;196698;744;0;0;0;0;.00nan;0;0
5788;193790;740;70;21;1;20;.952;1322000;0
5788;207184;740;39;22;4;18;.818;2278000;0
5788;207771;729;0;0;0;0;.00nan;0;0
5788;202839;729;70;16;1;15;.938;3600000;0
5789;1957;738;0;0;0;0;.00nan;0;0
5789;184158;738;76;43;4;39;.907;3900000;0
5789;174898;764;0;0;0;0;.00nan;0;0
5789;-1;764;69;37;4;33;.892;3900000;0
5790;31165;752;27;5;3;2;.400;382000;0
5790;44526;734;43;42;6;36;.857;3585000;0
5790;-1;734;0;0;0;0;.00nan;0;0
5790;52204;752;63;19;2;17;.895;3218000;0
5791;178098;733;97;51;2;49;.961;3900000;0
5791;66245;733;0;0;0;0;.00nan;0;0
5791;67294;737;0;0;0;0;.00nan;0;0
5791;76405;737;59;15;2;13;.867;3900000;0
5792;195887;743;83;34;2;32;.941;3600000;0
5792;56565;741;48;37;5;32;.865;3283000;0
5792;82273;741;49;1;0;1;1.000;317000;0
5792;93324;743;0;0;0;0;.00nan;0;0
5793;180177;736;0;0;0;0;.00nan;0;0
5793;-1;742;0;0;0;0;.00nan;0;0
5793;74734;736;53;41;5;36;.878;3541000;0
5793;88646;742;66;28;3;25;.893;3600000;0
5794;3359;751;0;0;0;0;.00nan;0;0
5794;85281;749;0;0;0;0;.00nan;0;0
5794;85661;749;58;41;4;37;.902;3563000;0
5794;148788;751;72;27;3;24;.889;3600000;0
5795;206313;745;54;46;6;40;.870;3584000;0
5795;33044;2168;0;0;0;0;.00nan;0;0
5795;202104;745;0;0;0;0;.00nan;0;0
5795;49935;2168;46;32;5;27;.844;3600000;0
5796;3756;744;63;28;3;25;.893;3600000;0
5796;196698;744;0;0;0;0;.00nan;0;0
5796;85797;3789;0;0;0;0;.00nan;0;0
5796;91742;3789;77;45;5;40;.889;3562000;0
5797;31165;752;0;0;0;0;.00nan;0;0
5797;33044;2168;89;31;1;30;.968;3704000;0
5797;49935;2168;0;0;0;0;.00nan;0;0
5797;52204;752;78;31;2;29;.935;3704000;0
5798;1957;738;0;0;0;0;.00nan;0;0
5798;184158;738;78;25;1;24;.960;3600000;0
5798;44526;734;71;33;2;31;.939;3588000;0
5798;-1;734;0;0;0;0;.00nan;0;0
5799;56565;741;66;43;5;38;.884;3600000;0
5799;67294;737;0;0;0;0;.00nan;0;0
5799;76405;737;85;25;2;23;.920;3600000;0
5799;82273;741;0;0;0;0;.00nan;0;0
5800;595;732;0;0;0;0;.00nan;0;0
5800;8505;732;82;37;3;34;.919;3644000;0
5800;-1;742;0;0;0;0;.00nan;0;0
5800;88646;742;68;20;2;18;.900;3644000;0
5801;165723;1880;0;0;0;0;.00nan;0;0
5801;195887;743;0;0;0;0;.00nan;0;0
5801;66993;1880;35;25;5;20;.800;3600000;0
5801;93324;743;63;15;1;14;.933;3600000;0
5802;178098;733;0;0;0;0;.00nan;0;0
5802;180177;736;86;28;1;27;.964;3900000;0
5802;66245;733;100;43;1;42;.977;3900000;0
5802;74734;736;0;0;0;0;.00nan;0;0
5803;2195;748;0;0;0;0;.00nan;0;0
5803;67287;748;70;51;6;45;.882;3600000;0
5803;85797;3789;0;0;0;0;.00nan;0;0
5803;91742;3789;100;19;0;19;1.000;3600000;0
5804;1957;738;72;37;3;34;.919;3600000;0
5804;184158;738;0;0;0;0;.00nan;0;0
5804;44526;734;0;0;0;0;.00nan;0;0
5804;-1;734;56;31;4;27;.871;3553000;0
5805;2643;747;71;27;3;24;.889;3600000;0
5805;199033;747;0;0;0;0;.00nan;0;0
5805;193790;740;0;0;0;0;.00nan;0;0
5805;207184;740;60;41;4;37;.902;3588000;0
5806;174898;764;0;0;0;0;.00nan;0;0
5806;207771;729;66;29;4;25;.862;3600000;0
5806;202839;729;0;0;0;0;.00nan;0;0
5806;-1;764;60;24;3;21;.875;3600000;0
5807;3756;744;56;29;3;26;.897;3600000;0
5807;196698;744;0;0;0;0;.00nan;0;0
5807;85281;749;0;0;0;0;.00nan;0;0
5807;85661;749;87;31;1;30;.968;3600000;0
5808;206313;745;77;34;3;31;.912;3540000;0
5808;195887;743;0;0;0;0;.00nan;0;0
5808;202104;745;0;0;0;0;.00nan;0;0
5808;93324;743;82;26;1;25;.962;3600000;0
5809;-1;739;0;0;0;0;.00nan;0;0
5809;56565;741;80;30;2;28;.933;3600000;0
5809;82273;741;0;0;0;0;.00nan;0;0
5809;85670;739;83;43;4;39;.907;3513000;0
5810;595;732;74;22;1;21;.955;3600000;0
5810;8505;732;0;0;0;0;.00nan;0;0
5810;178098;733;57;6;0;6;1.000;573000;0
5810;66245;733;69;53;6;47;.887;3027000;0
5811;3359;751;0;0;0;0;.00nan;0;0
5811;31165;752;92;45;3;42;.933;3552000;0
5811;52204;752;0;0;0;0;.00nan;0;0
5811;148788;751;90;34;2;32;.941;3600000;0
5812;33044;2168;0;0;0;0;.00nan;0;0
5812;49935;2168;88;37;2;35;.946;3573000;0
5812;85797;3789;0;0;0;0;.00nan;0;0
5812;91742;3789;95;40;1;39;.975;3600000;0
5813;2643;747;22;4;3;1;.250;354000;0
5813;199033;747;49;28;5;23;.821;3246000;0
5813;67294;737;0;0;0;0;.00nan;0;0
5813;76405;737;89;20;0;20;1.000;3600000;0
5814;-1;742;0;0;0;0;.00nan;0;0
5814;85281;749;59;18;2;16;.889;1536000;0
5814;85661;749;21;26;6;20;.769;2064000;0
5814;88646;742;54;21;3;18;.857;3600000;0
5815;193790;740;70;47;5;42;.894;3600000;0
5815;207184;740;0;0;0;0;.00nan;0;0
5815;44526;734;87;36;2;34;.944;3600000;0
5815;-1;734;0;0;0;0;.00nan;0;0
5816;180177;736;0;0;0;0;.00nan;0;0
5816;-1;764;0;0;0;0;.00nan;0;0
5816;74734;736;56;31;4;27;.871;3600000;0
5816;78977;764;84;33;1;32;.970;3600000;0
5817;3756;744;100;29;0;29;1.000;3600000;0
5817;196698;744;0;0;0;0;.00nan;0;0
5817;207771;729;0;0;0;0;.00nan;0;0
5817;202839;729;87;32;1;31;.969;3583000;0
5818;1957;738;0;0;0;0;.00nan;0;0
5818;184158;738;80;34;3;31;.912;3899000;0
5818;-1;739;0;0;0;0;.00nan;0;0
5818;85670;739;50;23;3;20;.870;3900000;0
5819;178098;733;0;0;0;0;.00nan;0;0
5819;206313;745;0;0;0;0;.00nan;0;0
5819;202104;745;75;26;1;25;.962;3600000;0
5819;66245;733;86;40;4;36;.900;3600000;0
5820;195887;743;0;0;0;0;.00nan;0;0
5820;180177;736;0;0;0;0;.00nan;0;0
5820;74734;736;68;33;3;30;.909;3584000;0
5820;93324;743;67;23;2;21;.913;3600000;0
5821;2195;748;0;0;0;0;.00nan;0;0
5821;67287;748;100;34;0;34;1.000;3600000;0
5821;67294;737;0;0;0;0;.00nan;0;0
5821;76405;737;88;32;2;30;.938;3566000;0
5822;207771;729;99;41;1;40;.976;3600000;0
5822;202839;729;0;0;0;0;.00nan;0;0
5822;-1;742;0;0;0;0;.00nan;0;0
5822;88646;742;92;39;3;36;.923;3579000;0
5823;595;732;99;46;1;45;.978;3600000;0
5823;8505;732;0;0;0;0;.00nan;0;0
5823;85797;3789;0;0;0;0;.00nan;0;0
5823;91742;3789;68;34;4;30;.882;3600000;0
5824;56565;741;68;35;3;32;.914;3900000;0
5824;82273;741;0;0;0;0;.00nan;0;0
5824;85281;749;0;0;0;0;.00nan;0;0
5824;85661;749;88;39;3;36;.923;3900000;0
5825;2643;747;100;52;1;51;.981;3600000;0
5825;199033;747;0;0;0;0;.00nan;0;0
5825;31165;752;54;14;2;12;.857;3595000;0
5825;52204;752;0;0;0;0;.00nan;0;0
5826;3756;744;85;42;3;39;.929;3589000;0
5826;33044;2168;0;0;0;0;.00nan;0;0
5826;196698;744;0;0;0;0;.00nan;0;0
5826;49935;2168;78;28;2;26;.929;3600000;0
5827;165723;1880;0;0;0;0;.00nan;0;0
5827;206313;745;49;32;4;28;.875;3524000;0
5827;202104;745;0;0;0;0;.00nan;0;0
5827;66993;1880;68;24;2;22;.917;3600000;0
5828;1957;738;0;0;0;0;.00nan;0;0
5828;193790;740;30;32;6;26;.813;3155000;0
5828;184158;738;52;25;4;21;.840;3600000;0
5828;207184;740;26;7;3;4;.571;445000;0
5829;3359;751;0;0;0;0;.00nan;0;0
5829;-1;764;0;0;0;0;.00nan;0;0
5829;78977;764;72;37;4;33;.892;3600000;0
5829;148788;751;100;31;0;31;1.000;3600000;0
5830;2195;748;0;0;0;0;.00nan;0;0
5830;207771;729;0;0;0;0;.00nan;0;0
5830;202839;729;85;27;1;26;.963;3600000;0
5830;67287;748;72;24;2;22;.917;3550000;0
5831;180177;736;0;0;0;0;.00nan;0;0
5831;-1;739;0;0;0;0;.00nan;0;0
5831;74734;736;97;51;3;48;.941;3594000;0
5831;85670;739;57;18;2;16;.889;3600000;0
5832;1957;738;61;8;0;8;1.000;1138000;0
5832;184158;738;51;36;6;30;.833;2462000;0
5832;85797;3789;0;0;0;0;.00nan;0;0
5832;91742;3789;66;27;3;24;.889;3600000;0
5833;2643;747;92;45;4;41;.911;3819000;0
5833;199033;747;0;0;0;0;.00nan;0;0
5833;31165;752;79;37;3;34;.919;3826000;0
5833;52204;752;0;0;0;0;.00nan;0;0
5834;165723;1880;0;0;0;0;.00nan;0;0
5834;66993;1880;84;39;3;36;.923;3900000;0
5834;67294;737;0;0;0;0;.00nan;0;0
5834;76405;737;51;24;3;21;.875;3900000;0
5835;595;732;51;34;5;29;.853;3600000;0
5835;8505;732;0;0;0;0;.00nan;0;0
5835;56565;741;92;36;1;35;.972;3600000;0
5835;82273;741;0;0;0;0;.00nan;0;0
5836;193790;740;83;31;1;30;.968;2644000;0
5836;33044;2168;0;0;0;0;.00nan;0;0
5836;207184;740;30;15;4;11;.733;956000;0
5836;49935;2168;88;28;1;27;.964;3600000;0
5837;3359;751;0;0;0;0;.00nan;0;0
5837;178098;733;87;43;3;40;.930;3900000;0
5837;66245;733;0;0;0;0;.00nan;0;0
5837;148788;751;74;28;3;25;.893;3900000;0
5838;-1;742;0;0;0;0;.00nan;0;0
5838;85281;749;0;0;0;0;.00nan;0;0
5838;85661;749;94;47;2;45;.957;3795000;0
5838;88646;742;75;31;3;28;.903;3795000;0
5839;3756;744;59;27;3;24;.889;3600000;0
5839;195887;743;0;0;0;0;.00nan;0;0
5839;196698;744;0;0;0;0;.00nan;0;0
5839;93324;743;76;43;4;39;.907;3575000;0
5840;44526;734;61;29;3;26;.897;3555000;0
5840;-1;739;0;0;0;0;.00nan;0;0
5840;-1;734;0;0;0;0;.00nan;0;0
5840;85670;739;90;31;1;30;.968;3600000;0
5841;2195;748;0;0;0;0;.00nan;0;0
5841;195887;743;0;0;0;0;.00nan;0;0
5841;67287;748;85;24;1;23;.958;3600000;0
5841;93324;743;54;34;4;30;.882;3600000;0
5842;3359;751;0;0;0;0;.00nan;0;0
5842;207771;729;43;29;5;24;.828;3533000;0
5842;202839;729;0;0;0;0;.00nan;0;0
5842;148788;751;80;37;3;34;.919;3600000;0
5843;2643;747;75;33;3;30;.909;3600000;0
5843;199033;747;0;0;0;0;.00nan;0;0
5843;31165;752;54;32;4;28;.875;3563000;0
5843;52204;752;0;0;0;0;.00nan;0;0
5844;206313;745;65;32;4;28;.875;3600000;0
5844;33044;2168;0;0;0;0;.00nan;0;0
5844;202104;745;0;0;0;0;.00nan;0;0
5844;49935;2168;100;37;1;36;.973;3600000;0
5845;1957;738;0;0;0;0;.00nan;0;0
5845;184158;738;96;53;3;50;.943;3547000;0
5845;67294;737;0;0;0;0;.00nan;0;0
5845;76405;737;67;22;2;20;.909;3600000;0
5846;-1;764;0;0;0;0;.00nan;0;0
5846;56565;741;0;0;0;0;.00nan;0;0
5846;78977;764;81;50;4;46;.920;3900000;0
5846;82273;741;48;28;4;24;.857;3900000;0
5847;193790;740;0;0;0;0;.00nan;0;0
5847;207184;740;89;27;1;26;.963;3600000;0
5847;85797;3789;0;0;0;0;.00nan;0;0
5847;91742;3789;65;25;3;22;.880;3568000;0
5848;178098;733;0;0;0;0;.00nan;0;0
5848;165723;1880;0;0;0;0;.00nan;0;0
5848;66245;733;97;57;3;54;.947;3552000;0
5848;66993;1880;65;17;1;16;.941;3600000;0
5849;-1;742;0;0;0;0;.00nan;0;0
5849;85281;749;0;0;0;0;.00nan;0;0
5849;85661;749;73;42;4;38;.905;3600000;0
5849;88646;742;100;27;0;27;1.000;3600000;0
5850;595;732;47;31;5;26;.839;3557000;0
5850;3756;744;89;40;3;37;.925;3600000;0
5850;8505;732;0;0;0;0;.00nan;0;0
5850;196698;744;0;0;0;0;.00nan;0;0
5851;180177;736;0;0;0;0;.00nan;0;0
5851;-1;739;0;0;0;0;.00nan;0;0
5851;74734;736;76;32;2;30;.938;3600000;0
5851;85670;739;70;30;3;27;.900;3554000;0
5852;2195;748;0;0;0;0;.00nan;0;0
5852;-1;764;0;0;0;0;.00nan;0;0
5852;67287;748;56;22;2;20;.909;3600000;0
5852;78977;764;77;34;3;31;.912;3559000;0
5853;195887;743;0;0;0;0;.00nan;0;0
5853;33044;2168;0;0;0;0;.00nan;0;0
5853;49935;2168;71;33;3;30;.909;3544000;0
5853;93324;743;100;45;2;43;.956;3600000;0
5854;207771;729;0;0;0;0;.00nan;0;0
5854;202839;729;79;29;2;27;.931;3900000;0
5854;85797;3789;0;0;0;0;.00nan;0;0
5854;91742;3789;72;26;2;24;.923;3900000;0
5855;1957;738;0;0;0;0;.00nan;0;0
5855;3359;751;0;0;0;0;.00nan;0;0
5855;184158;738;52;31;4;27;.871;3600000;0
5855;148788;751;68;21;1;20;.952;3600000;0
5856;2643;747;58;28;3;25;.893;3600000;0
5856;199033;747;0;0;0;0;.00nan;0;0
5856;-1;742;0;0;0;0;.00nan;0;0
5856;88646;742;50;27;4;23;.852;3556000;0
5857;206313;745;69;40;4;36;.900;3566000;0
5857;202104;745;0;0;0;0;.00nan;0;0
5857;56565;741;86;35;3;32;.914;3600000;0
5857;82273;741;0;0;0;0;.00nan;0;0
5858;165723;1880;0;0;0;0;.00nan;0;0
5858;44526;734;82;41;2;39;.951;3590000;0
5858;-1;734;0;0;0;0;.00nan;0;0
5858;66993;1880;87;22;1;21;.955;3600000;0
5859;31165;752;59;27;3;24;.889;3562000;0
5859;52204;752;0;0;0;0;.00nan;0;0
5859;85281;749;0;0;0;0;.00nan;0;0
5859;85661;749;94;38;2;36;.947;3600000;0
5860;178098;733;50;1;0;1;1.000;524000;0
5860;-1;739;0;0;0;0;.00nan;0;0
5860;66245;733;61;54;7;47;.870;3076000;0
5860;85670;739;77;18;1;17;.944;3600000;0
5861;2643;747;63;8;0;8;1.000;668000;0
5861;199033;747;30;32;6;26;.813;2932000;0
5861;-1;742;0;0;0;0;.00nan;0;0
5861;88646;742;100;42;1;41;.976;3600000;0
5862;193790;740;65;38;4;34;.895;3550000;0
5862;207184;740;0;0;0;0;.00nan;0;0
5862;67294;737;0;0;0;0;.00nan;0;0
5862;76405;737;49;11;2;9;.818;3600000;0
5863;165723;1880;73;23;2;21;.913;3600000;0
5863;44526;734;0;0;0;0;.00nan;0;0
5863;-1;734;70;34;3;31;.912;3544000;0
5863;66993;1880;0;0;0;0;.00nan;0;0
5864;595;732;73;27;2;25;.926;3600000;0
5864;8505;732;0;0;0;0;.00nan;0;0
5864;180177;736;68;13;0;13;1.000;848000;0
5864;74734;736;28;27;6;21;.778;2752000;0
5865;31165;752;0;0;0;0;.00nan;0;0
5865;52204;752;59;18;2;16;.889;3600000;0
5865;85281;749;63;46;5;41;.891;3085000;0
5865;85661;749;51;2;0;2;1.000;515000;0
5866;206313;745;65;32;3;29;.906;3600000;0
5866;202104;745;0;0;0;0;.00nan;0;0
5866;56565;741;59;45;5;40;.889;3565000;0
5866;82273;741;0;0;0;0;.00nan;0;0
5867;3359;751;56;42;4;38;.905;3542000;0
5867;195887;743;0;0;0;0;.00nan;0;0
5867;93324;743;96;39;2;37;.949;3600000;0
5867;148788;751;0;0;0;0;.00nan;0;0
5868;2195;748;0;0;0;0;.00nan;0;0
5868;33044;2168;0;0;0;0;.00nan;0;0
5868;49935;2168;59;32;4;28;.875;3600000;0
5868;67287;748;90;33;1;32;.970;3600000;0
5869;595;732;79;43;3;40;.930;3596000;0
5869;8505;732;0;0;0;0;.00nan;0;0
5869;85797;3789;77;21;2;19;.905;3600000;0
5869;91742;3789;0;0;0;0;.00nan;0;0
5870;178098;733;60;36;5;31;.861;3600000;0
5870;44526;734;82;27;1;26;.963;3600000;0
5870;-1;734;0;0;0;0;.00nan;0;0
5870;66245;733;0;0;0;0;.00nan;0;0
5871;1957;738;0;0;0;0;.00nan;0;0
5871;165723;1880;0;0;0;0;.00nan;0;0
5871;184158;738;83;34;3;31;.912;3600000;0
5871;66993;1880;70;25;2;23;.920;3600000;0
5872;180177;736;94;59;4;55;.932;3600000;0
5872;67294;737;0;0;0;0;.00nan;0;0
5872;74734;736;0;0;0;0;.00nan;0;0
5872;76405;737;80;23;1;22;.957;3600000;0
5873;3756;744;72;25;2;23;.920;3600000;0
5873;196698;744;0;0;0;0;.00nan;0;0
5873;-1;764;0;0;0;0;.00nan;0;0
5873;78977;764;97;49;3;46;.939;3600000;0
5874;206313;745;0;0;0;0;.00nan;0;0
5874;31165;752;76;23;1;22;.957;3600000;0
5874;202104;745;78;40;4;36;.900;3600000;0
5874;52204;752;0;0;0;0;.00nan;0;0
5875;1957;738;0;0;0;0;.00nan;0;0
5875;184158;738;65;35;4;31;.886;3600000;0
5875;207771;729;100;36;0;36;1.000;3600000;0
5875;202839;729;0;0;0;0;.00nan;0;0
5876;193790;740;69;46;5;41;.891;3600000;0
5876;207184;740;0;0;0;0;.00nan;0;0
5876;85797;3789;0;0;0;0;.00nan;0;0
5876;91742;3789;44;16;3;13;.813;3600000;0
5877;44526;734;69;36;3;33;.917;3596000;0
5877;-1;734;0;0;0;0;.00nan;0;0
5877;85281;749;0;0;0;0;.00nan;0;0
5877;85661;749;76;28;2;26;.929;3600000;0
5878;2195;748;0;0;0;0;.00nan;0;0
5878;-1;742;88;35;2;33;.943;3090000;0
5878;67287;748;31;28;6;22;.786;3550000;0
5878;88646;742;24;4;3;1;.250;510000;0
5879;595;732;82;28;1;27;.964;3600000;0
5879;8505;732;0;0;0;0;.00nan;0;0
5879;-1;739;0;0;0;0;.00nan;0;0
5879;85670;739;71;39;4;35;.897;3600000;0
5880;2643;747;81;39;3;36;.923;3628000;0
5880;3359;751;0;0;0;0;.00nan;0;0
5880;199033;747;0;0;0;0;.00nan;0;0
5880;148788;751;78;30;2;28;.933;3628000;0
5881;3756;744;99;35;1;34;.971;3600000;0
5881;180177;736;0;0;0;0;.00nan;0;0
5881;196698;744;0;0;0;0;.00nan;0;0
5881;74734;736;81;42;4;38;.905;3600000;0
5882;178098;733;0;0;0;0;.00nan;0;0
5882;66245;733;70;62;6;56;.903;3600000;0
5882;67294;737;0;0;0;0;.00nan;0;0
5882;76405;737;67;16;1;15;.938;3600000;0
5883;195887;743;0;0;0;0;.00nan;0;0
5883;-1;764;0;0;0;0;.00nan;0;0
5883;78977;764;76;44;4;40;.909;3600000;0
5883;93324;743;51;38;5;33;.868;3568000;0
5884;2643;747;53;27;4;23;.852;2377000;0
5884;199033;747;54;3;0;3;1.000;1197000;0
5884;33044;2168;0;0;0;0;.00nan;0;0
5884;49935;2168;68;28;2;26;.929;3600000;0
5885;3756;744;97;51;3;48;.941;3572000;0
5885;196698;744;0;0;0;0;.00nan;0;0
5885;85797;3789;0;0;0;0;.00nan;0;0
5885;91742;3789;54;14;2;12;.857;3600000;0
5886;1957;738;0;0;0;0;.00nan;0;0
5886;184158;738;84;30;1;29;.967;3600000;0
5886;85281;749;0;0;0;0;.00nan;0;0
5886;85661;749;76;35;3;32;.914;3549000;0
5887;-1;739;0;0;0;0;.00nan;0;0
5887;67294;737;0;0;0;0;.00nan;0;0
5887;76405;737;79;34;2;32;.941;3600000;0
5887;85670;739;40;39;6;33;.846;3600000;0
5888;595;732;63;33;3;30;.909;3621000;0
5888;8505;732;0;0;0;0;.00nan;0;0
5888;207771;729;71;42;4;38;.905;3621000;0
5888;202839;729;0;0;0;0;.00nan;0;0
5889;193790;740;0;0;0;0;.00nan;0;0
5889;31165;752;0;0;0;0;.00nan;0;0
5889;207184;740;90;53;3;50;.943;3600000;0
5889;52204;752;79;29;1;28;.966;3600000;0
5890;2195;748;0;0;0;0;.00nan;0;0
5890;180177;736;74;32;3;29;.906;2567000;0
5890;67287;748;70;17;1;16;.941;3600000;0
5890;74734;736;30;15;4;11;.733;1033000;0
5891;178098;733;91;38;1;37;.974;3600000;0
5891;44526;734;50;37;5;32;.865;3600000;0
5891;-1;734;0;0;0;0;.00nan;0;0
5891;66245;733;0;0;0;0;.00nan;0;0
5892;3359;751;0;0;0;0;.00nan;0;0
5892;195887;743;75;40;3;37;.925;3566000;0
5892;93324;743;0;0;0;0;.00nan;0;0
5892;148788;751;67;27;2;25;.926;3600000;0
5893;206313;745;62;38;4;34;.895;3778000;0
5893;202104;745;0;0;0;0;.00nan;0;0
5893;56565;741;67;31;3;28;.903;3778000;0
5893;82273;741;0;0;0;0;.00nan;0;0
5894;595;732;0;0;0;0;.00nan;0;0
5894;8505;732;76;32;3;29;.906;3600000;0
5894;-1;764;0;0;0;0;.00nan;0;0
5894;78977;764;81;47;4;43;.915;3600000;0
5895;178098;733;50;8;1;7;.875;926000;0
5895;165723;1880;0;0;0;0;.00nan;0;0
5895;66245;733;48;40;6;34;.850;2674000;0
5895;66993;1880;54;17;2;15;.882;3600000;0
5896;2195;748;0;0;0;0;.00nan;0;0
5896;193790;740;44;24;4;20;.833;3534000;0
5896;207184;740;0;0;0;0;.00nan;0;0
5896;67287;748;44;9;2;7;.778;3600000;0
5897;2643;747;44;19;3;16;.842;3556000;0
5897;199033;747;0;0;0;0;.00nan;0;0
5897;33044;2168;83;32;2;30;.938;3600000;0
5897;49935;2168;0;0;0;0;.00nan;0;0
5898;1957;738;0;0;0;0;.00nan;0;0
5898;184158;738;89;32;1;31;.969;3600000;0
5898;207771;729;0;0;0;0;.00nan;0;0
5898;202839;729;63;21;2;19;.905;3564000;0
5899;3756;744;63;29;3;26;.897;3544000;0
5899;196698;744;0;0;0;0;.00nan;0;0
5899;-1;739;0;0;0;0;.00nan;0;0
5899;85670;739;99;48;2;46;.958;3600000;0
5900;-1;742;0;0;0;0;.00nan;0;0
5900;85281;749;0;0;0;0;.00nan;0;0
5900;85661;749;91;29;2;27;.931;3600000;0
5900;88646;742;60;25;3;22;.880;3546000;0
5901;31165;752;78;51;4;47;.922;3600000;0
5901;52204;752;0;0;0;0;.00nan;0;0
5901;85797;3789;0;0;0;0;.00nan;0;0
5901;91742;3789;77;18;1;17;.944;3600000;0
5902;3359;751;0;0;0;0;.00nan;0;0
5902;67294;737;0;0;0;0;.00nan;0;0
5902;76405;737;67;18;1;17;.944;3600000;0
5902;148788;751;88;42;2;40;.952;3600000;0
5903;165723;1880;0;0;0;0;.00nan;0;0
5903;-1;764;0;0;0;0;.00nan;0;0
5903;66993;1880;56;32;5;27;.844;3513000;0
5903;78977;764;77;40;3;37;.925;3600000;0
5904;2195;748;0;0;0;0;.00nan;0;0
5904;180177;736;50;7;1;6;.857;462000;0
5904;67287;748;77;10;0;10;1.000;3600000;0
5904;74734;736;62;57;7;50;.877;3138000;0
5905;193790;740;0;0;0;0;.00nan;0;0
5905;33044;2168;0;0;0;0;.00nan;0;0
5905;207184;740;72;44;4;40;.909;3600000;0
5905;49935;2168;87;26;1;25;.962;3600000;0
5906;1957;738;75;61;7;54;.885;3600000;0
5906;184158;738;0;0;0;0;.00nan;0;0
5906;85797;3789;0;0;0;0;.00nan;0;0
5906;91742;3789;72;19;1;18;.947;3600000;0
5907;2643;747;89;26;1;25;.962;3600000;0
5907;199033;747;0;0;0;0;.00nan;0;0
5907;206313;745;63;32;3;29;.906;3537000;0
5907;202104;745;0;0;0;0;.00nan;0;0
5908;67294;737;77;27;2;25;.926;3600000;0
5908;76405;737;0;0;0;0;.00nan;0;0
5908;85281;749;56;11;1;10;.909;872000;0
5908;85661;749;33;30;6;24;.800;2728000;0
5909;195887;743;0;0;0;0;.00nan;0;0
5909;-1;764;0;0;0;0;.00nan;0;0
5909;78977;764;100;45;3;42;.933;3600000;0
5909;93324;743;49;19;4;15;.789;3564000;0
5910;178098;733;0;0;0;0;.00nan;0;0
5910;207771;729;0;0;0;0;.00nan;0;0
5910;202839;729;63;18;1;17;.944;3600000;0
5910;66245;733;91;46;2;44;.957;3596000;0
5911;595;732;95;39;2;37;.949;3600000;0
5911;8505;732;0;0;0;0;.00nan;0;0
5911;165723;1880;0;0;0;0;.00nan;0;0
5911;66993;1880;49;30;4;26;.867;3546000;0
5912;3359;751;0;0;0;0;.00nan;0;0
5912;56565;741;90;45;3;42;.933;3900000;0
5912;82273;741;0;0;0;0;.00nan;0;0
5912;148788;751;77;29;3;26;.897;3900000;0
5913;33044;2168;0;0;0;0;.00nan;0;0
5913;180177;736;0;0;0;0;.00nan;0;0
5913;49935;2168;83;25;1;24;.960;3600000;0
5913;74734;736;96;49;3;46;.939;3600000;0
5914;207771;729;68;40;5;35;.875;3600000;0
5914;202839;729;0;0;0;0;.00nan;0;0
5914;67294;737;0;0;0;0;.00nan;0;0
5914;76405;737;100;30;0;30;1.000;3600000;0
5915;195887;743;57;4;0;4;1.000;312000;0
5915;31165;752;69;25;2;23;.920;3600000;0
5915;52204;752;0;0;0;0;.00nan;0;0
5915;93324;743;66;56;7;49;.875;3288000;0
5916;2195;748;0;0;0;0;.00nan;0;0
5916;3359;751;0;0;0;0;.00nan;0;0
5916;67287;748;74;31;2;29;.935;3579000;0
5916;148788;751;92;32;1;31;.969;3600000;0
5917;1957;738;0;0;0;0;.00nan;0;0
5917;184158;738;65;24;2;22;.917;3600000;0
5917;207771;729;0;0;0;0;.00nan;0;0
5917;202839;729;57;35;5;30;.857;3600000;0
5918;-1;739;0;0;0;0;.00nan;0;0
5918;-1;742;0;0;0;0;.00nan;0;0
5918;85670;739;90;40;2;38;.950;3900000;0
5918;88646;742;86;29;2;27;.931;3900000;0
5919;595;732;82;28;2;26;.929;3900000;0
5919;8505;732;0;0;0;0;.00nan;0;0
5919;56565;741;92;48;2;46;.958;3900000;0
5919;82273;741;0;0;0;0;.00nan;0;0
5920;193790;740;0;0;0;0;.00nan;0;0
5920;165723;1880;0;0;0;0;.00nan;0;0
5920;207184;740;50;40;6;34;.850;3600000;0
5920;66993;1880;68;16;1;15;.938;3600000;0
5921;178098;733;0;0;0;0;.00nan;0;0
5921;66245;733;99;51;3;48;.941;3896000;0
5921;85797;3789;0;0;0;0;.00nan;0;0
5921;91742;3789;57;27;3;24;.889;3900000;0
5922;180177;736;0;0;0;0;.00nan;0;0
5922;67294;737;0;0;0;0;.00nan;0;0
5922;74734;736;67;40;4;36;.900;3563000;0
5922;76405;737;57;18;2;16;.889;3600000;0
5923;195887;743;0;0;0;0;.00nan;0;0
5923;56565;741;80;32;2;30;.938;3600000;0
5923;82273;741;0;0;0;0;.00nan;0;0
5923;93324;743;43;38;6;32;.842;3600000;0
5924;2643;747;65;37;4;33;.892;3600000;0
5924;199033;747;0;0;0;0;.00nan;0;0
5924;-1;764;0;0;0;0;.00nan;0;0
5924;78977;764;51;36;5;31;.861;3580000;0
5925;44526;734;81;45;4;41;.911;3537000;0
5925;-1;734;0;0;0;0;.00nan;0;0
5925;85797;3789;0;0;0;0;.00nan;0;0
5925;91742;3789;90;29;2;27;.931;3600000;0
5926;2195;748;0;0;0;0;.00nan;0;0
5926;31165;752;0;0;0;0;.00nan;0;0
5926;52204;752;65;19;1;18;.947;3600000;0
5926;67287;748;59;27;3;24;.889;3572000;0
5927;193790;740;0;0;0;0;.00nan;0;0
5927;206313;745;85;35;1;34;.971;3900000;0
5927;207184;740;100;55;1;54;.982;3900000;0
5927;202104;745;0;0;0;0;.00nan;0;0
5928;1957;738;0;0;0;0;.00nan;0;0
5928;178098;733;0;0;0;0;.00nan;0;0
5928;184158;738;48;25;4;21;.840;3600000;0
5928;66245;733;100;33;0;33;1.000;3600000;0
5929;33044;2168;0;0;0;0;.00nan;0;0
5929;49935;2168;42;35;6;29;.829;3600000;0
5929;85281;749;0;0;0;0;.00nan;0;0
5929;85661;749;90;47;3;44;.936;3600000;0
5930;3756;744;82;36;3;33;.917;3588000;0
5930;196698;744;0;0;0;0;.00nan;0;0
5930;-1;739;0;0;0;0;.00nan;0;0
5930;85670;739;85;28;1;27;.964;3600000;0
5931;180177;736;0;0;0;0;.00nan;0;0
5931;207771;729;73;30;3;27;.900;3612000;0
5931;202839;729;0;0;0;0;.00nan;0;0
5931;74734;736;78;35;2;33;.943;3612000;0
5932;2643;747;90;30;1;29;.967;3600000;0
5932;199033;747;0;0;0;0;.00nan;0;0
5932;-1;764;56;28;4;24;.857;2578000;0
5932;78977;764;35;18;4;14;.778;1022000;0
5933;595;732;100;29;0;29;1.000;3600000;0
5933;8505;732;0;0;0;0;.00nan;0;0
5933;165723;1880;0;0;0;0;.00nan;0;0
5933;66993;1880;50;28;4;24;.857;3600000;0
5934;33044;2168;0;0;0;0;.00nan;0;0
5934;49935;2168;65;39;4;35;.897;3553000;0
5934;85281;749;84;35;2;33;.943;3600000;0
5934;85661;749;0;0;0;0;.00nan;0;0
5935;195887;743;0;0;0;0;.00nan;0;0
5935;-1;742;0;0;0;0;.00nan;0;0
5935;88646;742;80;43;4;39;.907;3733000;0
5935;93324;743;43;25;5;20;.800;3733000;0
5936;1957;738;0;0;0;0;.00nan;0;0
5936;184158;738;60;41;5;36;.878;3600000;0
5936;-1;739;0;0;0;0;.00nan;0;0
5936;85670;739;92;18;0;18;1.000;3600000;0
5937;206313;745;0;0;0;0;.00nan;0;0
5937;202104;745;57;30;3;27;.900;3600000;0
5937;44526;734;82;37;2;35;.946;3600000;0
5937;-1;734;0;0;0;0;.00nan;0;0
5938;67294;737;0;0;0;0;.00nan;0;0
5938;76405;737;71;16;1;15;.938;3600000;0
5938;85797;3789;0;0;0;0;.00nan;0;0
5938;91742;3789;83;38;3;35;.921;3521000;0
5939;3359;751;0;0;0;0;.00nan;0;0
5939;56565;741;72;25;1;24;.960;3545000;0
5939;82273;741;0;0;0;0;.00nan;0;0
5939;148788;751;100;41;0;41;1.000;3600000;0
5940;193790;740;0;0;0;0;.00nan;0;0
5940;31165;752;63;22;2;20;.909;3600000;0
5940;207184;740;77;52;4;48;.923;3563000;0
5940;52204;752;0;0;0;0;.00nan;0;0
5941;2195;748;0;0;0;0;.00nan;0;0
5941;3756;744;85;41;2;39;.951;3900000;0
5941;196698;744;0;0;0;0;.00nan;0;0
5941;67287;748;64;19;2;17;.895;3900000;0
5942;2643;747;72;36;3;33;.917;3900000;0
5942;199033;747;0;0;0;0;.00nan;0;0
5942;33044;2168;0;0;0;0;.00nan;0;0
5942;49935;2168;81;40;3;37;.925;3900000;0
5943;595;732;68;39;4;35;.897;3567000;0
5943;8505;732;0;0;0;0;.00nan;0;0
5943;165723;1880;0;0;0;0;.00nan;0;0
5943;66993;1880;66;31;3;28;.903;3600000;0
5944;-1;764;0;0;0;0;.00nan;0;0
5944;78977;764;91;37;2;35;.946;3600000;0
5944;85281;749;0;0;0;0;.00nan;0;0
5944;85661;749;69;29;3;26;.897;3537000;0
5945;2195;748;0;0;0;0;.00nan;0;0
5945;-1;742;0;0;0;0;.00nan;0;0
5945;67287;748;100;39;1;38;.974;3900000;0
5945;88646;742;95;33;1;32;.970;3900000;0
5946;178098;733;0;0;0;0;.00nan;0;0
5946;-1;739;0;0;0;0;.00nan;0;0
5946;66245;733;99;54;3;51;.944;3600000;0
5946;85670;739;81;35;4;31;.886;3544000;0
5947;1957;738;0;0;0;0;.00nan;0;0
5947;184158;738;65;36;4;32;.889;3593000;0
5947;44526;734;64;27;3;24;.889;3600000;0
5947;-1;734;0;0;0;0;.00nan;0;0
5948;31165;752;89;32;2;30;.938;3565000;0
5948;52204;752;0;0;0;0;.00nan;0;0
5948;67294;737;0;0;0;0;.00nan;0;0
5948;76405;737;99;22;0;22;1.000;3600000;0
5949;195887;743;0;0;0;0;.00nan;0;0
5949;180177;736;0;0;0;0;.00nan;0;0
5949;74734;736;97;48;2;46;.958;3542000;0
5949;93324;743;100;25;0;25;1.000;3600000;0
5950;207771;729;0;0;0;0;.00nan;0;0
5950;202839;729;67;31;3;28;.903;3567000;0
5950;56565;741;76;34;2;32;.941;3600000;0
5950;82273;741;0;0;0;0;.00nan;0;0
5951;2643;747;61;25;3;22;.880;3560000;0
5951;199033;747;0;0;0;0;.00nan;0;0
5951;33044;2168;0;0;0;0;.00nan;0;0
5951;49935;2168;78;33;2;31;.939;3600000;0
5952;595;732;87;24;1;23;.958;3600000;0
5952;8505;732;0;0;0;0;.00nan;0;0
5952;193790;740;87;35;2;33;.943;3600000;0
5952;207184;740;0;0;0;0;.00nan;0;0
5953;-1;764;0;0;0;0;.00nan;0;0
5953;78977;764;85;30;2;28;.933;3556000;0
5953;85281;749;0;0;0;0;.00nan;0;0
5953;85661;749;93;37;1;36;.973;3600000;0
5954;3756;744;91;38;2;36;.947;3552000;0
5954;165723;1880;0;0;0;0;.00nan;0;0
5954;196698;744;0;0;0;0;.00nan;0;0
5954;66993;1880;90;19;0;19;1.000;3600000;0
5955;178098;733;0;0;0;0;.00nan;0;0
5955;66245;733;83;56;5;51;.911;3600000;0
5955;85797;3789;0;0;0;0;.00nan;0;0
5955;91742;3789;80;17;1;16;.941;3600000;0
5956;31165;752;70;30;2;28;.933;3600000;0
5956;-1;739;0;0;0;0;.00nan;0;0
5956;52204;752;0;0;0;0;.00nan;0;0
5956;85670;739;38;30;5;25;.833;3600000;0
5957;195887;743;0;0;0;0;.00nan;0;0
5957;-1;742;0;0;0;0;.00nan;0;0
5957;88646;742;67;27;2;25;.926;3600000;0
5957;93324;743;69;44;4;40;.909;3575000;0
5958;2195;748;0;0;0;0;.00nan;0;0
5958;3756;744;77;45;4;41;.911;3553000;0
5958;196698;744;0;0;0;0;.00nan;0;0
5958;67287;748;75;26;2;24;.923;3600000;0
5959;1957;738;0;0;0;0;.00nan;0;0
5959;184158;738;100;32;1;31;.969;3600000;0
5959;56565;741;65;31;4;27;.871;3600000;0
5959;82273;741;0;0;0;0;.00nan;0;0
5960;165723;1880;0;0;0;0;.00nan;0;0
5960;44526;734;79;48;4;44;.917;3600000;0
5960;-1;734;0;0;0;0;.00nan;0;0
5960;66993;1880;90;17;0;17;1.000;3600000;0
5961;3359;751;0;0;0;0;.00nan;0;0
5961;206313;745;29;33;6;27;.818;3250000;0
5961;202104;745;45;6;1;5;.833;350000;0
5961;148788;751;81;42;3;39;.929;3600000;0
5962;193790;740;0;0;0;0;.00nan;0;0
5962;207184;740;68;50;5;45;.900;3600000;0
5962;207771;729;42;22;4;18;.818;3043000;0
5962;202839;729;27;7;3;4;.571;511000;0
5963;595;732;57;20;2;18;.900;3600000;0
5963;8505;732;0;0;0;0;.00nan;0;0
5963;180177;736;0;0;0;0;.00nan;0;0
5963;74734;736;76;41;3;38;.927;3600000;0
5964;195887;743;30;7;3;4;.571;434000;0
5964;67294;737;0;0;0;0;.00nan;0;0
5964;76405;737;64;18;1;17;.944;3600000;0
5964;93324;743;67;28;3;25;.893;3166000;0
5965;31165;752;0;0;0;0;.00nan;0;0
5965;52204;752;91;36;2;34;.944;3554000;0
5965;85281;749;0;0;0;0;.00nan;0;0
5965;85661;749;95;23;0;23;1.000;3600000;0
5966;2195;748;0;0;0;0;.00nan;0;0
5966;206313;745;37;41;6;35;.854;3569000;0
5966;202104;745;0;0;0;0;.00nan;0;0
5966;67287;748;51;24;4;20;.833;3600000;0
5967;3756;744;37;23;5;18;.783;3583000;0
5967;33044;2168;0;0;0;0;.00nan;0;0
5967;196698;744;0;0;0;0;.00nan;0;0
5967;49935;2168;55;31;4;27;.871;3600000;0
5968;3359;751;0;0;0;0;.00nan;0;0
5968;85797;3789;89;35;1;34;.971;3595000;0
5968;91742;3789;0;0;0;0;.00nan;0;0
5968;148788;751;100;37;0;37;1.000;3600000;0
5969;207771;729;45;36;6;30;.833;2827000;0
5969;202839;729;54;5;0;5;1.000;773000;0
5969;-1;739;0;0;0;0;.00nan;0;0
5969;85670;739;89;28;1;27;.964;3600000;0
5970;2643;747;62;32;4;28;.875;3566000;0
5970;199033;747;0;0;0;0;.00nan;0;0
5970;-1;742;0;0;0;0;.00nan;0;0
5970;88646;742;96;50;3;47;.940;3600000;0
5971;178098;733;82;39;3;36;.923;3600000;0
5971;-1;764;0;0;0;0;.00nan;0;0
5971;66245;733;0;0;0;0;.00nan;0;0
5971;78977;764;66;41;4;37;.902;3558000;0
5972;1957;738;0;0;0;0;.00nan;0;0
5972;193790;740;0;0;0;0;.00nan;0;0
5972;184158;738;78;27;2;25;.926;3600000;0
5972;207184;740;60;31;3;28;.903;3552000;0
5973;56565;741;0;0;0;0;.00nan;0;0
5973;67294;737;0;0;0;0;.00nan;0;0
5973;76405;737;74;32;3;29;.906;3600000;0
5973;82273;741;55;35;5;30;.857;3516000;0
5974;165723;1880;0;0;0;0;.00nan;0;0
5974;44526;734;100;31;0;31;1.000;3600000;0
5974;-1;734;0;0;0;0;.00nan;0;0
5974;66993;1880;89;29;1;28;.966;3570000;0
5975;2643;747;28;33;6;27;.818;3600000;0
5975;199033;747;0;0;0;0;.00nan;0;0
5975;195887;743;0;0;0;0;.00nan;0;0
5975;93324;743;80;33;2;31;.939;3600000;0
5976;206313;745;33;33;6;27;.818;2329000;0
5976;33044;2168;74;24;1;23;.958;3600000;0
5976;202104;745;53;11;1;10;.909;1271000;0
5976;49935;2168;0;0;0;0;.00nan;0;0
5977;-1;739;0;0;0;0;.00nan;0;0
5977;85281;749;0;0;0;0;.00nan;0;0
5977;85661;749;85;35;3;32;.914;3600000;0
5977;85670;739;52;33;5;28;.848;3600000;0
5978;178098;733;59;7;0;7;1.000;684000;0
5978;-1;742;0;0;0;0;.00nan;0;0
5978;66245;733;47;43;6;37;.860;2916000;0
5978;88646;742;88;20;1;19;.950;3600000;0
5979;595;732;97;31;2;29;.935;3522000;0
5979;8505;732;0;0;0;0;.00nan;0;0
5979;85797;3789;0;0;0;0;.00nan;0;0
5979;91742;3789;100;34;0;34;1.000;3600000;0
5980;3359;751;0;0;0;0;.00nan;0;0
5980;31165;752;85;34;1;33;.971;3600000;0
5980;52204;752;0;0;0;0;.00nan;0;0
5980;148788;751;70;28;3;25;.893;3560000;0
5981;180177;736;0;0;0;0;.00nan;0;0
5981;207771;729;0;0;0;0;.00nan;0;0
5981;202839;729;80;31;2;29;.935;3677000;0
5981;74734;736;65;30;3;27;.900;3677000;0
5982;2195;748;0;0;0;0;.00nan;0;0
5982;-1;764;0;0;0;0;.00nan;0;0
5982;67287;748;80;25;1;24;.960;3600000;0
5982;78977;764;79;32;2;30;.938;3550000;0
5983;193790;740;0;0;0;0;.00nan;0;0
5983;207184;740;55;27;3;24;.889;3581000;0
5983;44526;734;79;35;2;33;.943;3600000;0
5983;-1;734;0;0;0;0;.00nan;0;0
5984;165723;1880;0;0;0;0;.00nan;0;0
5984;56565;741;68;41;4;37;.902;3571000;0
5984;66993;1880;61;20;2;18;.900;3600000;0
5984;82273;741;0;0;0;0;.00nan;0;0
5985;3756;744;80;25;1;24;.960;3600000;0
5985;196698;744;0;0;0;0;.00nan;0;0
5985;67294;737;0;0;0;0;.00nan;0;0
5985;76405;737;52;23;3;20;.870;3542000;0
5986;195887;743;0;0;0;0;.00nan;0;0
5986;85281;749;0;0;0;0;.00nan;0;0
5986;85661;749;88;30;1;29;.967;3600000;0
5986;93324;743;39;40;7;33;.825;3600000;0
5987;3359;751;0;0;0;0;.00nan;0;0
5987;33044;2168;0;0;0;0;.00nan;0;0
5987;49935;2168;84;40;2;38;.950;3600000;0
5987;148788;751;49;32;5;27;.844;3600000;0
5988;-1;739;0;0;0;0;.00nan;0;0
5988;85670;739;77;43;3;40;.930;3900000;0
5988;85797;3789;0;0;0;0;.00nan;0;0
5988;91742;3789;100;45;3;42;.933;3900000;0
5989;178098;733;89;50;2;48;.960;3583000;0
5989;44526;734;0;0;0;0;.00nan;0;0
5989;-1;734;76;13;0;13;1.000;3600000;0
5989;66245;733;0;0;0;0;.00nan;0;0
5990;2195;748;0;0;0;0;.00nan;0;0
5990;-1;742;0;0;0;0;.00nan;0;0
5990;67287;748;81;42;4;38;.905;3600000;0
5990;88646;742;35;22;5;17;.773;3551000;0
5991;595;732;86;32;2;30;.938;3546000;0
5991;8505;732;0;0;0;0;.00nan;0;0
5991;206313;745;100;37;0;37;1.000;3600000;0
5991;202104;745;0;0;0;0;.00nan;0;0
5992;31165;752;62;32;3;29;.906;3560000;0
5992;207771;729;92;45;2;43;.956;3600000;0
5992;202839;729;0;0;0;0;.00nan;0;0
5992;52204;752;0;0;0;0;.00nan;0;0
5993;1957;738;0;0;0;0;.00nan;0;0
5993;184158;738;82;36;3;33;.917;3600000;0
5993;180177;736;0;0;0;0;.00nan;0;0
5993;74734;736;98;54;4;50;.926;3543000;0
5994;2643;747;91;49;3;46;.939;3600000;0
5994;199033;747;0;0;0;0;.00nan;0;0
5994;-1;764;50;1;0;1;1.000;265000;0
5994;78977;764;37;26;5;21;.808;3335000;0
5996;180110;1880;0;0;0;0;.00nan;0;0
5996;180177;736;48;41;6;35;.854;2860000;0
5996;196715;736;50;9;1;8;.889;740000;0
5996;148573;1880;93;31;1;30;.968;3600000;0
5998;195887;729;0;0;0;0;.00nan;0;0
5998;66993;741;0;0;0;0;.00nan;0;0
5998;82273;741;81;40;3;37;.925;3738000;0
5998;88646;729;52;30;4;26;.867;3738000;0
6000;178098;733;100;38;1;37;.974;3600000;0
6000;207184;734;0;0;0;0;.00nan;0;0
6000;44526;734;87;39;2;37;.949;3564000;0
6000;67122;733;0;0;0;0;.00nan;0;0
6002;2195;748;0;0;0;0;.00nan;0;0
6002;3756;744;100;26;0;26;1.000;3600000;0
6002;193790;744;0;0;0;0;.00nan;0;0
6002;67287;748;67;42;4;38;.905;3600000;0
6004;199033;737;0;0;0;0;.00nan;0;0
6004;8504;737;45;17;3;14;.824;3544000;0
6004;31165;752;0;0;0;0;.00nan;0;0
6004;52204;752;66;25;2;23;.920;3600000;0
6006;841;764;0;0;0;0;.00nan;0;0
6006;190570;3789;0;0;0;0;.00nan;0;0
6006;-1;764;96;51;3;48;.941;3900000;0
6006;85797;3789;53;19;3;16;.842;3900000;0
6008;3359;751;0;0;0;0;.00nan;0;0
6008;198736;749;67;24;2;22;.917;2844000;0
6008;85661;749;26;12;4;8;.667;756000;0
6008;148788;751;20;30;7;23;.767;3600000;0
6010;33044;739;100;26;0;26;1.000;3600000;0
6010;202104;740;81;40;3;37;.925;3600000;0
6010;196698;740;0;0;0;0;.00nan;0;0
6010;-1;739;0;0;0;0;.00nan;0;0
6012;2643;743;94;34;2;32;.941;3900000;0
6012;8505;732;70;29;2;27;.931;3900000;0
6012;195867;732;0;0;0;0;.00nan;0;0
6012;-1;743;0;0;0;0;.00nan;0;0
6014;1957;738;85;36;2;34;.944;3900000;0
6014;-1;745;0;0;0;0;.00nan;0;0
6014;56565;745;100;38;2;36;.947;3900000;0
6014;93324;738;0;0;0;0;.00nan;0;0
6016;-1;747;0;0;0;0;.00nan;0;0
6016;207771;742;0;0;0;0;.00nan;0;0
6016;-1;742;75;24;2;22;.917;3600000;0
6016;76405;747;100;46;1;45;.978;3600000;0
6018;841;764;0;0;0;0;.00nan;0;0
6018;31165;752;97;33;1;32;.970;3600000;0
6018;-1;764;54;32;4;28;.875;3600000;0
6018;52204;752;0;0;0;0;.00nan;0;0
6020;-1;747;0;0;0;0;.00nan;0;0
6020;180110;1880;0;0;0;0;.00nan;0;0
6020;76405;747;68;45;4;41;.911;3590000;0
6020;148573;1880;73;32;3;29;.906;3600000;0
6022;199033;737;0;0;0;0;.00nan;0;0
6022;8504;737;46;25;4;21;.840;3600000;0
6022;-1;2168;72;16;0;16;1.000;1274000;0
6022;49935;2168;38;31;6;25;.806;2326000;0
6024;180177;736;91;32;2;30;.938;3900000;0
6024;196715;736;0;0;0;0;.00nan;0;0
6024;207771;742;62;21;2;19;.905;3900000;0
6024;-1;742;0;0;0;0;.00nan;0;0
6026;195887;729;0;0;0;0;.00nan;0;0
6026;190570;3789;0;0;0;0;.00nan;0;0
6026;85797;3789;96;39;1;38;.974;3900000;0
6026;88646;729;100;32;1;31;.969;3900000;0
6028;1957;738;70;35;3;32;.914;3600000;0
6028;202104;740;0;0;0;0;.00nan;0;0
6028;196698;740;93;24;0;24;1.000;3600000;0
6028;93324;738;0;0;0;0;.00nan;0;0
6030;2195;748;61;28;3;25;.893;3600000;0
6030;33044;739;43;26;5;21;.808;3573000;0
6030;-1;739;0;0;0;0;.00nan;0;0
6030;67287;748;0;0;0;0;.00nan;0;0
6032;3359;751;0;0;0;0;.00nan;0;0
6032;178098;733;67;39;4;35;.897;3600000;0
6032;67122;733;0;0;0;0;.00nan;0;0
6032;148788;751;74;22;1;21;.955;3600000;0
6034;198736;749;0;0;0;0;.00nan;0;0
6034;-1;745;0;0;0;0;.00nan;0;0
6034;56565;745;53;38;5;33;.868;3600000;0
6034;85661;749;75;21;1;20;.952;3600000;0
6036;2643;743;79;22;1;21;.955;3600000;0
6036;3756;744;74;42;3;39;.929;3570000;0
6036;193790;744;0;0;0;0;.00nan;0;0
6036;-1;743;0;0;0;0;.00nan;0;0
6038;8505;732;77;26;1;25;.962;3600000;0
6038;195867;732;0;0;0;0;.00nan;0;0
6038;207184;734;0;0;0;0;.00nan;0;0
6038;44526;734;67;31;3;28;.903;3543000;0
6040;180177;736;0;0;0;0;.00nan;0;0
6040;196715;736;62;29;3;26;.897;3600000;0
6040;-1;2168;0;0;0;0;.00nan;0;0
6040;49935;2168;47;25;5;20;.800;3566000;0
6042;841;764;100;38;0;38;1.000;3600000;0
6042;31165;752;0;0;0;0;.00nan;0;0
6042;-1;764;0;0;0;0;.00nan;0;0
6042;52204;752;75;23;1;22;.957;3600000;0
6044;-1;747;71;33;3;30;.909;3600000;0
6044;207184;734;33;31;5;26;.839;3575000;0
6044;44526;734;0;0;0;0;.00nan;0;0
6044;76405;747;0;0;0;0;.00nan;0;0
6046;8505;732;0;0;0;0;.00nan;0;0
6046;195867;732;64;34;4;30;.882;3600000;0
6046;66993;741;100;32;0;32;1.000;3600000;0
6046;82273;741;0;0;0;0;.00nan;0;0
6048;198736;749;100;29;0;29;1.000;3600000;0
6048;-1;745;76;39;4;35;.897;3600000;0
6048;56565;745;0;0;0;0;.00nan;0;0
6048;85661;749;0;0;0;0;.00nan;0;0
6050;1957;738;0;0;0;0;.00nan;0;0
6050;33044;739;0;0;0;0;.00nan;0;0
6050;-1;739;49;33;4;29;.879;3534000;0
6050;93324;738;57;17;2;15;.882;3600000;0
6052;2195;748;0;0;0;0;.00nan;0;0
6052;178098;733;0;0;0;0;.00nan;0;0
6052;67122;733;76;47;4;43;.915;3858000;0
6052;67287;748;66;30;3;27;.900;3858000;0
6054;180110;1880;47;12;2;10;.833;3600000;0
6054;202104;740;0;0;0;0;.00nan;0;0
6054;196698;740;64;46;5;41;.891;3600000;0
6054;148573;1880;0;0;0;0;.00nan;0;0
6056;3756;744;79;35;3;32;.914;3600000;0
6056;199033;737;71;42;5;37;.881;3570000;0
6056;8504;737;0;0;0;0;.00nan;0;0
6056;193790;744;0;0;0;0;.00nan;0;0
6058;3359;751;47;19;3;16;.842;3584000;0
6058;195887;729;68;25;2;23;.920;3600000;0
6058;88646;729;0;0;0;0;.00nan;0;0
6058;148788;751;0;0;0;0;.00nan;0;0
6060;2643;743;0;0;0;0;.00nan;0;0
6060;190570;3789;62;31;3;28;.903;3580000;0
6060;-1;743;82;30;1;29;.967;3600000;0
6060;85797;3789;0;0;0;0;.00nan;0;0
6062;202104;740;69;36;4;32;.889;3600000;0
6062;196698;740;0;0;0;0;.00nan;0;0
6062;207771;742;59;20;3;17;.850;3600000;0
6062;-1;742;0;0;0;0;.00nan;0;0
6064;1957;738;78;36;3;33;.917;3558000;0
6064;190570;3789;0;0;0;0;.00nan;0;0
6064;85797;3789;72;19;1;18;.947;3600000;0
6064;93324;738;0;0;0;0;.00nan;0;0
6066;841;764;56;24;4;20;.833;3900000;0
6066;178098;733;94;46;4;42;.913;3900000;0
6066;-1;764;0;0;0;0;.00nan;0;0
6066;67122;733;0;0;0;0;.00nan;0;0
6068;3756;744;61;19;2;17;.895;3600000;0
6068;193790;744;0;0;0;0;.00nan;0;0
6068;-1;745;0;0;0;0;.00nan;0;0
6068;56565;745;40;33;5;28;.848;3600000;0
6070;198736;749;77;38;3;35;.921;3600000;0
6070;31165;752;0;0;0;0;.00nan;0;0
6070;52204;752;57;29;4;25;.862;3587000;0
6070;85661;749;0;0;0;0;.00nan;0;0
6072;2195;748;0;0;0;0;.00nan;0;0
6072;180177;736;79;28;2;26;.929;3542000;0
6072;196715;736;0;0;0;0;.00nan;0;0
6072;67287;748;100;26;0;26;1.000;3600000;0
6074;33044;739;49;32;5;27;.844;3600000;0
6074;207184;734;0;0;0;0;.00nan;0;0
6074;44526;734;54;44;6;38;.864;3566000;0
6074;-1;739;0;0;0;0;.00nan;0;0
6076;-1;747;0;0;0;0;.00nan;0;0
6076;195887;729;0;0;0;0;.00nan;0;0
6076;76405;747;87;47;3;44;.936;3600000;0
6076;88646;729;70;33;4;29;.879;3575000;0
6078;3359;751;0;0;0;0;.00nan;0;0
6078;180110;1880;0;0;0;0;.00nan;0;0
6078;148573;1880;69;32;4;28;.875;3573000;0
6078;148788;751;71;34;3;31;.912;3600000;0
6080;199033;737;0;0;0;0;.00nan;0;0
6080;8504;737;99;35;1;34;.971;3600000;0
6080;66993;741;74;33;3;30;.909;3548000;0
6080;82273;741;0;0;0;0;.00nan;0;0
6082;2643;743;100;40;2;38;.950;3600000;0
6082;8505;732;43;26;4;22;.846;3519000;0
6082;195867;732;0;0;0;0;.00nan;0;0
6082;-1;743;0;0;0;0;.00nan;0;0
6084;180110;1880;74;29;2;27;.931;3900000;0
6084;66993;741;0;0;0;0;.00nan;0;0
6084;82273;741;100;44;2;42;.955;3900000;0
6084;148573;1880;0;0;0;0;.00nan;0;0
6086;841;764;0;0;0;0;.00nan;0;0
6086;1957;738;0;0;0;0;.00nan;0;0
6086;-1;764;69;27;2;25;.926;3600000;0
6086;93324;738;76;46;4;42;.913;3556000;0
6088;31165;752;54;24;4;20;.833;3562000;0
6088;207184;734;80;40;2;38;.950;3600000;0
6088;44526;734;0;0;0;0;.00nan;0;0
6088;52204;752;0;0;0;0;.00nan;0;0
6090;190570;3789;100;24;0;24;1.000;3600000;0
6090;202104;740;0;0;0;0;.00nan;0;0
6090;196698;740;77;24;1;23;.958;3571000;0
6090;85797;3789;0;0;0;0;.00nan;0;0
6092;2195;748;0;0;0;0;.00nan;0;0
6092;-1;2168;0;0;0;0;.00nan;0;0
6092;49935;2168;93;33;1;32;.970;3900000;0
6092;67287;748;81;29;1;28;.966;3900000;0
6094;199033;737;72;29;2;27;.931;3667000;0
6094;8504;737;0;0;0;0;.00nan;0;0
6094;207771;742;0;0;0;0;.00nan;0;0
6094;-1;742;100;49;1;48;.980;3667000;0
6096;3359;751;60;22;3;19;.864;3600000;0
6096;-1;747;54;33;4;29;.879;3600000;0
6096;76405;747;0;0;0;0;.00nan;0;0
6096;148788;751;0;0;0;0;.00nan;0;0
6098;3756;744;0;0;0;0;.00nan;0;0
6098;193790;744;91;18;0;18;1.000;3600000;0
6098;-1;745;0;0;0;0;.00nan;0;0
6098;56565;745;87;43;3;40;.930;3600000;0
6100;178098;733;0;0;0;0;.00nan;0;0
6100;33044;739;0;0;0;0;.00nan;0;0
6100;-1;739;77;27;1;26;.963;3600000;0
6100;67122;733;55;41;5;36;.878;3600000;0
6102;198736;749;0;0;0;0;.00nan;0;0
6102;180177;736;0;0;0;0;.00nan;0;0
6102;196715;736;58;42;5;37;.881;3600000;0
6102;85661;749;69;25;2;23;.920;3600000;0
6104;2643;743;0;0;0;0;.00nan;0;0
6104;8505;732;65;24;2;22;.917;3600000;0
6104;195867;732;0;0;0;0;.00nan;0;0
6104;-1;743;76;40;3;37;.925;3600000;0
6106;841;764;0;0;0;0;.00nan;0;0
6106;3359;751;0;0;0;0;.00nan;0;0
6106;-1;764;56;35;4;31;.886;3586000;0
6106;148788;751;76;29;2;27;.931;3600000;0
6108;2195;748;0;0;0;0;.00nan;0;0
6108;207771;742;77;29;2;27;.931;3563000;0
6108;-1;742;0;0;0;0;.00nan;0;0
6108;67287;748;100;29;0;29;1.000;3600000;0
6110;3756;744;0;0;0;0;.00nan;0;0
6110;193790;744;57;13;1;12;.923;3600000;0
6110;66993;741;53;33;5;28;.848;3600000;0
6110;82273;741;0;0;0;0;.00nan;0;0
6112;180177;736;73;35;3;32;.914;3558000;0
6112;196715;736;0;0;0;0;.00nan;0;0
6112;-1;2168;0;0;0;0;.00nan;0;0
6112;49935;2168;82;30;1;29;.967;3600000;0
6114;1957;738;48;36;5;31;.861;2188000;0
6114;195887;729;0;0;0;0;.00nan;0;0
6114;88646;729;49;16;2;14;.875;3600000;0
6114;93324;738;54;18;2;16;.889;1412000;0
6116;2643;743;86;33;2;31;.939;3900000;0
6116;8505;732;92;35;2;33;.943;3900000;0
6116;195867;732;0;0;0;0;.00nan;0;0
6116;-1;743;0;0;0;0;.00nan;0;0
6118;198736;749;0;0;0;0;.00nan;0;0
6118;178098;733;0;0;0;0;.00nan;0;0
6118;67122;733;67;45;4;41;.911;3600000;0
6118;85661;749;85;26;1;25;.962;3600000;0
6120;199033;737;0;0;0;0;.00nan;0;0
6120;8504;737;59;32;4;28;.875;3600000;0
6120;190570;3789;77;37;3;34;.919;3600000;0
6120;85797;3789;0;0;0;0;.00nan;0;0
6122;202104;740;49;22;3;19;.864;3600000;0
6122;196698;740;0;0;0;0;.00nan;0;0
6122;-1;745;0;0;0;0;.00nan;0;0
6122;56565;745;70;30;2;28;.933;3600000;0
6124;-1;747;0;0;0;0;.00nan;0;0
6124;33044;739;75;31;2;29;.935;3632000;0
6124;-1;739;0;0;0;0;.00nan;0;0
6124;76405;747;75;34;3;31;.912;3632000;0
6126;180110;1880;0;0;0;0;.00nan;0;0
6126;207184;734;0;0;0;0;.00nan;0;0
6126;44526;734;64;35;4;31;.886;3600000;0
6126;148573;1880;47;23;3;20;.870;3600000;0
6128;199033;737;86;32;1;31;.969;3600000;0
6128;8504;737;0;0;0;0;.00nan;0;0
6128;195887;729;0;0;0;0;.00nan;0;0
6128;88646;729;74;31;2;29;.935;3581000;0
6130;3359;751;55;36;5;31;.861;3600000;0
6130;31165;752;0;0;0;0;.00nan;0;0
6130;52204;752;86;34;3;31;.912;3600000;0
6130;148788;751;0;0;0;0;.00nan;0;0
6132;190570;3789;0;0;0;0;.00nan;0;0
6132;202104;740;0;0;0;0;.00nan;0;0
6132;196698;740;91;41;2;39;.951;3600000;0
6132;85797;3789;41;21;4;17;.810;3544000;0
6134;8505;732;0;0;0;0;.00nan;0;0
6134;195867;732;75;16;0;16;1.000;3600000;0
6134;207771;742;0;0;0;0;.00nan;0;0
6134;-1;742;90;42;3;39;.929;3600000;0
6136;2195;748;0;0;0;0;.00nan;0;0
6136;-1;747;99;43;1;42;.977;3600000;0
6136;67287;748;51;24;4;20;.833;3600000;0
6136;76405;747;0;0;0;0;.00nan;0;0
6138;841;764;55;36;5;31;.861;3556000;0
6138;-1;764;0;0;0;0;.00nan;0;0
6138;-1;2168;0;0;0;0;.00nan;0;0
6138;49935;2168;52;22;4;18;.818;3600000;0
6140;1957;738;53;37;5;32;.865;3589000;0
6140;3756;744;61;28;3;25;.893;3600000;0
6140;193790;744;0;0;0;0;.00nan;0;0
6140;93324;738;0;0;0;0;.00nan;0;0
6142;2643;743;0;0;0;0;.00nan;0;0
6142;-1;743;72;31;2;29;.935;3900000;0
6142;66993;741;0;0;0;0;.00nan;0;0
6142;82273;741;78;29;2;27;.931;3899000;0
6144;33044;739;0;0;0;0;.00nan;0;0
6144;207184;734;55;27;3;24;.889;3600000;0
6144;44526;734;0;0;0;0;.00nan;0;0
6144;-1;739;56;27;4;23;.852;3558000;0
6146;180110;1880;60;14;1;13;.929;3600000;0
6146;180177;736;0;0;0;0;.00nan;0;0
6146;196715;736;71;49;5;44;.898;3600000;0
6146;148573;1880;0;0;0;0;.00nan;0;0
6148;198736;749;72;30;3;27;.900;3826000;0
6148;178098;733;68;46;4;42;.913;3826000;0
6148;67122;733;0;0;0;0;.00nan;0;0
6148;85661;749;0;0;0;0;.00nan;0;0
6149;179602;564;89;19;0;19;1.000;3600000;0
6149;57993;569;0;0;0;0;.00nan;0;0
6149;78251;564;0;0;0;0;.00nan;0;0
6149;141419;569;95;37;1;36;.973;3600000;0
6150;1601;573;67;33;2;31;.939;3900000;0
6150;11925;576;0;0;0;0;.00nan;0;0
6150;67454;576;70;27;2;25;.926;3900000;0
6150;84945;573;0;0;0;0;.00nan;0;0
6151;320;562;65;40;5;35;.875;3600000;0
6151;56126;568;0;0;0;0;.00nan;0;0
6151;64800;568;70;15;1;14;.933;3600000;0
6151;155917;562;0;0;0;0;.00nan;0;0
6152;65014;570;0;0;0;0;.00nan;0;0
6152;67614;570;86;32;2;30;.938;3600000;0
6152;91403;577;0;0;0;0;.00nan;0;0
6152;143829;577;60;31;3;28;.903;3578000;0
6153;6541;571;0;0;0;0;.00nan;0;0
6153;13065;578;80;34;2;32;.941;3554000;0
6153;35520;578;0;0;0;0;.00nan;0;0
6153;90734;571;86;28;1;27;.964;3600000;0
6154;14191;574;0;0;0;0;.00nan;0;0
6154;169493;572;0;0;0;0;.00nan;0;0
6154;170144;574;88;41;3;38;.927;3575000;0
6154;68167;572;93;40;2;38;.950;3600000;0
6155;6127;575;46;25;4;21;.840;3568000;0
6155;7063;566;83;33;2;31;.939;3600000;0
6155;185232;575;0;0;0;0;.00nan;0;0
6155;44405;566;0;0;0;0;.00nan;0;0
6156;1601;573;0;0;0;0;.00nan;0;0
6156;57993;569;0;0;0;0;.00nan;0;0
6156;84945;573;67;29;3;26;.897;3600000;0
6156;141419;569;61;45;5;40;.889;3513000;0
6157;179602;564;0;0;0;0;.00nan;0;0
6157;65014;570;86;42;3;39;.929;3557000;0
6157;67614;570;0;0;0;0;.00nan;0;0
6157;78251;564;49;12;2;10;.833;3600000;0
6158;320;562;0;0;0;0;.00nan;0;0
6158;13065;578;100;29;0;29;1.000;3600000;0
6158;35520;578;0;0;0;0;.00nan;0;0
6158;155917;562;86;40;2;38;.950;3600000;0
6159;7063;566;0;0;0;0;.00nan;0;0
6159;185220;565;0;0;0;0;.00nan;0;0
6159;44405;566;100;39;1;38;.974;3600000;0
6159;84430;565;74;34;2;32;.941;3544000;0
6160;11925;576;82;19;1;18;.947;3600000;0
6160;169493;572;0;0;0;0;.00nan;0;0
6160;67454;576;0;0;0;0;.00nan;0;0
6160;68167;572;74;35;3;32;.914;3587000;0
6161;6541;571;0;0;0;0;.00nan;0;0
6161;11925;576;67;24;2;22;.917;3596000;0
6161;67454;576;0;0;0;0;.00nan;0;0
6161;90734;571;84;24;1;23;.958;3600000;0
6162;1601;573;0;0;0;0;.00nan;0;0
6162;179602;564;34;14;3;11;.786;3600000;0
6162;78251;564;0;0;0;0;.00nan;0;0
6162;84945;573;100;35;0;35;1.000;3600000;0
6163;56126;568;94;22;0;22;1.000;3600000;0
6163;64800;568;0;0;0;0;.00nan;0;0
6163;91403;577;67;20;2;18;.900;3525000;0
6163;143829;577;0;0;0;0;.00nan;0;0
6164;320;562;42;36;6;30;.833;3600000;0
6164;13065;578;68;19;1;18;.947;3600000;0
6164;35520;578;0;0;0;0;.00nan;0;0
6164;155917;562;0;0;0;0;.00nan;0;0
6165;185220;565;0;0;0;0;.00nan;0;0
6165;57993;569;0;0;0;0;.00nan;0;0
6165;84430;565;44;25;4;21;.840;3600000;0
6165;141419;569;92;19;0;19;1.000;3600000;0
6166;6127;575;86;39;2;37;.949;3600000;0
6166;14191;574;0;0;0;0;.00nan;0;0
6166;170144;574;63;31;3;28;.903;3570000;0
6166;185232;575;0;0;0;0;.00nan;0;0
6167;169493;572;91;34;2;32;.941;3900000;0
6167;65014;570;81;29;2;27;.931;3900000;0
6167;67614;570;0;0;0;0;.00nan;0;0
6167;68167;572;0;0;0;0;.00nan;0;0
6168;179602;564;88;18;0;18;1.000;3600000;0
6168;56126;568;0;0;0;0;.00nan;0;0
6168;64800;568;93;42;2;40;.952;3553000;0
6168;78251;564;0;0;0;0;.00nan;0;0
6169;320;562;23;30;6;24;.800;2573000;0
6169;185220;565;58;19;2;17;.895;3600000;0
6169;84430;565;0;0;0;0;.00nan;0;0
6169;155917;562;62;11;0;11;1.000;1027000;0
6170;7063;566;0;0;0;0;.00nan;0;0
6170;44405;566;86;42;3;39;.929;3600000;0
6170;91403;577;0;0;0;0;.00nan;0;0
6170;143829;577;51;26;4;22;.846;3547000;0
6171;6127;575;82;45;3;42;.933;3568000;0
6171;185232;575;0;0;0;0;.00nan;0;0
6171;64961;571;0;0;0;0;.00nan;0;0
6171;90734;571;78;26;2;24;.923;3600000;0
6172;14191;574;0;0;0;0;.00nan;0;0
6172;170144;574;84;29;2;27;.931;3900000;0
6172;65014;570;73;32;2;30;.938;3900000;0
6172;67614;570;0;0;0;0;.00nan;0;0
6173;1601;573;0;0;0;0;.00nan;0;0
6173;57993;569;93;39;1;38;.974;3600000;0
6173;84945;573;54;18;3;15;.833;3512000;0
6173;141419;569;0;0;0;0;.00nan;0;0
6174;11925;576;73;21;1;20;.952;3600000;0
6174;13065;578;0;0;0;0;.00nan;0;0
6174;35520;578;98;57;3;54;.947;3538000;0
6174;67454;576;0;0;0;0;.00nan;0;0
6175;11925;576;0;0;0;0;.00nan;0;0
6175;56126;568;0;0;0;0;.00nan;0;0
6175;64800;568;61;12;1;11;.917;3600000;0
6175;67454;576;49;29;4;25;.862;3600000;0
6176;179602;564;80;13;0;13;1.000;3600000;0
6176;185220;565;0;0;0;0;.00nan;0;0
6176;78251;564;0;0;0;0;.00nan;0;0
6176;84430;565;55;43;5;38;.884;3600000;0
6177;1601;573;48;32;4;28;.875;3568000;0
6177;6127;575;100;42;2;40;.952;3600000;0
6177;185232;575;0;0;0;0;.00nan;0;0
6177;84945;573;0;0;0;0;.00nan;0;0
6178;57993;569;0;0;0;0;.00nan;0;0
6178;64961;571;0;0;0;0;.00nan;0;0
6178;90734;571;93;21;0;21;1.000;3600000;0
6178;141419;569;97;49;1;48;.980;3600000;0
6179;320;562;0;0;0;0;.00nan;0;0
6179;169493;572;0;0;0;0;.00nan;0;0
6179;68167;572;81;24;0;24;1.000;3900000;0
6179;155917;562;100;30;0;30;1.000;3900000;0
6180;11925;576;30;14;4;10;.714;1162000;0
6180;179602;564;93;17;0;17;1.000;3600000;0
6180;67454;576;56;24;3;21;.875;2438000;0
6180;78251;564;0;0;0;0;.00nan;0;0
6181;320;562;34;30;6;24;.800;2673000;0
6181;91403;577;0;0;0;0;.00nan;0;0
6181;143829;577;65;16;1;15;.938;3600000;0
6181;155917;562;45;15;2;13;.867;927000;0
6182;14191;574;0;0;0;0;.00nan;0;0
6182;170144;574;68;18;1;17;.944;3600000;0
6182;57993;569;58;37;4;33;.892;3600000;0
6182;141419;569;0;0;0;0;.00nan;0;0
6183;6127;575;0;0;0;0;.00nan;0;0
6183;185232;575;91;19;0;19;1.000;3600000;0
6183;56126;568;0;0;0;0;.00nan;0;0
6183;64800;568;71;23;1;22;.957;3544000;0
6184;13065;578;91;34;1;33;.971;3600000;0
6184;169493;572;0;0;0;0;.00nan;0;0
6184;35520;578;0;0;0;0;.00nan;0;0
6184;68167;572;75;33;2;31;.939;3558000;0
6185;7063;566;0;0;0;0;.00nan;0;0
6185;44405;566;70;31;2;29;.935;3807000;0
6185;64961;571;0;0;0;0;.00nan;0;0
6185;90734;571;73;31;3;28;.903;3807000;0
6186;1601;573;0;0;0;0;.00nan;0;0
6186;65014;570;64;39;4;35;.897;3600000;0
6186;67614;570;0;0;0;0;.00nan;0;0
6186;84945;573;78;27;1;26;.963;3600000;0
6187;1601;573;0;0;0;0;.00nan;0;0
6187;64961;571;0;0;0;0;.00nan;0;0
6187;84945;573;95;37;2;35;.946;3900000;0
6187;90734;571;73;33;2;31;.939;3900000;0
6188;179602;564;67;26;2;24;.923;3600000;0
6188;78251;564;0;0;0;0;.00nan;0;0
6188;91403;577;75;40;3;37;.925;3565000;0
6188;143829;577;0;0;0;0;.00nan;0;0
6189;185220;565;49;1;0;1;1.000;248000;0
6189;56126;568;0;0;0;0;.00nan;0;0
6189;64800;568;61;28;4;24;.857;3600000;0
6189;84430;565;38;33;6;27;.818;3296000;0
6190;320;562;0;0;0;0;.00nan;0;0
6190;7063;566;0;0;0;0;.00nan;0;0
6190;44405;566;76;26;2;24;.923;3600000;0
6190;155917;562;72;34;3;31;.912;3573000;0
6191;6127;575;0;0;0;0;.00nan;0;0
6191;185232;575;81;27;1;26;.963;3600000;0
6191;57993;569;0;0;0;0;.00nan;0;0
6191;141419;569;91;34;2;32;.941;3555000;0
6192;14191;574;0;0;0;0;.00nan;0;0
6192;169493;572;78;19;0;19;1.000;1437000;0
6192;170144;574;63;25;3;22;.880;3600000;0
6192;68167;572;28;23;5;18;.783;2126000;0
6193;1601;573;0;0;0;0;.00nan;0;0
6193;7063;566;30;31;6;25;.806;3600000;0
6193;44405;566;0;0;0;0;.00nan;0;0
6193;84945;573;100;31;0;31;1.000;3600000;0
6194;1601;573;0;0;0;0;.00nan;0;0
6194;185220;565;0;0;0;0;.00nan;0;0
6194;84430;565;71;39;5;34;.872;3600000;0
6194;84945;573;100;44;1;43;.977;3600000;0
6195;64961;571;0;0;0;0;.00nan;0;0
6195;90734;571;87;37;2;35;.946;3900000;0
6195;91403;577;0;0;0;0;.00nan;0;0
6195;143829;577;67;29;2;27;.931;3890000;0
6196;13065;578;72;51;5;46;.902;3600000;0
6196;14191;574;0;0;0;0;.00nan;0;0
6196;170144;574;100;22;0;22;1.000;3600000;0
6196;35520;578;0;0;0;0;.00nan;0;0
6197;320;562;66;29;3;26;.897;3544000;0
6197;57993;569;0;0;0;0;.00nan;0;0
6197;141419;569;67;24;2;22;.917;3600000;0
6197;155917;562;0;0;0;0;.00nan;0;0
6198;6127;575;59;33;5;28;.848;3600000;0
6198;169493;572;0;0;0;0;.00nan;0;0
6198;185232;575;0;0;0;0;.00nan;0;0
6198;68167;572;99;41;1;40;.976;3600000;0
6199;11925;576;0;0;0;0;.00nan;0;0
6199;65014;570;76;27;2;25;.926;3600000;0
6199;67454;576;74;33;3;30;.909;3600000;0
6199;67614;570;0;0;0;0;.00nan;0;0
6200;11925;576;81;21;1;20;.952;3544000;0
6200;65014;570;0;0;0;0;.00nan;0;0
6200;67454;576;0;0;0;0;.00nan;0;0
6200;67614;570;85;19;0;19;1.000;3600000;0
6201;6127;575;0;0;0;0;.00nan;0;0
6201;185220;565;66;30;3;27;.900;3543000;0
6201;185232;575;80;28;2;26;.929;3600000;0
6201;84430;565;0;0;0;0;.00nan;0;0
6202;13065;578;0;0;0;0;.00nan;0;0
6202;35520;578;66;31;3;28;.903;3591000;0
6202;91403;577;89;29;1;28;.966;3600000;0
6202;143829;577;0;0;0;0;.00nan;0;0
6203;7063;566;0;0;0;0;.00nan;0;0
6203;179602;564;70;21;1;20;.952;3600000;0
6203;44405;566;90;44;2;42;.955;3590000;0
6203;78251;564;0;0;0;0;.00nan;0;0
6204;169493;572;0;0;0;0;.00nan;0;0
6204;56126;568;0;0;0;0;.00nan;0;0
6204;64800;568;50;18;3;15;.833;3552000;0
6204;68167;572;92;45;2;43;.956;3600000;0
6205;57993;569;49;23;3;20;.870;3576000;0
6205;64961;571;61;21;2;19;.905;3600000;0
6205;90734;571;0;0;0;0;.00nan;0;0
6205;141419;569;0;0;0;0;.00nan;0;0
6206;7063;566;0;0;0;0;.00nan;0;0
6206;44405;566;71;27;2;25;.926;3568000;0
6206;57993;569;0;0;0;0;.00nan;0;0
6206;141419;569;100;24;0;24;1.000;3600000;0
6207;11925;576;72;29;2;27;.931;3586000;0
6207;67454;576;0;0;0;0;.00nan;0;0
6207;91403;577;0;0;0;0;.00nan;0;0
6207;143829;577;96;36;1;35;.972;3600000;0
6208;320;562;52;34;4;30;.882;3600000;0
6208;6127;575;87;15;0;15;1.000;3600000;0
6208;185232;575;0;0;0;0;.00nan;0;0
6208;155917;562;0;0;0;0;.00nan;0;0
6209;179602;564;82;16;0;16;1.000;3600000;0
6209;65014;570;0;0;0;0;.00nan;0;0
6209;67614;570;62;38;4;34;.895;3600000;0
6209;78251;564;0;0;0;0;.00nan;0;0
6210;169493;572;0;0;0;0;.00nan;0;0
6210;185220;565;0;0;0;0;.00nan;0;0
6210;68167;572;25;26;6;20;.769;3552000;0
6210;84430;565;60;31;4;27;.871;3600000;0
6211;1601;573;0;0;0;0;.00nan;0;0
6211;14191;574;0;0;0;0;.00nan;0;0
6211;170144;574;100;39;1;38;.974;3600000;0
6211;84945;573;87;40;2;38;.950;3600000;0
6212;13065;578;44;32;5;27;.844;3575000;0
6212;35520;578;0;0;0;0;.00nan;0;0
6212;57993;569;0;0;0;0;.00nan;0;0
6212;141419;569;60;39;4;35;.897;3600000;0
6213;169493;572;0;0;0;0;.00nan;0;0
6213;64961;571;0;0;0;0;.00nan;0;0
6213;68167;572;81;35;2;33;.943;3545000;0
6213;90734;571;84;10;0;10;1.000;3600000;0
6214;320;562;85;47;3;44;.936;3600000;0
6214;179602;564;80;15;0;15;1.000;3600000;0
6214;78251;564;0;0;0;0;.00nan;0;0
6214;155917;562;0;0;0;0;.00nan;0;0
6215;7063;566;0;0;0;0;.00nan;0;0
6215;44405;566;29;30;7;23;.767;3600000;0
6215;56126;568;0;0;0;0;.00nan;0;0
6215;64800;568;61;17;1;16;.941;3600000;0
6216;6127;575;60;26;3;23;.885;3600000;0
6216;185232;575;0;0;0;0;.00nan;0;0
6216;65014;570;25;28;7;21;.750;3600000;0
6216;67614;570;0;0;0;0;.00nan;0;0
6217;11925;576;46;36;6;30;.833;3600000;0
6217;185220;565;0;0;0;0;.00nan;0;0
6217;67454;576;0;0;0;0;.00nan;0;0
6217;84430;565;87;29;1;28;.966;3600000;0
6218;13065;578;78;38;3;35;.921;3600000;0
6218;179602;564;83;15;0;15;1.000;3600000;0
6218;35520;578;0;0;0;0;.00nan;0;0
6218;78251;564;0;0;0;0;.00nan;0;0
6219;320;562;76;21;0;21;1.000;1617000;0
6219;1601;573;99;20;0;20;1.000;3600000;0
6219;84945;573;0;0;0;0;.00nan;0;0
6219;155917;562;20;30;7;23;.767;1983000;0
6220;169493;572;0;0;0;0;.00nan;0;0
6220;56126;568;85;14;0;14;1.000;3600000;0
6220;64800;568;0;0;0;0;.00nan;0;0
6220;68167;572;90;44;3;41;.932;3600000;0
6221;14191;574;0;0;0;0;.00nan;0;0
6221;170144;574;100;28;0;28;1.000;3600000;0
6221;91403;577;0;0;0;0;.00nan;0;0
6221;143829;577;62;35;4;31;.886;3600000;0
6222;57993;569;0;0;0;0;.00nan;0;0
6222;65014;570;0;0;0;0;.00nan;0;0
6222;67614;570;79;38;2;36;.947;3900000;0
6222;141419;569;69;28;2;26;.929;3900000;0
6223;6127;575;0;0;0;0;.00nan;0;0
6223;7063;566;86;50;4;46;.920;3600000;0
6223;185232;575;93;21;0;21;1.000;3600000;0
6223;44405;566;0;0;0;0;.00nan;0;0
6224;320;562;98;18;0;18;1.000;3600000;0
6224;11925;576;0;0;0;0;.00nan;0;0
6224;67454;576;61;32;3;29;.906;3600000;0
6224;155917;562;0;0;0;0;.00nan;0;0
6225;179602;564;90;24;1;23;.958;3600000;0
6225;185220;565;0;0;0;0;.00nan;0;0
6225;78251;564;0;0;0;0;.00nan;0;0
6225;84430;565;40;35;6;29;.829;3600000;0
6226;13065;578;72;37;4;33;.892;3572000;0
6226;14191;574;0;0;0;0;.00nan;0;0
6226;170144;574;69;31;3;28;.903;3600000;0
6226;35520;578;0;0;0;0;.00nan;0;0
6227;64961;571;0;0;0;0;.00nan;0;0
6227;65014;570;67;35;4;31;.886;3600000;0
6227;67614;570;0;0;0;0;.00nan;0;0
6227;90734;571;85;25;1;24;.960;3600000;0
6228;14191;574;0;0;0;0;.00nan;0;0
6228;170144;574;75;42;5;37;.881;3649000;0
6228;185220;565;58;34;4;30;.882;3649000;0
6228;84430;565;0;0;0;0;.00nan;0;0
6229;1601;573;0;0;0;0;.00nan;0;0
6229;11925;576;86;34;2;32;.941;3570000;0
6229;67454;576;0;0;0;0;.00nan;0;0
6229;84945;573;75;23;1;22;.957;3600000;0
6230;179602;564;77;29;2;27;.931;3600000;0
6230;56126;568;78;47;5;42;.894;3600000;0
6230;64800;568;0;0;0;0;.00nan;0;0
6230;78251;564;0;0;0;0;.00nan;0;0
6231;320;562;94;39;1;38;.974;3900000;0
6231;65014;570;64;20;1;19;.950;3900000;0
6231;67614;570;0;0;0;0;.00nan;0;0
6231;155917;562;0;0;0;0;.00nan;0;0
6232;57993;569;0;0;0;0;.00nan;0;0
6232;91403;577;0;0;0;0;.00nan;0;0
6232;141419;569;100;61;0;61;1.000;3600000;0
6232;143829;577;62;14;2;12;.857;3550000;0
6233;7063;566;0;0;0;0;.00nan;0;0
6233;169493;572;0;0;0;0;.00nan;0;0
6233;44405;566;61;28;4;24;.857;3600000;0
6233;68167;572;86;24;1;23;.958;3600000;0
6234;11925;576;78;27;1;26;.963;3600000;0
6234;179602;564;73;27;2;25;.926;3600000;0
6234;67454;576;0;0;0;0;.00nan;0;0
6234;78251;564;0;0;0;0;.00nan;0;0
6235;185220;565;0;0;0;0;.00nan;0;0
6235;64961;571;0;0;0;0;.00nan;0;0
6235;84430;565;81;30;2;28;.933;3668000;0
6235;90734;571;89;42;3;39;.929;3668000;0
6236;6127;575;0;0;0;0;.00nan;0;0
6236;14191;574;97;36;1;35;.972;3600000;0
6236;170144;574;0;0;0;0;.00nan;0;0
6236;185232;575;52;27;3;24;.889;3538000;0
6237;1601;573;0;0;0;0;.00nan;0;0
6237;13065;578;0;0;0;0;.00nan;0;0
6237;35520;578;73;45;4;41;.911;3511000;0
6237;84945;573;65;23;2;21;.913;3600000;0
6238;320;562;0;0;0;0;.00nan;0;0
6238;7063;566;76;32;2;30;.938;3900000;0
6238;44405;566;0;0;0;0;.00nan;0;0
6238;155917;562;74;33;2;31;.939;3900000;0
6239;57993;569;0;0;0;0;.00nan;0;0
6239;65014;570;0;0;0;0;.00nan;0;0
6239;67614;570;100;28;0;28;1.000;3600000;0
6239;141419;569;46;41;7;34;.829;3600000;0
6240;56126;568;0;0;0;0;.00nan;0;0
6240;64800;568;100;22;0;22;1.000;3600000;0
6240;91403;577;56;37;6;31;.838;3600000;0
6240;143829;577;0;0;0;0;.00nan;0;0
6241;320;562;56;29;3;26;.897;3900000;0
6241;64961;571;0;0;0;0;.00nan;0;0
6241;90734;571;67;28;3;25;.893;3900000;0
6241;155917;562;0;0;0;0;.00nan;0;0
6242;11925;576;71;29;2;27;.931;3559000;0
6242;185220;565;0;0;0;0;.00nan;0;0
6242;67454;576;0;0;0;0;.00nan;0;0
6242;84430;565;73;21;1;20;.952;3600000;0
6243;14191;574;0;0;0;0;.00nan;0;0
6243;170144;574;97;35;1;34;.971;3761000;0
6243;56126;568;0;0;0;0;.00nan;0;0
6243;64800;568;73;24;2;22;.917;3761000;0
6244;179602;564;69;32;3;29;.906;3565000;0
6244;64961;571;0;0;0;0;.00nan;0;0
6244;78251;564;0;0;0;0;.00nan;0;0
6244;90734;571;76;26;2;24;.923;3600000;0
6245;320;562;62;45;5;40;.889;3600000;0
6245;91403;577;0;0;0;0;.00nan;0;0
6245;143829;577;68;20;1;19;.950;3600000;0
6245;155917;562;0;0;0;0;.00nan;0;0
6246;6127;575;91;36;1;35;.972;3841000;0
6246;185232;575;0;0;0;0;.00nan;0;0
6246;57993;569;0;0;0;0;.00nan;0;0
6246;141419;569;94;49;2;47;.959;3841000;0
6247;7063;566;0;0;0;0;.00nan;0;0
6247;13065;578;80;37;3;34;.919;3600000;0
6247;35520;578;0;0;0;0;.00nan;0;0
6247;44405;566;100;26;0;26;1.000;3600000;0
6248;185220;565;43;21;3;18;.857;3561000;0
6248;65014;570;0;0;0;0;.00nan;0;0
6248;67614;570;57;22;2;20;.909;3600000;0
6248;84430;565;0;0;0;0;.00nan;0;0
6249;6127;575;57;30;4;26;.867;3600000;0
6249;179602;564;74;20;1;19;.950;3600000;0
6249;185232;575;0;0;0;0;.00nan;0;0
6249;78251;564;0;0;0;0;.00nan;0;0
6250;43896;573;0;0;0;0;.00nan;0;0
6250;84945;573;42;29;4;25;.862;3600000;0
6250;91403;577;86;19;0;19;1.000;3600000;0
6250;143829;577;0;0;0;0;.00nan;0;0
6251;7063;566;0;0;0;0;.00nan;0;0
6251;14191;574;0;0;0;0;.00nan;0;0
6251;170144;574;74;31;2;29;.935;3600000;0
6251;44405;566;51;24;4;20;.833;3574000;0
6252;56126;568;0;0;0;0;.00nan;0;0
6252;57993;569;0;0;0;0;.00nan;0;0
6252;64800;568;75;19;1;18;.947;3600000;0
6252;141419;569;98;61;4;57;.934;3600000;0
6253;13065;578;0;0;0;0;.00nan;0;0
6253;35520;578;49;29;4;25;.862;3545000;0
6253;65014;570;78;38;3;35;.921;3600000;0
6253;67614;570;0;0;0;0;.00nan;0;0
6254;169493;572;0;0;0;0;.00nan;0;0
6254;64961;571;0;0;0;0;.00nan;0;0
6254;68167;572;78;46;4;42;.913;3600000;0
6254;90734;571;36;24;5;19;.792;3582000;0
6255;169493;572;88;63;5;58;.921;3600000;0
6255;43896;573;0;0;0;0;.00nan;0;0
6255;68167;572;0;0;0;0;.00nan;0;0
6255;84945;573;59;14;1;13;.929;3600000;0
6256;6127;575;47;39;5;34;.872;3593000;0
6256;185232;575;0;0;0;0;.00nan;0;0
6256;56126;568;0;0;0;0;.00nan;0;0
6256;64800;568;39;17;3;14;.824;3600000;0
6257;13065;578;99;44;1;43;.977;3887000;0
6257;185220;565;0;0;0;0;.00nan;0;0
6257;35520;578;0;0;0;0;.00nan;0;0
6257;84430;565;80;29;2;27;.931;3887000;0
6258;320;562;84;52;4;48;.923;3600000;0
6258;43896;573;0;0;0;0;.00nan;0;0
6258;84945;573;53;17;2;15;.882;3600000;0
6258;155917;562;0;0;0;0;.00nan;0;0
6259;7063;566;0;0;0;0;.00nan;0;0
6259;11925;576;49;25;3;22;.880;3585000;0
6259;44405;566;97;32;1;31;.969;3600000;0
6259;67454;576;0;0;0;0;.00nan;0;0
6260;14191;574;0;0;0;0;.00nan;0;0
6260;170144;574;57;28;4;24;.857;3600000;0
6260;65014;570;52;36;5;31;.861;3570000;0
6260;67614;570;0;0;0;0;.00nan;0;0
6261;169493;572;0;0;0;0;.00nan;0;0
6261;57993;569;0;0;0;0;.00nan;0;0
6261;68167;572;81;35;3;32;.914;3600000;0
6261;141419;569;100;30;0;30;1.000;3600000;0
6262;6127;575;0;0;0;0;.00nan;0;0
6262;185232;575;58;21;3;18;.857;3515000;0
6262;65014;570;0;0;0;0;.00nan;0;0
6262;67614;570;99;39;1;38;.974;3600000;0
6263;11925;576;23;22;6;16;.727;2923000;0
6263;57993;569;0;0;0;0;.00nan;0;0
6263;67454;576;60;11;0;11;1.000;677000;0
6263;141419;569;68;33;3;30;.909;3600000;0
6264;7063;566;0;0;0;0;.00nan;0;0
6264;43896;573;0;0;0;0;.00nan;0;0
6264;44405;566;62;31;3;28;.903;3600000;0
6264;84945;573;100;37;0;37;1.000;3600000;0
6265;56126;568;56;20;3;17;.850;3600000;0
6265;64800;568;0;0;0;0;.00nan;0;0
6265;64961;571;62;33;4;29;.879;3245000;0
6265;90734;571;22;4;3;1;.250;355000;0
6266;185220;565;74;35;2;33;.943;3600000;0
6266;84430;565;0;0;0;0;.00nan;0;0
6266;91403;577;43;29;4;25;.862;3584000;0
6266;143829;577;0;0;0;0;.00nan;0;0
6267;14191;574;0;0;0;0;.00nan;0;0
6267;170144;574;81;25;1;24;.960;3600000;0
6267;179602;564;94;37;2;35;.946;3546000;0
6267;78251;564;0;0;0;0;.00nan;0;0
6268;185220;565;0;0;0;0;.00nan;0;0
6268;43896;573;0;0;0;0;.00nan;0;0
6268;84430;565;90;37;2;35;.946;3900000;0
6268;84945;573;56;22;2;20;.909;3896000;0
6269;14191;574;0;0;0;0;.00nan;0;0
6269;170144;574;30;37;7;30;.811;3591000;0
6269;179602;564;63;32;3;29;.906;3600000;0
6269;78251;564;0;0;0;0;.00nan;0;0
6270;11925;576;0;0;0;0;.00nan;0;0
6270;57993;569;68;44;4;40;.909;3600000;0
6270;67454;576;67;17;1;16;.941;3600000;0
6270;141419;569;0;0;0;0;.00nan;0;0
6271;320;562;71;46;5;41;.891;3600000;0
6271;13065;578;74;30;2;28;.933;3600000;0
6271;35520;578;0;0;0;0;.00nan;0;0
6271;155917;562;0;0;0;0;.00nan;0;0
6272;7063;566;100;27;0;27;1.000;3600000;0
6272;44405;566;0;0;0;0;.00nan;0;0
6272;91403;577;80;31;3;28;.903;3600000;0
6272;143829;577;0;0;0;0;.00nan;0;0
6273;6127;575;82;25;2;23;.920;3588000;0
6273;169493;572;0;0;0;0;.00nan;0;0
6273;185232;575;0;0;0;0;.00nan;0;0
6273;68167;572;99;42;1;41;.976;3600000;0
6274;56126;568;0;0;0;0;.00nan;0;0
6274;64800;568;97;22;0;22;1.000;3600000;0
6274;64961;571;0;0;0;0;.00nan;0;0
6274;90734;571;82;30;2;28;.933;3519000;0
6275;6127;575;75;25;2;23;.920;3600000;0
6275;185232;575;0;0;0;0;.00nan;0;0
6275;64961;571;0;0;0;0;.00nan;0;0
6275;90734;571;65;31;3;28;.903;3581000;0
6276;13065;578;0;0;0;0;.00nan;0;0
6276;35520;578;95;42;2;40;.952;3570000;0
6276;91403;577;85;28;1;27;.964;3600000;0
6276;143829;577;0;0;0;0;.00nan;0;0
6277;14191;574;0;0;0;0;.00nan;0;0
6277;170144;574;70;31;3;28;.903;3581000;0
6277;179602;564;64;17;1;16;.941;3600000;0
6277;78251;564;0;0;0;0;.00nan;0;0
6278;56126;568;80;29;2;27;.931;3600000;0
6278;64800;568;0;0;0;0;.00nan;0;0
6278;65014;570;56;5;0;5;1.000;796000;0
6278;67614;570;45;38;6;32;.842;2804000;0
6279;43896;573;0;0;0;0;.00nan;0;0
6279;64961;571;50;24;4;20;.833;3600000;0
6279;84945;573;100;39;1;38;.974;3600000;0
6279;90734;571;0;0;0;0;.00nan;0;0
6280;7063;566;60;12;1;11;.917;3600000;0
6280;44405;566;0;0;0;0;.00nan;0;0
6280;57993;569;0;0;0;0;.00nan;0;0
6280;141419;569;69;33;3;30;.909;3539000;0
6281;320;562;100;29;0;29;1.000;3600000;0
6281;11925;576;89;39;2;37;.949;3580000;0
6281;67454;576;0;0;0;0;.00nan;0;0
6281;155917;562;0;0;0;0;.00nan;0;0
6282;179602;564;70;35;3;32;.914;3577000;0
6282;185220;565;0;0;0;0;.00nan;0;0
6282;78251;564;0;0;0;0;.00nan;0;0
6282;84430;565;53;21;2;19;.905;3600000;0
6283;14191;574;0;0;0;0;.00nan;0;0
6283;170144;574;46;25;4;21;.840;3900000;0
6283;43896;573;80;51;4;47;.922;3900000;0
6283;84945;573;0;0;0;0;.00nan;0;0
6284;169493;572;0;0;0;0;.00nan;0;0
6284;68167;572;80;43;4;39;.907;3600000;0
6284;91403;577;56;12;1;11;.917;3600000;0
6284;143829;577;0;0;0;0;.00nan;0;0
6285;320;562;96;39;2;37;.949;3900000;0
6285;57993;569;71;23;2;21;.913;3900000;0
6285;141419;569;0;0;0;0;.00nan;0;0
6285;155917;562;0;0;0;0;.00nan;0;0
6286;6127;575;0;0;0;0;.00nan;0;0
6286;13065;578;96;39;1;38;.974;3600000;0
6286;185232;575;72;23;2;21;.913;3566000;0
6286;35520;578;0;0;0;0;.00nan;0;0
6287;7063;566;0;0;0;0;.00nan;0;0
6287;44405;566;71;31;2;29;.935;3600000;0
6287;65014;570;98;41;1;40;.976;3600000;0
6287;67614;570;0;0;0;0;.00nan;0;0
6288;179602;564;0;0;0;0;.00nan;0;0
6288;57993;569;0;0;0;0;.00nan;0;0
6288;78251;564;39;17;4;13;.765;3600000;0
6288;141419;569;79;35;3;32;.914;3600000;0
6289;14191;574;0;0;0;0;.00nan;0;0
6289;170144;574;80;36;3;33;.917;3900000;0
6289;56126;568;80;38;3;35;.921;3886000;0
6289;64800;568;0;0;0;0;.00nan;0;0
6290;6127;575;89;39;2;37;.949;3537000;0
6290;185232;575;0;0;0;0;.00nan;0;0
6290;91403;577;84;14;0;14;1.000;3600000;0
6290;143829;577;0;0;0;0;.00nan;0;0
6291;11925;576;97;37;1;36;.973;3900000;0
6291;64961;571;0;0;0;0;.00nan;0;0
6291;67454;576;0;0;0;0;.00nan;0;0
6291;90734;571;71;31;1;30;.968;3900000;0
6292;320;562;0;0;0;0;.00nan;0;0
6292;185220;565;0;0;0;0;.00nan;0;0
6292;84430;565;52;20;3;17;.850;3566000;0
6292;155917;562;76;26;2;24;.923;3600000;0
6293;7063;566;99;20;0;20;1.000;3600000;0
6293;13065;578;0;0;0;0;.00nan;0;0
6293;35520;578;60;26;4;22;.846;3600000;0
6293;44405;566;0;0;0;0;.00nan;0;0
6294;169493;572;0;0;0;0;.00nan;0;0
6294;43896;573;0;0;0;0;.00nan;0;0
6294;68167;572;89;54;4;50;.926;3548000;0
6294;84945;573;35;12;3;9;.750;3600000;0
6295;11925;576;82;14;0;14;1.000;3600000;0
6295;169493;572;0;0;0;0;.00nan;0;0
6295;67454;576;0;0;0;0;.00nan;0;0
6295;68167;572;55;40;5;35;.875;3600000;0
6296;179602;564;65;31;4;27;.871;3600000;0
6296;64961;571;0;0;0;0;.00nan;0;0
6296;78251;564;0;0;0;0;.00nan;0;0
6296;90734;571;99;43;1;42;.977;3600000;0
6297;185220;565;81;36;2;34;.944;3600000;0
6297;84430;565;0;0;0;0;.00nan;0;0
6297;91403;577;82;28;1;27;.964;3600000;0
6297;143829;577;0;0;0;0;.00nan;0;0
6298;320;562;98;46;2;44;.957;3593000;0
6298;14191;574;0;0;0;0;.00nan;0;0
6298;170144;574;92;19;0;19;1.000;3600000;0
6298;155917;562;0;0;0;0;.00nan;0;0
6299;13065;578;69;29;3;26;.897;3600000;0
6299;35520;578;0;0;0;0;.00nan;0;0
6299;65014;570;74;21;1;20;.952;3600000;0
6299;67614;570;0;0;0;0;.00nan;0;0
6300;56126;568;0;0;0;0;.00nan;0;0
6300;64800;568;63;25;3;22;.880;3600000;0
6300;91403;577;0;0;0;0;.00nan;0;0
6300;143829;577;100;37;2;35;.946;3600000;0
6301;14191;574;0;0;0;0;.00nan;0;0
6301;170144;574;67;36;3;33;.917;3900000;0
6301;64961;571;0;0;0;0;.00nan;0;0
6301;90734;571;82;34;3;31;.912;3900000;0
6302;6127;575;99;26;0;26;1.000;3600000;0
6302;11925;576;41;34;6;28;.824;3600000;0
6302;185232;575;0;0;0;0;.00nan;0;0
6302;67454;576;0;0;0;0;.00nan;0;0
6303;13065;578;0;0;0;0;.00nan;0;0
6303;185220;565;0;0;0;0;.00nan;0;0
6303;35520;578;61;37;5;32;.865;3566000;0
6303;84430;565;63;29;3;26;.897;3600000;0
6304;7063;566;94;47;2;45;.957;3900000;0
6304;43896;573;0;0;0;0;.00nan;0;0
6304;44405;566;0;0;0;0;.00nan;0;0
6304;84945;573;95;40;2;38;.950;3893000;0
6305;169493;572;0;0;0;0;.00nan;0;0
6305;65014;570;78;29;2;27;.931;3600000;0
6305;67614;570;0;0;0;0;.00nan;0;0
6305;68167;572;64;34;3;31;.912;3587000;0
6306;11925;576;0;0;0;0;.00nan;0;0
6306;65014;570;0;0;0;0;.00nan;0;0
6306;67454;576;84;30;2;28;.933;3600000;0
6306;67614;570;57;25;3;22;.880;3547000;0
6307;169493;572;0;0;0;0;.00nan;0;0
6307;179602;564;70;19;1;18;.947;3600000;0
6307;68167;572;63;38;4;34;.895;3600000;0
6307;78251;564;0;0;0;0;.00nan;0;0
6308;7063;566;0;0;0;0;.00nan;0;0
6308;185220;565;81;38;2;36;.947;3582000;0
6308;44405;566;98;24;0;24;1.000;3600000;0
6308;84430;565;0;0;0;0;.00nan;0;0
6309;13065;578;74;44;5;39;.886;3564000;0
6309;35520;578;0;0;0;0;.00nan;0;0
6309;43896;573;83;39;4;35;.897;3600000;0
6309;84945;573;0;0;0;0;.00nan;0;0
6310;56126;568;0;0;0;0;.00nan;0;0
6310;57993;569;0;0;0;0;.00nan;0;0
6310;64800;568;56;19;2;17;.895;3600000;0
6310;141419;569;78;43;4;39;.907;3600000;0
6311;14191;574;62;27;3;24;.889;3553000;0
6311;170144;574;0;0;0;0;.00nan;0;0
6311;64961;571;86;37;2;35;.946;3600000;0
6311;90734;571;0;0;0;0;.00nan;0;0
6312;320;562;92;43;3;40;.930;3900000;0
6312;6127;575;55;21;3;18;.857;3900000;0
6312;185232;575;0;0;0;0;.00nan;0;0
6312;155917;562;0;0;0;0;.00nan;0;0
6313;56126;568;0;0;0;0;.00nan;0;0
6313;64800;568;68;21;1;20;.952;3600000;0
6313;65014;570;73;30;2;28;.933;3600000;0
6313;67614;570;0;0;0;0;.00nan;0;0
6314;320;562;82;36;2;34;.944;3612000;0
6314;169493;572;0;0;0;0;.00nan;0;0
6314;68167;572;60;22;3;19;.864;3612000;0
6314;155917;562;0;0;0;0;.00nan;0;0
6315;43896;573;54;22;3;19;.864;3600000;0
6315;56126;568;0;0;0;0;.00nan;0;0
6315;64800;568;94;32;1;31;.969;3600000;0
6315;84945;573;0;0;0;0;.00nan;0;0
6316;64961;571;0;0;0;0;.00nan;0;0
6316;90734;571;79;24;1;23;.958;3900000;0
6316;91403;577;96;32;1;31;.969;3900000;0
6316;143829;577;0;0;0;0;.00nan;0;0
6317;11925;576;67;47;5;42;.894;3600000;0
6317;14191;574;0;0;0;0;.00nan;0;0
6317;170144;574;82;18;0;18;1.000;3600000;0
6317;67454;576;0;0;0;0;.00nan;0;0
6318;6127;575;69;43;4;39;.907;3753000;0
6318;179602;564;51;27;3;24;.889;3753000;0
6318;185232;575;0;0;0;0;.00nan;0;0
6318;78251;564;0;0;0;0;.00nan;0;0
6319;185220;565;60;21;2;19;.905;3564000;0
6319;65014;570;88;18;0;18;1.000;3600000;0
6319;67614;570;0;0;0;0;.00nan;0;0
6319;84430;565;0;0;0;0;.00nan;0;0
6320;64961;571;91;36;1;35;.972;3600000;0
6320;90734;571;0;0;0;0;.00nan;0;0
6320;91403;577;0;0;0;0;.00nan;0;0
6320;143829;577;68;33;3;30;.909;3577000;0
6321;13065;578;86;26;1;25;.962;3900000;0
6321;35520;578;0;0;0;0;.00nan;0;0
6321;57993;569;0;0;0;0;.00nan;0;0
6321;141419;569;77;29;1;28;.966;3900000;0
6322;7063;566;0;0;0;0;.00nan;0;0
6322;169493;572;0;0;0;0;.00nan;0;0
6322;44405;566;93;17;0;17;1.000;3600000;0
6322;68167;572;89;44;4;40;.909;3600000;0
6323;6127;575;0;0;0;0;.00nan;0;0
6323;185220;565;0;0;0;0;.00nan;0;0
6323;185232;575;60;27;3;24;.889;3600000;0
6323;84430;565;60;41;5;36;.878;3511000;0
6324;320;562;83;38;2;36;.947;3600000;0
6324;179602;564;67;11;1;10;.909;3600000;0
6324;78251;564;0;0;0;0;.00nan;0;0
6324;155917;562;0;0;0;0;.00nan;0;0
6325;43896;573;85;31;1;30;.968;3600000;0
6325;56126;568;0;0;0;0;.00nan;0;0
6325;64800;568;79;36;2;34;.944;3568000;0
6325;84945;573;0;0;0;0;.00nan;0;0
6326;14191;574;0;0;0;0;.00nan;0;0
6326;169493;572;32;15;4;11;.733;1083000;0
6326;170144;574;82;24;1;23;.958;3600000;0
6326;68167;572;73;26;2;24;.923;2517000;0
6327;7063;566;0;0;0;0;.00nan;0;0
6327;44405;566;74;32;2;30;.938;3900000;0
6327;65014;570;75;32;2;30;.938;3900000;0
6327;67614;570;0;0;0;0;.00nan;0;0
6328;43896;573;23;17;5;12;.706;3600000;0
6328;84945;573;0;0;0;0;.00nan;0;0
6328;91403;577;53;39;6;33;.846;3562000;0
6328;143829;577;0;0;0;0;.00nan;0;0
6329;6127;575;50;28;4;24;.857;3571000;0
6329;13065;578;88;36;2;34;.944;3600000;0
6329;185232;575;0;0;0;0;.00nan;0;0
6329;35520;578;0;0;0;0;.00nan;0;0
6330;179602;564;62;14;1;13;.929;3600000;0
6330;65014;570;0;0;0;0;.00nan;0;0
6330;67614;570;80;38;3;35;.921;3547000;0
6330;78251;564;0;0;0;0;.00nan;0;0
6331;185220;565;91;34;1;33;.971;3600000;0
6331;56126;568;77;31;2;29;.935;3587000;0
6331;64800;568;0;0;0;0;.00nan;0;0
6331;84430;565;0;0;0;0;.00nan;0;0
6332;6127;575;0;0;0;0;.00nan;0;0
6332;185232;575;87;41;2;39;.951;3616000;0
6332;64961;571;0;0;0;0;.00nan;0;0
6332;90734;571;63;23;3;20;.870;3616000;0
6333;320;562;73;21;1;20;.952;3600000;0
6333;11925;576;100;26;0;26;1.000;3600000;0
6333;67454;576;0;0;0;0;.00nan;0;0
6333;155917;562;0;0;0;0;.00nan;0;0
6334;169493;572;0;0;0;0;.00nan;0;0
6334;57993;569;0;0;0;0;.00nan;0;0
6334;68167;572;92;28;1;27;.964;3600000;0
6334;141419;569;55;20;2;18;.900;3581000;0
6335;7063;566;80;45;4;41;.911;3539000;0
6335;14191;574;0;0;0;0;.00nan;0;0
6335;170144;574;60;18;2;16;.889;3600000;0
6335;44405;566;0;0;0;0;.00nan;0;0
6336;179602;564;0;0;0;0;.00nan;0;0
6336;43896;573;41;40;7;33;.825;3600000;0
6336;78251;564;94;30;1;29;.967;3600000;0
6336;84945;573;0;0;0;0;.00nan;0;0
6337;11925;576;65;34;3;31;.912;3900000;0
6337;57993;569;0;0;0;0;.00nan;0;0
6337;67454;576;0;0;0;0;.00nan;0;0
6337;141419;569;67;33;3;30;.909;3900000;0
6338;14191;574;0;0;0;0;.00nan;0;0
6338;170144;574;65;39;5;34;.872;3600000;0
6338;185220;565;67;23;2;21;.913;3600000;0
6338;84430;565;0;0;0;0;.00nan;0;0
6339;43896;573;93;29;1;28;.966;3600000;0
6339;65014;570;59;34;5;29;.853;3600000;0
6339;67614;570;0;0;0;0;.00nan;0;0
6339;84945;573;0;0;0;0;.00nan;0;0
6340;7063;566;0;0;0;0;.00nan;0;0
6340;44405;566;81;26;1;25;.962;3546000;0
6340;64961;571;100;27;0;27;1.000;3600000;0
6340;90734;571;0;0;0;0;.00nan;0;0
6341;320;562;88;52;5;47;.904;3600000;0
6341;56126;568;0;0;0;0;.00nan;0;0
6341;64800;568;100;29;0;29;1.000;3600000;0
6341;155917;562;0;0;0;0;.00nan;0;0
6342;13065;578;71;35;3;32;.914;3900000;0
6342;169493;572;0;0;0;0;.00nan;0;0
6342;35520;578;0;0;0;0;.00nan;0;0
6342;68167;572;73;35;3;32;.914;3900000;0
6343;11925;576;0;0;0;0;.00nan;0;0
6343;13065;578;0;0;0;0;.00nan;0;0
6343;35520;578;78;24;1;23;.958;3600000;0
6343;67454;576;68;27;3;24;.889;3537000;0
6344;56126;568;0;0;0;0;.00nan;0;0
6344;64800;568;69;24;2;22;.917;3771000;0
6344;64961;571;72;38;3;35;.921;3771000;0
6344;90734;571;0;0;0;0;.00nan;0;0
6345;14191;574;62;29;3;26;.897;3543000;0
6345;170144;574;0;0;0;0;.00nan;0;0
6345;185220;565;0;0;0;0;.00nan;0;0
6345;84430;565;86;39;2;37;.949;3600000;0
6346;57993;569;73;32;2;30;.938;3535000;0
6346;65014;570;0;0;0;0;.00nan;0;0
6346;67614;570;100;18;0;18;1.000;3600000;0
6346;141419;569;0;0;0;0;.00nan;0;0
6347;6127;575;79;26;1;25;.962;3600000;0
6347;185232;575;0;0;0;0;.00nan;0;0
6347;91403;577;0;0;0;0;.00nan;0;0
6347;143829;577;65;28;2;26;.929;3600000;0
6348;7063;566;70;33;3;30;.909;3877000;0
6348;169493;572;0;0;0;0;.00nan;0;0
6348;44405;566;0;0;0;0;.00nan;0;0
6348;68167;572;90;38;2;36;.947;3877000;0
6349;11925;576;85;34;2;32;.941;3600000;0
6349;14191;574;0;0;0;0;.00nan;0;0
6349;170144;574;38;21;4;17;.810;3528000;0
6349;67454;576;0;0;0;0;.00nan;0;0
6350;185220;565;32;17;4;13;.765;3795000;0
6350;64961;571;65;46;5;41;.891;3794000;0
6350;84430;565;0;0;0;0;.00nan;0;0
6350;90734;571;0;0;0;0;.00nan;0;0
6351;7063;566;87;29;1;28;.966;3194000;0
6351;43896;573;79;31;2;29;.935;3600000;0
6351;44405;566;22;4;3;1;.250;370000;0
6351;84945;573;0;0;0;0;.00nan;0;0
6352;13065;578;97;52;2;50;.962;3573000;0
6352;35520;578;0;0;0;0;.00nan;0;0
6352;56126;568;0;0;0;0;.00nan;0;0
6352;64800;568;73;20;1;19;.950;3600000;0
6353;179602;564;60;27;3;24;.889;3567000;0
6353;78251;564;0;0;0;0;.00nan;0;0
6353;91403;577;73;23;2;21;.913;3600000;0
6353;143829;577;0;0;0;0;.00nan;0;0
6354;320;562;80;39;3;36;.923;3600000;0
6354;6127;575;99;23;0;23;1.000;3600000;0
6354;185232;575;0;0;0;0;.00nan;0;0
6354;155917;562;0;0;0;0;.00nan;0;0
6355;57993;569;0;0;0;0;.00nan;0;0
6355;65014;570;0;0;0;0;.00nan;0;0
6355;67614;570;83;21;1;20;.952;3600000;0
6355;141419;569;74;46;4;42;.913;3600000;0
6356;7063;566;0;0;0;0;.00nan;0;0
6356;179602;564;0;0;0;0;.00nan;0;0
6356;44405;566;45;44;7;37;.841;3600000;0
6356;78251;564;74;15;0;15;1.000;3600000;0
6357;14191;574;56;27;3;24;.889;3567000;0
6357;170144;574;0;0;0;0;.00nan;0;0
6357;57993;569;0;0;0;0;.00nan;0;0
6357;141419;569;80;32;2;30;.938;3600000;0
6358;6127;575;59;38;4;34;.895;3530000;0
6358;185232;575;0;0;0;0;.00nan;0;0
6358;43896;573;87;36;2;34;.944;3600000;0
6358;84945;573;0;0;0;0;.00nan;0;0
6359;13065;578;79;50;4;46;.920;3529000;0
6359;35520;578;0;0;0;0;.00nan;0;0
6359;56126;568;0;0;0;0;.00nan;0;0
6359;64800;568;68;24;2;22;.917;3600000;0
6360;11925;576;89;36;1;35;.972;3600000;0
6360;65014;570;45;16;3;13;.813;3580000;0
6360;67454;576;0;0;0;0;.00nan;0;0
6360;67614;570;0;0;0;0;.00nan;0;0
6361;169493;572;0;0;0;0;.00nan;0;0
6361;68167;572;80;33;2;31;.939;3600000;0
6361;91403;577;0;0;0;0;.00nan;0;0
6361;143829;577;63;15;1;14;.933;3600000;0
6362;320;562;30;24;5;19;.792;2511000;0
6362;64961;571;0;0;0;0;.00nan;0;0
6362;90734;571;66;18;1;17;.944;3600000;0
6362;155917;562;20;16;5;11;.688;1089000;0
6363;11925;576;68;32;3;29;.906;3600000;0
6363;67454;576;0;0;0;0;.00nan;0;0
6363;91403;577;75;18;1;17;.944;3600000;0
6363;143829;577;0;0;0;0;.00nan;0;0
6364;169493;572;0;0;0;0;.00nan;0;0
6364;185220;565;97;34;1;33;.971;3600000;0
6364;68167;572;51;23;3;20;.870;3556000;0
6364;84430;565;0;0;0;0;.00nan;0;0
6365;6127;575;68;23;2;21;.913;3600000;0
6365;11925;576;55;28;3;25;.893;3543000;0
6365;185232;575;0;0;0;0;.00nan;0;0
6365;67454;576;0;0;0;0;.00nan;0;0
6366;169493;572;0;0;0;0;.00nan;0;0
6366;43896;573;66;16;1;15;.938;3600000;0
6366;68167;572;93;40;2;38;.950;3558000;0
6366;84945;573;0;0;0;0;.00nan;0;0
6367;7063;566;76;38;3;35;.921;3600000;0
6367;44405;566;0;0;0;0;.00nan;0;0
6367;56126;568;0;0;0;0;.00nan;0;0
6367;64800;568;58;35;5;30;.857;3561000;0
6368;64961;571;81;29;2;27;.931;3600000;0
6368;65014;570;0;0;0;0;.00nan;0;0
6368;67614;570;64;29;3;26;.897;3586000;0
6368;90734;571;0;0;0;0;.00nan;0;0
6369;320;562;80;46;4;42;.913;3600000;0
6369;14191;574;0;0;0;0;.00nan;0;0
6369;170144;574;64;4;0;4;1.000;3600000;0
6369;155917;562;0;0;0;0;.00nan;0;0
6370;57993;569;0;0;0;0;.00nan;0;0
6370;91403;577;0;0;0;0;.00nan;0;0
6370;141419;569;66;25;2;23;.920;3600000;0
6370;143829;577;73;37;4;33;.892;3541000;0
6371;13065;578;89;36;2;34;.944;3565000;0
6371;179602;564;0;0;0;0;.00nan;0;0
6371;35520;578;0;0;0;0;.00nan;0;0
6371;78251;564;59;12;1;11;.917;3600000;0
6372;179602;564;68;26;2;24;.923;3566000;0
6372;56126;568;0;0;0;0;.00nan;0;0
6372;64800;568;99;34;1;33;.971;3600000;0
6372;78251;564;0;0;0;0;.00nan;0;0
6373;11925;576;69;34;3;31;.912;3600000;0
6373;67454;576;0;0;0;0;.00nan;0;0
6373;91403;577;100;23;0;23;1.000;3600000;0
6373;143829;577;0;0;0;0;.00nan;0;0
6374;43896;573;56;18;2;16;.889;3600000;0
6374;57993;569;0;0;0;0;.00nan;0;0
6374;84945;573;0;0;0;0;.00nan;0;0
6374;141419;569;89;43;3;40;.930;3600000;0
6375;6127;575;100;38;0;38;1.000;3600000;0
6375;185220;565;35;19;4;15;.789;3600000;0
6375;185232;575;0;0;0;0;.00nan;0;0
6375;84430;565;0;0;0;0;.00nan;0;0
6376;320;562;100;35;0;35;1.000;3600000;0
6376;7063;566;0;0;0;0;.00nan;0;0
6376;44405;566;48;21;3;18;.857;3600000;0
6376;155917;562;0;0;0;0;.00nan;0;0
6377;64961;571;71;41;4;37;.902;3600000;0
6377;65014;570;87;19;0;19;1.000;3600000;0
6377;67614;570;0;0;0;0;.00nan;0;0
6377;90734;571;0;0;0;0;.00nan;0;0
6378;14191;574;0;0;0;0;.00nan;0;0
6378;169493;572;0;0;0;0;.00nan;0;0
6378;170144;574;56;12;1;11;.917;3600000;0
6378;68167;572;68;38;4;34;.895;3600000;0
6379;185220;565;0;0;0;0;.00nan;0;0
6379;57993;569;0;0;0;0;.00nan;0;0
6379;84430;565;100;24;0;24;1.000;3600000;0
6379;141419;569;55;35;6;29;.829;3600000;0
6380;11925;576;95;37;1;36;.973;3558000;0
6380;43896;573;96;18;0;18;1.000;3600000;0
6380;67454;576;0;0;0;0;.00nan;0;0
6380;84945;573;0;0;0;0;.00nan;0;0
6381;56126;568;0;0;0;0;.00nan;0;0
6381;64800;568;78;39;4;35;.897;3563000;0
6381;91403;577;53;19;2;17;.895;3600000;0
6381;143829;577;0;0;0;0;.00nan;0;0
6382;6127;575;77;37;3;34;.919;3524000;0
6382;14191;574;0;0;0;0;.00nan;0;0
6382;170144;574;73;21;1;20;.952;3600000;0
6382;185232;575;0;0;0;0;.00nan;0;0
6383;13065;578;79;31;2;29;.935;3589000;0
6383;35520;578;0;0;0;0;.00nan;0;0
6383;64961;571;78;23;1;22;.957;3600000;0
6383;90734;571;0;0;0;0;.00nan;0;0
6384;320;562;76;38;4;34;.895;3600000;0
6384;65014;570;88;16;0;16;1.000;3600000;0
6384;67614;570;0;0;0;0;.00nan;0;0
6384;155917;562;0;0;0;0;.00nan;0;0
6385;169493;572;0;0;0;0;.00nan;0;0
6385;179602;564;75;32;2;30;.938;3532000;0
6385;68167;572;100;40;0;40;1.000;3600000;0
6385;78251;564;0;0;0;0;.00nan;0;0
6386;7063;566;66;17;1;16;.941;3600000;0
6386;11925;576;0;0;0;0;.00nan;0;0
6386;44405;566;0;0;0;0;.00nan;0;0
6386;67454;576;66;31;3;28;.903;3560000;0
6387;179602;564;12;19;6;13;.684;1917000;0
6387;185220;565;0;0;0;0;.00nan;0;0
6387;78251;564;52;14;2;12;.857;1683000;0
6387;84430;565;91;40;3;37;.925;3600000;0
6388;43896;573;100;40;0;40;1.000;3600000;0
6388;65014;570;78;22;1;21;.955;3545000;0
6388;67614;570;0;0;0;0;.00nan;0;0
6388;84945;573;0;0;0;0;.00nan;0;0
6389;6127;575;73;32;3;29;.906;3900000;0
6389;185232;575;0;0;0;0;.00nan;0;0
6389;56126;568;0;0;0;0;.00nan;0;0
6389;64800;568;57;21;2;19;.905;3900000;0
6390;14191;574;0;0;0;0;.00nan;0;0
6390;170144;574;91;25;1;24;.960;3600000;0
6390;91403;577;0;0;0;0;.00nan;0;0
6390;143829;577;70;35;4;31;.886;3600000;0
6391;320;562;47;33;5;28;.848;3600000;0
6391;13065;578;33;18;4;14;.778;3600000;0
6391;35520;578;0;0;0;0;.00nan;0;0
6391;155917;562;0;0;0;0;.00nan;0;0
6392;169493;572;0;0;0;0;.00nan;0;0
6392;57993;569;0;0;0;0;.00nan;0;0
6392;68167;572;86;34;1;33;.971;3900000;0
6392;141419;569;94;34;1;33;.971;3900000;0
6393;320;562;71;38;4;34;.895;3580000;0
6393;56126;568;0;0;0;0;.00nan;0;0
6393;64800;568;68;26;2;24;.923;3600000;0
6393;155917;562;0;0;0;0;.00nan;0;0
6394;179602;564;65;34;4;30;.882;3600000;0
6394;78251;564;0;0;0;0;.00nan;0;0
6394;91403;577;0;0;0;0;.00nan;0;0
6394;143829;577;100;37;1;36;.973;3600000;0
6395;185220;565;0;0;0;0;.00nan;0;0
6395;57993;569;0;0;0;0;.00nan;0;0
6395;84430;565;47;17;3;14;.824;3516000;0
6395;141419;569;95;34;1;33;.971;3600000;0
6396;6127;575;100;23;0;23;1.000;3600000;0
6396;11925;576;29;29;6;23;.793;2023000;0
6396;185232;575;0;0;0;0;.00nan;0;0
6396;67454;576;62;19;1;18;.947;1577000;0
6397;13065;578;0;0;0;0;.00nan;0;0
6397;35520;578;66;43;4;39;.907;3600000;0
6397;43896;573;69;20;1;19;.950;3600000;0
6397;84945;573;0;0;0;0;.00nan;0;0
6398;7063;566;69;22;1;21;.955;3600000;0
6398;169493;572;0;0;0;0;.00nan;0;0
6398;44405;566;0;0;0;0;.00nan;0;0
6398;68167;572;62;46;5;41;.891;3600000;0
6399;14191;574;0;0;0;0;.00nan;0;0
6399;170144;574;91;29;1;28;.966;3600000;0
6399;65014;570;77;36;3;33;.917;3600000;0
6399;67614;570;0;0;0;0;.00nan;0;0
6400;7063;566;68;39;4;35;.897;3600000;0
6400;14191;574;0;0;0;0;.00nan;0;0
6400;170144;574;77;25;2;23;.920;3600000;0
6400;44405;566;0;0;0;0;.00nan;0;0
6401;11925;576;66;51;5;46;.902;3600000;0
6401;56126;568;0;0;0;0;.00nan;0;0
6401;64800;568;90;17;0;17;1.000;3600000;0
6401;67454;576;0;0;0;0;.00nan;0;0
6402;13065;578;98;42;2;40;.952;3600000;0
6402;179602;564;0;0;0;0;.00nan;0;0
6402;35520;578;0;0;0;0;.00nan;0;0
6402;78251;564;70;19;1;18;.947;3600000;0
6403;169493;572;0;0;0;0;.00nan;0;0
6403;185220;565;59;28;3;25;.893;3512000;0
6403;68167;572;96;31;1;30;.968;3600000;0
6403;84430;565;0;0;0;0;.00nan;0;0
6404;320;562;98;51;2;49;.961;3600000;0
6404;43896;573;81;24;1;23;.958;3600000;0
6404;84945;573;0;0;0;0;.00nan;0;0
6404;155917;562;0;0;0;0;.00nan;0;0
6405;6127;575;81;28;1;27;.964;3600000;0
6405;185232;575;0;0;0;0;.00nan;0;0
6405;57993;569;0;0;0;0;.00nan;0;0
6405;141419;569;84;38;2;36;.947;3600000;0
6406;65014;570;89;36;2;34;.944;3556000;0
6406;67614;570;0;0;0;0;.00nan;0;0
6406;91403;577;0;0;0;0;.00nan;0;0
6406;143829;577;100;41;1;40;.976;3600000;0
6407;179602;564;51;30;5;25;.833;3600000;0
6407;43896;573;100;27;0;27;1.000;3600000;0
6407;78251;564;0;0;0;0;.00nan;0;0
6407;84945;573;0;0;0;0;.00nan;0;0
6408;56126;568;0;0;0;0;.00nan;0;0
6408;64800;568;83;28;1;27;.964;3600000;0
6408;65014;570;52;36;5;31;.861;2400000;0
6408;67614;570;59;6;0;6;1.000;1200000;0
6409;14191;574;0;0;0;0;.00nan;0;0
6409;170144;574;38;29;6;23;.793;3600000;0
6409;91403;577;0;0;0;0;.00nan;0;0
6409;143829;577;100;41;1;40;.976;3600000;0
6410;320;562;96;33;1;32;.970;3600000;0
6410;57993;569;0;0;0;0;.00nan;0;0
6410;141419;569;85;32;2;30;.938;3550000;0
6410;155917;562;0;0;0;0;.00nan;0;0
6411;13065;578;100;40;1;39;.975;3600000;0
6411;185220;565;0;0;0;0;.00nan;0;0
6411;35520;578;0;0;0;0;.00nan;0;0
6411;84430;565;62;29;3;26;.897;3591000;0
6412;11925;576;73;45;4;41;.911;3600000;0
6412;179602;564;0;0;0;0;.00nan;0;0
6412;67454;576;0;0;0;0;.00nan;0;0
6412;78251;564;84;26;1;25;.962;3600000;0
6413;11925;576;0;0;0;0;.00nan;0;0
6413;14191;574;0;0;0;0;.00nan;0;0
6413;170144;574;85;26;2;24;.923;3900000;0
6413;67454;576;97;52;2;50;.962;3900000;0
6414;43896;573;73;29;2;27;.931;3600000;0
6414;56126;568;54;32;4;28;.875;3542000;0
6414;64800;568;0;0;0;0;.00nan;0;0
6414;84945;573;0;0;0;0;.00nan;0;0
6415;64961;571;0;0;0;0;.00nan;0;0
6415;90734;571;44;27;5;22;.815;3600000;0
6415;91403;577;0;0;0;0;.00nan;0;0
6415;143829;577;73;24;1;23;.958;3600000;0
6416;320;562;0;0;0;0;.00nan;0;0
6416;185220;565;54;35;5;30;.857;3600000;0
6416;84430;565;0;0;0;0;.00nan;0;0
6416;155917;562;39;36;6;30;.833;3581000;0
6417;7063;566;72;26;2;24;.923;3600000;0
6417;169493;572;0;0;0;0;.00nan;0;0
6417;44405;566;0;0;0;0;.00nan;0;0
6417;68167;572;66;28;3;25;.893;3577000;0
6418;13065;578;97;34;1;33;.971;3600000;0
6418;35520;578;0;0;0;0;.00nan;0;0
6418;65014;570;0;0;0;0;.00nan;0;0
6418;67614;570;99;18;0;18;1.000;3600000;0
6419;185220;565;0;0;0;0;.00nan;0;0
6419;56126;568;0;0;0;0;.00nan;0;0
6419;64800;568;70;18;1;17;.944;3600000;0
6419;84430;565;76;47;4;43;.915;3600000;0
6420;43896;573;95;31;1;30;.968;3600000;0
6420;84945;573;0;0;0;0;.00nan;0;0
6420;91403;577;0;0;0;0;.00nan;0;0
6420;143829;577;74;32;2;30;.938;3574000;0
6421;179602;564;97;20;0;20;1.000;3600000;0
6421;64961;571;85;25;1;24;.960;3575000;0
6421;78251;564;0;0;0;0;.00nan;0;0
6421;90734;571;0;0;0;0;.00nan;0;0
6422;14191;574;51;18;3;15;.833;3600000;0
6422;170144;574;0;0;0;0;.00nan;0;0
6422;57993;569;91;55;4;51;.927;3576000;0
6422;141419;569;0;0;0;0;.00nan;0;0
6423;320;562;43;41;6;35;.854;3013000;0
6423;6127;575;94;21;0;21;1.000;3600000;0
6423;185232;575;0;0;0;0;.00nan;0;0
6423;155917;562;60;8;0;8;1.000;587000;0
6424;169493;572;37;32;6;26;.813;3110000;0
6424;65014;570;0;0;0;0;.00nan;0;0
6424;67614;570;88;24;1;23;.958;3600000;0
6424;68167;572;53;3;0;3;1.000;490000;0
6425;11925;576;0;0;0;0;.00nan;0;0
6425;185220;565;0;0;0;0;.00nan;0;0
6425;67454;576;98;37;1;36;.973;3600000;0
6425;84430;565;41;33;5;28;.848;3600000;0
6426;43896;573;61;19;2;17;.895;3600000;0
6426;57993;569;0;0;0;0;.00nan;0;0
6426;84945;573;0;0;0;0;.00nan;0;0
6426;141419;569;79;40;3;37;.925;3588000;0
6427;14191;574;0;0;0;0;.00nan;0;0
6427;170144;574;64;25;2;23;.920;3551000;0
6427;56126;568;0;0;0;0;.00nan;0;0
6427;64800;568;80;24;1;23;.958;3600000;0
6428;6127;575;60;22;2;20;.909;3600000;0
6428;13065;578;64;30;3;27;.900;3559000;0
6428;185232;575;0;0;0;0;.00nan;0;0
6428;35520;578;0;0;0;0;.00nan;0;0
6429;169493;572;0;0;0;0;.00nan;0;0
6429;64961;571;0;0;0;0;.00nan;0;0
6429;68167;572;89;38;1;37;.974;3900000;0
6429;90734;571;90;33;1;32;.970;3900000;0
6430;320;562;92;50;2;48;.960;3550000;0
6430;65014;570;92;19;0;19;1.000;3600000;0
6430;67614;570;0;0;0;0;.00nan;0;0
6430;155917;562;0;0;0;0;.00nan;0;0
6431;169493;572;0;0;0;0;.00nan;0;0
6431;179602;564;77;17;1;16;.941;3600000;0
6431;68167;572;55;29;4;25;.862;3600000;0
6431;78251;564;0;0;0;0;.00nan;0;0
6432;6127;575;95;33;1;32;.970;3600000;0
6432;185232;575;0;0;0;0;.00nan;0;0
6432;43896;573;52;28;4;24;.857;3600000;0
6432;84945;573;0;0;0;0;.00nan;0;0
6433;185220;565;74;32;3;29;.906;3600000;0
6433;84430;565;0;0;0;0;.00nan;0;0
6433;91403;577;0;0;0;0;.00nan;0;0
6433;143829;577;100;23;0;23;1.000;3600000;0
6434;13065;578;48;34;5;29;.853;3600000;0
6434;35520;578;0;0;0;0;.00nan;0;0
6434;64961;571;0;0;0;0;.00nan;0;0
6434;90734;571;54;25;4;21;.840;3600000;0
6435;7063;566;0;0;0;0;.00nan;0;0
6435;44405;566;83;36;3;33;.917;3900000;0
6435;57993;569;0;0;0;0;.00nan;0;0
6435;141419;569;81;47;3;44;.936;3900000;0
6436;56126;568;0;0;0;0;.00nan;0;0
6436;64800;568;100;33;0;33;1.000;3600000;0
6436;91403;577;0;0;0;0;.00nan;0;0
6436;143829;577;69;38;4;34;.895;3600000;0
6437;14191;574;0;0;0;0;.00nan;0;0
6437;170144;574;64;29;3;26;.897;3600000;0
6437;185220;565;0;0;0;0;.00nan;0;0
6437;84430;565;67;39;4;35;.897;3600000;0
6438;320;562;52;37;5;32;.865;3516000;0
6438;179602;564;0;0;0;0;.00nan;0;0
6438;78251;564;57;23;3;20;.870;3600000;0
6438;155917;562;0;0;0;0;.00nan;0;0
6439;6127;575;0;0;0;0;.00nan;0;0
6439;13065;578;0;0;0;0;.00nan;0;0
6439;185232;575;65;26;2;24;.923;3900000;0
6439;35520;578;95;36;2;34;.944;3900000;0
6440;7063;566;70;26;2;24;.923;3516000;0
6440;44405;566;0;0;0;0;.00nan;0;0
6440;64961;571;100;34;0;34;1.000;3600000;0
6440;90734;571;0;0;0;0;.00nan;0;0
6441;169493;572;0;0;0;0;.00nan;0;0
6441;43896;573;65;13;1;12;.923;3600000;0
6441;68167;572;83;39;3;36;.923;3556000;0
6441;84945;573;0;0;0;0;.00nan;0;0
6442;11925;576;97;44;1;43;.977;3600000;0
6442;65014;570;96;21;0;21;1.000;3600000;0
6442;67454;576;0;0;0;0;.00nan;0;0
6442;67614;570;0;0;0;0;.00nan;0;0
6443;11925;576;0;0;0;0;.00nan;0;0
6443;169493;572;0;0;0;0;.00nan;0;0
6443;67454;576;94;22;0;22;1.000;3600000;0
6443;68167;572;78;23;1;22;.957;3587000;0
6444;179602;564;85;17;1;16;.941;3600000;0
6444;57993;569;0;0;0;0;.00nan;0;0
6444;78251;564;0;0;0;0;.00nan;0;0
6444;141419;569;98;43;2;41;.953;3543000;0
6445;13065;578;74;41;4;37;.902;3600000;0
6445;185220;565;84;29;1;28;.966;3600000;0
6445;35520;578;0;0;0;0;.00nan;0;0
6445;84430;565;0;0;0;0;.00nan;0;0
6446;6127;575;52;23;3;20;.870;3554000;0
6446;185232;575;0;0;0;0;.00nan;0;0
6446;65014;570;69;19;1;18;.947;3600000;0
6446;67614;570;0;0;0;0;.00nan;0;0
6447;7063;566;0;0;0;0;.00nan;0;0
6447;44405;566;100;35;0;35;1.000;3600000;0
6447;91403;577;0;0;0;0;.00nan;0;0
6447;143829;577;71;17;1;16;.941;3572000;0
6448;320;562;52;36;5;31;.861;3600000;0
6448;91403;577;97;22;0;22;1.000;3600000;0
6448;143829;577;0;0;0;0;.00nan;0;0
6448;155917;562;0;0;0;0;.00nan;0;0
6449;56126;568;0;0;0;0;.00nan;0;0
6449;57993;569;99;46;1;45;.978;3600000;0
6449;64800;568;56;17;2;15;.882;3543000;0
6449;141419;569;0;0;0;0;.00nan;0;0
6450;14191;574;0;0;0;0;.00nan;0;0
6450;170144;574;76;20;1;19;.950;3600000;0
6450;179602;564;93;40;2;38;.950;3579000;0
6450;78251;564;0;0;0;0;.00nan;0;0
6451;11925;576;98;33;0;33;1.000;3204000;0
6451;185220;565;74;20;1;19;.950;3600000;0
6451;67454;576;27;7;3;4;.571;351000;0
6451;84430;565;0;0;0;0;.00nan;0;0
6452;7063;566;0;0;0;0;.00nan;0;0
6452;44405;566;100;25;0;25;1.000;3686000;0
6452;64961;571;80;24;1;23;.958;3686000;0
6452;90734;571;0;0;0;0;.00nan;0;0
6453;13065;578;56;31;4;27;.871;3567000;0
6453;169493;572;0;0;0;0;.00nan;0;0
6453;35520;578;0;0;0;0;.00nan;0;0
6453;68167;572;69;25;2;23;.920;3600000;0
6454;57993;569;0;0;0;0;.00nan;0;0
6454;65014;570;0;0;0;0;.00nan;0;0
6454;67614;570;92;25;1;24;.960;3600000;0
6454;141419;569;76;31;3;28;.903;3565000;0
6455;14191;574;51;26;4;22;.846;3540000;0
6455;170144;574;0;0;0;0;.00nan;0;0
6455;179602;564;0;0;0;0;.00nan;0;0
6455;78251;564;99;43;2;41;.953;3600000;0
6456;185220;565;0;0;0;0;.00nan;0;0
6456;43896;573;82;28;2;26;.929;3582000;0
6456;84430;565;100;48;1;47;.979;3600000;0
6456;84945;573;0;0;0;0;.00nan;0;0
6457;169493;572;0;0;0;0;.00nan;0;0
6457;56126;568;0;0;0;0;.00nan;0;0
6457;64800;568;71;17;1;16;.941;3600000;0
6457;68167;572;89;50;4;46;.920;3600000;0
6458;320;562;79;36;3;33;.917;3555000;0
6458;64961;571;0;0;0;0;.00nan;0;0
6458;90734;571;75;19;1;18;.947;3600000;0
6458;155917;562;0;0;0;0;.00nan;0;0
6459;6127;575;66;26;3;23;.885;3900000;0
6459;7063;566;0;0;0;0;.00nan;0;0
6459;185232;575;0;0;0;0;.00nan;0;0
6459;44405;566;56;31;3;28;.903;3900000;0
6460;13065;578;55;6;0;6;1.000;373000;0
6460;35520;578;43;43;6;37;.860;3227000;0
6460;91403;577;63;15;1;14;.933;3600000;0
6460;143829;577;0;0;0;0;.00nan;0;0
6461;7063;566;0;0;0;0;.00nan;0;0
6461;44405;566;69;38;3;35;.921;3600000;0
6461;56126;568;0;0;0;0;.00nan;0;0
6461;64800;568;86;18;0;18;1.000;3600000;0
6462;6127;575;65;21;2;19;.905;3577000;0
6462;11925;576;0;0;0;0;.00nan;0;0
6462;185232;575;0;0;0;0;.00nan;0;0
6462;67454;576;97;39;1;38;.974;3600000;0
6463;185220;565;45;17;3;14;.824;3550000;0
6463;57993;569;0;0;0;0;.00nan;0;0
6463;84430;565;0;0;0;0;.00nan;0;0
6463;141419;569;82;32;2;30;.938;3600000;0
6464;320;562;58;32;4;28;.875;3600000;0
6464;91403;577;0;0;0;0;.00nan;0;0
6464;143829;577;43;30;5;25;.833;3600000;0
6464;155917;562;0;0;0;0;.00nan;0;0
6465;43896;573;59;18;2;16;.889;3544000;0
6465;64961;571;0;0;0;0;.00nan;0;0
6465;84945;573;0;0;0;0;.00nan;0;0
6465;90734;571;100;32;0;32;1.000;3600000;0
6466;13065;578;100;42;0;42;1.000;3600000;0
6466;14191;574;0;0;0;0;.00nan;0;0
6466;170144;574;50;20;2;18;.900;3571000;0
6466;35520;578;0;0;0;0;.00nan;0;0
6467;185220;565;0;0;0;0;.00nan;0;0
6467;65014;570;86;33;2;31;.939;3600000;0
6467;67614;570;0;0;0;0;.00nan;0;0
6467;84430;565;61;32;3;29;.906;3586000;0
6468;56126;568;0;0;0;0;.00nan;0;0
6468;64800;568;66;18;1;17;.944;3600000;0
6468;64961;571;0;0;0;0;.00nan;0;0
6468;90734;571;64;29;3;26;.897;3531000;0
6469;320;562;62;28;3;25;.893;3600000;0
6469;13065;578;50;29;4;25;.862;3549000;0
6469;35520;578;0;0;0;0;.00nan;0;0
6469;155917;562;0;0;0;0;.00nan;0;0
6470;11925;576;73;23;2;21;.913;3600000;0
6470;57993;569;0;0;0;0;.00nan;0;0
6470;67454;576;0;0;0;0;.00nan;0;0
6470;141419;569;58;26;3;23;.885;3549000;0
6471;6127;575;99;35;1;34;.971;3600000;0
6471;179602;564;15;21;6;15;.714;3600000;0
6471;185232;575;0;0;0;0;.00nan;0;0
6471;78251;564;0;0;0;0;.00nan;0;0
6472;7063;566;0;0;0;0;.00nan;0;0
6472;43896;573;75;21;1;20;.952;3900000;0
6472;44405;566;100;50;1;49;.980;3900000;0
6472;84945;573;0;0;0;0;.00nan;0;0
6473;169493;572;0;0;0;0;.00nan;0;0
6473;68167;572;95;33;1;32;.970;3600000;0
6473;91403;577;0;0;0;0;.00nan;0;0
6473;143829;577;60;26;3;23;.885;3516000;0
6474;7063;566;65;47;5;42;.894;3823000;0
6474;185220;565;58;31;4;27;.871;3823000;0
6474;44405;566;0;0;0;0;.00nan;0;0
6474;84430;565;0;0;0;0;.00nan;0;0
6475;11925;576;0;0;0;0;.00nan;0;0
6475;57993;569;63;26;3;23;.885;3600000;0
6475;67454;576;89;18;0;18;1.000;3600000;0
6475;141419;569;0;0;0;0;.00nan;0;0
6476;169493;572;0;0;0;0;.00nan;0;0
6476;43896;573;0;0;0;0;.00nan;0;0
6476;68167;572;83;43;4;39;.907;3600000;0
6476;84945;573;77;22;1;21;.955;3600000;0
6477;56126;568;90;26;1;25;.962;3600000;0
6477;64800;568;0;0;0;0;.00nan;0;0
6477;64961;571;96;42;2;40;.952;3579000;0
6477;90734;571;0;0;0;0;.00nan;0;0
6478;14191;574;0;0;0;0;.00nan;0;0
6478;170144;574;98;34;1;33;.971;3600000;0
6478;65014;570;84;36;2;34;.944;3543000;0
6478;67614;570;0;0;0;0;.00nan;0;0
6479;320;562;72;36;3;33;.917;3900000;0
6479;13065;578;0;0;0;0;.00nan;0;0
6479;35520;578;64;26;3;23;.885;3900000;0
6479;155917;562;0;0;0;0;.00nan;0;0
6480;6127;575;0;0;0;0;.00nan;0;0
6480;185232;575;49;40;5;35;.875;3900000;0
6480;91403;577;28;20;5;15;.750;3900000;0
6480;143829;577;0;0;0;0;.00nan;0;0
6481;11925;576;0;0;0;0;.00nan;0;0
6481;56126;568;0;0;0;0;.00nan;0;0
6481;64800;568;70;21;1;20;.952;3600000;0
6481;67454;576;73;43;4;39;.907;3600000;0
6482;179602;564;58;33;4;29;.879;3600000;0
6482;43896;573;100;35;0;35;1.000;3600000;0
6482;78251;564;0;0;0;0;.00nan;0;0
6482;84945;573;0;0;0;0;.00nan;0;0
6483;14191;574;0;0;0;0;.00nan;0;0
6483;170144;574;85;35;2;33;.943;3600000;0
6483;57993;569;34;36;6;30;.833;2313000;0
6483;141419;569;39;18;3;15;.833;1287000;0
6484;6127;575;50;27;4;23;.852;3544000;0
6484;13065;578;91;34;2;32;.941;3600000;0
6484;185232;575;0;0;0;0;.00nan;0;0
6484;35520;578;0;0;0;0;.00nan;0;0
6485;64961;571;0;0;0;0;.00nan;0;0
6485;90734;571;97;38;2;36;.947;3900000;0
6485;91403;577;0;0;0;0;.00nan;0;0
6485;143829;577;64;23;2;21;.913;3900000;0
6486;320;562;56;37;5;32;.865;3600000;0
6486;43896;573;59;22;2;20;.909;3600000;0
6486;84945;573;0;0;0;0;.00nan;0;0
6486;155917;562;0;0;0;0;.00nan;0;0
6487;7063;566;0;0;0;0;.00nan;0;0
6487;44405;566;53;26;3;23;.885;3600000;0
6487;65014;570;80;32;2;30;.938;3600000;0
6487;67614;570;0;0;0;0;.00nan;0;0
6488;179602;564;0;0;0;0;.00nan;0;0
6488;56126;568;0;0;0;0;.00nan;0;0
6488;64800;568;93;29;1;28;.966;3600000;0
6488;78251;564;83;39;4;35;.897;3600000;0
6489;320;562;72;38;3;35;.921;3600000;0
6489;6127;575;64;22;2;20;.909;3600000;0
6489;185232;575;0;0;0;0;.00nan;0;0
6489;155917;562;0;0;0;0;.00nan;0;0
6490;169493;572;0;0;0;0;.00nan;0;0
6490;65014;570;0;0;0;0;.00nan;0;0
6490;67614;570;77;24;1;23;.958;3600000;0
6490;68167;572;97;44;2;42;.955;3574000;0
6491;7063;566;0;0;0;0;.00nan;0;0
6491;11925;576;0;0;0;0;.00nan;0;0
6491;44405;566;45;19;3;16;.842;3600000;0
6491;67454;576;58;36;4;32;.889;3600000;0
6492;14191;574;0;0;0;0;.00nan;0;0
6492;170144;574;84;41;3;38;.927;3600000;0
6492;43896;573;38;20;4;16;.800;3586000;0
6492;84945;573;0;0;0;0;.00nan;0;0
6493;13065;578;82;23;1;22;.957;3600000;0
6493;35520;578;0;0;0;0;.00nan;0;0
6493;64961;571;0;0;0;0;.00nan;0;0
6493;90734;571;68;25;3;22;.880;3571000;0
6494;7063;566;100;43;1;42;.977;3600000;0
6494;179602;564;66;22;2;20;.909;3541000;0
6494;44405;566;0;0;0;0;.00nan;0;0
6494;78251;564;0;0;0;0;.00nan;0;0
6495;65014;570;75;30;2;28;.933;3561000;0
6495;67614;570;0;0;0;0;.00nan;0;0
6495;91403;577;0;0;0;0;.00nan;0;0
6495;143829;577;86;24;1;23;.958;3600000;0
6496;185220;565;25;13;4;9;.692;879000;0
6496;64961;571;62;27;3;24;.889;3600000;0
6496;84430;565;84;17;0;17;1.000;2678000;0
6496;90734;571;0;0;0;0;.00nan;0;0
6497;14191;574;57;17;2;15;.882;3600000;0
6497;170144;574;0;0;0;0;.00nan;0;0
6497;43896;573;0;0;0;0;.00nan;0;0
6497;84945;573;85;49;3;46;.939;3600000;0
6498;320;562;0;0;0;0;.00nan;0;0
6498;56126;568;0;0;0;0;.00nan;0;0
6498;64800;568;64;13;1;12;.923;3600000;0
6498;155917;562;79;45;3;42;.933;3579000;0
6499;13065;578;0;0;0;0;.00nan;0;0
6499;35520;578;57;30;4;26;.867;3600000;0
6499;57993;569;0;0;0;0;.00nan;0;0
6499;141419;569;54;18;3;15;.833;3600000;0
6500;6127;575;84;35;2;33;.943;3600000;0
6500;169493;572;0;0;0;0;.00nan;0;0
6500;185232;575;0;0;0;0;.00nan;0;0
6500;68167;572;73;32;3;29;.906;3553000;0
6501;179602;564;0;0;0;0;.00nan;0;0
6501;65014;570;94;45;3;42;.933;3600000;0
6501;67614;570;0;0;0;0;.00nan;0;0
6501;78251;564;42;18;4;14;.778;3600000;0
6502;185220;565;58;22;2;20;.909;3579000;0
6502;84430;565;0;0;0;0;.00nan;0;0
6502;91403;577;0;0;0;0;.00nan;0;0
6502;143829;577;82;16;0;16;1.000;3600000;0
6503;7063;566;0;0;0;0;.00nan;0;0
6503;44405;566;99;31;1;30;.968;3600000;0
6503;56126;568;0;0;0;0;.00nan;0;0
6503;64800;568;65;34;4;30;.882;3600000;0
6504;11925;576;70;27;2;25;.926;3600000;0
6504;14191;574;0;0;0;0;.00nan;0;0
6504;170144;574;84;14;0;14;1.000;3600000;0
6504;67454;576;0;0;0;0;.00nan;0;0
6505;320;562;69;22;2;20;.909;3581000;0
6505;57993;569;0;0;0;0;.00nan;0;0
6505;141419;569;69;19;1;18;.947;3600000;0
6505;155917;562;0;0;0;0;.00nan;0;0
6506;6127;575;65;33;3;30;.909;3600000;0
6506;185232;575;0;0;0;0;.00nan;0;0
6506;64961;571;0;0;0;0;.00nan;0;0
6506;90734;571;100;32;0;32;1.000;3600000;0
6507;13065;578;59;18;2;16;.889;3710000;0
6507;169493;572;0;0;0;0;.00nan;0;0
6507;35520;578;0;0;0;0;.00nan;0;0
6507;68167;572;95;32;1;31;.969;3710000;0
6508;179602;564;0;0;0;0;.00nan;0;0
6508;185220;565;83;41;3;38;.927;3900000;0
6508;78251;564;78;31;3;28;.903;3900000;0
6508;84430;565;0;0;0;0;.00nan;0;0
6509;14191;574;0;0;0;0;.00nan;0;0
6509;170144;574;78;22;1;21;.955;3600000;0
6509;91403;577;0;0;0;0;.00nan;0;0
6509;143829;577;73;39;4;35;.897;3600000;0
6510;11925;576;0;0;0;0;.00nan;0;0
6510;64961;571;0;0;0;0;.00nan;0;0
6510;67454;576;70;29;2;27;.931;3722000;0
6510;90734;571;82;31;1;30;.968;3722000;0
6511;320;562;64;25;2;23;.920;3600000;0
6511;169493;572;0;0;0;0;.00nan;0;0
6511;68167;572;77;23;1;22;.957;3600000;0
6511;155917;562;0;0;0;0;.00nan;0;0
6512;6127;575;54;37;5;32;.865;3600000;0
6512;185232;575;0;0;0;0;.00nan;0;0
6512;43896;573;78;25;2;23;.920;3600000;0
6512;84945;573;0;0;0;0;.00nan;0;0
6513;7063;566;0;0;0;0;.00nan;0;0
6513;13065;578;55;34;4;30;.882;3600000;0
6513;35520;578;0;0;0;0;.00nan;0;0
6513;44405;566;76;28;1;27;.964;3600000;0
6514;56126;568;0;0;0;0;.00nan;0;0
6514;64800;568;80;41;3;38;.927;3536000;0
6514;65014;570;82;28;1;27;.964;3600000;0
6514;67614;570;0;0;0;0;.00nan;0;0
6515;11925;576;0;0;0;0;.00nan;0;0
6515;13065;578;53;30;5;25;.833;3600000;0
6515;35520;578;0;0;0;0;.00nan;0;0
6515;67454;576;62;25;2;23;.920;3600000;0
6516;43896;573;97;48;2;46;.958;3600000;0
6516;56126;568;0;0;0;0;.00nan;0;0
6516;64800;568;78;20;1;19;.950;3600000;0
6516;84945;573;0;0;0;0;.00nan;0;0
6517;57993;569;0;0;0;0;.00nan;0;0
6517;91403;577;0;0;0;0;.00nan;0;0
6517;141419;569;100;41;2;39;.951;3900000;0
6517;143829;577;67;26;2;24;.923;3900000;0
6518;185220;565;0;0;0;0;.00nan;0;0
6518;43896;573;0;0;0;0;.00nan;0;0
6518;84430;565;40;28;5;23;.821;3591000;0
6518;84945;573;92;49;3;46;.939;3600000;0
6519;57993;569;58;46;6;40;.870;3600000;0
6519;64961;571;0;0;0;0;.00nan;0;0
6519;90734;571;43;13;3;10;.769;3600000;0
6519;141419;569;0;0;0;0;.00nan;0;0
6520;7063;566;80;22;1;21;.955;3600000;0
6520;13065;578;0;0;0;0;.00nan;0;0
6520;35520;578;57;29;4;25;.862;3600000;0
6520;44405;566;0;0;0;0;.00nan;0;0
6521;169493;572;0;0;0;0;.00nan;0;0
6521;56126;568;0;0;0;0;.00nan;0;0
6521;64800;568;66;15;1;14;.933;3600000;0
6521;68167;572;83;46;4;42;.913;3600000;0
6522;11925;576;0;0;0;0;.00nan;0;0
6522;179602;564;0;0;0;0;.00nan;0;0
6522;67454;576;89;50;4;46;.920;3600000;0
6522;78251;564;80;14;0;14;1.000;3600000;0
6523;320;562;71;24;1;23;.958;3900000;0
6523;65014;570;89;33;1;32;.970;3900000;0
6523;67614;570;0;0;0;0;.00nan;0;0
6523;155917;562;0;0;0;0;.00nan;0;0
6524;185220;565;97;42;2;40;.952;3900000;0
6524;56126;568;0;0;0;0;.00nan;0;0
6524;64800;568;79;25;2;23;.920;3900000;0
6524;84430;565;0;0;0;0;.00nan;0;0
6525;7063;566;0;0;0;0;.00nan;0;0
6525;44405;566;100;53;0;53;1.000;3600000;0
6525;91403;577;0;0;0;0;.00nan;0;0
6525;143829;577;51;21;3;18;.857;3600000;0
6526;14191;574;0;0;0;0;.00nan;0;0
6526;170144;574;37;23;5;18;.783;3600000;0
6526;64961;571;0;0;0;0;.00nan;0;0
6526;90734;571;100;42;2;40;.952;3600000;0
6527;6127;575;62;24;2;22;.917;3600000;0
6527;169493;572;0;0;0;0;.00nan;0;0
6527;185232;575;0;0;0;0;.00nan;0;0
6527;68167;572;82;44;4;40;.909;3524000;0
6528;320;562;60;43;6;37;.860;3600000;0
6528;179602;564;0;0;0;0;.00nan;0;0
6528;78251;564;70;22;1;21;.955;3600000;0
6528;155917;562;0;0;0;0;.00nan;0;0
6529;14191;574;71;27;3;24;.889;3582000;0
6529;170144;574;0;0;0;0;.00nan;0;0
6529;64961;571;91;35;1;34;.971;3600000;0
6529;90734;571;0;0;0;0;.00nan;0;0
6530;11925;576;0;0;0;0;.00nan;0;0
6530;57993;569;0;0;0;0;.00nan;0;0
6530;67454;576;52;28;3;25;.893;3900000;0
6530;141419;569;48;19;3;16;.842;3900000;0
6531;13065;578;49;37;5;32;.865;3600000;0
6531;35520;578;0;0;0;0;.00nan;0;0
6531;91403;577;0;0;0;0;.00nan;0;0
6531;143829;577;63;12;1;11;.917;3600000;0
6532;7063;566;0;0;0;0;.00nan;0;0
6532;185220;565;0;0;0;0;.00nan;0;0
6532;44405;566;90;44;3;41;.932;3600000;0
6532;84430;565;100;24;0;24;1.000;3600000;0
6533;6127;575;98;39;1;38;.974;3600000;0
6533;185232;575;0;0;0;0;.00nan;0;0
6533;65014;570;67;26;2;24;.923;3600000;0
6533;67614;570;0;0;0;0;.00nan;0;0
6534;169493;572;60;36;4;32;.889;3771000;0
6534;43896;573;57;26;3;23;.885;3771000;0
6534;68167;572;0;0;0;0;.00nan;0;0
6534;84945;573;0;0;0;0;.00nan;0;0
6535;64961;571;0;0;0;0;.00nan;0;0
6535;90734;571;51;24;3;21;.875;3600000;0
6535;91403;577;23;14;4;10;.714;2473000;0
6535;143829;577;36;19;4;15;.789;1127000;0
6536;14191;574;0;0;0;0;.00nan;0;0
6536;170144;574;88;35;2;33;.943;3693000;0
6536;179602;564;0;0;0;0;.00nan;0;0
6536;78251;564;85;42;3;39;.929;3724000;0
6537;6127;575;88;32;1;31;.969;3600000;0
6537;185232;575;0;0;0;0;.00nan;0;0
6537;56126;568;0;0;0;0;.00nan;0;0
6537;64800;568;59;16;2;14;.875;3546000;0
6538;13065;578;38;13;3;10;.769;576000;0
6538;35520;578;79;35;3;32;.914;3024000;0
6538;65014;570;79;12;0;12;1.000;3600000;0
6538;67614;570;0;0;0;0;.00nan;0;0
6539;320;562;62;22;2;20;.909;3789000;0
6539;169493;572;0;0;0;0;.00nan;0;0
6539;68167;572;73;25;1;24;.960;3789000;0
6539;155917;562;0;0;0;0;.00nan;0;0
6540;11925;576;0;0;0;0;.00nan;0;0
6540;64961;571;100;23;0;23;1.000;3600000;0
6540;67454;576;57;21;2;19;.905;3528000;0
6540;90734;571;0;0;0;0;.00nan;0;0
6541;320;562;89;39;2;37;.949;3900000;0
6541;185220;565;0;0;0;0;.00nan;0;0
6541;84430;565;62;17;2;15;.882;3900000;0
6541;155917;562;0;0;0;0;.00nan;0;0
6542;13065;578;77;35;3;32;.914;3900000;0
6542;35520;578;0;0;0;0;.00nan;0;0
6542;43896;573;57;22;3;19;.864;3900000;0
6542;84945;573;0;0;0;0;.00nan;0;0
6543;56126;568;0;0;0;0;.00nan;0;0
6543;57993;569;0;0;0;0;.00nan;0;0
6543;64800;568;69;19;1;18;.947;3600000;0
6543;141419;569;71;47;5;42;.894;3600000;0
6544;6127;575;81;42;3;39;.929;3600000;0
6544;14191;574;0;0;0;0;.00nan;0;0
6544;170144;574;100;18;0;18;1.000;3600000;0
6544;185232;575;0;0;0;0;.00nan;0;0
6545;65014;570;67;29;3;26;.897;3512000;0
6545;67614;570;0;0;0;0;.00nan;0;0
6545;91403;577;0;0;0;0;.00nan;0;0
6545;143829;577;82;33;1;32;.970;3600000;0
6546;7063;566;0;0;0;0;.00nan;0;0
6546;169493;572;0;0;0;0;.00nan;0;0
6546;44405;566;68;26;2;24;.923;3524000;0
6546;68167;572;100;25;0;25;1.000;3600000;0
6547;6127;575;0;0;0;0;.00nan;0;0
6547;179602;564;0;0;0;0;.00nan;0;0
6547;185232;575;100;38;0;38;1.000;3600000;0
6547;78251;564;80;21;1;20;.952;3555000;0
6548;169493;572;0;0;0;0;.00nan;0;0
6548;64961;571;85;17;0;17;1.000;3600000;0
6548;68167;572;54;36;5;31;.861;3600000;0
6548;90734;571;0;0;0;0;.00nan;0;0
6549;320;562;0;0;0;0;.00nan;0;0
6549;14191;574;0;0;0;0;.00nan;0;0
6549;170144;574;69;24;2;22;.917;3600000;0
6549;155917;562;80;51;4;47;.922;3589000;0
6550;13065;578;0;0;0;0;.00nan;0;0
6550;35520;578;92;33;2;31;.939;3600000;0
6550;57993;569;57;22;3;19;.864;3600000;0
6550;141419;569;0;0;0;0;.00nan;0;0
6551;7063;566;39;23;4;19;.826;3600000;0
6551;11925;576;43;30;6;24;.800;2692000;0
6551;44405;566;0;0;0;0;.00nan;0;0
6551;67454;576;66;8;0;8;1.000;883000;0
6552;56126;568;0;0;0;0;.00nan;0;0
6552;64800;568;72;31;2;29;.935;3600000;0
6552;91403;577;69;31;3;28;.903;3585000;0
6552;143829;577;0;0;0;0;.00nan;0;0
6553;11925;576;0;0;0;0;.00nan;0;0
6553;65014;570;71;22;1;21;.955;3900000;0
6553;67454;576;95;47;1;46;.979;3900000;0
6553;67614;570;0;0;0;0;.00nan;0;0
6554;11925;576;62;27;3;24;.889;3600000;0
6554;43896;573;0;0;0;0;.00nan;0;0
6554;67454;576;0;0;0;0;.00nan;0;0
6554;84945;573;67;26;2;24;.923;3600000;0
6555;6127;575;0;0;0;0;.00nan;0;0
6555;185220;565;52;35;5;30;.857;3514000;0
6555;185232;575;75;34;3;31;.912;3600000;0
6555;84430;565;0;0;0;0;.00nan;0;0
6556;64961;571;84;26;1;25;.962;3600000;0
6556;65014;570;58;25;3;22;.880;3600000;0
6556;67614;570;0;0;0;0;.00nan;0;0
6556;90734;571;0;0;0;0;.00nan;0;0
6557;13065;578;77;49;4;45;.918;3600000;0
6557;14191;574;0;0;0;0;.00nan;0;0
6557;170144;574;100;29;0;29;1.000;3600000;0
6557;35520;578;0;0;0;0;.00nan;0;0
6558;320;562;74;24;2;22;.917;3600000;0
6558;7063;566;0;0;0;0;.00nan;0;0
6558;44405;566;68;28;3;25;.893;3576000;0
6558;155917;562;0;0;0;0;.00nan;0;0
6559;179602;564;0;0;0;0;.00nan;0;0
6559;57993;569;0;0;0;0;.00nan;0;0
6559;78251;564;80;25;1;24;.960;3600000;0
6559;141419;569;97;43;3;40;.930;3551000;0
6560;6127;575;89;38;2;36;.947;3600000;0
6560;7063;566;52;27;4;23;.852;3540000;0
6560;185232;575;0;0;0;0;.00nan;0;0
6560;44405;566;0;0;0;0;.00nan;0;0
6561;14191;574;0;0;0;0;.00nan;0;0
6561;170144;574;74;40;3;37;.925;3900000;0
6561;185220;565;86;44;3;41;.932;3900000;0
6561;84430;565;0;0;0;0;.00nan;0;0
6562;43896;573;100;35;1;34;.971;3600000;0
6562;84945;573;0;0;0;0;.00nan;0;0
6562;91403;577;0;0;0;0;.00nan;0;0
6562;143829;577;79;30;2;28;.933;3545000;0
6563;57993;569;0;0;0;0;.00nan;0;0
6563;64961;571;0;0;0;0;.00nan;0;0
6563;90734;571;59;31;4;27;.871;3827000;0
6563;141419;569;57;37;5;32;.865;3827000;0
6564;13065;578;91;40;3;37;.925;3883000;0
6564;35520;578;0;0;0;0;.00nan;0;0
6564;56126;568;0;0;0;0;.00nan;0;0
6564;64800;568;69;27;2;25;.926;3883000;0
6565;169493;572;0;0;0;0;.00nan;0;0
6565;179602;564;0;0;0;0;.00nan;0;0
6565;68167;572;87;26;1;25;.962;3900000;0
6565;78251;564;76;24;1;23;.958;3900000;0
6566;7063;566;0;0;0;0;.00nan;0;0
6566;44405;566;49;37;5;32;.865;3600000;0
6566;65014;570;0;0;0;0;.00nan;0;0
6566;67614;570;100;34;1;33;.971;3600000;0
6567;179602;564;82;33;2;31;.939;3900000;0
6567;78251;564;0;0;0;0;.00nan;0;0
6567;91403;577;88;41;2;39;.951;3900000;0
6567;143829;577;0;0;0;0;.00nan;0;0
6568;43896;573;0;0;0;0;.00nan;0;0
6568;64961;571;93;40;2;38;.950;3611000;0
6568;84945;573;78;25;1;24;.960;3611000;0
6568;90734;571;0;0;0;0;.00nan;0;0
6569;13065;578;0;0;0;0;.00nan;0;0
6569;35520;578;70;47;4;43;.915;3600000;0
6569;56126;568;100;22;0;22;1.000;3600000;0
6569;64800;568;0;0;0;0;.00nan;0;0
6570;14191;574;52;30;4;26;.867;3523000;0
6570;170144;574;0;0;0;0;.00nan;0;0
6570;185220;565;0;0;0;0;.00nan;0;0
6570;84430;565;73;33;2;31;.939;3600000;0
6571;320;562;90;37;1;36;.973;3600000;0
6571;11925;576;0;0;0;0;.00nan;0;0
6571;67454;576;44;19;3;16;.842;3600000;0
6571;155917;562;0;0;0;0;.00nan;0;0
6572;6127;575;44;16;3;13;.813;3900000;0
6572;185232;575;0;0;0;0;.00nan;0;0
6572;57993;569;90;42;3;39;.929;3900000;0
6572;141419;569;0;0;0;0;.00nan;0;0
6600;6127;575;70;31;2;29;.935;3600000;0
6600;185232;575;0;0;0;0;.00nan;0;0
6600;65014;570;79;19;1;18;.947;3600000;0
6600;67614;570;0;0;0;0;.00nan;0;0
6602;6541;571;0;0;0;0;.00nan;0;0
6602;179602;564;0;0;0;0;.00nan;0;0
6602;78251;564;27;28;6;22;.786;3600000;0
6602;90734;571;71;27;2;25;.926;3600000;0
6604;1601;573;0;0;0;0;.00nan;0;0
6604;11925;576;97;32;1;31;.969;3900000;0
6604;67454;576;0;0;0;0;.00nan;0;0
6604;84945;573;98;37;1;36;.973;3900000;0
6606;57993;569;0;0;0;0;.00nan;0;0
6606;91403;577;75;27;1;26;.963;3600000;0
6606;141419;569;68;31;3;28;.903;3600000;0
6606;143829;577;0;0;0;0;.00nan;0;0
6608;13065;578;76;38;3;35;.921;3591000;0
6608;35520;578;0;0;0;0;.00nan;0;0
6608;56126;568;0;0;0;0;.00nan;0;0
6608;64800;568;80;23;1;22;.957;3600000;0
6610;7063;566;0;0;0;0;.00nan;0;0
6610;185220;565;0;0;0;0;.00nan;0;0
6610;44405;566;82;25;1;24;.960;3600000;0
6610;84430;565;79;38;3;35;.921;3597000;0
6612;320;562;41;23;4;19;.826;3600000;0
6612;169493;572;0;0;0;0;.00nan;0;0
6612;68167;572;83;35;2;33;.943;3600000;0
6612;155917;562;0;0;0;0;.00nan;0;0
6614;6541;571;0;0;0;0;.00nan;0;0
6614;57993;569;73;41;3;38;.927;3900000;0
6614;90734;571;63;26;3;23;.885;3900000;0
6614;141419;569;0;0;0;0;.00nan;0;0
6616;320;562;96;39;1;38;.974;3900000;0
6616;1601;573;0;0;0;0;.00nan;0;0
6616;84945;573;86;29;1;28;.966;3900000;0
6616;155917;562;0;0;0;0;.00nan;0;0
6618;14191;574;92;53;3;50;.943;3656000;0
6618;170144;574;0;0;0;0;.00nan;0;0
6618;91403;577;50;29;4;25;.862;3655000;0
6618;143829;577;0;0;0;0;.00nan;0;0
6620;11925;576;66;21;2;19;.905;3600000;0
6620;169493;572;0;0;0;0;.00nan;0;0
6620;67454;576;0;0;0;0;.00nan;0;0
6620;68167;572;53;37;5;32;.865;3600000;0
6622;13065;578;0;0;0;0;.00nan;0;0
6622;185220;565;0;0;0;0;.00nan;0;0
6622;35520;578;87;31;2;29;.935;3900000;0
6622;84430;565;83;29;2;27;.931;3900000;0
6624;6127;575;0;0;0;0;.00nan;0;0
6624;7063;566;0;0;0;0;.00nan;0;0
6624;185232;575;51;41;5;36;.878;3519000;0
6624;44405;566;72;33;3;30;.909;3600000;0
6626;179602;564;100;28;0;28;1.000;3600000;0
6626;56126;568;0;0;0;0;.00nan;0;0
6626;64800;568;71;25;3;22;.880;3582000;0
6626;78251;564;0;0;0;0;.00nan;0;0
6628;56126;568;100;40;1;39;.975;3600000;0
6628;64800;568;0;0;0;0;.00nan;0;0
6628;65014;570;64;27;2;25;.926;3600000;0
6628;67614;570;0;0;0;0;.00nan;0;0
6630;7063;566;91;36;2;34;.944;3600000;0
6630;11925;576;0;0;0;0;.00nan;0;0
6630;44405;566;0;0;0;0;.00nan;0;0
6630;67454;576;71;38;3;35;.921;3600000;0
6632;14191;574;0;0;0;0;.00nan;0;0
6632;170144;574;99;23;0;23;1.000;3600000;0
6632;57993;569;0;0;0;0;.00nan;0;0
6632;141419;569;95;48;2;46;.958;3588000;0
6634;6541;571;67;20;2;18;.900;3600000;0
6634;13065;578;85;47;3;44;.936;3600000;0
6634;35520;578;0;0;0;0;.00nan;0;0
6634;90734;571;0;0;0;0;.00nan;0;0
6636;6127;575;49;17;3;14;.824;3900000;0
6636;169493;572;79;45;3;42;.933;3900000;0
6636;185232;575;0;0;0;0;.00nan;0;0
6636;68167;572;0;0;0;0;.00nan;0;0
6638;185220;565;57;23;3;20;.870;3600000;0
6638;84430;565;0;0;0;0;.00nan;0;0
6638;91403;577;0;0;0;0;.00nan;0;0
6638;143829;577;33;33;6;27;.818;3600000;0
6640;320;562;0;0;0;0;.00nan;0;0
6640;179602;564;56;18;2;16;.889;3553000;0
6640;78251;564;0;0;0;0;.00nan;0;0
6640;155917;562;99;40;1;39;.975;3600000;0
6642;6541;571;0;0;0;0;.00nan;0;0
6642;57993;569;55;5;0;5;1.000;545000;0
6642;90734;571;46;10;2;8;.800;3600000;0
6642;141419;569;57;48;6;42;.875;3055000;0
6646;6127;575;0;0;0;0;.00nan;0;0
6646;169493;572;0;0;0;0;.00nan;0;0
6646;185232;575;54;23;3;20;.870;3572000;0
6646;68167;572;86;31;1;30;.968;3600000;0
6650;320;562;95;38;2;36;.947;3600000;0
6650;7063;566;0;0;0;0;.00nan;0;0
6650;44405;566;86;32;3;29;.906;3569000;0
6650;155917;562;0;0;0;0;.00nan;0;0
6652;14191;574;0;0;0;0;.00nan;0;0
6652;170144;574;87;39;2;37;.949;3566000;0
6652;65014;570;84;32;1;31;.969;3600000;0
6652;67614;570;0;0;0;0;.00nan;0;0
6658;6127;575;52;14;2;12;.857;3600000;0
6658;169493;572;75;39;3;36;.923;3590000;0
6658;185232;575;0;0;0;0;.00nan;0;0
6658;68167;572;0;0;0;0;.00nan;0;0
6660;6541;571;36;20;4;16;.800;3547000;0
6660;65014;570;0;0;0;0;.00nan;0;0
6660;67614;570;89;36;2;34;.944;3600000;0
6660;90734;571;0;0;0;0;.00nan;0;0
6666;185220;565;0;0;0;0;.00nan;0;0
6666;57993;569;87;34;2;32;.941;3600000;0
6666;84430;565;73;39;4;35;.897;3519000;0
6666;141419;569;0;0;0;0;.00nan;0;0
6668;320;562;0;0;0;0;.00nan;0;0
6668;1601;573;100;32;0;32;1.000;3600000;0
6668;84945;573;0;0;0;0;.00nan;0;0
6668;155917;562;77;41;4;37;.902;3600000;0
6674;14191;574;0;0;0;0;.00nan;0;0
6674;170144;574;83;34;1;33;.971;3600000;0
6674;185220;565;0;0;0;0;.00nan;0;0
6674;84430;565;74;26;2;24;.923;3600000;0
6676;6127;575;45;10;2;8;.800;3600000;0
6676;169493;572;0;0;0;0;.00nan;0;0
6676;185232;575;0;0;0;0;.00nan;0;0
6676;68167;572;59;29;3;26;.897;3600000;0
6680;6541;571;0;0;0;0;.00nan;0;0
6680;13065;578;80;34;2;32;.941;3600000;0
6680;35520;578;0;0;0;0;.00nan;0;0
6680;90734;571;39;22;4;18;.818;3577000;0
6682;320;562;98;38;1;37;.974;3900000;0
6682;11925;576;82;29;1;28;.966;3900000;0
6682;67454;576;0;0;0;0;.00nan;0;0
6682;155917;562;0;0;0;0;.00nan;0;0
6686;320;562;0;0;0;0;.00nan;0;0
6686;6541;571;69;28;2;26;.929;3540000;0
6686;90734;571;0;0;0;0;.00nan;0;0
6686;155917;562;100;38;0;38;1.000;3600000;0
6688;7063;566;0;0;0;0;.00nan;0;0
6688;11925;576;0;0;0;0;.00nan;0;0
6688;44405;566;63;22;2;20;.909;3600000;0
6688;67454;576;72;35;3;32;.914;3600000;0
6690;14191;574;75;25;2;23;.920;3600000;0
6690;170144;574;0;0;0;0;.00nan;0;0
6690;57993;569;0;0;0;0;.00nan;0;0
6690;141419;569;82;41;3;38;.927;3600000;0
6692;13065;578;0;0;0;0;.00nan;0;0
6692;35520;578;54;20;3;17;.850;3550000;0
6692;65014;570;94;29;1;28;.966;3600000;0
6692;67614;570;0;0;0;0;.00nan;0;0
6697;1712;893;49;29;4;25;.862;3766000;0
6697;5354;873;0;0;0;0;.00nan;0;0
6697;7037;893;0;0;0;0;.00nan;0;0
6697;28833;873;53;30;5;25;.833;3766000;0
6698;63551;892;0;0;0;0;.00nan;0;0
6698;65762;876;82;40;3;37;.925;3600000;0
6698;141496;876;0;0;0;0;.00nan;0;0
6698;146684;892;48;28;4;24;.857;3567000;0
6699;987;875;70;39;4;35;.897;3542000;0
6699;3077;875;0;0;0;0;.00nan;0;0
6699;70099;877;0;0;0;0;.00nan;0;0
6699;149858;877;78;27;2;25;.926;3600000;0
6700;164710;878;64;36;4;32;.889;3600000;0
6700;28831;887;0;0;0;0;.00nan;0;0
6700;180316;887;65;23;1;22;.957;3600000;0
6700;80834;878;0;0;0;0;.00nan;0;0
6701;5559;881;88;19;0;19;1.000;3600000;0
6701;11716;881;0;0;0;0;.00nan;0;0
6701;196005;882;0;0;0;0;.00nan;0;0
6701;142911;882;82;41;3;38;.927;3600000;0
6702;164715;883;80;38;3;35;.921;3543000;0
6702;69536;886;72;21;1;20;.952;3600000;0
6702;78348;886;0;0;0;0;.00nan;0;0
6702;147567;883;0;0;0;0;.00nan;0;0
6703;11670;885;100;46;2;44;.957;3600000;0
6703;20645;1415;49;24;4;20;.833;3561000;0
6703;196012;1415;0;0;0;0;.00nan;0;0
6703;71075;885;0;0;0;0;.00nan;0;0
6704;1712;893;0;0;0;0;.00nan;0;0
6704;7037;893;54;22;3;19;.864;3600000;0
6704;164715;883;88;37;2;35;.946;3600000;0
6704;147567;883;0;0;0;0;.00nan;0;0
6705;987;875;79;29;2;27;.931;3893000;0
6705;3077;875;0;0;0;0;.00nan;0;0
6705;11670;885;69;28;2;26;.929;3900000;0
6705;71075;885;0;0;0;0;.00nan;0;0
6706;164710;878;91;39;2;37;.949;3600000;0
6706;63551;892;0;0;0;0;.00nan;0;0
6706;80834;878;0;0;0;0;.00nan;0;0
6706;146684;892;17;16;5;11;.688;3600000;0
6707;20645;1415;0;0;0;0;.00nan;0;0
6707;28831;887;0;0;0;0;.00nan;0;0
6707;196012;1415;50;32;5;27;.844;3600000;0
6707;180316;887;89;45;2;43;.956;3600000;0
6708;5559;881;84;47;3;44;.936;3900000;0
6708;11716;881;0;0;0;0;.00nan;0;0
6708;70099;877;0;0;0;0;.00nan;0;0
6708;149858;877;47;21;3;18;.857;3900000;0
6709;5354;873;0;0;0;0;.00nan;0;0
6709;28833;873;88;36;1;35;.972;3546000;0
6709;196005;882;0;0;0;0;.00nan;0;0
6709;142911;882;94;24;0;24;1.000;3600000;0
6710;1712;893;0;0;0;0;.00nan;0;0
6710;7037;893;84;32;1;31;.969;3600000;0
6710;65762;876;0;0;0;0;.00nan;0;0
6710;141496;876;50;27;4;23;.852;3600000;0
6711;987;875;91;35;1;34;.971;3600000;0
6711;3077;875;0;0;0;0;.00nan;0;0
6711;5559;881;97;53;3;50;.943;3524000;0
6711;11716;881;0;0;0;0;.00nan;0;0
6712;28831;887;0;0;0;0;.00nan;0;0
6712;180316;887;53;36;5;31;.861;3600000;0
6712;87798;877;94;33;1;32;.970;3600000;0
6712;149858;877;0;0;0;0;.00nan;0;0
6713;11670;885;84;31;3;28;.903;3546000;0
6713;75362;885;0;0;0;0;.00nan;0;0
6713;76574;882;0;0;0;0;.00nan;0;0
6713;142911;882;59;21;2;19;.905;3600000;0
6714;63551;892;56;28;3;25;.893;3600000;0
6714;78348;886;100;41;0;41;1.000;3600000;0
6714;146684;892;0;0;0;0;.00nan;0;0
6714;147567;886;0;0;0;0;.00nan;0;0
6715;5354;873;0;0;0;0;.00nan;0;0
6715;164710;878;80;29;2;27;.931;3600000;0
6715;28833;873;62;34;4;30;.882;3514000;0
6715;80834;878;0;0;0;0;.00nan;0;0
6716;164715;883;0;0;0;0;.00nan;0;0
6716;20645;1415;0;0;0;0;.00nan;0;0
6716;59025;1415;72;27;2;25;.926;3600000;0
6716;86180;883;79;41;3;38;.927;3579000;0
6717;11670;885;0;0;0;0;.00nan;0;0
6717;28831;887;0;0;0;0;.00nan;0;0
6717;180316;887;60;19;2;17;.895;3600000;0
6717;75362;885;67;48;6;42;.875;3600000;0
6718;164710;878;42;33;5;28;.848;3600000;0
6718;65762;876;0;0;0;0;.00nan;0;0
6718;80834;878;0;0;0;0;.00nan;0;0
6718;141496;876;89;33;2;31;.939;3600000;0
6719;987;875;78;41;4;37;.902;3600000;0
6719;3077;875;0;0;0;0;.00nan;0;0
6719;63551;892;78;23;1;22;.957;3600000;0
6719;146684;892;0;0;0;0;.00nan;0;0
6720;1712;893;0;0;0;0;.00nan;0;0
6720;7037;893;74;27;2;25;.926;3693000;0
6720;76574;882;0;0;0;0;.00nan;0;0
6720;142911;882;62;18;1;17;.944;3693000;0
6721;5354;873;0;0;0;0;.00nan;0;0
6721;5559;881;69;27;2;25;.926;3599000;0
6721;11716;881;0;0;0;0;.00nan;0;0
6721;28833;873;90;30;1;29;.967;3600000;0
6722;164715;883;0;0;0;0;.00nan;0;0
6722;86180;883;62;31;3;28;.903;3589000;0
6722;87798;877;83;35;2;33;.943;3600000;0
6722;149858;877;0;0;0;0;.00nan;0;0
6723;20645;1415;0;0;0;0;.00nan;0;0
6723;59025;1415;96;47;2;45;.957;3900000;0
6723;78348;886;64;22;2;20;.909;3900000;0
6723;147567;886;0;0;0;0;.00nan;0;0
6724;11670;885;52;35;5;30;.857;3600000;0
6724;63551;892;69;24;2;22;.917;3600000;0
6724;75362;885;0;0;0;0;.00nan;0;0
6724;146684;892;0;0;0;0;.00nan;0;0
6725;65762;876;0;0;0;0;.00nan;0;0
6725;69536;886;97;19;0;19;1.000;3600000;0
6725;78348;886;0;0;0;0;.00nan;0;0
6725;141496;876;81;30;2;28;.933;3600000;0
6726;1712;893;99;38;1;37;.974;3600000;0
6726;7037;893;0;0;0;0;.00nan;0;0
6726;63551;892;63;27;4;23;.852;3600000;0
6726;146684;892;0;0;0;0;.00nan;0;0
6727;987;875;0;0;0;0;.00nan;0;0
6727;3077;875;72;25;1;24;.960;3600000;0
6727;164715;883;0;0;0;0;.00nan;0;0
6727;86180;883;73;31;2;29;.935;3557000;0
6728;28831;887;98;34;1;33;.971;3600000;0
6728;180316;887;0;0;0;0;.00nan;0;0
6728;65762;876;75;48;5;43;.896;3600000;0
6728;141496;876;0;0;0;0;.00nan;0;0
6729;5559;881;90;30;1;29;.967;3600000;0
6729;11716;881;0;0;0;0;.00nan;0;0
6729;69536;886;72;26;2;24;.923;3580000;0
6729;78348;886;0;0;0;0;.00nan;0;0
6730;76574;882;0;0;0;0;.00nan;0;0
6730;87798;877;60;19;2;17;.895;3574000;0
6730;142911;882;100;45;1;44;.978;3600000;0
6730;149858;877;0;0;0;0;.00nan;0;0
6731;164710;878;78;42;4;38;.905;3600000;0
6731;20645;1415;0;0;0;0;.00nan;0;0
6731;59025;1415;35;28;5;23;.821;3600000;0
6731;80834;878;0;0;0;0;.00nan;0;0
6732;5354;873;0;0;0;0;.00nan;0;0
6732;11670;885;90;45;3;42;.933;3600000;0
6732;28833;873;74;19;1;18;.947;3600000;0
6732;75362;885;0;0;0;0;.00nan;0;0
6733;987;875;67;23;2;21;.913;3600000;0
6733;1712;893;0;0;0;0;.00nan;0;0
6733;3077;875;0;0;0;0;.00nan;0;0
6733;7037;893;81;46;3;43;.935;3590000;0
6734;5559;881;46;31;5;26;.839;3777000;0
6734;11670;885;37;31;6;25;.806;3777000;0
6734;11716;881;0;0;0;0;.00nan;0;0
6734;75362;885;0;0;0;0;.00nan;0;0
6735;28831;887;0;0;0;0;.00nan;0;0
6735;180316;887;91;43;2;41;.953;3600000;0
6735;63551;892;60;33;4;29;.879;3566000;0
6735;146684;892;0;0;0;0;.00nan;0;0
6736;69536;886;38;27;5;22;.815;3600000;0
6736;76574;882;0;0;0;0;.00nan;0;0
6736;78348;886;0;0;0;0;.00nan;0;0
6736;142911;882;99;43;2;41;.953;3600000;0
6737;164710;878;97;51;3;48;.941;3568000;0
6737;80834;878;0;0;0;0;.00nan;0;0
6737;87798;877;61;19;2;17;.895;3600000;0
6737;149858;877;0;0;0;0;.00nan;0;0
6738;164715;883;0;0;0;0;.00nan;0;0
6738;65762;876;0;0;0;0;.00nan;0;0
6738;86180;883;75;36;2;34;.944;3573000;0
6738;141496;876;100;32;0;32;1.000;3600000;0
6739;5354;873;98;52;3;49;.942;3600000;0
6739;20645;1415;0;0;0;0;.00nan;0;0
6739;28833;873;0;0;0;0;.00nan;0;0
6739;59025;1415;37;19;4;15;.789;3578000;0
6740;987;875;91;36;1;35;.972;3600000;0
6740;3077;875;0;0;0;0;.00nan;0;0
6740;69536;886;47;25;4;21;.840;3147000;0
6740;78348;886;19;7;4;3;.429;453000;0
6741;11670;885;88;38;3;35;.921;3900000;0
6741;75362;885;0;0;0;0;.00nan;0;0
6741;87798;877;62;30;3;27;.900;3900000;0
6741;149858;877;0;0;0;0;.00nan;0;0
6742;5354;873;0;0;0;0;.00nan;0;0
6742;28833;873;82;37;2;35;.946;3598000;0
6742;65762;876;0;0;0;0;.00nan;0;0
6742;141496;876;94;30;1;29;.967;3600000;0
6743;63551;892;0;0;0;0;.00nan;0;0
6743;76574;882;0;0;0;0;.00nan;0;0
6743;142911;882;62;28;3;25;.893;3900000;0
6743;146684;892;56;34;3;31;.912;3900000;0
6744;164710;878;92;43;2;41;.953;3900000;0
6744;164715;883;74;23;2;21;.913;3874000;0
6744;80834;878;0;0;0;0;.00nan;0;0
6744;86180;883;0;0;0;0;.00nan;0;0
6745;5559;881;70;39;5;34;.872;3900000;0
6745;11716;881;0;0;0;0;.00nan;0;0
6745;28831;887;0;0;0;0;.00nan;0;0
6745;180316;887;37;27;5;22;.815;3900000;0
6746;1712;893;98;45;2;43;.956;3562000;0
6746;7037;893;0;0;0;0;.00nan;0;0
6746;20645;1415;0;0;0;0;.00nan;0;0
6746;59025;1415;77;20;1;19;.950;3600000;0
6747;987;875;84;36;2;34;.944;3559000;0
6747;3077;875;0;0;0;0;.00nan;0;0
6747;65762;876;0;0;0;0;.00nan;0;0
6747;141496;876;86;28;1;27;.964;3600000;0
6748;28831;887;0;0;0;0;.00nan;0;0
6748;180316;887;85;22;1;21;.955;3600000;0
6748;76574;882;93;50;3;47;.940;3569000;0
6748;142911;882;0;0;0;0;.00nan;0;0
6749;11670;885;68;42;4;38;.905;3600000;0
6749;69536;886;82;13;0;13;1.000;3600000;0
6749;75362;885;0;0;0;0;.00nan;0;0
6749;78348;886;0;0;0;0;.00nan;0;0
6750;1712;893;0;0;0;0;.00nan;0;0
6750;7037;893;67;39;3;36;.923;3548000;0
6750;87798;877;72;26;2;24;.923;3600000;0
6750;149858;877;0;0;0;0;.00nan;0;0
6751;5559;881;0;0;0;0;.00nan;0;0
6751;164710;878;67;33;3;30;.909;3600000;0
6751;11716;881;95;18;0;18;1.000;3600000;0
6751;80834;878;0;0;0;0;.00nan;0;0
6752;20645;1415;0;0;0;0;.00nan;0;0
6752;59025;1415;100;22;0;22;1.000;3600000;0
6752;63551;892;72;24;1;23;.958;3572000;0
6752;146684;892;0;0;0;0;.00nan;0;0
6753;164715;883;0;0;0;0;.00nan;0;0
6753;28833;873;0;0;0;0;.00nan;0;0
6753;70879;873;98;47;3;44;.936;3600000;0
6753;86180;883;69;37;4;33;.892;3550000;0
6754;1712;893;65;28;3;25;.893;3657000;0
6754;7037;893;0;0;0;0;.00nan;0;0
6754;164710;878;82;47;4;43;.915;3657000;0
6754;80834;878;0;0;0;0;.00nan;0;0
6755;5559;881;0;0;0;0;.00nan;0;0
6755;11716;881;77;33;2;31;.939;3546000;0
6755;65762;876;100;25;0;25;1.000;3600000;0
6755;141496;876;0;0;0;0;.00nan;0;0
6756;28833;873;0;0;0;0;.00nan;0;0
6756;63551;892;0;0;0;0;.00nan;0;0
6756;70879;873;81;39;4;35;.897;3588000;0
6756;146684;892;61;20;2;18;.900;3600000;0
6757;28831;887;80;27;2;25;.926;3600000;0
6757;180316;887;0;0;0;0;.00nan;0;0
6757;69536;886;58;30;4;26;.867;3600000;0
6757;78348;886;0;0;0;0;.00nan;0;0
6758;987;875;92;37;2;35;.946;3900000;0
6758;3077;875;0;0;0;0;.00nan;0;0
6758;76574;882;0;0;0;0;.00nan;0;0
6758;142911;882;59;23;2;21;.913;3900000;0
6759;20645;1415;0;0;0;0;.00nan;0;0
6759;59025;1415;69;31;3;28;.903;3551000;0
6759;87798;877;100;40;1;39;.975;3600000;0
6759;149858;877;0;0;0;0;.00nan;0;0
6760;164715;883;0;0;0;0;.00nan;0;0
6760;11670;885;83;35;3;32;.914;3600000;0
6760;75362;885;0;0;0;0;.00nan;0;0
6760;86180;883;86;41;2;39;.951;3600000;0
6761;1712;893;0;0;0;0;.00nan;0;0
6761;5559;881;63;17;1;16;.941;3600000;0
6761;7037;893;82;41;3;38;.927;3578000;0
6761;11716;881;0;0;0;0;.00nan;0;0
6762;11670;885;65;35;4;31;.886;3539000;0
6762;65762;876;78;29;2;27;.931;3600000;0
6762;75362;885;0;0;0;0;.00nan;0;0
6762;141496;876;0;0;0;0;.00nan;0;0
6763;69536;886;88;29;1;28;.966;3600000;0
6763;78348;886;0;0;0;0;.00nan;0;0
6763;86192;877;0;0;0;0;.00nan;0;0
6763;87798;877;75;30;2;28;.933;3545000;0
6764;164710;878;0;0;0;0;.00nan;0;0
6764;76574;882;0;0;0;0;.00nan;0;0
6764;80834;878;57;24;3;21;.875;3797000;0
6764;142911;882;91;44;2;42;.955;3797000;0
6765;164715;883;46;29;5;24;.828;3600000;0
6765;63551;892;0;0;0;0;.00nan;0;0
6765;86180;883;0;0;0;0;.00nan;0;0
6765;146684;892;91;37;2;35;.946;3600000;0
6766;987;875;55;29;3;26;.897;3591000;0
6766;3077;875;0;0;0;0;.00nan;0;0
6766;20645;1415;0;0;0;0;.00nan;0;0
6766;59025;1415;72;20;1;19;.950;3600000;0
6767;28831;887;88;37;2;35;.946;3900000;0
6767;28833;873;0;0;0;0;.00nan;0;0
6767;180316;887;0;0;0;0;.00nan;0;0
6767;70879;873;88;28;2;26;.929;3900000;0
6768;987;875;0;0;0;0;.00nan;0;0
6768;3077;875;73;47;5;42;.894;3600000;0
6768;164710;878;90;31;1;30;.968;3600000;0
6768;80834;878;0;0;0;0;.00nan;0;0
6769;11670;885;0;0;0;0;.00nan;0;0
6769;63551;892;0;0;0;0;.00nan;0;0
6769;75362;885;54;30;4;26;.867;3600000;0
6769;146684;892;59;21;2;19;.905;3600000;0
6770;1712;893;0;0;0;0;.00nan;0;0
6770;7037;893;95;43;2;41;.953;3560000;0
6770;28831;887;92;21;0;21;1.000;3600000;0
6770;180316;887;0;0;0;0;.00nan;0;0
6771;59025;1415;67;31;3;28;.903;3900000;0
6771;76574;882;0;0;0;0;.00nan;0;0
6771;142911;882;85;40;3;37;.925;3900000;0
6771;143301;1415;0;0;0;0;.00nan;0;0
6772;65762;876;0;0;0;0;.00nan;0;0
6772;86192;877;65;25;2;23;.920;3600000;0
6772;87798;877;0;0;0;0;.00nan;0;0
6772;141496;876;69;43;5;38;.884;3600000;0
6773;5559;881;89;34;2;32;.941;3600000;0
6773;164715;883;0;0;0;0;.00nan;0;0
6773;11716;881;0;0;0;0;.00nan;0;0
6773;86180;883;58;33;3;30;.909;3575000;0
6774;28833;873;0;0;0;0;.00nan;0;0
6774;69536;886;88;28;2;26;.929;3683000;0
6774;70879;873;94;53;3;50;.943;3683000;0
6774;78348;886;0;0;0;0;.00nan;0;0
6775;1712;893;87;50;3;47;.940;3600000;0
6775;7037;893;0;0;0;0;.00nan;0;0
6775;11670;885;24;5;3;2;.400;557000;0
6775;75362;885;69;15;1;14;.933;3018000;0
6776;65762;876;0;0;0;0;.00nan;0;0
6776;76574;882;0;0;0;0;.00nan;0;0
6776;141496;876;52;24;4;20;.833;3546000;0
6776;142911;882;84;37;3;34;.919;3600000;0
6777;987;875;97;48;2;46;.958;3600000;0
6777;3077;875;0;0;0;0;.00nan;0;0
6777;28833;873;0;0;0;0;.00nan;0;0
6777;70879;873;63;27;3;24;.889;3543000;0
6778;63551;892;68;28;2;26;.929;3600000;0
6778;86192;877;66;33;3;30;.909;3565000;0
6778;87798;877;0;0;0;0;.00nan;0;0
6778;146684;892;0;0;0;0;.00nan;0;0
6779;164710;878;23;4;3;1;.250;199000;0
6779;69536;886;72;35;4;31;.886;3600000;0
6779;78348;886;0;0;0;0;.00nan;0;0
6779;80834;878;71;49;6;43;.878;3401000;0
6780;5559;881;58;27;4;23;.852;3600000;0
6780;11716;881;0;0;0;0;.00nan;0;0
6780;59025;1415;0;0;0;0;.00nan;0;0
6780;143301;1415;64;44;5;39;.886;3571000;0
6781;164715;883;84;40;2;38;.950;3600000;0
6781;28831;887;69;35;3;32;.914;3568000;0
6781;180316;887;0;0;0;0;.00nan;0;0
6781;86180;883;0;0;0;0;.00nan;0;0
6782;5559;881;74;47;4;43;.915;3582000;0
6782;11716;881;0;0;0;0;.00nan;0;0
6782;63551;892;55;15;2;13;.867;3600000;0
6782;146684;892;0;0;0;0;.00nan;0;0
6783;11670;885;0;0;0;0;.00nan;0;0
6783;28833;873;0;0;0;0;.00nan;0;0
6783;70879;873;80;22;1;21;.955;3600000;0
6783;75362;885;79;33;2;31;.939;3570000;0
6784;164710;878;77;28;1;27;.964;3600000;0
6784;11670;885;0;0;0;0;.00nan;0;0
6784;75362;885;85;38;2;36;.947;3555000;0
6784;80834;878;0;0;0;0;.00nan;0;0
6785;987;875;90;30;1;29;.967;3896000;0
6785;3077;875;0;0;0;0;.00nan;0;0
6785;28831;887;75;29;2;27;.931;3896000;0
6785;180316;887;0;0;0;0;.00nan;0;0
6786;164715;883;74;26;2;24;.923;3600000;0
6786;76574;882;61;29;3;26;.897;3600000;0
6786;86180;883;0;0;0;0;.00nan;0;0
6786;142911;882;0;0;0;0;.00nan;0;0
6787;1712;893;73;45;4;41;.911;3600000;0
6787;7037;893;0;0;0;0;.00nan;0;0
6787;69536;886;100;18;0;18;1.000;3600000;0
6787;78348;886;0;0;0;0;.00nan;0;0
6788;59025;1415;0;0;0;0;.00nan;0;0
6788;65762;876;80;31;2;29;.935;3600000;0
6788;141496;876;0;0;0;0;.00nan;0;0
6788;143301;1415;65;31;3;28;.903;3592000;0
6789;28833;873;0;0;0;0;.00nan;0;0
6789;70879;873;57;39;5;34;.872;3600000;0
6789;86192;877;73;23;2;21;.913;3600000;0
6789;87798;877;0;0;0;0;.00nan;0;0
6790;59025;1415;0;0;0;0;.00nan;0;0
6790;63551;892;62;22;2;20;.909;3600000;0
6790;143301;1415;55;32;4;28;.875;3561000;0
6790;146684;892;0;0;0;0;.00nan;0;0
6791;28833;873;0;0;0;0;.00nan;0;0
6791;70879;873;46;39;6;33;.846;3600000;0
6791;76574;882;0;0;0;0;.00nan;0;0
6791;142911;882;91;24;0;24;1.000;3600000;0
6792;28831;887;67;29;3;26;.897;3565000;0
6792;180316;887;0;0;0;0;.00nan;0;0
6792;69536;886;70;25;2;23;.920;3600000;0
6792;78348;886;0;0;0;0;.00nan;0;0
6793;11670;885;0;0;0;0;.00nan;0;0
6793;75362;885;97;27;0;27;1.000;3900000;0
6793;86192;877;90;20;0;20;1.000;3900000;0
6793;87798;877;0;0;0;0;.00nan;0;0
6794;164710;878;87;44;3;41;.932;3900000;0
6794;65762;876;48;25;3;22;.880;3900000;0
6794;80834;878;0;0;0;0;.00nan;0;0
6794;141496;876;0;0;0;0;.00nan;0;0
6795;1712;893;0;0;0;0;.00nan;0;0
6795;5559;881;61;22;2;20;.909;3561000;0
6795;7037;893;83;27;1;26;.963;3600000;0
6795;11716;881;0;0;0;0;.00nan;0;0
6796;987;875;76;21;1;20;.952;3600000;0
6796;3077;875;0;0;0;0;.00nan;0;0
6796;164715;883;0;0;0;0;.00nan;0;0
6796;86180;883;59;35;4;31;.886;3600000;0
6797;987;875;0;0;0;0;.00nan;0;0
6797;3077;875;92;40;2;38;.950;3900000;0
6797;59025;1415;0;0;0;0;.00nan;0;0
6797;143301;1415;85;38;2;36;.947;3900000;0
6798;1712;893;0;0;0;0;.00nan;0;0
6798;7037;893;87;38;2;36;.947;3600000;0
6798;28831;887;70;36;3;33;.917;3583000;0
6798;180316;887;0;0;0;0;.00nan;0;0
6799;11670;885;63;27;3;24;.889;2875000;0
6799;69536;886;38;16;4;12;.750;3600000;0
6799;75362;885;23;13;4;9;.692;725000;0
6799;78348;886;0;0;0;0;.00nan;0;0
6800;164715;883;0;0;0;0;.00nan;0;0
6800;65762;876;100;32;0;32;1.000;3600000;0
6800;86180;883;44;32;6;26;.813;3600000;0
6800;141496;876;0;0;0;0;.00nan;0;0
6801;987;875;44;32;5;27;.844;3600000;0
6801;3077;875;0;0;0;0;.00nan;0;0
6801;76574;882;0;0;0;0;.00nan;0;0
6801;142911;882;70;31;3;28;.903;3600000;0
6802;164710;878;51;29;4;25;.862;3600000;0
6802;63551;892;0;0;0;0;.00nan;0;0
6802;80834;878;0;0;0;0;.00nan;0;0
6802;146684;892;75;21;1;20;.952;3600000;0
6803;5559;881;0;0;0;0;.00nan;0;0
6803;11716;881;79;37;3;34;.919;3600000;0
6803;86192;877;59;31;4;27;.871;3593000;0
6803;87798;877;0;0;0;0;.00nan;0;0
6804;28833;873;0;0;0;0;.00nan;0;0
6804;59025;1415;0;0;0;0;.00nan;0;0
6804;70879;873;88;58;4;54;.931;3600000;0
6804;143301;1415;79;10;0;10;1.000;3600000;0
6805;1712;893;64;44;5;39;.886;3562000;0
6805;7037;893;0;0;0;0;.00nan;0;0
6805;11670;885;0;0;0;0;.00nan;0;0
6805;75362;885;55;26;4;22;.846;3600000;0
6806;65762;876;0;0;0;0;.00nan;0;0
6806;69536;886;52;34;5;29;.853;3518000;0
6806;78348;886;0;0;0;0;.00nan;0;0
6806;141496;876;67;33;3;30;.909;3600000;0
6807;164715;883;0;0;0;0;.00nan;0;0
6807;63551;892;0;0;0;0;.00nan;0;0
6807;86180;883;47;22;3;19;.864;3527000;0
6807;146684;892;91;33;1;32;.970;3600000;0
6808;5559;881;74;35;3;32;.914;3900000;0
6808;11716;881;0;0;0;0;.00nan;0;0
6808;28831;887;96;53;3;50;.943;3900000;0
6808;180316;887;0;0;0;0;.00nan;0;0
6809;76574;882;0;0;0;0;.00nan;0;0
6809;86192;877;99;21;0;21;1.000;3600000;0
6809;87798;877;0;0;0;0;.00nan;0;0
6809;142911;882;55;28;4;24;.857;3600000;0
6810;164710;878;65;19;1;18;.947;3600000;0
6810;28833;873;98;45;2;43;.956;3552000;0
6810;70879;873;0;0;0;0;.00nan;0;0
6810;80834;878;0;0;0;0;.00nan;0;0
6811;11670;885;0;0;0;0;.00nan;0;0
6811;196005;882;0;0;0;0;.00nan;0;0
6811;75362;885;67;31;3;28;.903;3525000;0
6811;76574;882;78;20;1;19;.950;3600000;0
6812;1712;893;0;0;0;0;.00nan;0;0
6812;63551;892;59;16;2;14;.875;3900000;0
6812;86862;893;90;36;2;34;.944;3900000;0
6812;146684;892;0;0;0;0;.00nan;0;0
6813;164710;878;0;0;0;0;.00nan;0;0
6813;69536;886;0;0;0;0;.00nan;0;0
6813;78348;886;90;30;2;28;.933;3600000;0
6813;80834;878;87;52;4;48;.923;3577000;0
6814;987;875;31;13;4;9;.692;1118000;0
6814;3077;875;57;38;5;33;.868;2482000;0
6814;86192;877;78;25;2;23;.920;3600000;0
6814;87798;877;0;0;0;0;.00nan;0;0
6815;5559;881;40;19;4;15;.789;3600000;0
6815;11716;881;0;0;0;0;.00nan;0;0
6815;65762;876;55;4;0;4;1.000;711000;0
6815;141496;876;33;32;6;26;.813;2858000;0
6816;164715;883;49;13;2;11;.846;3600000;0
6816;28833;873;75;45;4;41;.911;3519000;0
6816;86180;883;0;0;0;0;.00nan;0;0
6816;147567;873;0;0;0;0;.00nan;0;0
6817;28831;887;100;36;1;35;.972;3900000;0
6817;180316;887;0;0;0;0;.00nan;0;0
6817;59025;1415;0;0;0;0;.00nan;0;0
6817;143301;1415;77;28;1;27;.964;3900000;0
6818;1712;893;0;0;0;0;.00nan;0;0
6818;86192;877;67;23;2;21;.913;3785000;0
6818;86862;893;86;54;3;51;.944;3785000;0
6818;87798;877;0;0;0;0;.00nan;0;0
6819;987;875;89;37;2;35;.946;3561000;0
6819;3077;875;0;0;0;0;.00nan;0;0
6819;65762;876;84;28;1;27;.964;3600000;0
6819;141496;876;0;0;0;0;.00nan;0;0
6820;11670;885;0;0;0;0;.00nan;0;0
6820;28831;887;53;19;3;16;.842;3600000;0
6820;180316;887;0;0;0;0;.00nan;0;0
6820;75362;885;89;48;4;44;.917;3600000;0
6821;69536;886;0;0;0;0;.00nan;0;0
6821;76574;882;0;0;0;0;.00nan;0;0
6821;78348;886;69;31;3;28;.903;3561000;0
6821;142911;882;98;44;2;42;.955;3600000;0
6822;5559;881;81;29;3;26;.897;3600000;0
6822;164710;878;0;0;0;0;.00nan;0;0
6822;11716;881;0;0;0;0;.00nan;0;0
6822;80834;878;44;27;4;23;.852;3600000;0
6823;164715;883;78;28;2;26;.929;3600000;0
6823;59025;1415;0;0;0;0;.00nan;0;0
6823;86180;883;0;0;0;0;.00nan;0;0
6823;143301;1415;68;32;3;29;.906;3577000;0
6824;28833;873;72;31;3;28;.903;3600000;0
6824;63551;892;70;24;2;22;.917;3088000;0
6824;70879;873;0;0;0;0;.00nan;0;0
6824;146684;892;28;7;3;4;.571;449000;0
6825;1712;893;0;0;0;0;.00nan;0;0
6825;76574;882;0;0;0;0;.00nan;0;0
6825;86862;893;68;51;6;45;.882;3600000;0
6825;142911;882;67;26;3;23;.885;3600000;0
6826;11670;885;0;0;0;0;.00nan;0;0
6826;28833;873;0;0;0;0;.00nan;0;0
6826;70879;873;91;39;1;38;.974;3888000;0
6826;75362;885;96;36;1;35;.972;3900000;0
6827;59025;1415;46;5;1;4;.800;583000;0
6827;65762;876;83;38;2;36;.947;3600000;0
6827;141496;876;0;0;0;0;.00nan;0;0
6827;143301;1415;30;24;6;18;.750;3017000;0
6828;987;875;96;28;1;27;.964;3900000;0
6828;3077;875;0;0;0;0;.00nan;0;0
6828;28831;887;90;33;1;32;.970;3900000;0
6828;180316;887;0;0;0;0;.00nan;0;0
6829;69536;886;0;0;0;0;.00nan;0;0
6829;78348;886;70;27;2;25;.926;3770000;0
6829;86192;877;0;0;0;0;.00nan;0;0
6829;87798;877;78;27;1;26;.963;3770000;0
6830;5559;881;73;31;3;28;.903;3797000;0
6830;11716;881;0;0;0;0;.00nan;0;0
6830;63551;892;46;26;4;22;.846;3797000;0
6830;146684;892;0;0;0;0;.00nan;0;0
6831;164710;878;73;36;3;33;.917;3600000;0
6831;164715;883;54;45;6;39;.867;3246000;0
6831;80834;878;0;0;0;0;.00nan;0;0
6831;86180;883;54;4;0;4;1.000;354000;0
6832;11670;885;0;0;0;0;.00nan;0;0
6832;59025;1415;0;0;0;0;.00nan;0;0
6832;75362;885;87;33;2;31;.939;3900000;0
6832;143301;1415;76;36;2;34;.944;3900000;0
6833;987;875;100;30;0;30;1.000;3600000;0
6833;1712;893;0;0;0;0;.00nan;0;0
6833;3077;875;0;0;0;0;.00nan;0;0
6833;86862;893;81;36;3;33;.917;3600000;0
6834;63551;892;73;20;1;19;.950;3600000;0
6834;86192;877;96;41;2;39;.951;3600000;0
6834;87798;877;0;0;0;0;.00nan;0;0
6834;146684;892;0;0;0;0;.00nan;0;0
6835;164710;878;100;47;1;46;.979;3900000;0
6835;28831;887;87;25;1;24;.960;3900000;0
6835;180316;887;0;0;0;0;.00nan;0;0
6835;80834;878;0;0;0;0;.00nan;0;0
6836;164715;883;0;0;0;0;.00nan;0;0
6836;69536;886;0;0;0;0;.00nan;0;0
6836;78348;886;53;25;3;22;.880;3600000;0
6836;86180;883;100;48;2;46;.958;3600000;0
6837;28833;873;0;0;0;0;.00nan;0;0
6837;65762;876;60;25;3;22;.880;3600000;0
6837;70879;873;64;38;4;34;.895;3544000;0
6837;141496;876;0;0;0;0;.00nan;0;0
6838;5559;881;0;0;0;0;.00nan;0;0
6838;11716;881;94;33;1;32;.970;3600000;0
6838;76574;882;0;0;0;0;.00nan;0;0
6838;142911;882;80;35;2;33;.943;3592000;0
6839;11670;885;0;0;0;0;.00nan;0;0
6839;63551;892;0;0;0;0;.00nan;0;0
6839;75362;885;81;33;2;31;.939;3600000;0
6839;146684;892;84;18;0;18;1.000;3600000;0
6840;28833;873;0;0;0;0;.00nan;0;0
6840;69536;886;0;0;0;0;.00nan;0;0
6840;70879;873;56;46;6;40;.870;3600000;0
6840;78348;886;74;28;2;26;.929;3600000;0
6841;28831;887;88;29;1;28;.966;3600000;0
6841;180316;887;0;0;0;0;.00nan;0;0
6841;86192;877;85;45;3;42;.933;3600000;0
6841;87798;877;0;0;0;0;.00nan;0;0
6842;987;875;46;18;3;15;.833;3600000;0
6842;3077;875;0;0;0;0;.00nan;0;0
6842;164710;878;75;26;2;24;.923;3600000;0
6842;80834;878;0;0;0;0;.00nan;0;0
6843;1712;893;0;0;0;0;.00nan;0;0
6843;164715;883;0;0;0;0;.00nan;0;0
6843;86180;883;59;31;3;28;.903;3600000;0
6843;86862;893;100;32;0;32;1.000;3600000;0
6844;5559;881;51;25;3;22;.880;3600000;0
6844;11716;881;0;0;0;0;.00nan;0;0
6844;59025;1415;0;0;0;0;.00nan;0;0
6844;143301;1415;60;29;4;25;.862;3595000;0
6845;1712;893;0;0;0;0;.00nan;0;0
6845;59025;1415;0;0;0;0;.00nan;0;0
6845;86862;893;86;54;4;50;.926;3600000;0
6845;143301;1415;64;18;1;17;.944;3600000;0
6846;65762;876;87;30;2;28;.933;3600000;0
6846;86192;877;72;36;4;32;.889;3582000;0
6846;87798;877;0;0;0;0;.00nan;0;0
6846;141496;876;0;0;0;0;.00nan;0;0
6847;63551;892;90;30;1;29;.967;3600000;0
6847;69536;886;58;23;3;20;.870;3515000;0
6847;78348;886;0;0;0;0;.00nan;0;0
6847;146684;892;0;0;0;0;.00nan;0;0
6848;164715;883;0;0;0;0;.00nan;0;0
6848;28831;887;0;0;0;0;.00nan;0;0
6848;180316;887;100;34;0;34;1.000;3600000;0
6848;86180;883;89;41;3;38;.927;3600000;0
6849;164710;878;0;0;0;0;.00nan;0;0
6849;76574;882;0;0;0;0;.00nan;0;0
6849;80834;878;71;28;2;26;.929;3600000;0
6849;142911;882;40;21;4;17;.810;3574000;0
6850;5559;881;100;29;0;29;1.000;3600000;0
6850;11670;885;0;0;0;0;.00nan;0;0
6850;11716;881;0;0;0;0;.00nan;0;0
6850;75362;885;87;34;2;32;.941;3558000;0
6851;987;875;63;33;4;29;.879;3832000;0
6851;3077;875;0;0;0;0;.00nan;0;0
6851;28833;873;0;0;0;0;.00nan;0;0
6851;70879;873;87;40;3;37;.925;3832000;0
6852;1712;893;0;0;0;0;.00nan;0;0
6852;65762;876;53;22;3;19;.864;3600000;0
6852;86862;893;52;31;5;26;.839;3598000;0
6852;141496;876;0;0;0;0;.00nan;0;0
6853;987;875;0;0;0;0;.00nan;0;0
6853;3077;875;84;27;1;26;.963;3600000;0
6853;63551;892;71;27;3;24;.889;3558000;0
6853;146684;892;0;0;0;0;.00nan;0;0
6854;28831;887;0;0;0;0;.00nan;0;0
6854;28833;873;0;0;0;0;.00nan;0;0
6854;180316;887;49;30;4;26;.867;3600000;0
6854;70879;873;84;24;1;23;.958;3600000;0
6855;164715;883;95;40;3;37;.925;3600000;0
6855;86180;883;0;0;0;0;.00nan;0;0
6855;86192;877;54;31;4;27;.871;3554000;0
6855;87798;877;0;0;0;0;.00nan;0;0
6856;164710;878;60;30;4;26;.867;3564000;0
6856;11670;885;0;0;0;0;.00nan;0;0
6856;75362;885;67;31;3;28;.903;3600000;0
6856;80834;878;0;0;0;0;.00nan;0;0
6857;5559;881;99;38;1;37;.974;3600000;0
6857;11716;881;0;0;0;0;.00nan;0;0
6857;69536;886;0;0;0;0;.00nan;0;0
6857;78348;886;41;23;4;19;.826;3600000;0
6858;59025;1415;0;0;0;0;.00nan;0;0
6858;76574;882;0;0;0;0;.00nan;0;0
6858;142911;882;90;30;1;29;.967;3600000;0
6858;143301;1415;72;31;3;28;.903;3600000;0
6859;28831;887;81;29;2;27;.931;3600000;0
6859;180316;887;0;0;0;0;.00nan;0;0
6859;65762;876;46;25;4;21;.840;2809000;0
6859;141496;876;26;13;4;9;.692;791000;0
6860;987;875;85;26;1;25;.962;3600000;0
6860;3077;875;0;0;0;0;.00nan;0;0
6860;11670;885;0;0;0;0;.00nan;0;0
6860;75362;885;66;36;4;32;.889;3600000;0
6861;63551;892;50;23;3;20;.870;3714000;0
6861;76574;882;0;0;0;0;.00nan;0;0
6861;142911;882;72;40;4;36;.900;3714000;0
6861;146684;892;0;0;0;0;.00nan;0;0
6862;59025;1415;0;0;0;0;.00nan;0;0
6862;69536;886;61;29;3;26;.897;3552000;0
6862;78348;886;0;0;0;0;.00nan;0;0
6862;143301;1415;80;31;2;29;.935;3600000;0
6863;164710;878;0;0;0;0;.00nan;0;0
6863;80834;878;48;29;5;24;.828;3578000;0
6863;86192;877;59;32;4;28;.875;3600000;0
6863;87798;877;0;0;0;0;.00nan;0;0
6864;5559;881;71;29;3;26;.897;3524000;0
6864;164715;883;0;0;0;0;.00nan;0;0
6864;11716;881;0;0;0;0;.00nan;0;0
6864;86180;883;68;19;1;18;.947;3600000;0
6865;1712;893;0;0;0;0;.00nan;0;0
6865;28833;873;0;0;0;0;.00nan;0;0
6865;70879;873;88;35;3;32;.914;3600000;0
6865;86862;893;48;29;4;25;.862;3588000;0
6866;1712;893;0;0;0;0;.00nan;0;0
6866;69536;886;0;0;0;0;.00nan;0;0
6866;78348;886;83;16;0;16;1.000;3600000;0
6866;86862;893;86;47;3;44;.936;3600000;0
6867;11670;885;96;33;0;33;1.000;3900000;0
6867;65762;876;100;23;0;23;1.000;3900000;0
6867;75362;885;0;0;0;0;.00nan;0;0
6867;141496;876;0;0;0;0;.00nan;0;0
6868;28831;887;81;40;3;37;.925;3528000;0
6868;180316;887;0;0;0;0;.00nan;0;0
6868;63551;892;84;20;1;19;.950;3600000;0
6868;146684;892;0;0;0;0;.00nan;0;0
6869;28833;873;0;0;0;0;.00nan;0;0
6869;70879;873;97;57;4;53;.930;3543000;0
6869;86192;877;68;21;2;19;.905;3600000;0
6869;87798;877;0;0;0;0;.00nan;0;0
6870;987;875;79;23;1;22;.957;3600000;0
6870;3077;875;0;0;0;0;.00nan;0;0
6870;5559;881;0;0;0;0;.00nan;0;0
6870;11716;881;82;32;2;30;.938;3548000;0
6871;164715;883;0;0;0;0;.00nan;0;0
6871;76574;882;0;0;0;0;.00nan;0;0
6871;86180;883;85;34;2;32;.941;3600000;0
6871;142911;882;99;39;1;38;.974;3600000;0
6872;164710;878;99;41;2;39;.951;3600000;0
6872;59025;1415;36;16;4;12;.750;3515000;0
6872;80834;878;0;0;0;0;.00nan;0;0
6872;143301;1415;0;0;0;0;.00nan;0;0
6873;1712;893;52;25;4;21;.840;3900000;0
6873;69536;886;0;0;0;0;.00nan;0;0
6873;78348;886;67;37;4;33;.892;3900000;0
6873;86862;893;0;0;0;0;.00nan;0;0
6874;164715;883;0;0;0;0;.00nan;0;0
6874;11670;885;78;40;3;37;.925;3562000;0
6874;75362;885;0;0;0;0;.00nan;0;0
6874;86180;883;69;22;1;21;.955;3600000;0
6875;987;875;79;40;4;36;.900;3574000;0
6875;3077;875;0;0;0;0;.00nan;0;0
6875;63551;892;60;15;2;13;.867;3600000;0
6875;146684;892;0;0;0;0;.00nan;0;0
6876;164710;878;93;46;3;43;.935;3600000;0
6876;65762;876;68;24;2;22;.917;3600000;0
6876;80834;878;0;0;0;0;.00nan;0;0
6876;141496;876;0;0;0;0;.00nan;0;0
6877;5559;881;29;27;5;22;.815;3600000;0
6877;11716;881;0;0;0;0;.00nan;0;0
6877;28833;873;0;0;0;0;.00nan;0;0
6877;70879;873;89;33;2;31;.939;3600000;0
6878;987;875;100;32;0;32;1.000;3600000;0
6878;3077;875;0;0;0;0;.00nan;0;0
6878;69536;886;0;0;0;0;.00nan;0;0
6878;78348;886;82;30;1;29;.967;3545000;0
6879;63551;892;66;21;1;20;.952;3600000;0
6879;65762;876;0;0;0;0;.00nan;0;0
6879;141496;876;53;23;3;20;.870;3538000;0
6879;146684;892;0;0;0;0;.00nan;0;0
6880;28831;887;54;25;3;22;.880;3586000;0
6880;180316;887;0;0;0;0;.00nan;0;0
6880;76574;882;0;0;0;0;.00nan;0;0
6880;142911;882;77;31;2;29;.935;3600000;0
6881;1712;893;0;0;0;0;.00nan;0;0
6881;164710;878;58;27;3;24;.889;3600000;0
6881;80834;878;0;0;0;0;.00nan;0;0
6881;86862;893;77;47;4;43;.915;3592000;0
6882;59025;1415;0;0;0;0;.00nan;0;0
6882;86192;877;80;24;1;23;.958;3600000;0
6882;87798;877;0;0;0;0;.00nan;0;0
6882;143301;1415;51;30;4;26;.867;3600000;0
6883;5559;881;58;29;3;26;.897;3806000;0
6883;11716;881;0;0;0;0;.00nan;0;0
6883;28833;873;88;43;2;41;.953;3806000;0
6883;70879;873;0;0;0;0;.00nan;0;0
6884;1712;893;0;0;0;0;.00nan;0;0
6884;28831;887;64;22;2;20;.909;3600000;0
6884;180316;887;0;0;0;0;.00nan;0;0
6884;86862;893;87;51;3;48;.941;3577000;0
6885;987;875;56;23;3;20;.870;3575000;0
6885;3077;875;0;0;0;0;.00nan;0;0
6885;76574;882;0;0;0;0;.00nan;0;0
6885;142911;882;81;30;1;29;.967;3600000;0
6886;65762;876;0;0;0;0;.00nan;0;0
6886;69536;886;0;0;0;0;.00nan;0;0
6886;78348;886;58;35;5;30;.857;3600000;0
6886;141496;876;80;29;1;28;.966;3600000;0
6887;63551;892;32;23;5;18;.783;3600000;0
6887;86192;877;86;32;1;31;.969;3600000;0
6887;87798;877;0;0;0;0;.00nan;0;0
6887;146684;892;0;0;0;0;.00nan;0;0
6888;5559;881;0;0;0;0;.00nan;0;0
6888;164710;878;73;31;3;28;.903;3520000;0
6888;11716;881;90;28;1;27;.964;3600000;0
6888;80834;878;0;0;0;0;.00nan;0;0
6889;164715;883;0;0;0;0;.00nan;0;0
6889;59025;1415;0;0;0;0;.00nan;0;0
6889;86180;883;100;35;0;35;1.000;3600000;0
6889;143301;1415;63;23;2;21;.913;3531000;0
6890;1712;893;0;0;0;0;.00nan;0;0
6890;164710;878;65;29;3;26;.897;3551000;0
6890;80834;878;0;0;0;0;.00nan;0;0
6890;86862;893;99;40;2;38;.950;3600000;0
6891;28833;873;0;0;0;0;.00nan;0;0
6891;65762;876;0;0;0;0;.00nan;0;0
6891;70879;873;84;47;3;44;.936;3572000;0
6891;141496;876;76;22;1;21;.955;3600000;0
6892;69536;886;77;43;5;38;.884;3873000;0
6892;78348;886;0;0;0;0;.00nan;0;0
6892;86192;877;51;36;6;30;.833;3873000;0
6892;87798;877;0;0;0;0;.00nan;0;0
6893;5559;881;99;34;1;33;.971;3600000;0
6893;11716;881;0;0;0;0;.00nan;0;0
6893;196005;882;0;0;0;0;.00nan;0;0
6893;76574;882;70;26;2;24;.923;3547000;0
6894;164715;883;0;0;0;0;.00nan;0;0
6894;28831;887;69;26;2;24;.923;3600000;0
6894;180316;887;0;0;0;0;.00nan;0;0
6894;86180;883;81;25;1;24;.960;3600000;0
6895;987;875;76;38;3;35;.921;3514000;0
6895;3077;875;0;0;0;0;.00nan;0;0
6895;59025;1415;86;30;1;29;.967;3600000;0
6895;143301;1415;0;0;0;0;.00nan;0;0
6896;164715;883;0;0;0;0;.00nan;0;0
6896;76574;882;0;0;0;0;.00nan;0;0
6896;86180;883;67;22;2;20;.909;3900000;0
6896;142911;882;77;35;2;33;.943;3900000;0
6897;1712;893;0;0;0;0;.00nan;0;0
6897;11670;885;0;0;0;0;.00nan;0;0
6897;75362;885;26;30;6;24;.800;3600000;0
6897;86862;893;95;28;1;27;.964;3600000;0
6898;987;875;75;36;3;33;.917;3513000;0
6898;3077;875;0;0;0;0;.00nan;0;0
6898;5559;881;79;27;1;26;.963;3600000;0
6898;11716;881;0;0;0;0;.00nan;0;0
6899;28831;887;82;48;3;45;.938;3900000;0
6899;180316;887;0;0;0;0;.00nan;0;0
6899;69536;886;0;0;0;0;.00nan;0;0
6899;78348;886;71;25;3;22;.880;3900000;0
6900;65762;876;0;0;0;0;.00nan;0;0
6900;86192;877;0;0;0;0;.00nan;0;0
6900;87798;877;63;23;2;21;.913;3600000;0
6900;141496;876;89;27;1;26;.963;3600000;0
6901;164710;878;97;44;2;42;.955;3900000;0
6901;164715;883;0;0;0;0;.00nan;0;0
6901;80834;878;0;0;0;0;.00nan;0;0
6901;86180;883;87;32;2;30;.938;3900000;0
6902;59025;1415;0;0;0;0;.00nan;0;0
6902;63551;892;87;42;3;39;.929;3583000;0
6902;143301;1415;84;26;1;25;.962;3600000;0
6902;146684;892;0;0;0;0;.00nan;0;0
6903;28833;873;0;0;0;0;.00nan;0;0
6903;70879;873;50;39;5;34;.872;3596000;0
6903;76574;882;0;0;0;0;.00nan;0;0
6903;142911;882;44;24;4;20;.833;3600000;0
6904;63551;892;77;35;3;32;.914;3600000;0
6904;65762;876;0;0;0;0;.00nan;0;0
6904;141496;876;54;33;4;29;.879;3597000;0
6904;146684;892;0;0;0;0;.00nan;0;0
6905;987;875;80;27;1;26;.963;3600000;0
6905;3077;875;0;0;0;0;.00nan;0;0
6905;164710;878;72;36;3;33;.917;3587000;0
6905;80834;878;0;0;0;0;.00nan;0;0
6906;28831;887;0;0;0;0;.00nan;0;0
6906;180316;887;100;30;0;30;1.000;3733000;0
6906;59025;1415;0;0;0;0;.00nan;0;0
6906;143301;1415;92;36;1;35;.972;3733000;0
6907;11670;885;98;44;2;42;.955;3600000;0
6907;75362;885;0;0;0;0;.00nan;0;0
6907;76574;882;0;0;0;0;.00nan;0;0
6907;142911;882;90;16;0;16;1.000;3600000;0
6908;5559;881;89;43;2;41;.953;3567000;0
6908;11716;881;0;0;0;0;.00nan;0;0
6908;69536;886;97;21;0;21;1.000;3600000;0
6908;78348;886;0;0;0;0;.00nan;0;0
6909;1712;893;0;0;0;0;.00nan;0;0
6909;86192;877;70;39;4;35;.897;3775000;0
6909;86862;893;48;29;5;24;.828;3775000;0
6909;87798;877;0;0;0;0;.00nan;0;0
6910;164715;883;0;0;0;0;.00nan;0;0
6910;28833;873;0;0;0;0;.00nan;0;0
6910;70879;873;69;25;2;23;.920;3580000;0
6910;86180;883;95;28;1;27;.964;3600000;0
6911;5559;881;84;31;1;30;.968;3600000;0
6911;11716;881;0;0;0;0;.00nan;0;0
6911;59025;1415;0;0;0;0;.00nan;0;0
6911;143301;1415;52;27;4;23;.852;3600000;0
6912;1712;893;82;25;1;24;.960;3600000;0
6912;28833;873;0;0;0;0;.00nan;0;0
6912;70879;873;47;37;5;32;.865;3600000;0
6912;86862;893;0;0;0;0;.00nan;0;0
6913;11670;885;58;37;5;32;.865;3600000;0
6913;75362;885;0;0;0;0;.00nan;0;0
6913;86192;877;68;20;1;19;.950;3600000;0
6913;87798;877;0;0;0;0;.00nan;0;0
6914;63551;892;74;32;3;29;.906;3900000;0
6914;76574;882;0;0;0;0;.00nan;0;0
6914;142911;882;93;43;3;40;.930;3900000;0
6914;146684;892;0;0;0;0;.00nan;0;0
6915;987;875;100;43;1;42;.977;3600000;0
6915;3077;875;0;0;0;0;.00nan;0;0
6915;69536;886;66;20;2;18;.900;3582000;0
6915;78348;886;0;0;0;0;.00nan;0;0
6916;164710;878;0;0;0;0;.00nan;0;0
6916;28831;887;0;0;0;0;.00nan;0;0
6916;180316;887;56;27;4;23;.852;3729000;0
6916;80834;878;74;43;5;38;.884;3729000;0
6917;5559;881;0;0;0;0;.00nan;0;0
6917;11716;881;91;29;1;28;.966;3600000;0
6917;59025;1415;0;0;0;0;.00nan;0;0
6917;143301;1415;54;37;5;32;.865;3600000;0
6918;164715;883;94;24;0;24;1.000;3600000;0
6918;65762;876;0;0;0;0;.00nan;0;0
6918;86180;883;0;0;0;0;.00nan;0;0
6918;141496;876;83;37;3;34;.919;3600000;0
6919;5559;881;71;32;3;29;.906;3600000;0
6919;11670;885;0;0;0;0;.00nan;0;0
6919;11716;881;0;0;0;0;.00nan;0;0
6919;75362;885;65;33;4;29;.879;3574000;0
6920;28831;887;40;26;5;21;.808;3600000;0
6920;180316;887;0;0;0;0;.00nan;0;0
6920;65762;876;0;0;0;0;.00nan;0;0
6920;141496;876;87;36;2;34;.944;3600000;0
6921;76574;882;0;0;0;0;.00nan;0;0
6921;86192;877;67;20;1;19;.950;3600000;0
6921;87798;877;0;0;0;0;.00nan;0;0
6921;142911;882;79;42;4;38;.905;3600000;0
6922;164710;878;0;0;0;0;.00nan;0;0
6922;69536;886;90;33;1;32;.970;3600000;0
6922;78348;886;0;0;0;0;.00nan;0;0
6922;80834;878;45;36;6;30;.833;3600000;0
6923;164715;883;93;39;2;37;.949;3553000;0
6923;63551;892;81;26;1;25;.962;3600000;0
6923;86180;883;0;0;0;0;.00nan;0;0
6923;146684;892;0;0;0;0;.00nan;0;0
6924;1712;893;0;0;0;0;.00nan;0;0
6924;59025;1415;0;0;0;0;.00nan;0;0
6924;86862;893;73;47;5;42;.894;3546000;0
6924;143301;1415;49;23;4;19;.826;3600000;0
6925;987;875;100;44;2;42;.955;3900000;0
6925;3077;875;0;0;0;0;.00nan;0;0
6925;28833;873;0;0;0;0;.00nan;0;0
6925;70879;873;95;40;2;38;.950;3900000;0
6926;65762;876;69;24;2;22;.917;3600000;0
6926;76574;882;0;0;0;0;.00nan;0;0
6926;141496;876;0;0;0;0;.00nan;0;0
6926;142911;882;51;33;5;28;.848;3600000;0
6927;1712;893;0;0;0;0;.00nan;0;0
6927;164715;883;0;0;0;0;.00nan;0;0
6927;86180;883;83;36;3;33;.917;3600000;0
6927;86862;893;91;42;4;38;.905;3600000;0
6928;65762;876;0;0;0;0;.00nan;0;0
6928;76574;882;0;0;0;0;.00nan;0;0
6928;141496;876;76;22;1;21;.955;3600000;0
6928;142911;882;93;35;2;33;.943;3551000;0
6929;987;875;99;43;2;41;.953;3708000;0
6929;3077;875;0;0;0;0;.00nan;0;0
6929;63551;892;80;31;3;28;.903;3709000;0
6929;146684;892;0;0;0;0;.00nan;0;0
6930;164710;878;72;38;4;34;.895;3600000;0
6930;80834;878;0;0;0;0;.00nan;0;0
6930;86192;877;0;0;0;0;.00nan;0;0
6930;87798;877;100;28;0;28;1.000;3600000;0
6931;5559;881;77;25;2;23;.920;3900000;0
6931;11716;881;0;0;0;0;.00nan;0;0
6931;28831;887;0;0;0;0;.00nan;0;0
6931;180316;887;89;36;2;34;.944;3900000;0
6932;11670;885;0;0;0;0;.00nan;0;0
6932;59025;1415;53;18;2;16;.889;3600000;0
6932;75362;885;66;47;5;42;.894;3600000;0
6932;143301;1415;0;0;0;0;.00nan;0;0
6933;28833;873;86;27;1;26;.963;3900000;0
6933;69536;886;0;0;0;0;.00nan;0;0
6933;70879;873;0;0;0;0;.00nan;0;0
6933;78348;886;85;28;1;27;.964;3900000;0
6934;1712;893;0;0;0;0;.00nan;0;0
6934;5559;881;84;28;2;26;.929;3900000;0
6934;11716;881;0;0;0;0;.00nan;0;0
6934;86862;893;91;32;2;30;.938;3900000;0
6935;987;875;83;33;3;30;.909;3600000;0
6935;3077;875;0;0;0;0;.00nan;0;0
6935;65762;876;80;29;2;27;.931;3600000;0
6935;141496;876;0;0;0;0;.00nan;0;0
6936;28831;887;0;0;0;0;.00nan;0;0
6936;180316;887;83;45;4;41;.911;3900000;0
6936;76574;882;0;0;0;0;.00nan;0;0
6936;142911;882;80;44;4;40;.909;3900000;0
6937;63551;892;88;50;3;47;.940;3600000;0
6937;69536;886;0;0;0;0;.00nan;0;0
6937;78348;886;100;27;0;27;1.000;3600000;0
6937;146684;892;0;0;0;0;.00nan;0;0
6938;164710;878;97;46;2;44;.957;3545000;0
6938;59025;1415;0;0;0;0;.00nan;0;0
6938;80834;878;0;0;0;0;.00nan;0;0
6938;143301;1415;63;17;1;16;.941;3600000;0
6939;164715;883;0;0;0;0;.00nan;0;0
6939;11670;885;81;26;1;25;.962;3600000;0
6939;75362;885;0;0;0;0;.00nan;0;0
6939;86180;883;89;18;0;18;1.000;3600000;0
6940;28833;873;0;0;0;0;.00nan;0;0
6940;70879;873;85;35;3;32;.914;3819000;0
6940;86192;877;0;0;0;0;.00nan;0;0
6940;87798;877;84;35;2;33;.943;3804000;0
6941;1712;893;0;0;0;0;.00nan;0;0
6941;59025;1415;0;0;0;0;.00nan;0;0
6941;86862;893;83;43;3;40;.930;3561000;0
6941;143301;1415;77;31;2;29;.935;3600000;0
6942;28831;887;93;18;0;18;1.000;3600000;0
6942;28833;873;0;0;0;0;.00nan;0;0
6942;180316;887;0;0;0;0;.00nan;0;0
6942;70879;873;91;43;4;39;.907;3600000;0
6943;11670;885;0;0;0;0;.00nan;0;0
6943;75362;885;98;50;1;49;.980;3600000;0
6943;86192;877;97;19;0;19;1.000;3600000;0
6943;87798;877;0;0;0;0;.00nan;0;0
6944;164710;878;39;29;5;24;.828;3600000;0
6944;11670;885;0;0;0;0;.00nan;0;0
6944;75362;885;100;35;0;35;1.000;3600000;0
6944;80834;878;0;0;0;0;.00nan;0;0
6945;5559;881;40;30;5;25;.833;3600000;0
6945;11716;881;0;0;0;0;.00nan;0;0
6945;65762;876;0;0;0;0;.00nan;0;0
6945;141496;876;100;30;0;30;1.000;3600000;0
6946;28833;873;57;18;2;16;.889;1392000;0
6946;63551;892;79;18;1;17;.944;3600000;0
6946;70879;873;45;37;6;31;.838;2208000;0
6946;146684;892;0;0;0;0;.00nan;0;0
6947;987;875;73;44;4;40;.909;3575000;0
6947;3077;875;0;0;0;0;.00nan;0;0
6947;28831;887;59;28;3;25;.893;3600000;0
6947;180316;887;0;0;0;0;.00nan;0;0
6948;1712;893;0;0;0;0;.00nan;0;0
6948;76574;882;0;0;0;0;.00nan;0;0
6948;86862;893;52;32;4;28;.875;3600000;0
6948;142911;882;67;14;1;13;.929;3600000;0
6949;164715;883;0;0;0;0;.00nan;0;0
6949;86180;883;46;36;6;30;.833;3600000;0
6949;86192;877;66;28;3;25;.893;3600000;0
6949;87798;877;0;0;0;0;.00nan;0;0
6950;59025;1415;0;0;0;0;.00nan;0;0
6950;69536;886;27;27;6;21;.778;3600000;0
6950;78348;886;0;0;0;0;.00nan;0;0
6950;143301;1415;82;26;1;25;.962;3600000;0
6951;987;875;51;19;3;16;.842;3600000;0
6951;1712;893;0;0;0;0;.00nan;0;0
6951;3077;875;0;0;0;0;.00nan;0;0
6951;86862;893;81;45;4;41;.911;3562000;0
6952;11670;885;0;0;0;0;.00nan;0;0
6952;65762;876;0;0;0;0;.00nan;0;0
6952;75362;885;84;36;2;34;.944;3600000;0
6952;141496;876;81;14;0;14;1.000;3600000;0
6953;28831;887;0;0;0;0;.00nan;0;0
6953;180316;887;76;36;3;33;.917;3600000;0
6953;63551;892;79;38;4;34;.895;3542000;0
6953;146684;892;0;0;0;0;.00nan;0;0
6954;69536;886;0;0;0;0;.00nan;0;0
6954;76574;882;0;0;0;0;.00nan;0;0
6954;78348;886;66;22;2;20;.909;3600000;0
6954;142911;882;61;44;5;39;.886;3600000;0
6955;59025;1415;0;0;0;0;.00nan;0;0
6955;86192;877;67;25;2;23;.920;3600000;0
6955;87798;877;0;0;0;0;.00nan;0;0
6955;143301;1415;51;30;4;26;.867;3593000;0
6956;164710;878;100;28;0;28;1.000;3600000;0
6956;28833;873;0;0;0;0;.00nan;0;0
6956;70879;873;64;38;5;33;.868;3600000;0
6956;80834;878;0;0;0;0;.00nan;0;0
6957;5559;881;81;26;1;25;.962;3600000;0
6957;164715;883;0;0;0;0;.00nan;0;0
6957;11716;881;0;0;0;0;.00nan;0;0
6957;86180;883;77;37;3;34;.919;3542000;0
6958;1712;893;0;0;0;0;.00nan;0;0
6958;65762;876;0;0;0;0;.00nan;0;0
6958;86862;893;64;36;4;32;.889;3600000;0
6958;141496;876;24;20;5;15;.750;3542000;0
6959;987;875;100;27;0;27;1.000;3600000;0
6959;3077;875;0;0;0;0;.00nan;0;0
6959;164715;883;0;0;0;0;.00nan;0;0
6959;86180;883;73;27;2;25;.926;3566000;0
6960;164710;878;98;36;1;35;.972;3600000;0
6960;63551;892;74;33;2;31;.939;3565000;0
6960;80834;878;0;0;0;0;.00nan;0;0
6960;146684;892;0;0;0;0;.00nan;0;0
6961;59025;1415;0;0;0;0;.00nan;0;0
6961;76574;882;32;24;5;19;.792;3600000;0
6961;142911;882;0;0;0;0;.00nan;0;0
6961;143301;1415;95;22;0;22;1.000;3600000;0
6962;11670;885;0;0;0;0;.00nan;0;0
6962;69536;886;30;10;3;7;.700;3600000;0
6962;75362;885;83;38;2;36;.947;3600000;0
6962;78348;886;0;0;0;0;.00nan;0;0
6963;5559;881;92;28;1;27;.964;3900000;0
6963;11716;881;0;0;0;0;.00nan;0;0
6963;86192;877;77;21;1;20;.952;3900000;0
6963;87798;877;0;0;0;0;.00nan;0;0
6964;28831;887;0;0;0;0;.00nan;0;0
6964;28833;873;30;31;6;25;.806;2750000;0
6964;180316;887;56;33;5;28;.848;3600000;0
6964;70879;873;60;9;0;9;1.000;795000;0
6965;1712;893;0;0;0;0;.00nan;0;0
6965;63551;892;79;32;3;29;.906;3560000;0
6965;86862;893;83;34;2;32;.941;3600000;0
6965;146684;892;0;0;0;0;.00nan;0;0
6966;987;875;68;23;1;22;.957;3600000;0
6966;3077;875;0;0;0;0;.00nan;0;0
6966;11670;885;100;26;0;26;1.000;3600000;0
6966;75362;885;0;0;0;0;.00nan;0;0
6967;28831;887;76;20;1;19;.950;3600000;0
6967;180316;887;0;0;0;0;.00nan;0;0
6967;86192;877;85;47;4;43;.915;3600000;0
6967;87798;877;0;0;0;0;.00nan;0;0
6968;164710;878;14;24;6;18;.750;3600000;0
6968;76574;882;0;0;0;0;.00nan;0;0
6968;80834;878;0;0;0;0;.00nan;0;0
6968;142911;882;72;34;3;31;.912;3600000;0
6969;5559;881;85;32;2;30;.938;3600000;0
6969;11716;881;0;0;0;0;.00nan;0;0
6969;28833;873;0;0;0;0;.00nan;0;0
6969;70879;873;74;34;3;31;.912;3579000;0
6970;164715;883;0;0;0;0;.00nan;0;0
6970;69536;886;75;39;3;36;.923;3885000;0
6970;78348;886;0;0;0;0;.00nan;0;0
6970;86180;883;78;33;3;30;.909;3900000;0
6971;59025;1415;0;0;0;0;.00nan;0;0
6971;65762;876;0;0;0;0;.00nan;0;0
6971;141496;876;62;27;3;24;.889;3600000;0
6971;143301;1415;51;32;5;27;.844;3585000;0
6972;11670;885;76;42;4;38;.905;3600000;0
6972;28831;887;91;22;0;22;1.000;3600000;0
6972;180316;887;0;0;0;0;.00nan;0;0
6972;75362;885;0;0;0;0;.00nan;0;0
6973;164710;878;56;28;4;24;.857;3556000;0
6973;65762;876;85;32;2;30;.938;3600000;0
6973;80834;878;0;0;0;0;.00nan;0;0
6973;141496;876;0;0;0;0;.00nan;0;0
6974;987;875;100;27;0;27;1.000;3600000;0
6974;3077;875;0;0;0;0;.00nan;0;0
6974;86192;877;63;31;3;28;.903;3600000;0
6974;87798;877;0;0;0;0;.00nan;0;0
6975;5559;881;87;27;1;26;.963;3600000;0
6975;11716;881;0;0;0;0;.00nan;0;0
6975;63551;892;0;0;0;0;.00nan;0;0
6975;146684;892;73;27;2;25;.926;3582000;0
6976;164715;883;0;0;0;0;.00nan;0;0
6976;76574;882;0;0;0;0;.00nan;0;0
6976;86180;883;92;32;2;30;.938;3900000;0
6976;142911;882;78;36;2;34;.944;3900000;0
6977;1712;893;0;0;0;0;.00nan;0;0
6977;69536;886;0;0;0;0;.00nan;0;0
6977;78348;886;98;15;0;15;1.000;3600000;0
6977;86862;893;46;37;6;31;.838;3600000;0
6978;28833;873;0;0;0;0;.00nan;0;0
6978;59025;1415;0;0;0;0;.00nan;0;0
6978;70879;873;66;37;4;33;.892;3545000;0
6978;143301;1415;75;29;3;26;.897;3600000;0
6979;1712;893;100;33;0;33;1.000;3600000;0
6979;86862;893;0;0;0;0;.00nan;0;0
6979;141496;876;48;20;3;17;.850;3600000;0
6979;151940;876;0;0;0;0;.00nan;0;0
6980;11670;885;27;30;6;24;.800;2634000;0
6980;59025;1415;61;21;2;19;.905;3600000;0
6980;65762;1415;0;0;0;0;.00nan;0;0
6980;75362;885;46;19;3;16;.842;966000;0
6981;28831;887;0;0;0;0;.00nan;0;0
6981;196005;882;54;1;0;1;1.000;356000;0
6981;180316;887;95;35;2;33;.943;3600000;0
6981;76574;882;29;28;6;22;.786;3244000;0
6982;5354;886;0;0;0;0;.00nan;0;0
6982;78348;886;75;23;2;21;.913;3600000;0
6982;86192;877;54;25;3;22;.880;3543000;0
6982;87798;877;0;0;0;0;.00nan;0;0
6983;164710;878;0;0;0;0;.00nan;0;0
6983;63551;892;61;22;2;20;.909;3600000;0
6983;80834;878;85;54;4;50;.926;3600000;0
6983;146684;892;0;0;0;0;.00nan;0;0
6984;3077;875;0;0;0;0;.00nan;0;0
6984;7037;875;98;44;2;42;.955;3600000;0
6984;164715;883;63;23;3;20;.870;3562000;0
6984;86180;883;0;0;0;0;.00nan;0;0
6985;11670;885;0;0;0;0;.00nan;0;0
6985;28833;873;67;20;1;19;.950;3600000;0
6985;75362;885;17;22;6;16;.727;3600000;0
6985;147567;873;0;0;0;0;.00nan;0;0
6986;28831;887;0;0;0;0;.00nan;0;0
6986;180316;887;85;27;2;25;.926;3600000;0
6986;141496;876;89;47;3;44;.936;3597000;0
6986;151940;876;0;0;0;0;.00nan;0;0
6987;1712;893;84;49;4;45;.918;3600000;0
6987;3077;875;0;0;0;0;.00nan;0;0
6987;7037;875;63;14;1;13;.929;3600000;0
6987;86862;893;0;0;0;0;.00nan;0;0
6988;164715;883;19;8;4;4;.500;1131000;0
6988;63551;892;99;36;1;35;.972;3600000;0
6988;86180;883;22;23;6;17;.739;2469000;0
6988;146684;892;0;0;0;0;.00nan;0;0
6989;5354;886;0;0;0;0;.00nan;0;0
6989;164710;878;100;46;2;44;.957;3600000;0
6989;78348;886;32;25;5;20;.800;3600000;0
6989;80834;878;0;0;0;0;.00nan;0;0
6990;5559;881;88;39;2;37;.949;3600000;0
6990;11716;881;0;0;0;0;.00nan;0;0
6990;86192;877;0;0;0;0;.00nan;0;0
6990;87798;877;54;30;4;26;.867;3594000;0
6991;196005;882;0;0;0;0;.00nan;0;0
6991;59025;1415;72;32;3;29;.906;3600000;0
6991;65762;1415;0;0;0;0;.00nan;0;0
6991;76574;882;67;40;4;36;.900;3596000;0
6992;164715;883;0;0;0;0;.00nan;0;0
6992;86180;883;59;26;3;23;.885;3600000;0
6992;141496;876;80;28;1;27;.964;3600000;0
6992;151940;876;0;0;0;0;.00nan;0;0
6993;987;875;100;30;0;30;1.000;3600000;0
6993;7037;875;0;0;0;0;.00nan;0;0
6993;28833;873;0;0;0;0;.00nan;0;0
6993;70879;873;98;43;2;41;.953;3521000;0
6994;28831;887;83;31;1;30;.968;3600000;0
6994;180316;887;0;0;0;0;.00nan;0;0
6994;63551;892;91;40;3;37;.925;3580000;0
6994;146684;892;0;0;0;0;.00nan;0;0
6995;76574;882;0;0;0;0;.00nan;0;0
6995;86192;877;98;18;0;18;1.000;3600000;0
6995;87798;877;0;0;0;0;.00nan;0;0
6995;142911;882;98;39;1;38;.974;3556000;0
6996;59025;1415;0;0;0;0;.00nan;0;0
6996;69536;886;76;26;1;25;.962;3600000;0
6996;78348;886;0;0;0;0;.00nan;0;0
6996;143301;1415;79;31;2;29;.935;3600000;0
6997;164710;878;61;25;3;22;.880;3600000;0
6997;11670;885;64;36;4;32;.889;3600000;0
6997;75362;885;0;0;0;0;.00nan;0;0
6997;80834;878;0;0;0;0;.00nan;0;0
6998;1712;893;0;0;0;0;.00nan;0;0
6998;5559;881;82;27;1;26;.963;3600000;0
6998;11716;881;0;0;0;0;.00nan;0;0
6998;86862;893;71;35;3;32;.914;3570000;0
6999;59025;1415;0;0;0;0;.00nan;0;0
6999;141496;876;71;22;1;21;.955;3600000;0
6999;143301;1415;35;28;5;23;.821;3600000;0
6999;151940;876;0;0;0;0;.00nan;0;0
7000;164710;878;64;49;6;43;.878;3600000;0
7000;28831;887;0;0;0;0;.00nan;0;0
7000;180316;887;66;25;3;22;.880;3600000;0
7000;80834;878;0;0;0;0;.00nan;0;0
7001;63551;892;74;28;2;26;.929;3546000;0
7001;76574;882;0;0;0;0;.00nan;0;0
7001;142911;882;96;41;1;40;.976;3600000;0
7001;146684;892;0;0;0;0;.00nan;0;0
7004;5559;881;27;22;5;17;.773;3900000;0
7004;11670;885;0;0;0;0;.00nan;0;0
7004;11716;881;0;0;0;0;.00nan;0;0
7004;75362;885;93;53;5;48;.906;3900000;0
7005;28833;873;0;0;0;0;.00nan;0;0
7005;70879;873;86;39;2;37;.949;3600000;0
7005;85787;893;0;0;0;0;.00nan;0;0
7005;86862;893;65;32;3;29;.906;3549000;0
7007;11670;885;0;0;0;0;.00nan;0;0
7007;75362;885;95;46;3;43;.935;3600000;0
7007;141496;876;51;31;4;27;.871;3591000;0
7007;151940;876;0;0;0;0;.00nan;0;0
7008;987;875;51;27;4;23;.852;3586000;0
7008;7037;875;0;0;0;0;.00nan;0;0
7008;28831;887;60;29;3;26;.897;3600000;0
7008;180316;887;0;0;0;0;.00nan;0;0
7010;5559;881;82;26;1;25;.962;3600000;0
7010;11716;881;0;0;0;0;.00nan;0;0
7010;76574;882;0;0;0;0;.00nan;0;0
7010;142911;882;72;28;2;26;.929;3547000;0
7011;164710;878;78;41;4;37;.902;3600000;0
7011;164715;883;0;0;0;0;.00nan;0;0
7011;80834;878;0;0;0;0;.00nan;0;0
7011;86180;883;71;19;1;18;.947;3600000;0
7012;28833;873;0;0;0;0;.00nan;0;0
7012;59025;1415;0;0;0;0;.00nan;0;0
7012;70879;873;65;24;2;22;.917;3900000;0
7012;143301;1415;91;39;2;37;.949;3900000;0
7013;11670;885;0;0;0;0;.00nan;0;0
7013;75362;885;86;43;3;40;.930;3574000;0
7013;76574;882;0;0;0;0;.00nan;0;0
7013;142911;882;74;21;1;20;.952;3600000;0
7014;63551;892;0;0;0;0;.00nan;0;0
7014;85787;893;0;0;0;0;.00nan;0;0
7014;86862;893;98;53;3;50;.943;3519000;0
7014;146684;892;83;26;1;25;.962;3600000;0
7015;164715;883;0;0;0;0;.00nan;0;0
7015;28831;887;0;0;0;0;.00nan;0;0
7015;180316;887;80;32;2;30;.938;3600000;0
7015;86180;883;62;30;4;26;.867;3524000;0
7016;28833;873;0;0;0;0;.00nan;0;0
7016;69536;886;53;23;4;19;.826;3900000;0
7016;70879;873;92;59;4;55;.932;3900000;0
7016;78348;886;0;0;0;0;.00nan;0;0
7017;987;875;62;30;3;27;.900;3600000;0
7017;7037;875;0;0;0;0;.00nan;0;0
7017;164710;878;100;36;0;36;1.000;3600000;0
7017;80834;878;0;0;0;0;.00nan;0;0
7018;5559;881;83;24;1;23;.958;3600000;0
7018;11716;881;0;0;0;0;.00nan;0;0
7018;141496;876;62;32;4;28;.875;3600000;0
7018;151940;876;0;0;0;0;.00nan;0;0
7019;59025;1415;40;2;1;1;.500;743000;0
7019;86192;877;99;36;1;35;.972;3600000;0
7019;87798;877;0;0;0;0;.00nan;0;0
7019;143301;1415;23;28;6;22;.786;2857000;0
7020;69536;886;0;0;0;0;.00nan;0;0
7020;78348;886;70;39;3;36;.923;3900000;0
7020;141496;876;0;0;0;0;.00nan;0;0
7020;151940;876;77;31;3;28;.903;3900000;0
7021;987;875;55;24;3;21;.875;3600000;0
7021;7037;875;0;0;0;0;.00nan;0;0
7021;11670;885;0;0;0;0;.00nan;0;0
7021;75362;885;70;38;4;34;.895;3593000;0
7022;164710;878;28;13;4;9;.692;1187000;0
7022;76574;882;0;0;0;0;.00nan;0;0
7022;80834;878;64;15;1;14;.933;2413000;0
7022;142911;882;100;29;0;29;1.000;3600000;0
7023;28831;887;50;34;4;30;.882;3600000;0
7023;180316;887;0;0;0;0;.00nan;0;0
7023;86192;877;81;24;1;23;.958;3600000;0
7023;87798;877;0;0;0;0;.00nan;0;0
7024;5559;881;67;27;2;25;.926;3600000;0
7024;164715;883;0;0;0;0;.00nan;0;0
7024;11716;881;0;0;0;0;.00nan;0;0
7024;86180;883;56;27;3;24;.889;3566000;0
7025;28833;873;0;0;0;0;.00nan;0;0
7025;63551;892;63;27;3;24;.889;3600000;0
7025;70879;873;74;23;1;22;.957;3600000;0
7025;146684;892;0;0;0;0;.00nan;0;0
7026;11670;885;0;0;0;0;.00nan;0;0
7026;69536;886;100;17;0;17;1.000;3600000;0
7026;75362;885;97;40;1;39;.975;3577000;0
7026;78348;886;0;0;0;0;.00nan;0;0
7027;987;875;60;19;3;16;.842;3572000;0
7027;7037;875;0;0;0;0;.00nan;0;0
7027;76574;882;0;0;0;0;.00nan;0;0
7027;142911;882;64;22;2;20;.909;3600000;0
7028;63551;892;59;31;4;27;.871;3568000;0
7028;141496;876;72;28;2;26;.929;3600000;0
7028;146684;892;0;0;0;0;.00nan;0;0
7028;151940;876;0;0;0;0;.00nan;0;0
7029;5559;881;98;43;3;40;.930;3521000;0
7029;11716;881;0;0;0;0;.00nan;0;0
7029;28831;887;0;0;0;0;.00nan;0;0
7029;180316;887;81;28;1;27;.964;3600000;0
7030;28833;873;0;0;0;0;.00nan;0;0
7030;70879;873;53;35;5;30;.857;3600000;0
7030;86192;877;74;25;1;24;.960;3600000;0
7030;87798;877;0;0;0;0;.00nan;0;0
7031;164710;878;73;27;2;25;.926;3600000;0
7031;80834;878;0;0;0;0;.00nan;0;0
7031;85787;893;0;0;0;0;.00nan;0;0
7031;86862;893;52;34;5;29;.853;3600000;0
7032;164715;883;0;0;0;0;.00nan;0;0
7032;59025;1415;0;0;0;0;.00nan;0;0
7032;86180;883;61;43;6;37;.860;3600000;0
7032;143301;1415;80;24;1;23;.958;3600000;0
7062;164710;878;33;34;6;28;.824;3600000;0
7062;65762;876;91;35;1;34;.971;3600000;0
7062;80834;878;0;0;0;0;.00nan;0;0
7062;141496;876;0;0;0;0;.00nan;0;0
7064;1712;893;83;47;3;44;.936;3842000;0
7064;7037;893;0;0;0;0;.00nan;0;0
7064;28831;887;0;0;0;0;.00nan;0;0
7064;180316;887;71;27;2;25;.926;3837000;0
7066;5354;873;0;0;0;0;.00nan;0;0
7066;164715;883;74;38;4;34;.895;3900000;0
7066;28833;873;80;44;4;40;.909;3900000;0
7066;147567;883;0;0;0;0;.00nan;0;0
7068;63551;892;50;28;4;24;.857;3600000;0
7068;70099;877;0;0;0;0;.00nan;0;0
7068;146684;892;0;0;0;0;.00nan;0;0
7068;149858;877;83;32;1;31;.969;3600000;0
7070;987;875;70;35;4;31;.886;3702000;0
7070;3077;875;0;0;0;0;.00nan;0;0
7070;5559;881;0;0;0;0;.00nan;0;0
7070;11716;881;65;26;3;23;.885;3702000;0
7072;11670;885;81;44;3;41;.932;3524000;0
7072;196005;882;0;0;0;0;.00nan;0;0
7072;71075;885;0;0;0;0;.00nan;0;0
7072;142911;882;59;14;1;13;.929;3600000;0
7074;20645;1415;0;0;0;0;.00nan;0;0
7074;196012;1415;53;22;3;19;.864;3600000;0
7074;69536;886;58;28;4;24;.857;3544000;0
7074;78348;886;0;0;0;0;.00nan;0;0
7076;1712;893;0;0;0;0;.00nan;0;0
7076;7037;893;86;38;3;35;.921;3545000;0
7076;164710;878;0;0;0;0;.00nan;0;0
7076;80834;878;83;31;1;30;.968;3600000;0
7078;5559;881;36;21;4;17;.810;3600000;0
7078;11716;881;0;0;0;0;.00nan;0;0
7078;28831;887;39;32;6;26;.813;2589000;0
7078;180316;887;52;11;1;10;.909;1011000;0
7080;987;875;0;0;0;0;.00nan;0;0
7080;3077;875;100;36;0;36;1.000;3600000;0
7080;65762;876;0;0;0;0;.00nan;0;0
7080;141496;876;59;27;3;24;.889;3600000;0
7082;20645;1415;74;26;2;24;.923;3882000;0
7082;196012;1415;0;0;0;0;.00nan;0;0
7082;70099;877;80;34;3;31;.912;3882000;0
7082;149858;877;0;0;0;0;.00nan;0;0
7084;164715;883;0;0;0;0;.00nan;0;0
7084;11670;885;0;0;0;0;.00nan;0;0
7084;71075;885;67;31;3;28;.903;3544000;0
7084;147567;883;63;22;2;20;.909;3600000;0
7086;5354;873;90;48;4;44;.917;3815000;0
7086;28833;873;0;0;0;0;.00nan;0;0
7086;63551;892;0;0;0;0;.00nan;0;0
7086;146684;892;81;35;3;32;.914;3815000;0
7088;196005;882;100;35;0;35;1.000;3600000;0
7088;69536;886;0;0;0;0;.00nan;0;0
7088;78348;886;43;32;5;27;.844;3600000;0
7088;142911;882;0;0;0;0;.00nan;0;0
7092;5354;873;0;0;0;0;.00nan;0;0
7092;28833;873;59;32;4;28;.875;3600000;0
7092;196005;882;34;25;5;20;.800;3557000;0
7092;142911;882;0;0;0;0;.00nan;0;0
7096;987;875;0;0;0;0;.00nan;0;0
7096;3077;875;99;49;2;47;.959;3600000;0
7096;164715;883;46;20;3;17;.850;3545000;0
7096;147567;883;0;0;0;0;.00nan;0;0
7102;164710;878;80;38;3;35;.921;3626000;0
7102;65762;876;74;28;2;26;.929;3626000;0
7102;80834;878;0;0;0;0;.00nan;0;0
7102;141496;876;0;0;0;0;.00nan;0;0
7106;987;875;54;38;5;33;.868;3548000;0
7106;3077;875;0;0;0;0;.00nan;0;0
7106;65762;876;0;0;0;0;.00nan;0;0
7106;141496;876;61;21;3;18;.857;3600000;0
7108;1712;893;0;0;0;0;.00nan;0;0
7108;7037;893;52;19;3;16;.842;3552000;0
7108;11670;885;82;34;2;32;.941;3600000;0
7108;71075;885;0;0;0;0;.00nan;0;0
7110;5354;873;60;30;3;27;.900;3541000;0
7110;5559;881;65;14;1;13;.929;3600000;0
7110;11716;881;0;0;0;0;.00nan;0;0
7110;28833;873;0;0;0;0;.00nan;0;0
7112;164710;878;0;0;0;0;.00nan;0;0
7112;196005;882;0;0;0;0;.00nan;0;0
7112;80834;878;59;35;4;31;.886;3600000;0
7112;142911;882;100;27;0;27;1.000;3600000;0
7120;987;875;84;36;2;34;.944;3900000;0
7120;3077;875;0;0;0;0;.00nan;0;0
7120;11670;885;71;28;2;26;.929;3870000;0
7120;71075;885;0;0;0;0;.00nan;0;0
7124;164715;883;55;25;3;22;.880;3523000;0
7124;196005;882;0;0;0;0;.00nan;0;0
7124;142911;882;89;24;1;23;.958;3600000;0
7124;147567;883;0;0;0;0;.00nan;0;0
7128;5354;873;97;39;2;37;.949;3600000;0
7128;5559;881;87;30;1;29;.967;3600000;0
7128;11716;881;0;0;0;0;.00nan;0;0
7128;28833;873;0;0;0;0;.00nan;0;0
7130;164710;878;0;0;0;0;.00nan;0;0
7130;20645;1415;68;20;1;19;.950;3564000;0
7130;196012;1415;0;0;0;0;.00nan;0;0
7130;80834;878;100;35;0;35;1.000;3600000;0
7134;987;875;0;0;0;0;.00nan;0;0
7134;3077;875;41;29;6;23;.793;3562000;0
7134;5354;873;0;0;0;0;.00nan;0;0
7134;28833;873;64;35;4;31;.886;3600000;0
7138;5559;881;0;0;0;0;.00nan;0;0
7138;164710;878;0;0;0;0;.00nan;0;0
7138;11716;881;82;31;2;29;.935;3600000;0
7138;80834;878;61;30;3;27;.900;3566000;0
7140;1712;893;94;30;1;29;.967;3600000;0
7140;7037;893;0;0;0;0;.00nan;0;0
7140;164715;883;0;0;0;0;.00nan;0;0
7140;147567;883;58;35;4;31;.886;3600000;0
7144;11670;885;0;0;0;0;.00nan;0;0
7144;196005;882;64;30;3;27;.900;3793000;0
7144;71075;885;95;42;2;40;.952;3793000;0
7144;142911;882;0;0;0;0;.00nan;0;0
7150;1712;893;96;47;3;44;.936;3900000;0
7150;7037;893;0;0;0;0;.00nan;0;0
7150;164710;878;0;0;0;0;.00nan;0;0
7150;80834;878;71;35;3;32;.914;3900000;0
7152;5559;881;0;0;0;0;.00nan;0;0
7152;11716;881;76;41;4;37;.902;3550000;0
7152;20645;1415;0;0;0;0;.00nan;0;0
7152;196012;1415;77;23;2;21;.913;3600000;0
7154;164715;883;72;27;3;24;.889;3900000;0
7154;65762;876;0;0;0;0;.00nan;0;0
7154;141496;876;63;40;3;37;.925;3888000;0
7154;147567;883;0;0;0;0;.00nan;0;0
7156;11670;885;81;33;2;31;.939;3575000;0
7156;196005;882;0;0;0;0;.00nan;0;0
7156;71075;885;0;0;0;0;.00nan;0;0
7156;142911;882;100;32;0;32;1.000;3600000;0
7159;177519;512;0;0;0;0;.00nan;0;0
7159;7332;512;86;51;4;47;.922;3570000;0
7159;89998;515;0;0;0;0;.00nan;0;0
7159;143330;515;73;25;2;23;.920;3600000;0
7160;84287;516;57;31;4;27;.871;3600000;0
7160;143191;516;0;0;0;0;.00nan;0;0
7160;152478;513;49;33;5;28;.848;3600000;0
7160;152494;513;0;0;0;0;.00nan;0;0
7161;1072;514;75;23;1;22;.957;3900000;0
7161;190258;1876;0;0;0;0;.00nan;0;0
7161;152201;1876;95;41;1;40;.976;3900000;0
7161;155474;514;0;0;0;0;.00nan;0;0
7162;14047;511;74;28;2;26;.929;3600000;0
7162;86099;511;0;0;0;0;.00nan;0;0
7162;142929;1872;0;0;0;0;.00nan;0;0
7162;151590;1872;45;25;4;21;.840;3517000;0
7163;68425;519;0;0;0;0;.00nan;0;0
7163;143083;1472;82;37;3;34;.919;3560000;0
7163;143307;519;81;25;1;24;.960;3600000;0
7163;159851;1472;0;0;0;0;.00nan;0;0
7164;4618;520;73;38;4;34;.895;3600000;0
7164;174581;518;0;0;0;0;.00nan;0;0
7164;143256;520;0;0;0;0;.00nan;0;0
7164;143523;518;76;23;1;22;.957;3600000;0
7165;8035;524;99;53;1;52;.981;3600000;0
7165;54290;517;0;0;0;0;.00nan;0;0
7165;62287;517;52;16;2;14;.875;3573000;0
7165;152464;524;0;0;0;0;.00nan;0;0
7166;1072;514;0;0;0;0;.00nan;0;0
7166;174581;518;0;0;0;0;.00nan;0;0
7166;143523;518;80;32;2;30;.938;3900000;0
7166;155474;514;80;33;2;31;.939;3900000;0
7167;177519;512;68;27;3;24;.889;3572000;0
7167;7332;512;0;0;0;0;.00nan;0;0
7167;54290;517;0;0;0;0;.00nan;0;0
7167;62287;517;92;33;1;32;.970;3600000;0
7168;190258;1876;0;0;0;0;.00nan;0;0
7168;142929;1872;76;31;2;29;.935;3900000;0
7168;151590;1872;0;0;0;0;.00nan;0;0
7168;152201;1876;79;36;2;34;.944;3900000;0
7169;14047;511;0;0;0;0;.00nan;0;0
7169;68425;519;0;0;0;0;.00nan;0;0
7169;86099;511;30;23;5;18;.783;3545000;0
7169;143307;519;78;46;4;42;.913;3600000;0
7170;8035;524;0;0;0;0;.00nan;0;0
7170;84287;516;0;0;0;0;.00nan;0;0
7170;143191;516;53;22;3;19;.864;3600000;0
7170;152464;524;91;38;1;37;.974;3600000;0
7171;89998;515;0;0;0;0;.00nan;0;0
7171;143330;515;75;18;1;17;.944;3900000;0
7171;152478;513;84;31;1;30;.968;3900000;0
7171;152494;513;0;0;0;0;.00nan;0;0
7172;4618;520;76;34;3;31;.912;3900000;0
7172;143083;1472;67;32;3;29;.906;3900000;0
7172;143256;520;0;0;0;0;.00nan;0;0
7172;159851;1472;0;0;0;0;.00nan;0;0
7173;4618;520;0;0;0;0;.00nan;0;0
7173;142929;1872;58;18;2;16;.889;3564000;0
7173;143256;520;89;31;1;30;.968;3600000;0
7173;151590;1872;0;0;0;0;.00nan;0;0
7174;177519;512;52;29;4;25;.862;3544000;0
7174;7332;512;0;0;0;0;.00nan;0;0
7174;14047;511;0;0;0;0;.00nan;0;0
7174;86099;511;67;27;3;24;.889;3600000;0
7175;85749;513;0;0;0;0;.00nan;0;0
7175;143083;1472;0;0;0;0;.00nan;0;0
7175;152478;513;56;28;4;24;.857;3585000;0
7175;159851;1472;65;28;3;25;.893;3600000;0
7176;59614;515;0;0;0;0;.00nan;0;0
7176;84287;516;0;0;0;0;.00nan;0;0
7176;143191;516;85;28;1;27;.964;3600000;0
7176;143330;515;52;33;5;28;.848;3600000;0
7177;1072;514;0;0;0;0;.00nan;0;0
7177;54290;517;0;0;0;0;.00nan;0;0
7177;62287;517;91;39;1;38;.974;3600000;0
7177;155474;514;41;32;5;27;.844;3600000;0
7178;174581;518;0;0;0;0;.00nan;0;0
7178;68425;519;0;0;0;0;.00nan;0;0
7178;143307;519;76;30;2;28;.933;3900000;0
7178;143523;518;70;24;2;22;.917;3900000;0
7179;8035;524;0;0;0;0;.00nan;0;0
7179;190258;1876;0;0;0;0;.00nan;0;0
7179;152201;1876;64;20;2;18;.900;3600000;0
7179;152464;524;56;29;3;26;.897;3580000;0
7180;174581;518;0;0;0;0;.00nan;0;0
7180;59614;515;0;0;0;0;.00nan;0;0
7180;143330;515;70;16;1;15;.938;3600000;0
7180;143523;518;63;46;6;40;.870;3600000;0
7181;54290;517;68;24;2;22;.917;3900000;0
7181;62287;517;0;0;0;0;.00nan;0;0
7181;68425;519;73;30;2;28;.933;3900000;0
7181;143307;519;0;0;0;0;.00nan;0;0
7182;4618;520;98;37;1;36;.973;3542000;0
7182;190258;1876;100;29;0;29;1.000;3600000;0
7182;143256;520;0;0;0;0;.00nan;0;0
7182;152201;1876;0;0;0;0;.00nan;0;0
7183;14047;511;0;0;0;0;.00nan;0;0
7183;85749;513;54;10;1;9;.900;730000;0
7183;86099;511;62;20;2;18;.900;3600000;0
7183;152478;513;32;34;6;28;.824;2870000;0
7184;177519;512;49;21;3;18;.857;3600000;0
7184;7332;512;0;0;0;0;.00nan;0;0
7184;84287;516;0;0;0;0;.00nan;0;0
7184;143191;516;53;37;5;32;.865;3596000;0
7185;1072;514;0;0;0;0;.00nan;0;0
7185;142929;1872;91;33;1;32;.970;3600000;0
7185;151590;1872;0;0;0;0;.00nan;0;0
7185;155474;514;71;31;2;29;.935;3557000;0
7186;8035;524;0;0;0;0;.00nan;0;0
7186;143083;1472;45;17;3;14;.824;3541000;0
7186;152464;524;91;43;2;41;.953;3600000;0
7186;159851;1472;0;0;0;0;.00nan;0;0
7187;177519;512;53;25;3;22;.880;3600000;0
7187;7332;512;0;0;0;0;.00nan;0;0
7187;174581;518;0;0;0;0;.00nan;0;0
7187;143523;518;59;35;5;30;.857;3571000;0
7188;190258;1876;98;44;2;42;.955;3600000;0
7188;85749;513;0;0;0;0;.00nan;0;0
7188;152201;1876;0;0;0;0;.00nan;0;0
7188;152478;513;44;28;4;24;.857;3575000;0
7189;54290;517;0;0;0;0;.00nan;0;0
7189;62287;517;85;31;1;30;.968;3545000;0
7189;84287;516;100;35;0;35;1.000;3600000;0
7189;143191;516;0;0;0;0;.00nan;0;0
7190;14047;511;83;43;3;40;.930;3600000;0
7190;59614;515;0;0;0;0;.00nan;0;0
7190;86099;511;0;0;0;0;.00nan;0;0
7190;143330;515;79;38;4;34;.895;3542000;0
7191;1072;514;70;47;5;42;.894;3600000;0
7191;143083;1472;0;0;0;0;.00nan;0;0
7191;155474;514;0;0;0;0;.00nan;0;0
7191;159851;1472;83;43;4;39;.907;3600000;0
7192;4618;520;93;26;1;25;.962;3600000;0
7192;68425;519;0;0;0;0;.00nan;0;0
7192;143256;520;0;0;0;0;.00nan;0;0
7192;143307;519;64;23;2;21;.913;3563000;0
7193;8035;524;97;45;2;43;.956;3900000;0
7193;142929;1872;65;21;2;19;.905;3900000;0
7193;151590;1872;0;0;0;0;.00nan;0;0
7193;152464;524;0;0;0;0;.00nan;0;0
7194;8035;524;0;0;0;0;.00nan;0;0
7194;174581;518;0;0;0;0;.00nan;0;0
7194;143523;518;94;16;0;16;1.000;3600000;0
7194;152464;524;35;33;6;27;.818;3600000;0
7195;54290;517;0;0;0;0;.00nan;0;0
7195;62287;517;66;33;4;29;.879;3600000;0
7195;85749;513;0;0;0;0;.00nan;0;0
7195;152478;513;65;40;5;35;.875;3549000;0
7196;177519;512;80;28;1;27;.964;3600000;0
7196;7332;512;0;0;0;0;.00nan;0;0
7196;190258;1876;0;0;0;0;.00nan;0;0
7196;152201;1876;81;34;2;32;.941;3567000;0
7197;14047;511;0;0;0;0;.00nan;0;0
7197;84287;516;0;0;0;0;.00nan;0;0
7197;86099;511;71;23;2;21;.913;3900000;0
7197;143191;516;76;31;2;29;.935;3900000;0
7198;68425;519;0;0;0;0;.00nan;0;0
7198;142929;1872;0;0;0;0;.00nan;0;0
7198;143307;519;77;37;3;34;.919;3855000;0
7198;151590;1872;71;23;2;21;.913;3855000;0
7199;1072;514;0;0;0;0;.00nan;0;0
7199;4618;520;44;48;7;41;.854;3600000;0
7199;143256;520;0;0;0;0;.00nan;0;0
7199;155474;514;89;33;1;32;.970;3600000;0
7200;59614;515;0;0;0;0;.00nan;0;0
7200;143083;1472;45;41;6;35;.854;3600000;0
7200;143330;515;92;30;1;29;.967;3600000;0
7200;159851;1472;0;0;0;0;.00nan;0;0
7201;85749;513;72;35;3;32;.914;3600000;0
7201;142929;1872;51;37;5;32;.865;3600000;0
7201;151590;1872;0;0;0;0;.00nan;0;0
7201;152478;513;0;0;0;0;.00nan;0;0
7202;14047;511;66;20;1;19;.950;3600000;0
7202;86099;511;0;0;0;0;.00nan;0;0
7202;143083;1472;0;0;0;0;.00nan;0;0
7202;159851;1472;74;34;2;32;.941;3588000;0
7203;174581;518;0;0;0;0;.00nan;0;0
7203;84287;516;71;30;4;26;.867;3600000;0
7203;143191;516;0;0;0;0;.00nan;0;0
7203;143523;518;55;33;5;28;.848;3553000;0
7204;54290;517;0;0;0;0;.00nan;0;0
7204;59614;515;0;0;0;0;.00nan;0;0
7204;62287;517;83;31;1;30;.968;3600000;0
7204;143330;515;62;30;3;27;.900;3550000;0
7205;190258;1876;0;0;0;0;.00nan;0;0
7205;68425;519;0;0;0;0;.00nan;0;0
7205;143307;519;69;18;1;17;.944;3600000;0
7205;152201;1876;52;25;3;22;.880;3600000;0
7206;4618;520;69;35;3;32;.914;3515000;0
7206;177519;512;87;30;1;29;.967;3600000;0
7206;7332;512;0;0;0;0;.00nan;0;0
7206;143256;520;0;0;0;0;.00nan;0;0
7207;1072;514;52;19;2;17;.895;3600000;0
7207;8035;524;69;31;3;28;.903;3541000;0
7207;152464;524;0;0;0;0;.00nan;0;0
7207;155474;514;0;0;0;0;.00nan;0;0
7208;174581;518;0;0;0;0;.00nan;0;0
7208;85749;513;0;0;0;0;.00nan;0;0
7208;143523;518;100;30;1;29;.967;3900000;0
7208;152478;513;70;22;1;21;.955;3900000;0
7209;14047;511;0;0;0;0;.00nan;0;0
7209;54290;517;0;0;0;0;.00nan;0;0
7209;62287;517;100;33;0;33;1.000;3600000;0
7209;86099;511;75;25;2;23;.920;3523000;0
7210;190258;1876;64;35;4;31;.886;3561000;0
7210;59614;515;0;0;0;0;.00nan;0;0
7210;143330;515;74;29;2;27;.931;3600000;0
7210;152201;1876;0;0;0;0;.00nan;0;0
7211;1072;514;0;0;0;0;.00nan;0;0
7211;68425;519;0;0;0;0;.00nan;0;0
7211;143307;519;66;37;5;32;.865;3600000;0
7211;155474;514;59;22;2;20;.909;3600000;0
7212;177519;512;81;28;1;27;.964;3600000;0
7212;142929;1872;54;23;3;20;.870;3538000;0
7212;143191;512;0;0;0;0;.00nan;0;0
7212;151590;1872;0;0;0;0;.00nan;0;0
7213;4618;520;0;0;0;0;.00nan;0;0
7213;8035;524;0;0;0;0;.00nan;0;0
7213;143256;520;74;25;1;24;.960;3600000;0
7213;152464;524;59;36;4;32;.889;3600000;0
7214;67764;516;0;0;0;0;.00nan;0;0
7214;84287;516;54;28;3;25;.893;3562000;0
7214;143083;1472;78;32;2;30;.938;3600000;0
7214;159851;1472;0;0;0;0;.00nan;0;0
7215;1072;514;0;0;0;0;.00nan;0;0
7215;177519;512;0;0;0;0;.00nan;0;0
7215;143191;512;73;24;1;23;.958;3680000;0
7215;155474;514;91;33;2;31;.939;3680000;0
7216;4618;520;86;40;3;37;.925;3900000;0
7216;85749;513;67;24;3;21;.875;3900000;0
7216;143256;520;0;0;0;0;.00nan;0;0
7216;152478;513;0;0;0;0;.00nan;0;0
7217;14047;511;69;18;1;17;.944;3600000;0
7217;174581;518;0;0;0;0;.00nan;0;0
7217;86099;511;0;0;0;0;.00nan;0;0
7217;143523;518;59;38;5;33;.868;3600000;0
7218;190258;1876;55;37;4;33;.892;3600000;0
7218;67764;516;0;0;0;0;.00nan;0;0
7218;84287;516;87;32;1;31;.969;3600000;0
7218;152201;1876;0;0;0;0;.00nan;0;0
7219;59614;515;0;0;0;0;.00nan;0;0
7219;142929;1872;93;42;3;39;.929;3600000;0
7219;143330;515;47;22;4;18;.818;3548000;0
7219;151590;1872;0;0;0;0;.00nan;0;0
7220;8035;524;82;35;2;33;.943;3600000;0
7220;68425;519;85;30;1;29;.967;3600000;0
7220;143307;519;0;0;0;0;.00nan;0;0
7220;152464;524;0;0;0;0;.00nan;0;0
7221;54290;517;0;0;0;0;.00nan;0;0
7221;62287;517;65;20;2;18;.900;3600000;0
7221;143083;1472;0;0;0;0;.00nan;0;0
7221;159851;1472;77;33;3;30;.909;3560000;0
7222;174581;518;63;43;5;38;.884;3600000;0
7222;54290;517;0;0;0;0;.00nan;0;0
7222;62287;517;53;20;2;18;.900;3600000;0
7222;143523;518;0;0;0;0;.00nan;0;0
7223;190258;1876;0;0;0;0;.00nan;0;0
7223;143083;1472;100;34;0;34;1.000;3600000;0
7223;152201;1876;88;33;1;32;.970;3581000;0
7223;159851;1472;0;0;0;0;.00nan;0;0
7224;4618;520;59;40;5;35;.875;3600000;0
7224;14047;511;84;29;1;28;.966;3600000;0
7224;86099;511;0;0;0;0;.00nan;0;0
7224;143256;520;0;0;0;0;.00nan;0;0
7225;1072;514;61;31;4;27;.871;3900000;0
7225;59614;515;0;0;0;0;.00nan;0;0
7225;143330;515;71;43;4;39;.907;3900000;0
7225;155474;514;0;0;0;0;.00nan;0;0
7226;67764;516;0;0;0;0;.00nan;0;0
7226;84287;516;64;33;3;30;.909;3525000;0
7226;142929;1872;0;0;0;0;.00nan;0;0
7226;151590;1872;63;15;1;14;.933;3600000;0
7227;177519;512;0;0;0;0;.00nan;0;0
7227;68425;519;89;29;1;28;.966;3900000;0
7227;143191;512;73;26;1;25;.962;3900000;0
7227;143307;519;0;0;0;0;.00nan;0;0
7228;8035;524;0;0;0;0;.00nan;0;0
7228;85749;513;35;14;3;11;.786;3900000;0
7228;152464;524;80;39;3;36;.923;3900000;0
7228;152478;513;0;0;0;0;.00nan;0;0
7229;54290;517;0;0;0;0;.00nan;0;0
7229;62287;517;69;36;4;32;.889;3600000;0
7229;142929;1872;0;0;0;0;.00nan;0;0
7229;151590;1872;40;17;3;14;.824;3600000;0
7230;177519;512;0;0;0;0;.00nan;0;0
7230;8035;524;69;54;6;48;.889;3600000;0
7230;143191;512;60;14;1;13;.929;3600000;0
7230;152464;524;0;0;0;0;.00nan;0;0
7231;1072;514;54;21;3;18;.857;3600000;0
7231;85749;513;58;35;4;31;.886;3599000;0
7231;152478;513;0;0;0;0;.00nan;0;0
7231;155474;514;0;0;0;0;.00nan;0;0
7232;14047;511;0;0;0;0;.00nan;0;0
7232;190258;1876;0;0;0;0;.00nan;0;0
7232;86099;511;50;18;3;15;.833;3531000;0
7232;152201;1876;99;40;1;39;.975;3600000;0
7233;67764;516;0;0;0;0;.00nan;0;0
7233;68425;519;0;0;0;0;.00nan;0;0
7233;84287;516;51;35;5;30;.857;3600000;0
7233;143307;519;88;29;2;27;.931;3600000;0
7234;4618;520;67;46;5;41;.891;3565000;0
7234;59614;515;65;26;3;23;.885;3600000;0
7234;143256;520;0;0;0;0;.00nan;0;0
7234;143330;515;0;0;0;0;.00nan;0;0
7235;174581;518;0;0;0;0;.00nan;0;0
7235;143083;1472;91;20;0;20;1.000;3600000;0
7235;143523;518;38;33;6;27;.818;3600000;0
7235;159851;1472;0;0;0;0;.00nan;0;0
7236;174581;518;0;0;0;0;.00nan;0;0
7236;190258;1876;0;0;0;0;.00nan;0;0
7236;143523;518;53;29;4;25;.862;3561000;0
7236;152201;1876;64;29;3;26;.897;3600000;0
7237;177519;512;0;0;0;0;.00nan;0;0
7237;85749;513;0;0;0;0;.00nan;0;0
7237;143191;512;83;29;2;27;.931;3600000;0
7237;152478;513;48;26;4;22;.846;3574000;0
7238;8424;514;0;0;0;0;.00nan;0;0
7238;67764;516;0;0;0;0;.00nan;0;0
7238;84287;516;98;40;1;39;.975;3600000;0
7238;155474;514;99;23;0;23;1.000;3600000;0
7239;142929;1872;51;31;5;26;.839;3600000;0
7239;143083;1472;79;30;2;28;.933;3600000;0
7239;151590;1872;0;0;0;0;.00nan;0;0
7239;159851;1472;0;0;0;0;.00nan;0;0
7240;59614;515;0;0;0;0;.00nan;0;0
7240;68425;519;62;29;3;26;.897;3543000;0
7240;143307;519;0;0;0;0;.00nan;0;0
7240;143330;515;80;33;2;31;.939;3600000;0
7241;4618;520;61;22;2;20;.909;3517000;0
7241;54290;517;0;0;0;0;.00nan;0;0
7241;62287;517;91;24;0;24;1.000;3600000;0
7241;143256;520;0;0;0;0;.00nan;0;0
7242;8035;524;91;37;2;35;.946;3900000;0
7242;14047;511;81;30;2;28;.933;3900000;0
7242;86099;511;0;0;0;0;.00nan;0;0
7242;152464;524;0;0;0;0;.00nan;0;0
7243;174581;518;0;0;0;0;.00nan;0;0
7243;142929;1872;0;0;0;0;.00nan;0;0
7243;143523;518;50;30;4;26;.867;3732000;0
7243;151590;1872;46;29;5;24;.828;3732000;0
7244;190258;1876;0;0;0;0;.00nan;0;0
7244;54290;517;0;0;0;0;.00nan;0;0
7244;62287;517;87;19;0;19;1.000;3600000;0
7244;152201;1876;91;40;1;39;.975;3600000;0
7245;68425;519;0;0;0;0;.00nan;0;0
7245;85749;513;0;0;0;0;.00nan;0;0
7245;143307;519;74;29;2;27;.931;3592000;0
7245;152478;513;82;26;1;25;.962;3600000;0
7246;8424;514;80;33;3;30;.909;3570000;0
7246;14047;511;0;0;0;0;.00nan;0;0
7246;86099;511;66;20;1;19;.950;3600000;0
7246;155474;514;0;0;0;0;.00nan;0;0
7247;8035;524;0;0;0;0;.00nan;0;0
7247;59614;515;0;0;0;0;.00nan;0;0
7247;143330;515;58;13;1;12;.923;3600000;0
7247;152464;524;76;45;4;41;.911;3600000;0
7248;4618;520;82;19;1;18;.947;3600000;0
7248;67764;516;0;0;0;0;.00nan;0;0
7248;84287;516;61;38;6;32;.842;3600000;0
7248;143256;520;0;0;0;0;.00nan;0;0
7249;177519;512;0;0;0;0;.00nan;0;0
7249;143083;1472;0;0;0;0;.00nan;0;0
7249;143191;512;66;28;3;25;.893;3900000;0
7249;159851;1472;68;35;3;32;.914;3900000;0
7250;4618;520;0;0;0;0;.00nan;0;0
7250;174581;518;0;0;0;0;.00nan;0;0
7250;143256;520;83;34;2;32;.941;3900000;0
7250;143523;518;86;34;2;32;.941;3900000;0
7251;8035;524;85;41;3;38;.927;3572000;0
7251;54290;517;0;0;0;0;.00nan;0;0
7251;62287;517;70;20;1;19;.950;3600000;0
7251;152464;524;0;0;0;0;.00nan;0;0
7252;8424;514;67;17;1;16;.941;3600000;0
7252;190258;1876;0;0;0;0;.00nan;0;0
7252;152201;1876;98;47;2;45;.957;3554000;0
7252;155474;514;0;0;0;0;.00nan;0;0
7253;14047;511;95;33;1;32;.970;3600000;0
7253;86099;511;0;0;0;0;.00nan;0;0
7253;142929;1872;51;39;6;33;.846;3600000;0
7253;151590;1872;0;0;0;0;.00nan;0;0
7254;67764;516;0;0;0;0;.00nan;0;0
7254;84287;516;74;33;2;31;.939;3600000;0
7254;85749;513;0;0;0;0;.00nan;0;0
7254;152478;513;60;24;3;21;.875;3548000;0
7255;177519;512;0;0;0;0;.00nan;0;0
7255;59614;515;0;0;0;0;.00nan;0;0
7255;143191;512;60;35;4;31;.886;3600000;0
7255;143330;515;92;19;0;19;1.000;3600000;0
7256;68425;519;0;0;0;0;.00nan;0;0
7256;143083;1472;80;26;1;25;.962;3600000;0
7256;143307;519;72;29;3;26;.897;3600000;0
7256;159851;1472;0;0;0;0;.00nan;0;0
7257;177519;512;0;0;0;0;.00nan;0;0
7257;54290;517;0;0;0;0;.00nan;0;0
7257;62287;517;78;41;4;37;.902;3900000;0
7257;143191;512;47;21;4;17;.810;3900000;0
7258;59614;515;0;0;0;0;.00nan;0;0
7258;85749;513;70;34;4;30;.882;3832000;0
7258;143330;515;86;37;3;34;.919;3832000;0
7258;152478;513;0;0;0;0;.00nan;0;0
7259;8424;514;100;29;0;29;1.000;3600000;0
7259;174581;518;0;0;0;0;.00nan;0;0
7259;143523;518;43;25;4;21;.840;3600000;0
7259;155474;514;0;0;0;0;.00nan;0;0
7260;190258;1876;0;0;0;0;.00nan;0;0
7260;142929;1872;0;0;0;0;.00nan;0;0
7260;151590;1872;81;25;1;24;.960;3600000;0
7260;152201;1876;85;38;2;36;.947;3600000;0
7261;14047;511;75;19;2;17;.895;3600000;0
7261;68425;519;69;44;4;40;.909;3562000;0
7261;86099;511;0;0;0;0;.00nan;0;0
7261;143307;519;0;0;0;0;.00nan;0;0
7262;4618;520;0;0;0;0;.00nan;0;0
7262;143083;1472;67;31;3;28;.903;3538000;0
7262;143256;520;79;25;1;24;.960;3600000;0
7262;159851;1472;0;0;0;0;.00nan;0;0
7263;8035;524;76;33;3;30;.909;3600000;0
7263;67764;516;0;0;0;0;.00nan;0;0
7263;84287;516;71;25;2;23;.920;3600000;0
7263;152464;524;0;0;0;0;.00nan;0;0
7264;174581;518;0;0;0;0;.00nan;0;0
7264;68425;519;0;0;0;0;.00nan;0;0
7264;143307;519;24;24;6;18;.750;3600000;0
7264;143523;518;53;25;3;22;.880;3600000;0
7265;8035;524;88;33;2;31;.939;3600000;0
7265;190258;1876;0;0;0;0;.00nan;0;0
7265;152201;1876;52;24;3;21;.875;3559000;0
7265;152464;524;0;0;0;0;.00nan;0;0
7266;177519;512;0;0;0;0;.00nan;0;0
7266;14047;511;73;29;2;27;.931;3556000;0
7266;86099;511;0;0;0;0;.00nan;0;0
7266;143191;512;100;31;0;31;1.000;3600000;0
7267;59614;515;0;0;0;0;.00nan;0;0
7267;67764;516;93;50;1;49;.980;3583000;0
7267;84287;516;0;0;0;0;.00nan;0;0
7267;143330;515;87;20;0;20;1.000;3600000;0
7268;4618;520;0;0;0;0;.00nan;0;0
7268;142929;1872;67;37;4;33;.892;3519000;0
7268;143256;520;76;30;3;27;.900;3600000;0
7268;151590;1872;0;0;0;0;.00nan;0;0
7269;85749;513;0;0;0;0;.00nan;0;0
7269;143083;1472;0;0;0;0;.00nan;0;0
7269;152478;513;62;26;2;24;.923;3581000;0
7269;159851;1472;80;22;1;21;.955;3600000;0
7270;8424;514;68;21;2;19;.905;3600000;0
7270;54290;517;62;36;4;32;.889;3588000;0
7270;62287;517;0;0;0;0;.00nan;0;0
7270;155474;514;0;0;0;0;.00nan;0;0
7271;177519;512;0;0;0;0;.00nan;0;0
7271;67764;516;0;0;0;0;.00nan;0;0
7271;84287;516;76;32;3;29;.906;3585000;0
7271;143191;512;62;18;2;16;.889;3600000;0
7272;14047;511;0;0;0;0;.00nan;0;0
7272;85749;513;87;37;2;35;.946;3900000;0
7272;86099;511;89;31;2;29;.935;3900000;0
7272;152478;513;0;0;0;0;.00nan;0;0
7273;174581;518;0;0;0;0;.00nan;0;0
7273;59614;515;0;0;0;0;.00nan;0;0
7273;143330;515;68;16;1;15;.938;3600000;0
7273;143523;518;59;42;5;37;.881;3600000;0
7274;8424;514;100;35;0;35;1.000;3600000;0
7274;142929;1872;75;42;3;39;.929;3600000;0
7274;151590;1872;0;0;0;0;.00nan;0;0
7274;155474;514;0;0;0;0;.00nan;0;0
7275;54290;517;0;0;0;0;.00nan;0;0
7275;62287;517;57;31;3;28;.903;3600000;0
7275;68425;519;84;29;2;27;.931;3600000;0
7275;143307;519;0;0;0;0;.00nan;0;0
7276;4618;520;0;0;0;0;.00nan;0;0
7276;190258;1876;0;0;0;0;.00nan;0;0
7276;143256;520;84;24;1;23;.958;3600000;0
7276;152201;1876;85;41;3;38;.927;3521000;0
7277;8035;524;0;0;0;0;.00nan;0;0
7277;143083;1472;100;29;0;29;1.000;3600000;0
7277;152464;524;58;31;4;27;.871;3600000;0
7277;159851;1472;0;0;0;0;.00nan;0;0
7278;177519;512;0;0;0;0;.00nan;0;0
7278;174581;518;0;0;0;0;.00nan;0;0
7278;143191;512;92;20;0;20;1.000;3600000;0
7278;143523;518;52;37;5;32;.865;3600000;0
7279;54290;517;0;0;0;0;.00nan;0;0
7279;62287;517;76;26;1;25;.962;3600000;0
7279;67764;516;0;0;0;0;.00nan;0;0
7279;84287;516;69;28;2;26;.929;3572000;0
7280;190258;1876;0;0;0;0;.00nan;0;0
7280;85749;513;0;0;0;0;.00nan;0;0
7280;152201;1876;72;21;1;20;.952;3600000;0
7280;152478;513;73;35;3;32;.914;3598000;0
7281;14047;511;76;35;3;32;.914;3588000;0
7281;59614;515;0;0;0;0;.00nan;0;0
7281;86099;511;0;0;0;0;.00nan;0;0
7281;143330;515;90;29;1;28;.966;3600000;0
7282;8035;524;72;31;4;27;.871;3600000;0
7282;142929;1872;0;0;0;0;.00nan;0;0
7282;151590;1872;88;20;0;20;1.000;3600000;0
7282;152464;524;0;0;0;0;.00nan;0;0
7283;4618;520;0;0;0;0;.00nan;0;0
7283;68425;519;0;0;0;0;.00nan;0;0
7283;143256;520;87;11;0;11;1.000;3600000;0
7283;143307;519;86;31;2;29;.935;3565000;0
7284;8424;514;25;6;3;3;.500;475000;0
7284;143083;1472;91;48;4;44;.917;3900000;0
7284;155474;514;55;12;1;11;.917;3421000;0
7284;159851;1472;0;0;0;0;.00nan;0;0
7285;177519;512;0;0;0;0;.00nan;0;0
7285;190258;1876;0;0;0;0;.00nan;0;0
7285;143191;512;77;23;1;22;.957;3600000;0
7285;152201;1876;64;25;3;22;.880;3518000;0
7286;54290;517;0;0;0;0;.00nan;0;0
7286;62287;517;49;23;3;20;.870;3776000;0
7286;85749;513;86;37;2;35;.946;3776000;0
7286;152478;513;0;0;0;0;.00nan;0;0
7287;14047;511;100;25;0;25;1.000;3600000;0
7287;67764;516;65;32;3;29;.906;3600000;0
7287;84287;516;0;0;0;0;.00nan;0;0
7287;86099;511;0;0;0;0;.00nan;0;0
7288;59614;515;80;28;2;26;.929;3600000;0
7288;143083;1472;38;29;6;23;.793;2676000;0
7288;143330;515;0;0;0;0;.00nan;0;0
7288;159851;1472;44;13;2;11;.846;924000;0
7289;4618;520;0;0;0;0;.00nan;0;0
7289;8424;514;64;41;5;36;.878;3542000;0
7289;143256;520;43;22;4;18;.818;3600000;0
7289;155474;514;0;0;0;0;.00nan;0;0
7290;68425;519;75;35;2;33;.943;3874000;0
7290;142929;1872;0;0;0;0;.00nan;0;0
7290;143307;519;0;0;0;0;.00nan;0;0
7290;151590;1872;97;39;2;37;.949;3900000;0
7291;8035;524;80;35;2;33;.943;3900000;0
7291;174581;518;0;0;0;0;.00nan;0;0
7291;143523;518;71;25;2;23;.920;3900000;0
7291;152464;524;0;0;0;0;.00nan;0;0
7292;174581;518;70;28;2;26;.929;3563000;0
7292;67764;516;0;0;0;0;.00nan;0;0
7292;84287;516;88;30;1;29;.967;3600000;0
7292;143523;518;0;0;0;0;.00nan;0;0
7293;54290;517;0;0;0;0;.00nan;0;0
7293;59614;515;0;0;0;0;.00nan;0;0
7293;62287;517;57;31;3;28;.903;3534000;0
7293;143330;515;87;30;1;29;.967;3600000;0
7294;190258;1876;0;0;0;0;.00nan;0;0
7294;68425;519;49;19;3;16;.842;3600000;0
7294;143307;519;0;0;0;0;.00nan;0;0
7294;152201;1876;95;43;2;41;.953;3600000;0
7295;4618;520;0;0;0;0;.00nan;0;0
7295;177519;512;0;0;0;0;.00nan;0;0
7295;143191;512;72;35;3;32;.914;3600000;0
7295;143256;520;43;20;4;16;.800;3574000;0
7296;8035;524;80;32;2;30;.938;3900000;0
7296;8424;514;74;23;2;21;.913;3900000;0
7296;152464;524;0;0;0;0;.00nan;0;0
7296;155474;514;0;0;0;0;.00nan;0;0
7297;85749;513;0;0;0;0;.00nan;0;0
7297;142929;1872;70;32;3;29;.906;3900000;0
7297;151590;1872;0;0;0;0;.00nan;0;0
7297;152478;513;58;23;3;20;.870;3900000;0
7298;14047;511;84;15;0;15;1.000;3600000;0
7298;86099;511;0;0;0;0;.00nan;0;0
7298;143083;1472;73;38;3;35;.921;3600000;0
7298;159851;1472;0;0;0;0;.00nan;0;0
7299;177519;512;0;0;0;0;.00nan;0;0
7299;142929;1872;70;38;3;35;.921;3900000;0
7299;143191;512;86;38;3;35;.921;3900000;0
7299;151590;1872;0;0;0;0;.00nan;0;0
7300;174581;518;0;0;0;0;.00nan;0;0
7300;85749;513;52;9;1;8;.889;3600000;0
7300;143523;518;67;31;4;27;.871;3600000;0
7300;152478;513;0;0;0;0;.00nan;0;0
7301;14047;511;79;27;1;26;.963;3600000;0
7301;54290;517;0;0;0;0;.00nan;0;0
7301;62287;517;59;21;2;19;.905;3600000;0
7301;86099;511;0;0;0;0;.00nan;0;0
7302;67764;516;0;0;0;0;.00nan;0;0
7302;84287;516;89;16;0;16;1.000;3600000;0
7302;143083;1472;0;0;0;0;.00nan;0;0
7302;159851;1472;75;38;3;35;.921;3600000;0
7303;190258;1876;0;0;0;0;.00nan;0;0
7303;59614;515;0;0;0;0;.00nan;0;0
7303;143330;515;78;33;2;31;.939;3600000;0
7303;152201;1876;76;47;5;42;.894;3600000;0
7304;8424;514;75;22;1;21;.955;3600000;0
7304;68425;519;58;34;5;29;.853;3600000;0
7304;143307;519;0;0;0;0;.00nan;0;0
7304;155474;514;0;0;0;0;.00nan;0;0
7305;4618;520;0;0;0;0;.00nan;0;0
7305;8035;524;56;4;0;4;1.000;817000;0
7305;143256;520;70;17;1;16;.941;3600000;0
7305;152464;524;41;44;6;38;.864;2783000;0
7306;14047;511;68;30;3;27;.900;3900000;0
7306;174581;518;0;0;0;0;.00nan;0;0
7306;86099;511;0;0;0;0;.00nan;0;0
7306;143523;518;73;37;3;34;.919;3900000;0
7307;54290;517;65;18;2;16;.889;3600000;0
7307;62287;517;0;0;0;0;.00nan;0;0
7307;143083;1472;45;33;5;28;.848;3600000;0
7307;159851;1472;0;0;0;0;.00nan;0;0
7308;190258;1876;0;0;0;0;.00nan;0;0
7308;67764;516;0;0;0;0;.00nan;0;0
7308;84287;516;78;43;4;39;.907;3600000;0
7308;152201;1876;93;29;1;28;.966;3600000;0
7309;177519;512;0;0;0;0;.00nan;0;0
7309;8424;514;78;37;4;33;.892;3900000;0
7309;143191;512;73;44;4;40;.909;3900000;0
7309;155474;514;0;0;0;0;.00nan;0;0
7310;59614;515;0;0;0;0;.00nan;0;0
7310;142929;1872;0;0;0;0;.00nan;0;0
7310;143330;515;63;35;4;31;.886;3600000;0
7310;151590;1872;83;29;1;28;.966;3600000;0
7311;4618;520;0;0;0;0;.00nan;0;0
7311;85749;513;0;0;0;0;.00nan;0;0
7311;143256;520;91;19;0;19;1.000;3600000;0
7311;152478;513;70;37;3;34;.919;3600000;0
7312;8035;524;80;29;1;28;.966;3600000;0
7312;68425;519;0;0;0;0;.00nan;0;0
7312;143307;519;54;26;3;23;.885;3571000;0
7312;152464;524;0;0;0;0;.00nan;0;0
7313;174581;518;0;0;0;0;.00nan;0;0
7313;54290;517;0;0;0;0;.00nan;0;0
7313;62287;517;54;24;2;22;.917;3588000;0
7313;143523;518;80;28;1;27;.964;3600000;0
7314;177519;512;0;0;0;0;.00nan;0;0
7314;68425;519;0;0;0;0;.00nan;0;0
7314;143191;512;81;14;0;14;1.000;3600000;0
7314;143307;519;47;34;5;29;.853;3600000;0
7315;8035;524;61;27;3;24;.889;3550000;0
7315;85749;513;0;0;0;0;.00nan;0;0
7315;152464;524;0;0;0;0;.00nan;0;0
7315;152478;513;66;17;1;16;.941;3600000;0
7316;67764;516;0;0;0;0;.00nan;0;0
7316;84287;516;82;28;1;27;.964;3600000;0
7316;142929;1872;76;30;2;28;.933;3573000;0
7316;151590;1872;0;0;0;0;.00nan;0;0
7317;8424;514;70;35;3;32;.914;3546000;0
7317;59614;515;0;0;0;0;.00nan;0;0
7317;143330;515;85;31;1;30;.968;3600000;0
7317;155474;514;0;0;0;0;.00nan;0;0
7318;4618;520;0;0;0;0;.00nan;0;0
7318;14047;511;10;25;7;18;.720;2859000;0
7318;86099;511;50;7;1;6;.857;741000;0
7318;143256;520;45;24;4;20;.833;3600000;0
7319;190258;1876;0;0;0;0;.00nan;0;0
7319;143083;1472;0;0;0;0;.00nan;0;0
7319;152201;1876;70;19;1;18;.947;3600000;0
7319;159851;1472;68;25;2;23;.920;3600000;0
7320;174581;518;0;0;0;0;.00nan;0;0
7320;143083;1472;78;42;3;39;.929;3600000;0
7320;143523;518;100;29;0;29;1.000;3600000;0
7320;159851;1472;0;0;0;0;.00nan;0;0
7321;14047;511;71;19;1;18;.947;3600000;0
7321;190258;1876;0;0;0;0;.00nan;0;0
7321;86099;511;0;0;0;0;.00nan;0;0
7321;152201;1876;62;35;5;30;.857;3600000;0
7322;8424;514;84;32;2;30;.938;3555000;0
7322;85749;513;0;0;0;0;.00nan;0;0
7322;152478;513;100;31;1;30;.968;3600000;0
7322;155474;514;0;0;0;0;.00nan;0;0
7323;54290;517;100;21;0;21;1.000;3600000;0
7323;62287;517;0;0;0;0;.00nan;0;0
7323;142929;1872;47;18;3;15;.833;3600000;0
7323;151590;1872;0;0;0;0;.00nan;0;0
7324;67764;516;0;0;0;0;.00nan;0;0
7324;68425;519;61;29;4;25;.862;3573000;0
7324;84287;516;60;29;3;26;.897;3600000;0
7324;143307;519;0;0;0;0;.00nan;0;0
7325;4618;520;0;0;0;0;.00nan;0;0
7325;59614;515;0;0;0;0;.00nan;0;0
7325;143256;520;68;27;3;24;.889;3600000;0
7325;143330;515;100;29;0;29;1.000;3600000;0
7326;177519;512;0;0;0;0;.00nan;0;0
7326;8035;524;82;38;3;35;.921;3600000;0
7326;143191;512;100;28;0;28;1.000;3600000;0
7326;152464;524;0;0;0;0;.00nan;0;0
7327;174581;518;0;0;0;0;.00nan;0;0
7327;190258;1876;0;0;0;0;.00nan;0;0
7327;143523;518;75;26;1;25;.962;3549000;0
7327;152201;1876;100;27;0;27;1.000;3600000;0
7328;4618;520;0;0;0;0;.00nan;0;0
7328;54290;517;78;29;2;27;.931;3600000;0
7328;62287;517;0;0;0;0;.00nan;0;0
7328;143256;520;35;32;6;26;.813;3600000;0
7329;177519;512;0;0;0;0;.00nan;0;0
7329;85749;513;66;26;2;24;.923;3600000;0
7329;143191;512;68;34;3;31;.912;3592000;0
7329;152478;513;0;0;0;0;.00nan;0;0
7330;8035;524;49;55;7;48;.873;3262000;0
7330;14047;511;0;0;0;0;.00nan;0;0
7330;86099;511;63;20;2;18;.900;3600000;0
7330;152464;524;53;3;0;3;1.000;338000;0
7331;8424;514;38;25;4;21;.840;3600000;0
7331;67764;516;68;9;0;9;1.000;1330000;0
7331;84287;516;34;22;5;17;.773;2215000;0
7331;155474;514;0;0;0;0;.00nan;0;0
7332;59614;515;0;0;0;0;.00nan;0;0
7332;68425;519;0;0;0;0;.00nan;0;0
7332;143307;519;85;36;2;34;.944;3600000;0
7332;143330;515;55;22;3;19;.864;3571000;0
7333;142929;1872;66;16;1;15;.938;3600000;0
7333;143083;1472;0;0;0;0;.00nan;0;0
7333;151590;1872;0;0;0;0;.00nan;0;0
7333;159851;1472;58;30;3;27;.900;3589000;0
7334;190258;1876;0;0;0;0;.00nan;0;0
7334;54290;517;61;27;3;24;.889;3571000;0
7334;62287;517;0;0;0;0;.00nan;0;0
7334;152201;1876;96;29;1;28;.966;3600000;0
7335;177519;512;73;27;2;25;.926;3900000;0
7335;143083;1472;98;36;2;34;.944;3900000;0
7335;143191;512;0;0;0;0;.00nan;0;0
7335;159851;1472;0;0;0;0;.00nan;0;0
7336;4618;520;0;0;0;0;.00nan;0;0
7336;67764;516;0;0;0;0;.00nan;0;0
7336;84287;516;100;30;0;30;1.000;3600000;0
7336;143256;520;73;41;4;37;.902;3600000;0
7337;8424;514;80;12;0;12;1.000;3600000;0
7337;14047;511;72;23;1;22;.957;3579000;0
7337;86099;511;0;0;0;0;.00nan;0;0
7337;155474;514;0;0;0;0;.00nan;0;0
7338;174581;518;0;0;0;0;.00nan;0;0
7338;142929;1872;0;0;0;0;.00nan;0;0
7338;143523;518;80;38;3;35;.921;3600000;0
7338;151590;1872;33;25;5;20;.800;3548000;0
7339;68425;519;0;0;0;0;.00nan;0;0
7339;85749;513;0;0;0;0;.00nan;0;0
7339;143307;519;84;44;2;42;.955;3900000;0
7339;152478;513;73;26;2;24;.923;3900000;0
7340;8035;524;86;64;5;59;.922;3600000;0
7340;59614;515;0;0;0;0;.00nan;0;0
7340;143330;515;65;15;1;14;.933;3600000;0
7340;152464;524;0;0;0;0;.00nan;0;0
7341;177519;512;0;0;0;0;.00nan;0;0
7341;59614;515;0;0;0;0;.00nan;0;0
7341;143191;512;92;39;2;37;.949;3788000;0
7341;143330;515;67;29;3;26;.897;3788000;0
7342;67764;516;0;0;0;0;.00nan;0;0
7342;84287;516;88;37;2;35;.946;3900000;0
7342;85749;513;69;21;2;19;.905;3900000;0
7342;152478;513;0;0;0;0;.00nan;0;0
7343;8424;514;0;0;0;0;.00nan;0;0
7343;190258;1876;0;0;0;0;.00nan;0;0
7343;152201;1876;94;40;2;38;.950;3900000;0
7343;155474;514;63;15;2;13;.867;3900000;0
7344;14047;511;85;16;0;16;1.000;3600000;0
7344;86099;511;0;0;0;0;.00nan;0;0
7344;142929;1872;82;41;2;39;.951;3564000;0
7344;151590;1872;0;0;0;0;.00nan;0;0
7345;68425;519;74;39;3;36;.923;3600000;0
7345;143083;1472;0;0;0;0;.00nan;0;0
7345;143307;519;0;0;0;0;.00nan;0;0
7345;159851;1472;56;33;4;29;.879;3554000;0
7346;4618;520;60;13;1;12;.923;3600000;0
7346;174581;518;58;17;1;16;.941;1321000;0
7346;143256;520;0;0;0;0;.00nan;0;0
7346;143523;518;37;23;5;18;.783;2279000;0
7347;8035;524;0;0;0;0;.00nan;0;0
7347;54290;517;98;23;0;23;1.000;3600000;0
7347;62287;517;0;0;0;0;.00nan;0;0
7347;152464;524;86;32;1;31;.969;3600000;0
7348;8424;514;94;20;0;20;1.000;3667000;0
7348;142929;1872;82;26;1;25;.962;3667000;0
7348;151590;1872;0;0;0;0;.00nan;0;0
7348;155474;514;0;0;0;0;.00nan;0;0
7349;8424;514;90;36;2;34;.944;3600000;0
7349;174581;518;0;0;0;0;.00nan;0;0
7349;143523;518;58;45;6;39;.867;3600000;0
7349;155474;514;0;0;0;0;.00nan;0;0
7350;177519;512;0;0;0;0;.00nan;0;0
7350;54290;517;97;30;1;29;.967;3600000;0
7350;62287;517;0;0;0;0;.00nan;0;0
7350;143191;512;79;32;2;30;.938;3599000;0
7351;190258;1876;97;39;1;38;.974;3547000;0
7351;142929;1872;100;21;0;21;1.000;3600000;0
7351;151590;1872;0;0;0;0;.00nan;0;0
7351;152201;1876;0;0;0;0;.00nan;0;0
7352;14047;511;0;0;0;0;.00nan;0;0
7352;68425;519;81;37;3;34;.919;3721000;0
7352;86099;511;74;29;2;27;.931;3721000;0
7352;143307;519;0;0;0;0;.00nan;0;0
7353;8035;524;80;33;2;31;.939;3600000;0
7353;67764;516;0;0;0;0;.00nan;0;0
7353;84287;516;57;26;4;22;.846;3527000;0
7353;152464;524;0;0;0;0;.00nan;0;0
7354;59614;515;0;0;0;0;.00nan;0;0
7354;85749;513;73;42;4;38;.905;3697000;0
7354;143330;515;57;24;3;21;.875;3697000;0
7354;152478;513;0;0;0;0;.00nan;0;0
7355;4618;520;0;0;0;0;.00nan;0;0
7355;143083;1472;72;39;3;36;.923;3900000;0
7355;143256;520;85;34;3;31;.912;3900000;0
7355;159851;1472;0;0;0;0;.00nan;0;0
7356;177519;512;0;0;0;0;.00nan;0;0
7356;14047;511;78;36;3;33;.917;3562000;0
7356;86099;511;0;0;0;0;.00nan;0;0
7356;143191;512;91;32;2;30;.938;3600000;0
7357;85749;513;0;0;0;0;.00nan;0;0
7357;143083;1472;0;0;0;0;.00nan;0;0
7357;152478;513;49;34;5;29;.853;3600000;0
7357;159851;1472;73;29;2;27;.931;3600000;0
7358;59614;515;86;36;1;35;.972;3600000;0
7358;67764;516;0;0;0;0;.00nan;0;0
7358;84287;516;56;43;6;37;.860;3600000;0
7358;143330;515;0;0;0;0;.00nan;0;0
7359;8424;514;89;17;0;17;1.000;3600000;0
7359;54290;517;70;36;3;33;.917;3600000;0
7359;62287;517;0;0;0;0;.00nan;0;0
7359;155474;514;0;0;0;0;.00nan;0;0
7360;174581;518;0;0;0;0;.00nan;0;0
7360;68425;519;0;0;0;0;.00nan;0;0
7360;143307;519;79;25;1;24;.960;3600000;0
7360;143523;518;51;27;4;23;.852;3600000;0
7361;4618;520;0;0;0;0;.00nan;0;0
7361;142929;1872;60;23;3;20;.870;3600000;0
7361;143256;520;67;24;2;22;.917;3600000;0
7361;151590;1872;0;0;0;0;.00nan;0;0
7362;8035;524;71;29;2;27;.931;3544000;0
7362;190258;1876;0;0;0;0;.00nan;0;0
7362;152201;1876;90;28;1;27;.964;3600000;0
7362;152464;524;0;0;0;0;.00nan;0;0
7363;174581;518;96;25;0;25;1.000;3600000;0
7363;59614;515;0;0;0;0;.00nan;0;0
7363;143330;515;58;24;4;20;.833;3600000;0
7363;143523;518;0;0;0;0;.00nan;0;0
7364;54290;517;40;27;5;22;.815;3600000;0
7364;62287;517;0;0;0;0;.00nan;0;0
7364;68425;519;0;0;0;0;.00nan;0;0
7364;143307;519;78;36;2;34;.944;3600000;0
7365;4618;520;61;28;3;25;.893;3588000;0
7365;190258;1876;0;0;0;0;.00nan;0;0
7365;143256;520;0;0;0;0;.00nan;0;0
7365;152201;1876;93;36;1;35;.972;3600000;0
7366;14047;511;0;0;0;0;.00nan;0;0
7366;85749;513;0;0;0;0;.00nan;0;0
7366;86099;511;79;36;3;33;.917;3600000;0
7366;152478;513;69;40;4;36;.900;3579000;0
7367;177519;512;0;0;0;0;.00nan;0;0
7367;67764;516;83;35;2;33;.943;3549000;0
7367;84287;516;0;0;0;0;.00nan;0;0
7367;143191;512;79;12;0;12;1.000;3600000;0
7368;8035;524;66;29;3;26;.897;3600000;0
7368;143083;1472;74;21;1;20;.952;3600000;0
7368;152464;524;0;0;0;0;.00nan;0;0
7368;159851;1472;0;0;0;0;.00nan;0;0
7369;177519;512;0;0;0;0;.00nan;0;0
7369;174581;518;71;34;3;31;.912;3900000;0
7369;143191;512;58;27;3;24;.889;3900000;0
7369;143523;518;0;0;0;0;.00nan;0;0
7370;190258;1876;0;0;0;0;.00nan;0;0
7370;85749;513;78;25;2;23;.920;3600000;0
7370;152201;1876;42;37;7;30;.811;3600000;0
7370;152478;513;0;0;0;0;.00nan;0;0
7371;54290;517;72;45;5;40;.889;3600000;0
7371;62287;517;0;0;0;0;.00nan;0;0
7371;67764;516;0;0;0;0;.00nan;0;0
7371;84287;516;100;33;0;33;1.000;3600000;0
7372;14047;511;100;29;0;29;1.000;3600000;0
7372;59614;515;0;0;0;0;.00nan;0;0
7372;86099;511;0;0;0;0;.00nan;0;0
7372;143330;515;72;26;2;24;.923;3528000;0
7373;8424;514;83;28;2;26;.929;3600000;0
7373;143083;1472;0;0;0;0;.00nan;0;0
7373;155474;514;0;0;0;0;.00nan;0;0
7373;159851;1472;77;41;3;38;.927;3543000;0
7374;4618;520;70;20;1;19;.950;3600000;0
7374;68425;519;64;32;4;28;.875;3600000;0
7374;143256;520;0;0;0;0;.00nan;0;0
7374;143307;519;0;0;0;0;.00nan;0;0
7375;8035;524;52;3;0;3;1.000;413000;0
7375;142929;1872;71;20;1;19;.950;3600000;0
7375;151590;1872;0;0;0;0;.00nan;0;0
7375;152464;524;57;46;7;39;.848;3187000;0
7376;8035;524;90;37;2;35;.946;3600000;0
7376;174581;518;0;0;0;0;.00nan;0;0
7376;143523;518;42;26;4;22;.846;3520000;0
7376;152464;524;0;0;0;0;.00nan;0;0
7377;54290;517;0;0;0;0;.00nan;0;0
7377;62287;517;62;23;2;21;.913;3520000;0
7377;85749;513;98;23;0;23;1.000;3600000;0
7377;152478;513;0;0;0;0;.00nan;0;0
7378;177519;512;0;0;0;0;.00nan;0;0
7378;190258;1876;0;0;0;0;.00nan;0;0
7378;143191;512;37;30;5;25;.833;3569000;0
7378;152201;1876;56;27;3;24;.889;3600000;0
7379;14047;511;66;20;2;18;.900;3600000;0
7379;67764;516;0;0;0;0;.00nan;0;0
7379;84287;516;74;45;4;41;.911;3555000;0
7379;86099;511;0;0;0;0;.00nan;0;0
7380;68425;519;0;0;0;0;.00nan;0;0
7380;142929;1872;0;0;0;0;.00nan;0;0
7380;143307;519;80;36;3;33;.917;3786000;0
7380;151590;1872;67;25;2;23;.920;3814000;0
7381;4618;520;54;29;3;26;.897;3556000;0
7381;8424;514;91;32;1;31;.969;3600000;0
7381;143256;520;0;0;0;0;.00nan;0;0
7381;155474;514;0;0;0;0;.00nan;0;0
7382;59614;515;0;0;0;0;.00nan;0;0
7382;143083;1472;27;8;3;5;.625;439000;0
7382;143330;515;70;27;2;25;.926;3600000;0
7382;159851;1472;48;24;4;20;.833;3161000;0
7383;177519;512;0;0;0;0;.00nan;0;0
7383;142929;1872;88;29;1;28;.966;3578000;0
7383;143191;512;100;31;0;31;1.000;3600000;0
7383;151590;1872;0;0;0;0;.00nan;0;0
7384;174581;518;0;0;0;0;.00nan;0;0
7384;85749;513;91;26;1;25;.962;3900000;0
7384;143523;518;97;38;1;37;.974;3900000;0
7384;152478;513;0;0;0;0;.00nan;0;0
7385;14047;511;51;26;3;23;.885;3575000;0
7385;54290;517;98;39;1;38;.974;3600000;0
7385;62287;517;0;0;0;0;.00nan;0;0
7385;86099;511;0;0;0;0;.00nan;0;0
7386;67764;516;0;0;0;0;.00nan;0;0
7386;84287;516;75;21;1;20;.952;3600000;0
7386;143083;1472;79;36;3;33;.917;3600000;0
7386;159851;1472;0;0;0;0;.00nan;0;0
7387;190258;1876;0;0;0;0;.00nan;0;0
7387;59614;515;0;0;0;0;.00nan;0;0
7387;143330;515;84;27;1;26;.963;3600000;0
7387;152201;1876;97;50;3;47;.940;3600000;0
7388;8424;514;67;31;4;27;.871;3900000;0
7388;68425;519;0;0;0;0;.00nan;0;0
7388;143307;519;70;45;4;41;.911;3900000;0
7388;155474;514;0;0;0;0;.00nan;0;0
7389;4618;520;93;17;0;17;1.000;3600000;0
7389;8035;524;98;48;2;46;.958;3536000;0
7389;143256;520;0;0;0;0;.00nan;0;0
7389;152464;524;0;0;0;0;.00nan;0;0
7390;4618;520;69;35;3;32;.914;3900000;0
7390;177519;512;0;0;0;0;.00nan;0;0
7390;143191;512;64;31;3;28;.903;3900000;0
7390;143256;520;0;0;0;0;.00nan;0;0
7391;85749;513;58;28;4;24;.857;3530000;0
7391;142929;1872;91;45;3;42;.933;3600000;0
7391;151590;1872;0;0;0;0;.00nan;0;0
7391;152478;513;0;0;0;0;.00nan;0;0
7392;14047;511;47;33;6;27;.818;3642000;0
7392;86099;511;0;0;0;0;.00nan;0;0
7392;143083;1472;48;32;5;27;.844;3642000;0
7392;159851;1472;0;0;0;0;.00nan;0;0
7393;174581;518;0;0;0;0;.00nan;0;0
7393;67764;516;0;0;0;0;.00nan;0;0
7393;84287;516;48;21;3;18;.857;3583000;0
7393;143523;518;93;55;2;53;.964;3600000;0
7394;54290;517;0;0;0;0;.00nan;0;0
7394;59614;515;0;0;0;0;.00nan;0;0
7394;62287;517;63;37;5;32;.865;3600000;0
7394;143330;515;57;16;2;14;.875;3600000;0
7395;190258;1876;0;0;0;0;.00nan;0;0
7395;68425;519;0;0;0;0;.00nan;0;0
7395;143307;519;100;33;0;33;1.000;3600000;0
7395;152201;1876;68;42;4;38;.905;3600000;0
7396;8035;524;75;33;2;31;.939;3597000;0
7396;8424;514;69;18;1;17;.944;3600000;0
7396;152464;524;0;0;0;0;.00nan;0;0
7396;155474;514;0;0;0;0;.00nan;0;0
7397;174581;518;0;0;0;0;.00nan;0;0
7397;85749;513;35;28;5;23;.821;3583000;0
7397;143523;518;70;32;4;28;.875;3600000;0
7397;152478;513;0;0;0;0;.00nan;0;0
7398;14047;511;59;30;4;26;.867;3593000;0
7398;54290;517;71;28;3;25;.893;3600000;0
7398;62287;517;0;0;0;0;.00nan;0;0
7398;86099;511;0;0;0;0;.00nan;0;0
7399;190258;1876;0;0;0;0;.00nan;0;0
7399;59614;515;0;0;0;0;.00nan;0;0
7399;143330;515;61;11;1;10;.909;3600000;0
7399;152201;1876;70;34;3;31;.912;3567000;0
7400;8424;514;65;30;3;27;.900;3900000;0
7400;68425;519;0;0;0;0;.00nan;0;0
7400;143307;519;89;40;3;37;.925;3900000;0
7400;155474;514;0;0;0;0;.00nan;0;0
7401;177519;512;0;0;0;0;.00nan;0;0
7401;142929;1872;0;0;0;0;.00nan;0;0
7401;143191;512;73;28;2;26;.929;3600000;0
7401;151590;1872;46;27;4;23;.852;3600000;0
7402;67764;516;0;0;0;0;.00nan;0;0
7402;84287;516;79;34;3;31;.912;3900000;0
7402;143083;1472;0;0;0;0;.00nan;0;0
7402;159851;1472;67;34;3;31;.912;3900000;0
7403;4618;520;77;25;2;23;.920;3600000;0
7403;8035;524;0;0;0;0;.00nan;0;0
7403;143256;520;0;0;0;0;.00nan;0;0
7403;152464;524;60;33;4;29;.879;3569000;0
7404;177519;512;68;23;2;21;.913;3600000;0
7404;8424;514;84;37;3;34;.919;3575000;0
7404;143191;512;0;0;0;0;.00nan;0;0
7404;155474;514;0;0;0;0;.00nan;0;0
7405;4618;520;87;37;3;34;.919;3900000;0
7405;85749;513;73;40;3;37;.925;3900000;0
7405;143256;520;0;0;0;0;.00nan;0;0
7405;152478;513;0;0;0;0;.00nan;0;0
7406;14047;511;59;28;3;25;.893;3867000;0
7406;174581;518;0;0;0;0;.00nan;0;0
7406;86099;511;0;0;0;0;.00nan;0;0
7406;143523;518;82;40;3;37;.925;3900000;0
7407;190258;1876;0;0;0;0;.00nan;0;0
7407;67764;516;0;0;0;0;.00nan;0;0
7407;84287;516;65;18;1;17;.944;3600000;0
7407;152201;1876;61;28;4;24;.857;3600000;0
7408;59614;515;0;0;0;0;.00nan;0;0
7408;142929;1872;78;43;4;39;.907;3575000;0
7408;143330;515;56;22;3;19;.864;3600000;0
7408;151590;1872;0;0;0;0;.00nan;0;0
7409;8035;524;69;25;2;23;.920;3600000;0
7409;68425;519;44;25;5;20;.800;3600000;0
7409;143307;519;0;0;0;0;.00nan;0;0
7409;152464;524;0;0;0;0;.00nan;0;0
7410;54290;517;79;29;1;28;.966;3600000;0
7410;62287;517;0;0;0;0;.00nan;0;0
7410;143083;1472;78;30;2;28;.933;3554000;0
7410;159851;1472;0;0;0;0;.00nan;0;0
7411;174581;518;0;0;0;0;.00nan;0;0
7411;54290;517;52;36;5;31;.861;3576000;0
7411;62287;517;0;0;0;0;.00nan;0;0
7411;143523;518;68;30;3;27;.900;3600000;0
7412;190258;1876;0;0;0;0;.00nan;0;0
7412;143083;1472;0;0;0;0;.00nan;0;0
7412;152201;1876;49;24;3;21;.875;3577000;0
7412;159851;1472;79;24;1;23;.958;3600000;0
7413;8424;514;90;37;2;35;.946;3600000;0
7413;59614;515;0;0;0;0;.00nan;0;0
7413;143330;515;59;29;3;26;.897;3600000;0
7413;155474;514;0;0;0;0;.00nan;0;0
7414;67764;516;0;0;0;0;.00nan;0;0
7414;84287;516;43;39;6;33;.846;3600000;0
7414;142929;1872;100;38;1;37;.974;3600000;0
7414;151590;1872;0;0;0;0;.00nan;0;0
7415;177519;512;0;0;0;0;.00nan;0;0
7415;68425;519;0;0;0;0;.00nan;0;0
7415;143191;512;89;19;0;19;1.000;3600000;0
7415;143307;519;98;52;2;50;.962;3577000;0
7416;4618;520;60;41;5;36;.878;3600000;0
7416;14047;511;100;24;0;24;1.000;3600000;0
7416;86099;511;0;0;0;0;.00nan;0;0
7416;143256;520;0;0;0;0;.00nan;0;0
7417;8035;524;81;26;1;25;.962;3600000;0
7417;85749;513;0;0;0;0;.00nan;0;0
7417;152464;524;0;0;0;0;.00nan;0;0
7417;152478;513;86;35;2;33;.943;3543000;0
7418;190258;517;71;30;2;28;.933;3559000;0
7418;62287;517;0;0;0;0;.00nan;0;0
7418;142929;1872;65;17;1;16;.941;3600000;0
7418;151590;1872;0;0;0;0;.00nan;0;0
7419;177519;512;0;0;0;0;.00nan;0;0
7419;8035;524;90;46;2;44;.957;3600000;0
7419;143191;512;52;22;3;19;.864;3554000;0
7419;152464;524;0;0;0;0;.00nan;0;0
7420;8424;514;77;37;3;34;.919;3529000;0
7420;85749;513;77;24;1;23;.958;3600000;0
7420;152478;513;0;0;0;0;.00nan;0;0
7420;155474;514;0;0;0;0;.00nan;0;0
7421;14047;511;58;28;3;25;.893;3600000;0
7421;86099;511;0;0;0;0;.00nan;0;0
7421;143479;1876;0;0;0;0;.00nan;0;0
7421;152201;1876;100;40;0;40;1.000;3600000;0
7422;67764;516;0;0;0;0;.00nan;0;0
7422;68425;519;55;6;0;6;1.000;344000;0
7422;84287;516;74;30;3;27;.900;3600000;0
7422;143307;519;40;30;5;25;.833;3256000;0
7423;4618;520;73;26;2;24;.923;3600000;0
7423;59614;515;0;0;0;0;.00nan;0;0
7423;143256;520;0;0;0;0;.00nan;0;0
7423;143330;515;82;39;3;36;.923;3564000;0
7424;174581;518;0;0;0;0;.00nan;0;0
7424;143083;1472;92;20;0;20;1.000;3600000;0
7424;143523;518;85;39;3;36;.923;3600000;0
7424;159851;1472;0;0;0;0;.00nan;0;0
7425;174581;518;0;0;0;0;.00nan;0;0
7425;143479;1876;0;0;0;0;.00nan;0;0
7425;143523;518;71;34;3;31;.912;3600000;0
7425;152201;1876;70;26;2;24;.923;3600000;0
7426;177519;512;0;0;0;0;.00nan;0;0
7426;85749;513;0;0;0;0;.00nan;0;0
7426;143191;512;93;34;1;33;.971;3600000;0
7426;152478;513;89;43;2;41;.953;3568000;0
7427;8424;514;79;27;2;25;.926;3600000;0
7427;67764;516;0;0;0;0;.00nan;0;0
7427;84287;516;67;34;4;30;.882;3528000;0
7427;155474;514;0;0;0;0;.00nan;0;0
7428;142929;1872;0;0;0;0;.00nan;0;0
7428;143083;1472;78;39;3;36;.923;3900000;0
7428;151590;1872;74;30;3;27;.900;3900000;0
7428;159851;1472;0;0;0;0;.00nan;0;0
7429;59614;515;0;0;0;0;.00nan;0;0
7429;68425;519;0;0;0;0;.00nan;0;0
7429;143307;519;87;37;2;35;.946;3600000;0
7429;143330;515;68;33;3;30;.909;3577000;0
7430;4618;520;0;0;0;0;.00nan;0;0
7430;190258;517;0;0;0;0;.00nan;0;0
7430;62287;517;55;21;2;19;.905;3600000;0
7430;143256;520;53;41;5;36;.878;3600000;0
7431;8035;524;0;0;0;0;.00nan;0;0
7431;14047;511;71;17;1;16;.941;3600000;0
7431;86099;511;0;0;0;0;.00nan;0;0
7431;152464;524;91;50;3;47;.940;3573000;0
7432;174581;518;0;0;0;0;.00nan;0;0
7432;142929;1872;61;15;1;14;.933;3600000;0
7432;143523;518;94;47;2;45;.957;3583000;0
7432;151590;1872;0;0;0;0;.00nan;0;0
7433;190258;517;0;0;0;0;.00nan;0;0
7433;62287;517;62;35;3;32;.914;3600000;0
7433;143479;1876;47;8;1;7;.875;482000;0
7433;152201;1876;25;25;6;19;.760;3118000;0
7434;68425;519;0;0;0;0;.00nan;0;0
7434;85749;513;0;0;0;0;.00nan;0;0
7434;143307;519;88;44;2;42;.955;3900000;0
7434;152478;513;83;32;2;30;.938;3900000;0
7435;8424;514;67;21;2;19;.905;3600000;0
7435;14047;511;0;0;0;0;.00nan;0;0
7435;86099;511;24;31;7;24;.774;3600000;0
7435;155474;514;0;0;0;0;.00nan;0;0
7436;4618;520;100;22;0;22;1.000;3600000;0
7436;67764;516;49;30;4;26;.867;3600000;0
7436;84287;516;0;0;0;0;.00nan;0;0
7436;143256;520;0;0;0;0;.00nan;0;0
7437;8035;524;66;50;6;44;.880;3600000;0
7437;59614;515;0;0;0;0;.00nan;0;0
7437;143330;515;51;14;2;12;.857;3600000;0
7437;152464;524;0;0;0;0;.00nan;0;0
7438;177519;512;0;0;0;0;.00nan;0;0
7438;143083;1472;0;0;0;0;.00nan;0;0
7438;143191;512;81;25;1;24;.960;3600000;0
7438;159851;1472;90;36;2;34;.944;3556000;0
7439;4618;520;56;24;3;21;.875;3600000;0
7439;174581;518;0;0;0;0;.00nan;0;0
7439;143256;520;0;0;0;0;.00nan;0;0
7439;143523;518;100;30;0;30;1.000;3600000;0
7440;8035;524;77;37;3;34;.919;3543000;0
7440;190258;517;83;29;2;27;.931;3600000;0
7440;62287;517;0;0;0;0;.00nan;0;0
7440;152464;524;0;0;0;0;.00nan;0;0
7441;8424;514;65;22;2;20;.909;3600000;0
7441;143479;1876;0;0;0;0;.00nan;0;0
7441;152201;1876;94;49;4;45;.918;3566000;0
7441;155474;514;0;0;0;0;.00nan;0;0
7442;14047;511;65;23;2;21;.913;3600000;0
7442;86099;511;0;0;0;0;.00nan;0;0
7442;142929;1872;64;33;3;30;.909;3585000;0
7442;151590;1872;0;0;0;0;.00nan;0;0
7443;67764;516;0;0;0;0;.00nan;0;0
7443;84287;516;60;28;3;25;.893;3600000;0
7443;85749;513;57;29;4;25;.862;3600000;0
7443;152478;513;0;0;0;0;.00nan;0;0
7444;177519;512;0;0;0;0;.00nan;0;0
7444;59614;515;0;0;0;0;.00nan;0;0
7444;143191;512;99;43;1;42;.977;3600000;0
7444;143330;515;64;22;3;19;.864;3535000;0
7445;68425;519;0;0;0;0;.00nan;0;0
7445;143083;1472;90;28;1;27;.964;3600000;0
7445;143307;519;78;30;2;28;.933;3600000;0
7445;159851;1472;0;0;0;0;.00nan;0;0
7446;177519;512;44;29;5;24;.828;3600000;0
7446;190258;517;0;0;0;0;.00nan;0;0
7446;62287;517;100;30;0;30;1.000;3600000;0
7446;143191;512;0;0;0;0;.00nan;0;0
7447;59614;515;0;0;0;0;.00nan;0;0
7447;85749;513;0;0;0;0;.00nan;0;0
7447;143330;515;86;31;2;29;.935;3600000;0
7447;152478;513;63;51;6;45;.882;3600000;0
7448;8424;514;51;32;4;28;.875;3514000;0
7448;174581;518;0;0;0;0;.00nan;0;0
7448;143523;518;100;42;2;40;.952;3600000;0
7448;155474;514;0;0;0;0;.00nan;0;0
7449;142929;1872;55;32;4;28;.875;3600000;0
7449;143479;1876;0;0;0;0;.00nan;0;0
7449;151590;1872;0;0;0;0;.00nan;0;0
7449;152201;1876;51;31;5;26;.839;3600000;0
7450;14047;511;81;33;2;31;.939;3659000;0
7450;68425;519;74;34;3;31;.912;3659000;0
7450;86099;511;0;0;0;0;.00nan;0;0
7450;143307;519;0;0;0;0;.00nan;0;0
7451;4618;520;91;33;1;32;.970;3600000;0
7451;143083;1472;0;0;0;0;.00nan;0;0
7451;143256;520;0;0;0;0;.00nan;0;0
7451;159851;1472;53;24;3;21;.875;3550000;0
7452;8035;524;0;0;0;0;.00nan;0;0
7452;67764;516;0;0;0;0;.00nan;0;0
7452;84287;516;68;18;1;17;.944;3600000;0
7452;152464;524;68;42;4;38;.905;3600000;0
7453;174581;518;0;0;0;0;.00nan;0;0
7453;68425;519;0;0;0;0;.00nan;0;0
7453;143307;519;36;38;7;31;.816;3600000;0
7453;143523;518;84;26;1;25;.962;3600000;0
7454;8424;514;58;19;2;17;.895;3600000;0
7454;190258;517;52;3;0;3;1.000;311000;0
7454;62287;517;38;32;6;26;.813;3289000;0
7454;155474;514;0;0;0;0;.00nan;0;0
7455;8035;524;27;30;6;24;.800;2755000;0
7455;143479;1876;0;0;0;0;.00nan;0;0
7455;152201;1876;100;36;0;36;1.000;3600000;0
7455;152464;524;61;10;0;10;1.000;845000;0
7456;177519;512;0;0;0;0;.00nan;0;0
7456;14047;511;48;15;2;13;.867;3900000;0
7456;86099;511;0;0;0;0;.00nan;0;0
7456;143191;512;100;51;2;49;.961;3900000;0
7457;59614;515;0;0;0;0;.00nan;0;0
7457;67764;516;0;0;0;0;.00nan;0;0
7457;84287;516;81;33;2;31;.939;3656000;0
7457;143330;515;61;20;3;17;.850;3656000;0
7458;4618;520;50;23;3;20;.870;3545000;0
7458;142929;1872;79;32;2;30;.938;3600000;0
7458;143256;520;0;0;0;0;.00nan;0;0
7458;151590;1872;0;0;0;0;.00nan;0;0
7459;85749;513;62;29;3;26;.897;3600000;0
7459;143083;1472;66;23;2;21;.913;3600000;0
7459;152478;513;0;0;0;0;.00nan;0;0
7459;159851;1472;0;0;0;0;.00nan;0;0
7460;177519;512;0;0;0;0;.00nan;0;0
7460;67764;516;0;0;0;0;.00nan;0;0
7460;84287;516;61;36;5;31;.861;3600000;0
7460;143191;512;90;28;1;27;.964;3600000;0
7461;14047;511;57;32;4;28;.875;3600000;0
7461;85749;513;0;0;0;0;.00nan;0;0
7461;86099;511;0;0;0;0;.00nan;0;0
7461;152478;513;84;26;1;25;.962;3600000;0
7462;174581;518;0;0;0;0;.00nan;0;0
7462;59614;515;48;24;4;20;.833;3541000;0
7462;143330;515;0;0;0;0;.00nan;0;0
7462;143523;518;65;29;3;26;.897;3600000;0
7463;8424;514;70;23;2;21;.913;3900000;0
7463;142929;1872;78;31;2;29;.935;3900000;0
7463;151590;1872;0;0;0;0;.00nan;0;0
7463;155474;514;0;0;0;0;.00nan;0;0
7464;190258;517;0;0;0;0;.00nan;0;0
7464;62287;517;74;30;2;28;.933;3890000;0
7464;68425;519;0;0;0;0;.00nan;0;0
7464;143307;519;66;31;3;28;.903;3890000;0
7465;4618;520;0;0;0;0;.00nan;0;0
7465;143256;520;33;26;5;21;.808;3600000;0
7465;143479;1876;47;8;1;7;.875;403000;0
7465;152201;1876;20;25;6;19;.760;3166000;0
7466;8035;524;65;26;2;24;.923;3831000;0
7466;143083;1472;100;37;1;36;.973;3831000;0
7466;152464;524;0;0;0;0;.00nan;0;0
7466;159851;1472;0;0;0;0;.00nan;0;0
7467;177519;512;0;0;0;0;.00nan;0;0
7467;174581;518;0;0;0;0;.00nan;0;0
7467;143191;512;51;29;4;25;.862;3573000;0
7467;143523;518;67;30;3;27;.900;3600000;0
7468;190258;517;0;0;0;0;.00nan;0;0
7468;62287;517;71;35;3;32;.914;3828000;0
7468;67764;516;0;0;0;0;.00nan;0;0
7468;84287;516;75;28;2;26;.929;3828000;0
7469;85749;513;42;30;5;25;.833;3600000;0
7469;143479;1876;0;0;0;0;.00nan;0;0
7469;152201;1876;98;46;2;44;.957;3600000;0
7469;152478;513;0;0;0;0;.00nan;0;0
7470;14047;511;0;0;0;0;.00nan;0;0
7470;59614;515;0;0;0;0;.00nan;0;0
7470;86099;511;91;46;2;44;.957;3600000;0
7470;143330;515;58;25;3;22;.880;3580000;0
7471;8035;524;63;39;5;34;.872;3583000;0
7471;142929;1872;0;0;0;0;.00nan;0;0
7471;151590;1872;54;21;3;18;.857;3600000;0
7471;152464;524;0;0;0;0;.00nan;0;0
7472;4618;520;0;0;0;0;.00nan;0;0
7472;68425;519;0;0;0;0;.00nan;0;0
7472;143256;520;39;31;5;26;.839;3600000;0
7472;143307;519;81;30;1;29;.967;3600000;0
7473;143083;1472;0;0;0;0;.00nan;0;0
7473;155465;514;0;0;0;0;.00nan;0;0
7473;155474;514;73;39;4;35;.897;3568000;0
7473;159851;1472;63;33;3;30;.909;3600000;0
7474;177519;512;0;0;0;0;.00nan;0;0
7474;143191;512;52;19;3;16;.842;3600000;0
7474;143479;1876;0;0;0;0;.00nan;0;0
7474;152201;1876;74;21;1;20;.952;3600000;0
7475;190258;517;0;0;0;0;.00nan;0;0
7475;62287;517;69;29;3;26;.897;3515000;0
7475;85749;513;0;0;0;0;.00nan;0;0
7475;152478;513;95;40;1;39;.975;3600000;0
7476;14047;511;57;31;5;26;.839;3519000;0
7476;67764;516;43;18;3;15;.833;3600000;0
7476;84287;516;0;0;0;0;.00nan;0;0
7476;86099;511;0;0;0;0;.00nan;0;0
7477;59614;515;0;0;0;0;.00nan;0;0
7477;143083;1472;97;47;2;45;.957;3600000;0
7477;143330;515;87;29;1;28;.966;3600000;0
7477;159851;1472;0;0;0;0;.00nan;0;0
7478;4618;520;0;0;0;0;.00nan;0;0
7478;8424;514;74;23;2;21;.913;3900000;0
7478;143256;520;79;34;2;32;.941;3900000;0
7478;155474;514;0;0;0;0;.00nan;0;0
7479;68425;519;70;29;2;27;.931;3600000;0
7479;142929;1872;44;30;5;25;.833;3600000;0
7479;143307;519;0;0;0;0;.00nan;0;0
7479;151590;1872;0;0;0;0;.00nan;0;0
7480;8035;524;0;0;0;0;.00nan;0;0
7480;174581;518;0;0;0;0;.00nan;0;0
7480;143523;518;40;29;5;24;.828;3600000;0
7480;152464;524;73;21;1;20;.952;3600000;0
7481;174581;518;86;35;2;33;.943;3600000;0
7481;67764;516;0;0;0;0;.00nan;0;0
7481;84287;516;67;33;3;30;.909;3550000;0
7481;143523;518;0;0;0;0;.00nan;0;0
7482;190258;517;57;34;4;30;.882;3600000;0
7482;59614;515;0;0;0;0;.00nan;0;0
7482;62287;517;0;0;0;0;.00nan;0;0
7482;143330;515;100;27;0;27;1.000;3600000;0
7483;68425;519;0;0;0;0;.00nan;0;0
7483;143307;519;72;22;1;21;.955;3600000;0
7483;143479;1876;58;32;4;28;.875;3600000;0
7483;152201;1876;0;0;0;0;.00nan;0;0
7484;8035;524;98;53;2;51;.962;3900000;0
7484;8424;514;60;17;2;15;.882;3900000;0
7484;152464;524;0;0;0;0;.00nan;0;0
7484;155474;514;0;0;0;0;.00nan;0;0
7485;85749;513;70;24;2;22;.917;3816000;0
7485;142929;1872;72;32;3;29;.906;3816000;0
7485;151590;1872;0;0;0;0;.00nan;0;0
7485;152478;513;0;0;0;0;.00nan;0;0
7486;4618;520;80;33;3;30;.909;3114000;0
7486;177519;512;0;0;0;0;.00nan;0;0
7486;143191;512;57;31;5;26;.839;3600000;0
7486;143256;520;21;3;3;0;.000;432000;0
7487;14047;511;81;28;2;26;.929;3600000;0
7487;86099;511;0;0;0;0;.00nan;0;0
7487;143083;1472;58;37;5;32;.865;3350000;0
7487;159851;1472;50;1;0;1;1.000;250000;0
7488;14047;511;55;26;4;22;.846;3600000;0
7488;174581;518;0;0;0;0;.00nan;0;0
7488;86099;511;0;0;0;0;.00nan;0;0
7488;143523;518;55;38;5;33;.868;3600000;0
7489;190258;517;0;0;0;0;.00nan;0;0
7489;62287;517;56;24;3;21;.875;3600000;0
7489;143083;1472;45;32;5;27;.844;3513000;0
7489;159851;1472;0;0;0;0;.00nan;0;0
7490;67764;516;60;23;2;21;.913;2433000;0
7490;84287;516;33;17;4;13;.765;1167000;0
7490;143479;1876;0;0;0;0;.00nan;0;0
7490;152201;1876;100;30;0;30;1.000;3600000;0
7491;177519;512;0;0;0;0;.00nan;0;0
7491;8424;514;78;23;1;22;.957;3600000;0
7491;143191;512;89;32;2;30;.938;3600000;0
7491;155474;514;0;0;0;0;.00nan;0;0
7492;59614;515;0;0;0;0;.00nan;0;0
7492;142929;1872;91;38;2;36;.947;3600000;0
7492;143330;515;62;35;4;31;.886;3552000;0
7492;151590;1872;0;0;0;0;.00nan;0;0
7493;4618;520;0;0;0;0;.00nan;0;0
7493;85749;513;0;0;0;0;.00nan;0;0
7493;143256;520;79;32;2;30;.938;3600000;0
7493;152478;513;81;39;3;36;.923;3572000;0
7494;8035;524;66;39;4;35;.897;3900000;0
7494;68425;519;0;0;0;0;.00nan;0;0
7494;143307;519;66;40;4;36;.900;3900000;0
7494;152464;524;0;0;0;0;.00nan;0;0
7495;174581;518;0;0;0;0;.00nan;0;0
7495;190258;517;92;22;0;22;1.000;3600000;0
7495;62287;517;0;0;0;0;.00nan;0;0
7495;143523;518;95;47;3;44;.936;3600000;0
7496;177519;512;0;0;0;0;.00nan;0;0
7496;68425;519;46;32;5;27;.844;3600000;0
7496;143191;512;60;21;2;19;.905;3600000;0
7496;143307;519;0;0;0;0;.00nan;0;0
7497;8035;524;62;34;4;30;.882;3600000;0
7497;85749;513;89;19;0;19;1.000;3600000;0
7497;152464;524;0;0;0;0;.00nan;0;0
7497;152478;513;0;0;0;0;.00nan;0;0
7498;4618;520;24;33;6;27;.818;3600000;0
7498;14047;511;71;25;2;23;.920;3600000;0
7498;86099;511;0;0;0;0;.00nan;0;0
7498;143256;520;0;0;0;0;.00nan;0;0
7499;67764;516;0;0;0;0;.00nan;0;0
7499;84287;516;73;25;2;23;.920;3600000;0
7499;142929;1872;54;29;4;25;.862;3570000;0
7499;151590;1872;0;0;0;0;.00nan;0;0
7500;8424;514;70;24;2;22;.917;3600000;0
7500;59614;515;0;0;0;0;.00nan;0;0
7500;143330;515;51;25;4;21;.840;3588000;0
7500;155474;514;0;0;0;0;.00nan;0;0
7501;143083;1472;0;0;0;0;.00nan;0;0
7501;143479;1876;0;0;0;0;.00nan;0;0
7501;152201;1876;53;30;4;26;.867;3600000;0
7501;159851;1472;15;29;7;22;.759;3600000;0
7502;174581;518;0;0;0;0;.00nan;0;0
7502;143083;1472;0;0;0;0;.00nan;0;0
7502;143523;518;70;29;3;26;.897;3900000;0
7502;159851;1472;55;27;3;24;.889;3900000;0
7503;14047;511;90;19;0;19;1.000;3600000;0
7503;86099;511;0;0;0;0;.00nan;0;0
7503;143479;1876;75;39;3;36;.923;3600000;0
7503;155465;1876;0;0;0;0;.00nan;0;0
7504;8424;514;74;30;2;28;.933;3600000;0
7504;85749;513;0;0;0;0;.00nan;0;0
7504;152201;514;0;0;0;0;.00nan;0;0
7504;152478;513;72;35;3;32;.914;3584000;0
7505;190258;517;57;28;3;25;.893;3588000;0
7505;62287;517;0;0;0;0;.00nan;0;0
7505;142929;1872;0;0;0;0;.00nan;0;0
7505;151590;1872;59;26;2;24;.923;3600000;0
7506;67764;516;0;0;0;0;.00nan;0;0
7506;68425;519;0;0;0;0;.00nan;0;0
7506;84287;516;80;39;2;37;.949;3600000;0
7506;143307;519;47;30;4;26;.867;3522000;0
7507;4618;520;57;22;2;20;.909;3559000;0
7507;59614;515;0;0;0;0;.00nan;0;0
7507;143256;520;0;0;0;0;.00nan;0;0
7507;143330;515;100;37;1;36;.973;3600000;0
7508;177519;512;0;0;0;0;.00nan;0;0
7508;8035;524;66;22;2;20;.909;2007000;0
7508;143191;512;63;13;1;12;.923;3600000;0
7508;152464;524;7;19;6;13;.684;1593000;0
7509;174581;518;0;0;0;0;.00nan;0;0
7509;143479;1876;50;28;4;24;.857;3600000;0
7509;143523;518;82;23;1;22;.957;3600000;0
7509;155465;1876;0;0;0;0;.00nan;0;0
7510;4618;520;93;34;2;32;.941;3600000;0
7510;190258;517;0;0;0;0;.00nan;0;0
7510;62287;517;51;19;3;16;.842;3545000;0
7510;143256;520;0;0;0;0;.00nan;0;0
7511;177519;512;0;0;0;0;.00nan;0;0
7511;85749;513;80;28;1;27;.964;3600000;0
7511;143191;512;64;22;2;20;.909;3579000;0
7511;152478;513;0;0;0;0;.00nan;0;0
7512;8035;524;55;41;5;36;.878;3600000;0
7512;14047;511;57;15;2;13;.867;3600000;0
7512;86099;511;0;0;0;0;.00nan;0;0
7512;152464;524;0;0;0;0;.00nan;0;0
7513;8424;514;58;18;2;16;.889;3600000;0
7513;67764;516;91;44;4;40;.909;3538000;0
7513;84287;516;0;0;0;0;.00nan;0;0
7513;152201;514;0;0;0;0;.00nan;0;0
7514;59614;515;0;0;0;0;.00nan;0;0
7514;68425;519;0;0;0;0;.00nan;0;0
7514;143307;519;92;29;1;28;.966;3546000;0
7514;143330;515;78;14;0;14;1.000;3600000;0
7515;142929;1872;59;28;3;25;.893;3900000;0
7515;143083;1472;63;24;3;21;.875;3900000;0
7515;151590;1872;0;0;0;0;.00nan;0;0
7515;159851;1472;0;0;0;0;.00nan;0;0
7516;190258;517;88;16;0;16;1.000;3600000;0
7516;62287;517;0;0;0;0;.00nan;0;0
7516;143479;1876;0;0;0;0;.00nan;0;0
7516;155465;1876;78;29;2;27;.931;3600000;0
7517;177519;512;0;0;0;0;.00nan;0;0
7517;143083;1472;61;21;2;19;.905;3600000;0
7517;143191;512;61;36;5;31;.861;3600000;0
7517;159851;1472;0;0;0;0;.00nan;0;0
7518;8424;514;60;30;3;27;.900;3530000;0
7518;14047;511;78;27;1;26;.963;3600000;0
7518;86099;511;0;0;0;0;.00nan;0;0
7518;152201;514;0;0;0;0;.00nan;0;0
7519;174581;518;0;0;0;0;.00nan;0;0
7519;142929;1872;83;26;1;25;.962;3600000;0
7519;143523;518;98;42;2;40;.952;3564000;0
7519;151590;1872;0;0;0;0;.00nan;0;0
7520;68425;519;42;26;5;21;.808;3600000;0
7520;85749;513;0;0;0;0;.00nan;0;0
7520;143307;519;0;0;0;0;.00nan;0;0
7520;152478;513;100;39;2;37;.949;3600000;0
7521;4618;520;0;0;0;0;.00nan;0;0
7521;67764;516;0;0;0;0;.00nan;0;0
7521;84287;516;91;44;2;42;.955;3600000;0
7521;143256;520;67;30;3;27;.900;3599000;0
7522;8035;524;54;38;5;33;.868;3584000;0
7522;59614;515;0;0;0;0;.00nan;0;0
7522;143330;515;53;19;3;16;.842;3600000;0
7522;152464;524;0;0;0;0;.00nan;0;0
7524;177519;512;68;30;3;27;.900;3600000;0
7524;7332;512;0;0;0;0;.00nan;0;0
7524;89998;515;0;0;0;0;.00nan;0;0
7524;143330;515;82;25;2;23;.920;3600000;0
7526;68425;519;49;1;0;1;1.000;286000;0
7526;143083;1472;0;0;0;0;.00nan;0;0
7526;143307;519;35;35;6;29;.829;3314000;0
7526;159851;1472;71;16;1;15;.938;3600000;0
7528;1072;514;0;0;0;0;.00nan;0;0
7528;4618;520;86;40;3;37;.925;3900000;0
7528;143256;520;0;0;0;0;.00nan;0;0
7528;155474;514;56;24;3;21;.875;3900000;0
7530;14047;511;0;0;0;0;.00nan;0;0
7530;86099;511;68;20;1;19;.950;3845000;0
7530;152478;513;82;33;2;31;.939;3845000;0
7530;152494;513;0;0;0;0;.00nan;0;0
7532;8035;524;95;37;1;36;.973;3600000;0
7532;174581;518;0;0;0;0;.00nan;0;0
7532;143523;518;50;15;2;13;.867;3563000;0
7532;152464;524;0;0;0;0;.00nan;0;0
7534;190258;1876;0;0;0;0;.00nan;0;0
7534;84287;516;0;0;0;0;.00nan;0;0
7534;143191;516;80;21;1;20;.952;3600000;0
7534;152201;1876;64;36;4;32;.889;3570000;0
7536;54290;517;0;0;0;0;.00nan;0;0
7536;62287;517;100;28;0;28;1.000;3600000;0
7536;142929;1872;65;30;3;27;.900;3600000;0
7536;151590;1872;0;0;0;0;.00nan;0;0
7542;1072;514;89;26;1;25;.962;3600000;0
7542;4618;520;82;37;2;35;.946;3558000;0
7542;143256;520;0;0;0;0;.00nan;0;0
7542;155474;514;0;0;0;0;.00nan;0;0
7544;142929;1872;0;0;0;0;.00nan;0;0
7544;151590;1872;43;30;4;26;.867;3567000;0
7544;152478;513;68;26;2;24;.923;3600000;0
7544;152494;513;0;0;0;0;.00nan;0;0
7548;174581;518;0;0;0;0;.00nan;0;0
7548;68425;519;0;0;0;0;.00nan;0;0
7548;143307;519;32;22;5;17;.773;3600000;0
7548;143523;518;95;38;1;37;.974;3600000;0
7550;8035;524;53;31;4;27;.871;3900000;0
7550;143083;1472;42;21;4;17;.810;3900000;0
7550;152464;524;0;0;0;0;.00nan;0;0
7550;159851;1472;0;0;0;0;.00nan;0;0
7552;8035;524;0;0;0;0;.00nan;0;0
7552;152464;524;67;38;5;33;.868;3768000;0
7552;152478;513;0;0;0;0;.00nan;0;0
7552;152494;513;48;23;4;19;.826;3768000;0
7554;190258;1876;67;24;2;22;.917;3600000;0
7554;54290;517;0;0;0;0;.00nan;0;0
7554;62287;517;56;28;4;24;.857;3576000;0
7554;152201;1876;0;0;0;0;.00nan;0;0
7562;68425;519;79;29;1;28;.966;3585000;0
7562;142929;1872;95;21;0;21;1.000;3600000;0
7562;143307;519;0;0;0;0;.00nan;0;0
7562;151590;1872;0;0;0;0;.00nan;0;0
7564;174581;518;55;30;3;27;.900;3541000;0
7564;143083;1472;0;0;0;0;.00nan;0;0
7564;143523;518;0;0;0;0;.00nan;0;0
7564;159851;1472;70;25;2;23;.920;3600000;0
7566;8035;524;71;45;4;41;.911;3600000;0
7566;84287;516;0;0;0;0;.00nan;0;0
7566;143191;516;69;22;1;21;.955;3600000;0
7566;152464;524;0;0;0;0;.00nan;0;0
7568;1072;514;54;20;2;18;.900;3525000;0
7568;142929;1872;100;30;0;30;1.000;3600000;0
7568;151590;1872;0;0;0;0;.00nan;0;0
7568;155474;514;0;0;0;0;.00nan;0;0
7570;190258;1876;0;0;0;0;.00nan;0;0
7570;152201;1876;83;52;4;48;.923;3600000;0
7570;152478;513;56;39;5;34;.872;3526000;0
7570;152494;513;0;0;0;0;.00nan;0;0
7574;68425;519;73;11;0;11;1.000;1268000;0
7574;143083;1472;0;0;0;0;.00nan;0;0
7574;143307;519;19;24;6;18;.750;2332000;0
7574;159851;1472;100;38;1;37;.974;3600000;0
7582;54290;517;0;0;0;0;.00nan;0;0
7582;62287;517;36;21;4;17;.810;3542000;0
7582;68425;519;0;0;0;0;.00nan;0;0
7582;143307;519;85;34;2;32;.941;3600000;0
7584;8035;524;0;0;0;0;.00nan;0;0
7584;84287;516;100;33;0;33;1.000;3600000;0
7584;143191;516;0;0;0;0;.00nan;0;0
7584;152464;524;68;29;2;27;.931;3520000;0
7586;190258;1876;82;29;1;28;.966;3600000;0
7586;142929;1872;66;24;3;21;.875;3538000;0
7586;151590;1872;0;0;0;0;.00nan;0;0
7586;152201;1876;0;0;0;0;.00nan;0;0
7590;174581;518;0;0;0;0;.00nan;0;0
7590;143083;1472;68;28;2;26;.929;3900000;0
7590;143523;518;67;19;2;17;.895;3900000;0
7590;159851;1472;0;0;0;0;.00nan;0;0
7596;68425;519;78;23;1;22;.957;3549000;0
7596;84287;516;96;22;0;22;1.000;3600000;0
7596;143191;516;0;0;0;0;.00nan;0;0
7596;143307;519;0;0;0;0;.00nan;0;0
7598;190258;1876;0;0;0;0;.00nan;0;0
7598;152201;1876;100;50;0;50;1.000;3600000;0
7598;152478;513;68;35;3;32;.914;3600000;0
7598;152494;513;0;0;0;0;.00nan;0;0
7600;8035;524;84;52;5;47;.904;3600000;0
7600;174581;518;0;0;0;0;.00nan;0;0
7600;143523;518;74;22;1;21;.955;3600000;0
7600;152464;524;0;0;0;0;.00nan;0;0
7604;142929;1872;0;0;0;0;.00nan;0;0
7604;143083;1472;0;0;0;0;.00nan;0;0
7604;151590;1872;74;28;2;26;.929;3600000;0
7604;159851;1472;52;28;3;25;.893;3544000;0
7606;1072;514;0;0;0;0;.00nan;0;0
7606;54290;517;93;34;1;33;.971;3600000;0
7606;62287;517;0;0;0;0;.00nan;0;0
7606;155474;514;72;23;2;21;.913;3565000;0
7610;1072;514;76;21;1;20;.952;3600000;0
7610;8035;524;0;0;0;0;.00nan;0;0
7610;152464;524;57;46;6;40;.870;3600000;0
7610;155474;514;0;0;0;0;.00nan;0;0
7612;190258;1876;71;34;3;31;.912;3571000;0
7612;142929;1872;59;19;2;17;.895;3600000;0
7612;151590;1872;0;0;0;0;.00nan;0;0
7612;152201;1876;0;0;0;0;.00nan;0;0
7614;174581;518;75;25;1;24;.960;3600000;0
7614;143083;1472;73;27;2;25;.926;3600000;0
7614;143523;518;0;0;0;0;.00nan;0;0
7614;159851;1472;0;0;0;0;.00nan;0;0
7616;4618;520;55;32;5;27;.844;3594000;0
7616;143256;520;0;0;0;0;.00nan;0;0
7616;152478;513;58;25;3;22;.880;3600000;0
7616;152494;513;0;0;0;0;.00nan;0;0
7620;54290;517;0;0;0;0;.00nan;0;0
7620;62287;517;87;15;0;15;1.000;3600000;0
7620;68425;519;0;0;0;0;.00nan;0;0
7620;143307;519;98;46;1;45;.978;3548000;0
7621;1838;628;87;36;2;34;.944;3600000;0
7621;162945;631;0;0;0;0;.00nan;0;0
7621;144705;631;51;27;4;23;.852;3514000;0
7621;161336;628;0;0;0;0;.00nan;0;0
7622;168651;651;0;0;0;0;.00nan;0;0
7622;22684;632;49;27;5;22;.815;3600000;0
7622;195761;651;91;31;1;30;.968;3600000;0
7622;-1;632;0;0;0;0;.00nan;0;0
7623;17625;626;0;0;0;0;.00nan;0;0
7623;190508;626;64;16;1;15;.938;3600000;0
7623;186641;1813;74;33;3;30;.909;3575000;0
7623;-1;1813;0;0;0;0;.00nan;0;0
7624;177631;637;0;0;0;0;.00nan;0;0
7624;-1;639;0;0;0;0;.00nan;0;0
7624;73274;637;55;19;2;17;.895;3600000;0
7624;149969;639;62;41;5;36;.878;3600000;0
7625;11068;641;91;33;2;31;.939;3900000;0
7625;-1;641;0;0;0;0;.00nan;0;0
7625;145079;642;0;0;0;0;.00nan;0;0
7625;151728;642;81;34;2;32;.941;3900000;0
7626;11851;625;76;25;1;24;.960;3600000;0
7626;181431;636;0;0;0;0;.00nan;0;0
7626;38277;636;55;31;4;27;.871;3600000;0
7626;61683;625;0;0;0;0;.00nan;0;0
7627;43064;627;99;44;1;43;.977;3600000;0
7627;67362;1814;59;21;2;19;.905;3544000;0
7627;152851;627;0;0;0;0;.00nan;0;0
7627;156632;1814;0;0;0;0;.00nan;0;0
7628;1838;628;78;32;2;30;.938;3600000;0
7628;181431;636;50;22;3;19;.864;3600000;0
7628;38277;636;0;0;0;0;.00nan;0;0
7628;161336;628;0;0;0;0;.00nan;0;0
7629;177631;637;0;0;0;0;.00nan;0;0
7629;186641;1813;58;29;3;26;.897;3600000;0
7629;-1;1813;0;0;0;0;.00nan;0;0
7629;73274;637;64;16;1;15;.938;3600000;0
7630;-1;639;0;0;0;0;.00nan;0;0
7630;67362;1814;69;32;4;28;.875;3554000;0
7630;149969;639;93;47;3;44;.936;3600000;0
7630;156632;1814;0;0;0;0;.00nan;0;0
7631;162945;631;56;24;3;21;.875;3600000;0
7631;168651;651;54;41;5;36;.878;3587000;0
7631;195761;651;0;0;0;0;.00nan;0;0
7631;144705;631;0;0;0;0;.00nan;0;0
7632;11851;625;52;19;2;17;.895;3557000;0
7632;17625;626;0;0;0;0;.00nan;0;0
7632;190508;626;85;30;1;29;.967;3600000;0
7632;61683;625;0;0;0;0;.00nan;0;0
7633;22684;632;48;28;4;24;.857;3600000;0
7633;-1;632;0;0;0;0;.00nan;0;0
7633;145079;642;0;0;0;0;.00nan;0;0
7633;151728;642;91;30;1;29;.967;3600000;0
7634;11068;641;22;13;4;9;.692;1047000;0
7634;-1;641;35;20;4;16;.800;2553000;0
7634;43064;627;62;23;2;21;.913;3600000;0
7634;152851;627;0;0;0;0;.00nan;0;0
7635;186641;1813;65;37;4;33;.892;3600000;0
7635;-1;1813;0;0;0;0;.00nan;0;0
7635;67362;1814;57;26;3;23;.885;3600000;0
7635;156632;1814;0;0;0;0;.00nan;0;0
7636;17625;626;0;0;0;0;.00nan;0;0
7636;190508;626;81;43;4;39;.907;3600000;0
7636;181431;636;0;0;0;0;.00nan;0;0
7636;38277;636;46;15;3;12;.800;3600000;0
7637;177631;637;0;0;0;0;.00nan;0;0
7637;168651;651;37;36;6;30;.833;3600000;0
7637;195761;651;0;0;0;0;.00nan;0;0
7637;73274;637;91;20;0;20;1.000;3600000;0
7638;11851;625;73;27;2;25;.926;3514000;0
7638;22684;632;95;26;0;26;1.000;3600000;0
7638;-1;632;0;0;0;0;.00nan;0;0
7638;61683;625;0;0;0;0;.00nan;0;0
7639;-1;639;54;37;5;32;.865;3600000;0
7639;43064;627;76;23;1;22;.957;3600000;0
7639;85468;627;0;0;0;0;.00nan;0;0
7639;149969;639;0;0;0;0;.00nan;0;0
7640;1838;628;50;1;0;1;1.000;326000;0
7640;145079;642;0;0;0;0;.00nan;0;0
7640;151728;642;53;34;5;29;.853;3600000;0
7640;161336;628;27;25;6;19;.760;3235000;0
7641;162945;631;49;21;3;18;.857;3600000;0
7641;11068;641;0;0;0;0;.00nan;0;0
7641;-1;641;66;45;5;40;.889;3528000;0
7641;144705;631;0;0;0;0;.00nan;0;0
7642;168651;651;80;30;2;28;.933;3600000;0
7642;195761;651;0;0;0;0;.00nan;0;0
7642;181431;636;53;24;3;21;.875;3594000;0
7642;38277;636;0;0;0;0;.00nan;0;0
7643;177631;637;0;0;0;0;.00nan;0;0
7643;11068;641;64;32;4;28;.875;3538000;0
7643;-1;641;0;0;0;0;.00nan;0;0
7643;73274;637;62;22;2;20;.909;3600000;0
7644;1838;628;26;6;3;3;.500;498000;0
7644;67362;1814;0;0;0;0;.00nan;0;0
7644;156632;1814;77;28;2;26;.929;3600000;0
7644;161336;628;66;42;5;37;.881;3102000;0
7645;17625;626;91;40;3;37;.925;3900000;0
7645;22684;632;61;28;3;25;.893;3900000;0
7645;-1;632;0;0;0;0;.00nan;0;0
7645;190508;626;0;0;0;0;.00nan;0;0
7646;162945;631;67;21;1;20;.952;3600000;0
7646;144705;631;0;0;0;0;.00nan;0;0
7646;145079;642;61;35;4;31;.886;3600000;0
7646;151728;642;0;0;0;0;.00nan;0;0
7647;11851;625;50;20;3;17;.850;3600000;0
7647;-1;639;0;0;0;0;.00nan;0;0
7647;61683;625;0;0;0;0;.00nan;0;0
7647;149969;639;72;42;4;38;.905;3569000;0
7648;186641;1813;71;36;4;32;.889;3600000;0
7648;-1;1813;0;0;0;0;.00nan;0;0
7648;43064;627;73;20;1;19;.950;3600000;0
7648;85468;627;0;0;0;0;.00nan;0;0
7649;181431;636;92;35;1;34;.971;3600000;0
7649;38277;636;0;0;0;0;.00nan;0;0
7649;186641;1813;59;30;3;27;.900;3514000;0
7649;-1;1813;0;0;0;0;.00nan;0;0
7650;17625;626;0;0;0;0;.00nan;0;0
7650;190508;626;59;21;2;19;.905;3600000;0
7650;145079;642;0;0;0;0;.00nan;0;0
7650;151728;642;74;34;3;31;.912;3600000;0
7651;162945;631;0;0;0;0;.00nan;0;0
7651;177631;637;0;0;0;0;.00nan;0;0
7651;73274;637;86;27;1;26;.963;3600000;0
7651;144705;631;45;20;3;17;.850;3536000;0
7652;22684;632;82;37;3;34;.919;3622000;0
7652;-1;639;0;0;0;0;.00nan;0;0
7652;-1;632;0;0;0;0;.00nan;0;0
7652;149969;639;71;36;4;32;.889;3622000;0
7653;11068;641;0;0;0;0;.00nan;0;0
7653;-1;641;59;45;5;40;.889;3600000;0
7653;67362;1814;100;21;0;21;1.000;3600000;0
7653;156632;1814;0;0;0;0;.00nan;0;0
7654;11851;625;53;18;2;16;.889;3600000;0
7654;168651;651;90;30;1;29;.967;3600000;0
7654;195761;651;0;0;0;0;.00nan;0;0
7654;61683;625;0;0;0;0;.00nan;0;0
7655;1838;628;96;30;1;29;.967;3900000;0
7655;43064;627;95;38;1;37;.974;3900000;0
7655;85468;627;0;0;0;0;.00nan;0;0
7655;161336;628;0;0;0;0;.00nan;0;0
7656;181431;636;0;0;0;0;.00nan;0;0
7656;38277;636;64;23;2;21;.913;3900000;0
7656;145079;642;0;0;0;0;.00nan;0;0
7656;151728;642;100;56;2;54;.964;3900000;0
7657;177631;637;73;38;3;35;.921;3600000;0
7657;43064;627;61;40;4;36;.900;3583000;0
7657;73274;637;0;0;0;0;.00nan;0;0
7657;85468;627;0;0;0;0;.00nan;0;0
7658;11851;625;31;22;5;17;.773;3600000;0
7658;61683;625;0;0;0;0;.00nan;0;0
7658;67362;1814;79;30;2;28;.933;3600000;0
7658;156632;1814;0;0;0;0;.00nan;0;0
7659;11068;641;76;35;2;33;.943;3600000;0
7659;168651;651;34;25;5;20;.800;3600000;0
7659;195761;651;0;0;0;0;.00nan;0;0
7659;-1;641;0;0;0;0;.00nan;0;0
7660;162945;631;70;32;3;29;.906;3600000;0
7660;22684;632;100;31;0;31;1.000;3600000;0
7660;-1;632;0;0;0;0;.00nan;0;0
7660;144705;631;0;0;0;0;.00nan;0;0
7661;17625;626;0;0;0;0;.00nan;0;0
7661;-1;639;0;0;0;0;.00nan;0;0
7661;190508;626;65;41;4;37;.902;3591000;0
7661;149969;639;65;30;3;27;.900;3600000;0
7662;1838;628;0;0;0;0;.00nan;0;0
7662;186641;1813;74;32;3;29;.906;3569000;0
7662;-1;1813;0;0;0;0;.00nan;0;0
7662;161336;628;73;21;1;20;.952;3600000;0
7663;181431;636;66;31;3;28;.903;3600000;0
7663;38277;636;0;0;0;0;.00nan;0;0
7663;43064;627;66;37;4;33;.892;3563000;0
7663;85468;627;0;0;0;0;.00nan;0;0
7664;22684;632;77;34;2;32;.941;3550000;0
7664;-1;632;0;0;0;0;.00nan;0;0
7664;67362;1814;92;34;1;33;.971;3600000;0
7664;156632;1814;0;0;0;0;.00nan;0;0
7665;162945;631;81;24;1;23;.958;3600000;0
7665;-1;639;0;0;0;0;.00nan;0;0
7665;144705;631;0;0;0;0;.00nan;0;0
7665;149969;639;67;34;4;30;.882;3600000;0
7666;11851;625;77;23;1;22;.957;3600000;0
7666;186641;1813;98;40;2;38;.950;3550000;0
7666;-1;1813;0;0;0;0;.00nan;0;0
7666;61683;625;0;0;0;0;.00nan;0;0
7667;17625;626;97;35;1;34;.971;3900000;0
7667;168651;651;100;34;1;33;.971;3900000;0
7667;195761;651;0;0;0;0;.00nan;0;0
7667;190508;626;0;0;0;0;.00nan;0;0
7668;177631;637;0;0;0;0;.00nan;0;0
7668;73274;637;45;25;4;21;.840;3780000;0
7668;145079;642;0;0;0;0;.00nan;0;0
7668;151728;642;61;36;5;31;.861;3776000;0
7669;1838;628;37;16;4;12;.750;3550000;0
7669;11068;641;93;37;2;35;.946;3600000;0
7669;-1;641;0;0;0;0;.00nan;0;0
7669;161336;628;0;0;0;0;.00nan;0;0
7670;1838;628;0;0;0;0;.00nan;0;0
7670;17625;626;0;0;0;0;.00nan;0;0
7670;190508;626;46;27;4;23;.852;3537000;0
7670;161336;628;65;27;2;25;.926;3600000;0
7671;177631;637;0;0;0;0;.00nan;0;0
7671;67362;1814;74;28;2;26;.929;3900000;0
7671;73274;637;85;43;2;41;.953;3900000;0
7671;156632;1814;0;0;0;0;.00nan;0;0
7672;162945;631;0;0;0;0;.00nan;0;0
7672;186641;1813;82;41;3;38;.927;3575000;0
7672;-1;1813;0;0;0;0;.00nan;0;0
7672;144705;631;91;36;2;34;.944;3600000;0
7673;-1;639;0;0;0;0;.00nan;0;0
7673;181431;636;14;19;6;13;.684;2065000;0
7673;38277;636;38;12;3;9;.750;1535000;0
7673;149969;639;53;26;3;23;.885;3600000;0
7674;168651;651;76;31;2;29;.935;3900000;0
7674;195761;651;0;0;0;0;.00nan;0;0
7674;145079;642;0;0;0;0;.00nan;0;0
7674;151728;642;77;27;2;25;.926;3900000;0
7675;11068;641;69;30;3;27;.900;3531000;0
7675;11851;625;69;23;1;22;.957;3600000;0
7675;-1;641;0;0;0;0;.00nan;0;0
7675;61683;625;0;0;0;0;.00nan;0;0
7676;22684;632;72;33;3;30;.909;3900000;0
7676;-1;632;0;0;0;0;.00nan;0;0
7676;43064;627;83;40;3;37;.925;3900000;0
7676;85468;627;0;0;0;0;.00nan;0;0
7677;177631;637;0;0;0;0;.00nan;0;0
7677;181431;636;0;0;0;0;.00nan;0;0
7677;38277;636;60;40;6;34;.850;3600000;0
7677;73274;637;84;28;1;27;.964;3600000;0
7678;67362;1814;74;16;1;15;.938;3600000;0
7678;145079;642;0;0;0;0;.00nan;0;0
7678;151728;642;45;36;6;30;.833;3600000;0
7678;156632;1814;0;0;0;0;.00nan;0;0
7679;1838;628;88;39;2;37;.949;3600000;0
7679;22684;632;98;52;3;49;.942;3589000;0
7679;-1;632;0;0;0;0;.00nan;0;0
7679;161336;628;0;0;0;0;.00nan;0;0
7680;11068;641;0;0;0;0;.00nan;0;0
7680;-1;641;64;18;2;16;.889;3600000;0
7680;186641;1813;0;0;0;0;.00nan;0;0
7680;-1;1813;56;26;3;23;.885;3580000;0
7681;168651;651;81;34;3;31;.912;3568000;0
7681;195761;651;0;0;0;0;.00nan;0;0
7681;-1;639;0;0;0;0;.00nan;0;0
7681;149969;639;96;35;2;33;.943;3600000;0
7682;162945;631;0;0;0;0;.00nan;0;0
7682;17625;626;54;46;6;40;.870;3600000;0
7682;190508;626;0;0;0;0;.00nan;0;0
7682;144705;631;67;19;1;18;.947;3600000;0
7683;11851;625;43;10;2;8;.800;3600000;0
7683;43064;627;69;34;3;31;.912;3556000;0
7683;61683;625;0;0;0;0;.00nan;0;0
7683;85468;627;0;0;0;0;.00nan;0;0
7684;181431;636;36;43;8;35;.814;2503000;0
7684;38277;636;54;9;1;8;.889;1097000;0
7684;67362;1814;72;20;1;19;.950;3600000;0
7684;156632;1814;0;0;0;0;.00nan;0;0
7685;168651;651;51;30;5;25;.833;3600000;0
7685;195761;651;0;0;0;0;.00nan;0;0
7685;43064;627;73;22;2;20;.909;3600000;0
7685;85468;627;0;0;0;0;.00nan;0;0
7686;11068;641;0;0;0;0;.00nan;0;0
7686;22684;632;79;36;3;33;.917;3713000;0
7686;-1;632;0;0;0;0;.00nan;0;0
7686;-1;641;81;42;4;38;.905;3707000;0
7687;186641;1813;88;30;1;29;.967;3900000;0
7687;-1;1813;0;0;0;0;.00nan;0;0
7687;145079;642;0;0;0;0;.00nan;0;0
7687;151728;642;78;27;1;26;.963;3900000;0
7688;177631;637;0;0;0;0;.00nan;0;0
7688;17625;626;61;10;0;10;1.000;1288000;0
7688;190508;626;18;19;6;13;.684;2312000;0
7688;73274;637;71;26;2;24;.923;3600000;0
7689;1838;628;0;0;0;0;.00nan;0;0
7689;-1;639;0;0;0;0;.00nan;0;0
7689;149969;639;90;31;1;30;.968;3600000;0
7689;161336;628;56;21;2;19;.905;3590000;0
7690;162945;631;84;39;3;36;.923;3900000;0
7690;11851;625;78;38;3;35;.921;3900000;0
7690;61683;625;0;0;0;0;.00nan;0;0
7690;144705;631;0;0;0;0;.00nan;0;0
7691;22684;632;87;31;2;29;.935;3600000;0
7691;-1;632;0;0;0;0;.00nan;0;0
7691;181431;636;47;22;3;19;.864;3573000;0
7691;38277;636;0;0;0;0;.00nan;0;0
7692;177631;637;0;0;0;0;.00nan;0;0
7692;11851;625;64;27;2;25;.926;3600000;0
7692;61683;625;0;0;0;0;.00nan;0;0
7692;73274;637;85;46;3;43;.935;3594000;0
7693;162945;631;0;0;0;0;.00nan;0;0
7693;67362;1814;88;30;1;29;.967;3600000;0
7693;144705;631;50;32;5;27;.844;3600000;0
7693;156632;1814;0;0;0;0;.00nan;0;0
7694;1838;628;53;25;3;22;.880;3584000;0
7694;168651;651;0;0;0;0;.00nan;0;0
7694;195761;651;77;27;1;26;.963;3600000;0
7694;161336;628;0;0;0;0;.00nan;0;0
7695;-1;639;59;49;6;43;.878;3600000;0
7695;186641;1813;52;17;2;15;.882;3600000;0
7695;-1;1813;0;0;0;0;.00nan;0;0
7695;149969;639;0;0;0;0;.00nan;0;0
7696;11068;641;0;0;0;0;.00nan;0;0
7696;17625;626;0;0;0;0;.00nan;0;0
7696;190508;626;73;23;1;22;.957;3600000;0
7696;-1;641;75;38;3;35;.921;3565000;0
7697;43064;627;66;25;2;23;.920;3900000;0
7697;85468;627;0;0;0;0;.00nan;0;0
7697;145079;642;0;0;0;0;.00nan;0;0
7697;151728;642;91;42;2;40;.952;3900000;0
7698;17625;626;0;0;0;0;.00nan;0;0
7698;190508;626;71;33;3;30;.909;3592000;0
7698;67362;1814;0;0;0;0;.00nan;0;0
7698;156632;1814;74;25;2;23;.920;3600000;0
7699;11068;641;0;0;0;0;.00nan;0;0
7699;181431;636;81;22;1;21;.955;3600000;0
7699;38277;636;0;0;0;0;.00nan;0;0
7699;-1;641;53;32;5;27;.844;3600000;0
7700;177631;637;0;0;0;0;.00nan;0;0
7700;22684;632;70;37;5;32;.865;3600000;0
7700;-1;632;0;0;0;0;.00nan;0;0
7700;73274;637;80;27;2;25;.926;3600000;0
7701;168651;651;100;25;0;25;1.000;3600000;0
7701;195761;651;0;0;0;0;.00nan;0;0
7701;186641;1813;68;38;4;34;.895;3600000;0
7701;-1;1813;0;0;0;0;.00nan;0;0
7702;-1;639;0;0;0;0;.00nan;0;0
7702;145079;642;0;0;0;0;.00nan;0;0
7702;149969;639;68;27;3;24;.889;3600000;0
7702;151728;642;77;29;2;27;.931;3600000;0
7703;1838;628;0;0;0;0;.00nan;0;0
7703;11851;625;65;21;2;19;.905;3600000;0
7703;61683;625;0;0;0;0;.00nan;0;0
7703;161336;628;78;37;3;34;.919;3558000;0
7704;162945;631;64;23;1;22;.957;3600000;0
7704;43064;627;74;38;3;35;.921;3594000;0
7704;85468;627;0;0;0;0;.00nan;0;0
7704;144705;631;0;0;0;0;.00nan;0;0
7705;162945;631;0;0;0;0;.00nan;0;0
7705;181431;636;0;0;0;0;.00nan;0;0
7705;38277;636;52;37;5;32;.865;3600000;0
7705;144705;631;71;23;2;21;.913;3600000;0
7706;168651;651;14;18;6;12;.667;3034000;0
7706;195761;651;35;4;2;2;.500;566000;0
7706;67362;1814;98;31;1;30;.968;3600000;0
7706;156632;1814;0;0;0;0;.00nan;0;0
7707;22684;632;60;23;2;21;.913;3600000;0
7707;-1;632;0;0;0;0;.00nan;0;0
7707;186641;1813;75;47;5;42;.894;3600000;0
7707;-1;1813;0;0;0;0;.00nan;0;0
7708;17625;626;66;35;3;32;.914;3900000;0
7708;190508;626;0;0;0;0;.00nan;0;0
7708;43064;627;47;19;3;16;.842;3900000;0
7708;85468;627;0;0;0;0;.00nan;0;0
7709;1838;628;0;0;0;0;.00nan;0;0
7709;177631;637;0;0;0;0;.00nan;0;0
7709;73274;637;52;27;3;24;.889;3900000;0
7709;161336;628;66;31;3;28;.903;3900000;0
7710;11068;641;49;23;3;20;.870;3600000;0
7710;-1;639;0;0;0;0;.00nan;0;0
7710;-1;641;0;0;0;0;.00nan;0;0
7710;149969;639;57;20;2;18;.900;3600000;0
7711;11851;625;47;29;4;25;.862;3588000;0
7711;61683;625;0;0;0;0;.00nan;0;0
7711;145079;642;0;0;0;0;.00nan;0;0
7711;151728;642;76;37;3;34;.919;3600000;0
7712;177631;637;67;26;3;23;.885;3600000;0
7712;186641;1813;71;39;4;35;.897;3581000;0
7712;-1;1813;0;0;0;0;.00nan;0;0
7712;73274;637;0;0;0;0;.00nan;0;0
7713;17625;626;0;0;0;0;.00nan;0;0
7713;190508;626;98;49;1;48;.980;3900000;0
7713;181431;636;83;23;1;22;.957;3900000;0
7713;38277;636;0;0;0;0;.00nan;0;0
7714;162945;631;76;20;1;19;.950;3734000;0
7714;-1;639;0;0;0;0;.00nan;0;0
7714;144705;631;0;0;0;0;.00nan;0;0
7714;149969;639;100;38;0;38;1.000;3734000;0
7715;11851;625;87;32;1;31;.969;3600000;0
7715;168651;651;66;32;3;29;.906;3586000;0
7715;195761;651;0;0;0;0;.00nan;0;0
7715;61683;625;0;0;0;0;.00nan;0;0
7716;22684;632;96;42;2;40;.952;3579000;0
7716;-1;632;0;0;0;0;.00nan;0;0
7716;67362;1814;72;25;1;24;.960;3600000;0
7716;156632;1814;0;0;0;0;.00nan;0;0
7717;1838;628;14;23;6;17;.739;2714000;0
7717;145079;642;0;0;0;0;.00nan;0;0
7717;151728;642;94;38;1;37;.974;3600000;0
7717;161336;628;56;4;0;4;1.000;886000;0
7718;11068;641;72;50;5;45;.900;3600000;0
7718;-1;641;0;0;0;0;.00nan;0;0
7718;43064;627;0;0;0;0;.00nan;0;0
7718;85468;627;52;24;3;21;.875;3600000;0
7719;177631;637;0;0;0;0;.00nan;0;0
7719;181431;636;47;28;4;24;.857;3526000;0
7719;38277;636;0;0;0;0;.00nan;0;0
7719;73274;637;66;24;2;22;.917;3600000;0
7720;162945;631;100;22;0;22;1.000;3600000;0
7720;67362;1814;67;26;2;24;.923;3590000;0
7720;144705;631;0;0;0;0;.00nan;0;0
7720;156632;1814;0;0;0;0;.00nan;0;0
7721;168651;651;72;37;3;34;.919;3834000;0
7721;195761;651;0;0;0;0;.00nan;0;0
7721;43064;627;67;33;4;29;.879;3834000;0
7721;85468;627;0;0;0;0;.00nan;0;0
7722;186641;1813;80;22;1;21;.955;3600000;0
7722;-1;1813;0;0;0;0;.00nan;0;0
7722;145079;642;0;0;0;0;.00nan;0;0
7722;151728;642;50;34;5;29;.853;3600000;0
7723;17625;626;0;0;0;0;.00nan;0;0
7723;-1;639;0;0;0;0;.00nan;0;0
7723;190508;626;66;24;2;22;.917;3600000;0
7723;149969;639;100;40;1;39;.975;3600000;0
7724;1838;628;0;0;0;0;.00nan;0;0
7724;11068;641;0;0;0;0;.00nan;0;0
7724;-1;641;82;39;3;36;.923;3600000;0
7724;161336;628;85;13;0;13;1.000;3600000;0
7725;11851;625;85;20;0;20;1.000;3600000;0
7725;22684;632;58;30;3;27;.900;3600000;0
7725;-1;632;0;0;0;0;.00nan;0;0
7725;61683;625;0;0;0;0;.00nan;0;0
7726;181431;636;45;17;3;14;.824;3572000;0
7726;38277;636;0;0;0;0;.00nan;0;0
7726;186641;1813;88;29;1;28;.966;3600000;0
7726;-1;1813;0;0;0;0;.00nan;0;0
7727;162945;631;90;29;1;28;.966;3900000;0
7727;177631;637;0;0;0;0;.00nan;0;0
7727;73274;637;85;28;1;27;.964;3900000;0
7727;144705;631;0;0;0;0;.00nan;0;0
7728;1838;628;71;25;2;23;.920;3562000;0
7728;17625;626;88;23;1;22;.957;3600000;0
7728;190508;626;0;0;0;0;.00nan;0;0
7728;161336;628;0;0;0;0;.00nan;0;0
7729;11068;641;74;30;2;28;.933;3752000;0
7729;168651;651;49;21;3;18;.857;3752000;0
7729;195761;651;0;0;0;0;.00nan;0;0
7729;-1;641;0;0;0;0;.00nan;0;0
7730;11851;625;100;25;0;25;1.000;3600000;0
7730;43064;627;97;34;1;33;.971;3567000;0
7730;61683;625;0;0;0;0;.00nan;0;0
7730;85468;627;0;0;0;0;.00nan;0;0
7731;22684;632;69;32;3;29;.906;3600000;0
7731;-1;639;0;0;0;0;.00nan;0;0
7731;-1;632;0;0;0;0;.00nan;0;0
7731;149969;639;51;28;4;24;.857;3582000;0
7732;67362;1814;79;35;2;33;.943;3600000;0
7732;145079;642;0;0;0;0;.00nan;0;0
7732;151728;642;86;25;1;24;.960;3600000;0
7732;156632;1814;0;0;0;0;.00nan;0;0
7733;177631;637;0;0;0;0;.00nan;0;0
7733;67362;1814;54;23;3;20;.870;3600000;0
7733;73274;637;63;34;4;30;.882;3590000;0
7733;156632;1814;0;0;0;0;.00nan;0;0
7734;162945;631;43;19;4;15;.789;3554000;0
7734;181431;636;0;0;0;0;.00nan;0;0
7734;38277;636;44;17;3;14;.824;3600000;0
7734;144705;631;0;0;0;0;.00nan;0;0
7735;168651;651;79;23;1;22;.957;3600000;0
7735;195761;651;0;0;0;0;.00nan;0;0
7735;145079;642;0;0;0;0;.00nan;0;0
7735;151728;642;68;34;3;31;.912;3559000;0
7736;22684;632;96;21;0;21;1.000;3600000;0
7736;-1;632;0;0;0;0;.00nan;0;0
7736;186641;1813;97;45;1;44;.978;3600000;0
7736;-1;1813;0;0;0;0;.00nan;0;0
7737;11068;641;0;0;0;0;.00nan;0;0
7737;-1;639;0;0;0;0;.00nan;0;0
7737;-1;641;67;37;4;33;.892;3900000;0
7737;149969;639;62;29;4;25;.862;3900000;0
7738;11851;625;55;27;3;24;.889;3600000;0
7738;17625;626;0;0;0;0;.00nan;0;0
7738;190508;626;50;33;4;29;.879;3547000;0
7738;61683;625;0;0;0;0;.00nan;0;0
7739;1838;628;0;0;0;0;.00nan;0;0
7739;43064;627;82;28;2;26;.929;3584000;0
7739;85468;627;0;0;0;0;.00nan;0;0
7739;161336;628;96;23;0;23;1.000;3600000;0
7740;181431;636;61;23;2;21;.913;3600000;0
7740;38277;636;0;0;0;0;.00nan;0;0
7740;43064;627;59;30;4;26;.867;3552000;0
7740;85468;627;0;0;0;0;.00nan;0;0
7741;177631;637;0;0;0;0;.00nan;0;0
7741;11068;641;85;38;3;35;.921;3576000;0
7741;-1;641;0;0;0;0;.00nan;0;0
7741;73274;637;64;21;2;19;.905;3600000;0
7742;168651;651;64;30;3;27;.900;3600000;0
7742;22684;632;95;30;1;29;.967;3600000;0
7742;195761;651;0;0;0;0;.00nan;0;0
7742;-1;632;0;0;0;0;.00nan;0;0
7743;-1;639;0;0;0;0;.00nan;0;0
7743;186641;1813;89;27;1;26;.963;3900000;0
7743;-1;1813;0;0;0;0;.00nan;0;0
7743;149969;639;97;35;1;34;.971;3900000;0
7744;17625;626;77;41;3;38;.927;3900000;0
7744;190508;626;0;0;0;0;.00nan;0;0
7744;67362;1814;68;34;3;31;.912;3889000;0
7744;156632;1814;0;0;0;0;.00nan;0;0
7745;1838;628;45;35;6;29;.829;3573000;0
7745;162945;631;0;0;0;0;.00nan;0;0
7745;144705;631;71;39;4;35;.897;3600000;0
7745;161336;628;0;0;0;0;.00nan;0;0
7746;11851;625;0;0;0;0;.00nan;0;0
7746;61683;625;98;24;0;24;1.000;3900000;0
7746;145079;642;0;0;0;0;.00nan;0;0
7746;151728;642;96;28;0;28;1.000;3900000;0
7747;177631;637;0;0;0;0;.00nan;0;0
7747;168651;651;55;26;3;23;.885;3570000;0
7747;195761;651;0;0;0;0;.00nan;0;0
7747;73274;637;74;32;2;30;.938;3600000;0
7748;11851;625;0;0;0;0;.00nan;0;0
7748;-1;639;55;38;5;33;.868;3600000;0
7748;61683;625;68;20;1;19;.950;3600000;0
7748;149969;639;0;0;0;0;.00nan;0;0
7749;181431;636;0;0;0;0;.00nan;0;0
7749;38277;636;50;34;5;29;.853;3600000;0
7749;67362;1814;76;33;2;31;.939;3600000;0
7749;156632;1814;0;0;0;0;.00nan;0;0
7750;162945;631;0;0;0;0;.00nan;0;0
7750;17625;626;0;0;0;0;.00nan;0;0
7750;190508;626;96;35;1;34;.971;3900000;0
7750;144705;631;83;23;1;22;.957;3900000;0
7751;186641;1813;78;32;2;30;.938;3600000;0
7751;-1;1813;0;0;0;0;.00nan;0;0
7751;43064;627;92;40;3;37;.925;3600000;0
7751;85468;627;0;0;0;0;.00nan;0;0
7752;1838;628;0;0;0;0;.00nan;0;0
7752;22684;632;98;36;1;35;.972;3600000;0
7752;-1;632;0;0;0;0;.00nan;0;0
7752;161336;628;62;22;3;19;.864;3517000;0
7753;11068;641;0;0;0;0;.00nan;0;0
7753;-1;641;86;37;2;35;.946;3900000;0
7753;145079;642;0;0;0;0;.00nan;0;0
7753;151728;642;90;40;2;38;.950;3900000;0
7754;168651;651;72;32;3;29;.906;3600000;0
7754;195761;651;0;0;0;0;.00nan;0;0
7754;-1;639;0;0;0;0;.00nan;0;0
7754;149969;639;45;25;4;21;.840;3595000;0
7755;186641;1813;63;29;3;26;.897;3546000;0
7755;-1;1813;0;0;0;0;.00nan;0;0
7755;67362;1814;82;28;2;26;.929;3600000;0
7755;156632;1814;0;0;0;0;.00nan;0;0
7756;22684;632;53;27;4;23;.852;3537000;0
7756;-1;632;0;0;0;0;.00nan;0;0
7756;181431;636;57;16;2;14;.875;3600000;0
7756;38277;636;0;0;0;0;.00nan;0;0
7757;11068;641;58;27;3;24;.889;3600000;0
7757;17625;626;19;9;4;5;.556;524000;0
7757;190508;626;68;12;0;12;1.000;3039000;0
7757;-1;641;0;0;0;0;.00nan;0;0
7758;177631;637;0;0;0;0;.00nan;0;0
7758;73274;637;66;21;2;19;.905;3755000;0
7758;145079;642;73;21;1;20;.952;3755000;0
7758;151728;642;0;0;0;0;.00nan;0;0
7759;1838;628;100;26;0;26;1.000;3600000;0
7759;11851;625;40;26;4;22;.846;3600000;0
7759;61683;625;0;0;0;0;.00nan;0;0
7759;161336;628;0;0;0;0;.00nan;0;0
7760;162945;631;71;32;3;29;.906;3900000;0
7760;43064;627;75;34;3;31;.912;3900000;0
7760;85468;627;0;0;0;0;.00nan;0;0
7760;144705;631;0;0;0;0;.00nan;0;0
7761;17625;626;0;0;0;0;.00nan;0;0
7761;22684;632;42;37;6;31;.838;3825000;0
7761;-1;632;0;0;0;0;.00nan;0;0
7761;190508;626;45;42;7;35;.833;3828000;0
7762;-1;639;0;0;0;0;.00nan;0;0
7762;181431;636;0;0;0;0;.00nan;0;0
7762;38277;636;41;22;4;18;.818;3519000;0
7762;149969;639;72;28;2;26;.929;3600000;0
7763;1838;628;61;35;4;31;.886;3574000;0
7763;177631;637;0;0;0;0;.00nan;0;0
7763;73274;637;66;29;3;26;.897;3600000;0
7763;161336;628;0;0;0;0;.00nan;0;0
7764;11068;641;83;42;3;39;.929;3600000;0
7764;-1;641;0;0;0;0;.00nan;0;0
7764;67362;1814;47;23;4;19;.826;3544000;0
7764;156632;1814;0;0;0;0;.00nan;0;0
7765;162945;631;50;17;3;14;.824;3600000;0
7765;168651;651;88;52;4;48;.923;3546000;0
7765;195761;651;0;0;0;0;.00nan;0;0
7765;144705;631;0;0;0;0;.00nan;0;0
7766;11851;625;40;23;4;19;.826;3571000;0
7766;186641;1813;81;39;3;36;.923;3600000;0
7766;-1;1813;0;0;0;0;.00nan;0;0
7766;61683;625;0;0;0;0;.00nan;0;0
7767;43064;627;100;32;0;32;1.000;3600000;0
7767;85468;627;0;0;0;0;.00nan;0;0
7767;145079;642;0;0;0;0;.00nan;0;0
7767;151728;642;75;33;2;31;.939;3534000;0
7768;162945;631;33;18;4;14;.778;3600000;0
7768;22684;632;52;41;6;35;.854;3567000;0
7768;-1;632;0;0;0;0;.00nan;0;0
7768;144705;631;0;0;0;0;.00nan;0;0
7769;17625;626;84;39;3;36;.923;3547000;0
7769;168651;651;0;0;0;0;.00nan;0;0
7769;195761;651;99;32;1;31;.969;3600000;0
7769;190508;626;0;0;0;0;.00nan;0;0
7770;1838;628;0;0;0;0;.00nan;0;0
7770;181431;636;0;0;0;0;.00nan;0;0
7770;38277;636;82;31;2;29;.935;3900000;0
7770;161336;628;64;20;2;18;.900;3900000;0
7771;11068;641;0;0;0;0;.00nan;0;0
7771;-1;641;66;34;3;31;.912;3900000;0
7771;186641;1813;69;34;3;31;.912;3900000;0
7771;-1;1813;0;0;0;0;.00nan;0;0
7772;177631;637;0;0;0;0;.00nan;0;0
7772;11851;625;78;13;0;13;1.000;3600000;0
7772;61683;625;0;0;0;0;.00nan;0;0
7772;73274;637;52;42;5;37;.881;3600000;0
7773;43064;627;92;44;2;42;.955;3600000;0
7773;67362;1814;41;28;5;23;.821;3600000;0
7773;85468;627;0;0;0;0;.00nan;0;0
7773;156632;1814;0;0;0;0;.00nan;0;0
7774;-1;639;0;0;0;0;.00nan;0;0
7774;145079;642;0;0;0;0;.00nan;0;0
7774;149969;639;63;30;4;26;.867;3600000;0
7774;151728;642;45;30;5;25;.833;3562000;0
7775;11851;625;86;15;0;15;1.000;3600000;0
7775;181431;636;0;0;0;0;.00nan;0;0
7775;38277;636;68;32;3;29;.906;3600000;0
7775;61683;625;0;0;0;0;.00nan;0;0
7776;162945;631;0;0;0;0;.00nan;0;0
7776;11068;641;64;49;7;42;.857;3600000;0
7776;-1;641;0;0;0;0;.00nan;0;0
7776;144705;631;50;15;2;13;.867;3600000;0
7777;168651;651;61;39;5;34;.872;3600000;0
7777;195761;651;0;0;0;0;.00nan;0;0
7777;186641;1813;38;19;4;15;.789;1189000;0
7777;-1;1813;58;25;2;23;.920;2375000;0
7778;22684;632;63;32;3;29;.906;3900000;0
7778;-1;632;0;0;0;0;.00nan;0;0
7778;43064;627;67;31;3;28;.903;3900000;0
7778;85468;627;0;0;0;0;.00nan;0;0
7779;177631;637;0;0;0;0;.00nan;0;0
7779;-1;639;0;0;0;0;.00nan;0;0
7779;73274;637;50;25;4;21;.840;3526000;0
7779;149969;639;81;36;2;34;.944;3600000;0
7780;17625;626;0;0;0;0;.00nan;0;0
7780;190508;626;65;29;2;27;.931;3900000;0
7780;145079;642;0;0;0;0;.00nan;0;0
7780;151728;642;81;25;2;23;.920;3900000;0
7781;1838;628;100;39;0;39;1.000;3600000;0
7781;67362;1814;66;18;1;17;.944;3545000;0
7781;156632;1814;0;0;0;0;.00nan;0;0
7781;161336;628;0;0;0;0;.00nan;0;0
7782;168651;651;58;22;2;20;.909;3900000;0
7782;195761;651;0;0;0;0;.00nan;0;0
7782;181431;636;80;25;2;23;.920;3900000;0
7782;38277;636;0;0;0;0;.00nan;0;0
7783;177631;637;0;0;0;0;.00nan;0;0
7783;17625;626;0;0;0;0;.00nan;0;0
7783;190508;626;88;50;2;48;.960;3528000;0
7783;73274;637;95;24;0;24;1.000;3600000;0
7784;11851;625;57;41;5;36;.878;3551000;0
7784;61683;625;0;0;0;0;.00nan;0;0
7784;67362;1814;58;27;4;23;.852;3600000;0
7784;156632;1814;0;0;0;0;.00nan;0;0
7785;162945;631;0;0;0;0;.00nan;0;0
7785;144705;631;48;31;5;26;.839;3600000;0
7785;145079;642;0;0;0;0;.00nan;0;0
7785;151728;642;85;29;1;28;.966;3600000;0
7786;1838;628;71;20;1;19;.950;3900000;0
7786;186641;1813;97;36;1;35;.972;3900000;0
7786;-1;1813;0;0;0;0;.00nan;0;0
7786;161336;628;0;0;0;0;.00nan;0;0
7787;11068;641;0;0;0;0;.00nan;0;0
7787;22684;632;91;16;0;16;1.000;3600000;0
7787;-1;632;0;0;0;0;.00nan;0;0
7787;-1;641;72;42;4;38;.905;3600000;0
7788;-1;639;0;0;0;0;.00nan;0;0
7788;43064;627;97;36;2;34;.944;3600000;0
7788;85468;627;0;0;0;0;.00nan;0;0
7788;149969;639;75;35;3;32;.914;3600000;0
7789;22684;632;44;31;5;26;.839;3600000;0
7789;-1;632;0;0;0;0;.00nan;0;0
7789;145079;642;0;0;0;0;.00nan;0;0
7789;151728;642;100;22;0;22;1.000;3600000;0
7790;177631;637;0;0;0;0;.00nan;0;0
7790;43064;627;100;27;0;27;1.000;3600000;0
7790;73274;637;86;28;1;27;.964;3553000;0
7790;85468;627;0;0;0;0;.00nan;0;0
7791;168651;651;94;46;3;43;.935;3900000;0
7791;195761;651;0;0;0;0;.00nan;0;0
7791;67362;1814;0;0;0;0;.00nan;0;0
7791;156632;1814;73;29;3;26;.897;3900000;0
7792;162945;631;87;32;2;30;.938;3600000;0
7792;11851;625;56;30;3;27;.900;3600000;0
7792;61683;625;0;0;0;0;.00nan;0;0
7792;144705;631;0;0;0;0;.00nan;0;0
7793;17625;626;0;0;0;0;.00nan;0;0
7793;190508;626;71;25;2;23;.920;3558000;0
7793;186641;1813;70;21;1;20;.952;3600000;0
7793;-1;1813;0;0;0;0;.00nan;0;0
7794;1838;628;0;0;0;0;.00nan;0;0
7794;-1;639;0;0;0;0;.00nan;0;0
7794;149969;639;95;25;0;25;1.000;3600000;0
7794;161336;628;61;24;2;22;.917;3560000;0
7795;11068;641;65;32;3;29;.906;3577000;0
7795;181431;636;0;0;0;0;.00nan;0;0
7795;38277;636;67;23;2;21;.913;3600000;0
7795;-1;641;0;0;0;0;.00nan;0;0
7796;181431;636;91;29;1;28;.966;3600000;0
7796;38277;636;0;0;0;0;.00nan;0;0
7796;145079;642;0;0;0;0;.00nan;0;0
7796;151728;642;76;53;4;49;.925;3600000;0
7797;1838;628;86;33;1;32;.970;3600000;0
7797;168651;651;74;32;2;30;.938;3555000;0
7797;195761;651;0;0;0;0;.00nan;0;0
7797;161336;628;0;0;0;0;.00nan;0;0
7798;177631;637;0;0;0;0;.00nan;0;0
7798;22684;632;0;0;0;0;.00nan;0;0
7798;-1;632;57;28;3;25;.893;3583000;0
7798;73274;637;74;24;2;22;.917;3600000;0
7799;162945;631;79;26;1;25;.962;3600000;0
7799;186641;1813;91;44;3;41;.932;3560000;0
7799;-1;1813;0;0;0;0;.00nan;0;0
7799;144705;631;0;0;0;0;.00nan;0;0
7800;-1;639;0;0;0;0;.00nan;0;0
7800;67362;1814;52;15;2;13;.867;3519000;0
7800;149969;639;100;41;0;41;1.000;3600000;0
7800;156632;1814;0;0;0;0;.00nan;0;0
7801;11068;641;0;0;0;0;.00nan;0;0
7801;11851;625;59;12;1;11;.917;3600000;0
7801;-1;641;85;47;4;43;.915;3600000;0
7801;61683;625;0;0;0;0;.00nan;0;0
7802;17625;626;0;0;0;0;.00nan;0;0
7802;190508;626;99;36;1;35;.972;3600000;0
7802;43064;627;76;28;2;26;.929;3545000;0
7802;85468;627;0;0;0;0;.00nan;0;0
7803;1838;628;0;0;0;0;.00nan;0;0
7803;22684;632;76;28;2;26;.929;3600000;0
7803;-1;632;0;0;0;0;.00nan;0;0
7803;161336;628;45;20;3;17;.850;3560000;0
7804;162945;631;0;0;0;0;.00nan;0;0
7804;181431;636;97;42;2;40;.952;3767000;0
7804;38277;636;0;0;0;0;.00nan;0;0
7804;144705;631;65;24;3;21;.875;3767000;0
7805;177631;637;0;0;0;0;.00nan;0;0
7805;67362;1814;85;26;1;25;.962;3765000;0
7805;73274;637;94;43;2;41;.953;3765000;0
7805;156632;1814;0;0;0;0;.00nan;0;0
7806;11068;641;50;31;5;26;.839;3879000;0
7806;-1;639;54;29;4;25;.862;3879000;0
7806;-1;641;0;0;0;0;.00nan;0;0
7806;149969;639;0;0;0;0;.00nan;0;0
7807;17625;626;60;21;2;19;.905;3600000;0
7807;168651;651;93;39;1;38;.974;3600000;0
7807;195761;651;0;0;0;0;.00nan;0;0
7807;190508;626;0;0;0;0;.00nan;0;0
7808;43064;627;33;27;6;21;.778;3600000;0
7808;85468;627;0;0;0;0;.00nan;0;0
7808;145079;642;82;29;2;27;.931;3600000;0
7808;151728;642;0;0;0;0;.00nan;0;0
7809;11851;625;71;27;1;26;.963;3600000;0
7809;186641;1813;78;35;3;32;.914;3554000;0
7809;-1;1813;0;0;0;0;.00nan;0;0
7809;61683;625;0;0;0;0;.00nan;0;0
7810;43064;627;64;28;3;25;.893;3600000;0
7810;67362;1814;0;0;0;0;.00nan;0;0
7810;85468;627;0;0;0;0;.00nan;0;0
7810;156632;1814;11;19;6;13;.684;3600000;0
7811;162945;631;72;33;3;30;.909;3600000;0
7811;17625;626;0;0;0;0;.00nan;0;0
7811;190508;626;36;38;6;32;.842;3600000;0
7811;144705;631;0;0;0;0;.00nan;0;0
7812;168651;651;47;39;6;33;.846;3600000;0
7812;195761;651;0;0;0;0;.00nan;0;0
7812;181431;636;0;0;0;0;.00nan;0;0
7812;38277;636;85;34;2;32;.941;3600000;0
7813;177631;637;0;0;0;0;.00nan;0;0
7813;186641;1813;77;40;3;37;.925;3576000;0
7813;-1;1813;0;0;0;0;.00nan;0;0
7813;73274;637;85;24;1;23;.958;3600000;0
7814;22684;632;59;13;1;12;.923;3600000;0
7814;-1;639;0;0;0;0;.00nan;0;0
7814;-1;632;0;0;0;0;.00nan;0;0
7814;149969;639;80;36;2;34;.944;3600000;0
7815;11068;641;0;0;0;0;.00nan;0;0
7815;-1;641;53;21;3;18;.857;3600000;0
7815;145079;642;0;0;0;0;.00nan;0;0
7815;151728;642;97;22;0;22;1.000;3600000;0
7816;1838;628;0;0;0;0;.00nan;0;0
7816;11851;625;74;31;3;28;.903;3723000;0
7816;61683;625;0;0;0;0;.00nan;0;0
7816;161336;628;76;28;2;26;.929;3723000;0
7817;181431;636;0;0;0;0;.00nan;0;0
7817;38277;636;78;15;0;15;1.000;3600000;0
7817;186641;1813;85;46;3;43;.935;3600000;0
7817;-1;1813;0;0;0;0;.00nan;0;0
7818;1838;628;51;29;4;25;.862;3600000;0
7818;67362;1814;59;18;2;16;.889;3600000;0
7818;156632;1814;0;0;0;0;.00nan;0;0
7818;161336;628;0;0;0;0;.00nan;0;0
7819;162945;631;70;26;2;24;.923;3563000;0
7819;22684;632;83;26;1;25;.962;3600000;0
7819;-1;632;0;0;0;0;.00nan;0;0
7819;144705;631;0;0;0;0;.00nan;0;0
7820;177631;637;0;0;0;0;.00nan;0;0
7820;168651;651;82;30;2;28;.933;3820000;0
7820;195761;651;0;0;0;0;.00nan;0;0
7820;73274;637;81;26;1;25;.962;3820000;0
7821;-1;639;0;0;0;0;.00nan;0;0
7821;145079;642;0;0;0;0;.00nan;0;0
7821;149969;639;75;29;2;27;.931;3560000;0
7821;151728;642;100;30;0;30;1.000;3600000;0
7822;11068;641;92;46;2;44;.957;3869000;0
7822;17625;626;0;0;0;0;.00nan;0;0
7822;190508;626;78;22;1;21;.955;3869000;0
7822;-1;641;0;0;0;0;.00nan;0;0
7823;11851;625;69;32;3;29;.906;3600000;0
7823;43064;627;66;40;6;34;.850;3600000;0
7823;61683;625;0;0;0;0;.00nan;0;0
7823;85468;627;0;0;0;0;.00nan;0;0
7824;177631;637;98;36;1;35;.972;2683000;0
7824;73274;637;17;8;4;4;.500;1049000;0
7824;145079;642;0;0;0;0;.00nan;0;0
7824;151728;642;53;41;6;35;.854;3732000;0
7825;11068;641;45;25;4;21;.840;3600000;0
7825;168651;651;67;19;1;18;.947;3600000;0
7825;195761;651;0;0;0;0;.00nan;0;0
7825;-1;641;0;0;0;0;.00nan;0;0
7826;22684;632;86;38;2;36;.947;3900000;0
7826;-1;632;0;0;0;0;.00nan;0;0
7826;43064;627;99;46;2;44;.957;3900000;0
7826;85468;627;0;0;0;0;.00nan;0;0
7827;162945;631;95;25;0;25;1.000;3600000;0
7827;186641;1813;95;49;3;46;.939;3600000;0
7827;-1;1813;0;0;0;0;.00nan;0;0
7827;144705;631;0;0;0;0;.00nan;0;0
7828;-1;639;0;0;0;0;.00nan;0;0
7828;181431;636;0;0;0;0;.00nan;0;0
7828;38277;636;100;28;0;28;1.000;3600000;0
7828;149969;639;74;38;4;34;.895;3600000;0
7829;1838;628;0;0;0;0;.00nan;0;0
7829;17625;626;0;0;0;0;.00nan;0;0
7829;190508;626;54;24;3;21;.875;3564000;0
7829;161336;628;64;22;2;20;.909;3600000;0
7830;11851;625;43;20;3;17;.850;3600000;0
7830;61683;625;0;0;0;0;.00nan;0;0
7830;67362;1814;100;29;0;29;1.000;3600000;0
7830;156632;1814;0;0;0;0;.00nan;0;0
7831;11851;625;71;30;3;27;.900;3600000;0
7831;181431;636;0;0;0;0;.00nan;0;0
7831;38277;636;100;29;0;29;1.000;3600000;0
7831;61683;625;0;0;0;0;.00nan;0;0
7832;162945;631;95;31;2;29;.935;3600000;0
7832;177631;637;0;0;0;0;.00nan;0;0
7832;73274;637;52;38;5;33;.868;3600000;0
7832;144705;631;0;0;0;0;.00nan;0;0
7833;168651;651;66;29;3;26;.897;3567000;0
7833;195761;651;0;0;0;0;.00nan;0;0
7833;-1;639;0;0;0;0;.00nan;0;0
7833;149969;639;93;36;2;34;.944;3600000;0
7834;17625;626;51;27;4;23;.852;3557000;0
7834;190508;626;0;0;0;0;.00nan;0;0
7834;67362;1814;71;30;3;27;.900;3600000;0
7834;156632;1814;0;0;0;0;.00nan;0;0
7835;186641;1813;78;30;2;28;.933;3597000;0
7835;-1;1813;0;0;0;0;.00nan;0;0
7835;145079;642;0;0;0;0;.00nan;0;0
7835;151728;642;94;30;1;29;.967;3600000;0
7836;1838;628;89;46;2;44;.957;3514000;0
7836;43064;627;100;22;0;22;1.000;3600000;0
7836;85468;627;0;0;0;0;.00nan;0;0
7836;161336;628;0;0;0;0;.00nan;0;0
7837;11068;641;87;31;1;30;.968;3200000;0
7837;22684;632;73;28;2;26;.929;3600000;0
7837;-1;632;0;0;0;0;.00nan;0;0
7837;-1;641;27;9;3;6;.667;357000;0
7838;22684;632;80;31;2;29;.935;3600000;0
7838;-1;632;0;0;0;0;.00nan;0;0
7838;67362;1814;92;30;1;29;.967;3600000;0
7838;156632;1814;0;0;0;0;.00nan;0;0
7839;168651;651;74;22;1;21;.955;3600000;0
7839;195761;651;0;0;0;0;.00nan;0;0
7839;186641;1813;79;36;3;33;.917;3592000;0
7839;-1;1813;0;0;0;0;.00nan;0;0
7840;1838;628;0;0;0;0;.00nan;0;0
7840;-1;639;63;13;0;13;1.000;1390000;0
7840;149969;639;24;21;5;16;.762;2210000;0
7840;161336;628;89;32;1;31;.969;3600000;0
7841;162945;631;45;25;5;20;.800;3674000;0
7841;144705;631;0;0;0;0;.00nan;0;0
7841;145079;642;27;14;4;10;.714;859000;0
7841;151728;642;69;23;2;21;.913;2815000;0
7842;177631;637;0;0;0;0;.00nan;0;0
7842;11068;641;82;39;3;36;.923;3540000;0
7842;-1;641;0;0;0;0;.00nan;0;0
7842;73274;637;60;20;2;18;.900;3600000;0
7843;11851;625;95;22;1;21;.955;3600000;0
7843;17625;626;0;0;0;0;.00nan;0;0
7843;190508;626;83;45;4;41;.911;3600000;0
7843;61683;625;0;0;0;0;.00nan;0;0
7844;181431;636;0;0;0;0;.00nan;0;0
7844;38277;636;59;29;3;26;.897;3600000;0
7844;43064;627;72;42;4;38;.905;3549000;0
7844;85468;627;0;0;0;0;.00nan;0;0
7845;181431;636;58;32;4;28;.875;3513000;0
7845;38277;636;0;0;0;0;.00nan;0;0
7845;145079;642;0;0;0;0;.00nan;0;0
7845;151728;642;82;30;2;28;.933;3600000;0
7846;177631;637;80;38;3;35;.921;3519000;0
7846;11851;625;99;25;1;24;.960;3600000;0
7846;61683;625;0;0;0;0;.00nan;0;0
7846;73274;637;0;0;0;0;.00nan;0;0
7847;-1;639;0;0;0;0;.00nan;0;0
7847;67362;1814;56;12;1;11;.917;3600000;0
7847;149969;639;86;45;3;42;.933;3526000;0
7847;156632;1814;0;0;0;0;.00nan;0;0
7848;1838;628;77;23;1;22;.957;3600000;0
7848;162945;631;0;0;0;0;.00nan;0;0
7848;144705;631;39;23;4;19;.826;3600000;0
7848;161336;628;0;0;0;0;.00nan;0;0
7849;168651;651;57;24;3;21;.875;3557000;0
7849;22684;632;85;28;1;27;.964;3600000;0
7849;195761;651;0;0;0;0;.00nan;0;0
7849;-1;632;0;0;0;0;.00nan;0;0
7850;17625;626;0;0;0;0;.00nan;0;0
7850;190508;626;66;26;3;23;.885;3900000;0
7850;186641;1813;99;45;3;42;.933;3900000;0
7850;-1;1813;0;0;0;0;.00nan;0;0
7851;11068;641;67;52;6;46;.885;3304000;0
7851;-1;641;48;0;0;0;.00nan;296000;0
7851;43064;627;0;0;0;0;.00nan;0;0
7851;85468;627;51;18;3;15;.833;3600000;0
7852;162945;631;70;18;1;17;.944;3600000;0
7852;168651;651;44;26;4;22;.846;3600000;0
7852;195761;651;0;0;0;0;.00nan;0;0
7852;144705;631;0;0;0;0;.00nan;0;0
7853;17625;626;53;8;1;7;.875;1266000;0
7853;190508;626;32;15;4;11;.733;2334000;0
7853;145079;642;0;0;0;0;.00nan;0;0
7853;151728;642;100;29;0;29;1.000;3600000;0
7854;1838;628;61;27;3;24;.889;3546000;0
7854;181431;636;0;0;0;0;.00nan;0;0
7854;38277;636;81;35;2;33;.943;3600000;0
7854;161336;628;0;0;0;0;.00nan;0;0
7855;11068;641;0;0;0;0;.00nan;0;0
7855;-1;641;67;54;6;48;.889;3600000;0
7855;67362;1814;69;17;1;16;.941;3600000;0
7855;156632;1814;0;0;0;0;.00nan;0;0
7856;11851;625;79;30;2;28;.933;3600000;0
7856;22684;632;68;36;3;33;.917;3600000;0
7856;-1;632;0;0;0;0;.00nan;0;0
7856;61683;625;0;0;0;0;.00nan;0;0
7857;-1;639;0;0;0;0;.00nan;0;0
7857;186641;1813;85;21;1;20;.952;3600000;0
7857;-1;1813;0;0;0;0;.00nan;0;0
7857;149969;639;85;35;2;33;.943;3585000;0
7858;177631;637;0;0;0;0;.00nan;0;0
7858;43064;627;99;39;1;38;.974;3900000;0
7858;73274;637;73;25;1;24;.960;3900000;0
7858;85468;627;0;0;0;0;.00nan;0;0
7859;11851;625;69;26;3;23;.885;3628000;0
7859;168651;651;0;0;0;0;.00nan;0;0
7859;195761;651;100;45;2;43;.956;3628000;0
7859;61683;625;0;0;0;0;.00nan;0;0
7860;162945;631;47;26;4;22;.846;3600000;0
7860;43064;627;91;28;1;27;.964;3600000;0
7860;85468;627;0;0;0;0;.00nan;0;0
7860;144705;631;0;0;0;0;.00nan;0;0
7861;177631;637;0;0;0;0;.00nan;0;0
7861;22684;632;70;30;3;27;.900;3668000;0
7861;-1;632;0;0;0;0;.00nan;0;0
7861;73274;637;81;34;2;32;.941;3668000;0
7862;186641;1813;93;50;4;46;.920;3900000;0
7862;-1;1813;0;0;0;0;.00nan;0;0
7862;67362;1814;53;34;4;30;.882;3900000;0
7862;156632;1814;0;0;0;0;.00nan;0;0
7863;17625;626;0;0;0;0;.00nan;0;0
7863;-1;639;0;0;0;0;.00nan;0;0
7863;190508;626;49;31;5;26;.839;3900000;0
7863;149969;639;69;42;5;37;.881;3900000;0
7864;1838;628;0;0;0;0;.00nan;0;0
7864;145079;642;0;0;0;0;.00nan;0;0
7864;151728;642;70;35;4;31;.886;3682000;0
7864;161336;628;91;33;3;30;.909;3682000;0
7865;11068;641;80;45;4;41;.911;3581000;0
7865;181431;636;60;17;2;15;.882;3600000;0
7865;38277;636;0;0;0;0;.00nan;0;0
7865;-1;641;0;0;0;0;.00nan;0;0
7866;177631;637;0;0;0;0;.00nan;0;0
7866;181431;636;67;25;2;23;.920;3600000;0
7866;38277;636;0;0;0;0;.00nan;0;0
7866;73274;637;73;21;1;20;.952;3600000;0
7867;168651;651;90;33;1;32;.970;3600000;0
7867;195761;651;0;0;0;0;.00nan;0;0
7867;67362;1814;57;19;2;17;.895;3600000;0
7867;156632;1814;0;0;0;0;.00nan;0;0
7868;22684;632;53;21;2;19;.905;3900000;0
7868;-1;632;0;0;0;0;.00nan;0;0
7868;145079;642;0;0;0;0;.00nan;0;0
7868;151728;642;73;31;2;29;.935;3900000;0
7869;162945;631;63;26;3;23;.885;3600000;0
7869;-1;639;0;0;0;0;.00nan;0;0
7869;144705;631;0;0;0;0;.00nan;0;0
7869;149969;639;66;34;4;30;.882;3580000;0
7870;1838;628;0;0;0;0;.00nan;0;0
7870;186641;1813;59;33;4;29;.879;3600000;0
7870;-1;1813;0;0;0;0;.00nan;0;0
7870;161336;628;86;40;2;38;.950;3600000;0
7871;11068;641;65;48;5;43;.896;3600000;0
7871;11851;625;55;17;2;15;.882;3600000;0
7871;-1;641;0;0;0;0;.00nan;0;0
7871;61683;625;0;0;0;0;.00nan;0;0
7872;17625;626;0;0;0;0;.00nan;0;0
7872;190508;626;79;29;3;26;.897;3600000;0
7872;43064;627;54;32;4;28;.875;3588000;0
7872;85468;627;0;0;0;0;.00nan;0;0
7873;22684;632;70;34;4;30;.882;3600000;0
7873;-1;632;0;0;0;0;.00nan;0;0
7873;186641;1813;40;27;5;22;.815;3587000;0
7873;-1;1813;0;0;0;0;.00nan;0;0
7874;177631;637;0;0;0;0;.00nan;0;0
7874;-1;639;0;0;0;0;.00nan;0;0
7874;73274;637;92;18;0;18;1.000;3600000;0
7874;149969;639;86;47;3;44;.936;3600000;0
7875;67362;1814;50;19;3;16;.842;3687000;0
7875;145079;642;0;0;0;0;.00nan;0;0
7875;151728;642;81;46;4;42;.913;3687000;0
7875;156632;1814;0;0;0;0;.00nan;0;0
7876;17625;626;80;26;1;25;.962;3600000;0
7876;190508;626;0;0;0;0;.00nan;0;0
7876;181431;636;62;24;2;22;.917;3569000;0
7876;38277;636;0;0;0;0;.00nan;0;0
7877;1838;628;92;21;0;21;1.000;3600000;0
7877;11068;641;90;38;2;36;.947;3581000;0
7877;-1;641;0;0;0;0;.00nan;0;0
7877;161336;628;0;0;0;0;.00nan;0;0
7878;162945;631;67;33;4;29;.879;3576000;0
7878;11851;625;63;30;3;27;.900;3600000;0
7878;61683;625;0;0;0;0;.00nan;0;0
7878;144705;631;0;0;0;0;.00nan;0;0
7879;168651;651;90;29;1;28;.966;3600000;0
7879;195761;651;0;0;0;0;.00nan;0;0
7879;43064;627;55;28;3;25;.893;3525000;0
7879;85468;627;0;0;0;0;.00nan;0;0
7880;162945;631;100;34;0;34;1.000;3600000;0
7880;67362;1814;55;34;5;29;.853;3600000;0
7880;144705;631;0;0;0;0;.00nan;0;0
7880;156632;1814;0;0;0;0;.00nan;0;0
7881;22684;632;71;26;1;25;.962;3600000;0
7881;-1;632;0;0;0;0;.00nan;0;0
7881;181431;636;0;0;0;0;.00nan;0;0
7881;38277;636;54;36;5;31;.861;3600000;0
7882;-1;639;0;0;0;0;.00nan;0;0
7882;43064;627;88;21;0;21;1.000;3600000;0
7882;85468;627;0;0;0;0;.00nan;0;0
7882;149969;639;78;41;4;37;.902;3600000;0
7883;177631;637;0;0;0;0;.00nan;0;0
7883;17625;626;0;0;0;0;.00nan;0;0
7883;190508;626;74;30;2;28;.933;3545000;0
7883;73274;637;81;22;1;21;.955;3600000;0
7884;11851;625;25;18;5;13;.722;3545000;0
7884;61683;625;0;0;0;0;.00nan;0;0
7884;145079;642;0;0;0;0;.00nan;0;0
7884;151728;642;83;44;4;40;.909;3600000;0
7885;1838;628;95;14;0;14;1.000;3600000;0
7885;168651;651;76;37;3;34;.919;3600000;0
7885;195761;651;0;0;0;0;.00nan;0;0
7885;161336;628;0;0;0;0;.00nan;0;0
7886;11068;641;0;0;0;0;.00nan;0;0
7886;-1;641;100;31;0;31;1.000;3600000;0
7886;186641;1813;67;28;3;25;.893;3600000;0
7886;-1;1813;0;0;0;0;.00nan;0;0
7887;1838;628;59;24;2;22;.917;3900000;0
7887;177631;637;0;0;0;0;.00nan;0;0
7887;73274;637;75;30;2;28;.933;3900000;0
7887;161336;628;0;0;0;0;.00nan;0;0
7888;181431;636;85;32;2;30;.938;3600000;0
7888;38277;636;0;0;0;0;.00nan;0;0
7888;67362;1814;41;36;6;30;.833;3600000;0
7888;156632;1814;0;0;0;0;.00nan;0;0
7889;162945;631;58;18;2;16;.889;3600000;0
7889;11068;641;86;35;1;34;.971;2885000;0
7889;-1;641;27;13;4;9;.692;715000;0
7889;144705;631;0;0;0;0;.00nan;0;0
7890;168651;651;10;23;7;16;.696;3002000;0
7890;195761;651;56;4;0;4;1.000;598000;0
7890;145079;642;0;0;0;0;.00nan;0;0
7890;151728;642;69;37;3;34;.919;3600000;0
7891;17625;626;100;26;0;26;1.000;3600000;0
7891;22684;632;78;30;2;28;.933;3583000;0
7891;-1;632;0;0;0;0;.00nan;0;0
7891;190508;626;0;0;0;0;.00nan;0;0
7892;186641;1813;32;36;7;29;.806;3600000;0
7892;-1;1813;0;0;0;0;.00nan;0;0
7892;43064;627;67;26;3;23;.885;3600000;0
7892;85468;627;0;0;0;0;.00nan;0;0
7893;11851;625;69;17;1;16;.941;3600000;0
7893;-1;639;0;0;0;0;.00nan;0;0
7893;61683;625;0;0;0;0;.00nan;0;0
7893;149969;639;77;49;6;43;.878;3600000;0
7894;162945;631;57;21;2;19;.905;3600000;0
7894;181431;636;56;31;4;27;.871;3583000;0
7894;38277;636;0;0;0;0;.00nan;0;0
7894;144705;631;0;0;0;0;.00nan;0;0
7895;168651;651;0;0;0;0;.00nan;0;0
7895;195761;651;74;29;2;27;.931;3546000;0
7895;186641;1813;100;47;1;46;.979;3600000;0
7895;-1;1813;0;0;0;0;.00nan;0;0
7896;11851;625;40;18;3;15;.833;3600000;0
7896;22684;632;93;35;2;33;.943;3600000;0
7896;-1;632;0;0;0;0;.00nan;0;0
7896;61683;625;0;0;0;0;.00nan;0;0
7897;17625;626;0;0;0;0;.00nan;0;0
7897;-1;639;0;0;0;0;.00nan;0;0
7897;190508;626;90;38;2;36;.947;3900000;0
7897;149969;639;98;39;2;37;.949;3900000;0
7898;1838;628;0;0;0;0;.00nan;0;0
7898;67362;1814;52;29;4;25;.862;3579000;0
7898;156632;1814;0;0;0;0;.00nan;0;0
7898;161336;628;76;32;3;29;.906;3600000;0
7899;11068;641;75;33;3;30;.909;3900000;0
7899;-1;641;0;0;0;0;.00nan;0;0
7899;145079;642;0;0;0;0;.00nan;0;0
7899;151728;642;60;32;3;29;.906;3900000;0
7900;177631;637;0;0;0;0;.00nan;0;0
7900;43064;627;57;18;2;16;.889;3600000;0
7900;73274;637;38;31;5;26;.839;3600000;0
7900;85468;627;0;0;0;0;.00nan;0;0
7901;162945;631;0;0;0;0;.00nan;0;0
7901;43064;627;78;31;2;29;.935;3600000;0
7901;85468;627;0;0;0;0;.00nan;0;0
7901;144705;631;51;22;3;19;.864;3555000;0
7902;17625;626;0;0;0;0;.00nan;0;0
7902;190508;626;98;36;1;35;.972;3900000;0
7902;181431;636;0;0;0;0;.00nan;0;0
7902;38277;636;100;37;1;36;.973;3900000;0
7903;177631;637;0;0;0;0;.00nan;0;0
7903;22684;632;39;28;5;23;.821;3600000;0
7903;-1;632;0;0;0;0;.00nan;0;0
7903;73274;637;85;27;1;26;.963;3600000;0
7904;11068;641;85;44;4;40;.909;3524000;0
7904;-1;641;0;0;0;0;.00nan;0;0
7904;67362;1814;0;0;0;0;.00nan;0;0
7904;156632;1814;76;31;2;29;.935;3600000;0
7905;168651;651;38;29;5;24;.828;3600000;0
7905;195761;651;0;0;0;0;.00nan;0;0
7905;-1;639;0;0;0;0;.00nan;0;0
7905;149969;639;86;35;2;33;.943;3600000;0
7906;1838;628;0;0;0;0;.00nan;0;0
7906;145079;642;0;0;0;0;.00nan;0;0
7906;151728;642;53;31;4;27;.871;3575000;0
7906;161336;628;58;23;3;20;.870;3600000;0
7907;11851;625;0;0;0;0;.00nan;0;0
7907;186641;1813;53;35;5;30;.857;3600000;0
7907;-1;1813;0;0;0;0;.00nan;0;0
7907;61683;625;69;20;1;19;.950;3600000;0
7908;1838;628;82;27;2;25;.926;3600000;0
7908;181431;636;64;31;3;28;.903;3572000;0
7908;38277;636;0;0;0;0;.00nan;0;0
7908;161336;628;0;0;0;0;.00nan;0;0
7909;-1;639;0;0;0;0;.00nan;0;0
7909;186641;1813;0;0;0;0;.00nan;0;0
7909;-1;1813;78;40;3;37;.925;3600000;0
7909;149969;639;54;29;4;25;.862;3600000;0
7910;162945;631;83;23;2;21;.913;3622000;0
7910;17625;626;100;35;1;34;.971;3622000;0
7910;190508;626;0;0;0;0;.00nan;0;0
7910;144705;631;0;0;0;0;.00nan;0;0
7911;11068;641;65;31;3;28;.903;2410000;0
7911;168651;651;67;40;5;35;.875;3600000;0
7911;195761;651;0;0;0;0;.00nan;0;0
7911;-1;641;34;15;4;11;.733;1166000;0
7912;177631;637;0;0;0;0;.00nan;0;0
7912;11851;625;83;26;1;25;.962;3600000;0
7912;61683;625;0;0;0;0;.00nan;0;0
7912;73274;637;66;25;3;22;.880;3530000;0
7913;22684;632;86;40;3;37;.925;3544000;0
7913;-1;632;0;0;0;0;.00nan;0;0
7913;43064;627;100;39;2;37;.949;3600000;0
7913;85468;627;0;0;0;0;.00nan;0;0
7914;162945;631;76;22;1;21;.955;3600000;0
7914;168651;651;42;29;5;24;.828;3600000;0
7914;195761;651;0;0;0;0;.00nan;0;0
7914;144705;631;0;0;0;0;.00nan;0;0
7915;67362;1814;73;26;1;25;.962;3600000;0
7915;145079;642;0;0;0;0;.00nan;0;0
7915;151728;642;72;43;4;39;.907;3600000;0
7915;156632;1814;0;0;0;0;.00nan;0;0
7916;1838;628;0;0;0;0;.00nan;0;0
7916;43064;627;41;38;6;32;.842;3277000;0
7916;85468;627;32;3;2;1;.333;323000;0
7916;161336;628;100;34;0;34;1.000;3600000;0
7917;177631;637;0;0;0;0;.00nan;0;0
7917;73274;637;64;12;1;11;.917;3600000;0
7917;145079;642;0;0;0;0;.00nan;0;0
7917;151728;642;93;49;3;46;.939;3558000;0
7918;17625;626;92;39;2;37;.949;3900000;0
7918;190508;626;0;0;0;0;.00nan;0;0
7918;67362;1814;87;29;2;27;.931;3900000;0
7918;156632;1814;0;0;0;0;.00nan;0;0
7919;162945;631;88;32;2;30;.938;3600000;0
7919;11851;625;49;23;4;19;.826;3543000;0
7919;61683;625;0;0;0;0;.00nan;0;0
7919;144705;631;0;0;0;0;.00nan;0;0
7920;168651;651;71;30;3;27;.900;3900000;0
7920;195761;651;0;0;0;0;.00nan;0;0
7920;181431;636;0;0;0;0;.00nan;0;0
7920;38277;636;57;28;3;25;.893;3900000;0
7921;11068;641;0;0;0;0;.00nan;0;0
7921;-1;641;80;33;2;31;.939;3600000;0
7921;186641;1813;41;24;4;20;.833;3563000;0
7921;-1;1813;0;0;0;0;.00nan;0;0
7922;22684;632;70;27;3;24;.889;3600000;0
7922;-1;639;0;0;0;0;.00nan;0;0
7922;-1;632;0;0;0;0;.00nan;0;0
7922;149969;639;65;44;5;39;.886;3580000;0
7923;186641;1813;85;41;4;37;.902;3600000;0
7923;-1;1813;0;0;0;0;.00nan;0;0
7923;67362;1814;55;23;3;20;.870;3600000;0
7923;156632;1814;0;0;0;0;.00nan;0;0
7924;1838;628;77;21;1;20;.952;3587000;0
7924;-1;639;0;0;0;0;.00nan;0;0
7924;149969;639;100;32;0;32;1.000;3600000;0
7924;161336;628;0;0;0;0;.00nan;0;0
7925;17625;626;78;37;2;35;.946;3900000;0
7925;22684;632;93;28;2;26;.929;3900000;0
7925;-1;632;0;0;0;0;.00nan;0;0
7925;190508;626;0;0;0;0;.00nan;0;0
7926;177631;637;0;0;0;0;.00nan;0;0
7926;11068;641;100;44;2;42;.955;3900000;0
7926;-1;641;0;0;0;0;.00nan;0;0
7926;73274;637;71;27;2;25;.926;3900000;0
7927;11851;625;35;10;3;7;.700;3900000;0
7927;61683;625;0;0;0;0;.00nan;0;0
7927;145079;642;0;0;0;0;.00nan;0;0
7927;151728;642;85;46;3;43;.935;3900000;0
7928;181431;636;56;26;3;23;.885;3600000;0
7928;38277;636;0;0;0;0;.00nan;0;0
7928;43064;627;0;0;0;0;.00nan;0;0
7928;85468;627;56;35;5;30;.857;3600000;0
7929;17625;626;0;0;0;0;.00nan;0;0
7929;190508;626;68;25;2;23;.920;3900000;0
7929;145079;642;73;31;2;29;.935;3900000;0
7929;151728;642;0;0;0;0;.00nan;0;0
7930;11068;641;74;37;3;34;.919;3600000;0
7930;-1;641;0;0;0;0;.00nan;0;0
7930;43064;627;97;22;0;22;1.000;3600000;0
7930;85468;627;0;0;0;0;.00nan;0;0
7931;11851;625;100;27;0;27;1.000;3600000;0
7931;168651;651;71;26;2;24;.923;3562000;0
7931;195761;651;0;0;0;0;.00nan;0;0
7931;61683;625;0;0;0;0;.00nan;0;0
7932;-1;639;0;0;0;0;.00nan;0;0
7932;181431;636;0;0;0;0;.00nan;0;0
7932;38277;636;80;47;4;43;.915;3554000;0
7932;149969;639;62;31;3;28;.903;3600000;0
7933;162945;631;79;32;2;30;.938;3600000;0
7933;22684;632;33;19;4;15;.789;3600000;0
7933;-1;632;0;0;0;0;.00nan;0;0
7933;144705;631;0;0;0;0;.00nan;0;0
7934;1838;628;0;0;0;0;.00nan;0;0
7934;11851;625;83;25;1;24;.960;3900000;0
7934;61683;625;0;0;0;0;.00nan;0;0
7934;161336;628;88;33;1;32;.970;3900000;0
7935;43064;627;90;26;1;25;.962;3600000;0
7935;67362;1814;0;0;0;0;.00nan;0;0
7935;85468;627;0;0;0;0;.00nan;0;0
7935;156632;1814;58;28;3;25;.893;3600000;0
7936;177631;637;0;0;0;0;.00nan;0;0
7936;168651;651;51;39;6;33;.846;3600000;0
7936;195761;651;0;0;0;0;.00nan;0;0
7936;73274;637;82;37;3;34;.919;3600000;0
7937;11068;641;54;31;4;27;.871;3600000;0
7937;17625;626;0;0;0;0;.00nan;0;0
7937;190508;626;75;22;1;21;.955;3600000;0
7937;-1;641;0;0;0;0;.00nan;0;0
7938;186641;1813;70;34;3;31;.912;3623000;0
7938;-1;1813;0;0;0;0;.00nan;0;0
7938;145079;642;0;0;0;0;.00nan;0;0
7938;151728;642;79;30;2;28;.933;3623000;0
7939;1838;628;92;43;2;41;.953;3577000;0
7939;162945;631;0;0;0;0;.00nan;0;0
7939;144705;631;78;27;1;26;.963;3600000;0
7939;161336;628;0;0;0;0;.00nan;0;0
7940;177631;637;0;0;0;0;.00nan;0;0
7940;17625;626;80;32;2;30;.938;3900000;0
7940;190508;626;0;0;0;0;.00nan;0;0
7940;73274;637;74;24;2;22;.917;3900000;0
7941;168651;651;100;33;0;33;1.000;3600000;0
7941;22684;632;30;25;6;19;.760;3600000;0
7941;195761;651;0;0;0;0;.00nan;0;0
7941;-1;632;0;0;0;0;.00nan;0;0
7942;181431;636;100;41;0;41;1.000;3600000;0
7942;38277;636;0;0;0;0;.00nan;0;0
7942;186641;1813;77;31;2;29;.935;3579000;0
7942;-1;1813;0;0;0;0;.00nan;0;0
7943;-1;639;0;0;0;0;.00nan;0;0
7943;67362;1814;72;23;1;22;.957;3600000;0
7943;149969;639;76;38;3;35;.921;3515000;0
7943;156632;1814;0;0;0;0;.00nan;0;0
7944;11068;641;96;44;2;42;.955;3600000;0
7944;11851;625;54;19;3;16;.842;3597000;0
7944;-1;641;0;0;0;0;.00nan;0;0
7944;61683;625;0;0;0;0;.00nan;0;0
7945;43064;627;56;25;4;21;.840;3561000;0
7945;85468;627;0;0;0;0;.00nan;0;0
7945;145079;642;0;0;0;0;.00nan;0;0
7945;151728;642;89;52;3;49;.942;3600000;0
7946;162945;631;47;25;4;21;.840;3600000;0
7946;-1;639;28;9;3;6;.667;291000;0
7946;144705;631;0;0;0;0;.00nan;0;0
7946;149969;639;61;41;5;36;.878;3309000;0
7947;168651;651;61;27;4;23;.852;3600000;0
7947;195761;651;0;0;0;0;.00nan;0;0
7947;145079;642;50;1;0;1;1.000;266000;0
7947;151728;642;34;35;6;29;.829;3305000;0
7948;17625;626;32;23;5;18;.783;2587000;0
7948;190508;626;19;8;4;4;.500;1013000;0
7948;43064;627;100;30;1;29;.967;3600000;0
7948;85468;627;0;0;0;0;.00nan;0;0
7949;11068;641;63;38;4;34;.895;3900000;0
7949;181431;636;45;22;4;18;.818;3900000;0
7949;38277;636;0;0;0;0;.00nan;0;0
7949;-1;641;0;0;0;0;.00nan;0;0
7950;162945;631;34;27;5;22;.815;3600000;0
7950;67362;1814;100;28;0;28;1.000;3600000;0
7950;144705;631;0;0;0;0;.00nan;0;0
7950;156632;1814;0;0;0;0;.00nan;0;0
7951;177631;637;0;0;0;0;.00nan;0;0
7951;186641;1813;62;32;3;29;.906;3571000;0
7951;-1;1813;0;0;0;0;.00nan;0;0
7951;73274;637;50;15;2;13;.867;3600000;0
7952;1838;628;72;30;2;28;.933;3585000;0
7952;22684;632;79;30;1;29;.967;3599000;0
7952;-1;632;0;0;0;0;.00nan;0;0
7952;161336;628;0;0;0;0;.00nan;0;0
7953;11851;625;63;23;2;21;.913;3600000;0
7953;-1;639;0;0;0;0;.00nan;0;0
7953;61683;625;0;0;0;0;.00nan;0;0
7953;149969;639;80;54;5;49;.907;3600000;0
7954;22684;632;74;29;2;27;.931;3600000;0
7954;-1;632;0;0;0;0;.00nan;0;0
7954;181431;636;0;0;0;0;.00nan;0;0
7954;38277;636;56;26;4;22;.846;3521000;0
7955;177631;637;61;22;2;20;.909;3600000;0
7955;-1;639;0;0;0;0;.00nan;0;0
7955;73274;637;0;0;0;0;.00nan;0;0
7955;149969;639;64;39;5;34;.872;3600000;0
7956;162945;631;0;0;0;0;.00nan;0;0
7956;144705;631;66;24;2;22;.917;3536000;0
7956;145079;642;0;0;0;0;.00nan;0;0
7956;151728;642;100;29;0;29;1.000;3600000;0
7957;17625;626;0;0;0;0;.00nan;0;0
7957;168651;651;100;38;0;38;1.000;3600000;0
7957;195761;651;0;0;0;0;.00nan;0;0
7957;190508;626;79;24;1;23;.958;3561000;0
7958;1838;628;75;23;1;22;.957;3561000;0
7958;11068;641;0;0;0;0;.00nan;0;0
7958;-1;641;100;43;0;43;1.000;3600000;0
7958;161336;628;0;0;0;0;.00nan;0;0
7959;11851;625;56;29;4;25;.862;3600000;0
7959;61683;625;0;0;0;0;.00nan;0;0
7959;67362;1814;100;38;1;37;.974;3600000;0
7959;156632;1814;0;0;0;0;.00nan;0;0
7960;186641;1813;97;53;1;52;.981;3600000;0
7960;-1;1813;0;0;0;0;.00nan;0;0
7960;43064;627;61;18;2;16;.889;3553000;0
7960;85468;627;0;0;0;0;.00nan;0;0
7961;22684;632;0;0;0;0;.00nan;0;0
7961;-1;632;46;22;4;18;.818;3548000;0
7961;67362;1814;71;31;2;29;.935;3600000;0
7961;156632;1814;0;0;0;0;.00nan;0;0
7962;1838;628;0;0;0;0;.00nan;0;0
7962;186641;1813;83;43;4;39;.907;3600000;0
7962;-1;1813;0;0;0;0;.00nan;0;0
7962;161336;628;91;25;1;24;.960;3600000;0
7963;177631;637;0;0;0;0;.00nan;0;0
7963;181431;636;0;0;0;0;.00nan;0;0
7963;38277;636;98;39;1;38;.974;3600000;0
7963;73274;637;100;23;0;23;1.000;3600000;0
7964;11851;625;68;24;2;22;.917;3753000;0
7964;181431;636;62;27;3;24;.889;3753000;0
7964;38277;636;0;0;0;0;.00nan;0;0
7964;61683;625;0;0;0;0;.00nan;0;0
7965;177631;637;0;0;0;0;.00nan;0;0
7965;67362;1814;92;36;2;34;.944;3589000;0
7965;73274;637;99;33;1;32;.970;3600000;0
7965;156632;1814;0;0;0;0;.00nan;0;0
7966;22684;632;74;22;1;21;.955;3900000;0
7966;-1;632;0;0;0;0;.00nan;0;0
7966;186641;1813;75;23;1;22;.957;3900000;0
7966;-1;1813;0;0;0;0;.00nan;0;0
7967;-1;639;0;0;0;0;.00nan;0;0
7967;145079;642;0;0;0;0;.00nan;0;0
7967;149969;639;80;34;3;31;.912;3600000;0
7967;151728;642;72;24;2;22;.917;3600000;0
7968;1838;628;87;36;2;34;.944;3600000;0
7968;17625;626;0;0;0;0;.00nan;0;0
7968;190508;626;68;33;3;30;.909;3578000;0
7968;161336;628;0;0;0;0;.00nan;0;0
7969;162945;631;52;24;3;21;.875;3600000;0
7969;11068;641;0;0;0;0;.00nan;0;0
7969;-1;641;83;50;4;46;.920;3543000;0
7969;144705;631;0;0;0;0;.00nan;0;0
7970;168651;651;37;26;5;21;.808;3559000;0
7970;195761;651;0;0;0;0;.00nan;0;0
7970;43064;627;78;43;4;39;.907;3600000;0
7970;85468;627;0;0;0;0;.00nan;0;0
7971;162945;631;48;28;4;24;.857;3600000;0
7971;177631;637;0;0;0;0;.00nan;0;0
7971;73274;637;25;20;5;15;.750;3572000;0
7971;144705;631;0;0;0;0;.00nan;0;0
7972;181431;636;0;0;0;0;.00nan;0;0
7972;38277;636;82;24;1;23;.958;3600000;0
7972;67362;1814;0;0;0;0;.00nan;0;0
7972;156632;1814;58;19;3;16;.842;3559000;0
7973;22684;632;95;33;2;31;.939;3600000;0
7973;-1;632;0;0;0;0;.00nan;0;0
7973;145079;642;0;0;0;0;.00nan;0;0
7973;151728;642;71;40;4;36;.900;3565000;0
7974;17625;626;67;29;3;26;.897;3600000;0
7974;190508;626;0;0;0;0;.00nan;0;0
7974;186641;1813;0;0;0;0;.00nan;0;0
7974;-1;1813;65;35;4;31;.886;3563000;0
7975;11068;641;38;33;5;28;.848;3516000;0
7975;-1;639;0;0;0;0;.00nan;0;0
7975;-1;641;0;0;0;0;.00nan;0;0
7975;149969;639;75;27;3;24;.889;3600000;0
7976;1838;628;0;0;0;0;.00nan;0;0
7976;168651;651;72;36;4;32;.889;3565000;0
7976;195761;651;0;0;0;0;.00nan;0;0
7976;161336;628;84;29;2;27;.931;3600000;0
7977;11851;625;63;18;2;16;.889;3600000;0
7977;43064;627;70;35;4;31;.886;3600000;0
7977;61683;625;0;0;0;0;.00nan;0;0
7977;85468;627;0;0;0;0;.00nan;0;0
7986;181431;636;73;23;1;22;.957;3600000;0
7986;38277;636;0;0;0;0;.00nan;0;0
7986;186641;1813;88;50;3;47;.940;3546000;0
7986;-1;1813;0;0;0;0;.00nan;0;0
7988;162945;631;86;31;1;30;.968;3600000;0
7988;11068;641;0;0;0;0;.00nan;0;0
7988;-1;641;78;40;2;38;.950;3543000;0
7988;144705;631;0;0;0;0;.00nan;0;0
7990;22684;632;50;31;4;27;.871;3600000;0
7990;-1;632;0;0;0;0;.00nan;0;0
7990;145079;642;0;0;0;0;.00nan;0;0
7990;151728;642;100;26;0;26;1.000;3600000;0
7992;11851;625;64;24;2;22;.917;3900000;0
7992;17625;626;0;0;0;0;.00nan;0;0
7992;190508;626;96;57;2;55;.965;3900000;0
7992;61683;625;0;0;0;0;.00nan;0;0
7994;177631;637;0;0;0;0;.00nan;0;0
7994;67362;1814;51;22;3;19;.864;3586000;0
7994;73274;637;97;49;2;47;.959;3600000;0
7994;156632;1814;0;0;0;0;.00nan;0;0
7996;1838;628;0;0;0;0;.00nan;0;0
7996;-1;639;0;0;0;0;.00nan;0;0
7996;149969;639;76;47;5;42;.894;3600000;0
7996;161336;628;73;27;2;25;.926;3600000;0
7998;168651;651;67;16;1;15;.938;3600000;0
7998;195761;651;0;0;0;0;.00nan;0;0
7998;43064;627;58;36;3;33;.917;3585000;0
7998;152851;627;0;0;0;0;.00nan;0;0
8000;177631;637;78;33;2;31;.939;3565000;0
8000;67362;1814;0;0;0;0;.00nan;0;0
8000;73274;637;0;0;0;0;.00nan;0;0
8000;156632;1814;81;27;1;26;.963;3600000;0
8002;11851;625;0;0;0;0;.00nan;0;0
8002;-1;639;42;38;6;32;.842;3600000;0
8002;61683;625;56;20;2;18;.900;3600000;0
8002;149969;639;0;0;0;0;.00nan;0;0
8004;11068;641;55;37;4;33;.892;3600000;0
8004;-1;641;0;0;0;0;.00nan;0;0
8004;145079;642;0;0;0;0;.00nan;0;0
8004;151728;642;48;14;2;12;.857;3600000;0
8006;17625;626;72;39;5;34;.872;3544000;0
8006;190508;626;0;0;0;0;.00nan;0;0
8006;43064;627;0;0;0;0;.00nan;0;0
8006;152851;627;41;17;4;13;.765;3600000;0
8008;181431;636;0;0;0;0;.00nan;0;0
8008;38277;636;45;18;3;15;.833;3532000;0
8008;186641;1813;90;29;1;28;.966;3600000;0
8008;-1;1813;0;0;0;0;.00nan;0;0
8010;1838;628;61;26;3;23;.885;3695000;0
8010;168651;651;93;33;2;31;.939;3695000;0
8010;195761;651;0;0;0;0;.00nan;0;0
8010;161336;628;0;0;0;0;.00nan;0;0
8012;162945;631;0;0;0;0;.00nan;0;0
8012;22684;632;0;0;0;0;.00nan;0;0
8012;-1;632;93;43;1;42;.977;3600000;0
8012;144705;631;78;27;2;25;.926;3570000;0
8016;-1;639;0;0;0;0;.00nan;0;0
8016;186641;1813;86;28;1;27;.964;3600000;0
8016;-1;1813;0;0;0;0;.00nan;0;0
8016;149969;639;86;35;2;33;.943;3589000;0
8018;1838;628;63;37;4;33;.892;3570000;0
8018;11851;625;63;22;2;20;.909;3600000;0
8018;61683;625;0;0;0;0;.00nan;0;0
8018;161336;628;0;0;0;0;.00nan;0;0
8020;11068;641;99;44;1;43;.977;3617000;0
8020;-1;641;0;0;0;0;.00nan;0;0
8020;145079;642;74;28;2;26;.929;3617000;0
8020;151728;642;0;0;0;0;.00nan;0;0
8022;162945;631;95;38;2;36;.947;3900000;0
8022;43064;627;72;28;2;26;.929;3900000;0
8022;144705;631;0;0;0;0;.00nan;0;0
8022;152851;627;0;0;0;0;.00nan;0;0
8028;22684;632;61;24;2;22;.917;3573000;0
8028;-1;632;0;0;0;0;.00nan;0;0
8028;67362;1814;90;30;1;29;.967;3600000;0
8028;156632;1814;0;0;0;0;.00nan;0;0
8034;17625;626;0;0;0;0;.00nan;0;0
8034;-1;639;100;48;2;46;.958;3600000;0
8034;190508;626;50;23;3;20;.870;3569000;0
8034;149969;639;0;0;0;0;.00nan;0;0
8038;1838;628;0;0;0;0;.00nan;0;0
8038;145079;642;0;0;0;0;.00nan;0;0
8038;151728;642;79;47;4;43;.915;3600000;0
8038;161336;628;73;22;1;21;.955;3600000;0
8040;162945;631;85;31;2;29;.935;3600000;0
8040;174209;631;0;0;0;0;.00nan;0;0
8040;86429;627;0;0;0;0;.00nan;0;0
8040;152851;627;54;25;3;22;.880;3600000;0
8042;17625;626;0;0;0;0;.00nan;0;0
8042;190508;626;100;29;0;29;1.000;3600000;0
8042;86429;627;0;0;0;0;.00nan;0;0
8042;152851;627;75;34;2;32;.941;3581000;0
8048;11068;641;70;18;1;17;.944;3600000;0
8048;-1;641;0;0;0;0;.00nan;0;0
8048;186641;1813;69;37;3;34;.919;3567000;0
8048;-1;1813;0;0;0;0;.00nan;0;0
8052;1838;628;83;28;1;27;.964;3600000;0
8052;162945;631;0;0;0;0;.00nan;0;0
8052;174209;631;43;29;5;24;.828;3600000;0
8052;161336;628;0;0;0;0;.00nan;0;0
8054;22684;632;58;18;2;16;.889;3600000;0
8054;-1;632;0;0;0;0;.00nan;0;0
8054;145079;642;52;42;5;37;.881;3600000;0
8054;151728;642;0;0;0;0;.00nan;0;0
8060;186641;1813;0;0;0;0;.00nan;0;0
8060;-1;1813;39;15;3;12;.800;3585000;0
8060;145079;642;0;0;0;0;.00nan;0;0
8060;151728;642;92;41;2;39;.951;3600000;0
8062;162945;631;64;35;3;32;.914;3520000;0
8062;174209;631;0;0;0;0;.00nan;0;0
8062;86429;627;82;25;1;24;.960;3600000;0
8062;152851;627;0;0;0;0;.00nan;0;0
8064;11068;641;0;0;0;0;.00nan;0;0
8064;-1;641;45;42;6;36;.857;3600000;0
8064;67362;1814;53;26;4;22;.846;3600000;0
8064;156632;1814;0;0;0;0;.00nan;0;0
8068;1838;628;0;0;0;0;.00nan;0;0
8068;22684;632;76;26;1;25;.962;3594000;0
8068;-1;632;27;7;3;4;.571;306000;0
8068;161336;628;75;38;4;34;.895;3900000;0
8074;17625;626;0;0;0;0;.00nan;0;0
8074;190508;626;61;15;1;14;.933;3600000;0
8074;145079;642;0;0;0;0;.00nan;0;0
8074;151728;642;69;38;4;34;.895;3600000;0
8078;22684;632;69;25;2;23;.920;3600000;0
8078;-1;639;0;0;0;0;.00nan;0;0
8078;-1;632;0;0;0;0;.00nan;0;0
8078;149969;639;51;44;6;38;.864;3600000;0
8080;11068;641;100;34;0;34;1.000;3600000;0
8080;-1;641;0;0;0;0;.00nan;0;0
8080;43064;627;47;26;4;22;.846;3600000;0
8080;152851;627;0;0;0;0;.00nan;0;0
8082;1838;628;0;0;0;0;.00nan;0;0
8082;186641;1813;87;43;3;40;.930;3900000;0
8082;-1;1813;0;0;0;0;.00nan;0;0
8082;161336;628;42;18;3;15;.833;3900000;0
8083;183545;842;0;0;0;0;.00nan;0;0
8083;23433;842;67;35;4;31;.886;3600000;0
8083;174334;832;0;0;0;0;.00nan;0;0
8083;78920;832;78;24;1;23;.958;3600000;0
8084;180731;837;61;34;4;30;.882;3600000;0
8084;180929;837;0;0;0;0;.00nan;0;0
8084;78094;831;0;0;0;0;.00nan;0;0
8084;148041;831;47;33;5;28;.848;3551000;0
8085;5663;836;0;0;0;0;.00nan;0;0
8085;174334;832;0;0;0;0;.00nan;0;0
8085;182116;836;95;40;1;39;.975;3900000;0
8085;78920;832;95;30;1;29;.967;3900000;0
8086;8501;848;51;16;2;14;.875;3581000;0
8086;183545;842;0;0;0;0;.00nan;0;0
8086;23433;842;100;31;0;31;1.000;3600000;0
8086;47736;848;0;0;0;0;.00nan;0;0
8087;26336;829;0;0;0;0;.00nan;0;0
8087;53867;829;93;49;3;46;.939;3593000;0
8087;68390;834;61;17;1;16;.941;3600000;0
8087;147901;834;0;0;0;0;.00nan;0;0
8088;30431;839;0;0;0;0;.00nan;0;0
8088;180287;847;57;32;4;28;.875;3900000;0
8088;78223;839;57;28;4;24;.857;3900000;0
8088;87603;847;0;0;0;0;.00nan;0;0
8089;2410;838;76;43;4;39;.907;3736000;0
8089;16838;830;0;0;0;0;.00nan;0;0
8089;47791;830;44;18;3;15;.833;3736000;0
8089;57657;838;0;0;0;0;.00nan;0;0
8090;167824;828;55;41;5;36;.878;3575000;0
8090;48141;828;0;0;0;0;.00nan;0;0
8090;54017;833;35;23;4;19;.826;3600000;0
8090;62975;833;0;0;0;0;.00nan;0;0
8091;8501;848;70;27;2;25;.926;3600000;0
8091;167824;828;28;8;3;5;.625;240000;0
8091;47736;848;0;0;0;0;.00nan;0;0
8091;48141;828;90;32;1;31;.969;3335000;0
8092;16838;830;70;30;3;27;.900;3590000;0
8092;180287;847;85;32;2;30;.938;3600000;0
8092;47791;830;0;0;0;0;.00nan;0;0
8092;87603;847;0;0;0;0;.00nan;0;0
8093;2410;838;94;36;1;35;.972;3600000;0
8093;180731;837;0;0;0;0;.00nan;0;0
8093;180929;837;51;20;3;17;.850;3536000;0
8093;57657;838;0;0;0;0;.00nan;0;0
8094;183545;842;0;0;0;0;.00nan;0;0
8094;23433;842;86;46;3;43;.935;3881000;0
8094;30431;839;51;24;3;21;.875;3900000;0
8094;78223;839;0;0;0;0;.00nan;0;0
8095;174334;832;24;21;5;16;.762;3600000;0
8095;68390;834;23;25;6;19;.760;2933000;0
8095;78920;832;0;0;0;0;.00nan;0;0
8095;147901;834;48;7;1;6;.857;648000;0
8096;26336;829;46;32;6;26;.813;3600000;0
8096;53867;829;0;0;0;0;.00nan;0;0
8096;54017;833;0;0;0;0;.00nan;0;0
8096;62975;833;84;26;1;25;.962;3600000;0
8097;5663;836;0;0;0;0;.00nan;0;0
8097;182116;836;98;40;2;38;.950;3600000;0
8097;78094;831;0;0;0;0;.00nan;0;0
8097;148041;831;77;33;3;30;.909;3593000;0
8098;183545;842;0;0;0;0;.00nan;0;0
8098;23433;842;97;55;3;52;.945;3600000;0
8098;180731;837;0;0;0;0;.00nan;0;0
8098;180929;837;85;24;1;23;.958;3600000;0
8099;2410;838;74;42;5;37;.881;3576000;0
8099;5663;836;70;31;3;28;.903;3600000;0
8099;182116;836;0;0;0;0;.00nan;0;0
8099;57657;838;0;0;0;0;.00nan;0;0
8100;8501;848;57;32;4;28;.875;3600000;0
8100;47736;848;0;0;0;0;.00nan;0;0
8100;68390;834;0;0;0;0;.00nan;0;0
8100;147901;834;82;30;1;29;.967;3600000;0
8101;174334;832;0;0;0;0;.00nan;0;0
8101;26336;829;78;35;4;31;.886;3600000;0
8101;53867;829;0;0;0;0;.00nan;0;0
8101;78920;832;57;21;3;18;.857;3600000;0
8102;167824;828;54;34;5;29;.853;3600000;0
8102;30431;839;54;20;2;18;.900;3600000;0
8102;48141;828;0;0;0;0;.00nan;0;0
8102;78223;839;0;0;0;0;.00nan;0;0
8103;16838;830;77;48;5;43;.896;3581000;0
8103;47791;830;0;0;0;0;.00nan;0;0
8103;78094;831;45;23;4;19;.826;3600000;0
8103;148041;831;0;0;0;0;.00nan;0;0
8104;180287;847;57;41;5;36;.878;3600000;0
8104;54017;833;0;0;0;0;.00nan;0;0
8104;62975;833;86;17;0;17;1.000;3600000;0
8104;87603;847;0;0;0;0;.00nan;0;0
8105;167824;828;71;27;3;24;.889;3600000;0
8105;180287;847;80;33;1;32;.970;3600000;0
8105;48141;828;0;0;0;0;.00nan;0;0
8105;87603;847;0;0;0;0;.00nan;0;0
8106;16838;830;81;40;3;37;.925;3551000;0
8106;180731;837;0;0;0;0;.00nan;0;0
8106;180929;837;96;30;1;29;.967;3600000;0
8106;47791;830;0;0;0;0;.00nan;0;0
8107;5663;836;0;0;0;0;.00nan;0;0
8107;182116;836;55;42;6;36;.857;3600000;0
8107;68390;834;75;30;2;28;.933;3600000;0
8107;147901;834;0;0;0;0;.00nan;0;0
8108;8501;848;0;0;0;0;.00nan;0;0
8108;47736;848;70;23;2;21;.913;3900000;0
8108;78094;831;0;0;0;0;.00nan;0;0
8108;148041;831;63;28;2;26;.929;3900000;0
8109;2410;838;19;20;6;14;.700;2762000;0
8109;174334;832;0;0;0;0;.00nan;0;0
8109;57657;838;52;3;0;3;1.000;760000;0
8109;78920;832;74;42;4;38;.905;3600000;0
8110;183545;842;0;0;0;0;.00nan;0;0
8110;23433;842;97;44;1;43;.977;3900000;0
8110;26336;829;92;29;1;28;.966;3900000;0
8110;53867;829;0;0;0;0;.00nan;0;0
8111;8501;848;89;28;1;27;.964;3600000;0
8111;180287;847;0;0;0;0;.00nan;0;0
8111;47736;848;0;0;0;0;.00nan;0;0
8111;87603;847;61;38;5;33;.868;3600000;0
8112;180731;837;21;13;5;8;.615;1100000;0
8112;180929;837;46;30;4;26;.867;2500000;0
8112;68390;834;0;0;0;0;.00nan;0;0
8112;147901;834;99;38;1;37;.974;3600000;0
8113;174334;832;49;23;3;20;.870;3600000;0
8113;30431;839;84;34;2;32;.941;3600000;0
8113;78223;839;0;0;0;0;.00nan;0;0
8113;78920;832;0;0;0;0;.00nan;0;0
8114;2410;838;76;24;1;23;.958;1104000;0
8114;57657;838;47;33;6;27;.818;2496000;0
8114;78094;831;38;22;4;18;.818;3600000;0
8114;148041;831;0;0;0;0;.00nan;0;0
8115;167824;828;54;28;4;24;.857;3600000;0
8115;26336;829;0;0;0;0;.00nan;0;0
8115;48141;828;0;0;0;0;.00nan;0;0
8115;53867;829;40;29;6;23;.793;3544000;0
8116;5663;836;50;27;4;23;.852;3544000;0
8116;16838;830;0;0;0;0;.00nan;0;0
8116;182116;836;0;0;0;0;.00nan;0;0
8116;47791;830;67;28;3;25;.893;3600000;0
8117;183545;842;61;48;7;41;.854;3600000;0
8117;23433;842;0;0;0;0;.00nan;0;0
8117;54017;833;0;0;0;0;.00nan;0;0
8117;62975;833;72;19;1;18;.947;3600000;0
8118;30431;839;0;0;0;0;.00nan;0;0
8118;54017;833;53;21;3;18;.857;3600000;0
8118;62975;833;0;0;0;0;.00nan;0;0
8118;78223;839;50;38;5;33;.868;3600000;0
8119;174334;832;0;0;0;0;.00nan;0;0
8119;180731;837;0;0;0;0;.00nan;0;0
8119;180929;837;72;25;2;23;.920;3600000;0
8119;78920;832;71;44;4;40;.909;3594000;0
8120;5663;836;0;0;0;0;.00nan;0;0
8120;182116;836;81;34;2;32;.941;3750000;0
8120;54017;833;0;0;0;0;.00nan;0;0
8120;62975;833;78;38;3;35;.921;3750000;0
8121;8501;848;93;30;1;29;.967;3600000;0
8121;26336;829;32;29;6;23;.793;2663000;0
8121;47736;848;0;0;0;0;.00nan;0;0
8121;53867;829;40;7;2;5;.714;937000;0
8122;2410;838;91;26;1;25;.962;3600000;0
8122;167824;828;30;24;5;19;.792;3600000;0
8122;48141;828;0;0;0;0;.00nan;0;0
8122;57657;838;0;0;0;0;.00nan;0;0
8123;183545;842;0;0;0;0;.00nan;0;0
8123;23433;842;100;42;2;40;.952;3900000;0
8123;180287;847;80;29;2;27;.931;3900000;0
8123;87603;847;0;0;0;0;.00nan;0;0
8124;68390;834;78;43;4;39;.907;3555000;0
8124;78094;831;0;0;0;0;.00nan;0;0
8124;147901;834;0;0;0;0;.00nan;0;0
8124;148041;831;66;24;3;21;.875;3600000;0
8125;16838;830;99;46;2;44;.957;3600000;0
8125;30431;839;55;32;4;28;.875;3600000;0
8125;47791;830;0;0;0;0;.00nan;0;0
8125;78223;839;0;0;0;0;.00nan;0;0
8126;174334;832;86;28;1;27;.964;3600000;0
8126;54017;833;69;35;4;31;.886;3600000;0
8126;62975;833;0;0;0;0;.00nan;0;0
8126;78920;832;0;0;0;0;.00nan;0;0
8127;5663;836;0;0;0;0;.00nan;0;0
8127;167824;828;56;26;3;23;.885;3563000;0
8127;182116;836;77;25;2;23;.920;3600000;0
8127;48141;828;0;0;0;0;.00nan;0;0
8128;180287;847;59;36;5;31;.861;3564000;0
8128;68390;834;50;30;4;26;.867;3600000;0
8128;87603;847;0;0;0;0;.00nan;0;0
8128;147901;834;0;0;0;0;.00nan;0;0
8129;183545;842;81;15;0;15;1.000;890000;0
8129;16838;830;50;32;5;27;.844;3600000;0
8129;23433;842;34;30;6;24;.800;2694000;0
8129;47791;830;0;0;0;0;.00nan;0;0
8130;30431;839;58;43;5;38;.884;3577000;0
8130;180731;837;49;22;3;19;.864;3600000;0
8130;180929;837;0;0;0;0;.00nan;0;0
8130;78223;839;0;0;0;0;.00nan;0;0
8131;26336;829;0;0;0;0;.00nan;0;0
8131;53867;829;65;30;3;27;.900;3600000;0
8131;78094;831;0;0;0;0;.00nan;0;0
8131;148041;831;54;27;4;23;.852;3562000;0
8132;2410;838;92;47;3;44;.936;3655000;0
8132;54017;833;0;0;0;0;.00nan;0;0
8132;57657;838;0;0;0;0;.00nan;0;0
8132;62975;833;70;23;2;21;.913;3655000;0
8133;8501;848;63;26;2;24;.923;3600000;0
8133;180731;837;0;0;0;0;.00nan;0;0
8133;180929;837;54;28;4;24;.857;3524000;0
8133;47736;848;0;0;0;0;.00nan;0;0
8134;5663;836;42;27;4;23;.852;3543000;0
8134;180287;847;0;0;0;0;.00nan;0;0
8134;182116;836;0;0;0;0;.00nan;0;0
8134;87603;847;71;29;3;26;.897;3600000;0
8135;2410;838;0;0;0;0;.00nan;0;0
8135;30431;839;0;0;0;0;.00nan;0;0
8135;57657;838;49;22;3;19;.864;3535000;0
8135;78223;839;82;24;1;23;.958;3600000;0
8136;183545;842;27;7;3;4;.571;548000;0
8136;23433;842;54;28;3;25;.893;3052000;0
8136;68390;834;0;0;0;0;.00nan;0;0
8136;147901;834;72;27;2;25;.926;3600000;0
8137;167824;828;86;45;2;43;.956;3558000;0
8137;48141;828;0;0;0;0;.00nan;0;0
8137;78094;831;94;20;0;20;1.000;3600000;0
8137;148041;831;0;0;0;0;.00nan;0;0
8138;8501;848;0;0;0;0;.00nan;0;0
8138;174334;832;0;0;0;0;.00nan;0;0
8138;47736;848;65;27;3;24;.889;3600000;0
8138;78920;832;49;25;4;21;.840;3558000;0
8139;16838;830;97;31;1;30;.968;3600000;0
8139;26336;829;40;36;6;30;.833;2007000;0
8139;47791;830;0;0;0;0;.00nan;0;0
8139;53867;829;63;15;1;14;.933;1593000;0
8140;167824;828;64;31;3;28;.903;3600000;0
8140;48141;828;0;0;0;0;.00nan;0;0
8140;68390;834;35;27;5;22;.815;3570000;0
8140;147901;834;0;0;0;0;.00nan;0;0
8141;180287;847;91;36;2;34;.944;3600000;0
8141;180731;837;49;22;3;19;.864;3580000;0
8141;180929;837;0;0;0;0;.00nan;0;0
8141;87603;847;0;0;0;0;.00nan;0;0
8142;5663;836;0;0;0;0;.00nan;0;0
8142;8501;848;77;30;3;27;.900;3900000;0
8142;182116;836;81;31;3;28;.903;3900000;0
8142;47736;848;0;0;0;0;.00nan;0;0
8143;183545;842;0;0;0;0;.00nan;0;0
8143;23433;842;100;26;0;26;1.000;3600000;0
8143;174334;832;0;0;0;0;.00nan;0;0
8143;78920;832;60;14;1;13;.929;3598000;0
8144;30431;839;45;41;6;35;.854;3600000;0
8144;78094;831;67;15;1;14;.933;3600000;0
8144;78223;839;0;0;0;0;.00nan;0;0
8144;148041;831;0;0;0;0;.00nan;0;0
8145;2410;838;98;44;3;41;.932;3900000;0
8145;26336;829;0;0;0;0;.00nan;0;0
8145;53867;829;71;29;3;26;.897;3900000;0
8145;57657;838;0;0;0;0;.00nan;0;0
8146;16838;830;76;31;3;28;.903;3600000;0
8146;47791;830;0;0;0;0;.00nan;0;0
8146;54017;833;0;0;0;0;.00nan;0;0
8146;62975;833;69;25;2;23;.920;3600000;0
8147;167824;828;0;0;0;0;.00nan;0;0
8147;183545;842;61;14;1;13;.929;1135000;0
8147;23433;842;30;28;6;22;.786;2436000;0
8147;48141;828;28;21;5;16;.762;3600000;0
8148;5663;836;0;0;0;0;.00nan;0;0
8148;180731;837;0;0;0;0;.00nan;0;0
8148;180929;837;72;18;1;17;.944;3600000;0
8148;182116;836;54;42;6;36;.857;3600000;0
8149;2410;838;97;25;0;25;1.000;3600000;0
8149;180287;847;32;30;6;24;.800;3600000;0
8149;57657;838;0;0;0;0;.00nan;0;0
8149;87603;847;0;0;0;0;.00nan;0;0
8150;16838;830;96;35;2;33;.943;3600000;0
8150;47791;830;0;0;0;0;.00nan;0;0
8150;68390;834;66;17;1;16;.941;3600000;0
8150;147901;834;0;0;0;0;.00nan;0;0
8151;174334;832;92;42;1;41;.976;3600000;0
8151;78094;831;0;0;0;0;.00nan;0;0
8151;78920;832;0;0;0;0;.00nan;0;0
8151;148041;831;76;29;2;27;.931;3548000;0
8152;26336;829;52;30;4;26;.867;3600000;0
8152;30431;839;36;34;6;28;.824;3583000;0
8152;53867;829;0;0;0;0;.00nan;0;0
8152;78223;839;0;0;0;0;.00nan;0;0
8153;8501;848;53;25;3;22;.880;3555000;0
8153;30431;839;0;0;0;0;.00nan;0;0
8153;47736;848;0;0;0;0;.00nan;0;0
8153;78223;839;97;39;1;38;.974;3600000;0
8154;2410;838;26;24;6;18;.750;2309000;0
8154;57657;838;44;13;2;11;.846;1291000;0
8154;68390;834;0;0;0;0;.00nan;0;0
8154;147901;834;56;21;3;18;.857;3600000;0
8155;5663;836;64;35;4;31;.886;3600000;0
8155;183545;842;68;23;2;21;.913;3600000;0
8155;23433;842;0;0;0;0;.00nan;0;0
8155;182116;836;0;0;0;0;.00nan;0;0
8156;54017;833;0;0;0;0;.00nan;0;0
8156;62975;833;84;36;3;33;.917;3600000;0
8156;78094;831;33;32;6;26;.813;3222000;0
8156;148041;831;48;0;0;0;.00nan;378000;0
8157;26336;829;0;0;0;0;.00nan;0;0
8157;180287;847;66;12;0;12;1.000;1248000;0
8157;53867;829;89;32;2;30;.938;3600000;0
8157;87603;847;32;19;4;15;.789;2289000;0
8158;16838;830;0;0;0;0;.00nan;0;0
8158;174334;832;0;0;0;0;.00nan;0;0
8158;47791;830;77;30;2;28;.933;3900000;0
8158;78920;832;86;32;2;30;.938;3900000;0
8159;8501;848;0;0;0;0;.00nan;0;0
8159;47736;848;69;34;3;31;.912;3900000;0
8159;54017;833;80;29;3;26;.897;3900000;0
8159;62975;833;0;0;0;0;.00nan;0;0
8160;167824;828;73;37;3;34;.919;3600000;0
8160;174334;832;50;13;2;11;.846;1471000;0
8160;48141;828;0;0;0;0;.00nan;0;0
8160;78920;832;31;19;4;15;.789;2129000;0
8161;180287;847;81;43;4;39;.907;3655000;0
8161;78094;831;0;0;0;0;.00nan;0;0
8161;87603;847;0;0;0;0;.00nan;0;0
8161;148041;831;76;34;3;31;.912;3655000;0
8162;2410;838;45;30;5;25;.833;3600000;0
8162;183545;842;0;0;0;0;.00nan;0;0
8162;23433;842;84;28;1;27;.964;3600000;0
8162;57657;838;0;0;0;0;.00nan;0;0
8163;5663;836;0;0;0;0;.00nan;0;0
8163;30431;839;0;0;0;0;.00nan;0;0
8163;182116;836;100;49;0;49;1.000;3600000;0
8163;78223;839;36;21;4;17;.810;3600000;0
8164;54017;833;0;0;0;0;.00nan;0;0
8164;62975;833;76;38;4;34;.895;3900000;0
8164;68390;834;33;22;4;18;.818;3900000;0
8164;147901;834;0;0;0;0;.00nan;0;0
8165;180731;837;0;0;0;0;.00nan;0;0
8165;180929;837;67;40;4;36;.900;3566000;0
8165;54017;833;0;0;0;0;.00nan;0;0
8165;62975;833;82;39;3;36;.923;3600000;0
8166;5663;836;0;0;0;0;.00nan;0;0
8166;26336;829;51;22;3;19;.864;3565000;0
8166;182116;836;94;30;1;29;.967;3600000;0
8166;53867;829;0;0;0;0;.00nan;0;0
8167;2410;838;0;0;0;0;.00nan;0;0
8167;8501;848;93;19;0;19;1.000;3600000;0
8167;47736;848;0;0;0;0;.00nan;0;0
8167;57657;838;66;33;3;30;.909;3600000;0
8168;30431;839;73;32;3;29;.906;3527000;0
8168;68390;834;0;0;0;0;.00nan;0;0
8168;78223;839;0;0;0;0;.00nan;0;0
8168;147901;834;83;27;1;26;.963;3600000;0
8169;183545;842;0;0;0;0;.00nan;0;0
8169;23433;842;95;54;4;50;.926;3600000;0
8169;78094;831;78;22;1;21;.955;3600000;0
8169;148041;831;0;0;0;0;.00nan;0;0
8170;167824;828;92;33;1;32;.970;3600000;0
8170;16838;830;78;35;2;33;.943;3559000;0
8170;47791;830;0;0;0;0;.00nan;0;0
8170;48141;828;0;0;0;0;.00nan;0;0
8171;8501;848;60;32;4;28;.875;3555000;0
8171;16838;830;66;31;3;28;.903;3600000;0
8171;47736;848;0;0;0;0;.00nan;0;0
8171;47791;830;0;0;0;0;.00nan;0;0
8172;26336;829;0;0;0;0;.00nan;0;0
8172;180731;837;89;31;2;29;.935;3600000;0
8172;180929;837;0;0;0;0;.00nan;0;0
8172;53867;829;66;23;3;20;.870;3600000;0
8173;5663;836;0;0;0;0;.00nan;0;0
8173;182116;836;41;34;6;28;.824;3600000;0
8173;68390;834;85;34;1;33;.971;3600000;0
8173;147901;834;0;0;0;0;.00nan;0;0
8174;167824;828;61;24;3;21;.875;3600000;0
8174;48141;828;0;0;0;0;.00nan;0;0
8174;54017;833;0;0;0;0;.00nan;0;0
8174;62975;833;40;31;5;26;.839;3600000;0
8175;30431;839;79;34;3;31;.912;3900000;0
8175;180287;847;58;29;3;26;.897;3900000;0
8175;78223;839;0;0;0;0;.00nan;0;0
8175;87603;847;0;0;0;0;.00nan;0;0
8176;2410;838;64;23;2;21;.913;3600000;0
8176;16838;830;88;26;1;25;.962;3600000;0
8176;47791;830;0;0;0;0;.00nan;0;0
8176;57657;838;0;0;0;0;.00nan;0;0
8177;8501;848;60;18;2;16;.889;3600000;0
8177;183545;842;0;0;0;0;.00nan;0;0
8177;23433;842;93;56;4;52;.929;3525000;0
8177;47736;848;0;0;0;0;.00nan;0;0
8178;180731;837;0;0;0;0;.00nan;0;0
8178;180929;837;61;22;2;20;.909;3583000;0
8178;78094;831;92;22;0;22;1.000;3600000;0
8178;148041;831;0;0;0;0;.00nan;0;0
8179;26336;829;100;44;1;43;.977;3600000;0
8179;53867;829;0;0;0;0;.00nan;0;0
8179;68390;834;55;18;2;16;.889;3543000;0
8179;147901;834;0;0;0;0;.00nan;0;0
8180;2410;838;86;34;2;32;.941;3600000;0
8180;180731;837;61;34;4;30;.882;3538000;0
8180;180929;837;0;0;0;0;.00nan;0;0
8180;57657;838;0;0;0;0;.00nan;0;0
8181;5663;836;0;0;0;0;.00nan;0;0
8181;182116;836;63;36;4;32;.889;3600000;0
8181;78094;831;70;22;1;21;.955;3600000;0
8181;148041;831;0;0;0;0;.00nan;0;0
8182;8501;848;0;0;0;0;.00nan;0;0
8182;167824;828;88;43;2;41;.953;3567000;0
8182;47736;848;78;21;1;20;.952;3600000;0
8182;48141;828;0;0;0;0;.00nan;0;0
8183;174334;832;64;35;4;31;.886;3581000;0
8183;68390;834;0;0;0;0;.00nan;0;0
8183;78920;832;0;0;0;0;.00nan;0;0
8183;147901;834;62;27;3;24;.889;3600000;0
8184;16838;830;63;19;2;17;.895;3600000;0
8184;180287;847;49;32;6;26;.813;2308000;0
8184;47791;830;0;0;0;0;.00nan;0;0
8184;87603;847;75;16;0;16;1.000;1292000;0
8185;5663;836;0;0;0;0;.00nan;0;0
8185;174334;832;0;0;0;0;.00nan;0;0
8185;182116;836;48;25;4;21;.840;3600000;0
8185;78920;832;80;24;1;23;.958;3600000;0
8186;183545;842;0;0;0;0;.00nan;0;0
8186;23433;842;50;27;4;23;.852;3597000;0
8186;30431;839;0;0;0;0;.00nan;0;0
8186;78223;839;68;33;3;30;.909;3600000;0
8187;26336;829;0;0;0;0;.00nan;0;0
8187;53867;829;51;36;5;31;.861;3600000;0
8187;54017;833;0;0;0;0;.00nan;0;0
8187;62975;833;100;40;0;40;1.000;3600000;0
8188;167824;828;88;31;1;30;.968;3600000;0
8188;30431;839;50;22;3;19;.864;3526000;0
8188;48141;828;0;0;0;0;.00nan;0;0
8188;78223;839;0;0;0;0;.00nan;0;0
8189;180287;847;68;40;5;35;.875;3600000;0
8189;54017;833;0;0;0;0;.00nan;0;0
8189;62975;833;37;29;6;23;.793;3576000;0
8189;87603;847;0;0;0;0;.00nan;0;0
8190;8501;848;69;35;4;31;.886;3900000;0
8190;47736;848;0;0;0;0;.00nan;0;0
8190;68390;834;59;38;4;34;.895;3878000;0
8190;147901;834;0;0;0;0;.00nan;0;0
8191;2410;838;63;24;3;21;.875;3900000;0
8191;5663;836;0;0;0;0;.00nan;0;0
8191;182116;836;90;38;3;35;.921;3900000;0
8191;57657;838;0;0;0;0;.00nan;0;0
8192;183545;842;0;0;0;0;.00nan;0;0
8192;23433;842;99;41;1;40;.976;3600000;0
8192;180731;837;0;0;0;0;.00nan;0;0
8192;180929;837;77;30;2;28;.933;3544000;0
8193;16838;830;60;33;4;29;.879;3600000;0
8193;47791;830;0;0;0;0;.00nan;0;0
8193;78094;831;0;0;0;0;.00nan;0;0
8193;148041;831;100;23;0;23;1.000;3600000;0
8194;174334;832;0;0;0;0;.00nan;0;0
8194;26336;829;71;41;4;37;.902;3900000;0
8194;53867;829;0;0;0;0;.00nan;0;0
8194;78920;832;71;40;4;36;.900;3900000;0
8195;167824;828;100;34;0;34;1.000;3600000;0
8195;180287;847;97;44;1;43;.977;3546000;0
8195;48141;828;0;0;0;0;.00nan;0;0
8195;87603;847;0;0;0;0;.00nan;0;0
8196;2410;838;99;26;0;26;1.000;3600000;0
8196;174334;832;62;29;3;26;.897;3600000;0
8196;57657;838;0;0;0;0;.00nan;0;0
8196;78920;832;0;0;0;0;.00nan;0;0
8197;8501;848;100;27;0;27;1.000;3600000;0
8197;47736;848;0;0;0;0;.00nan;0;0
8197;78094;831;0;0;0;0;.00nan;0;0
8197;148041;831;53;29;4;25;.862;3600000;0
8198;183545;842;0;0;0;0;.00nan;0;0
8198;23433;842;92;53;5;48;.906;3600000;0
8198;26336;829;55;20;2;18;.900;3600000;0
8198;53867;829;0;0;0;0;.00nan;0;0
8199;16838;830;0;0;0;0;.00nan;0;0
8199;180731;837;37;27;5;22;.815;3544000;0
8199;180929;837;0;0;0;0;.00nan;0;0
8199;47791;830;83;48;4;44;.917;3600000;0
8200;30431;839;0;0;0;0;.00nan;0;0
8200;54017;833;0;0;0;0;.00nan;0;0
8200;62975;833;70;35;3;32;.914;3548000;0
8200;78223;839;71;28;2;26;.929;3600000;0
8201;180731;837;0;0;0;0;.00nan;0;0
8201;180929;837;46;39;5;34;.872;3600000;0
8201;68390;834;80;31;2;29;.935;3600000;0
8201;147901;834;0;0;0;0;.00nan;0;0
8202;5663;836;0;0;0;0;.00nan;0;0
8202;16838;830;58;29;4;25;.862;3812000;0
8202;182116;836;70;32;3;29;.906;3812000;0
8202;47791;830;0;0;0;0;.00nan;0;0
8203;8501;848;93;36;1;35;.972;3600000;0
8203;180287;847;0;0;0;0;.00nan;0;0
8203;47736;848;0;0;0;0;.00nan;0;0
8203;87603;847;52;34;4;30;.882;3600000;0
8204;2410;838;44;38;7;31;.816;2412000;0
8204;57657;838;28;8;3;5;.625;1188000;0
8204;78094;831;38;21;4;17;.810;3600000;0
8204;148041;831;0;0;0;0;.00nan;0;0
8205;183545;842;95;47;3;44;.936;3569000;0
8205;23433;842;0;0;0;0;.00nan;0;0
8205;54017;833;0;0;0;0;.00nan;0;0
8205;62975;833;73;21;1;20;.952;3600000;0
8206;174334;832;0;0;0;0;.00nan;0;0
8206;30431;839;93;39;3;36;.923;3900000;0
8206;78223;839;0;0;0;0;.00nan;0;0
8206;78920;832;66;23;3;20;.870;3900000;0
8207;2410;838;97;36;1;35;.972;3600000;0
8207;167824;828;68;26;2;24;.923;3545000;0
8207;48141;828;0;0;0;0;.00nan;0;0
8207;57657;838;0;0;0;0;.00nan;0;0
8208;183545;842;0;0;0;0;.00nan;0;0
8208;23433;842;79;26;1;25;.962;3600000;0
8208;180287;847;62;30;3;27;.900;3529000;0
8208;87603;847;0;0;0;0;.00nan;0;0
8209;68390;834;82;29;2;27;.931;3554000;0
8209;78094;831;0;0;0;0;.00nan;0;0
8209;147901;834;0;0;0;0;.00nan;0;0
8209;148041;831;90;34;1;33;.971;3600000;0
8210;174334;832;0;0;0;0;.00nan;0;0
8210;180731;837;0;0;0;0;.00nan;0;0
8210;180929;837;68;30;3;27;.900;3600000;0
8210;78920;832;53;33;5;28;.848;3543000;0
8211;16838;830;83;40;3;37;.925;3576000;0
8211;30431;839;68;27;2;25;.926;3600000;0
8211;47791;830;0;0;0;0;.00nan;0;0
8211;78223;839;0;0;0;0;.00nan;0;0
8212;5663;836;0;0;0;0;.00nan;0;0
8212;182116;836;100;37;1;36;.973;3600000;0
8212;54017;833;49;28;4;24;.857;3088000;0
8212;62975;833;53;4;0;4;1.000;512000;0
8213;8501;848;69;26;2;24;.923;3600000;0
8213;26336;829;0;0;0;0;.00nan;0;0
8213;47736;848;0;0;0;0;.00nan;0;0
8213;53867;829;91;40;3;37;.925;3600000;0
8214;8501;848;83;27;1;26;.963;3600000;0
8214;174334;832;0;0;0;0;.00nan;0;0
8214;47736;848;0;0;0;0;.00nan;0;0
8214;78920;832;57;27;3;24;.889;3532000;0
8215;30431;839;0;0;0;0;.00nan;0;0
8215;180731;837;40;18;4;14;.778;3545000;0
8215;180929;837;0;0;0;0;.00nan;0;0
8215;78223;839;98;41;3;38;.927;3600000;0
8216;5663;836;0;0;0;0;.00nan;0;0
8216;167824;828;49;34;4;30;.882;3600000;0
8216;182116;836;91;34;1;33;.971;3600000;0
8216;48141;828;0;0;0;0;.00nan;0;0
8217;2410;838;97;34;1;33;.971;3600000;0
8217;54017;833;0;0;0;0;.00nan;0;0
8217;57657;838;0;0;0;0;.00nan;0;0
8217;62975;833;62;28;4;24;.857;3600000;0
8218;180287;847;76;41;4;37;.902;3600000;0
8218;68390;834;27;32;6;26;.813;3561000;0
8218;87603;847;0;0;0;0;.00nan;0;0
8218;147901;834;0;0;0;0;.00nan;0;0
8219;26336;829;0;0;0;0;.00nan;0;0
8219;53867;829;89;48;4;44;.917;3600000;0
8219;78094;831;0;0;0;0;.00nan;0;0
8219;148041;831;100;26;0;26;1.000;3600000;0
8220;167824;828;0;0;0;0;.00nan;0;0
8220;48141;828;59;30;3;27;.900;3554000;0
8220;78094;831;0;0;0;0;.00nan;0;0
8220;148041;831;78;23;1;22;.957;3600000;0
8221;5663;836;84;31;1;30;.968;3600000;0
8221;180287;847;0;0;0;0;.00nan;0;0
8221;182116;836;0;0;0;0;.00nan;0;0
8221;87603;847;75;38;3;35;.921;3600000;0
8222;8501;848;66;34;3;31;.912;3900000;0
8222;180731;837;0;0;0;0;.00nan;0;0
8222;180929;837;72;31;3;28;.903;3900000;0
8222;47736;848;0;0;0;0;.00nan;0;0
8223;183545;842;0;0;0;0;.00nan;0;0
8223;23433;842;73;39;4;35;.897;3542000;0
8223;68390;834;0;0;0;0;.00nan;0;0
8223;147901;834;54;24;3;21;.875;3600000;0
8224;2410;838;0;0;0;0;.00nan;0;0
8224;30431;839;0;0;0;0;.00nan;0;0
8224;57657;838;75;22;1;21;.955;3600000;0
8224;78223;839;51;34;5;29;.853;3600000;0
8225;16838;830;85;35;3;32;.914;3600000;0
8225;26336;829;55;30;4;26;.867;3542000;0
8225;47791;830;0;0;0;0;.00nan;0;0
8225;53867;829;0;0;0;0;.00nan;0;0
8226;174334;832;0;0;0;0;.00nan;0;0
8226;54017;833;69;33;4;29;.879;3557000;0
8226;62975;833;0;0;0;0;.00nan;0;0
8226;78920;832;64;25;3;22;.880;3600000;0
8227;183545;842;80;31;2;29;.935;3554000;0
8227;16838;830;86;28;1;27;.964;3600000;0
8227;185506;842;0;0;0;0;.00nan;0;0
8227;47791;830;0;0;0;0;.00nan;0;0
8228;5663;836;0;0;0;0;.00nan;0;0
8228;180731;837;0;0;0;0;.00nan;0;0
8228;180929;837;42;20;3;17;.850;3597000;0
8228;182116;836;87;36;2;34;.944;3600000;0
8229;2410;838;79;29;2;27;.931;3600000;0
8229;180287;847;0;0;0;0;.00nan;0;0
8229;57657;838;0;0;0;0;.00nan;0;0
8229;87603;847;85;46;4;42;.913;3583000;0
8230;167824;828;73;21;1;20;.952;3900000;0
8230;183545;842;0;0;0;0;.00nan;0;0
8230;23433;842;100;34;1;33;.971;3900000;0
8230;48141;828;0;0;0;0;.00nan;0;0
8231;174334;832;0;0;0;0;.00nan;0;0
8231;78094;831;0;0;0;0;.00nan;0;0
8231;78920;832;84;25;1;24;.960;3600000;0
8231;148041;831;72;34;3;31;.912;3548000;0
8232;26336;829;54;26;3;23;.885;3900000;0
8232;30431;839;0;0;0;0;.00nan;0;0
8232;53867;829;0;0;0;0;.00nan;0;0
8232;78223;839;64;26;3;23;.885;3900000;0
8233;16838;830;100;43;1;42;.977;3680000;0
8233;47791;830;0;0;0;0;.00nan;0;0
8233;68390;834;89;35;2;33;.943;3680000;0
8233;147901;834;0;0;0;0;.00nan;0;0
8234;167824;828;0;0;0;0;.00nan;0;0
8234;180731;837;66;28;3;25;.893;3600000;0
8234;180929;837;0;0;0;0;.00nan;0;0
8234;48141;828;51;33;5;28;.848;3600000;0
8235;26336;829;0;0;0;0;.00nan;0;0
8235;180287;847;78;24;1;23;.958;3718000;0
8235;53867;829;93;44;2;42;.955;3718000;0
8235;87603;847;0;0;0;0;.00nan;0;0
8236;2410;838;0;0;0;0;.00nan;0;0
8236;57657;838;87;51;4;47;.922;3600000;0
8236;68390;834;96;19;0;19;1.000;3600000;0
8236;147901;834;0;0;0;0;.00nan;0;0
8237;16838;830;83;23;1;22;.957;3600000;0
8237;174334;832;0;0;0;0;.00nan;0;0
8237;47791;830;0;0;0;0;.00nan;0;0
8237;78920;832;78;35;2;33;.943;3537000;0
8238;8501;848;83;16;0;16;1.000;3600000;0
8238;30431;839;0;0;0;0;.00nan;0;0
8238;47736;848;0;0;0;0;.00nan;0;0
8238;78223;839;77;36;2;34;.944;3543000;0
8239;54017;833;0;0;0;0;.00nan;0;0
8239;62975;833;74;22;1;21;.955;3600000;0
8239;78094;831;57;19;2;17;.895;3559000;0
8239;148041;831;0;0;0;0;.00nan;0;0
8240;5663;836;0;0;0;0;.00nan;0;0
8240;183545;842;0;0;0;0;.00nan;0;0
8240;23433;842;72;29;2;27;.931;3600000;0
8240;182116;836;60;28;3;25;.893;3568000;0
8241;8501;848;92;32;1;31;.969;3600000;0
8241;47736;848;0;0;0;0;.00nan;0;0
8241;54017;833;0;0;0;0;.00nan;0;0
8241;62975;833;55;23;3;20;.870;3588000;0
8242;183545;842;0;0;0;0;.00nan;0;0
8242;23433;842;75;37;3;34;.919;3600000;0
8242;174334;832;53;10;1;9;.900;3600000;0
8242;78920;832;0;0;0;0;.00nan;0;0
8243;30431;839;0;0;0;0;.00nan;0;0
8243;68390;834;46;23;5;18;.783;3900000;0
8243;78223;839;52;38;5;33;.868;3900000;0
8243;147901;834;0;0;0;0;.00nan;0;0
8244;26336;829;87;32;2;30;.938;3565000;0
8244;180731;837;0;0;0;0;.00nan;0;0
8244;180929;837;80;30;1;29;.967;3600000;0
8244;53867;829;0;0;0;0;.00nan;0;0
8245;5663;836;0;0;0;0;.00nan;0;0
8245;30431;839;60;9;0;9;1.000;707000;0
8245;182116;836;77;25;2;23;.920;3600000;0
8245;78223;839;52;30;5;25;.833;2893000;0
8246;2410;838;82;33;2;31;.939;3600000;0
8246;183545;842;0;0;0;0;.00nan;0;0
8246;23433;842;79;29;1;28;.966;3600000;0
8246;57657;838;0;0;0;0;.00nan;0;0
8247;54017;833;0;0;0;0;.00nan;0;0
8247;62975;833;46;24;4;20;.833;3600000;0
8247;68390;834;0;0;0;0;.00nan;0;0
8247;147901;834;91;35;1;34;.971;3600000;0
8248;180287;847;100;63;1;62;.984;3900000;0
8248;78094;831;0;0;0;0;.00nan;0;0
8248;87603;847;0;0;0;0;.00nan;0;0
8248;148041;831;64;17;1;16;.941;3900000;0
8249;8501;848;79;28;2;26;.929;3591000;0
8249;16838;830;100;23;0;23;1.000;3600000;0
8249;47736;848;0;0;0;0;.00nan;0;0
8249;47791;830;0;0;0;0;.00nan;0;0
8250;167824;828;77;37;3;34;.919;3600000;0
8250;16838;830;64;28;4;24;.857;3566000;0
8250;47791;830;0;0;0;0;.00nan;0;0
8250;48141;828;0;0;0;0;.00nan;0;0
8251;174334;832;0;0;0;0;.00nan;0;0
8251;180287;847;54;25;3;22;.880;3600000;0
8251;78920;832;63;39;4;35;.897;3546000;0
8251;87603;847;0;0;0;0;.00nan;0;0
8252;2410;838;0;0;0;0;.00nan;0;0
8252;8501;848;82;26;1;25;.962;3600000;0
8252;47736;848;0;0;0;0;.00nan;0;0
8252;57657;838;70;40;4;36;.900;3600000;0
8253;183545;842;0;0;0;0;.00nan;0;0
8253;23433;842;87;46;4;42;.913;3806000;0
8253;78094;831;58;23;3;20;.870;3806000;0
8253;148041;831;0;0;0;0;.00nan;0;0
8254;5663;836;72;28;2;26;.929;3600000;0
8254;26336;829;0;0;0;0;.00nan;0;0
8254;182116;836;0;0;0;0;.00nan;0;0
8254;53867;829;67;33;3;30;.909;3554000;0
8255;180731;837;75;31;3;28;.903;3900000;0
8255;180929;837;0;0;0;0;.00nan;0;0
8255;54017;833;64;37;4;33;.892;3900000;0
8255;62975;833;0;0;0;0;.00nan;0;0
8256;167824;828;74;32;2;30;.938;3584000;0
8256;174334;832;77;22;1;21;.955;3600000;0
8256;48141;828;0;0;0;0;.00nan;0;0
8256;78920;832;0;0;0;0;.00nan;0;0
8257;180287;847;69;43;5;38;.884;3852000;0
8257;180731;837;0;0;0;0;.00nan;0;0
8257;180929;837;57;28;4;24;.857;3852000;0
8257;87603;847;0;0;0;0;.00nan;0;0
8258;5663;836;0;0;0;0;.00nan;0;0
8258;8501;848;60;20;2;18;.900;3900000;0
8258;182116;836;90;34;2;32;.941;3900000;0
8258;47736;848;0;0;0;0;.00nan;0;0
8259;2410;838;81;33;2;31;.939;3600000;0
8259;26336;829;44;21;3;18;.857;3600000;0
8259;53867;829;0;0;0;0;.00nan;0;0
8259;57657;838;0;0;0;0;.00nan;0;0
8260;174334;832;0;0;0;0;.00nan;0;0
8260;68390;834;33;31;6;25;.806;3600000;0
8260;78920;832;76;43;4;39;.907;3600000;0
8260;147901;834;0;0;0;0;.00nan;0;0
8261;30431;839;0;0;0;0;.00nan;0;0
8261;78094;831;0;0;0;0;.00nan;0;0
8261;78223;839;60;35;4;31;.886;3564000;0
8261;148041;831;69;20;2;18;.900;3600000;0
8262;16838;830;0;0;0;0;.00nan;0;0
8262;47791;830;77;33;3;30;.909;3600000;0
8262;54017;833;58;13;1;12;.923;1433000;0
8262;62975;833;41;19;4;15;.789;2167000;0
8263;167824;828;62;28;3;25;.893;3544000;0
8263;174334;832;0;0;0;0;.00nan;0;0
8263;48141;828;0;0;0;0;.00nan;0;0
8263;78920;832;86;27;1;26;.963;3600000;0
8264;180287;847;65;22;2;20;.909;3600000;0
8264;54017;833;0;0;0;0;.00nan;0;0
8264;62975;833;41;26;4;22;.846;3600000;0
8264;87603;847;0;0;0;0;.00nan;0;0
8265;5663;836;0;0;0;0;.00nan;0;0
8265;8501;848;97;22;0;22;1.000;3600000;0
8265;182116;836;66;20;1;19;.950;3545000;0
8265;47736;848;0;0;0;0;.00nan;0;0
8266;30431;839;0;0;0;0;.00nan;0;0
8266;180731;837;0;0;0;0;.00nan;0;0
8266;180929;837;45;21;3;18;.857;3545000;0
8266;78223;839;82;35;2;33;.943;3600000;0
8267;183545;842;0;0;0;0;.00nan;0;0
8267;23433;842;100;57;3;54;.947;3900000;0
8267;78094;831;41;15;3;12;.800;3900000;0
8267;148041;831;0;0;0;0;.00nan;0;0
8268;26336;829;0;0;0;0;.00nan;0;0
8268;53867;829;27;31;6;25;.806;3600000;0
8268;68390;834;58;31;3;28;.903;3600000;0
8268;147901;834;0;0;0;0;.00nan;0;0
8269;2410;838;55;34;4;30;.882;3600000;0
8269;16838;830;76;31;2;29;.935;3600000;0
8269;47791;830;0;0;0;0;.00nan;0;0
8269;57657;838;0;0;0;0;.00nan;0;0
8270;16838;830;0;0;0;0;.00nan;0;0
8270;180731;837;72;23;2;21;.913;3600000;0
8270;180929;837;0;0;0;0;.00nan;0;0
8270;47791;830;48;34;6;28;.824;3600000;0
8271;5663;836;54;27;3;24;.889;3600000;0
8271;182116;836;0;0;0;0;.00nan;0;0
8271;78094;831;0;0;0;0;.00nan;0;0
8271;148041;831;65;36;4;32;.889;3568000;0
8272;2410;838;0;0;0;0;.00nan;0;0
8272;167824;828;0;0;0;0;.00nan;0;0
8272;48141;828;43;26;4;22;.846;3544000;0
8272;57657;838;71;31;3;28;.903;3600000;0
8273;180287;847;0;0;0;0;.00nan;0;0
8273;68390;834;0;0;0;0;.00nan;0;0
8273;87603;847;74;40;4;36;.900;3573000;0
8273;147901;834;78;31;2;29;.935;3600000;0
8274;174334;832;66;27;3;24;.889;3600000;0
8274;30431;839;20;42;9;33;.786;3600000;0
8274;78223;839;0;0;0;0;.00nan;0;0
8274;78920;832;0;0;0;0;.00nan;0;0
8275;26336;829;97;41;2;39;.951;3582000;0
8275;53867;829;0;0;0;0;.00nan;0;0
8275;54017;833;68;18;1;17;.944;3600000;0
8275;62975;833;0;0;0;0;.00nan;0;0
8276;8501;848;87;40;4;36;.900;3900000;0
8276;183545;842;0;0;0;0;.00nan;0;0
8276;23433;842;46;30;4;26;.867;3900000;0
8276;47736;848;0;0;0;0;.00nan;0;0
8277;167824;828;51;35;5;30;.857;3600000;0
8277;180731;837;71;29;2;27;.931;3600000;0
8277;180929;837;0;0;0;0;.00nan;0;0
8277;48141;828;0;0;0;0;.00nan;0;0
8278;5663;836;0;0;0;0;.00nan;0;0
8278;180287;847;96;32;1;31;.969;3600000;0
8278;182116;836;61;35;4;31;.886;3600000;0
8278;87603;847;0;0;0;0;.00nan;0;0
8279;174334;832;0;0;0;0;.00nan;0;0
8279;78094;831;0;0;0;0;.00nan;0;0
8279;78920;832;90;37;2;35;.946;3900000;0
8279;148041;831;67;24;2;22;.917;3900000;0
8280;30431;839;0;0;0;0;.00nan;0;0
8280;54017;833;0;0;0;0;.00nan;0;0
8280;62975;833;68;18;1;17;.944;3600000;0
8280;78223;839;55;35;4;31;.886;3600000;0
8281;2410;838;89;35;3;32;.914;3600000;0
8281;26336;829;0;0;0;0;.00nan;0;0
8281;53867;829;98;32;1;31;.969;3600000;0
8281;57657;838;0;0;0;0;.00nan;0;0
8282;174334;832;97;30;1;29;.967;3900000;0
8282;180731;837;0;0;0;0;.00nan;0;0
8282;180929;837;98;37;1;36;.973;3900000;0
8282;78920;832;0;0;0;0;.00nan;0;0
8283;5663;836;78;37;3;34;.919;3600000;0
8283;16838;830;67;45;5;40;.889;3542000;0
8283;182116;836;0;0;0;0;.00nan;0;0
8283;47791;830;0;0;0;0;.00nan;0;0
8284;2410;838;0;0;0;0;.00nan;0;0
8284;8501;848;67;26;2;24;.923;3600000;0
8284;47736;848;0;0;0;0;.00nan;0;0
8284;57657;838;88;31;1;30;.968;3600000;0
8285;183545;842;0;0;0;0;.00nan;0;0
8285;23433;842;72;36;3;33;.917;3600000;0
8285;180287;847;0;0;0;0;.00nan;0;0
8285;87603;847;71;38;4;34;.895;3557000;0
8286;30431;839;92;30;1;29;.967;3600000;0
8286;68390;834;52;18;2;16;.889;3571000;0
8286;78223;839;0;0;0;0;.00nan;0;0
8286;147901;834;0;0;0;0;.00nan;0;0
8287;26336;829;85;52;4;48;.923;3600000;0
8287;53867;829;0;0;0;0;.00nan;0;0
8287;78094;831;81;29;1;28;.966;3600000;0
8287;148041;831;0;0;0;0;.00nan;0;0
8288;167824;828;0;0;0;0;.00nan;0;0
8288;48141;828;59;25;2;23;.920;3900000;0
8288;54017;833;77;32;2;30;.938;3900000;0
8288;62975;833;0;0;0;0;.00nan;0;0
8289;8501;848;0;0;0;0;.00nan;0;0
8289;47736;848;68;35;3;32;.914;3600000;0
8289;68390;834;0;0;0;0;.00nan;0;0
8289;147901;834;74;30;2;28;.933;3600000;0
8290;167824;828;66;22;2;20;.909;3574000;0
8290;183545;842;0;0;0;0;.00nan;0;0
8290;23433;842;94;37;1;36;.973;3600000;0
8290;48141;828;0;0;0;0;.00nan;0;0
8291;180287;847;55;35;4;31;.886;3600000;0
8291;78094;831;53;13;1;12;.923;2431000;0
8291;87603;847;0;0;0;0;.00nan;0;0
8291;148041;831;30;13;4;9;.692;1125000;0
8292;8501;848;100;28;0;28;1.000;3900000;0
8292;180731;837;0;0;0;0;.00nan;0;0
8292;180929;837;96;42;0;42;1.000;3900000;0
8292;47736;848;0;0;0;0;.00nan;0;0
8293;174334;832;85;30;2;28;.933;3600000;0
8293;54017;833;34;17;4;13;.765;3574000;0
8293;62975;833;0;0;0;0;.00nan;0;0
8293;78920;832;0;0;0;0;.00nan;0;0
8294;2410;838;93;36;2;34;.944;3600000;0
8294;30431;839;0;0;0;0;.00nan;0;0
8294;57657;838;0;0;0;0;.00nan;0;0
8294;78223;839;60;36;4;32;.889;3570000;0
8295;5663;836;0;0;0;0;.00nan;0;0
8295;26336;829;79;25;1;24;.960;3600000;0
8295;182116;836;59;22;2;20;.909;3568000;0
8295;53867;829;0;0;0;0;.00nan;0;0
8296;16838;830;69;34;3;31;.912;3600000;0
8296;47791;830;0;0;0;0;.00nan;0;0
8296;68390;834;100;27;0;27;1.000;3600000;0
8296;147901;834;0;0;0;0;.00nan;0;0
8297;26336;829;100;45;2;43;.956;3900000;0
8297;180731;837;81;29;2;27;.931;3900000;0
8297;180929;837;0;0;0;0;.00nan;0;0
8297;53867;829;0;0;0;0;.00nan;0;0
8298;5663;836;0;0;0;0;.00nan;0;0
8298;167824;828;78;27;1;26;.963;3600000;0
8298;182116;836;75;31;2;29;.935;3581000;0
8298;48141;828;0;0;0;0;.00nan;0;0
8299;8501;848;75;27;1;26;.963;3600000;0
8299;180287;847;49;23;4;19;.826;3600000;0
8299;47736;848;0;0;0;0;.00nan;0;0
8299;87603;847;0;0;0;0;.00nan;0;0
8300;183545;842;0;0;0;0;.00nan;0;0
8300;23433;842;78;19;1;18;.947;3600000;0
8300;30431;839;0;0;0;0;.00nan;0;0
8300;78223;839;80;35;3;32;.914;3555000;0
8301;174334;832;52;47;6;41;.872;3600000;0
8301;68390;834;47;16;3;13;.813;3600000;0
8301;78920;832;0;0;0;0;.00nan;0;0
8301;147901;834;0;0;0;0;.00nan;0;0
8302;2410;838;98;40;2;38;.950;3900000;0
8302;57657;838;0;0;0;0;.00nan;0;0
8302;78094;831;75;32;2;30;.938;3900000;0
8302;148041;831;0;0;0;0;.00nan;0;0
8303;16838;830;64;30;3;27;.900;3900000;0
8303;47791;830;0;0;0;0;.00nan;0;0
8303;54017;833;0;0;0;0;.00nan;0;0
8303;62975;833;62;23;3;20;.870;3900000;0
8304;16838;830;78;29;2;27;.931;3647000;0
8304;180287;847;0;0;0;0;.00nan;0;0
8304;47791;830;0;0;0;0;.00nan;0;0
8304;87603;847;89;30;1;29;.967;3647000;0
8305;2410;838;88;32;1;31;.969;3600000;0
8305;5663;836;0;0;0;0;.00nan;0;0
8305;182116;836;56;26;3;23;.885;3556000;0
8305;57657;838;0;0;0;0;.00nan;0;0
8306;180731;837;0;0;0;0;.00nan;0;0
8306;180929;837;59;49;6;43;.878;3600000;0
8306;68390;834;58;20;2;18;.900;3600000;0
8306;147901;834;0;0;0;0;.00nan;0;0
8307;167824;828;74;30;3;27;.900;3600000;0
8307;30431;839;0;0;0;0;.00nan;0;0
8307;48141;828;0;0;0;0;.00nan;0;0
8307;78223;839;51;27;4;23;.852;3600000;0
8308;8501;848;66;24;3;21;.875;3607000;0
8308;47736;848;0;0;0;0;.00nan;0;0
8308;78094;831;0;0;0;0;.00nan;0;0
8308;148041;831;76;28;2;26;.929;3611000;0
8309;174334;832;45;8;1;7;.875;563000;0
8309;26336;829;0;0;0;0;.00nan;0;0
8309;53867;829;57;44;6;38;.864;3600000;0
8309;78920;832;28;27;6;21;.778;3029000;0
8310;183545;842;0;0;0;0;.00nan;0;0
8310;23433;842;95;38;2;36;.947;3600000;0
8310;54017;833;74;33;3;30;.909;3546000;0
8310;62975;833;0;0;0;0;.00nan;0;0
8311;167824;828;51;20;3;17;.850;3600000;0
8311;26336;829;60;32;4;28;.875;3582000;0
8311;48141;828;0;0;0;0;.00nan;0;0
8311;53867;829;0;0;0;0;.00nan;0;0
8312;180731;837;0;0;0;0;.00nan;0;0
8312;180929;837;91;29;1;28;.966;3600000;0
8312;54017;833;0;0;0;0;.00nan;0;0
8312;62975;833;67;32;3;29;.906;3522000;0
8313;5663;836;0;0;0;0;.00nan;0;0
8313;182116;836;84;29;1;28;.966;3600000;0
8313;68390;834;54;21;3;18;.857;3533000;0
8313;147901;834;0;0;0;0;.00nan;0;0
8314;8501;848;88;32;1;31;.969;3600000;0
8314;30431;839;0;0;0;0;.00nan;0;0
8314;47736;848;0;0;0;0;.00nan;0;0
8314;78223;839;61;23;2;21;.913;3574000;0
8315;2410;838;92;19;0;19;1.000;3600000;0
8315;183545;842;0;0;0;0;.00nan;0;0
8315;23433;842;59;33;4;29;.879;3600000;0
8315;57657;838;0;0;0;0;.00nan;0;0
8316;174334;832;0;0;0;0;.00nan;0;0
8316;180287;847;60;22;2;20;.909;3600000;0
8316;78920;832;63;38;5;33;.868;3600000;0
8316;87603;847;0;0;0;0;.00nan;0;0
8317;16838;830;0;0;0;0;.00nan;0;0
8317;47791;830;93;50;4;46;.920;3574000;0
8317;78094;831;0;0;0;0;.00nan;0;0
8317;148041;831;65;23;2;21;.913;3600000;0
8318;26336;829;0;0;0;0;.00nan;0;0
8318;30431;839;0;0;0;0;.00nan;0;0
8318;53867;829;100;34;0;34;1.000;3600000;0
8318;78223;839;72;30;2;28;.933;3519000;0
8319;8501;848;100;43;0;43;1.000;3900000;0
8319;16838;830;93;28;0;28;1.000;3900000;0
8319;47736;848;0;0;0;0;.00nan;0;0
8319;47791;830;0;0;0;0;.00nan;0;0
8320;167824;828;69;40;5;35;.875;3900000;0
8320;48141;828;0;0;0;0;.00nan;0;0
8320;68390;834;54;36;5;31;.861;3900000;0
8320;147901;834;0;0;0;0;.00nan;0;0
8321;5663;836;0;0;0;0;.00nan;0;0
8321;182116;836;91;38;2;36;.947;3600000;0
8321;54017;833;53;26;3;23;.885;3549000;0
8321;62975;833;0;0;0;0;.00nan;0;0
8322;2410;838;77;22;1;21;.955;3600000;0
8322;180287;847;50;34;6;28;.824;3026000;0
8322;57657;838;0;0;0;0;.00nan;0;0
8322;87603;847;49;1;0;1;1.000;574000;0
8323;183545;842;97;39;1;38;.974;3554000;0
8323;23433;842;0;0;0;0;.00nan;0;0
8323;174334;832;90;24;0;24;1.000;3600000;0
8323;78920;832;0;0;0;0;.00nan;0;0
8324;180731;837;99;36;2;34;.944;3900000;0
8324;180929;837;0;0;0;0;.00nan;0;0
8324;78094;831;67;22;2;20;.909;3900000;0
8324;148041;831;0;0;0;0;.00nan;0;0
8325;167824;828;0;0;0;0;.00nan;0;0
8325;180287;847;0;0;0;0;.00nan;0;0
8325;48141;828;56;30;4;26;.867;3600000;0
8325;87603;847;82;25;1;24;.960;3600000;0
8326;8501;848;53;21;3;18;.857;3600000;0
8326;26336;829;27;21;5;16;.762;2780000;0
8326;47736;848;0;0;0;0;.00nan;0;0
8326;53867;829;23;14;4;10;.714;820000;0
8327;183545;842;0;0;0;0;.00nan;0;0
8327;23433;842;95;50;3;47;.940;3600000;0
8327;68390;834;0;0;0;0;.00nan;0;0
8327;147901;834;100;27;0;27;1.000;3600000;0
8328;5663;836;0;0;0;0;.00nan;0;0
8328;180731;837;90;28;1;27;.964;3600000;0
8328;180929;837;0;0;0;0;.00nan;0;0
8328;182116;836;85;56;6;50;.893;3600000;0
8329;2410;838;86;33;2;31;.939;3600000;0
8329;174334;832;37;23;4;19;.826;3546000;0
8329;57657;838;0;0;0;0;.00nan;0;0
8329;78920;832;0;0;0;0;.00nan;0;0
8330;16838;830;89;33;1;32;.970;3600000;0
8330;30431;839;58;33;4;29;.879;3600000;0
8330;47791;830;0;0;0;0;.00nan;0;0
8330;78223;839;0;0;0;0;.00nan;0;0
8331;54017;833;23;4;3;1;.250;374000;0
8331;62975;833;39;23;4;19;.826;3226000;0
8331;78094;831;0;0;0;0;.00nan;0;0
8331;148041;831;66;19;1;18;.947;3600000;0
8332;167824;828;77;44;4;40;.909;3900000;0
8332;48141;828;0;0;0;0;.00nan;0;0
8332;78094;831;0;0;0;0;.00nan;0;0
8332;148041;831;47;24;4;20;.833;3900000;0
8333;2410;838;44;24;3;21;.875;3565000;0
8333;57657;838;0;0;0;0;.00nan;0;0
8333;68390;834;0;0;0;0;.00nan;0;0
8333;147901;834;81;39;2;37;.949;3600000;0
8334;183545;842;0;0;0;0;.00nan;0;0
8334;23433;842;91;39;2;37;.949;3600000;0
8334;180731;837;58;32;4;28;.875;3599000;0
8334;180929;837;0;0;0;0;.00nan;0;0
8335;5663;836;0;0;0;0;.00nan;0;0
8335;174334;832;69;32;3;29;.906;3600000;0
8335;182116;836;51;36;5;31;.861;3548000;0
8335;78920;832;0;0;0;0;.00nan;0;0
8336;30431;839;66;23;2;21;.913;3600000;0
8336;180287;847;94;37;1;36;.973;3600000;0
8336;78223;839;0;0;0;0;.00nan;0;0
8336;87603;847;0;0;0;0;.00nan;0;0
8337;16838;830;73;26;2;24;.923;3600000;0
8337;26336;829;0;0;0;0;.00nan;0;0
8337;47791;830;0;0;0;0;.00nan;0;0
8337;53867;829;49;35;5;30;.857;3600000;0
8338;8501;848;64;36;4;32;.889;3600000;0
8338;47736;848;0;0;0;0;.00nan;0;0
8338;54017;833;0;0;0;0;.00nan;0;0
8338;62975;833;97;40;1;39;.975;3600000;0
8339;2410;838;81;48;5;43;.896;3600000;0
8339;180731;837;51;32;6;26;.813;3556000;0
8339;180929;837;0;0;0;0;.00nan;0;0
8339;57657;838;0;0;0;0;.00nan;0;0
8340;5663;836;97;32;1;31;.969;3600000;0
8340;183545;842;57;24;3;21;.875;3539000;0
8340;23433;842;0;0;0;0;.00nan;0;0
8340;182116;836;0;0;0;0;.00nan;0;0
8341;26336;829;87;26;1;25;.962;3600000;0
8341;180287;847;0;0;0;0;.00nan;0;0
8341;53867;829;0;0;0;0;.00nan;0;0
8341;87603;847;91;37;2;35;.946;3600000;0
8342;54017;833;62;28;3;25;.893;3600000;0
8342;62975;833;0;0;0;0;.00nan;0;0
8342;68390;834;53;42;6;36;.857;3600000;0
8342;147901;834;0;0;0;0;.00nan;0;0
8343;30431;839;0;0;0;0;.00nan;0;0
8343;78094;831;83;16;0;16;1.000;3600000;0
8343;78223;839;71;35;3;32;.914;3600000;0
8343;148041;831;0;0;0;0;.00nan;0;0
8344;16838;830;62;34;4;30;.882;3520000;0
8344;174334;832;0;0;0;0;.00nan;0;0
8344;47791;830;0;0;0;0;.00nan;0;0
8344;78920;832;100;52;2;50;.962;3600000;0
8345;180287;847;84;54;4;50;.926;3600000;0
8345;180731;837;100;20;0;20;1.000;3600000;0
8345;180929;837;0;0;0;0;.00nan;0;0
8345;87603;847;0;0;0;0;.00nan;0;0
8346;5663;836;0;0;0;0;.00nan;0;0
8346;30431;839;0;0;0;0;.00nan;0;0
8346;182116;836;67;21;2;19;.905;3569000;0
8346;78223;839;93;40;1;39;.975;3600000;0
8347;183545;842;0;0;0;0;.00nan;0;0
8347;23433;842;88;36;1;35;.972;3900000;0
8347;26336;829;85;33;1;32;.970;3900000;0
8347;53867;829;0;0;0;0;.00nan;0;0
8348;68390;834;77;35;3;32;.914;3552000;0
8348;78094;831;53;20;2;18;.900;3600000;0
8348;147901;834;0;0;0;0;.00nan;0;0
8348;148041;831;0;0;0;0;.00nan;0;0
8349;167824;828;25;33;7;26;.788;2908000;0
8349;16838;830;0;0;0;0;.00nan;0;0
8349;47791;830;49;22;3;19;.864;3600000;0
8349;48141;828;39;10;2;8;.800;692000;0
8350;167824;828;0;0;0;0;.00nan;0;0
8350;16838;830;67;33;3;30;.909;3600000;0
8350;47791;830;0;0;0;0;.00nan;0;0
8350;48141;828;68;40;5;35;.875;3600000;0
8351;180287;847;0;0;0;0;.00nan;0;0
8351;180731;837;79;31;2;29;.935;3600000;0
8351;180929;837;0;0;0;0;.00nan;0;0
8351;87603;847;44;35;5;30;.857;3600000;0
8352;5663;836;58;20;2;18;.900;3600000;0
8352;30431;839;55;31;4;27;.871;3600000;0
8352;182116;836;0;0;0;0;.00nan;0;0
8352;78223;839;0;0;0;0;.00nan;0;0
8353;183545;842;63;35;4;31;.886;3513000;0
8353;23433;842;0;0;0;0;.00nan;0;0
8353;26336;829;0;0;0;0;.00nan;0;0
8353;53867;829;64;28;2;26;.929;3600000;0
8354;2410;838;67;42;4;38;.905;3538000;0
8354;54017;833;0;0;0;0;.00nan;0;0
8354;57657;838;0;0;0;0;.00nan;0;0
8354;62975;833;92;30;2;28;.933;3600000;0
8355;2410;838;0;0;0;0;.00nan;0;0
8355;54017;833;85;26;1;25;.962;3600000;0
8355;57657;838;77;39;3;36;.923;3569000;0
8355;62975;833;0;0;0;0;.00nan;0;0
8356;68390;834;61;35;4;31;.886;3900000;0
8356;78094;831;0;0;0;0;.00nan;0;0
8356;147901;834;0;0;0;0;.00nan;0;0
8356;148041;831;62;30;4;26;.867;3861000;0
8357;167824;828;93;38;2;36;.947;3600000;0
8357;48141;828;0;0;0;0;.00nan;0;0
8357;68390;834;0;0;0;0;.00nan;0;0
8357;147901;834;43;24;4;20;.833;3516000;0
8358;8501;848;59;37;4;33;.892;3600000;0
8358;174334;832;0;0;0;0;.00nan;0;0
8358;47736;848;0;0;0;0;.00nan;0;0
8358;78920;832;40;18;3;15;.833;3600000;0
8359;26336;829;50;22;3;19;.864;3597000;0
8359;30431;839;0;0;0;0;.00nan;0;0
8359;53867;829;0;0;0;0;.00nan;0;0
8359;78223;839;72;27;2;25;.926;3600000;0
8360;8501;837;100;31;0;31;1.000;3600000;0
8360;30431;839;0;0;0;0;.00nan;0;0
8360;180731;837;0;0;0;0;.00nan;0;0
8360;78223;839;57;31;4;27;.871;3600000;0
8361;5663;836;0;0;0;0;.00nan;0;0
8361;182116;836;70;43;4;39;.907;3521000;0
8361;47736;848;74;24;2;22;.917;3600000;0
8361;47742;848;0;0;0;0;.00nan;0;0
8362;2410;838;51;46;6;40;.870;3600000;0
8362;16838;830;63;26;3;23;.885;3600000;0
8362;47791;830;0;0;0;0;.00nan;0;0
8362;57657;838;0;0;0;0;.00nan;0;0
8363;183545;842;0;0;0;0;.00nan;0;0
8363;23433;842;60;37;4;33;.892;3600000;0
8363;78094;831;0;0;0;0;.00nan;0;0
8363;148041;831;64;24;2;22;.917;3600000;0
8364;26336;829;96;36;1;35;.972;3641000;0
8364;53867;829;0;0;0;0;.00nan;0;0
8364;68390;834;79;30;2;28;.933;3641000;0
8364;147901;834;0;0;0;0;.00nan;0;0
8365;167824;828;55;24;3;21;.875;3600000;0
8365;174334;832;35;37;6;31;.838;3600000;0
8365;48141;828;0;0;0;0;.00nan;0;0
8365;78920;832;0;0;0;0;.00nan;0;0
8366;180287;847;85;37;3;34;.919;3600000;0
8366;54017;833;0;0;0;0;.00nan;0;0
8366;62975;833;100;25;0;25;1.000;3600000;0
8366;87603;847;0;0;0;0;.00nan;0;0
8367;2410;838;79;35;3;32;.914;3600000;0
8367;167824;828;0;0;0;0;.00nan;0;0
8367;48141;828;36;25;6;19;.760;3600000;0
8367;57657;838;0;0;0;0;.00nan;0;0
8368;183545;842;81;44;3;41;.932;3600000;0
8368;23433;842;0;0;0;0;.00nan;0;0
8368;47736;848;0;0;0;0;.00nan;0;0
8368;47742;848;71;26;2;24;.923;3600000;0
8369;174334;832;0;0;0;0;.00nan;0;0
8369;30431;839;33;21;4;17;.810;2264000;0
8369;78223;839;55;5;0;5;1.000;1282000;0
8369;78920;832;66;18;2;16;.889;3600000;0
8370;5663;836;93;38;3;35;.921;3900000;0
8370;182116;836;0;0;0;0;.00nan;0;0
8370;78094;831;57;29;3;26;.897;3900000;0
8370;148041;831;0;0;0;0;.00nan;0;0
8371;26336;829;0;0;0;0;.00nan;0;0
8371;53867;829;61;26;3;23;.885;3600000;0
8371;54017;833;0;0;0;0;.00nan;0;0
8371;62975;833;100;35;0;35;1.000;3600000;0
8372;8501;837;79;34;3;31;.912;3544000;0
8372;16838;830;0;0;0;0;.00nan;0;0
8372;180731;837;0;0;0;0;.00nan;0;0
8372;47791;830;93;40;1;39;.975;3600000;0
8373;180287;847;53;28;3;25;.893;3600000;0
8373;68390;834;89;33;2;31;.939;3600000;0
8373;87603;847;0;0;0;0;.00nan;0;0
8373;147901;834;0;0;0;0;.00nan;0;0
8374;8501;837;64;35;3;32;.914;3582000;0
8374;167824;828;81;30;2;28;.933;3600000;0
8374;180731;837;0;0;0;0;.00nan;0;0
8374;48141;828;0;0;0;0;.00nan;0;0
8375;5663;836;0;0;0;0;.00nan;0;0
8375;180287;847;0;0;0;0;.00nan;0;0
8375;182116;836;70;29;2;27;.931;3900000;0
8375;87603;847;82;28;2;26;.929;3900000;0
8376;2410;838;99;39;1;38;.974;3600000;0
8376;26336;829;80;28;2;26;.929;3600000;0
8376;53867;829;0;0;0;0;.00nan;0;0
8376;57657;838;0;0;0;0;.00nan;0;0
8377;183545;842;0;0;0;0;.00nan;0;0
8377;16838;830;88;30;2;28;.933;3600000;0
8377;23433;842;67;35;4;31;.886;3530000;0
8377;47791;830;0;0;0;0;.00nan;0;0
8378;47736;848;100;37;2;35;.946;3900000;0
8378;47742;848;0;0;0;0;.00nan;0;0
8378;68390;834;83;37;2;35;.946;3900000;0
8378;147901;834;0;0;0;0;.00nan;0;0
8379;174334;832;0;0;0;0;.00nan;0;0
8379;78094;831;45;45;7;38;.844;3562000;0
8379;78920;832;45;27;5;22;.815;3600000;0
8379;147977;831;0;0;0;0;.00nan;0;0
8380;54017;833;0;0;0;0;.00nan;0;0
8380;62975;833;49;43;6;37;.860;3600000;0
8380;78223;839;0;0;0;0;.00nan;0;0
8380;148041;839;86;33;2;31;.939;3600000;0
8381;8501;837;56;29;4;25;.862;3734000;0
8381;180731;837;0;0;0;0;.00nan;0;0
8381;68390;834;67;27;3;24;.889;3734000;0
8381;147901;834;0;0;0;0;.00nan;0;0
8382;2410;838;31;16;4;12;.750;3600000;0
8382;5663;836;0;0;0;0;.00nan;0;0
8382;182116;836;85;33;2;31;.939;3600000;0
8382;78920;838;0;0;0;0;.00nan;0;0
8383;183545;842;0;0;0;0;.00nan;0;0
8383;23433;842;88;41;2;39;.951;3570000;0
8383;54017;833;0;0;0;0;.00nan;0;0
8383;62975;833;73;9;0;9;1.000;3600000;0
8384;16838;830;55;31;4;27;.871;3600000;0
8384;180287;847;45;34;5;29;.853;3580000;0
8384;47791;830;0;0;0;0;.00nan;0;0
8384;87603;847;0;0;0;0;.00nan;0;0
8385;174334;832;72;21;2;19;.905;3716000;0
8385;180287;847;0;0;0;0;.00nan;0;0
8385;-1;832;0;0;0;0;.00nan;0;0
8385;87603;847;94;46;3;43;.935;3716000;0
8386;2410;838;0;0;0;0;.00nan;0;0
8386;183545;842;73;34;4;30;.882;3900000;0
8386;23433;842;0;0;0;0;.00nan;0;0
8386;78920;838;55;29;4;25;.862;3900000;0
8387;5663;836;81;35;2;33;.943;3571000;0
8387;182116;836;0;0;0;0;.00nan;0;0
8387;68390;834;0;0;0;0;.00nan;0;0
8387;147901;834;79;20;1;19;.950;3600000;0
8388;47736;848;57;26;3;23;.885;3600000;0
8388;47742;848;0;0;0;0;.00nan;0;0
8388;78223;839;0;0;0;0;.00nan;0;0
8388;148041;839;59;38;5;33;.868;3511000;0
8389;16838;830;0;0;0;0;.00nan;0;0
8389;47791;830;56;50;6;44;.880;3600000;0
8389;78094;831;61;21;2;19;.905;3600000;0
8389;147977;831;0;0;0;0;.00nan;0;0
8390;167824;828;22;25;6;19;.760;3600000;0
8390;26336;829;100;30;0;30;1.000;3600000;0
8390;48141;828;0;0;0;0;.00nan;0;0
8390;53867;829;0;0;0;0;.00nan;0;0
8391;167824;828;0;0;0;0;.00nan;0;0
8391;48141;828;59;24;2;22;.917;3600000;0
8391;78223;839;0;0;0;0;.00nan;0;0
8391;148041;839;70;37;3;34;.919;3589000;0
8392;47742;848;56;41;5;36;.878;3600000;0
8392;50199;848;0;0;0;0;.00nan;0;0
8392;78094;831;57;20;2;18;.900;3600000;0
8392;147977;831;0;0;0;0;.00nan;0;0
8393;8501;837;82;35;2;33;.943;3553000;0
8393;180731;837;0;0;0;0;.00nan;0;0
8393;54017;833;0;0;0;0;.00nan;0;0
8393;62975;833;99;31;1;30;.968;3600000;0
8394;167824;828;71;26;2;24;.923;3600000;0
8394;26336;829;57;34;4;30;.882;3596000;0
8394;48141;828;0;0;0;0;.00nan;0;0
8394;53867;829;0;0;0;0;.00nan;0;0
8395;16838;830;78;31;2;29;.935;3600000;0
8395;47742;848;0;0;0;0;.00nan;0;0
8395;47791;830;0;0;0;0;.00nan;0;0
8395;50199;848;29;23;5;18;.783;3600000;0
8396;174334;832;56;24;3;21;.875;3559000;0
8396;175063;847;67;26;2;24;.923;3600000;0
8396;47736;832;0;0;0;0;.00nan;0;0
8396;61292;847;0;0;0;0;.00nan;0;0
8397;26336;829;96;32;1;31;.969;3600000;0
8397;47742;848;66;26;3;23;.885;3523000;0
8397;50199;848;0;0;0;0;.00nan;0;0
8397;53867;829;0;0;0;0;.00nan;0;0
8398;183545;842;0;0;0;0;.00nan;0;0
8398;16838;830;78;24;1;23;.958;3600000;0
8398;23433;842;53;32;5;27;.844;3600000;0
8398;47791;830;0;0;0;0;.00nan;0;0
8399;8501;837;80;41;3;38;.927;3600000;0
8399;180731;837;0;0;0;0;.00nan;0;0
8399;78094;831;92;16;0;16;1.000;3600000;0
8399;147977;831;0;0;0;0;.00nan;0;0
8400;2410;838;0;0;0;0;.00nan;0;0
8400;180287;847;0;0;0;0;.00nan;0;0
8400;78920;838;60;35;4;31;.886;3600000;0
8400;87603;847;72;31;3;28;.903;3600000;0
8401;167824;828;79;46;4;42;.913;3600000;0
8401;48141;828;0;0;0;0;.00nan;0;0
8401;68390;834;69;18;1;17;.944;3600000;0
8401;147901;834;0;0;0;0;.00nan;0;0
8402;5663;836;0;0;0;0;.00nan;0;0
8402;182116;836;90;41;2;39;.951;3600000;0
8402;54017;833;64;30;4;26;.867;3600000;0
8402;62975;833;0;0;0;0;.00nan;0;0
8403;167824;828;0;0;0;0;.00nan;0;0
8403;180287;847;41;25;4;21;.840;3900000;0
8403;48141;828;64;31;4;27;.871;3900000;0
8403;87603;847;0;0;0;0;.00nan;0;0
8404;5663;836;80;36;3;33;.917;3557000;0
8404;8501;837;81;34;2;32;.941;3600000;0
8404;180731;837;0;0;0;0;.00nan;0;0
8404;182116;836;0;0;0;0;.00nan;0;0
8405;2410;838;0;0;0;0;.00nan;0;0
8405;174334;832;55;17;2;15;.882;3600000;0
8405;47736;832;0;0;0;0;.00nan;0;0
8405;78920;838;89;50;4;46;.920;3600000;0
8406;183545;842;0;0;0;0;.00nan;0;0
8406;23433;842;81;43;3;40;.930;3580000;0
8406;68390;834;87;30;2;28;.933;3600000;0
8406;147901;834;0;0;0;0;.00nan;0;0
8407;54017;833;0;0;0;0;.00nan;0;0
8407;62975;833;55;30;4;26;.867;3689000;0
8407;78094;831;62;30;3;27;.900;3689000;0
8407;147977;831;0;0;0;0;.00nan;0;0
8408;16838;830;0;0;0;0;.00nan;0;0
8408;47791;830;84;27;1;26;.963;3600000;0
8408;78223;839;0;0;0;0;.00nan;0;0
8408;148041;839;31;33;6;27;.818;3600000;0
8409;174334;832;58;36;4;32;.889;3583000;0
8409;47736;832;0;0;0;0;.00nan;0;0
8409;47742;848;0;0;0;0;.00nan;0;0
8409;50199;848;48;22;3;19;.864;3600000;0
8410;8501;837;77;25;1;24;.960;3600000;0
8410;167824;828;27;29;6;23;.793;2463000;0
8410;180731;837;0;0;0;0;.00nan;0;0
8410;48141;828;48;19;3;16;.842;1137000;0
8411;167824;828;81;36;3;33;.917;3900000;0
8411;48141;828;0;0;0;0;.00nan;0;0
8411;54017;833;0;0;0;0;.00nan;0;0
8411;62975;833;57;27;3;24;.889;3900000;0
8412;183545;842;49;29;4;25;.862;3226000;0
8412;23433;842;36;11;3;8;.727;374000;0
8412;180287;847;33;4;2;2;.500;881000;0
8412;87603;847;21;22;6;16;.727;2710000;0
8413;2410;838;0;0;0;0;.00nan;0;0
8413;47742;848;66;17;1;16;.941;3900000;0
8413;50199;848;0;0;0;0;.00nan;0;0
8413;78920;838;100;39;1;38;.974;3900000;0
8414;8501;837;64;24;2;22;.917;3600000;0
8414;174334;832;43;22;3;19;.864;3546000;0
8414;180731;837;0;0;0;0;.00nan;0;0
8414;47736;832;0;0;0;0;.00nan;0;0
8415;68390;834;62;23;2;21;.913;3600000;0
8415;78223;839;0;0;0;0;.00nan;0;0
8415;147901;834;0;0;0;0;.00nan;0;0
8415;148041;839;59;37;4;33;.892;3545000;0
8416;5663;836;0;0;0;0;.00nan;0;0
8416;16838;830;73;31;4;27;.871;3600000;0
8416;182116;836;100;27;0;27;1.000;3600000;0
8416;47791;830;0;0;0;0;.00nan;0;0
8417;8501;837;64;20;2;18;.900;3600000;0
8417;180731;837;0;0;0;0;.00nan;0;0
8417;47742;848;86;39;2;37;.949;2527000;0
8417;50199;848;28;16;4;12;.750;1073000;0
8418;5663;836;0;0;0;0;.00nan;0;0
8418;26336;829;90;45;3;42;.933;3600000;0
8418;182116;836;54;36;5;31;.861;3600000;0
8418;53867;829;0;0;0;0;.00nan;0;0
8419;2410;838;0;0;0;0;.00nan;0;0
8419;78223;839;0;0;0;0;.00nan;0;0
8419;78920;838;80;34;3;31;.912;3900000;0
8419;148041;839;61;28;3;25;.893;3900000;0
8420;167824;828;0;0;0;0;.00nan;0;0
8420;183545;842;0;0;0;0;.00nan;0;0
8420;23433;842;98;42;2;40;.952;3545000;0
8420;48141;828;76;26;1;25;.962;3600000;0
8421;180287;847;48;42;6;36;.857;3600000;0
8421;78094;831;53;17;2;15;.882;3600000;0
8421;87603;847;0;0;0;0;.00nan;0;0
8421;147977;831;0;0;0;0;.00nan;0;0
8422;174334;832;57;21;3;18;.857;3889000;0
8422;47736;832;0;0;0;0;.00nan;0;0
8422;54017;833;58;31;3;28;.903;3900000;0
8422;62975;833;0;0;0;0;.00nan;0;0
8423;16838;830;69;43;4;39;.907;3584000;0
8423;47791;830;0;0;0;0;.00nan;0;0
8423;68390;834;63;23;2;21;.913;3600000;0
8423;147901;834;0;0;0;0;.00nan;0;0
8424;26336;829;0;0;0;0;.00nan;0;0
8424;53867;829;76;28;2;26;.929;3600000;0
8424;78094;831;0;0;0;0;.00nan;0;0
8424;147977;831;62;16;1;15;.938;3600000;0
8425;167824;828;46;34;5;29;.853;3600000;0
8425;47742;848;76;29;2;27;.931;3600000;0
8425;48141;828;0;0;0;0;.00nan;0;0
8425;50199;848;0;0;0;0;.00nan;0;0
8426;174334;832;53;17;2;15;.882;3900000;0
8426;26336;829;100;60;2;58;.967;3900000;0
8426;47736;832;0;0;0;0;.00nan;0;0
8426;53867;829;0;0;0;0;.00nan;0;0
8427;5663;836;0;0;0;0;.00nan;0;0
8427;167824;828;76;37;3;34;.919;3600000;0
8427;182116;836;49;28;4;24;.857;3543000;0
8427;48141;828;0;0;0;0;.00nan;0;0
8428;180287;847;0;0;0;0;.00nan;0;0
8428;47742;848;0;0;0;0;.00nan;0;0
8428;50199;848;55;17;2;15;.882;3600000;0
8428;87603;847;66;41;4;37;.902;3569000;0
8429;2410;838;0;0;0;0;.00nan;0;0
8429;78094;831;59;26;3;23;.885;3513000;0
8429;78920;838;99;45;1;44;.978;3600000;0
8429;147977;831;0;0;0;0;.00nan;0;0
8430;183545;842;0;0;0;0;.00nan;0;0
8430;23433;842;76;32;2;30;.938;3600000;0
8430;78223;839;0;0;0;0;.00nan;0;0
8430;148041;839;100;25;0;25;1.000;3600000;0
8431;8501;837;25;23;5;18;.783;3600000;0
8431;26336;829;100;45;2;43;.956;3600000;0
8431;180731;837;0;0;0;0;.00nan;0;0
8431;53867;829;0;0;0;0;.00nan;0;0
8432;16838;830;0;0;0;0;.00nan;0;0
8432;47791;830;88;35;2;33;.943;3600000;0
8432;54017;833;0;0;0;0;.00nan;0;0
8432;62975;833;77;24;1;23;.958;3600000;0
8433;8501;837;86;17;0;17;1.000;3600000;0
8433;183545;842;0;0;0;0;.00nan;0;0
8433;23433;842;92;48;3;45;.938;3600000;0
8433;180731;837;0;0;0;0;.00nan;0;0
8434;5663;836;0;0;0;0;.00nan;0;0
8434;174334;832;56;19;3;16;.842;3771000;0
8434;182116;836;83;53;4;49;.925;3771000;0
8434;47736;832;0;0;0;0;.00nan;0;0
8435;180287;847;80;31;2;29;.935;3554000;0
8435;78223;839;0;0;0;0;.00nan;0;0
8435;87603;847;0;0;0;0;.00nan;0;0
8435;148041;839;99;31;1;30;.968;3600000;0
8436;47742;848;57;20;2;18;.900;3567000;0
8436;50199;848;0;0;0;0;.00nan;0;0
8436;54017;833;0;0;0;0;.00nan;0;0
8436;62975;833;82;26;1;25;.962;3600000;0
8437;2410;838;0;0;0;0;.00nan;0;0
8437;68390;834;85;34;1;33;.971;3600000;0
8437;78920;838;90;46;4;42;.913;3600000;0
8437;147901;834;0;0;0;0;.00nan;0;0
8438;167824;828;73;36;2;34;.944;3513000;0
8438;48141;828;0;0;0;0;.00nan;0;0
8438;78094;831;97;22;0;22;1.000;3600000;0
8438;147977;831;0;0;0;0;.00nan;0;0
8439;16838;830;54;28;4;24;.857;3557000;0
8439;26336;829;81;34;3;31;.912;3600000;0
8439;47791;830;0;0;0;0;.00nan;0;0
8439;53867;829;0;0;0;0;.00nan;0;0
8440;167824;828;86;34;2;32;.941;3900000;0
8440;47742;848;59;19;2;17;.895;3900000;0
8440;48141;828;0;0;0;0;.00nan;0;0
8440;50199;848;0;0;0;0;.00nan;0;0
8441;2410;838;0;0;0;0;.00nan;0;0
8441;8501;837;54;14;2;12;.857;3600000;0
8441;180731;837;0;0;0;0;.00nan;0;0
8441;78920;838;72;50;6;44;.880;3600000;0
8442;5663;836;0;0;0;0;.00nan;0;0
8442;183545;842;0;0;0;0;.00nan;0;0
8442;23433;842;74;39;3;36;.923;3555000;0
8442;182116;836;76;25;1;24;.960;3600000;0
8443;16838;830;92;40;2;38;.950;3900000;0
8443;174334;832;71;32;2;30;.938;3900000;0
8443;47736;832;0;0;0;0;.00nan;0;0
8443;47791;830;0;0;0;0;.00nan;0;0
8444;78094;831;100;32;1;31;.969;3600000;0
8444;78223;839;0;0;0;0;.00nan;0;0
8444;147977;831;0;0;0;0;.00nan;0;0
8444;148041;839;66;35;4;31;.886;3600000;0
8445;26336;829;97;52;3;49;.942;3516000;0
8445;180287;847;87;30;1;29;.967;3600000;0
8445;53867;829;0;0;0;0;.00nan;0;0
8445;87603;847;0;0;0;0;.00nan;0;0
8446;54017;833;0;0;0;0;.00nan;0;0
8446;62975;833;54;37;5;32;.865;3600000;0
8446;68390;834;34;30;7;23;.767;3276000;0
8446;147901;834;25;6;3;3;.500;324000;0
8448;5663;836;0;0;0;0;.00nan;0;0
8448;30431;839;0;0;0;0;.00nan;0;0
8448;182116;836;81;29;3;26;.897;3600000;0
8448;78223;839;92;20;0;20;1.000;3600000;0
8450;2410;838;85;41;4;37;.902;3589000;0
8450;180731;837;42;16;3;13;.813;3600000;0
8450;180929;837;0;0;0;0;.00nan;0;0
8450;57657;838;0;0;0;0;.00nan;0;0
8452;183545;842;100;33;0;33;1.000;3600000;0
8452;23433;842;0;0;0;0;.00nan;0;0
8452;174334;832;0;0;0;0;.00nan;0;0
8452;78920;832;66;32;3;29;.906;3600000;0
8454;8501;848;26;7;3;4;.571;477000;0
8454;16838;830;79;32;2;30;.938;3600000;0
8454;47736;848;49;25;4;21;.840;3123000;0
8454;47791;830;0;0;0;0;.00nan;0;0
8456;180287;847;88;43;3;40;.930;3573000;0
8456;68390;834;67;23;2;21;.913;3600000;0
8456;87603;847;0;0;0;0;.00nan;0;0
8456;147901;834;0;0;0;0;.00nan;0;0
8458;26336;829;86;34;2;32;.941;3659000;0
8458;53867;829;0;0;0;0;.00nan;0;0
8458;54017;833;0;0;0;0;.00nan;0;0
8458;62975;833;59;23;3;20;.870;3659000;0
8460;167824;828;65;31;3;28;.903;3592000;0
8460;48141;828;0;0;0;0;.00nan;0;0
8460;78094;831;0;0;0;0;.00nan;0;0
8460;148041;831;57;22;2;20;.909;3600000;0
8462;54017;833;62;30;4;26;.867;3600000;0
8462;62975;833;0;0;0;0;.00nan;0;0
8462;68390;834;0;0;0;0;.00nan;0;0
8462;147901;834;45;32;5;27;.844;3598000;0
8464;2410;838;0;0;0;0;.00nan;0;0
8464;180731;837;0;0;0;0;.00nan;0;0
8464;180929;837;94;33;1;32;.970;3600000;0
8464;57657;838;54;26;3;23;.885;3574000;0
8466;16838;830;0;0;0;0;.00nan;0;0
8466;47791;830;83;39;2;37;.949;3552000;0
8466;78094;831;78;21;1;20;.952;3600000;0
8466;148041;831;0;0;0;0;.00nan;0;0
8468;8501;848;66;37;3;34;.919;3530000;0
8468;30431;839;0;0;0;0;.00nan;0;0
8468;47736;848;0;0;0;0;.00nan;0;0
8468;78223;839;74;28;1;27;.964;3600000;0
8470;5663;836;73;36;4;32;.889;3900000;0
8470;180287;847;0;0;0;0;.00nan;0;0
8470;182116;836;0;0;0;0;.00nan;0;0
8470;87603;847;77;43;4;39;.907;3900000;0
8472;167824;828;0;0;0;0;.00nan;0;0
8472;183545;842;0;0;0;0;.00nan;0;0
8472;23433;842;48;50;7;43;.860;3600000;0
8472;48141;828;74;29;3;26;.897;3600000;0
8474;174334;832;65;19;1;18;.947;3600000;0
8474;26336;829;0;0;0;0;.00nan;0;0
8474;53867;829;59;36;4;32;.889;3600000;0
8474;78920;832;0;0;0;0;.00nan;0;0
8476;167824;828;60;41;5;36;.878;2238000;0
8476;48141;828;45;9;2;7;.778;1362000;0
8476;68390;834;78;26;1;25;.962;3600000;0
8476;147901;834;0;0;0;0;.00nan;0;0
8484;26336;829;0;0;0;0;.00nan;0;0
8484;30431;839;0;0;0;0;.00nan;0;0
8484;53867;829;87;42;3;39;.929;3584000;0
8484;78223;839;70;21;1;20;.952;3600000;0
8486;2410;838;83;46;4;42;.913;3600000;0
8486;8501;848;17;16;5;11;.688;3548000;0
8486;47736;848;0;0;0;0;.00nan;0;0
8486;57657;838;0;0;0;0;.00nan;0;0
8488;183545;842;59;47;6;41;.872;3600000;0
8488;23433;842;0;0;0;0;.00nan;0;0
8488;174334;832;66;18;1;17;.944;3600000;0
8488;78920;832;0;0;0;0;.00nan;0;0
8492;2410;838;0;0;0;0;.00nan;0;0
8492;26336;829;56;25;3;22;.880;3540000;0
8492;53867;829;0;0;0;0;.00nan;0;0
8492;57657;838;87;37;2;35;.946;3600000;0
8494;167824;828;88;37;2;35;.946;3600000;0
8494;174334;832;0;0;0;0;.00nan;0;0
8494;48141;828;0;0;0;0;.00nan;0;0
8494;78920;832;74;29;3;26;.897;3600000;0
8496;180287;847;33;28;6;22;.786;2968000;0
8496;68390;834;0;0;0;0;.00nan;0;0
8496;87603;847;49;7;1;6;.857;632000;0
8496;147901;834;77;35;3;32;.914;3600000;0
8498;5663;836;0;0;0;0;.00nan;0;0
8498;30431;839;99;37;1;36;.973;3600000;0
8498;182116;836;82;24;2;22;.917;3558000;0
8498;78223;839;0;0;0;0;.00nan;0;0
8504;167824;828;69;34;3;31;.912;3570000;0
8504;48141;828;0;0;0;0;.00nan;0;0
8504;62975;833;69;26;2;24;.923;3600000;0
8504;147977;833;0;0;0;0;.00nan;0;0
8506;26336;829;51;33;4;29;.879;3600000;0
8506;175063;847;75;24;1;23;.958;3600000;0
8506;53867;829;0;0;0;0;.00nan;0;0
8506;61292;847;0;0;0;0;.00nan;0;0
8508;5663;836;0;0;0;0;.00nan;0;0
8508;8501;848;52;25;4;21;.840;3900000;0
8508;182116;836;60;28;4;24;.857;3879000;0
8508;47736;848;0;0;0;0;.00nan;0;0
8514;2410;838;71;45;5;40;.889;3600000;0
8514;57657;838;0;0;0;0;.00nan;0;0
8514;68390;834;75;18;1;17;.944;3600000;0
8514;147901;834;0;0;0;0;.00nan;0;0
8518;26336;829;99;36;1;35;.972;3600000;0
8518;53867;829;0;0;0;0;.00nan;0;0
8518;62975;833;67;25;2;23;.920;3567000;0
8518;147977;833;0;0;0;0;.00nan;0;0
8520;5663;836;0;0;0;0;.00nan;0;0
8520;8501;848;44;30;5;25;.833;3600000;0
8520;182116;836;40;24;4;20;.833;3600000;0
8520;47736;848;0;0;0;0;.00nan;0;0
8522;2410;838;67;27;3;24;.889;3551000;0
8522;30431;839;0;0;0;0;.00nan;0;0
8522;57657;838;0;0;0;0;.00nan;0;0
8522;78223;839;99;41;2;39;.951;3600000;0
8526;167824;828;90;34;2;32;.941;3600000;0
8526;183545;842;61;33;5;28;.848;3600000;0
8526;23433;842;0;0;0;0;.00nan;0;0
8526;48141;828;0;0;0;0;.00nan;0;0
8532;175063;847;0;0;0;0;.00nan;0;0
8532;30431;839;97;38;1;37;.974;3600000;0
8532;61292;847;63;26;2;24;.923;3600000;0
8532;78223;839;0;0;0;0;.00nan;0;0
8534;26336;829;0;0;0;0;.00nan;0;0
8534;53867;829;72;41;3;38;.927;3569000;0
8534;78094;831;66;19;1;18;.947;3600000;0
8534;148041;831;0;0;0;0;.00nan;0;0
8536;16838;830;64;28;3;25;.893;3566000;0
8536;-1;830;0;0;0;0;.00nan;0;0
8536;62975;833;0;0;0;0;.00nan;0;0
8536;147977;833;79;23;1;22;.957;3600000;0
8538;8501;848;0;0;0;0;.00nan;0;0
8538;47736;848;91;40;2;38;.950;3600000;0
8538;68390;834;75;37;3;34;.919;3565000;0
8538;147901;834;0;0;0;0;.00nan;0;0
8540;183545;842;0;0;0;0;.00nan;0;0
8540;23433;842;67;41;5;36;.878;3600000;0
8540;180731;837;98;33;1;32;.970;3600000;0
8540;180929;837;0;0;0;0;.00nan;0;0
8542;167824;828;0;0;0;0;.00nan;0;0
8542;174334;832;0;0;0;0;.00nan;0;0
8542;48141;828;63;32;3;29;.906;3832000;0
8542;78920;832;61;20;2;18;.900;3832000;0
8544;2410;838;0;0;0;0;.00nan;0;0
8544;5663;836;35;17;4;13;.765;3600000;0
8544;182116;836;0;0;0;0;.00nan;0;0
8544;57657;838;68;47;5;42;.894;3600000;0
8545;171673;778;62;47;5;42;.894;3600000;0
8545;202497;778;0;0;0;0;.00nan;0;0
8545;-1;784;100;42;1;41;.976;3600000;0
8545;-1;784;0;0;0;0;.00nan;0;0
8546;8487;783;79;36;2;34;.944;3900000;0
8546;201174;798;74;30;2;28;.933;3900000;0
8546;195942;783;0;0;0;0;.00nan;0;0
8546;-1;798;0;0;0;0;.00nan;0;0
8547;193854;777;63;22;2;20;.909;3600000;0
8547;207726;777;0;0;0;0;.00nan;0;0
8547;207729;794;0;0;0;0;.00nan;0;0
8547;62060;794;81;40;3;37;.925;3598000;0
8548;165867;2182;0;0;0;0;.00nan;0;0
8548;-1;776;0;0;0;0;.00nan;0;0
8548;64066;2182;67;18;1;17;.944;3600000;0
8548;95405;776;58;34;4;30;.882;3600000;0
8549;183377;904;75;42;5;37;.881;3600000;0
8549;-1;780;0;0;0;0;.00nan;0;0
8549;-1;904;0;0;0;0;.00nan;0;0
8549;83199;780;100;27;0;27;1.000;3600000;0
8550;193859;796;0;0;0;0;.00nan;0;0
8550;190702;3737;74;38;3;35;.921;3600000;0
8550;192030;3737;0;0;0;0;.00nan;0;0
8550;149847;796;42;34;5;29;.853;3536000;0
8551;8487;783;70;46;5;41;.891;3600000;0
8551;165867;2182;68;21;1;20;.952;3600000;0
8551;195942;783;0;0;0;0;.00nan;0;0
8551;64066;2182;0;0;0;0;.00nan;0;0
8552;207729;794;0;0;0;0;.00nan;0;0
8552;-1;780;0;0;0;0;.00nan;0;0
8552;62060;794;81;43;2;41;.953;3600000;0
8552;83199;780;66;25;3;22;.880;3548000;0
8553;193859;796;0;0;0;0;.00nan;0;0
8553;171673;778;64;23;2;21;.913;3582000;0
8553;202497;778;0;0;0;0;.00nan;0;0
8553;149847;796;93;25;0;25;1.000;3600000;0
8554;201174;798;40;23;4;19;.826;3564000;0
8554;-1;798;0;0;0;0;.00nan;0;0
8554;-1;784;50;22;3;19;.864;3600000;0
8554;-1;784;0;0;0;0;.00nan;0;0
8555;183377;904;30;20;5;15;.750;3600000;0
8555;190702;3737;65;23;2;21;.913;3600000;0
8555;192030;3737;0;0;0;0;.00nan;0;0
8555;-1;904;0;0;0;0;.00nan;0;0
8556;193854;777;93;23;0;23;1.000;3600000;0
8556;207726;777;0;0;0;0;.00nan;0;0
8556;-1;776;0;0;0;0;.00nan;0;0
8556;95405;776;78;39;3;36;.923;3600000;0
8557;193859;796;0;0;0;0;.00nan;0;0
8557;183377;904;76;39;3;36;.923;3590000;0
8557;-1;904;0;0;0;0;.00nan;0;0
8557;149847;796;68;19;1;18;.947;3600000;0
8558;165867;2182;68;23;2;21;.913;3600000;0
8558;-1;784;67;40;4;36;.900;3568000;0
8558;-1;784;0;0;0;0;.00nan;0;0
8558;64066;2182;0;0;0;0;.00nan;0;0
8559;171673;778;100;25;0;25;1.000;3900000;0
8559;201174;798;96;38;0;38;1.000;3900000;0
8559;202497;778;0;0;0;0;.00nan;0;0
8559;-1;798;0;0;0;0;.00nan;0;0
8560;8487;783;52;53;7;46;.868;3600000;0
8560;193854;777;60;19;2;17;.895;3600000;0
8560;195942;783;0;0;0;0;.00nan;0;0
8560;207726;777;0;0;0;0;.00nan;0;0
8561;-1;776;0;0;0;0;.00nan;0;0
8561;-1;780;55;4;0;4;1.000;1417000;0
8561;83199;780;38;21;4;17;.810;2175000;0
8561;95405;776;88;40;2;38;.950;3600000;0
8562;190702;3737;90;21;0;21;1.000;3600000;0
8562;207729;794;0;0;0;0;.00nan;0;0
8562;192030;3737;0;0;0;0;.00nan;0;0
8562;62060;794;72;29;3;26;.897;3600000;0
8563;8487;783;50;30;4;26;.867;3600000;0
8563;195942;783;0;0;0;0;.00nan;0;0
8563;-1;780;0;0;0;0;.00nan;0;0
8563;83199;780;26;25;6;19;.760;3517000;0
8564;193859;796;0;0;0;0;.00nan;0;0
8564;207729;794;0;0;0;0;.00nan;0;0
8564;62060;794;70;55;5;50;.909;3900000;0
8564;149847;796;39;26;5;21;.808;3900000;0
8565;183377;904;51;40;5;35;.875;3347000;0
8565;171673;778;72;22;1;21;.955;3600000;0
8565;202497;778;0;0;0;0;.00nan;0;0
8565;-1;904;49;1;0;1;1.000;253000;0
8566;193854;777;63;27;3;24;.889;3571000;0
8566;207726;777;0;0;0;0;.00nan;0;0
8566;-1;784;94;44;2;42;.955;3600000;0
8566;-1;784;0;0;0;0;.00nan;0;0
8567;190702;3737;69;35;4;31;.886;3567000;0
8567;192030;3737;0;0;0;0;.00nan;0;0
8567;-1;776;0;0;0;0;.00nan;0;0
8567;95405;776;64;24;2;22;.917;3600000;0
8568;165867;2182;75;10;0;10;1.000;3600000;0
8568;201174;798;91;43;2;41;.953;3538000;0
8568;-1;798;0;0;0;0;.00nan;0;0
8568;64066;2182;0;0;0;0;.00nan;0;0
8569;183377;904;0;0;0;0;.00nan;0;0
8569;207729;794;0;0;0;0;.00nan;0;0
8569;-1;904;57;24;3;21;.875;3600000;0
8569;62060;794;82;41;4;37;.902;3600000;0
8570;193854;777;41;19;3;16;.842;3545000;0
8570;201174;798;99;48;2;46;.958;3600000;0
8570;207726;777;0;0;0;0;.00nan;0;0
8570;-1;798;0;0;0;0;.00nan;0;0
8571;193859;796;0;0;0;0;.00nan;0;0
8571;-1;776;57;9;1;8;.889;310000;0
8571;95405;776;55;49;6;43;.878;3290000;0
8571;149847;796;40;17;3;14;.824;3600000;0
8572;-1;784;62;36;4;32;.889;3580000;0
8572;-1;780;57;24;3;21;.875;3600000;0
8572;-1;784;0;0;0;0;.00nan;0;0
8572;83199;780;0;0;0;0;.00nan;0;0
8573;165867;2182;63;31;3;28;.903;3600000;0
8573;171673;778;100;35;0;35;1.000;3600000;0
8573;202497;778;0;0;0;0;.00nan;0;0
8573;64066;2182;0;0;0;0;.00nan;0;0
8574;8487;783;42;19;3;16;.842;3600000;0
8574;195942;783;0;0;0;0;.00nan;0;0
8574;190702;3737;100;41;0;41;1.000;3600000;0
8574;192030;3737;0;0;0;0;.00nan;0;0
8575;8487;783;68;37;3;34;.919;3600000;0
8575;193859;796;0;0;0;0;.00nan;0;0
8575;195942;783;0;0;0;0;.00nan;0;0
8575;149847;796;28;37;7;30;.811;3600000;0
8576;201174;798;0;0;0;0;.00nan;0;0
8576;-1;798;55;38;4;34;.895;3523000;0
8576;-1;780;0;0;0;0;.00nan;0;0
8576;83199;780;67;28;2;26;.929;3600000;0
8577;171673;778;63;22;3;19;.864;3600000;0
8577;207729;794;0;0;0;0;.00nan;0;0
8577;202497;778;0;0;0;0;.00nan;0;0
8577;62060;794;30;35;7;28;.800;3600000;0
8578;190702;3737;70;29;3;26;.897;3600000;0
8578;192030;3737;0;0;0;0;.00nan;0;0
8578;-1;784;0;0;0;0;.00nan;0;0
8578;-1;784;42;22;4;18;.818;3552000;0
8579;183377;904;75;46;5;41;.891;3600000;0
8579;-1;776;0;0;0;0;.00nan;0;0
8579;-1;904;0;0;0;0;.00nan;0;0
8579;95405;776;80;22;1;21;.955;3600000;0
8580;193854;777;70;29;3;26;.897;3545000;0
8580;165867;2182;82;30;2;28;.933;3600000;0
8580;207726;777;0;0;0;0;.00nan;0;0
8580;64066;2182;0;0;0;0;.00nan;0;0
8581;8487;783;87;30;1;29;.967;3600000;0
8581;183377;904;61;36;4;32;.889;3600000;0
8581;195942;783;0;0;0;0;.00nan;0;0
8581;-1;904;0;0;0;0;.00nan;0;0
8582;193859;796;0;0;0;0;.00nan;0;0
8582;-1;784;80;26;1;25;.962;3600000;0
8582;-1;784;0;0;0;0;.00nan;0;0
8582;149847;796;77;31;2;29;.935;3593000;0
8583;201174;798;61;29;3;26;.897;3900000;0
8583;190702;3737;82;45;3;42;.933;3900000;0
8583;192030;3737;0;0;0;0;.00nan;0;0
8583;-1;798;0;0;0;0;.00nan;0;0
8584;193854;777;79;34;3;31;.912;3564000;0
8584;171673;778;85;34;2;32;.941;3600000;0
8584;207726;777;0;0;0;0;.00nan;0;0
8584;202497;778;0;0;0;0;.00nan;0;0
8585;207729;794;0;0;0;0;.00nan;0;0
8585;-1;776;0;0;0;0;.00nan;0;0
8585;62060;794;85;28;1;27;.964;3600000;0
8585;95405;776;59;26;3;23;.885;3583000;0
8586;165867;2182;100;28;0;28;1.000;3600000;0
8586;-1;780;0;0;0;0;.00nan;0;0
8586;64066;2182;0;0;0;0;.00nan;0;0
8586;83199;780;97;51;3;48;.941;3600000;0
8587;193859;796;0;0;0;0;.00nan;0;0
8587;201174;798;100;32;0;32;1.000;3600000;0
8587;-1;798;0;0;0;0;.00nan;0;0
8587;149847;796;70;27;2;25;.926;3551000;0
8588;193854;777;0;0;0;0;.00nan;0;0
8588;207726;777;65;32;3;29;.906;3600000;0
8588;-1;780;0;0;0;0;.00nan;0;0
8588;83199;780;86;49;4;45;.918;3563000;0
8589;8487;783;72;36;3;33;.917;3559000;0
8589;195942;783;0;0;0;0;.00nan;0;0
8589;207729;794;80;26;1;25;.962;3600000;0
8589;62060;794;0;0;0;0;.00nan;0;0
8590;171673;778;73;20;1;19;.950;3600000;0
8590;202497;778;0;0;0;0;.00nan;0;0
8590;-1;776;0;0;0;0;.00nan;0;0
8590;95405;776;73;34;2;32;.941;3545000;0
8591;183377;904;50;41;5;36;.878;3570000;0
8591;-1;784;40;17;3;14;.824;3600000;0
8591;-1;904;0;0;0;0;.00nan;0;0
8591;-1;784;0;0;0;0;.00nan;0;0
8592;165867;2182;86;30;1;29;.967;3600000;0
8592;190702;3737;77;39;3;36;.923;3571000;0
8592;192030;3737;0;0;0;0;.00nan;0;0
8592;64066;2182;0;0;0;0;.00nan;0;0
8593;183377;904;85;41;2;39;.951;3600000;0
8593;201174;798;20;9;4;5;.556;1002000;0
8593;-1;798;51;20;3;17;.850;2598000;0
8593;-1;904;0;0;0;0;.00nan;0;0
8594;8487;783;55;31;4;27;.871;3600000;0
8594;195942;783;0;0;0;0;.00nan;0;0
8594;-1;776;0;0;0;0;.00nan;0;0
8594;95405;776;55;28;5;23;.821;3577000;0
8595;207729;794;0;0;0;0;.00nan;0;0
8595;-1;784;70;29;2;27;.931;3600000;0
8595;-1;784;0;0;0;0;.00nan;0;0
8595;62060;794;41;28;4;24;.857;3532000;0
8596;171673;778;67;35;4;31;.886;3574000;0
8596;202497;778;0;0;0;0;.00nan;0;0
8596;-1;780;0;0;0;0;.00nan;0;0
8596;83199;780;62;24;3;21;.875;3600000;0
8597;193859;796;0;0;0;0;.00nan;0;0
8597;165867;2182;0;0;0;0;.00nan;0;0
8597;64066;2182;74;29;2;27;.931;3600000;0
8597;149847;796;89;46;4;42;.913;3600000;0
8598;193854;777;79;32;2;30;.938;3600000;0
8598;190702;3737;0;0;0;0;.00nan;0;0
8598;207726;777;0;0;0;0;.00nan;0;0
8598;192030;3737;61;33;4;29;.879;3520000;0
8599;201174;798;47;26;4;22;.846;3561000;0
8599;207729;794;0;0;0;0;.00nan;0;0
8599;-1;798;0;0;0;0;.00nan;0;0
8599;62060;794;94;39;2;37;.949;3600000;0
8600;193854;777;75;29;2;27;.931;3600000;0
8600;193859;796;0;0;0;0;.00nan;0;0
8600;207726;777;0;0;0;0;.00nan;0;0
8600;149847;796;54;27;4;23;.852;3528000;0
8601;8487;783;51;29;4;25;.862;3600000;0
8601;171673;778;91;21;0;21;1.000;3600000;0
8601;195942;783;0;0;0;0;.00nan;0;0
8601;202497;778;0;0;0;0;.00nan;0;0
8602;-1;784;89;36;3;33;.917;3880000;0
8602;-1;776;0;0;0;0;.00nan;0;0
8602;-1;784;0;0;0;0;.00nan;0;0
8602;95405;776;61;37;4;33;.892;3880000;0
8603;190702;3737;71;29;2;27;.931;3900000;0
8603;192030;3737;0;0;0;0;.00nan;0;0
8603;-1;780;0;0;0;0;.00nan;0;0
8603;83199;780;60;17;2;15;.882;3900000;0
8604;183377;904;67;47;5;42;.894;3600000;0
8604;165867;2182;100;21;0;21;1.000;3600000;0
8604;-1;904;0;0;0;0;.00nan;0;0
8604;64066;2182;0;0;0;0;.00nan;0;0
8605;8487;783;52;25;3;22;.880;3600000;0
8605;195942;783;0;0;0;0;.00nan;0;0
8605;-1;784;62;38;4;34;.895;3600000;0
8605;-1;784;0;0;0;0;.00nan;0;0
8606;193854;777;44;20;4;16;.800;3600000;0
8606;183377;904;83;57;5;52;.912;3600000;0
8606;207726;777;0;0;0;0;.00nan;0;0
8606;-1;904;0;0;0;0;.00nan;0;0
8607;171673;778;100;28;0;28;1.000;3600000;0
8607;190702;3737;91;33;1;32;.970;3546000;0
8607;202497;778;0;0;0;0;.00nan;0;0
8607;192030;3737;0;0;0;0;.00nan;0;0
8608;165867;2182;84;29;1;28;.966;3900000;0
8608;207729;794;0;0;0;0;.00nan;0;0
8608;62060;794;93;32;1;31;.969;3900000;0
8608;64066;2182;0;0;0;0;.00nan;0;0
8609;201174;798;70;26;2;24;.923;3900000;0
8609;-1;798;0;0;0;0;.00nan;0;0
8609;-1;776;75;34;2;32;.941;3900000;0
8609;95405;776;0;0;0;0;.00nan;0;0
8610;193859;796;0;0;0;0;.00nan;0;0
8610;-1;780;91;31;1;30;.968;3600000;0
8610;83199;780;0;0;0;0;.00nan;0;0
8610;149847;796;62;29;3;26;.897;3600000;0
8611;8487;783;81;33;2;31;.939;3600000;0
8611;201174;798;0;0;0;0;.00nan;0;0
8611;195942;783;0;0;0;0;.00nan;0;0
8611;-1;798;95;38;1;37;.974;3600000;0
8612;193854;777;53;29;4;25;.862;3600000;0
8612;207726;777;0;0;0;0;.00nan;0;0
8612;207729;794;71;52;5;47;.904;3600000;0
8612;62060;794;0;0;0;0;.00nan;0;0
8613;171673;778;54;43;6;37;.860;3600000;0
8613;202497;778;0;0;0;0;.00nan;0;0
8613;-1;784;68;21;1;20;.952;3600000;0
8613;-1;784;0;0;0;0;.00nan;0;0
8614;183377;904;74;22;1;21;.955;3600000;0
8614;-1;780;0;0;0;0;.00nan;0;0
8614;-1;904;0;0;0;0;.00nan;0;0
8614;83199;780;72;23;2;21;.913;3571000;0
8615;165867;2182;55;17;2;15;.882;3667000;0
8615;-1;776;0;0;0;0;.00nan;0;0
8615;64066;2182;0;0;0;0;.00nan;0;0
8615;95405;776;69;28;3;25;.893;3664000;0
8616;193859;796;0;0;0;0;.00nan;0;0
8616;190702;3737;27;8;3;5;.625;540000;0
8616;192030;3737;62;34;3;31;.912;3060000;0
8616;149847;796;56;26;3;23;.885;3600000;0
8617;8487;783;75;46;5;41;.891;3560000;0
8617;165867;2182;54;24;3;21;.875;3600000;0
8617;195942;783;0;0;0;0;.00nan;0;0
8617;64066;2182;0;0;0;0;.00nan;0;0
8618;201174;798;74;37;3;34;.919;3600000;0
8618;-1;798;0;0;0;0;.00nan;0;0
8618;-1;784;83;28;1;27;.964;3600000;0
8618;-1;784;0;0;0;0;.00nan;0;0
8619;193859;796;0;0;0;0;.00nan;0;0
8619;171673;778;100;53;1;52;.981;3900000;0
8619;202497;778;0;0;0;0;.00nan;0;0
8619;149847;796;77;28;1;27;.964;3900000;0
8620;193854;777;79;25;1;24;.960;3600000;0
8620;207726;777;0;0;0;0;.00nan;0;0
8620;-1;776;0;0;0;0;.00nan;0;0
8620;95405;776;73;34;3;31;.912;3544000;0
8621;207729;794;0;0;0;0;.00nan;0;0
8621;-1;780;0;0;0;0;.00nan;0;0
8621;62060;794;100;44;1;43;.977;3600000;0
8621;83199;780;46;21;3;18;.857;3578000;0
8622;183377;904;89;35;1;34;.971;3600000;0
8622;190702;3737;77;27;2;25;.926;3600000;0
8622;192030;3737;0;0;0;0;.00nan;0;0
8622;-1;904;0;0;0;0;.00nan;0;0
8623;8487;783;66;33;4;29;.879;3576000;0
8623;193854;777;63;31;3;28;.903;3600000;0
8623;195942;783;0;0;0;0;.00nan;0;0
8623;207726;777;0;0;0;0;.00nan;0;0
8624;190702;3737;45;38;5;33;.868;3600000;0
8624;207729;794;0;0;0;0;.00nan;0;0
8624;192030;3737;0;0;0;0;.00nan;0;0
8624;62060;794;66;35;4;31;.886;3600000;0
8625;171673;778;61;27;3;24;.889;3600000;0
8625;201174;798;65;39;4;35;.897;3572000;0
8625;202497;778;0;0;0;0;.00nan;0;0
8625;-1;798;0;0;0;0;.00nan;0;0
8626;165867;2182;60;32;3;29;.906;3597000;0
8626;-1;784;99;44;2;42;.955;3600000;0
8626;-1;784;0;0;0;0;.00nan;0;0
8626;64066;2182;0;0;0;0;.00nan;0;0
8627;193859;796;0;0;0;0;.00nan;0;0
8627;183377;904;58;28;3;25;.893;3533000;0
8627;-1;904;0;0;0;0;.00nan;0;0
8627;149847;796;72;19;1;18;.947;3600000;0
8628;-1;776;0;0;0;0;.00nan;0;0
8628;-1;780;0;0;0;0;.00nan;0;0
8628;83199;780;90;28;1;27;.964;3741000;0
8628;95405;776;62;20;2;18;.900;3741000;0
8629;183377;904;56;34;4;30;.882;3900000;0
8629;171673;778;63;39;4;35;.897;3900000;0
8629;202497;778;0;0;0;0;.00nan;0;0
8629;-1;904;0;0;0;0;.00nan;0;0
8630;165867;2182;56;18;2;16;.889;3600000;0
8630;201174;798;49;43;6;37;.860;2964000;0
8630;-1;798;65;9;0;9;1.000;636000;0
8630;64066;2182;0;0;0;0;.00nan;0;0
8631;193854;777;73;35;3;32;.914;3900000;0
8631;207726;777;0;0;0;0;.00nan;0;0
8631;-1;784;75;42;3;39;.929;3900000;0
8631;-1;784;0;0;0;0;.00nan;0;0
8632;193859;796;0;0;0;0;.00nan;0;0
8632;207729;794;46;7;1;6;.857;782000;0
8632;62060;794;28;30;6;24;.800;2818000;0
8632;149847;796;63;21;2;19;.905;3600000;0
8633;8487;783;49;22;3;19;.864;3568000;0
8633;195942;783;0;0;0;0;.00nan;0;0
8633;-1;780;0;0;0;0;.00nan;0;0
8633;83199;780;84;29;1;28;.966;3600000;0
8634;190702;3737;94;36;3;33;.917;3578000;0
8634;192030;3737;0;0;0;0;.00nan;0;0
8634;-1;776;0;0;0;0;.00nan;0;0
8634;95405;776;72;31;2;29;.935;3600000;0
8635;8487;783;85;30;1;29;.967;3600000;0
8635;195942;783;0;0;0;0;.00nan;0;0
8635;190702;3737;68;27;2;25;.926;3565000;0
8635;192030;3737;0;0;0;0;.00nan;0;0
8636;193854;777;91;39;2;37;.949;3600000;0
8636;201174;798;81;43;3;40;.930;3548000;0
8636;207726;777;0;0;0;0;.00nan;0;0
8636;-1;798;0;0;0;0;.00nan;0;0
8637;183377;904;67;32;3;29;.906;3585000;0
8637;207729;794;0;0;0;0;.00nan;0;0
8637;-1;904;0;0;0;0;.00nan;0;0
8637;62060;794;78;25;2;23;.920;3600000;0
8638;171673;778;94;21;0;21;1.000;3600000;0
8638;202497;778;0;0;0;0;.00nan;0;0
8638;64066;2182;21;24;6;18;.750;3261000;0
8638;66924;2182;56;3;0;3;1.000;339000;0
8639;193859;796;0;0;0;0;.00nan;0;0
8639;-1;776;0;0;0;0;.00nan;0;0
8639;95405;776;77;31;2;29;.935;3599000;0
8639;149847;796;81;19;1;18;.947;3600000;0
8640;24177;780;61;29;3;26;.897;3600000;0
8640;-1;784;86;38;2;36;.947;3600000;0
8640;-1;780;0;0;0;0;.00nan;0;0
8640;-1;784;0;0;0;0;.00nan;0;0
8641;183377;904;78;24;1;23;.958;3600000;0
8641;-1;776;0;0;0;0;.00nan;0;0
8641;-1;904;0;0;0;0;.00nan;0;0
8641;95405;776;35;22;5;17;.773;3600000;0
8642;8487;783;68;36;3;33;.917;3600000;0
8642;193859;796;0;0;0;0;.00nan;0;0
8642;195942;783;0;0;0;0;.00nan;0;0
8642;149847;796;94;22;0;22;1.000;3600000;0
8643;193854;777;79;24;1;23;.958;3600000;0
8643;165867;2182;66;30;3;27;.900;3598000;0
8643;207726;777;0;0;0;0;.00nan;0;0
8643;64066;2182;0;0;0;0;.00nan;0;0
8644;171673;778;40;32;6;26;.813;3600000;0
8644;207729;794;0;0;0;0;.00nan;0;0
8644;202497;778;0;0;0;0;.00nan;0;0
8644;62060;794;63;32;4;28;.875;3600000;0
8645;201174;798;72;40;3;37;.925;3549000;0
8645;-1;798;0;0;0;0;.00nan;0;0
8645;-1;780;0;0;0;0;.00nan;0;0
8645;83199;780;89;35;2;33;.943;3600000;0
8646;190702;3737;57;32;4;28;.875;3663000;0
8646;192030;3737;0;0;0;0;.00nan;0;0
8646;-1;784;59;40;5;35;.875;3663000;0
8646;-1;784;0;0;0;0;.00nan;0;0
8647;8487;783;63;18;1;17;.944;3600000;0
8647;183377;904;73;39;4;35;.897;3600000;0
8647;195942;783;0;0;0;0;.00nan;0;0
8647;-1;904;0;0;0;0;.00nan;0;0
8648;201174;798;59;30;4;26;.867;3600000;0
8648;190702;3737;95;45;3;42;.933;3600000;0
8648;192030;3737;0;0;0;0;.00nan;0;0
8648;-1;798;0;0;0;0;.00nan;0;0
8649;193859;796;0;0;0;0;.00nan;0;0
8649;-1;784;64;34;4;30;.882;3600000;0
8649;-1;784;0;0;0;0;.00nan;0;0
8649;149847;796;29;28;5;23;.821;3562000;0
8650;207729;794;0;0;0;0;.00nan;0;0
8650;-1;776;81;30;1;29;.967;3600000;0
8650;62060;794;54;23;3;20;.870;3591000;0
8650;95405;776;0;0;0;0;.00nan;0;0
8651;165867;2182;82;47;4;43;.915;3600000;0
8651;-1;780;0;0;0;0;.00nan;0;0
8651;64066;2182;0;0;0;0;.00nan;0;0
8651;83199;780;100;21;0;21;1.000;3600000;0
8652;193854;777;76;32;2;30;.938;3600000;0
8652;171673;778;76;42;4;38;.905;3578000;0
8652;207726;777;0;0;0;0;.00nan;0;0
8652;202497;778;0;0;0;0;.00nan;0;0
8653;193859;796;0;0;0;0;.00nan;0;0
8653;201174;798;0;0;0;0;.00nan;0;0
8653;-1;798;67;27;2;25;.926;3600000;0
8653;149847;796;85;26;1;25;.962;3600000;0
8654;8487;783;73;24;2;22;.917;3600000;0
8654;195942;783;0;0;0;0;.00nan;0;0
8654;207729;794;0;0;0;0;.00nan;0;0
8654;62060;794;83;50;4;46;.920;3599000;0
8655;183377;904;74;40;4;36;.900;3560000;0
8655;-1;784;58;19;2;17;.895;3600000;0
8655;-1;904;0;0;0;0;.00nan;0;0
8655;-1;784;0;0;0;0;.00nan;0;0
8656;171673;778;82;25;1;24;.960;3600000;0
8656;202497;778;0;0;0;0;.00nan;0;0
8656;-1;776;0;0;0;0;.00nan;0;0
8656;95405;776;71;25;2;23;.920;3544000;0
8657;193854;777;69;21;1;20;.952;3600000;0
8657;207726;777;0;0;0;0;.00nan;0;0
8657;-1;780;0;0;0;0;.00nan;0;0
8657;83199;780;75;28;2;26;.929;3545000;0
8658;165867;2182;70;25;2;23;.920;3600000;0
8658;190702;3737;79;42;3;39;.929;3575000;0
8658;192030;3737;0;0;0;0;.00nan;0;0
8658;64066;2182;0;0;0;0;.00nan;0;0
8659;183377;904;85;26;2;24;.923;3600000;0
8659;201174;798;63;29;4;25;.862;3588000;0
8659;-1;798;0;0;0;0;.00nan;0;0
8659;-1;904;0;0;0;0;.00nan;0;0
8660;207729;794;0;0;0;0;.00nan;0;0
8660;-1;784;79;24;1;23;.958;3600000;0
8660;-1;784;0;0;0;0;.00nan;0;0
8660;62060;794;43;37;5;32;.865;3600000;0
8661;8487;783;50;29;5;24;.828;2332000;0
8661;195942;783;46;13;2;11;.846;1268000;0
8661;-1;776;0;0;0;0;.00nan;0;0
8661;95405;776;73;28;2;26;.929;3600000;0
8662;171673;778;88;29;1;28;.966;3600000;0
8662;202497;778;0;0;0;0;.00nan;0;0
8662;-1;780;0;0;0;0;.00nan;0;0
8662;83199;780;75;31;2;29;.935;3549000;0
8663;193854;777;0;0;0;0;.00nan;0;0
8663;190702;3737;35;11;3;8;.727;580000;0
8663;207726;777;60;17;2;15;.882;3600000;0
8663;192030;3737;56;27;2;25;.926;3020000;0
8664;193859;796;0;0;0;0;.00nan;0;0
8664;165867;2182;0;0;0;0;.00nan;0;0
8664;64066;2182;95;38;2;36;.947;3600000;0
8664;149847;796;65;37;4;33;.892;3577000;0
8665;8487;783;64;31;3;28;.903;3564000;0
8665;171673;778;76;21;1;20;.952;3600000;0
8665;195942;783;0;0;0;0;.00nan;0;0
8665;202497;778;0;0;0;0;.00nan;0;0
8666;193854;777;44;26;4;22;.846;3572000;0
8666;193859;796;0;0;0;0;.00nan;0;0
8666;207726;777;0;0;0;0;.00nan;0;0
8666;149847;796;79;32;3;29;.906;3600000;0
8667;201174;798;96;40;2;38;.950;3600000;0
8667;207729;794;0;0;0;0;.00nan;0;0
8667;-1;798;0;0;0;0;.00nan;0;0
8667;62060;794;29;35;7;28;.800;3600000;0
8668;183377;904;58;57;7;50;.877;3600000;0
8668;165867;2182;70;19;1;18;.947;3600000;0
8668;-1;904;0;0;0;0;.00nan;0;0
8668;64066;2182;0;0;0;0;.00nan;0;0
8669;-1;784;53;28;4;24;.857;3600000;0
8669;-1;776;88;40;3;37;.925;3172000;0
8669;-1;784;0;0;0;0;.00nan;0;0
8669;95405;776;25;6;3;3;.500;422000;0
8670;190702;3737;60;37;4;33;.892;3531000;0
8670;192030;3737;0;0;0;0;.00nan;0;0
8670;-1;780;0;0;0;0;.00nan;0;0
8670;83199;780;69;24;2;22;.917;3600000;0
8671;8487;783;0;0;0;0;.00nan;0;0
8671;195942;783;94;32;1;31;.969;3600000;0
8671;-1;784;56;27;3;24;.889;3576000;0
8671;-1;784;0;0;0;0;.00nan;0;0
8672;201174;798;60;29;3;26;.897;3584000;0
8672;-1;798;0;0;0;0;.00nan;0;0
8672;-1;776;0;0;0;0;.00nan;0;0
8672;95405;776;84;37;2;35;.946;3600000;0
8673;193854;777;100;25;0;25;1.000;3600000;0
8673;183377;904;84;44;3;41;.932;3600000;0
8673;207726;777;0;0;0;0;.00nan;0;0
8673;-1;904;0;0;0;0;.00nan;0;0
8674;193859;796;0;0;0;0;.00nan;0;0
8674;-1;780;62;34;4;30;.882;3513000;0
8674;83199;780;0;0;0;0;.00nan;0;0
8674;149847;796;75;32;2;30;.938;3600000;0
8675;165867;2182;39;26;5;21;.808;3600000;0
8675;207729;794;0;0;0;0;.00nan;0;0
8675;62060;794;99;37;1;36;.973;3600000;0
8675;64066;2182;0;0;0;0;.00nan;0;0
8676;171673;778;93;22;0;22;1.000;3600000;0
8676;190702;3737;0;0;0;0;.00nan;0;0
8676;202497;778;0;0;0;0;.00nan;0;0
8676;192030;3737;72;40;3;37;.925;3600000;0
8677;8487;783;100;21;0;21;1.000;3600000;0
8677;201174;798;54;33;4;29;.879;3600000;0
8677;195942;783;0;0;0;0;.00nan;0;0
8677;-1;798;0;0;0;0;.00nan;0;0
8678;193854;777;55;23;3;20;.870;3599000;0
8678;207726;777;0;0;0;0;.00nan;0;0
8678;207729;794;0;0;0;0;.00nan;0;0
8678;62060;794;83;33;2;31;.939;3600000;0
8679;171673;778;32;18;5;13;.722;3591000;0
8679;202497;778;0;0;0;0;.00nan;0;0
8679;-1;784;0;0;0;0;.00nan;0;0
8679;-1;784;73;27;3;24;.889;3600000;0
8680;193859;796;24;12;4;8;.667;3562000;0
8680;190702;3737;100;47;2;45;.957;3600000;0
8680;192030;3737;0;0;0;0;.00nan;0;0
8680;149847;796;0;0;0;0;.00nan;0;0
8681;165867;2182;60;17;2;15;.882;3600000;0
8681;-1;776;0;0;0;0;.00nan;0;0
8681;64066;2182;0;0;0;0;.00nan;0;0
8681;95405;776;29;32;6;26;.813;3600000;0
8682;183377;904;61;36;4;32;.889;3527000;0
8682;-1;780;0;0;0;0;.00nan;0;0
8682;-1;904;0;0;0;0;.00nan;0;0
8682;83199;780;83;35;2;33;.943;3600000;0
8683;183377;904;77;44;3;41;.932;3890000;0
8683;190702;3737;36;20;3;17;.850;3900000;0
8683;192030;3737;0;0;0;0;.00nan;0;0
8683;-1;904;0;0;0;0;.00nan;0;0
8684;201174;798;61;37;4;33;.892;3531000;0
8684;-1;798;0;0;0;0;.00nan;0;0
8684;-1;784;63;30;3;27;.900;3600000;0
8684;-1;784;0;0;0;0;.00nan;0;0
8685;193859;796;0;0;0;0;.00nan;0;0
8685;171673;778;52;29;4;25;.862;3600000;0
8685;202497;778;0;0;0;0;.00nan;0;0
8685;149847;796;98;21;0;21;1.000;3600000;0
8686;207729;794;57;28;3;25;.893;3600000;0
8686;-1;780;43;4;1;3;.750;641000;0
8686;62060;794;0;0;0;0;.00nan;0;0
8686;83199;780;24;25;6;19;.760;2959000;0
8687;193854;777;61;27;3;24;.889;3693000;0
8687;207726;777;0;0;0;0;.00nan;0;0
8687;-1;776;0;0;0;0;.00nan;0;0
8687;95405;776;49;29;4;25;.862;3693000;0
8688;8487;783;84;46;4;42;.913;3600000;0
8688;165867;2182;90;34;1;33;.971;3600000;0
8688;195942;783;0;0;0;0;.00nan;0;0
8688;64066;2182;0;0;0;0;.00nan;0;0
8689;171673;778;72;31;3;28;.903;3885000;0
8689;201174;798;66;35;4;31;.886;3885000;0
8689;202497;778;0;0;0;0;.00nan;0;0
8689;-1;798;0;0;0;0;.00nan;0;0
8690;8487;783;88;55;5;50;.909;3600000;0
8690;193854;777;63;18;1;17;.944;3600000;0
8690;195942;783;0;0;0;0;.00nan;0;0
8690;207726;777;0;0;0;0;.00nan;0;0
8691;193859;796;0;0;0;0;.00nan;0;0
8691;183377;904;62;48;6;42;.875;3600000;0
8691;-1;904;0;0;0;0;.00nan;0;0
8691;149847;796;43;11;3;8;.727;3600000;0
8692;-1;776;0;0;0;0;.00nan;0;0
8692;-1;780;0;0;0;0;.00nan;0;0
8692;83199;780;81;27;1;26;.963;3900000;0
8692;95405;776;95;44;1;43;.977;3900000;0
8693;165867;2182;0;0;0;0;.00nan;0;0
8693;-1;784;92;40;2;38;.950;3541000;0
8693;-1;784;0;0;0;0;.00nan;0;0
8693;64066;2182;80;23;1;22;.957;3600000;0
8694;190702;3737;0;0;0;0;.00nan;0;0
8694;207729;794;0;0;0;0;.00nan;0;0
8694;192030;3737;75;30;2;28;.933;3600000;0
8694;62060;794;50;35;5;30;.857;3566000;0
8695;201174;798;99;45;3;42;.933;3600000;0
8695;-1;798;0;0;0;0;.00nan;0;0
8695;-1;780;49;22;3;19;.864;3086000;0
8695;83199;780;37;14;3;11;.786;514000;0
8696;8487;783;72;19;1;18;.947;3600000;0
8696;171673;778;35;22;4;18;.818;3600000;0
8696;195942;783;0;0;0;0;.00nan;0;0
8696;202497;778;0;0;0;0;.00nan;0;0
8697;193854;777;56;20;2;18;.900;3600000;0
8697;193859;796;0;0;0;0;.00nan;0;0
8697;207726;777;0;0;0;0;.00nan;0;0
8697;149847;796;59;29;4;25;.862;3515000;0
8698;-1;784;72;30;2;28;.933;3600000;0
8698;-1;776;0;0;0;0;.00nan;0;0
8698;-1;784;0;0;0;0;.00nan;0;0
8698;95405;776;68;37;3;34;.919;3600000;0
8699;165867;2182;100;30;0;30;1.000;3600000;0
8699;207729;794;0;0;0;0;.00nan;0;0
8699;62060;794;58;35;4;31;.886;3600000;0
8699;64066;2182;0;0;0;0;.00nan;0;0
8700;183377;904;87;43;3;40;.930;3600000;0
8700;190702;3737;39;25;4;21;.840;3575000;0
8700;192030;3737;0;0;0;0;.00nan;0;0
8700;-1;904;0;0;0;0;.00nan;0;0
8701;183377;904;56;46;6;40;.870;3600000;0
8701;-1;784;72;22;1;21;.955;3600000;0
8701;-1;904;0;0;0;0;.00nan;0;0
8701;-1;784;0;0;0;0;.00nan;0;0
8702;8487;783;45;36;5;31;.861;3600000;0
8702;195942;783;0;0;0;0;.00nan;0;0
8702;-1;780;0;0;0;0;.00nan;0;0
8702;83199;780;79;29;1;28;.966;3600000;0
8703;171673;778;81;14;0;14;1.000;3600000;0
8703;201174;798;39;33;6;27;.818;3600000;0
8703;202497;778;0;0;0;0;.00nan;0;0
8703;-1;798;0;0;0;0;.00nan;0;0
8704;193859;796;0;0;0;0;.00nan;0;0
8704;207729;794;0;0;0;0;.00nan;0;0
8704;62060;794;82;41;3;38;.927;3600000;0
8704;149847;796;52;31;5;26;.839;3522000;0
8705;190702;3737;0;0;0;0;.00nan;0;0
8705;192030;3737;99;40;1;39;.975;3600000;0
8705;-1;776;0;0;0;0;.00nan;0;0
8705;95405;776;41;28;5;23;.821;3600000;0
8706;193854;777;100;44;2;42;.955;3600000;0
8706;165867;2182;77;34;3;31;.912;3543000;0
8706;207726;777;0;0;0;0;.00nan;0;0
8706;64066;2182;0;0;0;0;.00nan;0;0
8707;8487;783;53;32;4;28;.875;3600000;0
8707;195942;783;0;0;0;0;.00nan;0;0
8707;-1;798;51;23;3;20;.870;3600000;0
8707;66924;798;0;0;0;0;.00nan;0;0
8708;193854;777;78;28;1;27;.964;3600000;0
8708;207729;794;0;0;0;0;.00nan;0;0
8708;-1;777;0;0;0;0;.00nan;0;0
8708;62060;794;97;46;2;44;.957;3600000;0
8709;193859;796;0;0;0;0;.00nan;0;0
8709;165867;2182;93;34;2;32;.941;3600000;0
8709;64066;2182;0;0;0;0;.00nan;0;0
8709;149847;796;48;31;4;27;.871;3536000;0
8710;183377;904;73;31;2;29;.935;3766000;0
8710;-1;776;0;0;0;0;.00nan;0;0
8710;-1;904;0;0;0;0;.00nan;0;0
8710;95405;776;69;33;3;30;.909;3766000;0
8711;171673;778;84;38;3;35;.921;3600000;0
8711;202497;778;0;0;0;0;.00nan;0;0
8711;-1;780;0;0;0;0;.00nan;0;0
8711;83199;780;100;28;0;28;1.000;3600000;0
8712;24177;784;76;25;1;24;.960;3600000;0
8712;190702;3737;79;37;3;34;.919;3570000;0
8712;192030;3737;0;0;0;0;.00nan;0;0
8712;-1;784;0;0;0;0;.00nan;0;0
8713;183377;904;0;0;0;0;.00nan;0;0
8713;190702;3737;81;31;1;30;.968;3763000;0
8713;192030;3737;0;0;0;0;.00nan;0;0
8713;-1;904;88;33;2;31;.939;3763000;0
8714;24177;784;48;33;5;28;.848;3712000;0
8714;-1;776;0;0;0;0;.00nan;0;0
8714;-1;784;0;0;0;0;.00nan;0;0
8714;95405;776;45;28;6;22;.786;3712000;0
8715;8487;783;70;29;3;26;.897;3634000;0
8715;171673;778;67;26;2;24;.923;3664000;0
8715;195942;783;0;0;0;0;.00nan;0;0
8715;202497;778;0;0;0;0;.00nan;0;0
8716;193854;777;67;42;5;37;.881;3900000;0
8716;193859;796;0;0;0;0;.00nan;0;0
8716;-1;777;0;0;0;0;.00nan;0;0
8716;149847;796;38;31;5;26;.839;3900000;0
8717;165867;2182;83;19;1;18;.947;3600000;0
8717;207729;794;0;0;0;0;.00nan;0;0
8717;62060;794;75;39;3;36;.923;3534000;0
8717;64066;2182;0;0;0;0;.00nan;0;0
8718;-1;798;58;13;1;12;.923;1699000;0
8718;-1;780;45;4;1;3;.750;436000;0
8718;66924;798;12;23;7;16;.696;1849000;0
8718;83199;780;31;30;6;24;.800;3164000;0
8719;183377;904;88;37;2;35;.946;3600000;0
8719;24177;784;42;31;5;26;.839;3600000;0
8719;-1;904;0;0;0;0;.00nan;0;0
8719;-1;784;0;0;0;0;.00nan;0;0
8720;171673;778;65;45;5;40;.889;3600000;0
8720;202497;778;0;0;0;0;.00nan;0;0
8720;-1;798;0;0;0;0;.00nan;0;0
8720;66924;798;80;26;2;24;.923;3600000;0
8721;193859;796;0;0;0;0;.00nan;0;0
8721;207729;794;0;0;0;0;.00nan;0;0
8721;62060;794;84;37;2;35;.946;3600000;0
8721;149847;796;67;29;3;26;.897;3558000;0
8722;193854;777;0;0;0;0;.00nan;0;0
8722;165867;2182;68;27;3;24;.889;3878000;0
8722;-1;777;65;27;3;24;.889;3900000;0
8722;64066;2182;0;0;0;0;.00nan;0;0
8723;8487;783;63;37;4;33;.892;3553000;0
8723;195942;783;0;0;0;0;.00nan;0;0
8723;-1;780;0;0;0;0;.00nan;0;0
8723;83199;780;62;32;3;29;.906;3600000;0
8724;190702;3737;71;21;1;20;.952;3600000;0
8724;192030;3737;0;0;0;0;.00nan;0;0
8724;-1;776;0;0;0;0;.00nan;0;0
8724;95405;776;63;34;3;31;.912;3600000;0
8725;24177;784;0;0;0;0;.00nan;0;0
8725;190702;3737;100;29;0;29;1.000;3600000;0
8725;192030;3737;0;0;0;0;.00nan;0;0
8725;-1;784;79;36;3;33;.917;3600000;0
8726;8487;783;81;28;1;27;.964;3600000;0
8726;201174;798;21;21;6;15;.714;1997000;0
8726;195942;783;0;0;0;0;.00nan;0;0
8726;66924;798;59;13;1;12;.923;1603000;0
8727;171673;778;0;0;0;0;.00nan;0;0
8727;202497;778;68;26;2;24;.923;3600000;0
8727;-1;780;0;0;0;0;.00nan;0;0
8727;83199;780;56;25;3;22;.880;3545000;0
8728;193854;777;19;22;6;16;.727;3556000;0
8728;207726;777;0;0;0;0;.00nan;0;0
8728;207729;794;0;0;0;0;.00nan;0;0
8728;62060;794;69;50;5;45;.900;3600000;0
8729;183377;904;96;57;3;54;.947;3900000;0
8729;-1;776;52;25;3;22;.880;3900000;0
8729;-1;904;0;0;0;0;.00nan;0;0
8729;95405;776;0;0;0;0;.00nan;0;0
8730;193859;796;0;0;0;0;.00nan;0;0
8730;165867;2182;48;25;4;21;.840;3567000;0
8730;64066;2182;0;0;0;0;.00nan;0;0
8730;149847;796;72;34;3;31;.912;3600000;0
8731;8487;783;59;8;0;8;1.000;916000;0
8731;195942;783;24;25;7;18;.720;2684000;0
8731;-1;780;0;0;0;0;.00nan;0;0
8731;83199;780;64;37;4;33;.892;3600000;0
8732;165867;2182;90;36;1;35;.972;3900000;0
8732;201174;798;95;38;1;37;.974;3900000;0
8732;64066;2182;0;0;0;0;.00nan;0;0
8732;66924;798;0;0;0;0;.00nan;0;0
8733;193854;777;90;34;1;33;.971;3600000;0
8733;24177;784;77;44;4;40;.909;3600000;0
8733;207726;777;0;0;0;0;.00nan;0;0
8733;-1;784;0;0;0;0;.00nan;0;0
8734;193859;796;0;0;0;0;.00nan;0;0
8734;207729;794;0;0;0;0;.00nan;0;0
8734;62060;794;72;46;4;42;.913;3600000;0
8734;149847;796;42;10;2;8;.800;3600000;0
8735;190702;3737;36;30;5;25;.833;3600000;0
8735;192030;3737;0;0;0;0;.00nan;0;0
8735;-1;776;0;0;0;0;.00nan;0;0
8735;95405;776;85;36;2;34;.944;3600000;0
8736;183377;904;99;43;1;42;.977;3600000;0
8736;171673;778;50;14;2;12;.857;3594000;0
8736;202497;778;0;0;0;0;.00nan;0;0
8736;-1;904;0;0;0;0;.00nan;0;0
8737;193854;777;0;0;0;0;.00nan;0;0
8737;201174;798;48;9;2;7;.778;1481000;0
8737;207726;777;74;22;1;21;.955;3600000;0
8737;66924;798;37;22;5;17;.773;2119000;0
8738;24177;784;0;0;0;0;.00nan;0;0
8738;-1;784;70;36;3;33;.917;3764000;0
8738;-1;780;0;0;0;0;.00nan;0;0
8738;83199;780;51;32;4;28;.875;3764000;0
8739;193859;796;0;0;0;0;.00nan;0;0
8739;-1;776;0;0;0;0;.00nan;0;0
8739;95405;776;99;42;1;41;.976;3600000;0
8739;149847;796;54;26;3;23;.885;3527000;0
8740;183377;904;47;28;4;24;.857;3600000;0
8740;207729;794;0;0;0;0;.00nan;0;0
8740;-1;904;0;0;0;0;.00nan;0;0
8740;62060;794;100;28;0;28;1.000;3600000;0
8741;165867;2182;70;18;3;15;.833;3900000;0
8741;171673;778;54;21;3;18;.857;3900000;0
8741;202497;778;0;0;0;0;.00nan;0;0
8741;64066;2182;0;0;0;0;.00nan;0;0
8742;8487;783;66;26;3;23;.885;3515000;0
8742;195942;783;0;0;0;0;.00nan;0;0
8742;190702;3737;100;50;1;49;.980;3600000;0
8742;192030;3737;0;0;0;0;.00nan;0;0
8743;24177;784;0;0;0;0;.00nan;0;0
8743;190702;3737;71;29;3;26;.897;3600000;0
8743;192030;3737;0;0;0;0;.00nan;0;0
8743;-1;784;77;26;2;24;.923;3600000;0
8744;8487;780;81;23;1;22;.957;3600000;0
8744;201174;798;73;31;2;29;.935;3600000;0
8744;-1;780;0;0;0;0;.00nan;0;0
8744;66924;798;0;0;0;0;.00nan;0;0
8745;171673;778;71;25;2;23;.920;3600000;0
8745;207729;794;0;0;0;0;.00nan;0;0
8745;202497;778;0;0;0;0;.00nan;0;0
8745;62060;794;63;35;4;31;.886;3515000;0
8746;193859;796;74;29;3;26;.897;3900000;0
8746;195942;783;0;0;0;0;.00nan;0;0
8746;83199;783;59;29;3;26;.897;3900000;0
8746;149847;796;0;0;0;0;.00nan;0;0
8747;183377;904;97;42;2;40;.952;3900000;0
8747;-1;776;0;0;0;0;.00nan;0;0
8747;-1;904;0;0;0;0;.00nan;0;0
8747;95405;776;69;16;2;14;.875;3900000;0
8748;193854;777;76;47;5;42;.894;3584000;0
8748;165867;2182;77;39;3;36;.923;3600000;0
8748;207726;777;0;0;0;0;.00nan;0;0
8748;64066;2182;0;0;0;0;.00nan;0;0
8749;193854;777;87;29;1;28;.966;3600000;0
8749;171673;778;68;37;3;34;.919;3571000;0
8749;207726;777;0;0;0;0;.00nan;0;0
8749;202497;778;0;0;0;0;.00nan;0;0
8750;207729;794;0;0;0;0;.00nan;0;0
8750;-1;776;0;0;0;0;.00nan;0;0
8750;62060;794;100;32;0;32;1.000;3600000;0
8750;95405;776;70;28;2;26;.929;3588000;0
8751;193859;796;0;0;0;0;.00nan;0;0
8751;24177;784;0;0;0;0;.00nan;0;0
8751;-1;784;78;29;2;27;.931;3600000;0
8751;149847;796;63;33;3;30;.909;3543000;0
8752;183377;904;53;40;5;35;.875;3600000;0
8752;195942;783;0;0;0;0;.00nan;0;0
8752;-1;904;0;0;0;0;.00nan;0;0
8752;83199;783;85;19;1;18;.947;3600000;0
8753;8487;780;52;22;3;19;.864;3563000;0
8753;165867;2182;99;44;2;42;.955;3600000;0
8753;-1;780;0;0;0;0;.00nan;0;0
8753;64066;2182;0;0;0;0;.00nan;0;0
8754;201174;798;68;17;1;16;.941;3600000;0
8754;190702;3737;0;0;0;0;.00nan;0;0
8754;192030;3737;62;24;2;22;.917;3566000;0
8754;66924;798;0;0;0;0;.00nan;0;0
8755;183377;904;33;25;6;19;.760;1864000;0
8755;24177;784;0;0;0;0;.00nan;0;0
8755;-1;784;66;32;4;28;.875;3600000;0
8755;-1;904;43;18;3;15;.833;1736000;0
8756;195942;783;0;0;0;0;.00nan;0;0
8756;207729;794;0;0;0;0;.00nan;0;0
8756;62060;794;59;26;3;23;.885;3552000;0
8756;83199;783;56;17;2;15;.882;3600000;0
8757;171673;778;74;25;1;24;.960;3600000;0
8757;202497;778;0;0;0;0;.00nan;0;0
8757;-1;776;0;0;0;0;.00nan;0;0
8757;95405;776;76;29;2;27;.931;3584000;0
8758;193859;796;0;0;0;0;.00nan;0;0
8758;201174;798;63;40;4;36;.900;3900000;0
8758;66924;798;0;0;0;0;.00nan;0;0
8758;149847;796;58;31;4;27;.871;3900000;0
8759;8487;780;86;51;4;47;.922;3900000;0
8759;193854;777;38;24;4;20;.833;3900000;0
8759;207726;777;0;0;0;0;.00nan;0;0
8759;-1;780;0;0;0;0;.00nan;0;0
8760;165867;2182;0;0;0;0;.00nan;0;0
8760;190702;3737;72;25;1;24;.960;3600000;0
8760;192030;3737;0;0;0;0;.00nan;0;0
8760;64066;2182;71;34;3;31;.912;3535000;0
8761;183377;904;52;40;6;34;.850;3600000;0
8761;201174;798;68;18;2;16;.889;3600000;0
8761;-1;904;0;0;0;0;.00nan;0;0
8761;66924;798;0;0;0;0;.00nan;0;0
8762;193859;796;0;0;0;0;.00nan;0;0
8762;165867;2182;70;19;1;18;.947;3600000;0
8762;64066;2182;0;0;0;0;.00nan;0;0
8762;149847;796;45;44;6;38;.864;3600000;0
8763;24177;784;0;0;0;0;.00nan;0;0
8763;207729;794;0;0;0;0;.00nan;0;0
8763;-1;784;100;23;0;23;1.000;3600000;0
8763;62060;794;67;26;2;24;.923;3541000;0
8764;195942;783;0;0;0;0;.00nan;0;0
8764;-1;776;0;0;0;0;.00nan;0;0
8764;83199;783;74;33;3;30;.909;3535000;0
8764;95405;776;91;32;1;31;.969;3600000;0
8765;8487;780;36;29;6;23;.793;2347000;0
8765;171673;778;20;19;6;13;.684;2654000;0
8765;202497;778;61;6;0;6;1.000;1246000;0
8765;-1;780;71;12;0;12;1.000;1553000;0
8766;193854;777;73;26;2;24;.923;3600000;0
8766;190702;3737;50;40;5;35;.875;3600000;0
8766;207726;777;0;0;0;0;.00nan;0;0
8766;192030;3737;0;0;0;0;.00nan;0;0
8767;201174;798;77;27;2;25;.926;3600000;0
8767;207729;794;0;0;0;0;.00nan;0;0
8767;62060;794;77;40;4;36;.900;3530000;0
8767;66924;798;0;0;0;0;.00nan;0;0
8768;171673;778;81;23;1;22;.957;3600000;0
8768;195942;783;0;0;0;0;.00nan;0;0
8768;202497;778;0;0;0;0;.00nan;0;0
8768;83199;783;42;25;5;20;.800;3600000;0
8769;24177;784;51;2;0;2;1.000;314000;0
8769;-1;784;21;29;7;22;.759;3286000;0
8769;-1;776;0;0;0;0;.00nan;0;0
8769;95405;776;87;36;2;34;.944;3600000;0
8770;193854;777;69;23;2;21;.913;3600000;0
8770;193859;796;90;31;0;31;1.000;3009000;0
8770;207726;777;0;0;0;0;.00nan;0;0
8770;149847;796;40;10;3;7;.700;542000;0
8771;8487;780;55;16;2;14;.875;3600000;0
8771;190702;3737;90;44;3;41;.932;3600000;0
8771;192030;3737;0;0;0;0;.00nan;0;0
8771;-1;780;0;0;0;0;.00nan;0;0
8772;183377;904;39;39;6;33;.846;2772000;0
8772;165867;2182;55;22;3;19;.864;3600000;0
8772;-1;904;62;9;0;9;1.000;828000;0
8772;64066;2182;0;0;0;0;.00nan;0;0
8773;193854;777;66;16;1;15;.938;3600000;0
8773;183377;904;47;40;6;34;.850;2974000;0
8773;207726;777;0;0;0;0;.00nan;0;0
8773;-1;904;37;10;2;8;.800;626000;0
8774;24177;784;0;0;0;0;.00nan;0;0
8774;195942;783;85;28;1;27;.964;3600000;0
8774;-1;784;51;28;4;24;.857;3600000;0
8774;83199;783;0;0;0;0;.00nan;0;0
8775;8487;780;72;28;2;26;.929;3600000;0
8775;193859;796;0;0;0;0;.00nan;0;0
8775;-1;780;0;0;0;0;.00nan;0;0
8775;149847;796;81;37;3;34;.919;3518000;0
8776;165867;2182;51;21;3;18;.857;3900000;0
8776;207729;794;0;0;0;0;.00nan;0;0
8776;62060;794;64;36;3;33;.917;3900000;0
8776;64066;2182;0;0;0;0;.00nan;0;0
8777;201174;798;48;29;4;25;.862;3579000;0
8777;-1;776;0;0;0;0;.00nan;0;0
8777;66924;798;0;0;0;0;.00nan;0;0
8777;95405;776;77;29;2;27;.931;3600000;0
8778;171673;778;67;25;2;23;.920;3600000;0
8778;190702;3737;72;37;4;33;.892;3547000;0
8778;202497;778;0;0;0;0;.00nan;0;0
8778;192030;3737;0;0;0;0;.00nan;0;0
8779;201174;798;100;28;0;28;1.000;3600000;0
8779;195942;783;0;0;0;0;.00nan;0;0
8779;66924;798;0;0;0;0;.00nan;0;0
8779;83199;783;66;28;3;25;.893;3600000;0
8780;193854;777;59;18;2;16;.889;3600000;0
8780;207726;777;0;0;0;0;.00nan;0;0
8780;207729;794;0;0;0;0;.00nan;0;0
8780;62060;794;65;37;4;33;.892;3544000;0
8781;24177;784;0;0;0;0;.00nan;0;0
8781;171673;778;72;36;3;33;.917;3547000;0
8781;202497;778;0;0;0;0;.00nan;0;0
8781;-1;784;67;19;1;18;.947;3600000;0
8782;193859;796;0;0;0;0;.00nan;0;0
8782;190702;3737;73;37;4;33;.892;3599000;0
8782;192030;3737;0;0;0;0;.00nan;0;0
8782;149847;796;64;20;2;18;.900;3600000;0
8783;8487;780;67;24;3;21;.875;3900000;0
8783;183377;904;92;50;3;47;.940;3900000;0
8783;-1;780;0;0;0;0;.00nan;0;0
8783;-1;904;0;0;0;0;.00nan;0;0
8784;165867;2182;50;17;2;15;.882;3600000;0
8784;-1;776;53;19;2;17;.895;1532000;0
8784;64066;2182;0;0;0;0;.00nan;0;0
8784;95405;776;33;23;5;18;.783;2068000;0
8785;24177;784;0;0;0;0;.00nan;0;0
8785;201174;798;93;31;1;30;.968;3600000;0
8785;-1;784;56;22;2;20;.909;3574000;0
8785;66924;798;0;0;0;0;.00nan;0;0
8786;193859;796;92;37;2;35;.946;3579000;0
8786;171673;778;99;35;1;34;.971;3600000;0
8786;202497;778;0;0;0;0;.00nan;0;0
8786;149847;796;0;0;0;0;.00nan;0;0
8787;193854;777;86;14;0;14;1.000;3600000;0
8787;207726;777;0;0;0;0;.00nan;0;0
8787;-1;776;0;0;0;0;.00nan;0;0
8787;95405;776;50;43;6;37;.860;3600000;0
8788;8487;780;68;27;2;25;.926;3600000;0
8788;207729;794;0;0;0;0;.00nan;0;0
8788;-1;780;0;0;0;0;.00nan;0;0
8788;62060;794;59;36;4;32;.889;3521000;0
8789;165867;2182;71;36;3;33;.917;3600000;0
8789;195942;783;69;27;2;25;.926;3600000;0
8789;64066;2182;0;0;0;0;.00nan;0;0
8789;83199;783;0;0;0;0;.00nan;0;0
8790;183377;904;55;40;6;34;.850;3039000;0
8790;190702;3737;68;31;3;28;.903;3600000;0
8790;192030;3737;0;0;0;0;.00nan;0;0
8790;-1;904;45;7;1;6;.857;561000;0
8791;193854;777;96;23;0;23;1.000;3600000;0
8791;195942;783;0;0;0;0;.00nan;0;0
8791;207726;777;0;0;0;0;.00nan;0;0
8791;83199;783;84;43;4;39;.907;3600000;0
8792;190702;3737;72;25;2;23;.920;3600000;0
8792;207729;794;0;0;0;0;.00nan;0;0
8792;192030;3737;0;0;0;0;.00nan;0;0
8792;62060;794;61;33;4;29;.879;3521000;0
8793;171673;778;51;7;1;6;.857;629000;0
8793;201174;798;100;26;0;26;1.000;3600000;0
8793;202497;778;24;24;6;18;.750;2971000;0
8793;66924;798;0;0;0;0;.00nan;0;0
8794;193859;796;0;0;0;0;.00nan;0;0
8794;183377;904;25;7;3;4;.571;277000;0
8794;-1;904;71;34;3;31;.912;3323000;0
8794;149847;796;88;15;0;15;1.000;3600000;0
8795;8487;780;82;24;1;23;.958;3600000;0
8795;-1;776;51;25;3;22;.880;3563000;0
8795;-1;780;0;0;0;0;.00nan;0;0
8795;95405;776;0;0;0;0;.00nan;0;0
8796;165867;2182;52;32;5;27;.844;3600000;0
8796;24177;784;0;0;0;0;.00nan;0;0
8796;-1;784;100;39;0;39;1.000;3600000;0
8796;64066;2182;0;0;0;0;.00nan;0;0
8797;183377;904;92;40;1;39;.975;3900000;0
8797;171673;778;81;20;1;19;.950;3900000;0
8797;202497;778;0;0;0;0;.00nan;0;0
8797;-1;904;0;0;0;0;.00nan;0;0
8798;193859;796;0;0;0;0;.00nan;0;0
8798;207729;794;0;0;0;0;.00nan;0;0
8798;62060;794;52;25;4;21;.840;3570000;0
8798;149847;796;87;33;2;31;.939;3600000;0
8799;193854;777;67;34;3;31;.912;3549000;0
8799;24177;784;0;0;0;0;.00nan;0;0
8799;207726;777;0;0;0;0;.00nan;0;0
8799;-1;784;64;20;1;19;.950;3600000;0
8800;8487;780;29;21;5;16;.762;3900000;0
8800;195942;783;48;37;5;32;.865;3900000;0
8800;-1;780;0;0;0;0;.00nan;0;0
8800;83199;783;0;0;0;0;.00nan;0;0
8801;165867;2182;55;28;4;24;.857;3600000;0
8801;201174;798;59;41;5;36;.878;3600000;0
8801;64066;2182;0;0;0;0;.00nan;0;0
8801;66924;798;0;0;0;0;.00nan;0;0
8802;190702;3737;0;0;0;0;.00nan;0;0
8802;192030;3737;100;20;0;20;1.000;3600000;0
8802;-1;776;0;0;0;0;.00nan;0;0
8802;95405;776;97;37;1;36;.973;3587000;0
8803;8487;780;88;41;3;38;.927;3600000;0
8803;24177;784;7;26;7;19;.731;3600000;0
8803;-1;784;0;0;0;0;.00nan;0;0
8803;-1;780;0;0;0;0;.00nan;0;0
8804;195942;783;0;0;0;0;.00nan;0;0
8804;190702;3737;0;0;0;0;.00nan;0;0
8804;192030;3737;100;25;0;25;1.000;3600000;0
8804;83199;783;80;25;1;24;.960;3549000;0
8805;193854;777;59;25;3;22;.880;3611000;0
8805;201174;798;0;0;0;0;.00nan;0;0
8805;207726;777;0;0;0;0;.00nan;0;0
8805;66924;798;65;37;4;33;.892;3611000;0
8806;165867;2182;86;27;1;26;.963;3600000;0
8806;171673;778;73;38;3;35;.921;3569000;0
8806;202497;778;0;0;0;0;.00nan;0;0
8806;64066;2182;0;0;0;0;.00nan;0;0
8807;193859;796;0;0;0;0;.00nan;0;0
8807;-1;776;0;0;0;0;.00nan;0;0
8807;95405;776;29;35;6;29;.829;3600000;0
8807;149847;796;93;32;1;31;.969;3600000;0
8808;183377;904;96;41;1;40;.976;3600000;0
8808;207729;794;0;0;0;0;.00nan;0;0
8808;-1;904;0;0;0;0;.00nan;0;0
8808;62060;794;74;27;2;25;.926;3567000;0
8809;193854;777;75;31;2;29;.935;3600000;0
8809;165867;2182;55;27;3;24;.889;3546000;0
8809;207726;777;0;0;0;0;.00nan;0;0
8809;64066;2182;0;0;0;0;.00nan;0;0
8810;171673;778;67;30;3;27;.900;3600000;0
8810;207729;794;52;33;4;29;.879;3578000;0
8810;202497;778;0;0;0;0;.00nan;0;0
8810;62060;794;0;0;0;0;.00nan;0;0
8811;193859;796;0;0;0;0;.00nan;0;0
8811;195942;783;0;0;0;0;.00nan;0;0
8811;83199;783;98;38;1;37;.974;3600000;0
8811;149847;796;71;23;2;21;.913;3588000;0
8812;183377;904;88;37;3;34;.919;3600000;0
8812;-1;776;0;0;0;0;.00nan;0;0
8812;-1;904;0;0;0;0;.00nan;0;0
8812;95405;776;26;15;4;11;.733;3557000;0
8813;8487;780;0;0;0;0;.00nan;0;0
8813;201174;798;83;33;2;31;.939;3600000;0
8813;-1;780;49;22;4;18;.818;3527000;0
8813;66924;798;0;0;0;0;.00nan;0;0
8814;24177;784;0;0;0;0;.00nan;0;0
8814;190702;3737;0;0;0;0;.00nan;0;0
8814;192030;3737;77;30;2;28;.933;3819000;0
8814;-1;784;80;37;3;34;.919;3819000;0
8815;183377;904;50;38;5;33;.868;3778000;0
8815;195942;783;0;0;0;0;.00nan;0;0
8815;-1;904;0;0;0;0;.00nan;0;0
8815;83199;783;41;19;4;15;.789;3778000;0
8816;193854;777;27;30;6;24;.800;2753000;0
8816;171673;778;90;27;1;26;.963;3600000;0
8816;207726;777;35;7;2;5;.714;847000;0
8816;202497;778;0;0;0;0;.00nan;0;0
8817;193859;796;0;0;0;0;.00nan;0;0
8817;24177;784;61;14;1;13;.929;1515000;0
8817;-1;784;18;22;6;16;.727;2085000;0
8817;149847;796;88;41;3;38;.927;3600000;0
8818;207729;794;0;0;0;0;.00nan;0;0
8818;-1;776;0;0;0;0;.00nan;0;0
8818;62060;794;76;37;3;34;.919;3600000;0
8818;95405;776;83;24;1;23;.958;3600000;0
8819;8487;780;65;28;3;25;.893;3573000;0
8819;165867;2182;100;47;1;46;.979;3600000;0
8819;-1;780;0;0;0;0;.00nan;0;0
8819;64066;2182;0;0;0;0;.00nan;0;0
8820;201174;798;96;24;0;24;1.000;3600000;0
8820;190702;3737;66;28;2;26;.929;3515000;0
8820;192030;3737;0;0;0;0;.00nan;0;0
8820;66924;798;0;0;0;0;.00nan;0;0
8821;183377;904;82;36;2;34;.944;3600000;0
8821;24177;784;0;0;0;0;.00nan;0;0
8821;-1;784;54;26;4;22;.846;3573000;0
8821;-1;904;0;0;0;0;.00nan;0;0
8822;195942;783;87;25;1;24;.960;3600000;0
8822;207729;794;63;33;3;30;.909;2721000;0
8822;62060;794;28;12;4;8;.667;879000;0
8822;83199;783;0;0;0;0;.00nan;0;0
8823;193859;796;0;0;0;0;.00nan;0;0
8823;201174;798;100;33;0;33;1.000;3600000;0
8823;66924;798;0;0;0;0;.00nan;0;0
8823;149847;796;57;11;1;10;.909;3549000;0
8824;171673;778;45;26;5;21;.808;3600000;0
8824;202497;778;0;0;0;0;.00nan;0;0
8824;-1;776;75;28;2;26;.929;3600000;0
8824;95405;776;0;0;0;0;.00nan;0;0
8825;8487;780;61;32;3;29;.906;3652000;0
8825;193854;777;73;26;2;24;.923;3652000;0
8825;207726;777;0;0;0;0;.00nan;0;0
8825;-1;780;0;0;0;0;.00nan;0;0
8826;165867;2182;89;17;0;17;1.000;3600000;0
8826;190702;3737;0;0;0;0;.00nan;0;0
8826;192030;3737;76;31;2;29;.935;3600000;0
8826;64066;2182;0;0;0;0;.00nan;0;0
8827;183377;904;83;28;1;27;.964;3600000;0
8827;201174;798;67;20;2;18;.900;3600000;0
8827;-1;904;0;0;0;0;.00nan;0;0
8827;66924;798;0;0;0;0;.00nan;0;0
8828;193854;777;0;0;0;0;.00nan;0;0
8828;190702;3737;0;0;0;0;.00nan;0;0
8828;207726;777;67;26;2;24;.923;3600000;0
8828;192030;3737;53;41;5;36;.878;3600000;0
8829;8487;780;71;37;4;33;.892;3600000;0
8829;171673;778;100;28;0;28;1.000;3600000;0
8829;202497;778;0;0;0;0;.00nan;0;0
8829;-1;780;0;0;0;0;.00nan;0;0
8830;24177;784;0;0;0;0;.00nan;0;0
8830;207729;794;0;0;0;0;.00nan;0;0
8830;-1;784;41;22;4;18;.818;3790000;0
8830;62060;794;69;37;3;34;.919;3790000;0
8831;193859;796;70;30;2;28;.933;3600000;0
8831;165867;2182;100;36;1;35;.972;3600000;0
8831;64066;2182;0;0;0;0;.00nan;0;0
8831;149847;796;0;0;0;0;.00nan;0;0
8832;195942;783;0;0;0;0;.00nan;0;0
8832;-1;776;0;0;0;0;.00nan;0;0
8832;83199;783;46;24;4;20;.833;3900000;0
8832;95405;776;65;38;4;34;.895;3900000;0
8846;171673;778;86;36;2;34;.944;3600000;0
8846;202497;778;0;0;0;0;.00nan;0;0
8846;-1;780;0;0;0;0;.00nan;0;0
8846;83199;780;60;28;3;25;.893;3600000;0
8848;201174;798;60;32;3;29;.906;3576000;0
8848;-1;798;0;0;0;0;.00nan;0;0
8848;-1;776;0;0;0;0;.00nan;0;0
8848;95405;776;62;22;2;20;.909;3600000;0
8850;193859;796;0;0;0;0;.00nan;0;0
8850;190702;3737;54;34;5;29;.853;3581000;0
8850;192030;3737;0;0;0;0;.00nan;0;0
8850;149847;796;68;30;3;27;.900;3600000;0
8852;8487;783;94;30;1;29;.967;3600000;0
8852;195942;783;0;0;0;0;.00nan;0;0
8852;-1;784;63;24;3;21;.875;3523000;0
8852;-1;784;0;0;0;0;.00nan;0;0
8854;193854;777;57;12;1;11;.917;3600000;0
8854;207726;777;0;0;0;0;.00nan;0;0
8854;207729;794;52;17;2;15;.882;1446000;0
8854;62060;794;23;27;6;21;.778;2154000;0
8856;183377;904;53;30;4;26;.867;3514000;0
8856;165867;2182;65;23;2;21;.913;3600000;0
8856;-1;904;0;0;0;0;.00nan;0;0
8856;64066;2182;0;0;0;0;.00nan;0;0
8858;165867;2182;63;14;1;13;.929;3600000;0
8858;-1;780;0;0;0;0;.00nan;0;0
8858;64066;2182;0;0;0;0;.00nan;0;0
8858;83199;780;77;42;4;38;.905;3600000;0
8860;207729;794;0;0;0;0;.00nan;0;0
8860;-1;784;68;26;3;23;.885;3515000;0
8860;-1;784;0;0;0;0;.00nan;0;0
8860;62060;794;81;29;1;28;.966;3600000;0
8862;193859;796;0;0;0;0;.00nan;0;0
8862;-1;776;0;0;0;0;.00nan;0;0
8862;95405;776;64;40;4;36;.900;3600000;0
8862;149847;796;99;29;1;28;.966;3600000;0
8864;8487;783;52;27;4;23;.852;3600000;0
8864;195942;783;0;0;0;0;.00nan;0;0
8864;190702;3737;39;47;7;40;.851;3600000;0
8864;192030;3737;0;0;0;0;.00nan;0;0
8866;183377;904;47;36;5;31;.861;3600000;0
8866;171673;778;82;33;2;31;.939;3600000;0
8866;202497;778;0;0;0;0;.00nan;0;0
8866;-1;904;0;0;0;0;.00nan;0;0
8870;171673;778;0;0;0;0;.00nan;0;0
8870;207729;794;18;16;5;11;.688;1041000;0
8870;202497;778;81;32;2;30;.938;3600000;0
8870;62060;794;52;18;2;16;.889;2559000;0
8872;183377;904;0;0;0;0;.00nan;0;0
8872;165867;2182;0;0;0;0;.00nan;0;0
8872;-1;904;32;33;7;26;.788;3600000;0
8872;64066;2182;86;17;0;17;1.000;3600000;0
8874;190702;3737;0;0;0;0;.00nan;0;0
8874;192030;3737;60;24;3;21;.875;3600000;0
8874;-1;780;43;24;4;20;.833;3600000;0
8874;83199;780;0;0;0;0;.00nan;0;0
8876;8487;783;0;0;0;0;.00nan;0;0
8876;195942;783;59;30;4;26;.867;3600000;0
8876;-1;776;67;22;1;21;.955;3600000;0
8876;95405;776;0;0;0;0;.00nan;0;0
8880;193859;796;71;24;2;22;.917;3600000;0
8880;-1;784;0;0;0;0;.00nan;0;0
8880;-1;784;78;39;3;36;.923;3554000;0
8880;149847;796;0;0;0;0;.00nan;0;0
8882;207729;794;0;0;0;0;.00nan;0;0
8882;-1;776;0;0;0;0;.00nan;0;0
8882;62060;794;63;21;2;19;.905;3586000;0
8882;95405;776;99;45;1;44;.978;3600000;0
8884;183377;904;61;28;3;25;.893;3570000;0
8884;201174;798;72;32;2;30;.938;3600000;0
8884;-1;798;0;0;0;0;.00nan;0;0
8884;-1;904;0;0;0;0;.00nan;0;0
8886;193859;796;0;0;0;0;.00nan;0;0
8886;-1;780;0;0;0;0;.00nan;0;0
8886;83199;780;83;30;2;28;.933;3600000;0
8886;149847;796;50;22;3;19;.864;3576000;0
8888;8487;783;27;6;3;3;.500;493000;0
8888;195942;783;100;33;1;32;.970;3107000;0
8888;190702;3737;44;33;6;27;.818;2670000;0
8888;192030;3737;56;6;0;6;1.000;843000;0
8890;165867;2182;0;0;0;0;.00nan;0;0
8890;-1;784;68;25;2;23;.920;3900000;0
8890;-1;784;0;0;0;0;.00nan;0;0
8890;64066;2182;80;30;2;28;.933;3900000;0
8894;193859;796;54;23;3;20;.870;3898000;0
8894;-1;776;82;49;3;46;.939;3900000;0
8894;95405;776;0;0;0;0;.00nan;0;0
8894;149847;796;0;0;0;0;.00nan;0;0
8896;207729;794;66;36;3;33;.917;3600000;0
8896;-1;784;0;0;0;0;.00nan;0;0
8896;-1;784;100;27;0;27;1.000;3600000;0
8896;62060;794;0;0;0;0;.00nan;0;0
8900;8487;783;77;23;1;22;.957;3600000;0
8900;183377;904;0;0;0;0;.00nan;0;0
8900;195942;783;0;0;0;0;.00nan;0;0
8900;-1;904;73;50;5;45;.900;3600000;0
8902;171673;778;100;44;2;42;.955;3600000;0
8902;201174;798;0;0;0;0;.00nan;0;0
8902;202497;778;0;0;0;0;.00nan;0;0
8902;-1;798;45;28;4;24;.857;3555000;0
8904;165867;2182;78;24;1;23;.958;3600000;0
8904;190702;3737;0;0;0;0;.00nan;0;0
8904;192030;3737;89;39;2;37;.949;3600000;0
8904;64066;2182;0;0;0;0;.00nan;0;0
8906;193859;796;0;0;0;0;.00nan;0;0
8906;201174;798;77;38;3;35;.921;3600000;0
8906;-1;798;0;0;0;0;.00nan;0;0
8906;149847;796;53;29;4;25;.862;3567000;0
8908;-1;784;0;0;0;0;.00nan;0;0
8908;-1;776;0;0;0;0;.00nan;0;0
8908;-1;784;52;26;4;22;.846;3562000;0
8908;95405;776;87;34;2;32;.941;3600000;0
8910;183377;904;100;46;1;45;.978;3600000;0
8910;165867;2182;43;18;3;15;.833;3580000;0
8910;-1;904;0;0;0;0;.00nan;0;0
8910;64066;2182;0;0;0;0;.00nan;0;0
8912;171673;778;52;32;4;28;.875;3561000;0
8912;190702;3737;46;21;3;18;.857;3600000;0
8912;202497;778;0;0;0;0;.00nan;0;0
8912;192030;3737;0;0;0;0;.00nan;0;0
8914;8487;783;74;23;1;22;.957;3600000;0
8914;195942;783;0;0;0;0;.00nan;0;0
8914;207729;794;0;0;0;0;.00nan;0;0
8914;62060;794;93;42;2;40;.952;3600000;0
8916;193854;777;72;21;1;20;.952;3600000;0
8916;207726;777;0;0;0;0;.00nan;0;0
8916;-1;780;93;41;2;39;.951;3263000;0
8916;83199;780;25;6;3;3;.500;337000;0
8918;171673;778;0;0;0;0;.00nan;0;0
8918;207729;794;88;46;4;42;.913;3900000;0
8918;202497;778;46;25;4;21;.840;3900000;0
8918;62060;794;0;0;0;0;.00nan;0;0
8920;165867;2182;0;0;0;0;.00nan;0;0
8920;-1;780;0;0;0;0;.00nan;0;0
8920;64066;2182;58;22;2;20;.909;3600000;0
8920;83199;780;67;35;3;32;.914;3585000;0
8922;193854;777;0;0;0;0;.00nan;0;0
8922;207726;777;65;15;1;14;.933;3600000;0
8922;-1;776;77;40;3;37;.925;3590000;0
8922;95405;776;0;0;0;0;.00nan;0;0
8924;193859;796;35;18;4;14;.778;952000;0
8924;-1;784;69;26;3;23;.885;3600000;0
8924;-1;784;0;0;0;0;.00nan;0;0
8924;149847;796;71;22;1;21;.955;2561000;0
8926;201174;798;0;0;0;0;.00nan;0;0
8926;190702;3737;0;0;0;0;.00nan;0;0
8926;192030;3737;77;28;1;27;.964;3600000;0
8926;-1;798;67;30;2;28;.933;3546000;0
8928;8487;783;0;0;0;0;.00nan;0;0
8928;183377;904;0;0;0;0;.00nan;0;0
8928;195942;783;78;39;3;36;.923;3600000;0
8928;-1;904;63;36;4;32;.889;3552000;0
8929;10112;1423;98;54;2;52;.963;3600000;0
8929;178789;554;0;0;0;0;.00nan;0;0
8929;27517;1423;0;0;0;0;.00nan;0;0
8929;85489;554;59;11;1;10;.909;3600000;0
8930;178789;554;59;34;4;30;.882;3889000;0
8930;-1;555;0;0;0;0;.00nan;0;0
8930;68961;555;81;55;4;51;.927;3900000;0
8930;85489;554;0;0;0;0;.00nan;0;0
8931;177156;552;0;0;0;0;.00nan;0;0
8931;4379;2626;66;43;4;39;.907;3600000;0
8931;28989;2626;0;0;0;0;.00nan;0;0
8931;86422;552;55;24;3;21;.875;3600000;0
8932;-1;561;0;0;0;0;.00nan;0;0
8932;57172;556;51;26;3;23;.885;3600000;0
8932;65324;561;63;34;4;30;.882;3564000;0
8932;85349;556;0;0;0;0;.00nan;0;0
8933;2140;553;47;36;5;31;.861;3600000;0
8933;4379;2626;80;31;2;29;.935;3600000;0
8933;28989;2626;0;0;0;0;.00nan;0;0
8933;83252;553;0;0;0;0;.00nan;0;0
8934;10112;1423;49;40;6;34;.850;3600000;0
8934;27517;1423;0;0;0;0;.00nan;0;0
8934;75764;558;0;0;0;0;.00nan;0;0
8934;85395;558;70;26;2;24;.923;3600000;0
8935;2140;553;81;20;1;19;.950;3900000;0
8935;4379;2626;0;0;0;0;.00nan;0;0
8935;28989;2626;80;28;1;27;.964;3900000;0
8935;83252;553;0;0;0;0;.00nan;0;0
8936;177156;552;0;0;0;0;.00nan;0;0
8936;-1;555;97;47;2;45;.957;3900000;0
8936;68961;555;0;0;0;0;.00nan;0;0
8936;86422;552;75;18;2;16;.889;3900000;0
8937;178789;554;0;0;0;0;.00nan;0;0
8937;-1;561;0;0;0;0;.00nan;0;0
8937;65324;561;84;41;3;38;.927;3600000;0
8937;85489;554;38;31;5;26;.839;3561000;0
8938;4379;2626;35;29;5;24;.828;3600000;0
8938;28989;2626;0;0;0;0;.00nan;0;0
8938;-1;555;79;34;2;32;.941;3600000;0
8938;68961;555;0;0;0;0;.00nan;0;0
8939;10112;1423;61;49;6;43;.878;3600000;0
8939;27517;1423;0;0;0;0;.00nan;0;0
8939;57172;556;49;16;2;14;.875;3600000;0
8939;85349;556;0;0;0;0;.00nan;0;0
8940;-1;555;81;42;3;39;.929;3600000;0
8940;-1;560;0;0;0;0;.00nan;0;0
8940;54860;560;54;29;4;25;.862;3546000;0
8940;68961;555;0;0;0;0;.00nan;0;0
8941;177156;552;0;0;0;0;.00nan;0;0
8941;-1;561;0;0;0;0;.00nan;0;0
8941;65324;561;78;49;5;44;.898;3600000;0
8941;86422;552;57;21;2;19;.905;3600000;0
8942;-1;561;52;30;4;26;.867;3512000;0
8942;-1;560;0;0;0;0;.00nan;0;0
8942;54860;560;73;25;2;23;.920;3600000;0
8942;65324;561;0;0;0;0;.00nan;0;0
8943;10112;1423;41;38;6;32;.842;3266000;0
8943;178789;554;0;0;0;0;.00nan;0;0
8943;27517;1423;52;4;0;4;1.000;334000;0
8943;85489;554;55;18;2;16;.889;3600000;0
8944;-1;560;0;0;0;0;.00nan;0;0
8944;54860;560;91;38;2;36;.947;3516000;0
8944;75764;558;0;0;0;0;.00nan;0;0
8944;85395;558;92;17;0;17;1.000;3600000;0
8945;177156;552;93;24;0;24;1.000;3600000;0
8945;2140;553;79;39;3;36;.923;3600000;0
8945;83252;553;0;0;0;0;.00nan;0;0
8945;86422;552;0;0;0;0;.00nan;0;0
8946;177156;552;63;25;3;22;.880;2700000;0
8946;57172;556;57;36;5;31;.861;3600000;0
8946;85349;556;0;0;0;0;.00nan;0;0
8946;86422;552;19;10;4;6;.600;835000;0
8947;2140;553;79;44;3;41;.932;3600000;0
8947;178789;554;37;19;4;15;.789;3565000;0
8947;83252;553;0;0;0;0;.00nan;0;0
8947;85489;554;0;0;0;0;.00nan;0;0
8948;2140;553;80;35;3;32;.914;3551000;0
8948;-1;561;0;0;0;0;.00nan;0;0
8948;65324;561;68;25;2;23;.920;3600000;0
8948;83252;553;0;0;0;0;.00nan;0;0
8949;178789;554;0;0;0;0;.00nan;0;0
8949;57172;556;55;36;4;32;.889;3782000;0
8949;85349;556;0;0;0;0;.00nan;0;0
8949;85489;554;44;29;5;24;.828;3782000;0
8950;4379;2626;0;0;0;0;.00nan;0;0
8950;28989;2626;51;22;3;19;.864;3564000;0
8950;-1;561;87;25;1;24;.960;3600000;0
8950;65324;561;0;0;0;0;.00nan;0;0
8951;10112;1423;67;40;4;36;.900;3570000;0
8951;27517;1423;0;0;0;0;.00nan;0;0
8951;-1;560;0;0;0;0;.00nan;0;0
8951;54860;560;63;25;2;23;.920;3600000;0
8952;-1;555;33;12;3;9;.750;1213000;0
8952;68961;555;37;36;6;30;.833;2387000;0
8952;75764;558;0;0;0;0;.00nan;0;0
8952;85395;558;91;25;1;24;.960;3600000;0
8953;177156;552;79;26;2;24;.923;3600000;0
8953;2140;553;69;33;3;30;.909;3600000;0
8953;83252;553;0;0;0;0;.00nan;0;0
8953;86422;552;0;0;0;0;.00nan;0;0
8954;4379;2626;0;0;0;0;.00nan;0;0
8954;28989;2626;55;29;3;26;.897;3553000;0
8954;-1;561;0;0;0;0;.00nan;0;0
8954;65324;561;84;35;2;33;.943;3600000;0
8955;178789;554;74;32;3;29;.906;3584000;0
8955;75764;558;0;0;0;0;.00nan;0;0
8955;85395;558;81;27;2;25;.926;3600000;0
8955;85489;554;0;0;0;0;.00nan;0;0
8956;177156;552;0;0;0;0;.00nan;0;0
8956;75764;558;0;0;0;0;.00nan;0;0
8956;85395;558;71;44;5;39;.886;3600000;0
8956;86422;552;61;22;2;20;.909;3600000;0
8957;4379;2626;0;0;0;0;.00nan;0;0
8957;28989;2626;88;35;2;33;.943;3600000;0
8957;75764;558;0;0;0;0;.00nan;0;0
8957;85395;558;69;17;1;16;.941;3600000;0
8958;2140;553;49;22;3;19;.864;3552000;0
8958;-1;560;0;0;0;0;.00nan;0;0
8958;54860;560;55;22;2;20;.909;3600000;0
8958;83252;553;0;0;0;0;.00nan;0;0
8959;-1;555;0;0;0;0;.00nan;0;0
8959;57172;556;70;18;1;17;.944;3600000;0
8959;68961;555;69;46;5;41;.891;3600000;0
8959;85349;556;0;0;0;0;.00nan;0;0
8960;2140;553;75;36;4;32;.889;3761000;0
8960;-1;560;55;32;5;27;.844;3761000;0
8960;54860;560;0;0;0;0;.00nan;0;0
8960;83252;553;0;0;0;0;.00nan;0;0
8961;178789;554;0;0;0;0;.00nan;0;0
8961;75764;558;75;37;4;33;.892;3581000;0
8961;85395;558;0;0;0;0;.00nan;0;0
8961;85489;554;63;29;3;26;.897;3600000;0
8962;-1;555;79;65;6;59;.908;3215000;0
8962;57172;556;0;0;0;0;.00nan;0;0
8962;68961;555;54;9;1;8;.889;385000;0
8962;85349;556;52;10;1;9;.900;3600000;0
8963;177156;552;19;36;8;28;.778;3600000;0
8963;57172;556;67;35;4;31;.886;3600000;0
8963;85349;556;0;0;0;0;.00nan;0;0
8963;86422;552;0;0;0;0;.00nan;0;0
8964;2140;553;58;29;3;26;.897;3600000;0
8964;-1;561;0;0;0;0;.00nan;0;0
8964;65324;561;29;37;7;30;.811;3600000;0
8964;83252;553;0;0;0;0;.00nan;0;0
8965;4379;2626;0;0;0;0;.00nan;0;0
8965;10112;1423;83;26;1;25;.962;3600000;0
8965;27517;1423;0;0;0;0;.00nan;0;0
8965;28989;2626;67;26;2;24;.923;3562000;0
8966;-1;555;92;54;4;50;.926;3552000;0
8966;-1;560;0;0;0;0;.00nan;0;0
8966;54860;560;46;18;3;15;.833;3600000;0
8966;68961;555;0;0;0;0;.00nan;0;0
8967;2140;553;89;36;2;34;.944;3600000;0
8967;10112;1423;61;27;3;24;.889;3546000;0
8967;27517;1423;0;0;0;0;.00nan;0;0
8967;83252;553;0;0;0;0;.00nan;0;0
8968;57172;556;74;35;3;32;.914;3547000;0
8968;75764;558;0;0;0;0;.00nan;0;0
8968;85349;556;0;0;0;0;.00nan;0;0
8968;85395;558;89;37;2;35;.946;3600000;0
8969;177156;552;72;20;1;19;.950;3600000;0
8969;-1;561;0;0;0;0;.00nan;0;0
8969;65324;561;83;53;5;48;.906;3600000;0
8969;86422;552;0;0;0;0;.00nan;0;0
8970;178789;554;72;25;2;23;.920;3600000;0
8970;-1;561;0;0;0;0;.00nan;0;0
8970;65324;561;69;39;5;34;.872;3600000;0
8970;85489;554;0;0;0;0;.00nan;0;0
8971;2140;553;0;0;0;0;.00nan;0;0
8971;10112;1423;84;26;1;25;.962;1681000;0
8971;27517;1423;13;19;6;13;.684;1919000;0
8971;83252;553;56;17;1;16;.941;3600000;0
8972;177156;552;50;30;4;26;.867;2708000;0
8972;57172;556;83;40;3;37;.925;3600000;0
8972;85349;556;0;0;0;0;.00nan;0;0
8972;86422;552;21;10;4;6;.600;892000;0
8973;-1;555;0;0;0;0;.00nan;0;0
8973;68961;555;88;37;3;34;.919;3560000;0
8973;75764;558;0;0;0;0;.00nan;0;0
8973;85395;558;56;18;2;16;.889;3600000;0
8974;4379;2626;72;41;4;37;.902;3600000;0
8974;28989;2626;0;0;0;0;.00nan;0;0
8974;-1;560;34;19;5;14;.737;3600000;0
8974;54860;560;0;0;0;0;.00nan;0;0
8975;4379;2626;0;0;0;0;.00nan;0;0
8975;28989;2626;61;30;3;27;.900;3556000;0
8975;-1;561;84;28;1;27;.964;3600000;0
8975;65324;561;0;0;0;0;.00nan;0;0
8976;-1;561;0;0;0;0;.00nan;0;0
8976;-1;560;0;0;0;0;.00nan;0;0
8976;54860;560;96;46;2;44;.957;3900000;0
8976;65324;561;71;26;2;24;.923;3900000;0
8977;177156;552;84;37;2;35;.946;3600000;0
8977;2140;553;55;30;4;26;.867;3546000;0
8977;83252;553;0;0;0;0;.00nan;0;0
8977;86422;552;0;0;0;0;.00nan;0;0
8978;57172;556;71;34;3;31;.912;3900000;0
8978;75764;558;0;0;0;0;.00nan;0;0
8978;85349;556;0;0;0;0;.00nan;0;0
8978;85395;558;77;34;3;31;.912;3900000;0
8979;177156;552;0;0;0;0;.00nan;0;0
8979;75764;558;0;0;0;0;.00nan;0;0
8979;85395;558;61;36;5;31;.861;3548000;0
8979;86422;552;63;30;3;27;.900;3600000;0
8980;-1;555;42;38;6;32;.842;2995000;0
8980;-1;560;82;29;1;28;.966;3600000;0
8980;54860;560;0;0;0;0;.00nan;0;0
8980;68961;555;52;3;0;3;1.000;605000;0
8981;10112;1423;31;40;6;34;.850;3600000;0
8981;178789;554;49;20;3;17;.850;3600000;0
8981;27517;1423;0;0;0;0;.00nan;0;0
8981;85489;554;0;0;0;0;.00nan;0;0
8982;-1;555;7;20;7;13;.650;1285000;0
8982;57172;556;59;18;2;16;.889;3600000;0
8982;68961;555;65;41;5;36;.878;2315000;0
8982;85349;556;0;0;0;0;.00nan;0;0
8983;10112;1423;70;34;3;31;.912;3544000;0
8983;27517;1423;0;0;0;0;.00nan;0;0
8983;75764;558;0;0;0;0;.00nan;0;0
8983;85395;558;76;18;1;17;.944;3600000;0
8984;2140;553;96;21;0;21;1.000;3600000;0
8984;-1;555;97;61;2;59;.967;3582000;0
8984;68961;555;0;0;0;0;.00nan;0;0
8984;83252;553;0;0;0;0;.00nan;0;0
8985;178789;554;48;0;0;0;.00nan;249000;0
8985;-1;560;0;0;0;0;.00nan;0;0
8985;54860;560;75;50;5;45;.900;3600000;0
8985;85489;554;35;26;6;20;.769;3338000;0
8986;10112;1423;0;0;0;0;.00nan;0;0
8986;27517;1423;70;39;3;36;.923;3583000;0
8986;75764;558;0;0;0;0;.00nan;0;0
8986;85395;558;68;26;2;24;.923;3600000;0
8987;2140;553;71;24;2;22;.917;3600000;0
8987;-1;555;0;0;0;0;.00nan;0;0
8987;68961;555;64;31;3;28;.903;3569000;0
8987;83252;553;0;0;0;0;.00nan;0;0
8988;4379;2626;0;0;0;0;.00nan;0;0
8988;28989;2626;74;39;3;36;.923;3600000;0
8988;-1;560;50;32;5;27;.844;3580000;0
8988;54860;560;0;0;0;0;.00nan;0;0
8989;178789;554;90;20;0;20;1.000;3600000;0
8989;57172;556;92;39;2;37;.949;3541000;0
8989;85349;556;0;0;0;0;.00nan;0;0
8989;85489;554;0;0;0;0;.00nan;0;0
8990;10112;1423;27;19;5;14;.737;3549000;0
8990;27517;1423;0;0;0;0;.00nan;0;0
8990;-1;555;75;40;3;37;.925;3600000;0
8990;68961;555;0;0;0;0;.00nan;0;0
8991;2140;553;67;23;2;21;.913;3600000;0
8991;4379;2626;80;43;3;40;.930;3600000;0
8991;28989;2626;0;0;0;0;.00nan;0;0
8991;83252;553;0;0;0;0;.00nan;0;0
8992;-1;560;0;0;0;0;.00nan;0;0
8992;54860;560;74;32;2;30;.938;3900000;0
8992;57172;556;76;31;2;29;.935;3876000;0
8992;85349;556;0;0;0;0;.00nan;0;0
8993;2140;553;91;19;0;19;1.000;3600000;0
8993;10112;1423;29;29;6;23;.793;3600000;0
8993;27517;1423;0;0;0;0;.00nan;0;0
8993;83252;553;0;0;0;0;.00nan;0;0
8994;4379;2626;99;45;2;43;.956;3600000;0
8994;28989;2626;0;0;0;0;.00nan;0;0
8994;75764;558;0;0;0;0;.00nan;0;0
8994;85395;558;77;33;3;30;.909;3543000;0
8995;-1;561;0;0;0;0;.00nan;0;0
8995;65324;561;100;34;1;33;.971;3600000;0
8995;75764;558;0;0;0;0;.00nan;0;0
8995;85395;558;73;34;3;31;.912;3600000;0
8996;4379;2626;0;0;0;0;.00nan;0;0
8996;28989;2626;56;25;3;22;.880;3600000;0
8996;57172;556;65;24;2;22;.917;3600000;0
8996;85349;556;0;0;0;0;.00nan;0;0
8997;178789;554;54;11;1;10;.909;3562000;0
8997;-1;555;100;38;0;38;1.000;3600000;0
8997;68961;555;0;0;0;0;.00nan;0;0
8997;85489;554;0;0;0;0;.00nan;0;0
8998;177156;552;81;23;1;22;.957;3600000;0
8998;-1;560;80;36;3;33;.917;3516000;0
8998;54860;560;0;0;0;0;.00nan;0;0
8998;86422;552;0;0;0;0;.00nan;0;0
8999;-1;560;0;0;0;0;.00nan;0;0
8999;54860;560;79;44;3;41;.932;3551000;0
8999;57172;556;44;10;2;8;.800;3600000;0
8999;85349;556;0;0;0;0;.00nan;0;0
9000;177156;552;0;0;0;0;.00nan;0;0
9000;-1;561;0;0;0;0;.00nan;0;0
9000;65324;561;64;35;3;32;.914;3600000;0
9000;86422;552;83;42;4;38;.905;3567000;0
9001;2140;553;93;21;0;21;1.000;3600000;0
9001;178789;554;67;30;3;27;.900;3600000;0
9001;83252;553;0;0;0;0;.00nan;0;0
9001;85489;554;0;0;0;0;.00nan;0;0
9002;10112;1423;56;24;2;22;.917;3567000;0
9002;27517;1423;0;0;0;0;.00nan;0;0
9002;75764;558;0;0;0;0;.00nan;0;0
9002;85395;558;76;17;1;16;.941;3600000;0
9003;4379;2626;97;39;1;38;.974;3544000;0
9003;28989;2626;0;0;0;0;.00nan;0;0
9003;57172;556;89;18;0;18;1.000;3600000;0
9003;85349;556;0;0;0;0;.00nan;0;0
9004;178789;554;0;0;0;0;.00nan;0;0
9004;-1;560;0;0;0;0;.00nan;0;0
9004;54860;560;85;47;4;43;.915;3545000;0
9004;85489;554;74;30;3;27;.900;3600000;0
9005;10112;1423;0;0;0;0;.00nan;0;0
9005;27517;1423;64;26;2;24;.923;3600000;0
9005;-1;561;92;44;3;41;.932;3561000;0
9005;65324;561;0;0;0;0;.00nan;0;0
9006;-1;555;95;64;5;59;.922;3600000;0
9006;68961;555;0;0;0;0;.00nan;0;0
9006;75764;558;0;0;0;0;.00nan;0;0
9006;85395;558;71;24;2;22;.917;3600000;0
9007;177156;552;56;27;3;24;.889;3582000;0
9007;2140;553;99;40;1;39;.975;3600000;0
9007;83252;553;0;0;0;0;.00nan;0;0
9007;86422;552;0;0;0;0;.00nan;0;0
9008;177156;552;0;0;0;0;.00nan;0;0
9008;-1;560;0;0;0;0;.00nan;0;0
9008;54860;560;70;26;2;24;.923;3900000;0
9008;86422;552;95;34;2;32;.941;3900000;0
9009;10112;1423;0;0;0;0;.00nan;0;0
9009;27517;1423;56;25;2;23;.920;3568000;0
9009;-1;560;77;25;1;24;.960;3600000;0
9009;54860;560;0;0;0;0;.00nan;0;0
9010;2140;553;71;41;5;36;.878;3556000;0
9010;-1;561;0;0;0;0;.00nan;0;0
9010;65324;561;70;30;3;27;.900;3600000;0
9010;83252;553;0;0;0;0;.00nan;0;0
9011;4379;2626;0;0;0;0;.00nan;0;0
9011;28989;2626;59;30;3;27;.900;3600000;0
9011;75764;558;55;3;0;3;1.000;359000;0
9011;85395;558;32;31;6;25;.806;3241000;0
9012;178789;554;85;14;0;14;1.000;3600000;0
9012;-1;555;61;53;6;47;.887;3121000;0
9012;68961;555;62;4;0;4;1.000;479000;0
9012;85489;554;0;0;0;0;.00nan;0;0
9013;177156;552;64;15;1;14;.933;3600000;0
9013;10112;1423;53;35;4;31;.886;3600000;0
9013;27517;1423;0;0;0;0;.00nan;0;0
9013;86422;552;0;0;0;0;.00nan;0;0
9014;178789;554;0;0;0;0;.00nan;0;0
9014;75764;558;75;44;4;40;.909;3600000;0
9014;85395;558;0;0;0;0;.00nan;0;0
9014;85489;554;38;25;5;20;.800;3547000;0
9015;-1;561;34;11;3;8;.727;461000;0
9015;57172;556;80;30;2;28;.933;3600000;0
9015;65324;561;48;34;6;28;.824;3139000;0
9015;85349;556;0;0;0;0;.00nan;0;0
9016;4379;2626;39;20;4;16;.800;1102000;0
9016;169438;560;0;0;0;0;.00nan;0;0
9016;28989;2626;58;27;3;24;.889;2498000;0
9016;54860;560;61;32;3;29;.906;3600000;0
9017;4379;2626;0;0;0;0;.00nan;0;0
9017;169438;560;0;0;0;0;.00nan;0;0
9017;28989;2626;84;31;2;29;.935;3534000;0
9017;54860;560;100;35;0;35;1.000;3600000;0
9018;2140;553;78;25;1;24;.960;3600000;0
9018;65324;561;67;33;3;30;.909;3512000;0
9018;83252;553;0;0;0;0;.00nan;0;0
9018;148391;561;0;0;0;0;.00nan;0;0
9019;10112;1423;0;0;0;0;.00nan;0;0
9019;27517;1423;66;34;3;31;.912;3600000;0
9019;57172;556;52;17;2;15;.882;3600000;0
9019;85349;556;0;0;0;0;.00nan;0;0
9020;177156;552;0;0;0;0;.00nan;0;0
9020;-1;555;85;39;2;37;.949;3583000;0
9020;68961;555;0;0;0;0;.00nan;0;0
9020;86422;552;86;27;1;26;.963;3600000;0
9021;178789;554;46;31;5;26;.839;3600000;0
9021;75764;558;54;39;4;35;.897;2721000;0
9021;85395;558;30;14;4;10;.714;879000;0
9021;85489;554;0;0;0;0;.00nan;0;0
9022;10112;1423;96;46;2;44;.957;3517000;0
9022;27517;1423;0;0;0;0;.00nan;0;0
9022;57172;556;85;18;0;18;1.000;3600000;0
9022;85349;556;0;0;0;0;.00nan;0;0
9023;2140;553;0;0;0;0;.00nan;0;0
9023;178789;554;0;0;0;0;.00nan;0;0
9023;83252;553;49;30;4;26;.867;3577000;0
9023;85489;554;81;40;3;37;.925;3600000;0
9024;65324;561;69;43;5;38;.884;3617000;0
9024;75764;558;0;0;0;0;.00nan;0;0
9024;85395;558;57;30;4;26;.867;3617000;0
9024;148391;561;0;0;0;0;.00nan;0;0
9025;177156;552;70;16;1;15;.938;3600000;0
9025;-1;555;27;29;6;23;.793;2860000;0
9025;68961;555;18;8;4;4;.500;740000;0
9025;86422;552;0;0;0;0;.00nan;0;0
9026;-1;560;0;0;0;0;.00nan;0;0
9026;54860;560;59;40;5;35;.875;3588000;0
9026;75764;558;0;0;0;0;.00nan;0;0
9026;85395;558;63;23;3;20;.870;3600000;0
9027;-1;561;0;0;0;0;.00nan;0;0
9027;57172;556;58;18;2;16;.889;3654000;0
9027;65324;561;72;35;3;32;.914;3654000;0
9027;85349;556;0;0;0;0;.00nan;0;0
9028;10112;1423;53;36;5;31;.861;3600000;0
9028;27517;1423;0;0;0;0;.00nan;0;0
9028;-1;555;88;39;2;37;.949;3600000;0
9028;68961;555;0;0;0;0;.00nan;0;0
9029;177156;552;0;0;0;0;.00nan;0;0
9029;4379;2626;57;53;7;46;.868;3231000;0
9029;28989;2626;59;6;0;6;1.000;369000;0
9029;86422;552;93;20;0;20;1.000;3600000;0
9030;-1;560;0;0;0;0;.00nan;0;0
9030;54860;560;100;37;1;36;.973;3600000;0
9030;75764;558;0;0;0;0;.00nan;0;0
9030;85395;558;37;20;5;15;.750;3600000;0
9031;2140;553;99;36;1;35;.972;3600000;0
9031;57172;556;0;0;0;0;.00nan;0;0
9031;83252;553;0;0;0;0;.00nan;0;0
9031;85349;556;74;29;2;27;.931;3568000;0
9032;10112;1423;0;0;0;0;.00nan;0;0
9032;27517;1423;72;25;2;23;.920;3600000;0
9032;-1;555;0;0;0;0;.00nan;0;0
9032;68961;555;63;30;3;27;.900;3543000;0
9033;177156;552;0;0;0;0;.00nan;0;0
9033;4379;2626;0;0;0;0;.00nan;0;0
9033;28989;2626;72;44;5;39;.886;3600000;0
9033;86422;552;70;18;1;17;.944;3600000;0
9034;178789;554;71;42;3;39;.929;3600000;0
9034;-1;561;0;0;0;0;.00nan;0;0
9034;65324;561;49;35;5;30;.857;3569000;0
9034;85489;554;0;0;0;0;.00nan;0;0
9035;10112;1423;20;44;9;35;.795;3600000;0
9035;27517;1423;0;0;0;0;.00nan;0;0
9035;-1;561;67;17;1;16;.941;3600000;0
9035;65324;561;0;0;0;0;.00nan;0;0
9036;2140;553;54;34;6;28;.824;3519000;0
9036;75764;558;0;0;0;0;.00nan;0;0
9036;83252;553;0;0;0;0;.00nan;0;0
9036;85395;558;72;38;4;34;.895;3600000;0
9037;-1;560;0;0;0;0;.00nan;0;0
9037;54860;560;44;45;6;39;.867;3600000;0
9037;57172;556;85;27;1;26;.963;3600000;0
9037;85349;556;0;0;0;0;.00nan;0;0
9038;4379;2626;53;15;2;13;.867;3600000;0
9038;28989;2626;0;0;0;0;.00nan;0;0
9038;-1;555;63;44;5;39;.886;3600000;0
9038;68961;555;0;0;0;0;.00nan;0;0
9039;177156;552;98;50;3;47;.940;3535000;0
9039;178789;554;85;31;1;30;.968;3600000;0
9039;85489;554;0;0;0;0;.00nan;0;0
9039;86422;552;0;0;0;0;.00nan;0;0
9040;10112;1423;0;0;0;0;.00nan;0;0
9040;27517;1423;92;32;2;30;.938;3600000;0
9040;-1;561;0;0;0;0;.00nan;0;0
9040;65324;561;54;35;5;30;.857;3600000;0
9041;2140;553;0;0;0;0;.00nan;0;0
9041;75764;558;53;15;1;14;.933;1396000;0
9041;83252;553;74;29;2;27;.931;3600000;0
9041;85395;558;31;17;4;13;.765;2204000;0
9042;4379;2626;67;18;2;16;.889;3600000;0
9042;28989;2626;0;0;0;0;.00nan;0;0
9042;-1;555;0;0;0;0;.00nan;0;0
9042;68961;555;69;32;3;29;.906;3577000;0
9043;177156;552;0;0;0;0;.00nan;0;0
9043;178789;554;0;0;0;0;.00nan;0;0
9043;85489;554;44;36;5;31;.861;3589000;0
9043;86422;552;72;42;4;38;.905;3600000;0
9044;-1;560;36;26;5;21;.808;2125000;0
9044;54860;560;72;18;1;17;.944;1475000;0
9044;57172;556;80;25;1;24;.960;3600000;0
9044;85349;556;0;0;0;0;.00nan;0;0
9045;2140;553;65;30;3;27;.900;3900000;0
9045;-1;560;0;0;0;0;.00nan;0;0
9045;54860;560;62;29;3;26;.897;3900000;0
9045;83252;553;0;0;0;0;.00nan;0;0
9046;177156;552;0;0;0;0;.00nan;0;0
9046;10112;1423;52;46;6;40;.870;3001000;0
9046;27517;1423;59;5;0;5;1.000;599000;0
9046;86422;552;52;23;3;20;.870;3600000;0
9047;57172;556;52;21;3;18;.857;3556000;0
9047;75764;558;0;0;0;0;.00nan;0;0
9047;85349;556;0;0;0;0;.00nan;0;0
9047;85395;558;100;44;2;42;.955;3600000;0
9048;-1;555;0;0;0;0;.00nan;0;0
9048;-1;561;0;0;0;0;.00nan;0;0
9048;65324;561;74;27;2;25;.926;3600000;0
9048;68961;555;74;42;3;39;.929;3589000;0
9049;4379;2626;29;13;4;9;.692;894000;0
9049;178789;554;45;31;5;26;.839;3600000;0
9049;28989;2626;60;33;3;30;.909;2689000;0
9049;85489;554;0;0;0;0;.00nan;0;0
9050;-1;555;66;46;5;41;.891;3600000;0
9050;-1;561;55;19;2;17;.895;3600000;0
9050;65324;561;0;0;0;0;.00nan;0;0
9050;68961;555;0;0;0;0;.00nan;0;0
9051;2140;553;0;0;0;0;.00nan;0;0
9051;-1;560;0;0;0;0;.00nan;0;0
9051;54860;560;80;24;1;23;.958;3546000;0
9051;83252;553;95;19;0;19;1.000;3600000;0
9052;57172;556;71;28;2;26;.929;3851000;0
9052;75764;558;0;0;0;0;.00nan;0;0
9052;85349;556;0;0;0;0;.00nan;0;0
9052;85395;558;67;35;3;32;.914;3851000;0
9053;177156;552;60;27;4;23;.852;3546000;0
9053;10112;1423;0;0;0;0;.00nan;0;0
9053;27517;1423;87;43;3;40;.930;3600000;0
9053;86422;552;0;0;0;0;.00nan;0;0
9054;4379;2626;100;29;0;29;1.000;3600000;0
9054;178789;554;87;41;3;38;.927;3600000;0
9054;28989;2626;0;0;0;0;.00nan;0;0
9054;85489;554;0;0;0;0;.00nan;0;0
9055;2140;553;0;0;0;0;.00nan;0;0
9055;57172;556;39;24;4;20;.833;3600000;0
9055;83252;553;70;28;3;25;.893;3600000;0
9055;85349;556;0;0;0;0;.00nan;0;0
9056;178789;554;53;26;4;22;.846;3543000;0
9056;57172;556;0;0;0;0;.00nan;0;0
9056;85349;556;79;37;3;34;.919;3600000;0
9056;85489;554;0;0;0;0;.00nan;0;0
9057;-1;560;0;0;0;0;.00nan;0;0
9057;54860;560;64;44;5;39;.886;3600000;0
9057;75764;558;0;0;0;0;.00nan;0;0
9057;85395;558;64;20;2;18;.900;3600000;0
9058;2140;553;33;15;4;11;.733;1024000;0
9058;10112;1423;71;44;4;40;.909;3600000;0
9058;27517;1423;0;0;0;0;.00nan;0;0
9058;83252;553;60;16;1;15;.938;2523000;0
9059;4379;2626;83;33;1;32;.970;3600000;0
9059;28989;2626;0;0;0;0;.00nan;0;0
9059;-1;561;0;0;0;0;.00nan;0;0
9059;65324;561;81;40;3;37;.925;3600000;0
9060;177156;552;0;0;0;0;.00nan;0;0
9060;-1;555;0;0;0;0;.00nan;0;0
9060;68961;555;83;63;7;56;.889;3600000;0
9060;86422;552;88;17;0;17;1.000;3600000;0
9061;178789;554;0;0;0;0;.00nan;0;0
9061;57172;556;84;35;2;33;.943;3554000;0
9061;85349;556;0;0;0;0;.00nan;0;0
9061;85489;554;82;32;1;31;.969;3600000;0
9062;-1;561;53;21;3;18;.857;3600000;0
9062;-1;560;0;0;0;0;.00nan;0;0
9062;54860;560;67;39;4;35;.897;3548000;0
9062;65324;561;0;0;0;0;.00nan;0;0
9063;4379;2626;77;25;1;24;.960;3600000;0
9063;10112;1423;51;21;3;18;.857;2553000;0
9063;27517;1423;31;20;4;16;.800;1047000;0
9063;28989;2626;0;0;0;0;.00nan;0;0
9064;177156;552;0;0;0;0;.00nan;0;0
9064;75764;558;79;44;4;40;.909;3576000;0
9064;85395;558;0;0;0;0;.00nan;0;0
9064;86422;552;87;32;2;30;.938;3600000;0
9065;2140;553;65;27;2;25;.926;3554000;0
9065;-1;555;100;43;1;42;.977;3600000;0
9065;68961;555;0;0;0;0;.00nan;0;0
9065;83252;553;0;0;0;0;.00nan;0;0
9066;177156;552;0;0;0;0;.00nan;0;0
9066;-1;560;0;0;0;0;.00nan;0;0
9066;54860;560;67;28;2;26;.929;3543000;0
9066;86422;552;70;23;1;22;.957;3600000;0
9067;177156;552;69;23;1;22;.957;3600000;0
9067;-1;560;0;0;0;0;.00nan;0;0
9067;54860;560;40;32;6;26;.813;3600000;0
9067;86422;552;0;0;0;0;.00nan;0;0
9068;2140;553;70;38;4;34;.895;3516000;0
9068;57172;556;77;30;2;28;.933;3600000;0
9068;83252;553;0;0;0;0;.00nan;0;0
9068;85349;556;0;0;0;0;.00nan;0;0
9069;-1;555;56;35;4;31;.886;3600000;0
9069;68961;555;0;0;0;0;.00nan;0;0
9069;75764;558;0;0;0;0;.00nan;0;0
9069;85395;558;85;22;1;21;.955;3600000;0
9070;4379;2626;88;46;2;44;.957;3900000;0
9070;178789;554;71;30;2;28;.933;3900000;0
9070;28989;2626;0;0;0;0;.00nan;0;0
9070;85489;554;0;0;0;0;.00nan;0;0
9071;10112;1423;61;41;5;36;.878;3517000;0
9071;27517;1423;0;0;0;0;.00nan;0;0
9071;75764;558;68;29;3;26;.897;3600000;0
9071;85395;558;0;0;0;0;.00nan;0;0
9072;4379;2626;0;0;0;0;.00nan;0;0
9072;28989;2626;75;26;2;24;.923;3600000;0
9072;-1;555;0;0;0;0;.00nan;0;0
9072;68961;555;65;45;5;40;.889;3600000;0
9073;2140;553;60;22;2;20;.909;1421000;0
9073;178789;554;0;0;0;0;.00nan;0;0
9073;83252;553;55;37;5;32;.865;2179000;0
9073;85489;554;51;20;3;17;.850;3600000;0
9074;2140;553;82;29;1;28;.966;3600000;0
9074;-1;561;0;0;0;0;.00nan;0;0
9074;65324;561;69;31;2;29;.935;3561000;0
9074;83252;553;0;0;0;0;.00nan;0;0
9075;178789;554;69;24;2;22;.917;3882000;0
9075;75764;558;0;0;0;0;.00nan;0;0
9075;85395;558;94;50;3;47;.940;3882000;0
9075;85489;554;0;0;0;0;.00nan;0;0
9076;-1;555;98;46;2;44;.957;3567000;0
9076;57172;556;58;13;1;12;.923;3600000;0
9076;68961;555;0;0;0;0;.00nan;0;0
9076;85349;556;0;0;0;0;.00nan;0;0
9077;4379;2626;73;34;2;32;.941;3600000;0
9077;10112;1423;0;0;0;0;.00nan;0;0
9077;28989;2626;0;0;0;0;.00nan;0;0
9077;-1;1423;86;40;3;37;.925;3571000;0
9078;177156;552;0;0;0;0;.00nan;0;0
9078;-1;560;0;0;0;0;.00nan;0;0
9078;54860;560;80;50;6;44;.880;3600000;0
9078;86422;552;34;18;4;14;.778;3600000;0
9079;10112;1423;0;0;0;0;.00nan;0;0
9079;-1;1423;65;27;3;24;.889;3900000;0
9079;-1;560;0;0;0;0;.00nan;0;0
9079;54860;560;73;30;3;27;.900;3900000;0
9080;177156;552;38;27;5;22;.815;3582000;0
9080;2140;553;0;0;0;0;.00nan;0;0
9080;83252;553;64;31;3;28;.903;3600000;0
9080;86422;552;0;0;0;0;.00nan;0;0
9081;-1;555;0;0;0;0;.00nan;0;0
9081;-1;561;52;28;4;24;.857;3900000;0
9081;65324;561;0;0;0;0;.00nan;0;0
9081;68961;555;100;60;4;56;.933;3900000;0
9082;4379;2626;0;0;0;0;.00nan;0;0
9082;28989;2626;82;40;3;37;.925;3600000;0
9082;57172;556;98;39;4;35;.897;3551000;0
9082;85349;556;0;0;0;0;.00nan;0;0
9083;178789;554;0;0;0;0;.00nan;0;0
9083;75764;558;54;40;7;33;.825;3600000;0
9083;85395;558;0;0;0;0;.00nan;0;0
9083;85489;554;61;16;1;15;.938;3600000;0
9084;10112;1423;0;0;0;0;.00nan;0;0
9084;-1;1423;64;25;2;23;.920;3753000;0
9084;-1;560;0;0;0;0;.00nan;0;0
9084;54860;560;81;36;3;33;.917;3753000;0
9085;-1;555;41;35;6;29;.829;2510000;0
9085;-1;561;0;0;0;0;.00nan;0;0
9085;65324;561;34;13;4;9;.692;3600000;0
9085;68961;555;48;12;2;10;.833;1090000;0
9086;2140;553;50;27;4;23;.852;3600000;0
9086;75764;558;68;12;0;12;1.000;1239000;0
9086;83252;553;0;0;0;0;.00nan;0;0
9086;85395;558;23;25;7;18;.720;2361000;0
9087;4379;2626;71;40;4;36;.900;3600000;0
9087;28989;2626;0;0;0;0;.00nan;0;0
9087;57172;556;51;14;2;12;.857;3600000;0
9087;85349;556;0;0;0;0;.00nan;0;0
9088;177156;552;57;24;2;22;.917;2460000;0
9088;178789;554;67;29;3;26;.897;3600000;0
9088;85489;554;0;0;0;0;.00nan;0;0
9088;86422;552;27;14;4;10;.714;1140000;0
9089;10112;1423;24;33;7;26;.788;2440000;0
9089;-1;1423;34;23;5;18;.783;1160000;0
9089;57172;556;60;17;2;15;.882;3600000;0
9089;85349;556;0;0;0;0;.00nan;0;0
9090;-1;561;68;39;4;35;.897;3554000;0
9090;65324;561;0;0;0;0;.00nan;0;0
9090;75764;558;0;0;0;0;.00nan;0;0
9090;85395;558;42;17;3;14;.824;3600000;0
9091;-1;555;0;0;0;0;.00nan;0;0
9091;-1;560;65;31;3;28;.903;3600000;0
9091;54860;560;0;0;0;0;.00nan;0;0
9091;68961;555;55;36;5;31;.861;3585000;0
9092;177156;552;0;0;0;0;.00nan;0;0
9092;4379;2626;0;0;0;0;.00nan;0;0
9092;28989;2626;73;33;3;30;.909;3538000;0
9092;86422;552;51;15;2;13;.867;3600000;0
9093;2140;553;0;0;0;0;.00nan;0;0
9093;178789;554;0;0;0;0;.00nan;0;0
9093;83252;553;64;45;5;40;.889;3600000;0
9093;85489;554;81;34;2;32;.941;3600000;0
9094;178789;554;47;28;5;23;.821;3735000;0
9094;57172;556;54;26;4;22;.846;3735000;0
9094;85349;556;0;0;0;0;.00nan;0;0
9094;85489;554;0;0;0;0;.00nan;0;0
9095;-1;561;0;0;0;0;.00nan;0;0
9095;-1;560;0;0;0;0;.00nan;0;0
9095;54860;560;60;40;5;35;.875;3600000;0
9095;65324;561;86;35;2;33;.943;3600000;0
9096;2140;553;40;27;5;22;.815;3600000;0
9096;-1;555;0;0;0;0;.00nan;0;0
9096;68961;555;98;42;2;40;.952;3600000;0
9096;83252;553;0;0;0;0;.00nan;0;0
9097;4379;2626;83;29;1;28;.966;3600000;0
9097;28989;2626;0;0;0;0;.00nan;0;0
9097;75764;558;83;44;3;41;.932;3568000;0
9097;85395;558;0;0;0;0;.00nan;0;0
9098;177156;552;83;26;2;24;.923;3900000;0
9098;10112;1423;0;0;0;0;.00nan;0;0
9098;-1;1423;89;40;2;38;.950;3900000;0
9098;86422;552;0;0;0;0;.00nan;0;0
9099;178789;554;0;0;0;0;.00nan;0;0
9099;57172;556;62;23;2;21;.913;3900000;0
9099;85349;556;0;0;0;0;.00nan;0;0
9099;85489;554;76;29;2;27;.931;3900000;0
9100;-1;561;66;31;3;28;.903;3560000;0
9100;-1;560;77;33;2;31;.939;3600000;0
9100;54860;560;0;0;0;0;.00nan;0;0
9100;65324;561;0;0;0;0;.00nan;0;0
9101;177156;552;0;0;0;0;.00nan;0;0
9101;10112;1423;0;0;0;0;.00nan;0;0
9101;-1;1423;82;50;3;47;.940;3539000;0
9101;86422;552;82;24;1;23;.958;3600000;0
9102;4379;2626;0;0;0;0;.00nan;0;0
9102;28989;2626;42;28;4;24;.857;3553000;0
9102;75764;558;0;0;0;0;.00nan;0;0
9102;85395;558;100;47;3;44;.936;3600000;0
9103;10112;1423;0;0;0;0;.00nan;0;0
9103;-1;1423;68;42;5;37;.881;3600000;0
9103;-1;561;0;0;0;0;.00nan;0;0
9103;65324;561;100;28;0;28;1.000;3600000;0
9104;177156;552;0;0;0;0;.00nan;0;0
9104;75764;558;0;0;0;0;.00nan;0;0
9104;85395;558;67;32;4;28;.875;3600000;0
9104;86422;552;86;32;1;31;.969;3600000;0
9105;-1;560;51;10;1;9;.900;1251000;0
9105;54860;560;38;32;6;26;.813;2349000;0
9105;57172;556;0;0;0;0;.00nan;0;0
9105;85349;556;79;33;2;31;.939;3600000;0
9106;2140;553;88;16;0;16;1.000;3600000;0
9106;-1;555;50;45;6;39;.867;3355000;0
9106;68961;555;47;7;1;6;.857;245000;0
9106;83252;553;0;0;0;0;.00nan;0;0
9107;4379;2626;18;52;10;42;.808;3600000;0
9107;178789;554;90;16;0;16;1.000;3600000;0
9107;28989;2626;0;0;0;0;.00nan;0;0
9107;85489;554;0;0;0;0;.00nan;0;0
9108;10112;1423;0;0;0;0;.00nan;0;0
9108;178789;554;63;26;3;23;.885;3600000;0
9108;-1;1423;70;37;4;33;.892;3583000;0
9108;85489;554;0;0;0;0;.00nan;0;0
9109;2140;553;84;32;2;30;.938;3900000;0
9109;-1;560;0;0;0;0;.00nan;0;0
9109;54860;560;87;43;2;41;.953;3900000;0
9109;83252;553;0;0;0;0;.00nan;0;0
9110;-1;555;65;33;2;31;.939;2889000;0
9110;68961;555;15;9;4;5;.556;711000;0
9110;75764;558;57;29;3;26;.897;3600000;0
9110;85395;558;0;0;0;0;.00nan;0;0
9111;4379;2626;0;0;0;0;.00nan;0;0
9111;28989;2626;22;25;6;19;.760;3597000;0
9111;-1;561;0;0;0;0;.00nan;0;0
9111;65324;561;54;24;4;20;.833;3600000;0
9112;177156;552;63;33;4;29;.879;3600000;0
9112;57172;556;30;30;6;24;.800;3551000;0
9112;85349;556;0;0;0;0;.00nan;0;0
9112;86422;552;0;0;0;0;.00nan;0;0
9113;-1;561;0;0;0;0;.00nan;0;0
9113;65324;561;64;26;3;23;.885;3600000;0
9113;75764;558;70;44;4;40;.909;3589000;0
9113;85395;558;0;0;0;0;.00nan;0;0
9114;10112;1423;0;0;0;0;.00nan;0;0
9114;-1;1423;73;44;4;40;.909;3600000;0
9114;57172;556;98;23;0;23;1.000;3600000;0
9114;85349;556;0;0;0;0;.00nan;0;0
9115;177156;552;0;0;0;0;.00nan;0;0
9115;2140;553;100;39;0;39;1.000;3600000;0
9115;83252;553;0;0;0;0;.00nan;0;0
9115;86422;552;76;27;2;25;.926;3545000;0
9116;178789;554;32;16;4;12;.750;3600000;0
9116;-1;555;95;57;4;53;.930;3317000;0
9116;68961;555;26;8;3;5;.625;283000;0
9116;85489;554;0;0;0;0;.00nan;0;0
9117;10112;1423;0;0;0;0;.00nan;0;0
9117;-1;1423;93;51;4;47;.922;3597000;0
9117;57172;556;58;18;2;16;.889;3600000;0
9117;85349;556;0;0;0;0;.00nan;0;0
9118;10112;1423;0;0;0;0;.00nan;0;0
9118;-1;1423;57;27;3;24;.889;3558000;0
9118;-1;555;0;0;0;0;.00nan;0;0
9118;68961;555;82;32;2;30;.938;3600000;0
9119;-1;561;0;0;0;0;.00nan;0;0
9119;65324;561;61;30;3;27;.900;3600000;0
9119;75764;558;0;0;0;0;.00nan;0;0
9119;85395;558;59;34;4;30;.882;3600000;0
9120;2140;553;57;29;3;26;.897;3600000;0
9120;4379;2626;58;53;6;47;.887;3262000;0
9120;28989;2626;55;5;0;5;1.000;338000;0
9120;83252;553;0;0;0;0;.00nan;0;0
9121;177156;552;62;14;1;13;.929;1604000;0
9121;178789;554;59;35;5;30;.857;3900000;0
9121;85489;554;0;0;0;0;.00nan;0;0
9121;86422;552;45;20;4;16;.800;2296000;0
9122;4379;2626;0;0;0;0;.00nan;0;0
9122;28989;2626;42;23;4;19;.826;3548000;0
9122;-1;560;0;0;0;0;.00nan;0;0
9122;54860;560;87;35;2;33;.943;3600000;0
9123;2140;553;0;0;0;0;.00nan;0;0
9123;-1;561;0;0;0;0;.00nan;0;0
9123;65324;561;59;41;5;36;.878;3600000;0
9123;83252;553;65;26;2;24;.923;3600000;0
9124;178789;554;73;21;1;20;.952;3600000;0
9124;-1;555;36;13;3;10;.769;551000;0
9124;68961;555;53;51;7;44;.863;3049000;0
9124;85489;554;0;0;0;0;.00nan;0;0
9125;177156;552;90;22;0;22;1.000;3600000;0
9125;75764;558;62;37;4;33;.892;3600000;0
9125;85395;558;0;0;0;0;.00nan;0;0
9125;86422;552;0;0;0;0;.00nan;0;0
9126;4379;2626;81;50;4;46;.920;3600000;0
9126;28989;2626;0;0;0;0;.00nan;0;0
9126;75764;558;0;0;0;0;.00nan;0;0
9126;85395;558;86;22;0;22;1.000;3600000;0
9127;-1;560;0;0;0;0;.00nan;0;0
9127;54860;560;61;35;4;31;.886;3578000;0
9127;75764;558;0;0;0;0;.00nan;0;0
9127;85395;558;77;28;3;25;.893;3600000;0
9128;178789;554;86;15;0;15;1.000;3877000;0
9128;-1;561;0;0;0;0;.00nan;0;0
9128;65324;561;94;43;1;42;.977;3877000;0
9128;85489;554;0;0;0;0;.00nan;0;0
9129;2140;553;90;21;0;21;1.000;3600000;0
9129;196812;1423;0;0;0;0;.00nan;0;0
9129;-1;1423;46;39;6;33;.846;3600000;0
9129;83252;553;0;0;0;0;.00nan;0;0
9130;177156;552;87;40;2;38;.950;3525000;0
9130;57172;556;100;27;0;27;1.000;3600000;0
9130;85349;556;0;0;0;0;.00nan;0;0
9130;86422;552;0;0;0;0;.00nan;0;0
9131;4379;2626;0;0;0;0;.00nan;0;0
9131;28989;2626;85;44;3;41;.932;3600000;0
9131;-1;555;0;0;0;0;.00nan;0;0
9131;68961;555;55;34;4;30;.882;3600000;0
9132;2140;553;64;32;3;29;.906;3600000;0
9132;57172;556;0;0;0;0;.00nan;0;0
9132;83252;553;0;0;0;0;.00nan;0;0
9132;85349;556;68;28;2;26;.929;3600000;0
9133;-1;555;87;47;3;44;.936;3600000;0
9133;-1;561;62;11;0;11;1.000;2395000;0
9133;65324;561;24;11;4;7;.636;1146000;0
9133;68961;555;0;0;0;0;.00nan;0;0
9134;177156;552;0;0;0;0;.00nan;0;0
9134;-1;560;71;28;2;26;.929;3600000;0
9134;54860;560;0;0;0;0;.00nan;0;0
9134;86422;552;35;15;3;12;.800;3560000;0
9135;178789;554;80;13;1;12;.923;3600000;0
9135;196812;1423;98;50;2;48;.960;3560000;0
9135;-1;1423;0;0;0;0;.00nan;0;0
9135;85489;554;0;0;0;0;.00nan;0;0
9136;196812;1423;68;38;4;34;.895;3566000;0
9136;-1;1423;0;0;0;0;.00nan;0;0
9136;-1;560;0;0;0;0;.00nan;0;0
9136;54860;560;72;31;3;28;.903;3600000;0
9137;-1;555;0;0;0;0;.00nan;0;0
9137;-1;561;51;32;4;28;.875;3544000;0
9137;65324;561;0;0;0;0;.00nan;0;0
9137;68961;555;69;34;3;31;.912;3600000;0
9138;57172;556;72;30;3;27;.900;3600000;0
9138;75764;558;0;0;0;0;.00nan;0;0
9138;85349;556;0;0;0;0;.00nan;0;0
9138;85395;558;71;40;4;36;.900;3600000;0
9139;2140;553;73;19;1;18;.947;3600000;0
9139;4379;2626;97;45;2;43;.956;3600000;0
9139;28989;2626;0;0;0;0;.00nan;0;0
9139;83252;553;0;0;0;0;.00nan;0;0
9140;196812;1423;80;29;2;27;.931;3600000;0
9140;-1;1423;0;0;0;0;.00nan;0;0
9140;-1;560;50;29;4;25;.862;3513000;0
9140;54860;560;0;0;0;0;.00nan;0;0
9141;57172;556;0;0;0;0;.00nan;0;0
9141;75764;558;73;26;2;24;.923;3600000;0
9141;85349;556;31;24;5;19;.792;3600000;0
9141;85395;558;0;0;0;0;.00nan;0;0
9142;177156;552;70;26;2;24;.923;3600000;0
9142;-1;561;0;0;0;0;.00nan;0;0
9142;65324;561;84;59;5;54;.915;3600000;0
9142;86422;552;0;0;0;0;.00nan;0;0
9143;4379;2626;0;0;0;0;.00nan;0;0
9143;178789;554;70;28;2;26;.929;3600000;0
9143;28989;2626;41;36;6;30;.833;3600000;0
9143;85489;554;0;0;0;0;.00nan;0;0
9144;2140;553;92;33;2;31;.939;3600000;0
9144;178789;554;81;40;4;36;.900;3572000;0
9144;83252;553;0;0;0;0;.00nan;0;0
9144;85489;554;0;0;0;0;.00nan;0;0
9145;177156;552;0;0;0;0;.00nan;0;0
9145;-1;555;100;55;0;55;1.000;3600000;0
9145;68961;555;0;0;0;0;.00nan;0;0
9145;86422;552;55;13;1;12;.923;3570000;0
9210;10112;1423;0;0;0;0;.00nan;0;0
9210;27517;1423;66;41;3;38;.927;3600000;0
9210;-1;561;0;0;0;0;.00nan;0;0
9210;65324;561;76;32;2;30;.938;3600000;0
9212;177156;552;0;0;0;0;.00nan;0;0
9212;75764;558;0;0;0;0;.00nan;0;0
9212;85395;558;49;35;5;30;.857;3600000;0
9212;86422;552;56;15;2;13;.867;3600000;0
9214;178789;554;0;0;0;0;.00nan;0;0
9214;57172;556;77;27;1;26;.963;3600000;0
9214;85349;556;0;0;0;0;.00nan;0;0
9214;85489;554;85;50;4;46;.920;3600000;0
9216;-1;555;0;0;0;0;.00nan;0;0
9216;-1;560;0;0;0;0;.00nan;0;0
9216;54860;560;50;34;5;29;.853;3546000;0
9216;68961;555;70;38;3;35;.921;3600000;0
9218;2140;553;99;39;2;37;.949;3900000;0
9218;4379;2626;0;0;0;0;.00nan;0;0
9218;28989;2626;97;42;2;40;.952;3900000;0
9218;83252;553;0;0;0;0;.00nan;0;0
9220;4379;2626;59;31;4;27;.871;3551000;0
9220;28989;2626;0;0;0;0;.00nan;0;0
9220;57172;556;0;0;0;0;.00nan;0;0
9220;85349;556;89;35;2;33;.943;3600000;0
9222;-1;555;50;41;5;36;.878;2259000;0
9222;68961;555;51;12;1;11;.917;1341000;0
9222;75764;558;0;0;0;0;.00nan;0;0
9222;85395;558;60;9;1;8;.889;3600000;0
9224;177156;552;0;0;0;0;.00nan;0;0
9224;2140;553;71;30;2;28;.933;3551000;0
9224;83252;553;0;0;0;0;.00nan;0;0
9224;86422;552;100;30;0;30;1.000;3600000;0
9226;10112;1423;82;27;1;26;.963;3600000;0
9226;27517;1423;0;0;0;0;.00nan;0;0
9226;-1;561;0;0;0;0;.00nan;0;0
9226;65324;561;50;41;5;36;.878;3600000;0
9228;178789;554;0;0;0;0;.00nan;0;0
9228;-1;560;0;0;0;0;.00nan;0;0
9228;54860;560;82;55;5;50;.909;3600000;0
9228;85489;554;72;18;1;17;.944;3600000;0
9250;2140;553;67;21;2;19;.905;3600000;0
9250;4379;2626;45;7;1;6;.857;567000;0
9250;28989;2626;69;46;5;41;.891;3033000;0
9250;83252;553;0;0;0;0;.00nan;0;0
9252;178789;554;0;0;0;0;.00nan;0;0
9252;-1;555;0;0;0;0;.00nan;0;0
9252;68961;555;82;38;2;36;.947;3600000;0
9252;85489;554;91;30;1;29;.967;3600000;0
9254;177156;552;0;0;0;0;.00nan;0;0
9254;57172;556;92;35;1;34;.971;3600000;0
9254;85349;556;0;0;0;0;.00nan;0;0
9254;86422;552;86;41;3;38;.927;3530000;0
9256;10112;1423;62;38;4;34;.895;3600000;0
9256;27517;1423;0;0;0;0;.00nan;0;0
9256;75764;558;0;0;0;0;.00nan;0;0
9256;85395;558;100;29;0;29;1.000;3600000;0
9258;-1;561;0;0;0;0;.00nan;0;0
9258;-1;560;0;0;0;0;.00nan;0;0
9258;54860;560;71;33;3;30;.909;3600000;0
9258;65324;561;92;17;0;17;1.000;3600000;0
9260;10112;1423;0;0;0;0;.00nan;0;0
9260;27517;1423;93;39;1;38;.974;3554000;0
9260;75764;558;0;0;0;0;.00nan;0;0
9260;85395;558;79;13;0;13;1.000;3600000;0
9262;177156;552;99;44;2;42;.955;3600000;0
9262;57172;556;0;0;0;0;.00nan;0;0
9262;85349;556;45;25;4;21;.840;3585000;0
9262;86422;552;0;0;0;0;.00nan;0;0
9264;178789;554;66;18;2;16;.889;3600000;0
9264;-1;555;87;51;5;46;.902;3600000;0
9264;68961;555;0;0;0;0;.00nan;0;0
9264;85489;554;0;0;0;0;.00nan;0;0
9266;2140;553;0;0;0;0;.00nan;0;0
9266;-1;561;0;0;0;0;.00nan;0;0
9266;65324;561;98;36;1;35;.972;3584000;0
9266;83252;553;82;13;0;13;1.000;3600000;0
9268;4379;2626;55;38;5;33;.868;3600000;0
9268;28989;2626;0;0;0;0;.00nan;0;0
9268;-1;560;76;27;1;26;.963;3600000;0
9268;54860;560;0;0;0;0;.00nan;0;0
9269;184049;1097;70;42;5;37;.881;3600000;0
9269;173856;75;52;19;3;16;.842;3600000;0
9269;170598;1097;0;0;0;0;.00nan;0;0
9269;171615;75;0;0;0;0;.00nan;0;0
9270;171970;81;63;23;2;21;.913;3600000;0
9270;-1;151;55;10;1;9;.900;657000;0
9270;176770;81;0;0;0;0;.00nan;0;0
9270;196525;151;49;35;6;29;.829;2943000;0
9271;-1;71;0;0;0;0;.00nan;0;0
9271;57953;72;0;0;0;0;.00nan;0;0
9271;64811;72;58;26;3;23;.885;3544000;0
9271;78775;71;99;53;2;51;.962;3600000;0
9272;161535;4921;66;20;2;18;.900;3900000;0
9272;2495;80;0;0;0;0;.00nan;0;0
9272;184398;4921;0;0;0;0;.00nan;0;0
9272;85009;80;84;34;2;32;.941;3900000;0
9273;183859;4920;0;0;0;0;.00nan;0;0
9273;170612;85;0;0;0;0;.00nan;0;0
9273;170963;4920;81;26;2;24;.923;3600000;0
9273;57998;85;79;42;3;39;.929;3585000;0
9274;189581;76;57;12;1;11;.917;885000;0
9274;175423;77;0;0;0;0;.00nan;0;0
9274;176136;76;10;30;8;22;.733;2715000;0
9274;180873;77;79;31;2;29;.935;3600000;0
9275;163989;4245;79;32;2;30;.938;3600000;0
9275;-1;4245;0;0;0;0;.00nan;0;0
9275;181341;4620;0;0;0;0;.00nan;0;0
9275;85555;4620;59;28;3;25;.893;3569000;0
9276;173874;158;0;0;0;0;.00nan;0;0
9276;170351;149;0;0;0;0;.00nan;0;0
9276;85546;149;73;20;1;19;.950;3600000;0
9276;91398;158;46;25;4;21;.840;3600000;0
9277;163784;82;0;0;0;0;.00nan;0;0
9277;175423;77;0;0;0;0;.00nan;0;0
9277;176963;82;86;39;3;36;.923;3600000;0
9277;180873;77;84;32;1;31;.969;3600000;0
9278;184069;73;51;8;1;7;.875;1002000;0
9278;169166;1095;0;0;0;0;.00nan;0;0
9278;173823;73;20;23;6;17;.739;2598000;0
9278;78479;1095;83;43;4;39;.907;3600000;0
9279;-1;71;0;0;0;0;.00nan;0;0
9279;57953;72;0;0;0;0;.00nan;0;0
9279;64811;72;63;13;1;12;.923;3600000;0
9279;78775;71;60;29;3;26;.897;3600000;0
9280;166545;1096;0;0;0;0;.00nan;0;0
9280;183775;1096;39;29;5;24;.828;3514000;0
9280;189581;76;0;0;0;0;.00nan;0;0
9280;176136;76;59;29;3;26;.897;3600000;0
9281;171970;81;47;31;5;26;.839;3514000;0
9281;-1;151;0;0;0;0;.00nan;0;0
9281;176770;81;0;0;0;0;.00nan;0;0
9281;196525;151;97;50;3;47;.940;3600000;0
9282;161535;4921;67;49;5;44;.898;3587000;0
9282;2495;80;0;0;0;0;.00nan;0;0
9282;184398;4921;0;0;0;0;.00nan;0;0
9282;85009;80;46;16;3;13;.813;3600000;0
9283;183737;74;0;0;0;0;.00nan;0;0
9283;184049;1097;37;14;3;11;.786;555000;0
9283;170598;1097;66;23;1;22;.957;3045000;0
9283;-1;74;67;21;1;20;.952;3600000;0
9284;176860;2564;81;40;3;37;.925;3561000;0
9284;58100;69;93;30;1;29;.967;3600000;0
9284;64911;69;0;0;0;0;.00nan;0;0
9284;85633;2564;0;0;0;0;.00nan;0;0
9285;173874;158;0;0;0;0;.00nan;0;0
9285;170351;149;0;0;0;0;.00nan;0;0
9285;85546;149;73;26;2;24;.923;3600000;0
9285;91398;158;78;49;5;44;.898;3600000;0
9286;163989;4245;100;28;0;28;1.000;3600000;0
9286;-1;4245;0;0;0;0;.00nan;0;0
9286;181341;4620;97;40;1;39;.975;3556000;0
9286;85555;4620;0;0;0;0;.00nan;0;0
9287;183859;4920;100;30;0;30;1.000;3600000;0
9287;170612;85;0;0;0;0;.00nan;0;0
9287;170963;4920;0;0;0;0;.00nan;0;0
9287;57998;85;87;43;3;40;.930;3600000;0
9288;173856;75;56;23;3;20;.870;3600000;0
9288;171615;75;0;0;0;0;.00nan;0;0
9288;86472;4922;99;39;2;37;.949;3600000;0
9288;161046;4922;0;0;0;0;.00nan;0;0
9289;184081;157;38;28;5;23;.821;3600000;0
9289;178911;152;0;0;0;0;.00nan;0;0
9289;171730;157;0;0;0;0;.00nan;0;0
9289;189944;152;90;37;1;36;.973;3600000;0
9290;169096;67;32;24;5;19;.792;2101000;0
9290;174407;78;82;28;1;27;.964;3600000;0
9290;179406;78;0;0;0;0;.00nan;0;0
9290;182049;67;69;20;2;18;.900;1499000;0
9291;183859;4920;0;0;0;0;.00nan;0;0
9291;170612;85;49;33;5;28;.848;3569000;0
9291;170963;4920;49;30;4;26;.867;3600000;0
9291;57998;85;0;0;0;0;.00nan;0;0
9292;184081;157;57;19;2;17;.895;3600000;0
9292;178911;152;0;0;0;0;.00nan;0;0
9292;171730;157;0;0;0;0;.00nan;0;0
9292;189944;152;68;37;4;33;.892;3547000;0
9293;174407;78;75;42;4;38;.905;3758000;0
9293;179406;78;0;0;0;0;.00nan;0;0
9293;181341;4620;56;22;3;19;.864;3758000;0
9293;85555;4620;0;0;0;0;.00nan;0;0
9294;173874;158;0;0;0;0;.00nan;0;0
9294;170351;149;0;0;0;0;.00nan;0;0
9294;85546;149;62;24;3;21;.875;3600000;0
9294;91398;158;75;45;4;41;.911;3596000;0
9295;176860;2564;61;42;5;37;.881;3600000;0
9295;57953;72;0;0;0;0;.00nan;0;0
9295;64811;72;96;20;0;20;1.000;3600000;0
9295;85633;2564;0;0;0;0;.00nan;0;0
9296;189581;76;76;37;3;34;.919;3577000;0
9296;174407;78;81;32;2;30;.938;3600000;0
9296;179406;78;0;0;0;0;.00nan;0;0
9296;176136;76;0;0;0;0;.00nan;0;0
9297;183859;4920;86;27;1;26;.963;3600000;0
9297;170963;4920;0;0;0;0;.00nan;0;0
9297;86472;4922;49;28;4;24;.857;1941000;0
9297;161046;4922;60;11;1;10;.909;1659000;0
9298;-1;71;0;0;0;0;.00nan;0;0
9298;58100;69;75;33;2;31;.939;3600000;0
9298;64911;69;0;0;0;0;.00nan;0;0
9298;78775;71;88;33;1;32;.970;3600000;0
9299;166545;1096;0;0;0;0;.00nan;0;0
9299;183775;1096;100;23;0;23;1.000;3600000;0
9299;175423;77;0;0;0;0;.00nan;0;0
9299;180873;77;58;34;3;31;.912;3600000;0
9300;184069;73;43;17;3;14;.824;3898000;0
9300;173823;73;0;0;0;0;.00nan;0;0
9300;176860;2564;73;38;4;34;.895;3898000;0
9300;85633;2564;0;0;0;0;.00nan;0;0
9301;163989;4245;70;17;1;16;.941;3600000;0
9301;169096;67;0;0;0;0;.00nan;0;0
9301;-1;4245;0;0;0;0;.00nan;0;0
9301;182049;67;86;47;4;43;.915;3600000;0
9302;189581;76;0;0;0;0;.00nan;0;0
9302;174407;78;68;30;3;27;.900;3693000;0
9302;179406;78;0;0;0;0;.00nan;0;0
9302;176136;76;65;25;2;23;.920;3693000;0
9303;2495;80;89;25;1;24;.960;3900000;0
9303;173874;158;0;0;0;0;.00nan;0;0
9303;85009;80;0;0;0;0;.00nan;0;0
9303;91398;158;97;36;1;35;.972;3900000;0
9304;-1;151;0;0;0;0;.00nan;0;0
9304;178911;152;0;0;0;0;.00nan;0;0
9304;189944;152;93;36;1;35;.972;3600000;0
9304;196525;151;34;30;6;24;.800;3600000;0
9305;169166;1095;0;0;0;0;.00nan;0;0
9305;170351;149;71;35;3;32;.914;3600000;0
9305;78479;1095;32;29;6;23;.793;3600000;0
9305;85546;149;0;0;0;0;.00nan;0;0
9306;163989;4245;0;0;0;0;.00nan;0;0
9306;169096;67;59;14;1;13;.929;1284000;0
9306;-1;4245;82;26;1;25;.962;3600000;0
9306;182049;67;27;22;5;17;.773;2316000;0
9307;171970;81;0;0;0;0;.00nan;0;0
9307;163784;82;0;0;0;0;.00nan;0;0
9307;176770;81;94;33;1;32;.970;3600000;0
9307;176963;82;62;22;2;20;.909;3543000;0
9308;183737;74;0;0;0;0;.00nan;0;0
9308;184049;1097;0;0;0;0;.00nan;0;0
9308;170598;1097;100;28;0;28;1.000;3600000;0
9308;-1;74;59;30;4;26;.867;3600000;0
9309;184069;73;77;39;3;36;.923;3541000;0
9309;173823;73;0;0;0;0;.00nan;0;0
9309;-1;71;61;25;2;23;.920;3600000;0
9309;78775;71;0;0;0;0;.00nan;0;0
9310;176860;2564;0;0;0;0;.00nan;0;0
9310;57953;72;0;0;0;0;.00nan;0;0
9310;64811;72;79;23;1;22;.957;3600000;0
9310;85633;2564;78;56;5;51;.911;3600000;0
9311;183859;4920;75;28;2;26;.929;3600000;0
9311;170963;4920;0;0;0;0;.00nan;0;0
9311;86472;4922;72;49;5;44;.898;3600000;0
9311;161046;4922;0;0;0;0;.00nan;0;0
9312;2495;80;0;0;0;0;.00nan;0;0
9312;173874;158;97;48;3;45;.938;3600000;0
9312;85009;80;75;24;1;23;.958;3600000;0
9312;91398;158;0;0;0;0;.00nan;0;0
9313;170612;85;0;0;0;0;.00nan;0;0
9313;181341;4620;55;20;2;18;.900;3600000;0
9313;57998;85;65;33;3;30;.909;3579000;0
9313;85555;4620;0;0;0;0;.00nan;0;0
9314;184081;157;73;32;3;29;.906;3600000;0
9314;169166;1095;27;33;7;26;.788;3199000;0
9314;171730;157;0;0;0;0;.00nan;0;0
9314;78479;1095;58;8;0;8;1.000;401000;0
9315;-1;151;60;28;3;25;.893;3598000;0
9315;178911;152;96;35;1;34;.971;3600000;0
9315;189944;152;0;0;0;0;.00nan;0;0
9315;196525;151;0;0;0;0;.00nan;0;0
9316;161535;4921;85;44;3;41;.932;3856000;0
9316;170351;149;0;0;0;0;.00nan;0;0
9316;184398;4921;0;0;0;0;.00nan;0;0
9316;85546;149;64;32;4;28;.875;3856000;0
9317;171970;81;49;29;5;24;.828;3600000;0
9317;163784;82;41;12;3;9;.750;583000;0
9317;176770;81;0;0;0;0;.00nan;0;0
9317;176963;82;31;13;4;9;.692;2979000;0
9318;183859;4920;0;0;0;0;.00nan;0;0
9318;170963;4920;72;17;1;16;.941;3600000;0
9318;86472;4922;42;8;2;6;.750;889000;0
9318;161046;4922;45;36;6;30;.833;2711000;0
9319;189581;76;47;36;5;31;.861;3569000;0
9319;174407;78;59;29;4;25;.862;3600000;0
9319;179406;78;0;0;0;0;.00nan;0;0
9319;176136;76;0;0;0;0;.00nan;0;0
9320;183737;74;49;32;5;27;.844;3600000;0
9320;173856;75;0;0;0;0;.00nan;0;0
9320;171615;75;62;26;2;24;.923;3600000;0
9320;-1;74;0;0;0;0;.00nan;0;0
9321;170612;85;77;38;3;35;.921;3582000;0
9321;181341;4620;0;0;0;0;.00nan;0;0
9321;57998;85;0;0;0;0;.00nan;0;0
9321;85555;4620;83;33;2;31;.939;3600000;0
9322;184081;157;0;0;0;0;.00nan;0;0
9322;169166;1095;0;0;0;0;.00nan;0;0
9322;171730;157;36;10;3;7;.700;3600000;0
9322;78479;1095;100;52;2;50;.962;3600000;0
9323;161535;4921;0;0;0;0;.00nan;0;0
9323;170351;149;80;9;0;9;1.000;3600000;0
9323;184398;4921;81;32;2;30;.938;3588000;0
9323;85546;149;0;0;0;0;.00nan;0;0
9324;2495;80;0;0;0;0;.00nan;0;0
9324;173874;158;65;10;0;10;1.000;1369000;0
9324;85009;80;87;36;3;33;.917;3600000;0
9324;91398;158;39;22;4;18;.818;2201000;0
9325;166545;1096;0;0;0;0;.00nan;0;0
9325;163784;82;0;0;0;0;.00nan;0;0
9325;183775;1096;43;35;5;30;.857;3600000;0
9325;176963;82;97;37;1;36;.973;3600000;0
9326;184049;1097;90;51;4;47;.922;3668000;0
9326;173856;75;0;0;0;0;.00nan;0;0
9326;170598;1097;0;0;0;0;.00nan;0;0
9326;171615;75;64;31;3;28;.903;3668000;0
9327;-1;151;0;0;0;0;.00nan;0;0
9327;170351;149;52;21;3;18;.857;3600000;0
9327;196525;151;88;45;4;41;.911;3600000;0
9327;85546;149;0;0;0;0;.00nan;0;0
9328;183737;74;0;0;0;0;.00nan;0;0
9328;-1;74;38;22;4;18;.818;3569000;0
9328;86472;4922;76;29;2;27;.931;3600000;0
9328;161046;4922;0;0;0;0;.00nan;0;0
9329;171970;81;68;43;5;38;.884;3600000;0
9329;184081;157;77;20;1;19;.950;3600000;0
9329;171730;157;0;0;0;0;.00nan;0;0
9329;176770;81;0;0;0;0;.00nan;0;0
9330;163784;82;0;0;0;0;.00nan;0;0
9330;183737;74;80;23;1;22;.957;3600000;0
9330;-1;74;0;0;0;0;.00nan;0;0
9330;176963;82;95;41;2;39;.951;3600000;0
9331;161535;4921;100;38;1;37;.974;3600000;0
9331;184398;4921;0;0;0;0;.00nan;0;0
9331;60773;1095;0;0;0;0;.00nan;0;0
9331;78479;1095;57;23;3;20;.870;3572000;0
9332;184049;1097;0;0;0;0;.00nan;0;0
9332;173856;75;61;27;3;24;.889;3900000;0
9332;170598;1097;63;36;3;33;.917;3900000;0
9332;171615;75;0;0;0;0;.00nan;0;0
9333;166545;1096;0;0;0;0;.00nan;0;0
9333;183775;1096;60;35;4;31;.886;3543000;0
9333;175423;77;0;0;0;0;.00nan;0;0
9333;180873;77;67;31;3;28;.903;3600000;0
9334;-1;151;0;0;0;0;.00nan;0;0
9334;170351;149;0;0;0;0;.00nan;0;0
9334;196525;151;69;35;3;32;.914;3565000;0
9334;85546;149;98;32;1;31;.969;3600000;0
9335;176860;2564;90;53;3;50;.943;3600000;0
9335;57953;72;0;0;0;0;.00nan;0;0
9335;64811;72;67;19;1;18;.947;3600000;0
9335;85633;2564;0;0;0;0;.00nan;0;0
9336;2495;80;0;0;0;0;.00nan;0;0
9336;173874;158;62;12;0;12;1.000;607000;0
9336;85009;80;95;24;0;24;1.000;3600000;0
9336;91398;158;60;32;4;28;.875;2993000;0
9337;163989;4245;79;23;1;22;.957;3600000;0
9337;189581;76;0;0;0;0;.00nan;0;0
9337;-1;4245;0;0;0;0;.00nan;0;0
9337;176136;76;97;47;2;45;.957;3600000;0
9338;170612;85;0;0;0;0;.00nan;0;0
9338;57998;85;45;22;3;19;.864;3600000;0
9338;58100;69;100;25;0;25;1.000;3600000;0
9338;64911;69;0;0;0;0;.00nan;0;0
9339;183859;4920;80;24;1;23;.958;3600000;0
9339;170963;4920;0;0;0;0;.00nan;0;0
9339;181341;4620;82;31;2;29;.935;3578000;0
9339;85555;4620;0;0;0;0;.00nan;0;0
9340;171970;81;0;0;0;0;.00nan;0;0
9340;184081;157;0;0;0;0;.00nan;0;0
9340;171730;157;53;25;4;21;.840;3600000;0
9340;176770;81;87;43;3;40;.930;3600000;0
9341;169096;67;0;0;0;0;.00nan;0;0
9341;174407;78;88;34;2;32;.941;3900000;0
9341;179406;78;0;0;0;0;.00nan;0;0
9341;182049;67;62;22;2;20;.909;3900000;0
9342;161535;4921;0;0;0;0;.00nan;0;0
9342;184398;4921;100;27;0;27;1.000;3600000;0
9342;60773;1095;64;29;3;26;.897;3600000;0
9342;78479;1095;0;0;0;0;.00nan;0;0
9343;184049;1097;67;29;3;26;.897;3600000;0
9343;173856;75;0;0;0;0;.00nan;0;0
9343;170598;1097;0;0;0;0;.00nan;0;0
9343;171615;75;46;35;5;30;.857;3544000;0
9344;166545;1096;71;23;1;22;.957;3600000;0
9344;183737;74;0;0;0;0;.00nan;0;0
9344;183775;1096;0;0;0;0;.00nan;0;0
9344;-1;74;46;32;5;27;.844;3600000;0
9345;-1;151;57;44;5;39;.886;3571000;0
9345;170351;149;75;30;3;27;.900;3600000;0
9345;196525;151;0;0;0;0;.00nan;0;0
9345;85546;149;0;0;0;0;.00nan;0;0
9346;176860;2564;0;0;0;0;.00nan;0;0
9346;-1;71;0;0;0;0;.00nan;0;0
9346;78775;71;77;15;0;15;1.000;3600000;0
9346;85633;2564;95;48;2;46;.958;3600000;0
9347;2495;80;0;0;0;0;.00nan;0;0
9347;173874;158;57;36;4;32;.889;3562000;0
9347;85009;80;73;23;2;21;.913;3600000;0
9347;91398;158;0;0;0;0;.00nan;0;0
9348;163989;4245;0;0;0;0;.00nan;0;0
9348;189581;76;100;47;0;47;1.000;3600000;0
9348;-1;4245;64;33;4;29;.879;3600000;0
9348;176136;76;0;0;0;0;.00nan;0;0
9349;175423;77;78;29;2;27;.931;3600000;0
9349;180873;77;0;0;0;0;.00nan;0;0
9349;86472;4922;58;32;3;29;.906;3600000;0
9349;161046;4922;0;0;0;0;.00nan;0;0
9350;57953;72;0;0;0;0;.00nan;0;0
9350;58100;69;51;39;6;33;.846;3089000;0
9350;64811;72;68;26;2;24;.923;3600000;0
9350;64911;69;49;2;0;2;1.000;511000;0
9351;183859;4920;0;0;0;0;.00nan;0;0
9351;170963;4920;57;17;2;15;.882;3900000;0
9351;181341;4620;0;0;0;0;.00nan;0;0
9351;85555;4620;90;44;2;42;.955;3900000;0
9352;184069;73;39;24;5;19;.792;3546000;0
9352;173823;73;0;0;0;0;.00nan;0;0
9352;170612;85;64;30;3;27;.900;3600000;0
9352;57998;85;0;0;0;0;.00nan;0;0
9353;169096;67;34;32;5;27;.844;3600000;0
9353;174407;78;0;0;0;0;.00nan;0;0
9353;179406;78;86;27;1;26;.963;3600000;0
9353;182049;67;0;0;0;0;.00nan;0;0
9354;163784;82;100;26;0;26;1.000;3600000;0
9354;176963;82;0;0;0;0;.00nan;0;0
9354;86472;4922;0;0;0;0;.00nan;0;0
9354;161046;4922;80;35;3;32;.914;3600000;0
9355;163989;4245;69;23;1;22;.957;3600000;0
9355;189581;76;0;0;0;0;.00nan;0;0
9355;-1;4245;0;0;0;0;.00nan;0;0
9355;176136;76;32;23;5;18;.783;3600000;0
9356;166545;1096;0;0;0;0;.00nan;0;0
9356;183775;1096;71;32;3;29;.906;3559000;0
9356;175423;77;0;0;0;0;.00nan;0;0
9356;180873;77;82;26;1;25;.962;3600000;0
9357;183859;4920;83;27;1;26;.963;3600000;0
9357;170963;4920;0;0;0;0;.00nan;0;0
9357;181341;4620;42;28;5;23;.821;3600000;0
9357;85555;4620;0;0;0;0;.00nan;0;0
9358;2495;80;38;33;7;26;.788;3318000;0
9358;184081;157;28;22;5;17;.773;3600000;0
9358;171730;157;0;0;0;0;.00nan;0;0
9358;85009;80;58;3;0;3;1.000;282000;0
9359;184069;73;0;0;0;0;.00nan;0;0
9359;173823;73;72;30;3;27;.900;3681000;0
9359;170612;85;0;0;0;0;.00nan;0;0
9359;57998;85;87;39;2;37;.949;3681000;0
9360;171970;81;52;35;5;30;.857;3562000;0
9360;173874;158;0;0;0;0;.00nan;0;0
9360;176770;81;0;0;0;0;.00nan;0;0
9360;91398;158;73;36;3;33;.917;3600000;0
9361;173856;75;38;21;4;17;.810;3573000;0
9361;171615;75;0;0;0;0;.00nan;0;0
9361;86472;4922;81;37;3;34;.919;3600000;0
9361;161046;4922;0;0;0;0;.00nan;0;0
9362;169096;67;0;0;0;0;.00nan;0;0
9362;174407;78;77;28;2;26;.929;3600000;0
9362;179406;78;0;0;0;0;.00nan;0;0
9362;182049;67;66;42;5;37;.881;3600000;0
9363;161535;4921;0;0;0;0;.00nan;0;0
9363;184398;4921;65;21;2;19;.905;3600000;0
9363;176860;2564;67;34;3;31;.912;3577000;0
9363;85633;2564;0;0;0;0;.00nan;0;0
9364;189581;76;42;33;5;28;.848;3600000;0
9364;170612;85;0;0;0;0;.00nan;0;0
9364;176136;76;0;0;0;0;.00nan;0;0
9364;57998;85;94;30;1;29;.967;3600000;0
9365;170351;149;0;0;0;0;.00nan;0;0
9365;178911;152;0;0;0;0;.00nan;0;0
9365;189944;152;61;35;4;31;.886;3600000;0
9365;85546;149;77;23;1;22;.957;3600000;0
9366;161535;4921;72;31;4;27;.871;3600000;0
9366;184398;4921;0;0;0;0;.00nan;0;0
9366;176860;2564;37;23;5;18;.783;3582000;0
9366;85633;2564;0;0;0;0;.00nan;0;0
9367;183859;4920;69;15;1;14;.933;3600000;0
9367;170963;4920;0;0;0;0;.00nan;0;0
9367;174407;78;55;38;5;33;.868;3600000;0
9367;179406;78;0;0;0;0;.00nan;0;0
9368;2495;80;0;0;0;0;.00nan;0;0
9368;184081;157;69;19;2;17;.895;3600000;0
9368;171730;157;0;0;0;0;.00nan;0;0
9368;85009;80;80;48;4;44;.917;3580000;0
9369;169096;67;0;0;0;0;.00nan;0;0
9369;189581;76;0;0;0;0;.00nan;0;0
9369;176136;76;53;23;3;20;.870;3600000;0
9369;182049;67;50;35;5;30;.857;3600000;0
9370;171970;81;69;32;3;29;.906;3540000;0
9370;173874;158;0;0;0;0;.00nan;0;0
9370;176770;81;0;0;0;0;.00nan;0;0
9370;91398;158;83;27;1;26;.963;3600000;0
9371;-1;71;0;0;0;0;.00nan;0;0
9371;58100;69;73;39;3;36;.923;3600000;0
9371;64911;69;0;0;0;0;.00nan;0;0
9371;78775;71;64;37;4;33;.892;3600000;0
9372;166545;1096;0;0;0;0;.00nan;0;0
9372;183775;1096;75;44;4;40;.909;3568000;0
9372;184049;1097;60;24;3;21;.875;3600000;0
9372;170598;1097;0;0;0;0;.00nan;0;0
9373;57953;72;84;30;2;28;.933;3600000;0
9373;60773;1095;0;0;0;0;.00nan;0;0
9373;64811;72;0;0;0;0;.00nan;0;0
9373;78479;1095;83;39;3;36;.923;3600000;0
9374;163989;4245;48;21;3;18;.857;3600000;0
9374;-1;4245;0;0;0;0;.00nan;0;0
9374;181341;4620;69;27;2;25;.926;3600000;0
9374;85555;4620;0;0;0;0;.00nan;0;0
9375;183859;4920;0;0;0;0;.00nan;0;0
9375;170963;4920;59;25;3;22;.880;3600000;0
9375;174407;78;49;33;4;29;.879;3585000;0
9375;179406;78;0;0;0;0;.00nan;0;0
9376;2495;80;62;31;4;27;.871;3600000;0
9376;184081;157;98;24;0;24;1.000;3600000;0
9376;171730;157;0;0;0;0;.00nan;0;0
9376;85009;80;0;0;0;0;.00nan;0;0
9377;173856;75;59;15;1;14;.933;3600000;0
9377;171615;75;0;0;0;0;.00nan;0;0
9377;175423;77;0;0;0;0;.00nan;0;0
9377;180873;77;62;35;4;31;.886;3600000;0
9378;163784;82;91;43;3;40;.930;3620000;0
9378;176963;82;0;0;0;0;.00nan;0;0
9378;86472;4922;74;27;2;25;.926;3620000;0
9378;161046;4922;0;0;0;0;.00nan;0;0
9379;170351;149;71;21;1;20;.952;3600000;0
9379;178911;152;84;48;3;45;.938;3553000;0
9379;189944;152;0;0;0;0;.00nan;0;0
9379;85546;149;0;0;0;0;.00nan;0;0
9380;-1;151;0;0;0;0;.00nan;0;0
9380;184069;73;62;20;2;18;.900;3566000;0
9380;173823;73;0;0;0;0;.00nan;0;0
9380;196525;151;100;39;0;39;1.000;3600000;0
9381;171970;81;0;0;0;0;.00nan;0;0
9381;173874;158;97;54;4;50;.926;3600000;0
9381;176770;81;100;27;0;27;1.000;3600000;0
9381;91398;158;0;0;0;0;.00nan;0;0
9382;163784;82;0;0;0;0;.00nan;0;0
9382;184049;1097;0;0;0;0;.00nan;0;0
9382;170598;1097;93;21;0;21;1.000;3600000;0
9382;176963;82;66;32;4;28;.875;3600000;0
9383;57953;72;0;0;0;0;.00nan;0;0
9383;60773;1095;89;37;2;35;.946;3600000;0
9383;64811;72;72;38;4;34;.895;3516000;0
9383;78479;1095;0;0;0;0;.00nan;0;0
9384;166545;1096;61;28;3;25;.893;3600000;0
9384;183737;74;22;24;6;18;.750;2344000;0
9384;183775;1096;0;0;0;0;.00nan;0;0
9384;-1;74;49;12;2;10;.833;1256000;0
9385;161535;4921;0;0;0;0;.00nan;0;0
9385;184398;4921;91;27;1;26;.963;3600000;0
9385;176860;2564;24;11;4;7;.636;740000;0
9385;85633;2564;79;27;2;25;.926;2860000;0
9386;163989;4245;0;0;0;0;.00nan;0;0
9386;169096;67;55;45;7;38;.844;2952000;0
9386;-1;4245;67;30;3;27;.900;3600000;0
9386;182049;67;47;7;1;6;.857;648000;0
9387;173856;75;0;0;0;0;.00nan;0;0
9387;171615;75;38;35;6;29;.829;3600000;0
9387;175423;77;4;27;8;19;.704;3576000;0
9387;180873;77;0;0;0;0;.00nan;0;0
9388;2495;80;58;26;4;22;.846;3385000;0
9388;184081;157;58;28;3;25;.893;3600000;0
9388;171730;157;0;0;0;0;.00nan;0;0
9388;85009;80;26;7;3;4;.571;215000;0
9389;189581;76;74;30;2;28;.933;3600000;0
9389;170612;85;0;0;0;0;.00nan;0;0
9389;176136;76;0;0;0;0;.00nan;0;0
9389;57998;85;63;34;4;30;.882;3586000;0
9390;-1;71;0;0;0;0;.00nan;0;0
9390;58054;71;67;36;5;31;.861;3600000;0
9390;58100;69;0;0;0;0;.00nan;0;0
9390;64911;69;85;35;1;34;.971;3600000;0
9391;170351;149;0;0;0;0;.00nan;0;0
9391;189944;152;54;31;4;27;.871;3600000;0
9391;78775;152;0;0;0;0;.00nan;0;0
9391;85546;149;61;28;3;25;.893;3600000;0
9392;-1;151;0;0;0;0;.00nan;0;0
9392;184069;73;0;0;0;0;.00nan;0;0
9392;173823;73;49;24;3;21;.875;3587000;0
9392;196525;151;99;46;2;44;.957;3600000;0
9393;169096;67;0;0;0;0;.00nan;0;0
9393;181341;4620;0;0;0;0;.00nan;0;0
9393;182049;67;85;32;1;31;.969;3557000;0
9393;85555;4620;100;18;0;18;1.000;3600000;0
9394;171970;81;0;0;0;0;.00nan;0;0
9394;173874;158;0;0;0;0;.00nan;0;0
9394;176770;81;65;22;1;21;.955;3600000;0
9394;91398;158;32;32;6;26;.813;3600000;0
9395;163784;82;95;40;0;40;1.000;3900000;0
9395;184049;1097;0;0;0;0;.00nan;0;0
9395;170598;1097;100;32;0;32;1.000;3900000;0
9395;176963;82;0;0;0;0;.00nan;0;0
9396;166545;1096;50;1;0;1;1.000;302000;0
9396;183737;74;0;0;0;0;.00nan;0;0
9396;183775;1096;38;32;6;26;.813;3298000;0
9396;-1;74;99;45;1;44;.978;3600000;0
9397;183859;4920;49;13;2;11;.846;3600000;0
9397;170963;4920;0;0;0;0;.00nan;0;0
9397;174407;78;66;46;5;41;.891;3600000;0
9397;179406;78;0;0;0;0;.00nan;0;0
9398;-1;71;67;11;0;11;1.000;838000;0
9398;58054;71;37;31;6;25;.806;2728000;0
9398;58100;69;57;37;5;32;.865;3600000;0
9398;64911;69;0;0;0;0;.00nan;0;0
9399;-1;151;0;0;0;0;.00nan;0;0
9399;184069;73;37;18;3;15;.833;3533000;0
9399;173823;73;0;0;0;0;.00nan;0;0
9399;196525;151;98;35;1;34;.971;3600000;0
9400;166545;1096;0;0;0;0;.00nan;0;0
9400;163784;82;0;0;0;0;.00nan;0;0
9400;183775;1096;97;24;1;23;.958;3600000;0
9400;176963;82;77;52;5;47;.904;3600000;0
9401;-1;71;60;9;0;9;1.000;534000;0
9401;58054;71;34;30;6;24;.800;3066000;0
9401;60773;1095;66;17;1;16;.941;3600000;0
9401;78479;1095;0;0;0;0;.00nan;0;0
9402;184049;1097;80;34;2;32;.941;3600000;0
9402;173856;75;42;24;4;20;.833;3577000;0
9402;170598;1097;0;0;0;0;.00nan;0;0
9402;171615;75;0;0;0;0;.00nan;0;0
9403;171970;81;74;22;1;21;.955;3600000;0
9403;-1;151;0;0;0;0;.00nan;0;0
9403;176770;81;0;0;0;0;.00nan;0;0
9403;196525;151;50;32;4;28;.875;3600000;0
9404;161535;4921;55;30;5;25;.833;3600000;0
9404;184398;4921;0;0;0;0;.00nan;0;0
9404;189944;152;63;17;1;16;.941;3600000;0
9404;78775;152;0;0;0;0;.00nan;0;0
9405;183737;74;72;14;0;14;1.000;1459000;0
9405;-1;74;6;22;7;15;.682;2141000;0
9405;86472;4922;97;23;0;23;1.000;3600000;0
9405;161046;4922;0;0;0;0;.00nan;0;0
9406;184069;73;74;28;3;25;.893;3592000;0
9406;173823;73;0;0;0;0;.00nan;0;0
9406;58100;69;92;32;2;30;.938;3600000;0
9406;64911;69;0;0;0;0;.00nan;0;0
9407;166545;1096;0;0;0;0;.00nan;0;0
9407;183775;1096;56;36;5;31;.861;3600000;0
9407;175423;77;0;0;0;0;.00nan;0;0
9407;180873;77;54;30;4;26;.867;3600000;0
9408;163784;82;69;55;6;49;.891;3600000;0
9408;184049;1097;0;0;0;0;.00nan;0;0
9408;170598;1097;77;10;0;10;1.000;3600000;0
9408;176963;82;0;0;0;0;.00nan;0;0
9409;171970;81;0;0;0;0;.00nan;0;0
9409;-1;151;72;32;2;30;.938;3323000;0
9409;176770;81;44;33;6;27;.818;3860000;0
9409;196525;151;27;7;3;4;.571;537000;0
9410;184069;73;19;10;4;6;.600;1200000;0
9410;173823;73;70;16;1;15;.938;2400000;0
9410;57953;72;0;0;0;0;.00nan;0;0
9410;64811;72;67;16;1;15;.938;3600000;0
9411;161535;4921;0;0;0;0;.00nan;0;0
9411;184398;4921;43;26;4;22;.846;3600000;0
9411;189944;152;0;0;0;0;.00nan;0;0
9411;78775;152;100;34;0;34;1.000;3600000;0
9412;166545;1096;57;17;2;15;.882;3600000;0
9412;183737;74;71;43;4;39;.907;3600000;0
9412;183775;1096;0;0;0;0;.00nan;0;0
9412;-1;74;0;0;0;0;.00nan;0;0
9413;169096;67;0;0;0;0;.00nan;0;0
9413;189581;76;0;0;0;0;.00nan;0;0
9413;176136;76;68;28;3;25;.893;3813000;0
9413;182049;67;89;36;2;34;.944;3813000;0
9414;183859;4920;79;28;2;26;.929;3600000;0
9414;170612;85;0;0;0;0;.00nan;0;0
9414;170963;4920;0;0;0;0;.00nan;0;0
9414;57998;85;63;31;3;28;.903;3589000;0
9415;175423;77;83;22;1;21;.955;3600000;0
9415;180873;77;0;0;0;0;.00nan;0;0
9415;86472;4922;60;39;4;35;.897;3600000;0
9415;161046;4922;0;0;0;0;.00nan;0;0
9416;176860;2564;73;43;4;39;.907;3600000;0
9416;58100;69;35;27;5;22;.815;3545000;0
9416;64911;69;0;0;0;0;.00nan;0;0
9416;85633;2564;0;0;0;0;.00nan;0;0
9417;163989;4245;47;34;6;28;.824;3600000;0
9417;-1;4245;0;0;0;0;.00nan;0;0
9417;181341;4620;0;0;0;0;.00nan;0;0
9417;85555;4620;81;17;1;16;.941;3600000;0
9418;184081;157;83;40;3;37;.925;3900000;0
9418;173874;158;0;0;0;0;.00nan;0;0
9418;171730;157;0;0;0;0;.00nan;0;0
9418;91398;158;54;29;3;26;.897;3900000;0
9419;2495;80;0;0;0;0;.00nan;0;0
9419;170351;149;69;28;2;26;.929;3600000;0
9419;85009;80;59;39;5;34;.872;3600000;0
9419;85546;149;0;0;0;0;.00nan;0;0
9420;174407;78;87;46;3;43;.935;3600000;0
9420;179406;78;0;0;0;0;.00nan;0;0
9420;60773;1095;0;0;0;0;.00nan;0;0
9420;78479;1095;99;30;0;30;1.000;3600000;0
9421;163784;82;0;0;0;0;.00nan;0;0
9421;184049;1097;63;37;4;33;.892;3600000;0
9421;170598;1097;0;0;0;0;.00nan;0;0
9421;176963;82;94;33;1;32;.970;3600000;0
9422;-1;71;0;0;0;0;.00nan;0;0
9422;58054;71;61;26;3;23;.885;3599000;0
9422;58100;69;0;0;0;0;.00nan;0;0
9422;64911;69;91;41;2;39;.951;3600000;0
9423;171970;81;63;32;3;29;.906;3543000;0
9423;-1;151;0;0;0;0;.00nan;0;0
9423;176770;81;0;0;0;0;.00nan;0;0
9423;196525;151;87;32;1;31;.969;3600000;0
9424;176860;2564;80;51;6;45;.882;3034000;0
9424;57953;72;70;18;1;17;.944;3600000;0
9424;64811;72;0;0;0;0;.00nan;0;0
9424;85633;2564;55;9;1;8;.889;566000;0
9425;161535;4921;40;23;4;19;.826;3600000;0
9425;184398;4921;0;0;0;0;.00nan;0;0
9425;189944;152;0;0;0;0;.00nan;0;0
9425;78775;152;83;35;2;33;.943;3600000;0
9426;166545;1096;0;0;0;0;.00nan;0;0
9426;183737;74;53;4;0;4;1.000;874000;0
9426;183775;1096;100;34;1;33;.971;3600000;0
9426;-1;74;15;18;6;12;.667;2726000;0
9427;183859;4920;0;0;0;0;.00nan;0;0
9427;170612;85;67;37;4;33;.892;3582000;0
9427;170963;4920;71;28;2;26;.929;3600000;0
9427;57998;85;0;0;0;0;.00nan;0;0
9428;173856;75;0;0;0;0;.00nan;0;0
9428;171615;75;82;22;1;21;.955;3900000;0
9428;175423;77;0;0;0;0;.00nan;0;0
9428;180873;77;82;30;1;29;.967;3900000;0
9429;163989;4245;0;0;0;0;.00nan;0;0
9429;-1;4245;76;30;2;28;.933;3900000;0
9429;181341;4620;86;28;2;26;.929;3900000;0
9429;85555;4620;0;0;0;0;.00nan;0;0
9430;184081;157;0;0;0;0;.00nan;0;0
9430;173874;158;70;48;5;43;.896;3600000;0
9430;171730;157;70;26;2;24;.923;3600000;0
9430;91398;158;0;0;0;0;.00nan;0;0
9431;2495;80;44;31;5;26;.839;3600000;0
9431;170351;149;0;0;0;0;.00nan;0;0
9431;85009;80;0;0;0;0;.00nan;0;0
9431;85546;149;71;18;1;17;.944;3600000;0
9432;174407;78;86;32;2;30;.938;3563000;0
9432;179406;78;0;0;0;0;.00nan;0;0
9432;60773;1095;0;0;0;0;.00nan;0;0
9432;78479;1095;95;24;0;24;1.000;3600000;0
9433;184069;73;64;28;3;25;.893;3900000;0
9433;173823;73;0;0;0;0;.00nan;0;0
9433;-1;71;71;35;3;32;.914;3900000;0
9433;58054;71;0;0;0;0;.00nan;0;0
9434;57953;72;0;0;0;0;.00nan;0;0
9434;58100;69;21;22;6;16;.727;3231000;0
9434;64811;72;68;23;2;21;.913;3600000;0
9434;64911;69;40;2;1;1;.500;369000;0
9435;169096;67;0;0;0;0;.00nan;0;0
9435;189581;76;44;26;4;22;.846;3544000;0
9435;176136;76;0;0;0;0;.00nan;0;0
9435;182049;67;74;33;3;30;.909;3600000;0
9436;173856;75;93;43;2;41;.953;3580000;0
9436;171615;75;0;0;0;0;.00nan;0;0
9436;86472;4922;97;36;1;35;.972;3600000;0
9436;161046;4922;0;0;0;0;.00nan;0;0
9437;2495;80;0;0;0;0;.00nan;0;0
9437;170351;149;80;19;1;18;.947;3600000;0
9437;85009;80;69;40;4;36;.900;3600000;0
9437;85546;149;0;0;0;0;.00nan;0;0
9438;163989;4245;63;18;1;17;.944;3600000;0
9438;-1;4245;0;0;0;0;.00nan;0;0
9438;174407;78;0;0;0;0;.00nan;0;0
9438;179406;78;52;28;4;24;.857;3600000;0
9439;169096;67;83;33;2;31;.939;3592000;0
9439;170612;85;0;0;0;0;.00nan;0;0
9439;182049;67;0;0;0;0;.00nan;0;0
9439;57998;85;88;32;1;31;.969;3600000;0
9440;166545;1096;0;0;0;0;.00nan;0;0
9440;163784;82;55;28;4;24;.857;3900000;0
9440;183775;1096;67;37;4;33;.892;3900000;0
9440;176963;82;0;0;0;0;.00nan;0;0
9441;57953;72;0;0;0;0;.00nan;0;0
9441;60773;1095;0;0;0;0;.00nan;0;0
9441;64811;72;45;24;4;20;.833;3600000;0
9441;78479;1095;81;49;5;44;.898;3559000;0
9442;183737;74;10;18;6;12;.667;2438000;0
9442;-1;74;66;12;0;12;1.000;1132000;0
9442;86472;4922;81;44;4;40;.909;3600000;0
9442;161046;4922;0;0;0;0;.00nan;0;0
9443;161535;4921;60;29;3;26;.897;3600000;0
9443;184398;4921;0;0;0;0;.00nan;0;0
9443;176860;2564;46;31;5;26;.839;3554000;0
9443;85633;2564;0;0;0;0;.00nan;0;0
9444;189581;76;0;0;0;0;.00nan;0;0
9444;176136;76;68;39;4;35;.897;3558000;0
9444;181341;4620;0;0;0;0;.00nan;0;0
9444;85555;4620;75;26;2;24;.923;3600000;0
9445;173856;75;0;0;0;0;.00nan;0;0
9445;171615;75;73;25;2;23;.920;3900000;0
9445;175423;77;0;0;0;0;.00nan;0;0
9445;180873;77;95;41;2;39;.951;3900000;0
9446;2495;80;0;0;0;0;.00nan;0;0
9446;-1;151;0;0;0;0;.00nan;0;0
9446;196525;151;48;28;4;24;.857;3808000;0
9446;85009;80;95;54;3;51;.944;3808000;0
9447;184081;157;55;27;3;24;.889;3600000;0
9447;173874;158;0;0;0;0;.00nan;0;0
9447;171730;157;0;0;0;0;.00nan;0;0
9447;91398;158;55;39;5;34;.872;3528000;0
9448;183859;4920;54;16;2;14;.875;3600000;0
9448;170963;4920;0;0;0;0;.00nan;0;0
9448;189944;152;0;0;0;0;.00nan;0;0
9448;78775;152;75;51;6;45;.882;3600000;0
9449;184069;73;0;0;0;0;.00nan;0;0
9449;173823;73;39;33;5;28;.848;3600000;0
9449;58100;69;85;27;1;26;.963;3600000;0
9449;64911;69;0;0;0;0;.00nan;0;0
9450;171970;81;92;48;2;46;.958;3600000;0
9450;170351;149;0;0;0;0;.00nan;0;0
9450;176770;81;0;0;0;0;.00nan;0;0
9450;85546;149;51;21;3;18;.857;3544000;0
9451;161535;4921;0;0;0;0;.00nan;0;0
9451;184398;4921;75;23;2;21;.913;3600000;0
9451;-1;71;0;0;0;0;.00nan;0;0
9451;58054;71;59;36;5;31;.861;3600000;0
9452;169096;67;0;0;0;0;.00nan;0;0
9452;174407;78;54;23;3;20;.870;3600000;0
9452;179406;78;0;0;0;0;.00nan;0;0
9452;182049;67;32;18;4;14;.778;3600000;0
9453;163784;82;0;0;0;0;.00nan;0;0
9453;175423;77;0;0;0;0;.00nan;0;0
9453;176963;82;56;43;5;38;.884;3600000;0
9453;180873;77;59;21;2;19;.905;3600000;0
9454;184069;73;62;32;3;29;.906;3900000;0
9454;173823;73;0;0;0;0;.00nan;0;0
9454;60773;1095;0;0;0;0;.00nan;0;0
9454;78479;1095;86;44;3;41;.932;3900000;0
9455;-1;71;66;41;4;37;.902;3600000;0
9455;57953;72;69;18;1;17;.944;3600000;0
9455;58054;71;0;0;0;0;.00nan;0;0
9455;64811;72;0;0;0;0;.00nan;0;0
9456;183737;74;0;0;0;0;.00nan;0;0
9456;184049;1097;0;0;0;0;.00nan;0;0
9456;170598;1097;58;25;3;22;.880;3554000;0
9456;-1;74;71;24;2;22;.917;3600000;0
9457;173874;158;0;0;0;0;.00nan;0;0
9457;170351;149;71;25;2;23;.920;3600000;0
9457;85546;149;0;0;0;0;.00nan;0;0
9457;91398;158;73;40;4;36;.900;3529000;0
9458;163989;4245;40;30;5;25;.833;3600000;0
9458;170612;85;0;0;0;0;.00nan;0;0
9458;-1;4245;0;0;0;0;.00nan;0;0
9458;57998;85;71;26;2;24;.923;3600000;0
9459;189581;76;60;25;3;22;.880;3537000;0
9459;176136;76;0;0;0;0;.00nan;0;0
9459;181341;4620;78;26;2;24;.923;3600000;0
9459;85555;4620;0;0;0;0;.00nan;0;0
9460;2495;80;0;0;0;0;.00nan;0;0
9460;-1;151;0;0;0;0;.00nan;0;0
9460;196525;151;85;45;4;41;.911;3600000;0
9460;85009;80;27;24;6;18;.750;3539000;0
9461;166545;1096;7;24;7;17;.708;3262000;0
9461;183775;1096;47;1;0;1;1.000;638000;0
9461;86472;4922;13;24;7;17;.708;3292000;0
9461;161046;4922;59;4;0;4;1.000;608000;0
9462;176860;2564;69;48;5;43;.896;3600000;0
9462;58100;69;52;13;2;11;.846;3600000;0
9462;64911;69;0;0;0;0;.00nan;0;0
9462;85633;2564;0;0;0;0;.00nan;0;0
9463;171970;81;0;0;0;0;.00nan;0;0
9463;184081;157;73;13;1;12;.923;3600000;0
9463;171730;157;0;0;0;0;.00nan;0;0
9463;176770;81;50;45;6;39;.867;3600000;0
9464;183859;4920;72;27;2;25;.926;3600000;0
9464;170963;4920;0;0;0;0;.00nan;0;0
9464;189944;152;0;0;0;0;.00nan;0;0
9464;78775;152;93;39;1;38;.974;3600000;0
9465;169096;67;77;32;2;30;.938;3600000;0
9465;174407;78;72;32;4;28;.875;3600000;0
9465;179406;78;0;0;0;0;.00nan;0;0
9465;182049;67;0;0;0;0;.00nan;0;0
9466;166545;1096;0;0;0;0;.00nan;0;0
9466;163784;82;100;29;1;28;.966;3600000;0
9466;183775;1096;35;31;5;26;.839;3600000;0
9466;176963;82;0;0;0;0;.00nan;0;0
9467;-1;71;0;0;0;0;.00nan;0;0
9467;58054;71;73;45;4;41;.911;3806000;0
9467;58100;69;0;0;0;0;.00nan;0;0
9467;64911;69;61;25;3;22;.880;3806000;0
9468;183737;74;35;33;6;27;.818;3140000;0
9468;-1;74;51;3;0;3;1.000;460000;0
9468;175423;77;61;23;2;21;.913;3600000;0
9468;180873;77;0;0;0;0;.00nan;0;0
9469;176860;2564;84;50;4;46;.920;3595000;0
9469;60773;1095;64;28;3;25;.893;3600000;0
9469;78479;1095;0;0;0;0;.00nan;0;0
9469;85633;2564;0;0;0;0;.00nan;0;0
9470;173874;158;56;31;4;27;.871;3600000;0
9470;170351;149;0;0;0;0;.00nan;0;0
9470;85546;149;69;23;2;21;.913;3600000;0
9470;91398;158;0;0;0;0;.00nan;0;0
9471;163989;4245;0;0;0;0;.00nan;0;0
9471;170612;85;93;46;4;42;.913;3600000;0
9471;-1;4245;74;20;1;19;.950;3600000;0
9471;57998;85;0;0;0;0;.00nan;0;0
9472;189581;76;54;12;1;11;.917;1006000;0
9472;176136;76;30;24;6;18;.750;2594000;0
9472;181341;4620;0;0;0;0;.00nan;0;0
9472;85555;4620;100;26;0;26;1.000;3600000;0
9473;184049;1097;0;0;0;0;.00nan;0;0
9473;173856;75;0;0;0;0;.00nan;0;0
9473;170598;1097;82;33;2;31;.939;3568000;0
9473;171615;75;100;29;0;29;1.000;3600000;0
9474;2495;80;68;33;4;29;.879;3876000;0
9474;-1;151;0;0;0;0;.00nan;0;0
9474;196525;151;80;36;3;33;.917;3876000;0
9474;85009;80;0;0;0;0;.00nan;0;0
9475;171970;81;0;0;0;0;.00nan;0;0
9475;184081;157;0;0;0;0;.00nan;0;0
9475;171730;157;25;20;5;15;.750;3562000;0
9475;176770;81;78;45;4;41;.911;3600000;0
9476;183859;4920;0;0;0;0;.00nan;0;0
9476;170963;4920;55;31;5;26;.839;3591000;0
9476;189944;152;0;0;0;0;.00nan;0;0
9476;78775;152;92;50;3;47;.940;3600000;0
9477;161535;4921;0;0;0;0;.00nan;0;0
9477;184069;73;0;0;0;0;.00nan;0;0
9477;173823;73;34;18;4;14;.778;3600000;0
9477;184398;4921;100;46;1;45;.978;3600000;0
9478;176860;2564;0;0;0;0;.00nan;0;0
9478;57953;72;0;0;0;0;.00nan;0;0
9478;64811;72;65;16;1;15;.938;3600000;0
9478;85633;2564;65;41;4;37;.902;3600000;0
9479;173856;75;0;0;0;0;.00nan;0;0
9479;171615;75;76;35;3;32;.914;3600000;0
9479;175423;77;0;0;0;0;.00nan;0;0
9479;180873;77;87;20;0;20;1.000;3600000;0
9480;184081;157;41;17;3;14;.824;3544000;0
9480;170351;149;81;26;1;25;.962;3600000;0
9480;171730;157;0;0;0;0;.00nan;0;0
9480;85546;149;0;0;0;0;.00nan;0;0
9481;161535;4921;0;0;0;0;.00nan;0;0
9481;184069;73;65;28;2;26;.929;3600000;0
9481;173823;73;0;0;0;0;.00nan;0;0
9481;184398;4921;59;28;3;25;.893;3550000;0
9482;184049;1097;0;0;0;0;.00nan;0;0
9482;169096;67;0;0;0;0;.00nan;0;0
9482;170598;1097;52;16;2;14;.875;3565000;0
9482;182049;67;100;42;1;41;.976;3600000;0
9483;183859;4920;20;21;6;15;.714;3600000;0
9483;-1;151;27;27;6;21;.778;1292000;0
9483;170963;4920;0;0;0;0;.00nan;0;0
9483;196525;151;49;33;4;29;.879;2308000;0
9484;184069;73;69;28;3;25;.893;3809000;0
9484;173823;73;0;0;0;0;.00nan;0;0
9484;57953;72;0;0;0;0;.00nan;0;0
9484;64811;72;92;34;2;32;.941;3809000;0
9485;173856;75;71;25;2;23;.920;3600000;0
9485;171615;75;0;0;0;0;.00nan;0;0
9485;-1;74;0;0;0;0;.00nan;0;0
9485;176060;74;82;42;3;39;.929;3584000;0
9486;181341;4620;59;16;2;14;.875;3900000;0
9486;85555;4620;0;0;0;0;.00nan;0;0
9486;86472;4922;99;45;2;43;.956;3900000;0
9486;161046;4922;0;0;0;0;.00nan;0;0
9487;184081;157;69;22;1;21;.955;3600000;0
9487;170351;149;0;0;0;0;.00nan;0;0
9487;171730;157;0;0;0;0;.00nan;0;0
9487;85546;149;86;36;2;34;.944;3573000;0
9488;173874;158;0;0;0;0;.00nan;0;0
9488;174407;78;100;25;0;25;1.000;3600000;0
9488;179406;78;0;0;0;0;.00nan;0;0
9488;91398;158;63;29;4;25;.862;3600000;0
9489;175423;77;0;0;0;0;.00nan;0;0
9489;180873;77;99;35;1;34;.971;3600000;0
9489;181341;4620;0;0;0;0;.00nan;0;0
9489;85555;4620;60;29;4;25;.862;3600000;0
9490;184049;1097;0;0;0;0;.00nan;0;0
9490;169096;67;0;0;0;0;.00nan;0;0
9490;170598;1097;42;23;4;19;.826;3600000;0
9490;182049;67;79;48;5;43;.896;3586000;0
9491;171970;81;0;0;0;0;.00nan;0;0
9491;189944;152;0;0;0;0;.00nan;0;0
9491;176770;81;23;33;7;26;.788;3600000;0
9491;78775;152;93;33;1;32;.970;3600000;0
9492;161535;4921;0;0;0;0;.00nan;0;0
9492;184398;4921;95;48;2;46;.958;3900000;0
9492;60773;1095;0;0;0;0;.00nan;0;0
9492;78479;1095;70;26;2;24;.923;3900000;0
9493;-1;71;0;0;0;0;.00nan;0;0
9493;57953;72;0;0;0;0;.00nan;0;0
9493;58054;71;74;36;3;33;.917;3579000;0
9493;64811;72;80;28;2;26;.929;3600000;0
9494;166545;1096;0;0;0;0;.00nan;0;0
9494;163784;82;78;31;2;29;.935;3563000;0
9494;183775;1096;92;31;1;30;.968;3600000;0
9494;176963;82;0;0;0;0;.00nan;0;0
9495;183859;4920;65;27;3;24;.889;3570000;0
9495;-1;151;0;0;0;0;.00nan;0;0
9495;170963;4920;0;0;0;0;.00nan;0;0
9495;196525;151;82;32;2;30;.938;3600000;0
9496;163989;4245;43;18;4;14;.778;3600000;0
9496;173874;158;0;0;0;0;.00nan;0;0
9496;-1;4245;0;0;0;0;.00nan;0;0
9496;91398;158;85;53;5;48;.906;3588000;0
9497;173856;75;0;0;0;0;.00nan;0;0
9497;171615;75;77;24;2;22;.917;3600000;0
9497;-1;74;50;9;1;8;.889;677000;0
9497;176060;74;54;46;6;40;.870;2923000;0
9498;170612;85;0;0;0;0;.00nan;0;0
9498;176860;2564;39;33;6;27;.818;2895000;0
9498;57998;85;54;11;1;10;.909;3600000;0
9498;85633;2564;67;11;0;11;1.000;705000;0
9499;175423;77;31;23;5;18;.783;3600000;0
9499;180873;77;0;0;0;0;.00nan;0;0
9499;86472;4922;76;26;2;24;.923;3600000;0
9499;161046;4922;0;0;0;0;.00nan;0;0
9500;184069;73;0;0;0;0;.00nan;0;0
9500;173823;73;78;32;2;30;.938;3579000;0
9500;58100;69;86;31;1;30;.968;3600000;0
9500;64911;69;0;0;0;0;.00nan;0;0
9501;189581;76;42;19;4;15;.789;3560000;0
9501;174407;78;66;24;2;22;.917;3600000;0
9501;179406;78;0;0;0;0;.00nan;0;0
9501;176136;76;0;0;0;0;.00nan;0;0
9502;184049;1097;63;26;3;23;.885;3600000;0
9502;169096;67;59;10;1;9;.900;997000;0
9502;170598;1097;0;0;0;0;.00nan;0;0
9502;182049;67;24;33;7;26;.788;2603000;0
9503;171970;81;0;0;0;0;.00nan;0;0
9503;170351;149;0;0;0;0;.00nan;0;0
9503;176770;81;94;42;1;41;.976;3900000;0
9503;85546;149;81;22;1;21;.955;3900000;0
9504;163784;82;0;0;0;0;.00nan;0;0
9504;175423;77;0;0;0;0;.00nan;0;0
9504;176963;82;84;36;3;33;.917;3600000;0
9504;180873;77;55;27;4;23;.852;3587000;0
9505;-1;71;95;37;1;36;.973;3600000;0
9505;58054;71;0;0;0;0;.00nan;0;0
9505;60773;1095;48;28;4;24;.857;3600000;0
9505;78479;1095;0;0;0;0;.00nan;0;0
9506;166545;1096;74;33;3;30;.909;3600000;0
9506;183775;1096;0;0;0;0;.00nan;0;0
9506;86472;4922;82;38;4;34;.895;3600000;0
9506;161046;4922;0;0;0;0;.00nan;0;0
9507;183859;4920;0;0;0;0;.00nan;0;0
9507;-1;151;0;0;0;0;.00nan;0;0
9507;170963;4920;52;23;4;19;.826;3543000;0
9507;196525;151;77;41;3;38;.927;3600000;0
9508;184069;73;75;29;2;27;.931;3591000;0
9508;173823;73;0;0;0;0;.00nan;0;0
9508;57953;72;96;31;1;30;.968;3600000;0
9508;64811;72;0;0;0;0;.00nan;0;0
9509;-1;74;0;0;0;0;.00nan;0;0
9509;176060;74;68;31;3;28;.903;3568000;0
9509;181341;4620;73;22;1;21;.955;3600000;0
9509;85555;4620;0;0;0;0;.00nan;0;0
9510;163989;4245;0;0;0;0;.00nan;0;0
9510;173874;158;0;0;0;0;.00nan;0;0
9510;-1;4245;64;22;2;20;.909;3600000;0
9510;91398;158;46;33;5;28;.848;3600000;0
9511;170612;85;57;20;2;18;.900;3600000;0
9511;176860;2564;71;38;4;34;.895;3554000;0
9511;57998;85;0;0;0;0;.00nan;0;0
9511;85633;2564;0;0;0;0;.00nan;0;0
9512;161535;4921;0;0;0;0;.00nan;0;0
9512;184398;4921;52;26;4;22;.846;3580000;0
9512;58100;69;0;0;0;0;.00nan;0;0
9512;64911;69;72;29;2;27;.931;3600000;0
9513;184081;157;49;25;4;21;.840;3600000;0
9513;171730;157;0;0;0;0;.00nan;0;0
9513;189944;152;0;0;0;0;.00nan;0;0
9513;78775;152;60;46;6;40;.870;3553000;0
9514;189581;76;0;0;0;0;.00nan;0;0
9514;174407;78;54;39;5;34;.872;3600000;0
9514;179406;78;0;0;0;0;.00nan;0;0
9514;176136;76;76;18;1;17;.944;3600000;0
9515;163784;82;59;38;4;34;.895;3600000;0
9515;173856;75;0;0;0;0;.00nan;0;0
9515;171615;75;73;21;2;19;.905;3600000;0
9515;176963;82;0;0;0;0;.00nan;0;0
9516;-1;71;80;20;0;20;1.000;1321000;0
9516;57953;72;0;0;0;0;.00nan;0;0
9516;58054;71;27;22;6;16;.727;2279000;0
9516;64811;72;81;24;2;22;.917;3600000;0
9517;181341;4620;0;0;0;0;.00nan;0;0
9517;85555;4620;55;11;1;10;.909;3600000;0
9517;86472;4922;0;0;0;0;.00nan;0;0
9517;161046;4922;71;56;6;50;.893;3600000;0
9518;161535;4921;95;51;3;48;.941;3900000;0
9518;184398;4921;0;0;0;0;.00nan;0;0
9518;58100;69;63;28;3;25;.893;3900000;0
9518;64911;69;0;0;0;0;.00nan;0;0
9519;184081;157;64;13;1;12;.923;3600000;0
9519;171730;157;0;0;0;0;.00nan;0;0
9519;189944;152;0;0;0;0;.00nan;0;0
9519;78775;152;95;59;4;55;.932;3600000;0
9520;184069;73;0;0;0;0;.00nan;0;0
9520;173823;73;48;13;2;11;.846;3600000;0
9520;176860;2564;78;39;3;36;.923;3556000;0
9520;85633;2564;0;0;0;0;.00nan;0;0
9521;2495;80;97;27;0;27;1.000;3740000;0
9521;170351;149;93;33;1;32;.970;3740000;0
9521;85009;80;0;0;0;0;.00nan;0;0
9521;85546;149;0;0;0;0;.00nan;0;0
9522;-1;74;0;0;0;0;.00nan;0;0
9522;175423;77;0;0;0;0;.00nan;0;0
9522;176060;74;78;42;3;39;.929;3558000;0
9522;180873;77;60;21;2;19;.905;3600000;0
9523;169096;67;0;0;0;0;.00nan;0;0
9523;170612;85;0;0;0;0;.00nan;0;0
9523;182049;67;71;28;3;25;.893;3600000;0
9523;57998;85;44;26;4;22;.846;3600000;0
9524;184049;1097;0;0;0;0;.00nan;0;0
9524;170598;1097;80;31;2;29;.935;3600000;0
9524;86472;4922;100;33;1;32;.970;3600000;0
9524;161046;4922;0;0;0;0;.00nan;0;0
9525;166545;1096;73;39;3;36;.923;3559000;0
9525;183775;1096;0;0;0;0;.00nan;0;0
9525;60773;1095;0;0;0;0;.00nan;0;0
9525;78479;1095;82;33;2;31;.939;3600000;0
9526;-1;151;0;0;0;0;.00nan;0;0
9526;173874;158;0;0;0;0;.00nan;0;0
9526;196525;151;76;38;3;35;.921;3584000;0
9526;91398;158;80;28;1;27;.964;3600000;0
9527;176860;2564;51;35;6;29;.829;3600000;0
9527;58100;69;53;22;3;19;.864;3600000;0
9527;64911;69;0;0;0;0;.00nan;0;0
9527;85633;2564;0;0;0;0;.00nan;0;0
9528;163989;4245;13;24;7;17;.708;2117000;0
9528;-1;4245;45;6;1;5;.833;1483000;0
9528;181341;4620;54;34;4;30;.882;3600000;0
9528;85555;4620;0;0;0;0;.00nan;0;0
9529;171970;81;0;0;0;0;.00nan;0;0
9529;189944;152;0;0;0;0;.00nan;0;0
9529;176770;81;74;27;1;26;.963;3600000;0
9529;78775;152;87;41;2;39;.951;3587000;0
9530;2495;80;86;41;3;38;.927;3600000;0
9530;170351;149;0;0;0;0;.00nan;0;0
9530;85009;80;0;0;0;0;.00nan;0;0
9530;85546;149;46;26;4;22;.846;3578000;0
9531;184049;1097;0;0;0;0;.00nan;0;0
9531;170598;1097;90;14;0;14;1.000;3600000;0
9531;86472;4922;98;37;1;36;.973;3600000;0
9531;161046;4922;0;0;0;0;.00nan;0;0
9532;184081;157;56;23;3;20;.870;3595000;0
9532;171730;157;0;0;0;0;.00nan;0;0
9532;-1;71;0;0;0;0;.00nan;0;0
9532;58054;71;99;55;2;53;.964;3600000;0
9533;184069;73;56;28;4;24;.857;3558000;0
9533;173823;73;0;0;0;0;.00nan;0;0
9533;57953;72;0;0;0;0;.00nan;0;0
9533;64811;72;72;23;2;21;.913;3600000;0
9534;161535;4921;0;0;0;0;.00nan;0;0
9534;184398;4921;81;28;1;27;.964;3600000;0
9534;170963;2564;0;0;0;0;.00nan;0;0
9534;176860;2564;85;38;2;36;.947;3585000;0
9535;-1;151;0;0;0;0;.00nan;0;0
9535;173874;158;0;0;0;0;.00nan;0;0
9535;196525;151;69;20;1;19;.950;3600000;0
9535;91398;158;98;43;2;41;.953;3600000;0
9536;163989;4245;0;0;0;0;.00nan;0;0
9536;183859;4920;82;34;2;32;.941;3811000;0
9536;-1;4245;92;38;1;37;.974;3811000;0
9536;59592;4920;0;0;0;0;.00nan;0;0
9537;189581;76;0;0;0;0;.00nan;0;0
9537;-1;74;0;0;0;0;.00nan;0;0
9537;176060;74;20;32;7;25;.781;3513000;0
9537;176136;76;57;35;5;30;.857;3600000;0
9538;166545;1096;0;0;0;0;.00nan;0;0
9538;183775;1096;92;39;1;38;.974;3600000;0
9538;173856;75;58;33;4;29;.879;3600000;0
9538;171615;75;0;0;0;0;.00nan;0;0
9539;2495;80;0;0;0;0;.00nan;0;0
9539;170351;149;65;16;1;15;.938;3600000;0
9539;85009;80;58;22;3;19;.864;3568000;0
9539;85546;149;0;0;0;0;.00nan;0;0
9540;170612;85;0;0;0;0;.00nan;0;0
9540;181341;4620;57;12;1;11;.917;3600000;0
9540;57998;85;98;51;2;49;.961;3545000;0
9540;85555;4620;0;0;0;0;.00nan;0;0
9541;163784;82;0;0;0;0;.00nan;0;0
9541;175423;77;0;0;0;0;.00nan;0;0
9541;176963;82;97;36;1;35;.972;3600000;0
9541;180873;77;65;30;2;28;.933;3543000;0
9542;58100;69;84;31;2;29;.935;3600000;0
9542;60773;1095;0;0;0;0;.00nan;0;0
9542;64911;69;0;0;0;0;.00nan;0;0
9542;78479;1095;91;44;3;41;.932;3563000;0
9543;171970;81;0;0;0;0;.00nan;0;0
9543;189944;152;0;0;0;0;.00nan;0;0
9543;176770;81;86;30;2;28;.933;3600000;0
9543;78775;152;61;26;3;23;.885;3543000;0
9544;169096;67;0;0;0;0;.00nan;0;0
9544;174407;78;61;27;3;24;.889;3600000;0
9544;179406;78;0;0;0;0;.00nan;0;0
9544;182049;67;73;44;5;39;.886;3593000;0
9545;58100;69;0;0;0;0;.00nan;0;0
9545;60773;1095;0;0;0;0;.00nan;0;0
9545;64911;69;35;21;4;17;.810;3600000;0
9545;78479;1095;80;36;3;33;.917;3600000;0
9546;184049;1097;0;0;0;0;.00nan;0;0
9546;170598;1097;84;29;1;28;.966;3600000;0
9546;86472;4922;71;42;4;38;.905;3600000;0
9546;161046;4922;0;0;0;0;.00nan;0;0
9547;-1;71;48;36;6;30;.833;3600000;0
9547;57953;72;75;23;1;22;.957;3600000;0
9547;58054;71;0;0;0;0;.00nan;0;0
9547;64811;72;0;0;0;0;.00nan;0;0
9548;161535;4921;0;0;0;0;.00nan;0;0
9548;184398;4921;69;23;2;21;.913;3600000;0
9548;170963;2564;57;18;2;16;.889;1552000;0
9548;176860;2564;55;26;4;22;.846;2048000;0
9549;-1;151;0;0;0;0;.00nan;0;0
9549;173874;158;69;29;3;26;.897;3600000;0
9549;196525;151;50;28;5;23;.821;3545000;0
9549;91398;158;0;0;0;0;.00nan;0;0
9550;163989;4245;97;40;1;39;.975;3556000;0
9550;183859;4920;0;0;0;0;.00nan;0;0
9550;-1;4245;0;0;0;0;.00nan;0;0
9550;59592;4920;88;21;0;21;1.000;3600000;0
9551;189581;76;70;28;3;25;.893;3600000;0
9551;-1;74;56;4;0;4;1.000;299000;0
9551;176060;74;43;37;6;31;.838;3301000;0
9551;176136;76;0;0;0;0;.00nan;0;0
9552;163784;82;77;36;3;33;.917;3600000;0
9552;173856;75;83;17;0;17;1.000;3600000;0
9552;171615;75;0;0;0;0;.00nan;0;0
9552;176963;82;0;0;0;0;.00nan;0;0
9553;2495;80;70;21;1;20;.952;3600000;0
9553;170351;149;0;0;0;0;.00nan;0;0
9553;85009;80;0;0;0;0;.00nan;0;0
9553;85546;149;74;37;3;34;.919;3514000;0
9554;170612;85;35;32;6;26;.813;2847000;0
9554;181341;4620;0;0;0;0;.00nan;0;0
9554;57998;85;54;4;0;4;1.000;753000;0
9554;85555;4620;87;35;2;33;.943;3600000;0
9555;166545;1096;25;20;5;15;.750;3600000;0
9555;183775;1096;0;0;0;0;.00nan;0;0
9555;175423;77;79;27;1;26;.963;3600000;0
9555;180873;77;0;0;0;0;.00nan;0;0
9556;171970;81;0;0;0;0;.00nan;0;0
9556;189944;152;90;40;3;37;.925;3600000;0
9556;176770;81;100;32;0;32;1.000;3600000;0
9556;78775;152;0;0;0;0;.00nan;0;0
9557;184069;73;0;0;0;0;.00nan;0;0
9557;184081;157;76;30;2;28;.933;3560000;0
9557;173823;73;90;36;1;35;.972;3600000;0
9557;171730;157;0;0;0;0;.00nan;0;0
9558;169096;67;64;27;2;25;.926;3600000;0
9558;174407;78;0;0;0;0;.00nan;0;0
9558;179406;78;60;24;3;21;.875;3568000;0
9558;182049;67;0;0;0;0;.00nan;0;0
9559;161535;4921;76;27;1;26;.963;3600000;0
9559;184398;4921;0;0;0;0;.00nan;0;0
9559;-1;71;0;0;0;0;.00nan;0;0
9559;58054;71;52;28;3;25;.893;3528000;0
9560;166545;1096;0;0;0;0;.00nan;0;0
9560;183775;1096;75;25;2;23;.920;3563000;0
9560;175423;77;0;0;0;0;.00nan;0;0
9560;180873;77;92;33;1;32;.970;3600000;0
9561;170963;2564;100;43;2;41;.953;3600000;0
9561;176860;2564;0;0;0;0;.00nan;0;0
9561;60773;1095;54;27;3;24;.889;3545000;0
9561;78479;1095;0;0;0;0;.00nan;0;0
9562;163989;4245;0;0;0;0;.00nan;0;0
9562;183859;4920;75;25;2;23;.920;3600000;0
9562;-1;4245;83;44;3;41;.932;3546000;0
9562;59592;4920;0;0;0;0;.00nan;0;0
9563;163784;82;63;33;4;29;.879;3024000;0
9563;173856;75;100;25;0;25;1.000;3600000;0
9563;171615;75;0;0;0;0;.00nan;0;0
9563;176963;82;34;11;3;8;.727;576000;0
9564;184069;73;22;23;6;17;.739;2891000;0
9564;184081;157;76;22;1;21;.955;3600000;0
9564;173823;73;39;16;3;13;.813;709000;0
9564;171730;157;0;0;0;0;.00nan;0;0
9565;183859;4920;72;25;1;24;.960;3549000;0
9565;169096;67;0;0;0;0;.00nan;0;0
9565;182049;67;100;38;0;38;1.000;3600000;0
9565;59592;4920;0;0;0;0;.00nan;0;0
9566;189944;152;0;0;0;0;.00nan;0;0
9566;60773;1095;0;0;0;0;.00nan;0;0
9566;78479;1095;58;26;3;23;.885;3546000;0
9566;78775;152;77;32;2;30;.938;3600000;0
9567;166545;1096;0;0;0;0;.00nan;0;0
9567;163784;82;76;30;2;28;.933;3600000;0
9567;183775;1096;74;19;1;18;.947;3600000;0
9567;176963;82;0;0;0;0;.00nan;0;0
9568;2495;80;0;0;0;0;.00nan;0;0
9568;-1;151;0;0;0;0;.00nan;0;0
9568;196525;151;27;34;7;27;.794;3600000;0
9568;85009;80;99;37;1;36;.973;3600000;0
9569;171970;81;0;0;0;0;.00nan;0;0
9569;173874;158;0;0;0;0;.00nan;0;0
9569;176770;81;44;31;5;26;.839;3900000;0
9569;91398;158;49;30;5;25;.833;3900000;0
9570;163462;4620;0;0;0;0;.00nan;0;0
9570;189581;76;0;0;0;0;.00nan;0;0
9570;176136;76;73;41;4;37;.902;3587000;0
9570;181341;4620;54;25;3;22;.880;3600000;0
9571;-1;74;0;0;0;0;.00nan;0;0
9571;175423;77;0;0;0;0;.00nan;0;0
9571;176060;74;60;39;4;35;.897;3745000;0
9571;180873;77;48;16;3;13;.813;3745000;0
9572;183859;4920;82;34;2;32;.941;3600000;0
9572;169096;67;54;4;0;4;1.000;507000;0
9572;182049;67;66;36;4;32;.889;3085000;0
9572;59592;4920;0;0;0;0;.00nan;0;0
9573;163784;82;0;0;0;0;.00nan;0;0
9573;-1;74;0;0;0;0;.00nan;0;0
9573;176060;74;63;26;4;22;.846;3893000;0
9573;176963;82;66;33;4;29;.879;3900000;0
9574;170963;2564;0;0;0;0;.00nan;0;0
9574;176860;2564;62;38;5;33;.868;3600000;0
9574;60773;1095;0;0;0;0;.00nan;0;0
9574;78479;1095;83;30;2;28;.933;3600000;0
9575;189944;152;0;0;0;0;.00nan;0;0
9575;-1;71;0;0;0;0;.00nan;0;0
9575;58054;71;51;20;3;17;.850;3600000;0
9575;78775;152;45;45;7;38;.844;3600000;0
9576;2495;80;0;0;0;0;.00nan;0;0
9576;-1;151;78;25;1;24;.960;3600000;0
9576;196525;151;0;0;0;0;.00nan;0;0
9576;85009;80;55;26;3;23;.885;3547000;0
9577;161535;4921;0;0;0;0;.00nan;0;0
9577;184398;4921;83;45;4;41;.911;3600000;0
9577;58100;69;78;24;1;23;.958;3600000;0
9577;64911;69;0;0;0;0;.00nan;0;0
9578;171970;81;0;0;0;0;.00nan;0;0
9578;173874;158;0;0;0;0;.00nan;0;0
9578;176770;81;70;37;3;34;.919;3900000;0
9578;91398;158;81;25;3;22;.880;3900000;0
9579;184049;1097;0;0;0;0;.00nan;0;0
9579;173856;75;46;36;6;30;.833;3900000;0
9579;170598;1097;50;38;6;32;.842;3900000;0
9579;171615;75;0;0;0;0;.00nan;0;0
9580;170612;85;0;0;0;0;.00nan;0;0
9580;174407;78;59;36;4;32;.889;3600000;0
9580;179406;78;0;0;0;0;.00nan;0;0
9580;57998;85;63;14;1;13;.929;3600000;0
9581;166545;1096;0;0;0;0;.00nan;0;0
9581;183775;1096;64;25;2;23;.920;3600000;0
9581;86472;4922;56;32;5;27;.844;3600000;0
9581;161046;4922;0;0;0;0;.00nan;0;0
9582;163462;4620;0;0;0;0;.00nan;0;0
9582;189581;76;0;0;0;0;.00nan;0;0
9582;176136;76;89;35;2;33;.943;3600000;0
9582;181341;4620;72;40;3;37;.925;3600000;0
9583;184069;73;0;0;0;0;.00nan;0;0
9583;173823;73;93;45;3;42;.933;3596000;0
9583;57953;72;0;0;0;0;.00nan;0;0
9583;64811;72;63;21;2;19;.905;3600000;0
9584;169096;67;72;25;1;24;.960;3544000;0
9584;174407;78;0;0;0;0;.00nan;0;0
9584;179406;78;95;22;0;22;1.000;3600000;0
9584;182049;67;0;0;0;0;.00nan;0;0
9585;166545;1096;52;27;4;23;.852;3600000;0
9585;163784;82;100;34;0;34;1.000;3600000;0
9585;183775;1096;0;0;0;0;.00nan;0;0
9585;176963;82;0;0;0;0;.00nan;0;0
9586;184049;1097;44;25;5;20;.800;3546000;0
9586;173856;75;64;31;3;28;.903;3600000;0
9586;170598;1097;0;0;0;0;.00nan;0;0
9586;171615;75;0;0;0;0;.00nan;0;0
9587;189944;152;0;0;0;0;.00nan;0;0
9587;-1;71;0;0;0;0;.00nan;0;0
9587;58054;71;68;24;2;22;.917;3600000;0
9587;78775;152;97;50;3;47;.940;3577000;0
9588;2495;80;41;28;5;23;.821;3600000;0
9588;-1;151;0;0;0;0;.00nan;0;0
9588;196525;151;90;39;2;37;.949;3600000;0
9588;85009;80;0;0;0;0;.00nan;0;0
9589;170963;2564;0;0;0;0;.00nan;0;0
9589;176860;2564;99;39;2;37;.949;3600000;0
9589;57953;72;72;26;3;23;.885;3573000;0
9589;64811;72;0;0;0;0;.00nan;0;0
9590;161535;4921;86;48;3;45;.938;3551000;0
9590;184398;4921;0;0;0;0;.00nan;0;0
9590;58100;69;0;0;0;0;.00nan;0;0
9590;64911;69;85;27;1;26;.963;3600000;0
9591;-1;74;0;0;0;0;.00nan;0;0
9591;175423;77;0;0;0;0;.00nan;0;0
9591;176060;74;99;47;1;46;.979;3600000;0
9591;180873;77;49;15;2;13;.867;3541000;0
9592;171970;81;50;39;5;34;.872;3600000;0
9592;173874;158;81;40;4;36;.900;3600000;0
9592;176770;81;0;0;0;0;.00nan;0;0
9592;91398;158;0;0;0;0;.00nan;0;0
9593;163989;4245;89;29;1;28;.966;3600000;0
9593;183859;4920;0;0;0;0;.00nan;0;0
9593;-1;4245;0;0;0;0;.00nan;0;0
9593;59592;4920;67;25;2;23;.920;3560000;0
9594;163462;4620;86;30;1;29;.967;3600000;0
9594;189581;76;0;0;0;0;.00nan;0;0
9594;176136;76;98;47;3;44;.936;3589000;0
9594;181341;4620;0;0;0;0;.00nan;0;0
9595;184069;73;75;35;3;32;.914;3600000;0
9595;173823;73;0;0;0;0;.00nan;0;0
9595;60773;1095;33;35;7;28;.800;3600000;0
9595;78479;1095;0;0;0;0;.00nan;0;0
9596;189944;152;0;0;0;0;.00nan;0;0
9596;-1;71;57;24;3;21;.875;3573000;0
9596;58054;71;0;0;0;0;.00nan;0;0
9596;78775;152;90;33;2;31;.939;3600000;0
9597;161535;4921;0;0;0;0;.00nan;0;0
9597;184398;4921;83;42;4;38;.905;3600000;0
9597;58100;69;100;27;0;27;1.000;3600000;0
9597;64911;69;0;0;0;0;.00nan;0;0
9598;163989;4245;0;0;0;0;.00nan;0;0
9598;169096;67;0;0;0;0;.00nan;0;0
9598;-1;4245;81;28;1;27;.964;3600000;0
9598;182049;67;91;37;2;35;.946;3580000;0
9599;166545;1096;0;0;0;0;.00nan;0;0
9599;183775;1096;80;45;4;41;.911;3638000;0
9599;175423;77;43;29;5;24;.828;3638000;0
9599;180873;77;0;0;0;0;.00nan;0;0
9600;184081;157;60;24;3;21;.875;3600000;0
9600;170351;149;59;33;4;29;.879;3551000;0
9600;171730;157;0;0;0;0;.00nan;0;0
9600;85546;149;0;0;0;0;.00nan;0;0
9601;171970;81;0;0;0;0;.00nan;0;0
9601;176770;81;73;33;2;31;.939;3600000;0
9601;85009;80;0;0;0;0;.00nan;0;0
9601;85228;80;38;35;7;28;.800;3600000;0
9602;166545;1096;0;0;0;0;.00nan;0;0
9602;163784;82;67;20;1;19;.950;3600000;0
9602;183775;1096;68;33;3;30;.909;3561000;0
9602;176963;82;0;0;0;0;.00nan;0;0
9603;184049;1097;0;0;0;0;.00nan;0;0
9603;170598;1097;89;31;1;30;.968;3600000;0
9603;-1;74;0;0;0;0;.00nan;0;0
9603;176060;74;46;35;6;29;.829;3600000;0
9604;184081;157;47;17;3;14;.824;3600000;0
9604;173874;158;0;0;0;0;.00nan;0;0
9604;171730;157;0;0;0;0;.00nan;0;0
9604;91398;158;62;42;5;37;.881;3584000;0
9605;189581;76;0;0;0;0;.00nan;0;0
9605;170612;85;0;0;0;0;.00nan;0;0
9605;176136;76;58;39;4;35;.897;3746000;0
9605;148573;85;57;37;5;32;.865;3746000;0
9606;163462;4620;0;0;0;0;.00nan;0;0
9606;169096;67;0;0;0;0;.00nan;0;0
9606;181341;4620;71;24;2;22;.917;3536000;0
9606;182049;67;91;39;1;38;.974;3600000;0
9607;161535;4921;61;34;4;30;.882;3552000;0
9607;184398;4921;0;0;0;0;.00nan;0;0
9607;-1;71;0;0;0;0;.00nan;0;0
9607;58054;71;50;21;3;18;.857;3600000;0
9608;173856;75;60;30;3;27;.900;3600000;0
9608;171615;75;0;0;0;0;.00nan;0;0
9608;175423;77;0;0;0;0;.00nan;0;0
9608;180873;77;100;27;0;27;1.000;3600000;0
9609;163989;4245;49;17;2;15;.882;3600000;0
9609;169096;67;0;0;0;0;.00nan;0;0
9609;-1;4245;0;0;0;0;.00nan;0;0
9609;182049;67;81;48;5;43;.896;3600000;0
9610;171970;81;91;31;1;30;.968;3600000;0
9610;176770;81;0;0;0;0;.00nan;0;0
9610;85009;80;0;0;0;0;.00nan;0;0
9610;85228;80;52;16;2;14;.875;3545000;0
9611;184069;73;95;31;2;29;.935;3569000;0
9611;173823;73;0;0;0;0;.00nan;0;0
9611;60773;1095;0;0;0;0;.00nan;0;0
9611;78479;1095;76;26;1;25;.962;3600000;0
9612;166545;1096;0;0;0;0;.00nan;0;0
9612;183775;1096;81;30;1;29;.967;3600000;0
9612;173856;75;0;0;0;0;.00nan;0;0
9612;171615;75;100;31;0;31;1.000;3600000;0
9613;-1;151;0;0;0;0;.00nan;0;0
9613;189944;152;0;0;0;0;.00nan;0;0
9613;196525;151;36;36;6;30;.833;3600000;0
9613;78775;152;89;36;3;33;.917;3600000;0
9614;161535;4921;0;0;0;0;.00nan;0;0
9614;184398;4921;79;32;3;29;.906;3600000;0
9614;-1;71;36;21;4;17;.810;3552000;0
9614;58054;71;0;0;0;0;.00nan;0;0
9615;4487;4922;0;0;0;0;.00nan;0;0
9615;-1;74;69;26;2;24;.923;3600000;0
9615;176060;74;0;0;0;0;.00nan;0;0
9615;86472;4922;36;26;5;21;.808;3600000;0
9616;170963;2564;0;0;0;0;.00nan;0;0
9616;176860;2564;62;39;5;34;.872;3600000;0
9616;57953;72;0;0;0;0;.00nan;0;0
9616;64811;72;56;18;2;16;.889;3600000;0
9617;189581;76;43;35;6;29;.829;3600000;0
9617;170612;85;0;0;0;0;.00nan;0;0
9617;176136;76;0;0;0;0;.00nan;0;0
9617;148573;85;100;25;0;25;1.000;3600000;0
9618;184049;1097;0;0;0;0;.00nan;0;0
9618;170598;1097;58;28;3;25;.893;3600000;0
9618;175423;77;0;0;0;0;.00nan;0;0
9618;180873;77;68;26;2;24;.923;3600000;0
9619;184081;157;83;23;1;22;.957;3600000;0
9619;173874;158;54;3;0;3;1.000;360000;0
9619;171730;157;0;0;0;0;.00nan;0;0
9619;91398;158;47;43;7;36;.837;3240000;0
9620;163462;4620;0;0;0;0;.00nan;0;0
9620;174407;78;93;43;2;41;.953;3600000;0
9620;179406;78;0;0;0;0;.00nan;0;0
9620;181341;4620;65;31;3;28;.903;3557000;0
9621;163462;4620;100;29;0;29;1.000;3600000;0
9621;169096;67;65;39;4;35;.897;3600000;0
9621;181341;4620;0;0;0;0;.00nan;0;0
9621;182049;67;0;0;0;0;.00nan;0;0
9622;171970;81;0;0;0;0;.00nan;0;0
9622;176770;81;68;35;4;31;.886;3600000;0
9622;85009;80;0;0;0;0;.00nan;0;0
9622;85228;80;67;22;2;20;.909;3600000;0
9623;163784;82;0;0;0;0;.00nan;0;0
9623;173856;75;0;0;0;0;.00nan;0;0
9623;171615;75;76;31;2;29;.935;3737000;0
9623;176963;82;76;32;3;29;.906;3737000;0
9624;166545;1096;85;36;2;34;.944;3577000;0
9624;183775;1096;0;0;0;0;.00nan;0;0
9624;175423;77;72;19;1;18;.947;3600000;0
9624;180873;77;0;0;0;0;.00nan;0;0
9625;161535;4921;75;40;3;37;.925;3600000;0
9625;184398;4921;0;0;0;0;.00nan;0;0
9625;-1;71;36;7;2;5;.714;1090000;0
9625;58054;71;10;25;7;18;.720;2510000;0
9626;170963;2564;81;48;4;44;.917;3600000;0
9626;176860;2564;0;0;0;0;.00nan;0;0
9626;57953;72;65;25;3;22;.880;3600000;0
9626;64811;72;0;0;0;0;.00nan;0;0
9627;189581;76;47;9;1;8;.889;704000;0
9627;170612;85;0;0;0;0;.00nan;0;0
9627;176136;76;45;40;6;34;.850;2896000;0
9627;148573;85;48;22;3;19;.864;3600000;0
9628;4487;4922;84;27;1;26;.963;3600000;0
9628;184049;1097;0;0;0;0;.00nan;0;0
9628;170598;1097;25;25;6;19;.760;3600000;0
9628;86472;4922;0;0;0;0;.00nan;0;0
9629;58100;69;80;30;2;28;.933;3600000;0
9629;60773;1095;0;0;0;0;.00nan;0;0
9629;64911;69;0;0;0;0;.00nan;0;0
9629;78479;1095;76;36;3;33;.917;3580000;0
9630;-1;151;69;31;3;28;.903;3555000;0
9630;189944;152;0;0;0;0;.00nan;0;0
9630;196525;151;0;0;0;0;.00nan;0;0
9630;78775;152;86;33;2;31;.939;3600000;0
9631;184081;157;64;29;3;26;.897;3600000;0
9631;170351;149;0;0;0;0;.00nan;0;0
9631;171730;157;0;0;0;0;.00nan;0;0
9631;85546;149;48;20;4;16;.800;3575000;0
9632;163989;4245;0;0;0;0;.00nan;0;0
9632;-1;4245;52;17;2;15;.882;3546000;0
9632;174407;78;0;0;0;0;.00nan;0;0
9632;179406;78;100;45;0;45;1.000;3600000;0
9633;184069;73;0;0;0;0;.00nan;0;0
9633;173823;73;75;36;3;33;.917;3572000;0
9633;57953;72;0;0;0;0;.00nan;0;0
9633;64811;72;74;28;2;26;.929;3600000;0
9634;170963;2564;0;0;0;0;.00nan;0;0
9634;176860;2564;68;44;5;39;.886;3587000;0
9634;-1;71;0;0;0;0;.00nan;0;0
9634;58054;71;60;22;3;19;.864;3600000;0
9635;58100;69;61;31;4;27;.871;3600000;0
9635;60773;1095;48;0;0;0;.00nan;265000;0
9635;64911;69;0;0;0;0;.00nan;0;0
9635;78479;1095;53;41;6;35;.854;3306000;0
9636;163462;4620;29;12;4;8;.667;1079000;0
9636;183859;4920;98;18;0;18;1.000;3600000;0
9636;181341;4620;62;16;1;15;.938;2521000;0
9636;59592;4920;0;0;0;0;.00nan;0;0
9637;163989;4245;36;28;5;23;.821;3516000;0
9637;-1;4245;0;0;0;0;.00nan;0;0
9637;174407;78;82;36;3;33;.917;3600000;0
9637;179406;78;0;0;0;0;.00nan;0;0
9638;-1;74;0;0;0;0;.00nan;0;0
9638;176060;74;59;44;5;39;.886;3600000;0
9638;60773;1095;0;0;0;0;.00nan;0;0
9638;78479;1095;85;30;2;28;.933;3600000;0
9639;166545;1096;0;0;0;0;.00nan;0;0
9639;183775;1096;83;27;2;25;.926;3900000;0
9639;184049;1097;93;34;2;32;.941;3900000;0
9639;170598;1097;0;0;0;0;.00nan;0;0
9640;4487;4922;87;47;4;43;.915;3600000;0
9640;173856;75;0;0;0;0;.00nan;0;0
9640;171615;75;45;18;3;15;.833;3600000;0
9640;86472;4922;0;0;0;0;.00nan;0;0
9641;171970;81;45;26;4;22;.846;3867000;0
9641;-1;151;0;0;0;0;.00nan;0;0
9641;176770;81;0;0;0;0;.00nan;0;0
9641;196525;151;55;31;5;26;.839;3867000;0
9642;163784;82;53;30;4;26;.867;3537000;0
9642;175423;77;0;0;0;0;.00nan;0;0
9642;176963;82;0;0;0;0;.00nan;0;0
9642;180873;77;56;15;2;13;.867;3600000;0
9643;166545;1096;82;49;4;45;.918;3649000;0
9643;183775;1096;0;0;0;0;.00nan;0;0
9643;184049;1097;0;0;0;0;.00nan;0;0
9643;170598;1097;67;45;5;40;.889;3649000;0
9644;189581;76;0;0;0;0;.00nan;0;0
9644;176136;76;74;47;4;43;.915;3584000;0
9644;-1;71;0;0;0;0;.00nan;0;0
9644;58054;71;76;29;2;27;.931;3600000;0
9645;-1;74;0;0;0;0;.00nan;0;0
9645;176060;74;100;72;4;68;.944;3900000;0
9645;57953;72;0;0;0;0;.00nan;0;0
9645;64811;72;61;27;4;23;.852;3900000;0
9646;170963;2564;0;0;0;0;.00nan;0;0
9646;176860;2564;70;36;4;32;.889;3850000;0
9646;58100;69;67;28;3;25;.893;3850000;0
9646;64911;69;0;0;0;0;.00nan;0;0
9647;163989;4245;0;0;0;0;.00nan;0;0
9647;169096;67;0;0;0;0;.00nan;0;0
9647;-1;4245;78;21;1;20;.952;3600000;0
9647;182049;67;85;35;2;33;.943;3548000;0
9648;4487;4922;78;42;3;39;.929;3527000;0
9648;173856;75;77;26;1;25;.962;3600000;0
9648;171615;75;0;0;0;0;.00nan;0;0
9648;86472;4922;0;0;0;0;.00nan;0;0
9649;161535;4921;0;0;0;0;.00nan;0;0
9649;184398;4921;66;48;5;43;.896;3600000;0
9649;85009;80;0;0;0;0;.00nan;0;0
9649;85228;80;84;29;1;28;.966;3600000;0
9650;170612;85;0;0;0;0;.00nan;0;0
9650;174407;78;89;40;2;38;.950;3579000;0
9650;179406;78;0;0;0;0;.00nan;0;0
9650;148573;85;100;29;0;29;1.000;3600000;0
9651;163462;4620;0;0;0;0;.00nan;0;0
9651;183859;4920;71;25;1;24;.960;3600000;0
9651;181341;4620;74;36;3;33;.917;3588000;0
9651;59592;4920;0;0;0;0;.00nan;0;0
9652;184081;157;57;32;4;28;.875;3546000;0
9652;171730;157;0;0;0;0;.00nan;0;0
9652;189944;152;0;0;0;0;.00nan;0;0
9652;78775;152;73;31;3;28;.903;3600000;0
9653;173874;158;0;0;0;0;.00nan;0;0
9653;170351;149;45;28;4;24;.857;3600000;0
9653;85546;149;0;0;0;0;.00nan;0;0
9653;91398;158;58;40;5;35;.875;3546000;0
9654;183859;4920;0;0;0;0;.00nan;0;0
9654;169096;67;93;40;2;38;.950;3559000;0
9654;182049;67;0;0;0;0;.00nan;0;0
9654;59592;4920;71;16;1;15;.938;3600000;0
9655;171970;81;0;0;0;0;.00nan;0;0
9655;-1;151;48;35;5;30;.857;3600000;0
9655;176770;81;79;31;2;29;.935;3600000;0
9655;196525;151;0;0;0;0;.00nan;0;0
9656;163784;82;0;0;0;0;.00nan;0;0
9656;175423;77;49;28;4;24;.857;3600000;0
9656;176963;82;75;38;3;35;.921;3600000;0
9656;180873;77;0;0;0;0;.00nan;0;0
9657;-1;71;0;0;0;0;.00nan;0;0
9657;57953;72;55;19;2;17;.895;3600000;0
9657;58054;71;84;36;3;33;.917;3549000;0
9657;64811;72;0;0;0;0;.00nan;0;0
9658;163462;4620;67;41;4;37;.902;3600000;0
9658;163989;4245;60;19;2;17;.895;3600000;0
9658;-1;4245;0;0;0;0;.00nan;0;0
9658;181341;4620;0;0;0;0;.00nan;0;0
9659;161535;4921;99;49;2;47;.959;3600000;0
9659;184398;4921;0;0;0;0;.00nan;0;0
9659;85009;80;0;0;0;0;.00nan;0;0
9659;85228;80;58;28;3;25;.893;3600000;0
9660;170612;85;0;0;0;0;.00nan;0;0
9660;174407;78;0;0;0;0;.00nan;0;0
9660;179406;78;93;48;3;45;.938;3598000;0
9660;148573;85;61;19;2;17;.895;3600000;0
9661;4487;4922;67;21;2;19;.905;3560000;0
9661;173856;75;0;0;0;0;.00nan;0;0
9661;171615;75;96;25;0;25;1.000;3600000;0
9661;86472;4922;0;0;0;0;.00nan;0;0
9662;58100;69;57;32;4;28;.875;3709000;0
9662;60773;1095;0;0;0;0;.00nan;0;0
9662;64911;69;0;0;0;0;.00nan;0;0
9662;78479;1095;79;38;3;35;.921;3709000;0
9663;184081;157;86;20;0;20;1.000;3600000;0
9663;171730;157;0;0;0;0;.00nan;0;0
9663;189944;152;82;39;3;36;.923;3600000;0
9663;78775;152;0;0;0;0;.00nan;0;0
9664;184069;73;0;0;0;0;.00nan;0;0
9664;173823;73;76;19;1;18;.947;3600000;0
9664;189581;76;0;0;0;0;.00nan;0;0
9664;176136;76;50;39;5;34;.872;3600000;0
9665;173874;158;44;45;7;38;.844;3600000;0
9665;170351;149;0;0;0;0;.00nan;0;0
9665;85546;149;68;25;2;23;.920;3600000;0
9665;91398;158;0;0;0;0;.00nan;0;0
9666;183859;4920;64;17;1;16;.941;3900000;0
9666;169096;67;0;0;0;0;.00nan;0;0
9666;182049;67;100;52;1;51;.981;3900000;0
9666;59592;4920;0;0;0;0;.00nan;0;0
9667;171970;81;80;31;2;29;.935;3600000;0
9667;-1;151;0;0;0;0;.00nan;0;0
9667;176770;81;0;0;0;0;.00nan;0;0
9667;196525;151;73;33;3;30;.909;3573000;0
9668;-1;74;0;0;0;0;.00nan;0;0
9668;176060;74;59;26;3;23;.885;3591000;0
9668;60773;1095;68;21;2;19;.905;3600000;0
9668;78479;1095;0;0;0;0;.00nan;0;0
9669;-1;71;73;35;3;32;.914;3600000;0
9669;58054;71;0;0;0;0;.00nan;0;0
9669;58100;69;78;32;2;30;.938;3600000;0
9669;64911;69;0;0;0;0;.00nan;0;0
9670;166545;1096;0;0;0;0;.00nan;0;0
9670;183775;1096;100;45;0;45;1.000;3600000;0
9670;184049;1097;0;0;0;0;.00nan;0;0
9670;170598;1097;74;22;1;21;.955;3548000;0
9671;170963;2564;0;0;0;0;.00nan;0;0
9671;176860;2564;34;33;6;27;.818;3600000;0
9671;57953;72;0;0;0;0;.00nan;0;0
9671;64811;72;73;26;2;24;.923;3600000;0
9672;173874;158;0;0;0;0;.00nan;0;0
9672;170351;149;88;34;1;33;.971;3600000;0
9672;85546;149;0;0;0;0;.00nan;0;0
9672;91398;158;39;24;5;19;.792;3600000;0
9673;161535;4921;0;0;0;0;.00nan;0;0
9673;184398;4921;71;30;2;28;.933;3723000;0
9673;85009;80;0;0;0;0;.00nan;0;0
9673;85228;80;69;28;3;25;.893;3723000;0
9674;170612;85;0;0;0;0;.00nan;0;0
9674;174407;78;66;44;5;39;.886;3600000;0
9674;179406;78;0;0;0;0;.00nan;0;0
9674;148573;85;67;15;1;14;.933;3600000;0
9675;163784;82;70;40;4;36;.900;3555000;0
9675;175423;77;0;0;0;0;.00nan;0;0
9675;176963;82;0;0;0;0;.00nan;0;0
9675;180873;77;84;39;2;37;.949;3600000;0
9676;184081;157;82;28;1;27;.964;3600000;0
9676;171730;157;0;0;0;0;.00nan;0;0
9676;189944;152;0;0;0;0;.00nan;0;0
9676;78775;152;64;41;4;37;.902;3600000;0
9677;184069;73;100;26;0;26;1.000;3600000;0
9677;173823;73;0;0;0;0;.00nan;0;0
9677;189581;76;70;13;0;13;1.000;1116000;0
9677;176136;76;34;34;6;28;.824;2484000;0
9678;171970;81;54;7;1;6;.857;655000;0
9678;184081;157;90;19;0;19;1.000;3600000;0
9678;171730;157;0;0;0;0;.00nan;0;0
9678;176770;81;58;43;6;37;.860;2945000;0
9679;163784;82;91;42;3;39;.929;3721000;0
9679;184049;1097;0;0;0;0;.00nan;0;0
9679;170598;1097;92;30;2;28;.933;3721000;0
9679;176963;82;0;0;0;0;.00nan;0;0
9680;-1;151;0;0;0;0;.00nan;0;0
9680;170612;85;0;0;0;0;.00nan;0;0
9680;196525;151;55;38;4;34;.895;3557000;0
9680;148573;85;72;31;3;28;.903;3600000;0
9681;173856;75;0;0;0;0;.00nan;0;0
9681;171615;75;68;35;3;32;.914;3551000;0
9681;-1;74;75;17;1;16;.941;3600000;0
9681;176060;74;0;0;0;0;.00nan;0;0
9682;170963;2564;0;0;0;0;.00nan;0;0
9682;176860;2564;70;32;3;29;.906;3517000;0
9682;-1;71;0;0;0;0;.00nan;0;0
9682;58054;71;78;24;1;23;.958;3600000;0
9683;163462;4620;0;0;0;0;.00nan;0;0
9683;169096;67;0;0;0;0;.00nan;0;0
9683;181341;4620;61;36;4;32;.889;3900000;0
9683;182049;67;55;28;4;24;.857;3900000;0
9684;163989;4245;78;23;1;22;.957;3600000;0
9684;169096;67;77;43;4;39;.907;3600000;0
9684;-1;4245;0;0;0;0;.00nan;0;0
9684;182049;67;0;0;0;0;.00nan;0;0
9685;163784;82;44;40;6;34;.850;3174000;0
9685;184049;1097;97;25;0;25;1.000;3600000;0
9685;170598;1097;0;0;0;0;.00nan;0;0
9685;176963;82;48;0;0;0;.00nan;426000;0
9686;166545;1096;0;0;0;0;.00nan;0;0
9686;4487;4922;83;34;2;32;.941;3581000;0
9686;183775;1096;61;16;1;15;.938;3600000;0
9686;86472;4922;0;0;0;0;.00nan;0;0
9687;-1;151;91;40;2;38;.950;3600000;0
9687;170612;85;0;0;0;0;.00nan;0;0
9687;196525;151;0;0;0;0;.00nan;0;0
9687;148573;85;70;22;1;21;.955;3600000;0
9688;-1;74;0;0;0;0;.00nan;0;0
9688;175423;77;0;0;0;0;.00nan;0;0
9688;176060;74;55;34;4;30;.882;3600000;0
9688;180873;77;89;31;1;30;.968;3600000;0
9689;170963;2564;98;50;2;48;.960;3549000;0
9689;176860;2564;0;0;0;0;.00nan;0;0
9689;60773;1095;0;0;0;0;.00nan;0;0
9689;78479;1095;75;22;1;21;.955;3600000;0
9690;183859;4920;87;39;2;37;.949;3732000;0
9690;189944;152;0;0;0;0;.00nan;0;0
9690;59592;4920;0;0;0;0;.00nan;0;0
9690;78775;152;80;29;1;28;.966;3732000;0
9691;189581;76;0;0;0;0;.00nan;0;0
9691;176136;76;50;40;5;35;.875;3600000;0
9691;57953;72;0;0;0;0;.00nan;0;0
9691;64811;72;89;31;1;30;.968;3600000;0
9692;184069;73;69;25;2;23;.920;3900000;0
9692;173823;73;0;0;0;0;.00nan;0;0
9692;173856;75;0;0;0;0;.00nan;0;0
9692;171615;75;95;52;2;50;.962;3900000;0
9693;-1;71;0;0;0;0;.00nan;0;0
9693;58054;71;79;26;1;25;.962;3545000;0
9693;58100;69;94;18;0;18;1.000;3600000;0
9693;64911;69;0;0;0;0;.00nan;0;0
9694;184081;157;65;27;3;24;.889;3600000;0
9694;171730;157;0;0;0;0;.00nan;0;0
9694;85009;80;69;7;0;7;1.000;771000;0
9694;85228;80;31;30;7;23;.767;2829000;0
9695;171970;81;65;48;5;43;.896;3600000;0
9695;170351;149;0;0;0;0;.00nan;0;0
9695;176770;81;0;0;0;0;.00nan;0;0
9695;85546;149;81;6;0;6;1.000;3600000;0
9696;163462;4620;80;30;1;29;.967;3600000;0
9696;174407;78;26;7;3;4;.571;488000;0
9696;179406;78;77;24;1;23;.958;3112000;0
9696;181341;4620;0;0;0;0;.00nan;0;0
9697;58100;69;26;11;4;7;.636;475000;0
9697;60773;1095;57;17;2;15;.882;1310000;0
9697;64911;69;79;27;1;26;.963;3125000;0
9697;78479;1095;55;28;4;24;.857;2290000;0
9698;161535;4921;0;0;0;0;.00nan;0;0
9698;184398;4921;73;37;4;33;.892;3600000;0
9698;-1;71;93;47;3;44;.936;3600000;0
9698;58054;71;0;0;0;0;.00nan;0;0
9699;166545;1096;82;33;2;31;.939;3600000;0
9699;183775;1096;0;0;0;0;.00nan;0;0
9699;184049;1097;55;27;4;23;.852;3582000;0
9699;170598;1097;0;0;0;0;.00nan;0;0
9700;-1;151;0;0;0;0;.00nan;0;0
9700;170612;85;0;0;0;0;.00nan;0;0
9700;196525;151;100;46;0;46;1.000;3600000;0
9700;148573;85;64;27;3;24;.889;3600000;0
9701;163989;4245;0;0;0;0;.00nan;0;0
9701;169096;67;0;0;0;0;.00nan;0;0
9701;-1;4245;73;22;1;21;.955;3600000;0
9701;182049;67;44;44;7;37;.841;3600000;0
9702;183859;4920;0;0;0;0;.00nan;0;0
9702;189944;152;18;10;4;6;.600;816000;0
9702;59592;4920;57;29;3;26;.897;3600000;0
9702;78775;152;49;26;4;22;.846;2784000;0
9703;189581;76;46;28;3;25;.893;3900000;0
9703;176136;76;0;0;0;0;.00nan;0;0
9703;57953;72;76;27;3;24;.889;3900000;0
9703;64811;72;0;0;0;0;.00nan;0;0
9704;184069;73;0;0;0;0;.00nan;0;0
9704;173823;73;45;23;4;19;.826;3684000;0
9704;173856;75;65;37;5;32;.865;3684000;0
9704;171615;75;0;0;0;0;.00nan;0;0
9705;-1;74;74;33;2;31;.939;3600000;0
9705;175423;77;67;21;1;20;.952;3600000;0
9705;176060;74;0;0;0;0;.00nan;0;0
9705;180873;77;0;0;0;0;.00nan;0;0
9706;4487;4922;85;40;2;38;.950;3557000;0
9706;163784;82;0;0;0;0;.00nan;0;0
9706;176963;82;100;23;0;23;1.000;3600000;0
9706;86472;4922;0;0;0;0;.00nan;0;0
9707;184081;157;45;32;5;27;.844;3600000;0
9707;171730;157;0;0;0;0;.00nan;0;0
9707;85009;80;0;0;0;0;.00nan;0;0
9707;85228;80;53;39;6;33;.846;3600000;0
9708;171970;81;0;0;0;0;.00nan;0;0
9708;170351;149;0;0;0;0;.00nan;0;0
9708;176770;81;74;31;3;28;.903;3568000;0
9708;85546;149;60;17;1;16;.941;3600000;0
9709;163462;4620;0;0;0;0;.00nan;0;0
9709;174407;78;83;33;3;30;.909;3760000;0
9709;179406;78;0;0;0;0;.00nan;0;0
9709;181341;4620;83;29;2;27;.931;3760000;0
9710;163462;4620;61;21;2;19;.905;3600000;0
9710;169096;67;77;53;5;48;.906;3600000;0
9710;181341;4620;0;0;0;0;.00nan;0;0
9710;182049;67;0;0;0;0;.00nan;0;0
9711;163784;82;0;0;0;0;.00nan;0;0
9711;-1;74;0;0;0;0;.00nan;0;0
9711;176060;74;67;33;3;30;.909;3600000;0
9711;176963;82;41;34;6;28;.824;3600000;0
9712;161535;4921;35;37;7;30;.811;3600000;0
9712;184398;4921;0;0;0;0;.00nan;0;0
9712;-1;71;0;0;0;0;.00nan;0;0
9712;58054;71;67;37;4;33;.892;3600000;0
9713;163989;4245;52;21;2;19;.905;3600000;0
9713;-1;4245;0;0;0;0;.00nan;0;0
9713;174407;78;79;35;2;33;.943;3113000;0
9713;179406;78;39;14;3;11;.786;487000;0
9714;183859;4920;71;20;1;19;.950;3600000;0
9714;189944;152;44;4;1;3;.750;740000;0
9714;59592;4920;0;0;0;0;.00nan;0;0
9714;78775;152;48;36;6;30;.833;2860000;0
9715;189581;76;0;0;0;0;.00nan;0;0
9715;176136;76;78;26;1;25;.962;3900000;0
9715;57953;72;0;0;0;0;.00nan;0;0
9715;64811;72;88;31;1;30;.968;3900000;0
9716;184069;73;86;24;1;23;.958;3600000;0
9716;173823;73;0;0;0;0;.00nan;0;0
9716;173856;75;0;0;0;0;.00nan;0;0
9716;171615;75;83;35;2;33;.943;3570000;0
9717;166545;1096;0;0;0;0;.00nan;0;0
9717;4487;4922;83;29;2;27;.931;3900000;0
9717;183775;1096;88;37;2;35;.946;3900000;0
9717;86472;4922;0;0;0;0;.00nan;0;0
9718;58100;69;85;33;2;31;.939;3600000;0
9718;60773;1095;0;0;0;0;.00nan;0;0
9718;64911;69;0;0;0;0;.00nan;0;0
9718;78479;1095;100;35;1;34;.971;3600000;0
9719;184081;157;93;24;1;23;.958;3600000;0
9719;171730;157;0;0;0;0;.00nan;0;0
9719;85009;80;0;0;0;0;.00nan;0;0
9719;85228;80;65;32;3;29;.906;3516000;0
9720;171970;81;45;43;6;37;.860;2501000;0
9720;170351;149;82;13;0;13;1.000;3600000;0
9720;176770;81;59;14;1;13;.929;1099000;0
9720;85546;149;0;0;0;0;.00nan;0;0
9721;171970;81;61;31;4;27;.871;3600000;0
9721;189944;152;0;0;0;0;.00nan;0;0
9721;176770;81;0;0;0;0;.00nan;0;0
9721;78775;152;65;22;2;20;.909;3600000;0
9722;184049;1097;34;25;5;20;.800;3599000;0
9722;170598;1097;0;0;0;0;.00nan;0;0
9722;175423;77;0;0;0;0;.00nan;0;0
9722;180873;77;56;33;4;29;.879;3600000;0
9723;166545;1096;0;0;0;0;.00nan;0;0
9723;183775;1096;76;40;4;36;.900;3600000;0
9723;173856;75;0;0;0;0;.00nan;0;0
9723;171615;75;84;24;1;23;.958;3600000;0
9724;-1;151;39;11;3;8;.727;1207000;0
9724;173874;158;0;0;0;0;.00nan;0;0
9724;196525;151;36;26;5;21;.808;2393000;0
9724;91398;158;70;41;5;36;.878;3600000;0
9725;57953;72;0;0;0;0;.00nan;0;0
9725;58100;69;55;38;5;33;.868;3525000;0
9725;64811;72;64;29;3;26;.897;3600000;0
9725;64911;69;0;0;0;0;.00nan;0;0
9726;163462;4620;69;30;3;27;.900;3600000;0
9726;163989;4245;0;0;0;0;.00nan;0;0
9726;-1;4245;70;29;2;27;.931;3600000;0
9726;181341;4620;0;0;0;0;.00nan;0;0
9727;-1;71;0;0;0;0;.00nan;0;0
9727;58054;71;76;33;3;30;.909;3566000;0
9727;85009;80;0;0;0;0;.00nan;0;0
9727;85228;80;71;28;2;26;.929;3600000;0
9728;183859;4920;59;23;3;20;.870;3600000;0
9728;169096;67;0;0;0;0;.00nan;0;0
9728;182049;67;72;43;4;39;.907;3600000;0
9728;59592;4920;0;0;0;0;.00nan;0;0
9729;171970;81;100;32;0;32;1.000;3600000;0
9729;189944;152;0;0;0;0;.00nan;0;0
9729;176770;81;0;0;0;0;.00nan;0;0
9729;78775;152;61;25;2;23;.920;3525000;0
9730;184049;1097;0;0;0;0;.00nan;0;0
9730;170598;1097;81;28;1;27;.964;3600000;0
9730;175423;77;0;0;0;0;.00nan;0;0
9730;180873;77;57;26;3;23;.885;3597000;0
9731;166545;1096;0;0;0;0;.00nan;0;0
9731;183775;1096;48;25;3;22;.880;3600000;0
9731;173856;75;0;0;0;0;.00nan;0;0
9731;171615;75;68;25;2;23;.920;3600000;0
9732;-1;151;0;0;0;0;.00nan;0;0
9732;173874;158;0;0;0;0;.00nan;0;0
9732;196525;151;50;37;5;32;.865;3600000;0
9732;91398;158;98;21;0;21;1.000;3600000;0
9733;4487;4922;39;32;6;26;.813;3557000;0
9733;-1;74;0;0;0;0;.00nan;0;0
9733;176060;74;74;39;4;35;.897;3600000;0
9733;86472;4922;0;0;0;0;.00nan;0;0
9734;170963;2564;0;0;0;0;.00nan;0;0
9734;176860;2564;65;35;4;31;.886;3577000;0
9734;58100;69;97;47;2;45;.957;3600000;0
9734;64911;69;0;0;0;0;.00nan;0;0
9735;-1;71;0;0;0;0;.00nan;0;0
9735;58054;71;52;23;4;19;.826;3588000;0
9735;85009;80;0;0;0;0;.00nan;0;0
9735;85228;80;94;37;2;35;.946;3600000;0
9736;163989;4245;43;33;6;27;.818;2915000;0
9736;170612;85;60;40;5;35;.875;3600000;0
9736;-1;4245;46;5;1;4;.800;666000;0
9736;148573;85;0;0;0;0;.00nan;0;0
9737;163462;4620;58;16;2;14;.875;3600000;0
9737;163784;82;74;52;6;46;.885;3600000;0
9737;176963;82;0;0;0;0;.00nan;0;0
9737;181341;4620;0;0;0;0;.00nan;0;0
9738;161535;4921;0;0;0;0;.00nan;0;0
9738;184081;157;57;15;1;14;.933;3600000;0
9738;184398;4921;85;38;2;36;.947;3600000;0
9738;171730;157;0;0;0;0;.00nan;0;0
9739;184069;73;67;23;2;21;.913;3600000;0
9739;173823;73;0;0;0;0;.00nan;0;0
9739;57953;72;48;9;1;8;.889;1286000;0
9739;64811;72;38;28;6;22;.786;2314000;0
9740;170351;149;92;35;1;34;.971;3600000;0
9740;60773;1095;0;0;0;0;.00nan;0;0
9740;78479;1095;77;35;3;32;.914;3600000;0
9740;85546;149;0;0;0;0;.00nan;0;0
9741;189581;76;0;0;0;0;.00nan;0;0
9741;174407;78;81;43;3;40;.930;3647000;0
9741;179406;78;0;0;0;0;.00nan;0;0
9741;176136;76;45;25;4;21;.840;3647000;0
9742;171970;81;95;40;2;38;.950;3600000;0
9742;189944;152;0;0;0;0;.00nan;0;0
9742;176770;81;0;0;0;0;.00nan;0;0
9742;78775;152;53;29;4;25;.862;3570000;0
9743;184049;1097;77;26;1;25;.962;3600000;0
9743;170598;1097;0;0;0;0;.00nan;0;0
9743;175423;77;0;0;0;0;.00nan;0;0
9743;180873;77;80;33;3;30;.909;3547000;0
9744;-1;151;99;30;1;29;.967;3600000;0
9744;173874;158;0;0;0;0;.00nan;0;0
9744;196525;151;0;0;0;0;.00nan;0;0
9744;91398;158;76;35;3;32;.914;3554000;0
9745;166545;1096;82;38;2;36;.947;3575000;0
9745;183775;1096;0;0;0;0;.00nan;0;0
9745;-1;74;99;36;1;35;.972;3600000;0
9745;176060;74;0;0;0;0;.00nan;0;0
9746;183859;4920;72;8;0;8;1.000;3600000;0
9746;169096;67;57;44;6;38;.864;2300000;0
9746;182049;67;81;22;1;21;.955;1300000;0
9746;59592;4920;0;0;0;0;.00nan;0;0
9747;-1;71;78;36;3;33;.917;3900000;0
9747;58054;71;0;0;0;0;.00nan;0;0
9747;85009;80;0;0;0;0;.00nan;0;0
9747;85228;80;70;36;3;33;.917;3900000;0
9748;163989;4245;0;0;0;0;.00nan;0;0
9748;170612;85;0;0;0;0;.00nan;0;0
9748;-1;4245;64;21;3;18;.857;3570000;0
9748;148573;85;90;31;2;29;.935;3600000;0
9749;4487;4922;66;33;3;30;.909;3557000;0
9749;173856;75;66;23;2;21;.913;3600000;0
9749;171615;75;0;0;0;0;.00nan;0;0
9749;86472;4922;0;0;0;0;.00nan;0;0
9750;170963;2564;22;16;6;10;.625;1939000;0
9750;176860;2564;82;23;1;22;.957;1661000;0
9750;58100;69;0;0;0;0;.00nan;0;0
9750;64911;69;100;49;2;47;.959;3600000;0
9751;163462;4620;0;0;0;0;.00nan;0;0
9751;163784;82;0;0;0;0;.00nan;0;0
9751;176963;82;80;31;3;28;.903;3600000;0
9751;181341;4620;56;30;4;26;.867;3600000;0
9752;161535;4921;58;30;4;26;.867;3600000;0
9752;184081;157;100;23;0;23;1.000;3600000;0
9752;184398;4921;0;0;0;0;.00nan;0;0
9752;171730;157;0;0;0;0;.00nan;0;0
9753;184069;73;39;30;5;25;.833;3178000;0
9753;173823;73;26;7;3;4;.571;422000;0
9753;57953;72;0;0;0;0;.00nan;0;0
9753;64811;72;78;39;3;36;.923;3600000;0
9754;170351;149;0;0;0;0;.00nan;0;0
9754;60773;1095;0;0;0;0;.00nan;0;0
9754;78479;1095;64;38;5;33;.868;3600000;0
9754;85546;149;73;18;1;17;.944;3600000;0
9755;189581;76;0;0;0;0;.00nan;0;0
9755;174407;78;0;0;0;0;.00nan;0;0
9755;179406;78;78;25;1;24;.960;3600000;0
9755;176136;76;79;27;2;25;.926;3563000;0
9756;183859;4920;60;12;1;11;.917;3600000;0
9756;169096;67;33;34;6;28;.824;2198000;0
9756;182049;67;71;22;1;21;.955;1402000;0
9756;59592;4920;0;0;0;0;.00nan;0;0
9757;4487;4922;73;20;1;19;.950;3600000;0
9757;-1;74;0;0;0;0;.00nan;0;0
9757;176060;74;62;33;3;30;.909;3516000;0
9757;86472;4922;0;0;0;0;.00nan;0;0
9758;57953;72;81;31;1;30;.968;3900000;0
9758;58100;69;100;38;1;37;.974;3900000;0
9758;64811;72;0;0;0;0;.00nan;0;0
9758;64911;69;0;0;0;0;.00nan;0;0
9759;184069;73;0;0;0;0;.00nan;0;0
9759;173823;73;72;26;2;24;.923;3600000;0
9759;170963;2564;0;0;0;0;.00nan;0;0
9759;176860;2564;79;36;3;33;.917;3593000;0
9760;170351;149;49;14;2;12;.857;3600000;0
9760;189944;152;55;5;0;5;1.000;341000;0
9760;78775;152;50;37;6;31;.838;3259000;0
9760;85546;149;0;0;0;0;.00nan;0;0
9761;189581;76;90;20;0;20;1.000;3600000;0
9761;174407;78;78;34;3;31;.912;3600000;0
9761;179406;78;0;0;0;0;.00nan;0;0
9761;176136;76;0;0;0;0;.00nan;0;0
9762;171970;81;81;61;6;55;.902;3600000;0
9762;184081;157;80;25;2;23;.920;3600000;0
9762;171730;157;0;0;0;0;.00nan;0;0
9762;176770;81;0;0;0;0;.00nan;0;0
9763;161535;4921;0;0;0;0;.00nan;0;0
9763;184398;4921;45;40;6;34;.850;3600000;0
9763;60773;1095;0;0;0;0;.00nan;0;0
9763;78479;1095;95;34;1;33;.971;3600000;0
9764;163989;4245;20;10;4;6;.600;1015000;0
9764;170612;85;0;0;0;0;.00nan;0;0
9764;-1;4245;81;27;1;26;.963;2546000;0
9764;148573;85;80;45;4;41;.911;3600000;0
9765;163784;82;0;0;0;0;.00nan;0;0
9765;-1;74;0;0;0;0;.00nan;0;0
9765;176060;74;62;27;3;24;.889;3600000;0
9765;176963;82;75;43;4;39;.907;3552000;0
9766;58100;69;58;40;5;35;.875;3600000;0
9766;60773;1095;0;0;0;0;.00nan;0;0
9766;64911;69;0;0;0;0;.00nan;0;0
9766;78479;1095;78;21;1;20;.952;3600000;0
9767;174407;78;100;32;0;32;1.000;3600000;0
9767;179406;78;0;0;0;0;.00nan;0;0
9767;-1;71;0;0;0;0;.00nan;0;0
9767;58054;71;89;35;1;34;.971;3591000;0
9768;170963;2564;0;0;0;0;.00nan;0;0
9768;176860;2564;38;24;4;20;.833;3578000;0
9768;64811;72;0;0;0;0;.00nan;0;0
9768;91212;72;65;21;2;19;.905;3600000;0
9769;161535;4921;82;39;3;36;.923;3600000;0
9769;184069;73;63;15;1;14;.933;3600000;0
9769;173823;73;0;0;0;0;.00nan;0;0
9769;184398;4921;0;0;0;0;.00nan;0;0
9770;173874;158;0;0;0;0;.00nan;0;0
9770;189944;152;0;0;0;0;.00nan;0;0
9770;78775;152;70;30;3;27;.900;3900000;0
9770;91398;158;87;33;3;30;.909;3900000;0
9771;163989;4245;84;26;1;25;.962;3600000;0
9771;170612;85;0;0;0;0;.00nan;0;0
9771;-1;4245;0;0;0;0;.00nan;0;0
9771;148573;85;81;35;3;32;.914;3558000;0
9772;183859;4920;95;22;0;22;1.000;3600000;0
9772;189581;76;84;41;2;39;.951;3518000;0
9772;176136;76;0;0;0;0;.00nan;0;0
9772;59592;4920;0;0;0;0;.00nan;0;0
9773;184049;1097;100;40;2;38;.950;3600000;0
9773;173856;75;0;0;0;0;.00nan;0;0
9773;170598;1097;0;0;0;0;.00nan;0;0
9773;171615;75;55;38;5;33;.868;3600000;0
9774;-1;151;0;0;0;0;.00nan;0;0
9774;196525;151;74;20;1;19;.950;3600000;0
9774;85009;80;0;0;0;0;.00nan;0;0
9774;85228;80;34;27;5;22;.815;3600000;0
9775;166545;1096;0;0;0;0;.00nan;0;0
9775;4487;4922;33;31;6;25;.806;3061000;0
9775;183775;1096;65;21;3;18;.857;3600000;0
9775;86472;4922;58;5;0;5;1.000;539000;0
9776;163462;4620;68;26;3;23;.885;3600000;0
9776;169096;67;0;0;0;0;.00nan;0;0
9776;181341;4620;0;0;0;0;.00nan;0;0
9776;182049;67;56;31;4;27;.871;3584000;0
9777;184081;157;84;29;2;27;.931;3600000;0
9777;170351;149;0;0;0;0;.00nan;0;0
9777;171730;157;0;0;0;0;.00nan;0;0
9777;85546;149;66;34;3;31;.912;3577000;0
9778;4487;4922;73;23;1;22;.957;3600000;0
9778;163784;82;71;26;2;24;.923;3600000;0
9778;176963;82;0;0;0;0;.00nan;0;0
9778;86472;4922;0;0;0;0;.00nan;0;0
9779;174407;78;40;33;6;27;.818;3284000;0
9779;179406;78;52;5;0;5;1.000;316000;0
9779;-1;71;52;14;2;12;.857;3600000;0
9779;58054;71;0;0;0;0;.00nan;0;0
9780;166545;1096;65;38;4;34;.895;3545000;0
9780;183775;1096;0;0;0;0;.00nan;0;0
9780;-1;74;70;31;3;28;.903;3600000;0
9780;176060;74;0;0;0;0;.00nan;0;0
9781;58100;69;0;0;0;0;.00nan;0;0
9781;64811;72;0;0;0;0;.00nan;0;0
9781;64911;69;69;29;3;26;.897;3735000;0
9781;91212;72;73;43;4;39;.907;3735000;0
9782;161535;4921;0;0;0;0;.00nan;0;0
9782;184069;73;0;0;0;0;.00nan;0;0
9782;173823;73;58;22;2;20;.909;3900000;0
9782;184398;4921;100;43;2;41;.953;3900000;0
9783;170963;2564;55;41;5;36;.878;3545000;0
9783;176860;2564;0;0;0;0;.00nan;0;0
9783;60773;1095;0;0;0;0;.00nan;0;0
9783;78479;1095;56;32;4;28;.875;3600000;0
9784;173874;158;73;34;3;31;.912;3611000;0
9784;189944;152;72;23;2;21;.913;3611000;0
9784;78775;152;0;0;0;0;.00nan;0;0
9784;91398;158;0;0;0;0;.00nan;0;0
9785;163989;4245;0;0;0;0;.00nan;0;0
9785;170612;85;70;34;3;31;.912;3600000;0
9785;-1;4245;100;36;0;36;1.000;3600000;0
9785;148573;85;0;0;0;0;.00nan;0;0
9786;183859;4920;38;31;5;26;.839;3566000;0
9786;189581;76;0;0;0;0;.00nan;0;0
9786;176136;76;66;36;4;32;.889;3600000;0
9786;59592;4920;0;0;0;0;.00nan;0;0
9787;-1;151;58;33;4;29;.879;3600000;0
9787;196525;151;0;0;0;0;.00nan;0;0
9787;85009;80;0;0;0;0;.00nan;0;0
9787;85228;80;61;47;6;41;.872;3584000;0
9788;184049;1097;0;0;0;0;.00nan;0;0
9788;170598;1097;71;37;3;34;.919;3600000;0
9788;175423;77;0;0;0;0;.00nan;0;0
9788;180873;77;99;26;0;26;1.000;3600000;0
9789;163462;4620;0;0;0;0;.00nan;0;0
9789;169096;67;38;39;6;33;.846;2538000;0
9789;181341;4620;82;22;1;21;.955;3600000;0
9789;182049;67;63;16;1;15;.938;1062000;0
9790;174407;78;0;0;0;0;.00nan;0;0
9790;179406;78;95;34;1;33;.971;3600000;0
9790;-1;71;0;0;0;0;.00nan;0;0
9790;58054;71;52;27;4;23;.852;3600000;0
9791;166545;1096;0;0;0;0;.00nan;0;0
9791;183775;1096;78;29;3;26;.897;3600000;0
9791;-1;74;0;0;0;0;.00nan;0;0
9791;176060;74;48;41;5;36;.878;3600000;0
9792;163989;4245;0;0;0;0;.00nan;0;0
9792;170612;85;0;0;0;0;.00nan;0;0
9792;-1;4245;58;41;5;36;.878;3555000;0
9792;148573;85;100;49;3;46;.939;3600000;0
9793;183859;4920;0;0;0;0;.00nan;0;0
9793;189581;76;23;13;4;9;.692;669000;0
9793;176136;76;88;47;2;45;.957;2931000;0
9793;59592;4920;86;15;0;15;1.000;3600000;0
9794;184049;1097;54;29;4;25;.862;3600000;0
9794;170598;1097;0;0;0;0;.00nan;0;0
9794;175423;77;0;0;0;0;.00nan;0;0
9794;180873;77;86;30;1;29;.967;3600000;0
9795;4487;4922;93;39;3;36;.923;3900000;0
9795;173856;75;58;24;3;21;.875;3900000;0
9795;171615;75;0;0;0;0;.00nan;0;0
9795;86472;4922;0;0;0;0;.00nan;0;0
9796;161535;4921;71;33;3;30;.909;3565000;0
9796;184398;4921;0;0;0;0;.00nan;0;0
9796;60773;1095;0;0;0;0;.00nan;0;0
9796;78479;1095;86;34;2;32;.941;3600000;0
9797;163784;82;0;0;0;0;.00nan;0;0
9797;184049;1097;83;27;1;26;.963;3600000;0
9797;170598;1097;0;0;0;0;.00nan;0;0
9797;176963;82;52;34;4;30;.882;3600000;0
9798;171970;81;45;33;5;28;.848;3566000;0
9798;173874;158;0;0;0;0;.00nan;0;0
9798;176770;81;0;0;0;0;.00nan;0;0
9798;91398;158;69;30;3;27;.900;3600000;0
9799;183859;4920;0;0;0;0;.00nan;0;0
9799;189581;76;0;0;0;0;.00nan;0;0
9799;176136;76;90;47;4;43;.915;3567000;0
9799;59592;4920;66;29;3;26;.897;3600000;0
9800;184069;73;52;25;3;22;.880;3567000;0
9800;173823;73;0;0;0;0;.00nan;0;0
9800;170612;85;0;0;0;0;.00nan;0;0
9800;148573;85;72;21;2;19;.905;3600000;0
9801;189944;152;0;0;0;0;.00nan;0;0
9801;78775;152;68;35;3;32;.914;3556000;0
9801;85009;80;0;0;0;0;.00nan;0;0
9801;85228;80;89;36;2;34;.944;3600000;0
9802;173856;75;0;0;0;0;.00nan;0;0
9802;171615;75;90;29;1;28;.966;3600000;0
9802;175423;77;56;38;5;33;.868;3600000;0
9802;180873;77;0;0;0;0;.00nan;0;0
9803;183859;4920;58;28;3;25;.893;3552000;0
9803;169096;67;0;0;0;0;.00nan;0;0
9803;182049;67;85;33;2;31;.939;3600000;0
9803;59592;4920;0;0;0;0;.00nan;0;0
9804;58100;69;19;24;6;18;.750;2488000;0
9804;60773;1095;0;0;0;0;.00nan;0;0
9804;64911;69;63;5;0;5;1.000;1112000;0
9804;78479;1095;95;39;2;37;.949;3600000;0
9805;166545;1096;0;0;0;0;.00nan;0;0
9805;183775;1096;40;23;4;19;.826;3517000;0
9805;184049;1097;61;23;2;21;.913;3600000;0
9805;170598;1097;0;0;0;0;.00nan;0;0
9806;161535;4921;0;0;0;0;.00nan;0;0
9806;184398;4921;64;46;5;41;.891;3600000;0
9806;64811;72;0;0;0;0;.00nan;0;0
9806;91212;72;55;21;2;19;.905;3600000;0
9807;170963;2564;0;0;0;0;.00nan;0;0
9807;176860;2564;68;35;4;31;.886;3572000;0
9807;-1;71;0;0;0;0;.00nan;0;0
9807;58054;71;61;19;2;17;.895;3600000;0
9808;171970;81;70;37;4;33;.892;3900000;0
9808;173874;158;0;0;0;0;.00nan;0;0
9808;176770;81;0;0;0;0;.00nan;0;0
9808;91398;158;44;21;4;17;.810;3900000;0
9809;163784;82;0;0;0;0;.00nan;0;0
9809;173856;75;0;0;0;0;.00nan;0;0
9809;171615;75;100;36;0;36;1.000;3600000;0
9809;176963;82;98;43;1;42;.977;3600000;0
9810;184069;73;0;0;0;0;.00nan;0;0
9810;173823;73;40;29;5;24;.828;3600000;0
9810;170612;85;0;0;0;0;.00nan;0;0
9810;148573;85;100;41;0;41;1.000;3600000;0
9811;-1;74;0;0;0;0;.00nan;0;0
9811;175423;77;0;0;0;0;.00nan;0;0
9811;176060;74;55;27;5;22;.815;3600000;0
9811;180873;77;69;23;2;21;.913;3600000;0
9812;4487;4922;29;22;6;16;.727;2566000;0
9812;170351;149;62;16;2;14;.875;3600000;0
9812;85546;149;0;0;0;0;.00nan;0;0
9812;86472;4922;46;11;2;9;.818;1034000;0
9813;163462;4620;0;0;0;0;.00nan;0;0
9813;163989;4245;0;0;0;0;.00nan;0;0
9813;-1;4245;62;26;3;23;.885;3600000;0
9813;181341;4620;100;25;0;25;1.000;3600000;0
9814;-1;151;0;0;0;0;.00nan;0;0
9814;184081;157;0;0;0;0;.00nan;0;0
9814;171730;157;60;27;3;24;.889;3900000;0
9814;196525;151;70;33;3;30;.909;3900000;0
9815;189944;152;0;0;0;0;.00nan;0;0
9815;78775;152;53;33;4;29;.879;3575000;0
9815;85009;80;0;0;0;0;.00nan;0;0
9815;85228;80;53;24;3;21;.875;3600000;0
9816;189581;76;0;0;0;0;.00nan;0;0
9816;174407;78;44;33;5;28;.848;2279000;0
9816;179406;78;45;5;1;4;.800;1318000;0
9816;176136;76;62;29;4;25;.862;3600000;0
9817;163462;4620;0;0;0;0;.00nan;0;0
9817;169096;67;93;39;2;37;.949;3568000;0
9817;181341;4620;65;17;1;16;.941;3600000;0
9817;182049;67;0;0;0;0;.00nan;0;0
9818;-1;71;56;33;4;29;.879;3543000;0
9818;58054;71;0;0;0;0;.00nan;0;0
9818;60773;1095;77;34;3;31;.912;3600000;0
9818;78479;1095;0;0;0;0;.00nan;0;0
9819;166545;1096;54;33;5;28;.848;3526000;0
9819;183775;1096;0;0;0;0;.00nan;0;0
9819;184049;1097;67;25;3;22;.880;3600000;0
9819;170598;1097;0;0;0;0;.00nan;0;0
9820;161535;4921;97;48;2;46;.958;3571000;0
9820;184398;4921;0;0;0;0;.00nan;0;0
9820;64811;72;0;0;0;0;.00nan;0;0
9820;91212;72;100;21;0;21;1.000;3600000;0
9821;171970;81;0;0;0;0;.00nan;0;0
9821;173874;158;90;37;2;35;.946;3600000;0
9821;176770;81;57;39;5;34;.872;3600000;0
9821;91398;158;0;0;0;0;.00nan;0;0
9822;163989;4245;78;33;2;31;.939;3543000;0
9822;183859;4920;0;0;0;0;.00nan;0;0
9822;-1;4245;0;0;0;0;.00nan;0;0
9822;59592;4920;100;36;1;35;.972;3600000;0
9823;163784;82;72;35;3;32;.914;3600000;0
9823;171615;75;66;36;4;32;.889;3600000;0
9823;174407;75;0;0;0;0;.00nan;0;0
9823;176963;82;0;0;0;0;.00nan;0;0
9824;184069;73;61;35;4;31;.886;3849000;0
9824;173823;73;0;0;0;0;.00nan;0;0
9824;170612;85;0;0;0;0;.00nan;0;0
9824;148573;85;50;23;3;20;.870;3849000;0
9825;-1;74;83;50;4;46;.920;3600000;0
9825;175423;77;0;0;0;0;.00nan;0;0
9825;176060;74;0;0;0;0;.00nan;0;0
9825;180873;77;79;25;1;24;.960;3600000;0
9826;4487;4922;71;38;4;34;.895;3600000;0
9826;170351;149;0;0;0;0;.00nan;0;0
9826;85546;149;76;23;1;22;.957;3600000;0
9826;86472;4922;0;0;0;0;.00nan;0;0
9827;170963;2564;90;23;0;23;1.000;1673000;0
9827;176860;2564;35;28;6;22;.786;1927000;0
9827;58100;69;82;24;1;23;.958;3600000;0
9827;64911;69;0;0;0;0;.00nan;0;0
9828;-1;151;83;52;4;48;.923;3581000;0
9828;184081;157;75;28;2;26;.929;3600000;0
9828;171730;157;0;0;0;0;.00nan;0;0
9828;196525;151;0;0;0;0;.00nan;0;0
9829;189944;152;0;0;0;0;.00nan;0;0
9829;78775;152;100;34;0;34;1.000;3600000;0
9829;85009;80;0;0;0;0;.00nan;0;0
9829;85228;80;59;31;4;27;.871;3600000;0
9830;189581;76;79;35;3;32;.914;3600000;0
9830;179406;78;0;0;0;0;.00nan;0;0
9830;176136;76;0;0;0;0;.00nan;0;0
9830;191574;78;64;34;4;30;.882;3580000;0
9831;169096;67;0;0;0;0;.00nan;0;0
9831;189581;76;0;0;0;0;.00nan;0;0
9831;176136;76;51;23;4;19;.826;3596000;0
9831;182049;67;90;41;3;38;.927;3600000;0
9832;170963;2564;60;7;0;7;1.000;259000;0
9832;176860;2564;44;39;6;33;.846;3341000;0
9832;64811;72;0;0;0;0;.00nan;0;0
9832;91212;72;56;16;2;14;.875;3600000;0
9833;163989;4245;0;0;0;0;.00nan;0;0
9833;183859;4920;100;24;0;24;1.000;3600000;0
9833;-1;4245;58;27;3;24;.889;3600000;0
9833;59592;4920;0;0;0;0;.00nan;0;0
9834;4487;4922;94;52;3;49;.942;3643000;0
9834;170351;149;0;0;0;0;.00nan;0;0
9834;85546;149;66;26;2;24;.923;3643000;0
9834;86472;4922;0;0;0;0;.00nan;0;0
9835;58100;69;50;2;0;2;1.000;301000;0
9835;60773;1095;0;0;0;0;.00nan;0;0
9835;64911;69;47;32;6;26;.813;3299000;0
9835;78479;1095;83;32;2;30;.938;3600000;0
9836;-1;151;0;0;0;0;.00nan;0;0
9836;184081;157;60;23;2;21;.913;3600000;0
9836;171730;157;0;0;0;0;.00nan;0;0
9836;196525;151;58;46;5;41;.891;3600000;0
9837;163462;4620;47;30;5;25;.833;3534000;0
9837;179406;78;79;37;3;34;.919;3600000;0
9837;181341;4620;0;0;0;0;.00nan;0;0
9837;191574;78;0;0;0;0;.00nan;0;0
9838;173874;158;0;0;0;0;.00nan;0;0
9838;189944;152;0;0;0;0;.00nan;0;0
9838;78775;152;59;29;3;26;.897;3580000;0
9838;91398;158;71;23;2;21;.913;3600000;0
9839;184069;73;75;29;2;27;.931;3600000;0
9839;173823;73;0;0;0;0;.00nan;0;0
9839;60773;1095;0;0;0;0;.00nan;0;0
9839;78479;1095;82;52;5;47;.904;3600000;0
9840;171970;81;0;0;0;0;.00nan;0;0
9840;-1;151;0;0;0;0;.00nan;0;0
9840;176770;81;95;37;2;35;.946;3571000;0
9840;196525;151;93;23;0;23;1.000;3600000;0
9841;184049;1097;31;27;6;21;.778;3229000;0
9841;170598;1097;54;4;0;4;1.000;371000;0
9841;-1;74;0;0;0;0;.00nan;0;0
9841;176060;74;78;26;1;25;.962;3600000;0
9842;169096;67;85;19;0;19;1.000;3555000;0
9842;170612;85;0;0;0;0;.00nan;0;0
9842;182049;67;36;10;3;7;.700;345000;0
9842;148573;85;85;42;3;39;.929;3900000;0
9843;-1;71;0;0;0;0;.00nan;0;0
9843;58054;71;52;29;4;25;.862;3576000;0
9843;60773;1095;0;0;0;0;.00nan;0;0
9843;78479;1095;87;36;3;33;.917;3600000;0
9844;166545;1096;0;0;0;0;.00nan;0;0
9844;4487;4922;100;44;3;41;.932;3900000;0
9844;183775;1096;67;32;3;29;.906;3900000;0
9844;86472;4922;0;0;0;0;.00nan;0;0
9845;171970;81;0;0;0;0;.00nan;0;0
9845;-1;151;58;7;0;7;1.000;868000;0
9845;176770;81;79;31;2;29;.935;3600000;0
9845;196525;151;34;26;6;20;.769;2732000;0
9846;163784;82;37;22;4;18;.818;2903000;0
9846;-1;74;62;29;3;26;.897;3600000;0
9846;176060;74;0;0;0;0;.00nan;0;0
9846;176963;82;19;7;4;3;.429;697000;0
9847;161535;4921;0;0;0;0;.00nan;0;0
9847;184398;4921;86;34;2;32;.941;3562000;0
9847;170963;2564;0;0;0;0;.00nan;0;0
9847;176860;2564;100;34;0;34;1.000;3600000;0
9848;163989;4245;0;0;0;0;.00nan;0;0
9848;-1;4245;80;28;1;27;.964;3600000;0
9848;85009;80;0;0;0;0;.00nan;0;0
9848;85228;80;55;41;5;36;.878;3600000;0
9849;183859;4920;67;30;3;27;.900;3600000;0
9849;59592;4920;0;0;0;0;.00nan;0;0
9849;64811;72;0;0;0;0;.00nan;0;0
9849;91212;72;45;34;6;28;.824;3600000;0
9850;184049;1097;61;29;3;26;.897;3553000;0
9850;170598;1097;0;0;0;0;.00nan;0;0
9850;175423;77;0;0;0;0;.00nan;0;0
9850;180873;77;88;27;1;26;.963;3600000;0
9851;-1;76;0;0;0;0;.00nan;0;0
9851;189581;76;74;29;2;27;.931;3600000;0
9851;58100;69;70;37;4;33;.892;3524000;0
9851;64911;69;0;0;0;0;.00nan;0;0
9852;163462;4620;0;0;0;0;.00nan;0;0
9852;179406;78;72;34;3;31;.912;3595000;0
9852;181341;4620;65;17;1;16;.941;3600000;0
9852;191574;78;0;0;0;0;.00nan;0;0
9853;184081;157;89;29;1;28;.966;3600000;0
9853;171730;157;0;0;0;0;.00nan;0;0
9853;189944;152;0;0;0;0;.00nan;0;0
9853;78775;152;86;33;2;31;.939;3575000;0
9854;184069;73;45;4;1;3;.750;663000;0
9854;173823;73;47;25;4;21;.840;2937000;0
9854;171615;75;0;0;0;0;.00nan;0;0
9854;174407;75;99;46;2;44;.957;3600000;0
9855;173874;158;0;0;0;0;.00nan;0;0
9855;170351;149;44;18;3;15;.833;3568000;0
9855;85546;149;0;0;0;0;.00nan;0;0
9855;91398;158;79;27;2;25;.926;3600000;0
9856;4487;4922;84;30;2;28;.933;3600000;0
9856;163784;82;0;0;0;0;.00nan;0;0
9856;176963;82;86;14;0;14;1.000;3600000;0
9856;86472;4922;0;0;0;0;.00nan;0;0
9857;-1;71;78;37;2;35;.946;3900000;0
9857;58054;71;0;0;0;0;.00nan;0;0
9857;60773;1095;0;0;0;0;.00nan;0;0
9857;78479;1095;94;36;2;34;.944;3900000;0
9858;166545;1096;65;27;3;24;.889;3600000;0
9858;183775;1096;0;0;0;0;.00nan;0;0
9858;-1;74;0;0;0;0;.00nan;0;0
9858;176060;74;93;43;2;41;.953;3600000;0
9859;171970;81;65;39;6;33;.846;3600000;0
9859;-1;151;77;34;2;32;.941;3600000;0
9859;176770;81;0;0;0;0;.00nan;0;0
9859;196525;151;0;0;0;0;.00nan;0;0
9860;161535;4921;76;22;2;20;.909;3663000;0
9860;184398;4921;0;0;0;0;.00nan;0;0
9860;170963;2564;0;0;0;0;.00nan;0;0
9860;176860;2564;68;30;3;27;.900;3663000;0
9861;173874;158;0;0;0;0;.00nan;0;0
9861;170351;149;0;0;0;0;.00nan;0;0
9861;85546;149;55;25;3;22;.880;3548000;0
9861;91398;158;99;49;2;47;.959;3600000;0
9862;163989;4245;68;21;2;19;.905;3600000;0
9862;-1;4245;0;0;0;0;.00nan;0;0
9862;85009;80;0;0;0;0;.00nan;0;0
9862;85228;80;74;38;3;35;.921;3600000;0
9863;183859;4920;0;0;0;0;.00nan;0;0
9863;59592;4920;61;20;2;18;.900;3600000;0
9863;64811;72;59;7;0;7;1.000;909000;0
9863;91212;72;27;28;6;22;.786;2691000;0
9864;169096;67;0;0;0;0;.00nan;0;0
9864;170612;85;56;23;3;20;.870;3600000;0
9864;182049;67;76;37;4;33;.892;3600000;0
9864;148573;85;0;0;0;0;.00nan;0;0
9865;184049;1097;59;32;4;28;.875;3600000;0
9865;170598;1097;0;0;0;0;.00nan;0;0
9865;175423;77;0;0;0;0;.00nan;0;0
9865;180873;77;40;42;7;35;.833;3600000;0
9866;-1;76;90;40;2;38;.950;3873000;0
9866;189581;76;0;0;0;0;.00nan;0;0
9866;58100;69;0;0;0;0;.00nan;0;0
9866;64911;69;68;34;3;31;.912;3873000;0
9867;163462;4620;91;22;0;22;1.000;3600000;0
9867;179406;78;55;17;2;15;.882;1096000;0
9867;181341;4620;0;0;0;0;.00nan;0;0
9867;191574;78;31;31;6;25;.806;2504000;0
9868;184081;157;72;28;2;26;.929;3600000;0
9868;171730;157;0;0;0;0;.00nan;0;0
9868;189944;152;49;9;1;8;.889;450000;0
9868;78775;152;34;31;6;25;.806;3150000;0
9869;184069;73;50;31;4;27;.871;3541000;0
9869;173823;73;0;0;0;0;.00nan;0;0
9869;171615;75;0;0;0;0;.00nan;0;0
9869;174407;75;80;40;3;37;.925;3600000;0
9870;4487;4922;56;33;4;29;.879;3600000;0
9870;163784;82;0;0;0;0;.00nan;0;0
9870;176963;82;68;25;3;22;.880;3600000;0
9870;86472;4922;0;0;0;0;.00nan;0;0
9871;170963;2564;26;7;3;4;.571;505000;0
9871;176860;2564;89;46;4;42;.913;3095000;0
9871;-1;71;0;0;0;0;.00nan;0;0
9871;58054;71;42;23;4;19;.826;3600000;0
9872;166545;1096;0;0;0;0;.00nan;0;0
9872;183775;1096;75;34;3;31;.912;3576000;0
9872;175423;77;0;0;0;0;.00nan;0;0
9872;180873;77;88;33;1;32;.970;3600000;0
9873;163989;4245;0;0;0;0;.00nan;0;0
9873;-1;4245;68;19;2;17;.895;3600000;0
9873;85009;80;90;44;4;40;.909;3590000;0
9873;85228;80;0;0;0;0;.00nan;0;0
9874;183859;4920;66;29;3;26;.897;3600000;0
9874;59592;4920;0;0;0;0;.00nan;0;0
9874;64811;72;0;0;0;0;.00nan;0;0
9874;91212;72;56;36;5;31;.861;3566000;0
9875;169096;67;65;40;4;36;.900;3600000;0
9875;170612;85;0;0;0;0;.00nan;0;0
9875;182049;67;0;0;0;0;.00nan;0;0
9875;148573;85;79;22;1;21;.955;3600000;0
9876;-1;76;0;0;0;0;.00nan;0;0
9876;189581;76;50;35;5;30;.857;3600000;0
9876;58100;69;68;20;1;19;.950;3600000;0
9876;64911;69;0;0;0;0;.00nan;0;0
9877;184081;157;78;26;2;24;.923;3600000;0
9877;171730;157;0;0;0;0;.00nan;0;0
9877;189944;152;0;0;0;0;.00nan;0;0
9877;78775;152;68;36;4;32;.889;3562000;0
9878;184069;73;0;0;0;0;.00nan;0;0
9878;173823;73;87;38;2;36;.947;3900000;0
9878;171615;75;0;0;0;0;.00nan;0;0
9878;174407;75;95;41;2;39;.951;3900000;0
9879;173874;158;56;13;1;12;.923;1085000;0
9879;170351;149;79;27;2;25;.926;3600000;0
9879;85546;149;0;0;0;0;.00nan;0;0
9879;91398;158;42;31;6;25;.806;2515000;0
9880;184069;73;51;21;3;18;.857;3525000;0
9880;173823;73;0;0;0;0;.00nan;0;0
9880;170612;85;0;0;0;0;.00nan;0;0
9880;148573;85;98;36;1;35;.972;3600000;0
9881;171970;81;0;0;0;0;.00nan;0;0
9881;184081;157;76;24;2;22;.917;3600000;0
9881;171730;157;0;0;0;0;.00nan;0;0
9881;176770;81;61;30;3;27;.900;3600000;0
9882;184049;1097;100;26;0;26;1.000;3600000;0
9882;169096;67;71;32;3;29;.906;2845000;0
9882;170598;1097;0;0;0;0;.00nan;0;0
9882;182049;67;19;11;4;7;.636;755000;0
9883;161535;4921;0;0;0;0;.00nan;0;0
9883;184398;4921;67;27;2;25;.926;3812000;0
9883;170963;2564;0;0;0;0;.00nan;0;0
9883;176860;2564;67;30;3;27;.900;3812000;0
9884;171615;75;0;0;0;0;.00nan;0;0
9884;-1;74;0;0;0;0;.00nan;0;0
9884;174407;75;79;31;2;29;.935;3600000;0
9884;176060;74;64;46;6;40;.870;3600000;0
9885;173874;158;0;0;0;0;.00nan;0;0
9885;-1;71;0;0;0;0;.00nan;0;0
9885;58054;71;100;31;0;31;1.000;3600000;0
9885;91398;158;97;43;2;41;.953;3512000;0
9886;163784;82;0;0;0;0;.00nan;0;0
9886;176963;82;78;43;4;39;.907;3515000;0
9886;64811;72;0;0;0;0;.00nan;0;0
9886;91212;72;63;23;2;21;.913;3600000;0
9887;166545;1096;0;0;0;0;.00nan;0;0
9887;183775;1096;63;31;3;28;.903;3600000;0
9887;183859;4920;62;16;1;15;.938;3600000;0
9887;59592;4920;0;0;0;0;.00nan;0;0
9888;4487;4922;72;37;4;33;.892;3600000;0
9888;175423;77;71;22;1;21;.955;3600000;0
9888;180873;77;0;0;0;0;.00nan;0;0
9888;86472;4922;0;0;0;0;.00nan;0;0
9889;170351;149;0;0;0;0;.00nan;0;0
9889;-1;71;0;0;0;0;.00nan;0;0
9889;58054;71;91;43;2;41;.953;3600000;0
9889;85546;149;68;29;3;26;.897;3545000;0
9890;171970;81;0;0;0;0;.00nan;0;0
9890;184081;157;71;29;2;27;.931;3600000;0
9890;171730;157;0;0;0;0;.00nan;0;0
9890;176770;81;90;48;3;45;.938;3600000;0
9891;184049;1097;56;16;2;14;.875;3600000;0
9891;169096;67;60;45;6;39;.867;3210000;0
9891;170598;1097;0;0;0;0;.00nan;0;0
9891;182049;67;38;10;2;8;.800;390000;0
9892;163784;82;25;15;4;11;.733;876000;0
9892;176963;82;92;34;1;33;.971;2724000;0
9892;64811;72;0;0;0;0;.00nan;0;0
9892;91212;72;43;24;4;20;.833;3600000;0
9893;161535;4921;0;0;0;0;.00nan;0;0
9893;184398;4921;46;31;5;26;.839;3600000;0
9893;60773;1095;0;0;0;0;.00nan;0;0
9893;78479;1095;100;33;0;33;1.000;3600000;0
9894;166545;1096;98;62;3;59;.952;3575000;0
9894;183775;1096;0;0;0;0;.00nan;0;0
9894;183859;4920;72;15;1;14;.933;3600000;0
9894;59592;4920;0;0;0;0;.00nan;0;0
9895;163462;4620;43;25;4;21;.840;3600000;0
9895;-1;76;37;15;3;12;.800;561000;0
9895;189581;76;78;35;2;33;.943;2996000;0
9895;181341;4620;0;0;0;0;.00nan;0;0
9896;171615;75;0;0;0;0;.00nan;0;0
9896;-1;74;0;0;0;0;.00nan;0;0
9896;174407;75;92;22;0;22;1.000;3600000;0
9896;176060;74;64;43;5;38;.884;3600000;0
9897;173874;158;0;0;0;0;.00nan;0;0
9897;85009;80;0;0;0;0;.00nan;0;0
9897;85228;80;64;21;2;19;.905;3600000;0
9897;91398;158;58;33;4;29;.879;3600000;0
9898;4487;4922;75;33;3;30;.909;3554000;0
9898;175423;77;0;0;0;0;.00nan;0;0
9898;180873;77;80;21;1;20;.952;3600000;0
9898;86472;4922;0;0;0;0;.00nan;0;0
9899;170963;2564;0;0;0;0;.00nan;0;0
9899;176860;2564;87;41;4;37;.902;3559000;0
9899;58100;69;57;18;2;16;.889;3600000;0
9899;64911;69;0;0;0;0;.00nan;0;0
9900;-1;151;69;20;1;19;.950;1907000;0
9900;189944;152;59;20;2;18;.900;3600000;0
9900;196525;151;36;35;6;29;.829;1693000;0
9900;78775;152;0;0;0;0;.00nan;0;0
9901;184069;73;50;10;1;9;.900;1721000;0
9901;173823;73;30;29;6;23;.793;1879000;0
9901;170612;85;0;0;0;0;.00nan;0;0
9901;148573;85;84;35;2;33;.943;3600000;0
9902;163989;4245;71;26;2;24;.923;3868000;0
9902;-1;4245;0;0;0;0;.00nan;0;0
9902;179406;78;91;29;1;28;.966;3868000;0
9902;191574;78;0;0;0;0;.00nan;0;0
9903;171970;81;67;42;4;38;.905;3531000;0
9903;184081;157;81;29;2;27;.931;3600000;0
9903;171730;157;0;0;0;0;.00nan;0;0
9903;176770;81;0;0;0;0;.00nan;0;0
9904;184049;1097;78;27;2;25;.926;3600000;0
9904;169096;67;0;0;0;0;.00nan;0;0
9904;170598;1097;0;0;0;0;.00nan;0;0
9904;182049;67;55;49;7;42;.857;3600000;0
9905;-1;151;0;0;0;0;.00nan;0;0
9905;189944;152;0;0;0;0;.00nan;0;0
9905;196525;151;85;49;4;45;.918;3715000;0
9905;78775;152;64;24;3;21;.875;3715000;0
9906;163784;82;44;38;6;32;.842;3600000;0
9906;176963;82;0;0;0;0;.00nan;0;0
9906;64811;72;0;0;0;0;.00nan;0;0
9906;91212;72;42;21;4;17;.810;3600000;0
9907;161535;4921;75;36;3;33;.917;3600000;0
9907;184398;4921;0;0;0;0;.00nan;0;0
9907;60773;1095;0;0;0;0;.00nan;0;0
9907;78479;1095;100;32;0;32;1.000;3600000;0
9908;171615;75;0;0;0;0;.00nan;0;0
9908;-1;74;87;46;2;44;.957;3900000;0
9908;174407;75;81;22;2;20;.909;3900000;0
9908;176060;74;0;0;0;0;.00nan;0;0
9909;170963;2564;78;32;2;30;.938;3600000;0
9909;176860;2564;0;0;0;0;.00nan;0;0
9909;58100;69;13;21;6;15;.714;3600000;0
9909;64911;69;0;0;0;0;.00nan;0;0
9910;166545;1096;51;20;2;18;.900;1140000;0
9910;183775;1096;40;26;6;20;.769;2460000;0
9910;183859;4920;0;0;0;0;.00nan;0;0
9910;59592;4920;50;26;4;22;.846;3600000;0
9911;163462;4620;0;0;0;0;.00nan;0;0
9911;-1;76;55;36;5;31;.861;3516000;0
9911;189581;76;0;0;0;0;.00nan;0;0
9911;181341;4620;68;31;3;28;.903;3600000;0
9912;173874;158;0;0;0;0;.00nan;0;0
9912;85009;80;50;22;3;19;.864;3837000;0
9912;85228;80;0;0;0;0;.00nan;0;0
9912;91398;158;71;35;4;31;.886;3837000;0
9913;4487;4922;80;28;2;26;.929;3900000;0
9913;175423;77;57;20;2;18;.900;3900000;0
9913;180873;77;0;0;0;0;.00nan;0;0
9913;86472;4922;0;0;0;0;.00nan;0;0
9914;184069;73;75;29;2;27;.931;3900000;0
9914;173823;73;0;0;0;0;.00nan;0;0
9914;170612;85;0;0;0;0;.00nan;0;0
9914;148573;85;72;29;2;27;.931;3900000;0
9915;170351;149;79;36;3;33;.917;3600000;0
9915;-1;71;0;0;0;0;.00nan;0;0
9915;58054;71;67;37;4;33;.892;3559000;0
9915;85546;149;0;0;0;0;.00nan;0;0
9916;163989;4245;0;0;0;0;.00nan;0;0
9916;-1;4245;69;30;2;28;.933;3600000;0
9916;179406;78;0;0;0;0;.00nan;0;0
9916;191574;78;60;33;4;29;.879;3600000;0
9917;4487;4922;60;35;4;31;.886;3560000;0
9917;163784;82;0;0;0;0;.00nan;0;0
9917;176963;82;70;36;2;34;.944;3600000;0
9917;86472;4922;0;0;0;0;.00nan;0;0
9918;171970;81;0;0;0;0;.00nan;0;0
9918;170351;149;0;0;0;0;.00nan;0;0
9918;176770;81;75;35;3;32;.914;3547000;0
9918;85546;149;60;23;2;21;.913;3600000;0
9919;161535;4921;0;0;0;0;.00nan;0;0
9919;184398;4921;97;42;3;39;.929;3900000;0
9919;64811;72;0;0;0;0;.00nan;0;0
9919;91212;72;67;21;3;18;.857;3900000;0
9920;-1;151;0;0;0;0;.00nan;0;0
9920;196525;151;93;33;2;31;.939;3600000;0
9920;85009;80;0;0;0;0;.00nan;0;0
9920;85228;80;81;32;3;29;.906;3573000;0
9921;184081;157;80;25;1;24;.960;3600000;0
9921;173874;158;0;0;0;0;.00nan;0;0
9921;171730;157;0;0;0;0;.00nan;0;0
9921;91398;158;66;32;3;29;.906;3530000;0
9922;169096;67;52;43;7;36;.837;3600000;0
9922;170612;85;0;0;0;0;.00nan;0;0
9922;182049;67;0;0;0;0;.00nan;0;0
9922;148573;85;78;23;1;22;.957;3600000;0
9923;163784;82;0;0;0;0;.00nan;0;0
9923;175423;77;0;0;0;0;.00nan;0;0
9923;176963;82;83;50;4;46;.920;3600000;0
9923;180873;77;90;20;0;20;1.000;3600000;0
9924;58100;69;99;44;1;43;.977;3600000;0
9924;60773;1095;0;0;0;0;.00nan;0;0
9924;64911;69;0;0;0;0;.00nan;0;0
9924;78479;1095;85;37;3;34;.919;3584000;0
9925;166545;1096;70;34;3;31;.912;3900000;0
9925;4487;4922;78;40;3;37;.925;3900000;0
9925;183775;1096;0;0;0;0;.00nan;0;0
9925;86472;4922;0;0;0;0;.00nan;0;0
9926;161535;4921;98;57;4;53;.930;3585000;0
9926;184398;4921;0;0;0;0;.00nan;0;0
9926;64811;72;0;0;0;0;.00nan;0;0
9926;91212;72;55;16;2;14;.875;3600000;0
9927;184049;1097;60;26;3;23;.885;3558000;0
9927;170598;1097;0;0;0;0;.00nan;0;0
9927;-1;74;0;0;0;0;.00nan;0;0
9927;176060;74;81;34;2;32;.941;3600000;0
9928;170963;2564;0;0;0;0;.00nan;0;0
9928;176860;2564;71;45;4;41;.911;3567000;0
9928;-1;71;0;0;0;0;.00nan;0;0
9928;58054;71;53;19;3;16;.842;3600000;0
9929;163989;4245;85;29;1;28;.966;3600000;0
9929;-1;76;0;0;0;0;.00nan;0;0
9929;189581;76;49;37;5;32;.865;3600000;0
9929;-1;4245;0;0;0;0;.00nan;0;0
9930;171615;75;0;0;0;0;.00nan;0;0
9930;174407;75;51;20;3;17;.850;3600000;0
9930;179406;78;57;33;4;29;.879;3600000;0
9930;191574;78;0;0;0;0;.00nan;0;0
9931;-1;151;0;0;0;0;.00nan;0;0
9931;196525;151;24;23;6;17;.739;3600000;0
9931;85009;80;0;0;0;0;.00nan;0;0
9931;85228;80;85;35;3;32;.914;3600000;0
9932;171970;81;0;0;0;0;.00nan;0;0
9932;184081;157;61;28;3;25;.893;3900000;0
9932;171730;157;0;0;0;0;.00nan;0;0
9932;176770;81;83;35;3;32;.914;3900000;0
9933;184069;73;94;24;0;24;1.000;3600000;0
9933;173823;73;0;0;0;0;.00nan;0;0
9933;189944;152;0;0;0;0;.00nan;0;0
9933;78775;152;58;33;5;28;.848;3600000;0
9934;173874;158;0;0;0;0;.00nan;0;0
9934;170351;149;90;43;3;40;.930;3900000;0
9934;85546;149;0;0;0;0;.00nan;0;0
9934;91398;158;60;26;3;23;.885;3900000;0
9935;163462;4620;0;0;0;0;.00nan;0;0
9935;169096;67;0;0;0;0;.00nan;0;0
9935;181341;4620;33;26;5;21;.808;3536000;0
9935;182049;67;61;31;3;28;.903;3600000;0
9936;171970;81;59;38;4;34;.895;3562000;0
9936;184081;157;66;23;2;21;.913;3600000;0
9936;171730;157;0;0;0;0;.00nan;0;0
9936;176770;81;0;0;0;0;.00nan;0;0
9937;-1;71;80;32;2;30;.938;3900000;0
9937;58054;71;0;0;0;0;.00nan;0;0
9937;60773;1095;0;0;0;0;.00nan;0;0
9937;78479;1095;92;40;2;38;.950;3900000;0
9938;166545;1096;0;0;0;0;.00nan;0;0
9938;163784;82;87;48;3;45;.938;3558000;0
9938;183775;1096;82;29;1;28;.966;3600000;0
9938;176963;82;0;0;0;0;.00nan;0;0
9939;161535;4921;0;0;0;0;.00nan;0;0
9939;184398;4921;64;36;4;32;.889;3578000;0
9939;64811;72;0;0;0;0;.00nan;0;0
9939;91212;72;54;15;2;13;.867;3600000;0
9940;-1;74;100;30;0;30;1.000;3600000;0
9940;175423;77;0;0;0;0;.00nan;0;0
9940;176060;74;0;0;0;0;.00nan;0;0
9940;180873;77;70;22;2;20;.909;3541000;0
9941;170963;2564;95;50;2;48;.960;3600000;0
9941;176860;2564;0;0;0;0;.00nan;0;0
9941;58100;69;47;20;3;17;.850;3558000;0
9941;64911;69;0;0;0;0;.00nan;0;0
9942;173874;158;55;38;5;33;.868;3600000;0
9942;170351;149;0;0;0;0;.00nan;0;0
9942;85546;149;100;19;0;19;1.000;3600000;0
9942;91398;158;0;0;0;0;.00nan;0;0
9943;163989;4245;0;0;0;0;.00nan;0;0
9943;-1;76;43;46;7;39;.848;3600000;0
9943;189581;76;0;0;0;0;.00nan;0;0
9943;-1;4245;56;29;4;25;.862;3600000;0
9944;171615;75;52;2;0;2;1.000;447000;0
9944;174407;75;73;54;5;49;.907;3148000;0
9944;179406;78;0;0;0;0;.00nan;0;0
9944;191574;78;72;35;4;31;.886;3600000;0
9945;-1;151;41;31;5;26;.839;3574000;0
9945;196525;151;0;0;0;0;.00nan;0;0
9945;85009;80;65;33;3;30;.909;3600000;0
9945;85228;80;0;0;0;0;.00nan;0;0
9946;183859;4920;71;25;2;23;.920;3900000;0
9946;170612;85;85;34;2;32;.941;3900000;0
9946;59592;4920;0;0;0;0;.00nan;0;0
9946;148573;85;0;0;0;0;.00nan;0;0
9947;4487;4922;0;0;0;0;.00nan;0;0
9947;184049;1097;0;0;0;0;.00nan;0;0
9947;170598;1097;34;25;5;20;.800;3600000;0
9947;86472;4922;100;43;2;41;.953;3600000;0
9948;184069;73;100;26;0;26;1.000;3600000;0
9948;173823;73;0;0;0;0;.00nan;0;0
9948;189944;152;65;36;4;32;.889;3600000;0
9948;78775;152;0;0;0;0;.00nan;0;0
9949;166545;1096;46;12;2;10;.833;3600000;0
9949;163784;82;0;0;0;0;.00nan;0;0
9949;183775;1096;0;0;0;0;.00nan;0;0
9949;176963;82;97;48;3;45;.938;3586000;0
9950;-1;71;52;24;4;20;.833;2404000;0
9950;58054;71;30;12;4;8;.667;1196000;0
9950;60773;1095;43;22;4;18;.818;3600000;0
9950;78479;1095;0;0;0;0;.00nan;0;0
9951;-1;74;95;54;2;52;.963;3600000;0
9951;175423;77;39;19;4;15;.789;3513000;0
9951;176060;74;0;0;0;0;.00nan;0;0
9951;180873;77;0;0;0;0;.00nan;0;0
9952;163989;4245;89;17;0;17;1.000;3600000;0
9952;-1;76;0;0;0;0;.00nan;0;0
9952;189581;76;98;44;3;41;.932;3600000;0
9952;-1;4245;0;0;0;0;.00nan;0;0
9953;171615;75;0;0;0;0;.00nan;0;0
9953;174407;75;97;32;2;30;.938;3900000;0
9953;179406;78;84;35;2;33;.943;3900000;0
9953;191574;78;0;0;0;0;.00nan;0;0
9954;4487;4922;13;28;7;21;.750;2697000;0
9954;184049;1097;56;35;4;31;.886;3600000;0
9954;170598;1097;0;0;0;0;.00nan;0;0
9954;86472;4922;58;5;0;5;1.000;903000;0
9955;184081;157;82;25;1;24;.960;3600000;0
9955;170351;149;0;0;0;0;.00nan;0;0
9955;171730;157;0;0;0;0;.00nan;0;0
9955;85546;149;63;35;4;31;.886;3600000;0
9956;183859;4920;100;35;1;34;.971;3900000;0
9956;170612;85;0;0;0;0;.00nan;0;0
9956;59592;4920;0;0;0;0;.00nan;0;0
9956;148573;85;97;37;1;36;.973;3900000;0
9957;184069;73;71;28;3;25;.893;3900000;0
9957;173823;73;0;0;0;0;.00nan;0;0
9957;189944;152;0;0;0;0;.00nan;0;0
9957;78775;152;75;39;3;36;.923;3900000;0
9958;184049;1097;70;32;3;29;.906;3600000;0
9958;170598;1097;0;0;0;0;.00nan;0;0
9958;179406;78;37;42;7;35;.833;3600000;0
9958;191574;78;0;0;0;0;.00nan;0;0
9959;161535;4921;50;31;4;27;.871;3900000;0
9959;170351;149;48;26;4;22;.846;3900000;0
9959;184398;4921;0;0;0;0;.00nan;0;0
9959;85546;149;0;0;0;0;.00nan;0;0
9960;163989;4245;58;10;1;9;.900;3600000;0
9960;170963;2564;0;0;0;0;.00nan;0;0
9960;-1;4245;0;0;0;0;.00nan;0;0
9960;176860;2564;98;60;4;56;.933;3600000;0
9961;183859;4920;100;38;1;37;.974;3600000;0
9961;170612;85;0;0;0;0;.00nan;0;0
9961;59592;4920;0;0;0;0;.00nan;0;0
9961;148573;85;75;32;2;30;.938;3600000;0
9962;4487;4922;0;0;0;0;.00nan;0;0
9962;163784;82;0;0;0;0;.00nan;0;0
9962;176963;82;26;30;7;23;.767;3600000;0
9962;86472;4922;80;21;1;20;.952;3600000;0
9963;166545;1096;0;0;0;0;.00nan;0;0
9963;183775;1096;75;39;3;36;.923;3600000;0
9963;85009;80;0;0;0;0;.00nan;0;0
9963;85228;80;39;24;5;19;.792;3516000;0
9964;169096;67;0;0;0;0;.00nan;0;0
9964;170612;85;35;12;3;9;.750;1521000;0
9964;182049;67;87;52;2;50;.962;3600000;0
9964;148573;85;34;19;4;15;.789;2079000;0
9965;161535;4921;74;15;0;15;1.000;1338000;0
9965;184398;4921;19;21;6;15;.714;2262000;0
9965;60773;1095;0;0;0;0;.00nan;0;0
9965;78479;1095;82;29;1;28;.966;3600000;0
9966;184049;1097;60;29;4;25;.862;3600000;0
9966;170598;1097;0;0;0;0;.00nan;0;0
9966;179406;78;93;34;1;33;.971;3600000;0
9966;191574;78;0;0;0;0;.00nan;0;0
9967;170351;149;75;32;2;30;.938;3600000;0
9967;64811;72;0;0;0;0;.00nan;0;0
9967;85546;149;0;0;0;0;.00nan;0;0
9967;91212;72;61;29;3;26;.897;3564000;0
9968;173874;158;0;0;0;0;.00nan;0;0
9968;189944;152;0;0;0;0;.00nan;0;0
9968;78775;152;72;42;4;38;.905;3600000;0
9968;91398;158;95;32;1;31;.969;3600000;0
9969;4487;4922;80;32;3;29;.906;3600000;0
9969;-1;76;0;0;0;0;.00nan;0;0
9969;189581;76;88;16;0;16;1.000;3600000;0
9969;86472;4922;0;0;0;0;.00nan;0;0
9970;171615;75;0;0;0;0;.00nan;0;0
9970;-1;74;0;0;0;0;.00nan;0;0
9970;174407;75;100;34;1;33;.971;3600000;0
9970;176060;74;79;38;3;35;.921;3570000;0
9971;163784;82;0;0;0;0;.00nan;0;0
9971;175423;77;0;0;0;0;.00nan;0;0
9971;176963;82;62;43;5;38;.884;3600000;0
9971;180873;77;100;22;0;22;1.000;3600000;0
9972;163989;4245;0;0;0;0;.00nan;0;0
9972;-1;4245;58;26;3;23;.885;3600000;0
9972;58100;69;0;0;0;0;.00nan;0;0
9972;64911;69;50;32;5;27;.844;3557000;0
9973;163462;4620;98;44;2;42;.955;3600000;0
9973;183859;4920;88;29;1;28;.966;3600000;0
9973;181341;4620;0;0;0;0;.00nan;0;0
9973;59592;4920;0;0;0;0;.00nan;0;0
9974;-1;151;0;0;0;0;.00nan;0;0
9974;184081;157;91;18;0;18;1.000;3600000;0
9974;171730;157;0;0;0;0;.00nan;0;0
9974;196525;151;88;34;1;33;.971;3548000;0
9975;184069;73;48;30;4;26;.867;3569000;0
9975;173823;73;0;0;0;0;.00nan;0;0
9975;-1;71;0;0;0;0;.00nan;0;0
9975;58054;71;94;41;3;38;.927;3600000;0
9976;169096;67;70;31;3;28;.903;3600000;0
9976;170612;85;59;13;1;12;.923;2590000;0
9976;182049;67;0;0;0;0;.00nan;0;0
9976;148573;85;23;10;4;6;.600;972000;0
9977;161535;4921;87;36;3;33;.917;3600000;0
9977;184398;4921;0;0;0;0;.00nan;0;0
9977;60773;1095;0;0;0;0;.00nan;0;0
9977;78479;1095;43;24;4;20;.833;3594000;0
9978;184049;1097;0;0;0;0;.00nan;0;0
9978;170598;1097;96;25;0;25;1.000;3600000;0
9978;179406;78;0;0;0;0;.00nan;0;0
9978;191574;78;51;41;6;35;.854;3600000;0
9979;166545;1096;47;20;3;17;.850;3600000;0
9979;183775;1096;0;0;0;0;.00nan;0;0
9979;85009;80;0;0;0;0;.00nan;0;0
9979;85228;80;63;46;6;40;.870;3600000;0
9980;170351;149;56;7;0;7;1.000;958000;0
9980;64811;72;0;0;0;0;.00nan;0;0
9980;85546;149;26;26;6;20;.769;2642000;0
9980;91212;72;62;27;3;24;.889;3600000;0
9981;173874;158;0;0;0;0;.00nan;0;0
9981;189944;152;48;32;4;28;.875;3600000;0
9981;78775;152;0;0;0;0;.00nan;0;0
9981;91398;158;48;34;5;29;.853;3587000;0
9982;4487;4922;0;0;0;0;.00nan;0;0
9982;-1;76;68;20;1;19;.950;3600000;0
9982;189581;76;0;0;0;0;.00nan;0;0
9982;86472;4922;88;41;2;39;.951;3600000;0
9983;163784;82;69;20;1;19;.950;1378000;0
9983;171615;75;0;0;0;0;.00nan;0;0
9983;174407;75;53;23;3;20;.870;3600000;0
9983;176963;82;40;27;5;22;.815;2222000;0
9984;-1;74;88;34;1;33;.971;3600000;0
9984;175423;77;0;0;0;0;.00nan;0;0
9984;176060;74;0;0;0;0;.00nan;0;0
9984;180873;77;50;30;4;26;.867;3600000;0
9985;163989;4245;73;36;3;33;.917;3900000;0
9985;-1;4245;0;0;0;0;.00nan;0;0
9985;58100;69;46;16;3;13;.813;3900000;0
9985;64911;69;0;0;0;0;.00nan;0;0
9986;163462;4620;0;0;0;0;.00nan;0;0
9986;183859;4920;0;0;0;0;.00nan;0;0
9986;181341;4620;80;23;1;22;.957;3600000;0
9986;59592;4920;68;25;2;23;.920;3577000;0
9987;-1;151;53;35;5;30;.857;3600000;0
9987;184081;157;56;42;6;36;.857;3565000;0
9987;171730;157;0;0;0;0;.00nan;0;0
9987;196525;151;0;0;0;0;.00nan;0;0
9988;184069;73;0;0;0;0;.00nan;0;0
9988;173823;73;50;28;4;24;.857;3900000;0
9988;170963;2564;0;0;0;0;.00nan;0;0
9988;176860;2564;75;50;4;46;.920;3900000;0
9989;163989;4245;0;0;0;0;.00nan;0;0
9989;-1;4245;63;29;3;26;.897;3549000;0
9989;60773;1095;96;38;1;37;.974;3600000;0
9989;78479;1095;0;0;0;0;.00nan;0;0
9990;166545;1096;0;0;0;0;.00nan;0;0
9990;183775;1096;38;37;6;31;.838;3600000;0
9990;85009;80;69;36;3;33;.917;3600000;0
9990;85228;80;0;0;0;0;.00nan;0;0
9991;173874;158;0;0;0;0;.00nan;0;0
9991;189944;152;0;0;0;0;.00nan;0;0
9991;78775;152;100;32;0;32;1.000;3600000;0
9991;91398;158;86;28;1;27;.964;3558000;0
9992;163784;82;0;0;0;0;.00nan;0;0
9992;171615;75;0;0;0;0;.00nan;0;0
9992;174407;75;61;23;2;21;.913;3600000;0
9992;176963;82;49;32;4;28;.875;3590000;0
9993;-1;71;0;0;0;0;.00nan;0;0
9993;58054;71;84;34;2;32;.941;3600000;0
9993;58100;69;0;0;0;0;.00nan;0;0
9993;64911;69;62;36;4;32;.889;3568000;0
9994;-1;151;61;24;3;21;.875;2903000;0
9994;184081;157;0;0;0;0;.00nan;0;0
9994;171730;157;100;29;0;29;1.000;3600000;0
9994;196525;151;22;11;4;7;.636;697000;0
9995;184069;73;61;33;3;30;.909;3600000;0
9995;173823;73;0;0;0;0;.00nan;0;0
9995;170963;2564;42;43;7;36;.837;3600000;0
9995;176860;2564;0;0;0;0;.00nan;0;0
9996;163784;82;58;40;5;35;.875;3552000;0
9996;-1;74;62;32;3;29;.906;3600000;0
9996;176060;74;0;0;0;0;.00nan;0;0
9996;176963;82;0;0;0;0;.00nan;0;0
9997;60773;1095;0;0;0;0;.00nan;0;0
9997;64811;72;0;0;0;0;.00nan;0;0
9997;78479;1095;93;50;4;46;.920;3600000;0
9997;91212;72;94;28;1;27;.964;3600000;0
9998;-1;151;55;12;1;11;.917;809000;0
9998;189944;152;0;0;0;0;.00nan;0;0
9998;196525;151;26;26;6;20;.769;2791000;0
9998;78775;152;100;37;2;35;.946;3600000;0
9999;-1;76;12;19;6;13;.684;2886000;0
9999;169096;67;0;0;0;0;.00nan;0;0
9999;189581;76;47;6;1;5;.833;714000;0
9999;182049;67;98;42;2;40;.952;3600000;0
10000;175423;77;51;9;1;8;.889;1268000;0
10000;180873;77;45;18;4;14;.778;2285000;0
10000;85009;80;0;0;0;0;.00nan;0;0
10000;85228;80;70;40;4;36;.900;3600000;0
10001;184069;73;61;22;2;20;.909;3570000;0
10001;173823;73;0;0;0;0;.00nan;0;0
10001;170612;85;0;0;0;0;.00nan;0;0
10001;148573;85;84;27;1;26;.963;3600000;0
10002;171970;81;0;0;0;0;.00nan;0;0
10002;184081;157;0;0;0;0;.00nan;0;0
10002;171730;157;54;29;4;25;.862;3600000;0
10002;176770;81;47;40;6;34;.850;3559000;0
10003;184069;73;51;34;5;29;.853;3600000;0
10003;173823;73;0;0;0;0;.00nan;0;0
10003;60773;1095;0;0;0;0;.00nan;0;0
10003;78479;1095;100;33;1;32;.970;3600000;0
10004;-1;151;0;0;0;0;.00nan;0;0
10004;189944;152;0;0;0;0;.00nan;0;0
10004;196525;151;72;50;5;45;.900;3554000;0
10004;78775;152;64;27;3;24;.889;3600000;0
10005;161535;4921;83;35;2;33;.943;3535000;0
10005;184398;4921;0;0;0;0;.00nan;0;0
10005;64811;72;0;0;0;0;.00nan;0;0
10005;91212;72;97;22;0;22;1.000;3600000;0
10006;173874;158;0;0;0;0;.00nan;0;0
10006;170351;149;100;23;0;23;1.000;3600000;0
10006;85546;149;0;0;0;0;.00nan;0;0
10006;91398;158;90;45;3;42;.933;3600000;0
10007;183859;4920;44;15;3;12;.800;3551000;0
10007;170963;2564;0;0;0;0;.00nan;0;0
10007;176860;2564;99;56;1;55;.982;3600000;0
10007;59592;4920;0;0;0;0;.00nan;0;0
10008;163989;4245;80;34;3;31;.912;3600000;0
10008;-1;76;39;32;5;27;.844;3595000;0
10008;189581;76;0;0;0;0;.00nan;0;0
10008;57657;4245;0;0;0;0;.00nan;0;0
10009;184049;1097;0;0;0;0;.00nan;0;0
10009;170598;1097;69;17;1;16;.941;3600000;0
10009;171615;75;0;0;0;0;.00nan;0;0
10009;174407;75;52;37;5;32;.865;3600000;0
10010;175423;77;0;0;0;0;.00nan;0;0
10010;180873;77;52;32;4;28;.875;3600000;0
10010;85009;80;0;0;0;0;.00nan;0;0
10010;85228;80;61;30;3;27;.900;3600000;0
10011;169096;67;0;0;0;0;.00nan;0;0
10011;170612;85;0;0;0;0;.00nan;0;0
10011;182049;67;59;42;6;36;.857;3600000;0
10011;148573;85;81;24;1;23;.958;3600000;0
10012;4487;4922;93;34;1;33;.971;3900000;0
10012;-1;74;0;0;0;0;.00nan;0;0
10012;176060;74;80;23;1;22;.957;3900000;0
10012;86472;4922;0;0;0;0;.00nan;0;0
10013;-1;71;46;7;1;6;.857;617000;0
10013;58054;71;18;22;6;16;.727;2983000;0
10013;58100;69;59;30;4;26;.867;3600000;0
10013;64911;69;0;0;0;0;.00nan;0;0
10014;166545;1096;76;30;2;28;.933;3600000;0
10014;163784;82;0;0;0;0;.00nan;0;0
10014;183775;1096;0;0;0;0;.00nan;0;0
10014;176963;82;60;26;3;23;.885;3596000;0
10015;60773;1095;75;36;3;33;.917;3600000;0
10015;64811;72;82;17;0;17;1.000;1539000;0
10015;78479;1095;0;0;0;0;.00nan;0;0
10015;91212;72;34;22;5;17;.773;2061000;0
10016;184069;73;48;26;4;22;.846;3576000;0
10016;173823;73;0;0;0;0;.00nan;0;0
10016;-1;71;97;39;2;37;.949;3600000;0
10016;58054;71;0;0;0;0;.00nan;0;0
10017;-1;151;80;51;4;47;.922;3539000;0
10017;189944;152;79;31;2;29;.935;3600000;0
10017;196525;151;0;0;0;0;.00nan;0;0
10017;78775;152;0;0;0;0;.00nan;0;0
10018;171615;75;73;27;2;25;.926;3266000;0
10018;-1;74;59;24;3;21;.875;3600000;0
10018;174407;75;25;6;3;3;.500;268000;0
10018;176060;74;0;0;0;0;.00nan;0;0
10019;183859;4920;91;27;1;26;.963;3600000;0
10019;170963;2564;0;0;0;0;.00nan;0;0
10019;176860;2564;93;40;3;37;.925;3566000;0
10019;59592;4920;0;0;0;0;.00nan;0;0
10020;163989;4245;0;0;0;0;.00nan;0;0
10020;-1;76;39;30;6;24;.800;3600000;0
10020;189581;76;0;0;0;0;.00nan;0;0
10020;57657;4245;74;28;2;26;.929;3600000;0
10021;175423;77;95;23;0;23;1.000;3600000;0
10021;180873;77;0;0;0;0;.00nan;0;0
10021;85009;80;54;39;5;34;.872;3600000;0
10021;85228;80;0;0;0;0;.00nan;0;0
10022;169096;67;70;49;5;44;.898;3600000;0
10022;170612;85;63;24;2;22;.917;3600000;0
10022;182049;67;0;0;0;0;.00nan;0;0
10022;148573;85;0;0;0;0;.00nan;0;0
10023;4487;4922;0;0;0;0;.00nan;0;0
10023;184049;1097;72;34;4;30;.882;3515000;0
10023;170598;1097;0;0;0;0;.00nan;0;0
10023;86472;4922;92;40;2;38;.950;3600000;0
10024;161535;4921;0;0;0;0;.00nan;0;0
10024;184398;4921;56;24;3;21;.875;3600000;0
10024;58100;69;0;0;0;0;.00nan;0;0
10024;64911;69;54;15;2;13;.867;3600000;0
10025;184081;157;82;34;3;31;.912;3570000;0
10025;173874;158;0;0;0;0;.00nan;0;0
10025;171730;157;0;0;0;0;.00nan;0;0
10025;91398;158;97;42;2;40;.952;3600000;0
10026;171970;81;62;44;4;40;.909;3516000;0
10026;170351;149;0;0;0;0;.00nan;0;0
10026;176770;81;0;0;0;0;.00nan;0;0
10026;85546;149;73;26;2;24;.923;3600000;0
10027;163462;4620;0;0;0;0;.00nan;0;0
10027;179406;78;0;0;0;0;.00nan;0;0
10027;181341;4620;66;26;2;24;.923;3564000;0
10027;191574;78;89;25;1;24;.960;3600000;0
10028;171970;81;0;0;0;0;.00nan;0;0
10028;170351;149;70;19;2;17;.895;3600000;0
10028;176770;81;35;24;5;19;.792;3600000;0
10028;85546;149;0;0;0;0;.00nan;0;0
10029;166545;1096;0;0;0;0;.00nan;0;0
10029;163784;82;56;35;4;31;.886;3544000;0
10029;183775;1096;52;17;3;14;.824;3600000;0
10029;176963;82;0;0;0;0;.00nan;0;0
10030;-1;71;0;0;0;0;.00nan;0;0
10030;58054;71;97;56;4;52;.929;3593000;0
10030;64811;72;0;0;0;0;.00nan;0;0
10030;91212;72;68;18;2;16;.889;3600000;0
10031;171615;75;0;0;0;0;.00nan;0;0
10031;-1;74;0;0;0;0;.00nan;0;0
10031;174407;75;73;36;3;33;.917;3900000;0
10031;176060;74;70;37;3;34;.919;3900000;0
10032;183859;4920;67;17;1;16;.941;3600000;0
10032;170963;2564;29;30;6;24;.800;2160000;0
10032;176860;2564;46;18;3;15;.833;1440000;0
10032;59592;4920;0;0;0;0;.00nan;0;0
10033;4487;4922;62;36;4;32;.889;3600000;0
10033;184049;1097;0;0;0;0;.00nan;0;0
10033;170598;1097;72;20;1;19;.950;3600000;0
10033;86472;4922;0;0;0;0;.00nan;0;0
10034;161535;4921;98;58;4;54;.931;3600000;0
10034;184398;4921;0;0;0;0;.00nan;0;0
10034;58100;69;59;11;1;10;.909;3600000;0
10034;64911;69;0;0;0;0;.00nan;0;0
10035;184081;157;43;21;4;17;.810;3600000;0
10035;173874;158;40;15;3;12;.800;1192000;0
10035;171730;157;0;0;0;0;.00nan;0;0
10035;91398;158;34;30;6;24;.800;2408000;0
10036;184069;73;0;0;0;0;.00nan;0;0
10036;173823;73;41;22;4;18;.818;3564000;0
10036;60773;1095;0;0;0;0;.00nan;0;0
10036;78479;1095;64;30;3;27;.900;3600000;0
10037;163462;4620;90;22;0;22;1.000;3600000;0
10037;179406;78;0;0;0;0;.00nan;0;0
10037;181341;4620;0;0;0;0;.00nan;0;0
10037;191574;78;83;32;2;30;.938;3523000;0
10278;183737;74;0;0;0;0;.00nan;0;0
10278;-1;74;69;26;2;24;.923;3600000;0
10278;175423;77;0;0;0;0;.00nan;0;0
10278;180873;77;73;28;3;25;.893;3586000;0
10280;-1;151;0;0;0;0;.00nan;0;0
10280;196525;151;96;44;3;41;.932;3600000;0
10280;58100;69;45;28;5;23;.821;3558000;0
10280;64911;69;0;0;0;0;.00nan;0;0
10282;166545;1096;0;0;0;0;.00nan;0;0
10282;161535;4921;92;53;2;51;.962;3600000;0
10282;183775;1096;72;34;3;31;.912;3600000;0
10282;184398;4921;0;0;0;0;.00nan;0;0
10284;169096;67;70;33;2;31;.939;3900000;0
10284;173856;75;0;0;0;0;.00nan;0;0
10284;171615;75;77;27;2;25;.926;3868000;0
10284;182049;67;0;0;0;0;.00nan;0;0
10286;184049;1097;0;0;0;0;.00nan;0;0
10286;170598;1097;99;34;1;33;.971;3600000;0
10286;86472;4922;84;33;2;31;.939;3567000;0
10286;161046;4922;0;0;0;0;.00nan;0;0
10288;163784;82;0;0;0;0;.00nan;0;0
10288;174407;78;68;20;2;18;.900;3600000;0
10288;179406;78;0;0;0;0;.00nan;0;0
10288;176963;82;68;34;4;30;.882;3577000;0
10290;184069;73;0;0;0;0;.00nan;0;0
10290;173823;73;67;37;4;33;.892;3520000;0
10290;170351;149;0;0;0;0;.00nan;0;0
10290;85546;149;76;34;2;32;.941;3600000;0
10292;2495;80;61;31;3;28;.903;3560000;0
10292;189581;76;0;0;0;0;.00nan;0;0
10292;176136;76;81;34;2;32;.941;3600000;0
10292;85009;80;0;0;0;0;.00nan;0;0
10294;163989;4245;79;26;1;25;.962;3600000;0
10294;-1;4245;0;0;0;0;.00nan;0;0
10294;181341;4620;96;40;2;38;.950;3542000;0
10294;85555;4620;0;0;0;0;.00nan;0;0
10296;171970;81;0;0;0;0;.00nan;0;0
10296;176770;81;66;31;3;28;.903;3600000;0
10296;176860;2564;61;25;2;23;.920;3600000;0
10296;85633;2564;0;0;0;0;.00nan;0;0
10298;183859;4920;77;23;1;22;.957;3600000;0
10298;170963;4920;0;0;0;0;.00nan;0;0
10298;57953;72;0;0;0;0;.00nan;0;0
10298;64811;72;51;32;4;28;.875;3600000;0
10300;178911;152;71;16;0;16;1.000;1376000;0
10300;170612;85;0;0;0;0;.00nan;0;0
10300;189944;152;12;18;6;12;.667;2224000;0
10300;57998;85;55;22;3;19;.864;3600000;0
10302;169166;1095;46;6;1;5;.833;789000;0
10302;-1;71;0;0;0;0;.00nan;0;0
10302;78479;1095;45;38;6;32;.842;2811000;0
10302;78775;71;75;21;1;20;.952;3600000;0
10304;184081;157;62;26;3;23;.885;3561000;0
10304;173874;158;0;0;0;0;.00nan;0;0
10304;171730;157;0;0;0;0;.00nan;0;0
10304;91398;158;95;40;2;38;.950;3600000;0
10305;197999;116;60;15;2;13;.867;1736000;0
10305;216028;116;47;25;4;21;.840;2164000;0
10305;202161;115;0;0;0;0;.00nan;0;0
10305;207439;115;53;50;6;44;.880;3900000;0
10306;200233;108;84;33;2;31;.939;3600000;0
10306;210773;111;0;0;0;0;.00nan;0;0
10306;207535;108;0;0;0;0;.00nan;0;0
10306;-1;111;90;46;3;43;.935;3547000;0
10307;210773;111;0;0;0;0;.00nan;0;0
10307;215968;110;17;17;6;11;.647;3567000;0
10307;217985;110;0;0;0;0;.00nan;0;0
10307;-1;111;65;45;5;40;.889;3600000;0
10308;204630;109;46;36;6;30;.833;3600000;0
10308;200233;108;54;20;3;17;.850;3600000;0
10308;201631;109;0;0;0;0;.00nan;0;0
10308;207535;108;0;0;0;0;.00nan;0;0
10309;213845;113;45;31;5;26;.839;3600000;0
10309;204711;119;0;0;0;0;.00nan;0;0
10309;210765;113;0;0;0;0;.00nan;0;0
10309;-1;119;77;33;2;31;.939;3600000;0
10310;197999;116;0;0;0;0;.00nan;0;0
10310;216028;116;68;40;4;36;.900;3600000;0
10310;202161;115;63;14;1;13;.929;3600000;0
10310;207439;115;0;0;0;0;.00nan;0;0
10311;199481;122;66;29;3;26;.897;3600000;0
10311;205469;122;0;0;0;0;.00nan;0;0
10311;210785;123;52;36;5;31;.861;3541000;0
10311;-1;123;0;0;0;0;.00nan;0;0
10312;200210;114;72;31;3;28;.903;3551000;0
10312;207493;121;64;27;2;25;.926;3600000;0
10312;207504;114;0;0;0;0;.00nan;0;0
10312;202279;121;0;0;0;0;.00nan;0;0
10313;208620;112;0;0;0;0;.00nan;0;0
10313;203412;117;0;0;0;0;.00nan;0;0
10313;202246;112;60;47;6;41;.872;3600000;0
10313;213504;117;44;16;3;13;.813;3600000;0
10314;200293;126;0;0;0;0;.00nan;0;0
10314;212039;126;76;20;1;19;.950;3600000;0
10314;206864;127;0;0;0;0;.00nan;0;0
10314;202314;127;61;44;5;39;.886;3600000;0
10315;204618;125;50;30;5;25;.833;3584000;0
10315;206731;124;41;28;4;24;.857;3273000;0
10315;203054;124;57;4;0;4;1.000;327000;0
10315;208391;125;0;0;0;0;.00nan;0;0
10316;199695;120;0;0;0;0;.00nan;0;0
10316;200390;120;45;31;5;26;.839;3900000;0
10316;-1;118;0;0;0;0;.00nan;0;0
10316;218830;118;34;26;5;21;.808;3900000;0
10317;200210;114;82;35;3;32;.914;3600000;0
10317;207493;121;0;0;0;0;.00nan;0;0
10317;207504;114;0;0;0;0;.00nan;0;0
10317;202279;121;42;34;5;29;.853;3537000;0
10318;199481;122;44;28;5;23;.821;3900000;0
10318;205469;122;0;0;0;0;.00nan;0;0
10318;206731;124;54;35;5;30;.857;3878000;0
10318;203054;124;0;0;0;0;.00nan;0;0
10319;213845;113;24;26;6;20;.769;3157000;0
10319;204711;119;0;0;0;0;.00nan;0;0
10319;210765;113;41;3;1;2;.667;402000;0
10319;-1;119;54;33;5;28;.848;3600000;0
10320;199695;120;0;0;0;0;.00nan;0;0
10320;200390;120;100;26;0;26;1.000;3600000;0
10320;202161;115;50;28;3;25;.893;3600000;0
10320;207439;115;0;0;0;0;.00nan;0;0
10321;206864;127;72;18;1;17;.944;1392000;0
10321;202314;127;29;32;6;26;.813;2208000;0
10321;-1;118;0;0;0;0;.00nan;0;0
10321;218830;118;51;26;3;23;.885;3600000;0
10322;200293;126;0;0;0;0;.00nan;0;0
10322;210785;123;0;0;0;0;.00nan;0;0
10322;212039;126;100;30;0;30;1.000;3600000;0
10322;-1;123;70;42;4;38;.905;3600000;0
10323;208620;112;0;0;0;0;.00nan;0;0
10323;204618;125;50;28;4;24;.857;3559000;0
10323;202246;112;67;34;3;31;.912;3600000;0
10323;208391;125;0;0;0;0;.00nan;0;0
10324;197999;116;28;32;6;26;.813;2855000;0
10324;203412;117;54;18;3;15;.833;3600000;0
10324;216028;116;48;6;1;5;.833;745000;0
10324;213504;117;0;0;0;0;.00nan;0;0
10325;210773;111;0;0;0;0;.00nan;0;0
10325;215968;110;92;22;0;22;1.000;3600000;0
10325;217985;110;0;0;0;0;.00nan;0;0
10325;-1;111;74;61;5;56;.918;3600000;0
10326;199481;122;49;34;5;29;.853;3600000;0
10326;200293;126;0;0;0;0;.00nan;0;0
10326;205469;122;0;0;0;0;.00nan;0;0
10326;212039;126;77;32;3;29;.906;3600000;0
10327;204618;125;55;27;4;23;.852;3600000;0
10327;207493;121;0;0;0;0;.00nan;0;0
10327;202279;121;42;41;6;35;.854;3581000;0
10327;208391;125;0;0;0;0;.00nan;0;0
10328;213845;113;41;29;4;25;.862;3600000;0
10328;200210;114;0;0;0;0;.00nan;0;0
10328;210765;113;0;0;0;0;.00nan;0;0
10328;207504;114;75;25;1;24;.960;3600000;0
10329;203412;117;50;36;5;31;.861;3586000;0
10329;200233;108;0;0;0;0;.00nan;0;0
10329;207535;108;61;35;4;31;.886;3600000;0
10329;213504;117;0;0;0;0;.00nan;0;0
10330;197999;116;0;0;0;0;.00nan;0;0
10330;216028;116;72;34;3;31;.912;3900000;0
10330;206864;127;0;0;0;0;.00nan;0;0
10330;202314;127;67;25;3;22;.880;3900000;0
10331;203412;117;52;23;3;20;.870;3600000;0
10331;210773;111;38;28;5;23;.821;3518000;0
10331;-1;111;0;0;0;0;.00nan;0;0
10331;213504;117;0;0;0;0;.00nan;0;0
10332;199481;122;0;0;0;0;.00nan;0;0
10332;199695;120;0;0;0;0;.00nan;0;0
10332;200390;120;68;34;4;30;.882;3860000;0
10332;205469;122;77;42;4;38;.905;3900000;0
10333;197999;116;60;37;4;33;.892;3600000;0
10333;216028;116;0;0;0;0;.00nan;0;0
10333;207493;121;61;22;3;19;.864;3600000;0
10333;202279;121;0;0;0;0;.00nan;0;0
10334;204618;125;38;28;5;23;.821;3566000;0
10334;200293;126;0;0;0;0;.00nan;0;0
10334;212039;126;75;30;3;27;.900;3600000;0
10334;208391;125;0;0;0;0;.00nan;0;0
10335;204711;119;0;0;0;0;.00nan;0;0
10335;-1;119;1;30;9;21;.700;3600000;0
10335;-1;118;93;28;1;27;.964;3600000;0
10335;218830;118;0;0;0;0;.00nan;0;0
10336;213845;113;0;0;0;0;.00nan;0;0
10336;210765;113;44;36;5;31;.861;3600000;0
10336;215968;110;72;28;2;26;.929;3600000;0
10336;217985;110;0;0;0;0;.00nan;0;0
10337;203412;117;0;0;0;0;.00nan;0;0
10337;204630;109;86;49;4;45;.918;3600000;0
10337;201631;109;0;0;0;0;.00nan;0;0
10337;213504;117;36;28;5;23;.821;3566000;0
10338;200293;126;59;19;2;17;.895;3600000;0
10338;212039;126;0;0;0;0;.00nan;0;0
10338;206864;127;73;42;4;38;.905;3539000;0
10338;202314;127;0;0;0;0;.00nan;0;0
10339;208620;112;0;0;0;0;.00nan;0;0
10339;215968;110;0;0;0;0;.00nan;0;0
10339;202246;112;55;29;4;25;.862;3600000;0
10339;217985;110;42;29;5;24;.828;3578000;0
10340;204618;125;0;0;0;0;.00nan;0;0
10340;206731;124;0;0;0;0;.00nan;0;0
10340;203054;124;94;23;0;23;1.000;3600000;0
10340;208391;125;64;43;5;38;.884;3600000;0
10341;199695;120;57;26;3;23;.885;3564000;0
10341;204711;119;86;31;1;30;.968;3600000;0
10341;200390;120;0;0;0;0;.00nan;0;0
10341;-1;119;0;0;0;0;.00nan;0;0
10342;207493;121;0;0;0;0;.00nan;0;0
10342;202279;121;59;47;5;42;.894;3600000;0
10342;-1;118;0;0;0;0;.00nan;0;0
10342;218830;118;95;32;1;31;.969;3600000;0
10343;199481;122;54;33;5;28;.848;3549000;0
10343;205469;122;0;0;0;0;.00nan;0;0
10343;210785;123;0;0;0;0;.00nan;0;0
10343;-1;123;57;28;3;25;.893;3600000;0
10344;200210;114;37;30;6;24;.800;3572000;0
10344;202161;115;68;30;4;26;.867;3600000;0
10344;207439;115;0;0;0;0;.00nan;0;0
10344;207504;114;0;0;0;0;.00nan;0;0
10345;204630;109;76;29;2;27;.931;2738000;0
10345;210773;111;0;0;0;0;.00nan;0;0
10345;201631;109;27;15;4;11;.733;862000;0
10345;-1;111;67;15;1;14;.933;3600000;0
10346;213845;113;69;21;1;20;.952;3600000;0
10346;208620;112;57;29;3;26;.897;3541000;0
10346;210765;113;0;0;0;0;.00nan;0;0
10346;202246;112;0;0;0;0;.00nan;0;0
10347;197999;116;0;0;0;0;.00nan;0;0
10347;199695;120;0;0;0;0;.00nan;0;0
10347;200390;120;58;30;3;27;.900;3900000;0
10347;216028;116;84;41;3;38;.927;3900000;0
10348;204618;125;56;38;5;33;.868;3600000;0
10348;206864;127;0;0;0;0;.00nan;0;0
10348;202314;127;69;23;2;21;.913;3600000;0
10348;208391;125;0;0;0;0;.00nan;0;0
10349;210785;123;61;26;2;24;.923;3600000;0
10349;206731;124;64;15;1;14;.933;3600000;0
10349;-1;123;0;0;0;0;.00nan;0;0
10349;203054;124;0;0;0;0;.00nan;0;0
10350;197999;116;61;28;2;26;.929;3600000;0
10350;204630;109;72;40;4;36;.900;3573000;0
10350;216028;116;0;0;0;0;.00nan;0;0
10350;201631;109;0;0;0;0;.00nan;0;0
10351;204711;119;0;0;0;0;.00nan;0;0
10351;200210;114;60;38;5;33;.868;3589000;0
10351;207504;114;0;0;0;0;.00nan;0;0
10351;-1;119;83;31;2;29;.935;3600000;0
10352;200233;108;48;26;4;22;.846;3600000;0
10352;207493;121;51;2;0;2;1.000;323000;0
10352;207535;108;0;0;0;0;.00nan;0;0
10352;202279;121;52;46;6;40;.870;3277000;0
10353;210773;111;0;0;0;0;.00nan;0;0
10353;206864;127;0;0;0;0;.00nan;0;0
10353;202314;127;100;30;0;30;1.000;3600000;0
10353;-1;111;85;47;4;43;.915;3600000;0
10354;208620;112;0;0;0;0;.00nan;0;0
10354;200233;108;66;24;2;22;.917;3600000;0
10354;202246;112;31;23;5;18;.783;3600000;0
10354;207535;108;0;0;0;0;.00nan;0;0
10355;199481;122;0;0;0;0;.00nan;0;0
10355;205469;122;45;19;4;15;.789;3822000;0
10355;202161;115;73;38;3;35;.921;3822000;0
10355;207439;115;0;0;0;0;.00nan;0;0
10356;210773;111;37;16;3;13;.813;3862000;0
10356;207493;121;75;44;4;40;.909;3862000;0
10356;202279;121;0;0;0;0;.00nan;0;0
10356;-1;111;0;0;0;0;.00nan;0;0
10357;203412;117;53;23;3;20;.870;3600000;0
10357;199695;120;0;0;0;0;.00nan;0;0
10357;200390;120;55;34;4;30;.882;3581000;0
10357;213504;117;0;0;0;0;.00nan;0;0
10358;200293;126;0;0;0;0;.00nan;0;0
10358;206731;124;56;40;5;35;.875;3570000;0
10358;212039;126;43;29;4;25;.862;3600000;0
10358;203054;124;0;0;0;0;.00nan;0;0
10359;204618;125;42;28;5;23;.821;3600000;0
10359;204630;109;0;0;0;0;.00nan;0;0
10359;201631;109;99;53;2;51;.962;3600000;0
10359;208391;125;0;0;0;0;.00nan;0;0
10360;213845;113;35;30;5;25;.833;3518000;0
10360;210765;113;0;0;0;0;.00nan;0;0
10360;-1;118;0;0;0;0;.00nan;0;0
10360;218830;118;67;28;3;25;.893;3600000;0
10361;210785;123;71;24;1;23;.958;1958000;0
10361;215968;110;87;29;1;28;.966;3600000;0
10361;217985;110;0;0;0;0;.00nan;0;0
10361;-1;123;14;17;6;11;.647;1642000;0
10362;213845;113;0;0;0;0;.00nan;0;0
10362;210765;113;61;28;3;25;.893;3712000;0
10362;210785;123;0;0;0;0;.00nan;0;0
10362;-1;123;72;31;2;29;.935;3712000;0
10363;200210;114;0;0;0;0;.00nan;0;0
10363;210773;111;0;0;0;0;.00nan;0;0
10363;207504;114;61;23;2;21;.913;3900000;0
10363;-1;111;88;43;2;41;.953;3876000;0
10364;206731;124;0;0;0;0;.00nan;0;0
10364;203054;124;91;28;1;27;.964;3600000;0
10364;-1;118;0;0;0;0;.00nan;0;0
10364;218830;118;54;27;4;23;.852;3600000;0
10365;204711;119;45;26;4;22;.846;3600000;0
10365;206864;127;0;0;0;0;.00nan;0;0
10365;202314;127;83;31;1;30;.968;3600000;0
10365;-1;119;0;0;0;0;.00nan;0;0
10366;208620;112;55;20;3;17;.850;3589000;0
10366;200233;108;0;0;0;0;.00nan;0;0
10366;202246;112;0;0;0;0;.00nan;0;0
10366;207535;108;67;23;2;21;.913;3600000;0
10367;200293;126;37;23;5;18;.783;3560000;0
10367;212039;126;0;0;0;0;.00nan;0;0
10367;207493;121;0;0;0;0;.00nan;0;0
10367;202279;121;64;31;3;28;.903;3600000;0
10368;199695;120;52;29;4;25;.862;3557000;0
10368;204618;125;0;0;0;0;.00nan;0;0
10368;200390;120;0;0;0;0;.00nan;0;0
10368;208391;125;68;34;3;31;.912;3600000;0
10369;215968;110;0;0;0;0;.00nan;0;0
10369;202161;115;0;0;0;0;.00nan;0;0
10369;207439;115;64;39;4;35;.897;3900000;0
10369;217985;110;67;36;4;32;.889;3900000;0
10370;199481;122;74;23;1;22;.957;3600000;0
10370;205469;122;0;0;0;0;.00nan;0;0
10370;206864;127;65;36;3;33;.917;3562000;0
10370;202314;127;0;0;0;0;.00nan;0;0
10371;203412;117;95;21;0;21;1.000;3600000;0
10371;204630;109;94;42;2;40;.952;3595000;0
10371;201631;109;0;0;0;0;.00nan;0;0
10371;213504;117;0;0;0;0;.00nan;0;0
10372;213845;113;65;35;4;31;.886;3559000;0
10372;204711;119;0;0;0;0;.00nan;0;0
10372;210765;113;0;0;0;0;.00nan;0;0
10372;-1;119;60;20;2;18;.900;3600000;0
10373;197999;116;0;0;0;0;.00nan;0;0
10373;215968;110;94;23;0;23;1.000;3600000;0
10373;216028;116;60;28;3;25;.893;3600000;0
10373;217985;110;0;0;0;0;.00nan;0;0
10374;208620;112;0;0;0;0;.00nan;0;0
10374;207493;121;0;0;0;0;.00nan;0;0
10374;202246;112;58;31;5;26;.839;3772000;0
10374;202279;121;63;41;4;37;.902;3772000;0
10375;199481;122;69;28;2;26;.929;3600000;0
10375;200210;114;18;33;8;25;.758;3600000;0
10375;205469;122;0;0;0;0;.00nan;0;0
10375;207504;114;0;0;0;0;.00nan;0;0
10376;213845;113;29;42;7;35;.833;3110000;0
10376;203412;117;25;4;3;1;.250;402000;0
10376;210765;113;39;1;1;0;.000;490000;0
10376;213504;117;89;26;1;25;.962;3198000;0
10377;204618;125;53;47;6;41;.872;3600000;0
10377;200233;108;72;25;2;23;.920;3600000;0
10377;207535;108;0;0;0;0;.00nan;0;0
10377;208391;125;0;0;0;0;.00nan;0;0
10378;206731;124;0;0;0;0;.00nan;0;0
10378;202161;115;68;34;4;30;.882;3600000;0
10378;207439;115;0;0;0;0;.00nan;0;0
10378;203054;124;31;23;5;18;.783;3549000;0
10379;197999;116;100;31;0;31;1.000;3600000;0
10379;213845;113;41;38;6;32;.842;3600000;0
10379;210765;113;0;0;0;0;.00nan;0;0
10379;216028;116;0;0;0;0;.00nan;0;0
10380;204618;125;0;0;0;0;.00nan;0;0
10380;210773;111;0;0;0;0;.00nan;0;0
10380;-1;111;46;27;4;23;.852;3552000;0
10380;208391;125;73;33;3;30;.909;3600000;0
10381;204630;109;24;5;3;2;.400;314000;0
10381;200233;108;31;14;4;10;.714;3600000;0
10381;201631;109;74;36;3;33;.917;3256000;0
10381;207535;108;0;0;0;0;.00nan;0;0
10382;200210;114;0;0;0;0;.00nan;0;0
10382;200293;126;0;0;0;0;.00nan;0;0
10382;212039;126;100;28;0;28;1.000;3600000;0
10382;207504;114;59;44;5;39;.886;3600000;0
10383;199481;122;0;0;0;0;.00nan;0;0
10383;199695;120;0;0;0;0;.00nan;0;0
10383;200390;120;66;33;3;30;.909;3600000;0
10383;205469;122;45;24;4;20;.833;3544000;0
10384;204711;119;0;0;0;0;.00nan;0;0
10384;207493;121;50;25;3;22;.880;1954000;0
10384;202279;121;10;16;6;10;.625;1646000;0
10384;-1;119;54;25;3;22;.880;3600000;0
10385;203412;117;36;28;5;23;.821;3527000;0
10385;206731;124;86;45;3;42;.933;3600000;0
10385;213504;117;0;0;0;0;.00nan;0;0
10385;203054;124;0;0;0;0;.00nan;0;0
10386;202161;115;0;0;0;0;.00nan;0;0
10386;207439;115;44;27;5;22;.815;3553000;0
10386;-1;118;0;0;0;0;.00nan;0;0
10386;218830;118;39;15;3;12;.800;3600000;0
10387;208620;112;71;32;2;30;.938;2725000;0
10387;215968;110;54;25;3;22;.880;3600000;0
10387;202246;112;26;11;4;7;.636;875000;0
10387;217985;110;0;0;0;0;.00nan;0;0
10388;213845;113;49;29;5;24;.828;3600000;0
10388;199481;122;100;38;2;36;.947;3600000;0
10388;205469;122;0;0;0;0;.00nan;0;0
10388;210765;113;0;0;0;0;.00nan;0;0
10389;204711;119;66;34;4;30;.882;3600000;0
10389;200293;126;0;0;0;0;.00nan;0;0
10389;212039;126;36;27;5;22;.815;3573000;0
10389;-1;119;0;0;0;0;.00nan;0;0
10390;210773;111;75;37;3;34;.919;3798000;0
10390;-1;111;0;0;0;0;.00nan;0;0
10390;-1;118;91;38;2;36;.947;3785000;0
10390;218830;118;0;0;0;0;.00nan;0;0
10391;208620;112;0;0;0;0;.00nan;0;0
10391;199695;120;29;25;5;20;.800;3543000;0
10391;200390;120;0;0;0;0;.00nan;0;0
10391;202246;112;65;38;4;34;.895;3600000;0
10392;200233;108;0;0;0;0;.00nan;0;0
10392;215968;110;45;7;1;6;.857;768000;0
10392;207535;108;86;29;1;28;.966;3600000;0
10392;217985;110;21;22;6;16;.727;2832000;0
10393;210785;123;84;40;2;38;.950;3547000;0
10393;206864;127;0;0;0;0;.00nan;0;0
10393;202314;127;73;20;1;19;.950;3600000;0
10393;-1;123;0;0;0;0;.00nan;0;0
10394;203412;117;0;0;0;0;.00nan;0;0
10394;202161;115;77;33;3;30;.909;3600000;0
10394;207439;115;0;0;0;0;.00nan;0;0
10394;213504;117;69;18;1;17;.944;3600000;0
10395;204618;125;70;22;1;21;.955;3600000;0
10395;204630;109;66;35;4;31;.886;3600000;0
10395;201631;109;0;0;0;0;.00nan;0;0
10395;208391;125;0;0;0;0;.00nan;0;0
10396;197999;116;78;25;2;23;.920;3600000;0
10396;216028;116;0;0;0;0;.00nan;0;0
10396;206731;124;64;27;3;24;.889;3586000;0
10396;203054;124;0;0;0;0;.00nan;0;0
10397;199695;120;0;0;0;0;.00nan;0;0
10397;200390;120;54;30;4;26;.867;3900000;0
10397;210773;111;0;0;0;0;.00nan;0;0
10397;-1;111;64;29;4;25;.862;3900000;0
10398;204711;119;0;0;0;0;.00nan;0;0
10398;200210;114;35;19;4;15;.789;3600000;0
10398;207504;114;0;0;0;0;.00nan;0;0
10398;-1;119;40;33;5;28;.848;3551000;0
10399;210785;123;0;0;0;0;.00nan;0;0
10399;207493;121;0;0;0;0;.00nan;0;0
10399;202279;121;75;31;2;29;.935;3600000;0
10399;-1;123;64;32;3;29;.906;3600000;0
10400;215968;110;54;33;4;29;.879;3900000;0
10400;217985;110;0;0;0;0;.00nan;0;0
10400;-1;118;0;0;0;0;.00nan;0;0
10400;218830;118;73;56;4;52;.929;3900000;0
10401;199481;122;56;36;4;32;.889;3521000;0
10401;200293;126;0;0;0;0;.00nan;0;0
10401;205469;122;0;0;0;0;.00nan;0;0
10401;212039;126;81;28;2;26;.929;3600000;0
10402;204618;125;66;48;5;43;.896;3600000;0
10402;206731;124;57;26;3;23;.885;3600000;0
10402;203054;124;0;0;0;0;.00nan;0;0
10402;208391;125;0;0;0;0;.00nan;0;0
10403;204711;119;0;0;0;0;.00nan;0;0
10403;202161;115;31;27;5;22;.815;3561000;0
10403;207439;115;0;0;0;0;.00nan;0;0
10403;-1;119;65;31;3;28;.903;3600000;0
10404;197999;116;0;0;0;0;.00nan;0;0
10404;216028;116;85;32;1;31;.969;3600000;0
10404;-1;118;0;0;0;0;.00nan;0;0
10404;218830;118;65;23;3;20;.870;3593000;0
10405;204630;109;17;13;5;8;.615;851000;0
10405;201631;109;82;36;2;34;.944;2749000;0
10405;206864;127;0;0;0;0;.00nan;0;0
10405;202314;127;57;27;3;24;.889;3600000;0
10406;197999;116;79;41;3;38;.927;3900000;0
10406;208620;112;0;0;0;0;.00nan;0;0
10406;216028;116;0;0;0;0;.00nan;0;0
10406;202246;112;44;19;3;16;.842;3900000;0
10407;210773;111;0;0;0;0;.00nan;0;0
10407;215968;110;58;33;4;29;.879;3900000;0
10407;217985;110;0;0;0;0;.00nan;0;0
10407;-1;111;56;30;4;26;.867;3900000;0
10408;213845;113;68;34;4;30;.882;3529000;0
10408;210765;113;0;0;0;0;.00nan;0;0
10408;202161;115;0;0;0;0;.00nan;0;0
10408;207439;115;80;34;2;32;.941;3600000;0
10409;200210;114;0;0;0;0;.00nan;0;0
10409;200233;108;29;35;7;28;.800;3600000;0
10409;207504;114;78;27;1;26;.963;3600000;0
10409;207535;108;0;0;0;0;.00nan;0;0
10410;199481;122;69;32;3;29;.906;3900000;0
10410;204711;119;65;29;3;26;.897;3900000;0
10410;205469;122;0;0;0;0;.00nan;0;0
10410;-1;119;0;0;0;0;.00nan;0;0
10411;204630;109;79;31;2;29;.935;3600000;0
10411;201631;109;0;0;0;0;.00nan;0;0
10411;207493;121;55;23;3;20;.870;3600000;0
10411;202279;121;0;0;0;0;.00nan;0;0
10412;203412;117;85;32;2;30;.938;3600000;0
10412;213504;117;0;0;0;0;.00nan;0;0
10412;-1;118;53;2;0;2;1.000;335000;0
10412;218830;118;29;38;7;31;.816;3265000;0
10413;200293;126;0;0;0;0;.00nan;0;0
10413;212039;126;71;23;2;21;.913;3600000;0
10413;206864;127;27;9;4;5;.556;1125000;0
10413;202314;127;52;26;3;23;.885;2475000;0
10414;204618;125;75;23;1;22;.957;3600000;0
10414;210785;123;85;45;3;42;.933;3571000;0
10414;-1;123;0;0;0;0;.00nan;0;0
10414;208391;125;0;0;0;0;.00nan;0;0
10415;213845;113;0;0;0;0;.00nan;0;0
10415;210765;113;75;25;1;24;.960;3600000;0
10415;210773;111;72;42;4;38;.905;3600000;0
10415;-1;111;0;0;0;0;.00nan;0;0
10416;199481;122;0;0;0;0;.00nan;0;0
10416;199695;120;0;0;0;0;.00nan;0;0
10416;200390;120;48;35;5;30;.857;3600000;0
10416;205469;122;83;24;1;23;.958;3600000;0
10417;204618;125;0;0;0;0;.00nan;0;0
10417;206731;124;0;0;0;0;.00nan;0;0
10417;203054;124;59;23;2;21;.913;3600000;0
10417;208391;125;55;33;4;29;.879;3600000;0
10418;204711;119;0;0;0;0;.00nan;0;0
10418;200233;108;82;16;0;16;1.000;3600000;0
10418;207535;108;0;0;0;0;.00nan;0;0
10418;-1;119;96;61;4;57;.934;3600000;0
10419;200210;114;51;32;6;26;.813;3543000;0
10419;206864;127;60;31;5;26;.839;3600000;0
10419;207504;114;0;0;0;0;.00nan;0;0
10419;202314;127;0;0;0;0;.00nan;0;0
10420;200293;126;48;17;3;14;.824;3600000;0
10420;210785;123;0;0;0;0;.00nan;0;0
10420;212039;126;0;0;0;0;.00nan;0;0
10420;-1;123;40;21;4;17;.810;3600000;0
10421;208620;112;15;18;6;12;.667;2582000;0
10421;202161;115;62;29;3;26;.897;3600000;0
10421;207439;115;0;0;0;0;.00nan;0;0
10421;202246;112;57;4;0;4;1.000;1018000;0
10422;197999;116;0;0;0;0;.00nan;0;0
10422;203412;117;65;21;2;19;.905;3600000;0
10422;216028;116;71;59;6;53;.898;3600000;0
10422;213504;117;0;0;0;0;.00nan;0;0
10423;204630;109;75;30;3;27;.900;3600000;0
10423;201631;109;0;0;0;0;.00nan;0;0
10423;-1;118;34;21;5;16;.762;3600000;0
10423;218830;118;0;0;0;0;.00nan;0;0
10424;200210;114;0;0;0;0;.00nan;0;0
10424;200293;126;0;0;0;0;.00nan;0;0
10424;212039;126;41;25;5;20;.800;3574000;0
10424;207504;114;66;29;3;26;.897;3600000;0
10425;210785;123;44;37;5;32;.865;3558000;0
10425;206731;124;31;17;4;13;.765;3600000;0
10425;-1;123;0;0;0;0;.00nan;0;0
10425;203054;124;0;0;0;0;.00nan;0;0
10426;199695;120;57;42;5;37;.881;3600000;0
10426;200390;120;0;0;0;0;.00nan;0;0
10426;215968;110;81;26;1;25;.962;3600000;0
10426;217985;110;0;0;0;0;.00nan;0;0
10427;208620;112;0;0;0;0;.00nan;0;0
10427;202246;112;87;46;3;43;.935;3900000;0
10427;-1;118;0;0;0;0;.00nan;0;0
10427;218830;118;70;30;3;27;.900;3900000;0
10428;199695;120;0;0;0;0;.00nan;0;0
10428;200390;120;90;29;1;28;.966;3600000;0
10428;206731;124;60;27;3;24;.889;3514000;0
10428;203054;124;0;0;0;0;.00nan;0;0
10429;197999;116;50;38;5;33;.868;3600000;0
10429;203412;117;100;23;0;23;1.000;3600000;0
10429;216028;116;0;0;0;0;.00nan;0;0
10429;213504;117;0;0;0;0;.00nan;0;0
10430;200233;108;58;24;3;21;.875;3600000;0
10430;215968;110;61;36;4;32;.889;3600000;0
10430;207535;108;0;0;0;0;.00nan;0;0
10430;217985;110;0;0;0;0;.00nan;0;0
10431;199481;122;84;36;2;34;.944;3600000;0
10431;205469;122;0;0;0;0;.00nan;0;0
10431;206864;127;0;0;0;0;.00nan;0;0
10431;202314;127;69;36;4;32;.889;3535000;0
10432;204711;119;0;0;0;0;.00nan;0;0
10432;210785;123;0;0;0;0;.00nan;0;0
10432;-1;119;35;34;6;28;.824;3637000;0
10432;-1;123;69;39;5;34;.872;3673000;0
10433;210773;111;0;0;0;0;.00nan;0;0
10433;202161;115;59;27;3;24;.889;3614000;0
10433;207439;115;0;0;0;0;.00nan;0;0
10433;-1;111;69;35;4;31;.886;3614000;0
10434;204630;109;0;0;0;0;.00nan;0;0
10434;201631;109;88;48;2;46;.958;3600000;0
10434;-1;118;0;0;0;0;.00nan;0;0
10434;218830;118;87;16;0;16;1.000;3600000;0
10435;204711;119;70;34;3;31;.912;3557000;0
10435;206731;124;0;0;0;0;.00nan;0;0
10435;-1;119;0;0;0;0;.00nan;0;0
10435;203054;124;49;13;2;11;.846;3600000;0
10436;197999;116;0;0;0;0;.00nan;0;0
10436;199481;122;0;0;0;0;.00nan;0;0
10436;205469;122;57;30;4;26;.867;3748000;0
10436;216028;116;67;36;3;33;.917;3749000;0
10437;208620;112;0;0;0;0;.00nan;0;0
10437;207493;121;58;14;1;13;.929;3600000;0
10437;202246;112;85;42;3;39;.929;3558000;0
10437;202279;121;0;0;0;0;.00nan;0;0
10438;203412;117;33;36;7;29;.806;3310000;0
10438;200210;114;50;38;6;32;.842;3600000;0
10438;207504;114;0;0;0;0;.00nan;0;0
10438;213504;117;50;1;0;1;1.000;290000;0
10439;199695;120;60;39;4;35;.897;3139000;0
10439;200293;126;0;0;0;0;.00nan;0;0
10439;200390;120;25;6;3;3;.500;461000;0
10439;212039;126;64;18;1;17;.944;3600000;0
10440;213845;113;56;23;3;20;.870;3600000;0
10440;210765;113;0;0;0;0;.00nan;0;0
10440;210785;123;68;38;4;34;.895;3600000;0
10440;-1;123;0;0;0;0;.00nan;0;0
10441;200233;108;79;40;3;37;.925;3600000;0
10441;215968;110;0;0;0;0;.00nan;0;0
10441;207535;108;0;0;0;0;.00nan;0;0
10441;217985;110;38;26;5;21;.808;3563000;0
10442;210773;111;83;38;2;36;.947;3588000;0
10442;-1;111;0;0;0;0;.00nan;0;0
10442;-1;118;0;0;0;0;.00nan;0;0
10442;218830;118;98;26;0;26;1.000;3600000;0
10443;197999;116;51;33;5;28;.848;3600000;0
10443;200210;114;0;0;0;0;.00nan;0;0
10443;216028;116;0;0;0;0;.00nan;0;0
10443;207504;114;67;19;1;18;.947;3600000;0
10444;213845;113;56;28;3;25;.893;3600000;0
10444;210765;113;0;0;0;0;.00nan;0;0
10444;206731;124;46;31;5;26;.839;3532000;0
10444;203054;124;0;0;0;0;.00nan;0;0
10445;199695;120;0;0;0;0;.00nan;0;0
10445;200390;120;79;39;4;35;.897;3574000;0
10445;207493;121;65;32;3;29;.906;3600000;0
10445;202279;121;0;0;0;0;.00nan;0;0
10446;204618;125;43;40;6;34;.850;3133000;0
10446;206864;127;45;38;5;33;.868;3191000;0
10446;202314;127;36;10;3;7;.700;581000;0
10446;208391;125;34;12;3;9;.750;639000;0
10447;204630;109;0;0;0;0;.00nan;0;0
10447;201631;109;56;47;5;42;.894;3520000;0
10447;202161;115;71;32;3;29;.906;3600000;0
10447;207439;115;0;0;0;0;.00nan;0;0
10448;204711;119;0;0;0;0;.00nan;0;0
10448;200293;126;0;0;0;0;.00nan;0;0
10448;212039;126;58;12;1;11;.917;3600000;0
10448;-1;119;36;30;5;25;.833;3600000;0
10449;204618;125;0;0;0;0;.00nan;0;0
10449;206864;127;0;0;0;0;.00nan;0;0
10449;202314;127;55;32;4;28;.875;3533000;0
10449;208391;125;72;31;2;29;.935;3600000;0
10450;199481;122;44;34;5;29;.853;3578000;0
10450;205469;122;0;0;0;0;.00nan;0;0
10450;207493;121;79;37;3;34;.919;3600000;0
10450;202279;121;0;0;0;0;.00nan;0;0
10451;208620;112;0;0;0;0;.00nan;0;0
10451;215968;110;89;18;0;18;1.000;3600000;0
10451;202246;112;16;38;9;29;.763;3600000;0
10451;217985;110;0;0;0;0;.00nan;0;0
10452;200293;126;0;0;0;0;.00nan;0;0
10452;210785;123;79;42;3;39;.929;3600000;0
10452;212039;126;44;26;5;21;.808;3577000;0
10452;-1;123;0;0;0;0;.00nan;0;0
10453;199481;122;66;32;4;28;.875;3600000;0
10453;199695;120;0;0;0;0;.00nan;0;0
10453;200390;120;90;33;1;32;.970;3600000;0
10453;205469;122;0;0;0;0;.00nan;0;0
10454;210785;123;36;35;6;29;.829;2931000;0
10454;206731;124;57;26;4;22;.846;3600000;0
10454;-1;123;50;10;1;9;.900;669000;0
10454;203054;124;0;0;0;0;.00nan;0;0
10455;210773;111;0;0;0;0;.00nan;0;0
10455;202161;115;78;32;2;30;.938;3554000;0
10455;207439;115;0;0;0;0;.00nan;0;0
10455;-1;111;93;24;0;24;1.000;3600000;0
10456;197999;116;0;0;0;0;.00nan;0;0
10456;204618;125;30;27;6;21;.778;3600000;0
10456;216028;116;85;33;1;32;.970;3600000;0
10456;208391;125;0;0;0;0;.00nan;0;0
10457;203412;117;35;23;5;18;.783;3600000;0
10457;200210;114;48;46;6;40;.870;3576000;0
10457;207504;114;0;0;0;0;.00nan;0;0
10457;213504;117;0;0;0;0;.00nan;0;0
10458;200233;108;0;0;0;0;.00nan;0;0
10458;200293;126;0;0;0;0;.00nan;0;0
10458;212039;126;76;36;3;33;.917;3549000;0
10458;207535;108;58;18;2;16;.889;3600000;0
10459;206864;127;61;36;5;31;.861;3600000;0
10459;207493;121;41;39;6;33;.846;3218000;0
10459;202279;121;45;6;1;5;.833;325000;0
10459;202314;127;0;0;0;0;.00nan;0;0
10460;208620;112;0;0;0;0;.00nan;0;0
10460;200210;114;0;0;0;0;.00nan;0;0
10460;207504;114;57;30;3;27;.900;3600000;0
10460;202246;112;100;29;0;29;1.000;3600000;0
10461;200293;126;75;24;2;22;.917;3600000;0
10461;210773;111;0;0;0;0;.00nan;0;0
10461;212039;126;0;0;0;0;.00nan;0;0
10461;-1;111;41;49;7;42;.857;3600000;0
10462;204630;109;49;20;3;17;.850;1420000;0
10462;215968;110;52;16;2;14;.875;3600000;0
10462;201631;109;32;29;6;23;.793;2180000;0
10462;217985;110;0;0;0;0;.00nan;0;0
10463;213845;113;48;30;4;26;.867;3600000;0
10463;210765;113;0;0;0;0;.00nan;0;0
10463;202161;115;21;17;5;12;.706;2441000;0
10463;207439;115;22;12;4;8;.667;1159000;0
10464;203412;117;0;0;0;0;.00nan;0;0
10464;204711;119;65;47;5;42;.894;3600000;0
10464;-1;119;0;0;0;0;.00nan;0;0
10464;213504;117;60;22;2;20;.909;3600000;0
10465;199481;122;61;37;4;33;.892;3600000;0
10465;200233;108;85;45;5;40;.889;3574000;0
10465;205469;122;0;0;0;0;.00nan;0;0
10465;207535;108;0;0;0;0;.00nan;0;0
10466;199695;120;0;0;0;0;.00nan;0;0
10466;200390;120;44;24;4;20;.833;3600000;0
10466;207493;121;28;7;3;4;.571;557000;0
10466;202279;121;46;16;3;13;.813;3030000;0
10467;206731;124;79;34;2;32;.941;3553000;0
10467;203054;124;0;0;0;0;.00nan;0;0
10467;-1;118;0;0;0;0;.00nan;0;0
10467;218830;118;100;23;0;23;1.000;3600000;0
10468;208620;112;0;0;0;0;.00nan;0;0
10468;203412;117;89;30;1;29;.967;3600000;0
10468;202246;112;53;25;3;22;.880;3518000;0
10468;213504;117;0;0;0;0;.00nan;0;0
10469;204618;125;52;40;6;34;.850;3327000;0
10469;200210;114;88;34;2;32;.941;3600000;0
10469;207504;114;0;0;0;0;.00nan;0;0
10469;208391;125;52;4;0;4;1.000;273000;0
10470;204711;119;0;0;0;0;.00nan;0;0
10470;206731;124;0;0;0;0;.00nan;0;0
10470;-1;119;51;36;5;31;.861;3600000;0
10470;203054;124;61;33;4;29;.879;3600000;0
10471;213845;113;67;33;3;30;.909;3600000;0
10471;199695;120;53;30;4;26;.867;3600000;0
10471;200390;120;0;0;0;0;.00nan;0;0
10471;210765;113;0;0;0;0;.00nan;0;0
10472;207493;121;76;38;2;36;.947;3570000;0
10472;202279;121;0;0;0;0;.00nan;0;0
10472;-1;118;0;0;0;0;.00nan;0;0
10472;218830;118;86;26;1;25;.962;3600000;0
10473;204630;109;0;0;0;0;.00nan;0;0
10473;215968;110;58;16;1;15;.938;3600000;0
10473;201631;109;98;55;3;52;.945;3588000;0
10473;217985;110;0;0;0;0;.00nan;0;0
10474;210785;123;62;28;3;25;.893;3554000;0
10474;206864;127;0;0;0;0;.00nan;0;0
10474;202314;127;63;25;2;23;.920;3600000;0
10474;-1;123;0;0;0;0;.00nan;0;0
10475;197999;116;72;31;3;28;.903;3600000;0
10475;216028;116;0;0;0;0;.00nan;0;0
10475;202161;115;0;0;0;0;.00nan;0;0
10475;207439;115;31;33;6;27;.818;3600000;0
10476;204630;109;74;49;4;45;.918;3600000;0
10476;200293;126;0;0;0;0;.00nan;0;0
10476;201631;109;0;0;0;0;.00nan;0;0
10476;212039;126;78;13;0;13;1.000;3600000;0
10477;199481;122;59;36;4;32;.889;3600000;0
10477;204618;125;59;6;0;6;1.000;493000;0
10477;205469;122;0;0;0;0;.00nan;0;0
10477;208391;125;37;32;6;26;.813;3023000;0
10478;208620;112;40;29;5;24;.828;3600000;0
10478;200233;108;92;24;0;24;1.000;3600000;0
10478;202246;112;0;0;0;0;.00nan;0;0
10478;207535;108;0;0;0;0;.00nan;0;0
10479;210785;123;0;0;0;0;.00nan;0;0
10479;206864;127;82;29;1;28;.966;3600000;0
10479;202314;127;0;0;0;0;.00nan;0;0
10479;-1;123;84;42;2;40;.952;3600000;0
10480;210773;111;0;0;0;0;.00nan;0;0
10480;215968;110;0;0;0;0;.00nan;0;0
10480;217985;110;42;30;5;25;.833;3600000;0
10480;-1;111;92;29;1;28;.966;3600000;0
10481;204630;109;0;0;0;0;.00nan;0;0
10481;210773;111;51;7;1;6;.857;1254000;0
10481;201631;109;49;40;6;34;.850;3611000;0
10481;-1;111;19;23;6;17;.739;2357000;0
10482;207493;121;56;36;4;32;.889;3600000;0
10482;202279;121;0;0;0;0;.00nan;0;0
10482;-1;118;0;0;0;0;.00nan;0;0
10482;218830;118;32;23;5;18;.783;3557000;0
10483;208620;112;0;0;0;0;.00nan;0;0
10483;200293;126;0;0;0;0;.00nan;0;0
10483;212039;126;77;27;2;25;.926;3600000;0
10483;202246;112;50;26;4;22;.846;3549000;0
10484;203412;117;47;25;4;21;.840;3600000;0
10484;204618;125;42;37;6;31;.838;2617000;0
10484;213504;117;0;0;0;0;.00nan;0;0
10484;208391;125;51;22;3;19;.864;983000;0
10485;197999;116;0;0;0;0;.00nan;0;0
10485;200233;108;29;21;5;16;.762;3515000;0
10485;216028;116;87;36;3;33;.917;3600000;0
10485;207535;108;0;0;0;0;.00nan;0;0
10486;200210;114;97;42;2;40;.952;3900000;0
10486;202161;115;76;29;2;27;.931;3900000;0
10486;207439;115;0;0;0;0;.00nan;0;0
10486;207504;114;0;0;0;0;.00nan;0;0
10487;199695;120;0;0;0;0;.00nan;0;0
10487;200390;120;80;24;1;23;.958;3600000;0
10487;206864;127;52;2;0;2;1.000;470000;0
10487;202314;127;34;30;6;24;.800;3130000;0
10488;213845;113;22;27;6;21;.778;3600000;0
10488;210765;113;0;0;0;0;.00nan;0;0
10488;210773;111;0;0;0;0;.00nan;0;0
10488;-1;111;96;19;0;19;1.000;3600000;0
10489;208620;112;0;0;0;0;.00nan;0;0
10489;204630;109;0;0;0;0;.00nan;0;0
10489;201631;109;83;42;4;38;.905;3895000;0
10489;202246;112;31;16;4;12;.750;3900000;0
10490;204711;119;83;39;3;36;.923;3600000;0
10490;210785;123;51;35;5;30;.857;3564000;0
10490;-1;119;0;0;0;0;.00nan;0;0
10490;-1;123;0;0;0;0;.00nan;0;0
10491;199481;122;100;28;0;28;1.000;3600000;0
10491;205469;122;0;0;0;0;.00nan;0;0
10491;206864;127;52;24;3;21;.875;3600000;0
10491;202314;127;0;0;0;0;.00nan;0;0
10492;206731;124;69;26;2;24;.923;3600000;0
10492;207493;121;53;4;0;4;1.000;344000;0
10492;202279;121;43;35;6;29;.829;3256000;0
10492;203054;124;0;0;0;0;.00nan;0;0
10493;203412;117;41;37;6;31;.838;3600000;0
10493;200233;108;80;29;2;27;.931;3600000;0
10493;207535;108;0;0;0;0;.00nan;0;0
10493;213504;117;0;0;0;0;.00nan;0;0
10494;199695;120;81;51;4;47;.922;3600000;0
10494;200293;126;0;0;0;0;.00nan;0;0
10494;200390;120;0;0;0;0;.00nan;0;0
10494;212039;126;55;22;3;19;.864;3600000;0
10495;197999;116;25;20;6;14;.700;3756000;0
10495;204618;125;0;0;0;0;.00nan;0;0
10495;216028;116;0;0;0;0;.00nan;0;0
10495;208391;125;50;31;5;26;.839;3756000;0
10496;200210;114;0;0;0;0;.00nan;0;0
10496;207504;114;72;23;1;22;.957;3600000;0
10496;-1;118;82;35;3;32;.914;3514000;0
10496;218830;118;0;0;0;0;.00nan;0;0
10497;213845;113;68;20;1;19;.950;3600000;0
10497;204630;109;68;37;3;34;.919;3600000;0
10497;210765;113;0;0;0;0;.00nan;0;0
10497;201631;109;0;0;0;0;.00nan;0;0
10498;208620;112;0;0;0;0;.00nan;0;0
10498;210773;111;0;0;0;0;.00nan;0;0
10498;202246;112;77;40;3;37;.925;3513000;0
10498;-1;111;66;21;1;20;.952;3600000;0
10499;200210;114;65;20;2;18;.900;3600000;0
10499;210785;123;41;2;1;1;.500;433000;0
10499;207504;114;0;0;0;0;.00nan;0;0
10499;-1;123;35;32;6;26;.813;3167000;0
10500;199695;120;0;0;0;0;.00nan;0;0
10500;200390;120;92;44;3;41;.932;3900000;0
10500;206731;124;0;0;0;0;.00nan;0;0
10500;203054;124;56;29;3;26;.897;3900000;0
10501;204711;119;0;0;0;0;.00nan;0;0
10501;207493;121;58;38;5;33;.868;3543000;0
10501;202279;121;0;0;0;0;.00nan;0;0
10501;-1;119;37;18;4;14;.778;3600000;0
10502;199481;122;72;29;2;27;.931;3600000;0
10502;205469;122;0;0;0;0;.00nan;0;0
10502;206864;127;0;0;0;0;.00nan;0;0
10502;202314;127;80;48;4;44;.917;3562000;0
10503;202161;115;85;54;6;48;.889;3682000;0
10503;207439;115;0;0;0;0;.00nan;0;0
10503;-1;118;0;0;0;0;.00nan;0;0
10503;218830;118;38;31;5;26;.839;3682000;0
10504;197999;116;0;0;0;0;.00nan;0;0
10504;203412;117;66;18;1;17;.944;3600000;0
10504;216028;116;55;47;6;41;.872;3600000;0
10504;213504;117;0;0;0;0;.00nan;0;0
10505;200233;108;20;39;8;31;.795;3600000;0
10505;215968;110;80;25;2;23;.920;3600000;0
10505;207535;108;0;0;0;0;.00nan;0;0
10505;217985;110;0;0;0;0;.00nan;0;0
10506;200293;126;0;0;0;0;.00nan;0;0
10506;206731;124;63;39;4;35;.897;3600000;0
10506;212039;126;64;15;1;14;.933;3600000;0
10506;203054;124;0;0;0;0;.00nan;0;0
10507;199481;122;0;0;0;0;.00nan;0;0
10507;204711;119;0;0;0;0;.00nan;0;0
10507;205469;122;68;24;2;22;.917;3600000;0
10507;-1;119;54;32;4;28;.875;3564000;0
10508;210785;123;84;35;3;32;.914;3561000;0
10508;206731;124;72;23;1;22;.957;3600000;0
10508;-1;123;0;0;0;0;.00nan;0;0
10508;203054;124;0;0;0;0;.00nan;0;0
10509;199695;120;0;0;0;0;.00nan;0;0
10509;200390;120;46;26;4;22;.846;3556000;0
10509;202161;115;86;35;2;33;.943;3600000;0
10509;207439;115;0;0;0;0;.00nan;0;0
10510;197999;116;70;18;1;17;.944;3600000;0
10510;216028;116;0;0;0;0;.00nan;0;0
10510;207493;121;88;35;2;33;.943;3562000;0
10510;202279;121;0;0;0;0;.00nan;0;0
10511;208620;112;0;0;0;0;.00nan;0;0
10511;200210;114;92;35;1;34;.971;3857000;0
10511;207504;114;0;0;0;0;.00nan;0;0
10511;202246;112;92;37;2;35;.946;3857000;0
10512;204618;125;93;30;3;27;.900;3900000;0
10512;204711;119;68;24;3;21;.875;3900000;0
10512;-1;119;0;0;0;0;.00nan;0;0
10512;208391;125;0;0;0;0;.00nan;0;0
10513;200233;108;0;0;0;0;.00nan;0;0
10513;206864;127;0;0;0;0;.00nan;0;0
10513;207535;108;81;23;1;22;.957;3600000;0
10513;202314;127;74;42;3;39;.929;3527000;0
10514;208620;112;24;5;3;2;.400;391000;0
10514;204618;125;0;0;0;0;.00nan;0;0
10514;202246;112;55;20;2;18;.900;3480000;0
10514;208391;125;57;38;6;32;.842;3871000;0
10515;210773;111;0;0;0;0;.00nan;0;0
10515;206864;127;43;32;6;26;.813;3600000;0
10515;202314;127;0;0;0;0;.00nan;0;0
10515;-1;111;88;31;1;30;.968;3600000;0
10516;213845;113;52;33;5;28;.848;3559000;0
10516;200233;108;44;24;4;20;.833;3600000;0
10516;210765;113;0;0;0;0;.00nan;0;0
10516;207535;108;0;0;0;0;.00nan;0;0
10517;199481;122;77;38;3;35;.921;3600000;0
10517;199695;120;0;0;0;0;.00nan;0;0
10517;200390;120;39;34;6;28;.824;3600000;0
10517;205469;122;0;0;0;0;.00nan;0;0
10518;203412;117;56;24;3;21;.875;3600000;0
10518;207493;121;0;0;0;0;.00nan;0;0
10518;202279;121;44;34;5;29;.853;3539000;0
10518;213504;117;0;0;0;0;.00nan;0;0
10519;197999;116;0;0;0;0;.00nan;0;0
10519;216028;116;93;36;1;35;.972;3600000;0
10519;-1;118;0;0;0;0;.00nan;0;0
10519;218830;118;66;28;2;26;.929;3600000;0
10520;204630;109;67;44;5;39;.886;3600000;0
10520;215968;110;74;32;2;30;.938;3600000;0
10520;201631;109;0;0;0;0;.00nan;0;0
10520;217985;110;0;0;0;0;.00nan;0;0
10521;204630;109;0;0;0;0;.00nan;0;0
10521;215968;110;73;16;1;15;.938;3600000;0
10521;201631;109;62;46;5;41;.891;3600000;0
10521;217985;110;0;0;0;0;.00nan;0;0
10522;199481;122;0;0;0;0;.00nan;0;0
10522;205469;122;55;48;6;42;.875;3576000;0
10522;-1;118;48;23;4;19;.826;3600000;0
10522;218830;118;0;0;0;0;.00nan;0;0
10523;200210;114;73;28;3;25;.893;3600000;0
10523;206731;124;0;0;0;0;.00nan;0;0
10523;207504;114;0;0;0;0;.00nan;0;0
10523;203054;124;55;37;4;33;.892;3600000;0
10524;213845;113;20;17;6;11;.647;1580000;0
10524;204711;119;55;28;4;24;.857;3600000;0
10524;210765;113;81;18;0;18;1.000;2006000;0
10524;-1;119;0;0;0;0;.00nan;0;0
10525;197999;116;58;28;4;24;.857;3600000;0
10525;199695;120;43;34;5;29;.853;3600000;0
10525;200390;120;0;0;0;0;.00nan;0;0
10525;216028;116;0;0;0;0;.00nan;0;0
10526;200293;126;0;0;0;0;.00nan;0;0
10526;210785;123;67;50;5;45;.900;3554000;0
10526;212039;126;47;13;3;10;.769;3600000;0
10526;-1;123;0;0;0;0;.00nan;0;0
10527;202161;115;93;32;2;30;.938;3600000;0
10527;207439;115;0;0;0;0;.00nan;0;0
10527;207493;121;47;38;6;32;.842;2846000;0
10527;202279;121;70;13;0;13;1.000;754000;0
10528;208620;112;0;0;0;0;.00nan;0;0
10528;210773;111;0;0;0;0;.00nan;0;0
10528;202246;112;66;28;3;25;.893;3600000;0
10528;-1;111;100;20;0;20;1.000;3600000;0
10529;204630;109;69;34;3;31;.912;3571000;0
10529;201631;109;0;0;0;0;.00nan;0;0
10529;206864;127;0;0;0;0;.00nan;0;0
10529;202314;127;81;29;1;28;.966;3600000;0
10530;200293;126;88;31;1;30;.968;3600000;0
10530;212039;126;0;0;0;0;.00nan;0;0
10530;-1;118;0;0;0;0;.00nan;0;0
10530;218830;118;63;43;4;39;.907;3600000;0
10531;213845;113;0;0;0;0;.00nan;0;0
10531;204618;125;46;29;4;25;.862;3580000;0
10531;210765;113;72;31;2;29;.935;3600000;0
10531;208391;125;0;0;0;0;.00nan;0;0
10532;199481;122;92;40;2;38;.950;3561000;0
10532;205469;122;0;0;0;0;.00nan;0;0
10532;206731;124;72;23;1;22;.957;3600000;0
10532;203054;124;0;0;0;0;.00nan;0;0
10533;200210;114;0;0;0;0;.00nan;0;0
10533;210785;123;0;0;0;0;.00nan;0;0
10533;207504;114;44;18;3;15;.833;3600000;0
10533;-1;123;40;38;6;32;.842;3574000;0
10534;203412;117;93;35;1;34;.971;3600000;0
10534;215968;110;0;0;0;0;.00nan;0;0
10534;217985;110;49;30;4;26;.867;3600000;0
10534;213504;117;0;0;0;0;.00nan;0;0
10535;203412;117;73;47;5;42;.894;3765000;0
10535;200233;108;72;35;4;31;.886;3765000;0
10535;207535;108;0;0;0;0;.00nan;0;0
10535;213504;117;0;0;0;0;.00nan;0;0
10536;204630;109;0;0;0;0;.00nan;0;0
10536;210773;111;0;0;0;0;.00nan;0;0
10536;201631;109;76;38;3;35;.921;3600000;0
10536;-1;111;76;25;1;24;.960;3600000;0
10537;213845;113;38;43;7;36;.837;3231000;0
10537;210765;113;58;5;0;5;1.000;369000;0
10537;-1;118;0;0;0;0;.00nan;0;0
10537;218830;118;58;23;3;20;.870;3600000;0
10538;208620;112;0;0;0;0;.00nan;0;0
10538;200210;114;46;34;5;29;.853;3900000;0
10538;207504;114;0;0;0;0;.00nan;0;0
10538;202246;112;56;34;5;29;.853;3900000;0
10539;199481;122;100;27;0;27;1.000;3600000;0
10539;204711;119;49;36;6;30;.833;3600000;0
10539;205469;122;0;0;0;0;.00nan;0;0
10539;-1;119;0;0;0;0;.00nan;0;0
10540;204618;125;51;28;3;25;.893;3570000;0
10540;210785;123;77;36;2;34;.944;3600000;0
10540;-1;123;0;0;0;0;.00nan;0;0
10540;208391;125;0;0;0;0;.00nan;0;0
10541;206864;127;0;0;0;0;.00nan;0;0
10541;202161;115;49;22;4;18;.818;3547000;0
10541;207439;115;0;0;0;0;.00nan;0;0
10541;202314;127;75;31;3;28;.903;3600000;0
10542;200233;108;62;34;4;30;.882;3545000;0
10542;206731;124;50;21;3;18;.857;3600000;0
10542;207535;108;0;0;0;0;.00nan;0;0
10542;203054;124;0;0;0;0;.00nan;0;0
10543;197999;116;0;0;0;0;.00nan;0;0
10543;210773;111;0;0;0;0;.00nan;0;0
10543;216028;116;45;24;5;19;.792;3900000;0
10543;-1;111;52;37;5;32;.865;3885000;0
10544;199481;122;47;41;5;36;.878;3559000;0
10544;200210;114;0;0;0;0;.00nan;0;0
10544;205469;122;0;0;0;0;.00nan;0;0
10544;207504;114;67;39;4;35;.897;3600000;0
10545;213845;113;67;34;3;31;.912;3600000;0
10545;210765;113;0;0;0;0;.00nan;0;0
10545;207493;121;38;23;5;18;.783;3600000;0
10545;202279;121;0;0;0;0;.00nan;0;0
10546;203412;117;76;32;3;29;.906;3600000;0
10546;202161;115;48;24;4;20;.833;2110000;0
10546;207439;115;50;19;3;16;.842;1490000;0
10546;213504;117;0;0;0;0;.00nan;0;0
10547;208620;112;42;3;1;2;.667;312000;0
10547;200293;126;0;0;0;0;.00nan;0;0
10547;212039;126;87;26;1;25;.962;3600000;0
10547;202246;112;42;31;6;25;.806;3288000;0
10548;204618;125;77;27;2;25;.926;3600000;0
10548;210785;123;0;0;0;0;.00nan;0;0
10548;-1;123;64;35;5;30;.857;3600000;0
10548;208391;125;0;0;0;0;.00nan;0;0
10549;206864;127;79;29;2;27;.931;3600000;0
10549;202314;127;0;0;0;0;.00nan;0;0
10549;-1;118;0;0;0;0;.00nan;0;0
10549;218830;118;62;27;3;24;.889;3600000;0
10550;204630;109;34;12;3;9;.750;1394000;0
10550;206731;124;0;0;0;0;.00nan;0;0
10550;201631;109;26;30;7;23;.767;2206000;0
10550;203054;124;61;29;3;26;.897;3600000;0
10551;208620;112;77;41;3;38;.927;3600000;0
10551;215968;110;72;26;2;24;.923;3600000;0
10551;202246;112;0;0;0;0;.00nan;0;0
10551;217985;110;0;0;0;0;.00nan;0;0
10552;199695;120;0;0;0;0;.00nan;0;0
10552;204711;119;0;0;0;0;.00nan;0;0
10552;200390;120;63;36;4;32;.889;3900000;0
10552;-1;119;51;30;4;26;.867;3900000;0
10553;197999;116;32;33;6;27;.818;3600000;0
10553;200233;108;64;21;3;18;.857;3600000;0
10553;216028;116;0;0;0;0;.00nan;0;0
10553;207535;108;0;0;0;0;.00nan;0;0
10554;210785;123;77;23;1;22;.957;3600000;0
10554;207493;121;0;0;0;0;.00nan;0;0
10554;202279;121;60;38;5;33;.868;3600000;0
10554;-1;123;0;0;0;0;.00nan;0;0
10555;204618;125;53;2;0;2;1.000;277000;0
10555;202161;115;79;26;1;25;.962;3600000;0
10555;207439;115;0;0;0;0;.00nan;0;0
10555;208391;125;40;33;6;27;.818;3323000;0
10556;210773;111;0;0;0;0;.00nan;0;0
10556;206731;124;58;33;4;29;.879;3900000;0
10556;-1;111;37;25;4;21;.840;3900000;0
10556;203054;124;0;0;0;0;.00nan;0;0
10557;197999;116;0;0;0;0;.00nan;0;0
10557;204630;109;61;39;5;34;.872;3600000;0
10557;216028;116;73;20;1;19;.950;3600000;0
10557;201631;109;0;0;0;0;.00nan;0;0
10558;213845;113;60;44;5;39;.886;3600000;0
10558;203412;117;60;24;2;22;.917;3600000;0
10558;210765;113;0;0;0;0;.00nan;0;0
10558;213504;117;0;0;0;0;.00nan;0;0
10559;200210;114;43;29;5;24;.828;3598000;0
10559;200233;108;0;0;0;0;.00nan;0;0
10559;207504;114;0;0;0;0;.00nan;0;0
10559;207535;108;74;31;3;28;.903;3600000;0
10560;215968;110;66;41;5;36;.878;3600000;0
10560;217985;110;0;0;0;0;.00nan;0;0
10560;-1;118;87;19;0;19;1.000;3600000;0
10560;218830;118;0;0;0;0;.00nan;0;0
10561;199695;120;0;0;0;0;.00nan;0;0
10561;204711;119;51;22;3;19;.864;3584000;0
10561;200390;120;80;32;2;30;.938;3600000;0
10561;-1;119;0;0;0;0;.00nan;0;0
10562;199481;122;77;44;5;39;.886;3600000;0
10562;200293;126;0;0;0;0;.00nan;0;0
10562;205469;122;0;0;0;0;.00nan;0;0
10562;212039;126;63;18;1;17;.944;3600000;0
10563;199481;122;94;37;2;35;.946;3600000;0
10563;205469;122;0;0;0;0;.00nan;0;0
10563;-1;118;10;31;8;23;.742;3600000;0
10563;218830;118;0;0;0;0;.00nan;0;0
10564;200293;126;0;0;0;0;.00nan;0;0
10564;212039;126;69;28;3;25;.893;3600000;0
10564;207493;121;46;5;1;4;.800;354000;0
10564;202279;121;48;49;6;43;.878;3246000;0
10565;204630;109;66;25;2;23;.920;3102000;0
10565;215968;110;60;26;3;23;.885;3600000;0
10565;201631;109;28;7;3;4;.571;448000;0
10565;217985;110;0;0;0;0;.00nan;0;0
10566;203412;117;79;31;2;29;.935;3600000;0
10566;204618;125;74;38;3;35;.921;3550000;0
10566;213504;117;0;0;0;0;.00nan;0;0
10566;208391;125;0;0;0;0;.00nan;0;0
10567;200293;126;0;0;0;0;.00nan;0;0
10567;212039;126;65;26;3;23;.885;3600000;0
10567;202161;115;48;40;7;33;.825;3208000;0
10567;207439;115;48;0;0;0;.00nan;392000;0
10568;197999;116;0;0;0;0;.00nan;0;0
10568;210773;111;19;15;5;10;.667;1736000;0
10568;216028;116;71;26;2;24;.923;3600000;0
10568;-1;111;35;21;4;17;.810;1864000;0
10569;204711;119;0;0;0;0;.00nan;0;0
10569;200210;114;81;33;3;30;.909;3600000;0
10569;207504;114;0;0;0;0;.00nan;0;0
10569;-1;119;83;27;1;26;.963;3600000;0
10570;208620;112;0;0;0;0;.00nan;0;0
10570;200233;108;63;27;3;24;.889;3900000;0
10570;202246;112;69;39;3;36;.923;3900000;0
10570;207535;108;0;0;0;0;.00nan;0;0
10571;206864;127;0;0;0;0;.00nan;0;0
10571;202161;115;0;0;0;0;.00nan;0;0
10571;207439;115;62;23;2;21;.913;3600000;0
10571;202314;127;70;24;3;21;.875;3548000;0
10572;204630;109;79;32;2;30;.938;3600000;0
10572;200233;108;0;0;0;0;.00nan;0;0
10572;201631;109;0;0;0;0;.00nan;0;0
10572;207535;108;39;16;3;13;.813;3544000;0
10573;197999;116;43;31;5;26;.839;3600000;0
10573;213845;113;66;26;2;24;.923;3600000;0
10573;210765;113;0;0;0;0;.00nan;0;0
10573;216028;116;0;0;0;0;.00nan;0;0
10574;208620;112;90;39;2;37;.949;3600000;0
10574;199481;122;59;26;3;23;.885;3550000;0
10574;205469;122;0;0;0;0;.00nan;0;0
10574;202246;112;0;0;0;0;.00nan;0;0
10575;210785;123;61;8;0;8;1.000;673000;0
10575;207493;121;59;20;3;17;.850;3600000;0
10575;202279;121;0;0;0;0;.00nan;0;0
10575;-1;123;51;40;6;34;.850;2927000;0
10576;203412;117;76;28;2;26;.929;3600000;0
10576;200210;114;40;7;2;5;.714;628000;0
10576;207504;114;28;30;7;23;.767;2972000;0
10576;213504;117;0;0;0;0;.00nan;0;0
10577;204618;125;84;36;2;34;.944;3600000;0
10577;210773;111;0;0;0;0;.00nan;0;0
10577;-1;111;68;32;3;29;.906;3586000;0
10577;208391;125;0;0;0;0;.00nan;0;0
10578;199695;120;48;0;0;0;.00nan;384000;0
10578;200390;120;9;24;7;17;.708;3216000;0
10578;-1;118;0;0;0;0;.00nan;0;0
10578;218830;118;56;38;4;34;.895;3600000;0
10579;208620;112;0;0;0;0;.00nan;0;0
10579;199481;122;0;0;0;0;.00nan;0;0
10579;205469;122;56;27;4;23;.852;3548000;0
10579;202246;112;72;31;3;28;.903;3600000;0
10580;210785;123;80;46;4;42;.913;3634000;0
10580;206731;124;0;0;0;0;.00nan;0;0
10580;-1;123;0;0;0;0;.00nan;0;0
10580;203054;124;46;28;5;23;.821;3634000;0
10581;204711;119;0;0;0;0;.00nan;0;0
10581;-1;119;73;27;2;25;.926;3600000;0
10581;-1;118;43;36;6;30;.833;2729000;0
10581;218830;118;52;10;1;9;.900;871000;0
10582;199695;120;62;47;6;41;.872;3600000;0
10582;200293;126;0;0;0;0;.00nan;0;0
10582;200390;120;0;0;0;0;.00nan;0;0
10582;212039;126;83;28;2;26;.929;3600000;0
10583;215968;110;53;42;6;36;.857;3600000;0
10583;206864;127;0;0;0;0;.00nan;0;0
10583;217985;110;0;0;0;0;.00nan;0;0
10583;202314;127;50;36;5;31;.861;3600000;0
10584;213845;113;0;0;0;0;.00nan;0;0
10584;210765;113;61;23;2;21;.913;3577000;0
10584;202161;115;77;21;1;20;.952;3600000;0
10584;207439;115;0;0;0;0;.00nan;0;0
10585;204630;109;94;57;4;53;.930;3761000;0
10585;200233;108;65;21;3;18;.857;3794000;0
10585;201631;109;0;0;0;0;.00nan;0;0
10585;207535;108;0;0;0;0;.00nan;0;0
10586;203412;117;75;39;3;36;.923;3600000;0
10586;210773;111;0;0;0;0;.00nan;0;0
10586;-1;111;15;36;8;28;.778;3600000;0
10586;213504;117;0;0;0;0;.00nan;0;0
10587;200293;126;98;21;0;21;1.000;3600000;0
10587;215968;110;46;28;4;24;.857;3600000;0
10587;212039;126;0;0;0;0;.00nan;0;0
10587;217985;110;0;0;0;0;.00nan;0;0
10588;204618;125;60;21;2;19;.905;2346000;0
10588;207493;121;57;37;4;33;.892;3600000;0
10588;202279;121;0;0;0;0;.00nan;0;0
10588;208391;125;26;13;4;9;.692;1173000;0
10589;213845;113;8;32;8;24;.750;3198000;0
10589;200210;114;78;27;1;26;.963;3600000;0
10589;210765;113;53;4;0;4;1.000;402000;0
10589;207504;114;0;0;0;0;.00nan;0;0
10590;199481;122;97;42;2;40;.952;3900000;0
10590;205469;122;0;0;0;0;.00nan;0;0
10590;-1;118;0;0;0;0;.00nan;0;0
10590;218830;118;80;35;2;33;.943;3900000;0
10591;206731;124;67;33;3;30;.909;3600000;0
10591;206864;127;60;42;5;37;.881;3564000;0
10591;202314;127;0;0;0;0;.00nan;0;0
10591;203054;124;0;0;0;0;.00nan;0;0
10592;197999;116;0;0;0;0;.00nan;0;0
10592;204618;125;21;35;8;27;.771;2989000;0
10592;216028;116;60;28;4;24;.857;3600000;0
10592;208391;125;46;5;1;4;.800;611000;0
10593;199695;120;0;0;0;0;.00nan;0;0
10593;200390;120;61;27;3;24;.889;3600000;0
10593;-1;118;0;0;0;0;.00nan;0;0
10593;218830;118;15;21;6;15;.714;3580000;0
10594;213845;113;53;37;4;33;.892;3600000;0
10594;210765;113;0;0;0;0;.00nan;0;0
10594;215968;110;67;16;1;15;.938;3600000;0
10594;217985;110;0;0;0;0;.00nan;0;0
10595;204630;109;61;45;6;39;.867;3600000;0
10595;200210;114;92;31;1;30;.968;3600000;0
10595;201631;109;0;0;0;0;.00nan;0;0
10595;207504;114;0;0;0;0;.00nan;0;0
10596;200233;108;41;21;5;16;.762;3650000;0
10596;210773;111;0;0;0;0;.00nan;0;0
10596;207535;108;0;0;0;0;.00nan;0;0
10596;-1;111;56;30;4;26;.867;3650000;0
10597;206864;127;0;0;0;0;.00nan;0;0
10597;207493;121;83;34;2;32;.941;3600000;0
10597;202279;121;0;0;0;0;.00nan;0;0
10597;202314;127;63;34;3;31;.912;3574000;0
10598;210785;123;0;0;0;0;.00nan;0;0
10598;206731;124;0;0;0;0;.00nan;0;0
10598;-1;123;85;43;3;40;.930;3600000;0
10598;203054;124;54;32;4;28;.875;3586000;0
10599;208620;112;0;0;0;0;.00nan;0;0
10599;202161;115;28;29;6;23;.793;2536000;0
10599;207439;115;50;7;1;6;.857;1064000;0
10599;202246;112;35;26;5;21;.808;3600000;0
10600;200210;114;63;14;1;13;.929;3010000;0
10600;210773;111;33;23;5;18;.783;2065000;0
10600;207504;114;28;6;3;3;.500;590000;0
10600;-1;111;56;12;1;11;.917;1457000;0
10601;213845;113;17;24;6;18;.750;1729000;0
10601;210765;113;27;15;4;11;.733;1871000;0
10601;215968;110;89;31;1;30;.968;3600000;0
10601;217985;110;0;0;0;0;.00nan;0;0
10602;203412;117;49;26;4;22;.846;3553000;0
10602;206731;124;92;49;3;46;.939;3600000;0
10602;213504;117;0;0;0;0;.00nan;0;0
10602;203054;124;0;0;0;0;.00nan;0;0
10603;197999;116;58;24;2;22;.917;3900000;0
10603;204711;119;70;24;2;22;.917;3900000;0
10603;216028;116;0;0;0;0;.00nan;0;0
10603;-1;119;0;0;0;0;.00nan;0;0
10604;199481;122;55;36;5;31;.861;3554000;0
10604;204618;125;70;38;4;34;.895;3600000;0
10604;205469;122;0;0;0;0;.00nan;0;0
10604;208391;125;0;0;0;0;.00nan;0;0
10605;199695;120;0;0;0;0;.00nan;0;0
10605;200390;120;63;26;3;23;.885;3600000;0
10605;207493;121;0;0;0;0;.00nan;0;0
10605;202279;121;73;41;4;37;.902;3564000;0
10606;200293;126;68;16;1;15;.938;3600000;0
10606;210785;123;66;44;4;40;.909;3600000;0
10606;212039;126;0;0;0;0;.00nan;0;0
10606;-1;123;0;0;0;0;.00nan;0;0
10607;200233;108;64;31;3;28;.903;3600000;0
10607;207535;108;0;0;0;0;.00nan;0;0
10607;-1;118;0;0;0;0;.00nan;0;0
10607;218830;118;54;33;4;29;.879;3600000;0
10608;204618;125;0;0;0;0;.00nan;0;0
10608;208391;125;48;39;5;34;.872;3562000;0
10608;-1;118;62;28;3;25;.893;3600000;0
10608;218830;118;0;0;0;0;.00nan;0;0
10609;197999;116;0;0;0;0;.00nan;0;0
10609;200210;114;0;0;0;0;.00nan;0;0
10609;216028;116;44;31;5;26;.839;3600000;0
10609;207504;114;72;22;1;21;.955;3600000;0
10610;200293;126;0;0;0;0;.00nan;0;0
10610;206731;124;0;0;0;0;.00nan;0;0
10610;212039;126;62;24;3;21;.875;3545000;0
10610;203054;124;83;41;2;39;.951;3600000;0
10611;204630;109;61;39;5;34;.872;3600000;0
10611;204711;119;0;0;0;0;.00nan;0;0
10611;201631;109;0;0;0;0;.00nan;0;0
10611;-1;119;93;19;0;19;1.000;3600000;0
10612;199695;120;58;46;6;40;.870;3573000;0
10612;200390;120;0;0;0;0;.00nan;0;0
10612;206864;127;0;0;0;0;.00nan;0;0
10612;202314;127;50;37;5;32;.865;3600000;0
10613;203412;117;0;0;0;0;.00nan;0;0
10613;210785;123;0;0;0;0;.00nan;0;0
10613;-1;123;87;46;3;43;.935;3600000;0
10613;213504;117;97;26;0;26;1.000;3600000;0
10614;199481;122;0;0;0;0;.00nan;0;0
10614;205469;122;90;42;3;39;.929;3553000;0
10614;202161;115;0;0;0;0;.00nan;0;0
10614;207439;115;72;25;1;24;.960;3600000;0
10615;208620;112;0;0;0;0;.00nan;0;0
10615;210773;111;0;0;0;0;.00nan;0;0
10615;202246;112;48;25;3;22;.880;3900000;0
10615;-1;111;74;36;3;33;.917;3900000;0
10616;213845;113;99;29;0;29;1.000;3600000;0
10616;204630;109;51;30;4;26;.867;3600000;0
10616;210765;113;0;0;0;0;.00nan;0;0
10616;201631;109;0;0;0;0;.00nan;0;0
10617;203412;117;0;0;0;0;.00nan;0;0
10617;207493;121;52;59;8;51;.864;3600000;0
10617;202279;121;0;0;0;0;.00nan;0;0
10617;213504;117;55;24;3;21;.875;3600000;0
10618;200233;108;88;52;3;49;.942;3537000;0
10618;215968;110;95;23;0;23;1.000;3600000;0
10618;207535;108;0;0;0;0;.00nan;0;0
10618;217985;110;0;0;0;0;.00nan;0;0
10619;200233;108;51;37;5;32;.865;3523000;0
10619;210773;111;0;0;0;0;.00nan;0;0
10619;207535;108;0;0;0;0;.00nan;0;0
10619;-1;111;53;21;3;18;.857;3600000;0
10620;203412;117;28;23;5;18;.783;3600000;0
10620;202161;115;85;32;2;30;.938;3600000;0
10620;207439;115;0;0;0;0;.00nan;0;0
10620;213504;117;0;0;0;0;.00nan;0;0
10621;213845;113;54;19;2;17;.895;3600000;0
10621;210765;113;0;0;0;0;.00nan;0;0
10621;206864;127;0;0;0;0;.00nan;0;0
10621;202314;127;31;31;7;24;.774;3600000;0
10622;197999;116;60;7;0;7;1.000;3081000;0
10622;204630;109;99;54;2;52;.963;3600000;0
10622;216028;116;29;10;3;7;.700;475000;0
10622;201631;109;0;0;0;0;.00nan;0;0
10623;204711;119;0;0;0;0;.00nan;0;0
10623;-1;119;75;41;4;37;.902;3597000;0
10623;-1;118;0;0;0;0;.00nan;0;0
10623;218830;118;95;36;2;34;.944;3600000;0
10624;199695;120;0;0;0;0;.00nan;0;0
10624;200210;114;46;20;3;17;.850;3554000;0
10624;200390;120;94;42;2;40;.952;3600000;0
10624;207504;114;0;0;0;0;.00nan;0;0
10625;208620;112;0;0;0;0;.00nan;0;0
10625;215968;110;46;33;5;28;.848;3588000;0
10625;202246;112;69;34;3;31;.912;3600000;0
10625;217985;110;0;0;0;0;.00nan;0;0
10626;200293;126;0;0;0;0;.00nan;0;0
10626;212039;126;34;23;5;18;.783;3600000;0
10626;207493;121;54;42;6;36;.857;3546000;0
10626;202279;121;0;0;0;0;.00nan;0;0
10627;204618;125;64;27;2;25;.926;3600000;0
10627;210785;123;26;28;6;22;.786;2249000;0
10627;-1;123;34;17;4;13;.765;1351000;0
10627;208391;125;0;0;0;0;.00nan;0;0
10628;213845;113;0;0;0;0;.00nan;0;0
10628;200233;108;0;0;0;0;.00nan;0;0
10628;210765;113;70;29;2;27;.931;3600000;0
10628;207535;108;71;16;1;15;.938;3600000;0
10629;199481;122;76;42;4;38;.905;3600000;0
10629;205469;122;0;0;0;0;.00nan;0;0
10629;206731;124;42;8;2;6;.750;475000;0
10629;203054;124;28;36;7;29;.806;3125000;0
10630;200293;126;0;0;0;0;.00nan;0;0
10630;212039;126;45;21;4;17;.810;3600000;0
10630;207493;121;66;15;0;15;1.000;1390000;0
10630;202279;121;25;26;6;20;.769;2210000;0
10631;197999;116;0;0;0;0;.00nan;0;0
10631;203412;117;0;0;0;0;.00nan;0;0
10631;216028;116;63;25;3;22;.880;3543000;0
10631;213504;117;70;26;2;24;.923;3600000;0
10632;204630;109;69;46;5;41;.891;3600000;0
10632;210773;111;0;0;0;0;.00nan;0;0
10632;201631;109;0;0;0;0;.00nan;0;0
10632;-1;111;68;23;2;21;.913;3600000;0
10633;208620;112;0;0;0;0;.00nan;0;0
10633;202161;115;67;26;3;23;.885;3600000;0
10633;207439;115;0;0;0;0;.00nan;0;0
10633;202246;112;96;22;0;22;1.000;3600000;0
10634;206731;124;81;37;2;35;.946;3600000;0
10634;203054;124;0;0;0;0;.00nan;0;0
10634;-1;118;0;0;0;0;.00nan;0;0
10634;218830;118;65;33;3;30;.909;3543000;0
10635;204711;119;36;36;6;30;.833;3600000;0
10635;200210;114;0;0;0;0;.00nan;0;0
10635;207504;114;61;26;2;24;.923;3600000;0
10635;-1;119;0;0;0;0;.00nan;0;0
10636;199481;122;0;0;0;0;.00nan;0;0
10636;199695;120;0;0;0;0;.00nan;0;0
10636;200390;120;79;36;3;33;.917;3600000;0
10636;205469;122;68;44;4;40;.909;3544000;0
10637;210785;123;0;0;0;0;.00nan;0;0
10637;206864;127;82;42;3;39;.929;3552000;0
10637;202314;127;0;0;0;0;.00nan;0;0
10637;-1;123;76;24;2;22;.917;3600000;0
10638;203412;117;44;31;5;26;.839;3600000;0
10638;204618;125;93;34;2;32;.941;3600000;0
10638;213504;117;0;0;0;0;.00nan;0;0
10638;208391;125;0;0;0;0;.00nan;0;0
10639;197999;116;43;20;3;17;.850;3600000;0
10639;215968;110;51;27;4;23;.852;3561000;0
10639;216028;116;0;0;0;0;.00nan;0;0
10639;217985;110;0;0;0;0;.00nan;0;0
10640;213845;113;76;37;3;34;.919;3600000;0
10640;200233;108;99;22;0;22;1.000;3600000;0
10640;210765;113;0;0;0;0;.00nan;0;0
10640;207535;108;0;0;0;0;.00nan;0;0
10641;200293;126;0;0;0;0;.00nan;0;0
10641;212039;126;44;15;3;12;.800;3600000;0
10641;206864;127;0;0;0;0;.00nan;0;0
10641;202314;127;79;48;5;43;.896;3592000;0
10642;204618;125;0;0;0;0;.00nan;0;0
10642;210785;123;60;24;3;21;.875;3600000;0
10642;-1;123;0;0;0;0;.00nan;0;0
10642;208391;125;93;40;2;38;.950;3600000;0
10643;208620;112;25;14;4;10;.714;1711000;0
10643;204711;119;0;0;0;0;.00nan;0;0
10643;202246;112;20;22;6;16;.727;1889000;0
10643;-1;119;30;23;5;18;.783;3600000;0
10644;206731;124;0;0;0;0;.00nan;0;0
10644;207493;121;92;39;2;37;.949;3600000;0
10644;202279;121;0;0;0;0;.00nan;0;0
10644;203054;124;60;36;4;32;.889;3596000;0
10645;200210;114;38;28;5;23;.821;3600000;0
10645;207504;114;0;0;0;0;.00nan;0;0
10645;-1;118;75;23;1;22;.957;3600000;0
10645;218830;118;0;0;0;0;.00nan;0;0
10646;199695;120;72;24;2;22;.917;3600000;0
10646;200390;120;0;0;0;0;.00nan;0;0
10646;202161;115;48;0;0;0;.00nan;256000;0
10646;207439;115;22;24;6;18;.750;3344000;0
10647;199481;122;64;30;4;26;.867;3900000;0
10647;205469;122;0;0;0;0;.00nan;0;0
10647;215968;110;0;0;0;0;.00nan;0;0
10647;217985;110;62;43;4;39;.907;3900000;0
10648;204630;109;68;27;2;25;.926;3515000;0
10648;210773;111;0;0;0;0;.00nan;0;0
10648;201631;109;0;0;0;0;.00nan;0;0
10648;-1;111;91;18;0;18;1.000;3600000;0
10649;204711;119;0;0;0;0;.00nan;0;0
10649;207493;121;64;28;3;25;.893;3600000;0
10649;202279;121;0;0;0;0;.00nan;0;0
10649;-1;119;100;31;0;31;1.000;3600000;0
10650;204618;125;34;33;6;27;.818;2680000;0
10650;215968;110;75;29;2;27;.931;3600000;0
10650;217985;110;0;0;0;0;.00nan;0;0
10650;208391;125;60;11;0;11;1.000;920000;0
10651;200233;108;54;23;3;20;.870;3547000;0
10651;200293;126;0;0;0;0;.00nan;0;0
10651;212039;126;81;34;2;32;.941;3600000;0
10651;207535;108;0;0;0;0;.00nan;0;0
10652;206731;124;74;35;3;32;.914;3548000;0
10652;206864;127;0;0;0;0;.00nan;0;0
10652;202314;127;73;33;2;31;.939;3600000;0
10652;203054;124;0;0;0;0;.00nan;0;0
10653;200293;126;0;0;0;0;.00nan;0;0
10653;212039;126;39;21;4;17;.810;3600000;0
10653;202161;115;93;39;2;37;.949;3600000;0
10653;207439;115;0;0;0;0;.00nan;0;0
10654;197999;116;0;0;0;0;.00nan;0;0
10654;208620;112;0;0;0;0;.00nan;0;0
10654;216028;116;71;38;4;34;.895;3900000;0
10654;202246;112;58;34;4;30;.882;3900000;0
10655;199695;120;0;0;0;0;.00nan;0;0
10655;204711;119;0;0;0;0;.00nan;0;0
10655;200390;120;71;46;5;41;.891;3685000;0
10655;-1;119;33;29;6;23;.793;3685000;0
10656;199481;122;51;22;3;19;.864;3554000;0
10656;205469;122;0;0;0;0;.00nan;0;0
10656;210785;123;0;0;0;0;.00nan;0;0
10656;-1;123;79;28;1;27;.964;3600000;0
10657;213845;113;56;22;2;20;.909;3563000;0
10657;210765;113;0;0;0;0;.00nan;0;0
10657;210773;111;0;0;0;0;.00nan;0;0
10657;-1;111;80;24;1;23;.958;3600000;0
10658;197999;116;55;33;4;29;.879;3600000;0
10658;204630;109;0;0;0;0;.00nan;0;0
10658;216028;116;0;0;0;0;.00nan;0;0
10658;201631;109;86;32;1;31;.969;3600000;0
10659;199695;120;55;10;1;9;.900;713000;0
10659;200210;114;55;3;0;3;1.000;577000;0
10659;200390;120;18;21;6;15;.714;3187000;0
10659;207504;114;15;22;7;15;.682;3323000;0
10660;200233;108;81;31;2;29;.935;3600000;0
10660;206731;124;0;0;0;0;.00nan;0;0
10660;207535;108;0;0;0;0;.00nan;0;0
10660;203054;124;68;37;4;33;.892;3530000;0
10661;202161;115;0;0;0;0;.00nan;0;0
10661;207439;115;57;25;3;22;.880;3900000;0
10661;207493;121;80;41;3;38;.927;3900000;0
10661;202279;121;0;0;0;0;.00nan;0;0
10662;208620;112;0;0;0;0;.00nan;0;0
10662;203412;117;62;31;3;28;.903;3600000;0
10662;202246;112;70;51;5;46;.902;3561000;0
10662;213504;117;0;0;0;0;.00nan;0;0
10663;204618;125;54;41;6;35;.854;3226000;0
10663;208391;125;55;4;0;4;1.000;374000;0
10663;-1;118;0;0;0;0;.00nan;0;0
10663;218830;118;88;23;1;22;.957;3600000;0
10664;204630;109;68;29;3;26;.897;3600000;0
10664;210773;111;0;0;0;0;.00nan;0;0
10664;201631;109;0;0;0;0;.00nan;0;0
10664;-1;111;72;36;4;32;.889;3600000;0
10665;213845;113;0;0;0;0;.00nan;0;0
10665;210765;113;42;25;4;21;.840;3600000;0
10665;207493;121;0;0;0;0;.00nan;0;0
10665;202279;121;48;41;6;35;.854;3600000;0
10666;215968;110;61;37;4;33;.892;3600000;0
10666;206731;124;37;28;5;23;.821;3128000;0
10666;217985;110;0;0;0;0;.00nan;0;0
10666;203054;124;41;3;1;2;.667;410000;0
10667;204711;119;0;0;0;0;.00nan;0;0
10667;206864;127;74;23;1;22;.957;3600000;0
10667;202314;127;0;0;0;0;.00nan;0;0
10667;-1;119;52;36;5;31;.861;3600000;0
10668;199695;120;69;37;4;33;.892;3589000;0
10668;200390;120;0;0;0;0;.00nan;0;0
10668;-1;118;21;16;5;11;.688;3589000;0
10668;218830;118;0;0;0;0;.00nan;0;0
10669;203412;117;0;0;0;0;.00nan;0;0
10669;199481;122;44;35;6;29;.829;3600000;0
10669;205469;122;0;0;0;0;.00nan;0;0
10669;213504;117;89;43;3;40;.930;3600000;0
10670;200233;108;52;18;2;16;.889;3900000;0
10670;210785;123;81;39;2;37;.949;3900000;0
10670;207535;108;0;0;0;0;.00nan;0;0
10670;-1;123;0;0;0;0;.00nan;0;0
10671;204618;125;0;0;0;0;.00nan;0;0
10671;202161;115;69;41;4;37;.902;3840000;0
10671;207439;115;0;0;0;0;.00nan;0;0
10671;208391;125;64;45;5;40;.889;3840000;0
10672;213845;113;57;36;4;32;.889;3584000;0
10672;208620;112;57;22;2;20;.909;3600000;0
10672;210765;113;0;0;0;0;.00nan;0;0
10672;202246;112;0;0;0;0;.00nan;0;0
10673;197999;116;50;7;1;6;.857;1089000;0
10673;199481;122;0;0;0;0;.00nan;0;0
10673;205469;122;73;46;5;41;.891;3600000;0
10673;216028;116;36;26;6;20;.769;2457000;0
10674;200210;114;48;22;3;19;.864;3600000;0
10674;206864;127;0;0;0;0;.00nan;0;0
10674;207504;114;0;0;0;0;.00nan;0;0
10674;202314;127;79;43;4;39;.907;3561000;0
10675;200293;126;0;0;0;0;.00nan;0;0
10675;212039;126;53;27;4;23;.852;3600000;0
10675;-1;118;0;0;0;0;.00nan;0;0
10675;218830;118;46;39;6;33;.846;3578000;0
10676;210785;123;0;0;0;0;.00nan;0;0
10676;215968;110;43;26;4;22;.846;3600000;0
10676;217985;110;0;0;0;0;.00nan;0;0
10676;-1;123;88;39;3;36;.923;3600000;0
10677;199695;120;0;0;0;0;.00nan;0;0
10677;200390;120;52;35;5;30;.857;3600000;0
10677;206731;124;0;0;0;0;.00nan;0;0
10677;203054;124;98;36;1;35;.972;3600000;0
10678;204711;119;0;0;0;0;.00nan;0;0
10678;202161;115;73;29;3;26;.897;3578000;0
10678;207439;115;0;0;0;0;.00nan;0;0
10678;-1;119;99;41;1;40;.976;3600000;0
10679;213845;113;62;38;4;34;.895;3557000;0
10679;203412;117;64;29;3;26;.897;3600000;0
10679;210765;113;0;0;0;0;.00nan;0;0
10679;213504;117;0;0;0;0;.00nan;0;0
10680;200293;126;0;0;0;0;.00nan;0;0
10680;212039;126;71;29;3;26;.897;3900000;0
10680;207493;121;68;29;3;26;.897;3900000;0
10680;202279;121;0;0;0;0;.00nan;0;0
10681;210785;123;100;45;2;43;.956;3600000;0
10681;206864;127;0;0;0;0;.00nan;0;0
10681;202314;127;58;29;3;26;.897;3594000;0
10681;-1;123;0;0;0;0;.00nan;0;0
10682;197999;116;0;0;0;0;.00nan;0;0
10682;213845;113;0;0;0;0;.00nan;0;0
10682;210765;113;58;27;4;23;.852;3658000;0
10682;216028;116;67;30;3;27;.900;3658000;0
10683;200210;114;63;39;4;35;.897;3600000;0
10683;202161;115;0;0;0;0;.00nan;0;0
10683;207439;115;62;30;3;27;.900;3600000;0
10683;207504;114;0;0;0;0;.00nan;0;0
10684;200233;108;89;29;1;28;.966;3900000;0
10684;210773;111;0;0;0;0;.00nan;0;0
10684;207535;108;0;0;0;0;.00nan;0;0
10684;-1;111;100;44;1;43;.977;3900000;0
10685;208620;112;0;0;0;0;.00nan;0;0
10685;204630;109;61;41;5;36;.878;3561000;0
10685;201631;109;0;0;0;0;.00nan;0;0
10685;202246;112;62;28;3;25;.893;3600000;0
10686;210773;111;80;37;3;34;.919;3589000;0
10686;215968;110;67;27;2;25;.926;3600000;0
10686;217985;110;0;0;0;0;.00nan;0;0
10686;-1;111;0;0;0;0;.00nan;0;0
10687;200210;114;0;0;0;0;.00nan;0;0
10687;206731;124;5;29;8;21;.724;2032000;0
10687;207504;114;68;15;1;14;.933;3600000;0
10687;203054;124;51;14;2;12;.857;1568000;0
10688;199481;122;100;28;0;28;1.000;3600000;0
10688;204711;119;0;0;0;0;.00nan;0;0
10688;205469;122;0;0;0;0;.00nan;0;0
10688;-1;119;75;29;2;27;.931;3546000;0
10689;210785;123;0;0;0;0;.00nan;0;0
10689;207493;121;54;25;3;22;.880;3547000;0
10689;202279;121;0;0;0;0;.00nan;0;0
10689;-1;123;75;30;2;28;.933;3600000;0
10690;203412;117;26;31;6;25;.806;2709000;0
10690;200293;126;0;0;0;0;.00nan;0;0
10690;212039;126;66;24;3;21;.875;3600000;0
10690;213504;117;38;7;2;5;.714;891000;0
10691;204618;125;31;23;6;17;.739;2323000;0
10691;208391;125;52;11;1;10;.909;1277000;0
10691;-1;118;0;0;0;0;.00nan;0;0
10691;218830;118;20;22;6;16;.727;3600000;0
10692;199695;120;0;0;0;0;.00nan;0;0
10692;204630;109;34;40;8;32;.800;3600000;0
10692;200390;120;38;22;4;18;.818;3600000;0
10692;201631;109;0;0;0;0;.00nan;0;0
10693;204711;119;66;24;2;22;.917;3600000;0
10693;206731;124;52;4;0;4;1.000;920000;0
10693;-1;119;0;0;0;0;.00nan;0;0
10693;203054;124;22;24;6;18;.750;2680000;0
10694;200233;108;0;0;0;0;.00nan;0;0
10694;215968;110;84;48;4;44;.917;3600000;0
10694;207535;108;75;21;1;20;.952;3600000;0
10694;217985;110;0;0;0;0;.00nan;0;0
10695;203412;117;0;0;0;0;.00nan;0;0
10695;206864;127;65;32;4;28;.875;3552000;0
10695;202314;127;0;0;0;0;.00nan;0;0
10695;213504;117;85;44;3;41;.932;3600000;0
10696;210785;123;70;23;2;21;.913;3600000;0
10696;-1;123;0;0;0;0;.00nan;0;0
10696;-1;118;54;25;4;21;.840;3532000;0
10696;218830;118;0;0;0;0;.00nan;0;0
10697;197999;116;0;0;0;0;.00nan;0;0
10697;204618;125;30;34;6;28;.824;2916000;0
10697;216028;116;62;36;4;32;.889;3600000;0
10697;208391;125;42;4;1;3;.750;684000;0
10698;208620;112;62;22;2;20;.909;1257000;0
10698;202161;115;59;17;2;15;.882;3600000;0
10698;207439;115;0;0;0;0;.00nan;0;0
10698;202246;112;71;45;4;41;.911;2343000;0
10699;213845;113;68;39;4;35;.897;3600000;0
10699;200293;126;0;0;0;0;.00nan;0;0
10699;210765;113;0;0;0;0;.00nan;0;0
10699;212039;126;35;30;5;25;.833;3600000;0
10700;199481;122;72;20;1;19;.950;3600000;0
10700;204630;109;0;0;0;0;.00nan;0;0
10700;205469;122;0;0;0;0;.00nan;0;0
10700;201631;109;86;49;4;45;.918;3600000;0
10701;199695;120;74;38;3;35;.921;3600000;0
10701;200390;120;0;0;0;0;.00nan;0;0
10701;207493;121;70;46;5;41;.891;3577000;0
10701;202279;121;0;0;0;0;.00nan;0;0
10702;210773;111;0;0;0;0;.00nan;0;0
10702;215968;110;0;0;0;0;.00nan;0;0
10702;217985;110;27;29;6;23;.793;3600000;0
10702;-1;111;13;34;9;25;.735;3600000;0
10703;204711;119;67;23;2;21;.913;2904000;0
10703;200293;126;0;0;0;0;.00nan;0;0
10703;212039;126;66;30;3;27;.900;3600000;0
10703;-1;119;25;12;4;8;.667;696000;0
10704;199481;122;87;40;2;38;.950;3544000;0
10704;205469;122;0;0;0;0;.00nan;0;0
10704;-1;118;0;0;0;0;.00nan;0;0
10704;218830;118;81;27;1;26;.963;3600000;0
10705;208620;112;0;0;0;0;.00nan;0;0
10705;215968;110;61;31;3;28;.903;3572000;0
10705;202246;112;88;36;2;34;.944;3600000;0
10705;217985;110;0;0;0;0;.00nan;0;0
10706;203412;117;65;25;2;23;.920;3900000;0
10706;202161;115;100;44;2;42;.955;3900000;0
10706;207439;115;0;0;0;0;.00nan;0;0
10706;213504;117;0;0;0;0;.00nan;0;0
10707;197999;116;0;0;0;0;.00nan;0;0
10707;204711;119;0;0;0;0;.00nan;0;0
10707;216028;116;65;24;2;22;.917;3600000;0
10707;-1;119;62;29;3;26;.897;3542000;0
10708;213845;113;59;36;4;32;.889;3866000;0
10708;200210;114;44;21;5;16;.762;3866000;0
10708;210765;113;0;0;0;0;.00nan;0;0
10708;207504;114;0;0;0;0;.00nan;0;0
10709;199695;120;0;0;0;0;.00nan;0;0
10709;200233;108;45;24;4;20;.833;3600000;0
10709;200390;120;66;40;5;35;.875;3543000;0
10709;207535;108;0;0;0;0;.00nan;0;0
10710;204618;125;87;44;3;41;.932;3600000;0
10710;206864;127;0;0;0;0;.00nan;0;0
10710;202314;127;55;28;4;24;.857;3547000;0
10710;208391;125;0;0;0;0;.00nan;0;0
10711;199695;120;69;21;2;19;.905;3600000;0
10711;200390;120;0;0;0;0;.00nan;0;0
10711;210773;111;0;0;0;0;.00nan;0;0
10711;-1;111;54;31;5;26;.839;3600000;0
10712;204630;109;64;37;4;33;.892;3570000;0
10712;210785;123;61;25;2;23;.920;3600000;0
10712;201631;109;0;0;0;0;.00nan;0;0
10712;-1;123;0;0;0;0;.00nan;0;0
10713;197999;116;73;44;4;40;.909;3600000;0
10713;213845;113;0;0;0;0;.00nan;0;0
10713;210765;113;70;25;2;23;.920;3600000;0
10713;216028;116;0;0;0;0;.00nan;0;0
10714;199481;122;0;0;0;0;.00nan;0;0
10714;205469;122;50;38;6;32;.842;3600000;0
10714;207493;121;16;32;7;25;.781;3600000;0
10714;202279;121;0;0;0;0;.00nan;0;0
10715;203412;117;0;0;0;0;.00nan;0;0
10715;204711;119;10;19;6;13;.684;3040000;0
10715;-1;119;49;7;1;6;.857;532000;0
10715;213504;117;42;29;5;24;.828;3600000;0
10716;204618;125;51;13;2;11;.846;524000;0
10716;200293;126;0;0;0;0;.00nan;0;0
10716;212039;126;44;16;3;13;.813;3600000;0
10716;208391;125;44;36;6;30;.833;3076000;0
10717;206731;124;65;38;4;34;.895;3553000;0
10717;203054;124;0;0;0;0;.00nan;0;0
10717;-1;118;0;0;0;0;.00nan;0;0
10717;218830;118;68;36;3;33;.917;3600000;0
10718;200233;108;0;0;0;0;.00nan;0;0
10718;215968;110;89;41;3;38;.927;3900000;0
10718;207535;108;60;25;3;22;.880;3900000;0
10718;217985;110;0;0;0;0;.00nan;0;0
10719;208620;112;0;0;0;0;.00nan;0;0
10719;206864;127;93;41;2;39;.951;3600000;0
10719;202246;112;55;30;4;26;.867;3562000;0
10719;202314;127;0;0;0;0;.00nan;0;0
10720;199481;122;100;32;0;32;1.000;3600000;0
10720;205469;122;0;0;0;0;.00nan;0;0
10720;207493;121;0;0;0;0;.00nan;0;0
10720;202279;121;54;40;5;35;.875;3600000;0
10721;200293;126;0;0;0;0;.00nan;0;0
10721;206731;124;57;35;4;31;.886;3600000;0
10721;212039;126;86;28;1;27;.964;3600000;0
10721;203054;124;0;0;0;0;.00nan;0;0
10722;200233;108;71;29;2;27;.931;3629000;0
10722;210785;123;0;0;0;0;.00nan;0;0
10722;207535;108;0;0;0;0;.00nan;0;0
10722;-1;123;93;47;3;44;.936;3629000;0
10723;200210;114;0;0;0;0;.00nan;0;0
10723;202161;115;59;33;4;29;.879;3590000;0
10723;207439;115;0;0;0;0;.00nan;0;0
10723;207504;114;46;19;3;16;.842;3600000;0
10724;210773;111;0;0;0;0;.00nan;0;0
10724;210785;123;77;50;4;46;.920;3555000;0
10724;-1;111;56;21;3;18;.857;3600000;0
10724;-1;123;0;0;0;0;.00nan;0;0
10725;199695;120;0;0;0;0;.00nan;0;0
10725;204630;109;97;52;3;49;.942;3900000;0
10725;200390;120;56;21;3;18;.857;3900000;0
10725;201631;109;0;0;0;0;.00nan;0;0
10726;213845;113;49;25;4;21;.840;3900000;0
10726;208620;112;0;0;0;0;.00nan;0;0
10726;210765;113;0;0;0;0;.00nan;0;0
10726;202246;112;78;42;4;38;.905;3877000;0
10727;197999;116;65;29;2;27;.931;3157000;0
10727;200210;114;68;25;2;23;.920;3600000;0
10727;216028;116;21;10;4;6;.600;443000;0
10727;207504;114;0;0;0;0;.00nan;0;0
10728;203412;117;19;31;7;24;.774;3332000;0
10728;202161;115;0;0;0;0;.00nan;0;0
10728;207439;115;86;53;5;48;.906;3600000;0
10728;213504;117;51;2;0;2;1.000;250000;0
10729;204618;125;38;30;5;25;.833;3574000;0
10729;204711;119;0;0;0;0;.00nan;0;0
10729;-1;119;82;41;3;38;.927;3600000;0
10729;208391;125;0;0;0;0;.00nan;0;0
10730;215968;110;73;37;4;33;.892;3900000;0
10730;206864;127;0;0;0;0;.00nan;0;0
10730;217985;110;0;0;0;0;.00nan;0;0
10730;202314;127;65;37;4;33;.892;3900000;0
10731;199695;120;0;0;0;0;.00nan;0;0
10731;200390;120;55;35;5;30;.857;3568000;0
10731;202161;115;55;22;3;19;.864;3600000;0
10731;207439;115;0;0;0;0;.00nan;0;0
10732;197999;116;0;0;0;0;.00nan;0;0
10732;203412;117;57;37;4;33;.892;3564000;0
10732;216028;116;73;31;3;28;.903;3600000;0
10732;213504;117;0;0;0;0;.00nan;0;0
10733;208620;112;0;0;0;0;.00nan;0;0
10733;200210;114;53;18;2;16;.889;3600000;0
10733;207504;114;0;0;0;0;.00nan;0;0
10733;202246;112;69;39;4;35;.897;3600000;0
10734;204630;109;57;36;5;31;.861;2222000;0
10734;200233;108;75;12;0;12;1.000;3600000;0
10734;201631;109;64;17;1;16;.941;1378000;0
10734;207535;108;0;0;0;0;.00nan;0;0
10735;210785;123;0;0;0;0;.00nan;0;0
10735;206864;127;0;0;0;0;.00nan;0;0
10735;202314;127;44;22;3;19;.864;3586000;0
10735;-1;123;99;35;1;34;.971;3600000;0
10736;200210;114;0;0;0;0;.00nan;0;0
10736;210773;111;0;0;0;0;.00nan;0;0
10736;207504;114;22;18;5;13;.722;3900000;0
10736;-1;111;88;54;5;49;.907;3900000;0
10737;213845;113;48;21;3;18;.857;3513000;0
10737;210765;113;0;0;0;0;.00nan;0;0
10737;206731;124;100;40;1;39;.975;3600000;0
10737;203054;124;0;0;0;0;.00nan;0;0
10738;200233;108;71;23;1;22;.957;3600000;0
10738;207493;121;59;45;6;39;.867;3600000;0
10738;207535;108;0;0;0;0;.00nan;0;0
10738;202279;121;0;0;0;0;.00nan;0;0
10739;197999;116;70;25;1;24;.960;3600000;0
10739;203412;117;73;23;1;22;.957;2584000;0
10739;216028;116;0;0;0;0;.00nan;0;0
10739;213504;117;27;11;4;7;.636;1016000;0
10740;199481;122;81;25;1;24;.960;3600000;0
10740;204618;125;74;42;3;39;.929;3559000;0
10740;205469;122;0;0;0;0;.00nan;0;0
10740;208391;125;0;0;0;0;.00nan;0;0
10741;200293;126;0;0;0;0;.00nan;0;0
10741;212039;126;80;38;4;34;.895;3900000;0
10741;-1;118;0;0;0;0;.00nan;0;0
10741;218830;118;33;23;4;19;.826;3900000;0
10742;204711;119;0;0;0;0;.00nan;0;0
10742;215968;110;77;32;3;29;.906;3600000;0
10742;217985;110;0;0;0;0;.00nan;0;0
10742;-1;119;49;38;6;32;.842;3600000;0
10743;204630;109;87;38;2;36;.947;3600000;0
10743;200210;114;42;25;5;20;.800;3600000;0
10743;201631;109;0;0;0;0;.00nan;0;0
10743;207504;114;0;0;0;0;.00nan;0;0
10744;208620;112;0;0;0;0;.00nan;0;0
10744;210773;111;0;0;0;0;.00nan;0;0
10744;202246;112;61;37;5;32;.865;3600000;0
10744;-1;111;23;22;6;16;.727;3592000;0
10745;204711;119;85;26;1;25;.962;3600000;0
10745;207493;121;68;16;1;15;.938;2512000;0
10745;202279;121;31;15;4;11;.733;1088000;0
10745;-1;119;0;0;0;0;.00nan;0;0
10746;199695;120;0;0;0;0;.00nan;0;0
10746;200390;120;75;33;2;31;.939;3600000;0
10746;206731;124;51;34;5;29;.853;3600000;0
10746;203054;124;0;0;0;0;.00nan;0;0
10747;200233;108;0;0;0;0;.00nan;0;0
10747;206864;127;83;32;2;30;.938;3600000;0
10747;207535;108;34;23;4;19;.826;3561000;0
10747;202314;127;0;0;0;0;.00nan;0;0
10748;199481;122;0;0;0;0;.00nan;0;0
10748;205469;122;49;25;4;21;.840;3639000;0
10748;210785;123;70;41;3;38;.927;3639000;0
10748;-1;123;0;0;0;0;.00nan;0;0
10749;215968;110;61;21;2;19;.905;3600000;0
10749;202161;115;65;31;3;28;.903;3557000;0
10749;207439;115;0;0;0;0;.00nan;0;0
10749;217985;110;0;0;0;0;.00nan;0;0
10750;213845;113;53;17;2;15;.882;3600000;0
10750;208620;112;56;33;4;29;.879;3566000;0
10750;210765;113;0;0;0;0;.00nan;0;0
10750;202246;112;0;0;0;0;.00nan;0;0
10751;197999;116;0;0;0;0;.00nan;0;0
10751;216028;116;43;34;5;29;.853;3600000;0
10751;202161;115;0;0;0;0;.00nan;0;0
10751;207439;115;44;19;3;16;.842;3600000;0
10752;199695;120;60;42;5;37;.881;3579000;0
10752;200390;120;0;0;0;0;.00nan;0;0
10752;-1;118;0;0;0;0;.00nan;0;0
10752;218830;118;50;23;3;20;.870;3600000;0
10753;204618;125;65;56;6;50;.893;3600000;0
10753;200293;126;0;0;0;0;.00nan;0;0
10753;212039;126;62;18;1;17;.944;3600000;0
10753;208391;125;0;0;0;0;.00nan;0;0
10754;210785;123;0;0;0;0;.00nan;0;0
10754;206864;127;0;0;0;0;.00nan;0;0
10754;202314;127;58;27;3;24;.889;3511000;0
10754;-1;123;89;26;1;25;.962;3600000;0
10755;204630;109;98;52;3;49;.942;3600000;0
10755;215968;110;0;0;0;0;.00nan;0;0
10755;201631;109;0;0;0;0;.00nan;0;0
10755;217985;110;70;23;2;21;.913;3600000;0
10756;199481;122;44;33;5;28;.848;3600000;0
10756;205469;122;0;0;0;0;.00nan;0;0
10756;207493;121;21;11;4;7;.636;985000;0
10756;202279;121;60;20;2;18;.900;2560000;0
10757;199695;120;0;0;0;0;.00nan;0;0
10757;200390;120;100;37;1;36;.973;3600000;0
10757;202161;115;26;27;6;21;.778;3600000;0
10757;207439;115;0;0;0;0;.00nan;0;0
10758;204618;125;76;28;2;26;.929;3600000;0
10758;210785;123;54;26;3;23;.885;3600000;0
10758;-1;123;0;0;0;0;.00nan;0;0
10758;208391;125;0;0;0;0;.00nan;0;0
10759;204711;119;0;0;0;0;.00nan;0;0
10759;-1;119;63;37;4;33;.892;3569000;0
10759;-1;118;0;0;0;0;.00nan;0;0
10759;218830;118;63;26;2;24;.923;3600000;0
10760;197999;116;0;0;0;0;.00nan;0;0
10760;213845;113;70;28;2;26;.929;3600000;0
10760;210765;113;0;0;0;0;.00nan;0;0
10760;216028;116;58;37;4;33;.892;3528000;0
10761;203412;117;76;39;4;35;.897;3900000;0
10761;200210;114;69;37;4;33;.892;3900000;0
10761;207504;114;0;0;0;0;.00nan;0;0
10761;213504;117;0;0;0;0;.00nan;0;0
10762;200233;108;54;32;4;28;.875;3600000;0
10762;215968;110;61;32;3;29;.906;3600000;0
10762;207535;108;0;0;0;0;.00nan;0;0
10762;217985;110;0;0;0;0;.00nan;0;0
10763;200293;126;0;0;0;0;.00nan;0;0
10763;212039;126;60;14;1;13;.929;3600000;0
10763;206864;127;61;22;2;20;.909;1287000;0
10763;202314;127;61;42;5;37;.881;2313000;0
10764;208620;112;0;0;0;0;.00nan;0;0
10764;203412;117;0;0;0;0;.00nan;0;0
10764;202246;112;64;42;5;37;.881;3600000;0
10764;213504;117;78;30;2;28;.933;3600000;0
10765;210773;111;0;0;0;0;.00nan;0;0
10765;215968;110;39;32;6;26;.813;3600000;0
10765;217985;110;0;0;0;0;.00nan;0;0
10765;-1;111;89;33;2;31;.939;3600000;0
10766;206731;124;0;0;0;0;.00nan;0;0
10766;202161;115;63;41;5;36;.878;3600000;0
10766;207439;115;0;0;0;0;.00nan;0;0
10766;203054;124;63;36;4;32;.889;3600000;0
10767;199481;122;97;45;2;43;.956;3600000;0
10767;205469;122;0;0;0;0;.00nan;0;0
10767;-1;118;50;29;4;25;.862;3539000;0
10767;218830;118;0;0;0;0;.00nan;0;0
10768;204711;119;41;26;5;21;.808;3600000;0
10768;207493;121;62;48;6;42;.875;3572000;0
10768;202279;121;0;0;0;0;.00nan;0;0
10768;-1;119;0;0;0;0;.00nan;0;0
10769;204630;109;40;41;6;35;.854;2850000;0
10769;200293;126;31;15;4;11;.733;3600000;0
10769;201631;109;75;17;0;17;1.000;728000;0
10769;212039;126;0;0;0;0;.00nan;0;0
10770;213845;113;0;0;0;0;.00nan;0;0
10770;204618;125;49;31;4;27;.871;3600000;0
10770;210765;113;69;29;3;26;.897;3600000;0
10770;208391;125;0;0;0;0;.00nan;0;0
10771;197999;116;0;0;0;0;.00nan;0;0
10771;208620;112;0;0;0;0;.00nan;0;0
10771;216028;116;88;29;1;28;.966;3600000;0
10771;202246;112;65;22;2;20;.909;3558000;0
10772;204630;109;92;57;4;53;.930;3555000;0
10772;206731;124;46;13;2;11;.846;3600000;0
10772;201631;109;0;0;0;0;.00nan;0;0
10772;203054;124;0;0;0;0;.00nan;0;0
10773;199481;122;0;0;0;0;.00nan;0;0
10773;204711;119;0;0;0;0;.00nan;0;0
10773;205469;122;50;17;3;14;.824;3600000;0
10773;-1;119;27;24;5;19;.792;3531000;0
10774;199695;120;0;0;0;0;.00nan;0;0
10774;200390;120;49;19;3;16;.842;3600000;0
10774;207493;121;52;3;0;3;1.000;394000;0
10774;202279;121;44;37;6;31;.838;3206000;0
10775;200210;114;0;0;0;0;.00nan;0;0
10775;200233;108;51;18;2;16;.889;3528000;0
10775;207504;114;88;19;0;19;1.000;3600000;0
10775;207535;108;0;0;0;0;.00nan;0;0
10776;210785;123;0;0;0;0;.00nan;0;0
10776;202161;115;0;0;0;0;.00nan;0;0
10776;207439;115;56;33;4;29;.879;3600000;0
10776;-1;123;81;37;3;34;.919;3600000;0
10777;200233;108;0;0;0;0;.00nan;0;0
10777;210773;111;0;0;0;0;.00nan;0;0
10777;207535;108;64;24;2;22;.917;3600000;0
10777;-1;111;39;26;4;22;.846;3557000;0
10778;213845;113;46;36;5;31;.861;3600000;0
10778;203412;117;25;27;6;21;.778;3040000;0
10778;210765;113;0;0;0;0;.00nan;0;0
10778;213504;117;50;3;0;3;1.000;529000;0
10779;197999;116;30;25;5;20;.800;3566000;0
10779;200210;114;0;0;0;0;.00nan;0;0
10779;216028;116;0;0;0;0;.00nan;0;0
10779;207504;114;75;29;3;26;.897;3600000;0
10780;207493;121;54;25;3;22;.880;3600000;0
10780;202279;121;0;0;0;0;.00nan;0;0
10780;-1;118;0;0;0;0;.00nan;0;0
10780;218830;118;40;32;5;27;.844;3600000;0
10781;204630;109;0;0;0;0;.00nan;0;0
10781;210785;123;42;19;4;15;.789;3560000;0
10781;201631;109;91;47;3;44;.936;3600000;0
10781;-1;123;0;0;0;0;.00nan;0;0
10782;208620;112;43;25;4;21;.840;3015000;0
10782;215968;110;0;0;0;0;.00nan;0;0
10782;202246;112;31;9;3;6;.667;585000;0
10782;217985;110;57;31;4;27;.871;3600000;0
10783;200293;126;0;0;0;0;.00nan;0;0
10783;212039;126;69;32;3;29;.906;3600000;0
10783;206864;127;0;0;0;0;.00nan;0;0
10783;202314;127;45;29;5;24;.828;3581000;0
10784;210773;111;0;0;0;0;.00nan;0;0
10784;215968;110;70;21;1;20;.952;3600000;0
10784;217985;110;0;0;0;0;.00nan;0;0
10784;-1;111;93;48;4;44;.917;3600000;0
10785;206731;124;47;20;3;17;.850;3572000;0
10785;207493;121;89;36;2;34;.944;3600000;0
10785;202279;121;0;0;0;0;.00nan;0;0
10785;203054;124;0;0;0;0;.00nan;0;0
10786;199695;120;0;0;0;0;.00nan;0;0
10786;200293;126;0;0;0;0;.00nan;0;0
10786;200390;120;47;36;6;30;.833;3600000;0
10786;212039;126;65;18;2;16;.889;3600000;0
10787;203412;117;59;36;4;32;.889;3600000;0
10787;204618;125;61;41;5;36;.878;3558000;0
10787;213504;117;0;0;0;0;.00nan;0;0
10787;208391;125;0;0;0;0;.00nan;0;0
10788;197999;116;0;0;0;0;.00nan;0;0
10788;200210;114;0;0;0;0;.00nan;0;0
10788;216028;116;88;32;1;31;.969;3600000;0
10788;207504;114;54;19;3;16;.842;3577000;0
10789;213845;113;44;31;5;26;.839;3577000;0
10789;200233;108;56;35;4;31;.886;3600000;0
10789;210765;113;0;0;0;0;.00nan;0;0
10789;207535;108;0;0;0;0;.00nan;0;0
10790;204711;119;0;0;0;0;.00nan;0;0
10790;206864;127;0;0;0;0;.00nan;0;0
10790;202314;127;52;28;4;24;.857;3600000;0
10790;-1;119;56;39;5;34;.872;3564000;0
10791;199481;122;50;41;6;35;.854;3553000;0
10791;205469;122;0;0;0;0;.00nan;0;0
10791;210773;111;26;11;4;7;.636;2090000;0
10791;-1;111;59;13;1;12;.923;1510000;0
10792;204630;109;100;53;2;51;.962;3600000;0
10792;200233;108;0;0;0;0;.00nan;0;0
10792;201631;109;0;0;0;0;.00nan;0;0
10792;207535;108;36;19;4;15;.789;3543000;0
10793;213845;113;53;2;0;2;1.000;401000;0
10793;210765;113;38;33;6;27;.818;3199000;0
10793;202161;115;20;23;6;17;.739;1972000;0
10793;207439;115;27;19;5;14;.737;1628000;0
10794;206864;127;89;38;2;36;.947;3600000;0
10794;207493;121;0;0;0;0;.00nan;0;0
10794;202279;121;37;39;7;32;.821;3600000;0
10794;202314;127;0;0;0;0;.00nan;0;0
10795;203412;117;0;0;0;0;.00nan;0;0
10795;200210;114;53;24;3;21;.875;3542000;0
10795;207504;114;0;0;0;0;.00nan;0;0
10795;213504;117;94;37;2;35;.946;3600000;0
10796;204711;119;0;0;0;0;.00nan;0;0
10796;200293;126;0;0;0;0;.00nan;0;0
10796;212039;126;64;28;3;25;.893;3698000;0
10796;-1;119;77;41;4;37;.902;3643000;0
10797;199695;120;0;0;0;0;.00nan;0;0
10797;200390;120;48;19;3;16;.842;3600000;0
10797;210785;123;0;0;0;0;.00nan;0;0
10797;-1;123;60;33;4;29;.879;3548000;0
10798;208620;112;0;0;0;0;.00nan;0;0
10798;202246;112;46;38;6;32;.842;3600000;0
10798;-1;118;0;0;0;0;.00nan;0;0
10798;218830;118;100;24;0;24;1.000;3600000;0
10799;215968;110;85;37;2;35;.946;3900000;0
10799;206731;124;0;0;0;0;.00nan;0;0
10799;217985;110;0;0;0;0;.00nan;0;0
10799;203054;124;71;28;2;26;.929;3900000;0
10800;199481;122;0;0;0;0;.00nan;0;0
10800;204630;109;0;0;0;0;.00nan;0;0
10800;205469;122;66;17;1;16;.941;3600000;0
10800;201631;109;52;30;4;26;.867;3600000;0
10801;208620;112;59;38;4;34;.895;3600000;0
10801;206731;124;90;25;1;24;.960;3600000;0
10801;202246;112;0;0;0;0;.00nan;0;0
10801;203054;124;0;0;0;0;.00nan;0;0
10802;200293;126;0;0;0;0;.00nan;0;0
10802;212039;126;41;28;5;23;.821;3600000;0
10802;-1;118;0;0;0;0;.00nan;0;0
10802;218830;118;85;37;2;35;.946;3600000;0
10803;199695;120;78;33;2;31;.939;3600000;0
10803;200390;120;0;0;0;0;.00nan;0;0
10803;206864;127;0;0;0;0;.00nan;0;0
10803;202314;127;46;30;5;25;.833;3600000;0
10804;204711;119;58;27;4;23;.852;3600000;0
10804;210785;123;42;29;5;24;.828;3573000;0
10804;-1;119;0;0;0;0;.00nan;0;0
10804;-1;123;0;0;0;0;.00nan;0;0
10805;204618;125;0;0;0;0;.00nan;0;0
10805;200210;114;0;0;0;0;.00nan;0;0
10805;207504;114;57;30;3;27;.900;3900000;0
10805;208391;125;61;26;3;23;.885;3900000;0
10806;210773;111;51;10;1;9;.900;1151000;0
10806;202161;115;79;26;1;25;.962;3600000;0
10806;207439;115;0;0;0;0;.00nan;0;0
10806;-1;111;41;38;6;32;.842;2449000;0
10807;208620;112;0;0;0;0;.00nan;0;0
10807;200233;108;48;13;2;11;.846;3600000;0
10807;202246;112;63;38;4;34;.895;3514000;0
10807;207535;108;0;0;0;0;.00nan;0;0
10808;213845;113;73;45;4;41;.911;3600000;0
10808;203412;117;84;26;1;25;.962;3600000;0
10808;210765;113;0;0;0;0;.00nan;0;0
10808;213504;117;0;0;0;0;.00nan;0;0
10809;215968;110;34;20;4;16;.800;3600000;0
10809;207493;121;80;64;5;59;.922;3600000;0
10809;202279;121;0;0;0;0;.00nan;0;0
10809;217985;110;0;0;0;0;.00nan;0;0
10810;204618;125;94;21;0;21;1.000;3600000;0
10810;210785;123;0;0;0;0;.00nan;0;0
10810;-1;123;40;30;5;25;.833;3600000;0
10810;208391;125;0;0;0;0;.00nan;0;0
10811;197999;116;85;38;4;34;.895;3600000;0
10811;210773;111;33;42;7;35;.833;3600000;0
10811;216028;116;0;0;0;0;.00nan;0;0
10811;-1;111;0;0;0;0;.00nan;0;0
10812;199481;122;75;39;3;36;.923;3900000;0
10812;205469;122;0;0;0;0;.00nan;0;0
10812;-1;118;0;0;0;0;.00nan;0;0
10812;218830;118;79;37;3;34;.919;3900000;0
10813;199695;120;0;0;0;0;.00nan;0;0
10813;200390;120;42;33;5;28;.848;3650000;0
10813;215968;110;0;0;0;0;.00nan;0;0
10813;217985;110;68;40;4;36;.900;3619000;0
10814;204630;109;82;37;3;34;.919;3573000;0
10814;210773;111;0;0;0;0;.00nan;0;0
10814;201631;109;0;0;0;0;.00nan;0;0
10814;-1;111;74;19;2;17;.895;3600000;0
10815;200293;126;0;0;0;0;.00nan;0;0
10815;206731;124;64;37;4;33;.892;3600000;0
10815;212039;126;52;15;2;13;.867;3600000;0
10815;203054;124;0;0;0;0;.00nan;0;0
10816;204711;119;0;0;0;0;.00nan;0;0
10816;200210;114;43;22;4;18;.818;3743000;0
10816;207504;114;0;0;0;0;.00nan;0;0
10816;-1;119;50;22;3;19;.864;3743000;0
10817;208620;112;13;17;6;11;.647;1724000;0
10817;206864;127;73;35;2;33;.943;3600000;0
10817;202246;112;24;16;5;11;.688;1876000;0
10817;202314;127;0;0;0;0;.00nan;0;0
10818;203412;117;72;43;4;39;.907;3600000;0
10818;204618;125;100;30;0;30;1.000;3600000;0
10818;213504;117;0;0;0;0;.00nan;0;0
10818;208391;125;0;0;0;0;.00nan;0;0
10819;210785;123;48;30;4;26;.867;3524000;0
10819;202161;115;80;30;2;28;.933;3600000;0
10819;207439;115;0;0;0;0;.00nan;0;0
10819;-1;123;0;0;0;0;.00nan;0;0
10820;200233;108;99;43;1;42;.977;3600000;0
10820;207535;108;0;0;0;0;.00nan;0;0
10820;-1;118;0;0;0;0;.00nan;0;0
10820;218830;118;57;18;2;16;.889;3588000;0
10821;208620;112;0;0;0;0;.00nan;0;0
10821;199695;120;0;0;0;0;.00nan;0;0
10821;200390;120;74;20;1;19;.950;3600000;0
10821;202246;112;54;25;3;22;.880;3568000;0
10822;200233;108;0;0;0;0;.00nan;0;0
10822;210773;111;0;0;0;0;.00nan;0;0
10822;207535;108;69;40;3;37;.925;3600000;0
10822;-1;111;94;24;0;24;1.000;3600000;0
10823;197999;116;0;0;0;0;.00nan;0;0
10823;204630;109;89;39;2;37;.949;3900000;0
10823;216028;116;75;29;2;27;.931;3900000;0
10823;201631;109;0;0;0;0;.00nan;0;0
10824;200210;114;0;0;0;0;.00nan;0;0
10824;215968;110;57;32;4;28;.875;3900000;0
10824;207504;114;50;29;4;25;.862;3900000;0
10824;217985;110;0;0;0;0;.00nan;0;0
10825;213845;113;49;36;5;31;.861;3600000;0
10825;199481;122;39;36;6;30;.833;3276000;0
10825;205469;122;50;1;0;1;1.000;298000;0
10825;210765;113;0;0;0;0;.00nan;0;0
10826;204618;125;58;26;3;23;.885;3600000;0
10826;207493;121;40;30;5;25;.833;3549000;0
10826;202279;121;0;0;0;0;.00nan;0;0
10826;208391;125;0;0;0;0;.00nan;0;0
10827;203412;117;0;0;0;0;.00nan;0;0
10827;210785;123;0;0;0;0;.00nan;0;0
10827;-1;123;52;39;6;33;.846;3695000;0
10827;213504;117;49;32;5;27;.844;3695000;0
10828;200293;126;0;0;0;0;.00nan;0;0
10828;206731;124;78;36;3;33;.917;3600000;0
10828;212039;126;45;26;4;22;.846;3598000;0
10828;203054;124;0;0;0;0;.00nan;0;0
10829;204711;119;0;0;0;0;.00nan;0;0
10829;-1;119;64;23;2;21;.913;3600000;0
10829;-1;118;38;27;5;22;.815;3600000;0
10829;218830;118;0;0;0;0;.00nan;0;0
10830;213845;113;0;0;0;0;.00nan;0;0
10830;210765;113;86;34;1;33;.971;3600000;0
10830;210773;111;0;0;0;0;.00nan;0;0
10830;-1;111;80;29;2;27;.931;3551000;0
10831;206731;124;0;0;0;0;.00nan;0;0
10831;206864;127;0;0;0;0;.00nan;0;0
10831;202314;127;61;35;4;31;.886;3600000;0
10831;203054;124;52;29;3;26;.897;3600000;0
10832;204711;119;46;28;5;23;.821;3600000;0
10832;215968;110;0;0;0;0;.00nan;0;0
10832;217985;110;79;27;1;26;.963;3600000;0
10832;-1;119;0;0;0;0;.00nan;0;0
10833;199695;120;82;31;1;30;.968;3600000;0
10833;200390;120;0;0;0;0;.00nan;0;0
10833;207493;121;0;0;0;0;.00nan;0;0
10833;202279;121;43;30;5;25;.833;3600000;0
10834;204630;109;0;0;0;0;.00nan;0;0
10834;201631;109;79;34;2;32;.941;3600000;0
10834;202161;115;64;29;4;25;.862;3515000;0
10834;207439;115;0;0;0;0;.00nan;0;0
10835;197999;116;28;15;4;11;.733;2195000;0
10835;210785;123;46;38;5;33;.868;3562000;0
10835;216028;116;63;8;0;8;1.000;1405000;0
10835;-1;123;0;0;0;0;.00nan;0;0
10836;208620;112;0;0;0;0;.00nan;0;0
10836;200210;114;53;29;4;25;.862;3543000;0
10836;207504;114;0;0;0;0;.00nan;0;0
10836;202246;112;65;26;3;23;.885;3600000;0
10837;203412;117;29;31;6;25;.806;1809000;0
10837;199481;122;82;22;1;21;.955;3600000;0
10837;205469;122;0;0;0;0;.00nan;0;0
10837;213504;117;61;22;2;20;.909;1791000;0
10838;204618;125;51;21;4;17;.810;3566000;0
10838;206864;127;0;0;0;0;.00nan;0;0
10838;202314;127;67;35;3;32;.914;3600000;0
10838;208391;125;0;0;0;0;.00nan;0;0
10839;208620;112;63;38;4;34;.895;3600000;0
10839;204711;119;0;0;0;0;.00nan;0;0
10839;202246;112;0;0;0;0;.00nan;0;0
10839;-1;119;93;31;1;30;.968;3600000;0
10840;210773;111;52;21;3;18;.857;1506000;0
10840;202161;115;56;21;3;18;.857;3600000;0
10840;207439;115;0;0;0;0;.00nan;0;0
10840;-1;111;38;29;6;23;.793;2094000;0
10841;197999;116;0;0;0;0;.00nan;0;0
10841;204630;109;67;41;6;35;.854;3074000;0
10841;216028;116;45;18;4;14;.778;3600000;0
10841;201631;109;45;5;1;4;.800;526000;0
10842;213845;113;89;24;0;24;1.000;3600000;0
10842;199695;120;0;0;0;0;.00nan;0;0
10842;200390;120;57;46;6;40;.870;3600000;0
10842;210765;113;0;0;0;0;.00nan;0;0
10843;203412;117;97;47;3;44;.936;3600000;0
10843;213504;117;0;0;0;0;.00nan;0;0
10843;-1;118;0;0;0;0;.00nan;0;0
10843;218830;118;47;30;4;26;.867;3543000;0
10844;206864;127;47;31;5;26;.839;2020000;0
10844;207493;121;68;31;3;28;.903;3600000;0
10844;202279;121;0;0;0;0;.00nan;0;0
10844;202314;127;45;10;2;8;.800;1580000;0
10845;200210;114;0;0;0;0;.00nan;0;0
10845;215968;110;72;37;3;34;.919;3600000;0
10845;207504;114;43;27;4;23;.852;3570000;0
10845;217985;110;0;0;0;0;.00nan;0;0
10846;199481;122;0;0;0;0;.00nan;0;0
10846;200233;108;68;15;1;14;.933;3600000;0
10846;205469;122;62;31;5;26;.839;3600000;0
10846;207535;108;0;0;0;0;.00nan;0;0
10847;204618;125;0;0;0;0;.00nan;0;0
10847;200293;126;0;0;0;0;.00nan;0;0
10847;212039;126;68;19;1;18;.947;3600000;0
10847;208391;125;85;36;2;34;.944;3588000;0
10848;199695;120;0;0;0;0;.00nan;0;0
10848;200390;120;70;36;4;32;.889;3575000;0
10848;202161;115;68;22;2;20;.909;3600000;0
10848;207439;115;0;0;0;0;.00nan;0;0
10849;210785;123;0;0;0;0;.00nan;0;0
10849;206731;124;64;21;2;19;.905;3600000;0
10849;-1;123;51;37;5;32;.865;3600000;0
10849;203054;124;0;0;0;0;.00nan;0;0
10850;210773;111;0;0;0;0;.00nan;0;0
10850;207493;121;66;38;4;34;.895;3600000;0
10850;202279;121;0;0;0;0;.00nan;0;0
10850;-1;111;39;30;5;25;.833;3600000;0
10851;204630;109;41;46;7;39;.848;3600000;0
10851;215968;110;58;24;3;21;.875;3600000;0
10851;201631;109;0;0;0;0;.00nan;0;0
10851;217985;110;0;0;0;0;.00nan;0;0
10852;213845;113;51;26;4;22;.846;3600000;0
10852;200210;114;43;28;5;23;.821;3600000;0
10852;210765;113;0;0;0;0;.00nan;0;0
10852;207504;114;0;0;0;0;.00nan;0;0
10853;208620;112;0;0;0;0;.00nan;0;0
10853;206731;124;71;36;4;32;.889;3600000;0
10853;202246;112;59;41;6;35;.854;3530000;0
10853;203054;124;0;0;0;0;.00nan;0;0
10854;199481;122;51;38;5;33;.868;3900000;0
10854;200293;126;0;0;0;0;.00nan;0;0
10854;205469;122;0;0;0;0;.00nan;0;0
10854;212039;126;49;36;5;31;.861;3900000;0
10855;203412;117;0;0;0;0;.00nan;0;0
10855;200233;108;52;21;3;18;.857;3557000;0
10855;207535;108;0;0;0;0;.00nan;0;0
10855;213504;117;93;42;2;40;.952;3600000;0
10856;197999;116;0;0;0;0;.00nan;0;0
10856;210785;123;59;32;3;29;.906;3600000;0
10856;216028;116;55;33;4;29;.879;3557000;0
10856;-1;123;0;0;0;0;.00nan;0;0
10857;206864;127;0;0;0;0;.00nan;0;0
10857;202314;127;83;51;4;47;.922;3600000;0
10857;-1;118;0;0;0;0;.00nan;0;0
10857;218830;118;26;24;5;19;.792;3600000;0
10858;204630;109;61;9;0;9;1.000;606000;0
10858;201631;109;31;31;6;25;.806;2994000;0
10858;207493;121;0;0;0;0;.00nan;0;0
10858;202279;121;99;25;0;25;1.000;3600000;0
10859;200210;114;0;0;0;0;.00nan;0;0
10859;210773;111;68;41;4;37;.902;3583000;0
10859;207504;114;50;23;3;20;.870;3600000;0
10859;-1;111;0;0;0;0;.00nan;0;0
10860;197999;116;49;44;6;38;.864;3600000;0
10860;216028;116;0;0;0;0;.00nan;0;0
10860;206731;124;0;0;0;0;.00nan;0;0
10860;203054;124;40;18;3;15;.833;3600000;0
10861;204711;119;0;0;0;0;.00nan;0;0
10861;-1;119;85;43;3;40;.930;3600000;0
10861;-1;118;64;32;4;28;.875;3567000;0
10861;218830;118;0;0;0;0;.00nan;0;0
10862;199695;120;0;0;0;0;.00nan;0;0
10862;200390;120;38;30;6;24;.800;3600000;0
10862;206864;127;77;42;3;39;.929;3600000;0
10862;202314;127;0;0;0;0;.00nan;0;0
10863;208620;112;0;0;0;0;.00nan;0;0
10863;210785;123;0;0;0;0;.00nan;0;0
10863;202246;112;69;38;4;34;.895;3513000;0
10863;-1;123;59;22;2;20;.909;3600000;0
10864;204618;125;81;47;3;44;.936;3589000;0
10864;200233;108;0;0;0;0;.00nan;0;0
10864;207535;108;56;18;2;16;.889;3600000;0
10864;208391;125;0;0;0;0;.00nan;0;0
10865;213845;113;0;0;0;0;.00nan;0;0
10865;210765;113;41;30;5;25;.833;3585000;0
10865;202161;115;0;0;0;0;.00nan;0;0
10865;207439;115;46;21;3;18;.857;3600000;0
10866;197999;116;0;0;0;0;.00nan;0;0
10866;200293;126;35;22;5;17;.773;3900000;0
10866;216028;116;79;58;5;53;.914;3900000;0
10866;212039;126;0;0;0;0;.00nan;0;0
10867;199481;122;0;0;0;0;.00nan;0;0
10867;204618;125;0;0;0;0;.00nan;0;0
10867;205469;122;61;31;4;27;.871;3900000;0
10867;208391;125;80;43;4;39;.907;3900000;0
10868;213845;113;84;39;2;37;.949;3600000;0
10868;203412;117;27;22;5;17;.773;1849000;0
10868;210765;113;0;0;0;0;.00nan;0;0
10868;213504;117;61;9;0;9;1.000;1751000;0
10869;204711;119;35;19;4;15;.789;3658000;0
10869;210773;111;0;0;0;0;.00nan;0;0
10869;-1;119;0;0;0;0;.00nan;0;0
10869;-1;111;77;48;5;43;.896;3658000;0
10870;215968;110;39;8;2;6;.750;517000;0
10870;202161;115;63;33;3;30;.909;3600000;0
10870;207439;115;0;0;0;0;.00nan;0;0
10870;217985;110;20;33;7;26;.788;3083000;0
10871;215968;110;48;36;5;31;.861;3594000;0
10871;207493;121;0;0;0;0;.00nan;0;0
10871;202279;121;47;25;4;21;.840;3600000;0
10871;217985;110;0;0;0;0;.00nan;0;0
10872;203412;117;100;37;1;36;.973;3600000;0
10872;202161;115;28;26;5;21;.808;3600000;0
10872;207439;115;0;0;0;0;.00nan;0;0
10872;213504;117;0;0;0;0;.00nan;0;0
10873;197999;116;0;0;0;0;.00nan;0;0
10873;200293;126;0;0;0;0;.00nan;0;0
10873;216028;116;69;29;2;27;.931;3581000;0
10873;212039;126;67;18;1;17;.944;3600000;0
10874;204630;109;27;13;4;9;.692;980000;0
10874;200210;114;36;13;4;9;.692;3600000;0
10874;201631;109;59;29;3;26;.897;2620000;0
10874;207504;114;0;0;0;0;.00nan;0;0
10875;204711;119;0;0;0;0;.00nan;0;0
10875;200233;108;82;23;1;22;.957;3600000;0
10875;207535;108;0;0;0;0;.00nan;0;0
10875;-1;119;51;37;5;32;.865;3600000;0
10876;206731;124;31;18;4;14;.778;1005000;0
10876;206864;127;0;0;0;0;.00nan;0;0
10876;202314;127;54;44;5;39;.886;3591000;0
10876;203054;124;71;12;0;12;1.000;2595000;0
10877;208620;112;0;0;0;0;.00nan;0;0
10877;210785;123;23;14;4;10;.714;974000;0
10877;202246;112;49;26;4;22;.846;3600000;0
10877;-1;123;91;35;1;34;.971;2610000;0
10878;204711;119;0;0;0;0;.00nan;0;0
10878;210773;111;0;0;0;0;.00nan;0;0
10878;-1;119;100;32;0;32;1.000;3600000;0
10878;-1;111;71;22;1;21;.955;3544000;0
10879;213845;113;53;25;3;22;.880;3600000;0
10879;204630;109;83;47;4;43;.915;3544000;0
10879;210765;113;0;0;0;0;.00nan;0;0
10879;201631;109;0;0;0;0;.00nan;0;0
10880;206731;124;89;22;0;22;1.000;3600000;0
10880;206864;127;63;47;5;42;.894;3100000;0
10880;202314;127;36;9;3;6;.667;500000;0
10880;203054;124;0;0;0;0;.00nan;0;0
10881;199481;122;46;23;4;19;.826;3900000;0
10881;205469;122;0;0;0;0;.00nan;0;0
10881;207493;121;0;0;0;0;.00nan;0;0
10881;202279;121;82;45;4;41;.911;3900000;0
10882;203412;117;58;45;6;39;.867;3145000;0
10882;200293;126;0;0;0;0;.00nan;0;0
10882;212039;126;46;24;4;20;.833;3600000;0
10882;213504;117;54;4;0;4;1.000;407000;0
10883;204618;125;64;32;4;28;.875;3600000;0
10883;215968;110;78;22;1;21;.955;3600000;0
10883;217985;110;0;0;0;0;.00nan;0;0
10883;208391;125;0;0;0;0;.00nan;0;0
10884;199695;120;65;13;1;12;.923;1304000;0
10884;200390;120;48;32;5;27;.844;2296000;0
10884;-1;118;0;0;0;0;.00nan;0;0
10884;218830;118;85;17;0;17;1.000;3600000;0
10885;208620;112;66;22;2;20;.909;3600000;0
10885;210773;111;36;32;5;27;.844;3600000;0
10885;202246;112;0;0;0;0;.00nan;0;0
10885;-1;111;0;0;0;0;.00nan;0;0
10886;206731;124;99;24;0;24;1.000;3600000;0
10886;207493;121;64;34;4;30;.882;3600000;0
10886;202279;121;0;0;0;0;.00nan;0;0
10886;203054;124;0;0;0;0;.00nan;0;0
10887;199695;120;66;31;2;29;.935;3900000;0
10887;200390;120;0;0;0;0;.00nan;0;0
10887;210785;123;84;29;2;27;.931;3900000;0
10887;-1;123;0;0;0;0;.00nan;0;0
10888;203412;117;0;0;0;0;.00nan;0;0
10888;215968;110;0;0;0;0;.00nan;0;0
10888;217985;110;69;29;3;26;.897;3600000;0
10888;213504;117;52;40;5;35;.875;3566000;0
10889;200210;114;0;0;0;0;.00nan;0;0
10889;202161;115;98;38;2;36;.947;3600000;0
10889;207439;115;0;0;0;0;.00nan;0;0
10889;207504;114;42;19;4;15;.789;3563000;0
10890;204630;109;61;5;0;5;1.000;937000;0
10890;204711;119;0;0;0;0;.00nan;0;0
10890;201631;109;20;26;6;20;.769;2663000;0
10890;-1;119;20;17;5;12;.706;3600000;0
10891;197999;116;0;0;0;0;.00nan;0;0
10891;200210;114;59;34;4;30;.882;3600000;0
10891;216028;116;84;38;3;35;.921;3600000;0
10891;207504;114;0;0;0;0;.00nan;0;0
10892;210785;123;0;0;0;0;.00nan;0;0
10892;-1;123;39;40;6;34;.850;3600000;0
10892;-1;118;0;0;0;0;.00nan;0;0
10892;218830;118;56;21;2;19;.905;3600000;0
10893;199481;122;68;30;3;27;.900;3600000;0
10893;205469;122;0;0;0;0;.00nan;0;0
10893;210773;111;0;0;0;0;.00nan;0;0
10893;-1;111;59;44;5;39;.886;3570000;0
10894;204618;125;72;26;2;24;.923;3600000;0
10894;200293;126;0;0;0;0;.00nan;0;0
10894;212039;126;66;44;5;39;.886;3600000;0
10894;208391;125;0;0;0;0;.00nan;0;0
10895;213845;113;55;30;4;26;.867;3900000;0
10895;210765;113;0;0;0;0;.00nan;0;0
10895;206864;127;0;0;0;0;.00nan;0;0
10895;202314;127;50;27;4;23;.852;3900000;0
10896;199695;120;0;0;0;0;.00nan;0;0
10896;200233;108;58;22;3;19;.864;3600000;0
10896;200390;120;64;39;4;35;.897;3600000;0
10896;207535;108;0;0;0;0;.00nan;0;0
10986;213845;113;57;13;1;12;.923;3600000;0
10986;204630;109;59;47;6;41;.872;3600000;0
10986;210765;113;0;0;0;0;.00nan;0;0
10986;201631;109;0;0;0;0;.00nan;0;0
10988;204618;125;58;22;2;20;.909;3600000;0
10988;206864;127;0;0;0;0;.00nan;0;0
10988;202314;127;76;35;3;32;.914;3571000;0
10988;208391;125;0;0;0;0;.00nan;0;0
10990;206731;124;35;39;7;32;.821;3243000;0
10990;203054;124;51;2;0;2;1.000;300000;0
10990;-1;118;0;0;0;0;.00nan;0;0
10990;218830;118;28;29;6;23;.793;3600000;0
10992;197999;116;0;0;0;0;.00nan;0;0
10992;210773;111;0;0;0;0;.00nan;0;0
10992;216028;116;57;24;3;21;.875;3900000;0
10992;-1;111;75;45;3;42;.933;3900000;0
10994;208620;112;0;0;0;0;.00nan;0;0
10994;200233;108;55;37;5;32;.865;3600000;0
10994;202246;112;62;21;2;19;.905;3600000;0
10994;207535;108;0;0;0;0;.00nan;0;0
10996;199695;120;0;0;0;0;.00nan;0;0
10996;200293;126;0;0;0;0;.00nan;0;0
10996;200390;120;57;30;4;26;.867;3591000;0
10996;212039;126;63;29;3;26;.897;3600000;0
10998;204711;119;0;0;0;0;.00nan;0;0
10998;200210;114;55;18;2;16;.889;3691000;0
10998;207504;114;0;0;0;0;.00nan;0;0
10998;-1;119;61;26;3;23;.885;3691000;0
11000;210785;123;24;5;3;2;.400;365000;0
11000;207493;121;0;0;0;0;.00nan;0;0
11000;202279;121;45;28;5;23;.821;3600000;0
11000;-1;123;62;29;3;26;.897;3181000;0
11002;203412;117;63;26;3;23;.885;3600000;0
11002;199481;122;82;45;4;41;.911;3597000;0
11002;205469;122;0;0;0;0;.00nan;0;0
11002;213504;117;0;0;0;0;.00nan;0;0
11004;215968;110;65;30;3;27;.900;3600000;0
11004;202161;115;0;0;0;0;.00nan;0;0
11004;207439;115;65;50;6;44;.880;3600000;0
11004;217985;110;0;0;0;0;.00nan;0;0
11006;204630;109;0;0;0;0;.00nan;0;0
11006;206731;124;0;0;0;0;.00nan;0;0
11006;201631;109;83;36;3;33;.917;3900000;0
11006;203054;124;46;18;3;15;.833;3900000;0
11008;204711;119;44;39;6;33;.846;3600000;0
11008;200210;114;0;0;0;0;.00nan;0;0
11008;207504;114;41;16;3;13;.813;3600000;0
11008;-1;119;0;0;0;0;.00nan;0;0
11010;213845;113;0;0;0;0;.00nan;0;0
11010;199695;120;2;19;7;12;.632;2292000;0
11010;200390;120;50;14;2;12;.857;1308000;0
11010;210765;113;35;20;4;16;.800;3600000;0
11012;204618;125;0;0;0;0;.00nan;0;0
11012;200233;108;0;0;0;0;.00nan;0;0
11012;207535;108;65;24;2;22;.917;3600000;0
11012;208391;125;67;34;3;31;.912;3552000;0
11014;203412;117;0;0;0;0;.00nan;0;0
11014;215968;110;0;0;0;0;.00nan;0;0
11014;217985;110;63;18;2;16;.889;3600000;0
11014;213504;117;62;35;4;31;.886;3533000;0
11016;208620;112;53;26;3;23;.885;3600000;0
11016;206864;127;48;26;4;22;.846;3564000;0
11016;202246;112;0;0;0;0;.00nan;0;0
11016;202314;127;0;0;0;0;.00nan;0;0
11018;199481;122;0;0;0;0;.00nan;0;0
11018;205469;122;39;32;6;26;.813;3600000;0
11018;207493;121;70;29;2;27;.931;3600000;0
11018;202279;121;0;0;0;0;.00nan;0;0
11020;210773;111;36;9;3;6;.667;600000;0
11020;-1;111;54;39;5;34;.872;3000000;0
11020;-1;118;62;26;2;24;.923;3600000;0
11020;218830;118;0;0;0;0;.00nan;0;0
11022;200293;126;64;25;3;22;.880;3600000;0
11022;210785;123;37;36;6;30;.833;3600000;0
11022;212039;126;0;0;0;0;.00nan;0;0
11022;-1;123;0;0;0;0;.00nan;0;0
11024;197999;116;48;27;4;23;.852;3600000;0
11024;216028;116;0;0;0;0;.00nan;0;0
11024;202161;115;48;36;5;31;.861;3557000;0
11024;207439;115;0;0;0;0;.00nan;0;0
11026;199695;120;0;0;0;0;.00nan;0;0
11026;200210;114;68;42;4;38;.905;3559000;0
11026;200390;120;61;23;2;21;.913;3600000;0
11026;207504;114;0;0;0;0;.00nan;0;0
11028;208620;112;0;0;0;0;.00nan;0;0
11028;204630;109;89;47;4;43;.915;3564000;0
11028;201631;109;0;0;0;0;.00nan;0;0
11028;202246;112;55;23;3;20;.870;3600000;0
11030;197999;116;0;0;0;0;.00nan;0;0
11030;213845;113;68;38;4;34;.895;3691000;0
11030;210765;113;0;0;0;0;.00nan;0;0
11030;216028;116;42;33;5;28;.848;3691000;0
11032;204618;125;62;29;3;26;.897;3600000;0
11032;206731;124;92;22;0;22;1.000;3600000;0
11032;203054;124;0;0;0;0;.00nan;0;0
11032;208391;125;0;0;0;0;.00nan;0;0
11034;200293;126;0;0;0;0;.00nan;0;0
11034;212039;126;77;22;2;20;.909;3635000;0
11034;-1;118;0;0;0;0;.00nan;0;0
11034;218830;118;71;35;3;32;.914;3635000;0
11036;199481;122;70;34;4;30;.882;3281000;0
11036;204711;119;0;0;0;0;.00nan;0;0
11036;205469;122;28;8;3;5;.625;319000;0
11036;-1;119;61;18;2;16;.889;3600000;0
11038;210773;111;48;29;4;25;.862;3600000;0
11038;206864;127;50;6;1;5;.833;1169000;0
11038;202314;127;39;24;5;19;.792;2357000;0
11038;-1;111;0;0;0;0;.00nan;0;0
11040;215968;110;64;26;3;23;.885;3600000;0
11040;202161;115;0;0;0;0;.00nan;0;0
11040;207439;115;48;34;5;29;.853;3523000;0
11040;217985;110;0;0;0;0;.00nan;0;0
11042;203412;117;59;19;2;17;.895;3600000;0
11042;207493;121;34;34;7;27;.794;3145000;0
11042;202279;121;56;4;0;4;1.000;455000;0
11042;213504;117;0;0;0;0;.00nan;0;0
11044;200233;108;68;29;3;26;.897;3600000;0
11044;210785;123;0;0;0;0;.00nan;0;0
11044;207535;108;0;0;0;0;.00nan;0;0
11044;-1;123;39;27;5;22;.815;3518000;0
11046;200233;108;0;0;0;0;.00nan;0;0
11046;215968;110;0;0;0;0;.00nan;0;0
11046;207535;108;77;39;2;37;.949;3600000;0
11046;217985;110;28;25;5;20;.800;3600000;0
11048;203412;117;0;0;0;0;.00nan;0;0
11048;213504;117;65;33;5;28;.848;3783000;0
11048;-1;118;75;41;4;37;.902;3783000;0
11048;218830;118;0;0;0;0;.00nan;0;0
11050;204711;119;21;23;6;17;.739;3600000;0
11050;200210;114;0;0;0;0;.00nan;0;0
11050;207504;114;62;21;2;19;.905;3600000;0
11050;-1;119;0;0;0;0;.00nan;0;0
11052;199695;120;60;21;2;19;.905;3600000;0
11052;204618;125;0;0;0;0;.00nan;0;0
11052;200390;120;0;0;0;0;.00nan;0;0
11052;208391;125;51;33;4;29;.879;3600000;0
11054;199481;122;0;0;0;0;.00nan;0;0
11054;200293;126;58;19;2;17;.895;3600000;0
11054;205469;122;78;47;4;43;.915;3573000;0
11054;212039;126;0;0;0;0;.00nan;0;0
11056;213845;113;0;0;0;0;.00nan;0;0
11056;210765;113;72;22;2;20;.909;3600000;0
11056;210773;111;0;0;0;0;.00nan;0;0
11056;-1;111;41;35;5;30;.857;3600000;0
11058;208620;112;47;39;5;34;.872;3600000;0
11058;206731;124;0;0;0;0;.00nan;0;0
11058;202246;112;0;0;0;0;.00nan;0;0
11058;203054;124;64;33;3;30;.909;3600000;0
11060;197999;116;62;32;4;28;.875;3577000;0
11060;204630;109;64;20;2;18;.900;3600000;0
11060;216028;116;0;0;0;0;.00nan;0;0
11060;201631;109;0;0;0;0;.00nan;0;0
11062;206864;127;14;18;6;12;.667;2021000;0
11062;202161;115;57;39;4;35;.897;3600000;0
11062;207439;115;0;0;0;0;.00nan;0;0
11062;202314;127;51;6;1;5;.833;1579000;0
11064;210785;123;78;40;3;37;.925;3600000;0
11064;207493;121;0;0;0;0;.00nan;0;0
11064;202279;121;61;33;4;29;.879;3581000;0
11064;-1;123;0;0;0;0;.00nan;0;0
11066;204630;109;82;28;1;27;.964;3900000;0
11066;201631;109;0;0;0;0;.00nan;0;0
11066;207493;121;86;22;1;21;.955;3900000;0
11066;202279;121;0;0;0;0;.00nan;0;0
11068;215968;110;58;27;4;23;.852;3607000;0
11068;217985;110;0;0;0;0;.00nan;0;0
11068;-1;118;0;0;0;0;.00nan;0;0
11068;218830;118;68;32;3;29;.906;3607000;0
11070;213845;113;63;16;2;14;.875;3600000;0
11070;210765;113;0;0;0;0;.00nan;0;0
11070;210785;123;0;0;0;0;.00nan;0;0
11070;-1;123;87;48;4;44;.917;3585000;0
11072;199695;120;0;0;0;0;.00nan;0;0
11072;200293;126;0;0;0;0;.00nan;0;0
11072;200390;120;71;42;4;38;.905;3548000;0
11072;212039;126;43;14;3;11;.786;3600000;0
11074;197999;116;0;0;0;0;.00nan;0;0
11074;204618;125;49;28;4;24;.857;3544000;0
11074;216028;116;69;30;3;27;.900;3600000;0
11074;208391;125;0;0;0;0;.00nan;0;0
11076;208620;112;0;0;0;0;.00nan;0;0
11076;199481;122;56;17;2;15;.882;3600000;0
11076;205469;122;0;0;0;0;.00nan;0;0
11076;202246;112;78;29;3;26;.897;3592000;0
11078;210773;111;0;0;0;0;.00nan;0;0
11078;206731;124;44;17;4;13;.765;3596000;0
11078;-1;111;75;43;3;40;.930;3600000;0
11078;203054;124;0;0;0;0;.00nan;0;0
11080;203412;117;95;25;0;25;1.000;3600000;0
11080;204711;119;0;0;0;0;.00nan;0;0
11080;-1;119;71;34;3;31;.912;3600000;0
11080;213504;117;0;0;0;0;.00nan;0;0
11082;200233;108;69;32;3;29;.906;3900000;0
11082;202161;115;0;0;0;0;.00nan;0;0
11082;207439;115;89;52;3;49;.942;3900000;0
11082;207535;108;0;0;0;0;.00nan;0;0
11084;200210;114;0;0;0;0;.00nan;0;0
11084;206864;127;0;0;0;0;.00nan;0;0
11084;207504;114;64;26;3;23;.885;3600000;0
11084;202314;127;47;39;5;34;.872;3538000;0
11086;213845;113;43;33;5;28;.848;3549000;0
11086;203412;117;60;28;3;25;.893;3600000;0
11086;210765;113;0;0;0;0;.00nan;0;0
11086;213504;117;0;0;0;0;.00nan;0;0
11088;197999;116;66;27;2;25;.926;3587000;0
11088;216028;116;0;0;0;0;.00nan;0;0
11088;-1;118;88;26;1;25;.962;3600000;0
11088;218830;118;0;0;0;0;.00nan;0;0
11090;200210;114;90;44;2;42;.955;3859000;0
11090;206864;127;51;25;3;22;.880;3859000;0
11090;207504;114;0;0;0;0;.00nan;0;0
11090;202314;127;0;0;0;0;.00nan;0;0
11092;204618;125;54;4;0;4;1.000;669000;0
11092;215968;110;0;0;0;0;.00nan;0;0
11092;217985;110;32;23;5;18;.783;3600000;0
11092;208391;125;40;39;6;33;.846;2882000;0
11094;204711;119;67;25;2;23;.920;3600000;0
11094;210785;123;30;29;7;22;.759;2010000;0
11094;-1;119;0;0;0;0;.00nan;0;0
11094;-1;123;54;8;1;7;.875;1590000;0
11096;208620;112;72;27;2;25;.926;3600000;0
11096;207493;121;0;0;0;0;.00nan;0;0
11096;202246;112;0;0;0;0;.00nan;0;0
11096;202279;121;78;32;3;29;.906;3592000;0
11098;204630;109;28;14;4;10;.714;1562000;0
11098;206731;124;0;0;0;0;.00nan;0;0
11098;201631;109;37;31;5;26;.839;2038000;0
11098;203054;124;61;20;2;18;.900;3600000;0
11100;200233;108;0;0;0;0;.00nan;0;0
11100;210773;111;63;46;5;41;.891;3600000;0
11100;207535;108;51;15;2;13;.867;3600000;0
11100;-1;111;0;0;0;0;.00nan;0;0
11102;200293;126;37;26;5;21;.808;3588000;0
11102;212039;126;0;0;0;0;.00nan;0;0
11102;202161;115;96;60;4;56;.933;3600000;0
11102;207439;115;0;0;0;0;.00nan;0;0
11104;199481;122;0;0;0;0;.00nan;0;0
11104;199695;120;36;29;6;23;.793;3590000;0
11104;200390;120;0;0;0;0;.00nan;0;0
11104;205469;122;48;24;4;20;.833;3600000;0
11106;204711;119;0;0;0;0;.00nan;0;0
11106;215968;110;46;20;3;17;.850;3600000;0
11106;217985;110;0;0;0;0;.00nan;0;0
11106;-1;119;46;37;5;32;.865;3557000;0
11108;200293;126;0;0;0;0;.00nan;0;0
11108;206731;124;87;38;2;36;.947;3600000;0
11108;212039;126;46;21;4;17;.810;3578000;0
11108;203054;124;0;0;0;0;.00nan;0;0
11110;200210;114;65;37;4;33;.892;3600000;0
11110;207504;114;0;0;0;0;.00nan;0;0
11110;-1;118;0;0;0;0;.00nan;0;0
11110;218830;118;56;18;2;16;.889;3600000;0
11112;206864;127;0;0;0;0;.00nan;0;0
11112;207493;121;0;0;0;0;.00nan;0;0
11112;202279;121;49;34;5;29;.853;3600000;0
11112;202314;127;63;24;2;22;.917;3600000;0
11114;208620;112;0;0;0;0;.00nan;0;0
11114;204630;109;49;28;4;24;.857;3600000;0
11114;201631;109;0;0;0;0;.00nan;0;0
11114;202246;112;100;25;0;25;1.000;3600000;0
11116;197999;116;0;0;0;0;.00nan;0;0
11116;204618;125;61;22;2;20;.909;3600000;0
11116;216028;116;63;40;4;36;.900;3572000;0
11116;208391;125;0;0;0;0;.00nan;0;0
11118;203412;117;45;30;6;24;.800;3692000;0
11118;200233;108;36;24;5;19;.792;3692000;0
11118;207535;108;0;0;0;0;.00nan;0;0
11118;213504;117;0;0;0;0;.00nan;0;0
11120;199481;122;67;32;4;28;.875;3600000;0
11120;205469;122;0;0;0;0;.00nan;0;0
11120;210785;123;46;16;2;14;.875;2955000;0
11120;-1;123;27;7;3;4;.571;592000;0
11122;213845;113;76;24;1;23;.958;3600000;0
11122;210765;113;0;0;0;0;.00nan;0;0
11122;202161;115;68;33;3;30;.909;3600000;0
11122;207439;115;0;0;0;0;.00nan;0;0
11124;199695;120;48;15;2;13;.867;1622000;0
11124;200390;120;42;30;5;25;.833;1978000;0
11124;210773;111;0;0;0;0;.00nan;0;0
11124;-1;111;78;25;2;23;.920;3600000;0
11125;199784;87;26;9;3;6;.667;380000;0
11125;205076;87;60;29;3;26;.897;3220000;0
11125;210480;88;0;0;0;0;.00nan;0;0
11125;-1;88;47;20;3;17;.850;3600000;0
11126;200065;93;0;0;0;0;.00nan;0;0
11126;205318;97;0;0;0;0;.00nan;0;0
11126;205824;97;49;16;2;14;.875;3543000;0
11126;-1;93;100;35;0;35;1.000;3600000;0
11127;209784;91;89;44;3;41;.932;3542000;0
11127;205429;91;0;0;0;0;.00nan;0;0
11127;200572;95;78;25;1;24;.960;3600000;0
11127;212487;95;0;0;0;0;.00nan;0;0
11128;194502;86;70;29;2;27;.931;3600000;0
11128;205124;89;0;0;0;0;.00nan;0;0
11128;201792;89;56;34;4;30;.882;3550000;0
11128;201876;86;0;0;0;0;.00nan;0;0
11129;192739;92;100;38;1;37;.974;3600000;0
11129;212301;92;0;0;0;0;.00nan;0;0
11129;212343;96;0;0;0;0;.00nan;0;0
11129;-1;96;56;30;4;26;.867;3600000;0
11130;197962;99;0;0;0;0;.00nan;0;0
11130;210603;104;43;25;4;21;.840;3574000;0
11130;202788;99;68;28;2;26;.929;3600000;0
11130;208300;104;0;0;0;0;.00nan;0;0
11131;199768;105;0;0;0;0;.00nan;0;0
11131;205112;105;78;46;4;42;.913;3600000;0
11131;200549;102;29;23;6;17;.739;3597000;0
11131;210923;102;0;0;0;0;.00nan;0;0
11132;210368;106;0;0;0;0;.00nan;0;0
11132;205276;103;0;0;0;0;.00nan;0;0
11132;210428;103;78;49;5;44;.898;3600000;0
11132;-1;106;63;25;3;22;.880;3600000;0
11133;197940;100;70;18;1;17;.944;3600000;0
11133;208417;101;0;0;0;0;.00nan;0;0
11133;201739;101;56;34;4;30;.882;3600000;0
11133;212368;100;0;0;0;0;.00nan;0;0
11134;200065;93;51;27;4;23;.852;3600000;0
11134;205318;97;32;11;3;8;.727;481000;0
11134;205824;97;56;25;3;22;.880;3048000;0
11134;-1;93;0;0;0;0;.00nan;0;0
11135;199784;87;0;0;0;0;.00nan;0;0
11135;194502;86;47;27;4;23;.852;3579000;0
11135;205076;87;65;26;2;24;.923;3600000;0
11135;201876;86;0;0;0;0;.00nan;0;0
11136;199768;105;0;0;0;0;.00nan;0;0
11136;205112;105;39;27;5;22;.815;3600000;0
11136;200549;102;55;20;2;18;.900;3600000;0
11136;210923;102;0;0;0;0;.00nan;0;0
11137;210480;88;46;42;6;36;.857;3600000;0
11137;201888;90;0;0;0;0;.00nan;0;0
11137;-1;90;61;23;2;21;.913;3600000;0
11137;-1;88;0;0;0;0;.00nan;0;0
11138;209784;91;0;0;0;0;.00nan;0;0
11138;205429;91;83;32;3;29;.906;3600000;0
11138;200572;95;25;24;6;18;.750;3600000;0
11138;212487;95;0;0;0;0;.00nan;0;0
11139;209796;107;0;0;0;0;.00nan;0;0
11139;205276;103;0;0;0;0;.00nan;0;0
11139;210428;103;84;42;3;39;.929;3600000;0
11139;201817;107;45;24;5;19;.792;3522000;0
11140;192739;92;65;19;2;17;.895;3600000;0
11140;212301;92;0;0;0;0;.00nan;0;0
11140;212343;96;0;0;0;0;.00nan;0;0
11140;-1;96;67;45;5;40;.889;3600000;0
11141;197940;100;75;38;4;34;.895;3600000;0
11141;215785;94;100;33;0;33;1.000;3600000;0
11141;212368;100;0;0;0;0;.00nan;0;0
11141;-1;94;0;0;0;0;.00nan;0;0
11142;210368;106;35;21;4;17;.810;3552000;0
11142;207118;98;64;32;3;29;.906;3600000;0
11142;-1;106;0;0;0;0;.00nan;0;0
11142;-1;98;0;0;0;0;.00nan;0;0
11143;205124;89;0;0;0;0;.00nan;0;0
11143;201792;89;62;33;4;29;.879;3561000;0
11143;201888;90;53;21;3;18;.857;3600000;0
11143;-1;90;0;0;0;0;.00nan;0;0
11144;210603;104;56;31;4;27;.871;3600000;0
11144;215785;94;33;32;6;26;.813;3267000;0
11144;-1;94;51;2;0;2;1.000;284000;0
11144;208300;104;0;0;0;0;.00nan;0;0
11145;199784;87;0;0;0;0;.00nan;0;0
11145;205076;87;47;31;5;26;.839;3600000;0
11145;205124;89;46;28;4;24;.857;2739000;0
11145;201792;89;34;14;4;10;.714;861000;0
11146;194502;86;60;34;4;30;.882;3837000;0
11146;210480;88;48;23;3;20;.870;3837000;0
11146;201876;86;0;0;0;0;.00nan;0;0
11146;-1;88;0;0;0;0;.00nan;0;0
11147;199784;87;39;37;6;31;.838;3282000;0
11147;194502;86;0;0;0;0;.00nan;0;0
11147;205076;87;26;6;3;3;.500;318000;0
11147;201876;86;61;22;3;19;.864;3600000;0
11148;205124;89;0;0;0;0;.00nan;0;0
11148;210480;88;64;30;3;27;.900;3600000;0
11148;201792;89;100;38;0;38;1.000;3600000;0
11148;-1;88;0;0;0;0;.00nan;0;0
11149;205318;97;33;18;4;14;.778;2235000;0
11149;205824;97;76;11;0;11;1.000;1665000;0
11149;212343;96;0;0;0;0;.00nan;0;0
11149;-1;96;75;45;4;41;.911;3900000;0
11150;200065;93;76;35;3;32;.914;3514000;0
11150;200572;95;81;26;1;25;.962;3600000;0
11150;212487;95;0;0;0;0;.00nan;0;0
11150;-1;93;0;0;0;0;.00nan;0;0
11151;192739;92;92;39;2;37;.949;3877000;0
11151;209784;91;0;0;0;0;.00nan;0;0
11151;205429;91;91;41;3;38;.927;3877000;0
11151;212301;92;0;0;0;0;.00nan;0;0
11152;208417;101;55;5;0;5;1.000;607000;0
11152;197962;99;0;0;0;0;.00nan;0;0
11152;201739;101;41;37;6;31;.838;2993000;0
11152;202788;99;49;23;3;20;.870;3600000;0
11153;205276;103;0;0;0;0;.00nan;0;0
11153;210428;103;59;23;3;20;.870;3600000;0
11153;215785;94;30;26;6;20;.769;3600000;0
11153;-1;94;0;0;0;0;.00nan;0;0
11154;197940;100;0;0;0;0;.00nan;0;0
11154;200549;102;91;47;3;44;.936;3552000;0
11154;210923;102;0;0;0;0;.00nan;0;0
11154;212368;100;84;26;1;25;.962;3600000;0
11155;199784;87;67;43;4;39;.907;3566000;0
11155;205076;87;0;0;0;0;.00nan;0;0
11155;200572;95;50;21;3;18;.857;3600000;0
11155;212487;95;0;0;0;0;.00nan;0;0
11156;205318;97;54;27;4;23;.852;3600000;0
11156;205824;97;0;0;0;0;.00nan;0;0
11156;201888;90;0;0;0;0;.00nan;0;0
11156;-1;90;65;38;5;33;.868;3543000;0
11157;194502;86;91;35;2;33;.943;3600000;0
11157;210480;88;0;0;0;0;.00nan;0;0
11157;201876;86;0;0;0;0;.00nan;0;0
11157;-1;88;57;32;4;28;.875;3536000;0
11158;209796;107;0;0;0;0;.00nan;0;0
11158;210368;106;0;0;0;0;.00nan;0;0
11158;201817;107;57;47;5;42;.894;3600000;0
11158;-1;106;61;28;4;24;.857;3600000;0
11159;199768;105;0;0;0;0;.00nan;0;0
11159;205112;105;94;24;0;24;1.000;3600000;0
11159;210603;104;42;32;5;27;.844;3600000;0
11159;208300;104;0;0;0;0;.00nan;0;0
11160;197962;99;58;24;3;21;.875;3600000;0
11160;215785;94;0;0;0;0;.00nan;0;0
11160;202788;99;0;0;0;0;.00nan;0;0
11160;-1;94;47;23;4;19;.826;3595000;0
11161;197940;100;85;35;2;33;.943;3600000;0
11161;200549;102;0;0;0;0;.00nan;0;0
11161;210923;102;68;36;4;32;.889;3595000;0
11161;212368;100;0;0;0;0;.00nan;0;0
11162;205276;103;0;0;0;0;.00nan;0;0
11162;210428;103;55;30;4;26;.867;3600000;0
11162;207118;98;51;32;5;27;.844;3554000;0
11162;-1;98;0;0;0;0;.00nan;0;0
11163;200065;93;60;32;4;28;.875;3562000;0
11163;201888;90;70;36;3;33;.917;3600000;0
11163;-1;90;0;0;0;0;.00nan;0;0
11163;-1;93;0;0;0;0;.00nan;0;0
11164;192739;92;96;21;0;21;1.000;3600000;0
11164;209784;91;0;0;0;0;.00nan;0;0
11164;205429;91;40;38;6;32;.842;3600000;0
11164;212301;92;0;0;0;0;.00nan;0;0
11165;208417;101;49;25;3;22;.880;3575000;0
11165;205276;103;0;0;0;0;.00nan;0;0
11165;210428;103;67;19;1;18;.947;3600000;0
11165;201739;101;0;0;0;0;.00nan;0;0
11166;192739;92;81;27;2;25;.926;3600000;0
11166;205124;89;0;0;0;0;.00nan;0;0
11166;201792;89;17;31;7;24;.774;3600000;0
11166;212301;92;0;0;0;0;.00nan;0;0
11167;200549;102;42;30;6;24;.800;3658000;0
11167;210923;102;0;0;0;0;.00nan;0;0
11167;207118;98;48;36;5;31;.861;3658000;0
11167;-1;98;0;0;0;0;.00nan;0;0
11168;199784;87;38;13;3;10;.769;1000000;0
11168;205076;87;42;48;7;41;.854;2600000;0
11168;200572;95;61;15;1;14;.933;3600000;0
11168;212487;95;0;0;0;0;.00nan;0;0
11169;205318;97;0;0;0;0;.00nan;0;0
11169;210480;88;67;13;1;12;.923;3600000;0
11169;205824;97;65;29;3;26;.897;3519000;0
11169;-1;88;0;0;0;0;.00nan;0;0
11170;192739;92;0;0;0;0;.00nan;0;0
11170;212301;92;77;34;2;32;.941;3564000;0
11170;201888;90;0;0;0;0;.00nan;0;0
11170;-1;90;93;27;0;27;1.000;3600000;0
11171;200549;102;0;0;0;0;.00nan;0;0
11171;210923;102;60;27;3;24;.889;3573000;0
11171;207118;98;0;0;0;0;.00nan;0;0
11171;-1;98;66;23;2;21;.913;3600000;0
11172;209784;91;90;35;3;32;.914;3600000;0
11172;194502;86;60;38;5;33;.868;3578000;0
11172;205429;91;0;0;0;0;.00nan;0;0
11172;201876;86;0;0;0;0;.00nan;0;0
11173;205124;89;0;0;0;0;.00nan;0;0
11173;201792;89;55;28;3;25;.893;3586000;0
11173;212343;96;0;0;0;0;.00nan;0;0
11173;-1;96;90;35;2;33;.943;3600000;0
11174;205318;97;69;56;7;49;.875;3600000;0
11174;200572;95;0;0;0;0;.00nan;0;0
11174;205824;97;0;0;0;0;.00nan;0;0
11174;212487;95;30;16;4;12;.750;3600000;0
11175;197940;100;98;44;1;43;.977;3900000;0
11175;197962;99;0;0;0;0;.00nan;0;0
11175;212368;100;0;0;0;0;.00nan;0;0
11175;202788;99;100;34;1;33;.971;3900000;0
11176;210368;106;70;16;1;15;.938;3600000;0
11176;215785;94;58;43;5;38;.884;3600000;0
11176;-1;106;0;0;0;0;.00nan;0;0
11176;-1;94;0;0;0;0;.00nan;0;0
11177;205276;103;0;0;0;0;.00nan;0;0
11177;210428;103;37;41;7;34;.829;3600000;0
11177;200549;102;57;20;3;17;.850;3600000;0
11177;210923;102;0;0;0;0;.00nan;0;0
11178;209796;107;26;31;6;25;.806;3600000;0
11178;210603;104;69;32;3;29;.906;3600000;0
11178;201817;107;0;0;0;0;.00nan;0;0
11178;208300;104;0;0;0;0;.00nan;0;0
11179;199784;87;88;33;2;31;.939;3600000;0
11179;200065;93;47;29;4;25;.862;3536000;0
11179;205076;87;0;0;0;0;.00nan;0;0
11179;-1;93;0;0;0;0;.00nan;0;0
11180;194502;86;91;30;1;29;.967;3600000;0
11180;205318;97;0;0;0;0;.00nan;0;0
11180;205824;97;68;34;3;31;.912;3563000;0
11180;201876;86;0;0;0;0;.00nan;0;0
11181;208417;101;0;0;0;0;.00nan;0;0
11181;210368;106;0;0;0;0;.00nan;0;0
11181;201739;101;71;43;5;38;.884;3900000;0
11181;-1;106;41;32;5;27;.844;3880000;0
11182;205276;103;0;0;0;0;.00nan;0;0
11182;210428;103;100;40;0;40;1.000;3600000;0
11182;200549;102;0;0;0;0;.00nan;0;0
11182;210923;102;77;26;1;25;.962;3560000;0
11183;209784;91;0;0;0;0;.00nan;0;0
11183;205429;91;69;24;2;22;.917;3600000;0
11183;212343;96;59;28;3;25;.893;3556000;0
11183;-1;96;0;0;0;0;.00nan;0;0
11184;210480;88;0;0;0;0;.00nan;0;0
11184;201888;90;0;0;0;0;.00nan;0;0
11184;-1;90;44;31;5;26;.839;3535000;0
11184;-1;88;83;44;3;41;.932;3600000;0
11185;192739;92;86;37;2;35;.946;3600000;0
11185;205124;89;65;32;3;29;.906;3590000;0
11185;201792;89;0;0;0;0;.00nan;0;0
11185;212301;92;0;0;0;0;.00nan;0;0
11186;199768;105;0;0;0;0;.00nan;0;0
11186;205112;105;80;30;1;29;.967;3600000;0
11186;215785;94;0;0;0;0;.00nan;0;0
11186;-1;94;40;25;4;21;.840;3600000;0
11187;210603;104;0;0;0;0;.00nan;0;0
11187;207118;98;0;0;0;0;.00nan;0;0
11187;-1;98;70;19;1;18;.947;3600000;0
11187;208300;104;50;37;6;31;.838;3600000;0
11188;197962;99;65;15;1;14;.933;3600000;0
11188;205276;103;0;0;0;0;.00nan;0;0
11188;210428;103;53;28;4;24;.857;3600000;0
11188;202788;99;0;0;0;0;.00nan;0;0
11189;197940;100;55;27;3;24;.889;3573000;0
11189;212368;100;0;0;0;0;.00nan;0;0
11189;207118;98;90;43;2;41;.953;3600000;0
11189;-1;98;0;0;0;0;.00nan;0;0
11190;192739;92;70;29;3;26;.897;3600000;0
11190;209784;91;37;31;5;26;.839;3564000;0
11190;205429;91;0;0;0;0;.00nan;0;0
11190;212301;92;0;0;0;0;.00nan;0;0
11191;200065;93;65;26;2;24;.923;3600000;0
11191;194502;86;81;39;3;36;.923;3579000;0
11191;201876;86;0;0;0;0;.00nan;0;0
11191;-1;93;0;0;0;0;.00nan;0;0
11192;199784;87;0;0;0;0;.00nan;0;0
11192;209784;91;0;0;0;0;.00nan;0;0
11192;205076;87;76;24;2;22;.917;3600000;0
11192;205429;91;45;26;5;21;.808;3600000;0
11193;200065;93;0;0;0;0;.00nan;0;0
11193;210480;88;55;22;3;19;.864;3600000;0
11193;-1;88;0;0;0;0;.00nan;0;0
11193;-1;93;38;26;4;22;.846;3551000;0
11194;200549;102;90;35;1;34;.971;3600000;0
11194;200572;95;56;19;2;17;.895;3581000;0
11194;210923;102;0;0;0;0;.00nan;0;0
11194;212487;95;0;0;0;0;.00nan;0;0
11195;197962;99;0;0;0;0;.00nan;0;0
11195;210603;104;69;18;1;17;.944;3600000;0
11195;202788;99;67;33;3;30;.909;3582000;0
11195;208300;104;0;0;0;0;.00nan;0;0
11196;209784;91;99;48;2;46;.958;3600000;0
11196;194502;86;58;30;3;27;.900;3547000;0
11196;205429;91;0;0;0;0;.00nan;0;0
11196;201876;86;0;0;0;0;.00nan;0;0
11197;200065;93;24;5;3;2;.400;324000;0
11197;205124;89;0;0;0;0;.00nan;0;0
11197;201792;89;63;33;3;30;.909;3600000;0
11197;-1;93;70;26;2;24;.923;3192000;0
11198;210480;88;0;0;0;0;.00nan;0;0
11198;212343;96;0;0;0;0;.00nan;0;0
11198;-1;88;50;35;6;29;.829;3600000;0
11198;-1;96;73;38;3;35;.921;3600000;0
11199;197962;99;0;0;0;0;.00nan;0;0
11199;210368;106;56;25;3;22;.880;3600000;0
11199;202788;99;100;25;0;25;1.000;3600000;0
11199;-1;106;0;0;0;0;.00nan;0;0
11200;208417;101;0;0;0;0;.00nan;0;0
11200;200572;95;35;22;5;17;.773;3600000;0
11200;201739;101;77;37;2;35;.946;3600000;0
11200;212487;95;0;0;0;0;.00nan;0;0
11201;200549;102;79;32;2;30;.938;3766000;0
11201;210923;102;0;0;0;0;.00nan;0;0
11201;207118;98;0;0;0;0;.00nan;0;0
11201;-1;98;87;24;1;23;.958;3766000;0
11202;209796;107;0;0;0;0;.00nan;0;0
11202;205276;103;0;0;0;0;.00nan;0;0
11202;210428;103;62;27;3;24;.889;3600000;0
11202;201817;107;100;27;0;27;1.000;3600000;0
11203;199768;105;49;31;4;27;.871;3865000;0
11203;199784;87;0;0;0;0;.00nan;0;0
11203;205076;87;59;33;4;29;.879;3900000;0
11203;205112;105;0;0;0;0;.00nan;0;0
11204;197940;100;85;28;1;27;.964;3600000;0
11204;215785;94;76;44;4;40;.909;3600000;0
11204;212368;100;0;0;0;0;.00nan;0;0
11204;-1;94;0;0;0;0;.00nan;0;0
11205;194502;86;0;0;0;0;.00nan;0;0
11205;205124;89;55;42;5;37;.881;3900000;0
11205;201792;89;0;0;0;0;.00nan;0;0
11205;201876;86;36;31;5;26;.839;3900000;0
11206;209784;91;0;0;0;0;.00nan;0;0
11206;210480;88;50;31;5;26;.839;3600000;0
11206;205429;91;83;33;2;31;.939;3600000;0
11206;-1;88;0;0;0;0;.00nan;0;0
11207;200065;93;43;25;4;21;.840;3530000;0
11207;201888;90;0;0;0;0;.00nan;0;0
11207;-1;90;98;50;2;48;.960;3600000;0
11207;-1;93;0;0;0;0;.00nan;0;0
11208;199784;87;80;39;2;37;.949;3600000;0
11208;205076;87;0;0;0;0;.00nan;0;0
11208;210603;104;82;23;1;22;.957;3600000;0
11208;208300;104;0;0;0;0;.00nan;0;0
11209;197962;99;0;0;0;0;.00nan;0;0
11209;199768;105;0;0;0;0;.00nan;0;0
11209;205112;105;100;38;1;37;.974;3600000;0
11209;202788;99;61;27;3;24;.889;3529000;0
11210;197940;100;0;0;0;0;.00nan;0;0
11210;200572;95;72;22;2;20;.909;3600000;0
11210;212368;100;76;45;4;41;.911;3558000;0
11210;212487;95;0;0;0;0;.00nan;0;0
11211;205318;97;90;34;1;33;.971;3600000;0
11211;205824;97;0;0;0;0;.00nan;0;0
11211;207118;98;68;32;3;29;.906;3513000;0
11211;-1;98;0;0;0;0;.00nan;0;0
11212;192739;92;53;15;2;13;.867;3600000;0
11212;212301;92;0;0;0;0;.00nan;0;0
11212;212343;96;0;0;0;0;.00nan;0;0
11212;-1;96;64;46;5;41;.891;3600000;0
11213;199768;105;85;37;2;35;.946;3733000;0
11213;205112;105;0;0;0;0;.00nan;0;0
11213;210368;106;0;0;0;0;.00nan;0;0
11213;-1;106;67;17;1;16;.941;3733000;0
11214;205124;89;0;0;0;0;.00nan;0;0
11214;201792;89;99;38;1;37;.974;3600000;0
11214;201888;90;0;0;0;0;.00nan;0;0
11214;-1;90;36;23;4;19;.826;3600000;0
11215;194502;86;52;38;5;33;.868;3600000;0
11215;210480;88;0;0;0;0;.00nan;0;0
11215;201876;86;0;0;0;0;.00nan;0;0
11215;-1;88;56;12;1;11;.917;3600000;0
11216;192739;92;61;22;2;20;.909;3600000;0
11216;212301;92;0;0;0;0;.00nan;0;0
11216;212343;96;0;0;0;0;.00nan;0;0
11216;-1;96;64;47;6;41;.872;3600000;0
11217;197962;99;50;40;6;34;.850;2943000;0
11217;200572;95;100;24;0;24;1.000;3600000;0
11217;212487;95;0;0;0;0;.00nan;0;0
11217;202788;99;54;9;1;8;.889;657000;0
11218;199784;87;63;40;4;36;.900;3600000;0
11218;209796;107;0;0;0;0;.00nan;0;0
11218;205076;87;0;0;0;0;.00nan;0;0
11218;201817;107;100;36;1;35;.972;3600000;0
11219;197940;100;100;35;0;35;1.000;3600000;0
11219;205318;97;38;23;4;19;.826;3600000;0
11219;205824;97;0;0;0;0;.00nan;0;0
11219;212368;100;0;0;0;0;.00nan;0;0
11220;209784;91;53;43;6;37;.860;3587000;0
11220;200065;93;25;11;4;7;.636;993000;0
11220;205429;91;0;0;0;0;.00nan;0;0
11220;-1;93;66;11;0;11;1.000;2607000;0
11221;199784;87;59;7;0;7;1.000;576000;0
11221;205076;87;32;40;7;33;.825;3024000;0
11221;210368;106;43;17;4;13;.765;3600000;0
11221;-1;106;0;0;0;0;.00nan;0;0
11222;208417;101;0;0;0;0;.00nan;0;0
11222;205318;97;0;0;0;0;.00nan;0;0
11222;205824;97;89;38;3;35;.921;3600000;0
11222;201739;101;90;22;0;22;1.000;3600000;0
11223;200572;95;68;19;1;18;.947;3600000;0
11223;207118;98;0;0;0;0;.00nan;0;0
11223;212487;95;0;0;0;0;.00nan;0;0
11223;-1;98;85;49;3;46;.939;3576000;0
11224;199768;105;72;15;0;15;1.000;1703000;0
11224;205112;105;25;14;4;10;.714;1867000;0
11224;205276;103;0;0;0;0;.00nan;0;0
11224;210428;103;56;18;2;16;.889;3600000;0
11225;192739;92;0;0;0;0;.00nan;0;0
11225;212301;92;46;26;4;22;.846;3600000;0
11225;201888;90;0;0;0;0;.00nan;0;0
11225;-1;90;47;28;5;23;.821;3594000;0
11226;209796;107;5;24;7;17;.708;2983000;0
11226;200065;93;28;26;6;20;.769;2096000;0
11226;201817;107;44;4;1;3;.750;578000;0
11226;-1;93;64;7;0;7;1.000;1504000;0
11227;209784;91;0;0;0;0;.00nan;0;0
11227;205429;91;41;14;3;11;.786;3608000;0
11227;212343;96;0;0;0;0;.00nan;0;0
11227;-1;96;72;40;4;36;.900;3608000;0
11228;205124;89;91;37;2;35;.946;3600000;0
11228;210480;88;51;22;3;19;.864;3564000;0
11228;201792;89;0;0;0;0;.00nan;0;0
11228;-1;88;0;0;0;0;.00nan;0;0
11229;197962;99;0;0;0;0;.00nan;0;0
11229;205318;97;0;0;0;0;.00nan;0;0
11229;205824;97;97;34;1;33;.971;3600000;0
11229;202788;99;65;22;2;20;.909;3563000;0
11230;208417;101;0;0;0;0;.00nan;0;0
11230;205276;103;0;0;0;0;.00nan;0;0
11230;210428;103;90;20;0;20;1.000;3600000;0
11230;201739;101;40;29;5;24;.828;3600000;0
11231;199768;105;0;0;0;0;.00nan;0;0
11231;205112;105;47;33;5;28;.848;3600000;0
11231;207118;98;81;31;2;29;.935;3600000;0
11231;-1;98;0;0;0;0;.00nan;0;0
11232;199784;87;67;22;2;20;.909;3600000;0
11232;205076;87;0;0;0;0;.00nan;0;0
11232;215785;94;54;37;5;32;.865;3600000;0
11232;-1;94;0;0;0;0;.00nan;0;0
11233;197940;100;64;25;2;23;.920;3567000;0
11233;210603;104;70;23;1;22;.957;3600000;0
11233;212368;100;0;0;0;0;.00nan;0;0
11233;208300;104;0;0;0;0;.00nan;0;0
11234;194502;86;47;21;3;18;.857;3600000;0
11234;205124;89;0;0;0;0;.00nan;0;0
11234;201792;89;63;46;5;41;.891;3600000;0
11234;201876;86;0;0;0;0;.00nan;0;0
11235;197962;99;73;29;2;27;.931;3600000;0
11235;200549;102;0;0;0;0;.00nan;0;0
11235;210923;102;55;30;4;26;.867;3549000;0
11235;202788;99;0;0;0;0;.00nan;0;0
11236;212343;96;43;35;6;29;.829;2008000;0
11236;201888;90;52;1;0;1;1.000;625000;0
11236;-1;90;33;26;6;20;.769;2975000;0
11236;-1;96;60;19;2;17;.895;1505000;0
11237;199784;87;0;0;0;0;.00nan;0;0
11237;205076;87;95;44;2;42;.955;3600000;0
11237;205276;103;23;36;8;28;.778;3258000;0
11237;210428;103;50;1;0;1;1.000;342000;0
11238;210368;106;55;14;1;13;.929;3600000;0
11238;215785;94;0;0;0;0;.00nan;0;0
11238;-1;106;0;0;0;0;.00nan;0;0
11238;-1;94;97;52;2;50;.962;3591000;0
11239;197940;100;0;0;0;0;.00nan;0;0
11239;210603;104;0;0;0;0;.00nan;0;0
11239;212368;100;68;29;3;26;.897;3600000;0
11239;208300;104;43;24;4;20;.833;3599000;0
11240;208417;101;40;22;4;18;.818;3600000;0
11240;201739;101;0;0;0;0;.00nan;0;0
11240;207118;98;0;0;0;0;.00nan;0;0
11240;-1;98;83;28;1;27;.964;3600000;0
11241;209784;91;0;0;0;0;.00nan;0;0
11241;200065;93;0;0;0;0;.00nan;0;0
11241;205429;91;70;50;5;45;.900;3543000;0
11241;-1;93;62;28;3;25;.893;3600000;0
11242;210480;88;0;0;0;0;.00nan;0;0
11242;200572;95;73;29;1;28;.966;3600000;0
11242;212487;95;0;0;0;0;.00nan;0;0
11242;-1;88;41;46;7;39;.848;3600000;0
11243;192739;92;59;14;1;13;.929;3600000;0
11243;209796;107;0;0;0;0;.00nan;0;0
11243;201817;107;32;35;7;28;.800;3600000;0
11243;212301;92;0;0;0;0;.00nan;0;0
11244;208417;101;0;0;0;0;.00nan;0;0
11244;210603;104;70;35;3;32;.914;3555000;0
11244;201739;101;80;28;2;26;.929;3600000;0
11244;208300;104;0;0;0;0;.00nan;0;0
11245;199768;105;0;0;0;0;.00nan;0;0
11245;205112;105;81;15;0;15;1.000;3600000;0
11245;215785;94;67;33;3;30;.909;3600000;0
11245;-1;94;0;0;0;0;.00nan;0;0
11246;205318;97;74;42;3;39;.929;3600000;0
11246;200549;102;54;31;4;27;.871;3600000;0
11246;205824;97;0;0;0;0;.00nan;0;0
11246;210923;102;0;0;0;0;.00nan;0;0
11247;209796;107;59;22;3;19;.864;3558000;0
11247;201817;107;0;0;0;0;.00nan;0;0
11247;212343;96;0;0;0;0;.00nan;0;0
11247;-1;96;76;28;2;26;.929;3600000;0
11248;194502;86;94;20;0;20;1.000;3600000;0
11248;201876;86;0;0;0;0;.00nan;0;0
11248;201888;90;30;27;6;21;.778;2373000;0
11248;-1;90;50;8;1;7;.875;1227000;0
11249;197962;99;0;0;0;0;.00nan;0;0
11249;205276;103;0;0;0;0;.00nan;0;0
11249;210428;103;26;28;6;22;.786;3600000;0
11249;202788;99;68;33;3;30;.909;3600000;0
11250;209784;91;78;29;1;28;.966;3600000;0
11250;209796;107;71;15;0;15;1.000;1082000;0
11250;205429;91;0;0;0;0;.00nan;0;0
11250;201817;107;38;32;6;26;.813;2518000;0
11251;205124;89;0;0;0;0;.00nan;0;0
11251;200572;95;0;0;0;0;.00nan;0;0
11251;201792;89;77;50;4;46;.920;3513000;0
11251;212487;95;66;19;2;17;.895;3600000;0
11252;197940;100;25;23;5;18;.783;3558000;0
11252;212368;100;0;0;0;0;.00nan;0;0
11252;207118;98;80;45;4;41;.911;3600000;0
11252;-1;98;0;0;0;0;.00nan;0;0
11253;199768;105;0;0;0;0;.00nan;0;0
11253;205112;105;87;52;4;48;.923;3745000;0
11253;215785;94;73;35;3;32;.914;3765000;0
11253;-1;94;0;0;0;0;.00nan;0;0
11254;199784;87;33;32;6;26;.813;3359000;0
11254;194502;86;66;28;3;25;.893;3600000;0
11254;205076;87;43;5;1;4;.800;241000;0
11254;201876;86;0;0;0;0;.00nan;0;0
11255;209784;91;21;29;7;22;.759;2852000;0
11255;200065;93;65;25;2;23;.920;3600000;0
11255;205429;91;56;6;0;6;1.000;748000;0
11255;-1;93;0;0;0;0;.00nan;0;0
11256;192739;92;81;29;1;28;.966;3600000;0
11256;205318;97;69;38;4;34;.895;3600000;0
11256;205824;97;0;0;0;0;.00nan;0;0
11256;212301;92;0;0;0;0;.00nan;0;0
11257;210368;106;77;35;3;32;.914;3574000;0
11257;212343;96;0;0;0;0;.00nan;0;0
11257;-1;106;0;0;0;0;.00nan;0;0
11257;-1;96;88;35;2;33;.943;3600000;0
11258;210480;88;57;22;2;20;.909;3600000;0
11258;201888;90;0;0;0;0;.00nan;0;0
11258;-1;90;52;40;5;35;.875;3600000;0
11258;-1;88;0;0;0;0;.00nan;0;0
11259;209796;107;87;56;4;52;.929;3600000;0
11259;200572;95;50;15;2;13;.867;3600000;0
11259;201817;107;0;0;0;0;.00nan;0;0
11259;212487;95;0;0;0;0;.00nan;0;0
11260;197962;99;31;17;4;13;.765;2285000;0
11260;199768;105;0;0;0;0;.00nan;0;0
11260;205112;105;96;43;3;40;.930;3600000;0
11260;202788;99;55;5;0;5;1.000;1268000;0
11261;197940;100;65;34;3;31;.912;3600000;0
11261;208417;101;0;0;0;0;.00nan;0;0
11261;201739;101;50;26;4;22;.846;3561000;0
11261;212368;100;0;0;0;0;.00nan;0;0
11262;210603;104;57;24;3;21;.875;3572000;0
11262;207118;98;0;0;0;0;.00nan;0;0
11262;-1;98;82;38;2;36;.947;3600000;0
11262;208300;104;0;0;0;0;.00nan;0;0
11263;205276;103;0;0;0;0;.00nan;0;0
11263;210428;103;52;28;4;24;.857;3531000;0
11263;215785;94;67;26;2;24;.923;3600000;0
11263;-1;94;0;0;0;0;.00nan;0;0
11264;199784;87;0;0;0;0;.00nan;0;0
11264;205076;87;55;42;6;36;.857;3600000;0
11264;201888;90;80;33;2;31;.939;3600000;0
11264;-1;90;0;0;0;0;.00nan;0;0
11265;200065;93;0;0;0;0;.00nan;0;0
11265;212343;96;45;25;4;21;.840;974000;0
11265;-1;96;65;33;3;30;.909;2626000;0
11265;-1;93;73;17;1;16;.941;3600000;0
11266;197962;99;0;0;0;0;.00nan;0;0
11266;199768;105;34;34;6;28;.824;2452000;0
11266;205112;105;59;13;1;12;.923;1148000;0
11266;202788;99;73;25;2;23;.920;3600000;0
11267;209796;107;0;0;0;0;.00nan;0;0
11267;205318;97;0;0;0;0;.00nan;0;0
11267;205824;97;29;31;6;25;.806;3600000;0
11267;201817;107;84;36;2;34;.944;3600000;0
11268;194502;86;53;31;4;27;.871;3600000;0
11268;200549;102;19;36;9;27;.750;3600000;0
11268;210923;102;0;0;0;0;.00nan;0;0
11268;201876;86;0;0;0;0;.00nan;0;0
11269;205124;89;44;23;3;20;.870;1315000;0
11269;200572;95;28;26;6;20;.769;3252000;0
11269;201792;89;35;25;5;20;.800;2237000;0
11269;212487;95;51;1;0;1;1.000;348000;0
11270;205276;103;0;0;0;0;.00nan;0;0
11270;210428;103;99;22;0;22;1.000;3600000;0
11270;207118;98;76;28;2;26;.929;3521000;0
11270;-1;98;0;0;0;0;.00nan;0;0
11271;192739;92;0;0;0;0;.00nan;0;0
11271;210368;106;0;0;0;0;.00nan;0;0
11271;212301;92;66;37;3;34;.919;3544000;0
11271;-1;106;75;26;2;24;.923;3600000;0
11272;210603;104;0;0;0;0;.00nan;0;0
11272;215785;94;0;0;0;0;.00nan;0;0
11272;-1;94;35;26;5;21;.808;3596000;0
11272;208300;104;49;17;3;14;.824;3600000;0
11273;197940;100;0;0;0;0;.00nan;0;0
11273;208417;101;51;32;4;28;.875;3600000;0
11273;201739;101;0;0;0;0;.00nan;0;0
11273;212368;100;58;25;3;22;.880;3600000;0
11274;194502;86;0;0;0;0;.00nan;0;0
11274;205124;89;0;0;0;0;.00nan;0;0
11274;201792;89;95;45;2;43;.956;3578000;0
11274;201876;86;100;31;0;31;1.000;3600000;0
11275;210480;88;0;0;0;0;.00nan;0;0
11275;200549;102;0;0;0;0;.00nan;0;0
11275;210923;102;83;53;4;49;.925;3832000;0
11275;-1;88;56;23;3;20;.870;3832000;0
11276;208417;101;0;0;0;0;.00nan;0;0
11276;197962;99;82;38;2;36;.947;3600000;0
11276;201739;101;31;17;4;13;.765;3577000;0
11276;202788;99;0;0;0;0;.00nan;0;0
11277;200065;93;71;38;3;35;.921;3600000;0
11277;210368;106;34;34;6;28;.824;3600000;0
11277;-1;106;0;0;0;0;.00nan;0;0
11277;-1;93;0;0;0;0;.00nan;0;0
11278;199784;87;0;0;0;0;.00nan;0;0
11278;205076;87;100;30;0;30;1.000;3600000;0
11278;200549;102;43;27;4;23;.852;3600000;0
11278;210923;102;0;0;0;0;.00nan;0;0
11279;209784;91;56;33;3;30;.909;3900000;0
11279;205429;91;0;0;0;0;.00nan;0;0
11279;215785;94;65;33;3;30;.909;3900000;0
11279;-1;94;0;0;0;0;.00nan;0;0
11280;210368;106;0;0;0;0;.00nan;0;0
11280;205318;97;37;12;3;9;.750;557000;0
11280;205824;97;86;35;2;33;.943;3043000;0
11280;-1;106;21;21;6;15;.714;3565000;0
11281;205124;89;0;0;0;0;.00nan;0;0
11281;210480;88;81;21;1;20;.952;3600000;0
11281;201792;89;61;36;3;33;.917;3567000;0
11281;-1;88;0;0;0;0;.00nan;0;0
11282;208417;101;44;14;3;11;.786;3793000;0
11282;199768;105;0;0;0;0;.00nan;0;0
11282;205112;105;71;31;2;29;.935;3793000;0
11282;201739;101;0;0;0;0;.00nan;0;0
11283;205124;89;78;48;5;43;.896;3570000;0
11283;201792;89;0;0;0;0;.00nan;0;0
11283;201888;90;0;0;0;0;.00nan;0;0
11283;-1;90;40;21;4;17;.810;3600000;0
11284;200065;93;60;20;1;19;.950;3600000;0
11284;215785;94;29;32;6;26;.813;3600000;0
11284;-1;94;0;0;0;0;.00nan;0;0
11284;-1;93;0;0;0;0;.00nan;0;0
11285;209784;91;90;44;3;41;.932;3600000;0
11285;205318;97;57;28;4;24;.857;3566000;0
11285;205429;91;0;0;0;0;.00nan;0;0
11285;205824;97;0;0;0;0;.00nan;0;0
11286;199784;87;0;0;0;0;.00nan;0;0
11286;205076;87;50;28;4;24;.857;3600000;0
11286;210480;88;0;0;0;0;.00nan;0;0
11286;-1;88;48;32;5;27;.844;3568000;0
11287;200549;102;66;29;3;26;.897;3587000;0
11287;210923;102;0;0;0;0;.00nan;0;0
11287;201888;90;86;36;2;34;.944;3600000;0
11287;-1;90;0;0;0;0;.00nan;0;0
11288;210368;106;32;30;6;24;.800;2348000;0
11288;200572;95;91;29;1;28;.966;3600000;0
11288;212487;95;0;0;0;0;.00nan;0;0
11288;-1;106;51;10;1;9;.900;1252000;0
11289;192739;92;68;20;2;18;.900;3600000;0
11289;194502;86;0;0;0;0;.00nan;0;0
11289;212301;92;0;0;0;0;.00nan;0;0
11289;201876;86;89;48;3;45;.938;3600000;0
11290;197962;99;0;0;0;0;.00nan;0;0
11290;212343;96;0;0;0;0;.00nan;0;0
11290;202788;99;59;18;2;16;.889;3620000;0
11290;-1;96;99;42;1;41;.976;3620000;0
11291;208417;101;0;0;0;0;.00nan;0;0
11291;205276;103;0;0;0;0;.00nan;0;0
11291;210428;103;89;29;1;28;.966;3600000;0
11291;201739;101;33;22;5;17;.773;3600000;0
11292;197940;100;70;30;3;27;.900;3900000;0
11292;212368;100;0;0;0;0;.00nan;0;0
11292;207118;98;0;0;0;0;.00nan;0;0
11292;-1;98;84;58;3;55;.948;3900000;0
11293;209796;107;0;0;0;0;.00nan;0;0
11293;210603;104;92;36;2;34;.944;3600000;0
11293;201817;107;60;34;4;30;.882;3528000;0
11293;208300;104;0;0;0;0;.00nan;0;0
11294;209784;91;0;0;0;0;.00nan;0;0
11294;210368;106;56;20;2;18;.900;3543000;0
11294;205429;91;100;35;1;34;.971;3600000;0
11294;-1;106;0;0;0;0;.00nan;0;0
11295;205318;97;0;0;0;0;.00nan;0;0
11295;215785;94;0;0;0;0;.00nan;0;0
11295;205824;97;71;39;2;37;.949;3900000;0
11295;-1;94;80;31;2;29;.935;3900000;0
11296;205124;89;0;0;0;0;.00nan;0;0
11296;200549;102;0;0;0;0;.00nan;0;0
11296;210923;102;82;16;0;16;1.000;3600000;0
11296;201792;89;61;53;6;47;.887;3600000;0
11297;197940;100;0;0;0;0;.00nan;0;0
11297;205276;103;0;0;0;0;.00nan;0;0
11297;210428;103;63;31;3;28;.903;3566000;0
11297;212368;100;65;21;2;19;.905;3600000;0
11298;199768;105;0;0;0;0;.00nan;0;0
11298;205112;105;86;30;2;28;.933;3900000;0
11298;210603;104;0;0;0;0;.00nan;0;0
11298;208300;104;69;27;2;25;.926;3900000;0
11299;208417;101;68;28;2;26;.929;3562000;0
11299;197962;99;97;30;1;29;.967;3600000;0
11299;201739;101;0;0;0;0;.00nan;0;0
11299;202788;99;0;0;0;0;.00nan;0;0
11300;212343;96;87;40;2;38;.950;3900000;0
11300;207118;98;71;25;2;23;.920;3900000;0
11300;-1;98;0;0;0;0;.00nan;0;0
11300;-1;96;0;0;0;0;.00nan;0;0
11301;210480;88;60;33;4;29;.879;3600000;0
11301;201888;90;0;0;0;0;.00nan;0;0
11301;-1;90;83;25;1;24;.960;3600000;0
11301;-1;88;0;0;0;0;.00nan;0;0
11302;200572;95;40;7;2;5;.714;3600000;0
11302;215785;94;97;64;5;59;.922;3600000;0
11302;212487;95;0;0;0;0;.00nan;0;0
11302;-1;94;0;0;0;0;.00nan;0;0
11303;200065;93;75;21;1;20;.952;3600000;0
11303;194502;86;38;35;6;29;.829;3600000;0
11303;201876;86;0;0;0;0;.00nan;0;0
11303;-1;93;0;0;0;0;.00nan;0;0
11304;192739;92;97;32;1;31;.969;3600000;0
11304;205318;97;55;41;6;35;.854;3600000;0
11304;205824;97;0;0;0;0;.00nan;0;0
11304;212301;92;0;0;0;0;.00nan;0;0
11305;199768;105;0;0;0;0;.00nan;0;0
11305;205112;105;74;27;2;25;.926;3600000;0
11305;207118;98;0;0;0;0;.00nan;0;0
11305;-1;98;15;29;7;22;.759;3600000;0
11306;197940;100;78;22;1;21;.955;3600000;0
11306;212343;96;48;7;1;6;.857;455000;0
11306;212368;100;0;0;0;0;.00nan;0;0
11306;-1;96;31;30;6;24;.800;3145000;0
11307;210480;88;0;0;0;0;.00nan;0;0
11307;201888;90;0;0;0;0;.00nan;0;0
11307;-1;90;80;36;2;34;.944;3556000;0
11307;-1;88;100;25;0;25;1.000;3600000;0
11308;205276;103;0;0;0;0;.00nan;0;0
11308;210428;103;33;26;5;21;.808;3600000;0
11308;200572;95;69;19;1;18;.947;3600000;0
11308;212487;95;0;0;0;0;.00nan;0;0
11309;209784;91;11;18;6;12;.667;2343000;0
11309;205124;89;0;0;0;0;.00nan;0;0
11309;205429;91;61;7;0;7;1.000;1557000;0
11309;201792;89;63;55;6;49;.891;3900000;0
11310;197962;99;0;0;0;0;.00nan;0;0
11310;210368;106;0;0;0;0;.00nan;0;0
11310;202788;99;61;27;3;24;.889;3600000;0
11310;-1;106;64;40;4;36;.900;3583000;0
11311;208417;101;0;0;0;0;.00nan;0;0
11311;201739;101;60;21;2;19;.905;3600000;0
11311;212343;96;0;0;0;0;.00nan;0;0
11311;-1;96;44;28;5;23;.821;3600000;0
11312;199784;87;49;10;1;9;.900;490000;0
11312;194502;86;77;28;1;27;.964;3600000;0
11312;205076;87;40;37;7;30;.811;3110000;0
11312;201876;86;0;0;0;0;.00nan;0;0
11313;194502;86;0;0;0;0;.00nan;0;0
11313;205318;97;37;23;4;19;.826;3598000;0
11313;205824;97;0;0;0;0;.00nan;0;0
11313;201876;86;73;34;3;31;.912;3600000;0
11314;200572;95;0;0;0;0;.00nan;0;0
11314;201888;90;0;0;0;0;.00nan;0;0
11314;212487;95;70;28;2;26;.929;3600000;0
11314;-1;90;98;52;3;49;.942;3552000;0
11315;192739;92;44;33;6;27;.818;3600000;0
11315;200065;93;0;0;0;0;.00nan;0;0
11315;212301;92;0;0;0;0;.00nan;0;0
11315;-1;93;77;28;2;26;.929;3600000;0
11316;209784;91;0;0;0;0;.00nan;0;0
11316;205276;103;0;0;0;0;.00nan;0;0
11316;210428;103;42;30;5;25;.833;3600000;0
11316;205429;91;69;26;2;24;.923;3600000;0
11317;200549;102;0;0;0;0;.00nan;0;0
11317;210923;102;45;24;4;20;.833;3600000;0
11317;212343;96;0;0;0;0;.00nan;0;0
11317;-1;96;45;38;6;32;.842;3520000;0
11318;208417;101;32;29;6;23;.793;3176000;0
11318;210368;106;88;26;1;25;.962;3600000;0
11318;201739;101;45;6;1;5;.833;424000;0
11318;-1;106;0;0;0;0;.00nan;0;0
11319;205124;89;0;0;0;0;.00nan;0;0
11319;210603;104;66;17;1;16;.941;3600000;0
11319;201792;89;73;26;2;24;.923;3553000;0
11319;208300;104;0;0;0;0;.00nan;0;0
11320;197962;99;0;0;0;0;.00nan;0;0
11320;199768;105;0;0;0;0;.00nan;0;0
11320;205112;105;48;36;6;30;.833;3600000;0
11320;202788;99;65;27;2;25;.926;3600000;0
11321;215785;94;78;31;2;29;.935;3600000;0
11321;207118;98;51;29;4;25;.862;3600000;0
11321;-1;98;0;0;0;0;.00nan;0;0
11321;-1;94;0;0;0;0;.00nan;0;0
11322;197940;100;70;26;2;24;.923;3900000;0
11322;209796;107;0;0;0;0;.00nan;0;0
11322;201817;107;97;49;2;47;.959;3900000;0
11322;212368;100;0;0;0;0;.00nan;0;0
11323;199784;87;0;0;0;0;.00nan;0;0
11323;205076;87;59;44;6;38;.864;3600000;0
11323;210480;88;74;34;3;31;.912;3600000;0
11323;-1;88;0;0;0;0;.00nan;0;0
11324;205276;103;0;0;0;0;.00nan;0;0
11324;210428;103;77;26;1;25;.962;3600000;0
11324;205318;97;0;0;0;0;.00nan;0;0
11324;205824;97;49;35;5;30;.857;3600000;0
11325;192739;92;80;33;2;31;.939;3591000;0
11325;200065;93;96;32;1;31;.969;3600000;0
11325;212301;92;0;0;0;0;.00nan;0;0
11325;-1;93;0;0;0;0;.00nan;0;0
11326;197940;100;0;0;0;0;.00nan;0;0
11326;209796;107;64;24;2;22;.917;3600000;0
11326;201817;107;0;0;0;0;.00nan;0;0
11326;212368;100;60;43;4;39;.907;3520000;0
11327;197962;99;96;35;3;32;.914;3600000;0
11327;210603;104;20;19;6;13;.684;3108000;0
11327;202788;99;0;0;0;0;.00nan;0;0
11327;208300;104;56;5;0;5;1.000;492000;0
11328;199768;105;100;34;1;33;.971;3600000;0
11328;205112;105;0;0;0;0;.00nan;0;0
11328;205124;89;59;26;3;23;.885;3511000;0
11328;201792;89;0;0;0;0;.00nan;0;0
11329;208417;101;0;0;0;0;.00nan;0;0
11329;215785;94;0;0;0;0;.00nan;0;0
11329;201739;101;62;30;3;27;.900;3600000;0
11329;-1;94;53;36;5;31;.861;3600000;0
11330;199784;87;0;0;0;0;.00nan;0;0
11330;205076;87;77;39;3;36;.923;3600000;0
11330;210480;88;70;31;2;29;.935;3600000;0
11330;-1;88;0;0;0;0;.00nan;0;0
11331;197940;100;100;25;0;25;1.000;3600000;0
11331;212368;100;0;0;0;0;.00nan;0;0
11331;207118;98;0;0;0;0;.00nan;0;0
11331;-1;98;42;25;4;21;.840;3600000;0
11332;194502;86;68;38;4;34;.895;3600000;0
11332;201876;86;0;0;0;0;.00nan;0;0
11332;201888;90;0;0;0;0;.00nan;0;0
11332;-1;90;59;27;3;24;.889;3600000;0
11333;205318;97;0;0;0;0;.00nan;0;0
11333;200572;95;59;18;2;16;.889;3600000;0
11333;205824;97;83;41;3;38;.927;3547000;0
11333;212487;95;0;0;0;0;.00nan;0;0
11334;208417;101;0;0;0;0;.00nan;0;0
11334;200549;102;0;0;0;0;.00nan;0;0
11334;210923;102;41;35;5;30;.857;3600000;0
11334;201739;101;78;32;2;30;.938;3600000;0
11335;209796;107;0;0;0;0;.00nan;0;0
11335;205124;89;0;0;0;0;.00nan;0;0
11335;201792;89;56;38;4;34;.895;3600000;0
11335;201817;107;71;24;2;22;.917;3600000;0
11336;197940;100;81;31;2;29;.935;3874000;0
11336;212368;100;0;0;0;0;.00nan;0;0
11336;207118;98;93;51;2;49;.961;3900000;0
11336;-1;98;0;0;0;0;.00nan;0;0
11337;192739;92;49;27;4;23;.852;3900000;0
11337;210480;88;0;0;0;0;.00nan;0;0
11337;212301;92;0;0;0;0;.00nan;0;0
11337;-1;88;85;55;4;51;.927;3900000;0
11338;199768;105;0;0;0;0;.00nan;0;0
11338;205112;105;91;27;1;26;.963;3900000;0
11338;205276;103;0;0;0;0;.00nan;0;0
11338;210428;103;72;23;1;22;.957;3900000;0
11339;208417;101;35;23;4;19;.826;3600000;0
11339;200549;102;74;24;1;23;.958;3600000;0
11339;210923;102;0;0;0;0;.00nan;0;0
11339;201739;101;0;0;0;0;.00nan;0;0
11340;205124;89;69;48;5;43;.896;3900000;0
11340;215785;94;39;25;5;20;.800;3900000;0
11340;201792;89;0;0;0;0;.00nan;0;0
11340;-1;94;0;0;0;0;.00nan;0;0
11341;192739;92;87;40;3;37;.925;3600000;0
11341;199784;87;0;0;0;0;.00nan;0;0
11341;205076;87;45;33;5;28;.848;3520000;0
11341;212301;92;0;0;0;0;.00nan;0;0
11342;194502;86;82;40;2;38;.950;3685000;0
11342;201876;86;0;0;0;0;.00nan;0;0
11342;201888;90;0;0;0;0;.00nan;0;0
11342;-1;90;74;38;3;35;.921;3685000;0
11343;210480;88;58;32;3;29;.906;3546000;0
11343;200572;95;69;24;2;22;.917;3600000;0
11343;212487;95;0;0;0;0;.00nan;0;0
11343;-1;88;0;0;0;0;.00nan;0;0
11344;200065;93;66;14;1;13;.929;3600000;0
11344;212343;96;0;0;0;0;.00nan;0;0
11344;-1;96;76;42;3;39;.929;3565000;0
11344;-1;93;0;0;0;0;.00nan;0;0
11345;205124;89;0;0;0;0;.00nan;0;0
11345;210368;106;50;20;3;17;.850;3600000;0
11345;201792;89;73;49;5;44;.898;3582000;0
11345;-1;106;0;0;0;0;.00nan;0;0
11346;208417;101;0;0;0;0;.00nan;0;0
11346;200549;102;47;26;4;22;.846;3600000;0
11346;210923;102;0;0;0;0;.00nan;0;0
11346;201739;101;45;31;5;26;.839;3600000;0
11347;199768;105;0;0;0;0;.00nan;0;0
11347;205112;105;77;26;2;24;.923;3600000;0
11347;205276;103;0;0;0;0;.00nan;0;0
11347;210428;103;66;29;3;26;.897;3600000;0
11348;209796;107;0;0;0;0;.00nan;0;0
11348;215785;94;40;40;6;34;.850;3600000;0
11348;201817;107;93;31;1;30;.968;3600000;0
11348;-1;94;0;0;0;0;.00nan;0;0
11349;197940;100;91;32;1;31;.969;3600000;0
11349;209784;91;22;23;6;17;.739;1892000;0
11349;205429;91;52;14;2;12;.857;1708000;0
11349;212368;100;0;0;0;0;.00nan;0;0
11350;199784;87;38;12;3;9;.750;366000;0
11350;205076;87;73;44;4;40;.909;3234000;0
11350;205318;97;59;25;3;22;.880;3600000;0
11350;205824;97;0;0;0;0;.00nan;0;0
11351;200572;95;0;0;0;0;.00nan;0;0
11351;201888;90;35;9;3;6;.667;579000;0
11351;212487;95;47;27;4;23;.852;3600000;0
11351;-1;90;91;43;2;41;.953;2965000;0
11352;200065;93;0;0;0;0;.00nan;0;0
11352;212343;96;0;0;0;0;.00nan;0;0
11352;-1;96;91;50;3;47;.940;3600000;0
11352;-1;93;66;19;2;17;.895;3600000;0
11353;209796;107;59;29;3;26;.897;3900000;0
11353;215785;94;0;0;0;0;.00nan;0;0
11353;201817;107;0;0;0;0;.00nan;0;0
11353;-1;94;63;30;3;27;.900;3900000;0
11354;205276;103;0;0;0;0;.00nan;0;0
11354;210428;103;56;43;5;38;.884;3561000;0
11354;210603;104;0;0;0;0;.00nan;0;0
11354;208300;104;53;23;3;20;.870;3600000;0
11355;192739;92;70;28;2;26;.929;3579000;0
11355;194502;86;0;0;0;0;.00nan;0;0
11355;212301;92;0;0;0;0;.00nan;0;0
11355;201876;86;82;25;1;24;.960;3600000;0
11356;208417;101;58;26;3;23;.885;3597000;0
11356;209784;91;0;0;0;0;.00nan;0;0
11356;205429;91;69;24;2;22;.917;3600000;0
11356;201739;101;0;0;0;0;.00nan;0;0
11357;200549;102;0;0;0;0;.00nan;0;0
11357;210923;102;56;25;3;22;.880;3657000;0
11357;207118;98;59;36;4;32;.889;3657000;0
11357;-1;98;0;0;0;0;.00nan;0;0
11358;205124;89;0;0;0;0;.00nan;0;0
11358;205276;103;50;28;4;24;.857;3541000;0
11358;210428;103;0;0;0;0;.00nan;0;0
11358;201792;89;64;23;3;20;.870;3600000;0
11359;210368;106;82;35;3;32;.914;3600000;0
11359;215785;94;31;48;8;40;.833;3600000;0
11359;-1;106;0;0;0;0;.00nan;0;0
11359;-1;94;0;0;0;0;.00nan;0;0
11360;197962;99;0;0;0;0;.00nan;0;0
11360;210603;104;61;26;2;24;.923;3587000;0
11360;202788;99;67;21;1;20;.952;3600000;0
11360;208300;104;0;0;0;0;.00nan;0;0
11361;205276;103;0;0;0;0;.00nan;0;0
11361;210428;103;100;37;1;36;.973;3900000;0
11361;201888;90;0;0;0;0;.00nan;0;0
11361;-1;90;86;28;1;27;.964;3900000;0
11362;209784;91;0;0;0;0;.00nan;0;0
11362;205429;91;74;32;3;29;.906;3900000;0
11362;207118;98;0;0;0;0;.00nan;0;0
11362;-1;98;55;27;3;24;.889;3900000;0
11363;199768;105;49;7;1;6;.857;316000;0
11363;209796;107;0;0;0;0;.00nan;0;0
11363;205112;105;39;36;6;30;.833;3284000;0
11363;201817;107;55;23;3;20;.870;3600000;0
11364;215785;94;35;16;4;12;.750;1194000;0
11364;201888;90;84;33;2;31;.939;3600000;0
11364;-1;90;0;0;0;0;.00nan;0;0
11364;-1;94;74;24;1;23;.958;2406000;0
11365;205318;97;0;0;0;0;.00nan;0;0
11365;210480;88;0;0;0;0;.00nan;0;0
11365;205824;97;81;34;2;32;.941;3600000;0
11365;-1;88;66;32;3;29;.906;3586000;0
11366;192739;92;19;27;7;20;.741;2935000;0
11366;199784;87;0;0;0;0;.00nan;0;0
11366;205076;87;60;41;5;36;.878;3600000;0
11366;212301;92;51;2;0;2;1.000;588000;0
11367;197962;99;0;0;0;0;.00nan;0;0
11367;209784;91;88;35;2;33;.943;3600000;0
11367;205429;91;0;0;0;0;.00nan;0;0
11367;202788;99;53;25;3;22;.880;3600000;0
11368;197940;100;51;29;4;25;.862;3600000;0
11368;210368;106;0;0;0;0;.00nan;0;0
11368;212368;100;0;0;0;0;.00nan;0;0
11368;-1;106;35;25;5;20;.800;3541000;0
11369;209796;107;48;26;4;22;.846;3600000;0
11369;201817;107;0;0;0;0;.00nan;0;0
11369;207118;98;16;24;6;18;.750;1524000;0
11369;-1;98;49;21;3;18;.857;2076000;0
11370;208417;101;0;0;0;0;.00nan;0;0
11370;210603;104;73;26;2;24;.923;3900000;0
11370;201739;101;77;32;2;30;.938;3900000;0
11370;208300;104;0;0;0;0;.00nan;0;0
11371;194502;86;85;45;4;41;.911;3557000;0
11371;200572;95;73;29;2;27;.931;3600000;0
11371;201876;86;0;0;0;0;.00nan;0;0
11371;212487;95;0;0;0;0;.00nan;0;0
11372;199784;87;0;0;0;0;.00nan;0;0
11372;205076;87;93;26;1;25;.962;3600000;0
11372;212343;96;0;0;0;0;.00nan;0;0
11372;-1;96;52;31;4;27;.871;3600000;0
11373;192739;92;69;28;3;25;.893;3600000;0
11373;210480;88;66;46;6;40;.870;3600000;0
11373;212301;92;0;0;0;0;.00nan;0;0
11373;-1;88;0;0;0;0;.00nan;0;0
11374;208417;101;54;21;3;18;.857;3531000;0
11374;197962;99;0;0;0;0;.00nan;0;0
11374;201739;101;0;0;0;0;.00nan;0;0
11374;202788;99;77;28;1;27;.964;3600000;0
11375;209784;91;0;0;0;0;.00nan;0;0
11375;205429;91;37;34;6;28;.824;3690000;0
11375;200549;102;54;36;5;31;.861;3690000;0
11375;210923;102;0;0;0;0;.00nan;0;0
11376;205276;103;0;0;0;0;.00nan;0;0
11376;210428;103;55;25;3;22;.880;3900000;0
11376;210603;104;0;0;0;0;.00nan;0;0
11376;208300;104;88;42;3;39;.929;3900000;0
11377;209796;107;0;0;0;0;.00nan;0;0
11377;201817;107;98;31;2;29;.935;3600000;0
11377;201888;90;0;0;0;0;.00nan;0;0
11377;-1;90;51;28;4;24;.857;3600000;0
11378;197940;100;45;26;4;22;.846;3900000;0
11378;199768;105;0;0;0;0;.00nan;0;0
11378;205112;105;65;38;4;34;.895;3900000;0
11378;212368;100;0;0;0;0;.00nan;0;0
11379;210368;106;70;29;3;26;.897;3600000;0
11379;215785;94;48;44;6;38;.864;3600000;0
11379;-1;106;0;0;0;0;.00nan;0;0
11379;-1;94;0;0;0;0;.00nan;0;0
11380;194502;86;0;0;0;0;.00nan;0;0
11380;205124;89;0;0;0;0;.00nan;0;0
11380;201792;89;71;37;3;34;.919;3900000;0
11380;201876;86;57;29;3;26;.897;3900000;0
11381;192739;92;47;30;5;25;.833;3600000;0
11381;200065;93;86;30;2;28;.933;3600000;0
11381;212301;92;0;0;0;0;.00nan;0;0
11381;-1;93;0;0;0;0;.00nan;0;0
11382;197962;99;50;26;5;21;.808;3821000;0
11382;215785;94;0;0;0;0;.00nan;0;0
11382;202788;99;0;0;0;0;.00nan;0;0
11382;-1;94;75;41;4;37;.902;3821000;0
11383;199784;87;0;0;0;0;.00nan;0;0
11383;205076;87;58;30;4;26;.867;3600000;0
11383;205318;97;54;35;5;30;.857;3562000;0
11383;205824;97;0;0;0;0;.00nan;0;0
11384;210368;106;0;0;0;0;.00nan;0;0
11384;201888;90;39;38;6;32;.842;3600000;0
11384;-1;106;76;23;1;22;.957;3600000;0
11384;-1;90;0;0;0;0;.00nan;0;0
11385;210480;88;0;0;0;0;.00nan;0;0
11385;212343;96;0;0;0;0;.00nan;0;0
11385;-1;88;78;24;1;23;.958;3900000;0
11385;-1;96;93;37;1;36;.973;3900000;0
11386;197940;100;99;40;1;39;.975;3600000;0
11386;210603;104;90;38;2;36;.947;3574000;0
11386;212368;100;0;0;0;0;.00nan;0;0
11386;208300;104;0;0;0;0;.00nan;0;0
11387;208417;101;44;9;2;7;.778;2599000;0
11387;199768;105;75;33;2;31;.939;3600000;0
11387;205112;105;0;0;0;0;.00nan;0;0
11387;201739;101;23;12;4;8;.667;1001000;0
11388;209796;107;69;27;3;24;.889;3600000;0
11388;201817;107;0;0;0;0;.00nan;0;0
11388;207118;98;0;0;0;0;.00nan;0;0
11388;-1;98;69;41;4;37;.902;3554000;0
11389;199784;87;30;27;6;21;.778;3520000;0
11389;205076;87;0;0;0;0;.00nan;0;0
11389;205124;89;80;45;4;41;.911;3600000;0
11389;201792;89;0;0;0;0;.00nan;0;0
11390;210368;106;67;30;3;27;.900;3600000;0
11390;210603;104;64;21;2;19;.905;1884000;0
11390;-1;106;0;0;0;0;.00nan;0;0
11390;208300;104;6;15;6;9;.600;1716000;0
11391;200549;102;0;0;0;0;.00nan;0;0
11391;215785;94;76;39;3;36;.923;3561000;0
11391;210923;102;71;29;2;27;.931;3600000;0
11391;-1;94;0;0;0;0;.00nan;0;0
11392;194502;86;81;42;4;38;.905;3600000;0
11392;200572;95;44;26;5;21;.808;3568000;0
11392;201876;86;0;0;0;0;.00nan;0;0
11392;212487;95;0;0;0;0;.00nan;0;0
11393;200065;93;65;27;3;24;.889;3900000;0
11393;212343;96;0;0;0;0;.00nan;0;0
11393;-1;96;96;54;3;51;.944;3900000;0
11393;-1;93;0;0;0;0;.00nan;0;0
11394;200549;102;85;28;1;27;.964;3600000;0
11394;215785;94;0;0;0;0;.00nan;0;0
11394;210923;102;0;0;0;0;.00nan;0;0
11394;-1;94;49;41;5;36;.878;3600000;0
11395;199768;105;0;0;0;0;.00nan;0;0
11395;205112;105;48;32;5;27;.844;3563000;0
11395;201888;90;0;0;0;0;.00nan;0;0
11395;-1;90;65;28;3;25;.893;3600000;0
11396;197940;100;54;26;3;23;.885;3600000;0
11396;197962;99;0;0;0;0;.00nan;0;0
11396;212368;100;0;0;0;0;.00nan;0;0
11396;202788;99;41;27;5;22;.815;3560000;0
11397;205318;97;50;43;6;37;.860;3563000;0
11397;200572;95;0;0;0;0;.00nan;0;0
11397;205824;97;0;0;0;0;.00nan;0;0
11397;212487;95;49;32;4;28;.875;3600000;0
11398;209784;91;0;0;0;0;.00nan;0;0
11398;200065;93;0;0;0;0;.00nan;0;0
11398;205429;91;69;40;4;36;.900;3600000;0
11398;-1;93;93;32;1;31;.969;3600000;0
11399;205276;103;0;0;0;0;.00nan;0;0
11399;210428;103;86;34;2;32;.941;3600000;0
11399;207118;98;63;34;3;31;.912;3567000;0
11399;-1;98;0;0;0;0;.00nan;0;0
11400;210603;104;80;36;3;33;.917;3600000;0
11400;201888;90;58;35;4;31;.886;3589000;0
11400;-1;90;0;0;0;0;.00nan;0;0
11400;208300;104;0;0;0;0;.00nan;0;0
11401;197940;100;0;0;0;0;.00nan;0;0
11401;197962;99;98;48;2;46;.958;3574000;0
11401;212368;100;99;24;0;24;1.000;3600000;0
11401;202788;99;0;0;0;0;.00nan;0;0
11402;199784;87;0;0;0;0;.00nan;0;0
11402;205076;87;50;35;6;29;.829;3600000;0
11402;210480;88;85;25;1;24;.960;3600000;0
11402;-1;88;0;0;0;0;.00nan;0;0
11403;205124;89;0;0;0;0;.00nan;0;0
11403;200572;95;61;24;3;21;.875;3600000;0
11403;201792;89;89;52;4;48;.923;3600000;0
11403;212487;95;0;0;0;0;.00nan;0;0
11404;209784;91;0;0;0;0;.00nan;0;0
11404;205429;91;49;27;5;22;.815;3517000;0
11404;201888;90;0;0;0;0;.00nan;0;0
11404;-1;90;98;51;3;48;.941;3600000;0
11405;200065;93;37;26;5;21;.808;3600000;0
11405;205318;97;0;0;0;0;.00nan;0;0
11405;205824;97;66;16;1;15;.938;3600000;0
11405;-1;93;0;0;0;0;.00nan;0;0
11406;194502;86;98;29;1;28;.966;3600000;0
11406;201876;86;0;0;0;0;.00nan;0;0
11406;212343;96;0;0;0;0;.00nan;0;0
11406;-1;96;56;38;5;33;.868;3600000;0
11407;192739;92;51;19;3;16;.842;3600000;0
11407;215785;94;24;25;6;19;.760;2125000;0
11407;212301;92;0;0;0;0;.00nan;0;0
11407;-1;94;47;14;2;12;.857;1475000;0
11408;197940;100;0;0;0;0;.00nan;0;0
11408;197962;99;0;0;0;0;.00nan;0;0
11408;212368;100;89;17;0;17;1.000;3600000;0
11408;202788;99;71;44;4;40;.909;3600000;0
11409;210368;106;67;14;1;13;.929;3600000;0
11409;205276;103;0;0;0;0;.00nan;0;0
11409;210428;103;77;39;4;35;.897;3600000;0
11409;-1;106;0;0;0;0;.00nan;0;0
11410;208417;101;95;36;2;34;.944;3600000;0
11410;201739;101;0;0;0;0;.00nan;0;0
11410;207118;98;0;0;0;0;.00nan;0;0
11410;-1;98;32;28;6;22;.786;3600000;0
11411;199768;105;0;0;0;0;.00nan;0;0
11411;205112;105;75;35;3;32;.914;3600000;0
11411;200549;102;30;27;6;21;.778;2859000;0
11411;210923;102;64;10;1;9;.900;741000;0
11412;210480;88;0;0;0;0;.00nan;0;0
11412;200572;95;0;0;0;0;.00nan;0;0
11412;212487;95;46;17;3;14;.824;3600000;0
11412;-1;88;93;64;6;58;.906;3600000;0
11413;205124;89;89;42;3;39;.929;3566000;0
11413;205318;97;99;42;1;41;.976;3600000;0
11413;205824;97;0;0;0;0;.00nan;0;0
11413;201792;89;0;0;0;0;.00nan;0;0
11414;210368;106;0;0;0;0;.00nan;0;0
11414;205276;103;0;0;0;0;.00nan;0;0
11414;210428;103;69;32;3;29;.906;3548000;0
11414;-1;106;53;15;2;13;.867;3600000;0
11415;215785;94;0;0;0;0;.00nan;0;0
11415;212343;96;0;0;0;0;.00nan;0;0
11415;-1;94;57;36;4;32;.889;3600000;0
11415;-1;96;43;18;3;15;.833;3600000;0
11416;209796;107;0;0;0;0;.00nan;0;0
11416;201817;107;42;15;3;12;.800;3600000;0
11416;207118;98;63;41;4;37;.902;3551000;0
11416;-1;98;0;0;0;0;.00nan;0;0
11417;200549;102;0;0;0;0;.00nan;0;0
11417;210603;104;73;32;2;30;.938;3600000;0
11417;210923;102;61;30;3;27;.900;3600000;0
11417;208300;104;0;0;0;0;.00nan;0;0
11418;208417;101;0;0;0;0;.00nan;0;0
11418;199768;105;54;28;4;24;.857;3600000;0
11418;205112;105;0;0;0;0;.00nan;0;0
11418;201739;101;61;27;3;24;.889;3600000;0
11419;197940;100;0;0;0;0;.00nan;0;0
11419;197962;99;0;0;0;0;.00nan;0;0
11419;212368;100;67;27;2;25;.926;3543000;0
11419;202788;99;100;36;1;35;.972;3600000;0
11420;200065;93;55;16;2;14;.875;3600000;0
11420;205124;89;0;0;0;0;.00nan;0;0
11420;201792;89;83;60;6;54;.900;3600000;0
11420;-1;93;0;0;0;0;.00nan;0;0
11421;192739;92;65;34;5;29;.853;3600000;0
11421;194502;86;84;48;4;44;.917;3600000;0
11421;212301;92;0;0;0;0;.00nan;0;0
11421;201876;86;0;0;0;0;.00nan;0;0
11422;199768;105;0;0;0;0;.00nan;0;0
11422;205112;105;60;22;2;20;.909;3600000;0
11422;205276;103;32;27;6;21;.778;2431000;0
11422;210428;103;43;11;2;9;.818;1169000;0
11423;210368;106;46;29;5;24;.828;3600000;0
11423;200549;102;44;36;6;30;.833;3210000;0
11423;210923;102;52;3;0;3;1.000;384000;0
11423;-1;106;0;0;0;0;.00nan;0;0
11424;208417;101;66;36;3;33;.917;3779000;0
11424;210603;104;52;27;4;23;.852;3779000;0
11424;201739;101;0;0;0;0;.00nan;0;0
11424;208300;104;0;0;0;0;.00nan;0;0
11425;199784;87;49;27;5;22;.815;3124000;0
11425;205076;87;28;7;3;4;.571;476000;0
11425;212343;96;0;0;0;0;.00nan;0;0
11425;-1;96;91;43;3;40;.930;3600000;0
11426;197940;100;57;19;2;17;.895;3600000;0
11426;209796;107;39;17;3;14;.824;473000;0
11426;201817;107;36;27;5;22;.815;3127000;0
11426;212368;100;0;0;0;0;.00nan;0;0
11427;194502;86;51;27;4;23;.852;3552000;0
11427;201876;86;0;0;0;0;.00nan;0;0
11427;212343;96;71;36;3;33;.917;3600000;0
11427;-1;96;0;0;0;0;.00nan;0;0
11428;200065;93;44;41;6;35;.854;3600000;0
11428;200572;95;87;19;0;19;1.000;3600000;0
11428;212487;95;0;0;0;0;.00nan;0;0
11428;-1;93;0;0;0;0;.00nan;0;0
11429;199784;87;0;0;0;0;.00nan;0;0
11429;194502;86;52;26;3;23;.885;3570000;0
11429;205076;87;75;30;1;29;.967;3600000;0
11429;201876;86;0;0;0;0;.00nan;0;0
11430;200065;93;100;28;0;28;1.000;3600000;0
11430;205124;89;50;1;0;1;1.000;345000;0
11430;201792;89;52;41;6;35;.854;3255000;0
11430;-1;93;0;0;0;0;.00nan;0;0
11431;197962;99;45;2;1;1;.500;385000;0
11431;210480;88;26;26;6;20;.769;3649000;0
11431;202788;99;18;27;6;21;.778;3264000;0
11431;-1;88;0;0;0;0;.00nan;0;0
11432;212343;96;0;0;0;0;.00nan;0;0
11432;201888;90;0;0;0;0;.00nan;0;0
11432;-1;90;70;26;2;24;.923;3600000;0
11432;-1;96;62;30;4;26;.867;3562000;0
11433;209784;91;64;32;4;28;.875;3600000;0
11433;205429;91;0;0;0;0;.00nan;0;0
11433;200572;95;91;20;0;20;1.000;3600000;0
11433;212487;95;0;0;0;0;.00nan;0;0
11434;192739;92;89;19;0;19;1.000;3600000;0
11434;205318;97;0;0;0;0;.00nan;0;0
11434;205824;97;48;32;4;28;.875;3600000;0
11434;212301;92;0;0;0;0;.00nan;0;0
11435;210368;106;0;0;0;0;.00nan;0;0
11435;210603;104;0;0;0;0;.00nan;0;0
11435;-1;106;33;25;5;20;.800;3593000;0
11435;208300;104;84;38;3;35;.921;3600000;0
11436;197940;100;75;32;3;29;.906;3600000;0
11436;200549;102;0;0;0;0;.00nan;0;0
11436;210923;102;37;35;6;29;.829;3600000;0
11436;212368;100;0;0;0;0;.00nan;0;0
11437;199768;105;81;18;0;18;1.000;1756000;0
11437;209796;107;67;32;3;29;.906;3600000;0
11437;205112;105;37;22;4;18;.818;1844000;0
11437;201817;107;0;0;0;0;.00nan;0;0
11438;208417;101;0;0;0;0;.00nan;0;0
11438;215785;94;68;23;2;21;.913;3581000;0
11438;201739;101;100;27;0;27;1.000;3600000;0
11438;-1;94;0;0;0;0;.00nan;0;0
11439;197962;99;0;0;0;0;.00nan;0;0
11439;199784;87;53;22;3;19;.864;3600000;0
11439;205076;87;0;0;0;0;.00nan;0;0
11439;202788;99;56;32;4;28;.875;3560000;0
11440;194502;86;0;0;0;0;.00nan;0;0
11440;201876;86;63;29;3;26;.897;3546000;0
11440;201888;90;81;38;2;36;.947;3600000;0
11440;-1;90;0;0;0;0;.00nan;0;0
11441;205124;89;100;52;2;50;.962;3600000;0
11441;201792;89;0;0;0;0;.00nan;0;0
11441;212343;96;74;41;3;38;.927;3600000;0
11441;-1;96;0;0;0;0;.00nan;0;0
11442;210480;88;0;0;0;0;.00nan;0;0
11442;207118;98;0;0;0;0;.00nan;0;0
11442;-1;98;81;30;2;28;.933;3600000;0
11442;-1;88;69;20;1;19;.950;3600000;0
11443;209784;91;32;19;4;15;.789;1755000;0
11443;205429;91;12;21;6;15;.714;1845000;0
11443;200572;95;34;19;4;15;.789;3600000;0
11443;212487;95;0;0;0;0;.00nan;0;0
11444;209796;107;0;0;0;0;.00nan;0;0
11444;210368;106;40;24;4;20;.833;3553000;0
11444;201817;107;90;36;2;34;.944;3600000;0
11444;-1;106;0;0;0;0;.00nan;0;0
11445;197940;100;0;0;0;0;.00nan;0;0
11445;200549;102;68;35;4;31;.886;3554000;0
11445;210923;102;0;0;0;0;.00nan;0;0
11445;212368;100;83;31;2;29;.935;3600000;0
11446;192739;92;71;22;2;20;.909;3600000;0
11446;205318;97;63;31;3;28;.903;3566000;0
11446;205824;97;0;0;0;0;.00nan;0;0
11446;212301;92;0;0;0;0;.00nan;0;0
11447;199768;105;0;0;0;0;.00nan;0;0
11447;205112;105;83;31;2;29;.935;3600000;0
11447;205276;103;0;0;0;0;.00nan;0;0
11447;210428;103;68;29;3;26;.897;3576000;0
11448;208417;101;0;0;0;0;.00nan;0;0
11448;215785;94;26;32;8;24;.750;3600000;0
11448;201739;101;77;18;1;17;.944;3600000;0
11448;-1;94;0;0;0;0;.00nan;0;0
11449;200065;93;77;36;3;33;.917;3600000;0
11449;201888;90;0;0;0;0;.00nan;0;0
11449;-1;90;77;47;4;43;.915;3600000;0
11449;-1;93;0;0;0;0;.00nan;0;0
11450;210368;106;0;0;0;0;.00nan;0;0
11450;215785;94;40;2;1;1;.500;392000;0
11450;-1;106;45;23;4;19;.826;3600000;0
11450;-1;94;31;28;6;22;.786;3208000;0
11451;205276;103;55;41;5;36;.878;3600000;0
11451;210428;103;0;0;0;0;.00nan;0;0
11451;210603;104;66;13;1;12;.923;3600000;0
11451;208300;104;0;0;0;0;.00nan;0;0
11452;194502;86;69;30;2;28;.933;3559000;0
11452;201876;86;0;0;0;0;.00nan;0;0
11452;207118;98;87;32;1;31;.969;3600000;0
11452;-1;98;0;0;0;0;.00nan;0;0
11453;197962;99;0;0;0;0;.00nan;0;0
11453;205124;89;0;0;0;0;.00nan;0;0
11453;201792;89;75;44;5;39;.886;3600000;0
11453;202788;99;99;35;1;34;.971;3600000;0
11454;199784;87;0;0;0;0;.00nan;0;0
11454;205076;87;72;32;3;29;.906;3900000;0
11454;207118;98;0;0;0;0;.00nan;0;0
11454;-1;98;92;44;3;41;.932;3900000;0
11455;197962;99;0;0;0;0;.00nan;0;0
11455;201888;90;0;0;0;0;.00nan;0;0
11455;202788;99;67;30;3;27;.900;3896000;0
11455;-1;90;77;27;2;25;.926;3896000;0
11456;200065;93;62;13;2;11;.846;3600000;0
11456;212343;96;0;0;0;0;.00nan;0;0
11456;-1;96;71;33;4;29;.879;3546000;0
11456;-1;93;0;0;0;0;.00nan;0;0
11457;209784;91;94;33;1;32;.970;3600000;0
11457;205318;97;0;0;0;0;.00nan;0;0
11457;205429;91;0;0;0;0;.00nan;0;0
11457;205824;97;32;19;4;15;.789;3600000;0
11458;210368;106;90;22;0;22;1.000;3600000;0
11458;205276;103;0;0;0;0;.00nan;0;0
11458;210428;103;69;31;3;28;.903;3600000;0
11458;-1;106;0;0;0;0;.00nan;0;0
11459;209796;107;56;34;5;29;.853;3600000;0
11459;210603;104;75;27;2;25;.926;3600000;0
11459;201817;107;0;0;0;0;.00nan;0;0
11459;208300;104;0;0;0;0;.00nan;0;0
11460;200549;102;87;55;5;50;.909;3600000;0
11460;215785;94;63;28;3;25;.893;3600000;0
11460;210923;102;0;0;0;0;.00nan;0;0
11460;-1;94;0;0;0;0;.00nan;0;0
11461;200572;95;53;22;3;19;.864;3600000;0
11461;212343;96;71;45;5;40;.889;3536000;0
11461;212487;95;0;0;0;0;.00nan;0;0
11461;-1;96;0;0;0;0;.00nan;0;0
11462;197962;99;0;0;0;0;.00nan;0;0
11462;194502;86;62;30;3;27;.900;3600000;0
11462;201876;86;0;0;0;0;.00nan;0;0
11462;202788;99;64;37;4;33;.892;3600000;0
11463;205124;89;0;0;0;0;.00nan;0;0
11463;201792;89;75;33;2;31;.939;3600000;0
11463;207118;98;58;37;5;32;.865;3600000;0
11463;-1;98;0;0;0;0;.00nan;0;0
11464;200065;93;0;0;0;0;.00nan;0;0
11464;205318;97;0;0;0;0;.00nan;0;0
11464;205824;97;42;34;5;29;.853;3600000;0
11464;-1;93;83;33;2;31;.939;3600000;0
11465;209784;91;0;0;0;0;.00nan;0;0
11465;210480;88;40;25;4;21;.840;3600000;0
11465;205429;91;58;35;5;30;.857;3600000;0
11465;-1;88;0;0;0;0;.00nan;0;0
11466;192739;92;63;15;1;14;.933;977000;0
11466;200572;95;82;25;1;24;.960;3600000;0
11466;212301;92;38;35;6;29;.829;2623000;0
11466;212487;95;0;0;0;0;.00nan;0;0
11467;205276;103;0;0;0;0;.00nan;0;0
11467;210428;103;60;37;4;33;.892;3592000;0
11467;200549;102;0;0;0;0;.00nan;0;0
11467;210923;102;63;23;2;21;.913;3600000;0
11468;208417;101;0;0;0;0;.00nan;0;0
11468;209796;107;86;54;5;49;.907;3600000;0
11468;201739;101;60;19;2;17;.895;3600000;0
11468;201817;107;0;0;0;0;.00nan;0;0
11469;210368;106;47;28;4;24;.857;3693000;0
11469;210603;104;100;59;3;56;.949;3693000;0
11469;-1;106;0;0;0;0;.00nan;0;0
11469;208300;104;0;0;0;0;.00nan;0;0
11470;197940;100;83;22;1;21;.955;3600000;0
11470;199768;105;0;0;0;0;.00nan;0;0
11470;205112;105;64;36;4;32;.889;3600000;0
11470;212368;100;0;0;0;0;.00nan;0;0
11471;199784;87;0;0;0;0;.00nan;0;0
11471;194502;86;0;0;0;0;.00nan;0;0
11471;205076;87;100;34;1;33;.971;3900000;0
11471;201876;86;87;31;1;30;.968;3900000;0
11472;201888;90;50;18;2;16;.889;3598000;0
11472;207118;98;0;0;0;0;.00nan;0;0
11472;-1;98;100;48;1;47;.979;3600000;0
11472;-1;90;0;0;0;0;.00nan;0;0
11473;209784;91;43;32;5;27;.844;3583000;0
11473;205318;97;64;32;3;29;.906;3600000;0
11473;205429;91;0;0;0;0;.00nan;0;0
11473;205824;97;0;0;0;0;.00nan;0;0
11474;210368;106;0;0;0;0;.00nan;0;0
11474;210603;104;0;0;0;0;.00nan;0;0
11474;-1;106;73;38;4;34;.895;3900000;0
11474;208300;104;79;41;4;37;.902;3900000;0
11475;210480;88;0;0;0;0;.00nan;0;0
11475;212343;96;0;0;0;0;.00nan;0;0
11475;-1;88;72;25;2;23;.920;3600000;0
11475;-1;96;67;36;3;33;.917;3547000;0
11476;209796;107;0;0;0;0;.00nan;0;0
11476;215785;94;40;38;5;33;.868;3515000;0
11476;201817;107;61;34;3;31;.912;3600000;0
11476;-1;94;0;0;0;0;.00nan;0;0
11477;197940;100;84;32;3;29;.906;3563000;0
11477;199768;105;82;28;1;27;.964;3600000;0
11477;205112;105;0;0;0;0;.00nan;0;0
11477;212368;100;0;0;0;0;.00nan;0;0
11478;208417;101;46;46;8;38;.826;3600000;0
11478;200549;102;78;32;3;29;.906;3600000;0
11478;210923;102;0;0;0;0;.00nan;0;0
11478;201739;101;0;0;0;0;.00nan;0;0
11479;200065;93;73;36;3;33;.917;3600000;0
11479;200572;95;50;26;4;22;.846;3551000;0
11479;212487;95;0;0;0;0;.00nan;0;0
11479;-1;93;0;0;0;0;.00nan;0;0
11480;192739;92;93;37;2;35;.946;3600000;0
11480;210480;88;81;44;3;41;.932;3548000;0
11480;212301;92;0;0;0;0;.00nan;0;0
11480;-1;88;0;0;0;0;.00nan;0;0
11481;205276;103;0;0;0;0;.00nan;0;0
11481;210428;103;75;29;2;27;.931;3600000;0
11481;215785;94;0;0;0;0;.00nan;0;0
11481;-1;94;31;26;5;21;.808;3600000;0
11482;208417;101;45;5;1;4;.800;449000;0
11482;209796;107;54;19;3;16;.842;3600000;0
11482;201739;101;18;21;6;15;.714;3151000;0
11482;201817;107;0;0;0;0;.00nan;0;0
11483;199784;87;0;0;0;0;.00nan;0;0
11483;205076;87;33;42;7;35;.833;3600000;0
11483;210480;88;0;0;0;0;.00nan;0;0
11483;-1;88;85;18;0;18;1.000;3600000;0
11484;205124;89;0;0;0;0;.00nan;0;0
11484;201792;89;59;37;5;32;.865;3866000;0
11484;201888;90;0;0;0;0;.00nan;0;0
11484;-1;90;60;31;4;27;.871;3866000;0
11485;209784;91;0;0;0;0;.00nan;0;0
11485;205429;91;19;33;7;26;.788;3600000;0
11485;200572;95;65;23;2;21;.913;3600000;0
11485;212487;95;0;0;0;0;.00nan;0;0
11486;205318;97;56;30;4;26;.867;3900000;0
11486;205824;97;0;0;0;0;.00nan;0;0
11486;212343;96;0;0;0;0;.00nan;0;0
11486;-1;96;45;28;4;24;.857;3900000;0
11487;197962;99;57;36;5;31;.861;3829000;0
11487;207118;98;79;42;4;38;.905;3829000;0
11487;202788;99;0;0;0;0;.00nan;0;0
11487;-1;98;0;0;0;0;.00nan;0;0
11488;192739;92;54;30;4;26;.867;3575000;0
11488;200549;102;64;31;3;28;.903;3600000;0
11488;210923;102;0;0;0;0;.00nan;0;0
11488;212301;92;0;0;0;0;.00nan;0;0
11489;197940;100;30;26;6;20;.769;2552000;0
11489;208417;101;0;0;0;0;.00nan;0;0
11489;201739;101;71;33;2;31;.939;3600000;0
11489;212368;100;50;1;0;1;1.000;1048000;0
11490;205276;103;0;0;0;0;.00nan;0;0
11490;210428;103;71;34;4;30;.882;3600000;0
11490;210603;104;83;29;1;28;.966;3600000;0
11490;208300;104;0;0;0;0;.00nan;0;0
11491;199768;105;0;0;0;0;.00nan;0;0
11491;205112;105;74;37;3;34;.919;3582000;0
11491;210368;106;0;0;0;0;.00nan;0;0
11491;-1;106;69;25;2;23;.920;3600000;0
11492;197940;100;0;0;0;0;.00nan;0;0
11492;205276;103;71;26;2;24;.923;3562000;0
11492;210428;103;0;0;0;0;.00nan;0;0
11492;212368;100;89;28;1;27;.964;3600000;0
11493;209796;107;70;51;5;46;.902;3600000;0
11493;210368;106;62;22;2;20;.909;3600000;0
11493;201817;107;0;0;0;0;.00nan;0;0
11493;-1;106;0;0;0;0;.00nan;0;0
11494;200065;93;92;31;1;30;.968;3600000;0
11494;200549;102;0;0;0;0;.00nan;0;0
11494;210923;102;49;34;5;29;.853;3600000;0
11494;-1;93;0;0;0;0;.00nan;0;0
11495;199784;87;52;22;4;18;.818;3600000;0
11495;205076;87;0;0;0;0;.00nan;0;0
11495;201888;90;0;0;0;0;.00nan;0;0
11495;-1;90;49;36;5;31;.861;3578000;0
11496;194502;86;57;33;4;29;.879;3739000;0
11496;210480;88;45;31;5;26;.839;3739000;0
11496;205799;86;0;0;0;0;.00nan;0;0
11496;-1;88;0;0;0;0;.00nan;0;0
11497;209784;91;50;14;2;12;.857;3600000;0
11497;205429;91;0;0;0;0;.00nan;0;0
11497;212343;96;0;0;0;0;.00nan;0;0
11497;-1;96;65;45;5;40;.889;3600000;0
11498;205318;97;0;0;0;0;.00nan;0;0
11498;200572;95;71;26;2;24;.923;3600000;0
11498;205824;97;69;36;3;33;.917;3575000;0
11498;212487;95;0;0;0;0;.00nan;0;0
11499;208417;101;76;23;1;22;.957;3600000;0
11499;192739;92;85;34;2;32;.941;3600000;0
11499;201739;101;0;0;0;0;.00nan;0;0
11499;212301;92;0;0;0;0;.00nan;0;0
11500;197962;99;0;0;0;0;.00nan;0;0
11500;207118;98;0;0;0;0;.00nan;0;0
11500;202788;99;37;22;4;18;.818;3538000;0
11500;-1;98;82;35;2;33;.943;3600000;0
11501;194502;86;0;0;0;0;.00nan;0;0
11501;205124;89;0;0;0;0;.00nan;0;0
11501;205799;86;37;16;3;13;.813;3600000;0
11501;201792;89;91;53;4;49;.925;3600000;0
11502;199784;87;54;3;0;3;1.000;783000;0
11502;205076;87;34;31;6;25;.806;2817000;0
11502;210480;88;0;0;0;0;.00nan;0;0
11502;-1;88;75;25;1;24;.960;3600000;0
11503;200572;95;0;0;0;0;.00nan;0;0
11503;212343;96;63;41;5;36;.878;3600000;0
11503;212487;95;54;11;1;10;.909;3600000;0
11503;-1;96;0;0;0;0;.00nan;0;0
11504;197962;99;84;37;2;35;.946;3900000;0
11504;200549;102;94;34;2;32;.941;3900000;0
11504;210923;102;0;0;0;0;.00nan;0;0
11504;202788;99;0;0;0;0;.00nan;0;0
11505;209784;91;0;0;0;0;.00nan;0;0
11505;205318;97;89;52;4;48;.923;3532000;0
11505;205429;91;65;32;3;29;.906;3600000;0
11505;205824;97;0;0;0;0;.00nan;0;0
11506;209796;107;0;0;0;0;.00nan;0;0
11506;215785;94;0;0;0;0;.00nan;0;0
11506;201817;107;86;33;1;32;.970;3600000;0
11506;-1;94;54;43;6;37;.860;3600000;0
11507;199768;105;0;0;0;0;.00nan;0;0
11507;205112;105;68;28;3;25;.893;3600000;0
11507;210603;104;24;17;5;12;.706;3567000;0
11507;208300;104;0;0;0;0;.00nan;0;0
11508;192739;92;0;0;0;0;.00nan;0;0
11508;215575;100;0;0;0;0;.00nan;0;0
11508;212301;92;60;30;3;27;.900;3556000;0
11508;212368;100;83;31;2;29;.935;3600000;0
11509;200065;93;62;11;1;10;.909;3600000;0
11509;207118;98;97;54;3;51;.944;3600000;0
11509;-1;98;0;0;0;0;.00nan;0;0
11509;-1;93;0;0;0;0;.00nan;0;0
11510;209796;107;15;8;4;4;.500;1021000;0
11510;205276;103;0;0;0;0;.00nan;0;0
11510;210428;103;76;27;2;25;.926;3600000;0
11510;201817;107;31;20;4;16;.800;2579000;0
11511;208417;101;0;0;0;0;.00nan;0;0
11511;205119;106;76;34;2;32;.941;3600000;0
11511;210368;106;0;0;0;0;.00nan;0;0
11511;201739;101;43;32;5;27;.844;3600000;0
11512;199768;105;44;26;4;22;.846;3600000;0
11512;205112;105;0;0;0;0;.00nan;0;0
11512;210603;104;0;0;0;0;.00nan;0;0
11512;208300;104;57;40;6;34;.850;3595000;0
11513;194502;86;69;35;3;32;.914;3600000;0
11513;210480;88;41;23;4;19;.826;3572000;0
11513;205799;86;0;0;0;0;.00nan;0;0
11513;-1;88;0;0;0;0;.00nan;0;0
11514;199784;87;29;9;3;6;.667;579000;0
11514;205076;87;53;21;2;19;.905;2993000;0
11514;201888;90;0;0;0;0;.00nan;0;0
11514;-1;90;65;39;4;35;.897;3600000;0
11515;200065;93;66;33;4;29;.879;3798000;0
11515;215575;100;0;0;0;0;.00nan;0;0
11515;212368;100;63;30;3;27;.900;3798000;0
11515;-1;93;0;0;0;0;.00nan;0;0
11516;192739;92;60;26;3;23;.885;3543000;0
11516;215785;94;96;42;2;40;.952;3600000;0
11516;212301;92;0;0;0;0;.00nan;0;0
11516;-1;94;0;0;0;0;.00nan;0;0
11517;205318;97;0;0;0;0;.00nan;0;0
11517;205824;97;54;27;3;24;.889;3551000;0
11517;212343;96;0;0;0;0;.00nan;0;0
11517;-1;96;89;38;2;36;.947;3600000;0
11518;209784;91;88;39;1;38;.974;3594000;0
11518;205429;91;0;0;0;0;.00nan;0;0
11518;200572;95;87;18;0;18;1.000;3600000;0
11518;212487;95;0;0;0;0;.00nan;0;0
11519;205276;103;0;0;0;0;.00nan;0;0
11519;210428;103;88;39;2;37;.949;3600000;0
11519;200549;102;0;0;0;0;.00nan;0;0
11519;210923;102;75;19;1;18;.947;3600000;0
11520;197962;99;0;0;0;0;.00nan;0;0
11520;192739;92;56;37;5;32;.865;3780000;0
11520;212301;92;0;0;0;0;.00nan;0;0
11520;202788;99;24;25;6;19;.760;3780000;0
11521;208417;101;55;23;2;21;.913;3600000;0
11521;200065;93;42;37;6;31;.838;3600000;0
11521;201739;101;0;0;0;0;.00nan;0;0
11521;-1;93;0;0;0;0;.00nan;0;0
11522;194502;86;27;26;6;20;.769;2563000;0
11522;205124;89;0;0;0;0;.00nan;0;0
11522;205799;86;42;3;1;2;.667;1037000;0
11522;201792;89;75;41;4;37;.902;3600000;0
11523;210480;88;0;0;0;0;.00nan;0;0
11523;201888;90;0;0;0;0;.00nan;0;0
11523;-1;90;69;47;5;42;.894;3600000;0
11523;-1;88;71;22;1;21;.955;3600000;0
11524;200572;95;63;21;3;18;.857;3600000;0
11524;210603;104;35;47;8;39;.830;3600000;0
11524;212487;95;0;0;0;0;.00nan;0;0
11524;208300;104;0;0;0;0;.00nan;0;0
11525;199768;105;0;0;0;0;.00nan;0;0
11525;209784;91;0;0;0;0;.00nan;0;0
11525;205112;105;98;38;2;36;.947;3579000;0
11525;205429;91;65;18;1;17;.944;3600000;0
11526;205318;97;0;0;0;0;.00nan;0;0
11526;205824;97;78;25;1;24;.960;3600000;0
11526;212343;96;0;0;0;0;.00nan;0;0
11526;-1;96;61;38;5;33;.868;3600000;0
11527;197962;99;82;31;3;28;.903;3900000;0
11527;200065;93;53;23;3;20;.870;3900000;0
11527;202788;99;0;0;0;0;.00nan;0;0
11527;-1;93;0;0;0;0;.00nan;0;0
11528;205119;106;65;20;2;18;.900;3587000;0
11528;210368;106;0;0;0;0;.00nan;0;0
11528;215785;94;85;32;1;31;.969;3600000;0
11528;-1;94;0;0;0;0;.00nan;0;0
11529;192739;92;100;27;0;27;1.000;3600000;0
11529;212301;92;0;0;0;0;.00nan;0;0
11529;207118;98;0;0;0;0;.00nan;0;0
11529;-1;98;74;36;3;33;.917;3600000;0
11530;209796;107;75;25;1;24;.960;3600000;0
11530;200549;102;52;30;4;26;.867;3600000;0
11530;210923;102;0;0;0;0;.00nan;0;0
11530;201817;107;0;0;0;0;.00nan;0;0
11531;208417;101;0;0;0;0;.00nan;0;0
11531;199784;87;56;4;0;4;1.000;285000;0
11531;205076;87;26;29;6;23;.793;3315000;0
11531;201739;101;67;19;2;17;.895;3600000;0
11532;205124;89;74;59;5;54;.915;3600000;0
11532;201792;89;0;0;0;0;.00nan;0;0
11532;201888;90;69;27;2;25;.926;3600000;0
11532;-1;90;0;0;0;0;.00nan;0;0
11533;215575;100;0;0;0;0;.00nan;0;0
11533;210480;88;61;28;3;25;.893;3600000;0
11533;212368;100;100;32;0;32;1.000;3600000;0
11533;-1;88;0;0;0;0;.00nan;0;0
11534;194502;86;0;0;0;0;.00nan;0;0
11534;200572;95;0;0;0;0;.00nan;0;0
11534;205799;86;82;36;2;34;.944;3900000;0
11534;212487;95;72;31;2;29;.935;3900000;0
11535;199768;105;0;0;0;0;.00nan;0;0
11535;205112;105;93;39;1;38;.974;3569000;0
11535;205318;97;87;14;0;14;1.000;3600000;0
11535;205824;97;0;0;0;0;.00nan;0;0
11536;205119;106;0;0;0;0;.00nan;0;0
11536;210368;106;56;20;2;18;.900;3600000;0
11536;200549;102;0;0;0;0;.00nan;0;0
11536;210923;102;80;49;5;44;.898;3600000;0
11537;205276;103;0;0;0;0;.00nan;0;0
11537;210428;103;64;41;5;36;.878;3600000;0
11537;207118;98;66;21;1;20;.952;3600000;0
11537;-1;98;0;0;0;0;.00nan;0;0
11538;209796;107;0;0;0;0;.00nan;0;0
11538;215785;94;0;0;0;0;.00nan;0;0
11538;201817;107;97;36;1;35;.972;3600000;0
11538;-1;94;40;31;5;26;.839;3600000;0
11539;192739;92;100;47;2;45;.957;3600000;0
11539;200065;93;0;0;0;0;.00nan;0;0
11539;212301;92;0;0;0;0;.00nan;0;0
11539;-1;93;64;36;4;32;.889;3527000;0
11540;205318;97;91;33;2;31;.939;3600000;0
11540;210603;104;53;36;5;31;.861;3585000;0
11540;205824;97;0;0;0;0;.00nan;0;0
11540;208300;104;0;0;0;0;.00nan;0;0
11541;200549;102;55;17;2;15;.882;3600000;0
11541;215785;94;83;45;3;42;.933;3600000;0
11541;210923;102;0;0;0;0;.00nan;0;0
11541;-1;94;0;0;0;0;.00nan;0;0
11542;199784;87;75;37;3;34;.919;3600000;0
11542;205076;87;0;0;0;0;.00nan;0;0
11542;215575;100;0;0;0;0;.00nan;0;0
11542;212368;100;73;40;4;36;.900;3572000;0
11543;208417;101;0;0;0;0;.00nan;0;0
11543;205124;89;67;13;0;13;1.000;1036000;0
11543;201739;101;74;10;0;10;1.000;3600000;0
11543;201792;89;41;37;6;31;.838;2564000;0
11544;209784;91;83;30;1;29;.967;3600000;0
11544;205429;91;0;0;0;0;.00nan;0;0
11544;210603;104;41;9;2;7;.778;477000;0
11544;208300;104;33;33;6;27;.818;3123000;0
11545;199768;105;34;21;4;17;.810;1381000;0
11545;205112;105;36;35;6;29;.829;2219000;0
11545;200572;95;37;21;5;16;.762;2115000;0
11545;212487;95;61;7;0;7;1.000;1485000;0
11546;194502;86;58;29;3;26;.897;3558000;0
11546;215575;100;88;40;2;38;.950;3600000;0
11546;205799;86;0;0;0;0;.00nan;0;0
11546;212368;100;0;0;0;0;.00nan;0;0
11547;208417;101;0;0;0;0;.00nan;0;0
11547;201739;101;43;26;4;22;.846;3668000;0
11547;201888;90;0;0;0;0;.00nan;0;0
11547;-1;90;81;37;3;34;.919;3668000;0
11548;210603;104;56;35;5;30;.857;3555000;0
11548;212343;96;0;0;0;0;.00nan;0;0
11548;-1;96;70;39;4;35;.897;3600000;0
11548;208300;104;0;0;0;0;.00nan;0;0
11549;209796;107;0;0;0;0;.00nan;0;0
11549;201817;107;31;26;5;21;.808;3518000;0
11549;207118;98;74;39;3;36;.923;3600000;0
11549;-1;98;0;0;0;0;.00nan;0;0
11550;192739;92;44;25;4;21;.840;3600000;0
11550;199768;105;0;0;0;0;.00nan;0;0
11550;205112;105;55;43;6;37;.860;3527000;0
11550;212301;92;0;0;0;0;.00nan;0;0
11551;200065;93;44;17;3;14;.824;3900000;0
11551;210603;104;78;35;3;32;.914;3900000;0
11551;-1;93;0;0;0;0;.00nan;0;0
11551;208300;104;0;0;0;0;.00nan;0;0
11552;199784;87;66;29;4;25;.862;3600000;0
11552;205076;87;0;0;0;0;.00nan;0;0
11552;200572;95;36;27;5;22;.815;3548000;0
11552;212487;95;0;0;0;0;.00nan;0;0
11553;205124;89;0;0;0;0;.00nan;0;0
11553;215575;100;0;0;0;0;.00nan;0;0
11553;201792;89;73;25;1;24;.960;3600000;0
11553;212368;100;60;23;2;21;.913;3543000;0
11554;208417;101;0;0;0;0;.00nan;0;0
11554;210480;88;43;24;4;20;.833;3600000;0
11554;201739;101;37;37;7;30;.811;3600000;0
11554;-1;88;0;0;0;0;.00nan;0;0
11555;209784;91;0;0;0;0;.00nan;0;0
11555;205318;97;23;4;3;1;.250;497000;0
11555;205429;91;83;45;4;41;.911;3850000;0
11555;205824;97;63;21;2;19;.905;3353000;0
11556;199768;105;0;0;0;0;.00nan;0;0
11556;205112;105;87;37;2;35;.946;3600000;0
11556;212343;96;55;32;5;27;.844;3600000;0
11556;-1;96;0;0;0;0;.00nan;0;0
11557;197962;99;0;0;0;0;.00nan;0;0
11557;215785;94;82;40;3;37;.925;3900000;0
11557;202788;99;76;32;3;29;.906;3900000;0
11557;-1;94;0;0;0;0;.00nan;0;0
11558;200549;102;61;18;2;16;.889;3600000;0
11558;210923;102;0;0;0;0;.00nan;0;0
11558;207118;98;51;3;0;3;1.000;855000;0
11558;-1;98;36;33;6;27;.818;2745000;0
11559;209796;107;99;46;2;44;.957;3600000;0
11559;210368;106;0;0;0;0;.00nan;0;0
11559;201817;107;0;0;0;0;.00nan;0;0
11559;-1;106;59;28;3;25;.893;3547000;0
11560;208417;101;70;30;2;28;.933;3524000;0
11560;194502;86;79;15;0;15;1.000;3600000;0
11560;205799;86;0;0;0;0;.00nan;0;0
11560;201739;101;0;0;0;0;.00nan;0;0
11561;205124;89;76;53;6;47;.887;3595000;0
11561;210480;88;0;0;0;0;.00nan;0;0
11561;201792;89;0;0;0;0;.00nan;0;0
11561;-1;88;29;17;4;13;.765;3600000;0
11562;215575;100;59;27;3;24;.889;3600000;0
11562;212368;100;0;0;0;0;.00nan;0;0
11562;201888;90;0;0;0;0;.00nan;0;0
11562;-1;90;88;16;0;16;1.000;3600000;0
11563;209784;91;0;0;0;0;.00nan;0;0
11563;205318;97;63;33;3;30;.909;3600000;0
11563;205429;91;100;27;0;27;1.000;3600000;0
11563;205824;97;0;0;0;0;.00nan;0;0
11564;209796;107;0;0;0;0;.00nan;0;0
11564;210368;106;78;13;0;13;1.000;3600000;0
11564;201817;107;69;26;2;24;.923;3544000;0
11564;-1;106;0;0;0;0;.00nan;0;0
11565;200549;102;0;0;0;0;.00nan;0;0
11565;210923;102;38;18;4;14;.778;3600000;0
11565;207118;98;28;27;6;21;.778;2126000;0
11565;-1;98;74;23;2;21;.913;1474000;0
11566;192739;92;78;27;2;25;.926;3600000;0
11566;212301;92;0;0;0;0;.00nan;0;0
11566;212343;96;0;0;0;0;.00nan;0;0
11566;-1;96;33;39;7;32;.821;3600000;0
11567;197962;99;22;12;4;8;.667;876000;0
11567;215785;94;0;0;0;0;.00nan;0;0
11567;202788;99;84;21;1;20;.952;2715000;0
11567;-1;94;69;38;4;34;.895;3600000;0
11568;199784;87;0;0;0;0;.00nan;0;0
11568;205076;87;53;30;4;26;.867;3581000;0
11568;205124;89;0;0;0;0;.00nan;0;0
11568;201792;89;84;27;2;25;.926;3600000;0
11569;199768;105;0;0;0;0;.00nan;0;0
11569;200065;93;54;16;2;14;.875;3600000;0
11569;205112;105;88;54;4;50;.926;3558000;0
11569;-1;93;0;0;0;0;.00nan;0;0
11570;210480;88;77;34;2;32;.941;3600000;0
11570;201888;90;0;0;0;0;.00nan;0;0
11570;-1;90;79;39;3;36;.923;3546000;0
11570;-1;88;0;0;0;0;.00nan;0;0
11571;192739;92;94;43;1;42;.977;3600000;0
11571;210603;104;70;26;2;24;.923;3600000;0
11571;212301;92;0;0;0;0;.00nan;0;0
11571;208300;104;0;0;0;0;.00nan;0;0
11572;205276;103;0;0;0;0;.00nan;0;0
11572;210428;103;42;19;3;16;.842;3548000;0
11572;215785;94;83;29;1;28;.966;3600000;0
11572;-1;94;0;0;0;0;.00nan;0;0
11573;197962;99;27;23;5;18;.783;3555000;0
11573;210368;106;86;35;3;32;.914;3600000;0
11573;202788;99;0;0;0;0;.00nan;0;0
11573;-1;106;0;0;0;0;.00nan;0;0
11574;205318;97;0;0;0;0;.00nan;0;0
11574;200572;95;52;19;3;16;.842;3600000;0
11574;205824;97;88;51;4;47;.922;3543000;0
11574;212487;95;0;0;0;0;.00nan;0;0
11575;197962;99;0;0;0;0;.00nan;0;0
11575;205276;103;0;0;0;0;.00nan;0;0
11575;210428;103;34;26;5;21;.808;3559000;0
11575;202788;99;55;27;4;23;.852;3600000;0
11576;209784;91;0;0;0;0;.00nan;0;0
11576;194502;86;70;28;2;26;.929;3600000;0
11576;205429;91;56;31;4;27;.871;3577000;0
11576;201876;86;0;0;0;0;.00nan;0;0
11577;212343;96;0;0;0;0;.00nan;0;0
11577;201888;90;0;0;0;0;.00nan;0;0
11577;-1;90;39;24;4;20;.833;3900000;0
11577;-1;96;48;21;4;17;.810;3900000;0
11578;210368;106;80;23;1;22;.957;3600000;0
11578;207118;98;0;0;0;0;.00nan;0;0
11578;-1;106;0;0;0;0;.00nan;0;0
11578;-1;98;89;50;4;46;.920;3547000;0
11579;209784;91;14;21;6;15;.714;2167000;0
11579;210480;88;0;0;0;0;.00nan;0;0
11579;205429;91;53;23;3;20;.870;1433000;0
11579;-1;88;63;23;2;21;.913;3600000;0
11580;194502;86;57;44;6;38;.864;3600000;0
11580;200572;95;0;0;0;0;.00nan;0;0
11580;201876;86;0;0;0;0;.00nan;0;0
11580;212487;95;65;15;1;14;.933;3600000;0
11581;200065;93;45;22;4;18;.818;3600000;0
11581;201888;90;0;0;0;0;.00nan;0;0
11581;-1;90;59;34;5;29;.853;3563000;0
11581;-1;93;0;0;0;0;.00nan;0;0
11582;205318;97;90;34;1;33;.971;3600000;0
11582;205824;97;0;0;0;0;.00nan;0;0
11582;212343;96;0;0;0;0;.00nan;0;0
11582;-1;96;42;34;5;29;.853;3600000;0
11583;210368;106;94;46;2;44;.957;3600000;0
11583;200549;102;0;0;0;0;.00nan;0;0
11583;210923;102;62;31;4;27;.871;3553000;0
11583;-1;106;0;0;0;0;.00nan;0;0
11584;192739;92;46;19;3;16;.842;3900000;0
11584;205124;89;0;0;0;0;.00nan;0;0
11584;201792;89;72;39;3;36;.923;3900000;0
11584;212301;92;0;0;0;0;.00nan;0;0
11585;208417;101;0;0;0;0;.00nan;0;0
11585;201739;101;45;13;2;11;.846;3556000;0
11585;207118;98;78;26;1;25;.962;3600000;0
11585;-1;98;0;0;0;0;.00nan;0;0
11586;210603;104;0;0;0;0;.00nan;0;0
11586;215785;94;87;36;2;34;.944;3551000;0
11586;-1;94;0;0;0;0;.00nan;0;0
11586;208300;104;70;20;1;19;.950;3600000;0
11587;199768;105;0;0;0;0;.00nan;0;0
11587;209796;107;54;21;3;18;.857;3600000;0
11587;205112;105;66;39;4;35;.897;3543000;0
11587;201817;107;0;0;0;0;.00nan;0;0
11588;197940;100;59;17;2;15;.882;3600000;0
11588;197962;99;0;0;0;0;.00nan;0;0
11588;212368;100;0;0;0;0;.00nan;0;0
11588;202788;99;74;33;3;30;.909;3553000;0
11589;199784;87;100;42;1;41;.976;3900000;0
11589;209784;91;97;42;1;41;.976;3900000;0
11589;205076;87;0;0;0;0;.00nan;0;0
11589;205429;91;0;0;0;0;.00nan;0;0
11590;194502;86;0;0;0;0;.00nan;0;0
11590;200572;95;47;18;3;15;.833;3600000;0
11590;201876;86;50;47;6;41;.872;3600000;0
11590;212487;95;0;0;0;0;.00nan;0;0
11591;205318;97;0;0;0;0;.00nan;0;0
11591;210480;88;48;26;4;22;.846;3600000;0
11591;205824;97;61;46;6;40;.870;3544000;0
11591;-1;88;0;0;0;0;.00nan;0;0
11592;210368;106;0;0;0;0;.00nan;0;0
11592;200549;102;81;37;2;35;.946;3600000;0
11592;210923;102;0;0;0;0;.00nan;0;0
11592;-1;106;53;24;3;21;.875;3568000;0
11593;205124;89;44;40;6;34;.850;2942000;0
11593;201792;89;32;3;2;1;.333;658000;0
11593;212343;96;51;32;5;27;.844;3600000;0
11593;-1;96;0;0;0;0;.00nan;0;0
11594;205276;103;0;0;0;0;.00nan;0;0
11594;210428;103;81;26;1;25;.962;3600000;0
11594;210603;104;51;28;4;24;.857;3600000;0
11594;208300;104;0;0;0;0;.00nan;0;0
11595;199768;105;0;0;0;0;.00nan;0;0
11595;209796;107;0;0;0;0;.00nan;0;0
11595;205112;105;59;20;2;18;.900;3600000;0
11595;201817;107;37;28;5;23;.821;3600000;0
11596;208417;101;54;16;2;14;.875;3590000;0
11596;201739;101;0;0;0;0;.00nan;0;0
11596;207118;98;0;0;0;0;.00nan;0;0
11596;-1;98;90;44;1;43;.977;3600000;0
11597;199784;87;0;0;0;0;.00nan;0;0
11597;205076;87;67;23;2;21;.913;3900000;0
11597;205318;97;85;34;2;32;.941;3900000;0
11597;205824;97;0;0;0;0;.00nan;0;0
11598;200065;93;0;0;0;0;.00nan;0;0
11598;205124;89;0;0;0;0;.00nan;0;0
11598;201792;89;99;52;3;49;.942;3900000;0
11598;-1;93;59;23;3;20;.870;3900000;0
11599;192739;92;48;20;3;17;.850;3568000;0
11599;212301;92;0;0;0;0;.00nan;0;0
11599;201888;90;0;0;0;0;.00nan;0;0
11599;-1;90;82;32;2;30;.938;3600000;0
11600;197940;100;0;0;0;0;.00nan;0;0
11600;197962;99;29;37;7;30;.811;2840000;0
11600;212368;100;50;31;5;26;.839;3600000;0
11600;202788;99;44;4;1;3;.750;760000;0
11601;199768;105;79;46;4;42;.913;3568000;0
11601;205112;105;0;0;0;0;.00nan;0;0
11601;215785;94;54;27;3;24;.889;3600000;0
11601;-1;94;0;0;0;0;.00nan;0;0
11602;209796;107;72;30;2;28;.933;3600000;0
11602;205276;103;34;34;6;28;.824;3600000;0
11602;210428;103;0;0;0;0;.00nan;0;0
11602;201817;107;0;0;0;0;.00nan;0;0
11603;199768;105;0;0;0;0;.00nan;0;0
11603;205112;105;65;30;3;27;.900;3562000;0
11603;205276;103;0;0;0;0;.00nan;0;0
11603;210428;103;60;16;2;14;.875;3600000;0
11604;215785;94;41;27;5;22;.815;3542000;0
11604;207118;98;63;27;3;24;.889;3600000;0
11604;-1;98;0;0;0;0;.00nan;0;0
11604;-1;94;0;0;0;0;.00nan;0;0
11605;194502;86;41;30;5;25;.833;3600000;0
11605;205318;97;41;36;6;30;.833;2745000;0
11605;205824;97;51;8;1;7;.875;779000;0
11605;201876;86;0;0;0;0;.00nan;0;0
11606;205124;89;47;25;4;21;.840;1626000;0
11606;201792;89;54;27;4;23;.852;1974000;0
11606;201888;90;0;0;0;0;.00nan;0;0
11606;-1;90;73;27;2;25;.926;3600000;0
11607;199784;87;48;43;6;37;.860;3076000;0
11607;200065;93;62;25;3;22;.880;3600000;0
11607;205076;87;42;3;1;2;.667;524000;0
11607;-1;93;0;0;0;0;.00nan;0;0
11608;209784;91;0;0;0;0;.00nan;0;0
11608;210480;88;0;0;0;0;.00nan;0;0
11608;205429;91;50;16;2;14;.875;3600000;0
11608;-1;88;39;29;5;24;.828;3600000;0
11609;192739;92;82;41;3;38;.927;3546000;0
11609;212301;92;0;0;0;0;.00nan;0;0
11609;212343;96;0;0;0;0;.00nan;0;0
11609;-1;96;91;28;1;27;.964;3600000;0
11610;209796;107;59;27;2;25;.926;3600000;0
11610;205276;103;0;0;0;0;.00nan;0;0
11610;210428;103;88;41;3;38;.927;3600000;0
11610;201817;107;0;0;0;0;.00nan;0;0
11611;197940;100;39;28;5;23;.821;3600000;0
11611;208417;101;32;28;6;22;.786;3125000;0
11611;201739;101;45;5;1;4;.800;426000;0
11611;212368;100;0;0;0;0;.00nan;0;0
11612;197962;99;0;0;0;0;.00nan;0;0
11612;207118;98;69;54;5;49;.907;3600000;0
11612;202788;99;60;25;2;23;.920;3600000;0
11612;-1;98;0;0;0;0;.00nan;0;0
11613;200549;102;0;0;0;0;.00nan;0;0
11613;210603;104;70;41;4;37;.902;3549000;0
11613;210923;102;77;31;2;29;.935;3600000;0
11613;208300;104;0;0;0;0;.00nan;0;0
11614;199768;105;0;0;0;0;.00nan;0;0
11614;205112;105;68;35;4;31;.886;3560000;0
11614;210368;106;64;19;2;17;.895;3600000;0
11614;-1;106;0;0;0;0;.00nan;0;0
11615;205124;89;0;0;0;0;.00nan;0;0
11615;201792;89;81;41;3;38;.927;3600000;0
11615;201888;90;43;25;4;21;.840;3563000;0
11615;-1;90;0;0;0;0;.00nan;0;0
11616;197962;99;64;33;4;29;.879;3563000;0
11616;207118;98;0;0;0;0;.00nan;0;0
11616;202788;99;0;0;0;0;.00nan;0;0
11616;-1;98;63;28;3;25;.893;3600000;0
11617;194502;86;0;0;0;0;.00nan;0;0
11617;205318;97;0;0;0;0;.00nan;0;0
11617;205824;97;89;39;2;37;.949;3600000;0
11617;201876;86;40;26;5;21;.808;3600000;0
11618;199784;87;0;0;0;0;.00nan;0;0
11618;205076;87;82;25;1;24;.960;3600000;0
11618;212343;96;52;29;5;24;.828;3600000;0
11618;-1;96;0;0;0;0;.00nan;0;0
11619;209796;107;0;0;0;0;.00nan;0;0
11619;215785;94;94;32;1;31;.969;3600000;0
11619;201817;107;59;25;2;23;.920;3590000;0
11619;-1;94;0;0;0;0;.00nan;0;0
11620;210368;106;0;0;0;0;.00nan;0;0
11620;210603;104;70;15;0;15;1.000;2499000;0
11620;-1;106;66;29;3;26;.897;3600000;0
11620;208300;104;25;8;4;4;.500;1064000;0
11621;199768;105;53;43;5;38;.884;3558000;0
11621;205112;105;0;0;0;0;.00nan;0;0
11621;200549;102;58;22;3;19;.864;3600000;0
11621;210923;102;0;0;0;0;.00nan;0;0
11622;197940;100;0;0;0;0;.00nan;0;0
11622;208417;101;0;0;0;0;.00nan;0;0
11622;201739;101;59;28;3;25;.893;3900000;0
11622;212368;100;62;27;3;24;.889;3900000;0
11623;200065;93;64;29;3;26;.897;3563000;0
11623;210480;88;66;20;2;18;.900;3600000;0
11623;-1;88;0;0;0;0;.00nan;0;0
11623;-1;93;0;0;0;0;.00nan;0;0
11624;200572;95;64;22;2;20;.909;3600000;0
11624;201888;90;0;0;0;0;.00nan;0;0
11624;212487;95;0;0;0;0;.00nan;0;0
11624;-1;90;58;35;4;31;.886;3542000;0
11625;192739;92;79;21;1;20;.952;3600000;0
11625;199784;87;37;41;7;34;.829;3600000;0
11625;205076;87;0;0;0;0;.00nan;0;0
11625;212301;92;0;0;0;0;.00nan;0;0
11626;197940;100;80;36;3;33;.917;3600000;0
11626;208417;101;18;10;4;6;.600;920000;0
11626;201739;101;53;36;5;31;.861;2680000;0
11626;212368;100;0;0;0;0;.00nan;0;0
11627;205276;103;0;0;0;0;.00nan;0;0
11627;210428;103;100;23;0;23;1.000;3600000;0
11627;200549;102;0;0;0;0;.00nan;0;0
11627;210923;102;50;31;4;27;.871;3600000;0
11628;192739;92;65;27;3;24;.889;3600000;0
11628;209784;91;97;39;1;38;.974;3600000;0
11628;205429;91;0;0;0;0;.00nan;0;0
11628;212301;92;0;0;0;0;.00nan;0;0
11629;209796;107;70;26;3;23;.885;3600000;0
11629;200549;102;27;28;6;22;.786;3035000;0
11629;210923;102;57;6;0;6;1.000;565000;0
11629;201817;107;0;0;0;0;.00nan;0;0
11630;210603;104;61;26;3;23;.885;3600000;0
11630;215785;94;41;32;6;26;.813;2347000;0
11630;-1;94;36;7;2;5;.714;1253000;0
11630;208300;104;0;0;0;0;.00nan;0;0
11631;205124;89;0;0;0;0;.00nan;0;0
11631;201792;89;86;41;3;38;.927;3546000;0
11631;212343;96;0;0;0;0;.00nan;0;0
11631;-1;96;70;30;2;28;.933;3600000;0
11632;210480;88;0;0;0;0;.00nan;0;0
11632;201888;90;0;0;0;0;.00nan;0;0
11632;-1;90;61;39;4;35;.897;3600000;0
11632;-1;88;34;27;5;22;.815;3576000;0
11633;209784;91;0;0;0;0;.00nan;0;0
11633;205429;91;72;46;4;42;.913;3600000;0
11633;200572;95;0;0;0;0;.00nan;0;0
11633;212487;95;53;16;2;14;.875;3600000;0
11634;199768;105;0;0;0;0;.00nan;0;0
11634;205112;105;62;20;2;18;.900;3600000;0
11634;215785;94;0;0;0;0;.00nan;0;0
11634;-1;94;58;37;4;33;.892;3600000;0
11635;210368;106;53;22;3;19;.864;3600000;0
11635;207118;98;45;17;3;14;.824;1457000;0
11635;-1;106;0;0;0;0;.00nan;0;0
11635;-1;98;36;28;5;23;.821;2143000;0
11636;199784;87;0;0;0;0;.00nan;0;0
11636;205076;87;63;32;3;29;.906;3600000;0
11636;212343;96;0;0;0;0;.00nan;0;0
11636;-1;96;56;31;4;27;.871;3548000;0
11637;194502;86;33;30;6;24;.800;3111000;0
11637;205124;89;0;0;0;0;.00nan;0;0
11637;201792;89;81;31;2;29;.935;3600000;0
11637;201876;86;40;2;1;1;.500;489000;0
11638;210480;88;25;22;5;17;.773;1859000;0
11638;200572;95;73;21;2;19;.905;3600000;0
11638;212487;95;0;0;0;0;.00nan;0;0
11638;-1;88;55;19;2;17;.895;1741000;0
11639;205318;97;76;37;3;34;.919;3600000;0
11639;205824;97;0;0;0;0;.00nan;0;0
11639;201888;90;0;0;0;0;.00nan;0;0
11639;-1;90;46;30;5;25;.833;3545000;0
11640;192739;92;61;34;4;30;.882;3900000;0
11640;200065;93;76;38;4;34;.895;3858000;0
11640;212301;92;0;0;0;0;.00nan;0;0
11640;-1;93;0;0;0;0;.00nan;0;0
11641;197962;99;0;0;0;0;.00nan;0;0
11641;205276;103;0;0;0;0;.00nan;0;0
11641;210428;103;100;26;0;26;1.000;3600000;0
11641;202788;99;59;22;2;20;.909;3584000;0
11642;210368;106;60;22;2;20;.909;3600000;0
11642;207118;98;43;36;5;31;.861;3600000;0
11642;-1;106;0;0;0;0;.00nan;0;0
11642;-1;98;0;0;0;0;.00nan;0;0
11643;208417;101;0;0;0;0;.00nan;0;0
11643;200549;102;60;29;3;26;.897;3900000;0
11643;210923;102;0;0;0;0;.00nan;0;0
11643;201739;101;72;38;3;35;.921;3900000;0
11644;210603;104;46;30;4;26;.867;3900000;0
11644;215785;94;41;26;4;22;.846;3900000;0
11644;-1;94;0;0;0;0;.00nan;0;0
11644;208300;104;0;0;0;0;.00nan;0;0
11645;197940;100;42;23;4;19;.826;3600000;0
11645;209796;107;55;42;5;37;.881;3600000;0
11645;201817;107;0;0;0;0;.00nan;0;0
11645;212368;100;0;0;0;0;.00nan;0;0
11646;209784;91;100;38;1;37;.974;3600000;0
11646;200065;93;0;0;0;0;.00nan;0;0
11646;205429;91;0;0;0;0;.00nan;0;0
11646;-1;93;59;26;3;23;.885;3561000;0
11647;194502;86;0;0;0;0;.00nan;0;0
11647;201876;86;100;29;0;29;1.000;3600000;0
11647;212343;96;77;41;3;38;.927;3600000;0
11647;-1;96;0;0;0;0;.00nan;0;0
11648;205124;89;84;43;4;39;.907;3674000;0
11648;205318;97;0;0;0;0;.00nan;0;0
11648;205824;97;57;30;3;27;.900;3674000;0
11648;201792;89;0;0;0;0;.00nan;0;0
11649;199784;87;31;28;6;22;.786;2318000;0
11649;205076;87;61;15;1;14;.933;1282000;0
11649;200572;95;0;0;0;0;.00nan;0;0
11649;212487;95;69;17;1;16;.941;3600000;0
11650;209796;107;0;0;0;0;.00nan;0;0
11650;210368;106;0;0;0;0;.00nan;0;0
11650;201817;107;70;32;3;29;.906;3600000;0
11650;-1;106;61;37;4;33;.892;3541000;0
11651;199768;105;0;0;0;0;.00nan;0;0
11651;205112;105;80;45;4;41;.911;3600000;0
11651;210603;104;0;0;0;0;.00nan;0;0
11651;208300;104;51;37;5;32;.865;3555000;0
11652;208417;101;56;30;4;26;.867;3542000;0
11652;215785;94;0;0;0;0;.00nan;0;0
11652;201739;101;0;0;0;0;.00nan;0;0
11652;-1;94;57;26;3;23;.885;3600000;0
11653;197962;99;0;0;0;0;.00nan;0;0
11653;200549;102;0;0;0;0;.00nan;0;0
11653;210923;102;59;28;3;25;.893;3563000;0
11653;202788;99;99;41;2;39;.951;3600000;0
11654;210480;88;0;0;0;0;.00nan;0;0
11654;212343;96;0;0;0;0;.00nan;0;0
11654;-1;88;94;21;0;21;1.000;3600000;0
11654;-1;96;67;44;4;40;.909;3600000;0
11655;199784;87;81;34;2;32;.941;3900000;0
11655;205076;87;0;0;0;0;.00nan;0;0
11655;201888;90;0;0;0;0;.00nan;0;0
11655;-1;90;62;19;2;17;.895;3900000;0
11656;192739;92;61;28;3;25;.893;3600000;0
11656;200065;93;62;35;4;31;.886;3592000;0
11656;212301;92;0;0;0;0;.00nan;0;0
11656;-1;93;0;0;0;0;.00nan;0;0
11657;205276;103;0;0;0;0;.00nan;0;0
11657;210428;103;50;25;4;21;.840;3569000;0
11657;215785;94;65;25;3;22;.880;3600000;0
11657;-1;94;0;0;0;0;.00nan;0;0
11658;199768;105;49;36;4;32;.889;3576000;0
11658;205112;105;0;0;0;0;.00nan;0;0
11658;210368;106;39;14;3;11;.786;3600000;0
11658;-1;106;0;0;0;0;.00nan;0;0
11659;197940;100;76;25;1;24;.960;3600000;0
11659;209796;107;51;39;5;34;.872;3600000;0
11659;201817;107;0;0;0;0;.00nan;0;0
11659;212368;100;0;0;0;0;.00nan;0;0
11660;210603;104;71;21;1;20;.952;3600000;0
11660;207118;98;0;0;0;0;.00nan;0;0
11660;-1;98;88;33;2;31;.939;3578000;0
11660;208300;104;0;0;0;0;.00nan;0;0
11661;192739;92;64;18;2;16;.889;3900000;0
11661;194502;86;0;0;0;0;.00nan;0;0
11661;212301;92;0;0;0;0;.00nan;0;0
11661;201876;86;82;30;2;28;.933;3900000;0
11662;209784;91;0;0;0;0;.00nan;0;0
11662;205429;91;100;37;1;36;.973;3600000;0
11662;201888;90;0;0;0;0;.00nan;0;0
11662;-1;90;53;35;5;30;.857;3600000;0
11663;200572;95;56;11;1;10;.909;3600000;0
11663;212343;96;60;45;6;39;.867;3600000;0
11663;212487;95;0;0;0;0;.00nan;0;0
11663;-1;96;0;0;0;0;.00nan;0;0
11664;205318;97;77;29;2;27;.931;3600000;0
11664;210480;88;67;30;3;27;.900;3600000;0
11664;205824;97;0;0;0;0;.00nan;0;0
11664;-1;88;0;0;0;0;.00nan;0;0
11665;192739;92;0;0;0;0;.00nan;0;0
11665;199784;87;0;0;0;0;.00nan;0;0
11665;205076;87;73;27;2;25;.926;3870000;0
11665;212301;92;84;42;3;39;.929;3870000;0
11666;200065;93;74;26;2;24;.923;3600000;0
11666;210480;88;0;0;0;0;.00nan;0;0
11666;-1;88;48;27;5;22;.815;3600000;0
11666;-1;93;0;0;0;0;.00nan;0;0
11667;199768;105;0;0;0;0;.00nan;0;0
11667;205112;105;63;30;3;27;.900;3569000;0
11667;205276;103;0;0;0;0;.00nan;0;0
11667;210428;103;77;28;2;26;.929;3600000;0
11668;197962;99;0;0;0;0;.00nan;0;0
11668;209796;107;48;20;3;17;.850;3600000;0
11668;201817;107;0;0;0;0;.00nan;0;0
11668;202788;99;37;23;4;19;.826;3588000;0
11669;209784;91;76;23;1;22;.957;3600000;0
11669;205124;89;0;0;0;0;.00nan;0;0
11669;205429;91;0;0;0;0;.00nan;0;0
11669;201792;89;71;28;2;26;.929;3600000;0
11670;197940;100;79;26;1;25;.962;3600000;0
11670;212368;100;0;0;0;0;.00nan;0;0
11670;207118;98;73;30;2;28;.933;3552000;0
11670;-1;98;0;0;0;0;.00nan;0;0
11671;199784;87;69;32;3;29;.906;3900000;0
11671;209784;91;0;0;0;0;.00nan;0;0
11671;205076;87;0;0;0;0;.00nan;0;0
11671;205429;91;68;30;3;27;.900;3900000;0
11672;205124;89;0;0;0;0;.00nan;0;0
11672;201792;89;68;32;3;29;.906;3584000;0
11672;201888;90;0;0;0;0;.00nan;0;0
11672;-1;90;68;27;2;25;.926;3600000;0
11673;192739;92;64;42;5;37;.881;3600000;0
11673;200572;95;72;22;1;21;.955;3600000;0
11673;212301;92;0;0;0;0;.00nan;0;0
11673;212487;95;0;0;0;0;.00nan;0;0
11674;200065;93;67;35;4;31;.886;3600000;0
11674;205318;97;0;0;0;0;.00nan;0;0
11674;205824;97;44;30;5;25;.833;3575000;0
11674;-1;93;0;0;0;0;.00nan;0;0
11675;194502;86;78;24;2;22;.917;3600000;0
11675;201876;86;0;0;0;0;.00nan;0;0
11675;212343;96;0;0;0;0;.00nan;0;0
11675;-1;96;65;31;4;27;.871;3539000;0
11676;197962;99;66;23;2;21;.913;3600000;0
11676;207118;98;0;0;0;0;.00nan;0;0
11676;202788;99;0;0;0;0;.00nan;0;0
11676;-1;98;72;50;6;44;.880;3600000;0
11677;197940;100;90;28;1;27;.964;3600000;0
11677;200549;102;62;33;4;29;.879;3600000;0
11677;210923;102;0;0;0;0;.00nan;0;0
11677;212368;100;0;0;0;0;.00nan;0;0
11678;205276;103;0;0;0;0;.00nan;0;0
11678;210428;103;82;44;4;40;.909;3600000;0
11678;215785;94;84;28;1;27;.964;3600000;0
11678;-1;94;0;0;0;0;.00nan;0;0
11679;208417;101;0;0;0;0;.00nan;0;0
11679;209796;107;71;40;3;37;.925;3572000;0
11679;201739;101;95;38;2;36;.947;3600000;0
11679;201817;107;0;0;0;0;.00nan;0;0
11680;199768;105;0;0;0;0;.00nan;0;0
11680;205112;105;62;38;4;34;.895;3600000;0
11680;210603;104;69;20;1;19;.950;3600000;0
11680;208300;104;0;0;0;0;.00nan;0;0
11681;200065;93;0;0;0;0;.00nan;0;0
11681;194502;86;0;0;0;0;.00nan;0;0
11681;201876;86;93;45;2;43;.956;3600000;0
11681;-1;93;52;26;4;22;.846;3550000;0
11682;199784;87;0;0;0;0;.00nan;0;0
11682;205076;87;100;27;0;27;1.000;3600000;0
11682;205124;89;63;36;3;33;.917;3600000;0
11682;201792;89;0;0;0;0;.00nan;0;0
11683;192739;92;85;35;3;32;.914;3600000;0
11683;210480;88;47;31;4;27;.871;3562000;0
11683;212301;92;0;0;0;0;.00nan;0;0
11683;-1;88;0;0;0;0;.00nan;0;0
11684;200572;95;0;0;0;0;.00nan;0;0
11684;201888;90;49;6;1;5;.833;838000;0
11684;212487;95;78;35;2;33;.943;3600000;0
11684;-1;90;23;26;6;20;.769;2762000;0
11685;205318;97;71;22;1;21;.955;3600000;0
11685;205824;97;0;0;0;0;.00nan;0;0
11685;212343;96;35;31;6;25;.806;3600000;0
11685;-1;96;0;0;0;0;.00nan;0;0
11686;209796;107;33;7;2;5;.714;643000;0
11686;210368;106;63;35;4;31;.886;3600000;0
11686;201817;107;32;32;6;26;.813;2957000;0
11686;-1;106;0;0;0;0;.00nan;0;0
11687;197940;100;0;0;0;0;.00nan;0;0
11687;200549;102;0;0;0;0;.00nan;0;0
11687;210923;102;80;41;4;37;.902;3600000;0
11687;212368;100;23;23;6;17;.739;3555000;0
11688;210603;104;0;0;0;0;.00nan;0;0
11688;215785;94;0;0;0;0;.00nan;0;0
11688;-1;94;56;30;4;26;.867;3600000;0
11688;208300;104;52;35;5;30;.857;3600000;0
11689;208417;101;90;43;1;42;.977;3600000;0
11689;205276;103;0;0;0;0;.00nan;0;0
11689;210428;103;72;34;3;31;.912;3600000;0
11689;201739;101;0;0;0;0;.00nan;0;0
11690;197962;99;0;0;0;0;.00nan;0;0
11690;207118;98;43;18;3;15;.833;3575000;0
11690;202788;99;84;27;1;26;.963;3600000;0
11690;-1;98;0;0;0;0;.00nan;0;0
11691;205318;97;62;25;3;22;.880;3900000;0
11691;210480;88;0;0;0;0;.00nan;0;0
11691;205824;97;0;0;0;0;.00nan;0;0
11691;-1;88;73;31;3;28;.903;3900000;0
11692;200065;93;63;24;2;22;.917;3600000;0
11692;212343;96;0;0;0;0;.00nan;0;0
11692;-1;96;80;37;3;34;.919;3568000;0
11692;-1;93;0;0;0;0;.00nan;0;0
11693;210368;106;82;29;2;27;.931;3600000;0
11693;215785;94;40;34;6;28;.824;2860000;0
11693;-1;106;0;0;0;0;.00nan;0;0
11693;-1;94;55;12;1;11;.917;740000;0
11694;210603;104;50;14;2;12;.857;3600000;0
11694;207118;98;0;0;0;0;.00nan;0;0
11694;-1;98;71;45;4;41;.911;3576000;0
11694;208300;104;0;0;0;0;.00nan;0;0
11695;199768;105;0;0;0;0;.00nan;0;0
11695;209796;107;31;32;6;26;.813;3600000;0
11695;205112;105;50;19;3;16;.842;3600000;0
11695;201817;107;0;0;0;0;.00nan;0;0
11696;209784;91;0;0;0;0;.00nan;0;0
11696;205429;91;86;38;2;36;.947;3578000;0
11696;200572;95;83;28;1;27;.964;3600000;0
11696;212487;95;0;0;0;0;.00nan;0;0
11697;209796;107;0;0;0;0;.00nan;0;0
11697;205276;103;0;0;0;0;.00nan;0;0
11697;210428;103;76;30;3;27;.900;3900000;0
11697;201817;107;67;31;3;28;.903;3900000;0
11698;197940;100;59;25;3;22;.880;3600000;0
11698;208417;101;0;0;0;0;.00nan;0;0
11698;201739;101;31;28;6;22;.786;3600000;0
11698;212368;100;0;0;0;0;.00nan;0;0
11699;199784;87;0;0;0;0;.00nan;0;0
11699;194502;86;51;29;4;25;.862;3576000;0
11699;205076;87;90;37;2;35;.946;3600000;0
11699;201876;86;0;0;0;0;.00nan;0;0
11700;199784;87;73;51;5;46;.902;3600000;0
11700;200065;93;51;29;4;25;.862;3600000;0
11700;205076;87;0;0;0;0;.00nan;0;0
11700;-1;93;0;0;0;0;.00nan;0;0
11701;210480;88;18;31;7;24;.774;3600000;0
11701;200572;95;50;25;4;21;.840;3600000;0
11701;212487;95;0;0;0;0;.00nan;0;0
11701;-1;88;0;0;0;0;.00nan;0;0
11702;209784;91;0;0;0;0;.00nan;0;0
11702;205429;91;74;34;3;31;.912;3600000;0
11702;201888;90;0;0;0;0;.00nan;0;0
11702;-1;90;52;34;4;30;.882;3548000;0
11703;205124;89;0;0;0;0;.00nan;0;0
11703;205318;97;0;0;0;0;.00nan;0;0
11703;205824;97;63;23;2;21;.913;3600000;0
11703;201792;89;57;36;5;31;.861;3600000;0
11704;192739;92;79;46;4;42;.913;3900000;0
11704;212301;92;0;0;0;0;.00nan;0;0
11704;212343;96;0;0;0;0;.00nan;0;0
11704;-1;96;84;53;4;49;.925;3900000;0
11705;197962;99;0;0;0;0;.00nan;0;0
11705;200549;102;43;22;4;18;.818;3557000;0
11705;210923;102;0;0;0;0;.00nan;0;0
11705;202788;99;89;46;3;43;.935;3600000;0
11706;205276;103;0;0;0;0;.00nan;0;0
11706;210428;103;49;35;5;30;.857;3600000;0
11706;215785;94;60;24;3;21;.875;3600000;0
11706;-1;94;0;0;0;0;.00nan;0;0
11707;208417;101;63;31;4;27;.871;3685000;0
11707;210368;106;56;23;3;20;.870;3685000;0
11707;201739;101;0;0;0;0;.00nan;0;0
11707;-1;106;0;0;0;0;.00nan;0;0
11708;199768;105;0;0;0;0;.00nan;0;0
11708;205112;105;73;28;2;26;.929;3546000;0
11708;210603;104;89;27;1;26;.963;3600000;0
11708;208300;104;0;0;0;0;.00nan;0;0
11709;197940;100;72;26;2;24;.923;3600000;0
11709;212368;100;0;0;0;0;.00nan;0;0
11709;207118;98;88;39;3;36;.923;3600000;0
11709;-1;98;0;0;0;0;.00nan;0;0
11710;209784;91;82;24;1;23;.958;3600000;0
11710;205124;89;61;29;2;27;.931;3557000;0
11710;205429;91;0;0;0;0;.00nan;0;0
11710;201792;89;0;0;0;0;.00nan;0;0
11711;200065;93;0;0;0;0;.00nan;0;0
11711;194502;86;53;23;3;20;.870;3514000;0
11711;201876;86;0;0;0;0;.00nan;0;0
11711;-1;93;82;24;1;23;.958;3600000;0
11712;210480;88;0;0;0;0;.00nan;0;0
11712;200572;95;0;0;0;0;.00nan;0;0
11712;212487;95;53;18;3;15;.833;3600000;0
11712;-1;88;58;35;4;31;.886;3522000;0
11713;197962;99;69;24;2;22;.917;3600000;0
11713;200549;102;0;0;0;0;.00nan;0;0
11713;210923;102;27;28;6;22;.786;3600000;0
11713;202788;99;0;0;0;0;.00nan;0;0
11714;205318;97;55;27;4;23;.852;3600000;0
11714;205824;97;0;0;0;0;.00nan;0;0
11714;201888;90;48;39;6;33;.846;3563000;0
11714;-1;90;0;0;0;0;.00nan;0;0
11715;208417;101;0;0;0;0;.00nan;0;0
11715;210368;106;0;0;0;0;.00nan;0;0
11715;201739;101;82;44;3;41;.932;3600000;0
11715;-1;106;66;22;2;20;.909;3600000;0
11716;192739;92;0;0;0;0;.00nan;0;0
11716;212301;92;95;22;0;22;1.000;3600000;0
11716;212343;96;72;41;4;37;.902;3600000;0
11716;-1;96;0;0;0;0;.00nan;0;0
11717;199768;105;0;0;0;0;.00nan;0;0
11717;205112;105;75;40;3;37;.925;3582000;0
11717;210603;104;0;0;0;0;.00nan;0;0
11717;208300;104;96;39;1;38;.974;3600000;0
11718;209796;107;51;24;3;21;.875;3600000;0
11718;215785;94;0;0;0;0;.00nan;0;0
11718;201817;107;0;0;0;0;.00nan;0;0
11718;-1;94;66;21;2;19;.905;3600000;0
11719;197940;100;0;0;0;0;.00nan;0;0
11719;212368;100;71;21;1;20;.952;3600000;0
11719;207118;98;51;2;0;2;1.000;486000;0
11719;-1;98;20;28;7;21;.750;3114000;0
11720;210368;106;81;26;1;25;.962;3900000;0
11720;215785;94;96;30;1;29;.967;3900000;0
11720;-1;106;0;0;0;0;.00nan;0;0
11720;-1;94;0;0;0;0;.00nan;0;0
11721;199784;87;0;0;0;0;.00nan;0;0
11721;205076;87;74;37;3;34;.919;3583000;0
11721;201888;90;0;0;0;0;.00nan;0;0
11721;-1;90;99;37;1;36;.973;3600000;0
11722;200065;93;62;40;4;36;.900;3553000;0
11722;210480;88;48;11;2;9;.818;3600000;0
11722;-1;88;0;0;0;0;.00nan;0;0
11722;-1;93;0;0;0;0;.00nan;0;0
11723;209784;91;0;0;0;0;.00nan;0;0
11723;205429;91;61;25;3;22;.880;3600000;0
11723;212343;96;73;14;0;14;1.000;2603000;0
11723;-1;96;39;23;4;19;.826;997000;0
11724;192739;92;0;0;0;0;.00nan;0;0
11724;205318;97;0;0;0;0;.00nan;0;0
11724;205824;97;62;19;2;17;.895;3600000;0
11724;212301;92;87;28;1;27;.964;3600000;0
11725;197940;100;62;29;3;26;.897;3600000;0
11725;197962;99;0;0;0;0;.00nan;0;0
11725;212368;100;0;0;0;0;.00nan;0;0
11725;202788;99;46;30;5;25;.833;3600000;0
11726;208417;101;0;0;0;0;.00nan;0;0
11726;210603;104;75;42;3;39;.929;3600000;0
11726;201739;101;79;34;2;32;.941;3600000;0
11726;208300;104;0;0;0;0;.00nan;0;0
11727;199768;105;0;0;0;0;.00nan;0;0
11727;205112;105;46;25;4;21;.840;3528000;0
11727;207118;98;81;33;2;31;.939;3600000;0
11727;-1;98;0;0;0;0;.00nan;0;0
11728;209796;107;71;21;2;19;.905;3600000;0
11728;200549;102;0;0;0;0;.00nan;0;0
11728;210923;102;48;29;4;25;.862;3557000;0
11728;201817;107;0;0;0;0;.00nan;0;0
11729;194502;86;0;0;0;0;.00nan;0;0
11729;200572;95;88;15;0;15;1.000;3600000;0
11729;201876;86;53;40;6;34;.850;3600000;0
11729;212487;95;0;0;0;0;.00nan;0;0
11730;205276;103;0;0;0;0;.00nan;0;0
11730;210428;103;57;37;5;32;.865;3513000;0
11730;210603;104;0;0;0;0;.00nan;0;0
11730;208300;104;44;18;3;15;.833;3600000;0
11731;209796;107;1;19;7;12;.632;1762000;0
11731;200549;102;80;32;2;30;.938;3600000;0
11731;210923;102;0;0;0;0;.00nan;0;0
11731;201817;107;33;19;4;15;.789;1838000;0
11732;192739;92;79;45;5;40;.889;3732000;0
11732;200065;93;41;29;6;23;.793;3732000;0
11732;212301;92;0;0;0;0;.00nan;0;0
11732;-1;93;0;0;0;0;.00nan;0;0
11733;209784;91;90;33;1;32;.970;3600000;0
11733;194502;86;55;31;4;27;.871;3600000;0
11733;205429;91;0;0;0;0;.00nan;0;0
11733;201876;86;0;0;0;0;.00nan;0;0
11734;199784;87;0;0;0;0;.00nan;0;0
11734;205076;87;73;27;1;26;.963;3600000;0
11734;205124;89;0;0;0;0;.00nan;0;0
11734;201792;89;70;42;3;39;.929;3553000;0
11735;199784;87;58;28;3;25;.893;3586000;0
11735;205076;87;0;0;0;0;.00nan;0;0
11735;201888;90;0;0;0;0;.00nan;0;0
11735;-1;90;76;32;2;30;.938;3600000;0
11736;205318;97;65;42;5;37;.881;2295000;0
11736;200572;95;77;18;1;17;.944;3600000;0
11736;205824;97;70;21;2;19;.905;1305000;0
11736;212487;95;0;0;0;0;.00nan;0;0
11737;200065;93;90;17;0;17;1.000;3600000;0
11737;205276;103;0;0;0;0;.00nan;0;0
11737;210428;103;89;34;1;33;.971;3543000;0
11737;-1;93;0;0;0;0;.00nan;0;0
11738;192739;92;71;42;4;38;.905;3561000;0
11738;209784;91;0;0;0;0;.00nan;0;0
11738;205429;91;62;28;3;25;.893;3600000;0
11738;212301;92;0;0;0;0;.00nan;0;0
11739;197962;99;0;0;0;0;.00nan;0;0
11739;200549;102;0;0;0;0;.00nan;0;0
11739;210923;102;55;25;3;22;.880;3900000;0
11739;202788;99;81;40;3;37;.925;3900000;0
11740;208417;101;0;0;0;0;.00nan;0;0
11740;201739;101;45;14;2;12;.857;3600000;0
11740;207118;98;0;0;0;0;.00nan;0;0
11740;-1;98;87;31;1;30;.968;3600000;0
11741;210480;88;0;0;0;0;.00nan;0;0
11741;210603;104;75;47;4;43;.915;3900000;0
11741;-1;88;52;26;4;22;.846;3900000;0
11741;208300;104;0;0;0;0;.00nan;0;0
11742;199768;105;0;0;0;0;.00nan;0;0
11742;194502;86;67;30;3;27;.900;3900000;0
11742;205112;105;69;32;3;29;.906;3900000;0
11742;201876;86;0;0;0;0;.00nan;0;0
11743;197940;100;71;40;3;37;.925;3600000;0
11743;210368;106;62;40;4;36;.900;3543000;0
11743;212368;100;0;0;0;0;.00nan;0;0
11743;-1;106;0;0;0;0;.00nan;0;0
11744;199784;87;0;0;0;0;.00nan;0;0
11744;205076;87;44;25;4;21;.840;3800000;0
11744;205124;89;44;29;5;24;.828;3800000;0
11744;201792;89;0;0;0;0;.00nan;0;0
11745;205318;97;70;49;5;44;.898;3591000;0
11745;200572;95;0;0;0;0;.00nan;0;0
11745;205824;97;0;0;0;0;.00nan;0;0
11745;212487;95;55;20;3;17;.850;3600000;0
11746;205276;103;0;0;0;0;.00nan;0;0
11746;210428;103;41;29;5;24;.828;3600000;0
11746;212343;96;0;0;0;0;.00nan;0;0
11746;-1;96;81;29;1;28;.966;3600000;0
11747;209796;107;0;0;0;0;.00nan;0;0
11747;215785;94;81;28;1;27;.964;3600000;0
11747;201817;107;34;31;6;25;.806;3600000;0
11747;-1;94;0;0;0;0;.00nan;0;0
11748;194502;86;55;6;0;6;1.000;814000;0
11748;210603;104;0;0;0;0;.00nan;0;0
11748;201876;86;15;18;6;12;.667;2765000;0
11748;208300;104;68;41;4;37;.902;3600000;0
11749;199768;105;57;35;4;31;.886;3518000;0
11749;205112;105;0;0;0;0;.00nan;0;0
11749;210480;88;75;28;2;26;.929;3600000;0
11749;-1;88;0;0;0;0;.00nan;0;0
11750;197940;100;0;0;0;0;.00nan;0;0
11750;210368;106;0;0;0;0;.00nan;0;0
11750;212368;100;68;43;5;38;.884;3596000;0
11750;-1;106;70;33;3;30;.909;3600000;0
11751;208417;101;57;30;3;27;.900;3600000;0
11751;197962;99;87;37;2;35;.946;3600000;0
11751;201739;101;0;0;0;0;.00nan;0;0
11751;202788;99;0;0;0;0;.00nan;0;0
11752;200549;102;99;27;0;27;1.000;3600000;0
11752;210923;102;0;0;0;0;.00nan;0;0
11752;207118;98;31;29;6;23;.793;3600000;0
11752;-1;98;0;0;0;0;.00nan;0;0
11753;209784;91;21;19;5;14;.737;2120000;0
11753;200065;93;52;21;3;18;.857;3600000;0
11753;205429;91;68;13;0;13;1.000;1432000;0
11753;-1;93;0;0;0;0;.00nan;0;0
11754;192739;92;89;27;1;26;.963;3600000;0
11754;205276;103;63;31;3;28;.903;3600000;0
11754;210428;103;0;0;0;0;.00nan;0;0
11754;212301;92;0;0;0;0;.00nan;0;0
11755;197962;99;0;0;0;0;.00nan;0;0
11755;209796;107;81;33;2;31;.939;3561000;0
11755;201817;107;0;0;0;0;.00nan;0;0
11755;202788;99;72;23;1;22;.957;3600000;0
11756;212343;96;0;0;0;0;.00nan;0;0
11756;201888;90;0;0;0;0;.00nan;0;0
11756;-1;90;81;35;3;32;.914;3521000;0
11756;-1;96;94;31;1;30;.968;3600000;0
11757;209796;107;0;0;0;0;.00nan;0;0
11757;210480;88;39;25;5;20;.800;3570000;0
11757;201817;107;40;24;4;20;.833;3600000;0
11757;-1;88;0;0;0;0;.00nan;0;0
11758;192739;92;100;21;0;21;1.000;3600000;0
11758;200065;93;0;0;0;0;.00nan;0;0
11758;212301;92;0;0;0;0;.00nan;0;0
11758;-1;93;50;29;4;25;.862;3600000;0
11759;205124;89;0;0;0;0;.00nan;0;0
11759;201792;89;71;26;2;24;.923;3600000;0
11759;212343;96;65;29;3;26;.897;3562000;0
11759;-1;96;0;0;0;0;.00nan;0;0
11760;205276;103;0;0;0;0;.00nan;0;0
11760;210428;103;82;30;1;29;.967;3900000;0
11760;210480;88;0;0;0;0;.00nan;0;0
11760;-1;88;67;20;1;19;.950;3900000;0
11761;197962;99;0;0;0;0;.00nan;0;0
11761;210603;104;83;34;2;32;.941;3600000;0
11761;202788;99;50;34;5;29;.853;3600000;0
11761;208300;104;0;0;0;0;.00nan;0;0
11762;194502;86;51;29;4;25;.862;3575000;0
11762;210368;106;65;29;3;26;.897;3600000;0
11762;201876;86;0;0;0;0;.00nan;0;0
11762;-1;106;0;0;0;0;.00nan;0;0
11763;199784;87;0;0;0;0;.00nan;0;0
11763;205076;87;62;24;3;21;.875;3600000;0
11763;205124;89;0;0;0;0;.00nan;0;0
11763;201792;89;56;44;6;38;.864;3600000;0
11764;209784;91;0;0;0;0;.00nan;0;0
11764;205429;91;83;45;4;41;.911;3600000;0
11764;201888;90;0;0;0;0;.00nan;0;0
11764;-1;90;100;36;0;36;1.000;3600000;0
11765;192739;92;52;37;6;31;.838;3600000;0
11765;205318;97;0;0;0;0;.00nan;0;0
11765;205824;97;79;27;1;26;.963;3600000;0
11765;212301;92;0;0;0;0;.00nan;0;0
11766;200572;95;73;17;1;16;.941;3600000;0
11766;212343;96;0;0;0;0;.00nan;0;0
11766;212487;95;0;0;0;0;.00nan;0;0
11766;-1;96;93;50;3;47;.940;3553000;0
11767;197962;99;92;22;0;22;1.000;3600000;0
11767;209796;107;14;16;6;10;.625;2477000;0
11767;201817;107;50;9;1;8;.889;1123000;0
11767;202788;99;0;0;0;0;.00nan;0;0
11768;210368;106;0;0;0;0;.00nan;0;0
11768;210480;88;24;30;6;24;.800;2758000;0
11768;-1;106;71;35;3;32;.914;3600000;0
11768;-1;88;49;8;1;7;.875;842000;0
11769;200549;102;79;33;3;30;.909;3680000;0
11769;210603;104;52;24;4;20;.833;3680000;0
11769;210923;102;0;0;0;0;.00nan;0;0
11769;208300;104;0;0;0;0;.00nan;0;0
11770;208417;101;0;0;0;0;.00nan;0;0
11770;201739;101;60;27;2;25;.926;3900000;0
11770;207118;98;75;27;2;25;.926;3863000;0
11770;-1;98;0;0;0;0;.00nan;0;0
11771;197940;100;74;34;2;32;.941;3600000;0
11771;199768;105;0;0;0;0;.00nan;0;0
11771;205112;105;52;26;4;22;.846;3586000;0
11771;212368;100;0;0;0;0;.00nan;0;0
11772;194502;86;43;32;5;27;.844;3600000;0
11772;215785;94;76;28;2;26;.929;3600000;0
11772;201876;86;0;0;0;0;.00nan;0;0
11772;-1;94;0;0;0;0;.00nan;0;0
11773;199784;87;82;29;1;28;.966;3600000;0
11773;205076;87;0;0;0;0;.00nan;0;0
11773;201888;90;0;0;0;0;.00nan;0;0
11773;-1;90;54;26;3;23;.885;3548000;0
11774;209784;91;47;20;3;17;.850;3567000;0
11774;205124;89;91;33;1;32;.970;3600000;0
11774;205429;91;0;0;0;0;.00nan;0;0
11774;201792;89;0;0;0;0;.00nan;0;0
11775;208417;101;57;24;3;21;.875;3542000;0
11775;197962;99;72;27;2;25;.926;3600000;0
11775;201739;101;0;0;0;0;.00nan;0;0
11775;202788;99;0;0;0;0;.00nan;0;0
11776;197940;100;0;0;0;0;.00nan;0;0
11776;210368;106;72;26;2;24;.923;3600000;0
11776;212368;100;65;41;5;36;.878;3600000;0
11776;-1;106;0;0;0;0;.00nan;0;0
11777;200549;102;0;0;0;0;.00nan;0;0
11777;210603;104;0;0;0;0;.00nan;0;0
11777;210923;102;72;28;2;26;.929;3600000;0
11777;208300;104;64;30;3;27;.900;3600000;0
11778;200065;93;100;40;0;40;1.000;3600000;0
11778;212343;96;98;40;1;39;.975;3552000;0
11778;-1;96;0;0;0;0;.00nan;0;0
11778;-1;93;0;0;0;0;.00nan;0;0
11779;192739;92;91;45;3;42;.933;3587000;0
11779;200572;95;0;0;0;0;.00nan;0;0
11779;212301;92;0;0;0;0;.00nan;0;0
11779;212487;95;80;20;1;19;.950;3600000;0
11780;209796;107;0;0;0;0;.00nan;0;0
11780;194502;86;73;26;1;25;.962;3104000;0
11780;201817;107;91;40;2;38;.950;3600000;0
11780;201876;86;26;7;3;4;.571;496000;0
11781;199768;105;66;26;2;24;.923;3600000;0
11781;205112;105;0;0;0;0;.00nan;0;0
11781;207118;98;0;0;0;0;.00nan;0;0
11781;-1;98;51;28;4;24;.857;3516000;0
11782;210480;88;0;0;0;0;.00nan;0;0
11782;215785;94;0;0;0;0;.00nan;0;0
11782;-1;94;100;20;0;20;1.000;3600000;0
11782;-1;88;55;28;3;25;.893;3600000;0
11783;200065;93;79;29;1;28;.966;3600000;0
11783;205318;97;26;23;5;18;.783;3600000;0
11783;205824;97;0;0;0;0;.00nan;0;0
11783;-1;93;0;0;0;0;.00nan;0;0
11784;194502;86;0;0;0;0;.00nan;0;0
11784;205276;103;0;0;0;0;.00nan;0;0
11784;210428;103;100;36;0;36;1.000;3600000;0
11784;201876;86;38;21;4;17;.810;3600000;0
11785;208417;101;0;0;0;0;.00nan;0;0
11785;209796;107;41;28;4;24;.857;3581000;0
11785;201739;101;70;24;2;22;.917;3600000;0
11785;201817;107;0;0;0;0;.00nan;0;0
11874;210368;106;66;33;4;29;.879;3555000;0
11874;200572;95;65;20;2;18;.900;3600000;0
11874;212487;95;0;0;0;0;.00nan;0;0
11874;-1;106;0;0;0;0;.00nan;0;0
11876;197962;99;0;0;0;0;.00nan;0;0
11876;210480;88;60;19;2;17;.895;3596000;0
11876;202788;99;96;32;1;31;.969;3600000;0
11876;-1;88;0;0;0;0;.00nan;0;0
11878;209796;107;0;0;0;0;.00nan;0;0
11878;201817;107;15;28;7;21;.750;3600000;0
11878;201888;90;100;33;0;33;1.000;3600000;0
11878;-1;90;0;0;0;0;.00nan;0;0
11880;205124;89;67;12;0;12;1.000;801000;0
11880;205318;97;55;17;2;15;.882;3600000;0
11880;205824;97;0;0;0;0;.00nan;0;0
11880;201792;89;27;31;7;24;.774;2799000;0
11882;200549;102;0;0;0;0;.00nan;0;0
11882;210923;102;53;18;2;16;.889;3600000;0
11882;212343;96;0;0;0;0;.00nan;0;0
11882;-1;96;75;48;4;44;.917;3598000;0
11884;208417;101;0;0;0;0;.00nan;0;0
11884;209784;91;0;0;0;0;.00nan;0;0
11884;205429;91;65;20;2;18;.900;3589000;0
11884;201739;101;93;40;1;39;.975;3600000;0
11886;197940;100;58;28;4;24;.857;3599000;0
11886;210603;104;44;18;3;15;.833;3600000;0
11886;212368;100;0;0;0;0;.00nan;0;0
11886;208300;104;0;0;0;0;.00nan;0;0
11888;199768;105;57;39;4;35;.897;3900000;0
11888;205112;105;0;0;0;0;.00nan;0;0
11888;215785;94;50;23;4;19;.826;3900000;0
11888;-1;94;0;0;0;0;.00nan;0;0
11890;199784;87;0;0;0;0;.00nan;0;0
11890;205076;87;56;12;1;11;.917;3600000;0
11890;205276;103;0;0;0;0;.00nan;0;0
11890;210428;103;75;44;4;40;.909;3600000;0
11892;200065;93;70;18;1;17;.944;3600000;0
11892;207118;98;61;40;4;36;.900;3600000;0
11892;-1;98;0;0;0;0;.00nan;0;0
11892;-1;93;0;0;0;0;.00nan;0;0
11894;192739;92;77;23;1;22;.957;3600000;0
11894;194502;86;22;25;6;19;.760;2254000;0
11894;212301;92;0;0;0;0;.00nan;0;0
11894;201876;86;57;11;1;10;.909;1346000;0
11896;210368;106;0;0;0;0;.00nan;0;0
11896;205318;97;0;0;0;0;.00nan;0;0
11896;205824;97;67;41;4;37;.902;3756000;0
11896;-1;106;62;23;3;20;.870;3756000;0
11898;209796;107;35;24;4;20;.833;3900000;0
11898;215785;94;74;43;4;39;.907;3900000;0
11898;201817;107;0;0;0;0;.00nan;0;0
11898;-1;94;0;0;0;0;.00nan;0;0
11900;199768;105;0;0;0;0;.00nan;0;0
11900;205112;105;91;32;1;31;.969;3600000;0
11900;205124;89;69;36;3;33;.917;3585000;0
11900;201792;89;0;0;0;0;.00nan;0;0
11902;197962;99;0;0;0;0;.00nan;0;0
11902;210480;88;0;0;0;0;.00nan;0;0
11902;202788;99;26;27;6;21;.778;3558000;0
11902;-1;88;64;36;4;32;.889;3600000;0
11904;192739;92;57;42;5;37;.881;3600000;0
11904;209784;91;53;42;6;36;.857;3576000;0
11904;205429;91;0;0;0;0;.00nan;0;0
11904;212301;92;0;0;0;0;.00nan;0;0
11906;208417;101;0;0;0;0;.00nan;0;0
11906;200572;95;58;20;2;18;.900;3600000;0
11906;201739;101;56;38;5;33;.868;3600000;0
11906;212487;95;0;0;0;0;.00nan;0;0
11908;199784;87;36;25;5;20;.800;2300000;0
11908;205076;87;62;9;0;9;1.000;1264000;0
11908;205276;103;0;0;0;0;.00nan;0;0
11908;210428;103;39;22;4;18;.818;3600000;0
11910;200549;102;30;8;3;5;.625;405000;0
11910;210603;104;0;0;0;0;.00nan;0;0
11910;210923;102;75;31;2;29;.935;3195000;0
11910;208300;104;91;22;0;22;1.000;3600000;0
11912;194502;86;69;34;3;31;.912;3588000;0
11912;201876;86;0;0;0;0;.00nan;0;0
11912;201888;90;65;23;2;21;.913;3600000;0
11912;-1;90;0;0;0;0;.00nan;0;0
11914;197940;100;54;22;3;19;.864;3900000;0
11914;212368;100;0;0;0;0;.00nan;0;0
11914;207118;98;0;0;0;0;.00nan;0;0
11914;-1;98;74;36;3;33;.917;3900000;0
11916;200065;93;56;22;4;18;.818;3663000;0
11916;212343;96;0;0;0;0;.00nan;0;0
11916;-1;96;72;36;3;33;.917;3663000;0
11916;-1;93;0;0;0;0;.00nan;0;0
11918;199768;105;69;36;3;33;.917;3900000;0
11918;199784;87;59;30;3;27;.900;3900000;0
11918;205076;87;0;0;0;0;.00nan;0;0
11918;205112;105;0;0;0;0;.00nan;0;0
11920;200572;95;0;0;0;0;.00nan;0;0
11920;201888;90;0;0;0;0;.00nan;0;0
11920;212487;95;87;19;0;19;1.000;3600000;0
11920;-1;90;63;40;4;36;.900;3600000;0
11922;197940;100;0;0;0;0;.00nan;0;0
11922;200549;102;80;28;1;27;.964;3900000;0
11922;210923;102;0;0;0;0;.00nan;0;0
11922;212368;100;98;29;1;28;.966;3900000;0
11924;209796;107;0;0;0;0;.00nan;0;0
11924;210480;88;54;21;3;18;.857;3542000;0
11924;201817;107;68;25;1;24;.960;3600000;0
11924;-1;88;0;0;0;0;.00nan;0;0
11926;200065;93;0;0;0;0;.00nan;0;0
11926;212343;96;54;40;4;36;.900;3900000;0
11926;-1;96;0;0;0;0;.00nan;0;0
11926;-1;93;51;29;4;25;.862;3900000;0
11928;197962;99;68;45;5;40;.889;3900000;0
11928;192739;92;0;0;0;0;.00nan;0;0
11928;212301;92;50;34;5;29;.853;3900000;0
11928;202788;99;0;0;0;0;.00nan;0;0
11930;205276;103;72;24;1;23;.958;3600000;0
11930;210428;103;0;0;0;0;.00nan;0;0
11930;207118;98;37;30;5;25;.833;3600000;0
11930;-1;98;0;0;0;0;.00nan;0;0
11932;205318;97;72;23;1;22;.957;3600000;0
11932;215785;94;0;0;0;0;.00nan;0;0
11932;205824;97;0;0;0;0;.00nan;0;0
11932;-1;94;59;29;4;25;.862;3600000;0
11934;209784;91;0;0;0;0;.00nan;0;0
11934;205429;91;62;38;4;34;.895;3560000;0
11934;210603;104;0;0;0;0;.00nan;0;0
11934;208300;104;74;24;2;22;.917;3600000;0
11936;208417;101;60;16;1;15;.938;3617000;0
11936;194502;86;0;0;0;0;.00nan;0;0
11936;201739;101;0;0;0;0;.00nan;0;0
11936;201876;86;82;34;2;32;.941;3617000;0
11938;205124;89;0;0;0;0;.00nan;0;0
11938;210368;106;62;22;2;20;.909;3600000;0
11938;201792;89;62;41;4;37;.902;3547000;0
11938;-1;106;0;0;0;0;.00nan;0;0
11940;205124;89;15;36;8;28;.778;2859000;0
11940;210368;106;0;0;0;0;.00nan;0;0
11940;201792;89;48;10;2;8;.800;741000;0
11940;-1;106;73;23;2;21;.913;3600000;0
11942;199784;87;0;0;0;0;.00nan;0;0
11942;200065;93;89;18;0;18;1.000;3600000;0
11942;205076;87;47;45;7;38;.844;3600000;0
11942;-1;93;0;0;0;0;.00nan;0;0
11944;197940;100;74;37;3;34;.919;3600000;0
11944;210480;88;53;18;2;16;.889;3600000;0
11944;212368;100;0;0;0;0;.00nan;0;0
11944;-1;88;0;0;0;0;.00nan;0;0
11946;205276;103;0;0;0;0;.00nan;0;0
11946;210428;103;60;34;3;31;.912;3595000;0
11946;207118;98;0;0;0;0;.00nan;0;0
11946;-1;98;73;29;2;27;.931;3600000;0
11948;200572;95;0;0;0;0;.00nan;0;0
11948;201888;90;0;0;0;0;.00nan;0;0
11948;212487;95;56;25;3;22;.880;3561000;0
11948;-1;90;71;25;2;23;.920;3600000;0
11950;197962;99;0;0;0;0;.00nan;0;0
11950;200549;102;54;27;4;23;.852;3569000;0
11950;210923;102;0;0;0;0;.00nan;0;0
11950;202788;99;60;22;3;19;.864;3600000;0
11952;208417;101;0;0;0;0;.00nan;0;0
11952;209796;107;87;31;1;30;.968;3600000;0
11952;201739;101;62;24;2;22;.917;3543000;0
11952;201817;107;0;0;0;0;.00nan;0;0
11954;192739;92;50;33;4;29;.879;3517000;0
11954;199768;105;0;0;0;0;.00nan;0;0
11954;205112;105;97;40;2;38;.950;3600000;0
11954;212301;92;0;0;0;0;.00nan;0;0
11956;205318;97;0;0;0;0;.00nan;0;0
11956;210603;104;62;28;4;24;.857;3900000;0
11956;205824;97;58;35;4;31;.886;3900000;0
11956;208300;104;0;0;0;0;.00nan;0;0
11958;209784;91;0;0;0;0;.00nan;0;0
11958;194502;86;71;26;2;24;.923;3600000;0
11958;205429;91;56;28;3;25;.893;3542000;0
11958;201876;86;0;0;0;0;.00nan;0;0
11960;215785;94;50;27;4;23;.852;1870000;0
11960;212343;96;0;0;0;0;.00nan;0;0
11960;-1;94;77;18;1;17;.944;1704000;0
11960;-1;96;52;23;3;20;.870;3600000;0
11962;194502;86;0;0;0;0;.00nan;0;0
11962;215785;94;38;21;4;17;.810;1036000;0
11962;201876;86;41;29;5;24;.828;3600000;0
11962;-1;94;45;26;5;21;.808;2564000;0
11964;210480;88;0;0;0;0;.00nan;0;0
11964;207118;98;100;28;0;28;1.000;3600000;0
11964;-1;98;0;0;0;0;.00nan;0;0
11964;-1;88;58;15;1;14;.933;3553000;0
11966;205276;103;0;0;0;0;.00nan;0;0
11966;210428;103;48;24;3;21;.875;3547000;0
11966;210603;104;0;0;0;0;.00nan;0;0
11966;208300;104;86;32;1;31;.969;3600000;0
11968;197962;99;58;19;2;17;.895;3610000;0
11968;199768;105;53;26;3;23;.885;3610000;0
11968;205112;105;0;0;0;0;.00nan;0;0
11968;202788;99;0;0;0;0;.00nan;0;0
11970;209784;91;67;32;3;29;.906;3600000;0
11970;210368;106;22;29;7;22;.759;3058000;0
11970;205429;91;0;0;0;0;.00nan;0;0
11970;-1;106;46;4;1;3;.750;542000;0
11972;209796;107;0;0;0;0;.00nan;0;0
11972;200549;102;0;0;0;0;.00nan;0;0
11972;210923;102;76;39;3;36;.923;3600000;0
11972;201817;107;100;29;0;29;1.000;3600000;0
11974;205124;89;0;0;0;0;.00nan;0;0
11974;200572;95;76;13;0;13;1.000;3600000;0
11974;201792;89;64;41;5;36;.878;3600000;0
11974;212487;95;0;0;0;0;.00nan;0;0
11976;197940;100;0;0;0;0;.00nan;0;0
11976;212343;96;93;28;1;27;.964;3600000;0
11976;212368;100;91;40;2;38;.950;3561000;0
11976;-1;96;0;0;0;0;.00nan;0;0
11978;208417;101;69;26;2;24;.923;3600000;0
11978;201739;101;0;0;0;0;.00nan;0;0
11978;201888;90;71;34;4;30;.882;3548000;0
11978;-1;90;0;0;0;0;.00nan;0;0
11980;200065;93;53;24;3;21;.875;3900000;0
11980;205318;97;53;18;3;15;.833;3900000;0
11980;205824;97;0;0;0;0;.00nan;0;0
11980;-1;93;0;0;0;0;.00nan;0;0
11982;192739;92;62;31;3;28;.903;3600000;0
11982;199784;87;40;30;5;25;.833;3597000;0
11982;205076;87;0;0;0;0;.00nan;0;0
11982;212301;92;0;0;0;0;.00nan;0;0
11984;208417;101;0;0;0;0;.00nan;0;0
11984;200572;95;85;18;0;18;1.000;3600000;0
11984;201739;101;76;46;4;42;.913;3600000;0
11984;212487;95;0;0;0;0;.00nan;0;0
11986;209796;107;0;0;0;0;.00nan;0;0
11986;194502;86;47;27;5;22;.815;3600000;0
11986;201817;107;67;24;2;22;.917;3600000;0
11986;201876;86;0;0;0;0;.00nan;0;0
11988;200549;102;0;0;0;0;.00nan;0;0
11988;210603;104;68;34;4;30;.882;3548000;0
11988;210923;102;62;30;3;27;.900;3600000;0
11988;208300;104;0;0;0;0;.00nan;0;0
11990;210368;106;0;0;0;0;.00nan;0;0
11990;207118;98;58;52;7;45;.865;3600000;0
11990;-1;106;100;26;0;26;1.000;3600000;0
11990;-1;98;0;0;0;0;.00nan;0;0
11992;192739;92;82;31;3;28;.903;3600000;0
11992;205318;97;0;0;0;0;.00nan;0;0
11992;205824;97;37;18;4;14;.778;3543000;0
11992;212301;92;0;0;0;0;.00nan;0;0
11994;199768;105;0;0;0;0;.00nan;0;0
11994;200065;93;98;13;0;13;1.000;3600000;0
11994;205112;105;94;42;1;41;.976;3586000;0
11994;-1;93;0;0;0;0;.00nan;0;0
11996;197962;99;0;0;0;0;.00nan;0;0
11996;209784;91;71;25;2;23;.920;3600000;0
11996;205429;91;0;0;0;0;.00nan;0;0
11996;202788;99;65;34;3;31;.912;3600000;0
11998;205124;89;0;0;0;0;.00nan;0;0
11998;205276;103;0;0;0;0;.00nan;0;0
11998;210428;103;79;15;0;15;1.000;3600000;0
11998;201792;89;73;31;3;28;.903;3600000;0
12000;199784;87;75;23;1;22;.957;3600000;0
12000;205076;87;0;0;0;0;.00nan;0;0
12000;215785;94;62;29;3;26;.897;3575000;0
12000;-1;94;0;0;0;0;.00nan;0;0
12002;212343;96;0;0;0;0;.00nan;0;0
12002;201888;90;0;0;0;0;.00nan;0;0
12002;-1;90;69;24;2;22;.917;3600000;0
12002;-1;96;56;42;6;36;.857;3600000;0
12004;197940;100;0;0;0;0;.00nan;0;0
12004;210480;88;0;0;0;0;.00nan;0;0
12004;212368;100;32;24;5;19;.792;3600000;0
12004;-1;88;78;26;2;24;.923;3600000;0
12006;210368;106;0;0;0;0;.00nan;0;0
12006;205276;103;0;0;0;0;.00nan;0;0
12006;210428;103;90;47;2;45;.957;3600000;0
12006;-1;106;84;17;0;17;1.000;3600000;0
12008;194502;86;0;0;0;0;.00nan;0;0
12008;201876;86;83;24;1;23;.958;3600000;0
12008;201888;90;20;27;6;21;.778;3264000;0
12008;-1;90;53;2;0;2;1.000;336000;0
12010;197962;99;72;34;2;32;.941;3573000;0
12010;210480;88;72;19;1;18;.947;3600000;0
12010;202788;99;0;0;0;0;.00nan;0;0
12010;-1;88;0;0;0;0;.00nan;0;0
12012;205318;97;38;22;4;18;.818;3554000;0
12012;210603;104;0;0;0;0;.00nan;0;0
12012;205824;97;0;0;0;0;.00nan;0;0
12012;208300;104;60;28;3;25;.893;3600000;0
12014;199768;105;90;21;0;21;1.000;3600000;0
12014;205112;105;0;0;0;0;.00nan;0;0
12014;205124;89;62;35;3;32;.914;3600000;0
12014;201792;89;0;0;0;0;.00nan;0;0
12016;192739;92;0;0;0;0;.00nan;0;0
12016;215785;94;80;17;0;17;1.000;2445000;0
12016;212301;92;73;18;1;17;.944;3600000;0
12016;-1;94;30;14;4;10;.714;1155000;0
12018;200572;95;72;9;0;9;1.000;3600000;0
12018;207118;98;0;0;0;0;.00nan;0;0
12018;212487;95;0;0;0;0;.00nan;0;0
12018;-1;98;84;36;2;34;.944;3517000;0
12020;208417;101;50;25;4;21;.840;3900000;0
12020;201739;101;0;0;0;0;.00nan;0;0
12020;212343;96;75;35;4;31;.886;3900000;0
12020;-1;96;0;0;0;0;.00nan;0;0
12022;197940;100;42;30;5;25;.833;3608000;0
12022;199784;87;0;0;0;0;.00nan;0;0
12022;205076;87;55;31;4;27;.871;3608000;0
12022;212368;100;0;0;0;0;.00nan;0;0
12024;209784;91;0;0;0;0;.00nan;0;0
12024;209796;107;72;28;2;26;.929;3600000;0
12024;205429;91;71;39;3;36;.923;3583000;0
12024;201817;107;0;0;0;0;.00nan;0;0
12026;200065;93;77;23;1;22;.957;3600000;0
12026;200549;102;76;34;2;32;.941;3544000;0
12026;210923;102;0;0;0;0;.00nan;0;0
12026;-1;93;0;0;0;0;.00nan;0;0
12027;203276;139;40;38;6;32;.842;2727000;0
12027;204938;139;52;6;1;5;.833;873000;0
12027;-1;144;92;24;0;24;1.000;3600000;0
12027;-1;144;0;0;0;0;.00nan;0;0
12028;210004;141;0;0;0;0;.00nan;0;0
12028;201673;141;84;30;1;29;.967;3600000;0
12028;208201;143;74;35;2;33;.943;3584000;0
12028;-1;143;0;0;0;0;.00nan;0;0
12029;208575;142;0;0;0;0;.00nan;0;0
12029;199587;140;0;0;0;0;.00nan;0;0
12029;204668;140;54;33;5;28;.848;3545000;0
12029;196456;142;55;34;4;30;.882;3600000;0
12030;203288;135;68;22;2;20;.909;3564000;0
12030;208556;135;0;0;0;0;.00nan;0;0
12030;199430;136;0;0;0;0;.00nan;0;0
12030;201530;136;97;26;0;26;1.000;3600000;0
12031;204873;129;0;0;0;0;.00nan;0;0
12031;200436;130;33;37;7;30;.811;3015000;0
12031;-1;129;35;25;5;20;.800;3600000;0
12031;-1;130;50;15;2;13;.867;585000;0
12032;208609;131;0;0;0;0;.00nan;0;0
12032;-1;131;76;33;2;31;.939;3739000;0
12032;-1;128;65;30;3;27;.900;3739000;0
12032;-1;128;0;0;0;0;.00nan;0;0
12033;198081;133;0;0;0;0;.00nan;0;0
12033;199701;138;0;0;0;0;.00nan;0;0
12033;202059;133;58;27;3;24;.889;3600000;0
12033;-1;138;61;41;5;36;.878;3600000;0
12034;198081;133;0;0;0;0;.00nan;0;0
12034;199437;134;36;25;5;20;.800;3600000;0
12034;202059;133;25;28;6;22;.786;3555000;0
12034;-1;134;0;0;0;0;.00nan;0;0
12035;198091;132;33;18;4;14;.778;1581000;0
12035;201666;1340;54;28;4;24;.857;3600000;0
12035;202045;1340;0;0;0;0;.00nan;0;0
12035;207313;132;66;21;2;19;.905;2019000;0
12036;208609;131;29;28;6;22;.786;3022000;0
12036;210060;137;0;0;0;0;.00nan;0;0
12036;-1;137;63;44;5;39;.886;3600000;0
12036;-1;131;33;4;2;2;.500;557000;0
12037;210004;141;0;0;0;0;.00nan;0;0
12037;201673;141;85;29;1;28;.966;3900000;0
12037;208201;143;97;41;1;40;.976;3900000;0
12037;-1;143;0;0;0;0;.00nan;0;0
12038;208575;142;0;0;0;0;.00nan;0;0
12038;199587;140;0;0;0;0;.00nan;0;0
12038;204668;140;52;28;4;24;.857;3600000;0
12038;196456;142;81;27;1;26;.963;3600000;0
12039;203276;139;51;42;5;37;.881;3600000;0
12039;204938;139;0;0;0;0;.00nan;0;0
12039;-1;144;36;18;4;14;.778;3600000;0
12039;-1;144;0;0;0;0;.00nan;0;0
12040;199430;136;62;11;0;11;1.000;1362000;0
12040;199437;134;63;28;3;25;.893;3600000;0
12040;201530;136;4;25;7;18;.720;2238000;0
12040;-1;134;0;0;0;0;.00nan;0;0
12041;210060;137;0;0;0;0;.00nan;0;0
12041;-1;137;75;35;2;33;.943;3600000;0
12041;-1;128;29;20;5;15;.750;3600000;0
12041;-1;128;0;0;0;0;.00nan;0;0
12042;198091;132;29;26;6;20;.769;2259000;0
12042;201666;1340;74;35;3;32;.914;3600000;0
12042;202045;1340;0;0;0;0;.00nan;0;0
12042;207313;132;52;8;1;7;.875;1341000;0
12043;199701;138;0;0;0;0;.00nan;0;0
12043;200436;130;56;23;3;20;.870;3900000;0
12043;-1;130;0;0;0;0;.00nan;0;0
12043;-1;138;65;36;3;33;.917;3900000;0
12044;203288;135;66;42;6;36;.857;3623000;0
12044;208556;135;0;0;0;0;.00nan;0;0
12044;204873;129;39;28;5;23;.821;3623000;0
12044;-1;129;0;0;0;0;.00nan;0;0
12045;203276;139;0;0;0;0;.00nan;0;0
12045;204938;139;90;46;3;43;.935;3900000;0
12045;208201;143;54;24;3;21;.875;3900000;0
12045;-1;143;0;0;0;0;.00nan;0;0
12046;199587;140;0;0;0;0;.00nan;0;0
12046;204668;140;83;43;2;41;.953;3900000;0
12046;210004;141;0;0;0;0;.00nan;0;0
12046;201673;141;88;33;2;31;.939;3900000;0
12047;198081;133;81;27;1;26;.963;3600000;0
12047;199430;136;0;0;0;0;.00nan;0;0
12047;201530;136;74;30;2;28;.933;3546000;0
12047;202059;133;0;0;0;0;.00nan;0;0
12048;198091;132;0;0;0;0;.00nan;0;0
12048;200436;130;66;33;3;30;.909;3523000;0
12048;207313;132;97;30;1;29;.967;3600000;0
12048;-1;130;0;0;0;0;.00nan;0;0
12049;210060;137;0;0;0;0;.00nan;0;0
12049;201666;1340;61;11;1;10;.909;3600000;0
12049;202045;1340;0;0;0;0;.00nan;0;0
12049;-1;137;96;47;2;45;.957;3600000;0
12050;203288;135;76;30;2;28;.933;3600000;0
12050;208556;135;0;0;0;0;.00nan;0;0
12050;199701;138;0;0;0;0;.00nan;0;0
12050;-1;138;58;33;4;29;.879;3561000;0
12051;208609;131;0;0;0;0;.00nan;0;0
12051;204873;129;73;36;3;33;.917;3600000;0
12051;-1;129;0;0;0;0;.00nan;0;0
12051;-1;131;74;31;2;29;.935;3600000;0
12052;199437;134;71;21;2;19;.905;3900000;0
12052;-1;134;0;0;0;0;.00nan;0;0
12052;-1;128;0;0;0;0;.00nan;0;0
12052;-1;128;84;36;2;34;.944;3900000;0
12053;198081;133;0;0;0;0;.00nan;0;0
12053;199430;136;92;39;2;37;.949;3553000;0
12053;201530;136;0;0;0;0;.00nan;0;0
12053;202059;133;83;17;0;17;1.000;3600000;0
12054;200436;130;0;0;0;0;.00nan;0;0
12054;201666;1340;0;0;0;0;.00nan;0;0
12054;202045;1340;55;28;3;25;.893;3600000;0
12054;-1;130;38;39;6;33;.846;3600000;0
12055;208575;142;0;0;0;0;.00nan;0;0
12055;210004;141;83;39;3;36;.923;3600000;0
12055;201673;141;0;0;0;0;.00nan;0;0
12055;196456;142;45;28;4;24;.857;3572000;0
12056;199587;140;0;0;0;0;.00nan;0;0
12056;204668;140;55;34;5;29;.853;3585000;0
12056;-1;144;60;26;3;23;.885;3600000;0
12056;-1;144;0;0;0;0;.00nan;0;0
12057;203276;139;40;28;5;23;.821;3600000;0
12057;204938;139;0;0;0;0;.00nan;0;0
12057;208201;143;0;0;0;0;.00nan;0;0
12057;-1;143;32;29;6;23;.793;3600000;0
12058;198091;132;67;19;2;17;.895;3600000;0
12058;210060;137;23;4;3;1;.250;138000;0
12058;207313;132;0;0;0;0;.00nan;0;0
12058;-1;137;60;36;4;32;.889;3462000;0
12059;208575;142;41;30;5;25;.833;3600000;0
12059;196456;142;0;0;0;0;.00nan;0;0
12059;-1;144;0;0;0;0;.00nan;0;0
12059;-1;144;53;24;3;21;.875;3600000;0
12060;208609;131;0;0;0;0;.00nan;0;0
12060;204873;129;46;32;5;27;.844;3600000;0
12060;-1;129;0;0;0;0;.00nan;0;0
12060;-1;131;78;24;1;23;.958;3600000;0
12061;199437;134;51;24;3;21;.875;3622000;0
12061;199701;138;0;0;0;0;.00nan;0;0
12061;-1;134;0;0;0;0;.00nan;0;0
12061;-1;138;69;36;4;32;.889;3622000;0
12062;203288;135;0;0;0;0;.00nan;0;0
12062;208556;135;55;17;2;15;.882;3600000;0
12062;-1;128;49;29;4;25;.862;3517000;0
12062;-1;128;0;0;0;0;.00nan;0;0
12063;199587;140;0;0;0;0;.00nan;0;0
12063;204668;140;52;28;4;24;.857;3600000;0
12063;-1;144;35;25;5;20;.800;3596000;0
12063;-1;144;0;0;0;0;.00nan;0;0
12064;208575;142;0;0;0;0;.00nan;0;0
12064;196456;142;37;28;5;23;.821;3551000;0
12064;208201;143;75;38;4;34;.895;3600000;0
12064;-1;143;0;0;0;0;.00nan;0;0
12065;199430;136;0;0;0;0;.00nan;0;0
12065;201530;136;68;29;3;26;.897;3600000;0
12065;-1;128;0;0;0;0;.00nan;0;0
12065;-1;128;57;29;4;25;.862;3573000;0
12066;198091;132;68;36;3;33;.917;3600000;0
12066;204873;129;0;0;0;0;.00nan;0;0
12066;207313;132;0;0;0;0;.00nan;0;0
12066;-1;129;72;31;2;29;.935;3600000;0
12067;198081;133;0;0;0;0;.00nan;0;0
12067;199701;138;0;0;0;0;.00nan;0;0
12067;202059;133;88;18;0;18;1.000;3600000;0
12067;-1;138;63;28;3;25;.893;3600000;0
12068;203288;135;36;25;5;20;.800;2338000;0
12068;208556;135;71;12;0;12;1.000;1262000;0
12068;210004;141;0;0;0;0;.00nan;0;0
12068;201673;141;33;29;6;23;.793;3548000;0
12069;198091;132;0;0;0;0;.00nan;0;0
12069;200436;130;37;20;4;16;.800;1167000;0
12069;207313;132;64;33;5;28;.848;3900000;0
12069;-1;130;75;21;1;20;.952;2733000;0
12070;203276;139;65;53;7;46;.868;3329000;0
12070;204938;139;48;0;0;0;.00nan;271000;0
12070;-1;144;47;22;3;19;.864;3600000;0
12070;-1;144;0;0;0;0;.00nan;0;0
12071;208201;143;0;0;0;0;.00nan;0;0
12071;-1;143;34;28;6;22;.786;3600000;0
12071;-1;128;39;30;5;25;.833;3600000;0
12071;-1;128;0;0;0;0;.00nan;0;0
12072;203288;135;53;50;7;43;.860;3600000;0
12072;208556;135;0;0;0;0;.00nan;0;0
12072;208575;142;0;0;0;0;.00nan;0;0
12072;196456;142;82;20;1;19;.950;3600000;0
12073;199437;134;0;0;0;0;.00nan;0;0
12073;201666;1340;83;27;1;26;.963;3600000;0
12073;202045;1340;0;0;0;0;.00nan;0;0
12073;-1;134;84;39;2;37;.949;3555000;0
12074;198081;133;0;0;0;0;.00nan;0;0
12074;199587;140;43;4;1;3;.750;837000;0
12074;204668;140;47;35;6;29;.829;2763000;0
12074;202059;133;67;27;2;25;.926;3600000;0
12075;208609;131;42;20;3;17;.850;3580000;0
12075;199430;136;75;33;2;31;.939;3600000;0
12075;201530;136;0;0;0;0;.00nan;0;0
12075;-1;131;0;0;0;0;.00nan;0;0
12076;199701;138;0;0;0;0;.00nan;0;0
12076;210060;137;0;0;0;0;.00nan;0;0
12076;-1;137;81;34;3;31;.912;3563000;0
12076;-1;138;83;34;2;32;.941;3600000;0
12077;204873;129;69;21;2;19;.905;3600000;0
12077;200436;130;72;41;4;37;.902;3586000;0
12077;-1;129;0;0;0;0;.00nan;0;0
12077;-1;130;0;0;0;0;.00nan;0;0
12078;199437;134;90;37;2;35;.946;3588000;0
12078;201666;1340;0;0;0;0;.00nan;0;0
12078;202045;1340;81;28;1;27;.964;3600000;0
12078;-1;134;0;0;0;0;.00nan;0;0
12079;199587;140;44;3;1;2;.667;324000;0
12079;199701;138;30;31;6;25;.806;3600000;0
12079;204668;140;32;32;6;26;.813;3216000;0
12079;-1;138;0;0;0;0;.00nan;0;0
12080;198091;132;82;15;0;15;1.000;3600000;0
12080;210060;137;47;38;6;32;.842;3600000;0
12080;207313;132;0;0;0;0;.00nan;0;0
12080;-1;137;0;0;0;0;.00nan;0;0
12081;208575;142;77;27;2;25;.926;3600000;0
12081;196456;142;0;0;0;0;.00nan;0;0
12081;-1;128;0;0;0;0;.00nan;0;0
12081;-1;128;71;45;4;41;.911;3566000;0
12082;203276;139;53;21;2;19;.905;2540000;0
12082;210004;141;0;0;0;0;.00nan;0;0
12082;204938;139;28;13;4;9;.692;1060000;0
12082;201673;141;86;16;0;16;1.000;3600000;0
12083;199430;136;0;0;0;0;.00nan;0;0
12083;201530;136;69;54;6;48;.889;3600000;0
12083;-1;144;0;0;0;0;.00nan;0;0
12083;-1;144;76;21;1;20;.952;3600000;0
12084;203288;135;76;43;4;39;.907;3761000;0
12084;208556;135;0;0;0;0;.00nan;0;0
12084;208201;143;80;38;3;35;.921;3761000;0
12084;-1;143;0;0;0;0;.00nan;0;0
12085;198081;133;37;25;5;20;.800;3600000;0
12085;204873;129;0;0;0;0;.00nan;0;0
12085;202059;133;0;0;0;0;.00nan;0;0
12085;-1;129;31;33;6;27;.818;3600000;0
12086;208609;131;0;0;0;0;.00nan;0;0
12086;200436;130;46;33;5;28;.848;3600000;0
12086;-1;131;69;22;1;21;.955;3600000;0
12086;-1;130;0;0;0;0;.00nan;0;0
12087;210004;141;0;0;0;0;.00nan;0;0
12087;201673;141;84;30;1;29;.967;3600000;0
12087;-1;128;67;34;4;30;.882;3600000;0
12087;-1;128;0;0;0;0;.00nan;0;0
12088;199430;136;84;44;3;41;.932;3600000;0
12088;199587;140;0;0;0;0;.00nan;0;0
12088;204668;140;49;24;4;20;.833;3600000;0
12088;201530;136;0;0;0;0;.00nan;0;0
12089;198081;133;0;0;0;0;.00nan;0;0
12089;204873;129;58;29;3;26;.897;3569000;0
12089;202059;133;82;30;2;28;.933;3600000;0
12089;-1;129;0;0;0;0;.00nan;0;0
12090;198091;132;72;26;2;24;.923;3600000;0
12090;201666;1340;73;42;5;37;.881;3600000;0
12090;202045;1340;0;0;0;0;.00nan;0;0
12090;207313;132;0;0;0;0;.00nan;0;0
12091;208609;131;56;26;4;22;.846;3600000;0
12091;210060;137;0;0;0;0;.00nan;0;0
12091;-1;137;87;30;1;29;.967;3600000;0
12091;-1;131;0;0;0;0;.00nan;0;0
12092;210004;141;82;19;1;18;.947;3600000;0
12092;200436;130;28;15;4;11;.733;1169000;0
12092;201673;141;0;0;0;0;.00nan;0;0
12092;-1;130;67;34;3;31;.912;2431000;0
12093;198081;133;4;32;9;23;.719;3289000;0
12093;208575;142;0;0;0;0;.00nan;0;0
12093;196456;142;65;20;2;18;.900;3600000;0
12093;202059;133;53;3;0;3;1.000;311000;0
12094;204873;129;71;33;4;29;.879;3600000;0
12094;208201;143;96;35;1;34;.971;3600000;0
12094;-1;129;0;0;0;0;.00nan;0;0
12094;-1;143;0;0;0;0;.00nan;0;0
12095;203276;139;28;30;6;24;.800;2408000;0
12095;204938;139;44;4;1;3;.750;1192000;0
12095;-1;128;0;0;0;0;.00nan;0;0
12095;-1;128;78;27;2;25;.926;3600000;0
12096;208609;131;0;0;0;0;.00nan;0;0
12096;199437;134;49;25;3;22;.880;3582000;0
12096;-1;131;71;24;2;22;.917;3600000;0
12096;-1;134;0;0;0;0;.00nan;0;0
12097;199587;140;65;25;2;23;.920;3600000;0
12097;204668;140;0;0;0;0;.00nan;0;0
12097;200436;130;59;42;6;36;.857;3600000;0
12097;-1;130;0;0;0;0;.00nan;0;0
12098;199430;136;0;0;0;0;.00nan;0;0
12098;201530;136;92;40;2;38;.950;3600000;0
12098;-1;144;49;25;3;22;.880;3554000;0
12098;-1;144;0;0;0;0;.00nan;0;0
12099;199437;134;0;0;0;0;.00nan;0;0
12099;210060;137;0;0;0;0;.00nan;0;0
12099;-1;137;39;29;5;24;.828;3574000;0
12099;-1;134;45;18;3;15;.833;3600000;0
12100;203288;135;0;0;0;0;.00nan;0;0
12100;208556;135;73;30;2;28;.933;3600000;0
12100;204873;129;0;0;0;0;.00nan;0;0
12100;-1;129;81;38;3;35;.921;3580000;0
12101;208575;142;58;20;2;18;.900;3561000;0
12101;199701;138;0;0;0;0;.00nan;0;0
12101;196456;142;0;0;0;0;.00nan;0;0
12101;-1;138;80;27;1;26;.963;3600000;0
12102;200436;130;49;7;1;6;.857;684000;0
12102;-1;144;0;0;0;0;.00nan;0;0
12102;-1;130;19;31;7;24;.774;2916000;0
12102;-1;144;79;11;0;11;1.000;3600000;0
12103;203276;139;74;51;5;46;.902;3600000;0
12103;204938;139;0;0;0;0;.00nan;0;0
12103;201666;1340;0;0;0;0;.00nan;0;0
12103;202045;1340;47;13;2;11;.846;3600000;0
12104;198081;133;100;44;2;42;.955;3900000;0
12104;208609;131;84;35;2;33;.943;3900000;0
12104;202059;133;0;0;0;0;.00nan;0;0
12104;-1;131;0;0;0;0;.00nan;0;0
12105;199587;140;0;0;0;0;.00nan;0;0
12105;204668;140;72;34;3;31;.912;3600000;0
12105;210004;141;0;0;0;0;.00nan;0;0
12105;201673;141;36;25;4;21;.840;3600000;0
12106;198091;132;0;0;0;0;.00nan;0;0
12106;207313;132;80;25;1;24;.960;3600000;0
12106;208201;143;0;0;0;0;.00nan;0;0
12106;-1;143;74;31;2;29;.935;3600000;0
12107;199437;134;83;33;2;31;.939;3600000;0
12107;199701;138;0;0;0;0;.00nan;0;0
12107;-1;134;0;0;0;0;.00nan;0;0
12107;-1;138;66;46;5;41;.891;3600000;0
12108;208575;142;0;0;0;0;.00nan;0;0
12108;199430;136;85;48;4;44;.917;3600000;0
12108;201530;136;0;0;0;0;.00nan;0;0
12108;196456;142;69;26;2;24;.923;3600000;0
12109;201666;1340;78;9;0;9;1.000;3600000;0
12109;202045;1340;0;0;0;0;.00nan;0;0
12109;208201;143;22;38;8;30;.789;3600000;0
12109;-1;143;0;0;0;0;.00nan;0;0
12110;204873;129;0;0;0;0;.00nan;0;0
12110;-1;129;72;32;3;29;.906;3518000;0
12110;-1;128;93;37;1;36;.973;3600000;0
12110;-1;128;0;0;0;0;.00nan;0;0
12111;208609;131;0;0;0;0;.00nan;0;0
12111;210060;137;0;0;0;0;.00nan;0;0
12111;-1;137;79;43;4;39;.907;3576000;0
12111;-1;131;73;32;3;29;.906;3600000;0
12112;210004;141;63;23;2;21;.913;3565000;0
12112;201673;141;0;0;0;0;.00nan;0;0
12112;-1;144;0;0;0;0;.00nan;0;0
12112;-1;144;92;35;1;34;.971;3600000;0
12113;203276;139;0;0;0;0;.00nan;0;0
12113;198091;132;70;15;1;14;.933;3600000;0
12113;204938;139;39;35;6;29;.829;3600000;0
12113;207313;132;0;0;0;0;.00nan;0;0
12114;203288;135;100;25;0;25;1.000;3600000;0
12114;198081;133;0;0;0;0;.00nan;0;0
12114;208556;135;0;0;0;0;.00nan;0;0
12114;202059;133;67;31;3;28;.903;3600000;0
12115;199437;134;28;19;5;14;.737;3717000;0
12115;-1;134;0;0;0;0;.00nan;0;0
12115;-1;128;71;49;6;43;.878;3717000;0
12115;-1;128;0;0;0;0;.00nan;0;0
12116;204873;129;32;24;5;19;.792;3600000;0
12116;210060;137;66;30;2;28;.933;3600000;0
12116;-1;137;0;0;0;0;.00nan;0;0
12116;-1;129;0;0;0;0;.00nan;0;0
12117;208201;143;0;0;0;0;.00nan;0;0
12117;-1;144;0;0;0;0;.00nan;0;0
12117;-1;143;75;33;3;30;.909;3600000;0
12117;-1;144;42;37;6;31;.838;3600000;0
12118;198091;132;18;30;7;23;.767;3098000;0
12118;199587;140;0;0;0;0;.00nan;0;0
12118;204668;140;61;22;2;20;.909;3600000;0
12118;207313;132;49;6;1;5;.833;502000;0
12119;203288;135;69;20;1;19;.950;3600000;0
12119;208556;135;0;0;0;0;.00nan;0;0
12119;200436;130;28;30;6;24;.800;3338000;0
12119;-1;130;49;2;0;2;1.000;262000;0
12120;199430;136;0;0;0;0;.00nan;0;0
12120;199701;138;36;36;6;30;.833;3600000;0
12120;201530;136;52;22;3;19;.864;3600000;0
12120;-1;138;0;0;0;0;.00nan;0;0
12121;201666;1340;64;28;3;25;.893;3750000;0
12121;202045;1340;0;0;0;0;.00nan;0;0
12121;208201;143;82;42;2;40;.952;3750000;0
12121;-1;143;0;0;0;0;.00nan;0;0
12122;198091;132;0;0;0;0;.00nan;0;0
12122;208575;142;0;0;0;0;.00nan;0;0
12122;196456;142;97;22;0;22;1.000;3600000;0
12122;207313;132;76;44;5;39;.886;3600000;0
12123;199430;136;36;31;7;24;.774;3600000;0
12123;199437;134;78;36;4;32;.889;3600000;0
12123;201530;136;0;0;0;0;.00nan;0;0
12123;-1;134;0;0;0;0;.00nan;0;0
12124;198081;133;59;19;2;17;.895;3567000;0
12124;210060;137;0;0;0;0;.00nan;0;0
12124;202059;133;0;0;0;0;.00nan;0;0
12124;-1;137;93;32;1;31;.969;3600000;0
12125;208609;131;0;0;0;0;.00nan;0;0
12125;204873;129;0;0;0;0;.00nan;0;0
12125;-1;129;46;26;3;23;.885;3554000;0
12125;-1;131;69;22;1;21;.955;3600000;0
12126;200436;130;0;0;0;0;.00nan;0;0
12126;-1;130;64;30;3;27;.900;3592000;0
12126;-1;128;0;0;0;0;.00nan;0;0
12126;-1;128;62;24;2;22;.917;3600000;0
12127;199587;140;0;0;0;0;.00nan;0;0
12127;204668;140;100;31;0;31;1.000;3600000;0
12127;-1;144;81;34;2;32;.941;3600000;0
12127;-1;144;0;0;0;0;.00nan;0;0
12128;203288;135;73;16;1;15;.938;3600000;0
12128;208556;135;0;0;0;0;.00nan;0;0
12128;199437;134;0;0;0;0;.00nan;0;0
12128;-1;134;82;36;2;34;.944;3596000;0
12129;199701;138;0;0;0;0;.00nan;0;0
12129;210060;137;63;27;3;24;.889;3900000;0
12129;-1;137;0;0;0;0;.00nan;0;0
12129;-1;138;72;32;3;29;.906;3900000;0
12130;208575;142;0;0;0;0;.00nan;0;0
12130;201666;1340;0;0;0;0;.00nan;0;0
12130;196456;142;56;28;3;25;.893;3600000;0
12130;202045;1340;50;34;4;30;.882;3555000;0
12131;203276;139;70;42;3;39;.929;3568000;0
12131;210004;141;0;0;0;0;.00nan;0;0
12131;204938;139;0;0;0;0;.00nan;0;0
12131;201673;141;72;20;1;19;.950;3600000;0
12132;198091;132;67;20;2;18;.900;3600000;0
12132;207313;132;0;0;0;0;.00nan;0;0
12132;208201;143;0;0;0;0;.00nan;0;0
12132;-1;143;74;35;3;32;.914;3600000;0
12133;203276;139;54;5;0;5;1.000;427000;0
12133;204938;139;31;30;6;24;.800;3173000;0
12133;-1;144;0;0;0;0;.00nan;0;0
12133;-1;144;55;22;3;19;.864;3600000;0
12134;204873;129;80;13;0;13;1.000;3900000;0
12134;-1;129;0;0;0;0;.00nan;0;0
12134;-1;128;0;0;0;0;.00nan;0;0
12134;-1;128;96;46;0;46;1.000;3900000;0
12135;210004;141;70;24;2;22;.917;3600000;0
12135;201666;1340;94;51;3;48;.941;3600000;0
12135;201673;141;0;0;0;0;.00nan;0;0
12135;202045;1340;0;0;0;0;.00nan;0;0
12136;198081;133;44;28;4;24;.857;3544000;0
12136;199701;138;69;32;3;29;.906;3600000;0
12136;202059;133;0;0;0;0;.00nan;0;0
12136;-1;138;0;0;0;0;.00nan;0;0
12137;208609;131;83;33;2;31;.939;3600000;0
12137;200436;130;1;25;9;16;.640;3089000;0
12137;-1;131;0;0;0;0;.00nan;0;0
12137;-1;130;43;13;2;11;.846;511000;0
12138;203288;135;0;0;0;0;.00nan;0;0
12138;208556;135;62;20;2;18;.900;3600000;0
12138;199430;136;0;0;0;0;.00nan;0;0
12138;201530;136;98;53;3;50;.943;3600000;0
12139;208575;142;0;0;0;0;.00nan;0;0
12139;210004;141;0;0;0;0;.00nan;0;0
12139;201673;141;69;34;3;31;.912;3600000;0
12139;196456;142;85;29;1;28;.966;3600000;0
12140;203288;135;99;46;2;44;.957;3600000;0
12140;198081;133;0;0;0;0;.00nan;0;0
12140;208556;135;0;0;0;0;.00nan;0;0
12140;202059;133;54;29;4;25;.862;3556000;0
12141;199430;136;71;47;5;42;.894;3212000;0
12141;199701;138;0;0;0;0;.00nan;0;0
12141;201530;136;54;3;0;3;1.000;388000;0
12141;-1;138;85;39;2;37;.949;3600000;0
12142;203276;139;53;42;6;36;.857;3560000;0
12142;199587;140;56;7;0;7;1.000;1330000;0
12142;204668;140;43;25;4;21;.840;2270000;0
12142;204938;139;0;0;0;0;.00nan;0;0
12143;200436;130;66;38;4;34;.895;3600000;0
12143;208201;143;76;26;1;25;.962;3600000;0
12143;-1;143;0;0;0;0;.00nan;0;0
12143;-1;130;0;0;0;0;.00nan;0;0
12144;203276;139;50;1;0;1;1.000;326000;0
12144;210004;141;0;0;0;0;.00nan;0;0
12144;204938;139;27;36;7;29;.806;3274000;0
12144;201673;141;47;29;4;25;.862;3600000;0
12145;199437;134;80;44;4;40;.909;3564000;0
12145;-1;144;55;26;3;23;.885;3600000;0
12145;-1;134;0;0;0;0;.00nan;0;0
12145;-1;144;0;0;0;0;.00nan;0;0
12146;208575;142;48;0;0;0;.00nan;218000;0
12146;199587;140;0;0;0;0;.00nan;0;0
12146;204668;140;66;44;4;40;.909;3600000;0
12146;196456;142;24;22;6;16;.727;3340000;0
12147;198081;133;68;32;3;29;.906;3730000;0
12147;199430;136;0;0;0;0;.00nan;0;0
12147;201530;136;66;23;2;21;.913;3730000;0
12147;202059;133;0;0;0;0;.00nan;0;0
12148;198091;132;0;0;0;0;.00nan;0;0
12148;204873;129;36;36;6;30;.833;3623000;0
12148;207313;132;54;37;5;32;.865;3663000;0
12148;-1;129;0;0;0;0;.00nan;0;0
12149;203288;135;69;26;2;24;.923;3600000;0
12149;208556;135;0;0;0;0;.00nan;0;0
12149;210060;137;0;0;0;0;.00nan;0;0
12149;-1;137;51;24;3;21;.875;3549000;0
12150;208609;131;0;0;0;0;.00nan;0;0
12150;208201;143;0;0;0;0;.00nan;0;0
12150;-1;131;62;33;4;29;.879;3548000;0
12150;-1;143;79;36;3;33;.917;3600000;0
12151;199701;138;0;0;0;0;.00nan;0;0
12151;-1;138;73;34;3;31;.912;3600000;0
12151;-1;128;0;0;0;0;.00nan;0;0
12151;-1;128;50;37;5;32;.865;3590000;0
12152;208575;142;22;4;3;1;.250;384000;0
12152;196456;142;51;22;3;19;.864;3216000;0
12152;-1;144;0;0;0;0;.00nan;0;0
12152;-1;144;50;20;3;17;.850;3600000;0
12153;198081;133;0;0;0;0;.00nan;0;0
12153;199430;136;68;40;4;36;.900;3600000;0
12153;201530;136;0;0;0;0;.00nan;0;0
12153;202059;133;75;22;1;21;.955;3600000;0
12154;204873;129;0;0;0;0;.00nan;0;0
12154;201666;1340;56;22;3;19;.864;3600000;0
12154;202045;1340;0;0;0;0;.00nan;0;0
12154;-1;129;75;49;4;45;.918;3555000;0
12155;208201;143;68;27;3;24;.889;3550000;0
12155;-1;143;0;0;0;0;.00nan;0;0
12155;-1;128;0;0;0;0;.00nan;0;0
12155;-1;128;99;49;2;47;.959;3600000;0
12156;203288;135;0;0;0;0;.00nan;0;0
12156;208556;135;90;50;4;46;.920;3543000;0
12156;210060;137;53;25;3;22;.880;3600000;0
12156;-1;137;0;0;0;0;.00nan;0;0
12157;208609;131;66;22;1;21;.955;3600000;0
12157;199701;138;63;32;3;29;.906;3600000;0
12157;-1;131;0;0;0;0;.00nan;0;0
12157;-1;138;0;0;0;0;.00nan;0;0
12158;199437;134;0;0;0;0;.00nan;0;0
12158;210004;141;65;25;2;23;.920;3600000;0
12158;201673;141;0;0;0;0;.00nan;0;0
12158;-1;134;78;39;3;36;.923;3562000;0
12159;198091;132;38;29;5;24;.828;3600000;0
12159;200436;130;28;28;6;22;.786;2582000;0
12159;207313;132;0;0;0;0;.00nan;0;0
12159;-1;130;36;8;2;6;.750;1018000;0
12160;203276;139;89;35;2;33;.943;3600000;0
12160;199437;134;59;33;4;29;.879;3558000;0
12160;204938;139;0;0;0;0;.00nan;0;0
12160;-1;134;0;0;0;0;.00nan;0;0
12161;200436;130;63;8;0;8;1.000;555000;0
12161;201666;1340;0;0;0;0;.00nan;0;0
12161;202045;1340;66;18;1;17;.944;3600000;0
12161;-1;130;34;34;6;28;.824;3045000;0
12162;208575;142;40;28;5;23;.821;3600000;0
12162;196456;142;0;0;0;0;.00nan;0;0
12162;-1;144;61;24;3;21;.875;3600000;0
12162;-1;144;0;0;0;0;.00nan;0;0
12163;199587;140;0;0;0;0;.00nan;0;0
12163;204668;140;84;29;1;28;.966;3600000;0
12163;204873;129;47;18;3;15;.833;3512000;0
12163;-1;129;0;0;0;0;.00nan;0;0
12164;210004;141;0;0;0;0;.00nan;0;0
12164;201666;1340;75;24;1;23;.958;3600000;0
12164;201673;141;44;32;5;27;.844;3600000;0
12164;202045;1340;0;0;0;0;.00nan;0;0
12165;198081;133;0;0;0;0;.00nan;0;0
12165;210060;137;0;0;0;0;.00nan;0;0
12165;202059;133;65;28;3;25;.893;3600000;0
12165;-1;137;53;36;4;32;.889;3544000;0
12166;199701;138;0;0;0;0;.00nan;0;0
12166;-1;138;27;29;6;23;.793;3570000;0
12166;-1;128;0;0;0;0;.00nan;0;0
12166;-1;128;35;24;5;19;.792;3600000;0
12167;208609;131;0;0;0;0;.00nan;0;0
12167;208201;143;47;26;4;22;.846;3560000;0
12167;-1;131;73;28;2;26;.929;3600000;0
12167;-1;143;0;0;0;0;.00nan;0;0
12168;198091;132;0;0;0;0;.00nan;0;0
12168;210004;141;41;25;5;20;.800;3586000;0
12168;201673;141;0;0;0;0;.00nan;0;0
12168;207313;132;70;42;4;38;.905;3600000;0
12169;208575;142;0;0;0;0;.00nan;0;0
12169;199430;136;69;19;1;18;.947;1511000;0
12169;201530;136;20;23;6;17;.739;2089000;0
12169;196456;142;100;26;0;26;1.000;3600000;0
12170;203276;139;52;39;5;34;.872;3600000;0
12170;204938;139;0;0;0;0;.00nan;0;0
12170;-1;144;0;0;0;0;.00nan;0;0
12170;-1;144;68;22;2;20;.909;3600000;0
12171;199437;134;94;32;1;31;.969;3600000;0
12171;210060;137;0;0;0;0;.00nan;0;0
12171;-1;137;73;27;2;25;.926;3557000;0
12171;-1;134;0;0;0;0;.00nan;0;0
12172;198091;132;74;37;3;34;.919;3600000;0
12172;199587;140;0;0;0;0;.00nan;0;0
12172;204668;140;81;30;2;28;.933;3600000;0
12172;207313;132;0;0;0;0;.00nan;0;0
12173;203288;135;72;25;2;23;.920;3600000;0
12173;208556;135;0;0;0;0;.00nan;0;0
12173;200436;130;27;7;3;4;.571;324000;0
12173;-1;130;92;38;1;37;.974;3209000;0
12174;198081;133;73;25;2;23;.920;3564000;0
12174;202059;133;0;0;0;0;.00nan;0;0
12174;-1;128;0;0;0;0;.00nan;0;0
12174;-1;128;75;22;1;21;.955;3600000;0
12175;203276;139;59;8;0;8;1.000;1224000;0
12175;204938;139;35;33;6;27;.818;2376000;0
12175;-1;144;57;27;3;24;.889;3600000;0
12175;-1;144;0;0;0;0;.00nan;0;0
12176;203288;135;0;0;0;0;.00nan;0;0
12176;208556;135;76;28;2;26;.929;3600000;0
12176;199701;138;0;0;0;0;.00nan;0;0
12176;-1;138;51;33;5;28;.848;3600000;0
12177;204873;129;67;21;3;18;.857;3900000;0
12177;210004;141;0;0;0;0;.00nan;0;0
12177;201673;141;61;31;3;28;.903;3900000;0
12177;-1;129;0;0;0;0;.00nan;0;0
12178;199587;140;0;0;0;0;.00nan;0;0
12178;204668;140;49;34;5;29;.853;3558000;0
12178;201666;1340;66;34;3;31;.912;3600000;0
12178;202045;1340;0;0;0;0;.00nan;0;0
12179;198081;133;0;0;0;0;.00nan;0;0
12179;202059;133;47;25;4;21;.840;3600000;0
12179;-1;128;73;32;3;29;.906;3600000;0
12179;-1;128;0;0;0;0;.00nan;0;0
12180;210060;137;71;21;1;20;.952;3600000;0
12180;200436;130;69;39;4;35;.897;3600000;0
12180;-1;137;0;0;0;0;.00nan;0;0
12180;-1;130;0;0;0;0;.00nan;0;0
12181;208575;142;0;0;0;0;.00nan;0;0
12181;208609;131;81;47;3;44;.936;3551000;0
12181;196456;142;66;20;2;18;.900;3600000;0
12181;-1;131;0;0;0;0;.00nan;0;0
12182;199430;136;0;0;0;0;.00nan;0;0
12182;201530;136;65;40;4;36;.900;3600000;0
12182;208201;143;0;0;0;0;.00nan;0;0
12182;-1;143;72;16;1;15;.938;3600000;0
12183;203276;139;68;34;3;31;.912;3612000;0
12183;208609;131;0;0;0;0;.00nan;0;0
12183;204938;139;0;0;0;0;.00nan;0;0
12183;-1;131;65;18;2;16;.889;3612000;0
12184;199437;134;13;27;7;20;.741;3600000;0
12184;199701;138;88;30;1;29;.967;3600000;0
12184;-1;134;0;0;0;0;.00nan;0;0
12184;-1;138;0;0;0;0;.00nan;0;0
12185;198091;132;54;24;3;21;.875;3582000;0
12185;199437;134;0;0;0;0;.00nan;0;0
12185;207313;132;0;0;0;0;.00nan;0;0
12185;-1;134;99;39;1;38;.974;3600000;0
12186;198081;133;42;24;4;20;.833;3520000;0
12186;199701;138;0;0;0;0;.00nan;0;0
12186;202059;133;0;0;0;0;.00nan;0;0
12186;-1;138;76;32;2;30;.938;3600000;0
12187;199430;136;62;26;3;23;.885;3600000;0
12187;200436;130;78;51;5;46;.902;3515000;0
12187;201530;136;0;0;0;0;.00nan;0;0
12187;-1;130;0;0;0;0;.00nan;0;0
12188;199587;140;0;0;0;0;.00nan;0;0
12188;204668;140;90;57;5;52;.912;3600000;0
12188;210004;141;0;0;0;0;.00nan;0;0
12188;201673;141;70;21;1;20;.952;3600000;0
12189;210060;137;0;0;0;0;.00nan;0;0
12189;-1;137;100;38;0;38;1.000;3600000;0
12189;208201;143;77;28;2;26;.929;3515000;0
12189;-1;143;0;0;0;0;.00nan;0;0
12190;203276;139;45;39;6;33;.846;3600000;0
12190;208575;142;0;0;0;0;.00nan;0;0
12190;204938;139;0;0;0;0;.00nan;0;0
12190;196456;142;48;31;5;26;.839;3600000;0
12191;198091;132;32;23;5;18;.783;3188000;0
12191;199430;136;0;0;0;0;.00nan;0;0
12191;201530;136;76;53;5;48;.906;3900000;0
12191;207313;132;57;3;0;3;1.000;712000;0
12192;199437;134;44;40;7;33;.825;3600000;0
12192;204873;129;0;0;0;0;.00nan;0;0
12192;-1;129;61;22;2;20;.909;3600000;0
12192;-1;134;0;0;0;0;.00nan;0;0
12193;198081;133;0;0;0;0;.00nan;0;0
12193;200436;130;0;0;0;0;.00nan;0;0
12193;202059;133;54;20;3;17;.850;3600000;0
12193;-1;130;68;36;4;32;.889;3589000;0
12194;203288;135;61;30;3;27;.900;3600000;0
12194;208556;135;0;0;0;0;.00nan;0;0
12194;208609;131;100;35;0;35;1.000;3600000;0
12194;-1;131;0;0;0;0;.00nan;0;0
12195;199701;138;33;12;3;9;.750;868000;0
12195;201666;1340;62;23;3;20;.870;3600000;0
12195;202045;1340;0;0;0;0;.00nan;0;0
12195;-1;138;20;23;6;17;.739;2732000;0
12196;-1;144;0;0;0;0;.00nan;0;0
12196;-1;128;51;7;1;6;.857;389000;0
12196;-1;144;59;17;2;15;.882;3600000;0
12196;-1;128;41;34;6;28;.824;3211000;0
12197;199701;138;11;35;9;26;.743;2840000;0
12197;201666;1340;55;17;2;15;.882;3600000;0
12197;202045;1340;0;0;0;0;.00nan;0;0
12197;-1;138;67;13;0;13;1.000;760000;0
12198;198091;132;0;0;0;0;.00nan;0;0
12198;199430;136;62;31;4;27;.871;3519000;0
12198;201530;136;0;0;0;0;.00nan;0;0
12198;207313;132;74;25;2;23;.920;3600000;0
12199;199437;134;0;0;0;0;.00nan;0;0
12199;204873;129;66;25;2;23;.920;3600000;0
12199;-1;129;0;0;0;0;.00nan;0;0
12199;-1;134;70;34;3;31;.912;3600000;0
12200;203288;135;0;0;0;0;.00nan;0;0
12200;208556;135;44;26;4;22;.846;3546000;0
12200;-1;144;65;35;3;32;.914;3600000;0
12200;-1;144;0;0;0;0;.00nan;0;0
12201;200436;130;91;37;1;36;.973;3600000;0
12201;-1;130;0;0;0;0;.00nan;0;0
12201;-1;128;74;35;4;31;.886;3600000;0
12201;-1;128;0;0;0;0;.00nan;0;0
12202;208575;142;25;18;5;13;.722;3600000;0
12202;210060;137;0;0;0;0;.00nan;0;0
12202;196456;142;0;0;0;0;.00nan;0;0
12202;-1;137;81;25;2;23;.920;3600000;0
12203;208575;142;50;2;0;2;1.000;309000;0
12203;196456;142;51;33;6;27;.818;3291000;0
12203;208201;143;76;32;2;30;.938;3600000;0
12203;-1;143;0;0;0;0;.00nan;0;0
12204;203276;139;38;36;5;31;.861;3600000;0
12204;199587;140;0;0;0;0;.00nan;0;0
12204;204668;140;66;23;2;21;.913;3600000;0
12204;204938;139;0;0;0;0;.00nan;0;0
12205;204873;129;0;0;0;0;.00nan;0;0
12205;-1;129;51;25;3;22;.880;3600000;0
12205;-1;128;0;0;0;0;.00nan;0;0
12205;-1;128;1;26;9;17;.654;3600000;0
12206;208609;131;48;13;2;11;.846;3600000;0
12206;-1;144;11;17;6;11;.647;1701000;0
12206;-1;131;0;0;0;0;.00nan;0;0
12206;-1;144;55;17;2;15;.882;1899000;0
12207;210004;141;0;0;0;0;.00nan;0;0
12207;210060;137;51;29;4;25;.862;3600000;0
12207;201673;141;78;26;1;25;.962;3600000;0
12207;-1;137;0;0;0;0;.00nan;0;0
12208;198081;133;65;25;2;23;.920;3537000;0
12208;201666;1340;100;28;0;28;1.000;3600000;0
12208;202045;1340;0;0;0;0;.00nan;0;0
12208;202059;133;0;0;0;0;.00nan;0;0
12209;203276;139;48;0;0;0;.00nan;423000;0
12209;204938;139;42;40;6;34;.850;3123000;0
12209;208201;143;0;0;0;0;.00nan;0;0
12209;-1;143;52;32;5;27;.844;3600000;0
12210;199587;140;0;0;0;0;.00nan;0;0
12210;204668;140;70;26;1;25;.962;3600000;0
12210;208201;143;71;36;3;33;.917;3521000;0
12210;-1;143;0;0;0;0;.00nan;0;0
12211;210004;141;0;0;0;0;.00nan;0;0
12211;201673;141;66;24;3;21;.875;3600000;0
12211;-1;144;0;0;0;0;.00nan;0;0
12211;-1;144;73;36;4;32;.889;3546000;0
12212;203276;139;28;7;3;4;.571;356000;0
12212;198081;133;0;0;0;0;.00nan;0;0
12212;204938;139;83;27;1;26;.963;3244000;0
12212;202059;133;91;31;1;30;.968;3600000;0
12213;208609;131;66;22;3;19;.864;3600000;0
12213;199430;136;61;22;2;20;.909;2982000;0
12213;201530;136;24;6;3;3;.500;536000;0
12213;-1;131;0;0;0;0;.00nan;0;0
12214;199701;138;0;0;0;0;.00nan;0;0
12214;204873;129;18;10;4;6;.600;2211000;0
12214;-1;129;45;10;2;8;.800;1520000;0
12214;-1;138;62;40;5;35;.875;3731000;0
12215;208575;142;0;0;0;0;.00nan;0;0
12215;199587;140;0;0;0;0;.00nan;0;0
12215;204668;140;63;46;5;41;.891;3600000;0
12215;196456;142;78;33;2;31;.939;3600000;0
12216;208609;131;0;0;0;0;.00nan;0;0
12216;199437;134;27;23;5;18;.783;3565000;0
12216;-1;131;62;30;3;27;.900;3600000;0
12216;-1;134;0;0;0;0;.00nan;0;0
12217;198091;132;0;0;0;0;.00nan;0;0
12217;200436;130;77;39;3;36;.923;3553000;0
12217;207313;132;60;21;2;19;.905;3600000;0
12217;-1;130;0;0;0;0;.00nan;0;0
12218;201666;1340;56;25;3;22;.880;3548000;0
12218;202045;1340;0;0;0;0;.00nan;0;0
12218;-1;128;0;0;0;0;.00nan;0;0
12218;-1;128;86;34;2;32;.941;3600000;0
12219;203288;135;22;5;3;2;.400;413000;0
12219;208556;135;65;27;3;24;.889;3172000;0
12219;210060;137;0;0;0;0;.00nan;0;0
12219;-1;137;72;41;4;37;.902;3600000;0
12220;203276;139;82;31;1;30;.968;3600000;0
12220;199701;138;55;27;4;23;.852;3600000;0
12220;204938;139;0;0;0;0;.00nan;0;0
12220;-1;138;0;0;0;0;.00nan;0;0
12221;198081;133;84;37;3;34;.919;3900000;0
12221;204873;129;47;20;3;17;.850;3900000;0
12221;202059;133;0;0;0;0;.00nan;0;0
12221;-1;129;0;0;0;0;.00nan;0;0
12222;200436;130;62;8;0;8;1.000;285000;0
12222;201666;1340;0;0;0;0;.00nan;0;0
12222;202045;1340;91;19;0;19;1.000;3600000;0
12222;-1;130;49;45;6;39;.867;3315000;0
12223;203288;135;100;42;1;41;.976;3600000;0
12223;208556;135;0;0;0;0;.00nan;0;0
12223;210060;137;0;0;0;0;.00nan;0;0
12223;-1;137;64;31;3;28;.903;3517000;0
12224;208609;131;33;17;4;13;.765;3867000;0
12224;199437;134;0;0;0;0;.00nan;0;0
12224;-1;131;0;0;0;0;.00nan;0;0
12224;-1;134;47;31;5;26;.839;3867000;0
12225;208575;142;22;21;6;15;.714;3055000;0
12225;196456;142;62;4;0;4;1.000;545000;0
12225;-1;144;56;27;3;24;.889;3600000;0
12225;-1;144;0;0;0;0;.00nan;0;0
12226;210004;141;0;0;0;0;.00nan;0;0
12226;201673;141;65;25;2;23;.920;3600000;0
12226;208201;143;27;16;4;12;.750;1523000;0
12226;-1;143;17;17;5;12;.706;2077000;0
12227;199587;140;0;0;0;0;.00nan;0;0
12227;204668;140;65;41;5;36;.878;3600000;0
12227;208201;143;32;29;6;23;.793;3530000;0
12227;-1;143;0;0;0;0;.00nan;0;0
12228;203276;139;90;38;1;37;.974;3600000;0
12228;199430;136;0;0;0;0;.00nan;0;0
12228;204938;139;0;0;0;0;.00nan;0;0
12228;201530;136;54;24;3;21;.875;3582000;0
12229;198081;133;0;0;0;0;.00nan;0;0
12229;204873;129;69;13;0;13;1.000;2445000;0
12229;202059;133;69;35;3;32;.914;3600000;0
12229;-1;129;30;15;4;11;.733;1155000;0
12230;198091;132;0;0;0;0;.00nan;0;0
12230;207313;132;26;28;5;23;.821;3900000;0
12230;-1;128;60;42;5;37;.881;3900000;0
12230;-1;128;0;0;0;0;.00nan;0;0
12231;199437;134;25;18;5;13;.722;3548000;0
12231;200436;130;54;26;4;22;.846;3600000;0
12231;-1;130;0;0;0;0;.00nan;0;0
12231;-1;134;0;0;0;0;.00nan;0;0
12232;198081;133;35;33;6;27;.818;3290000;0
12232;199587;140;0;0;0;0;.00nan;0;0
12232;204668;140;59;40;4;36;.900;3600000;0
12232;202059;133;40;2;1;1;.500;310000;0
12233;199430;136;0;0;0;0;.00nan;0;0
12233;201530;136;94;48;4;44;.917;3600000;0
12233;201666;1340;0;0;0;0;.00nan;0;0
12233;202045;1340;38;33;5;28;.848;3591000;0
12234;199587;140;63;19;3;16;.842;1420000;0
12234;204668;140;37;35;6;29;.829;2180000;0
12234;210004;141;65;26;2;24;.923;3600000;0
12234;201673;141;0;0;0;0;.00nan;0;0
12235;198081;133;0;0;0;0;.00nan;0;0
12235;208575;142;0;0;0;0;.00nan;0;0
12235;196456;142;62;22;3;19;.864;3600000;0
12235;202059;133;50;29;4;25;.862;3567000;0
12236;199437;134;77;32;2;30;.938;3600000;0
12236;199701;138;0;0;0;0;.00nan;0;0
12236;-1;134;0;0;0;0;.00nan;0;0
12236;-1;138;48;29;5;24;.828;3600000;0
12237;208609;131;39;44;8;36;.818;3600000;0
12237;204873;129;56;29;4;25;.862;3600000;0
12237;-1;129;0;0;0;0;.00nan;0;0
12237;-1;131;0;0;0;0;.00nan;0;0
12238;200436;130;43;22;4;18;.818;3768000;0
12238;-1;130;0;0;0;0;.00nan;0;0
12238;-1;128;72;32;3;29;.906;3768000;0
12238;-1;128;0;0;0;0;.00nan;0;0
12239;198091;132;0;0;0;0;.00nan;0;0
12239;210004;141;0;0;0;0;.00nan;0;0
12239;201673;141;98;44;3;41;.932;3584000;0
12239;207313;132;98;35;1;34;.971;3600000;0
12240;201666;1340;45;26;5;21;.808;3600000;0
12240;202045;1340;0;0;0;0;.00nan;0;0
12240;-1;144;88;31;1;30;.968;3600000;0
12240;-1;144;0;0;0;0;.00nan;0;0
12241;208575;142;30;29;6;23;.793;3600000;0
12241;196456;142;0;0;0;0;.00nan;0;0
12241;208201;143;37;21;4;17;.810;3078000;0
12241;-1;143;29;9;3;6;.667;507000;0
12242;203288;135;44;35;6;29;.829;2673000;0
12242;208556;135;63;8;0;8;1.000;927000;0
12242;204873;129;0;0;0;0;.00nan;0;0
12242;-1;129;45;18;3;15;.833;3600000;0
12243;199430;136;50;24;3;21;.875;3600000;0
12243;210060;137;0;0;0;0;.00nan;0;0
12243;201530;136;0;0;0;0;.00nan;0;0
12243;-1;137;100;40;0;40;1.000;3600000;0
12244;199701;138;0;0;0;0;.00nan;0;0
12244;-1;138;64;31;3;28;.903;3600000;0
12244;-1;128;56;32;4;28;.875;3600000;0
12244;-1;128;0;0;0;0;.00nan;0;0
12245;203288;135;58;30;4;26;.867;1723000;0
12245;208556;135;28;27;6;21;.778;1877000;0
12245;208609;131;58;27;3;24;.889;3600000;0
12245;-1;131;0;0;0;0;.00nan;0;0
12246;198081;133;45;27;4;23;.852;3600000;0
12246;202059;133;0;0;0;0;.00nan;0;0
12246;208201;143;0;0;0;0;.00nan;0;0
12246;-1;143;95;37;1;36;.973;3600000;0
12247;199587;140;0;0;0;0;.00nan;0;0
12247;204668;140;80;30;1;29;.967;3600000;0
12247;201666;1340;48;36;6;30;.833;3600000;0
12247;202045;1340;0;0;0;0;.00nan;0;0
12248;203276;139;28;17;5;12;.706;1164000;0
12248;198091;132;61;14;1;13;.929;3600000;0
12248;204938;139;62;22;2;20;.909;2436000;0
12248;207313;132;0;0;0;0;.00nan;0;0
12249;198091;132;0;0;0;0;.00nan;0;0
12249;207313;132;58;32;4;28;.875;3600000;0
12249;-1;144;0;0;0;0;.00nan;0;0
12249;-1;144;72;41;5;36;.878;3553000;0
12250;203276;139;20;27;6;21;.778;1807000;0
12250;204938;139;37;18;4;14;.778;1793000;0
12250;201666;1340;54;25;3;22;.880;3600000;0
12250;202045;1340;0;0;0;0;.00nan;0;0
12251;208609;131;0;0;0;0;.00nan;0;0
12251;-1;131;47;19;3;16;.842;3600000;0
12251;-1;128;61;34;4;30;.882;3581000;0
12251;-1;128;0;0;0;0;.00nan;0;0
12252;208575;142;0;0;0;0;.00nan;0;0
12252;210004;141;0;0;0;0;.00nan;0;0
12252;201673;141;97;19;0;19;1.000;3600000;0
12252;196456;142;54;47;6;41;.872;3600000;0
12253;199430;136;68;29;3;26;.897;3600000;0
12253;199701;138;0;0;0;0;.00nan;0;0
12253;201530;136;0;0;0;0;.00nan;0;0
12253;-1;138;60;35;4;31;.886;3600000;0
12254;210060;137;70;12;0;12;1.000;1403000;0
12254;200436;130;79;37;3;34;.919;3600000;0
12254;-1;137;18;11;5;6;.545;2164000;0
12254;-1;130;0;0;0;0;.00nan;0;0
12255;203288;135;57;28;4;24;.857;3588000;0
12255;208556;135;0;0;0;0;.00nan;0;0
12255;199437;134;80;35;3;32;.914;3600000;0
12255;-1;134;0;0;0;0;.00nan;0;0
12256;208201;143;54;40;6;34;.850;3600000;0
12256;-1;144;0;0;0;0;.00nan;0;0
12256;-1;143;0;0;0;0;.00nan;0;0
12256;-1;144;65;29;3;26;.897;3600000;0
12257;199430;136;0;0;0;0;.00nan;0;0
12257;199701;138;0;0;0;0;.00nan;0;0
12257;201530;136;80;42;3;39;.929;3600000;0
12257;-1;138;57;39;5;34;.872;3598000;0
12258;208575;142;50;0;0;0;.00nan;402000;0
12258;196456;142;34;33;6;27;.818;3198000;0
12258;-1;128;24;13;4;9;.692;1054000;0
12258;-1;128;56;26;3;23;.885;2493000;0
12259;203276;139;87;48;4;44;.917;3600000;0
12259;210004;141;0;0;0;0;.00nan;0;0
12259;204938;139;0;0;0;0;.00nan;0;0
12259;201673;141;38;25;5;20;.800;3546000;0
12260;203288;135;87;36;2;34;.944;3600000;0
12260;208556;135;0;0;0;0;.00nan;0;0
12260;210060;137;0;0;0;0;.00nan;0;0
12260;-1;137;30;31;6;25;.806;3600000;0
12261;204873;129;56;17;2;15;.882;3600000;0
12261;200436;130;69;54;5;49;.907;3600000;0
12261;-1;129;0;0;0;0;.00nan;0;0
12261;-1;130;0;0;0;0;.00nan;0;0
12262;208609;131;73;25;1;24;.960;3600000;0
12262;199587;140;0;0;0;0;.00nan;0;0
12262;204668;140;61;24;2;22;.917;3542000;0
12262;-1;131;0;0;0;0;.00nan;0;0
12263;199701;138;0;0;0;0;.00nan;0;0
12263;-1;144;100;35;0;35;1.000;3600000;0
12263;-1;138;67;39;4;35;.897;3600000;0
12263;-1;144;0;0;0;0;.00nan;0;0
12264;198081;133;0;0;0;0;.00nan;0;0
12264;202059;133;59;26;3;23;.885;3600000;0
12264;-1;128;21;21;6;15;.714;3600000;0
12264;-1;128;0;0;0;0;.00nan;0;0
12265;199430;136;55;6;0;6;1.000;644000;0
12265;204873;129;0;0;0;0;.00nan;0;0
12265;201530;136;58;39;5;34;.872;2956000;0
12265;-1;129;80;29;2;27;.931;3600000;0
12266;208575;142;0;0;0;0;.00nan;0;0
12266;201666;1340;67;25;2;23;.920;3600000;0
12266;196456;142;34;26;5;21;.808;3600000;0
12266;202045;1340;0;0;0;0;.00nan;0;0
12267;199587;140;0;0;0;0;.00nan;0;0
12267;204668;140;71;28;3;25;.893;3600000;0
12267;210060;137;40;34;6;28;.824;3600000;0
12267;-1;137;0;0;0;0;.00nan;0;0
12268;208609;131;0;0;0;0;.00nan;0;0
12268;200436;130;0;0;0;0;.00nan;0;0
12268;-1;131;65;26;2;24;.923;3600000;0
12268;-1;130;57;53;7;46;.868;3600000;0
12269;199437;134;0;0;0;0;.00nan;0;0
12269;199587;140;89;37;3;34;.919;3900000;0
12269;204668;140;0;0;0;0;.00nan;0;0
12269;-1;134;62;29;3;26;.897;3900000;0
12270;198081;133;62;27;2;25;.926;3542000;0
12270;202059;133;0;0;0;0;.00nan;0;0
12270;-1;128;98;35;1;34;.971;3600000;0
12270;-1;128;0;0;0;0;.00nan;0;0
12271;199430;136;97;50;1;49;.980;3900000;0
12271;204873;129;90;26;1;25;.962;3900000;0
12271;201530;136;0;0;0;0;.00nan;0;0
12271;-1;129;0;0;0;0;.00nan;0;0
12272;203288;135;49;30;4;26;.867;3546000;0
12272;208556;135;0;0;0;0;.00nan;0;0
12272;201666;1340;0;0;0;0;.00nan;0;0
12272;202045;1340;45;21;3;18;.857;3600000;0
12273;208609;131;47;16;3;13;.813;3600000;0
12273;210060;137;0;0;0;0;.00nan;0;0
12273;-1;137;55;35;5;30;.857;3586000;0
12273;-1;131;0;0;0;0;.00nan;0;0
12274;199701;138;0;0;0;0;.00nan;0;0
12274;210004;141;0;0;0;0;.00nan;0;0
12274;201673;141;97;20;0;20;1.000;3600000;0
12274;-1;138;77;43;4;39;.907;3600000;0
12275;203276;139;72;34;2;32;.941;3900000;0
12275;204938;139;0;0;0;0;.00nan;0;0
12275;208201;143;65;20;2;18;.900;3900000;0
12275;-1;143;0;0;0;0;.00nan;0;0
12276;198091;132;0;0;0;0;.00nan;0;0
12276;208575;142;54;37;5;32;.865;3600000;0
12276;196456;142;0;0;0;0;.00nan;0;0
12276;207313;132;69;16;1;15;.938;3600000;0
12277;208201;143;0;0;0;0;.00nan;0;0
12277;-1;144;48;21;3;18;.857;3600000;0
12277;-1;143;54;30;5;25;.833;3519000;0
12277;-1;144;0;0;0;0;.00nan;0;0
12278;203276;139;0;0;0;0;.00nan;0;0
12278;199701;138;0;0;0;0;.00nan;0;0
12278;204938;139;69;39;4;35;.897;3600000;0
12278;-1;138;35;31;6;25;.806;3568000;0
12279;203288;135;0;0;0;0;.00nan;0;0
12279;198091;132;100;28;0;28;1.000;3600000;0
12279;208556;135;33;41;7;34;.829;3600000;0
12279;207313;132;0;0;0;0;.00nan;0;0
12280;199437;134;31;24;5;19;.792;3514000;0
12280;200436;130;73;35;3;32;.914;3600000;0
12280;-1;130;0;0;0;0;.00nan;0;0
12280;-1;134;0;0;0;0;.00nan;0;0
12281;199587;140;0;0;0;0;.00nan;0;0
12281;204668;140;61;28;3;25;.893;3600000;0
12281;208201;143;45;34;5;29;.853;3523000;0
12281;-1;143;0;0;0;0;.00nan;0;0
12282;203276;139;66;23;2;21;.913;3600000;0
12282;204938;139;0;0;0;0;.00nan;0;0
12282;200436;130;63;36;4;32;.889;3548000;0
12282;-1;130;0;0;0;0;.00nan;0;0
12283;199437;134;26;7;3;4;.571;286000;0
12283;-1;144;0;0;0;0;.00nan;0;0
12283;-1;134;47;26;4;22;.846;3314000;0
12283;-1;144;41;21;4;17;.810;3600000;0
12284;203288;135;62;37;4;33;.892;3547000;0
12284;208556;135;0;0;0;0;.00nan;0;0
12284;201666;1340;78;32;3;29;.906;3600000;0
12284;202045;1340;0;0;0;0;.00nan;0;0
12285;208575;142;0;0;0;0;.00nan;0;0
12285;200436;130;62;41;5;36;.878;3600000;0
12285;196456;142;87;36;2;34;.944;3600000;0
12285;-1;130;0;0;0;0;.00nan;0;0
12286;199587;140;0;0;0;0;.00nan;0;0
12286;204668;140;78;32;2;30;.938;3615000;0
12286;204873;129;59;30;3;27;.900;3615000;0
12286;-1;129;0;0;0;0;.00nan;0;0
12287;199430;136;0;0;0;0;.00nan;0;0
12287;210060;137;0;0;0;0;.00nan;0;0
12287;201530;136;77;24;1;23;.958;3762000;0
12287;-1;137;88;33;2;31;.939;3762000;0
12288;208609;131;0;0;0;0;.00nan;0;0
12288;210004;141;0;0;0;0;.00nan;0;0
12288;201673;141;87;33;1;32;.970;3600000;0
12288;-1;131;65;39;4;35;.897;3600000;0
12289;208575;142;43;26;4;22;.846;3571000;0
12289;204873;129;0;0;0;0;.00nan;0;0
12289;196456;142;0;0;0;0;.00nan;0;0
12289;-1;129;71;34;3;31;.912;3600000;0
12290;203276;139;16;23;6;17;.739;2817000;0
12290;199587;140;0;0;0;0;.00nan;0;0
12290;204668;140;96;21;0;21;1.000;3600000;0
12290;204938;139;34;6;2;4;.667;783000;0
12291;199437;134;32;18;4;14;.778;1042000;0
12291;210004;141;0;0;0;0;.00nan;0;0
12291;201673;141;50;11;2;9;.818;3600000;0
12291;-1;134;65;19;1;18;.947;2558000;0
12292;198081;133;0;0;0;0;.00nan;0;0
12292;202059;133;74;41;3;38;.927;3600000;0
12292;-1;144;36;16;4;12;.750;2051000;0
12292;-1;144;66;12;1;11;.917;1463000;0
12293;208609;131;86;37;2;35;.946;3600000;0
12293;201666;1340;56;26;5;21;.808;3600000;0
12293;202045;1340;0;0;0;0;.00nan;0;0
12293;-1;131;0;0;0;0;.00nan;0;0
12294;198091;132;55;20;2;18;.900;3900000;0
12294;207313;132;0;0;0;0;.00nan;0;0
12294;-1;128;0;0;0;0;.00nan;0;0
12294;-1;128;99;46;2;44;.957;3900000;0
12295;199701;138;68;34;3;31;.912;3600000;0
12295;-1;144;28;29;6;23;.793;3600000;0
12295;-1;138;0;0;0;0;.00nan;0;0
12295;-1;144;0;0;0;0;.00nan;0;0
12296;199430;136;57;25;3;22;.880;3566000;0
12296;199437;134;87;36;2;34;.944;3600000;0
12296;201530;136;0;0;0;0;.00nan;0;0
12296;-1;134;0;0;0;0;.00nan;0;0
12297;201666;1340;39;26;5;21;.808;3900000;0
12297;202045;1340;0;0;0;0;.00nan;0;0
12297;-1;128;50;31;5;26;.839;3900000;0
12297;-1;128;0;0;0;0;.00nan;0;0
12298;210004;141;25;18;5;13;.722;2382000;0
12298;210060;137;0;0;0;0;.00nan;0;0
12298;201673;141;58;11;1;10;.909;1218000;0
12298;-1;137;72;29;2;27;.931;3600000;0
12299;203288;135;72;33;2;31;.939;3543000;0
12299;198091;132;0;0;0;0;.00nan;0;0
12299;208556;135;0;0;0;0;.00nan;0;0
12299;207313;132;100;33;0;33;1.000;3600000;0
12300;200436;130;97;58;4;54;.931;3600000;0
12300;208201;143;63;15;1;14;.933;3600000;0
12300;-1;143;0;0;0;0;.00nan;0;0
12300;-1;130;0;0;0;0;.00nan;0;0
12301;203276;139;68;42;5;37;.881;3573000;0
12301;208575;142;0;0;0;0;.00nan;0;0
12301;204938;139;0;0;0;0;.00nan;0;0
12301;196456;142;56;19;3;16;.842;3600000;0
12302;204873;129;71;38;4;34;.895;3568000;0
12302;208201;143;0;0;0;0;.00nan;0;0
12302;-1;129;0;0;0;0;.00nan;0;0
12302;-1;143;79;41;3;38;.927;3600000;0
12303;203288;135;41;18;4;14;.778;3600000;0
12303;208556;135;0;0;0;0;.00nan;0;0
12303;208609;131;0;0;0;0;.00nan;0;0
12303;-1;131;62;15;1;14;.933;3600000;0
12304;198081;133;58;15;2;13;.867;3600000;0
12304;199701;138;0;0;0;0;.00nan;0;0
12304;202059;133;0;0;0;0;.00nan;0;0
12304;-1;138;73;45;4;41;.911;3533000;0
12305;198091;132;0;0;0;0;.00nan;0;0
12305;210060;137;100;35;0;35;1.000;3600000;0
12305;207313;132;48;27;4;23;.852;3600000;0
12305;-1;137;0;0;0;0;.00nan;0;0
12306;208575;142;0;0;0;0;.00nan;0;0
12306;196456;142;79;27;3;24;.889;3600000;0
12306;-1;144;41;26;4;22;.846;3549000;0
12306;-1;144;0;0;0;0;.00nan;0;0
12307;198091;132;44;32;6;26;.813;3134000;0
12307;201666;1340;99;42;1;41;.976;3600000;0
12307;202045;1340;0;0;0;0;.00nan;0;0
12307;207313;132;46;6;1;5;.833;466000;0
12308;199430;136;0;0;0;0;.00nan;0;0
12308;210060;137;74;22;2;20;.909;3600000;0
12308;201530;136;73;32;3;29;.906;3574000;0
12308;-1;137;0;0;0;0;.00nan;0;0
12309;199437;134;19;29;7;22;.759;3600000;0
12309;199701;138;0;0;0;0;.00nan;0;0
12309;-1;134;0;0;0;0;.00nan;0;0
12309;-1;138;78;29;2;27;.931;3600000;0
12310;210004;141;0;0;0;0;.00nan;0;0
12310;201673;141;55;34;4;30;.882;3557000;0
12310;-1;144;0;0;0;0;.00nan;0;0
12310;-1;144;93;41;3;38;.927;3600000;0
12311;203276;139;95;24;0;24;1.000;3600000;0
12311;208575;142;0;0;0;0;.00nan;0;0
12311;204938;139;0;0;0;0;.00nan;0;0
12311;196456;142;45;20;3;17;.850;3600000;0
12312;199587;140;0;0;0;0;.00nan;0;0
12312;204668;140;64;15;1;14;.933;3600000;0
12312;208201;143;90;45;2;43;.956;3600000;0
12312;-1;143;0;0;0;0;.00nan;0;0
12313;198081;133;0;0;0;0;.00nan;0;0
12313;199437;134;41;33;5;28;.848;3159000;0
12313;202059;133;55;22;3;19;.864;3600000;0
12313;-1;134;50;1;0;1;1.000;369000;0
12314;198091;132;0;0;0;0;.00nan;0;0
12314;208609;131;71;26;3;23;.885;3600000;0
12314;207313;132;100;27;0;27;1.000;3600000;0
12314;-1;131;0;0;0;0;.00nan;0;0
12315;199701;138;0;0;0;0;.00nan;0;0
12315;204873;129;59;17;2;15;.882;3900000;0
12315;-1;129;0;0;0;0;.00nan;0;0
12315;-1;138;59;23;2;21;.913;3900000;0
12316;201666;1340;56;12;1;11;.917;3600000;0
12316;202045;1340;0;0;0;0;.00nan;0;0
12316;-1;128;0;0;0;0;.00nan;0;0
12316;-1;128;82;35;2;33;.943;3600000;0
12317;199430;136;60;21;3;18;.857;3600000;0
12317;200436;130;100;27;0;27;1.000;3600000;0
12317;201530;136;0;0;0;0;.00nan;0;0
12317;-1;130;0;0;0;0;.00nan;0;0
12318;203288;135;40;13;3;10;.769;3698000;0
12318;208556;135;0;0;0;0;.00nan;0;0
12318;210060;137;0;0;0;0;.00nan;0;0
12318;-1;137;70;41;4;37;.902;3698000;0
12319;198081;133;40;25;4;21;.840;3584000;0
12319;199437;134;0;0;0;0;.00nan;0;0
12319;202059;133;0;0;0;0;.00nan;0;0
12319;-1;134;62;25;2;23;.920;3600000;0
12320;204873;129;0;0;0;0;.00nan;0;0
12320;210060;137;75;58;6;52;.897;3600000;0
12320;-1;137;0;0;0;0;.00nan;0;0
12320;-1;129;62;21;3;18;.857;3600000;0
12321;208609;131;0;0;0;0;.00nan;0;0
12321;201666;1340;36;21;5;16;.762;3600000;0
12321;202045;1340;0;0;0;0;.00nan;0;0
12321;-1;131;82;36;2;34;.944;3600000;0
12322;199701;138;65;36;5;31;.861;3556000;0
12322;200436;130;60;30;4;26;.867;3600000;0
12322;-1;130;0;0;0;0;.00nan;0;0
12322;-1;138;0;0;0;0;.00nan;0;0
12323;203288;135;0;0;0;0;.00nan;0;0
12323;208556;135;84;29;1;28;.966;3600000;0
12323;199430;136;0;0;0;0;.00nan;0;0
12323;201530;136;53;33;4;29;.879;3600000;0
12324;210004;141;76;26;2;24;.923;3600000;0
12324;201673;141;0;0;0;0;.00nan;0;0
12324;208201;143;0;0;0;0;.00nan;0;0
12324;-1;143;73;35;4;31;.886;3564000;0
12325;199587;140;0;0;0;0;.00nan;0;0
12325;204668;140;50;26;4;22;.846;3600000;0
12325;-1;144;98;33;1;32;.970;3600000;0
12325;-1;144;0;0;0;0;.00nan;0;0
12326;203276;139;12;36;9;27;.750;3600000;0
12326;208575;142;66;31;3;28;.903;3600000;0
12326;204938;139;0;0;0;0;.00nan;0;0
12326;196456;142;0;0;0;0;.00nan;0;0
12327;198091;132;50;22;3;19;.864;3600000;0
12327;207313;132;0;0;0;0;.00nan;0;0
12327;-1;128;24;14;4;10;.714;1146000;0
12327;-1;128;74;29;2;27;.931;2454000;0
12328;210004;141;0;0;0;0;.00nan;0;0
12328;201673;141;71;27;3;24;.889;3900000;0
12328;-1;144;0;0;0;0;.00nan;0;0
12328;-1;144;48;33;3;30;.909;3900000;0
12329;203276;139;79;36;3;33;.917;3600000;0
12329;204938;139;0;0;0;0;.00nan;0;0
12329;208201;143;22;5;3;2;.400;508000;0
12329;-1;143;19;26;7;19;.731;3092000;0
12330;208575;142;0;0;0;0;.00nan;0;0
12330;199587;140;0;0;0;0;.00nan;0;0
12330;204668;140;77;25;2;23;.920;3541000;0
12330;196456;142;100;33;0;33;1.000;3600000;0
12331;208609;131;63;27;3;24;.889;3600000;0
12331;199437;134;58;37;5;32;.865;3564000;0
12331;-1;131;0;0;0;0;.00nan;0;0
12331;-1;134;0;0;0;0;.00nan;0;0
12332;203288;135;100;26;0;26;1.000;3600000;0
12332;208556;135;0;0;0;0;.00nan;0;0
12332;199430;136;49;44;6;38;.864;3600000;0
12332;201530;136;0;0;0;0;.00nan;0;0
12333;198091;132;0;0;0;0;.00nan;0;0
12333;204873;129;64;38;5;33;.868;3562000;0
12333;207313;132;61;33;4;29;.879;3600000;0
12333;-1;129;0;0;0;0;.00nan;0;0
12334;198081;133;0;0;0;0;.00nan;0;0
12334;210060;137;0;0;0;0;.00nan;0;0
12334;202059;133;76;31;2;29;.935;3547000;0
12334;-1;137;71;21;1;20;.952;3600000;0
12335;199701;138;0;0;0;0;.00nan;0;0
12335;200436;130;24;27;6;21;.778;2781000;0
12335;-1;130;43;5;1;4;.800;819000;0
12335;-1;138;73;23;2;21;.913;3600000;0
12336;199587;140;95;46;2;44;.957;3898000;0
12336;204668;140;0;0;0;0;.00nan;0;0
12336;-1;144;66;21;2;19;.905;3900000;0
12336;-1;144;0;0;0;0;.00nan;0;0
12337;204873;129;0;0;0;0;.00nan;0;0
12337;210060;137;57;34;3;31;.912;3542000;0
12337;-1;137;0;0;0;0;.00nan;0;0
12337;-1;129;75;20;1;19;.950;3600000;0
12338;208575;142;0;0;0;0;.00nan;0;0
12338;196456;142;67;37;4;33;.892;3555000;0
12338;208201;143;92;40;2;38;.950;3600000;0
12338;-1;143;0;0;0;0;.00nan;0;0
12339;198081;133;81;28;1;27;.964;3600000;0
12339;199701;138;28;29;6;23;.793;3600000;0
12339;201661;138;0;0;0;0;.00nan;0;0
12339;202059;133;0;0;0;0;.00nan;0;0
12340;199430;136;56;4;0;4;1.000;643000;0
12340;199437;134;68;29;2;27;.931;3600000;0
12340;201530;136;24;20;6;14;.700;2957000;0
12340;-1;134;0;0;0;0;.00nan;0;0
12341;198091;132;24;29;6;23;.793;2686000;0
12341;201666;1340;37;28;6;22;.786;2934000;0
12341;202045;1340;59;7;0;7;1.000;666000;0
12341;207313;132;33;14;3;11;.786;914000;0
12342;200436;130;30;32;7;25;.781;3645000;0
12342;-1;130;0;0;0;0;.00nan;0;0
12342;-1;128;57;2;0;2;1.000;326000;0
12342;-1;128;19;18;6;12;.667;3319000;0
12343;203288;135;79;36;2;34;.944;3600000;0
12343;208556;135;0;0;0;0;.00nan;0;0
12343;208609;131;0;0;0;0;.00nan;0;0
12343;-1;131;60;30;4;26;.867;3556000;0
12344;203276;139;64;37;4;33;.892;3668000;0
12344;210004;141;0;0;0;0;.00nan;0;0
12344;204938;139;0;0;0;0;.00nan;0;0
12344;201673;141;47;34;5;29;.853;3668000;0
12345;208575;142;72;29;2;27;.931;3556000;0
12345;196456;142;0;0;0;0;.00nan;0;0
12345;208201;143;0;0;0;0;.00nan;0;0
12345;-1;143;83;29;1;28;.966;3600000;0
12346;203276;139;0;0;0;0;.00nan;0;0
12346;204938;139;88;45;3;42;.933;3600000;0
12346;-1;144;65;22;2;20;.909;3600000;0
12346;-1;144;0;0;0;0;.00nan;0;0
12347;199430;136;72;25;2;23;.920;3578000;0
12347;199437;134;0;0;0;0;.00nan;0;0
12347;201530;136;0;0;0;0;.00nan;0;0
12347;-1;134;69;20;1;19;.950;3600000;0
12348;198081;133;0;0;0;0;.00nan;0;0
12348;199701;138;0;0;0;0;.00nan;0;0
12348;201661;138;76;25;1;24;.960;3600000;0
12348;202059;133;64;31;3;28;.903;3599000;0
12349;198091;132;0;0;0;0;.00nan;0;0
12349;201666;1340;11;17;6;11;.647;2697000;0
12349;202045;1340;25;7;3;4;.571;903000;0
12349;207313;132;54;26;4;22;.846;3600000;0
12350;210060;137;0;0;0;0;.00nan;0;0
12350;200436;130;0;0;0;0;.00nan;0;0
12350;-1;137;45;17;3;14;.824;3563000;0
12350;-1;130;81;28;1;27;.964;3600000;0
12351;203288;135;43;42;6;36;.857;3600000;0
12351;208556;135;0;0;0;0;.00nan;0;0
12351;204873;129;0;0;0;0;.00nan;0;0
12351;-1;129;70;27;2;25;.926;3600000;0
12352;208609;131;57;32;4;28;.875;3584000;0
12352;-1;131;0;0;0;0;.00nan;0;0
12352;-1;128;69;24;2;22;.917;3600000;0
12352;-1;128;0;0;0;0;.00nan;0;0
12353;199587;140;0;0;0;0;.00nan;0;0
12353;204668;140;82;57;5;52;.912;3600000;0
12353;210004;141;0;0;0;0;.00nan;0;0
12353;201673;141;50;13;2;11;.846;3600000;0
12354;208575;142;0;0;0;0;.00nan;0;0
12354;196456;142;58;37;5;32;.865;3600000;0
12354;-1;144;50;26;4;22;.846;2539000;0
12354;-1;144;19;10;4;6;.600;996000;0
12355;203288;135;26;21;6;15;.714;2789000;0
12355;208556;135;32;5;2;3;.600;811000;0
12355;204873;129;0;0;0;0;.00nan;0;0
12355;-1;129;38;27;5;22;.815;3600000;0
12356;201666;1340;60;18;2;16;.889;3600000;0
12356;202045;1340;0;0;0;0;.00nan;0;0
12356;-1;128;0;0;0;0;.00nan;0;0
12356;-1;128;52;25;3;22;.880;3570000;0
12357;199437;134;76;30;2;28;.933;3600000;0
12357;200436;130;44;54;8;46;.852;3248000;0
12357;-1;130;53;4;0;4;1.000;352000;0
12357;-1;134;0;0;0;0;.00nan;0;0
12358;199430;136;0;0;0;0;.00nan;0;0
12358;199701;138;70;26;2;24;.923;3600000;0
12358;201530;136;57;36;4;32;.889;3516000;0
12358;201661;138;0;0;0;0;.00nan;0;0
12359;203276;139;80;31;1;30;.968;3600000;0
12359;199587;140;0;0;0;0;.00nan;0;0
12359;204668;140;74;32;3;29;.906;3565000;0
12359;204938;139;0;0;0;0;.00nan;0;0
12360;198081;133;53;34;4;30;.882;3600000;0
12360;208609;131;50;30;5;25;.833;3581000;0
12360;202059;133;0;0;0;0;.00nan;0;0
12360;-1;131;0;0;0;0;.00nan;0;0
12361;210060;137;0;0;0;0;.00nan;0;0
12361;-1;137;49;38;6;32;.842;3600000;0
12361;208201;143;58;19;2;17;.895;3600000;0
12361;-1;143;0;0;0;0;.00nan;0;0
12362;203276;139;51;32;4;28;.875;3600000;0
12362;199587;140;59;7;0;7;1.000;512000;0
12362;204668;140;35;32;6;26;.813;3062000;0
12362;204938;139;0;0;0;0;.00nan;0;0
12363;199437;134;100;30;0;30;1.000;3600000;0
12363;208201;143;0;0;0;0;.00nan;0;0
12363;-1;143;61;33;4;29;.879;3600000;0
12363;-1;134;0;0;0;0;.00nan;0;0
12364;198091;132;88;17;0;17;1.000;3600000;0
12364;207313;132;0;0;0;0;.00nan;0;0
12364;-1;128;26;20;5;15;.750;2222000;0
12364;-1;128;41;9;2;7;.778;1378000;0
12365;204873;129;51;18;3;15;.833;3600000;0
12365;201666;1340;57;6;0;6;1.000;1209000;0
12365;202045;1340;62;36;4;32;.889;2383000;0
12365;-1;129;0;0;0;0;.00nan;0;0
12366;210060;137;68;41;5;36;.878;3707000;0
12366;-1;137;0;0;0;0;.00nan;0;0
12366;-1;144;0;0;0;0;.00nan;0;0
12366;-1;144;52;26;4;22;.846;3707000;0
12367;203288;135;0;0;0;0;.00nan;0;0
12367;208556;135;92;38;2;36;.947;3596000;0
12367;200436;130;97;32;1;31;.969;3600000;0
12367;-1;130;0;0;0;0;.00nan;0;0
12368;208609;131;0;0;0;0;.00nan;0;0
12368;199701;138;0;0;0;0;.00nan;0;0
12368;201661;138;53;37;5;32;.865;3600000;0
12368;-1;131;95;40;1;39;.975;3600000;0
12369;198081;133;0;0;0;0;.00nan;0;0
12369;199430;136;0;0;0;0;.00nan;0;0
12369;201530;136;66;22;2;20;.909;3651000;0
12369;202059;133;93;34;1;33;.971;3651000;0
12370;201666;1340;53;21;3;18;.857;3600000;0
12370;202045;1340;0;0;0;0;.00nan;0;0
12370;-1;128;0;0;0;0;.00nan;0;0
12370;-1;128;63;45;4;41;.911;3600000;0
12371;203288;135;65;37;5;32;.865;3600000;0
12371;208556;135;0;0;0;0;.00nan;0;0
12371;208201;143;37;34;6;28;.824;3573000;0
12371;-1;143;0;0;0;0;.00nan;0;0
12372;200436;130;0;0;0;0;.00nan;0;0
12372;-1;144;53;23;3;20;.870;3600000;0
12372;-1;130;100;35;0;35;1.000;3600000;0
12372;-1;144;0;0;0;0;.00nan;0;0
12373;208575;142;0;0;0;0;.00nan;0;0
12373;210004;141;0;0;0;0;.00nan;0;0
12373;201673;141;62;24;3;21;.875;3600000;0
12373;196456;142;52;33;5;28;.848;3584000;0
12374;198091;132;26;27;7;20;.741;2282000;0
12374;204873;129;0;0;0;0;.00nan;0;0
12374;207313;132;65;9;0;9;1.000;1318000;0
12374;-1;129;75;23;1;22;.957;3600000;0
12375;208575;142;71;39;4;35;.897;3600000;0
12375;199587;140;0;0;0;0;.00nan;0;0
12375;204668;140;100;38;0;38;1.000;3600000;0
12375;196456;142;0;0;0;0;.00nan;0;0
12376;203276;139;63;48;7;41;.854;3600000;0
12376;210004;141;31;15;4;11;.733;2627000;0
12376;204938;139;0;0;0;0;.00nan;0;0
12376;201673;141;17;7;4;3;.429;922000;0
12377;199437;134;84;21;0;21;1.000;3600000;0
12377;210060;137;0;0;0;0;.00nan;0;0
12377;-1;137;70;44;6;38;.864;3600000;0
12377;-1;134;0;0;0;0;.00nan;0;0
12378;198081;133;0;0;0;0;.00nan;0;0
12378;199430;136;78;43;4;39;.907;3600000;0
12378;201530;136;0;0;0;0;.00nan;0;0
12378;202059;133;96;21;0;21;1.000;3600000;0
12379;208609;131;60;25;3;22;.880;3600000;0
12379;199701;138;51;28;4;24;.857;3565000;0
12379;201661;138;0;0;0;0;.00nan;0;0
12379;-1;131;0;0;0;0;.00nan;0;0
12380;198091;132;0;0;0;0;.00nan;0;0
12380;201666;1340;47;25;4;21;.840;3598000;0
12380;202045;1340;0;0;0;0;.00nan;0;0
12380;207313;132;89;35;2;33;.943;3600000;0
12381;210004;141;0;0;0;0;.00nan;0;0
12381;201673;141;95;30;1;29;.967;3900000;0
12381;-1;144;0;0;0;0;.00nan;0;0
12381;-1;144;91;33;1;32;.970;3900000;0
12382;204873;129;95;35;2;33;.943;3600000;0
12382;-1;129;0;0;0;0;.00nan;0;0
12382;-1;128;53;3;0;3;1.000;870000;0
12382;-1;128;44;35;6;29;.829;2730000;0
12383;199437;134;61;40;5;35;.875;3600000;0
12383;208201;143;18;23;6;17;.739;3350000;0
12383;-1;143;55;5;0;5;1.000;221000;0
12383;-1;134;0;0;0;0;.00nan;0;0
12384;203288;135;53;23;4;19;.826;3600000;0
12384;208556;135;0;0;0;0;.00nan;0;0
12384;199587;140;0;0;0;0;.00nan;0;0
12384;204668;140;100;26;0;26;1.000;3600000;0
12385;203276;139;64;31;3;28;.903;3571000;0
12385;199430;136;61;25;2;23;.920;3600000;0
12385;204938;139;0;0;0;0;.00nan;0;0
12385;201530;136;0;0;0;0;.00nan;0;0
12386;203288;135;0;0;0;0;.00nan;0;0
12386;208556;135;81;51;5;46;.902;3570000;0
12386;-1;144;0;0;0;0;.00nan;0;0
12386;-1;144;65;32;4;28;.875;3600000;0
12387;199430;136;0;0;0;0;.00nan;0;0
12387;199587;140;0;0;0;0;.00nan;0;0
12387;204668;140;77;43;4;39;.907;3600000;0
12387;201530;136;38;25;5;20;.800;3577000;0
12388;204873;129;69;45;5;40;.889;3600000;0
12388;201666;1340;26;20;5;15;.750;1902000;0
12388;202045;1340;50;11;2;9;.818;1630000;0
12388;-1;129;0;0;0;0;.00nan;0;0
12389;200436;130;0;0;0;0;.00nan;0;0
12389;-1;130;81;32;2;30;.938;3600000;0
12389;-1;128;0;0;0;0;.00nan;0;0
12389;-1;128;55;27;3;24;.889;3549000;0
12390;208609;131;66;32;3;29;.906;3600000;0
12390;210060;137;0;0;0;0;.00nan;0;0
12390;-1;137;69;37;4;33;.892;3565000;0
12390;-1;131;0;0;0;0;.00nan;0;0
12391;198091;132;72;17;1;16;.941;3600000;0
12391;199701;138;0;0;0;0;.00nan;0;0
12391;201661;138;65;37;4;33;.892;3600000;0
12391;207313;132;0;0;0;0;.00nan;0;0
12392;199701;138;84;32;2;30;.938;3600000;0
12392;201661;138;0;0;0;0;.00nan;0;0
12392;-1;128;47;30;4;26;.867;3600000;0
12392;-1;128;0;0;0;0;.00nan;0;0
12393;198081;133;0;0;0;0;.00nan;0;0
12393;198091;132;0;0;0;0;.00nan;0;0
12393;202059;133;65;42;6;36;.857;3581000;0
12393;207313;132;36;20;4;16;.800;3600000;0
12394;200436;130;39;43;7;36;.837;3224000;0
12394;201666;1340;37;38;7;31;.816;3359000;0
12394;202045;1340;40;2;1;1;.500;216000;0
12394;-1;130;60;8;0;8;1.000;376000;0
12395;199430;136;21;29;7;22;.759;2368000;0
12395;210004;141;0;0;0;0;.00nan;0;0
12395;201530;136;40;22;4;18;.818;1232000;0
12395;201673;141;67;20;1;19;.950;3600000;0
12396;208575;142;100;33;1;32;.970;3600000;0
12396;199437;134;27;14;4;10;.714;1656000;0
12396;196456;142;0;0;0;0;.00nan;0;0
12396;-1;134;11;17;6;11;.647;1944000;0
12397;203276;139;49;22;3;19;.864;3600000;0
12397;203288;135;35;28;6;22;.786;3600000;0
12397;208556;135;0;0;0;0;.00nan;0;0
12397;204938;139;0;0;0;0;.00nan;0;0
12398;208201;143;60;38;4;34;.895;3600000;0
12398;-1;144;0;0;0;0;.00nan;0;0
12398;-1;143;0;0;0;0;.00nan;0;0
12398;-1;144;61;40;5;35;.875;3577000;0
12399;199437;134;62;32;4;28;.875;3553000;0
12399;199587;140;0;0;0;0;.00nan;0;0
12399;204668;140;70;33;3;30;.909;3600000;0
12399;-1;134;0;0;0;0;.00nan;0;0
12400;208609;131;67;18;1;17;.944;3600000;0
12400;200436;130;0;0;0;0;.00nan;0;0
12400;-1;131;0;0;0;0;.00nan;0;0
12400;-1;130;80;38;3;35;.921;3521000;0
12401;208575;142;38;7;2;5;.714;1063000;0
12401;210004;141;0;0;0;0;.00nan;0;0
12401;201673;141;100;22;0;22;1.000;3600000;0
12401;196456;142;21;22;6;16;.727;2537000;0
12402;198081;133;46;40;5;35;.875;3600000;0
12402;198091;132;22;24;6;18;.750;3009000;0
12402;202059;133;0;0;0;0;.00nan;0;0
12402;207313;132;54;4;0;4;1.000;568000;0
12403;204873;129;67;30;3;27;.900;3600000;0
12403;210060;137;0;0;0;0;.00nan;0;0
12403;-1;137;61;39;5;34;.872;3600000;0
12403;-1;129;0;0;0;0;.00nan;0;0
12404;203276;139;32;33;7;26;.788;3600000;0
12404;199587;140;0;0;0;0;.00nan;0;0
12404;204668;140;94;18;0;18;1.000;3600000;0
12404;204938;139;0;0;0;0;.00nan;0;0
12405;210004;141;0;0;0;0;.00nan;0;0
12405;201673;141;71;17;1;16;.941;3600000;0
12405;-1;128;70;28;1;27;.964;1939000;0
12405;-1;128;14;20;6;14;.700;1661000;0
12406;199701;138;0;0;0;0;.00nan;0;0
12406;208201;143;0;0;0;0;.00nan;0;0
12406;-1;143;70;24;2;22;.917;3900000;0
12406;-1;138;100;53;2;51;.962;3900000;0
12407;208575;142;47;30;5;25;.833;3600000;0
12407;196456;142;0;0;0;0;.00nan;0;0
12407;-1;144;86;25;1;24;.960;3600000;0
12407;-1;144;0;0;0;0;.00nan;0;0
12408;203276;139;0;0;0;0;.00nan;0;0
12408;204938;139;99;35;1;34;.971;3600000;0
12408;210060;137;0;0;0;0;.00nan;0;0
12408;-1;137;46;19;3;16;.842;3574000;0
12409;198081;133;0;0;0;0;.00nan;0;0
12409;198091;132;0;0;0;0;.00nan;0;0
12409;202059;133;57;40;5;35;.875;3600000;0
12409;207313;132;81;29;2;27;.931;3600000;0
12410;203288;135;76;40;4;36;.900;3564000;0
12410;208556;135;0;0;0;0;.00nan;0;0
12410;210004;141;0;0;0;0;.00nan;0;0
12410;201673;141;100;37;2;35;.946;3600000;0
12411;208609;131;10;14;6;8;.571;2528000;0
12411;204873;129;33;34;6;28;.824;3065000;0
12411;-1;129;63;12;0;12;1.000;535000;0
12411;-1;131;52;12;1;11;.917;1023000;0
12412;199587;140;0;0;0;0;.00nan;0;0
12412;204668;140;82;24;1;23;.958;3600000;0
12412;210060;137;43;37;6;31;.838;3600000;0
12412;-1;137;0;0;0;0;.00nan;0;0
12413;199430;136;0;0;0;0;.00nan;0;0
12413;200436;130;59;41;5;36;.878;3600000;0
12413;201530;136;61;23;3;20;.870;3600000;0
12413;-1;130;0;0;0;0;.00nan;0;0
12414;198081;133;80;46;5;41;.891;3600000;0
12414;201666;1340;89;30;1;29;.967;3600000;0
12414;202045;1340;0;0;0;0;.00nan;0;0
12414;202059;133;0;0;0;0;.00nan;0;0
12415;199437;134;86;30;1;29;.967;3600000;0
12415;-1;134;0;0;0;0;.00nan;0;0
12415;-1;128;0;0;0;0;.00nan;0;0
12415;-1;128;47;24;3;21;.875;3511000;0
12416;199430;136;59;49;6;43;.878;3607000;0
12416;210004;141;0;0;0;0;.00nan;0;0
12416;201530;136;0;0;0;0;.00nan;0;0
12416;201673;141;21;26;7;19;.731;3570000;0
12417;198091;132;87;45;4;41;.911;3600000;0
12417;204873;129;0;0;0;0;.00nan;0;0
12417;207313;132;0;0;0;0;.00nan;0;0
12417;-1;129;90;19;0;19;1.000;3600000;0
12418;198081;133;0;0;0;0;.00nan;0;0
12418;201666;1340;0;0;0;0;.00nan;0;0
12418;202045;1340;43;21;4;17;.810;3600000;0
12418;202059;133;44;35;5;30;.857;3555000;0
12419;203288;135;66;28;3;25;.893;3600000;0
12419;208556;135;0;0;0;0;.00nan;0;0
12419;208609;131;38;31;6;25;.806;3600000;0
12419;-1;131;0;0;0;0;.00nan;0;0
12420;210060;137;0;0;0;0;.00nan;0;0
12420;-1;137;83;42;3;39;.929;3900000;0
12420;-1;144;78;32;3;29;.906;3900000;0
12420;-1;144;0;0;0;0;.00nan;0;0
12421;203276;139;90;43;3;40;.930;3900000;0
12421;204938;139;0;0;0;0;.00nan;0;0
12421;208201;143;72;30;3;27;.900;3900000;0
12421;-1;143;0;0;0;0;.00nan;0;0
12422;208575;142;0;0;0;0;.00nan;0;0
12422;199701;138;0;0;0;0;.00nan;0;0
12422;196456;142;58;25;3;22;.880;3600000;0
12422;-1;138;63;40;4;36;.900;3561000;0
12423;208575;142;86;36;2;34;.944;3600000;0
12423;196456;142;0;0;0;0;.00nan;0;0
12423;208201;143;0;0;0;0;.00nan;0;0
12423;-1;143;41;27;4;23;.852;3600000;0
12424;199587;140;0;0;0;0;.00nan;0;0
12424;199701;138;68;57;7;50;.877;3600000;0
12424;204668;140;67;31;4;27;.871;3600000;0
12424;-1;138;0;0;0;0;.00nan;0;0
12425;199437;134;83;26;1;25;.962;3600000;0
12425;200436;130;61;28;3;25;.893;3600000;0
12425;-1;130;0;0;0;0;.00nan;0;0
12425;-1;134;0;0;0;0;.00nan;0;0
12426;204873;129;0;0;0;0;.00nan;0;0
12426;-1;129;47;33;5;28;.848;3581000;0
12426;-1;128;0;0;0;0;.00nan;0;0
12426;-1;128;65;36;4;32;.889;3600000;0
12427;198091;132;0;0;0;0;.00nan;0;0
12427;208609;131;0;0;0;0;.00nan;0;0
12427;207313;132;31;29;6;23;.793;3582000;0
12427;-1;131;61;34;4;30;.882;3600000;0
12428;208609;131;0;0;0;0;.00nan;0;0
12428;-1;144;99;37;1;36;.973;3600000;0
12428;-1;131;77;40;3;37;.925;3594000;0
12428;-1;144;0;0;0;0;.00nan;0;0
12429;210004;141;0;0;0;0;.00nan;0;0
12429;201673;141;95;38;3;35;.921;3900000;0
12429;208201;143;83;48;3;45;.938;3900000;0
12429;-1;143;0;0;0;0;.00nan;0;0
12430;208575;142;0;0;0;0;.00nan;0;0
12430;199587;140;0;0;0;0;.00nan;0;0
12430;204668;140;58;25;3;22;.880;3600000;0
12430;196456;142;86;36;2;34;.944;3600000;0
12431;198081;133;0;0;0;0;.00nan;0;0
12431;199701;138;0;0;0;0;.00nan;0;0
12431;202059;133;67;38;4;34;.895;3600000;0
12431;-1;138;60;46;6;40;.870;3567000;0
12432;204873;129;70;27;2;25;.926;3600000;0
12432;200436;130;71;43;4;39;.907;3600000;0
12432;-1;129;0;0;0;0;.00nan;0;0
12432;-1;130;0;0;0;0;.00nan;0;0
12433;199430;136;75;51;5;46;.902;3600000;0
12433;201530;136;0;0;0;0;.00nan;0;0
12433;201666;1340;62;23;2;21;.913;3600000;0
12433;202045;1340;0;0;0;0;.00nan;0;0
12434;203276;139;63;30;3;27;.900;3900000;0
12434;204938;139;0;0;0;0;.00nan;0;0
12434;210060;137;0;0;0;0;.00nan;0;0
12434;-1;137;49;20;3;17;.850;3900000;0
12435;203288;135;48;19;3;16;.842;3546000;0
12435;208556;135;0;0;0;0;.00nan;0;0
12435;-1;128;66;31;2;29;.935;3600000;0
12435;-1;128;0;0;0;0;.00nan;0;0
12436;198081;133;85;28;2;26;.929;3600000;0
12436;199437;134;47;25;4;21;.840;3558000;0
12436;202059;133;0;0;0;0;.00nan;0;0
12436;-1;134;0;0;0;0;.00nan;0;0
12437;210060;137;45;25;4;21;.840;3600000;0
12437;-1;137;0;0;0;0;.00nan;0;0
12437;-1;128;55;41;6;35;.854;3569000;0
12437;-1;128;0;0;0;0;.00nan;0;0
12438;203276;139;100;38;1;37;.974;3600000;0
12438;203288;135;0;0;0;0;.00nan;0;0
12438;208556;135;61;32;4;28;.875;3600000;0
12438;204938;139;0;0;0;0;.00nan;0;0
12439;208609;131;100;30;0;30;1.000;3600000;0
12439;199587;140;42;29;5;24;.828;3600000;0
12439;204668;140;0;0;0;0;.00nan;0;0
12439;-1;131;0;0;0;0;.00nan;0;0
12440;198091;132;80;30;2;28;.933;3600000;0
12440;199430;136;0;0;0;0;.00nan;0;0
12440;201530;136;35;26;5;21;.808;3600000;0
12440;207313;132;0;0;0;0;.00nan;0;0
12441;199587;140;0;0;0;0;.00nan;0;0
12441;204668;140;47;35;5;30;.857;3600000;0
12441;-1;144;0;0;0;0;.00nan;0;0
12441;-1;144;70;27;2;25;.926;3600000;0
12442;208575;142;0;0;0;0;.00nan;0;0
12442;196456;142;100;27;0;27;1.000;3600000;0
12442;208201;143;0;0;0;0;.00nan;0;0
12442;-1;143;78;25;1;24;.960;3600000;0
12443;203276;139;0;0;0;0;.00nan;0;0
12443;204873;129;57;20;2;18;.900;3600000;0
12443;204938;139;72;37;4;33;.892;3595000;0
12443;-1;129;0;0;0;0;.00nan;0;0
12444;199430;136;62;44;5;39;.886;3574000;0
12444;201530;136;0;0;0;0;.00nan;0;0
12444;201666;1340;44;15;3;12;.800;3600000;0
12444;202045;1340;0;0;0;0;.00nan;0;0
12445;208609;131;68;38;3;35;.921;3600000;0
12445;210004;141;0;0;0;0;.00nan;0;0
12445;201673;141;70;18;1;17;.944;3600000;0
12445;-1;131;0;0;0;0;.00nan;0;0
12446;199437;134;49;7;1;6;.857;1224000;0
12446;199701;138;0;0;0;0;.00nan;0;0
12446;-1;134;21;23;6;17;.739;2376000;0
12446;-1;138;62;31;3;28;.903;3600000;0
12447;198091;132;0;0;0;0;.00nan;0;0
12447;210060;137;0;0;0;0;.00nan;0;0
12447;207313;132;68;18;1;17;.944;3600000;0
12447;-1;137;54;44;5;39;.886;3600000;0
12448;199437;134;56;37;6;31;.838;3600000;0
12448;204873;129;80;35;2;33;.943;3600000;0
12448;-1;129;0;0;0;0;.00nan;0;0
12448;-1;134;0;0;0;0;.00nan;0;0
12449;210060;137;55;43;6;37;.860;3176000;0
12449;201666;1340;78;27;1;26;.963;3600000;0
12449;202045;1340;0;0;0;0;.00nan;0;0
12449;-1;137;57;5;0;5;1.000;424000;0
12450;198091;132;76;33;3;30;.909;3600000;0
12450;207313;132;0;0;0;0;.00nan;0;0
12450;-1;128;57;32;4;28;.875;3544000;0
12450;-1;128;0;0;0;0;.00nan;0;0
12451;198081;133;0;0;0;0;.00nan;0;0
12451;200436;130;86;46;4;42;.913;3600000;0
12451;202059;133;29;26;6;20;.769;3557000;0
12451;-1;130;0;0;0;0;.00nan;0;0
12452;203288;135;21;25;6;19;.760;3564000;0
12452;208556;135;0;0;0;0;.00nan;0;0
12452;208575;142;0;0;0;0;.00nan;0;0
12452;196456;142;95;41;3;38;.927;3600000;0
12453;199701;138;0;0;0;0;.00nan;0;0
12453;204873;129;0;0;0;0;.00nan;0;0
12453;-1;129;53;17;2;15;.882;3600000;0
12453;-1;138;71;32;3;29;.906;3600000;0
12454;203276;139;49;27;4;23;.852;3900000;0
12454;204938;139;0;0;0;0;.00nan;0;0
12454;-1;144;61;30;4;26;.867;3900000;0
12454;-1;144;0;0;0;0;.00nan;0;0
12455;199587;140;47;6;1;5;.833;643000;0
12455;204668;140;40;35;6;29;.829;2957000;0
12455;208201;143;80;35;3;32;.914;3600000;0
12455;-1;143;0;0;0;0;.00nan;0;0
12456;198081;133;71;33;3;30;.909;3600000;0
12456;199437;134;61;35;4;31;.886;3554000;0
12456;202059;133;0;0;0;0;.00nan;0;0
12456;-1;134;0;0;0;0;.00nan;0;0
12457;208575;142;50;20;3;17;.850;3600000;0
12457;200436;130;53;3;0;3;1.000;399000;0
12457;196456;142;0;0;0;0;.00nan;0;0
12457;-1;130;70;45;4;41;.911;3201000;0
12458;203288;135;0;0;0;0;.00nan;0;0
12458;198091;132;0;0;0;0;.00nan;0;0
12458;208556;135;40;27;5;22;.815;3585000;0
12458;207313;132;56;31;4;27;.871;3600000;0
12459;208609;131;61;19;2;17;.895;3545000;0
12459;201666;1340;66;15;1;14;.933;3600000;0
12459;202045;1340;0;0;0;0;.00nan;0;0
12459;-1;131;0;0;0;0;.00nan;0;0
12460;198081;133;0;0;0;0;.00nan;0;0
12460;199437;134;0;0;0;0;.00nan;0;0
12460;202059;133;60;31;3;28;.903;3520000;0
12460;-1;134;66;18;1;17;.944;3600000;0
12461;204873;129;7;22;7;15;.682;3600000;0
12461;201666;1340;0;0;0;0;.00nan;0;0
12461;202045;1340;50;27;4;23;.852;3600000;0
12461;-1;129;0;0;0;0;.00nan;0;0
12462;199430;136;0;0;0;0;.00nan;0;0
12462;201530;136;68;41;5;36;.878;3545000;0
12462;-1;128;73;33;3;30;.909;3600000;0
12462;-1;128;0;0;0;0;.00nan;0;0
12463;208575;142;0;0;0;0;.00nan;0;0
12463;210060;137;0;0;0;0;.00nan;0;0
12463;196456;142;54;25;3;22;.880;3600000;0
12463;-1;137;62;33;4;29;.879;3557000;0
12464;210004;141;0;0;0;0;.00nan;0;0
12464;201673;141;100;44;2;42;.955;3600000;0
12464;-1;144;0;0;0;0;.00nan;0;0
12464;-1;144;62;36;4;32;.889;3544000;0
12465;199587;140;0;0;0;0;.00nan;0;0
12465;204668;140;72;38;4;34;.895;3600000;0
12465;208201;143;0;0;0;0;.00nan;0;0
12465;-1;143;83;31;1;30;.968;3600000;0
12466;199430;136;73;41;3;38;.927;3600000;0
12466;201530;136;0;0;0;0;.00nan;0;0
12466;-1;128;54;31;4;27;.871;3553000;0
12466;-1;128;0;0;0;0;.00nan;0;0
12467;198091;132;54;31;4;27;.871;3600000;0
12467;208609;131;77;34;3;31;.912;3600000;0
12467;207313;132;0;0;0;0;.00nan;0;0
12467;-1;131;0;0;0;0;.00nan;0;0
12468;203276;139;65;42;5;37;.881;3849000;0
12468;210004;141;0;0;0;0;.00nan;0;0
12468;204938;139;0;0;0;0;.00nan;0;0
12468;201673;141;53;29;4;25;.862;3849000;0
12469;199701;138;0;0;0;0;.00nan;0;0
12469;210060;137;71;32;3;29;.906;3600000;0
12469;-1;137;0;0;0;0;.00nan;0;0
12469;-1;138;81;50;5;45;.900;3566000;0
12470;203288;135;68;26;2;24;.923;3600000;0
12470;208556;135;0;0;0;0;.00nan;0;0
12470;200436;130;35;32;6;26;.813;3010000;0
12470;-1;130;50;9;1;8;.889;590000;0
12471;204873;129;92;39;2;37;.949;3600000;0
12471;-1;129;0;0;0;0;.00nan;0;0
12471;-1;144;25;32;7;25;.781;3600000;0
12471;-1;144;0;0;0;0;.00nan;0;0
12472;198081;133;0;0;0;0;.00nan;0;0
12472;210004;141;80;16;0;16;1.000;2942000;0
12472;201673;141;29;13;4;9;.692;658000;0
12472;202059;133;63;41;5;36;.878;3556000;0
12473;199430;136;0;0;0;0;.00nan;0;0
12473;201530;136;65;31;3;28;.903;3600000;0
12473;208201;143;41;24;4;20;.833;3564000;0
12473;-1;143;0;0;0;0;.00nan;0;0
12474;203276;139;93;58;4;54;.931;3900000;0
12474;208575;142;63;17;1;16;.941;3489000;0
12474;204938;139;0;0;0;0;.00nan;0;0
12474;196456;142;27;7;3;4;.571;411000;0
12475;198091;132;0;0;0;0;.00nan;0;0
12475;207313;132;80;36;3;33;.917;3600000;0
12475;-1;144;74;24;1;23;.958;3600000;0
12475;-1;144;0;0;0;0;.00nan;0;0
12476;203288;135;41;20;4;16;.800;3600000;0
12476;208556;135;0;0;0;0;.00nan;0;0
12476;-1;128;56;41;5;36;.878;3582000;0
12476;-1;128;0;0;0;0;.00nan;0;0
12477;203276;139;92;43;2;41;.953;3600000;0
12477;199587;140;0;0;0;0;.00nan;0;0
12477;204668;140;48;20;3;17;.850;3544000;0
12477;204938;139;0;0;0;0;.00nan;0;0
12478;198081;133;64;28;3;25;.893;3653000;0
12478;202059;133;0;0;0;0;.00nan;0;0
12478;208201;143;70;43;4;39;.907;3653000;0
12478;-1;143;0;0;0;0;.00nan;0;0
12479;199430;136;63;39;4;35;.897;3552000;0
12479;204873;129;73;27;2;25;.926;3600000;0
12479;201530;136;0;0;0;0;.00nan;0;0
12479;-1;129;0;0;0;0;.00nan;0;0
12480;201666;1340;25;7;3;4;.571;376000;0
12480;202045;1340;34;20;4;16;.800;3147000;0
12480;-1;144;0;0;0;0;.00nan;0;0
12480;-1;144;45;35;5;30;.857;3600000;0
12481;210060;137;0;0;0;0;.00nan;0;0
12481;200436;130;58;26;4;22;.846;3558000;0
12481;-1;137;74;38;3;35;.921;3600000;0
12481;-1;130;0;0;0;0;.00nan;0;0
12482;208609;131;20;24;6;18;.750;3648000;0
12482;199437;134;56;51;7;44;.863;3602000;0
12482;-1;131;0;0;0;0;.00nan;0;0
12482;-1;134;0;0;0;0;.00nan;0;0
12483;199701;138;0;0;0;0;.00nan;0;0
12483;210004;141;0;0;0;0;.00nan;0;0
12483;201673;141;90;32;1;31;.969;3600000;0
12483;-1;138;84;41;3;38;.927;3597000;0
12484;199701;138;73;47;5;42;.894;3900000;0
12484;208201;143;43;39;5;34;.872;3900000;0
12484;-1;143;0;0;0;0;.00nan;0;0
12484;-1;138;0;0;0;0;.00nan;0;0
12485;199430;136;0;0;0;0;.00nan;0;0
12485;204873;129;0;0;0;0;.00nan;0;0
12485;201530;136;62;43;5;38;.884;3600000;0
12485;-1;129;73;31;2;29;.935;3600000;0
12486;203288;135;44;26;4;22;.846;3563000;0
12486;208556;135;0;0;0;0;.00nan;0;0
12486;201666;1340;73;26;2;24;.923;3600000;0
12486;202045;1340;0;0;0;0;.00nan;0;0
12487;208609;131;0;0;0;0;.00nan;0;0
12487;-1;131;55;34;5;29;.853;3824000;0
12487;-1;128;0;0;0;0;.00nan;0;0
12487;-1;128;52;42;6;36;.857;3833000;0
12488;210004;141;0;0;0;0;.00nan;0;0
12488;200436;130;0;0;0;0;.00nan;0;0
12488;201673;141;37;12;4;8;.667;3900000;0
12488;-1;130;68;40;4;36;.900;3900000;0
12489;208575;142;0;0;0;0;.00nan;0;0
12489;199587;140;0;0;0;0;.00nan;0;0
12489;204668;140;77;38;3;35;.921;3600000;0
12489;196456;142;83;26;1;25;.962;3600000;0
12490;199437;134;73;37;5;32;.865;3797000;0
12490;210060;137;0;0;0;0;.00nan;0;0
12490;-1;137;37;19;4;15;.789;3797000;0
12490;-1;134;0;0;0;0;.00nan;0;0
12491;203288;135;68;40;5;35;.875;3600000;0
12491;198091;132;66;15;2;13;.867;3600000;0
12491;208556;135;0;0;0;0;.00nan;0;0
12491;207313;132;0;0;0;0;.00nan;0;0
12492;199437;134;99;23;0;23;1.000;3600000;0
12492;199701;138;0;0;0;0;.00nan;0;0
12492;-1;134;0;0;0;0;.00nan;0;0
12492;-1;138;84;33;2;31;.939;3538000;0
12493;210004;141;0;0;0;0;.00nan;0;0
12493;201673;141;89;33;3;30;.909;3568000;0
12493;208201;143;100;43;2;41;.953;3600000;0
12493;-1;143;0;0;0;0;.00nan;0;0
12494;203276;139;56;26;3;23;.885;3600000;0
12494;204938;139;0;0;0;0;.00nan;0;0
12494;-1;128;58;27;4;23;.852;3600000;0
12494;-1;128;0;0;0;0;.00nan;0;0
12495;200436;130;66;36;4;32;.889;3534000;0
12495;201666;1340;65;22;2;20;.909;3600000;0
12495;202045;1340;0;0;0;0;.00nan;0;0
12495;-1;130;0;0;0;0;.00nan;0;0
12496;208609;131;43;30;4;26;.867;3745000;0
12496;199430;136;80;46;5;41;.891;3745000;0
12496;201530;136;0;0;0;0;.00nan;0;0
12496;-1;131;0;0;0;0;.00nan;0;0
12497;199701;138;0;0;0;0;.00nan;0;0
12497;210060;137;0;0;0;0;.00nan;0;0
12497;-1;137;30;25;5;20;.800;3600000;0
12497;-1;138;66;31;3;28;.903;3600000;0
12498;204873;129;41;36;6;30;.833;3249000;0
12498;210004;141;60;26;3;23;.885;3600000;0
12498;201673;141;0;0;0;0;.00nan;0;0
12498;-1;129;42;5;1;4;.800;351000;0
12499;-1;144;47;26;4;22;.846;3535000;0
12499;-1;128;0;0;0;0;.00nan;0;0
12499;-1;144;0;0;0;0;.00nan;0;0
12499;-1;128;88;38;2;36;.947;3600000;0
12500;208575;142;0;0;0;0;.00nan;0;0
12500;196456;142;85;27;1;26;.963;3600000;0
12500;208201;143;89;42;3;39;.929;3514000;0
12500;-1;143;0;0;0;0;.00nan;0;0
12501;198081;133;0;0;0;0;.00nan;0;0
12501;210060;137;0;0;0;0;.00nan;0;0
12501;202059;133;67;18;1;17;.944;3600000;0
12501;-1;137;52;34;5;29;.853;3600000;0
12502;198091;132;53;3;0;3;1.000;438000;0
12502;199437;134;83;35;3;32;.914;3600000;0
12502;207313;132;39;20;4;16;.800;3140000;0
12502;-1;134;0;0;0;0;.00nan;0;0
12503;203288;135;93;36;2;34;.944;3763000;0
12503;208556;135;0;0;0;0;.00nan;0;0
12503;201666;1340;0;0;0;0;.00nan;0;0
12503;202045;1340;67;31;3;28;.903;3763000;0
12504;208609;131;0;0;0;0;.00nan;0;0
12504;200436;130;0;0;0;0;.00nan;0;0
12504;-1;131;58;35;4;31;.886;3531000;0
12504;-1;130;81;30;2;28;.933;3600000;0
12505;199430;136;0;0;0;0;.00nan;0;0
12505;199701;138;0;0;0;0;.00nan;0;0
12505;201530;136;74;31;3;28;.903;3600000;0
12505;-1;138;44;33;5;28;.848;3534000;0
12506;199587;140;0;0;0;0;.00nan;0;0
12506;204668;140;48;20;4;16;.800;3672000;0
12506;-1;128;78;38;3;35;.921;3672000;0
12506;-1;128;0;0;0;0;.00nan;0;0
12507;203276;139;57;47;6;41;.872;3600000;0
12507;204873;129;0;0;0;0;.00nan;0;0
12507;204938;139;0;0;0;0;.00nan;0;0
12507;-1;129;86;23;1;22;.957;3600000;0
12508;198091;132;68;26;2;24;.923;3600000;0
12508;199437;134;69;15;0;15;1.000;877000;0
12508;207313;132;0;0;0;0;.00nan;0;0
12508;-1;134;40;36;6;30;.833;2723000;0
12509;204873;129;28;31;6;25;.806;3600000;0
12509;-1;129;0;0;0;0;.00nan;0;0
12509;-1;144;0;0;0;0;.00nan;0;0
12509;-1;144;78;21;1;20;.952;3600000;0
12510;208575;142;0;0;0;0;.00nan;0;0
12510;210004;141;0;0;0;0;.00nan;0;0
12510;201673;141;66;23;2;21;.913;3600000;0
12510;196456;142;83;51;4;47;.922;3555000;0
12511;208609;131;63;26;3;23;.885;3600000;0
12511;199430;136;45;41;6;35;.854;3600000;0
12511;201530;136;0;0;0;0;.00nan;0;0
12511;-1;131;0;0;0;0;.00nan;0;0
12512;199437;134;73;29;3;26;.897;3900000;0
12512;201666;1340;79;32;3;29;.906;3900000;0
12512;202045;1340;0;0;0;0;.00nan;0;0
12512;-1;134;0;0;0;0;.00nan;0;0
12513;210060;137;0;0;0;0;.00nan;0;0
12513;200436;130;46;46;7;39;.848;3593000;0
12513;-1;137;38;26;5;21;.808;3600000;0
12513;-1;130;0;0;0;0;.00nan;0;0
12514;203288;135;64;21;2;19;.905;3555000;0
12514;198081;133;0;0;0;0;.00nan;0;0
12514;208556;135;0;0;0;0;.00nan;0;0
12514;202059;133;90;34;1;33;.971;3600000;0
12515;208575;142;0;0;0;0;.00nan;0;0
12515;210004;141;0;0;0;0;.00nan;0;0
12515;201673;141;71;29;3;26;.897;3600000;0
12515;196456;142;70;46;5;41;.891;3600000;0
12516;199587;140;71;27;2;25;.926;3600000;0
12516;204668;140;0;0;0;0;.00nan;0;0
12516;-1;144;55;26;3;23;.885;3600000;0
12516;-1;144;0;0;0;0;.00nan;0;0
12517;203276;139;91;53;5;48;.906;3835000;0
12517;204938;139;0;0;0;0;.00nan;0;0
12517;208201;143;63;35;4;31;.886;3835000;0
12517;-1;143;0;0;0;0;.00nan;0;0
12518;210004;141;0;0;0;0;.00nan;0;0
12518;201673;141;84;35;2;33;.943;3900000;0
12518;-1;144;78;32;2;30;.938;3900000;0
12518;-1;144;0;0;0;0;.00nan;0;0
12519;203288;135;67;41;5;36;.878;3533000;0
12519;198081;133;66;28;3;25;.893;3600000;0
12519;208556;135;0;0;0;0;.00nan;0;0
12519;202059;133;0;0;0;0;.00nan;0;0
12520;204873;129;52;33;4;29;.879;3610000;0
12520;-1;129;0;0;0;0;.00nan;0;0
12520;-1;128;67;32;3;29;.906;3610000;0
12520;-1;128;0;0;0;0;.00nan;0;0
12521;198091;132;0;0;0;0;.00nan;0;0
12521;201666;1340;37;37;6;31;.838;3587000;0
12521;202045;1340;0;0;0;0;.00nan;0;0
12521;207313;132;52;30;4;26;.867;3600000;0
12522;208575;142;0;0;0;0;.00nan;0;0
12522;208609;131;31;22;6;16;.727;3600000;0
12522;196456;142;79;47;4;43;.915;3600000;0
12522;-1;131;0;0;0;0;.00nan;0;0
12523;199430;136;0;0;0;0;.00nan;0;0
12523;199701;138;0;0;0;0;.00nan;0;0
12523;201530;136;76;35;3;32;.914;3600000;0
12523;-1;138;49;27;5;22;.815;3521000;0
12524;203276;139;82;33;2;31;.939;3563000;0
12524;199437;134;80;30;1;29;.967;3600000;0
12524;204938;139;0;0;0;0;.00nan;0;0
12524;-1;134;0;0;0;0;.00nan;0;0
12525;208575;142;0;0;0;0;.00nan;0;0
12525;204873;129;37;6;2;4;.667;535000;0
12525;196456;142;66;43;5;38;.884;3600000;0
12525;-1;129;13;27;7;20;.741;3065000;0
12526;210060;137;73;27;2;25;.926;3600000;0
12526;200436;130;9;34;8;26;.765;3600000;0
12526;-1;137;0;0;0;0;.00nan;0;0
12526;-1;130;0;0;0;0;.00nan;0;0
12527;203288;135;99;52;2;50;.962;3600000;0
12527;208556;135;0;0;0;0;.00nan;0;0
12527;199701;138;65;35;4;31;.886;3556000;0
12527;-1;138;0;0;0;0;.00nan;0;0
12528;198081;133;0;0;0;0;.00nan;0;0
12528;199430;136;0;0;0;0;.00nan;0;0
12528;201530;136;55;31;3;28;.903;3900000;0
12528;202059;133;61;29;3;26;.897;3900000;0
12529;198091;132;47;19;3;16;.842;3551000;0
12529;207313;132;0;0;0;0;.00nan;0;0
12529;-1;128;0;0;0;0;.00nan;0;0
12529;-1;128;93;30;1;29;.967;3600000;0
12530;203276;139;67;29;3;26;.897;3600000;0
12530;204938;139;0;0;0;0;.00nan;0;0
12530;200436;130;0;0;0;0;.00nan;0;0
12530;-1;130;41;36;6;30;.833;3600000;0
12531;208609;131;91;30;1;29;.967;3600000;0
12531;201666;1340;66;27;3;24;.889;3568000;0
12531;202045;1340;0;0;0;0;.00nan;0;0
12531;-1;131;0;0;0;0;.00nan;0;0
12532;199587;140;0;0;0;0;.00nan;0;0
12532;204668;140;100;42;2;40;.952;3600000;0
12532;210004;141;0;0;0;0;.00nan;0;0
12532;201673;141;64;35;4;31;.886;3566000;0
12533;208201;143;34;39;6;33;.846;3335000;0
12533;-1;144;63;20;3;17;.850;3600000;0
12533;-1;143;50;3;0;3;1.000;265000;0
12533;-1;144;0;0;0;0;.00nan;0;0
12534;208201;143;0;0;0;0;.00nan;0;0
12534;-1;144;0;0;0;0;.00nan;0;0
12534;-1;143;48;39;5;34;.872;3548000;0
12534;-1;144;59;26;3;23;.885;3600000;0
12535;199587;140;0;0;0;0;.00nan;0;0
12535;204668;140;68;27;2;25;.926;3600000;0
12535;210004;141;0;0;0;0;.00nan;0;0
12535;201673;141;50;53;7;46;.868;3600000;0
12536;208575;142;0;0;0;0;.00nan;0;0
12536;199437;134;65;37;4;33;.892;3600000;0
12536;196456;142;61;39;5;34;.872;3573000;0
12536;-1;134;0;0;0;0;.00nan;0;0
12537;201666;1340;0;0;0;0;.00nan;0;0
12537;202045;1340;50;15;2;13;.867;3600000;0
12537;-1;128;95;49;3;46;.939;3551000;0
12537;-1;128;0;0;0;0;.00nan;0;0
12538;203276;139;65;38;5;33;.868;3600000;0
12538;208609;131;0;0;0;0;.00nan;0;0
12538;204938;139;0;0;0;0;.00nan;0;0
12538;-1;131;75;21;1;20;.952;3600000;0
12539;198081;133;62;26;2;24;.923;3600000;0
12539;199430;136;56;35;5;30;.857;3600000;0
12539;201530;136;0;0;0;0;.00nan;0;0
12539;202059;133;0;0;0;0;.00nan;0;0
12540;203288;135;55;20;3;17;.850;3600000;0
12540;208556;135;0;0;0;0;.00nan;0;0
12540;210060;137;0;0;0;0;.00nan;0;0
12540;-1;137;56;37;5;32;.865;3558000;0
12541;198091;132;0;0;0;0;.00nan;0;0
12541;200436;130;69;31;2;29;.935;3900000;0
12541;207313;132;79;23;2;21;.913;3900000;0
12541;-1;130;0;0;0;0;.00nan;0;0
12542;208575;142;0;0;0;0;.00nan;0;0
12542;196456;142;53;29;4;25;.862;3763000;0
12542;208201;143;57;27;3;24;.889;3763000;0
12542;-1;143;0;0;0;0;.00nan;0;0
12543;199701;138;0;0;0;0;.00nan;0;0
12543;204873;129;59;21;2;19;.905;3600000;0
12543;-1;129;0;0;0;0;.00nan;0;0
12543;-1;138;53;27;3;24;.889;3593000;0
12544;199587;140;0;0;0;0;.00nan;0;0
12544;204668;140;57;11;1;10;.909;3600000;0
12544;-1;128;85;37;2;35;.946;3600000;0
12544;-1;128;0;0;0;0;.00nan;0;0
12545;203288;135;0;0;0;0;.00nan;0;0
12545;208556;135;64;36;4;32;.889;3600000;0
12545;199437;134;22;20;6;14;.700;2739000;0
12545;-1;134;45;10;2;8;.800;861000;0
12546;198081;133;0;0;0;0;.00nan;0;0
12546;210004;141;0;0;0;0;.00nan;0;0
12546;201673;141;82;28;2;26;.929;3689000;0
12546;202059;133;65;31;3;28;.903;3689000;0
12547;208575;142;63;47;5;42;.894;3600000;0
12547;196456;142;0;0;0;0;.00nan;0;0
12547;-1;144;58;22;2;20;.909;3600000;0
12547;-1;144;0;0;0;0;.00nan;0;0
12548;210060;137;0;0;0;0;.00nan;0;0
12548;201666;1340;0;0;0;0;.00nan;0;0
12548;202045;1340;54;27;3;24;.889;3600000;0
12548;-1;137;49;39;5;34;.872;3600000;0
12549;203276;139;100;38;1;37;.974;3600000;0
12549;198081;133;89;38;2;36;.947;3549000;0
12549;204938;139;0;0;0;0;.00nan;0;0
12549;202059;133;0;0;0;0;.00nan;0;0
12550;198091;132;69;27;2;25;.926;3565000;0
12550;199701;138;0;0;0;0;.00nan;0;0
12550;207313;132;0;0;0;0;.00nan;0;0
12550;-1;138;73;18;1;17;.944;3600000;0
12551;204873;129;70;35;3;32;.914;3600000;0
12551;201666;1340;58;48;6;42;.875;3600000;0
12551;202045;1340;0;0;0;0;.00nan;0;0
12551;-1;129;0;0;0;0;.00nan;0;0
12552;208609;131;71;19;1;18;.947;3600000;0
12552;210060;137;71;25;2;23;.920;1211000;0
12552;-1;137;11;21;7;14;.667;2389000;0
12552;-1;131;0;0;0;0;.00nan;0;0
12553;199587;140;0;0;0;0;.00nan;0;0
12553;204668;140;73;34;3;31;.912;3900000;0
12553;200436;130;0;0;0;0;.00nan;0;0
12553;-1;130;63;27;3;24;.889;3900000;0
12554;203288;135;84;24;1;23;.958;3600000;0
12554;208556;135;0;0;0;0;.00nan;0;0
12554;-1;128;0;0;0;0;.00nan;0;0
12554;-1;128;90;42;2;40;.952;3600000;0
12555;198081;133;0;0;0;0;.00nan;0;0
12555;202059;133;56;38;5;33;.868;3539000;0
12555;-1;144;63;31;3;28;.903;3600000;0
12555;-1;144;0;0;0;0;.00nan;0;0
12556;199430;136;0;0;0;0;.00nan;0;0
12556;199437;134;71;21;1;20;.952;3600000;0
12556;201530;136;36;26;5;21;.808;3600000;0
12556;-1;134;0;0;0;0;.00nan;0;0
12557;204873;129;81;23;1;22;.957;3107000;0
12557;-1;129;35;13;3;10;.769;493000;0
12557;-1;128;73;19;1;18;.947;3600000;0
12557;-1;128;0;0;0;0;.00nan;0;0
12558;203288;135;41;23;4;19;.826;2375000;0
12558;208556;135;50;14;2;12;.857;1225000;0
12558;199587;140;73;21;2;19;.905;3600000;0
12558;204668;140;0;0;0;0;.00nan;0;0
12559;210004;141;76;27;1;26;.963;3600000;0
12559;201673;141;0;0;0;0;.00nan;0;0
12559;208201;143;65;38;4;34;.895;3600000;0
12559;-1;143;0;0;0;0;.00nan;0;0
12560;203276;139;80;39;2;37;.949;3857000;0
12560;208575;142;0;0;0;0;.00nan;0;0
12560;204938;139;0;0;0;0;.00nan;0;0
12560;196456;142;72;33;3;30;.909;3857000;0
12561;198091;132;50;23;4;19;.826;3600000;0
12561;199701;138;50;37;5;32;.865;3590000;0
12561;207313;132;0;0;0;0;.00nan;0;0
12561;-1;138;0;0;0;0;.00nan;0;0
12562;208201;143;47;31;5;26;.839;3585000;0
12562;-1;144;0;0;0;0;.00nan;0;0
12562;-1;143;0;0;0;0;.00nan;0;0
12562;-1;144;75;34;3;31;.912;3600000;0
12563;199430;136;100;30;0;30;1.000;3600000;0
12563;210060;137;0;0;0;0;.00nan;0;0
12563;201530;136;0;0;0;0;.00nan;0;0
12563;-1;137;68;35;3;32;.914;3600000;0
12564;199701;138;0;0;0;0;.00nan;0;0
12564;201666;1340;0;0;0;0;.00nan;0;0
12564;202045;1340;41;26;4;22;.846;3528000;0
12564;-1;138;85;39;2;37;.949;3600000;0
12565;208609;131;38;23;4;19;.826;3543000;0
12565;200436;130;100;57;3;54;.947;3600000;0
12565;-1;131;0;0;0;0;.00nan;0;0
12565;-1;130;0;0;0;0;.00nan;0;0
12640;210004;141;0;0;0;0;.00nan;0;0
12640;201666;1340;92;33;1;32;.970;3600000;0
12640;201673;141;53;34;5;29;.853;3600000;0
12640;202045;1340;0;0;0;0;.00nan;0;0
12642;203276;139;44;24;4;20;.833;3600000;0
12642;199430;136;0;0;0;0;.00nan;0;0
12642;204938;139;0;0;0;0;.00nan;0;0
12642;201530;136;78;29;1;28;.966;3600000;0
12644;199587;140;0;0;0;0;.00nan;0;0
12644;204668;140;43;14;3;11;.786;3600000;0
12644;200436;130;25;6;3;3;.500;456000;0
12644;-1;130;30;28;6;22;.786;3144000;0
12646;208609;131;36;32;6;26;.813;3243000;0
12646;199701;138;0;0;0;0;.00nan;0;0
12646;-1;131;49;1;0;1;1.000;355000;0
12646;-1;138;80;47;4;43;.915;3600000;0
12648;203288;135;54;35;5;30;.857;3618000;0
12648;208556;135;0;0;0;0;.00nan;0;0
12648;204873;129;79;46;4;42;.913;3618000;0
12648;-1;129;0;0;0;0;.00nan;0;0
12650;199437;134;70;36;4;32;.889;3550000;0
12650;196456;142;49;20;3;17;.850;3600000;0
12650;217769;142;0;0;0;0;.00nan;0;0
12650;-1;134;0;0;0;0;.00nan;0;0
12652;198091;132;78;28;2;26;.929;3600000;0
12652;207313;132;0;0;0;0;.00nan;0;0
12652;-1;144;18;25;6;19;.760;2482000;0
12652;-1;144;44;10;2;8;.800;1118000;0
12654;208201;143;64;36;3;33;.917;3600000;0
12654;-1;143;0;0;0;0;.00nan;0;0
12654;-1;128;0;0;0;0;.00nan;0;0
12654;-1;128;55;29;4;25;.862;3542000;0
12656;198081;133;0;0;0;0;.00nan;0;0
12656;210060;137;57;25;3;22;.880;2499000;0
12656;202059;133;46;36;6;30;.833;3600000;0
12656;-1;137;23;9;4;5;.556;1069000;0
12658;199587;140;49;22;3;19;.864;3543000;0
12658;204668;140;0;0;0;0;.00nan;0;0
12658;200436;130;86;34;2;32;.941;3600000;0
12658;-1;130;0;0;0;0;.00nan;0;0
12660;208609;131;0;0;0;0;.00nan;0;0
12660;-1;131;79;32;3;29;.906;3600000;0
12660;-1;128;53;30;4;26;.867;3574000;0
12660;-1;128;0;0;0;0;.00nan;0;0
12662;203288;135;88;33;2;31;.939;3600000;0
12662;198091;132;0;0;0;0;.00nan;0;0
12662;208556;135;0;0;0;0;.00nan;0;0
12662;207313;132;43;20;3;17;.850;3554000;0
12664;198081;133;93;42;3;39;.929;3600000;0
12664;202059;133;0;0;0;0;.00nan;0;0
12664;208201;143;0;0;0;0;.00nan;0;0
12664;-1;143;62;30;4;26;.867;3546000;0
12666;208575;142;0;0;0;0;.00nan;0;0
12666;210004;141;65;17;1;16;.941;3600000;0
12666;201673;141;0;0;0;0;.00nan;0;0
12666;196456;142;46;27;4;23;.852;3600000;0
12668;203276;139;53;27;3;24;.889;3600000;0
12668;199430;136;0;0;0;0;.00nan;0;0
12668;204938;139;0;0;0;0;.00nan;0;0
12668;201530;136;82;33;2;31;.939;3600000;0
12670;204873;129;0;0;0;0;.00nan;0;0
12670;210060;137;38;29;5;24;.828;3551000;0
12670;-1;137;0;0;0;0;.00nan;0;0
12670;-1;129;84;41;3;38;.927;3600000;0
12672;199437;134;78;29;2;27;.931;3900000;0
12672;199701;138;0;0;0;0;.00nan;0;0
12672;-1;134;0;0;0;0;.00nan;0;0
12672;-1;138;70;30;2;28;.933;3900000;0
12674;201666;1340;85;27;1;26;.963;3600000;0
12674;202045;1340;0;0;0;0;.00nan;0;0
12674;-1;144;22;25;6;19;.760;2711000;0
12674;-1;144;63;12;0;12;1.000;889000;0
12676;198091;132;63;35;4;31;.886;3600000;0
12676;201666;1340;0;0;0;0;.00nan;0;0
12676;202045;1340;51;22;3;19;.864;3600000;0
12676;207313;132;0;0;0;0;.00nan;0;0
12678;199701;138;92;38;2;36;.947;3600000;0
12678;210004;141;0;0;0;0;.00nan;0;0
12678;201673;141;44;20;4;16;.800;3518000;0
12678;-1;138;0;0;0;0;.00nan;0;0
12680;203276;139;0;0;0;0;.00nan;0;0
12680;203288;135;0;0;0;0;.00nan;0;0
12680;208556;135;54;26;3;23;.885;3557000;0
12680;204938;139;91;41;2;39;.951;3600000;0
12682;210060;137;0;0;0;0;.00nan;0;0
12682;-1;137;69;36;3;33;.917;3600000;0
12682;208201;143;35;26;5;21;.808;3536000;0
12682;-1;143;0;0;0;0;.00nan;0;0
12684;198081;133;0;0;0;0;.00nan;0;0
12684;208609;131;73;34;4;30;.882;3600000;0
12684;202059;133;24;42;8;34;.810;3600000;0
12684;-1;131;0;0;0;0;.00nan;0;0
12686;208575;142;68;25;2;23;.920;3600000;0
12686;199437;134;28;16;4;12;.750;2432000;0
12686;196456;142;0;0;0;0;.00nan;0;0
12686;-1;134;31;17;4;13;.765;1168000;0
12688;204873;129;37;14;3;11;.786;3600000;0
12688;-1;129;0;0;0;0;.00nan;0;0
12688;-1;128;0;0;0;0;.00nan;0;0
12688;-1;128;59;31;4;27;.871;3600000;0
12690;199430;136;49;29;4;25;.862;3563000;0
12690;201530;136;0;0;0;0;.00nan;0;0
12690;-1;144;0;0;0;0;.00nan;0;0
12690;-1;144;44;17;3;14;.824;3600000;0
12692;199587;140;0;0;0;0;.00nan;0;0
12692;204668;140;45;23;4;19;.826;3564000;0
12692;200436;130;0;0;0;0;.00nan;0;0
12692;-1;130;68;33;3;30;.909;3600000;0
12694;198081;133;84;35;2;33;.943;3600000;0
12694;208575;142;0;0;0;0;.00nan;0;0
12694;196456;142;65;35;4;31;.886;3513000;0
12694;202059;133;0;0;0;0;.00nan;0;0
12696;208201;143;44;33;6;27;.818;3600000;0
12696;-1;144;52;22;3;19;.864;3600000;0
12696;-1;143;0;0;0;0;.00nan;0;0
12696;-1;144;0;0;0;0;.00nan;0;0
12698;208609;131;0;0;0;0;.00nan;0;0
12698;-1;131;54;20;2;18;.900;3600000;0
12698;-1;128;36;25;5;20;.800;2690000;0
12698;-1;128;61;10;0;10;1.000;910000;0
12700;199701;138;0;0;0;0;.00nan;0;0
12700;210060;137;0;0;0;0;.00nan;0;0
12700;-1;137;67;38;4;34;.895;3600000;0
12700;-1;138;79;28;2;26;.929;3600000;0
12702;203276;139;65;35;3;32;.914;3900000;0
12702;204873;129;0;0;0;0;.00nan;0;0
12702;204938;139;0;0;0;0;.00nan;0;0
12702;-1;129;58;33;3;30;.909;3900000;0
12704;210004;141;42;16;3;13;.813;3545000;0
12704;200436;130;100;49;2;47;.959;3600000;0
12704;201673;141;0;0;0;0;.00nan;0;0
12704;-1;130;0;0;0;0;.00nan;0;0
12706;199430;136;21;23;6;17;.739;1970000;0
12706;199437;134;76;23;1;22;.957;3600000;0
12706;201530;136;77;20;0;20;1.000;1630000;0
12706;-1;134;0;0;0;0;.00nan;0;0
12708;199587;140;0;0;0;0;.00nan;0;0
12708;204668;140;76;38;4;34;.895;3600000;0
12708;201666;1340;100;30;0;30;1.000;3600000;0
12708;202045;1340;0;0;0;0;.00nan;0;0
12710;203288;135;83;33;2;31;.939;3822000;0
12710;198091;132;64;38;3;35;.921;3822000;0
12710;208556;135;0;0;0;0;.00nan;0;0
12710;207313;132;0;0;0;0;.00nan;0;0
12712;199587;140;64;18;1;17;.944;3600000;0
12712;204668;140;0;0;0;0;.00nan;0;0
12712;-1;128;0;0;0;0;.00nan;0;0
12712;-1;128;44;25;5;20;.800;3600000;0
12714;203288;135;0;0;0;0;.00nan;0;0
12714;208556;135;59;31;4;27;.871;3563000;0
12714;199701;138;67;25;3;22;.880;3600000;0
12714;-1;138;0;0;0;0;.00nan;0;0
12716;203276;139;0;0;0;0;.00nan;0;0
12716;204938;139;86;40;3;37;.925;3600000;0
12716;-1;144;0;0;0;0;.00nan;0;0
12716;-1;144;31;20;5;15;.750;3525000;0
12718;198081;133;0;0;0;0;.00nan;0;0
12718;198091;132;0;0;0;0;.00nan;0;0
12718;202059;133;83;39;3;36;.923;3900000;0
12718;207313;132;67;34;3;31;.912;3900000;0
12720;208609;131;32;20;5;15;.750;3600000;0
12720;200436;130;0;0;0;0;.00nan;0;0
12720;-1;131;0;0;0;0;.00nan;0;0
12720;-1;130;31;36;6;30;.833;3600000;0
12722;210060;137;71;25;2;23;.920;3600000;0
12722;201666;1340;0;0;0;0;.00nan;0;0
12722;202045;1340;57;27;3;24;.889;3556000;0
12722;-1;137;0;0;0;0;.00nan;0;0
12724;210004;141;0;0;0;0;.00nan;0;0
12724;201673;141;94;30;1;29;.967;3600000;0
12724;208201;143;59;13;1;12;.923;1594000;0
12724;-1;143;20;25;6;19;.760;2006000;0
12726;208575;142;44;31;5;26;.839;3600000;0
12726;204873;129;76;22;1;21;.955;3600000;0
12726;196456;142;0;0;0;0;.00nan;0;0
12726;-1;129;0;0;0;0;.00nan;0;0
12728;199430;136;97;47;2;45;.957;3558000;0
12728;199437;134;0;0;0;0;.00nan;0;0
12728;201530;136;0;0;0;0;.00nan;0;0
12728;-1;134;68;20;1;19;.950;3600000;0
12730;210004;141;0;0;0;0;.00nan;0;0
12730;200436;130;39;43;7;36;.837;2901000;0
12730;201673;141;51;12;2;10;.833;3600000;0
12730;-1;130;62;8;0;8;1.000;699000;0
12732;199701;138;0;0;0;0;.00nan;0;0
12732;204873;129;0;0;0;0;.00nan;0;0
12732;-1;129;59;26;3;23;.885;3600000;0
12732;-1;138;53;34;5;29;.853;3574000;0
12734;198081;133;70;36;3;33;.917;3600000;0
12734;201666;1340;77;21;1;20;.952;3600000;0
12734;202045;1340;0;0;0;0;.00nan;0;0
12734;202059;133;0;0;0;0;.00nan;0;0
12736;198091;132;59;11;1;10;.909;3600000;0
12736;207313;132;0;0;0;0;.00nan;0;0
12736;-1;128;64;52;6;46;.885;3180000;0
12736;-1;128;49;2;0;2;1.000;420000;0
12738;203288;135;20;10;4;6;.600;984000;0
12738;208556;135;57;24;3;21;.875;2616000;0
12738;210060;137;0;0;0;0;.00nan;0;0
12738;-1;137;61;21;2;19;.905;3600000;0
12740;208575;142;0;0;0;0;.00nan;0;0
12740;196456;142;64;34;4;30;.882;3600000;0
12740;-1;144;53;40;5;35;.875;3600000;0
12740;-1;144;0;0;0;0;.00nan;0;0
12742;199430;136;66;36;4;32;.889;3570000;0
12742;199437;134;53;23;3;20;.870;3600000;0
12742;201530;136;0;0;0;0;.00nan;0;0
12742;-1;134;0;0;0;0;.00nan;0;0
12744;208609;131;0;0;0;0;.00nan;0;0
12744;199587;140;0;0;0;0;.00nan;0;0
12744;204668;140;85;29;1;28;.966;3600000;0
12744;-1;131;43;16;3;13;.813;3530000;0
12746;203276;139;52;33;5;28;.848;3600000;0
12746;204938;139;0;0;0;0;.00nan;0;0
12746;208201;143;0;0;0;0;.00nan;0;0
12746;-1;143;100;37;0;37;1.000;3600000;0
12748;199701;138;62;22;2;20;.909;3600000;0
12748;-1;138;0;0;0;0;.00nan;0;0
12748;-1;128;0;0;0;0;.00nan;0;0
12748;-1;128;59;42;3;39;.929;3543000;0
12750;208575;142;65;34;3;31;.912;3548000;0
12750;196456;142;0;0;0;0;.00nan;0;0
12750;-1;144;0;0;0;0;.00nan;0;0
12750;-1;144;77;31;2;29;.935;3600000;0
12752;199430;136;0;0;0;0;.00nan;0;0
12752;210060;137;71;21;1;20;.952;3600000;0
12752;201530;136;76;38;2;36;.947;3572000;0
12752;-1;137;0;0;0;0;.00nan;0;0
12754;198091;132;0;0;0;0;.00nan;0;0
12754;208609;131;65;31;3;28;.903;3600000;0
12754;207313;132;65;36;4;32;.889;3600000;0
12754;-1;131;0;0;0;0;.00nan;0;0
12756;199587;140;67;17;1;16;.941;3600000;0
12756;204668;140;0;0;0;0;.00nan;0;0
12756;200436;130;0;0;0;0;.00nan;0;0
12756;-1;130;44;39;6;33;.846;3600000;0
12758;203288;135;44;28;4;24;.857;3900000;0
12758;198081;133;0;0;0;0;.00nan;0;0
12758;208556;135;0;0;0;0;.00nan;0;0
12758;202059;133;68;39;4;35;.897;3900000;0
12760;199437;134;0;0;0;0;.00nan;0;0
12760;204873;129;70;30;2;28;.933;3552000;0
12760;-1;129;0;0;0;0;.00nan;0;0
12760;-1;134;78;25;1;24;.960;3600000;0
12762;203276;139;0;0;0;0;.00nan;0;0
12762;204938;139;73;47;4;43;.915;3563000;0
12762;208201;143;0;0;0;0;.00nan;0;0
12762;-1;143;62;20;2;18;.900;3600000;0
12764;210004;141;37;30;5;25;.833;3552000;0
12764;201666;1340;0;0;0;0;.00nan;0;0
12764;201673;141;0;0;0;0;.00nan;0;0
12764;202045;1340;56;32;3;29;.906;3600000;0
12790;195164;218;100;33;0;33;1.000;3600000;0
12790;190095;218;0;0;0;0;.00nan;0;0
12790;-1;219;91;36;1;35;.972;3551000;0
12790;-1;219;0;0;0;0;.00nan;0;0
12789;190034;217;0;0;0;0;.00nan;0;0
12789;190041;217;47;26;4;22;.846;3562000;0
12789;-1;180;79;34;2;32;.941;3600000;0
12789;197707;180;0;0;0;0;.00nan;0;0
12782;200333;194;87;36;1;35;.972;3887000;0
12782;196352;194;0;0;0;0;.00nan;0;0
12782;-1;189;80;39;2;37;.949;3887000;0
12782;-1;189;0;0;0;0;.00nan;0;0
12861;189081;187;0;0;0;0;.00nan;0;0
12861;192547;190;0;0;0;0;.00nan;0;0
12861;-1;187;61;16;1;15;.938;3600000;0
12861;197704;190;59;45;5;40;.889;3600000;0
12786;-1;1371;0;0;0;0;.00nan;0;0
12786;-1;220;0;0;0;0;.00nan;0;0
12786;-1;220;100;33;0;33;1.000;3600000;0
12786;192688;1371;66;24;2;22;.917;3529000;0
12885;195238;200;0;0;0;0;.00nan;0;0
12885;196283;206;70;41;4;37;.902;3600000;0
12885;-1;200;34;29;6;23;.793;3579000;0
12885;202998;206;0;0;0;0;.00nan;0;0
13117;179679;212;60;24;3;21;.875;3600000;0
13117;182128;215;57;36;4;32;.889;3600000;0
13117;-1;212;0;0;0;0;.00nan;0;0
13117;-1;215;0;0;0;0;.00nan;0;0
13155;205788;207;0;0;0;0;.00nan;0;0
13155;201560;202;64;23;2;21;.913;3900000;0
13155;-1;207;95;54;2;52;.963;3900000;0
13155;196299;202;0;0;0;0;.00nan;0;0
12810;184648;196;36;36;6;30;.833;2662000;0
12810;184788;198;31;13;4;9;.692;2364000;0
12810;181443;198;47;6;1;5;.833;1236000;0
12810;191118;196;45;5;1;4;.800;931000;0
12817;198074;195;0;0;0;0;.00nan;0;0
12817;189529;193;88;39;2;37;.949;3600000;0
12817;207061;195;67;34;3;31;.912;3541000;0
12817;186451;193;0;0;0;0;.00nan;0;0
12844;187628;227;98;53;1;52;.981;3600000;0
12844;189773;231;86;13;0;13;1.000;3600000;0
12844;206955;231;0;0;0;0;.00nan;0;0
12844;187217;227;0;0;0;0;.00nan;0;0
12800;182467;185;100;51;3;48;.941;3600000;0
12800;205837;184;51;12;2;10;.833;2851000;0
12800;190125;184;14;7;4;3;.429;749000;0
12800;-1;185;0;0;0;0;.00nan;0;0
12828;192939;208;58;37;4;33;.892;3600000;0
12828;200380;208;0;0;0;0;.00nan;0;0
12828;192629;226;97;18;0;18;1.000;3600000;0
12828;-1;226;0;0;0;0;.00nan;0;0
12830;203383;232;68;45;4;41;.911;3546000;0
12830;183695;232;0;0;0;0;.00nan;0;0
12830;184133;230;0;0;0;0;.00nan;0;0
12830;181338;230;42;17;3;14;.824;3600000;0
12824;184650;4864;0;0;0;0;.00nan;0;0
12824;186332;4864;64;25;3;22;.880;3600000;0
12824;-1;209;64;39;4;35;.897;3564000;0
12824;203063;209;0;0;0;0;.00nan;0;0
12805;198149;188;0;0;0;0;.00nan;0;0
12805;199416;191;0;0;0;0;.00nan;0;0
12805;194893;191;45;28;4;24;.857;3537000;0
12805;184409;188;62;29;2;27;.931;3600000;0
12770;201524;205;0;0;0;0;.00nan;0;0
12770;-1;205;83;14;0;14;1.000;3600000;0
12770;-1;199;80;38;3;35;.921;3600000;0
12770;-1;199;0;0;0;0;.00nan;0;0
12769;184175;224;0;0;0;0;.00nan;0;0
12769;189885;225;0;0;0;0;.00nan;0;0
12769;-1;225;83;46;5;41;.891;3600000;0
12769;185840;224;76;12;0;12;1.000;3600000;0
12968;194950;1505;0;0;0;0;.00nan;0;0
12968;196571;177;0;0;0;0;.00nan;0;0
12968;186549;1505;69;30;3;27;.900;3572000;0
12968;-1;177;79;33;2;31;.939;3600000;0
12768;198147;176;0;0;0;0;.00nan;0;0
12768;205743;2620;0;0;0;0;.00nan;0;0
12768;206801;176;73;39;4;35;.897;3596000;0
12768;-1;2620;64;19;2;17;.895;3600000;0
12941;200306;182;0;0;0;0;.00nan;0;0
12941;185810;182;100;28;0;28;1.000;3600000;0
12941;-1;214;79;40;3;37;.925;3600000;0
12941;191518;214;0;0;0;0;.00nan;0;0
12765;195251;4949;50;38;5;33;.868;3798000;0
12765;192461;210;78;43;4;39;.907;3798000;0
12765;197672;210;0;0;0;0;.00nan;0;0
12765;197685;4949;0;0;0;0;.00nan;0;0
12767;183686;213;0;0;0;0;.00nan;0;0
12767;-1;216;0;0;0;0;.00nan;0;0
12767;201495;213;55;33;4;29;.879;3900000;0
12767;-1;216;45;26;4;22;.846;3900000;0
12944;200452;221;75;22;1;21;.955;3600000;0
12944;185800;229;85;47;2;45;.957;3600000;0
12944;185960;229;0;0;0;0;.00nan;0;0
12944;187431;221;0;0;0;0;.00nan;0;0
12914;192915;179;73;10;0;10;1.000;3600000;0
12914;187355;179;0;0;0;0;.00nan;0;0
12914;-1;178;61;56;7;49;.875;3600000;0
12914;-1;178;0;0;0;0;.00nan;0;0
12907;201585;197;53;29;4;25;.862;3600000;0
12907;206822;197;0;0;0;0;.00nan;0;0
12907;-1;192;91;20;0;20;1.000;3600000;0
12907;207398;192;0;0;0;0;.00nan;0;0
12780;200437;201;45;35;5;30;.857;3600000;0
12780;200440;204;0;0;0;0;.00nan;0;0
12780;189902;204;100;21;0;21;1.000;3600000;0
12780;-1;201;0;0;0;0;.00nan;0;0
12775;184610;222;41;27;6;21;.778;3321000;0
12775;185851;222;49;1;0;1;1.000;279000;0
12775;191120;223;0;0;0;0;.00nan;0;0
12775;187118;223;92;33;1;32;.970;3600000;0
13794;-1;192;52;28;4;24;.857;3580000;0
13794;207398;192;0;0;0;0;.00nan;0;0
13794;-1;189;64;31;3;28;.903;3600000;0
13794;-1;189;0;0;0;0;.00nan;0;0
12821;190164;4959;68;29;2;27;.931;3600000;0
12821;206801;176;0;0;0;0;.00nan;0;0
12821;182006;176;34;22;4;18;.818;3585000;0
12821;-1;4959;0;0;0;0;.00nan;0;0
12826;195238;200;90;29;1;28;.966;3600000;0
12826;-1;200;0;0;0;0;.00nan;0;0
12826;192629;226;66;29;3;26;.897;3534000;0
12826;-1;226;0;0;0;0;.00nan;0;0
12820;200440;204;0;0;0;0;.00nan;0;0
12820;189902;204;56;17;2;15;.882;3600000;0
12820;196283;206;0;0;0;0;.00nan;0;0
12820;202998;206;31;41;7;34;.829;3600000;0
12894;196571;177;61;17;1;16;.941;3600000;0
12894;-1;178;0;0;0;0;.00nan;0;0
12894;-1;178;53;39;5;34;.872;3600000;0
12894;-1;177;0;0;0;0;.00nan;0;0
12872;205743;2620;0;0;0;0;.00nan;0;0
12872;184650;4864;0;0;0;0;.00nan;0;0
12872;-1;2620;79;22;1;21;.955;3600000;0
12872;186332;4864;41;26;4;22;.846;3600000;0
12971;192915;179;0;0;0;0;.00nan;0;0
12971;194950;1505;0;0;0;0;.00nan;0;0
12971;186549;1505;79;29;2;27;.931;3600000;0
12971;187355;179;75;32;3;29;.906;3600000;0
13331;182467;185;45;44;6;38;.864;3600000;0
13331;200306;182;0;0;0;0;.00nan;0;0
13331;185810;182;57;16;2;14;.875;3600000;0
13331;-1;185;0;0;0;0;.00nan;0;0
12972;182324;4960;0;0;0;0;.00nan;0;0
12972;187628;227;89;28;1;27;.964;3900000;0
12972;194219;4960;78;29;1;28;.966;3900000;0
12972;187217;227;0;0;0;0;.00nan;0;0
12990;189081;187;55;28;4;24;.857;3810000;0
12990;201585;197;92;63;3;60;.952;3776000;0
12990;206822;197;0;0;0;0;.00nan;0;0
12990;-1;187;0;0;0;0;.00nan;0;0
12837;198074;195;0;0;0;0;.00nan;0;0
12837;207061;195;43;10;2;8;.800;3600000;0
12837;192547;190;0;0;0;0;.00nan;0;0
12837;197704;190;98;51;3;48;.941;3600000;0
12833;-1;219;74;28;2;26;.929;3600000;0
12833;182128;215;0;0;0;0;.00nan;0;0
12833;-1;219;0;0;0;0;.00nan;0;0
12833;-1;215;69;40;4;36;.900;3584000;0
12899;198149;188;0;0;0;0;.00nan;0;0
12899;200333;194;94;60;3;57;.950;3600000;0
12899;184409;188;44;24;4;20;.833;3553000;0
12899;196352;194;0;0;0;0;.00nan;0;0
12933;201525;203;97;42;1;41;.976;3580000;0
12933;201560;202;79;12;0;12;1.000;3600000;0
12933;196299;202;0;0;0;0;.00nan;0;0
12933;191078;203;0;0;0;0;.00nan;0;0
12773;183686;213;0;0;0;0;.00nan;0;0
12773;195251;4949;53;15;2;13;.867;3600000;0
12773;201495;213;53;53;7;46;.868;3600000;0
12773;197685;4949;0;0;0;0;.00nan;0;0
12793;179499;186;0;0;0;0;.00nan;0;0
12793;190098;186;68;34;3;31;.912;3895000;0
12793;179679;212;87;37;2;35;.946;3895000;0
12793;-1;212;0;0;0;0;.00nan;0;0
12772;190034;217;56;29;4;25;.862;3600000;0
12772;190041;217;0;0;0;0;.00nan;0;0
12772;184785;211;61;28;3;25;.893;3600000;0
12772;179646;211;0;0;0;0;.00nan;0;0
12776;192939;208;100;51;2;49;.961;3900000;0
12776;200380;208;0;0;0;0;.00nan;0;0
12776;201524;205;0;0;0;0;.00nan;0;0
12776;-1;205;74;27;2;25;.926;3900000;0
12796;-1;181;93;41;2;39;.951;3900000;0
12796;-1;220;0;0;0;0;.00nan;0;0
12796;-1;220;63;26;2;24;.923;3900000;0
12796;192552;181;0;0;0;0;.00nan;0;0
12779;203383;232;54;24;3;21;.875;3600000;0
12779;183695;232;0;0;0;0;.00nan;0;0
12779;191120;223;53;4;0;4;1.000;453000;0
12779;187118;223;35;27;6;21;.778;3147000;0
12797;189529;193;0;0;0;0;.00nan;0;0
12797;184648;196;12;17;6;11;.647;2177000;0
12797;186451;193;62;30;3;27;.900;3600000;0
12797;191118;196;51;18;2;16;.889;1423000;0
12802;-1;216;52;34;4;30;.882;3514000;0
12802;192461;210;86;30;2;28;.933;3600000;0
12802;197672;210;0;0;0;0;.00nan;0;0
12802;-1;216;0;0;0;0;.00nan;0;0
12784;205788;207;0;0;0;0;.00nan;0;0
12784;-1;207;56;31;4;27;.871;3600000;0
12784;-1;199;5;16;6;10;.625;3585000;0
12784;-1;199;0;0;0;0;.00nan;0;0
12766;184610;222;66;31;3;28;.903;3573000;0
12766;180377;228;73;23;2;21;.913;3600000;0
12766;185851;222;0;0;0;0;.00nan;0;0
12766;208044;228;0;0;0;0;.00nan;0;0
12788;200452;221;55;23;3;20;.870;3600000;0
12788;184175;224;48;31;4;27;.871;3551000;0
12788;185840;224;0;0;0;0;.00nan;0;0
12788;187431;221;0;0;0;0;.00nan;0;0
12781;189773;231;93;19;0;19;1.000;3600000;0
12781;189885;225;63;61;7;54;.885;3600000;0
12781;206955;231;0;0;0;0;.00nan;0;0
12781;-1;225;0;0;0;0;.00nan;0;0
12804;199416;191;0;0;0;0;.00nan;0;0
12804;194893;191;44;18;3;15;.833;3580000;0
12804;184788;198;91;39;1;38;.974;3600000;0
12804;181443;198;0;0;0;0;.00nan;0;0
12867;205837;184;0;0;0;0;.00nan;0;0
12867;-1;1371;0;0;0;0;.00nan;0;0
12867;190125;184;64;24;3;21;.875;3900000;0
12867;192688;1371;70;32;3;29;.906;3900000;0
12808;179499;186;100;34;0;34;1.000;3600000;0
12808;190098;186;0;0;0;0;.00nan;0;0
12808;-1;180;60;40;4;36;.900;3600000;0
12808;197707;180;0;0;0;0;.00nan;0;0
12888;180377;228;76;24;1;23;.958;3681000;0
12888;185800;229;73;26;2;24;.923;3681000;0
12888;185960;229;0;0;0;0;.00nan;0;0
12888;208044;228;0;0;0;0;.00nan;0;0
12889;192915;179;0;0;0;0;.00nan;0;0
12889;195251;4949;56;41;5;36;.878;3600000;0
12889;187355;179;82;23;1;22;.957;3600000;0
12889;197685;4949;0;0;0;0;.00nan;0;0
12840;-1;219;64;22;2;20;.909;3600000;0
12840;-1;219;0;0;0;0;.00nan;0;0
12840;-1;180;73;41;4;37;.902;3575000;0
12840;197707;180;0;0;0;0;.00nan;0;0
12794;190034;217;100;30;1;29;.967;3600000;0
12794;190041;217;0;0;0;0;.00nan;0;0
12794;182128;215;0;0;0;0;.00nan;0;0
12794;-1;215;61;33;4;29;.879;3600000;0
13209;199416;191;65;17;1;16;.941;3600000;0
13209;189081;187;98;54;3;51;.944;3544000;0
13209;194893;191;0;0;0;0;.00nan;0;0
13209;-1;187;0;0;0;0;.00nan;0;0
12852;184650;4864;0;0;0;0;.00nan;0;0
12852;186332;4864;97;30;0;30;1.000;3600000;0
12852;-1;209;71;28;2;26;.929;3537000;0
12852;203063;209;0;0;0;0;.00nan;0;0
13034;182324;4960;0;0;0;0;.00nan;0;0
13034;194219;4960;45;22;3;19;.864;3586000;0
13034;189885;225;67;35;2;33;.943;3600000;0
13034;-1;225;0;0;0;0;.00nan;0;0
12841;203383;232;0;0;0;0;.00nan;0;0
12841;183695;232;86;27;1;26;.963;3600000;0
12841;200452;221;62;26;2;24;.923;3560000;0
12841;187431;221;0;0;0;0;.00nan;0;0
12778;194950;1505;0;0;0;0;.00nan;0;0
12778;186549;1505;89;37;1;36;.973;3900000;0
12778;192461;210;82;29;1;28;.966;3900000;0
12778;197672;210;0;0;0;0;.00nan;0;0
13271;200306;182;25;7;3;4;.571;298000;0
13271;185810;182;80;37;3;34;.919;3302000;0
13271;-1;214;54;21;3;18;.857;3600000;0
13271;191518;214;0;0;0;0;.00nan;0;0
13247;192939;208;0;0;0;0;.00nan;0;0
13247;200380;208;96;39;2;37;.949;3900000;0
13247;200437;201;93;46;2;44;.957;3900000;0
13247;-1;201;0;0;0;0;.00nan;0;0
12845;185800;229;0;0;0;0;.00nan;0;0
12845;185960;229;67;25;2;23;.920;3868000;0
12845;191120;223;0;0;0;0;.00nan;0;0
12845;187118;223;97;34;1;33;.971;3868000;0
12916;201525;203;76;32;2;30;.938;3650000;0
12916;191078;203;0;0;0;0;.00nan;0;0
12916;192629;226;67;23;3;20;.870;3650000;0
12916;-1;226;0;0;0;0;.00nan;0;0
12913;189529;193;0;0;0;0;.00nan;0;0
12913;-1;192;84;33;2;31;.939;3600000;0
12913;207398;192;0;0;0;0;.00nan;0;0
12913;186451;193;56;26;4;22;.846;3600000;0
12822;198149;188;0;0;0;0;.00nan;0;0
12822;184409;188;59;27;3;24;.889;3562000;0
12822;184788;198;0;0;0;0;.00nan;0;0
12822;181443;198;71;26;2;24;.923;3600000;0
12774;184175;224;81;42;3;39;.929;3600000;0
12774;189773;231;12;13;5;8;.615;2143000;0
12774;206955;231;51;2;0;2;1.000;1402000;0
12774;185840;224;0;0;0;0;.00nan;0;0
12801;182467;185;0;0;0;0;.00nan;0;0
12801;-1;181;66;25;3;22;.880;3557000;0
12801;-1;185;88;37;2;35;.946;3600000;0
12801;192552;181;0;0;0;0;.00nan;0;0
12816;195164;218;96;50;2;48;.960;3600000;0
12816;190095;218;0;0;0;0;.00nan;0;0
12816;179679;212;0;0;0;0;.00nan;0;0
12816;-1;212;74;30;3;27;.900;3596000;0
12814;205837;184;0;0;0;0;.00nan;0;0
12814;-1;1371;100;47;2;45;.957;3900000;0
12814;190125;184;87;38;2;36;.947;3900000;0
12814;192688;1371;0;0;0;0;.00nan;0;0
12803;201560;202;53;18;2;16;.889;3570000;0
12803;196299;202;0;0;0;0;.00nan;0;0
12803;-1;199;0;0;0;0;.00nan;0;0
12803;-1;199;93;33;1;32;.970;3600000;0
12823;200333;194;34;28;6;22;.786;2953000;0
12823;196352;194;51;5;1;4;.800;647000;0
12823;192547;190;99;45;1;44;.978;3600000;0
12823;197704;190;0;0;0;0;.00nan;0;0
12795;205788;207;0;0;0;0;.00nan;0;0
12795;201524;205;0;0;0;0;.00nan;0;0
12795;-1;207;76;44;4;40;.909;3544000;0
12795;-1;205;62;24;2;22;.917;3600000;0
12977;-1;183;0;0;0;0;.00nan;0;0
12977;180574;183;57;19;2;17;.895;3600000;0
12977;-1;178;0;0;0;0;.00nan;0;0
12977;-1;178;57;34;4;30;.882;3588000;0
12777;183686;213;100;48;2;46;.958;3900000;0
12777;-1;216;67;20;2;18;.900;3900000;0
12777;201495;213;0;0;0;0;.00nan;0;0
12777;-1;216;0;0;0;0;.00nan;0;0
12791;205743;2620;0;0;0;0;.00nan;0;0
12791;190164;4959;0;0;0;0;.00nan;0;0
12791;-1;2620;43;45;7;38;.844;3600000;0
12791;-1;4959;75;32;2;30;.938;3600000;0
12857;184133;230;0;0;0;0;.00nan;0;0
12857;184610;222;47;45;7;38;.844;2529000;0
12857;181338;230;63;15;1;14;.933;3600000;0
12857;185851;222;1;18;7;11;.611;1071000;0
12838;198074;195;81;11;0;11;1.000;3600000;0
12838;184648;196;85;44;4;40;.909;3600000;0
12838;207061;195;0;0;0;0;.00nan;0;0
12838;191118;196;0;0;0;0;.00nan;0;0
12783;192915;179;0;0;0;0;.00nan;0;0
12783;-1;216;56;24;2;22;.917;3589000;0
12783;187355;179;92;22;1;21;.955;3600000;0
12783;-1;216;0;0;0;0;.00nan;0;0
14076;196571;177;62;17;1;16;.941;3581000;0
14076;-1;178;0;0;0;0;.00nan;0;0
14076;-1;178;100;28;0;28;1.000;3600000;0
14076;-1;177;0;0;0;0;.00nan;0;0
12806;201585;197;82;35;3;32;.914;3543000;0
12806;206822;197;0;0;0;0;.00nan;0;0
12806;-1;189;0;0;0;0;.00nan;0;0
12806;-1;189;68;21;2;19;.905;3600000;0
12798;200440;204;0;0;0;0;.00nan;0;0
12798;195238;200;69;27;2;25;.926;3600000;0
12798;189902;204;78;21;1;20;.952;3600000;0
12798;-1;200;0;0;0;0;.00nan;0;0
12839;195164;218;89;37;2;35;.946;3548000;0
12839;190034;217;82;29;1;28;.966;3600000;0
12839;190041;217;0;0;0;0;.00nan;0;0
12839;190095;218;0;0;0;0;.00nan;0;0
12832;203383;232;97;57;3;54;.947;3550000;0
12832;183695;232;0;0;0;0;.00nan;0;0
12832;189773;231;0;0;0;0;.00nan;0;0
12832;206955;231;67;27;2;25;.926;3600000;0
12809;195251;4949;74;36;4;32;.889;3900000;0
12809;192461;210;0;0;0;0;.00nan;0;0
12809;197672;210;36;22;4;18;.818;3900000;0
12809;197685;4949;0;0;0;0;.00nan;0;0
12878;192939;208;73;21;1;20;.952;3600000;0
12878;200380;208;0;0;0;0;.00nan;0;0
12878;201524;205;55;21;2;19;.905;3600000;0
12878;-1;205;0;0;0;0;.00nan;0;0
12882;-1;1371;0;0;0;0;.00nan;0;0
12882;-1;214;81;53;5;48;.906;3787000;0
12882;191518;214;0;0;0;0;.00nan;0;0
12882;192688;1371;38;20;4;16;.800;3787000;0
14108;182324;4960;60;25;3;22;.880;3600000;0
14108;194219;4960;0;0;0;0;.00nan;0;0
14108;185800;229;43;24;4;20;.833;3600000;0
14108;185960;229;0;0;0;0;.00nan;0;0
12879;184133;230;48;4;1;3;.750;3600000;0
12879;189885;225;46;48;7;41;.854;2700000;0
12879;181338;230;0;0;0;0;.00nan;0;0
12879;-1;225;47;17;3;14;.824;900000;0
12771;200333;194;0;0;0;0;.00nan;0;0
12771;201585;197;94;40;2;38;.950;3600000;0
12771;206822;197;0;0;0;0;.00nan;0;0
12771;196352;194;51;24;3;21;.875;3565000;0
12886;200440;204;33;29;6;23;.793;2632000;0
12886;189902;204;52;4;0;4;1.000;887000;0
12886;201560;202;0;0;0;0;.00nan;0;0
12886;196299;202;45;25;4;21;.840;3600000;0
14049;205837;184;0;0;0;0;.00nan;0;0
14049;190125;184;84;32;1;31;.969;3600000;0
14049;-1;181;63;31;3;28;.903;3570000;0
14049;192552;181;0;0;0;0;.00nan;0;0
13031;201525;203;81;46;4;42;.913;3563000;0
13031;191078;203;0;0;0;0;.00nan;0;0
13031;192629;226;62;28;3;25;.893;3600000;0
13031;-1;226;0;0;0;0;.00nan;0;0
12951;184648;196;68;29;2;27;.931;3900000;0
12951;-1;192;78;29;2;27;.931;3900000;0
12951;207398;192;0;0;0;0;.00nan;0;0
12951;191118;196;0;0;0;0;.00nan;0;0
12785;200437;201;0;0;0;0;.00nan;0;0
12785;195238;200;100;29;0;29;1.000;3600000;0
12785;-1;200;0;0;0;0;.00nan;0;0
12785;-1;201;68;29;2;27;.931;3535000;0
12887;184788;198;59;27;3;24;.889;3900000;0
12887;181443;198;0;0;0;0;.00nan;0;0
12887;-1;189;76;38;3;35;.921;3900000;0
12887;-1;189;0;0;0;0;.00nan;0;0
12900;183686;213;0;0;0;0;.00nan;0;0
12900;201495;213;75;27;3;24;.889;3900000;0
12900;-1;183;59;28;3;25;.893;3900000;0
12900;180574;183;0;0;0;0;.00nan;0;0
12959;179679;212;58;31;4;27;.871;3900000;0
12959;182128;215;0;0;0;0;.00nan;0;0
12959;-1;212;0;0;0;0;.00nan;0;0
12959;-1;215;74;47;4;43;.915;3900000;0
12787;184175;224;39;29;6;23;.793;3600000;0
12787;185840;224;0;0;0;0;.00nan;0;0
12787;191120;223;0;0;0;0;.00nan;0;0
12787;187118;223;94;38;2;36;.947;3600000;0
12825;184650;4864;0;0;0;0;.00nan;0;0
12825;186332;4864;54;25;3;22;.880;3900000;0
12825;-1;209;86;39;3;36;.923;3900000;0
12825;203063;209;0;0;0;0;.00nan;0;0
12799;196283;206;0;0;0;0;.00nan;0;0
12799;-1;199;23;23;6;17;.739;2886000;0
12799;-1;199;31;4;2;2;.500;714000;0
12799;202998;206;56;33;4;29;.879;3600000;0
13374;199416;191;0;0;0;0;.00nan;0;0
13374;194893;191;61;22;2;20;.909;3600000;0
13374;189529;193;51;3;0;3;1.000;258000;0
13374;186451;193;61;42;6;36;.857;3342000;0
12834;198149;188;0;0;0;0;.00nan;0;0
12834;189081;187;75;43;5;38;.884;3900000;0
12834;184409;188;52;38;5;33;.868;3900000;0
12834;-1;187;0;0;0;0;.00nan;0;0
12862;182467;185;80;46;3;43;.935;3587000;0
12862;-1;220;0;0;0;0;.00nan;0;0
12862;-1;220;60;16;1;15;.938;3600000;0
12862;-1;185;0;0;0;0;.00nan;0;0
12854;200452;221;51;19;3;16;.842;3600000;0
12854;184610;222;0;0;0;0;.00nan;0;0
12854;185851;222;59;41;5;36;.878;3598000;0
12854;187431;221;0;0;0;0;.00nan;0;0
12835;179499;186;63;41;5;36;.878;3600000;0
12835;190098;186;0;0;0;0;.00nan;0;0
12835;-1;219;0;0;0;0;.00nan;0;0
12835;-1;219;61;24;2;22;.917;3600000;0
12843;205743;2620;0;0;0;0;.00nan;0;0
12843;206801;176;63;30;4;26;.867;3600000;0
12843;182006;176;0;0;0;0;.00nan;0;0
12843;-1;2620;42;29;5;24;.828;3557000;0
12812;184785;211;0;0;0;0;.00nan;0;0
12812;179646;211;72;38;4;34;.895;3600000;0
12812;-1;180;71;21;1;20;.952;3600000;0
12812;197707;180;0;0;0;0;.00nan;0;0
12846;187628;227;75;32;2;30;.938;3600000;0
12846;180377;228;0;0;0;0;.00nan;0;0
12846;187217;227;0;0;0;0;.00nan;0;0
12846;208044;228;20;29;6;23;.793;3600000;0
12831;205837;184;47;32;4;28;.875;3846000;0
12831;190125;184;0;0;0;0;.00nan;0;0
12831;-1;220;52;33;5;28;.848;3846000;0
12831;-1;220;0;0;0;0;.00nan;0;0
13004;203383;232;68;20;1;19;.950;3600000;0
13004;183695;232;0;0;0;0;.00nan;0;0
13004;189885;225;0;0;0;0;.00nan;0;0
13004;-1;225;98;43;2;41;.953;3600000;0
14092;179679;212;0;0;0;0;.00nan;0;0
14092;-1;212;69;28;2;26;.929;3600000;0
14092;-1;180;0;0;0;0;.00nan;0;0
14092;197707;180;58;26;3;23;.885;3542000;0
12848;184785;211;0;0;0;0;.00nan;0;0
12848;179646;211;76;18;1;17;.944;3600000;0
12848;-1;219;75;33;3;30;.909;3544000;0
12848;-1;219;0;0;0;0;.00nan;0;0
12850;198149;188;52;19;2;17;.895;3566000;0
12850;184409;188;0;0;0;0;.00nan;0;0
12850;184648;196;100;38;1;37;.974;3600000;0
12850;191118;196;0;0;0;0;.00nan;0;0
12949;-1;183;62;20;2;18;.900;3900000;0
12949;180574;183;0;0;0;0;.00nan;0;0
12949;-1;178;0;0;0;0;.00nan;0;0
12949;-1;178;100;41;2;39;.951;3900000;0
12895;190034;217;0;0;0;0;.00nan;0;0
12895;190041;217;43;19;3;16;.842;3600000;0
12895;182128;215;0;0;0;0;.00nan;0;0
12895;-1;215;50;34;5;29;.853;3529000;0
12847;189773;231;81;10;0;10;1.000;3600000;0
12847;206955;231;0;0;0;0;.00nan;0;0
12847;185800;229;0;0;0;0;.00nan;0;0
12847;185960;229;89;60;2;58;.967;3541000;0
13390;200306;182;0;0;0;0;.00nan;0;0
13390;185810;182;100;30;1;29;.967;3900000;0
13390;-1;214;0;0;0;0;.00nan;0;0
13390;191518;214;85;34;1;33;.971;3900000;0
12996;189529;193;77;30;2;28;.933;3600000;0
12996;-1;192;0;0;0;0;.00nan;0;0
12996;207398;192;69;35;3;32;.914;3547000;0
12996;186451;193;0;0;0;0;.00nan;0;0
12864;189081;187;0;0;0;0;.00nan;0;0
12864;192547;190;0;0;0;0;.00nan;0;0
12864;-1;187;57;29;3;26;.897;3561000;0
12864;197704;190;99;45;2;43;.956;3600000;0
12819;196571;177;56;35;4;31;.886;3600000;0
12819;192461;210;22;12;4;8;.667;982000;0
12819;197672;210;46;16;3;13;.813;2618000;0
12819;-1;177;0;0;0;0;.00nan;0;0
12868;182467;185;0;0;0;0;.00nan;0;0
12868;-1;181;0;0;0;0;.00nan;0;0
12868;-1;185;97;42;1;41;.976;3900000;0
12868;192552;181;76;20;1;19;.950;3900000;0
13113;182324;4960;0;0;0;0;.00nan;0;0
13113;194219;4960;95;23;0;23;1.000;3600000;0
13113;184610;222;55;35;4;31;.886;3600000;0
13113;185851;222;0;0;0;0;.00nan;0;0
14138;184175;224;0;0;0;0;.00nan;0;0
14138;180377;228;56;27;3;24;.889;3600000;0
14138;185840;224;95;24;0;24;1.000;3600000;0
14138;208044;228;0;0;0;0;.00nan;0;0
12815;198074;195;0;0;0;0;.00nan;0;0
12815;184788;198;0;0;0;0;.00nan;0;0
12815;207061;195;74;20;1;19;.950;3600000;0
12815;181443;198;64;44;5;39;.886;3600000;0
12811;205788;207;0;0;0;0;.00nan;0;0
12811;-1;207;87;27;1;26;.963;3900000;0
12811;196283;206;0;0;0;0;.00nan;0;0
12811;202998;206;86;36;1;35;.972;3900000;0
13095;201525;203;0;0;0;0;.00nan;0;0
13095;191078;203;61;29;3;26;.897;3900000;0
13095;192629;226;0;0;0;0;.00nan;0;0
13095;-1;226;49;21;3;18;.857;3848000;0
12939;187628;227;0;0;0;0;.00nan;0;0
12939;200452;221;0;0;0;0;.00nan;0;0
12939;187217;227;67;32;3;29;.906;3600000;0
12939;187431;221;53;33;5;28;.848;3532000;0
12883;206801;176;73;27;2;25;.926;3595000;0
12883;182006;176;0;0;0;0;.00nan;0;0
12883;-1;209;0;0;0;0;.00nan;0;0
12883;203063;209;81;32;1;31;.969;3600000;0
12938;184650;4864;94;40;2;38;.950;3600000;0
12938;190164;4959;0;0;0;0;.00nan;0;0
12938;186332;4864;0;0;0;0;.00nan;0;0
12938;-1;4959;60;30;3;27;.900;3562000;0
12813;194950;1505;0;0;0;0;.00nan;0;0
12813;-1;216;61;31;4;27;.871;3600000;0
12813;186549;1505;95;34;1;33;.971;3600000;0
12813;-1;216;0;0;0;0;.00nan;0;0
13026;199416;191;0;0;0;0;.00nan;0;0
13026;200333;194;97;47;2;45;.957;3575000;0
13026;194893;191;85;26;1;25;.962;3600000;0
13026;196352;194;0;0;0;0;.00nan;0;0
13002;195238;200;52;39;5;34;.872;3600000;0
13002;201560;202;60;21;2;19;.905;3600000;0
13002;196299;202;0;0;0;0;.00nan;0;0
13002;-1;200;0;0;0;0;.00nan;0;0
12961;192915;179;79;36;2;34;.944;3600000;0
12961;196571;177;0;0;0;0;.00nan;0;0
12961;187355;179;0;0;0;0;.00nan;0;0
12961;-1;177;57;23;3;20;.870;3599000;0
12898;205788;207;57;40;4;36;.900;3569000;0
12898;201524;205;0;0;0;0;.00nan;0;0
12898;-1;207;0;0;0;0;.00nan;0;0
12898;-1;205;55;20;2;18;.900;3600000;0
14077;190034;217;81;45;4;41;.911;3557000;0
14077;190041;217;0;0;0;0;.00nan;0;0
14077;179499;186;39;14;3;11;.786;3600000;0
14077;190098;186;0;0;0;0;.00nan;0;0
13108;183686;213;70;26;2;24;.923;3600000;0
13108;201495;213;0;0;0;0;.00nan;0;0
13108;-1;178;39;39;6;33;.846;3600000;0
13108;-1;178;0;0;0;0;.00nan;0;0
12876;205743;2620;0;0;0;0;.00nan;0;0
12876;190164;4959;0;0;0;0;.00nan;0;0
12876;-1;2620;100;26;0;26;1.000;3600000;0
12876;-1;4959;60;22;3;19;.864;3600000;0
12792;184133;230;0;0;0;0;.00nan;0;0
12792;181338;230;65;22;2;20;.909;3600000;0
12792;191120;223;0;0;0;0;.00nan;0;0
12792;187118;223;61;50;6;44;.880;3600000;0
12875;201585;197;75;48;5;43;.896;3513000;0
12875;206822;197;0;0;0;0;.00nan;0;0
12875;192547;190;57;23;3;20;.870;3600000;0
12875;197704;190;0;0;0;0;.00nan;0;0
13965;192939;208;0;0;0;0;.00nan;0;0
13965;200380;208;62;34;4;30;.882;3600000;0
13965;200440;204;0;0;0;0;.00nan;0;0
13965;189902;204;75;34;2;32;.941;3600000;0
14151;199416;191;91;19;0;19;1.000;3600000;0
14151;189081;187;73;43;3;40;.930;3600000;0
14151;194893;191;0;0;0;0;.00nan;0;0
14151;-1;187;0;0;0;0;.00nan;0;0
14147;189773;231;94;16;0;16;1.000;3600000;0
14147;206955;231;0;0;0;0;.00nan;0;0
14147;191120;223;56;44;5;39;.886;3600000;0
14147;187118;223;0;0;0;0;.00nan;0;0
13208;179499;186;0;0;0;0;.00nan;0;0
13208;190098;186;65;20;2;18;.900;3600000;0
13208;179679;212;22;4;3;1;.250;410000;0
13208;-1;212;82;29;1;28;.966;3159000;0
12818;184175;224;86;36;3;33;.917;3627000;0
12818;180377;228;0;0;0;0;.00nan;0;0
12818;185840;224;0;0;0;0;.00nan;0;0
12818;208044;228;72;41;4;37;.902;3627000;0
12829;200437;201;84;53;2;51;.962;3600000;0
12829;200440;204;65;35;4;31;.886;3597000;0
12829;189902;204;0;0;0;0;.00nan;0;0
12829;-1;201;0;0;0;0;.00nan;0;0
12836;194950;1505;90;42;2;40;.952;3900000;0
12836;195251;4949;69;31;2;29;.935;3900000;0
12836;186549;1505;0;0;0;0;.00nan;0;0
12836;197685;4949;0;0;0;0;.00nan;0;0
13942;206801;176;0;0;0;0;.00nan;0;0
13942;182006;176;80;28;1;27;.964;3600000;0
13942;-1;209;65;28;2;26;.929;3578000;0
13942;203063;209;0;0;0;0;.00nan;0;0
12904;-1;181;61;31;4;27;.871;3552000;0
12904;-1;220;0;0;0;0;.00nan;0;0
12904;-1;220;58;19;2;17;.895;3600000;0
12904;192552;181;0;0;0;0;.00nan;0;0
12807;198074;195;56;15;2;13;.867;3600000;0
12807;207061;195;0;0;0;0;.00nan;0;0
12807;-1;189;40;13;3;10;.769;1174000;0
12807;-1;189;41;33;6;27;.818;2426000;0
12897;196283;206;14;19;6;13;.684;1528000;0
12897;-1;199;0;0;0;0;.00nan;0;0
12897;-1;199;100;33;1;32;.970;3600000;0
12897;202998;206;44;18;2;16;.889;2072000;0
14093;201585;197;98;42;2;40;.952;3600000;0
14093;206822;197;0;0;0;0;.00nan;0;0
14093;-1;192;59;20;3;17;.850;3567000;0
14093;207398;192;0;0;0;0;.00nan;0;0
12851;195164;218;59;27;3;24;.889;3600000;0
12851;184785;211;47;19;3;16;.842;1634000;0
12851;190095;218;0;0;0;0;.00nan;0;0
12851;179646;211;16;23;6;17;.739;1966000;0
14079;182467;185;100;30;0;30;1.000;3600000;0
14079;200306;182;0;0;0;0;.00nan;0;0
14079;185810;182;76;29;2;27;.931;3524000;0
14079;-1;185;0;0;0;0;.00nan;0;0
12937;205743;2620;0;0;0;0;.00nan;0;0
12937;-1;2620;58;19;2;17;.895;3600000;0
12937;-1;209;0;0;0;0;.00nan;0;0
12937;203063;209;80;41;4;37;.902;3573000;0
13056;201525;203;87;39;2;37;.949;3593000;0
13056;201560;202;0;0;0;0;.00nan;0;0
13056;196299;202;66;19;1;18;.947;3600000;0
13056;191078;203;0;0;0;0;.00nan;0;0
14140;184650;4864;0;0;0;0;.00nan;0;0
14140;190164;4959;61;31;3;28;.903;3552000;0
14140;186332;4864;89;38;2;36;.947;3600000;0
14140;-1;4959;0;0;0;0;.00nan;0;0
13096;200452;221;48;21;3;18;.857;3557000;0
13096;180377;228;74;25;2;23;.920;3600000;0
13096;187431;221;0;0;0;0;.00nan;0;0
13096;208044;228;0;0;0;0;.00nan;0;0
13008;200333;194;80;41;3;38;.927;3900000;0
13008;189529;193;0;0;0;0;.00nan;0;0
13008;196352;194;0;0;0;0;.00nan;0;0
13008;186451;193;78;34;3;31;.912;3900000;0
14162;189081;187;0;0;0;0;.00nan;0;0
14162;184648;196;100;26;0;26;1.000;3600000;0
14162;191118;196;0;0;0;0;.00nan;0;0
14162;-1;187;44;24;4;20;.833;3600000;0
14146;205837;184;0;0;0;0;.00nan;0;0
14146;190125;184;90;21;0;21;1.000;3600000;0
14146;-1;214;72;35;3;32;.914;3600000;0
14146;191518;214;0;0;0;0;.00nan;0;0
13027;205788;207;0;0;0;0;.00nan;0;0
13027;-1;207;62;24;2;22;.917;3600000;0
13027;192629;226;54;23;3;20;.870;3558000;0
13027;-1;226;0;0;0;0;.00nan;0;0
13128;192915;179;0;0;0;0;.00nan;0;0
13128;183686;213;0;0;0;0;.00nan;0;0
13128;201495;213;48;30;4;26;.867;3600000;0
13128;187355;179;58;12;1;11;.917;3600000;0
13188;192939;208;72;31;2;29;.935;3600000;0
13188;200380;208;0;0;0;0;.00nan;0;0
13188;195238;200;0;0;0;0;.00nan;0;0
13188;-1;200;48;31;5;26;.839;3600000;0
12858;-1;216;0;0;0;0;.00nan;0;0
12858;-1;183;92;42;3;39;.929;3600000;0
12858;180574;183;0;0;0;0;.00nan;0;0
12858;-1;216;68;38;4;34;.895;3600000;0
12856;182324;4960;76;11;0;11;1.000;3600000;0
12856;194219;4960;0;0;0;0;.00nan;0;0
12856;184175;224;0;0;0;0;.00nan;0;0
12856;185840;224;60;35;4;31;.886;3600000;0
12849;198149;188;0;0;0;0;.00nan;0;0
12849;184409;188;69;18;1;17;.944;3600000;0
12849;-1;189;49;32;4;28;.875;3600000;0
12849;-1;189;0;0;0;0;.00nan;0;0
12855;184610;222;56;33;4;29;.879;3600000;0
12855;185800;229;53;21;3;18;.857;3600000;0
12855;185851;222;0;0;0;0;.00nan;0;0
12855;185960;229;0;0;0;0;.00nan;0;0
12881;189773;231;65;17;1;16;.941;3600000;0
12881;189885;225;70;38;4;34;.895;3600000;0
12881;206955;231;0;0;0;0;.00nan;0;0
12881;-1;225;0;0;0;0;.00nan;0;0
12896;-1;1371;0;0;0;0;.00nan;0;0
12896;-1;220;0;0;0;0;.00nan;0;0
12896;-1;220;84;50;4;46;.920;3600000;0
12896;192688;1371;92;35;1;34;.971;3600000;0
12892;179499;186;72;28;2;26;.929;3600000;0
12892;190098;186;0;0;0;0;.00nan;0;0
12892;-1;180;70;31;3;28;.903;3600000;0
12892;197707;180;0;0;0;0;.00nan;0;0
13073;200452;221;0;0;0;0;.00nan;0;0
13073;189885;225;0;0;0;0;.00nan;0;0
13073;-1;225;60;28;3;25;.893;3598000;0
13073;187431;221;85;24;1;23;.958;3600000;0
14095;183686;213;63;42;4;38;.905;3600000;0
14095;195251;4949;89;14;0;14;1.000;3600000;0
14095;201495;213;0;0;0;0;.00nan;0;0
14095;197685;4949;0;0;0;0;.00nan;0;0
12966;179679;212;93;36;1;35;.972;3600000;0
12966;-1;219;61;21;2;19;.905;3549000;0
12966;-1;219;0;0;0;0;.00nan;0;0
12966;-1;212;0;0;0;0;.00nan;0;0
12891;182467;185;81;43;3;40;.930;3781000;0
12891;205837;184;0;0;0;0;.00nan;0;0
12891;190125;184;70;29;2;27;.931;3781000;0
12891;-1;185;0;0;0;0;.00nan;0;0
12902;182324;4960;0;0;0;0;.00nan;0;0
12902;194219;4960;77;44;4;40;.909;3600000;0
12902;184133;230;0;0;0;0;.00nan;0;0
12902;181338;230;86;19;0;19;1.000;3600000;0
12993;192915;179;53;39;6;33;.846;3541000;0
12993;-1;183;0;0;0;0;.00nan;0;0
12993;180574;183;45;25;4;21;.840;3600000;0
12993;187355;179;0;0;0;0;.00nan;0;0
12915;203383;232;76;27;1;26;.963;3600000;0
12915;183695;232;0;0;0;0;.00nan;0;0
12915;185800;229;0;0;0;0;.00nan;0;0
12915;185960;229;84;52;4;48;.923;3600000;0
12967;189529;193;27;23;6;17;.739;3600000;0
12967;184648;196;88;38;2;36;.947;3600000;0
12967;186451;193;0;0;0;0;.00nan;0;0
12967;191118;196;0;0;0;0;.00nan;0;0
13013;200306;182;0;0;0;0;.00nan;0;0
13013;-1;181;74;39;4;35;.897;3600000;0
13013;185810;182;93;23;0;23;1.000;3600000;0
13013;192552;181;0;0;0;0;.00nan;0;0
12910;200437;201;88;29;1;28;.966;3900000;0
12910;196283;206;0;0;0;0;.00nan;0;0
12910;-1;201;0;0;0;0;.00nan;0;0
12910;202998;206;88;30;1;29;.967;3900000;0
12877;201585;197;92;33;1;32;.970;3600000;0
12877;206822;197;0;0;0;0;.00nan;0;0
12877;192547;190;0;0;0;0;.00nan;0;0
12877;197704;190;57;28;3;25;.893;3556000;0
13014;199416;191;45;11;2;9;.818;3600000;0
13014;194893;191;0;0;0;0;.00nan;0;0
13014;-1;192;65;53;7;46;.868;3600000;0
13014;207398;192;0;0;0;0;.00nan;0;0
12890;195164;218;86;36;2;34;.944;3600000;0
12890;190034;217;0;0;0;0;.00nan;0;0
12890;190041;217;60;29;3;26;.897;3582000;0
12890;190095;218;0;0;0;0;.00nan;0;0
12943;190164;4959;0;0;0;0;.00nan;0;0
12943;206801;176;75;25;2;23;.920;3600000;0
12943;182006;176;0;0;0;0;.00nan;0;0
12943;-1;4959;76;37;4;33;.892;3596000;0
12842;198074;195;0;0;0;0;.00nan;0;0
12842;198149;188;0;0;0;0;.00nan;0;0
12842;184409;188;80;31;2;29;.935;3600000;0
12842;207061;195;39;13;3;10;.769;3532000;0
12871;184610;222;50;1;0;1;1.000;237000;0
12871;185851;222;48;32;5;27;.844;3302000;0
12871;191120;223;0;0;0;0;.00nan;0;0
12871;187118;223;54;22;3;19;.864;3600000;0
13143;201560;202;60;37;4;33;.892;3568000;0
13143;196299;202;0;0;0;0;.00nan;0;0
13143;192629;226;0;0;0;0;.00nan;0;0
13143;-1;226;48;22;3;19;.864;3600000;0
12873;194950;1505;0;0;0;0;.00nan;0;0
12873;-1;216;80;21;1;20;.952;3600000;0
12873;186549;1505;57;25;2;23;.920;3581000;0
12873;-1;216;0;0;0;0;.00nan;0;0
12827;-1;178;0;0;0;0;.00nan;0;0
12827;192461;210;78;26;2;24;.923;3543000;0
12827;197672;210;0;0;0;0;.00nan;0;0
12827;-1;178;100;56;1;55;.982;3600000;0
12935;201524;205;0;0;0;0;.00nan;0;0
12935;-1;205;98;42;1;41;.976;3600000;0
12935;-1;199;61;37;4;33;.892;3600000;0
12935;-1;199;0;0;0;0;.00nan;0;0
14010;195238;200;0;0;0;0;.00nan;0;0
14010;201524;205;57;27;3;24;.889;3600000;0
14010;-1;200;73;46;4;42;.913;3600000;0
14010;-1;205;0;0;0;0;.00nan;0;0
12975;184650;4864;0;0;0;0;.00nan;0;0
12975;186332;4864;54;21;2;19;.905;3550000;0
12975;-1;209;0;0;0;0;.00nan;0;0
12975;203063;209;96;31;1;30;.968;3600000;0
12905;-1;220;50;22;3;19;.864;3676000;0
12905;-1;220;0;0;0;0;.00nan;0;0
12905;-1;214;85;38;2;36;.947;3676000;0
12905;191518;214;0;0;0;0;.00nan;0;0
12853;180377;228;0;0;0;0;.00nan;0;0
12853;191120;223;65;28;3;25;.893;3600000;0
12853;187118;223;0;0;0;0;.00nan;0;0
12853;208044;228;35;23;4;19;.826;3561000;0
12954;187628;227;29;8;3;5;.625;566000;0
12954;189773;231;71;19;1;18;.947;3600000;0
12954;206955;231;0;0;0;0;.00nan;0;0
12954;187217;227;97;33;1;32;.970;3034000;0
13129;195164;218;0;0;0;0;.00nan;0;0
13129;190095;218;71;36;3;33;.917;3900000;0
13129;179679;212;0;0;0;0;.00nan;0;0
13129;-1;212;80;39;3;36;.923;3900000;0
12987;184788;198;60;34;4;30;.882;3600000;0
12987;-1;192;48;0;0;0;.00nan;184000;0
12987;207398;192;39;32;6;26;.813;3349000;0
12987;181443;198;0;0;0;0;.00nan;0;0
13133;192939;208;70;32;3;29;.906;3600000;0
13133;200380;208;0;0;0;0;.00nan;0;0
13133;201525;203;0;0;0;0;.00nan;0;0
13133;191078;203;57;31;4;27;.871;3544000;0
14125;200306;182;0;0;0;0;.00nan;0;0
14125;-1;1371;52;18;2;16;.889;3600000;0
14125;185810;182;81;43;3;40;.930;3545000;0
14125;192688;1371;0;0;0;0;.00nan;0;0
12911;200437;201;85;32;2;30;.938;3790000;0
12911;-1;199;0;0;0;0;.00nan;0;0
12911;-1;201;0;0;0;0;.00nan;0;0
12911;-1;199;54;26;3;23;.885;3790000;0
12865;182467;185;50;30;4;26;.867;3900000;0
12865;-1;181;64;25;4;21;.840;3900000;0
12865;-1;185;0;0;0;0;.00nan;0;0
12865;192552;181;0;0;0;0;.00nan;0;0
12884;205743;2620;0;0;0;0;.00nan;0;0
12884;184650;4864;0;0;0;0;.00nan;0;0
12884;-1;2620;59;36;4;32;.889;3600000;0
12884;186332;4864;63;28;3;25;.893;3600000;0
12880;205837;184;0;0;0;0;.00nan;0;0
12880;190125;184;47;25;4;21;.840;3600000;0
12880;-1;214;0;0;0;0;.00nan;0;0
12880;191518;214;65;42;5;37;.881;3596000;0
12917;190034;217;70;22;1;21;.955;3600000;0
12917;190041;217;0;0;0;0;.00nan;0;0
12917;-1;219;52;37;5;32;.865;3600000;0
12917;-1;219;0;0;0;0;.00nan;0;0
13000;194950;1505;0;0;0;0;.00nan;0;0
13000;-1;183;89;39;3;36;.923;3600000;0
13000;180574;183;0;0;0;0;.00nan;0;0
13000;186549;1505;87;30;1;29;.967;3600000;0
12909;196571;177;23;26;6;20;.769;2334000;0
12909;192461;210;100;26;0;26;1.000;3600000;0
12909;197672;210;0;0;0;0;.00nan;0;0
12909;-1;177;66;12;0;12;1.000;1266000;0
12859;203383;232;65;17;2;15;.882;3570000;0
12859;183695;232;0;0;0;0;.00nan;0;0
12859;184175;224;80;33;1;32;.970;3600000;0
12859;185840;224;0;0;0;0;.00nan;0;0
12903;179499;186;0;0;0;0;.00nan;0;0
12903;184785;211;36;19;4;15;.789;1200000;0
12903;190098;186;55;31;4;27;.871;3600000;0
12903;179646;211;44;25;5;20;.800;2400000;0
14170;198149;188;85;25;2;23;.920;3600000;0
14170;189081;187;45;32;4;28;.875;3528000;0
14170;184409;188;0;0;0;0;.00nan;0;0
14170;-1;187;0;0;0;0;.00nan;0;0
13052;192915;179;0;0;0;0;.00nan;0;0
13052;195251;4949;57;26;3;23;.885;3547000;0
13052;187355;179;75;22;1;21;.955;3600000;0
13052;197685;4949;0;0;0;0;.00nan;0;0
13045;184610;222;51;27;4;23;.852;3600000;0
13045;180377;228;53;26;5;21;.808;3542000;0
13045;185851;222;0;0;0;0;.00nan;0;0
13045;208044;228;0;0;0;0;.00nan;0;0
13037;195238;200;96;52;2;50;.962;3900000;0
13037;201560;202;70;27;2;25;.926;3900000;0
13037;196299;202;0;0;0;0;.00nan;0;0
13037;-1;200;0;0;0;0;.00nan;0;0
12863;198074;195;0;0;0;0;.00nan;0;0
12863;200333;194;31;22;5;17;.773;2125000;0
12863;207061;195;69;24;1;23;.958;3600000;0
12863;196352;194;45;25;4;21;.840;1475000;0
13036;184648;196;58;27;4;23;.852;3570000;0
13036;191118;196;0;0;0;0;.00nan;0;0
13036;192547;190;0;0;0;0;.00nan;0;0
13036;197704;190;79;38;3;35;.921;3600000;0
12860;-1;216;0;0;0;0;.00nan;0;0
12860;-1;178;0;0;0;0;.00nan;0;0
12860;-1;178;100;51;1;50;.980;3600000;0
12860;-1;216;51;16;2;14;.875;3600000;0
12934;184788;198;0;0;0;0;.00nan;0;0
12934;181443;198;74;24;1;23;.958;3900000;0
12934;-1;189;0;0;0;0;.00nan;0;0
12934;-1;189;96;43;1;42;.977;3900000;0
12947;190164;4959;65;20;2;18;.900;3669000;0
12947;206801;176;0;0;0;0;.00nan;0;0
12947;182006;176;58;22;3;19;.864;3669000;0
12947;-1;4959;0;0;0;0;.00nan;0;0
12922;182128;215;100;38;2;36;.947;3600000;0
12922;-1;180;41;31;5;26;.839;3600000;0
12922;197707;180;0;0;0;0;.00nan;0;0
12922;-1;215;0;0;0;0;.00nan;0;0
12953;196283;206;72;32;3;29;.906;3559000;0
12953;192629;226;73;29;2;27;.931;3600000;0
12953;-1;226;0;0;0;0;.00nan;0;0
12953;202998;206;0;0;0;0;.00nan;0;0
12928;200440;204;0;0;0;0;.00nan;0;0
12928;189902;204;53;19;4;15;.789;3616000;0
12928;201525;203;77;42;3;39;.929;3616000;0
12928;191078;203;0;0;0;0;.00nan;0;0
14128;189885;225;75;18;1;17;.944;3600000;0
14128;-1;225;0;0;0;0;.00nan;0;0
14128;191120;223;0;0;0;0;.00nan;0;0
14128;187118;223;68;31;3;28;.903;3600000;0
12955;192939;208;90;38;2;36;.947;3600000;0
12955;200380;208;0;0;0;0;.00nan;0;0
12955;196283;206;0;0;0;0;.00nan;0;0
12955;202998;206;55;33;4;29;.879;3558000;0
12912;200440;204;0;0;0;0;.00nan;0;0
12912;189902;204;14;29;7;22;.759;3600000;0
12912;201524;205;0;0;0;0;.00nan;0;0
12912;-1;205;98;31;0;31;1.000;3600000;0
12866;198149;188;0;0;0;0;.00nan;0;0
12866;184409;188;60;16;1;15;.938;3600000;0
12866;-1;189;83;51;4;47;.922;3600000;0
12866;-1;189;0;0;0;0;.00nan;0;0
12929;182324;4960;0;0;0;0;.00nan;0;0
12929;194219;4960;81;38;3;35;.921;3600000;0
12929;184133;230;0;0;0;0;.00nan;0;0
12929;181338;230;54;18;2;16;.889;3600000;0
12950;179679;212;0;0;0;0;.00nan;0;0
12950;-1;212;54;17;2;15;.882;3600000;0
12950;-1;180;31;29;5;24;.828;2392000;0
12950;197707;180;50;14;2;12;.857;1208000;0
14164;200437;201;0;0;0;0;.00nan;0;0
14164;192629;226;0;0;0;0;.00nan;0;0
14164;-1;226;74;28;2;26;.929;3600000;0
14164;-1;201;73;52;5;47;.904;3600000;0
13028;190164;4959;0;0;0;0;.00nan;0;0
13028;-1;209;72;28;2;26;.929;3600000;0
13028;-1;4959;59;25;3;22;.880;3572000;0
13028;203063;209;0;0;0;0;.00nan;0;0
12920;182467;185;0;0;0;0;.00nan;0;0
12920;-1;1371;0;0;0;0;.00nan;0;0
12920;-1;185;100;55;1;54;.982;3900000;0
12920;192688;1371;96;31;1;30;.968;3900000;0
13149;200452;221;40;35;6;29;.829;2263000;0
13149;189773;231;64;21;1;20;.952;3600000;0
13149;206955;231;0;0;0;0;.00nan;0;0
13149;187431;221;77;14;0;14;1.000;1337000;0
12919;190034;217;0;0;0;0;.00nan;0;0
12919;190041;217;77;12;0;12;1.000;3600000;0
12919;184785;211;0;0;0;0;.00nan;0;0
12919;179646;211;97;46;2;44;.957;3569000;0
12893;201585;197;73;28;2;26;.929;3600000;0
12893;206822;197;0;0;0;0;.00nan;0;0
12893;192547;190;57;26;3;23;.885;3600000;0
12893;197704;190;0;0;0;0;.00nan;0;0
12918;194950;1505;98;36;2;34;.944;3600000;0
12918;195251;4949;55;27;4;23;.852;3546000;0
12918;186549;1505;0;0;0;0;.00nan;0;0
12918;197685;4949;0;0;0;0;.00nan;0;0
12963;200306;182;0;0;0;0;.00nan;0;0
12963;205837;184;0;0;0;0;.00nan;0;0
12963;190125;184;53;38;6;32;.842;3562000;0
12963;185810;182;55;32;4;28;.875;3600000;0
14104;195164;218;47;41;6;35;.854;3569000;0
14104;190095;218;0;0;0;0;.00nan;0;0
14104;-1;219;0;0;0;0;.00nan;0;0
14104;-1;219;57;40;5;35;.875;3600000;0
13044;199416;191;0;0;0;0;.00nan;0;0
13044;194893;191;77;17;1;16;.941;3600000;0
13044;-1;192;60;44;5;39;.886;3600000;0
13044;207398;192;0;0;0;0;.00nan;0;0
12901;189081;187;0;0;0;0;.00nan;0;0
12901;184648;196;0;0;0;0;.00nan;0;0
12901;191118;196;99;46;1;45;.978;3600000;0
12901;-1;187;60;33;4;29;.879;3600000;0
12870;187628;227;69;22;2;20;.909;3600000;0
12870;184175;224;0;0;0;0;.00nan;0;0
12870;185840;224;39;24;5;19;.792;3600000;0
12870;187217;227;0;0;0;0;.00nan;0;0
13025;200333;194;65;25;2;23;.920;3600000;0
13025;184788;198;69;32;3;29;.906;3588000;0
13025;196352;194;0;0;0;0;.00nan;0;0
13025;181443;198;0;0;0;0;.00nan;0;0
12952;205743;2620;0;0;0;0;.00nan;0;0
12952;206801;176;90;52;4;48;.923;3600000;0
12952;182006;176;0;0;0;0;.00nan;0;0
12952;-1;2620;91;19;0;19;1.000;3600000;0
14025;192939;208;0;0;0;0;.00nan;0;0
14025;200380;208;89;37;2;35;.946;3697000;0
14025;-1;199;79;28;1;27;.964;3697000;0
14025;-1;199;0;0;0;0;.00nan;0;0
13020;189885;225;0;0;0;0;.00nan;0;0
13020;-1;225;89;40;3;37;.925;3600000;0
13020;185800;229;72;26;2;24;.923;3600000;0
13020;185960;229;0;0;0;0;.00nan;0;0
13066;199416;191;73;31;2;29;.935;3600000;0
13066;194893;191;0;0;0;0;.00nan;0;0
13066;189529;193;0;0;0;0;.00nan;0;0
13066;186451;193;53;45;6;39;.867;3600000;0
12924;-1;1371;80;28;1;27;.964;3600000;0
12924;-1;214;19;9;4;5;.556;361000;0
12924;191518;214;67;22;2;20;.909;3239000;0
12924;192688;1371;0;0;0;0;.00nan;0;0
12908;203383;232;51;35;4;31;.886;3900000;0
12908;183695;232;0;0;0;0;.00nan;0;0
12908;184133;230;40;23;4;19;.826;3900000;0
12908;181338;230;0;0;0;0;.00nan;0;0
13035;183686;213;0;0;0;0;.00nan;0;0
13035;201495;213;83;43;3;40;.930;3600000;0
13035;196571;177;37;16;4;12;.750;3550000;0
13035;-1;177;0;0;0;0;.00nan;0;0
13053;200306;182;73;37;3;34;.919;3600000;0
13053;-1;220;0;0;0;0;.00nan;0;0
13053;-1;220;97;22;0;22;1.000;3600000;0
13053;185810;182;0;0;0;0;.00nan;0;0
12986;-1;178;0;0;0;0;.00nan;0;0
12986;192461;210;64;18;2;16;.889;3600000;0
12986;197672;210;0;0;0;0;.00nan;0;0
12986;-1;178;98;55;3;52;.945;3579000;0
12982;179499;186;62;41;4;37;.902;3600000;0
12982;190098;186;0;0;0;0;.00nan;0;0
12982;182128;215;0;0;0;0;.00nan;0;0
12982;-1;215;47;36;5;31;.861;3600000;0
13366;205788;207;0;0;0;0;.00nan;0;0
13366;195238;200;0;0;0;0;.00nan;0;0
13366;-1;207;75;29;2;27;.931;3900000;0
13366;-1;200;87;35;2;33;.943;3900000;0
12930;198074;195;43;12;2;10;.833;3600000;0
12930;201585;197;80;44;4;40;.909;3600000;0
12930;206822;197;0;0;0;0;.00nan;0;0
12930;207061;195;0;0;0;0;.00nan;0;0
12981;187628;227;0;0;0;0;.00nan;0;0
12981;191120;223;0;0;0;0;.00nan;0;0
12981;187118;223;69;29;2;27;.931;3900000;0
12981;187217;227;81;24;2;22;.917;3900000;0
13360;-1;219;27;17;4;13;.765;3600000;0
13360;182128;215;100;32;0;32;1.000;3600000;0
13360;-1;219;0;0;0;0;.00nan;0;0
13360;-1;215;0;0;0;0;.00nan;0;0
14130;-1;192;55;26;4;22;.846;3556000;0
14130;207398;192;0;0;0;0;.00nan;0;0
14130;192547;190;0;0;0;0;.00nan;0;0
14130;197704;190;87;44;3;41;.932;3600000;0
12974;200440;204;0;0;0;0;.00nan;0;0
12974;189902;204;51;31;4;27;.871;3697000;0
12974;201524;205;0;0;0;0;.00nan;0;0
12974;-1;205;57;37;5;32;.865;3697000;0
13266;195251;4949;62;32;4;28;.875;3718000;0
13266;196571;177;0;0;0;0;.00nan;0;0
13266;197685;4949;0;0;0;0;.00nan;0;0
13266;-1;177;71;37;3;34;.919;3718000;0
14144;205788;207;20;21;6;15;.714;2593000;0
14144;201525;203;98;25;0;25;1.000;3600000;0
14144;-1;207;32;12;3;9;.750;1007000;0
14144;191078;203;0;0;0;0;.00nan;0;0
14149;-1;216;0;0;0;0;.00nan;0;0
14149;-1;178;42;44;6;38;.864;3600000;0
14149;-1;178;0;0;0;0;.00nan;0;0
14149;-1;216;61;16;2;14;.875;3600000;0
13010;195164;218;44;32;5;27;.844;3600000;0
13010;184785;211;91;32;1;31;.969;3600000;0
13010;190095;218;0;0;0;0;.00nan;0;0
13010;179646;211;0;0;0;0;.00nan;0;0
12926;200437;201;100;41;1;40;.976;3600000;0
12926;-1;199;80;22;1;21;.955;3012000;0
12926;-1;201;0;0;0;0;.00nan;0;0
12926;-1;199;30;10;3;7;.700;588000;0
13083;198074;195;0;0;0;0;.00nan;0;0
13083;184788;198;0;0;0;0;.00nan;0;0
13083;207061;195;93;19;0;19;1.000;3600000;0
13083;181443;198;41;35;6;29;.829;3600000;0
13074;182467;185;100;38;1;37;.974;3900000;0
13074;-1;181;86;26;1;25;.962;3900000;0
13074;-1;185;0;0;0;0;.00nan;0;0
13074;192552;181;0;0;0;0;.00nan;0;0
12997;192939;208;75;36;3;33;.917;3600000;0
12997;200380;208;0;0;0;0;.00nan;0;0
12997;201524;205;69;39;4;35;.897;3559000;0
12997;-1;205;0;0;0;0;.00nan;0;0
14082;200306;182;0;0;0;0;.00nan;0;0
14082;185810;182;56;27;3;24;.889;3591000;0
14082;-1;214;68;27;2;25;.926;3600000;0
14082;191518;214;0;0;0;0;.00nan;0;0
12970;190034;217;40;34;5;29;.853;3578000;0
12970;190041;217;0;0;0;0;.00nan;0;0
12970;-1;219;0;0;0;0;.00nan;0;0
12970;-1;219;68;31;3;28;.903;3600000;0
12991;206801;176;0;0;0;0;.00nan;0;0
12991;182006;176;42;33;5;28;.848;3600000;0
12991;-1;209;39;24;4;20;.833;3600000;0
12991;203063;209;0;0;0;0;.00nan;0;0
13730;192915;179;0;0;0;0;.00nan;0;0
13730;183686;213;95;41;2;39;.951;3593000;0
13730;201495;213;0;0;0;0;.00nan;0;0
13730;187355;179;65;16;1;15;.938;3600000;0
12931;200437;201;0;0;0;0;.00nan;0;0
12931;196283;206;48;34;5;29;.853;3600000;0
12931;-1;201;85;32;1;31;.969;3600000;0
12931;202998;206;0;0;0;0;.00nan;0;0
13260;205743;2620;0;0;0;0;.00nan;0;0
13260;190164;4959;40;21;4;17;.810;2313000;0
13260;-1;2620;76;24;1;23;.958;3600000;0
13260;-1;4959;54;16;2;14;.875;1287000;0
13068;195251;4949;0;0;0;0;.00nan;0;0
13068;192461;210;87;28;1;27;.964;3600000;0
13068;197672;210;0;0;0;0;.00nan;0;0
13068;197685;4949;68;44;4;40;.909;3600000;0
13703;189885;225;53;16;2;14;.875;3545000;0
13703;-1;225;0;0;0;0;.00nan;0;0
13703;185800;229;0;0;0;0;.00nan;0;0
13703;185960;229;85;27;1;26;.963;3600000;0
13104;200452;221;88;52;3;49;.942;3600000;0
13104;184175;224;79;11;0;11;1.000;3600000;0
13104;185840;224;0;0;0;0;.00nan;0;0
13104;187431;221;0;0;0;0;.00nan;0;0
12940;184133;230;0;0;0;0;.00nan;0;0
12940;184610;222;70;41;4;37;.902;3600000;0
12940;181338;230;64;13;1;12;.923;3600000;0
12940;185851;222;0;0;0;0;.00nan;0;0
12925;203383;232;0;0;0;0;.00nan;0;0
12925;183695;232;39;44;7;37;.841;3600000;0
12925;189773;231;91;15;0;15;1.000;3600000;0
12925;206955;231;0;0;0;0;.00nan;0;0
13522;195238;200;89;29;1;28;.966;3600000;0
13522;-1;200;0;0;0;0;.00nan;0;0
13522;192629;226;39;23;4;19;.826;3600000;0
13522;-1;226;0;0;0;0;.00nan;0;0
12869;198149;188;0;0;0;0;.00nan;0;0
12869;184409;188;73;20;1;19;.950;3600000;0
12869;184648;196;60;31;3;28;.903;3562000;0
12869;191118;196;0;0;0;0;.00nan;0;0
13017;187628;227;75;10;0;10;1.000;3600000;0
13017;191120;223;0;0;0;0;.00nan;0;0
13017;187118;223;97;38;1;37;.974;3600000;0
13017;187217;227;0;0;0;0;.00nan;0;0
12948;205837;184;0;0;0;0;.00nan;0;0
12948;-1;1371;0;0;0;0;.00nan;0;0
12948;190125;184;98;32;0;32;1.000;3600000;0
12948;192688;1371;75;40;4;36;.900;3600000;0
12927;203383;232;66;37;3;34;.919;3600000;0
12927;183695;232;0;0;0;0;.00nan;0;0
12927;189773;231;72;20;1;19;.950;3600000;0
12927;206955;231;0;0;0;0;.00nan;0;0
13072;182324;4960;0;0;0;0;.00nan;0;0
13072;194219;4960;41;21;3;18;.857;3575000;0
13072;184175;224;100;48;2;46;.958;3600000;0
13072;185840;224;0;0;0;0;.00nan;0;0
12936;183686;213;0;0;0;0;.00nan;0;0
12936;-1;216;41;21;4;17;.810;3600000;0
12936;201495;213;91;35;1;34;.971;3600000;0
12936;-1;216;0;0;0;0;.00nan;0;0
13063;179679;212;100;24;0;24;1.000;3600000;0
13063;-1;212;0;0;0;0;.00nan;0;0
13063;-1;180;45;30;4;26;.867;3600000;0
13063;197707;180;0;0;0;0;.00nan;0;0
12962;195164;218;79;32;2;30;.938;3600000;0
12962;190034;217;0;0;0;0;.00nan;0;0
12962;190041;217;59;34;4;30;.882;3562000;0
12962;190095;218;0;0;0;0;.00nan;0;0
13123;184785;211;0;0;0;0;.00nan;0;0
13123;179646;211;100;35;0;35;1.000;3600000;0
13123;182128;215;46;21;3;18;.857;3600000;0
13123;-1;215;0;0;0;0;.00nan;0;0
13323;200333;194;33;10;3;7;.700;559000;0
13323;-1;192;59;24;3;21;.875;3600000;0
13323;196352;194;81;37;2;35;.946;3036000;0
13323;207398;192;0;0;0;0;.00nan;0;0
12945;201525;203;91;42;2;40;.952;3600000;0
12945;191078;203;0;0;0;0;.00nan;0;0
12945;-1;199;51;24;3;21;.875;3580000;0
12945;-1;199;0;0;0;0;.00nan;0;0
12958;187628;227;60;23;2;21;.913;3600000;0
12958;191120;223;79;39;3;36;.923;3550000;0
12958;187118;223;0;0;0;0;.00nan;0;0
12958;187217;227;0;0;0;0;.00nan;0;0
13162;189529;193;66;26;2;24;.923;3600000;0
13162;186451;193;0;0;0;0;.00nan;0;0
13162;-1;189;0;0;0;0;.00nan;0;0
13162;-1;189;62;35;4;31;.886;3580000;0
13082;-1;181;0;0;0;0;.00nan;0;0
13082;-1;220;0;0;0;0;.00nan;0;0
13082;-1;220;91;31;1;30;.968;3600000;0
13082;192552;181;98;48;3;45;.938;3550000;0
12960;205837;184;0;0;0;0;.00nan;0;0
12960;-1;1371;0;0;0;0;.00nan;0;0
12960;190125;184;98;42;2;40;.952;3600000;0
12960;192688;1371;91;31;1;30;.968;3600000;0
13006;205788;207;0;0;0;0;.00nan;0;0
13006;-1;207;52;29;4;25;.862;3600000;0
13006;196283;206;0;0;0;0;.00nan;0;0
13006;202998;206;90;29;1;28;.966;3600000;0
14046;195238;200;0;0;0;0;.00nan;0;0
14046;201560;202;50;18;3;15;.833;3600000;0
14046;196299;202;0;0;0;0;.00nan;0;0
14046;-1;200;73;47;4;43;.915;3574000;0
12998;184648;196;61;25;3;22;.880;3600000;0
12998;201585;197;79;48;4;44;.917;3593000;0
12998;206822;197;0;0;0;0;.00nan;0;0
12998;191118;196;0;0;0;0;.00nan;0;0
12969;205743;2620;84;37;2;35;.946;3900000;0
12969;206801;176;70;24;2;22;.917;3900000;0
12969;182006;176;0;0;0;0;.00nan;0;0
12969;-1;2620;0;0;0;0;.00nan;0;0
13009;184650;4864;0;0;0;0;.00nan;0;0
13009;186332;4864;56;28;3;25;.893;3593000;0
13009;-1;209;0;0;0;0;.00nan;0;0
13009;203063;209;83;32;2;30;.938;3600000;0
12989;194950;1505;0;0;0;0;.00nan;0;0
12989;186549;1505;58;18;1;17;.944;3900000;0
12989;-1;178;0;0;0;0;.00nan;0;0
12989;-1;178;100;54;1;53;.981;3900000;0
13033;199416;191;0;0;0;0;.00nan;0;0
13033;194893;191;83;13;0;13;1.000;3600000;0
13033;192547;190;0;0;0;0;.00nan;0;0
13033;197704;190;85;63;6;57;.905;3600000;0
13058;184610;222;0;0;0;0;.00nan;0;0
13058;180377;228;77;31;2;29;.935;3600000;0
13058;185851;222;74;36;3;33;.917;3600000;0
13058;208044;228;0;0;0;0;.00nan;0;0
12979;198149;188;0;0;0;0;.00nan;0;0
12979;189081;187;74;18;2;16;.889;3900000;0
12979;184409;188;74;38;2;36;.947;3900000;0
12979;-1;187;0;0;0;0;.00nan;0;0
13038;-1;183;36;23;5;18;.783;3323000;0
13038;180574;183;53;3;0;3;1.000;277000;0
13038;196571;177;83;40;2;38;.950;3600000;0
13038;-1;177;0;0;0;0;.00nan;0;0
13023;200437;201;0;0;0;0;.00nan;0;0
13023;200440;204;0;0;0;0;.00nan;0;0
13023;189902;204;63;18;2;16;.889;3900000;0
13023;-1;201;96;38;2;36;.947;3900000;0
12992;184788;198;67;15;1;14;.933;3600000;0
12992;201585;197;32;9;3;6;.667;578000;0
12992;206822;197;43;35;6;29;.829;3022000;0
12992;181443;198;0;0;0;0;.00nan;0;0
13170;205788;207;41;35;6;29;.829;2815000;0
13170;-1;207;54;7;0;7;1.000;785000;0
13170;192629;226;62;16;1;15;.938;3600000;0
13170;-1;226;0;0;0;0;.00nan;0;0
13064;182467;185;96;45;2;43;.956;3537000;0
13064;200306;182;0;0;0;0;.00nan;0;0
13064;185810;182;68;21;1;20;.952;3600000;0
13064;-1;185;0;0;0;0;.00nan;0;0
13291;199416;191;72;22;1;21;.955;3600000;0
13291;194893;191;0;0;0;0;.00nan;0;0
13291;-1;192;0;0;0;0;.00nan;0;0
13291;207398;192;64;32;3;29;.906;3561000;0
13061;-1;183;38;34;6;28;.824;3051000;0
13061;180574;183;51;2;0;2;1.000;549000;0
13061;196571;177;0;0;0;0;.00nan;0;0
13061;-1;177;99;18;0;18;1.000;3600000;0
13050;200333;194;0;0;0;0;.00nan;0;0
13050;184788;198;0;0;0;0;.00nan;0;0
13050;196352;194;74;43;4;39;.907;3600000;0
13050;181443;198;35;26;5;21;.808;3600000;0
12965;190034;217;51;21;3;18;.857;3600000;0
12965;190041;217;0;0;0;0;.00nan;0;0
12965;184785;211;0;0;0;0;.00nan;0;0
12965;179646;211;78;47;4;43;.915;3600000;0
13216;201525;203;98;43;1;42;.977;3562000;0
13216;201560;202;83;11;0;11;1.000;3600000;0
13216;196299;202;0;0;0;0;.00nan;0;0
13216;191078;203;0;0;0;0;.00nan;0;0
13040;184650;4864;0;0;0;0;.00nan;0;0
13040;206801;176;0;0;0;0;.00nan;0;0
13040;182006;176;61;28;3;25;.893;3600000;0
13040;186332;4864;50;36;5;31;.861;3569000;0
13022;192939;208;93;27;1;26;.963;3600000;0
13022;200380;208;0;0;0;0;.00nan;0;0
13022;196283;206;79;43;3;40;.930;3600000;0
13022;202998;206;0;0;0;0;.00nan;0;0
12976;189529;193;0;0;0;0;.00nan;0;0
12976;186451;193;62;17;1;16;.941;3600000;0
12976;-1;189;0;0;0;0;.00nan;0;0
12976;-1;189;79;37;3;34;.919;3521000;0
12980;184175;224;80;26;1;25;.962;3600000;0
12980;185840;224;0;0;0;0;.00nan;0;0
12980;191120;223;0;0;0;0;.00nan;0;0
12980;187118;223;78;30;2;28;.933;3600000;0
13029;198074;195;0;0;0;0;.00nan;0;0
13029;207061;195;55;11;1;10;.909;3600000;0
13029;192547;190;85;53;4;49;.925;3279000;0
13029;197704;190;24;6;3;3;.500;321000;0
12932;184133;230;0;0;0;0;.00nan;0;0
12932;189773;231;78;19;0;19;1.000;1626000;0
12932;206955;231;11;20;6;14;.700;1938000;0
12932;181338;230;56;36;5;31;.861;3600000;0
13102;200306;182;77;30;2;28;.933;3600000;0
13102;-1;181;41;27;4;23;.852;3573000;0
13102;185810;182;0;0;0;0;.00nan;0;0
13102;192552;181;0;0;0;0;.00nan;0;0
12973;200440;204;63;32;3;29;.906;3570000;0
12973;189902;204;0;0;0;0;.00nan;0;0
12973;-1;199;0;0;0;0;.00nan;0;0
12973;-1;199;78;29;2;27;.931;3600000;0
13174;189885;225;72;26;2;24;.923;3900000;0
13174;180377;228;80;36;2;34;.944;3900000;0
13174;-1;225;0;0;0;0;.00nan;0;0
13174;208044;228;0;0;0;0;.00nan;0;0
13048;192915;179;91;37;2;35;.946;3900000;0
13048;194950;1505;76;28;2;26;.929;3900000;0
13048;186549;1505;0;0;0;0;.00nan;0;0
13048;187355;179;0;0;0;0;.00nan;0;0
14080;183686;213;0;0;0;0;.00nan;0;0
14080;201495;213;83;41;3;38;.927;3515000;0
14080;192461;210;60;18;1;17;.944;3600000;0
14080;197672;210;0;0;0;0;.00nan;0;0
13081;201524;205;0;0;0;0;.00nan;0;0
13081;-1;205;70;43;4;39;.907;3544000;0
13081;192629;226;0;0;0;0;.00nan;0;0
13081;-1;226;66;28;3;25;.893;3600000;0
12942;-1;1371;0;0;0;0;.00nan;0;0
12942;-1;214;74;22;1;21;.955;3600000;0
12942;191518;214;0;0;0;0;.00nan;0;0
12942;192688;1371;48;19;3;16;.842;3562000;0
13077;200437;201;64;38;4;34;.895;3600000;0
13077;195238;200;70;21;1;20;.952;3600000;0
13077;-1;200;0;0;0;0;.00nan;0;0
13077;-1;201;0;0;0;0;.00nan;0;0
13273;195164;218;58;36;4;32;.889;3600000;0
13273;190095;218;0;0;0;0;.00nan;0;0
13273;-1;219;74;25;1;24;.960;3600000;0
13273;-1;219;0;0;0;0;.00nan;0;0
13240;179499;186;76;29;2;27;.931;3600000;0
13240;190098;186;0;0;0;0;.00nan;0;0
13240;179679;212;31;15;4;11;.733;1139000;0
13240;-1;212;76;28;2;26;.929;2461000;0
13088;182324;4960;63;25;3;22;.880;3600000;0
13088;194219;4960;0;0;0;0;.00nan;0;0
13088;200452;221;100;22;0;22;1.000;3600000;0
13088;187431;221;0;0;0;0;.00nan;0;0
12988;182467;185;0;0;0;0;.00nan;0;0
12988;-1;220;0;0;0;0;.00nan;0;0
12988;-1;220;56;17;2;15;.882;3548000;0
12988;-1;185;100;38;1;37;.974;3600000;0
12983;182128;215;0;0;0;0;.00nan;0;0
12983;-1;180;73;33;4;29;.879;3600000;0
12983;197707;180;0;0;0;0;.00nan;0;0
12983;-1;215;89;25;1;24;.960;3600000;0
12874;-1;216;0;0;0;0;.00nan;0;0
12874;-1;178;0;0;0;0;.00nan;0;0
12874;-1;178;89;48;2;46;.958;3900000;0
12874;-1;216;72;22;2;20;.909;3900000;0
13325;200452;221;45;24;4;20;.833;3851000;0
13325;180377;228;0;0;0;0;.00nan;0;0
13325;187431;221;0;0;0;0;.00nan;0;0
13325;208044;228;83;44;3;41;.932;3851000;0
12906;-1;216;65;31;3;28;.903;3594000;0
12906;192461;210;0;0;0;0;.00nan;0;0
12906;197672;210;55;17;2;15;.882;3600000;0
12906;-1;216;0;0;0;0;.00nan;0;0
13115;195251;4949;85;17;0;17;1.000;3600000;0
13115;-1;183;78;40;3;37;.925;3600000;0
13115;180574;183;0;0;0;0;.00nan;0;0
13115;197685;4949;0;0;0;0;.00nan;0;0
13393;199416;191;0;0;0;0;.00nan;0;0
13393;194893;191;59;11;1;10;.909;3600000;0
13393;201585;197;94;49;3;46;.939;3245000;0
13393;206822;197;24;5;3;2;.400;355000;0
12984;184648;196;76;23;1;22;.957;3600000;0
12984;191118;196;0;0;0;0;.00nan;0;0
12984;-1;189;65;25;2;23;.920;3551000;0
12984;-1;189;0;0;0;0;.00nan;0;0
12946;205837;184;0;0;0;0;.00nan;0;0
12946;190125;184;68;29;3;26;.897;3600000;0
12946;-1;214;0;0;0;0;.00nan;0;0
12946;191518;214;28;31;6;25;.806;3600000;0
14165;205743;2620;0;0;0;0;.00nan;0;0
14165;206801;176;78;44;3;41;.932;3900000;0
14165;182006;176;0;0;0;0;.00nan;0;0
14165;-1;2620;40;17;3;14;.824;3900000;0
13114;192915;179;0;0;0;0;.00nan;0;0
13114;187355;179;33;22;5;17;.773;3900000;0
13114;-1;178;70;46;5;41;.891;3900000;0
13114;-1;178;0;0;0;0;.00nan;0;0
13122;201524;205;0;0;0;0;.00nan;0;0
13122;201560;202;33;19;4;15;.789;3545000;0
13122;196299;202;0;0;0;0;.00nan;0;0
13122;-1;205;73;41;3;38;.927;3600000;0
13480;189081;187;54;25;3;22;.880;3600000;0
13480;-1;192;39;29;5;24;.828;2077000;0
13480;207398;192;54;18;2;16;.889;1523000;0
13480;-1;187;0;0;0;0;.00nan;0;0
13041;200333;194;75;38;3;35;.921;3565000;0
13041;189529;193;56;15;2;13;.867;3600000;0
13041;196352;194;0;0;0;0;.00nan;0;0
13041;186451;193;0;0;0;0;.00nan;0;0
13039;190164;4959;0;0;0;0;.00nan;0;0
13039;-1;209;96;44;2;42;.955;3900000;0
13039;-1;4959;65;22;2;20;.909;3900000;0
13039;203063;209;0;0;0;0;.00nan;0;0
13075;187628;227;0;0;0;0;.00nan;0;0
13075;185800;229;77;38;3;35;.921;3900000;0
13075;185960;229;0;0;0;0;.00nan;0;0
13075;187217;227;64;33;3;30;.909;3900000;0
13080;195164;218;82;40;3;37;.925;3600000;0
13080;190095;218;0;0;0;0;.00nan;0;0
13080;182128;215;35;25;5;20;.800;3582000;0
13080;-1;215;0;0;0;0;.00nan;0;0
13198;189885;225;0;0;0;0;.00nan;0;0
13198;184610;222;75;31;3;28;.903;3600000;0
13198;-1;225;66;53;7;46;.868;3600000;0
13198;185851;222;0;0;0;0;.00nan;0;0
13032;198074;195;67;30;2;28;.933;3600000;0
13032;198149;188;0;0;0;0;.00nan;0;0
13032;184409;188;52;23;3;20;.870;3587000;0
13032;207061;195;0;0;0;0;.00nan;0;0
12956;203383;232;55;36;4;32;.889;3547000;0
12956;183695;232;0;0;0;0;.00nan;0;0
12956;184133;230;59;19;3;16;.842;3600000;0
12956;181338;230;0;0;0;0;.00nan;0;0
14169;205837;184;0;0;0;0;.00nan;0;0
14169;190125;184;100;44;2;42;.955;3900000;0
14169;-1;220;65;21;2;19;.905;3900000;0
14169;-1;220;0;0;0;0;.00nan;0;0
13011;-1;219;0;0;0;0;.00nan;0;0
13011;-1;219;77;22;1;21;.955;3600000;0
13011;-1;180;50;27;4;23;.852;3600000;0
13011;197707;180;0;0;0;0;.00nan;0;0
14100;182324;4960;0;0;0;0;.00nan;0;0
14100;187628;227;55;32;4;28;.875;3600000;0
14100;194219;4960;100;28;0;28;1.000;3600000;0
14100;187217;227;0;0;0;0;.00nan;0;0
14098;200437;201;0;0;0;0;.00nan;0;0
14098;195238;200;0;0;0;0;.00nan;0;0
14098;-1;200;97;24;0;24;1.000;3600000;0
14098;-1;201;55;37;5;32;.865;3600000;0
13089;192939;208;91;37;2;35;.946;3600000;0
13089;200380;208;0;0;0;0;.00nan;0;0
13089;200440;204;0;0;0;0;.00nan;0;0
13089;189902;204;54;28;4;24;.857;3592000;0
14111;-1;183;0;0;0;0;.00nan;0;0
14111;180574;183;45;28;5;23;.821;3600000;0
14111;196571;177;0;0;0;0;.00nan;0;0
14111;-1;177;57;29;4;25;.862;3574000;0
13268;205743;2620;58;16;1;15;.938;3600000;0
13268;-1;2620;0;0;0;0;.00nan;0;0
13268;-1;209;0;0;0;0;.00nan;0;0
13268;203063;209;93;50;3;47;.940;3568000;0
14145;203383;232;0;0;0;0;.00nan;0;0
14145;183695;232;54;12;2;10;.833;3600000;0
14145;184175;224;39;25;5;20;.800;3600000;0
14145;185840;224;0;0;0;0;.00nan;0;0
13069;184650;4864;0;0;0;0;.00nan;0;0
13069;190164;4959;91;19;0;19;1.000;3600000;0
13069;186332;4864;62;34;4;30;.882;3600000;0
13069;-1;4959;0;0;0;0;.00nan;0;0
13012;201525;203;0;0;0;0;.00nan;0;0
13012;191078;203;60;28;3;25;.893;3600000;0
13012;-1;199;70;27;2;25;.926;3600000;0
13012;-1;199;0;0;0;0;.00nan;0;0
13001;-1;1371;0;0;0;0;.00nan;0;0
13001;-1;220;0;0;0;0;.00nan;0;0
13001;-1;220;33;30;6;24;.800;3578000;0
13001;192688;1371;93;43;4;39;.907;3600000;0
13007;194950;1505;0;0;0;0;.00nan;0;0
13007;186549;1505;79;27;1;26;.963;3600000;0
13007;192461;210;77;38;3;35;.921;3514000;0
13007;197672;210;0;0;0;0;.00nan;0;0
13403;195251;4949;48;23;3;20;.870;3900000;0
13403;196571;177;99;53;3;50;.943;3900000;0
13403;197685;4949;0;0;0;0;.00nan;0;0
13403;-1;177;0;0;0;0;.00nan;0;0
13246;205788;207;0;0;0;0;.00nan;0;0
13246;201560;202;0;0;0;0;.00nan;0;0
13246;-1;207;52;32;4;28;.875;3549000;0
13246;196299;202;71;24;2;22;.917;3600000;0
13159;184785;211;95;38;2;36;.947;3600000;0
13159;179646;211;0;0;0;0;.00nan;0;0
13159;179679;212;72;21;1;20;.952;3174000;0
13159;-1;212;23;4;3;1;.250;360000;0
14107;198074;195;0;0;0;0;.00nan;0;0
14107;189529;193;0;0;0;0;.00nan;0;0
14107;207061;195;52;10;1;9;.900;3600000;0
14107;186451;193;67;33;3;30;.909;3542000;0
13797;195164;218;65;28;3;25;.893;3600000;0
13797;190095;218;0;0;0;0;.00nan;0;0
13797;-1;219;78;45;4;41;.911;3600000;0
13797;-1;219;0;0;0;0;.00nan;0;0
13800;200306;182;0;0;0;0;.00nan;0;0
13800;185810;182;69;21;1;20;.952;3572000;0
13800;-1;214;87;19;0;19;1.000;3600000;0
13800;191518;214;0;0;0;0;.00nan;0;0
13090;182324;4960;63;30;3;27;.900;3600000;0
13090;194219;4960;0;0;0;0;.00nan;0;0
13090;185800;229;0;0;0;0;.00nan;0;0
13090;185960;229;77;27;1;26;.963;3600000;0
13100;189081;187;65;28;3;25;.893;3554000;0
13100;192547;190;91;49;2;47;.959;3600000;0
13100;-1;187;0;0;0;0;.00nan;0;0
13100;197704;190;0;0;0;0;.00nan;0;0
13005;190034;217;0;0;0;0;.00nan;0;0
13005;190041;217;85;14;0;14;1.000;3600000;0
13005;182128;215;0;0;0;0;.00nan;0;0
13005;-1;215;82;43;3;40;.930;3600000;0
12957;184133;230;0;0;0;0;.00nan;0;0
12957;189885;225;81;40;2;38;.950;3600000;0
12957;181338;230;77;11;0;11;1.000;3600000;0
12957;-1;225;0;0;0;0;.00nan;0;0
13051;192629;226;63;24;2;22;.917;3600000;0
13051;-1;226;0;0;0;0;.00nan;0;0
13051;-1;199;0;0;0;0;.00nan;0;0
13051;-1;199;76;42;4;38;.905;3535000;0
13071;206801;176;75;28;3;25;.893;3600000;0
13071;182006;176;0;0;0;0;.00nan;0;0
13071;-1;209;59;34;4;30;.882;3563000;0
13071;203063;209;0;0;0;0;.00nan;0;0
13229;184650;4864;0;0;0;0;.00nan;0;0
13229;190164;4959;0;0;0;0;.00nan;0;0
13229;186332;4864;76;41;4;37;.902;3600000;0
13229;-1;4959;68;15;1;14;.933;3600000;0
13105;184788;198;71;31;3;28;.903;3600000;0
13105;201585;197;75;56;6;50;.893;3600000;0
13105;206822;197;0;0;0;0;.00nan;0;0
13105;181443;198;0;0;0;0;.00nan;0;0
12964;-1;216;0;0;0;0;.00nan;0;0
12964;192461;210;83;34;2;32;.941;3600000;0
12964;197672;210;0;0;0;0;.00nan;0;0
12964;-1;216;38;30;5;25;.833;3600000;0
13078;187628;227;51;29;4;25;.862;3600000;0
13078;200452;221;42;33;5;28;.848;3571000;0
13078;187217;227;0;0;0;0;.00nan;0;0
13078;187431;221;0;0;0;0;.00nan;0;0
13252;200333;194;80;33;2;31;.939;3600000;0
13252;196352;194;0;0;0;0;.00nan;0;0
13252;-1;189;0;0;0;0;.00nan;0;0
13252;-1;189;94;35;1;34;.971;3600000;0
13180;200306;182;49;39;6;33;.846;3292000;0
13180;-1;181;43;31;5;26;.839;3600000;0
13180;185810;182;53;2;0;2;1.000;256000;0
13180;192552;181;0;0;0;0;.00nan;0;0
13042;198149;188;0;0;0;0;.00nan;0;0
13042;199416;191;0;0;0;0;.00nan;0;0
13042;194893;191;62;20;2;18;.900;3600000;0
13042;184409;188;61;42;5;37;.881;3600000;0
13019;184610;222;57;27;3;24;.889;3600000;0
13019;185851;222;0;0;0;0;.00nan;0;0
13019;191120;223;0;0;0;0;.00nan;0;0
13019;187118;223;74;34;4;30;.882;3600000;0
13425;192939;208;100;33;0;33;1.000;3600000;0
13425;200380;208;0;0;0;0;.00nan;0;0
13425;201525;203;89;36;3;33;.917;3600000;0
13425;191078;203;0;0;0;0;.00nan;0;0
13043;205788;207;40;21;4;17;.810;3553000;0
13043;-1;207;0;0;0;0;.00nan;0;0
13043;196283;206;0;0;0;0;.00nan;0;0
13043;202998;206;74;33;3;30;.909;3600000;0
13049;189081;187;0;0;0;0;.00nan;0;0
13049;184648;196;50;40;5;35;.875;3600000;0
13049;191118;196;0;0;0;0;.00nan;0;0
13049;-1;187;69;27;2;25;.926;3600000;0
13120;189773;231;66;15;1;14;.933;3600000;0
13120;206955;231;0;0;0;0;.00nan;0;0
13120;180377;228;79;49;5;44;.898;3600000;0
13120;208044;228;0;0;0;0;.00nan;0;0
13098;200440;204;0;0;0;0;.00nan;0;0
13098;189902;204;67;24;2;22;.917;3600000;0
13098;201524;205;0;0;0;0;.00nan;0;0
13098;-1;205;27;32;6;26;.813;3600000;0
13184;200437;201;57;39;6;33;.846;3600000;0
13184;192629;226;0;0;0;0;.00nan;0;0
13184;-1;226;61;27;3;24;.889;3600000;0
13184;-1;201;0;0;0;0;.00nan;0;0
13177;201585;197;56;18;2;16;.889;3600000;0
13177;206822;197;0;0;0;0;.00nan;0;0
13177;-1;189;50;33;5;28;.848;3600000;0
13177;-1;189;0;0;0;0;.00nan;0;0
13215;179499;186;0;0;0;0;.00nan;0;0
13215;190098;186;92;30;1;29;.967;3600000;0
13215;179679;212;0;0;0;0;.00nan;0;0
13215;-1;212;58;30;3;27;.900;3592000;0
12985;-1;1371;0;0;0;0;.00nan;0;0
12985;-1;220;0;0;0;0;.00nan;0;0
12985;-1;220;54;32;4;28;.875;3600000;0
12985;192688;1371;77;25;1;24;.960;3600000;0
12995;187628;227;0;0;0;0;.00nan;0;0
12995;184133;230;0;0;0;0;.00nan;0;0
12995;181338;230;88;22;1;21;.955;3600000;0
12995;187217;227;73;40;3;37;.925;3521000;0
13124;-1;219;54;31;3;28;.903;3822000;0
13124;-1;219;0;0;0;0;.00nan;0;0
13124;-1;180;0;0;0;0;.00nan;0;0
13124;197707;180;68;38;4;34;.895;3822000;0
13139;200440;204;79;36;3;33;.917;3559000;0
13139;195238;200;0;0;0;0;.00nan;0;0
13139;189902;204;0;0;0;0;.00nan;0;0
13139;-1;200;69;27;2;25;.926;3600000;0
13136;198149;188;67;25;1;24;.960;3600000;0
13136;184409;188;0;0;0;0;.00nan;0;0
13136;192547;190;0;0;0;0;.00nan;0;0
13136;197704;190;94;41;2;39;.951;3573000;0
13119;184175;224;71;23;2;21;.913;3600000;0
13119;189885;225;0;0;0;0;.00nan;0;0
13119;-1;225;69;49;5;44;.898;3600000;0
13119;185840;224;0;0;0;0;.00nan;0;0
13721;199416;191;65;18;1;17;.944;3600000;0
13721;200333;194;0;0;0;0;.00nan;0;0
13721;194893;191;0;0;0;0;.00nan;0;0
13721;196352;194;98;47;2;45;.957;3600000;0
13016;203383;232;82;27;1;26;.963;3600000;0
13016;183695;232;0;0;0;0;.00nan;0;0
13016;180377;228;0;0;0;0;.00nan;0;0
13016;208044;228;44;32;5;27;.844;3600000;0
14060;195164;218;71;28;2;26;.929;3557000;0
14060;190095;218;0;0;0;0;.00nan;0;0
14060;182128;215;83;30;1;29;.967;3600000;0
14060;-1;215;0;0;0;0;.00nan;0;0
13015;184648;196;52;29;4;25;.862;3590000;0
13015;184788;198;0;0;0;0;.00nan;0;0
13015;181443;198;58;28;3;25;.893;3600000;0
13015;191118;196;0;0;0;0;.00nan;0;0
13046;201560;202;42;20;4;16;.800;3629000;0
13046;196299;202;0;0;0;0;.00nan;0;0
13046;-1;199;100;55;3;52;.945;3629000;0
13046;-1;199;0;0;0;0;.00nan;0;0
13290;182467;185;81;32;3;29;.906;3600000;0
13290;-1;185;0;0;0;0;.00nan;0;0
13290;-1;214;36;28;5;23;.821;3600000;0
13290;191518;214;0;0;0;0;.00nan;0;0
13060;201524;205;58;22;3;19;.864;3525000;0
13060;196283;206;93;38;1;37;.974;3600000;0
13060;-1;205;0;0;0;0;.00nan;0;0
13060;202998;206;0;0;0;0;.00nan;0;0
13320;184650;4864;74;21;2;19;.905;3600000;0
13320;190164;4959;82;35;3;32;.914;3541000;0
13320;186332;4864;0;0;0;0;.00nan;0;0
13320;-1;4959;0;0;0;0;.00nan;0;0
13151;189773;231;93;21;0;21;1.000;3600000;0
13151;206955;231;0;0;0;0;.00nan;0;0
13151;185800;229;48;38;5;33;.868;3600000;0
13151;185960;229;0;0;0;0;.00nan;0;0
13144;205743;2620;0;0;0;0;.00nan;0;0
13144;-1;2620;86;23;1;22;.957;3600000;0
13144;-1;209;0;0;0;0;.00nan;0;0
13144;203063;209;52;37;5;32;.865;3600000;0
13003;190034;217;71;27;2;25;.926;3600000;0
13003;190041;217;0;0;0;0;.00nan;0;0
13003;184785;211;78;42;4;38;.905;3600000;0
13003;179646;211;0;0;0;0;.00nan;0;0
13359;192915;179;83;32;2;30;.938;3600000;0
13359;196571;177;0;0;0;0;.00nan;0;0
13359;187355;179;0;0;0;0;.00nan;0;0
13359;-1;177;85;35;3;32;.914;3569000;0
12923;-1;216;49;23;3;20;.870;3590000;0
12923;-1;183;86;27;1;26;.963;3600000;0
12923;180574;183;0;0;0;0;.00nan;0;0
12923;-1;216;0;0;0;0;.00nan;0;0
13084;205837;184;0;0;0;0;.00nan;0;0
13084;190125;184;100;21;0;21;1.000;3600000;0
13084;-1;220;70;35;3;32;.914;3600000;0
13084;-1;220;0;0;0;0;.00nan;0;0
13130;195251;4949;95;21;0;21;1.000;3600000;0
13130;-1;178;55;5;0;5;1.000;624000;0
13130;197685;4949;0;0;0;0;.00nan;0;0
13130;-1;178;44;52;6;46;.885;2976000;0
13145;-1;219;0;0;0;0;.00nan;0;0
13145;-1;219;87;32;2;30;.938;3600000;0
13145;-1;180;26;37;7;30;.811;3171000;0
13145;197707;180;59;7;0;7;1.000;429000;0
13169;200437;201;63;21;2;19;.905;1631000;0
13169;201560;202;78;15;0;15;1.000;3600000;0
13169;196299;202;0;0;0;0;.00nan;0;0
13169;-1;201;30;33;6;27;.818;1969000;0
12999;200306;182;0;0;0;0;.00nan;0;0
12999;-1;1371;0;0;0;0;.00nan;0;0
12999;185810;182;92;39;2;37;.949;3600000;0
12999;192688;1371;52;21;3;18;.857;3551000;0
13137;200452;221;0;0;0;0;.00nan;0;0
13137;191120;223;0;0;0;0;.00nan;0;0
13137;187118;223;78;35;2;33;.943;3600000;0
13137;187431;221;62;31;3;28;.903;3555000;0
13202;192939;208;38;26;5;21;.808;3600000;0
13202;200380;208;0;0;0;0;.00nan;0;0
13202;201525;203;90;37;1;36;.973;3600000;0
13202;191078;203;0;0;0;0;.00nan;0;0
13308;195164;218;67;44;5;39;.886;3600000;0
13308;190095;218;0;0;0;0;.00nan;0;0
13308;179679;212;76;26;1;25;.962;3600000;0
13308;-1;212;0;0;0;0;.00nan;0;0
13210;179499;186;57;14;1;13;.929;3600000;0
13210;184785;211;0;0;0;0;.00nan;0;0
13210;190098;186;0;0;0;0;.00nan;0;0
13210;179646;211;60;44;6;38;.864;3600000;0
13187;190164;4959;0;0;0;0;.00nan;0;0
13187;-1;209;45;23;3;20;.870;3541000;0
13187;-1;4959;99;40;1;39;.975;3600000;0
13187;203063;209;0;0;0;0;.00nan;0;0
13183;198074;195;0;0;0;0;.00nan;0;0
13183;189081;187;44;36;5;31;.861;3600000;0
13183;207061;195;83;26;1;25;.962;3600000;0
13183;-1;187;0;0;0;0;.00nan;0;0
13099;-1;178;88;47;4;43;.915;3711000;0
13099;192461;210;50;23;3;20;.870;3711000;0
13099;197672;210;0;0;0;0;.00nan;0;0
13099;-1;178;0;0;0;0;.00nan;0;0
12978;184133;230;0;0;0;0;.00nan;0;0
12978;180377;228;33;12;3;9;.750;585000;0
12978;181338;230;59;12;1;11;.917;3600000;0
12978;208044;228;33;32;6;26;.813;3015000;0
13109;200440;204;0;0;0;0;.00nan;0;0
13109;189902;204;76;30;2;28;.933;3600000;0
13109;201524;205;0;0;0;0;.00nan;0;0
13109;-1;205;61;37;4;33;.892;3600000;0
13142;182324;4960;0;0;0;0;.00nan;0;0
13142;194219;4960;79;40;3;37;.925;3542000;0
13142;189773;231;76;19;1;18;.947;3600000;0
13142;206955;231;0;0;0;0;.00nan;0;0
12921;192915;179;99;40;1;39;.975;3600000;0
12921;-1;216;0;0;0;0;.00nan;0;0
12921;187355;179;0;0;0;0;.00nan;0;0
12921;-1;216;31;27;6;21;.778;3600000;0
13110;205743;2620;0;0;0;0;.00nan;0;0
13110;206801;176;58;23;3;20;.870;3600000;0
13110;182006;176;0;0;0;0;.00nan;0;0
13110;-1;2620;52;31;4;27;.871;3558000;0
13085;189529;193;0;0;0;0;.00nan;0;0
13085;186451;193;63;29;4;25;.862;3600000;0
13085;192547;190;0;0;0;0;.00nan;0;0
13085;197704;190;57;40;5;35;.875;3553000;0
13163;184175;224;79;23;1;22;.957;3600000;0
13163;185800;229;97;34;2;32;.941;3554000;0
13163;185840;224;0;0;0;0;.00nan;0;0
13163;185960;229;0;0;0;0;.00nan;0;0
13021;190034;217;0;0;0;0;.00nan;0;0
13021;190041;217;45;35;5;30;.857;3890000;0
13021;182128;215;0;0;0;0;.00nan;0;0
13021;-1;215;72;41;4;37;.902;3890000;0
13107;-1;181;100;23;0;23;1.000;3600000;0
13107;-1;214;80;27;1;26;.963;3600000;0
13107;191518;214;0;0;0;0;.00nan;0;0
13107;192552;181;0;0;0;0;.00nan;0;0
13030;203383;232;72;21;1;20;.952;3600000;0
13030;183695;232;0;0;0;0;.00nan;0;0
13030;184610;222;72;29;2;27;.931;3573000;0
13030;185851;222;0;0;0;0;.00nan;0;0
13054;194950;1505;0;0;0;0;.00nan;0;0
13054;-1;183;0;0;0;0;.00nan;0;0
13054;180574;183;1;28;9;19;.679;3600000;0
13054;186549;1505;54;28;3;25;.893;3600000;0
13047;195238;200;65;29;3;26;.897;3900000;0
13047;-1;200;0;0;0;0;.00nan;0;0
13047;-1;199;0;0;0;0;.00nan;0;0
13047;-1;199;49;23;3;20;.870;3895000;0
13059;200333;194;59;41;6;35;.854;3600000;0
13059;184648;196;50;23;4;19;.826;3600000;0
13059;196352;194;0;0;0;0;.00nan;0;0
13059;191118;196;0;0;0;0;.00nan;0;0
13391;201524;205;0;0;0;0;.00nan;0;0
13391;196283;206;0;0;0;0;.00nan;0;0
13391;-1;205;98;18;0;18;1.000;3600000;0
13391;202998;206;75;46;4;42;.913;3600000;0
13343;182324;4960;0;0;0;0;.00nan;0;0
13343;194219;4960;59;21;2;19;.905;3600000;0
13343;200452;221;47;32;5;27;.844;3600000;0
13343;187431;221;0;0;0;0;.00nan;0;0
13465;183686;213;0;0;0;0;.00nan;0;0
13465;195251;4949;72;15;1;14;.933;3600000;0
13465;201495;213;69;36;3;33;.917;3564000;0
13465;197685;4949;0;0;0;0;.00nan;0;0
14085;190164;4959;67;18;1;17;.944;3600000;0
14085;-1;209;0;0;0;0;.00nan;0;0
14085;-1;4959;0;0;0;0;.00nan;0;0
14085;203063;209;59;27;3;24;.889;3576000;0
13222;199416;191;0;0;0;0;.00nan;0;0
13222;194893;191;66;13;1;12;.923;3600000;0
13222;-1;189;0;0;0;0;.00nan;0;0
13222;-1;189;98;58;3;55;.948;3572000;0
13125;187628;227;58;27;3;24;.889;3571000;0
13125;184610;222;0;0;0;0;.00nan;0;0
13125;185851;222;99;37;1;36;.973;3600000;0
13125;187217;227;0;0;0;0;.00nan;0;0
13249;201525;203;0;0;0;0;.00nan;0;0
13249;201560;202;82;29;2;27;.931;3600000;0
13249;196299;202;0;0;0;0;.00nan;0;0
13249;191078;203;74;43;4;39;.907;3593000;0
13176;184175;224;73;26;1;25;.962;3555000;0
13176;185800;229;0;0;0;0;.00nan;0;0
13176;185840;224;0;0;0;0;.00nan;0;0
13176;185960;229;100;23;0;23;1.000;3600000;0
13161;200306;182;0;0;0;0;.00nan;0;0
13161;205837;184;0;0;0;0;.00nan;0;0
13161;190125;184;54;24;3;21;.875;3580000;0
13161;185810;182;87;29;1;28;.966;3600000;0
13112;189529;193;85;40;3;37;.925;3552000;0
13112;184788;198;84;33;2;31;.939;3600000;0
13112;181443;198;0;0;0;0;.00nan;0;0
13112;186451;193;0;0;0;0;.00nan;0;0
14154;-1;1371;0;0;0;0;.00nan;0;0
14154;-1;220;0;0;0;0;.00nan;0;0
14154;-1;220;73;33;3;30;.909;3900000;0
14154;192688;1371;100;48;3;45;.938;3900000;0
13302;195164;218;56;31;4;27;.871;3600000;0
13302;179499;186;74;28;2;26;.929;3136000;0
13302;190095;218;0;0;0;0;.00nan;0;0
13302;190098;186;28;8;3;5;.625;435000;0
13733;189081;187;0;0;0;0;.00nan;0;0
13733;-1;192;100;33;0;33;1.000;3600000;0
13733;207398;192;0;0;0;0;.00nan;0;0
13733;-1;187;79;36;2;34;.944;3522000;0
13091;194950;1505;85;37;2;35;.946;3600000;0
13091;196571;177;54;34;4;30;.882;3517000;0
13091;186549;1505;0;0;0;0;.00nan;0;0
13091;-1;177;0;0;0;0;.00nan;0;0
13190;198074;195;48;14;2;12;.857;3541000;0
13190;200333;194;0;0;0;0;.00nan;0;0
13190;207061;195;0;0;0;0;.00nan;0;0
13190;196352;194;100;42;1;41;.976;3600000;0
14150;190034;217;100;32;0;32;1.000;3600000;0
14150;190041;217;0;0;0;0;.00nan;0;0
14150;-1;219;71;39;3;36;.923;3600000;0
14150;-1;219;0;0;0;0;.00nan;0;0
13116;-1;181;75;19;1;18;.947;3600000;0
13116;-1;214;0;0;0;0;.00nan;0;0
13116;191518;214;79;49;4;45;.918;3600000;0
13116;192552;181;0;0;0;0;.00nan;0;0
14000;200440;204;0;0;0;0;.00nan;0;0
14000;189902;204;77;28;2;26;.929;3900000;0
14000;192629;226;85;30;2;28;.933;3900000;0
14000;-1;226;0;0;0;0;.00nan;0;0
13196;182128;215;76;39;4;35;.897;3684000;0
13196;-1;180;48;21;3;18;.857;3684000;0
13196;197707;180;0;0;0;0;.00nan;0;0
13196;-1;215;0;0;0;0;.00nan;0;0
13087;195238;200;35;30;5;25;.833;3575000;0
13087;196283;206;54;31;4;27;.871;3600000;0
13087;-1;200;0;0;0;0;.00nan;0;0
13087;202998;206;0;0;0;0;.00nan;0;0
13520;192939;208;69;33;3;30;.909;3573000;0
13520;200380;208;0;0;0;0;.00nan;0;0
13520;205788;207;0;0;0;0;.00nan;0;0
13520;-1;207;100;40;1;39;.975;3600000;0
13542;192915;179;0;0;0;0;.00nan;0;0
13542;183686;213;67;33;3;30;.909;3900000;0
13542;201495;213;0;0;0;0;.00nan;0;0
13542;187355;179;66;26;3;23;.885;3900000;0
13070;203383;232;0;0;0;0;.00nan;0;0
13070;183695;232;62;17;2;15;.882;3549000;0
13070;189885;225;0;0;0;0;.00nan;0;0
13070;-1;225;94;34;1;33;.971;3600000;0
13203;200437;201;75;31;2;29;.935;3537000;0
13203;192629;226;0;0;0;0;.00nan;0;0
13203;-1;226;100;37;0;37;1.000;3600000;0
13203;-1;201;0;0;0;0;.00nan;0;0
13067;205743;2620;0;0;0;0;.00nan;0;0
13067;206801;176;66;29;3;26;.897;3623000;0
13067;182006;176;0;0;0;0;.00nan;0;0
13067;-1;2620;65;24;2;22;.917;3623000;0
13138;198149;188;0;0;0;0;.00nan;0;0
13138;184409;188;50;14;2;12;.857;3600000;0
13138;201585;197;98;53;3;50;.943;3600000;0
13138;206822;197;0;0;0;0;.00nan;0;0
13221;184785;211;0;0;0;0;.00nan;0;0
13221;179646;211;99;46;2;44;.957;3600000;0
13221;179679;212;64;11;0;11;1.000;874000;0
13221;-1;212;7;24;7;17;.708;2726000;0
13086;195251;4949;58;31;4;27;.871;3586000;0
13086;-1;183;88;36;2;34;.944;3600000;0
13086;180574;183;0;0;0;0;.00nan;0;0
13086;197685;4949;0;0;0;0;.00nan;0;0
13055;182467;185;59;33;4;29;.879;3600000;0
13055;-1;1371;98;37;1;36;.973;3600000;0
13055;-1;185;0;0;0;0;.00nan;0;0
13055;192688;1371;0;0;0;0;.00nan;0;0
13244;196571;177;0;0;0;0;.00nan;0;0
13244;-1;178;0;0;0;0;.00nan;0;0
13244;-1;178;100;33;0;33;1.000;3600000;0
13244;-1;177;54;26;3;23;.885;3600000;0
13065;205837;184;91;20;0;20;1.000;3600000;0
13065;190125;184;0;0;0;0;.00nan;0;0
13065;-1;220;28;7;3;4;.571;529000;0
13065;-1;220;81;38;3;35;.921;3071000;0
13535;195164;218;93;45;2;43;.956;3900000;0
13535;190095;218;0;0;0;0;.00nan;0;0
13535;-1;219;76;40;2;38;.950;3900000;0
13535;-1;219;0;0;0;0;.00nan;0;0
14089;182467;185;0;0;0;0;.00nan;0;0
14089;200306;182;0;0;0;0;.00nan;0;0
14089;185810;182;58;29;3;26;.897;3600000;0
14089;-1;185;100;46;0;46;1.000;3600000;0
13148;189529;193;83;33;2;31;.939;3600000;0
13148;186451;193;0;0;0;0;.00nan;0;0
13148;192547;190;0;0;0;0;.00nan;0;0
13148;197704;190;67;37;4;33;.892;3555000;0
13248;198074;195;0;0;0;0;.00nan;0;0
13248;199416;191;0;0;0;0;.00nan;0;0
13248;194893;191;77;27;1;26;.963;3600000;0
13248;207061;195;67;35;4;31;.886;3600000;0
13093;194950;1505;88;31;1;30;.968;3600000;0
13093;186549;1505;0;0;0;0;.00nan;0;0
13093;192461;210;81;34;3;31;.912;3534000;0
13093;197672;210;0;0;0;0;.00nan;0;0
13387;182324;4960;0;0;0;0;.00nan;0;0
13387;194219;4960;100;30;0;30;1.000;3600000;0
13387;191120;223;0;0;0;0;.00nan;0;0
13387;187118;223;92;37;2;35;.946;3575000;0
14142;184133;230;0;0;0;0;.00nan;0;0
14142;184175;224;73;45;5;40;.889;3595000;0
14142;181338;230;48;17;3;14;.824;3600000;0
14142;185840;224;0;0;0;0;.00nan;0;0
14099;205788;207;94;26;0;26;1.000;3283000;0
14099;195238;200;0;0;0;0;.00nan;0;0
14099;-1;207;29;4;3;1;.250;334000;0
14099;-1;200;78;40;4;36;.900;3617000;0
13150;184650;4864;0;0;0;0;.00nan;0;0
13150;206801;176;0;0;0;0;.00nan;0;0
13150;182006;176;77;30;2;28;.933;3600000;0
13150;186332;4864;53;27;3;24;.889;3546000;0
13057;201525;203;44;21;3;18;.857;3546000;0
13057;191078;203;0;0;0;0;.00nan;0;0
13057;-1;199;77;31;2;29;.935;3600000;0
13057;-1;199;0;0;0;0;.00nan;0;0
13167;190034;217;71;22;1;21;.955;3600000;0
13167;190041;217;0;0;0;0;.00nan;0;0
13167;-1;180;39;27;5;22;.815;2153000;0
13167;197707;180;46;15;2;13;.867;1447000;0
13164;189773;231;44;13;3;10;.769;3600000;0
13164;206955;231;0;0;0;0;.00nan;0;0
13164;191120;223;0;0;0;0;.00nan;0;0
13164;187118;223;92;57;5;52;.912;3600000;0
13140;200306;182;65;48;5;43;.896;3600000;0
13140;-1;220;58;18;2;16;.889;3600000;0
13140;-1;220;0;0;0;0;.00nan;0;0
13140;185810;182;0;0;0;0;.00nan;0;0
13197;179499;186;34;23;5;18;.783;3546000;0
13197;190098;186;0;0;0;0;.00nan;0;0
13197;182128;215;0;0;0;0;.00nan;0;0
13197;-1;215;61;37;4;33;.892;3600000;0
13018;-1;216;98;26;0;26;1.000;3600000;0
13018;196571;177;56;38;5;33;.868;3600000;0
13018;-1;216;0;0;0;0;.00nan;0;0
13018;-1;177;0;0;0;0;.00nan;0;0
13131;194950;1505;0;0;0;0;.00nan;0;0
13131;-1;183;0;0;0;0;.00nan;0;0
13131;180574;183;47;42;6;36;.857;3562000;0
13131;186549;1505;47;23;4;19;.826;3600000;0
13294;189081;187;70;17;1;16;.941;3600000;0
13294;-1;189;0;0;0;0;.00nan;0;0
13294;-1;187;0;0;0;0;.00nan;0;0
13294;-1;189;89;40;2;38;.950;3564000;0
14168;-1;1371;0;0;0;0;.00nan;0;0
14168;-1;181;9;17;6;11;.647;2494000;0
14168;192552;181;59;11;1;10;.909;1106000;0
14168;192688;1371;82;40;3;37;.925;3600000;0
13421;200333;194;79;36;3;33;.917;3655000;0
13421;-1;192;70;22;2;20;.909;3655000;0
13421;196352;194;0;0;0;0;.00nan;0;0
13421;207398;192;0;0;0;0;.00nan;0;0
13305;192939;208;39;36;6;30;.833;3541000;0
13305;200380;208;0;0;0;0;.00nan;0;0
13305;201560;202;45;26;4;22;.846;3600000;0
13305;196299;202;0;0;0;0;.00nan;0;0
13306;203383;232;55;26;4;22;.846;3600000;0
13306;183695;232;0;0;0;0;.00nan;0;0
13306;200452;221;80;27;1;26;.963;3600000;0
13306;187431;221;0;0;0;0;.00nan;0;0
13337;205743;2620;52;9;1;8;.889;616000;0
13337;190164;4959;0;0;0;0;.00nan;0;0
13337;-1;2620;17;23;6;17;.739;2984000;0
13337;-1;4959;49;32;4;28;.875;3600000;0
13227;184788;198;62;22;2;20;.909;3600000;0
13227;201585;197;47;33;5;28;.848;3600000;0
13227;206822;197;0;0;0;0;.00nan;0;0
13227;181443;198;0;0;0;0;.00nan;0;0
13189;199416;191;94;25;0;25;1.000;3600000;0
13189;194893;191;0;0;0;0;.00nan;0;0
13189;192547;190;98;82;5;77;.939;3600000;0
13189;197704;190;0;0;0;0;.00nan;0;0
13793;192915;179;46;24;4;20;.833;3596000;0
13793;183686;213;0;0;0;0;.00nan;0;0
13793;201495;213;68;32;3;29;.906;3600000;0
13793;187355;179;0;0;0;0;.00nan;0;0
13282;200437;201;53;36;5;31;.861;3600000;0
13282;205788;207;0;0;0;0;.00nan;0;0
13282;-1;207;78;32;1;31;.969;3600000;0
13282;-1;201;0;0;0;0;.00nan;0;0
13270;184785;211;0;0;0;0;.00nan;0;0
13270;179646;211;57;48;6;42;.875;3600000;0
13270;-1;219;0;0;0;0;.00nan;0;0
13270;-1;219;65;23;2;21;.913;3600000;0
13269;195238;200;74;30;2;28;.933;3600000;0
13269;-1;200;0;0;0;0;.00nan;0;0
13269;192629;226;0;0;0;0;.00nan;0;0
13269;-1;226;51;34;5;29;.853;3600000;0
13344;192939;208;0;0;0;0;.00nan;0;0
13344;200380;208;90;36;2;34;.944;3569000;0
13344;201560;202;76;18;1;17;.944;3600000;0
13344;196299;202;0;0;0;0;.00nan;0;0
13353;195164;218;0;0;0;0;.00nan;0;0
13353;190095;218;72;33;3;30;.909;3600000;0
13353;179679;212;30;29;6;23;.793;3159000;0
13353;-1;212;31;4;2;2;.500;441000;0
13239;198149;188;0;0;0;0;.00nan;0;0
13239;184409;188;85;25;1;24;.960;3900000;0
13239;184648;196;91;32;1;31;.969;3900000;0
13239;191118;196;0;0;0;0;.00nan;0;0
13141;203383;232;0;0;0;0;.00nan;0;0
13141;183695;232;58;38;5;33;.868;3584000;0
13141;180377;228;71;30;3;27;.900;3600000;0
13141;208044;228;0;0;0;0;.00nan;0;0
13135;201524;205;0;0;0;0;.00nan;0;0
13135;201525;203;0;0;0;0;.00nan;0;0
13135;-1;205;75;20;1;19;.950;3600000;0
13135;191078;203;86;42;2;40;.952;3565000;0
13153;189773;231;0;0;0;0;.00nan;0;0
13153;189885;225;97;36;1;35;.972;3600000;0
13153;206955;231;54;16;2;14;.875;3545000;0
13153;-1;225;0;0;0;0;.00nan;0;0
13121;-1;220;0;0;0;0;.00nan;0;0
13121;-1;220;64;33;4;29;.879;3829000;0
13121;-1;214;0;0;0;0;.00nan;0;0
13121;191518;214;63;29;3;26;.897;3829000;0
13422;205743;2620;91;37;1;36;.973;3900000;0
13422;190164;4959;70;22;1;21;.955;3900000;0
13422;-1;2620;0;0;0;0;.00nan;0;0
13422;-1;4959;0;0;0;0;.00nan;0;0
13079;-1;1371;0;0;0;0;.00nan;0;0
13079;-1;181;0;0;0;0;.00nan;0;0
13079;192552;181;43;29;4;25;.862;3600000;0
13079;192688;1371;100;34;0;34;1.000;3600000;0
13200;195251;4949;50;26;4;22;.846;3542000;0
13200;-1;183;62;29;2;27;.931;3600000;0
13200;180574;183;0;0;0;0;.00nan;0;0
13200;197685;4949;0;0;0;0;.00nan;0;0
13126;187628;227;77;25;1;24;.960;3600000;0
13126;185800;229;0;0;0;0;.00nan;0;0
13126;185960;229;46;29;4;25;.862;3600000;0
13126;187217;227;0;0;0;0;.00nan;0;0
13134;182324;4960;0;0;0;0;.00nan;0;0
13134;194219;4960;100;33;0;33;1.000;3600000;0
13134;184610;222;97;35;1;34;.971;3600000;0
13134;185851;222;0;0;0;0;.00nan;0;0
13097;196283;206;0;0;0;0;.00nan;0;0
13097;-1;199;0;0;0;0;.00nan;0;0
13097;-1;199;65;33;3;30;.909;3571000;0
13097;202998;206;74;31;2;29;.935;3600000;0
13185;200333;194;0;0;0;0;.00nan;0;0
13185;184788;198;0;0;0;0;.00nan;0;0
13185;196352;194;53;44;6;38;.864;3600000;0
13185;181443;198;55;21;3;18;.857;3600000;0
13236;179499;186;0;0;0;0;.00nan;0;0
13236;190098;186;92;35;1;34;.971;3900000;0
13236;182128;215;86;27;1;26;.963;3900000;0
13236;-1;215;0;0;0;0;.00nan;0;0
13166;206801;176;100;40;0;40;1.000;3600000;0
13166;182006;176;0;0;0;0;.00nan;0;0
13166;-1;209;69;22;1;21;.955;3575000;0
13166;203063;209;0;0;0;0;.00nan;0;0
12994;-1;216;70;32;3;29;.906;3900000;0
12994;-1;178;0;0;0;0;.00nan;0;0
12994;-1;178;94;43;3;40;.930;3900000;0
12994;-1;216;0;0;0;0;.00nan;0;0
13253;200452;221;0;0;0;0;.00nan;0;0
13253;184175;224;100;26;0;26;1.000;3600000;0
13253;185840;224;0;0;0;0;.00nan;0;0
13253;187431;221;73;29;2;27;.931;3527000;0
13254;189529;193;0;0;0;0;.00nan;0;0
13254;201585;197;0;0;0;0;.00nan;0;0
13254;206822;197;62;34;4;30;.882;3600000;0
13254;186451;193;86;19;0;19;1.000;3600000;0
13101;196571;177;0;0;0;0;.00nan;0;0
13101;192461;210;94;21;0;21;1.000;3600000;0
13101;197672;210;0;0;0;0;.00nan;0;0
13101;-1;177;21;36;7;29;.806;3600000;0
13024;187628;227;0;0;0;0;.00nan;0;0
13024;184133;230;59;21;3;18;.857;3600000;0
13024;181338;230;0;0;0;0;.00nan;0;0
13024;187217;227;88;57;4;53;.930;3600000;0
13261;198074;195;0;0;0;0;.00nan;0;0
13261;199416;191;43;29;4;25;.862;3600000;0
13261;194893;191;0;0;0;0;.00nan;0;0
13261;207061;195;100;30;0;30;1.000;3600000;0
13217;200306;182;0;0;0;0;.00nan;0;0
13217;205837;184;63;16;1;15;.938;3600000;0
13217;190125;184;0;0;0;0;.00nan;0;0
13217;185810;182;78;52;4;48;.923;3600000;0
13352;200437;201;0;0;0;0;.00nan;0;0
13352;201524;205;0;0;0;0;.00nan;0;0
13352;-1;205;93;24;0;24;1.000;3600000;0
13352;-1;201;72;44;5;39;.886;3600000;0
13281;-1;189;52;38;5;33;.868;3600000;0
13281;192547;190;0;0;0;0;.00nan;0;0
13281;197704;190;56;28;3;25;.893;3600000;0
13281;-1;189;0;0;0;0;.00nan;0;0
13551;199416;191;0;0;0;0;.00nan;0;0
13551;194893;191;49;17;3;14;.824;3600000;0
13551;-1;192;18;47;9;38;.809;3600000;0
13551;207398;192;0;0;0;0;.00nan;0;0
13062;-1;216;0;0;0;0;.00nan;0;0
13062;-1;178;64;37;5;32;.865;3600000;0
13062;-1;178;0;0;0;0;.00nan;0;0
13062;-1;216;100;35;0;35;1.000;3600000;0
13544;182467;185;0;0;0;0;.00nan;0;0
13544;-1;181;90;33;1;32;.970;3600000;0
13544;-1;185;41;43;6;37;.860;3600000;0
13544;192552;181;0;0;0;0;.00nan;0;0
13152;183686;213;0;0;0;0;.00nan;0;0
13152;201495;213;68;31;3;28;.903;3550000;0
13152;192461;210;79;23;1;22;.957;3600000;0
13152;197672;210;0;0;0;0;.00nan;0;0
13076;-1;1371;0;0;0;0;.00nan;0;0
13076;-1;220;63;45;5;40;.889;3600000;0
13076;-1;220;0;0;0;0;.00nan;0;0
13076;192688;1371;90;31;2;29;.935;3600000;0
13157;200452;221;62;34;4;30;.882;3600000;0
13157;189773;231;63;16;1;15;.938;3600000;0
13157;206955;231;0;0;0;0;.00nan;0;0
13157;187431;221;0;0;0;0;.00nan;0;0
13207;205837;184;0;0;0;0;.00nan;0;0
13207;190125;184;91;21;0;21;1.000;3600000;0
13207;-1;214;0;0;0;0;.00nan;0;0
13207;191518;214;98;44;2;42;.955;3552000;0
13490;200440;204;48;0;0;0;.00nan;234000;0
13490;189902;204;46;35;6;29;.829;3340000;0
13490;201560;202;59;32;4;28;.875;3600000;0
13490;196299;202;0;0;0;0;.00nan;0;0
13171;184650;4864;0;0;0;0;.00nan;0;0
13171;206801;176;92;38;2;36;.947;3600000;0
13171;182006;176;0;0;0;0;.00nan;0;0
13171;186332;4864;61;24;3;21;.875;3600000;0
13111;184133;230;0;0;0;0;.00nan;0;0
13111;180377;228;85;58;5;53;.914;3600000;0
13111;181338;230;54;16;2;14;.875;3600000;0
13111;208044;228;0;0;0;0;.00nan;0;0
13223;184785;211;88;42;3;39;.929;3600000;0
13223;179646;211;0;0;0;0;.00nan;0;0
13223;179679;212;81;23;1;22;.957;3600000;0
13223;-1;212;0;0;0;0;.00nan;0;0
13179;190034;217;66;27;3;24;.889;3600000;0
13179;190041;217;0;0;0;0;.00nan;0;0
13179;-1;180;54;38;5;33;.868;3567000;0
13179;197707;180;0;0;0;0;.00nan;0;0
13219;194950;1505;47;24;4;20;.833;3600000;0
13219;195251;4949;37;26;5;21;.808;3600000;0
13219;186549;1505;0;0;0;0;.00nan;0;0
13219;197685;4949;0;0;0;0;.00nan;0;0
13213;184788;198;73;20;1;19;.950;3600000;0
13213;181443;198;0;0;0;0;.00nan;0;0
13213;-1;189;0;0;0;0;.00nan;0;0
13213;-1;189;67;37;4;33;.892;3600000;0
13103;195238;200;0;0;0;0;.00nan;0;0
13103;-1;200;99;43;1;42;.977;3600000;0
13103;-1;199;57;29;3;26;.897;3516000;0
13103;-1;199;0;0;0;0;.00nan;0;0
13928;182324;4960;0;0;0;0;.00nan;0;0
13928;194219;4960;66;16;1;15;.938;3600000;0
13928;184610;222;64;36;4;32;.889;3600000;0
13928;185851;222;0;0;0;0;.00nan;0;0
13285;195164;218;93;29;1;28;.966;3900000;0
13285;190095;218;0;0;0;0;.00nan;0;0
13285;182128;215;0;0;0;0;.00nan;0;0
13285;-1;215;78;20;1;19;.950;3900000;0
13092;205788;207;0;0;0;0;.00nan;0;0
13092;-1;207;71;22;2;20;.909;3600000;0
13092;196283;206;14;27;7;20;.741;3181000;0
13092;202998;206;50;1;0;1;1.000;419000;0
13272;184175;224;38;15;3;12;.800;3600000;0
13272;185800;229;58;25;2;23;.920;3600000;0
13272;185840;224;0;0;0;0;.00nan;0;0
13272;185960;229;0;0;0;0;.00nan;0;0
13199;203383;232;53;26;3;23;.885;3545000;0
13199;183695;232;0;0;0;0;.00nan;0;0
13199;191120;223;0;0;0;0;.00nan;0;0
13199;187118;223;74;29;2;27;.931;3600000;0
13094;184648;196;64;25;2;23;.920;3600000;0
13094;191118;196;0;0;0;0;.00nan;0;0
13094;192547;190;74;35;3;32;.914;3579000;0
13094;197704;190;0;0;0;0;.00nan;0;0
13257;198149;188;0;0;0;0;.00nan;0;0
13257;189081;187;49;13;2;11;.846;3600000;0
13257;184409;188;84;41;4;37;.902;3513000;0
13257;-1;187;0;0;0;0;.00nan;0;0
14103;190164;4959;0;0;0;0;.00nan;0;0
14103;-1;209;78;34;3;31;.912;3600000;0
14103;-1;4959;66;21;2;19;.905;3600000;0
14103;203063;209;0;0;0;0;.00nan;0;0
13132;201525;203;100;47;1;46;.979;3600000;0
13132;196283;206;0;0;0;0;.00nan;0;0
13132;191078;203;0;0;0;0;.00nan;0;0
13132;202998;206;61;30;3;27;.900;3546000;0
13534;200440;204;0;0;0;0;.00nan;0;0
13534;189902;204;70;20;2;18;.900;3900000;0
13534;192629;226;85;33;2;31;.939;3900000;0
13534;-1;226;0;0;0;0;.00nan;0;0
13417;183686;213;88;29;1;28;.966;3600000;0
13417;201495;213;0;0;0;0;.00nan;0;0
13417;196571;177;62;26;3;23;.885;3600000;0
13417;-1;177;0;0;0;0;.00nan;0;0
13438;189081;187;0;0;0;0;.00nan;0;0
13438;189529;193;0;0;0;0;.00nan;0;0
13438;186451;193;73;27;2;25;.926;3583000;0
13438;-1;187;85;27;1;26;.963;3600000;0
13470;205743;2620;0;0;0;0;.00nan;0;0
13470;190164;4959;99;43;2;41;.953;3600000;0
13470;-1;2620;54;23;3;20;.870;3586000;0
13470;-1;4959;0;0;0;0;.00nan;0;0
13156;180377;228;0;0;0;0;.00nan;0;0
13156;191120;223;60;16;1;15;.938;3600000;0
13156;187118;223;0;0;0;0;.00nan;0;0
13156;208044;228;56;35;4;31;.886;3600000;0
14163;201524;205;0;0;0;0;.00nan;0;0
14163;201560;202;52;23;3;20;.870;3600000;0
14163;196299;202;0;0;0;0;.00nan;0;0
14163;-1;205;50;26;4;22;.846;3570000;0
14110;179499;186;78;22;1;21;.955;3600000;0
14110;190098;186;0;0;0;0;.00nan;0;0
14110;182128;215;45;24;4;20;.833;3600000;0
14110;-1;215;0;0;0;0;.00nan;0;0
13333;192939;208;55;21;3;18;.857;3550000;0
13333;200380;208;0;0;0;0;.00nan;0;0
13333;205788;207;0;0;0;0;.00nan;0;0
13333;-1;207;84;29;1;28;.966;3600000;0
13412;179679;212;0;0;0;0;.00nan;0;0
13412;-1;219;100;23;0;23;1.000;3600000;0
13412;-1;219;0;0;0;0;.00nan;0;0
13412;-1;212;86;37;2;35;.946;3571000;0
13477;182467;185;96;20;0;20;1.000;3600000;0
13477;-1;185;0;0;0;0;.00nan;0;0
13477;-1;214;53;34;5;29;.853;3600000;0
13477;191518;214;0;0;0;0;.00nan;0;0
13186;187628;227;63;24;2;22;.917;3600000;0
13186;189885;225;58;34;4;30;.882;3518000;0
13186;-1;225;0;0;0;0;.00nan;0;0
13186;187217;227;0;0;0;0;.00nan;0;0
13251;194950;1505;48;24;3;21;.875;3900000;0
13251;186549;1505;0;0;0;0;.00nan;0;0
13251;-1;178;0;0;0;0;.00nan;0;0
13251;-1;178;85;47;3;44;.936;3900000;0
13428;184175;224;80;37;3;34;.919;3600000;0
13428;184610;222;75;24;2;22;.917;2614000;0
13428;185840;224;0;0;0;0;.00nan;0;0
13428;185851;222;19;9;4;5;.556;986000;0
13172;-1;183;85;40;2;38;.950;3900000;0
13172;180574;183;0;0;0;0;.00nan;0;0
13172;192461;210;0;0;0;0;.00nan;0;0
13172;197672;210;65;21;2;19;.905;3900000;0
13242;198074;195;0;0;0;0;.00nan;0;0
13242;201585;197;24;15;4;11;.733;1037000;0
13242;206822;197;77;44;4;40;.909;2563000;0
13242;207061;195;57;10;1;9;.900;3600000;0
13206;184650;4864;59;25;3;22;.880;3600000;0
13206;186332;4864;0;0;0;0;.00nan;0;0
13206;-1;209;0;0;0;0;.00nan;0;0
13206;203063;209;73;43;5;38;.884;3534000;0
13165;200306;182;0;0;0;0;.00nan;0;0
13165;-1;1371;0;0;0;0;.00nan;0;0
13165;185810;182;55;30;4;26;.867;3558000;0
13165;192688;1371;81;30;2;28;.933;3600000;0
13232;195164;218;74;30;2;28;.933;3555000;0
13232;184785;211;0;0;0;0;.00nan;0;0
13232;190095;218;0;0;0;0;.00nan;0;0
13232;179646;211;100;43;0;43;1.000;3600000;0
13537;192915;179;0;0;0;0;.00nan;0;0
13537;195251;4949;0;0;0;0;.00nan;0;0
13537;187355;179;63;27;2;25;.926;3600000;0
13537;197685;4949;67;43;5;38;.884;3600000;0
13334;182324;4960;0;0;0;0;.00nan;0;0
13334;194219;4960;55;21;2;19;.905;3600000;0
13334;189885;225;0;0;0;0;.00nan;0;0
13334;-1;225;93;48;3;45;.938;3547000;0
13127;184133;230;0;0;0;0;.00nan;0;0
13127;181338;230;57;11;1;10;.909;3600000;0
13127;185800;229;0;0;0;0;.00nan;0;0
13127;185960;229;80;49;4;45;.918;3600000;0
13280;198074;195;44;25;4;21;.840;3600000;0
13280;189529;193;80;47;5;42;.894;3555000;0
13280;207061;195;0;0;0;0;.00nan;0;0
13280;186451;193;0;0;0;0;.00nan;0;0
13410;200437;201;70;18;1;17;.944;3600000;0
13410;195238;200;50;30;4;26;.867;3600000;0
13410;-1;200;0;0;0;0;.00nan;0;0
13410;-1;201;0;0;0;0;.00nan;0;0
13255;198149;188;85;35;2;33;.943;3555000;0
13255;184409;188;0;0;0;0;.00nan;0;0
13255;-1;192;88;30;1;29;.967;3600000;0
13255;207398;192;0;0;0;0;.00nan;0;0
13383;179499;186;0;0;0;0;.00nan;0;0
13383;190098;186;68;31;2;29;.935;3900000;0
13383;-1;219;100;56;2;54;.964;3900000;0
13383;-1;219;0;0;0;0;.00nan;0;0
14161;200306;182;85;45;2;43;.956;3900000;0
14161;-1;181;60;19;2;17;.895;3900000;0
14161;185810;182;0;0;0;0;.00nan;0;0
14161;192552;181;0;0;0;0;.00nan;0;0
13173;190034;217;0;0;0;0;.00nan;0;0
13173;190041;217;67;21;1;20;.952;3600000;0
13173;-1;180;65;31;3;28;.903;3561000;0
13173;197707;180;0;0;0;0;.00nan;0;0
13265;192915;179;64;44;5;39;.886;3589000;0
13265;-1;183;0;0;0;0;.00nan;0;0
13265;180574;183;75;37;4;33;.892;3600000;0
13265;187355;179;0;0;0;0;.00nan;0;0
13301;200333;194;59;43;6;37;.860;3600000;0
13301;184648;196;56;16;2;14;.875;3600000;0
13301;196352;194;0;0;0;0;.00nan;0;0
13301;191118;196;0;0;0;0;.00nan;0;0
13178;206801;176;85;35;2;33;.943;3600000;0
13178;182006;176;0;0;0;0;.00nan;0;0
13178;-1;209;0;0;0;0;.00nan;0;0
13178;203063;209;69;35;3;32;.914;3564000;0
13388;200440;204;0;0;0;0;.00nan;0;0
13388;189902;204;70;25;2;23;.920;3900000;0
13388;201524;205;0;0;0;0;.00nan;0;0
13388;-1;205;100;46;2;44;.957;3900000;0
14141;-1;220;0;0;0;0;.00nan;0;0
14141;-1;220;47;27;4;23;.852;3866000;0
14141;-1;214;0;0;0;0;.00nan;0;0
14141;191518;214;73;38;3;35;.921;3866000;0
13335;182467;185;88;43;2;41;.953;3600000;0
13335;205837;184;0;0;0;0;.00nan;0;0
13335;190125;184;77;10;0;10;1.000;3600000;0
13335;-1;185;0;0;0;0;.00nan;0;0
13214;205743;2620;0;0;0;0;.00nan;0;0
13214;-1;2620;83;21;1;20;.952;3900000;0
13214;-1;209;95;43;1;42;.977;3900000;0
13214;203063;209;0;0;0;0;.00nan;0;0
13168;182324;4960;58;12;1;11;.917;3600000;0
13168;194219;4960;0;0;0;0;.00nan;0;0
13168;180377;228;67;28;2;26;.929;3578000;0
13168;208044;228;0;0;0;0;.00nan;0;0
13218;200437;201;72;29;2;27;.931;3600000;0
13218;201525;203;65;32;3;29;.906;3586000;0
13218;191078;203;0;0;0;0;.00nan;0;0
13218;-1;201;0;0;0;0;.00nan;0;0
13224;200440;204;24;12;4;8;.667;779000;0
13224;189902;204;48;20;3;17;.850;2740000;0
13224;-1;199;0;0;0;0;.00nan;0;0
13224;-1;199;41;26;5;21;.808;3600000;0
13631;199416;191;0;0;0;0;.00nan;0;0
13631;194893;191;100;24;0;24;1.000;3600000;0
13631;184648;196;0;0;0;0;.00nan;0;0
13631;191118;196;97;49;3;46;.939;3600000;0
13376;196571;177;0;0;0;0;.00nan;0;0
13376;-1;178;68;10;0;10;1.000;1746000;0
13376;-1;178;47;24;5;19;.792;1854000;0
13376;-1;177;78;19;1;18;.947;3600000;0
13106;-1;216;0;0;0;0;.00nan;0;0
13106;-1;183;92;31;1;30;.968;3600000;0
13106;180574;183;0;0;0;0;.00nan;0;0
13106;-1;216;62;35;4;31;.886;3600000;0
13225;195164;218;64;29;3;26;.897;3600000;0
13225;190095;218;0;0;0;0;.00nan;0;0
13225;-1;180;89;31;1;30;.968;3600000;0
13225;197707;180;0;0;0;0;.00nan;0;0
13146;200306;182;0;0;0;0;.00nan;0;0
13146;-1;220;87;38;3;35;.921;3900000;0
13146;-1;220;0;0;0;0;.00nan;0;0
13146;185810;182;69;30;3;27;.900;3900000;0
13220;190034;217;0;0;0;0;.00nan;0;0
13220;190041;217;75;29;2;27;.931;3549000;0
13220;179679;212;100;35;1;34;.971;3600000;0
13220;-1;212;0;0;0;0;.00nan;0;0
13372;179499;186;60;22;3;19;.864;3900000;0
13372;184785;211;0;0;0;0;.00nan;0;0
13372;190098;186;0;0;0;0;.00nan;0;0
13372;179646;211;79;37;3;34;.919;3900000;0
13211;190164;4959;0;0;0;0;.00nan;0;0
13211;206801;176;0;0;0;0;.00nan;0;0
13211;182006;176;57;34;4;30;.882;3600000;0
13211;-1;4959;96;34;1;33;.971;3600000;0
13263;189773;231;62;14;2;12;.857;3600000;0
13263;206955;231;0;0;0;0;.00nan;0;0
13263;185800;229;79;52;4;48;.923;3578000;0
13263;185960;229;0;0;0;0;.00nan;0;0
13423;203383;232;45;27;5;22;.815;3900000;0
13423;183695;232;0;0;0;0;.00nan;0;0
13423;191120;223;0;0;0;0;.00nan;0;0
13423;187118;223;84;55;5;50;.909;3900000;0
13314;198074;195;0;0;0;0;.00nan;0;0
13314;200333;194;0;0;0;0;.00nan;0;0
13314;207061;195;68;19;1;18;.947;3600000;0
13314;196352;194;80;50;5;45;.900;3600000;0
13231;-1;1371;0;0;0;0;.00nan;0;0
13231;-1;181;28;35;7;28;.800;3600000;0
13231;192552;181;0;0;0;0;.00nan;0;0
13231;192688;1371;59;26;3;23;.885;3600000;0
14160;184175;224;67;27;2;25;.926;3900000;0
14160;189885;225;0;0;0;0;.00nan;0;0
14160;-1;225;99;42;2;40;.952;3900000;0
14160;185840;224;0;0;0;0;.00nan;0;0
13604;195238;200;63;32;4;28;.875;3600000;0
13604;201560;202;54;25;3;22;.880;3600000;0
13604;196299;202;0;0;0;0;.00nan;0;0
13604;-1;200;0;0;0;0;.00nan;0;0
13194;200452;221;100;46;1;45;.978;3600000;0
13194;184133;230;0;0;0;0;.00nan;0;0
13194;181338;230;46;18;2;16;.889;3600000;0
13194;187431;221;0;0;0;0;.00nan;0;0
13373;198074;195;0;0;0;0;.00nan;0;0
13373;199416;191;0;0;0;0;.00nan;0;0
13373;194893;191;93;32;1;31;.969;3600000;0
13373;207061;195;64;32;4;28;.875;3600000;0
13195;190034;217;99;30;1;29;.967;3600000;0
13195;190041;217;0;0;0;0;.00nan;0;0
13195;182128;215;0;0;0;0;.00nan;0;0
13195;-1;215;69;24;2;22;.917;3545000;0
13228;200306;182;59;46;5;41;.891;3600000;0
13228;205837;184;0;0;0;0;.00nan;0;0
13228;190125;184;63;27;3;24;.889;3600000;0
13228;185810;182;0;0;0;0;.00nan;0;0
13237;198149;188;0;0;0;0;.00nan;0;0
13237;184409;188;66;40;4;36;.900;3900000;0
13237;184788;198;62;30;4;26;.867;3900000;0
13237;181443;198;0;0;0;0;.00nan;0;0
13541;192939;208;58;40;5;35;.875;3600000;0
13541;200380;208;0;0;0;0;.00nan;0;0
13541;192629;226;0;0;0;0;.00nan;0;0
13541;-1;226;78;24;1;23;.958;3600000;0
13192;189773;231;0;0;0;0;.00nan;0;0
13192;189885;225;60;42;4;38;.905;3600000;0
13192;206955;231;89;18;0;18;1.000;3600000;0
13192;-1;225;0;0;0;0;.00nan;0;0
13312;185800;229;0;0;0;0;.00nan;0;0
13312;185960;229;61;30;3;27;.900;3600000;0
13312;191120;223;88;22;0;22;1.000;3600000;0
13312;187118;223;0;0;0;0;.00nan;0;0
13193;196571;177;75;43;3;40;.930;3559000;0
13193;192461;210;79;19;1;18;.947;3600000;0
13193;197672;210;0;0;0;0;.00nan;0;0
13193;-1;177;0;0;0;0;.00nan;0;0
13158;192915;179;0;0;0;0;.00nan;0;0
13158;-1;216;66;27;3;24;.889;3900000;0
13158;187355;179;78;34;3;31;.912;3900000;0
13158;-1;216;0;0;0;0;.00nan;0;0
13356;184650;4864;0;0;0;0;.00nan;0;0
13356;190164;4959;0;0;0;0;.00nan;0;0
13356;186332;4864;88;33;1;32;.970;3600000;0
13356;-1;4959;100;31;0;31;1.000;3600000;0
13743;183686;213;63;10;0;10;1.000;682000;0
13743;195251;4949;82;13;0;13;1.000;3600000;0
13743;201495;213;32;39;7;32;.821;2918000;0
13743;197685;4949;0;0;0;0;.00nan;0;0
13276;201585;197;84;40;3;37;.925;3600000;0
13276;206822;197;0;0;0;0;.00nan;0;0
13276;192547;190;0;0;0;0;.00nan;0;0
13276;197704;190;84;32;2;30;.938;3600000;0
13350;189081;187;67;24;2;22;.917;3600000;0
13350;-1;189;33;9;3;6;.667;591000;0
13350;-1;187;0;0;0;0;.00nan;0;0
13350;-1;189;97;33;0;33;1.000;3009000;0
13256;187628;227;74;22;1;21;.955;3600000;0
13256;184610;222;65;47;6;41;.872;3600000;0
13256;185851;222;0;0;0;0;.00nan;0;0
13256;187217;227;0;0;0;0;.00nan;0;0
13212;-1;1371;0;0;0;0;.00nan;0;0
13212;-1;181;0;0;0;0;.00nan;0;0
13212;192552;181;58;29;3;26;.897;3518000;0
13212;192688;1371;99;39;1;38;.974;3600000;0
14155;179499;186;59;27;3;24;.889;3320000;0
14155;190098;186;22;4;3;1;.250;280000;0
14155;-1;219;66;22;2;20;.909;3600000;0
14155;-1;219;0;0;0;0;.00nan;0;0
13468;200437;201;0;0;0;0;.00nan;0;0
13468;201560;202;54;22;3;19;.864;3600000;0
13468;196299;202;0;0;0;0;.00nan;0;0
13468;-1;201;62;42;6;36;.857;3600000;0
13286;205788;207;0;0;0;0;.00nan;0;0
13286;201525;203;0;0;0;0;.00nan;0;0
13286;-1;207;41;31;5;26;.839;3562000;0
13286;191078;203;59;30;4;26;.867;3600000;0
13284;195164;218;62;29;3;26;.897;3900000;0
13284;190095;218;0;0;0;0;.00nan;0;0
13284;-1;180;0;0;0;0;.00nan;0;0
13284;197707;180;72;34;3;31;.912;3900000;0
13147;201524;205;76;32;2;30;.938;3561000;0
13147;196283;206;0;0;0;0;.00nan;0;0
13147;-1;205;0;0;0;0;.00nan;0;0
13147;202998;206;85;34;1;33;.971;3600000;0
13588;182467;185;83;29;1;28;.966;3600000;0
13588;-1;185;0;0;0;0;.00nan;0;0
13588;-1;214;53;33;4;29;.879;3600000;0
13588;191518;214;0;0;0;0;.00nan;0;0
13278;182324;4960;0;0;0;0;.00nan;0;0
13278;194219;4960;79;26;1;25;.962;3900000;0
13278;180377;228;0;0;0;0;.00nan;0;0
13278;208044;228;100;39;1;38;.974;3900000;0
13182;205788;207;56;28;3;25;.893;3525000;0
13182;-1;207;0;0;0;0;.00nan;0;0
13182;196283;206;90;28;1;27;.964;3600000;0
13182;202998;206;0;0;0;0;.00nan;0;0
14158;179679;212;63;26;2;24;.923;3600000;0
14158;-1;219;0;0;0;0;.00nan;0;0
14158;-1;219;49;30;4;26;.867;3600000;0
14158;-1;212;0;0;0;0;.00nan;0;0
14081;184648;196;79;12;0;12;1.000;3600000;0
14081;-1;192;84;39;2;37;.949;3540000;0
14081;207398;192;0;0;0;0;.00nan;0;0
14081;191118;196;0;0;0;0;.00nan;0;0
13298;189529;193;55;23;3;20;.870;3900000;0
13298;201585;197;0;0;0;0;.00nan;0;0
13298;206822;197;82;46;3;43;.935;3900000;0
13298;186451;193;0;0;0;0;.00nan;0;0
13357;-1;189;59;32;5;27;.844;3900000;0
13357;192547;190;50;35;5;30;.857;3900000;0
13357;197704;190;0;0;0;0;.00nan;0;0
13357;-1;189;0;0;0;0;.00nan;0;0
13289;198149;188;0;0;0;0;.00nan;0;0
13289;184409;188;70;30;2;28;.933;3600000;0
13289;-1;192;53;3;0;3;1.000;704000;0
13289;207398;192;45;40;6;34;.850;2896000;0
13181;184650;4864;0;0;0;0;.00nan;0;0
13181;206801;176;100;46;2;44;.957;3900000;0
13181;182006;176;0;0;0;0;.00nan;0;0
13181;186332;4864;63;28;2;26;.929;3900000;0
13442;183686;213;0;0;0;0;.00nan;0;0
13442;201495;213;88;42;2;40;.952;3600000;0
13442;-1;178;0;0;0;0;.00nan;0;0
13442;-1;178;54;33;4;29;.879;3565000;0
13349;203383;232;67;18;1;17;.944;3600000;0
13349;183695;232;0;0;0;0;.00nan;0;0
13349;184610;222;26;28;6;22;.786;2974000;0
13349;185851;222;43;11;2;9;.818;626000;0
13264;205743;2620;0;0;0;0;.00nan;0;0
13264;-1;2620;58;15;2;13;.867;3600000;0
13264;-1;209;0;0;0;0;.00nan;0;0
13264;203063;209;78;44;3;41;.932;3600000;0
13509;201560;202;79;22;1;21;.955;3600000;0
13509;196299;202;0;0;0;0;.00nan;0;0
13509;192629;226;65;47;6;41;.872;3600000;0
13509;-1;226;0;0;0;0;.00nan;0;0
13201;192915;179;70;38;4;34;.895;3547000;0
13201;187355;179;0;0;0;0;.00nan;0;0
13201;192461;210;57;23;3;20;.870;3600000;0
13201;197672;210;0;0;0;0;.00nan;0;0
13435;189081;187;100;30;0;30;1.000;3600000;0
13435;200333;194;91;45;3;42;.933;3600000;0
13435;196352;194;0;0;0;0;.00nan;0;0
13435;-1;187;0;0;0;0;.00nan;0;0
13433;182467;185;35;11;3;8;.727;899000;0
13433;205837;184;0;0;0;0;.00nan;0;0
13433;190125;184;53;23;3;20;.870;3600000;0
13433;-1;185;32;36;6;30;.833;2701000;0
14043;198074;195;50;23;3;20;.870;3575000;0
14043;184788;198;0;0;0;0;.00nan;0;0
14043;207061;195;0;0;0;0;.00nan;0;0
14043;181443;198;94;35;1;34;.971;3600000;0
13437;192939;208;80;23;1;22;.957;3600000;0
13437;200380;208;0;0;0;0;.00nan;0;0
13437;200437;201;48;40;6;34;.850;3600000;0
13437;-1;201;0;0;0;0;.00nan;0;0
13293;187628;227;88;47;2;45;.957;3550000;0
13293;184133;230;0;0;0;0;.00nan;0;0
13293;181338;230;78;31;1;30;.968;3600000;0
13293;187217;227;0;0;0;0;.00nan;0;0
13329;195164;218;82;36;3;33;.917;3600000;0
13329;179499;186;33;24;4;20;.833;3600000;0
13329;190095;218;0;0;0;0;.00nan;0;0
13329;190098;186;0;0;0;0;.00nan;0;0
13348;184785;211;95;43;2;41;.953;3900000;0
13348;179646;211;0;0;0;0;.00nan;0;0
13348;182128;215;0;0;0;0;.00nan;0;0
13348;-1;215;70;24;2;22;.917;3900000;0
13118;194950;1505;68;29;2;27;.931;3600000;0
13118;-1;216;65;34;3;31;.912;3579000;0
13118;186549;1505;0;0;0;0;.00nan;0;0
13118;-1;216;0;0;0;0;.00nan;0;0
13392;182324;4960;0;0;0;0;.00nan;0;0
13392;194219;4960;68;18;1;17;.944;3600000;0
13392;185800;229;85;40;2;38;.950;3600000;0
13392;185960;229;0;0;0;0;.00nan;0;0
14132;195251;4949;65;26;2;24;.923;3900000;0
14132;196571;177;75;28;2;26;.929;3900000;0
14132;197685;4949;0;0;0;0;.00nan;0;0
14132;-1;177;0;0;0;0;.00nan;0;0
14171;200306;182;0;0;0;0;.00nan;0;0
14171;185810;182;34;29;6;23;.793;3600000;0
14171;-1;214;83;37;3;34;.919;3600000;0
14171;191518;214;0;0;0;0;.00nan;0;0
13238;201524;205;0;0;0;0;.00nan;0;0
13238;-1;205;35;19;4;15;.789;3584000;0
13238;-1;199;79;33;2;31;.939;3600000;0
13238;-1;199;0;0;0;0;.00nan;0;0
13250;189885;225;56;29;3;26;.897;3516000;0
13250;-1;225;0;0;0;0;.00nan;0;0
13250;191120;223;74;23;1;22;.957;3600000;0
13250;187118;223;0;0;0;0;.00nan;0;0
13230;179679;212;0;0;0;0;.00nan;0;0
13230;-1;212;52;20;3;17;.850;3612000;0
13230;-1;180;91;38;2;36;.947;3612000;0
13230;197707;180;0;0;0;0;.00nan;0;0
13235;192915;179;0;0;0;0;.00nan;0;0
13235;-1;183;78;25;1;24;.960;3600000;0
13235;180574;183;0;0;0;0;.00nan;0;0
13235;187355;179;87;34;2;32;.941;3545000;0
13394;203383;232;0;0;0;0;.00nan;0;0
13394;183695;232;73;20;1;19;.950;3600000;0
13394;184610;222;0;0;0;0;.00nan;0;0
13394;185851;222;49;37;5;32;.865;3600000;0
13154;-1;181;44;24;5;19;.792;3579000;0
13154;-1;220;0;0;0;0;.00nan;0;0
13154;-1;220;61;28;3;25;.893;3600000;0
13154;192552;181;0;0;0;0;.00nan;0;0
13226;194950;1505;0;0;0;0;.00nan;0;0
13226;186549;1505;100;44;2;42;.955;3900000;0
13226;192461;210;0;0;0;0;.00nan;0;0
13226;197672;210;67;28;2;26;.929;3900000;0
13332;196571;177;0;0;0;0;.00nan;0;0
13332;-1;178;87;48;3;45;.938;3590000;0
13332;-1;178;0;0;0;0;.00nan;0;0
13332;-1;177;70;18;1;17;.944;3600000;0
13191;205743;2620;59;20;2;18;.900;3600000;0
13191;206801;176;56;9;1;8;.889;1261000;0
13191;182006;176;26;30;6;24;.800;2339000;0
13191;-1;2620;0;0;0;0;.00nan;0;0
14135;200452;221;46;23;3;20;.870;3900000;0
14135;184175;224;85;36;3;33;.917;3900000;0
14135;185840;224;0;0;0;0;.00nan;0;0
14135;187431;221;0;0;0;0;.00nan;0;0
14153;200437;201;0;0;0;0;.00nan;0;0
14153;205788;207;0;0;0;0;.00nan;0;0
14153;-1;207;64;19;1;18;.947;3600000;0
14153;-1;201;98;44;2;42;.955;3552000;0
13346;189529;193;0;0;0;0;.00nan;0;0
13346;186451;193;55;8;1;7;.875;3600000;0
13346;192547;190;0;0;0;0;.00nan;0;0
13346;197704;190;53;36;6;30;.833;3600000;0
14106;183686;213;86;34;2;32;.941;3900000;0
14106;195251;4949;0;0;0;0;.00nan;0;0
14106;201495;213;0;0;0;0;.00nan;0;0
14106;197685;4949;79;28;2;26;.929;3900000;0
13175;200440;204;0;0;0;0;.00nan;0;0
13175;189902;204;89;28;1;27;.964;3600000;0
13175;196283;206;0;0;0;0;.00nan;0;0
13175;202998;206;62;29;3;26;.897;3540000;0
13458;205837;184;0;0;0;0;.00nan;0;0
13458;190125;184;94;20;0;20;1.000;3600000;0
13458;-1;214;0;0;0;0;.00nan;0;0
13458;191518;214;47;32;4;28;.875;3600000;0
13382;179499;186;0;0;0;0;.00nan;0;0
13382;184785;211;0;0;0;0;.00nan;0;0
13382;190098;186;59;13;1;12;.923;3600000;0
13382;179646;211;77;47;4;43;.915;3600000;0
13204;189885;225;0;0;0;0;.00nan;0;0
13204;180377;228;49;23;4;19;.826;3544000;0
13204;-1;225;81;42;3;39;.929;3600000;0
13204;208044;228;0;0;0;0;.00nan;0;0
13160;195238;200;0;0;0;0;.00nan;0;0
13160;-1;200;83;26;1;25;.962;3600000;0
13160;-1;199;81;34;2;32;.941;3567000;0
13160;-1;199;0;0;0;0;.00nan;0;0
13283;184133;230;97;46;3;43;.935;3584000;0
13283;189773;231;0;0;0;0;.00nan;0;0
13283;206955;231;91;26;1;25;.962;3600000;0
13283;181338;230;0;0;0;0;.00nan;0;0
14119;201560;202;61;26;3;23;.885;3673000;0
14119;196283;206;88;45;4;41;.911;3673000;0
14119;196299;202;0;0;0;0;.00nan;0;0
14119;202998;206;0;0;0;0;.00nan;0;0
13725;199416;191;0;0;0;0;.00nan;0;0
13725;189081;187;81;37;2;35;.946;3600000;0
13725;194893;191;82;25;1;24;.960;3600000;0
13725;-1;187;0;0;0;0;.00nan;0;0
13909;-1;219;67;22;2;20;.909;3600000;0
13909;182128;215;93;40;1;39;.975;3600000;0
13909;-1;219;0;0;0;0;.00nan;0;0
13909;-1;215;0;0;0;0;.00nan;0;0
13398;198074;195;0;0;0;0;.00nan;0;0
13398;-1;192;75;49;5;44;.898;3600000;0
13398;207061;195;62;16;2;14;.875;3600000;0
13398;207398;192;0;0;0;0;.00nan;0;0
13336;195238;200;90;22;1;21;.955;3600000;0
13336;201525;203;48;40;5;35;.875;3600000;0
13336;-1;200;0;0;0;0;.00nan;0;0
13336;191078;203;0;0;0;0;.00nan;0;0
13292;190034;217;49;28;4;24;.857;3600000;0
13292;190041;217;0;0;0;0;.00nan;0;0
13292;179679;212;99;33;1;32;.970;3600000;0
13292;-1;212;0;0;0;0;.00nan;0;0
13355;200440;204;0;0;0;0;.00nan;0;0
13355;205788;207;0;0;0;0;.00nan;0;0
13355;189902;204;100;21;0;21;1.000;3600000;0
13355;-1;207;57;42;5;37;.881;3600000;0
13317;198149;188;0;0;0;0;.00nan;0;0
13317;189529;193;0;0;0;0;.00nan;0;0
13317;184409;188;54;38;5;33;.868;3571000;0
13317;186451;193;51;27;4;23;.852;3600000;0
13267;200333;194;31;18;4;14;.778;524000;0
13267;184788;198;78;38;3;35;.921;3600000;0
13267;196352;194;53;31;4;27;.871;3076000;0
13267;181443;198;0;0;0;0;.00nan;0;0
13245;184650;4864;0;0;0;0;.00nan;0;0
13245;186332;4864;55;34;4;30;.882;3600000;0
13245;-1;209;97;36;1;35;.972;3600000;0
13245;203063;209;0;0;0;0;.00nan;0;0
13296;184648;196;98;20;0;20;1.000;3600000;0
13296;201585;197;67;48;6;42;.875;3600000;0
13296;206822;197;0;0;0;0;.00nan;0;0
13296;191118;196;0;0;0;0;.00nan;0;0
13327;187628;227;51;31;4;27;.871;3515000;0
13327;184175;224;0;0;0;0;.00nan;0;0
13327;185840;224;70;28;2;26;.929;3600000;0
13327;187217;227;0;0;0;0;.00nan;0;0
13205;194950;1505;83;28;1;27;.964;3600000;0
13205;-1;183;0;0;0;0;.00nan;0;0
13205;180574;183;71;29;2;27;.931;3544000;0
13205;186549;1505;0;0;0;0;.00nan;0;0
13241;200306;182;0;0;0;0;.00nan;0;0
13241;-1;220;0;0;0;0;.00nan;0;0
13241;-1;220;52;21;3;18;.857;3900000;0
13241;185810;182;65;30;3;27;.900;3900000;0
13234;184788;198;0;0;0;0;.00nan;0;0
13234;181443;198;68;27;2;25;.926;3546000;0
13234;-1;189;0;0;0;0;.00nan;0;0
13234;-1;189;93;25;1;24;.960;3600000;0
13259;182467;185;76;52;6;46;.885;3600000;0
13259;-1;1371;0;0;0;0;.00nan;0;0
13259;-1;185;0;0;0;0;.00nan;0;0
13259;192688;1371;58;31;4;27;.871;3600000;0
13427;201524;205;0;0;0;0;.00nan;0;0
13427;-1;205;38;28;5;23;.821;3600000;0
13427;192629;226;72;24;2;22;.917;3600000;0
13427;-1;226;0;0;0;0;.00nan;0;0
13407;192915;179;0;0;0;0;.00nan;0;0
13407;187355;179;66;22;2;20;.909;3600000;0
13407;-1;178;0;0;0;0;.00nan;0;0
13407;-1;178;83;51;4;47;.922;3586000;0
13405;198149;188;43;29;5;24;.828;3771000;0
13405;184409;188;0;0;0;0;.00nan;0;0
13405;184648;196;33;18;4;14;.778;3771000;0
13405;191118;196;0;0;0;0;.00nan;0;0
13340;190034;217;0;0;0;0;.00nan;0;0
13340;190041;217;58;26;3;23;.885;3600000;0
13340;179499;186;64;47;5;42;.894;3566000;0
13340;190098;186;0;0;0;0;.00nan;0;0
13774;195164;218;98;42;1;41;.976;3588000;0
13774;190095;218;0;0;0;0;.00nan;0;0
13774;182128;215;0;0;0;0;.00nan;0;0
13774;-1;215;100;22;0;22;1.000;3600000;0
13358;182467;185;0;0;0;0;.00nan;0;0
13358;-1;220;82;31;2;29;.935;3600000;0
13358;-1;220;0;0;0;0;.00nan;0;0
13358;-1;185;53;39;5;34;.872;3600000;0
13361;189773;231;65;20;2;18;.900;3600000;0
13361;184610;222;93;28;1;27;.964;3600000;0
13361;206955;231;0;0;0;0;.00nan;0;0
13361;185851;222;0;0;0;0;.00nan;0;0
13370;184133;230;0;0;0;0;.00nan;0;0
13370;184175;224;45;38;6;32;.842;3600000;0
13370;181338;230;73;18;1;17;.944;3600000;0
13370;185840;224;0;0;0;0;.00nan;0;0
13384;199416;191;0;0;0;0;.00nan;0;0
13384;194893;191;62;16;1;15;.938;3600000;0
13384;-1;189;17;14;5;9;.643;1004000;0
13384;-1;189;78;33;2;31;.939;2596000;0
13310;203383;232;56;26;3;23;.885;3900000;0
13310;183695;232;0;0;0;0;.00nan;0;0
13310;180377;228;0;0;0;0;.00nan;0;0
13310;208044;228;87;41;3;38;.927;3900000;0
13475;201585;197;92;47;1;46;.979;3640000;0
13475;206822;197;0;0;0;0;.00nan;0;0
13475;-1;192;100;21;0;21;1.000;3640000;0
13475;207398;192;0;0;0;0;.00nan;0;0
13316;190164;4959;0;0;0;0;.00nan;0;0
13316;-1;209;0;0;0;0;.00nan;0;0
13316;-1;4959;77;22;1;21;.955;3900000;0
13316;203063;209;100;40;1;39;.975;3900000;0
13318;205837;184;0;0;0;0;.00nan;0;0
13318;190125;184;81;29;1;28;.966;3600000;0
13318;-1;181;77;42;4;38;.905;3600000;0
13318;192552;181;0;0;0;0;.00nan;0;0
14096;195238;200;0;0;0;0;.00nan;0;0
14096;201525;203;43;36;6;30;.833;3600000;0
14096;-1;200;81;26;1;25;.962;3600000;0
14096;191078;203;0;0;0;0;.00nan;0;0
13299;184785;211;63;31;3;28;.903;3600000;0
13299;179646;211;0;0;0;0;.00nan;0;0
13299;-1;180;64;24;2;22;.917;3600000;0
13299;197707;180;0;0;0;0;.00nan;0;0
13622;183686;213;53;27;3;24;.889;3005000;0
13622;201495;213;25;14;4;10;.714;595000;0
13622;196571;177;80;24;1;23;.958;3600000;0
13622;-1;177;0;0;0;0;.00nan;0;0
13441;205743;2620;0;0;0;0;.00nan;0;0
13441;184650;4864;0;0;0;0;.00nan;0;0
13441;-1;2620;100;24;0;24;1.000;3600000;0
13441;186332;4864;98;41;2;39;.951;3531000;0
13243;200437;201;100;32;0;32;1.000;3600000;0
13243;196283;206;0;0;0;0;.00nan;0;0
13243;-1;201;0;0;0;0;.00nan;0;0
13243;202998;206;78;31;1;30;.968;3552000;0
13339;189885;225;88;40;2;38;.950;3572000;0
13339;184610;222;0;0;0;0;.00nan;0;0
13339;-1;225;0;0;0;0;.00nan;0;0
13339;185851;222;74;27;1;26;.963;3600000;0
13311;198074;195;0;0;0;0;.00nan;0;0
13311;201585;197;0;0;0;0;.00nan;0;0
13311;206822;197;69;39;4;35;.897;3600000;0
13311;207061;195;44;15;3;12;.800;3600000;0
13287;180377;228;73;38;3;35;.921;3574000;0
13287;185800;229;63;23;2;21;.913;3600000;0
13287;185960;229;0;0;0;0;.00nan;0;0
13287;208044;228;0;0;0;0;.00nan;0;0
13279;-1;183;16;8;4;4;.500;789000;0
13279;180574;183;47;20;3;17;.850;2811000;0
13279;-1;178;71;35;4;31;.886;3600000;0
13279;-1;178;0;0;0;0;.00nan;0;0
13233;183686;213;0;0;0;0;.00nan;0;0
13233;201495;213;97;56;2;54;.964;3900000;0
13233;192461;210;68;23;2;21;.913;3900000;0
13233;197672;210;0;0;0;0;.00nan;0;0
13563;192939;208;71;29;2;27;.931;3600000;0
13563;200380;208;0;0;0;0;.00nan;0;0
13563;192629;226;13;19;6;13;.684;1506000;0
13563;-1;226;57;12;1;11;.917;2094000;0
13364;200440;204;0;0;0;0;.00nan;0;0
13364;189902;204;62;11;1;10;.909;3600000;0
13364;201525;203;0;0;0;0;.00nan;0;0
13364;191078;203;47;46;6;40;.870;3600000;0
13307;184650;4864;94;21;0;21;1.000;3600000;0
13307;186332;4864;0;0;0;0;.00nan;0;0
13307;-1;209;97;34;1;33;.971;3561000;0
13307;203063;209;0;0;0;0;.00nan;0;0
13300;195238;200;61;31;3;28;.903;3853000;0
13300;196283;206;84;47;3;44;.936;3900000;0
13300;-1;200;0;0;0;0;.00nan;0;0
13300;202998;206;0;0;0;0;.00nan;0;0
13295;190034;217;59;24;4;20;.833;3600000;0
13295;190041;217;0;0;0;0;.00nan;0;0
13295;179499;186;54;9;1;8;.889;405000;0
13295;190098;186;26;29;6;23;.793;3195000;0
14121;194950;1505;0;0;0;0;.00nan;0;0
14121;196571;177;0;0;0;0;.00nan;0;0
14121;186549;1505;65;31;3;28;.903;3600000;0
14121;-1;177;87;32;2;30;.938;3600000;0
13684;179679;212;75;36;3;33;.917;3600000;0
13684;-1;219;92;51;5;46;.902;3600000;0
13684;-1;219;0;0;0;0;.00nan;0;0
13684;-1;212;0;0;0;0;.00nan;0;0
13351;184133;230;66;17;1;16;.941;3600000;0
13351;184175;224;94;36;2;34;.944;3543000;0
13351;181338;230;0;0;0;0;.00nan;0;0
13351;185840;224;0;0;0;0;.00nan;0;0
13430;200333;194;83;32;3;29;.906;3852000;0
13430;196352;194;0;0;0;0;.00nan;0;0
13430;192547;190;62;31;3;28;.903;3900000;0
13430;197704;190;0;0;0;0;.00nan;0;0
13319;184788;198;74;31;2;29;.935;3900000;0
13319;-1;192;0;0;0;0;.00nan;0;0
13319;207398;192;76;31;2;29;.935;3900000;0
13319;181443;198;0;0;0;0;.00nan;0;0
13315;184785;211;0;0;0;0;.00nan;0;0
13315;179646;211;83;51;4;47;.922;3900000;0
13315;-1;180;0;0;0;0;.00nan;0;0
13315;197707;180;70;34;4;30;.882;3900000;0
13600;205743;2620;0;0;0;0;.00nan;0;0
13600;206801;176;77;27;2;25;.926;3600000;0
13600;182006;176;0;0;0;0;.00nan;0;0
13600;-1;2620;64;29;3;26;.897;3579000;0
13406;205788;207;0;0;0;0;.00nan;0;0
13406;201524;205;0;0;0;0;.00nan;0;0
13406;-1;207;88;40;2;38;.950;3600000;0
13406;-1;205;33;22;4;18;.818;3555000;0
13396;198149;188;0;0;0;0;.00nan;0;0
13396;189529;193;66;23;3;20;.870;3565000;0
13396;184409;188;78;38;2;36;.947;3600000;0
13396;186451;193;0;0;0;0;.00nan;0;0
13275;-1;1371;0;0;0;0;.00nan;0;0
13275;-1;214;85;37;3;34;.919;3569000;0
13275;191518;214;0;0;0;0;.00nan;0;0
13275;192688;1371;72;24;2;22;.917;3600000;0
13397;182324;4960;0;0;0;0;.00nan;0;0
13397;194219;4960;88;31;1;30;.968;3600000;0
13397;189773;231;0;0;0;0;.00nan;0;0
13397;206955;231;62;22;2;20;.909;3543000;0
13342;205837;184;82;32;1;31;.969;3600000;0
13342;190125;184;0;0;0;0;.00nan;0;0
13342;-1;181;0;0;0;0;.00nan;0;0
13342;192552;181;41;29;5;24;.828;3600000;0
13330;190164;4959;74;41;4;37;.902;3600000;0
13330;206801;176;0;0;0;0;.00nan;0;0
13330;182006;176;73;30;3;27;.900;3600000;0
13330;-1;4959;0;0;0;0;.00nan;0;0
13977;201560;202;0;0;0;0;.00nan;0;0
13977;196299;202;66;36;3;33;.917;3600000;0
13977;192629;226;0;0;0;0;.00nan;0;0
13977;-1;226;47;25;4;21;.840;3582000;0
13277;-1;220;64;39;5;34;.872;3600000;0
13277;-1;220;0;0;0;0;.00nan;0;0
13277;-1;214;0;0;0;0;.00nan;0;0
13277;191518;214;86;26;1;25;.962;3600000;0
13321;189081;187;26;25;6;19;.760;3600000;0
13321;184788;198;0;0;0;0;.00nan;0;0
13321;181443;198;81;39;3;36;.923;3600000;0
13321;-1;187;0;0;0;0;.00nan;0;0
13420;203383;232;43;26;4;22;.846;3600000;0
13420;183695;232;0;0;0;0;.00nan;0;0
13420;189885;225;0;0;0;0;.00nan;0;0
13420;-1;225;43;41;6;35;.854;3554000;0
13436;182467;185;62;31;3;28;.903;3579000;0
13436;-1;1371;0;0;0;0;.00nan;0;0
13436;-1;185;0;0;0;0;.00nan;0;0
13436;192688;1371;69;23;2;21;.913;3600000;0
13565;200437;201;67;30;3;27;.900;3600000;0
13565;205788;207;0;0;0;0;.00nan;0;0
13565;-1;207;45;30;5;25;.833;3533000;0
13565;-1;201;0;0;0;0;.00nan;0;0
13262;195251;4949;93;33;1;32;.970;3600000;0
13262;-1;216;0;0;0;0;.00nan;0;0
13262;197685;4949;0;0;0;0;.00nan;0;0
13262;-1;216;76;36;3;33;.917;3572000;0
13347;187628;227;0;0;0;0;.00nan;0;0
13347;200452;221;61;33;4;29;.879;3560000;0
13347;187217;227;57;28;3;25;.893;3600000;0
13347;187431;221;0;0;0;0;.00nan;0;0
13304;184785;211;57;51;6;45;.882;3346000;0
13304;179646;211;44;3;1;2;.667;254000;0
13304;179679;212;0;0;0;0;.00nan;0;0
13304;-1;212;72;31;2;29;.935;3600000;0
13538;192939;208;64;36;4;32;.889;3571000;0
13538;200380;208;0;0;0;0;.00nan;0;0
13538;200440;204;0;0;0;0;.00nan;0;0
13538;189902;204;67;19;2;17;.895;3600000;0
13309;184175;224;90;43;2;41;.953;3600000;0
13309;180377;228;0;0;0;0;.00nan;0;0
13309;185840;224;0;0;0;0;.00nan;0;0
13309;208044;228;37;30;5;25;.833;3600000;0
13362;195238;200;0;0;0;0;.00nan;0;0
13362;201525;203;75;25;2;23;.920;3600000;0
13362;-1;200;35;19;4;15;.789;3519000;0
13362;191078;203;0;0;0;0;.00nan;0;0
13288;195251;4949;0;0;0;0;.00nan;0;0
13288;192461;210;85;42;3;39;.929;3600000;0
13288;197672;210;0;0;0;0;.00nan;0;0
13288;197685;4949;54;31;5;26;.839;3550000;0
13401;184648;196;50;29;4;25;.862;3600000;0
13401;191118;196;0;0;0;0;.00nan;0;0
13401;-1;189;0;0;0;0;.00nan;0;0
13401;-1;189;83;27;1;26;.963;3600000;0
13415;179499;186;93;46;2;44;.957;3600000;0
13415;190098;186;0;0;0;0;.00nan;0;0
13415;-1;219;51;33;4;29;.879;3521000;0
13415;-1;219;0;0;0;0;.00nan;0;0
13371;-1;181;68;33;3;30;.909;3588000;0
13371;-1;220;0;0;0;0;.00nan;0;0
13371;-1;220;71;28;2;26;.929;3600000;0
13371;192552;181;0;0;0;0;.00nan;0;0
13258;201524;205;0;0;0;0;.00nan;0;0
13258;-1;205;73;26;2;24;.923;3600000;0
13258;-1;199;61;29;3;26;.897;3581000;0
13258;-1;199;0;0;0;0;.00nan;0;0
13460;189081;187;0;0;0;0;.00nan;0;0
13460;189529;193;0;0;0;0;.00nan;0;0
13460;186451;193;64;17;1;16;.941;3600000;0
13460;-1;187;73;39;3;36;.923;3571000;0
13399;200306;182;0;0;0;0;.00nan;0;0
13399;205837;184;0;0;0;0;.00nan;0;0
13399;190125;184;58;31;3;28;.903;3900000;0
13399;185810;182;100;50;3;47;.940;3900000;0
13386;-1;192;58;28;3;25;.893;3600000;0
13386;207398;192;0;0;0;0;.00nan;0;0
13386;192547;190;56;4;0;4;1.000;439000;0
13386;197704;190;54;42;6;36;.857;3161000;0
13326;190164;4959;0;0;0;0;.00nan;0;0
13326;-1;209;0;0;0;0;.00nan;0;0
13326;-1;4959;77;22;1;21;.955;3600000;0
13326;203063;209;79;42;4;38;.905;3600000;0
13274;194950;1505;65;28;4;24;.857;3600000;0
13274;-1;183;24;8;4;4;.500;803000;0
13274;180574;183;81;24;1;23;.958;2777000;0
13274;186549;1505;0;0;0;0;.00nan;0;0
13431;187628;227;87;27;1;26;.963;3900000;0
13431;185800;229;0;0;0;0;.00nan;0;0
13431;185960;229;97;37;1;36;.973;3900000;0
13431;187217;227;0;0;0;0;.00nan;0;0
13419;198149;188;0;0;0;0;.00nan;0;0
13419;200333;194;0;0;0;0;.00nan;0;0
13419;184409;188;26;27;6;21;.778;3519000;0
13419;196352;194;85;51;4;47;.922;3600000;0
13629;200437;201;87;34;2;32;.941;3004000;0
13629;201560;202;43;21;4;17;.810;3600000;0
13629;196299;202;0;0;0;0;.00nan;0;0
13629;-1;201;30;9;3;6;.667;596000;0
13487;182324;4960;0;0;0;0;.00nan;0;0
13487;194219;4960;71;24;2;22;.917;3600000;0
13487;191120;223;0;0;0;0;.00nan;0;0
13487;187118;223;64;48;6;42;.875;3600000;0
13577;192939;208;0;0;0;0;.00nan;0;0
13577;200380;208;56;25;3;22;.880;3900000;0
13577;205788;207;0;0;0;0;.00nan;0;0
13577;-1;207;80;43;3;40;.930;3900000;0
13345;195164;218;31;23;5;18;.783;3544000;0
13345;190095;218;0;0;0;0;.00nan;0;0
13345;-1;180;83;43;4;39;.907;3600000;0
13345;197707;180;0;0;0;0;.00nan;0;0
13328;192915;179;75;36;3;33;.917;3543000;0
13328;-1;216;84;34;2;32;.941;3600000;0
13328;187355;179;0;0;0;0;.00nan;0;0
13328;-1;216;0;0;0;0;.00nan;0;0
13322;-1;183;76;43;3;40;.930;3600000;0
13322;180574;183;0;0;0;0;.00nan;0;0
13322;192461;210;0;0;0;0;.00nan;0;0
13322;197672;210;50;32;5;27;.844;3589000;0
13416;200306;182;68;32;3;29;.906;3703000;0
13416;-1;1371;0;0;0;0;.00nan;0;0
13416;185810;182;0;0;0;0;.00nan;0;0
13416;192688;1371;81;33;2;31;.939;3703000;0
13606;190034;217;0;0;0;0;.00nan;0;0
13606;190041;217;71;27;2;25;.926;3600000;0
13606;179679;212;76;37;3;34;.919;3545000;0
13606;-1;212;0;0;0;0;.00nan;0;0
13411;199416;191;0;0;0;0;.00nan;0;0
13411;194893;191;92;17;0;17;1.000;3600000;0
13411;-1;189;46;7;1;6;.857;770000;0
13411;-1;189;41;40;7;33;.825;2830000;0
13367;201524;205;87;13;0;13;1.000;3600000;0
13367;201525;203;0;0;0;0;.00nan;0;0
13367;-1;205;0;0;0;0;.00nan;0;0
13367;191078;203;89;30;1;29;.967;3589000;0
13379;200452;221;97;51;3;48;.941;3889000;0
13379;184133;230;0;0;0;0;.00nan;0;0
13379;181338;230;58;24;3;21;.875;3900000;0
13379;187431;221;0;0;0;0;.00nan;0;0
14114;184650;4864;83;27;1;26;.963;3600000;0
14114;206801;176;75;29;2;27;.931;3567000;0
14114;182006;176;0;0;0;0;.00nan;0;0
14114;186332;4864;0;0;0;0;.00nan;0;0
13303;183686;213;35;45;7;38;.844;3600000;0
13303;194950;1505;0;0;0;0;.00nan;0;0
13303;201495;213;0;0;0;0;.00nan;0;0
13303;186549;1505;71;31;2;29;.935;3600000;0
13369;189773;231;59;12;1;11;.917;3600000;0
13369;206955;231;0;0;0;0;.00nan;0;0
13369;185800;229;79;46;3;43;.935;3517000;0
13369;185960;229;0;0;0;0;.00nan;0;0
13365;200440;204;0;0;0;0;.00nan;0;0
13365;189902;204;65;16;1;15;.938;3600000;0
13365;196283;206;0;0;0;0;.00nan;0;0
13365;202998;206;52;35;4;31;.886;3600000;0
13478;198074;195;0;0;0;0;.00nan;0;0
13478;207061;195;82;15;0;15;1.000;3600000;0
13478;192547;190;45;40;7;33;.825;3245000;0
13478;197704;190;69;12;0;12;1.000;355000;0
13313;195238;200;28;29;6;23;.793;2770000;0
13313;-1;200;49;12;2;10;.833;830000;0
13313;-1;199;0;0;0;0;.00nan;0;0
13313;-1;199;72;27;2;25;.926;3600000;0
13491;198074;195;0;0;0;0;.00nan;0;0
13491;189081;187;36;27;5;22;.815;3535000;0
13491;207061;195;60;29;3;26;.897;3600000;0
13491;-1;187;0;0;0;0;.00nan;0;0
13297;205743;2620;0;0;0;0;.00nan;0;0
13297;184650;4864;91;44;2;42;.955;3222000;0
13297;-1;2620;56;19;2;17;.895;3600000;0
13297;186332;4864;25;6;3;3;.500;378000;0
13571;203383;232;51;26;5;21;.808;3600000;0
13571;187628;227;82;32;2;30;.938;3600000;0
13571;183695;232;0;0;0;0;.00nan;0;0
13571;187217;227;0;0;0;0;.00nan;0;0
13363;192915;179;0;0;0;0;.00nan;0;0
13363;-1;216;0;0;0;0;.00nan;0;0
13363;187355;179;69;27;3;24;.889;3767000;0
13363;-1;216;71;44;4;40;.909;3767000;0
13671;189529;193;64;17;2;15;.882;3600000;0
13671;201585;197;46;23;4;19;.826;2163000;0
13671;206822;197;29;22;5;17;.773;1437000;0
13671;186451;193;0;0;0;0;.00nan;0;0
13567;199416;191;0;0;0;0;.00nan;0;0
13567;200333;194;50;29;4;25;.862;1594000;0
13567;194893;191;56;13;1;12;.923;3600000;0
13567;196352;194;92;36;1;35;.972;2006000;0
14166;206801;176;0;0;0;0;.00nan;0;0
14166;182006;176;52;22;3;19;.864;3600000;0
14166;-1;209;51;44;6;38;.864;3178000;0
14166;203063;209;55;4;0;4;1.000;422000;0
13751;184175;224;39;16;4;12;.750;3600000;0
13751;180377;228;50;43;6;37;.860;3315000;0
13751;185840;224;0;0;0;0;.00nan;0;0
13751;208044;228;48;0;0;0;.00nan;225000;0
13483;195164;218;0;0;0;0;.00nan;0;0
13483;190095;218;66;34;3;31;.912;3900000;0
13483;-1;219;67;39;3;36;.923;3900000;0
13483;-1;219;0;0;0;0;.00nan;0;0
13341;184648;196;73;32;3;29;.906;3600000;0
13341;184788;198;61;41;6;35;.854;3600000;0
13341;181443;198;0;0;0;0;.00nan;0;0
13341;191118;196;0;0;0;0;.00nan;0;0
13354;194950;1505;65;13;1;12;.923;3600000;0
13354;196571;177;87;44;3;41;.932;3561000;0
13354;186549;1505;0;0;0;0;.00nan;0;0
13354;-1;177;0;0;0;0;.00nan;0;0
13515;182467;185;67;21;2;19;.905;3900000;0
13515;200306;182;0;0;0;0;.00nan;0;0
13515;185810;182;98;52;2;50;.962;3900000;0
13515;-1;185;0;0;0;0;.00nan;0;0
13498;195251;4949;61;24;3;21;.875;3600000;0
13498;-1;178;0;0;0;0;.00nan;0;0
13498;197685;4949;0;0;0;0;.00nan;0;0
13498;-1;178;85;52;5;47;.904;3556000;0
13400;200452;221;62;36;4;32;.889;3600000;0
13400;184610;222;30;23;5;18;.783;3566000;0
13400;185851;222;0;0;0;0;.00nan;0;0
13400;187431;221;0;0;0;0;.00nan;0;0
13404;192629;226;63;28;4;24;.857;3600000;0
13404;-1;226;0;0;0;0;.00nan;0;0
13404;-1;199;100;43;1;42;.977;3600000;0
13404;-1;199;0;0;0;0;.00nan;0;0
13481;182324;4960;0;0;0;0;.00nan;0;0
13481;194219;4960;30;19;4;15;.789;3553000;0
13481;189885;225;91;46;3;43;.935;3600000;0
13481;-1;225;0;0;0;0;.00nan;0;0
13591;200306;182;77;38;2;36;.947;3566000;0
13591;-1;220;0;0;0;0;.00nan;0;0
13591;-1;220;64;17;1;16;.941;3600000;0
13591;185810;182;0;0;0;0;.00nan;0;0
13547;189081;187;52;21;3;18;.857;3600000;0
13547;-1;189;0;0;0;0;.00nan;0;0
13547;-1;187;0;0;0;0;.00nan;0;0
13547;-1;189;62;38;4;34;.895;3584000;0
13449;195251;4949;81;28;2;26;.929;3587000;0
13449;-1;216;95;31;1;30;.968;3600000;0
13449;197685;4949;0;0;0;0;.00nan;0;0
13449;-1;216;0;0;0;0;.00nan;0;0
13554;184785;211;0;0;0;0;.00nan;0;0
13554;179646;211;83;49;3;46;.939;3600000;0
13554;-1;219;42;22;4;18;.818;3522000;0
13554;-1;219;0;0;0;0;.00nan;0;0
13488;182324;4960;0;0;0;0;.00nan;0;0
13488;194219;4960;97;21;0;21;1.000;3600000;0
13488;184175;224;61;35;4;31;.886;3600000;0
13488;185840;224;0;0;0;0;.00nan;0;0
13402;196283;206;0;0;0;0;.00nan;0;0
13402;-1;199;0;0;0;0;.00nan;0;0
13402;-1;199;81;34;3;31;.912;3641000;0
13402;202998;206;81;30;2;28;.933;3641000;0
13726;205788;207;0;0;0;0;.00nan;0;0
13726;201560;202;65;26;2;24;.923;3600000;0
13726;-1;207;53;40;4;36;.900;3518000;0
13726;196299;202;0;0;0;0;.00nan;0;0
13395;183686;213;0;0;0;0;.00nan;0;0
13395;201495;213;97;36;1;35;.972;3683000;0
13395;-1;183;0;0;0;0;.00nan;0;0
13395;180574;183;77;28;2;26;.929;3683000;0
13617;182467;185;0;0;0;0;.00nan;0;0
13617;205837;184;0;0;0;0;.00nan;0;0
13617;190125;184;62;40;5;35;.875;3551000;0
13617;-1;185;69;37;4;33;.892;3600000;0
13381;200452;221;0;0;0;0;.00nan;0;0
13381;184133;230;0;0;0;0;.00nan;0;0
13381;181338;230;53;13;2;11;.846;3600000;0
13381;187431;221;92;66;5;61;.924;3600000;0
13521;189529;193;0;0;0;0;.00nan;0;0
13521;186451;193;77;25;3;22;.880;3600000;0
13521;192547;190;0;0;0;0;.00nan;0;0
13521;197704;190;57;38;5;33;.868;3531000;0
13429;205743;2620;0;0;0;0;.00nan;0;0
13429;-1;2620;42;27;4;23;.852;3565000;0
13429;-1;209;0;0;0;0;.00nan;0;0
13429;203063;209;67;29;3;26;.897;3600000;0
13324;203383;232;67;17;1;16;.941;3600000;0
13324;183695;232;0;0;0;0;.00nan;0;0
13324;180377;228;0;0;0;0;.00nan;0;0
13324;208044;228;81;51;5;46;.902;3600000;0
13512;201585;197;78;37;2;35;.946;3900000;0
13512;206822;197;0;0;0;0;.00nan;0;0
13512;-1;192;55;17;2;15;.882;3900000;0
13512;207398;192;0;0;0;0;.00nan;0;0
13517;200437;201;85;28;1;27;.964;3600000;0
13517;195238;200;0;0;0;0;.00nan;0;0
13517;-1;200;83;39;3;36;.923;3600000;0
13517;-1;201;0;0;0;0;.00nan;0;0
13526;206801;176;57;19;2;17;.895;3600000;0
13526;182006;176;0;0;0;0;.00nan;0;0
13526;-1;209;68;35;3;32;.914;3600000;0
13526;203063;209;0;0;0;0;.00nan;0;0
13464;198149;188;0;0;0;0;.00nan;0;0
13464;189529;193;66;32;3;29;.906;3624000;0
13464;184409;188;69;26;2;24;.923;3649000;0
13464;186451;193;0;0;0;0;.00nan;0;0
13452;205837;184;0;0;0;0;.00nan;0;0
13452;190125;184;46;19;4;15;.789;3600000;0
13452;-1;220;68;30;3;27;.900;3600000;0
13452;-1;220;0;0;0;0;.00nan;0;0
13620;184610;222;62;23;2;21;.913;3600000;0
13620;185800;229;72;38;3;35;.921;3564000;0
13620;185851;222;0;0;0;0;.00nan;0;0
13620;185960;229;0;0;0;0;.00nan;0;0
13418;192915;179;80;33;2;31;.939;3591000;0
13418;196571;177;65;19;1;18;.947;3600000;0
13418;187355;179;0;0;0;0;.00nan;0;0
13418;-1;177;0;0;0;0;.00nan;0;0
13581;184648;196;56;30;4;26;.867;3600000;0
13581;201585;197;0;0;0;0;.00nan;0;0
13581;206822;197;99;44;1;43;.977;3600000;0
13581;191118;196;0;0;0;0;.00nan;0;0
13444;200440;204;0;0;0;0;.00nan;0;0
13444;189902;204;79;39;4;35;.897;3549000;0
13444;201524;205;69;23;2;21;.913;3600000;0
13444;-1;205;0;0;0;0;.00nan;0;0
13637;189081;187;52;29;3;26;.897;3900000;0
13637;200333;194;0;0;0;0;.00nan;0;0
13637;196352;194;97;48;3;45;.938;3900000;0
13637;-1;187;0;0;0;0;.00nan;0;0
13409;203383;232;0;0;0;0;.00nan;0;0
13409;183695;232;65;43;5;38;.884;3600000;0
13409;184133;230;77;22;1;21;.955;3600000;0
13409;181338;230;0;0;0;0;.00nan;0;0
13658;192939;208;59;30;4;26;.867;1962000;0
13658;200380;208;45;14;2;12;.857;1593000;0
13658;201560;202;55;28;4;24;.857;3600000;0
13658;196299;202;0;0;0;0;.00nan;0;0
13380;195164;218;77;39;3;36;.923;3881000;0
13380;190095;218;0;0;0;0;.00nan;0;0
13380;-1;180;87;38;2;36;.947;3881000;0
13380;197707;180;0;0;0;0;.00nan;0;0
13389;189773;231;34;17;4;13;.765;3561000;0
13389;206955;231;0;0;0;0;.00nan;0;0
13389;180377;228;100;55;2;53;.964;3600000;0
13389;208044;228;0;0;0;0;.00nan;0;0
13368;183686;213;61;31;3;28;.903;3796000;0
13368;201495;213;0;0;0;0;.00nan;0;0
13368;-1;183;77;24;2;22;.917;3796000;0
13368;180574;183;0;0;0;0;.00nan;0;0
13502;179499;186;40;18;4;14;.778;3649000;0
13502;184785;211;85;52;5;47;.904;3649000;0
13502;190098;186;0;0;0;0;.00nan;0;0
13502;179646;211;0;0;0;0;.00nan;0;0
13560;198074;195;0;0;0;0;.00nan;0;0
13560;-1;192;0;0;0;0;.00nan;0;0
13560;207061;195;36;27;5;22;.815;3600000;0
13560;207398;192;80;38;3;35;.921;3600000;0
13504;184788;198;0;0;0;0;.00nan;0;0
13504;181443;198;74;31;2;29;.935;3652000;0
13504;192547;190;94;36;1;35;.972;3652000;0
13504;197704;190;0;0;0;0;.00nan;0;0
13549;195238;200;56;35;4;31;.886;3590000;0
13549;-1;200;0;0;0;0;.00nan;0;0
13549;192629;226;47;12;2;10;.833;3600000;0
13549;-1;226;0;0;0;0;.00nan;0;0
13525;187628;227;93;36;1;35;.972;3900000;0
13525;189885;225;0;0;0;0;.00nan;0;0
13525;-1;225;95;39;1;38;.974;3900000;0
13525;187217;227;0;0;0;0;.00nan;0;0
13507;200437;201;0;0;0;0;.00nan;0;0
13507;201525;203;54;20;3;17;.850;3580000;0
13507;191078;203;0;0;0;0;.00nan;0;0
13507;-1;201;92;32;2;30;.938;3600000;0
13338;194950;1505;0;0;0;0;.00nan;0;0
13338;186549;1505;85;22;1;21;.955;3600000;0
13338;-1;178;0;0;0;0;.00nan;0;0
13338;-1;178;77;41;3;38;.927;3522000;0
13566;190034;217;47;6;1;5;.833;1229000;0
13566;190041;217;53;31;5;26;.839;2371000;0
13566;-1;219;0;0;0;0;.00nan;0;0
13566;-1;219;76;31;2;29;.935;3600000;0
13378;184650;4864;0;0;0;0;.00nan;0;0
13378;190164;4959;0;0;0;0;.00nan;0;0
13378;186332;4864;58;30;3;27;.900;3518000;0
13378;-1;4959;84;28;1;27;.964;3600000;0
13957;179679;212;57;24;3;21;.875;3572000;0
13957;182128;215;0;0;0;0;.00nan;0;0
13957;-1;212;0;0;0;0;.00nan;0;0
13957;-1;215;75;30;2;28;.933;3600000;0
13479;-1;181;100;24;0;24;1.000;3600000;0
13479;-1;214;76;38;3;35;.921;3600000;0
13479;191518;214;0;0;0;0;.00nan;0;0
13479;192552;181;0;0;0;0;.00nan;0;0
13440;192939;208;88;17;0;17;1.000;3600000;0
13440;200380;208;0;0;0;0;.00nan;0;0
13440;-1;199;0;0;0;0;.00nan;0;0
13440;-1;199;72;25;1;24;.960;3600000;0
13523;196283;206;0;0;0;0;.00nan;0;0
13523;192629;226;0;0;0;0;.00nan;0;0
13523;-1;226;63;26;2;24;.923;3600000;0
13523;202998;206;48;26;3;23;.885;3559000;0
14152;194950;1505;57;43;6;37;.860;3600000;0
14152;-1;216;51;22;3;19;.864;3600000;0
14152;186549;1505;0;0;0;0;.00nan;0;0
14152;-1;216;0;0;0;0;.00nan;0;0
13426;184650;4864;0;0;0;0;.00nan;0;0
13426;206801;176;79;13;0;13;1.000;3600000;0
13426;182006;176;0;0;0;0;.00nan;0;0
13426;186332;4864;81;28;1;27;.964;3543000;0
13414;184133;230;0;0;0;0;.00nan;0;0
13414;184610;222;71;52;5;47;.904;3600000;0
13414;181338;230;58;12;1;11;.917;3600000;0
13414;185851;222;0;0;0;0;.00nan;0;0
13445;195164;218;79;35;3;32;.914;3600000;0
13445;179499;186;48;37;5;32;.865;3543000;0
13445;190095;218;0;0;0;0;.00nan;0;0
13445;190098;186;0;0;0;0;.00nan;0;0
13447;-1;216;0;0;0;0;.00nan;0;0
13447;196571;177;74;24;2;22;.917;3600000;0
13447;-1;216;54;33;5;28;.848;3600000;0
13447;-1;177;0;0;0;0;.00nan;0;0
13510;200452;221;66;31;3;28;.903;3600000;0
13510;191120;223;0;0;0;0;.00nan;0;0
13510;187118;223;100;45;1;44;.978;3600000;0
13510;187431;221;0;0;0;0;.00nan;0;0
13432;183686;213;0;0;0;0;.00nan;0;0
13432;201495;213;71;40;3;37;.925;3600000;0
13432;192461;210;87;17;0;17;1.000;3600000;0
13432;197672;210;0;0;0;0;.00nan;0;0
13385;182128;215;100;31;0;31;1.000;3600000;0
13385;-1;180;38;32;6;26;.813;2661000;0
13385;197707;180;63;11;0;11;1.000;939000;0
13385;-1;215;0;0;0;0;.00nan;0;0
13424;192915;179;0;0;0;0;.00nan;0;0
13424;-1;183;83;31;2;29;.935;3600000;0
13424;180574;183;0;0;0;0;.00nan;0;0
13424;187355;179;81;24;1;23;.958;3600000;0
13545;198074;195;0;0;0;0;.00nan;0;0
13545;-1;192;75;38;4;34;.895;3589000;0
13545;207061;195;76;32;3;29;.906;3600000;0
13545;207398;192;0;0;0;0;.00nan;0;0
13613;205743;2620;0;0;0;0;.00nan;0;0
13613;-1;2620;59;21;2;19;.905;3900000;0
13613;-1;209;97;50;2;48;.960;3900000;0
13613;203063;209;0;0;0;0;.00nan;0;0
13711;190034;217;44;27;4;23;.852;3600000;0
13711;190041;217;0;0;0;0;.00nan;0;0
13711;179679;212;0;0;0;0;.00nan;0;0
13711;-1;212;67;33;3;30;.909;3600000;0
13454;201524;205;0;0;0;0;.00nan;0;0
13454;196283;206;0;0;0;0;.00nan;0;0
13454;-1;205;80;22;1;21;.955;3600000;0
13454;202998;206;58;38;4;34;.895;3600000;0
13484;-1;181;73;20;1;19;.950;3600000;0
13484;-1;214;74;38;3;35;.921;3600000;0
13484;191518;214;0;0;0;0;.00nan;0;0
13484;192552;181;0;0;0;0;.00nan;0;0
13492;189081;187;60;35;4;31;.886;3600000;0
13492;200333;194;0;0;0;0;.00nan;0;0
13492;196352;194;95;36;1;35;.972;3600000;0
13492;-1;187;0;0;0;0;.00nan;0;0
13496;182467;185;38;30;5;25;.833;3600000;0
13496;205837;184;0;0;0;0;.00nan;0;0
13496;190125;184;98;25;0;25;1.000;3600000;0
13496;-1;185;0;0;0;0;.00nan;0;0
13582;200440;204;0;0;0;0;.00nan;0;0
13582;195238;200;0;0;0;0;.00nan;0;0
13582;189902;204;75;24;1;23;.958;3552000;0
13582;-1;200;100;32;0;32;1.000;3600000;0
13499;203383;232;100;28;0;28;1.000;3600000;0
13499;187628;227;44;20;3;17;.850;3600000;0
13499;183695;232;0;0;0;0;.00nan;0;0
13499;187217;227;0;0;0;0;.00nan;0;0
13408;182324;4960;0;0;0;0;.00nan;0;0
13408;194219;4960;83;32;2;30;.938;3600000;0
13408;189773;231;53;34;4;30;.882;3600000;0
13408;206955;231;0;0;0;0;.00nan;0;0
13413;205788;207;0;0;0;0;.00nan;0;0
13413;-1;207;35;21;4;17;.810;3547000;0
13413;-1;199;86;37;2;35;.946;3600000;0
13413;-1;199;0;0;0;0;.00nan;0;0
13723;199416;191;0;0;0;0;.00nan;0;0
13723;194893;191;76;17;1;16;.941;3600000;0
13723;184648;196;70;52;5;47;.904;3600000;0
13723;191118;196;0;0;0;0;.00nan;0;0
13802;200306;182;0;0;0;0;.00nan;0;0
13802;-1;1371;0;0;0;0;.00nan;0;0
13802;185810;182;54;24;3;21;.875;3600000;0
13802;192688;1371;51;26;4;22;.846;3560000;0
13485;198149;188;0;0;0;0;.00nan;0;0
13485;184409;188;74;34;2;32;.941;3900000;0
13485;-1;189;0;0;0;0;.00nan;0;0
13485;-1;189;76;27;2;25;.926;3900000;0
13786;198074;195;53;32;3;29;.906;3600000;0
13786;199416;191;0;0;0;0;.00nan;0;0
13786;194893;191;80;24;1;23;.958;3600000;0
13786;207061;195;0;0;0;0;.00nan;0;0
13904;200306;182;71;36;3;33;.917;3600000;0
13904;-1;1371;0;0;0;0;.00nan;0;0
13904;185810;182;0;0;0;0;.00nan;0;0
13904;192688;1371;32;21;5;16;.762;3561000;0
13641;179499;186;0;0;0;0;.00nan;0;0
13641;190098;186;88;30;1;29;.967;3600000;0
13641;-1;219;32;33;6;27;.818;3600000;0
13641;-1;219;0;0;0;0;.00nan;0;0
13656;190034;217;0;0;0;0;.00nan;0;0
13656;190041;217;65;18;1;17;.944;3600000;0
13656;182128;215;93;50;3;47;.940;3567000;0
13656;-1;215;0;0;0;0;.00nan;0;0
14070;184175;224;63;25;3;22;.880;3889000;0
14070;189885;225;80;47;4;43;.915;3889000;0
14070;-1;225;0;0;0;0;.00nan;0;0
14070;185840;224;0;0;0;0;.00nan;0;0
13469;190164;4959;49;20;3;17;.850;3600000;0
13469;206801;176;53;30;5;25;.833;3565000;0
13469;182006;176;0;0;0;0;.00nan;0;0
13469;-1;4959;0;0;0;0;.00nan;0;0
13474;189529;193;0;0;0;0;.00nan;0;0
13474;186451;193;67;27;3;24;.889;3600000;0
13474;-1;189;14;14;5;9;.643;1262000;0
13474;-1;189;63;34;4;30;.882;2338000;0
13596;200437;201;74;35;3;32;.914;3600000;0
13596;200440;204;0;0;0;0;.00nan;0;0
13596;189902;204;100;31;1;30;.968;3600000;0
13596;-1;201;0;0;0;0;.00nan;0;0
13463;182467;185;0;0;0;0;.00nan;0;0
13463;-1;220;0;0;0;0;.00nan;0;0
13463;-1;220;82;25;1;24;.960;3543000;0
13463;-1;185;100;33;0;33;1.000;3600000;0
13514;187628;227;0;0;0;0;.00nan;0;0
13514;185800;229;56;28;4;24;.857;3550000;0
13514;185960;229;0;0;0;0;.00nan;0;0
13514;187217;227;63;24;3;21;.875;3600000;0
13557;195164;218;99;37;1;36;.973;3600000;0
13557;184785;211;0;0;0;0;.00nan;0;0
13557;190095;218;0;0;0;0;.00nan;0;0
13557;179646;211;77;30;2;28;.933;3600000;0
13562;201525;203;47;42;7;35;.833;3600000;0
13562;191078;203;0;0;0;0;.00nan;0;0
13562;192629;226;62;19;2;17;.895;3600000;0
13562;-1;226;0;0;0;0;.00nan;0;0
13532;192915;179;51;41;6;35;.854;3344000;0
13532;187355;179;51;2;0;2;1.000;256000;0
13532;192461;210;97;19;0;19;1.000;3600000;0
13532;197672;210;0;0;0;0;.00nan;0;0
13495;-1;181;0;0;0;0;.00nan;0;0
13495;-1;214;0;0;0;0;.00nan;0;0
13495;191518;214;44;29;5;24;.828;3548000;0
13495;192552;181;66;28;3;25;.893;3600000;0
13377;194950;1505;0;0;0;0;.00nan;0;0
13377;186549;1505;53;27;4;23;.852;3561000;0
13377;-1;178;0;0;0;0;.00nan;0;0
13377;-1;178;84;37;2;35;.946;3600000;0
13453;182324;4960;58;24;4;20;.833;3900000;0
13453;194219;4960;0;0;0;0;.00nan;0;0
13453;200452;221;0;0;0;0;.00nan;0;0
13453;187431;221;92;56;4;52;.929;3900000;0
13443;179679;212;72;35;3;32;.914;3600000;0
13443;-1;212;0;0;0;0;.00nan;0;0
13443;-1;180;0;0;0;0;.00nan;0;0
13443;197707;180;43;22;4;18;.818;3548000;0
13457;205788;207;49;36;5;31;.861;2350000;0
13457;201524;205;0;0;0;0;.00nan;0;0
13457;-1;207;58;16;1;15;.938;1250000;0
13457;-1;205;55;24;3;21;.875;3600000;0
13859;192939;208;83;22;0;22;1.000;3900000;0
13859;200380;208;0;0;0;0;.00nan;0;0
13859;201525;203;0;0;0;0;.00nan;0;0
13859;191078;203;100;38;0;38;1.000;3900000;0
13439;189773;231;56;12;1;11;.917;3600000;0
13439;184610;222;83;37;3;34;.919;3554000;0
13439;206955;231;0;0;0;0;.00nan;0;0
13439;185851;222;0;0;0;0;.00nan;0;0
13459;184650;4864;0;0;0;0;.00nan;0;0
13459;190164;4959;0;0;0;0;.00nan;0;0
13459;186332;4864;100;39;0;39;1.000;3600000;0
13459;-1;4959;86;27;1;26;.963;3600000;0
13524;184648;196;44;38;6;32;.842;3296000;0
13524;184788;198;0;0;0;0;.00nan;0;0
13524;181443;198;48;14;2;12;.857;3600000;0
13524;191118;196;48;0;0;0;.00nan;304000;0
13503;196571;177;33;12;3;9;.750;3519000;0
13503;-1;178;98;40;1;39;.975;3600000;0
13503;-1;178;0;0;0;0;.00nan;0;0
13503;-1;177;0;0;0;0;.00nan;0;0
13461;194950;1505;66;30;3;27;.900;3554000;0
13461;-1;216;100;45;2;43;.956;3600000;0
13461;186549;1505;0;0;0;0;.00nan;0;0
13461;-1;216;0;0;0;0;.00nan;0;0
13609;200333;194;0;0;0;0;.00nan;0;0
13609;201585;197;100;27;0;27;1.000;3600000;0
13609;206822;197;0;0;0;0;.00nan;0;0
13609;196352;194;66;28;3;25;.893;3600000;0
13624;184175;224;74;30;3;27;.900;3584000;0
13624;185840;224;0;0;0;0;.00nan;0;0
13624;191120;223;0;0;0;0;.00nan;0;0
13624;187118;223;85;27;1;26;.963;3600000;0
13610;180377;228;0;0;0;0;.00nan;0;0
13610;185800;229;0;0;0;0;.00nan;0;0
13610;185960;229;80;21;1;20;.952;3900000;0
13610;208044;228;83;32;1;31;.969;3900000;0
14005;195251;4949;58;41;6;35;.854;3569000;0
14005;192461;210;75;38;4;34;.895;3600000;0
14005;197672;210;0;0;0;0;.00nan;0;0
14005;197685;4949;0;0;0;0;.00nan;0;0
13375;199416;191;0;0;0;0;.00nan;0;0
13375;194893;191;51;13;3;10;.769;3600000;0
13375;184788;198;17;16;5;11;.688;903000;0
13375;181443;198;59;22;2;20;.909;2697000;0
14136;205788;207;0;0;0;0;.00nan;0;0
14136;195238;200;0;0;0;0;.00nan;0;0
14136;-1;207;90;38;2;36;.947;3600000;0
14136;-1;200;35;17;4;13;.765;3546000;0
13680;189885;225;86;43;3;40;.930;3888000;0
13680;-1;225;0;0;0;0;.00nan;0;0
13680;191120;223;0;0;0;0;.00nan;0;0
13680;187118;223;67;36;4;32;.889;3888000;0
13489;198149;188;0;0;0;0;.00nan;0;0
13489;184409;188;76;27;1;26;.963;3600000;0
13489;192547;190;41;4;1;3;.750;548000;0
13489;197704;190;49;38;6;32;.842;3052000;0
13583;198149;188;46;26;4;22;.846;3578000;0
13583;200333;194;0;0;0;0;.00nan;0;0
13583;184409;188;0;0;0;0;.00nan;0;0
13583;196352;194;77;45;3;42;.933;3600000;0
13494;201524;205;0;0;0;0;.00nan;0;0
13494;201560;202;46;39;5;34;.872;3750000;0
13494;196299;202;0;0;0;0;.00nan;0;0
13494;-1;205;44;21;4;17;.810;3750000;0
13757;184648;196;58;18;2;16;.889;3581000;0
13757;201585;197;100;36;0;36;1.000;3600000;0
13757;206822;197;0;0;0;0;.00nan;0;0
13757;191118;196;0;0;0;0;.00nan;0;0
13614;192939;208;85;29;1;28;.966;3600000;0
13614;200380;208;0;0;0;0;.00nan;0;0
13614;200437;201;80;32;2;30;.938;3549000;0
13614;-1;201;0;0;0;0;.00nan;0;0
13548;199416;191;0;0;0;0;.00nan;0;0
13548;194893;191;76;18;1;17;.944;3600000;0
13548;192547;190;91;49;3;46;.939;3600000;0
13548;197704;190;0;0;0;0;.00nan;0;0
13471;205743;2620;0;0;0;0;.00nan;0;0
13471;190164;4959;80;51;4;47;.922;3561000;0
13471;-1;2620;48;14;2;12;.857;3600000;0
13471;-1;4959;0;0;0;0;.00nan;0;0
13893;184785;211;0;0;0;0;.00nan;0;0
13893;179646;211;96;45;1;44;.978;3900000;0
13893;182128;215;0;0;0;0;.00nan;0;0
13893;-1;215;79;21;1;20;.952;3900000;0
13564;200440;204;0;0;0;0;.00nan;0;0
13564;189902;204;98;21;0;21;1.000;3600000;0
13564;196283;206;0;0;0;0;.00nan;0;0
13564;202998;206;94;49;2;47;.959;3553000;0
13448;190034;217;52;35;4;31;.886;3900000;0
13448;190041;217;0;0;0;0;.00nan;0;0
13448;-1;180;53;27;4;23;.852;3885000;0
13448;197707;180;0;0;0;0;.00nan;0;0
13672;198074;195;0;0;0;0;.00nan;0;0
13672;207061;195;63;21;2;19;.905;3579000;0
13672;-1;189;0;0;0;0;.00nan;0;0
13672;-1;189;100;29;0;29;1.000;3600000;0
13691;195251;4949;0;0;0;0;.00nan;0;0
13691;-1;183;46;17;3;14;.824;3554000;0
13691;180574;183;0;0;0;0;.00nan;0;0
13691;197685;4949;82;30;2;28;.933;3600000;0
13692;203383;232;54;30;4;26;.867;3566000;0
13692;183695;232;0;0;0;0;.00nan;0;0
13692;185800;229;73;35;3;32;.914;3600000;0
13692;185960;229;0;0;0;0;.00nan;0;0
13595;205788;207;0;0;0;0;.00nan;0;0
13595;201525;203;0;0;0;0;.00nan;0;0
13595;-1;207;67;37;4;33;.892;3600000;0
13595;191078;203;65;18;1;17;.944;3600000;0
13746;182467;185;56;6;0;6;1.000;807000;0
13746;-1;220;0;0;0;0;.00nan;0;0
13746;-1;220;68;34;3;31;.912;3600000;0
13746;-1;185;26;35;7;28;.800;2793000;0
13575;192915;179;0;0;0;0;.00nan;0;0
13575;187355;179;70;28;2;26;.929;3600000;0
13575;192461;210;46;31;4;27;.871;3548000;0
13575;197672;210;0;0;0;0;.00nan;0;0
13574;184133;230;0;0;0;0;.00nan;0;0
13574;189885;225;0;0;0;0;.00nan;0;0
13574;181338;230;41;8;2;6;.750;3600000;0
13574;-1;225;83;82;6;76;.927;3600000;0
13482;183686;213;0;0;0;0;.00nan;0;0
13482;-1;216;89;29;1;28;.966;3600000;0
13482;201495;213;63;29;3;26;.897;3568000;0
13482;-1;216;0;0;0;0;.00nan;0;0
13589;195164;218;83;41;3;38;.927;3577000;0
13589;190095;218;0;0;0;0;.00nan;0;0
13589;179679;212;73;29;2;27;.931;3600000;0
13589;-1;212;0;0;0;0;.00nan;0;0
14001;184175;224;82;13;0;13;1.000;3600000;0
14001;185800;229;0;0;0;0;.00nan;0;0
14001;185840;224;0;0;0;0;.00nan;0;0
14001;185960;229;55;34;4;30;.882;3600000;0
13587;200333;194;100;36;0;36;1.000;3600000;0
13587;-1;192;54;24;3;21;.875;3600000;0
13587;196352;194;0;0;0;0;.00nan;0;0
13587;207398;192;0;0;0;0;.00nan;0;0
13434;184133;230;62;18;1;17;.944;3600000;0
13434;181338;230;0;0;0;0;.00nan;0;0
13434;191120;223;0;0;0;0;.00nan;0;0
13434;187118;223;94;65;5;60;.923;3600000;0
13486;189773;231;65;27;3;24;.889;3900000;0
13486;206955;231;0;0;0;0;.00nan;0;0
13486;180377;228;79;42;3;39;.929;3900000;0
13486;208044;228;0;0;0;0;.00nan;0;0
13946;-1;219;93;36;1;35;.972;3600000;0
13946;182128;215;75;28;2;26;.929;3544000;0
13946;-1;219;0;0;0;0;.00nan;0;0
13946;-1;215;0;0;0;0;.00nan;0;0
13530;189081;187;75;24;1;23;.958;3600000;0
13530;184788;198;47;33;5;28;.848;3600000;0
13530;181443;198;0;0;0;0;.00nan;0;0
13530;-1;187;0;0;0;0;.00nan;0;0
13511;200452;221;48;25;4;21;.840;3515000;0
13511;184610;222;100;45;2;43;.956;3600000;0
13511;185851;222;0;0;0;0;.00nan;0;0
13511;187431;221;0;0;0;0;.00nan;0;0
13569;200306;182;0;0;0;0;.00nan;0;0
13569;-1;181;58;31;4;27;.871;3553000;0
13569;185810;182;80;31;2;29;.935;3600000;0
13569;192552;181;0;0;0;0;.00nan;0;0
13572;192915;179;65;27;2;25;.926;3564000;0
13572;187355;179;0;0;0;0;.00nan;0;0
13572;-1;178;0;0;0;0;.00nan;0;0
13572;-1;178;91;34;1;33;.971;3600000;0
13599;205837;184;0;0;0;0;.00nan;0;0
13599;-1;1371;0;0;0;0;.00nan;0;0
13599;190125;184;56;29;3;26;.897;3600000;0
13599;192688;1371;95;54;4;50;.926;3574000;0
13505;192939;208;0;0;0;0;.00nan;0;0
13505;200380;208;81;34;2;32;.941;3600000;0
13505;201524;205;65;13;0;13;1.000;1368000;0
13505;-1;205;25;13;4;9;.692;2192000;0
13546;201560;202;53;7;1;6;.857;3600000;0
13546;196283;206;81;50;3;47;.940;3600000;0
13546;196299;202;0;0;0;0;.00nan;0;0
13546;202998;206;0;0;0;0;.00nan;0;0
13540;182324;4960;0;0;0;0;.00nan;0;0
13540;203383;232;0;0;0;0;.00nan;0;0
13540;194219;4960;71;31;3;28;.903;3600000;0
13540;183695;232;62;25;2;23;.920;3600000;0
13462;184650;4864;0;0;0;0;.00nan;0;0
13462;206801;176;61;25;3;22;.880;3714000;0
13462;182006;176;0;0;0;0;.00nan;0;0
13462;186332;4864;66;27;2;25;.926;3714000;0
13467;-1;216;0;0;0;0;.00nan;0;0
13467;196571;177;99;40;1;39;.975;3600000;0
13467;-1;216;68;39;4;35;.897;3600000;0
13467;-1;177;0;0;0;0;.00nan;0;0
13472;183686;213;94;41;2;39;.951;3767000;0
13472;194950;1505;0;0;0;0;.00nan;0;0
13472;201495;213;0;0;0;0;.00nan;0;0
13472;186549;1505;77;39;3;36;.923;3767000;0
13552;189529;193;0;0;0;0;.00nan;0;0
13552;186451;193;43;22;4;18;.818;3547000;0
13552;-1;189;0;0;0;0;.00nan;0;0
13552;-1;189;93;38;2;36;.947;3600000;0
13632;200440;204;0;0;0;0;.00nan;0;0
13632;189902;204;79;25;1;24;.960;3600000;0
13632;201525;203;79;44;4;40;.909;3600000;0
13632;191078;203;0;0;0;0;.00nan;0;0
13451;184785;211;69;35;4;31;.886;3565000;0
13451;179646;211;0;0;0;0;.00nan;0;0
13451;-1;180;0;0;0;0;.00nan;0;0
13451;197707;180;63;29;3;26;.897;3600000;0
13781;-1;220;52;23;3;20;.870;3749000;0
13781;-1;220;0;0;0;0;.00nan;0;0
13781;-1;214;79;44;4;40;.909;3708000;0
13781;191518;214;0;0;0;0;.00nan;0;0
13455;192629;226;43;30;5;25;.833;3600000;0
13455;-1;226;0;0;0;0;.00nan;0;0
13455;-1;199;99;37;1;36;.973;3600000;0
13455;-1;199;0;0;0;0;.00nan;0;0
13784;190164;4959;0;0;0;0;.00nan;0;0
13784;-1;209;0;0;0;0;.00nan;0;0
13784;-1;4959;67;24;2;22;.917;3600000;0
13784;203063;209;57;27;3;24;.889;3600000;0
13686;194950;1505;40;32;5;27;.844;3600000;0
13686;195251;4949;99;40;2;38;.950;3600000;0
13686;186549;1505;0;0;0;0;.00nan;0;0
13686;197685;4949;0;0;0;0;.00nan;0;0
13683;199416;191;63;16;1;15;.938;3900000;0
13683;194893;191;0;0;0;0;.00nan;0;0
13683;189529;193;100;49;1;48;.980;3900000;0
13683;186451;193;0;0;0;0;.00nan;0;0
13450;189773;231;78;22;2;20;.909;3834000;0
13450;206955;231;0;0;0;0;.00nan;0;0
13450;191120;223;0;0;0;0;.00nan;0;0
13450;187118;223;94;59;3;56;.949;3834000;0
13516;182324;4960;63;24;2;22;.917;3600000;0
13516;187628;227;47;32;5;27;.844;3600000;0
13516;194219;4960;0;0;0;0;.00nan;0;0
13516;187217;227;0;0;0;0;.00nan;0;0
13676;195164;218;12;24;7;17;.708;2663000;0
13676;179499;186;100;30;0;30;1.000;3600000;0
13676;190095;218;46;9;1;8;.889;937000;0
13676;190098;186;0;0;0;0;.00nan;0;0
13673;196571;177;0;0;0;0;.00nan;0;0
13673;192461;210;75;25;2;23;.920;3600000;0
13673;197672;210;0;0;0;0;.00nan;0;0
13673;-1;177;63;34;4;30;.882;3519000;0
13568;184788;198;0;0;0;0;.00nan;0;0
13568;-1;192;0;0;0;0;.00nan;0;0
13568;207398;192;38;28;5;23;.821;3525000;0
13568;181443;198;64;25;3;22;.880;3600000;0
13618;198149;188;0;0;0;0;.00nan;0;0
13618;184409;188;66;22;2;20;.909;3600000;0
13618;201585;197;30;14;4;10;.714;1031000;0
13618;206822;197;49;33;4;29;.879;2569000;0
13585;187628;227;0;0;0;0;.00nan;0;0
13585;184610;222;100;39;1;38;.974;3600000;0
13585;185851;222;0;0;0;0;.00nan;0;0
13585;187217;227;46;30;4;26;.867;3600000;0
13645;200440;204;0;0;0;0;.00nan;0;0
13645;189902;204;99;40;1;39;.975;3600000;0
13645;192629;226;83;35;2;33;.943;3600000;0
13645;-1;226;0;0;0;0;.00nan;0;0
13446;200437;201;44;23;4;19;.826;3600000;0
13446;-1;199;0;0;0;0;.00nan;0;0
13446;-1;201;0;0;0;0;.00nan;0;0
13446;-1;199;100;21;0;21;1.000;3600000;0
13699;182467;185;88;52;3;49;.942;3577000;0
13699;205837;184;0;0;0;0;.00nan;0;0
13699;190125;184;70;16;1;15;.938;3600000;0
13699;-1;185;0;0;0;0;.00nan;0;0
13964;-1;219;58;17;2;15;.882;3600000;0
13964;182128;215;0;0;0;0;.00nan;0;0
13964;-1;219;0;0;0;0;.00nan;0;0
13964;-1;215;89;54;5;49;.907;3600000;0
13476;205743;2620;0;0;0;0;.00nan;0;0
13476;184650;4864;0;0;0;0;.00nan;0;0
13476;-1;2620;100;29;1;28;.966;3600000;0
13476;186332;4864;57;24;3;21;.875;3579000;0
13573;198074;195;0;0;0;0;.00nan;0;0
13573;207061;195;69;29;3;26;.897;3600000;0
13573;192547;190;48;7;1;6;.857;384000;0
13573;197704;190;45;38;6;32;.842;3216000;0
13528;190164;4959;91;45;2;43;.956;3600000;0
13528;206801;176;0;0;0;0;.00nan;0;0
13528;182006;176;62;28;3;25;.893;3553000;0
13528;-1;4959;0;0;0;0;.00nan;0;0
13578;192939;208;53;15;2;13;.867;3600000;0
13578;200380;208;0;0;0;0;.00nan;0;0
13578;196283;206;0;0;0;0;.00nan;0;0
13578;202998;206;58;45;5;40;.889;3600000;0
13642;190034;217;0;0;0;0;.00nan;0;0
13642;190041;217;65;35;4;31;.886;3600000;0
13642;179499;186;0;0;0;0;.00nan;0;0
13642;190098;186;35;27;5;22;.815;3573000;0
13473;184785;211;0;0;0;0;.00nan;0;0
13473;179646;211;76;39;3;36;.923;3600000;0
13473;-1;180;80;12;0;12;1.000;3600000;0
13473;197707;180;0;0;0;0;.00nan;0;0
13654;200452;221;73;19;1;18;.947;3600000;0
13654;189885;225;55;37;5;32;.865;3600000;0
13654;-1;225;0;0;0;0;.00nan;0;0
13654;187431;221;0;0;0;0;.00nan;0;0
13657;201524;205;0;0;0;0;.00nan;0;0
13657;201525;203;57;33;4;29;.879;3600000;0
13657;-1;205;83;23;1;22;.957;3600000;0
13657;191078;203;0;0;0;0;.00nan;0;0
13580;184133;230;0;0;0;0;.00nan;0;0
13580;180377;228;77;39;3;36;.923;3900000;0
13580;181338;230;53;18;3;15;.833;3900000;0
13580;208044;228;0;0;0;0;.00nan;0;0
13758;203383;232;70;18;1;17;.944;3600000;0
13758;183695;232;0;0;0;0;.00nan;0;0
13758;184175;224;61;37;5;32;.865;3600000;0
13758;185840;224;0;0;0;0;.00nan;0;0
13531;-1;1371;0;0;0;0;.00nan;0;0
13531;-1;181;89;54;3;51;.944;3600000;0
13531;192552;181;0;0;0;0;.00nan;0;0
13531;192688;1371;100;28;0;28;1.000;3600000;0
13543;192915;179;0;0;0;0;.00nan;0;0
13543;187355;179;100;32;0;32;1.000;3600000;0
13543;-1;178;0;0;0;0;.00nan;0;0
13543;-1;178;75;39;4;35;.897;3600000;0
13817;200306;182;0;0;0;0;.00nan;0;0
13817;185810;182;97;27;0;27;1.000;3600000;0
13817;-1;214;75;21;1;20;.952;3578000;0
13817;191518;214;0;0;0;0;.00nan;0;0
13796;-1;183;78;27;1;26;.963;3600000;0
13796;180574;183;0;0;0;0;.00nan;0;0
13796;196571;177;78;31;2;29;.935;3557000;0
13796;-1;177;0;0;0;0;.00nan;0;0
13555;182324;4960;0;0;0;0;.00nan;0;0
13555;194219;4960;27;24;5;19;.792;3600000;0
13555;184610;222;91;35;1;34;.971;3600000;0
13555;185851;222;0;0;0;0;.00nan;0;0
13667;-1;178;84;37;2;35;.946;3567000;0
13667;192461;210;100;21;0;21;1.000;3600000;0
13667;197672;210;0;0;0;0;.00nan;0;0
13667;-1;178;0;0;0;0;.00nan;0;0
13559;184785;211;84;55;5;50;.909;3600000;0
13559;179646;211;0;0;0;0;.00nan;0;0
13559;179679;212;61;15;1;14;.933;3600000;0
13559;-1;212;0;0;0;0;.00nan;0;0
13647;200333;194;64;35;4;31;.886;3600000;0
13647;184648;196;77;33;3;30;.909;3600000;0
13647;196352;194;0;0;0;0;.00nan;0;0
13647;191118;196;0;0;0;0;.00nan;0;0
13550;206801;176;95;27;1;26;.963;3600000;0
13550;182006;176;0;0;0;0;.00nan;0;0
13550;-1;209;0;0;0;0;.00nan;0;0
13550;203063;209;38;26;5;21;.808;3600000;0
13556;-1;1371;0;0;0;0;.00nan;0;0
13556;-1;181;0;0;0;0;.00nan;0;0
13556;192552;181;69;24;3;21;.875;3600000;0
13556;192688;1371;81;45;5;40;.889;3584000;0
13937;205788;207;0;0;0;0;.00nan;0;0
13937;-1;207;91;35;1;34;.971;3600000;0
13937;192629;226;0;0;0;0;.00nan;0;0
13937;-1;226;49;13;2;11;.846;3547000;0
13670;189081;187;72;21;1;20;.952;3600000;0
13670;201585;197;55;46;6;40;.870;3600000;0
13670;206822;197;0;0;0;0;.00nan;0;0
13670;-1;187;0;0;0;0;.00nan;0;0
13529;200452;221;76;26;2;24;.923;3900000;0
13529;191120;223;0;0;0;0;.00nan;0;0
13529;187118;223;78;29;2;27;.931;3900000;0
13529;187431;221;0;0;0;0;.00nan;0;0
13903;-1;192;66;35;3;32;.914;3551000;0
13903;207398;192;0;0;0;0;.00nan;0;0
13903;-1;189;0;0;0;0;.00nan;0;0
13903;-1;189;83;31;2;29;.935;3600000;0
13519;184175;224;78;46;3;43;.935;3600000;0
13519;189773;231;53;17;2;15;.882;3600000;0
13519;206955;231;0;0;0;0;.00nan;0;0
13519;185840;224;0;0;0;0;.00nan;0;0
13697;182467;185;0;0;0;0;.00nan;0;0
13697;205837;184;54;17;2;15;.882;3600000;0
13697;190125;184;0;0;0;0;.00nan;0;0
13697;-1;185;74;37;3;34;.919;3600000;0
13506;183686;213;0;0;0;0;.00nan;0;0
13506;-1;216;66;23;2;21;.913;3600000;0
13506;201495;213;60;35;4;31;.886;3571000;0
13506;-1;216;0;0;0;0;.00nan;0;0
13607;187628;227;75;31;2;29;.935;3562000;0
13607;189885;225;99;24;0;24;1.000;3600000;0
13607;-1;225;0;0;0;0;.00nan;0;0
13607;187217;227;0;0;0;0;.00nan;0;0
13689;200306;182;0;0;0;0;.00nan;0;0
13689;-1;220;0;0;0;0;.00nan;0;0
13689;-1;220;95;24;0;24;1.000;3600000;0
13689;185810;182;91;55;2;53;.964;3533000;0
13693;194950;1505;0;0;0;0;.00nan;0;0
13693;195251;4949;66;18;1;17;.944;3600000;0
13693;186549;1505;58;42;6;36;.857;3600000;0
13693;197685;4949;0;0;0;0;.00nan;0;0
13649;180377;228;0;0;0;0;.00nan;0;0
13649;185800;229;62;32;4;28;.875;3691000;0
13649;185960;229;0;0;0;0;.00nan;0;0
13649;208044;228;44;32;5;27;.844;3691000;0
13668;200437;201;100;44;1;43;.977;3600000;0
13668;201560;202;58;25;2;23;.920;3544000;0
13668;196299;202;0;0;0;0;.00nan;0;0
13668;-1;201;0;0;0;0;.00nan;0;0
13456;205788;207;72;40;3;37;.925;3578000;0
13456;-1;207;0;0;0;0;.00nan;0;0
13456;-1;199;0;0;0;0;.00nan;0;0
13456;-1;199;69;26;2;24;.923;3600000;0
13598;199416;191;0;0;0;0;.00nan;0;0
13598;194893;191;74;25;1;24;.960;3600000;0
13598;192547;190;0;0;0;0;.00nan;0;0
13598;197704;190;96;56;4;52;.929;3600000;0
13694;198074;195;0;0;0;0;.00nan;0;0
13694;189081;187;0;0;0;0;.00nan;0;0
13694;207061;195;81;31;2;29;.935;3724000;0
13694;-1;187;70;34;3;31;.912;3724000;0
13561;198149;188;0;0;0;0;.00nan;0;0
13561;184409;188;72;36;4;32;.889;3540000;0
13561;184788;198;0;0;0;0;.00nan;0;0
13561;181443;198;68;22;2;20;.909;3600000;0
14091;-1;183;0;0;0;0;.00nan;0;0
14091;180574;183;90;50;3;47;.940;3888000;0
14091;192461;210;80;28;2;26;.929;3888000;0
14091;197672;210;0;0;0;0;.00nan;0;0
13643;195164;218;56;35;6;29;.829;3600000;0
13643;190034;217;60;20;2;18;.900;3600000;0
13643;190041;217;0;0;0;0;.00nan;0;0
13643;190095;218;0;0;0;0;.00nan;0;0
13790;179499;186;71;25;2;23;.920;3540000;0
13790;190098;186;0;0;0;0;.00nan;0;0
13790;179679;212;0;0;0;0;.00nan;0;0
13790;-1;212;91;25;0;25;1.000;3600000;0
13762;189529;193;90;18;0;18;1.000;3600000;0
13762;184648;196;89;50;2;48;.960;3583000;0
13762;186451;193;0;0;0;0;.00nan;0;0
13762;191118;196;0;0;0;0;.00nan;0;0
13497;205743;2620;0;0;0;0;.00nan;0;0
13497;184650;4864;0;0;0;0;.00nan;0;0
13497;-1;2620;95;28;1;27;.964;3600000;0
13497;186332;4864;56;31;3;28;.903;3556000;0
13661;189529;193;0;0;0;0;.00nan;0;0
13661;184788;198;72;40;4;36;.900;3832000;0
13661;181443;198;0;0;0;0;.00nan;0;0
13661;186451;193;41;32;5;27;.844;3832000;0
13825;198074;195;0;0;0;0;.00nan;0;0
13825;201585;197;68;55;6;49;.891;3600000;0
13825;206822;197;0;0;0;0;.00nan;0;0
13825;207061;195;100;20;0;20;1.000;3600000;0
13675;184648;196;58;6;0;6;1.000;543000;0
13675;191118;196;36;25;4;21;.840;3057000;0
13675;-1;189;0;0;0;0;.00nan;0;0
13675;-1;189;77;25;1;24;.960;3600000;0
13923;201525;203;0;0;0;0;.00nan;0;0
13923;196283;206;0;0;0;0;.00nan;0;0
13923;191078;203;27;31;6;25;.806;3600000;0
13923;202998;206;66;29;2;27;.931;3600000;0
13466;201560;202;0;0;0;0;.00nan;0;0
13466;196299;202;77;20;1;19;.950;3600000;0
13466;-1;199;69;52;5;47;.904;3600000;0
13466;-1;199;0;0;0;0;.00nan;0;0
13646;200440;204;0;0;0;0;.00nan;0;0
13646;189902;204;80;31;2;29;.935;3600000;0
13646;192629;226;75;36;3;33;.917;3600000;0
13646;-1;226;0;0;0;0;.00nan;0;0
13633;-1;1371;0;0;0;0;.00nan;0;0
13633;-1;181;51;29;4;25;.862;3600000;0
13633;192552;181;0;0;0;0;.00nan;0;0
13633;192688;1371;93;34;1;33;.971;3600000;0
13665;192939;208;68;21;1;20;.952;3600000;0
13665;200380;208;0;0;0;0;.00nan;0;0
13665;205788;207;0;0;0;0;.00nan;0;0
13665;-1;207;75;44;4;40;.909;3600000;0
13590;192915;179;0;0;0;0;.00nan;0;0
13590;194950;1505;90;36;1;35;.972;3600000;0
13590;186549;1505;0;0;0;0;.00nan;0;0
13590;187355;179;23;35;8;27;.771;3600000;0
13592;-1;216;50;33;4;29;.879;3900000;0
13592;-1;183;78;39;4;35;.897;3900000;0
13592;180574;183;0;0;0;0;.00nan;0;0
13592;-1;216;0;0;0;0;.00nan;0;0
13640;198149;188;0;0;0;0;.00nan;0;0
13640;199416;191;0;0;0;0;.00nan;0;0
13640;194893;191;91;30;1;29;.967;3600000;0
13640;184409;188;87;51;4;47;.922;3600000;0
13635;183686;213;0;0;0;0;.00nan;0;0
13635;201495;213;49;25;4;21;.840;3515000;0
13635;196571;177;66;23;2;21;.913;3600000;0
13635;-1;177;0;0;0;0;.00nan;0;0
13533;205743;2620;44;22;4;18;.818;3600000;0
13533;190164;4959;81;30;2;28;.933;3600000;0
13533;-1;2620;0;0;0;0;.00nan;0;0
13533;-1;4959;0;0;0;0;.00nan;0;0
13527;184175;224;83;40;2;38;.950;3560000;0
13527;189773;231;66;17;1;16;.941;3600000;0
13527;206955;231;0;0;0;0;.00nan;0;0
13527;185840;224;0;0;0;0;.00nan;0;0
13709;200306;182;0;0;0;0;.00nan;0;0
13709;205837;184;0;0;0;0;.00nan;0;0
13709;190125;184;54;18;2;16;.889;3900000;0
13709;185810;182;85;44;2;42;.955;3900000;0
13905;187628;227;50;19;3;16;.842;3600000;0
13905;191120;223;0;0;0;0;.00nan;0;0
13905;187118;223;81;45;4;41;.911;3600000;0
13905;187217;227;0;0;0;0;.00nan;0;0
13508;184785;211;0;0;0;0;.00nan;0;0
13508;179646;211;90;34;1;33;.971;3600000;0
13508;-1;180;59;38;5;33;.868;3600000;0
13508;197707;180;0;0;0;0;.00nan;0;0
14102;195251;4949;80;28;2;26;.929;3600000;0
14102;-1;178;0;0;0;0;.00nan;0;0
14102;197685;4949;0;0;0;0;.00nan;0;0
14102;-1;178;84;68;6;62;.912;3600000;0
13759;198074;195;0;0;0;0;.00nan;0;0
13759;198149;188;59;38;5;33;.868;3600000;0
13759;184409;188;0;0;0;0;.00nan;0;0
13759;207061;195;85;16;0;16;1.000;3600000;0
13655;200333;194;85;31;2;29;.935;3900000;0
13655;196352;194;0;0;0;0;.00nan;0;0
13655;-1;189;68;30;2;28;.933;3900000;0
13655;-1;189;0;0;0;0;.00nan;0;0
13916;200437;201;68;25;2;23;.920;3600000;0
13916;201525;203;42;37;6;31;.838;2984000;0
13916;191078;203;55;6;0;6;1.000;616000;0
13916;-1;201;0;0;0;0;.00nan;0;0
13579;184133;230;0;0;0;0;.00nan;0;0
13579;189773;231;97;41;2;39;.951;3517000;0
13579;206955;231;0;0;0;0;.00nan;0;0
13579;181338;230;100;26;0;26;1.000;3600000;0
13619;184788;198;0;0;0;0;.00nan;0;0
13619;201585;197;88;39;2;37;.949;3581000;0
13619;206822;197;0;0;0;0;.00nan;0;0
13619;181443;198;83;15;0;15;1.000;3600000;0
13615;-1;1371;0;0;0;0;.00nan;0;0
13615;-1;214;84;33;1;32;.970;3600000;0
13615;191518;214;0;0;0;0;.00nan;0;0
13615;192688;1371;44;27;5;22;.815;3600000;0
13539;-1;216;0;0;0;0;.00nan;0;0
13539;-1;183;0;0;0;0;.00nan;0;0
13539;180574;183;68;21;1;20;.952;3545000;0
13539;-1;216;100;25;0;25;1.000;3600000;0
13500;184650;4864;50;37;5;32;.865;3600000;0
13500;190164;4959;0;0;0;0;.00nan;0;0
13500;186332;4864;0;0;0;0;.00nan;0;0
13500;-1;4959;100;39;0;39;1.000;3600000;0
13626;182324;4960;0;0;0;0;.00nan;0;0
13626;203383;232;60;30;3;27;.900;3530000;0
13626;194219;4960;85;30;1;29;.967;3600000;0
13626;183695;232;0;0;0;0;.00nan;0;0
13608;189081;187;100;23;0;23;1.000;3600000;0
13608;192547;190;0;0;0;0;.00nan;0;0
13608;-1;187;0;0;0;0;.00nan;0;0
13608;197704;190;86;40;2;38;.950;3535000;0
13715;194950;1505;0;0;0;0;.00nan;0;0
13715;196571;177;0;0;0;0;.00nan;0;0
13715;186549;1505;67;37;3;34;.919;3552000;0
13715;-1;177;60;23;2;21;.913;3600000;0
13891;179679;212;0;0;0;0;.00nan;0;0
13891;182128;215;0;0;0;0;.00nan;0;0
13891;-1;212;95;36;1;35;.972;3900000;0
13891;-1;215;100;36;1;35;.972;3900000;0
13971;184610;222;92;35;1;34;.971;3600000;0
13971;185800;229;65;24;2;22;.917;3578000;0
13971;185851;222;0;0;0;0;.00nan;0;0
13971;185960;229;0;0;0;0;.00nan;0;0
13695;206801;176;33;32;6;26;.813;3600000;0
13695;182006;176;0;0;0;0;.00nan;0;0
13695;-1;209;79;29;2;27;.931;3600000;0
13695;203063;209;0;0;0;0;.00nan;0;0
13954;189885;225;80;30;1;29;.967;3900000;0
13954;180377;228;83;24;1;23;.958;3900000;0
13954;-1;225;0;0;0;0;.00nan;0;0
13954;208044;228;0;0;0;0;.00nan;0;0
13688;195238;200;83;15;0;15;1.000;3600000;0
13688;196283;206;69;31;3;28;.903;3600000;0
13688;-1;200;0;0;0;0;.00nan;0;0
13688;202998;206;0;0;0;0;.00nan;0;0
13663;201524;205;0;0;0;0;.00nan;0;0
13663;-1;205;47;26;4;22;.846;3516000;0
13663;192629;226;0;0;0;0;.00nan;0;0
13663;-1;226;81;33;2;31;.939;3600000;0
13752;200440;204;67;28;2;26;.929;3600000;0
13752;189902;204;0;0;0;0;.00nan;0;0
13752;201560;202;40;31;5;26;.839;3600000;0
13752;196299;202;0;0;0;0;.00nan;0;0
13682;195164;218;43;43;7;36;.837;3678000;0
13682;190034;217;52;1;0;1;1.000;396000;0
13682;190041;217;27;25;6;19;.760;3282000;0
13682;190095;218;0;0;0;0;.00nan;0;0
13612;192915;179;78;35;3;32;.914;3900000;0
13612;187355;179;0;0;0;0;.00nan;0;0
13612;192461;210;91;33;3;30;.909;3900000;0
13612;197672;210;0;0;0;0;.00nan;0;0
13662;187628;227;81;27;1;26;.963;3600000;0
13662;184175;224;56;26;3;23;.885;3534000;0
13662;185840;224;0;0;0;0;.00nan;0;0
13662;187217;227;0;0;0;0;.00nan;0;0
13742;190034;217;69;33;3;30;.909;3586000;0
13742;190041;217;0;0;0;0;.00nan;0;0
13742;-1;219;83;34;2;32;.941;3600000;0
13742;-1;219;0;0;0;0;.00nan;0;0
13727;205837;184;0;0;0;0;.00nan;0;0
13727;190125;184;56;14;1;13;.929;3600000;0
13727;-1;214;0;0;0;0;.00nan;0;0
13727;191518;214;46;44;7;37;.841;3600000;0
13493;192939;208;52;24;3;21;.875;3600000;0
13493;200380;208;0;0;0;0;.00nan;0;0
13493;-1;199;0;0;0;0;.00nan;0;0
13493;-1;199;68;39;4;35;.897;3543000;0
13788;200333;194;84;30;1;29;.967;3600000;0
13788;189529;193;55;24;3;21;.875;3540000;0
13788;196352;194;0;0;0;0;.00nan;0;0
13788;186451;193;0;0;0;0;.00nan;0;0
13593;192915;179;79;42;4;38;.905;3900000;0
13593;-1;183;68;37;4;33;.892;3900000;0
13593;180574;183;0;0;0;0;.00nan;0;0
13593;187355;179;0;0;0;0;.00nan;0;0
13536;192629;226;32;25;5;20;.800;3600000;0
13536;-1;226;0;0;0;0;.00nan;0;0
13536;-1;199;81;37;2;35;.946;3600000;0
13536;-1;199;0;0;0;0;.00nan;0;0
13570;195164;218;54;25;3;22;.880;3600000;0
13570;184785;211;30;44;8;36;.818;3600000;0
13570;190095;218;0;0;0;0;.00nan;0;0
13570;179646;211;0;0;0;0;.00nan;0;0
13714;184648;196;64;28;3;25;.893;3600000;0
13714;-1;192;68;37;4;33;.892;3578000;0
13714;207398;192;0;0;0;0;.00nan;0;0
13714;191118;196;0;0;0;0;.00nan;0;0
13696;182324;4960;0;0;0;0;.00nan;0;0
13696;194219;4960;50;22;3;19;.864;3558000;0
13696;200452;221;90;33;2;31;.939;3600000;0
13696;187431;221;0;0;0;0;.00nan;0;0
13713;198074;195;0;0;0;0;.00nan;0;0
13713;207061;195;67;31;3;28;.903;3600000;0
13713;-1;189;97;51;3;48;.941;3074000;0
13713;-1;189;39;12;3;9;.750;526000;0
13586;179499;186;61;30;3;27;.900;3600000;0
13586;190098;186;0;0;0;0;.00nan;0;0
13586;-1;180;63;36;4;32;.889;3578000;0
13586;197707;180;0;0;0;0;.00nan;0;0
13871;195238;200;81;41;3;38;.927;3573000;0
13871;201525;203;0;0;0;0;.00nan;0;0
13871;-1;200;0;0;0;0;.00nan;0;0
13871;191078;203;80;26;2;24;.923;3600000;0
13980;179679;212;0;0;0;0;.00nan;0;0
13980;182128;215;50;32;4;28;.875;3600000;0
13980;-1;212;73;28;2;26;.929;3600000;0
13980;-1;215;0;0;0;0;.00nan;0;0
13639;203383;232;0;0;0;0;.00nan;0;0
13639;187628;227;0;0;0;0;.00nan;0;0
13639;183695;232;73;29;2;27;.931;3545000;0
13639;187217;227;96;34;1;33;.971;3600000;0
13501;184650;4864;0;0;0;0;.00nan;0;0
13501;186332;4864;74;28;2;26;.929;3600000;0
13501;-1;209;0;0;0;0;.00nan;0;0
13501;203063;209;53;31;4;27;.871;3578000;0
13603;205743;2620;0;0;0;0;.00nan;0;0
13603;190164;4959;0;0;0;0;.00nan;0;0
13603;-1;2620;79;17;1;16;.941;3600000;0
13603;-1;4959;73;42;5;37;.881;3600000;0
13681;200437;201;85;39;3;36;.923;3600000;0
13681;201524;205;85;14;0;14;1.000;3600000;0
13681;-1;205;0;0;0;0;.00nan;0;0
13681;-1;201;0;0;0;0;.00nan;0;0
13741;200306;182;0;0;0;0;.00nan;0;0
13741;205837;184;54;27;3;24;.889;3600000;0
13741;190125;184;0;0;0;0;.00nan;0;0
13741;185810;182;66;37;4;33;.892;3600000;0
14027;195251;4949;31;18;4;14;.778;3600000;0
14027;-1;178;0;0;0;0;.00nan;0;0
14027;197685;4949;0;0;0;0;.00nan;0;0
14027;-1;178;98;41;1;40;.976;3600000;0
13648;198149;188;0;0;0;0;.00nan;0;0
13648;184409;188;69;25;1;24;.960;3600000;0
13648;192547;190;0;0;0;0;.00nan;0;0
13648;197704;190;61;31;3;28;.903;3573000;0
13651;183686;213;0;0;0;0;.00nan;0;0
13651;201495;213;80;31;2;29;.935;3537000;0
13651;192461;210;83;14;0;14;1.000;3600000;0
13651;197672;210;0;0;0;0;.00nan;0;0
13644;-1;1371;0;0;0;0;.00nan;0;0
13644;-1;181;69;29;2;27;.931;3900000;0
13644;192552;181;0;0;0;0;.00nan;0;0
13644;192688;1371;86;43;2;41;.953;3900000;0
13674;189885;225;62;28;2;26;.929;3900000;0
13674;180377;228;0;0;0;0;.00nan;0;0
13674;-1;225;0;0;0;0;.00nan;0;0
13674;208044;228;82;28;2;26;.929;3900000;0
13652;184788;198;88;28;1;27;.964;3600000;0
13652;181443;198;0;0;0;0;.00nan;0;0
13652;192547;190;38;12;3;9;.750;516000;0
13652;197704;190;66;31;3;28;.903;3084000;0
13685;195238;200;0;0;0;0;.00nan;0;0
13685;201524;205;96;35;1;34;.971;3600000;0
13685;-1;200;72;27;2;25;.926;3577000;0
13685;-1;205;0;0;0;0;.00nan;0;0
14109;206801;176;34;17;4;13;.765;1004000;0
14109;182006;176;75;25;1;24;.960;2584000;0
14109;-1;209;59;23;3;20;.870;3600000;0
14109;203063;209;0;0;0;0;.00nan;0;0
13630;179499;186;0;0;0;0;.00nan;0;0
13630;190098;186;39;20;4;16;.800;3600000;0
13630;-1;180;0;0;0;0;.00nan;0;0
13630;197707;180;89;37;1;36;.973;3600000;0
13745;189081;187;24;7;3;4;.571;568000;0
13745;-1;192;0;0;0;0;.00nan;0;0
13745;207398;192;88;21;0;21;1.000;3600000;0
13745;-1;187;50;22;3;19;.864;3032000;0
13513;205743;2620;85;35;2;33;.943;3600000;0
13513;184650;4864;0;0;0;0;.00nan;0;0
13513;-1;2620;0;0;0;0;.00nan;0;0
13513;186332;4864;100;36;0;36;1.000;3600000;0
13700;201560;202;63;14;1;13;.929;3600000;0
13700;196283;206;0;0;0;0;.00nan;0;0
13700;196299;202;0;0;0;0;.00nan;0;0
13700;202998;206;33;48;7;41;.854;3600000;0
13601;200452;221;59;26;3;23;.885;3590000;0
13601;184610;222;77;33;2;31;.939;3600000;0
13601;185851;222;0;0;0;0;.00nan;0;0
13601;187431;221;0;0;0;0;.00nan;0;0
13842;200333;194;0;0;0;0;.00nan;0;0
13842;201585;197;92;38;2;36;.947;3600000;0
13842;206822;197;0;0;0;0;.00nan;0;0
13842;196352;194;34;26;5;21;.808;3600000;0
14072;179679;212;100;38;0;38;1.000;3600000;0
14072;-1;219;72;29;2;27;.931;3538000;0
14072;-1;219;0;0;0;0;.00nan;0;0
14072;-1;212;0;0;0;0;.00nan;0;0
13584;184133;230;0;0;0;0;.00nan;0;0
13584;181338;230;65;15;1;14;.933;3600000;0
13584;185800;229;88;69;6;63;.913;3600000;0
13584;185960;229;0;0;0;0;.00nan;0;0
14118;-1;183;0;0;0;0;.00nan;0;0
14118;180574;183;84;28;1;27;.964;3600000;0
14118;192461;210;45;26;4;22;.846;3600000;0
14118;197672;210;0;0;0;0;.00nan;0;0
13660;192939;208;96;32;1;31;.969;3600000;0
13660;200380;208;0;0;0;0;.00nan;0;0
13660;200440;204;0;0;0;0;.00nan;0;0
13660;189902;204;61;45;5;40;.889;3600000;0
13701;-1;181;0;0;0;0;.00nan;0;0
13701;-1;220;0;0;0;0;.00nan;0;0
13701;-1;220;53;20;3;17;.850;3600000;0
13701;192552;181;60;35;4;31;.886;3597000;0
13558;183686;213;74;36;3;33;.917;3568000;0
13558;-1;216;0;0;0;0;.00nan;0;0
13558;201495;213;0;0;0;0;.00nan;0;0
13558;-1;216;83;30;2;28;.933;3600000;0
13772;182467;185;82;33;2;31;.939;3728000;0
13772;-1;185;0;0;0;0;.00nan;0;0
13772;-1;214;76;42;3;39;.929;3705000;0
13772;191518;214;0;0;0;0;.00nan;0;0
13718;195251;4949;14;33;8;25;.758;3600000;0
13718;196571;177;84;52;3;49;.942;3600000;0
13718;197685;4949;0;0;0;0;.00nan;0;0
13718;-1;177;0;0;0;0;.00nan;0;0
13677;182324;4960;78;41;3;38;.927;3600000;0
13677;203383;232;72;34;4;30;.882;3561000;0
13677;194219;4960;0;0;0;0;.00nan;0;0
13677;183695;232;0;0;0;0;.00nan;0;0
13576;184785;211;0;0;0;0;.00nan;0;0
13576;179646;211;71;37;3;34;.919;3554000;0
13576;182128;215;0;0;0;0;.00nan;0;0
13576;-1;215;77;26;2;24;.923;3600000;0
13724;200437;201;66;32;3;29;.906;3542000;0
13724;196283;206;78;23;1;22;.957;3600000;0
13724;-1;201;0;0;0;0;.00nan;0;0
13724;202998;206;0;0;0;0;.00nan;0;0
13750;187628;227;73;32;2;30;.938;3900000;0
13750;184610;222;0;0;0;0;.00nan;0;0
13750;185851;222;95;42;2;40;.952;3900000;0
13750;187217;227;0;0;0;0;.00nan;0;0
13597;184133;230;83;14;0;14;1.000;3600000;0
13597;181338;230;0;0;0;0;.00nan;0;0
13597;191120;223;0;0;0;0;.00nan;0;0
13597;187118;223;90;52;4;48;.923;3600000;0
13855;195164;218;59;34;4;30;.882;3600000;0
13855;190095;218;0;0;0;0;.00nan;0;0
13855;-1;219;0;0;0;0;.00nan;0;0
13855;-1;219;52;37;5;32;.865;3589000;0
13756;189081;187;56;18;2;16;.889;3600000;0
13756;184648;196;94;45;3;42;.933;3600000;0
13756;191118;196;0;0;0;0;.00nan;0;0
13756;-1;187;0;0;0;0;.00nan;0;0
13748;182467;185;0;0;0;0;.00nan;0;0
13748;200306;182;0;0;0;0;.00nan;0;0
13748;185810;182;48;33;5;28;.848;3600000;0
13748;-1;185;78;24;1;23;.958;3600000;0
13679;192915;179;0;0;0;0;.00nan;0;0
13679;187355;179;61;28;3;25;.893;3600000;0
13679;192461;210;0;0;0;0;.00nan;0;0
13679;197672;210;41;28;5;23;.821;3529000;0
13864;184175;224;86;23;1;22;.957;3600000;0
13864;185840;224;0;0;0;0;.00nan;0;0
13864;191120;223;0;0;0;0;.00nan;0;0
13864;187118;223;98;45;3;42;.933;3584000;0
13952;189529;193;0;0;0;0;.00nan;0;0
13952;-1;192;0;0;0;0;.00nan;0;0
13952;207398;192;73;34;3;31;.912;3552000;0
13952;186451;193;59;19;2;17;.895;3600000;0
13959;199416;191;0;0;0;0;.00nan;0;0
13959;194893;191;58;16;2;14;.875;3900000;0
13959;201585;197;100;54;2;52;.963;3900000;0
13959;206822;197;0;0;0;0;.00nan;0;0
13737;190034;217;0;0;0;0;.00nan;0;0
13737;190041;217;100;45;1;44;.978;3600000;0
13737;179499;186;84;28;3;25;.893;3570000;0
13737;190098;186;0;0;0;0;.00nan;0;0
13623;200452;221;49;40;6;34;.850;3600000;0
13623;189773;231;90;16;0;16;1.000;3600000;0
13623;206955;231;0;0;0;0;.00nan;0;0
13623;187431;221;0;0;0;0;.00nan;0;0
13894;183686;213;0;0;0;0;.00nan;0;0
13894;194950;1505;54;28;4;24;.857;3600000;0
13894;201495;213;44;36;5;31;.861;3578000;0
13894;186549;1505;0;0;0;0;.00nan;0;0
13987;189885;225;50;41;6;35;.854;3600000;0
13987;-1;225;0;0;0;0;.00nan;0;0
13987;185800;229;83;28;1;27;.964;3600000;0
13987;185960;229;0;0;0;0;.00nan;0;0
13882;199416;191;58;18;2;16;.889;3600000;0
13882;194893;191;0;0;0;0;.00nan;0;0
13882;184648;196;39;32;6;26;.813;2515000;0
13882;191118;196;49;18;3;15;.833;1085000;0
13835;205743;2620;0;0;0;0;.00nan;0;0
13835;-1;2620;63;17;2;15;.882;3600000;0
13835;-1;209;60;10;0;10;1.000;870000;0
13835;203063;209;53;41;6;35;.854;2730000;0
14012;200306;182;0;0;0;0;.00nan;0;0
14012;205837;184;0;0;0;0;.00nan;0;0
14012;190125;184;52;24;4;20;.833;3900000;0
14012;185810;182;80;46;4;42;.913;3900000;0
14068;195251;4949;41;14;3;11;.786;3600000;0
14068;-1;178;0;0;0;0;.00nan;0;0
14068;197685;4949;0;0;0;0;.00nan;0;0
14068;-1;178;90;49;4;45;.918;3580000;0
13767;198149;188;0;0;0;0;.00nan;0;0
13767;184409;188;78;35;3;32;.914;3900000;0
13767;201585;197;88;44;3;41;.932;3900000;0
13767;206822;197;0;0;0;0;.00nan;0;0
13594;184785;211;70;48;5;43;.896;3600000;0
13594;179646;211;0;0;0;0;.00nan;0;0
13594;182128;215;71;27;2;25;.926;3600000;0
13594;-1;215;0;0;0;0;.00nan;0;0
13659;200333;194;64;34;3;31;.912;3900000;0
13659;196352;194;0;0;0;0;.00nan;0;0
13659;192547;190;0;0;0;0;.00nan;0;0
13659;197704;190;85;35;3;32;.914;3900000;0
13706;-1;1371;0;0;0;0;.00nan;0;0
13706;-1;220;0;0;0;0;.00nan;0;0
13706;-1;220;62;40;5;35;.875;3600000;0
13706;192688;1371;84;26;1;25;.962;3600000;0
13782;190034;217;55;35;4;31;.886;3520000;0
13782;190041;217;0;0;0;0;.00nan;0;0
13782;179679;212;78;34;2;32;.941;3600000;0
13782;-1;212;0;0;0;0;.00nan;0;0
13749;-1;181;52;32;5;27;.844;3550000;0
13749;-1;214;56;33;4;29;.879;3600000;0
13749;191518;214;0;0;0;0;.00nan;0;0
13749;192552;181;0;0;0;0;.00nan;0;0
13710;182324;4960;0;0;0;0;.00nan;0;0
13710;194219;4960;48;26;4;22;.846;3900000;0
13710;184175;224;70;38;4;34;.895;3900000;0
13710;185840;224;0;0;0;0;.00nan;0;0
13761;192939;208;61;32;3;29;.906;3563000;0
13761;200380;208;0;0;0;0;.00nan;0;0
13761;200437;201;0;0;0;0;.00nan;0;0
13761;-1;201;94;48;2;46;.958;3600000;0
13653;184650;4864;0;0;0;0;.00nan;0;0
13653;206801;176;89;31;1;30;.968;3600000;0
13653;182006;176;0;0;0;0;.00nan;0;0
13653;186332;4864;71;32;3;29;.906;3534000;0
13814;205788;207;0;0;0;0;.00nan;0;0
13814;-1;207;100;42;3;39;.929;3900000;0
13814;192629;226;55;24;3;21;.875;3900000;0
13814;-1;226;0;0;0;0;.00nan;0;0
13621;184133;230;28;14;4;10;.714;3600000;0
13621;184610;222;84;28;1;27;.964;3600000;0
13621;181338;230;0;0;0;0;.00nan;0;0
13621;185851;222;0;0;0;0;.00nan;0;0
13611;205743;2620;59;24;3;21;.875;3579000;0
13611;190164;4959;89;31;1;30;.968;3600000;0
13611;-1;2620;0;0;0;0;.00nan;0;0
13611;-1;4959;0;0;0;0;.00nan;0;0
13722;-1;189;0;0;0;0;.00nan;0;0
13722;192547;190;68;11;0;11;1.000;1455000;0
13722;197704;190;60;32;4;28;.875;2092000;0
13722;-1;189;58;25;3;22;.880;3600000;0
13728;-1;1371;100;25;0;25;1.000;3600000;0
13728;-1;214;0;0;0;0;.00nan;0;0
13728;191518;214;60;36;4;32;.889;3600000;0
13728;192688;1371;0;0;0;0;.00nan;0;0
13753;182324;4960;85;26;1;25;.962;3600000;0
13753;194219;4960;0;0;0;0;.00nan;0;0
13753;180377;228;0;0;0;0;.00nan;0;0
13753;208044;228;55;38;5;33;.868;3600000;0
13553;184650;4864;98;32;1;31;.969;3590000;0
13553;206801;176;0;0;0;0;.00nan;0;0
13553;182006;176;94;23;0;23;1.000;3600000;0
13553;186332;4864;0;0;0;0;.00nan;0;0
13716;184133;230;0;0;0;0;.00nan;0;0
13716;181338;230;99;24;0;24;1.000;3600000;0
13716;185800;229;70;44;5;39;.886;3600000;0
13716;185960;229;0;0;0;0;.00nan;0;0
13634;179499;186;73;19;1;18;.947;3600000;0
13634;190098;186;0;0;0;0;.00nan;0;0
13634;-1;180;27;26;6;20;.769;2079000;0
13634;197707;180;74;24;1;23;.958;1521000;0
13669;184785;211;0;0;0;0;.00nan;0;0
13669;179646;211;80;49;5;44;.898;3600000;0
13669;179679;212;0;0;0;0;.00nan;0;0
13669;-1;212;69;22;1;21;.955;3600000;0
13678;189529;193;86;32;2;30;.938;3900000;0
13678;184788;198;79;26;2;24;.923;3900000;0
13678;181443;198;0;0;0;0;.00nan;0;0
13678;186451;193;0;0;0;0;.00nan;0;0
13627;183686;213;0;0;0;0;.00nan;0;0
13627;201495;213;43;25;4;21;.840;3622000;0
13627;-1;183;58;37;5;32;.865;3622000;0
13627;180574;183;0;0;0;0;.00nan;0;0
13913;195164;218;55;33;5;28;.848;3600000;0
13913;190095;218;0;0;0;0;.00nan;0;0
13913;-1;219;96;25;0;25;1.000;3600000;0
13913;-1;219;0;0;0;0;.00nan;0;0
13704;192915;179;0;0;0;0;.00nan;0;0
13704;194950;1505;0;0;0;0;.00nan;0;0
13704;186549;1505;72;32;3;29;.906;3600000;0
13704;187355;179;70;38;4;34;.895;3574000;0
13712;192939;208;75;30;3;27;.900;3600000;0
13712;200380;208;0;0;0;0;.00nan;0;0
13712;205788;207;0;0;0;0;.00nan;0;0
13712;-1;207;70;43;4;39;.907;3551000;0
13705;182467;185;64;43;5;38;.884;3581000;0
13705;-1;181;0;0;0;0;.00nan;0;0
13705;-1;185;0;0;0;0;.00nan;0;0
13705;192552;181;66;24;3;21;.875;3600000;0
13636;189773;231;78;21;1;20;.952;3600000;0
13636;206955;231;0;0;0;0;.00nan;0;0
13636;191120;223;0;0;0;0;.00nan;0;0
13636;187118;223;60;46;7;39;.848;3600000;0
13729;196283;206;0;0;0;0;.00nan;0;0
13729;192629;226;0;0;0;0;.00nan;0;0
13729;-1;226;57;26;3;23;.885;3600000;0
13729;202998;206;73;48;4;44;.917;3556000;0
13769;200440;204;0;0;0;0;.00nan;0;0
13769;189902;204;66;31;3;28;.903;3600000;0
13769;201525;203;62;38;5;33;.868;3586000;0
13769;191078;203;0;0;0;0;.00nan;0;0
13806;200437;201;87;27;1;26;.963;3900000;0
13806;195238;200;69;18;1;17;.944;3900000;0
13806;-1;200;0;0;0;0;.00nan;0;0
13806;-1;201;0;0;0;0;.00nan;0;0
13791;198149;188;54;22;2;20;.909;3577000;0
13791;184409;188;0;0;0;0;.00nan;0;0
13791;-1;192;95;35;1;34;.971;3600000;0
13791;207398;192;0;0;0;0;.00nan;0;0
13801;198074;195;0;0;0;0;.00nan;0;0
13801;189081;187;76;40;3;37;.925;3900000;0
13801;207061;195;62;27;3;24;.889;3900000;0
13801;-1;187;0;0;0;0;.00nan;0;0
13833;205837;184;72;24;1;23;.958;2984000;0
13833;190125;184;24;5;3;2;.400;592000;0
13833;-1;220;52;23;3;20;.870;3600000;0
13833;-1;220;0;0;0;0;.00nan;0;0
13616;195251;4949;0;0;0;0;.00nan;0;0
13616;-1;216;45;35;6;29;.829;3242000;0
13616;197685;4949;56;46;5;41;.891;3600000;0
13616;-1;216;49;1;0;1;1.000;306000;0
13602;201560;202;57;25;4;21;.840;3600000;0
13602;196299;202;0;0;0;0;.00nan;0;0
13602;-1;199;54;4;0;4;1.000;823000;0
13602;-1;199;40;36;6;30;.833;2746000;0
13740;-1;216;0;0;0;0;.00nan;0;0
13740;192461;210;93;34;1;33;.971;3600000;0
13740;197672;210;0;0;0;0;.00nan;0;0
13740;-1;216;100;35;0;35;1.000;3600000;0
13738;203383;232;50;31;4;27;.871;3600000;0
13738;187628;227;0;0;0;0;.00nan;0;0
13738;183695;232;0;0;0;0;.00nan;0;0
13738;187217;227;39;34;5;29;.853;3600000;0
14048;189885;225;68;24;2;22;.917;3900000;0
14048;-1;225;0;0;0;0;.00nan;0;0
14048;185800;229;0;0;0;0;.00nan;0;0
14048;185960;229;84;36;2;34;.944;3900000;0
14030;190164;4959;0;0;0;0;.00nan;0;0
14030;-1;209;46;29;4;25;.862;3600000;0
14030;-1;4959;96;41;2;39;.951;3600000;0
14030;203063;209;0;0;0;0;.00nan;0;0
13650;195238;200;33;27;5;22;.815;3722000;0
13650;-1;200;0;0;0;0;.00nan;0;0
13650;-1;199;70;48;4;44;.917;3722000;0
13650;-1;199;0;0;0;0;.00nan;0;0
13764;184175;224;69;32;4;28;.875;3600000;0
13764;184610;222;46;31;5;26;.839;3595000;0
13764;185840;224;0;0;0;0;.00nan;0;0
13764;185851;222;0;0;0;0;.00nan;0;0
13638;-1;219;30;17;4;13;.765;3550000;0
13638;-1;219;0;0;0;0;.00nan;0;0
13638;-1;180;85;36;2;34;.944;3600000;0
13638;197707;180;0;0;0;0;.00nan;0;0
13707;200452;221;67;20;1;19;.950;3859000;0
13707;180377;228;0;0;0;0;.00nan;0;0
13707;187431;221;0;0;0;0;.00nan;0;0
13707;208044;228;75;33;2;31;.939;3859000;0
13708;189081;187;100;26;0;26;1.000;3600000;0
13708;184788;198;0;0;0;0;.00nan;0;0
13708;181443;198;88;53;5;48;.906;3600000;0
13708;-1;187;0;0;0;0;.00nan;0;0
13792;200306;182;0;0;0;0;.00nan;0;0
13792;-1;181;65;21;2;19;.905;3600000;0
13792;185810;182;49;34;5;29;.853;3600000;0
13792;192552;181;0;0;0;0;.00nan;0;0
13625;205743;2620;0;0;0;0;.00nan;0;0
13625;-1;2620;90;29;1;28;.966;3600000;0
13625;-1;209;0;0;0;0;.00nan;0;0
13625;203063;209;56;38;5;33;.868;3600000;0
13805;182467;185;0;0;0;0;.00nan;0;0
13805;-1;185;70;34;4;30;.882;3600000;0
13805;-1;214;52;33;5;28;.848;3597000;0
13805;191518;214;0;0;0;0;.00nan;0;0
13687;187628;227;29;12;4;8;.667;906000;0
13687;189773;231;66;17;1;16;.941;3600000;0
13687;206955;231;0;0;0;0;.00nan;0;0
13687;187217;227;97;42;3;39;.929;2694000;0
13889;195251;4949;65;28;3;25;.893;3600000;0
13889;196571;177;33;27;6;21;.778;3600000;0
13889;197685;4949;0;0;0;0;.00nan;0;0
13889;-1;177;0;0;0;0;.00nan;0;0
13881;198074;195;0;0;0;0;.00nan;0;0
13881;-1;192;78;56;6;50;.893;3866000;0
13881;207061;195;48;30;5;25;.833;3866000;0
13881;207398;192;0;0;0;0;.00nan;0;0
13776;205837;184;0;0;0;0;.00nan;0;0
13776;-1;1371;94;52;5;47;.904;3572000;0
13776;190125;184;83;37;3;34;.919;3600000;0
13776;192688;1371;0;0;0;0;.00nan;0;0
13518;184650;4864;0;0;0;0;.00nan;0;0
13518;206801;176;0;0;0;0;.00nan;0;0
13518;182006;176;50;15;2;13;.867;3600000;0
13518;186332;4864;94;51;3;48;.941;3555000;0
13778;183686;213;59;31;4;27;.871;3600000;0
13778;201495;213;0;0;0;0;.00nan;0;0
13778;-1;178;0;0;0;0;.00nan;0;0
13778;-1;178;92;29;1;28;.966;3600000;0
13736;192939;208;0;0;0;0;.00nan;0;0
13736;200380;208;56;30;4;26;.867;3546000;0
13736;201560;202;76;41;3;38;.927;3600000;0
13736;196299;202;0;0;0;0;.00nan;0;0
13768;182324;4960;58;18;2;16;.889;3543000;0
13768;194219;4960;0;0;0;0;.00nan;0;0
13768;191120;223;0;0;0;0;.00nan;0;0
13768;187118;223;84;30;1;29;.967;3600000;0
13858;190034;217;0;0;0;0;.00nan;0;0
13858;190041;217;70;23;1;22;.957;3900000;0
13858;179679;212;100;52;1;51;.981;3900000;0
13858;-1;212;0;0;0;0;.00nan;0;0
13851;179499;186;0;0;0;0;.00nan;0;0
13851;190098;186;44;34;5;29;.853;3900000;0
13851;182128;215;0;0;0;0;.00nan;0;0
13851;-1;215;59;35;5;30;.857;3900000;0
13968;199416;191;0;0;0;0;.00nan;0;0
13968;194893;191;53;22;3;19;.864;3600000;0
13968;201585;197;98;60;4;56;.933;3556000;0
13968;206822;197;0;0;0;0;.00nan;0;0
13789;200440;204;0;0;0;0;.00nan;0;0
13789;205788;207;0;0;0;0;.00nan;0;0
13789;189902;204;49;24;4;20;.833;3600000;0
13789;-1;207;66;47;5;42;.894;3559000;0
13719;201524;205;0;0;0;0;.00nan;0;0
13719;201525;203;42;14;3;11;.786;1602000;0
13719;-1;205;53;10;1;9;.900;3600000;0
13719;191078;203;43;29;5;24;.828;1998000;0
13847;184648;196;63;25;3;22;.880;3600000;0
13847;191118;196;0;0;0;0;.00nan;0;0
13847;-1;189;0;0;0;0;.00nan;0;0
13847;-1;189;57;32;4;28;.875;3543000;0
13915;194950;1505;92;22;0;22;1.000;3600000;0
13915;186549;1505;0;0;0;0;.00nan;0;0
13915;-1;178;83;41;2;39;.951;3524000;0
13915;-1;178;0;0;0;0;.00nan;0;0
13898;199416;191;0;0;0;0;.00nan;0;0
13898;194893;191;79;22;1;21;.955;3600000;0
13898;184788;198;61;32;3;29;.906;3552000;0
13898;181443;198;0;0;0;0;.00nan;0;0
13812;200437;201;0;0;0;0;.00nan;0;0
13812;201560;202;39;25;5;20;.800;3568000;0
13812;196299;202;0;0;0;0;.00nan;0;0
13812;-1;201;82;44;4;40;.909;3600000;0
13787;189529;193;0;0;0;0;.00nan;0;0
13787;-1;192;60;31;3;28;.903;3582000;0
13787;207398;192;0;0;0;0;.00nan;0;0
13787;186451;193;83;25;1;24;.960;3600000;0
13605;192915;179;60;28;3;25;.893;3600000;0
13605;-1;183;25;19;5;14;.737;2168000;0
13605;180574;183;38;14;3;11;.786;1432000;0
13605;187355;179;0;0;0;0;.00nan;0;0
13754;203383;232;62;35;4;31;.886;3638000;0
13754;183695;232;0;0;0;0;.00nan;0;0
13754;200452;221;76;34;3;31;.912;3638000;0
13754;187431;221;0;0;0;0;.00nan;0;0
13907;184175;224;64;18;2;16;.889;3600000;0
13907;184610;222;81;44;3;41;.932;3591000;0
13907;185840;224;0;0;0;0;.00nan;0;0
13907;185851;222;0;0;0;0;.00nan;0;0
13918;198074;195;65;17;1;16;.941;3600000;0
13918;184648;196;80;49;4;45;.918;3600000;0
13918;207061;195;0;0;0;0;.00nan;0;0
13918;191118;196;0;0;0;0;.00nan;0;0
13698;184133;230;0;0;0;0;.00nan;0;0
13698;180377;228;69;47;5;42;.894;3600000;0
13698;181338;230;68;25;2;23;.920;3600000;0
13698;208044;228;0;0;0;0;.00nan;0;0
13798;-1;216;0;0;0;0;.00nan;0;0
13798;196571;177;0;0;0;0;.00nan;0;0
13798;-1;216;70;23;2;21;.913;3549000;0
13798;-1;177;88;21;0;21;1.000;3600000;0
13795;201585;197;77;27;2;25;.926;3650000;0
13795;206822;197;0;0;0;0;.00nan;0;0
13795;-1;189;70;30;3;27;.900;3650000;0
13795;-1;189;0;0;0;0;.00nan;0;0
13840;195238;200;0;0;0;0;.00nan;0;0
13840;201524;205;0;0;0;0;.00nan;0;0
13840;-1;200;50;23;3;20;.870;3583000;0
13840;-1;205;92;32;1;31;.969;3600000;0
13780;182467;185;91;46;2;44;.957;3564000;0
13780;-1;220;0;0;0;0;.00nan;0;0
13780;-1;220;96;19;0;19;1.000;3600000;0
13780;-1;185;0;0;0;0;.00nan;0;0
13717;182128;215;73;26;2;24;.923;3900000;0
13717;-1;180;0;0;0;0;.00nan;0;0
13717;197707;180;89;32;2;30;.938;3900000;0
13717;-1;215;0;0;0;0;.00nan;0;0
13810;189081;187;77;27;2;25;.926;3814000;0
13810;200333;194;84;37;3;34;.919;3814000;0
13810;196352;194;0;0;0;0;.00nan;0;0
13810;-1;187;0;0;0;0;.00nan;0;0
13666;200440;204;0;0;0;0;.00nan;0;0
13666;189902;204;61;32;4;28;.875;3515000;0
13666;-1;199;0;0;0;0;.00nan;0;0
13666;-1;199;63;23;2;21;.913;3600000;0
13925;194950;1505;51;4;0;4;1.000;265000;0
13925;195251;4949;91;22;0;22;1.000;3600000;0
13925;186549;1505;50;35;6;29;.829;3335000;0
13925;197685;4949;0;0;0;0;.00nan;0;0
13628;192915;179;0;0;0;0;.00nan;0;0
13628;-1;183;100;36;1;35;.972;3900000;0
13628;180574;183;0;0;0;0;.00nan;0;0
13628;187355;179;91;36;1;35;.972;3900000;0
13755;200333;194;0;0;0;0;.00nan;0;0
13755;196352;194;67;49;5;44;.898;3600000;0
13755;192547;190;52;6;1;5;.833;709000;0
13755;197704;190;45;38;6;32;.842;2871000;0
13785;184785;211;87;47;3;44;.936;3900000;0
13785;179646;211;0;0;0;0;.00nan;0;0
13785;-1;219;58;24;3;21;.875;3900000;0
13785;-1;219;0;0;0;0;.00nan;0;0
13885;198149;188;0;0;0;0;.00nan;0;0
13885;189529;193;70;31;3;28;.903;3600000;0
13885;184409;188;43;26;4;22;.846;3556000;0
13885;186451;193;0;0;0;0;.00nan;0;0
13838;201525;203;66;28;2;26;.929;3600000;0
13838;196283;206;0;0;0;0;.00nan;0;0
13838;191078;203;0;0;0;0;.00nan;0;0
13838;202998;206;59;28;3;25;.893;3579000;0
13824;187628;227;74;29;2;27;.931;3600000;0
13824;189885;225;61;28;3;25;.893;3545000;0
13824;-1;225;0;0;0;0;.00nan;0;0
13824;187217;227;0;0;0;0;.00nan;0;0
13760;203383;232;92;32;2;30;.938;3574000;0
13760;183695;232;0;0;0;0;.00nan;0;0
13760;191120;223;0;0;0;0;.00nan;0;0
13760;187118;223;96;18;0;18;1.000;3600000;0
13869;190034;217;92;33;1;32;.970;3900000;0
13869;190041;217;0;0;0;0;.00nan;0;0
13869;179499;186;98;40;1;39;.975;3900000;0
13869;190098;186;0;0;0;0;.00nan;0;0
13846;200452;221;58;18;2;16;.889;3584000;0
13846;185800;229;93;22;0;22;1.000;3600000;0
13846;185960;229;0;0;0;0;.00nan;0;0
13846;187431;221;0;0;0;0;.00nan;0;0
13844;201524;205;0;0;0;0;.00nan;0;0
13844;-1;205;97;37;1;36;.973;3600000;0
13844;192629;226;47;22;3;19;.864;3529000;0
13844;-1;226;0;0;0;0;.00nan;0;0
13734;183686;213;0;0;0;0;.00nan;0;0
13734;201495;213;78;33;1;32;.970;3900000;0
13734;-1;178;0;0;0;0;.00nan;0;0
13734;-1;178;76;31;1;30;.968;3900000;0
13938;198074;195;0;0;0;0;.00nan;0;0
13938;198149;188;0;0;0;0;.00nan;0;0
13938;184409;188;81;33;2;31;.939;3654000;0
13938;207061;195;78;39;3;36;.923;3654000;0
13832;205837;184;0;0;0;0;.00nan;0;0
13832;190125;184;81;15;0;15;1.000;3600000;0
13832;-1;181;98;52;2;50;.962;3523000;0
13832;192552;181;0;0;0;0;.00nan;0;0
14116;200306;182;0;0;0;0;.00nan;0;0
14116;-1;1371;0;0;0;0;.00nan;0;0
14116;185810;182;75;51;5;46;.902;3600000;0
14116;192688;1371;80;28;2;26;.929;3600000;0
13834;184133;230;0;0;0;0;.00nan;0;0
13834;189773;231;66;38;3;35;.921;3570000;0
13834;206955;231;0;0;0;0;.00nan;0;0
13834;181338;230;71;21;1;20;.952;3600000;0
13770;187628;227;0;0;0;0;.00nan;0;0
13770;180377;228;0;0;0;0;.00nan;0;0
13770;187217;227;45;31;5;26;.839;3600000;0
13770;208044;228;90;42;2;40;.952;3600000;0
13839;192915;179;91;39;2;37;.949;3600000;0
13839;196571;177;0;0;0;0;.00nan;0;0
13839;187355;179;0;0;0;0;.00nan;0;0
13839;-1;177;48;33;5;28;.848;3600000;0
13771;192939;208;85;16;0;16;1.000;3900000;0
13771;200380;208;0;0;0;0;.00nan;0;0
13771;192629;226;0;0;0;0;.00nan;0;0
13771;-1;226;96;46;0;46;1.000;3900000;0
13828;203383;232;0;0;0;0;.00nan;0;0
13828;183695;232;69;32;3;29;.906;3600000;0
13828;185800;229;100;34;0;34;1.000;3600000;0
13828;185960;229;0;0;0;0;.00nan;0;0
13819;200333;194;73;42;4;38;.905;3600000;0
13819;184648;196;56;9;1;8;.889;3600000;0
13819;196352;194;0;0;0;0;.00nan;0;0
13819;191118;196;0;0;0;0;.00nan;0;0
13978;200437;201;39;21;5;16;.762;3600000;0
13978;-1;199;41;32;6;26;.813;3105000;0
13978;-1;201;0;0;0;0;.00nan;0;0
13978;-1;199;39;1;1;0;.000;432000;0
13976;194950;1505;77;39;4;35;.897;3584000;0
13976;186549;1505;0;0;0;0;.00nan;0;0
13976;192461;210;67;20;2;18;.900;3600000;0
13976;197672;210;0;0;0;0;.00nan;0;0
14053;201525;203;71;41;4;37;.902;3600000;0
14053;201560;202;32;25;5;20;.800;3600000;0
14053;196299;202;0;0;0;0;.00nan;0;0
14053;191078;203;0;0;0;0;.00nan;0;0
14009;199416;191;0;0;0;0;.00nan;0;0
14009;194893;191;57;27;4;23;.852;3900000;0
14009;184788;198;0;0;0;0;.00nan;0;0
14009;181443;198;57;29;4;25;.862;3900000;0
13992;184175;224;67;24;2;22;.917;3562000;0
13992;184610;222;89;34;1;33;.971;3600000;0
13992;185840;224;0;0;0;0;.00nan;0;0
13992;185851;222;0;0;0;0;.00nan;0;0
13865;179499;186;0;0;0;0;.00nan;0;0
13865;190098;186;52;25;3;22;.880;3581000;0
13865;179679;212;0;0;0;0;.00nan;0;0
13865;-1;212;75;27;2;25;.926;3600000;0
13900;182467;185;85;31;1;30;.968;3600000;0
13900;-1;185;0;0;0;0;.00nan;0;0
13900;-1;214;44;29;4;25;.862;3600000;0
13900;191518;214;0;0;0;0;.00nan;0;0
13852;190034;217;0;0;0;0;.00nan;0;0
13852;190041;217;63;30;4;26;.867;3600000;0
13852;182128;215;0;0;0;0;.00nan;0;0
13852;-1;215;60;49;6;43;.878;3555000;0
13974;190164;4959;72;23;1;22;.957;3600000;0
13974;-1;209;46;28;4;24;.857;3600000;0
13974;-1;4959;0;0;0;0;.00nan;0;0
13974;203063;209;0;0;0;0;.00nan;0;0
13848;205788;207;0;0;0;0;.00nan;0;0
13848;-1;207;95;32;1;31;.969;3600000;0
13848;196283;206;0;0;0;0;.00nan;0;0
13848;202998;206;59;24;3;21;.875;3528000;0
13731;183686;213;78;48;3;45;.938;3573000;0
13731;201495;213;0;0;0;0;.00nan;0;0
13731;-1;183;59;21;2;19;.905;3600000;0
13731;180574;183;0;0;0;0;.00nan;0;0
13732;205743;2620;0;0;0;0;.00nan;0;0
13732;184650;4864;0;0;0;0;.00nan;0;0
13732;-1;2620;72;18;1;17;.944;3600000;0
13732;186332;4864;47;32;5;27;.844;3600000;0
13876;184785;211;27;7;3;4;.571;313000;0
13876;179646;211;61;27;3;24;.889;3287000;0
13876;179679;212;79;29;2;27;.931;3600000;0
13876;-1;212;0;0;0;0;.00nan;0;0
13823;-1;192;73;27;2;25;.926;3600000;0
13823;207398;192;0;0;0;0;.00nan;0;0
13823;192547;190;0;0;0;0;.00nan;0;0
13823;197704;190;63;37;4;33;.892;3542000;0
13827;200440;204;0;0;0;0;.00nan;0;0
13827;205788;207;75;38;3;35;.921;3600000;0
13827;189902;204;44;27;4;23;.852;3600000;0
13827;-1;207;0;0;0;0;.00nan;0;0
13985;199416;191;74;8;0;8;1.000;3600000;0
13985;200333;194;0;0;0;0;.00nan;0;0
13985;194893;191;0;0;0;0;.00nan;0;0
13985;196352;194;97;51;2;49;.961;3600000;0
13841;189081;187;0;0;0;0;.00nan;0;0
13841;-1;189;89;41;4;37;.902;3600000;0
13841;-1;187;57;16;2;14;.875;3600000;0
13841;-1;189;0;0;0;0;.00nan;0;0
13845;200437;201;0;0;0;0;.00nan;0;0
13845;201524;205;0;0;0;0;.00nan;0;0
13845;-1;205;70;24;1;23;.958;3600000;0
13845;-1;201;83;36;2;34;.944;3589000;0
13836;189773;231;0;0;0;0;.00nan;0;0
13836;206955;231;33;11;3;8;.727;3600000;0
13836;180377;228;72;50;6;44;.880;3600000;0
13836;208044;228;0;0;0;0;.00nan;0;0
13884;192915;179;0;0;0;0;.00nan;0;0
13884;187355;179;73;26;2;24;.923;3600000;0
13884;-1;178;0;0;0;0;.00nan;0;0
13884;-1;178;81;46;4;42;.913;3543000;0
13664;190164;4959;0;0;0;0;.00nan;0;0
13664;206801;176;86;36;2;34;.944;3900000;0
13664;182006;176;0;0;0;0;.00nan;0;0
13664;-1;4959;96;36;2;34;.944;3900000;0
13931;192939;208;67;25;2;23;.920;3600000;0
13931;200380;208;0;0;0;0;.00nan;0;0
13931;196283;206;53;30;4;26;.867;3546000;0
13931;202998;206;0;0;0;0;.00nan;0;0
13808;182324;4960;0;0;0;0;.00nan;0;0
13808;194219;4960;81;17;0;17;1.000;3600000;0
13808;189885;225;81;38;2;36;.947;3600000;0
13808;-1;225;0;0;0;0;.00nan;0;0
13735;190034;217;70;37;4;33;.892;3835000;0
13735;190041;217;0;0;0;0;.00nan;0;0
13735;-1;180;73;32;3;29;.906;3835000;0
13735;197707;180;0;0;0;0;.00nan;0;0
13890;189529;193;0;0;0;0;.00nan;0;0
13890;184648;196;67;54;6;48;.889;3600000;0
13890;186451;193;64;11;1;10;.909;3600000;0
13890;191118;196;0;0;0;0;.00nan;0;0
13720;205743;2620;85;14;0;14;1.000;3600000;0
13720;-1;2620;0;0;0;0;.00nan;0;0
13720;-1;209;98;31;1;30;.968;3545000;0
13720;203063;209;0;0;0;0;.00nan;0;0
13927;-1;216;90;36;2;34;.944;3600000;0
13927;192461;210;54;25;3;22;.880;3543000;0
13927;197672;210;0;0;0;0;.00nan;0;0
13927;-1;216;0;0;0;0;.00nan;0;0
13739;195251;4949;61;27;3;24;.889;3600000;0
13739;-1;183;0;0;0;0;.00nan;0;0
13739;180574;183;64;44;5;39;.886;3517000;0
13739;197685;4949;0;0;0;0;.00nan;0;0
13690;195238;200;0;0;0;0;.00nan;0;0
13690;-1;200;63;18;2;16;.889;3600000;0
13690;-1;199;0;0;0;0;.00nan;0;0
13690;-1;199;84;42;3;39;.929;3543000;0
13818;200452;221;0;0;0;0;.00nan;0;0
13818;184133;230;42;28;4;24;.857;3577000;0
13818;181338;230;0;0;0;0;.00nan;0;0
13818;187431;221;83;32;2;30;.938;3600000;0
13811;182467;185;0;0;0;0;.00nan;0;0
13811;-1;220;0;0;0;0;.00nan;0;0
13811;-1;220;63;26;3;23;.885;3718000;0
13811;-1;185;77;49;4;45;.918;3718000;0
14126;184610;222;100;22;0;22;1.000;3600000;0
14126;185851;222;0;0;0;0;.00nan;0;0
14126;191120;223;0;0;0;0;.00nan;0;0
14126;187118;223;64;22;2;20;.909;3588000;0
13940;195164;218;60;30;3;27;.900;3900000;0
13940;179499;186;71;38;3;35;.921;3900000;0
13940;190095;218;0;0;0;0;.00nan;0;0
13940;190098;186;0;0;0;0;.00nan;0;0
13910;205837;184;0;0;0;0;.00nan;0;0
13910;190125;184;80;38;3;35;.921;3900000;0
13910;-1;181;0;0;0;0;.00nan;0;0
13910;192552;181;61;30;3;27;.900;3900000;0
14073;200306;182;0;0;0;0;.00nan;0;0
14073;-1;181;74;31;2;29;.935;3576000;0
14073;185810;182;94;36;1;35;.972;3600000;0
14073;192552;181;0;0;0;0;.00nan;0;0
13899;195251;4949;54;30;4;26;.867;3600000;0
13899;-1;216;88;33;1;32;.970;3600000;0
13899;197685;4949;0;0;0;0;.00nan;0;0
13899;-1;216;0;0;0;0;.00nan;0;0
13853;200333;194;99;29;1;28;.966;3600000;0
13853;196352;194;0;0;0;0;.00nan;0;0
13853;-1;189;31;30;6;24;.800;2912000;0
13853;-1;189;52;2;0;2;1.000;688000;0
13874;184648;196;8;15;6;9;.600;2288000;0
13874;191118;196;74;11;0;11;1.000;1312000;0
13874;192547;190;43;7;2;5;.714;592000;0
13874;197704;190;29;26;5;21;.808;2989000;0
13901;184610;222;74;21;1;20;.952;3600000;0
13901;185800;229;79;31;2;29;.935;3548000;0
13901;185851;222;0;0;0;0;.00nan;0;0
13901;185960;229;0;0;0;0;.00nan;0;0
13702;190164;4959;57;23;3;20;.870;3542000;0
13702;206801;176;79;27;1;26;.963;3600000;0
13702;182006;176;0;0;0;0;.00nan;0;0
13702;-1;4959;0;0;0;0;.00nan;0;0
14061;179679;212;0;0;0;0;.00nan;0;0
14061;-1;219;69;45;4;41;.911;3900000;0
14061;-1;219;0;0;0;0;.00nan;0;0
14061;-1;212;53;28;4;24;.857;3900000;0
13857;182324;4960;0;0;0;0;.00nan;0;0
13857;194219;4960;48;21;3;18;.857;3600000;0
13857;189773;231;69;38;4;34;.895;3567000;0
13857;206955;231;0;0;0;0;.00nan;0;0
13912;-1;220;0;0;0;0;.00nan;0;0
13912;-1;220;87;36;3;33;.917;3600000;0
13912;-1;214;79;43;4;39;.907;3600000;0
13912;191518;214;0;0;0;0;.00nan;0;0
13744;-1;183;88;36;2;34;.944;3600000;0
13744;180574;183;0;0;0;0;.00nan;0;0
13744;-1;178;72;37;3;34;.919;3600000;0
13744;-1;178;0;0;0;0;.00nan;0;0
13982;198074;195;0;0;0;0;.00nan;0;0
13982;189529;193;0;0;0;0;.00nan;0;0
13982;207061;195;46;27;5;22;.815;3600000;0
13982;186451;193;68;27;3;24;.889;3600000;0
13850;205837;184;0;0;0;0;.00nan;0;0
13850;-1;1371;0;0;0;0;.00nan;0;0
13850;190125;184;68;35;3;32;.914;3551000;0
13850;192688;1371;86;35;2;33;.943;3600000;0
13830;203383;232;69;23;1;22;.957;3600000;0
13830;183695;232;0;0;0;0;.00nan;0;0
13830;189885;225;0;0;0;0;.00nan;0;0
13830;-1;225;82;39;2;37;.949;3592000;0
13773;205743;2620;42;31;5;26;.839;3600000;0
13773;184650;4864;0;0;0;0;.00nan;0;0
13773;-1;2620;0;0;0;0;.00nan;0;0
13773;186332;4864;88;37;2;35;.946;3600000;0
13826;201524;205;0;0;0;0;.00nan;0;0
13826;-1;201;69;16;0;16;1.000;1121000;0
13826;-1;205;92;18;0;18;1.000;3600000;0
13826;-1;201;42;43;7;36;.837;2479000;0
13820;180377;228;0;0;0;0;.00nan;0;0
13820;191120;223;0;0;0;0;.00nan;0;0
13820;187118;223;98;43;2;41;.953;3584000;0
13820;208044;228;64;15;1;14;.933;3600000;0
13887;189081;187;84;24;1;23;.958;3900000;0
13887;184874;197;0;0;0;0;.00nan;0;0
13887;206822;197;96;62;1;61;.984;3900000;0
13887;-1;187;0;0;0;0;.00nan;0;0
13807;183686;213;0;0;0;0;.00nan;0;0
13807;194950;1505;0;0;0;0;.00nan;0;0
13807;201495;213;59;35;4;31;.886;3600000;0
13807;186549;1505;66;28;2;26;.929;3600000;0
13849;184785;211;81;32;2;30;.938;3600000;0
13849;179646;211;0;0;0;0;.00nan;0;0
13849;182128;215;0;0;0;0;.00nan;0;0
13849;-1;215;77;23;1;22;.957;3600000;0
13747;195164;218;63;20;2;18;.900;3600000;0
13747;190095;218;0;0;0;0;.00nan;0;0
13747;-1;180;67;43;5;38;.884;3600000;0
13747;197707;180;0;0;0;0;.00nan;0;0
13766;192939;208;39;29;6;23;.793;3659000;0
13766;200380;208;0;0;0;0;.00nan;0;0
13766;192629;226;0;0;0;0;.00nan;0;0
13766;-1;226;66;40;5;35;.875;3659000;0
13963;184788;198;85;45;3;42;.933;3900000;0
13963;-1;192;60;29;3;26;.897;3900000;0
13963;207398;192;0;0;0;0;.00nan;0;0
13963;181443;198;0;0;0;0;.00nan;0;0
13932;187628;227;45;33;5;28;.848;3600000;0
13932;200452;221;32;46;7;39;.848;2590000;0
13932;187217;227;0;0;0;0;.00nan;0;0
13932;187431;221;66;12;0;12;1.000;973000;0
13868;190034;217;54;20;2;18;.900;3580000;0
13868;190041;217;0;0;0;0;.00nan;0;0
13868;182128;215;100;34;1;33;.971;3600000;0
13868;-1;215;0;0;0;0;.00nan;0;0
14057;-1;216;0;0;0;0;.00nan;0;0
14057;196571;177;77;37;3;34;.919;3600000;0
14057;-1;216;50;35;5;30;.857;3521000;0
14057;-1;177;0;0;0;0;.00nan;0;0
13998;183686;213;100;36;0;36;1.000;3600000;0
13998;194950;1505;0;0;0;0;.00nan;0;0
13998;201495;213;0;0;0;0;.00nan;0;0
13998;186549;1505;65;18;2;16;.889;3545000;0
13777;179499;186;85;28;1;27;.964;3600000;0
13777;190098;186;0;0;0;0;.00nan;0;0
13777;-1;180;0;0;0;0;.00nan;0;0
13777;197707;180;52;37;5;32;.865;3600000;0
13765;184650;4864;67;30;3;27;.900;3900000;0
13765;206801;176;0;0;0;0;.00nan;0;0
13765;182006;176;81;44;3;41;.932;3900000;0
13765;186332;4864;0;0;0;0;.00nan;0;0
13821;187628;227;0;0;0;0;.00nan;0;0
13821;184133;230;0;0;0;0;.00nan;0;0
13821;181338;230;65;18;1;17;.944;3600000;0
13821;187217;227;71;60;7;53;.883;3600000;0
13906;192915;179;86;32;1;31;.969;3600000;0
13906;195251;4949;77;36;3;33;.917;3600000;0
13906;187355;179;0;0;0;0;.00nan;0;0
13906;197685;4949;0;0;0;0;.00nan;0;0
13831;182324;4960;67;26;2;24;.923;3600000;0
13831;203383;232;53;32;4;28;.875;3518000;0
13831;194219;4960;0;0;0;0;.00nan;0;0
13831;183695;232;0;0;0;0;.00nan;0;0
13837;200440;204;0;0;0;0;.00nan;0;0
13837;189902;204;63;30;4;26;.867;3600000;0
13837;201525;203;17;22;6;16;.727;2393000;0
13837;191078;203;45;14;2;12;.857;1207000;0
13860;-1;189;57;24;3;21;.875;3561000;0
13860;192547;190;67;30;2;28;.933;3600000;0
13860;197704;190;0;0;0;0;.00nan;0;0
13860;-1;189;0;0;0;0;.00nan;0;0
14040;199416;191;94;35;1;34;.971;3600000;0
14040;194893;191;0;0;0;0;.00nan;0;0
14040;189529;193;97;43;2;41;.953;3586000;0
14040;186451;193;0;0;0;0;.00nan;0;0
13888;189081;187;0;0;0;0;.00nan;0;0
13888;-1;192;58;29;3;26;.897;3565000;0
13888;207398;192;0;0;0;0;.00nan;0;0
13888;-1;187;79;30;2;28;.933;3600000;0
13933;198149;188;0;0;0;0;.00nan;0;0
13933;184409;188;84;45;3;42;.933;3600000;0
13933;184788;198;50;7;1;6;.857;1237000;0
13933;181443;198;26;22;5;17;.773;2363000;0
13875;-1;220;54;34;5;29;.853;3600000;0
13875;-1;220;0;0;0;0;.00nan;0;0
13875;-1;214;0;0;0;0;.00nan;0;0
13875;191518;214;91;32;1;31;.969;3600000;0
13950;195164;218;0;0;0;0;.00nan;0;0
13950;184785;211;91;43;3;40;.930;3600000;0
13950;190095;218;75;42;4;38;.905;3581000;0
13950;179646;211;0;0;0;0;.00nan;0;0
13879;182467;185;60;37;4;33;.892;3600000;0
13879;-1;1371;0;0;0;0;.00nan;0;0
13879;-1;185;0;0;0;0;.00nan;0;0
13879;192688;1371;86;29;1;28;.966;3600000;0
13948;201524;205;0;0;0;0;.00nan;0;0
13948;196283;206;0;0;0;0;.00nan;0;0
13948;-1;205;60;28;3;25;.893;3600000;0
13948;202998;206;63;38;4;34;.895;3594000;0
13941;200452;221;72;32;3;29;.906;3890000;0
13941;189885;225;69;34;3;31;.912;3900000;0
13941;-1;225;0;0;0;0;.00nan;0;0
13941;187431;221;0;0;0;0;.00nan;0;0
13902;205788;207;0;0;0;0;.00nan;0;0
13902;201560;202;69;21;1;20;.952;3600000;0
13902;-1;207;75;47;5;42;.894;3600000;0
13902;196299;202;0;0;0;0;.00nan;0;0
13911;185800;229;81;33;3;30;.909;3533000;0
13911;185960;229;0;0;0;0;.00nan;0;0
13911;191120;223;0;0;0;0;.00nan;0;0
13911;187118;223;86;26;1;25;.962;3600000;0
13763;192939;208;100;27;0;27;1.000;3600000;0
13763;200380;208;0;0;0;0;.00nan;0;0
13763;-1;199;70;31;2;29;.935;3531000;0
13763;-1;199;0;0;0;0;.00nan;0;0
13892;201525;203;21;29;7;22;.759;2924000;0
13892;201560;202;0;0;0;0;.00nan;0;0
13892;196299;202;100;31;1;30;.968;3600000;0
13892;191078;203;58;6;0;6;1.000;676000;0
13944;189773;231;90;30;1;29;.967;3600000;0
13944;184610;222;98;57;2;55;.965;3600000;0
13944;206955;231;0;0;0;0;.00nan;0;0
13944;185851;222;0;0;0;0;.00nan;0;0
13979;200440;204;74;15;0;15;1.000;1412000;0
13979;195238;200;76;29;2;27;.931;3600000;0
13979;189902;204;24;17;5;12;.706;2188000;0
13979;-1;200;0;0;0;0;.00nan;0;0
13920;205837;184;0;0;0;0;.00nan;0;0
13920;190125;184;47;25;4;21;.840;3811000;0
13920;-1;181;60;38;5;33;.868;3811000;0
13920;192552;181;0;0;0;0;.00nan;0;0
14120;203383;232;0;0;0;0;.00nan;0;0
14120;183695;232;97;42;2;40;.952;3600000;0
14120;189773;231;34;20;4;16;.800;3559000;0
14120;206955;231;0;0;0;0;.00nan;0;0
13822;192915;179;0;0;0;0;.00nan;0;0
13822;195251;4949;53;32;5;27;.844;3600000;0
13822;187355;179;83;33;2;31;.939;3600000;0
13822;197685;4949;0;0;0;0;.00nan;0;0
13897;184874;197;0;0;0;0;.00nan;0;0
13897;206822;197;74;38;3;35;.921;3600000;0
13897;-1;189;80;32;1;31;.969;3600000;0
13897;-1;189;0;0;0;0;.00nan;0;0
13917;-1;181;0;0;0;0;.00nan;0;0
13917;-1;220;0;0;0;0;.00nan;0;0
13917;-1;220;67;25;2;23;.920;3600000;0
13917;192552;181;35;29;5;24;.828;3600000;0
13815;182324;4960;0;0;0;0;.00nan;0;0
13815;194219;4960;74;21;1;20;.952;3600000;0
13815;180377;228;66;45;5;40;.889;3600000;0
13815;208044;228;0;0;0;0;.00nan;0;0
13958;189885;225;69;35;3;32;.914;3600000;0
13958;184610;222;99;33;1;32;.970;3600000;0
13958;-1;225;0;0;0;0;.00nan;0;0
13958;185851;222;0;0;0;0;.00nan;0;0
13973;198074;195;0;0;0;0;.00nan;0;0
13973;200333;194;0;0;0;0;.00nan;0;0
13973;207061;195;70;15;1;14;.933;3600000;0
13973;196352;194;80;62;6;56;.903;3600000;0
13829;192629;226;0;0;0;0;.00nan;0;0
13829;-1;226;62;28;3;25;.893;3565000;0
13829;-1;199;94;33;1;32;.970;3600000;0
13829;-1;199;0;0;0;0;.00nan;0;0
13877;184133;230;0;0;0;0;.00nan;0;0
13877;184175;224;86;49;3;46;.939;3569000;0
13877;181338;230;63;17;2;15;.882;3600000;0
13877;185840;224;0;0;0;0;.00nan;0;0
13843;200452;221;84;22;1;21;.955;3600000;0
13843;191120;223;0;0;0;0;.00nan;0;0
13843;187118;223;92;39;2;37;.949;3554000;0
13843;187431;221;0;0;0;0;.00nan;0;0
13804;184650;4864;0;0;0;0;.00nan;0;0
13804;190164;4959;41;22;4;18;.818;3572000;0
13804;186332;4864;77;40;3;37;.925;3600000;0
13804;-1;4959;0;0;0;0;.00nan;0;0
13967;198149;188;0;0;0;0;.00nan;0;0
13967;184409;188;80;28;1;27;.964;3799000;0
13967;192547;190;0;0;0;0;.00nan;0;0
13967;197704;190;75;27;2;25;.926;3799000;0
13863;179499;186;0;0;0;0;.00nan;0;0
13863;190098;186;75;34;3;31;.912;3600000;0
13863;-1;180;55;37;5;32;.865;3524000;0
13863;197707;180;0;0;0;0;.00nan;0;0
13867;184785;211;0;0;0;0;.00nan;0;0
13867;179646;211;66;40;4;36;.900;3600000;0
13867;-1;219;69;20;1;19;.950;3600000;0
13867;-1;219;0;0;0;0;.00nan;0;0
13775;192939;208;100;20;0;20;1.000;3600000;0
13775;200380;208;0;0;0;0;.00nan;0;0
13775;205788;207;0;0;0;0;.00nan;0;0
13775;-1;207;57;35;4;31;.886;3600000;0
13926;184648;196;24;7;3;4;.571;343000;0
13926;-1;192;42;22;4;18;.818;3600000;0
13926;207398;192;0;0;0;0;.00nan;0;0
13926;191118;196;65;26;2;24;.923;3227000;0
13934;182467;185;75;34;3;31;.912;3600000;0
13934;-1;185;0;0;0;0;.00nan;0;0
13934;-1;214;100;53;0;53;1.000;3600000;0
13934;191518;214;0;0;0;0;.00nan;0;0
13870;-1;183;92;22;0;22;1.000;3600000;0
13870;180574;183;0;0;0;0;.00nan;0;0
13870;-1;178;61;39;4;35;.897;3600000;0
13870;-1;178;0;0;0;0;.00nan;0;0
13799;205743;2620;0;0;0;0;.00nan;0;0
13799;206801;176;55;29;4;25;.862;3582000;0
13799;182006;176;0;0;0;0;.00nan;0;0
13799;-1;2620;59;27;3;24;.889;3600000;0
13935;195164;218;74;37;3;34;.919;3854000;0
13935;190095;218;0;0;0;0;.00nan;0;0
13935;182128;215;0;0;0;0;.00nan;0;0
13935;-1;215;64;34;4;30;.882;3854000;0
13914;195251;4949;0;0;0;0;.00nan;0;0
13914;-1;216;34;34;6;28;.824;2356000;0
13914;197685;4949;78;28;1;27;.964;3600000;0
13914;-1;216;62;16;1;15;.938;1244000;0
13953;189081;187;92;18;0;18;1.000;3600000;0
13953;189529;193;0;0;0;0;.00nan;0;0
13953;186451;193;84;34;2;32;.941;3548000;0
13953;-1;187;0;0;0;0;.00nan;0;0
14013;183686;213;47;41;6;35;.854;2455000;0
14013;201495;213;67;17;1;16;.941;1145000;0
14013;192461;210;53;19;2;17;.895;3600000;0
14013;197672;210;0;0;0;0;.00nan;0;0
13961;-1;192;0;0;0;0;.00nan;0;0
13961;207398;192;66;22;2;20;.909;3600000;0
13961;192547;190;74;41;5;36;.878;3600000;0
13961;197704;190;0;0;0;0;.00nan;0;0
13981;198149;188;36;13;3;10;.769;3600000;0
13981;184409;188;0;0;0;0;.00nan;0;0
13981;184874;197;0;0;0;0;.00nan;0;0
13981;206822;197;81;55;5;50;.909;3566000;0
13986;195164;218;67;39;4;35;.897;3546000;0
13986;190034;217;0;0;0;0;.00nan;0;0
13986;190041;217;81;31;2;29;.935;3600000;0
13986;190095;218;0;0;0;0;.00nan;0;0
13872;-1;1371;0;0;0;0;.00nan;0;0
13872;-1;220;61;41;5;36;.878;3577000;0
13872;-1;220;0;0;0;0;.00nan;0;0
13872;192688;1371;72;33;3;30;.909;3600000;0
14023;198074;195;77;24;1;23;.958;3600000;0
14023;207061;195;0;0;0;0;.00nan;0;0
14023;-1;189;75;47;4;43;.915;3600000;0
14023;-1;189;0;0;0;0;.00nan;0;0
13983;184175;224;45;35;5;30;.857;3600000;0
13983;189773;231;68;18;1;17;.944;3600000;0
13983;206955;231;0;0;0;0;.00nan;0;0
13983;185840;224;0;0;0;0;.00nan;0;0
13984;184650;4864;0;0;0;0;.00nan;0;0
13984;186332;4864;67;19;1;18;.947;3900000;0
13984;-1;209;100;39;1;38;.974;3900000;0
13984;203063;209;0;0;0;0;.00nan;0;0
13924;199416;191;0;0;0;0;.00nan;0;0
13924;194893;191;79;26;1;25;.962;3600000;0
13924;184648;196;75;40;3;37;.925;3600000;0
13924;191118;196;0;0;0;0;.00nan;0;0
13939;201525;203;85;54;4;50;.926;3900000;0
13939;191078;203;0;0;0;0;.00nan;0;0
13939;-1;199;0;0;0;0;.00nan;0;0
13939;-1;199;63;36;4;32;.889;3900000;0
14071;189081;187;90;31;1;30;.968;3600000;0
14071;184788;198;72;36;3;33;.917;3579000;0
14071;181443;198;0;0;0;0;.00nan;0;0
14071;-1;187;0;0;0;0;.00nan;0;0
13921;201560;202;62;34;4;30;.882;3763000;0
13921;196283;206;0;0;0;0;.00nan;0;0
13921;196299;202;0;0;0;0;.00nan;0;0
13921;202998;206;57;29;3;26;.897;3763000;0
13919;182467;185;0;0;0;0;.00nan;0;0
13919;-1;1371;0;0;0;0;.00nan;0;0
13919;-1;185;75;34;3;31;.912;3600000;0
13919;192688;1371;76;38;4;34;.895;3565000;0
14090;189885;225;87;33;2;31;.939;3900000;0
14090;-1;225;0;0;0;0;.00nan;0;0
14090;191120;223;0;0;0;0;.00nan;0;0
14090;187118;223;67;25;2;23;.920;3900000;0
13816;179679;212;52;17;2;15;.882;3600000;0
13816;-1;212;0;0;0;0;.00nan;0;0
13816;-1;180;68;47;5;42;.894;3600000;0
13816;197707;180;0;0;0;0;.00nan;0;0
13803;192939;208;93;20;0;20;1.000;3600000;0
13803;200380;208;0;0;0;0;.00nan;0;0
13803;195238;200;60;23;2;21;.913;3562000;0
13803;-1;200;0;0;0;0;.00nan;0;0
14036;184610;222;91;60;3;57;.950;3578000;0
14036;180377;228;63;19;2;17;.895;3600000;0
14036;185851;222;0;0;0;0;.00nan;0;0
14036;208044;228;0;0;0;0;.00nan;0;0
13949;179499;186;99;35;1;34;.971;3600000;0
13949;190098;186;0;0;0;0;.00nan;0;0
13949;-1;219;69;47;5;42;.894;3600000;0
13949;-1;219;0;0;0;0;.00nan;0;0
13951;192915;179;85;43;3;40;.930;3600000;0
13951;196571;177;76;24;2;22;.917;3600000;0
13951;187355;179;0;0;0;0;.00nan;0;0
13951;-1;177;0;0;0;0;.00nan;0;0
13886;183686;213;0;0;0;0;.00nan;0;0
13886;201495;213;76;32;2;30;.938;3596000;0
13886;192461;210;73;21;1;20;.952;3600000;0
13886;197672;210;0;0;0;0;.00nan;0;0
13999;200440;204;0;0;0;0;.00nan;0;0
13999;205788;207;0;0;0;0;.00nan;0;0
13999;189902;204;100;34;1;33;.971;3600000;0
13999;-1;207;69;27;2;25;.926;3582000;0
13930;200452;221;64;27;3;24;.889;3600000;0
13930;185800;229;53;25;4;21;.840;3568000;0
13930;185960;229;0;0;0;0;.00nan;0;0
13930;187431;221;0;0;0;0;.00nan;0;0
13896;190034;217;58;25;3;22;.880;3900000;0
13896;190041;217;0;0;0;0;.00nan;0;0
13896;-1;219;0;0;0;0;.00nan;0;0
13896;-1;219;75;47;3;44;.936;3900000;0
13895;189529;193;0;0;0;0;.00nan;0;0
13895;184874;197;0;0;0;0;.00nan;0;0
13895;206822;197;88;44;2;42;.955;3559000;0
13895;186451;193;91;18;0;18;1.000;3600000;0
13960;195238;200;0;0;0;0;.00nan;0;0
13960;201524;205;0;0;0;0;.00nan;0;0
13960;-1;200;80;44;4;40;.909;3600000;0
13960;-1;205;41;31;5;26;.839;3558000;0
13779;205743;2620;0;0;0;0;.00nan;0;0
13779;206801;176;91;43;2;41;.953;3600000;0
13779;182006;176;0;0;0;0;.00nan;0;0
13779;-1;2620;38;25;4;21;.840;3600000;0
14129;187628;227;86;29;1;28;.966;3600000;0
14129;184175;224;0;0;0;0;.00nan;0;0
14129;185840;224;80;36;2;34;.944;3600000;0
14129;187217;227;0;0;0;0;.00nan;0;0
14087;194950;1505;62;31;3;28;.903;3544000;0
14087;-1;216;0;0;0;0;.00nan;0;0
14087;186549;1505;0;0;0;0;.00nan;0;0
14087;-1;216;89;27;1;26;.963;3600000;0
13929;-1;220;0;0;0;0;.00nan;0;0
13929;-1;220;71;19;1;18;.947;3900000;0
13929;-1;214;94;29;1;28;.966;3900000;0
13929;191518;214;0;0;0;0;.00nan;0;0
13945;200440;204;0;0;0;0;.00nan;0;0
13945;189902;204;67;42;5;37;.881;3600000;0
13945;201560;202;0;0;0;0;.00nan;0;0
13945;196299;202;61;16;1;15;.938;3600000;0
13993;203383;232;40;27;4;23;.852;3600000;0
13993;183695;232;0;0;0;0;.00nan;0;0
13993;200452;221;0;0;0;0;.00nan;0;0
13993;187431;221;75;25;1;24;.960;3600000;0
14015;195251;4949;61;39;5;34;.872;3600000;0
14015;196571;177;0;0;0;0;.00nan;0;0
14015;197685;4949;0;0;0;0;.00nan;0;0
14015;-1;177;51;40;6;34;.850;3592000;0
14016;201525;203;0;0;0;0;.00nan;0;0
14016;196283;206;59;21;2;19;.905;3600000;0
14016;191078;203;60;37;5;32;.865;3600000;0
14016;202998;206;0;0;0;0;.00nan;0;0
14029;-1;201;0;0;0;0;.00nan;0;0
14029;192629;226;66;24;2;22;.917;3600000;0
14029;-1;226;0;0;0;0;.00nan;0;0
14029;-1;201;56;38;5;33;.868;3600000;0
13873;179499;186;0;0;0;0;.00nan;0;0
13873;190098;186;59;40;4;36;.900;3600000;0
13873;182128;215;81;24;1;23;.958;3600000;0
13873;-1;215;0;0;0;0;.00nan;0;0
14020;199416;191;0;0;0;0;.00nan;0;0
14020;194893;191;80;28;2;26;.929;3710000;0
14020;-1;189;0;0;0;0;.00nan;0;0
14020;-1;189;99;43;1;42;.977;3710000;0
13856;182324;4960;0;0;0;0;.00nan;0;0
13856;194219;4960;72;31;3;28;.903;3600000;0
13856;184133;230;0;0;0;0;.00nan;0;0
13856;181338;230;95;31;1;30;.968;3600000;0
13994;184650;4864;0;0;0;0;.00nan;0;0
13994;190164;4959;0;0;0;0;.00nan;0;0
13994;186332;4864;26;37;7;30;.811;3600000;0
13994;-1;4959;79;32;2;30;.938;3600000;0
14006;198149;188;0;0;0;0;.00nan;0;0
14006;184409;188;87;16;0;16;1.000;3600000;0
14006;-1;192;76;24;2;22;.917;3556000;0
14006;207398;192;0;0;0;0;.00nan;0;0
13969;184785;211;34;17;4;13;.765;1577000;0
13969;179646;211;36;31;6;25;.806;2023000;0
13969;179679;212;68;20;2;18;.900;3600000;0
13969;-1;212;0;0;0;0;.00nan;0;0
13813;205743;2620;40;36;6;30;.833;3249000;0
13813;-1;2620;41;3;1;2;.667;351000;0
13813;-1;209;62;25;3;22;.880;3600000;0
13813;203063;209;0;0;0;0;.00nan;0;0
13936;182467;185;39;23;4;19;.826;2309000;0
13936;-1;181;52;16;2;14;.875;3600000;0
13936;-1;185;34;18;4;14;.778;1291000;0
13936;192552;181;0;0;0;0;.00nan;0;0
13883;182128;215;0;0;0;0;.00nan;0;0
13883;-1;180;79;25;1;24;.960;3600000;0
13883;197707;180;0;0;0;0;.00nan;0;0
13883;-1;215;47;29;4;25;.862;3600000;0
13966;192915;179;0;0;0;0;.00nan;0;0
13966;194950;1505;0;0;0;0;.00nan;0;0
13966;186549;1505;50;38;5;33;.868;3600000;0
13966;187355;179;100;25;0;25;1.000;3600000;0
13862;182324;4960;68;22;2;20;.909;3600000;0
13862;194219;4960;0;0;0;0;.00nan;0;0
13862;185800;229;23;11;4;7;.636;792000;0
13862;185960;229;53;22;3;19;.864;2808000;0
13970;187628;227;0;0;0;0;.00nan;0;0
13970;180377;228;0;0;0;0;.00nan;0;0
13970;187217;227;63;22;2;20;.909;3900000;0
13970;208044;228;92;41;2;39;.951;3900000;0
13989;184788;198;0;0;0;0;.00nan;0;0
13989;181443;198;75;38;3;35;.921;3600000;0
13989;192547;190;0;0;0;0;.00nan;0;0
13989;197704;190;55;32;4;28;.875;3546000;0
13854;184133;230;41;16;3;13;.813;3548000;0
13854;181338;230;0;0;0;0;.00nan;0;0
13854;191120;223;95;46;2;44;.957;3600000;0
13854;187118;223;0;0;0;0;.00nan;0;0
13975;198074;195;0;0;0;0;.00nan;0;0
13975;184648;196;77;35;2;33;.943;3900000;0
13975;207061;195;73;28;2;26;.929;3900000;0
13975;191118;196;0;0;0;0;.00nan;0;0
14167;205788;207;0;0;0;0;.00nan;0;0
14167;-1;207;59;34;5;29;.853;3600000;0
14167;-1;201;0;0;0;0;.00nan;0;0
14167;-1;201;85;30;1;29;.967;3600000;0
13783;190164;4959;29;21;5;16;.762;3538000;0
13783;206801;176;0;0;0;0;.00nan;0;0
13783;182006;176;82;39;4;35;.897;3600000;0
13783;-1;4959;0;0;0;0;.00nan;0;0
14017;-1;183;90;45;3;42;.933;3600000;0
14017;180574;183;0;0;0;0;.00nan;0;0
14017;192461;210;60;19;2;17;.895;3600000;0
14017;197672;210;0;0;0;0;.00nan;0;0
13995;-1;1371;0;0;0;0;.00nan;0;0
13995;-1;214;0;0;0;0;.00nan;0;0
13995;191518;214;23;33;7;26;.788;3600000;0
13995;192688;1371;76;37;3;34;.919;3600000;0
13988;195164;218;55;34;4;30;.882;3860000;0
13988;190095;218;0;0;0;0;.00nan;0;0
13988;179679;212;0;0;0;0;.00nan;0;0
13988;-1;212;90;48;5;43;.896;3860000;0
14035;183686;213;0;0;0;0;.00nan;0;0
14035;-1;216;0;0;0;0;.00nan;0;0
14035;201495;213;62;35;4;31;.886;3746000;0
14035;-1;216;46;19;3;16;.842;3746000;0
13880;200452;221;80;28;2;26;.929;3600000;0
13880;185800;229;50;23;3;20;.870;3588000;0
13880;185960;229;0;0;0;0;.00nan;0;0
13880;187431;221;0;0;0;0;.00nan;0;0
14122;196283;206;0;0;0;0;.00nan;0;0
14122;192629;226;66;16;1;15;.938;3600000;0
14122;-1;226;0;0;0;0;.00nan;0;0
14122;202998;206;78;30;2;28;.933;3547000;0
14059;196571;177;77;28;2;26;.929;3600000;0
14059;-1;178;62;49;6;43;.878;3600000;0
14059;-1;178;0;0;0;0;.00nan;0;0
14059;-1;177;0;0;0;0;.00nan;0;0
14075;200333;194;74;36;3;33;.917;3588000;0
14075;189529;193;0;0;0;0;.00nan;0;0
14075;196352;194;0;0;0;0;.00nan;0;0
14075;186451;193;78;29;2;27;.931;3600000;0
14062;190034;217;0;0;0;0;.00nan;0;0
14062;190041;217;91;19;0;19;1.000;3600000;0
14062;184785;211;85;40;4;36;.900;3600000;0
14062;179646;211;0;0;0;0;.00nan;0;0
14026;-1;219;62;30;3;27;.900;3600000;0
14026;182128;215;56;43;5;38;.884;3552000;0
14026;-1;219;0;0;0;0;.00nan;0;0
14026;-1;215;0;0;0;0;.00nan;0;0
13955;201560;202;95;31;1;30;.968;3600000;0
13955;196299;202;0;0;0;0;.00nan;0;0
13955;192629;226;0;0;0;0;.00nan;0;0
13955;-1;226;51;29;4;25;.862;3600000;0
14041;-1;192;0;0;0;0;.00nan;0;0
14041;207398;192;48;16;2;14;.875;3600000;0
14041;-1;189;0;0;0;0;.00nan;0;0
14041;-1;189;78;46;4;42;.913;3577000;0
13991;189529;193;75;35;3;32;.914;3600000;0
13991;184788;198;50;33;5;28;.848;3580000;0
13991;181443;198;0;0;0;0;.00nan;0;0
13991;186451;193;0;0;0;0;.00nan;0;0
14123;182467;185;30;28;6;22;.786;2190000;0
14123;-1;1371;0;0;0;0;.00nan;0;0
14123;-1;185;45;9;2;7;.778;1410000;0
14123;192688;1371;78;25;1;24;.960;3600000;0
14054;205837;184;0;0;0;0;.00nan;0;0
14054;190125;184;79;12;0;12;1.000;3600000;0
14054;-1;214;79;53;5;48;.906;3600000;0
14054;191518;214;0;0;0;0;.00nan;0;0
14032;195251;4949;36;19;4;15;.789;3597000;0
14032;196571;177;0;0;0;0;.00nan;0;0
14032;197685;4949;0;0;0;0;.00nan;0;0
14032;-1;177;90;46;3;43;.935;3600000;0
14159;201524;205;0;0;0;0;.00nan;0;0
14159;196283;206;61;42;5;37;.881;3600000;0
14159;-1;205;83;22;1;21;.955;3600000;0
14159;202998;206;0;0;0;0;.00nan;0;0
14063;198149;188;0;0;0;0;.00nan;0;0
14063;199416;191;0;0;0;0;.00nan;0;0
14063;194893;191;86;16;0;16;1.000;3600000;0
14063;184409;188;66;27;2;25;.926;3532000;0
14172;192915;179;0;0;0;0;.00nan;0;0
14172;187355;179;56;9;1;8;.889;3600000;0
14172;-1;178;0;0;0;0;.00nan;0;0
14172;-1;178;69;56;5;51;.911;3600000;0
14058;200452;221;80;34;2;32;.941;3600000;0
14058;180377;228;53;34;4;30;.882;3525000;0
14058;187431;221;0;0;0;0;.00nan;0;0
14058;208044;228;0;0;0;0;.00nan;0;0
14003;200306;182;46;35;5;30;.857;3600000;0
14003;-1;181;85;38;2;36;.947;3600000;0
14003;185810;182;0;0;0;0;.00nan;0;0
14003;192552;181;0;0;0;0;.00nan;0;0
14137;205788;207;0;0;0;0;.00nan;0;0
14137;-1;207;54;27;3;24;.889;3600000;0
14137;-1;199;61;19;1;18;.947;3600000;0
14137;-1;199;0;0;0;0;.00nan;0;0
14124;180377;228;0;0;0;0;.00nan;0;0
14124;191120;223;0;0;0;0;.00nan;0;0
14124;187118;223;56;36;5;31;.861;3600000;0
14124;208044;228;79;27;1;26;.963;3600000;0
14055;184133;230;0;0;0;0;.00nan;0;0
14055;181338;230;65;12;1;11;.917;3600000;0
14055;185800;229;0;0;0;0;.00nan;0;0
14055;185960;229;78;52;5;47;.904;3600000;0
14115;194950;1505;74;28;2;26;.929;3600000;0
14115;-1;216;74;38;3;35;.921;3600000;0
14115;186549;1505;0;0;0;0;.00nan;0;0
14115;-1;216;0;0;0;0;.00nan;0;0
13972;195164;218;100;26;0;26;1.000;3600000;0
13972;190095;218;0;0;0;0;.00nan;0;0
13972;182128;215;0;0;0;0;.00nan;0;0
13972;-1;215;80;49;5;44;.898;3600000;0
14024;-1;183;74;44;4;40;.909;3900000;0
14024;180574;183;0;0;0;0;.00nan;0;0
14024;192461;210;80;35;4;31;.886;3900000;0
14024;197672;210;0;0;0;0;.00nan;0;0
14008;205837;184;0;0;0;0;.00nan;0;0
14008;190125;184;58;39;5;34;.872;3600000;0
14008;-1;181;0;0;0;0;.00nan;0;0
14008;192552;181;82;42;3;39;.929;3600000;0
14007;201524;205;0;0;0;0;.00nan;0;0
14007;201560;202;0;0;0;0;.00nan;0;0
14007;196299;202;82;41;4;37;.902;3900000;0
14007;-1;205;62;37;4;33;.892;3900000;0
14014;179499;186;29;28;6;22;.786;3256000;0
14014;190098;186;55;3;0;3;1.000;344000;0
14014;-1;180;83;27;1;26;.963;3600000;0
14014;197707;180;0;0;0;0;.00nan;0;0
14019;192915;179;54;32;5;27;.844;3513000;0
14019;183686;213;0;0;0;0;.00nan;0;0
14019;201495;213;77;41;3;38;.927;3600000;0
14019;187355;179;0;0;0;0;.00nan;0;0
14078;189885;225;0;0;0;0;.00nan;0;0
14078;184610;222;77;30;3;27;.900;3600000;0
14078;-1;225;64;33;4;29;.879;3551000;0
14078;185851;222;0;0;0;0;.00nan;0;0
13866;182324;4960;0;0;0;0;.00nan;0;0
13866;187628;227;51;36;5;31;.861;3600000;0
13866;194219;4960;88;19;0;19;1.000;3600000;0
13866;187217;227;0;0;0;0;.00nan;0;0
14004;199416;191;0;0;0;0;.00nan;0;0
14004;194893;191;71;9;0;9;1.000;3600000;0
14004;184874;197;0;0;0;0;.00nan;0;0
14004;206822;197;65;37;3;34;.919;3600000;0
13947;200440;204;0;0;0;0;.00nan;0;0
13947;189902;204;63;26;3;23;.885;3600000;0
13947;-1;199;0;0;0;0;.00nan;0;0
13947;-1;199;72;45;4;41;.911;3576000;0
13996;190164;4959;0;0;0;0;.00nan;0;0
13996;206801;176;82;32;2;30;.938;3900000;0
13996;182006;176;0;0;0;0;.00nan;0;0
13996;-1;4959;82;38;2;36;.947;3900000;0
14083;190034;217;44;22;4;18;.818;3562000;0
14083;190041;217;0;0;0;0;.00nan;0;0
14083;184785;211;0;0;0;0;.00nan;0;0
14083;179646;211;75;39;3;36;.923;3600000;0
13861;192939;208;74;32;3;29;.906;3900000;0
13861;200380;208;0;0;0;0;.00nan;0;0
13861;195238;200;63;28;3;25;.893;3900000;0
13861;-1;200;0;0;0;0;.00nan;0;0
14101;198149;188;78;51;5;46;.902;3542000;0
14101;200333;194;81;38;4;34;.895;3600000;0
14101;184409;188;0;0;0;0;.00nan;0;0
14101;196352;194;0;0;0;0;.00nan;0;0
14042;184648;196;96;42;3;39;.929;3600000;0
14042;191118;196;0;0;0;0;.00nan;0;0
14042;192547;190;0;0;0;0;.00nan;0;0
14042;197704;190;61;35;5;30;.857;3600000;0
14011;-1;192;55;19;2;17;.895;3600000;0
14011;207398;192;0;0;0;0;.00nan;0;0
14011;-1;189;71;30;3;27;.900;3584000;0
14011;-1;189;0;0;0;0;.00nan;0;0
14034;205788;207;59;42;4;38;.905;3596000;0
14034;201525;203;48;19;3;16;.842;3600000;0
14034;-1;207;0;0;0;0;.00nan;0;0
14034;191078;203;0;0;0;0;.00nan;0;0
13908;205743;2620;0;0;0;0;.00nan;0;0
13908;184650;4864;0;0;0;0;.00nan;0;0
13908;-1;2620;56;18;2;16;.889;3600000;0
13908;186332;4864;68;37;3;34;.919;3600000;0
14021;183686;213;0;0;0;0;.00nan;0;0
14021;201495;213;80;33;2;31;.939;3600000;0
14021;196571;177;51;32;4;28;.875;3515000;0
14021;-1;177;0;0;0;0;.00nan;0;0
14094;203383;232;66;40;4;36;.900;3600000;0
14094;183695;232;0;0;0;0;.00nan;0;0
14094;184175;224;78;27;2;25;.926;3600000;0
14094;185840;224;0;0;0;0;.00nan;0;0
14052;182467;185;67;41;5;36;.878;3600000;0
14052;-1;185;0;0;0;0;.00nan;0;0
14052;-1;214;82;24;1;23;.958;3600000;0
14052;191518;214;0;0;0;0;.00nan;0;0
14074;-1;219;100;23;0;23;1.000;3600000;0
14074;-1;219;0;0;0;0;.00nan;0;0
14074;-1;180;0;0;0;0;.00nan;0;0
14074;197707;180;87;44;2;42;.955;3569000;0
13997;195164;218;92;35;2;33;.943;3600000;0
13997;179499;186;0;0;0;0;.00nan;0;0
13997;190095;218;0;0;0;0;.00nan;0;0
13997;190098;186;54;25;3;22;.880;3543000;0
13962;200452;221;71;32;2;30;.938;3600000;0
13962;189773;231;61;16;1;15;.938;3600000;0
13962;206955;231;0;0;0;0;.00nan;0;0
13962;187431;221;0;0;0;0;.00nan;0;0
14056;189081;187;76;18;1;17;.944;3600000;0
14056;184874;197;79;36;2;34;.944;3580000;0
14056;206822;197;0;0;0;0;.00nan;0;0
14056;-1;187;0;0;0;0;.00nan;0;0
13809;192939;208;0;0;0;0;.00nan;0;0
13809;200380;208;80;40;4;36;.900;3573000;0
13809;195238;200;0;0;0;0;.00nan;0;0
13809;-1;200;55;23;3;20;.870;3600000;0
14044;198074;195;0;0;0;0;.00nan;0;0
14044;184648;196;0;0;0;0;.00nan;0;0
14044;207061;195;70;18;1;17;.944;3600000;0
14044;191118;196;88;56;2;54;.964;3568000;0
14069;200452;221;0;0;0;0;.00nan;0;0
14069;189885;225;70;30;2;28;.933;3600000;0
14069;-1;225;0;0;0;0;.00nan;0;0
14069;187431;221;67;26;3;23;.885;3568000;0
14067;190164;4959;0;0;0;0;.00nan;0;0
14067;-1;209;100;31;0;31;1.000;3600000;0
14067;-1;4959;56;27;3;24;.889;3600000;0
14067;203063;209;0;0;0;0;.00nan;0;0
14143;179679;212;74;34;2;32;.941;3900000;0
14143;182128;215;83;36;2;34;.944;3900000;0
14143;-1;212;0;0;0;0;.00nan;0;0
14143;-1;215;0;0;0;0;.00nan;0;0
14066;194950;1505;0;0;0;0;.00nan;0;0
14066;195251;4949;54;25;3;22;.880;3599000;0
14066;186549;1505;88;37;2;35;.946;3600000;0
14066;197685;4949;0;0;0;0;.00nan;0;0
14065;184788;198;87;28;1;27;.964;3600000;0
14065;181443;198;0;0;0;0;.00nan;0;0
14065;192547;190;0;0;0;0;.00nan;0;0
14065;197704;190;80;45;5;40;.889;3600000;0
14028;182467;185;0;0;0;0;.00nan;0;0
14028;200306;182;0;0;0;0;.00nan;0;0
14028;185810;182;73;29;2;27;.931;3600000;0
14028;-1;185;58;36;4;32;.889;3600000;0
14097;205743;2620;0;0;0;0;.00nan;0;0
14097;184650;4864;0;0;0;0;.00nan;0;0
14097;-1;2620;67;19;1;18;.947;3600000;0
14097;186332;4864;76;47;5;42;.894;3600000;0
14031;201560;202;46;27;5;22;.815;3583000;0
14031;196299;202;0;0;0;0;.00nan;0;0
14031;-1;201;0;0;0;0;.00nan;0;0
14031;-1;201;68;35;4;31;.886;3600000;0
14117;200440;204;0;0;0;0;.00nan;0;0
14117;189902;204;69;24;1;23;.958;3600000;0
14117;201525;203;78;33;2;31;.939;3600000;0
14117;191078;203;0;0;0;0;.00nan;0;0
14112;198149;188;0;0;0;0;.00nan;0;0
14112;184409;188;90;35;1;34;.971;3600000;0
14112;-1;189;0;0;0;0;.00nan;0;0
14112;-1;189;55;35;6;29;.829;3600000;0
13943;182324;4960;0;0;0;0;.00nan;0;0
13943;194219;4960;83;25;1;24;.960;3600000;0
13943;191120;223;0;0;0;0;.00nan;0;0
13943;187118;223;81;47;4;43;.915;3600000;0
14037;187628;227;42;34;5;29;.853;3600000;0
14037;180377;228;100;24;0;24;1.000;3600000;0
14037;187217;227;0;0;0;0;.00nan;0;0
14037;208044;228;0;0;0;0;.00nan;0;0
14113;203383;232;0;0;0;0;.00nan;0;0
14113;183695;232;56;26;3;23;.885;3557000;0
14113;185800;229;77;27;1;26;.963;3600000;0
14113;185960;229;0;0;0;0;.00nan;0;0
14156;-1;181;61;11;1;10;.909;3600000;0
14156;-1;214;0;0;0;0;.00nan;0;0
14156;191518;214;62;48;5;43;.896;3600000;0
14156;192552;181;0;0;0;0;.00nan;0;0
14127;184785;211;100;31;0;31;1.000;3600000;0
14127;179646;211;0;0;0;0;.00nan;0;0
14127;-1;219;54;33;4;29;.879;3600000;0
14127;-1;219;0;0;0;0;.00nan;0;0
14084;-1;178;25;36;7;29;.806;2915000;0
14084;192461;210;89;34;3;31;.912;3600000;0
14084;-1;178;61;7;0;7;1.000;685000;0
14084;197672;210;0;0;0;0;.00nan;0;0
14064;184650;4864;43;35;5;30;.857;3600000;0
14064;186332;4864;0;0;0;0;.00nan;0;0
14064;-1;209;87;40;2;38;.950;3600000;0
14064;203063;209;0;0;0;0;.00nan;0;0
13922;192939;208;83;32;2;30;.938;3600000;0
13922;200380;208;0;0;0;0;.00nan;0;0
13922;192629;226;0;0;0;0;.00nan;0;0
13922;-1;226;62;29;3;26;.897;3600000;0
14002;205788;207;0;0;0;0;.00nan;0;0
14002;195238;200;55;26;4;22;.846;3600000;0
14002;-1;207;100;27;0;27;1.000;3600000;0
14002;-1;200;0;0;0;0;.00nan;0;0
14088;198074;195;0;0;0;0;.00nan;0;0
14088;184788;198;0;0;0;0;.00nan;0;0
14088;207061;195;73;30;3;27;.900;3600000;0
14088;181443;198;81;45;4;41;.911;3587000;0
13956;182324;4960;65;27;3;24;.889;3883000;0
13956;194219;4960;0;0;0;0;.00nan;0;0
13956;184133;230;0;0;0;0;.00nan;0;0
13956;181338;230;76;35;3;32;.914;3900000;0
14039;189773;231;38;20;4;16;.800;3585000;0
14039;184610;222;0;0;0;0;.00nan;0;0
14039;206955;231;0;0;0;0;.00nan;0;0
14039;185851;222;70;38;3;35;.921;3600000;0
13878;205743;2620;0;0;0;0;.00nan;0;0
13878;190164;4959;100;44;3;41;.932;3900000;0
13878;-1;2620;66;26;3;23;.885;3900000;0
13878;-1;4959;0;0;0;0;.00nan;0;0
14038;-1;183;95;34;2;32;.941;3600000;0
14038;180574;183;0;0;0;0;.00nan;0;0
14038;192461;210;52;27;3;24;.889;3542000;0
14038;197672;210;0;0;0;0;.00nan;0;0
14105;185800;229;0;0;0;0;.00nan;0;0
14105;185960;229;53;31;4;27;.871;3600000;0
14105;191120;223;93;29;1;28;.966;3600000;0
14105;187118;223;0;0;0;0;.00nan;0;0
14131;201525;203;0;0;0;0;.00nan;0;0
14131;-1;201;79;29;2;27;.931;3600000;0
14131;191078;203;70;37;3;34;.919;3600000;0
14131;-1;201;0;0;0;0;.00nan;0;0
14033;195164;218;91;16;0;16;1.000;3600000;0
14033;190095;218;0;0;0;0;.00nan;0;0
14033;-1;180;56;39;5;34;.872;3600000;0
14033;197707;180;0;0;0;0;.00nan;0;0
14134;189081;187;63;27;3;24;.889;3766000;0
14134;189529;193;0;0;0;0;.00nan;0;0
14134;186451;193;82;37;2;35;.946;3766000;0
14134;-1;187;0;0;0;0;.00nan;0;0
14022;200333;194;0;0;0;0;.00nan;0;0
14022;-1;192;50;30;4;26;.867;3585000;0
14022;196352;194;88;41;3;38;.927;3600000;0
14022;207398;192;0;0;0;0;.00nan;0;0
14045;200306;182;83;47;4;43;.915;3576000;0
14045;-1;220;0;0;0;0;.00nan;0;0
14045;-1;220;73;29;3;26;.897;3600000;0
14045;185810;182;0;0;0;0;.00nan;0;0
14086;199416;191;0;0;0;0;.00nan;0;0
14086;189081;187;0;0;0;0;.00nan;0;0
14086;194893;191;57;22;3;19;.864;3600000;0
14086;-1;187;74;46;5;41;.891;3600000;0
14047;205837;184;58;36;4;32;.889;3600000;0
14047;190125;184;0;0;0;0;.00nan;0;0
14047;-1;220;35;34;6;28;.824;2916000;0
14047;-1;220;37;7;2;5;.714;684000;0
14050;183686;213;0;0;0;0;.00nan;0;0
14050;201495;213;58;32;4;28;.875;3600000;0
14050;-1;178;85;25;1;24;.960;3600000;0
14050;-1;178;0;0;0;0;.00nan;0;0
14018;179499;186;22;20;5;15;.750;2393000;0
14018;184785;211;0;0;0;0;.00nan;0;0
14018;190098;186;56;9;1;8;.889;1200000;0
14018;179646;211;77;43;4;39;.907;3600000;0
14139;203383;232;62;32;3;29;.906;3517000;0
14139;183695;232;0;0;0;0;.00nan;0;0
14139;184610;222;93;29;1;28;.966;3600000;0
14139;185851;222;0;0;0;0;.00nan;0;0
14148;184133;230;41;17;3;14;.824;3600000;0
14148;189885;225;83;47;4;43;.915;3569000;0
14148;181338;230;0;0;0;0;.00nan;0;0
14148;-1;225;0;0;0;0;.00nan;0;0
14157;187628;227;75;43;4;39;.907;3518000;0
14157;189773;231;0;0;0;0;.00nan;0;0
14157;206955;231;73;24;2;22;.917;3600000;0
14157;187217;227;0;0;0;0;.00nan;0;0
14051;-1;183;0;0;0;0;.00nan;0;0
14051;180574;183;44;31;4;27;.871;3900000;0
14051;196571;177;45;22;4;18;.818;2221000;0
14051;-1;177;65;12;0;12;1.000;1679000;0
13990;192629;226;74;28;1;27;.964;3600000;0
13990;-1;226;0;0;0;0;.00nan;0;0
13990;-1;199;61;33;3;30;.909;3575000;0
13990;-1;199;0;0;0;0;.00nan;0;0
14133;200333;194;45;27;4;23;.852;3600000;0
14133;184874;197;0;0;0;0;.00nan;0;0
14133;206822;197;100;31;0;31;1.000;3600000;0
14133;196352;194;0;0;0;0;.00nan;0;0
14174;201585;197;49;37;6;31;.838;3600000;0
14174;206822;197;0;0;0;0;.00nan;0;0
14174;-1;219;75;24;1;23;.958;3600000;0
14174;-1;219;0;0;0;0;.00nan;0;0
14176;184785;211;0;0;0;0;.00nan;0;0
14176;179646;211;61;40;4;36;.900;3600000;0
14176;-1;183;22;21;5;16;.762;3600000;0
14176;180574;183;0;0;0;0;.00nan;0;0
14178;183686;213;0;0;0;0;.00nan;0;0
14178;205837;184;53;22;3;19;.864;3541000;0
14178;190125;184;0;0;0;0;.00nan;0;0
14178;201495;213;73;30;2;28;.933;3600000;0
14180;192915;179;0;0;0;0;.00nan;0;0
14180;-1;220;66;25;2;23;.920;3600000;0
14180;-1;220;0;0;0;0;.00nan;0;0
14180;187355;179;75;39;3;36;.923;3575000;0
14182;184133;230;0;0;0;0;.00nan;0;0
14182;184650;4864;0;0;0;0;.00nan;0;0
14182;181338;230;81;11;0;11;1.000;3600000;0
14182;186332;4864;38;49;7;42;.857;3600000;0
14184;198147;176;0;0;0;0;.00nan;0;0
14184;206801;176;90;34;2;32;.941;3600000;0
14184;196283;206;48;18;2;16;.889;2566000;0
14184;202998;206;29;15;4;11;.733;1034000;0
14186;194950;1505;0;0;0;0;.00nan;0;0
14186;186549;1505;93;21;0;21;1.000;3600000;0
14186;192461;210;42;31;5;26;.839;3600000;0
14186;197672;210;0;0;0;0;.00nan;0;0
14188;198149;188;0;0;0;0;.00nan;0;0
14188;192939;208;93;44;3;41;.932;3900000;0
14188;200380;208;0;0;0;0;.00nan;0;0
14188;184409;188;69;25;3;22;.880;3899000;0
14190;179499;186;63;30;4;26;.867;3900000;0
14190;190098;186;0;0;0;0;.00nan;0;0
14190;-1;181;62;33;4;29;.879;3900000;0
14190;192552;181;0;0;0;0;.00nan;0;0
14192;187628;227;73;30;2;28;.933;3600000;0
14192;189081;187;87;52;4;48;.923;3600000;0
14192;187217;227;0;0;0;0;.00nan;0;0
14192;-1;187;0;0;0;0;.00nan;0;0
14194;200437;201;65;37;4;33;.892;3600000;0
14194;195251;4949;97;23;0;23;1.000;3600000;0
14194;-1;201;0;0;0;0;.00nan;0;0
14194;197685;4949;0;0;0;0;.00nan;0;0
14196;201524;205;69;31;3;28;.903;2421000;0
14196;179679;212;32;14;4;10;.714;1063000;0
14196;-1;205;26;14;4;10;.714;1111000;0
14196;-1;212;72;23;1;22;.957;2537000;0
14198;206975;192;0;0;0;0;.00nan;0;0
14198;180377;228;22;28;6;22;.786;3573000;0
14198;207398;192;43;19;4;15;.789;3600000;0
14198;208044;228;0;0;0;0;.00nan;0;0
14200;203383;232;50;34;5;29;.853;3600000;0
14200;183695;232;0;0;0;0;.00nan;0;0
14200;190034;217;0;0;0;0;.00nan;0;0
14200;190041;217;100;36;0;36;1.000;3600000;0
14202;182467;185;26;31;7;24;.774;2771000;0
14202;189885;225;28;21;5;16;.762;3600000;0
14202;-1;225;0;0;0;0;.00nan;0;0
14202;-1;185;70;11;0;11;1.000;829000;0
14204;200306;182;0;0;0;0;.00nan;0;0
14204;201560;202;67;23;3;20;.870;3900000;0
14204;196299;202;0;0;0;0;.00nan;0;0
14204;185810;182;88;48;3;45;.938;3892000;0
14206;195164;218;53;36;5;31;.861;3567000;0
14206;184525;198;0;0;0;0;.00nan;0;0
14206;184788;198;60;38;4;34;.895;3600000;0
14206;190095;218;0;0;0;0;.00nan;0;0
14208;185800;229;100;26;0;26;1.000;3600000;0
14208;185960;229;0;0;0;0;.00nan;0;0
14208;-1;209;88;27;1;26;.963;3582000;0
14208;203063;209;0;0;0;0;.00nan;0;0
14210;205788;207;0;0;0;0;.00nan;0;0
14210;-1;207;68;31;2;29;.935;3542000;0
14210;192547;190;0;0;0;0;.00nan;0;0
14210;197704;190;78;13;0;13;1.000;3600000;0
14212;205743;2620;0;0;0;0;.00nan;0;0
14212;189773;231;77;22;1;21;.955;3600000;0
14212;206955;231;0;0;0;0;.00nan;0;0
14212;-1;2620;96;50;2;48;.960;3600000;0
14214;-1;1371;0;0;0;0;.00nan;0;0
14214;-1;189;0;0;0;0;.00nan;0;0
14214;192688;1371;95;32;1;31;.969;3600000;0
14214;-1;189;64;36;4;32;.889;3600000;0
14216;184175;224;49;36;5;31;.861;3549000;0
14216;182128;215;0;0;0;0;.00nan;0;0
14216;185840;224;0;0;0;0;.00nan;0;0
14216;-1;215;73;35;3;32;.914;3600000;0
14218;200440;204;0;0;0;0;.00nan;0;0
14218;189529;193;99;21;0;21;1.000;3600000;0
14218;189902;204;41;29;5;24;.828;3600000;0
14218;186451;193;0;0;0;0;.00nan;0;0
14220;196571;177;58;31;4;27;.871;3600000;0
14220;-1;178;94;43;2;41;.953;3600000;0
14220;-1;178;0;0;0;0;.00nan;0;0
14220;-1;177;0;0;0;0;.00nan;0;0
14222;201525;203;38;25;4;21;.840;3600000;0
14222;191078;203;0;0;0;0;.00nan;0;0
14222;-1;180;100;42;2;40;.952;3600000;0
14222;197707;180;0;0;0;0;.00nan;0;0
14224;-1;216;71;29;2;27;.931;3574000;0
14224;192629;226;82;33;1;32;.970;3600000;0
14224;-1;226;0;0;0;0;.00nan;0;0
14224;-1;216;0;0;0;0;.00nan;0;0
14226;198074;195;0;0;0;0;.00nan;0;0
14226;199416;191;0;0;0;0;.00nan;0;0
14226;194893;191;90;28;1;27;.964;3600000;0
14226;207061;195;76;38;3;35;.921;3542000;0
14228;190164;4959;63;21;2;19;.905;3600000;0
14228;-1;199;42;20;4;16;.800;3536000;0
14228;-1;4959;0;0;0;0;.00nan;0;0
14228;-1;199;0;0;0;0;.00nan;0;0
14230;182324;4960;0;0;0;0;.00nan;0;0
14230;194219;4960;27;22;5;17;.773;3562000;0
14230;184610;222;93;50;4;46;.920;3600000;0
14230;185851;222;0;0;0;0;.00nan;0;0
14232;195238;200;0;0;0;0;.00nan;0;0
14232;-1;200;76;25;1;24;.960;3600000;0
14232;-1;214;0;0;0;0;.00nan;0;0
14232;191518;214;63;33;3;30;.909;3529000;0
14234;200333;194;0;0;0;0;.00nan;0;0
14234;184648;196;83;29;1;28;.966;3600000;0
14234;196352;194;40;35;5;30;.857;3600000;0
14234;191118;196;0;0;0;0;.00nan;0;0
14236;200452;221;88;35;2;33;.943;3600000;0
14236;191120;223;0;0;0;0;.00nan;0;0
14236;187118;223;68;36;3;33;.917;3578000;0
14236;187431;221;0;0;0;0;.00nan;0;0
14238;205743;2620;0;0;0;0;.00nan;0;0
14238;201585;197;96;22;0;22;1.000;3600000;0
14238;206822;197;0;0;0;0;.00nan;0;0
14238;-1;2620;69;29;2;27;.931;3533000;0
14240;198147;176;0;0;0;0;.00nan;0;0
14240;200440;204;0;0;0;0;.00nan;0;0
14240;189902;204;62;30;4;26;.867;3600000;0
14240;206801;176;100;31;0;31;1.000;3600000;0
14242;201525;203;32;28;6;22;.786;2175000;0
14242;196571;177;0;0;0;0;.00nan;0;0
14242;191078;203;66;12;0;12;1.000;1425000;0
14242;-1;177;87;23;1;22;.957;3600000;0
14244;192939;208;0;0;0;0;.00nan;0;0
14244;200380;208;78;56;5;51;.911;3600000;0
14244;189529;193;100;28;0;28;1.000;3600000;0
14244;186451;193;0;0;0;0;.00nan;0;0
14246;184648;196;94;21;0;21;1.000;3600000;0
14246;191118;196;0;0;0;0;.00nan;0;0
14246;-1;180;88;35;1;34;.971;3568000;0
14246;197707;180;0;0;0;0;.00nan;0;0
14248;-1;216;66;28;2;26;.929;3600000;0
14248;-1;209;76;26;1;25;.962;2708000;0
14248;203063;209;37;19;4;15;.789;892000;0
14248;-1;216;0;0;0;0;.00nan;0;0
14250;201560;202;90;20;0;20;1.000;3600000;0
14250;180377;228;0;0;0;0;.00nan;0;0
14250;196299;202;0;0;0;0;.00nan;0;0
14250;208044;228;68;36;3;33;.917;3600000;0
14252;189885;225;0;0;0;0;.00nan;0;0
14252;184650;4864;0;0;0;0;.00nan;0;0
14252;-1;225;64;21;2;19;.905;3600000;0
14252;186332;4864;24;30;6;24;.800;3600000;0
14254;203383;232;76;23;1;22;.957;3600000;0
14254;183695;232;0;0;0;0;.00nan;0;0
14254;-1;181;92;42;2;40;.952;3590000;0
14254;192552;181;0;0;0;0;.00nan;0;0
14256;-1;189;0;0;0;0;.00nan;0;0
14256;-1;199;58;44;6;38;.864;3600000;0
14256;-1;189;70;24;2;22;.917;3600000;0
14256;-1;199;0;0;0;0;.00nan;0;0
14258;200306;182;0;0;0;0;.00nan;0;0
14258;200437;201;58;26;3;23;.885;3600000;0
14258;185810;182;56;37;5;32;.865;3546000;0
14258;-1;201;0;0;0;0;.00nan;0;0
14260;184525;198;0;0;0;0;.00nan;0;0
14260;184788;198;69;23;2;21;.913;3600000;0
14260;196283;206;88;48;3;45;.938;3600000;0
14260;202998;206;0;0;0;0;.00nan;0;0
14262;195238;200;40;37;6;31;.838;3600000;0
14262;-1;200;0;0;0;0;.00nan;0;0
14262;-1;214;0;0;0;0;.00nan;0;0
14262;191518;214;78;29;2;27;.931;3600000;0
14264;179679;212;0;0;0;0;.00nan;0;0
14264;182128;215;82;42;3;39;.929;3521000;0
14264;-1;212;98;33;1;32;.970;3600000;0
14264;-1;215;0;0;0;0;.00nan;0;0
14266;199416;191;0;0;0;0;.00nan;0;0
14266;194893;191;46;21;3;18;.857;3900000;0
14266;205837;184;96;52;3;49;.942;3900000;0
14266;190125;184;0;0;0;0;.00nan;0;0
14268;194950;1505;0;0;0;0;.00nan;0;0
14268;186549;1505;59;14;1;13;.929;3600000;0
14268;-1;178;61;12;0;12;1.000;1267000;0
14268;-1;178;65;48;6;42;.875;2333000;0
14270;192915;179;70;35;3;32;.914;3600000;0
14270;185800;229;84;35;2;33;.943;3600000;0
14270;185960;229;0;0;0;0;.00nan;0;0
14270;187355;179;0;0;0;0;.00nan;0;0
14272;183686;213;0;0;0;0;.00nan;0;0
14272;189773;231;60;29;5;24;.828;3678000;0
14272;201495;213;34;19;4;15;.789;3678000;0
14272;206955;231;0;0;0;0;.00nan;0;0
14274;195251;4949;100;34;1;33;.971;3600000;0
14274;192461;210;89;35;2;33;.943;3543000;0
14274;197672;210;0;0;0;0;.00nan;0;0
14274;197685;4949;0;0;0;0;.00nan;0;0
14276;189081;187;0;0;0;0;.00nan;0;0
14276;195164;218;63;23;2;21;.913;3600000;0
14276;190095;218;0;0;0;0;.00nan;0;0
14276;-1;187;99;35;1;34;.971;3600000;0
14278;184133;230;0;0;0;0;.00nan;0;0
14278;205788;207;0;0;0;0;.00nan;0;0
14278;-1;207;100;52;2;50;.962;3600000;0
14278;181338;230;47;29;4;25;.862;3538000;0
14280;182324;4960;0;0;0;0;.00nan;0;0
14280;194219;4960;70;23;1;22;.957;3600000;0
14280;206975;192;0;0;0;0;.00nan;0;0
14280;207398;192;54;36;4;32;.889;3600000;0
14282;198149;188;0;0;0;0;.00nan;0;0
14282;184409;188;75;27;2;25;.926;3600000;0
14282;184785;211;0;0;0;0;.00nan;0;0
14282;179646;211;61;36;4;32;.889;3514000;0
14284;-1;1371;0;0;0;0;.00nan;0;0
14284;191120;223;0;0;0;0;.00nan;0;0
14284;187118;223;71;35;3;32;.914;3864000;0
14284;192688;1371;99;48;2;46;.958;3864000;0
14286;200452;221;93;35;1;34;.971;3655000;0
14286;190164;4959;0;0;0;0;.00nan;0;0
14286;187431;221;0;0;0;0;.00nan;0;0
14286;-1;4959;76;31;2;29;.935;3655000;0
14288;198074;195;0;0;0;0;.00nan;0;0
14288;182467;185;0;0;0;0;.00nan;0;0
14288;207061;195;55;9;1;8;.889;3600000;0
14288;-1;185;62;41;5;36;.878;3600000;0
14290;184175;224;74;26;2;24;.923;3600000;0
14290;-1;219;78;32;3;29;.906;3559000;0
14290;-1;219;0;0;0;0;.00nan;0;0
14290;185840;224;0;0;0;0;.00nan;0;0
14292;-1;183;38;40;6;34;.850;3095000;0
14292;180574;183;51;2;0;2;1.000;505000;0
14292;192629;226;68;17;1;16;.941;3600000;0
14292;-1;226;0;0;0;0;.00nan;0;0
14294;184610;222;62;27;3;24;.889;3600000;0
14294;179499;186;0;0;0;0;.00nan;0;0
14294;190098;186;28;23;5;18;.783;3573000;0
14294;185851;222;0;0;0;0;.00nan;0;0
14296;201524;205;0;0;0;0;.00nan;0;0
14296;-1;205;74;22;1;21;.955;3600000;0
14296;-1;220;49;7;1;6;.857;892000;0
14296;-1;220;57;57;8;49;.860;2708000;0
14298;200333;194;0;0;0;0;.00nan;0;0
14298;196352;194;54;33;4;29;.879;3600000;0
14298;192547;190;0;0;0;0;.00nan;0;0
14298;197704;190;86;29;1;28;.966;3600000;0
14300;187628;227;88;30;2;28;.933;3600000;0
14300;190034;217;0;0;0;0;.00nan;0;0
14300;190041;217;88;37;3;34;.919;3545000;0
14300;187217;227;0;0;0;0;.00nan;0;0
14302;194950;1505;75;20;1;19;.950;3600000;0
14302;184648;196;77;43;3;40;.930;3532000;0
14302;186549;1505;0;0;0;0;.00nan;0;0
14302;191118;196;0;0;0;0;.00nan;0;0
14304;189081;187;51;19;3;16;.842;3600000;0
14304;182128;215;61;7;0;7;1.000;422000;0
14304;-1;187;0;0;0;0;.00nan;0;0
14304;-1;215;47;45;6;39;.867;3178000;0
14306;200306;182;74;59;6;53;.898;3320000;0
14306;205837;184;0;0;0;0;.00nan;0;0
14306;190125;184;57;28;3;25;.893;3600000;0
14306;185810;182;51;9;1;8;.889;280000;0
14308;184525;198;70;37;3;34;.919;3900000;0
14308;190034;217;93;42;3;39;.929;3900000;0
14308;190041;217;0;0;0;0;.00nan;0;0
14308;184788;198;0;0;0;0;.00nan;0;0
14310;-1;220;59;34;4;30;.882;3578000;0
14310;-1;220;0;0;0;0;.00nan;0;0
14310;-1;199;0;0;0;0;.00nan;0;0
14310;-1;199;71;30;3;27;.900;3600000;0
14312;184175;224;68;30;2;28;.933;3600000;0
14312;185840;224;0;0;0;0;.00nan;0;0
14312;192547;190;58;25;3;22;.880;3560000;0
14312;197704;190;0;0;0;0;.00nan;0;0
14314;201585;197;72;34;3;31;.912;3600000;0
14314;206822;197;0;0;0;0;.00nan;0;0
14314;196283;206;0;0;0;0;.00nan;0;0
14314;202998;206;61;39;4;35;.897;3592000;0
14316;192915;179;0;0;0;0;.00nan;0;0
14316;195238;200;0;0;0;0;.00nan;0;0
14316;-1;200;67;23;2;21;.913;3600000;0
14316;187355;179;44;32;5;27;.844;3600000;0
14318;201525;203;0;0;0;0;.00nan;0;0
14318;179679;212;60;38;4;34;.895;3549000;0
14318;191078;203;58;27;3;24;.889;3600000;0
14318;-1;212;0;0;0;0;.00nan;0;0
14320;200440;204;99;29;0;29;1.000;3600000;0
14320;189902;204;0;0;0;0;.00nan;0;0
14320;190164;4959;67;37;4;33;.892;3600000;0
14320;-1;4959;0;0;0;0;.00nan;0;0
14322;198074;195;62;23;2;21;.913;3600000;0
14322;207061;195;0;0;0;0;.00nan;0;0
14322;180377;228;78;54;5;49;.907;3600000;0
14322;208044;228;0;0;0;0;.00nan;0;0
14324;198149;188;53;19;3;16;.842;3600000;0
14324;184409;188;0;0;0;0;.00nan;0;0
14324;184785;211;88;59;5;54;.915;3562000;0
14324;179646;211;0;0;0;0;.00nan;0;0
14326;200437;201;0;0;0;0;.00nan;0;0
14326;-1;1371;0;0;0;0;.00nan;0;0
14326;192688;1371;82;47;5;42;.894;3600000;0
14326;-1;201;61;20;2;18;.900;3600000;0
14328;189885;225;58;33;4;29;.879;3600000;0
14328;179499;186;82;12;0;12;1.000;3600000;0
14328;190098;186;0;0;0;0;.00nan;0;0
14328;-1;225;0;0;0;0;.00nan;0;0
14330;182467;185;54;41;5;36;.878;3600000;0
14330;201560;202;41;19;4;15;.789;3600000;0
14330;196299;202;0;0;0;0;.00nan;0;0
14330;-1;185;0;0;0;0;.00nan;0;0
14332;201524;205;63;15;1;14;.933;3600000;0
14332;-1;205;0;0;0;0;.00nan;0;0
14332;185800;229;0;0;0;0;.00nan;0;0
14332;185960;229;72;41;4;37;.902;3600000;0
14334;-1;219;47;35;5;30;.857;3171000;0
14334;206975;192;91;32;1;31;.969;3600000;0
14334;207398;192;0;0;0;0;.00nan;0;0
14334;-1;219;34;12;3;9;.750;429000;0
14336;198147;176;0;0;0;0;.00nan;0;0
14336;206801;176;83;35;2;33;.943;3600000;0
14336;-1;181;0;0;0;0;.00nan;0;0
14336;192552;181;48;34;5;29;.853;3600000;0
14338;182324;4960;72;29;3;26;.897;3560000;0
14338;194219;4960;0;0;0;0;.00nan;0;0
14338;183686;213;68;24;2;22;.917;3600000;0
14338;201495;213;0;0;0;0;.00nan;0;0
14340;184133;230;84;23;1;22;.957;3600000;0
14340;181338;230;0;0;0;0;.00nan;0;0
14340;191120;223;88;44;3;41;.932;3600000;0
14340;187118;223;0;0;0;0;.00nan;0;0
14342;187628;227;0;0;0;0;.00nan;0;0
14342;195251;4949;0;0;0;0;.00nan;0;0
14342;187217;227;87;42;3;39;.929;3600000;0
14342;197685;4949;39;39;7;32;.821;3600000;0
14344;200333;194;67;17;1;16;.941;3600000;0
14344;196352;194;0;0;0;0;.00nan;0;0
14344;-1;214;50;26;4;22;.846;3600000;0
14344;191518;214;0;0;0;0;.00nan;0;0
14346;203383;232;0;0;0;0;.00nan;0;0
14346;183695;232;80;34;3;31;.912;3600000;0
14346;200452;221;0;0;0;0;.00nan;0;0
14346;187431;221;58;38;5;33;.868;3550000;0
14348;-1;216;0;0;0;0;.00nan;0;0
14348;-1;209;0;0;0;0;.00nan;0;0
14348;203063;209;73;55;5;50;.909;3827000;0
14348;-1;216;34;21;4;17;.810;3826000;0
14350;205788;207;58;34;4;30;.882;3534000;0
14350;195164;218;0;0;0;0;.00nan;0;0
14350;190095;218;60;20;2;18;.900;3600000;0
14350;-1;207;0;0;0;0;.00nan;0;0
14352;192939;208;86;19;0;19;1.000;3600000;0
14352;200380;208;0;0;0;0;.00nan;0;0
14352;-1;178;0;0;0;0;.00nan;0;0
14352;-1;178;91;39;1;38;.974;3580000;0
14354;196571;177;100;26;0;26;1.000;3600000;0
14354;-1;180;0;0;0;0;.00nan;0;0
14354;197707;180;67;26;2;24;.923;3552000;0
14354;-1;177;0;0;0;0;.00nan;0;0
14356;189529;193;81;35;2;33;.943;3600000;0
14356;186451;193;0;0;0;0;.00nan;0;0
14356;192461;210;0;0;0;0;.00nan;0;0
14356;197672;210;73;42;4;38;.905;3590000;0
14358;184610;222;57;4;0;4;1.000;361000;0
14358;185851;222;15;34;8;26;.765;3239000;0
14358;-1;189;63;22;3;19;.864;3600000;0
14358;-1;189;0;0;0;0;.00nan;0;0
14360;184650;4864;92;37;2;35;.946;3600000;0
14360;186332;4864;0;0;0;0;.00nan;0;0
14360;192629;226;0;0;0;0;.00nan;0;0
14360;-1;226;41;32;5;27;.844;3600000;0
14362;189773;231;0;0;0;0;.00nan;0;0
14362;-1;183;0;0;0;0;.00nan;0;0
14362;206955;231;68;19;1;18;.947;3600000;0
14362;180574;183;61;38;4;34;.895;3600000;0
14364;199416;191;36;20;4;16;.800;3600000;0
14364;194893;191;0;0;0;0;.00nan;0;0
14364;205743;2620;79;60;5;55;.917;3592000;0
14364;-1;2620;0;0;0;0;.00nan;0;0
14366;195164;218;87;29;1;28;.966;3600000;0
14366;190095;218;0;0;0;0;.00nan;0;0
14366;-1;180;63;36;4;32;.889;3600000;0
14366;197707;180;0;0;0;0;.00nan;0;0
14368;198147;176;82;30;1;29;.967;3600000;0
14368;205788;207;0;0;0;0;.00nan;0;0
14368;206801;176;0;0;0;0;.00nan;0;0
14368;-1;207;96;24;0;24;1.000;3600000;0
14370;192939;208;59;44;5;39;.886;2180000;0
14370;200380;208;59;16;2;14;.875;1420000;0
14370;189529;193;0;0;0;0;.00nan;0;0
14370;186451;193;94;16;0;16;1.000;3600000;0
14372;198074;195;0;0;0;0;.00nan;0;0
14372;201525;203;100;46;0;46;1.000;3600000;0
14372;207061;195;58;10;1;9;.900;3557000;0
14372;191078;203;0;0;0;0;.00nan;0;0
14374;192915;179;0;0;0;0;.00nan;0;0
14374;-1;1371;0;0;0;0;.00nan;0;0
14374;187355;179;64;29;3;26;.897;3600000;0
14374;192688;1371;66;33;4;29;.879;3541000;0
14376;199416;191;73;19;1;18;.947;3600000;0
14376;194893;191;0;0;0;0;.00nan;0;0
14376;-1;183;54;44;6;38;.864;3600000;0
14376;180574;183;0;0;0;0;.00nan;0;0
14378;-1;219;55;14;2;12;.857;3600000;0
14378;-1;219;0;0;0;0;.00nan;0;0
14378;-1;178;38;51;9;42;.824;3600000;0
14378;-1;178;0;0;0;0;.00nan;0;0
14380;195251;4949;47;35;5;30;.857;3591000;0
14380;192629;226;54;22;3;19;.864;3600000;0
14380;-1;226;0;0;0;0;.00nan;0;0
14380;197685;4949;0;0;0;0;.00nan;0;0
14382;182467;185;0;0;0;0;.00nan;0;0
14382;-1;185;76;44;4;40;.909;3600000;0
14382;192461;210;58;16;2;14;.875;3600000;0
14382;197672;210;0;0;0;0;.00nan;0;0
14384;184648;196;66;16;1;15;.938;3600000;0
14384;190164;4959;0;0;0;0;.00nan;0;0
14384;191118;196;0;0;0;0;.00nan;0;0
14384;-1;4959;37;36;6;30;.833;3600000;0
14386;201560;202;0;0;0;0;.00nan;0;0
14386;196299;202;51;26;3;23;.885;3600000;0
14386;182128;215;0;0;0;0;.00nan;0;0
14386;-1;215;83;37;2;35;.946;3600000;0
14388;184175;224;74;26;1;25;.962;3600000;0
14388;185840;224;0;0;0;0;.00nan;0;0
14388;-1;199;70;35;3;32;.914;3590000;0
14388;-1;199;0;0;0;0;.00nan;0;0
14390;200452;221;75;35;3;32;.914;3855000;0
14390;185800;229;85;31;2;29;.935;3855000;0
14390;185960;229;0;0;0;0;.00nan;0;0
14390;187431;221;0;0;0;0;.00nan;0;0
14392;189081;187;0;0;0;0;.00nan;0;0
14392;196571;177;95;37;2;35;.946;3600000;0
14392;-1;187;63;19;1;18;.947;3600000;0
14392;-1;177;0;0;0;0;.00nan;0;0
14394;189773;231;57;20;2;18;.900;3600000;0
14394;184785;211;0;0;0;0;.00nan;0;0
14394;179646;211;61;42;4;38;.905;3579000;0
14394;206955;231;0;0;0;0;.00nan;0;0
14396;183686;213;52;3;0;3;1.000;355000;0
14396;201495;213;36;33;6;27;.818;3245000;0
14396;196283;206;0;0;0;0;.00nan;0;0
14396;202998;206;91;19;0;19;1.000;3600000;0
14398;184133;230;0;0;0;0;.00nan;0;0
14398;180377;228;0;0;0;0;.00nan;0;0
14398;181338;230;49;14;2;12;.857;3548000;0
14398;208044;228;81;28;1;27;.964;3600000;0
14400;194950;1505;0;0;0;0;.00nan;0;0
14400;184650;4864;0;0;0;0;.00nan;0;0
14400;186332;4864;94;43;2;41;.953;3600000;0
14400;186549;1505;59;28;3;25;.893;3565000;0
14402;200440;204;43;25;4;21;.840;3594000;0
14402;189902;204;0;0;0;0;.00nan;0;0
14402;-1;209;96;40;2;38;.950;3600000;0
14402;203063;209;0;0;0;0;.00nan;0;0
14404;184610;222;71;45;4;41;.911;3594000;0
14404;185851;222;0;0;0;0;.00nan;0;0
14404;191120;223;0;0;0;0;.00nan;0;0
14404;187118;223;67;22;2;20;.909;3600000;0
14406;189885;225;0;0;0;0;.00nan;0;0
14406;201585;197;48;19;3;16;.842;3517000;0
14406;206822;197;0;0;0;0;.00nan;0;0
14406;-1;225;100;32;1;31;.969;3600000;0
14408;201524;205;0;0;0;0;.00nan;0;0
14408;-1;205;70;29;3;26;.897;3710000;0
14408;-1;189;77;29;2;27;.931;3710000;0
14408;-1;189;0;0;0;0;.00nan;0;0
14410;198149;188;0;0;0;0;.00nan;0;0
14410;187628;227;76;27;2;25;.926;3600000;0
14410;184409;188;31;21;5;16;.762;3600000;0
14410;187217;227;0;0;0;0;.00nan;0;0
14412;205837;184;0;0;0;0;.00nan;0;0
14412;190125;184;70;25;2;23;.920;3600000;0
14412;-1;220;0;0;0;0;.00nan;0;0
14412;-1;220;74;48;4;44;.917;3569000;0
14414;-1;216;82;37;2;35;.946;3600000;0
14414;206975;192;0;0;0;0;.00nan;0;0
14414;207398;192;47;30;4;26;.867;3600000;0
14414;-1;216;0;0;0;0;.00nan;0;0
14416;182324;4960;72;33;3;30;.909;3637000;0
14416;203383;232;53;24;4;20;.833;3637000;0
14416;194219;4960;0;0;0;0;.00nan;0;0
14416;183695;232;0;0;0;0;.00nan;0;0
14418;200333;194;0;0;0;0;.00nan;0;0
14418;190034;217;0;0;0;0;.00nan;0;0
14418;190041;217;71;19;1;18;.947;3600000;0
14418;196352;194;53;41;5;36;.878;3600000;0
14420;200306;182;0;0;0;0;.00nan;0;0
14420;-1;181;70;41;5;36;.878;3600000;0
14420;185810;182;72;15;1;14;.933;3600000;0
14420;192552;181;0;0;0;0;.00nan;0;0
14422;195238;200;94;18;0;18;1.000;3600000;0
14422;-1;200;0;0;0;0;.00nan;0;0
14422;-1;214;0;0;0;0;.00nan;0;0
14422;191518;214;88;35;1;34;.971;3598000;0
14424;205743;2620;0;0;0;0;.00nan;0;0
14424;179499;186;78;37;2;35;.946;3600000;0
14424;190098;186;0;0;0;0;.00nan;0;0
14424;-1;2620;75;34;3;31;.912;3596000;0
14426;184525;198;0;0;0;0;.00nan;0;0
14426;184788;198;90;24;1;23;.958;3600000;0
14426;179679;212;64;16;1;15;.938;1487000;0
14426;-1;212;33;19;4;15;.789;2113000;0
14428;200437;201;0;0;0;0;.00nan;0;0
14428;192547;190;0;0;0;0;.00nan;0;0
14428;-1;201;75;31;2;29;.935;3552000;0
14428;197704;190;91;29;1;28;.966;3600000;0
14429;181748;714;43;19;4;15;.789;3600000;0
14429;145636;714;0;0;0;0;.00nan;0;0
14429;145787;2473;0;0;0;0;.00nan;0;0
14429;148503;2473;31;30;6;24;.800;3556000;0
14430;5997;2474;0;0;0;0;.00nan;0;0
14430;26308;706;86;13;0;13;1.000;3600000;0
14430;72229;2474;64;44;5;39;.886;3600000;0
14430;156932;706;0;0;0;0;.00nan;0;0
14431;1213;713;63;20;2;18;.900;3600000;0
14431;8478;713;0;0;0;0;.00nan;0;0
14431;180990;710;64;48;6;42;.875;3210000;0
14431;81085;710;30;2;2;0;.000;390000;0
14432;-1;711;0;0;0;0;.00nan;0;0
14432;-1;707;0;0;0;0;.00nan;0;0
14432;44200;711;88;19;0;19;1.000;3600000;0
14432;145843;707;89;35;1;34;.971;3556000;0
14433;-1;2465;64;34;3;31;.912;3600000;0
14433;43925;712;100;31;0;31;1.000;3600000;0
14433;70115;2465;0;0;0;0;.00nan;0;0
14433;160866;712;0;0;0;0;.00nan;0;0
14434;-1;711;0;0;0;0;.00nan;0;0
14434;26308;706;72;47;5;42;.894;3600000;0
14434;44200;711;72;20;1;19;.950;3600000;0
14434;156932;706;0;0;0;0;.00nan;0;0
14435;43925;712;100;33;1;32;.970;3900000;0
14435;85507;2473;0;0;0;0;.00nan;0;0
14435;148503;2473;96;35;1;34;.971;3900000;0
14435;160866;712;0;0;0;0;.00nan;0;0
14436;26308;706;63;37;5;32;.865;3554000;0
14436;180990;710;69;37;4;33;.892;3600000;0
14436;81085;710;0;0;0;0;.00nan;0;0
14436;156932;706;0;0;0;0;.00nan;0;0
14437;5997;2474;0;0;0;0;.00nan;0;0
14437;-1;707;55;48;6;42;.875;3600000;0
14437;72229;2474;62;22;3;19;.864;3600000;0
14437;145843;707;0;0;0;0;.00nan;0;0
14438;1213;713;75;34;4;30;.882;3600000;0
14438;8478;713;0;0;0;0;.00nan;0;0
14438;-1;2465;39;27;5;22;.815;3600000;0
14438;70115;2465;0;0;0;0;.00nan;0;0
14439;-1;711;0;0;0;0;.00nan;0;0
14439;181748;714;0;0;0;0;.00nan;0;0
14439;44200;711;84;13;0;13;1.000;3600000;0
14439;145636;714;90;38;2;36;.947;3549000;0
14440;26308;706;53;14;2;12;.857;3600000;0
14440;43925;712;58;44;6;38;.864;3600000;0
14440;156932;706;0;0;0;0;.00nan;0;0
14440;160866;712;0;0;0;0;.00nan;0;0
14441;-1;711;0;0;0;0;.00nan;0;0
14441;44200;711;89;27;2;25;.926;3600000;0
14441;85507;2473;0;0;0;0;.00nan;0;0
14441;148503;2473;59;26;3;23;.885;3544000;0
14442;5997;2474;85;36;2;34;.944;3600000;0
14442;-1;2465;0;0;0;0;.00nan;0;0
14442;70115;2465;41;22;4;18;.818;3543000;0
14442;72229;2474;0;0;0;0;.00nan;0;0
14443;1213;713;100;24;0;24;1.000;3600000;0
14443;8478;713;0;0;0;0;.00nan;0;0
14443;181748;714;0;0;0;0;.00nan;0;0
14443;145636;714;75;37;2;35;.946;3575000;0
14444;180990;710;0;0;0;0;.00nan;0;0
14444;-1;707;81;48;4;44;.917;3600000;0
14444;81085;710;58;25;3;22;.880;3600000;0
14444;145843;707;0;0;0;0;.00nan;0;0
14445;-1;2465;55;16;2;14;.875;3600000;0
14445;-1;707;55;37;5;32;.865;3600000;0
14445;70115;2465;0;0;0;0;.00nan;0;0
14445;145843;707;0;0;0;0;.00nan;0;0
14446;1213;713;40;26;4;22;.846;3553000;0
14446;8478;713;0;0;0;0;.00nan;0;0
14446;85507;2473;69;31;3;28;.903;3600000;0
14446;148503;2473;0;0;0;0;.00nan;0;0
14447;-1;711;0;0;0;0;.00nan;0;0
14447;43925;712;88;38;2;36;.947;3600000;0
14447;44200;711;31;17;4;13;.765;3551000;0
14447;160866;712;0;0;0;0;.00nan;0;0
14448;-1;2465;88;35;2;33;.943;3600000;0
14448;180990;710;72;22;1;21;.955;3600000;0
14448;70115;2465;0;0;0;0;.00nan;0;0
14448;81085;710;0;0;0;0;.00nan;0;0
14449;5997;2474;0;0;0;0;.00nan;0;0
14449;181748;714;0;0;0;0;.00nan;0;0
14449;72229;2474;71;43;4;39;.907;3583000;0
14449;145636;714;50;20;3;17;.850;3600000;0
14450;26308;706;58;20;3;17;.850;3900000;0
14450;-1;707;0;0;0;0;.00nan;0;0
14450;145843;707;73;30;3;27;.900;3900000;0
14450;156932;706;0;0;0;0;.00nan;0;0
14451;180990;710;62;31;3;28;.903;3900000;0
14451;181748;714;79;36;3;33;.917;3900000;0
14451;81085;710;0;0;0;0;.00nan;0;0
14451;145636;714;0;0;0;0;.00nan;0;0
14452;1213;713;46;24;4;20;.833;3600000;0
14452;8478;713;0;0;0;0;.00nan;0;0
14452;43925;712;60;37;5;32;.865;3554000;0
14452;160866;712;0;0;0;0;.00nan;0;0
14453;-1;711;0;0;0;0;.00nan;0;0
14453;26308;706;94;42;2;40;.952;3643000;0
14453;44200;711;74;17;1;16;.941;3643000;0
14453;156932;706;0;0;0;0;.00nan;0;0
14454;5997;2474;54;4;0;4;1.000;501000;0
14454;72229;2474;36;26;6;20;.769;3099000;0
14454;85507;2473;0;0;0;0;.00nan;0;0
14454;148503;2473;100;26;0;26;1.000;3600000;0
14455;-1;2465;100;24;0;24;1.000;3600000;0
14455;-1;707;67;27;2;25;.926;3546000;0
14455;70115;2465;0;0;0;0;.00nan;0;0
14455;145843;707;0;0;0;0;.00nan;0;0
14456;1213;713;61;14;2;12;.857;3600000;0
14456;5997;2474;96;53;4;49;.925;3595000;0
14456;8478;713;0;0;0;0;.00nan;0;0
14456;72229;2474;0;0;0;0;.00nan;0;0
14457;180990;710;72;25;2;23;.920;3600000;0
14457;81085;710;0;0;0;0;.00nan;0;0
14457;85507;2473;53;11;1;10;.909;651000;0
14457;148503;2473;33;46;8;38;.826;2949000;0
14458;1213;713;52;31;5;26;.839;3599000;0
14458;8478;713;0;0;0;0;.00nan;0;0
14458;-1;711;0;0;0;0;.00nan;0;0
14458;44200;711;41;22;4;18;.818;3600000;0
14459;5997;2474;70;31;3;28;.903;3600000;0
14459;43925;712;0;0;0;0;.00nan;0;0
14459;72229;2474;0;0;0;0;.00nan;0;0
14459;160866;712;62;43;5;38;.884;3600000;0
14460;26308;706;88;32;1;31;.969;3900000;0
14460;-1;2465;77;21;1;20;.952;3900000;0
14460;70115;2465;0;0;0;0;.00nan;0;0
14460;156932;706;0;0;0;0;.00nan;0;0
14461;181748;714;0;0;0;0;.00nan;0;0
14461;-1;707;0;0;0;0;.00nan;0;0
14461;145636;714;51;10;1;9;.900;3600000;0
14461;145843;707;88;50;4;46;.920;3600000;0
14462;5997;2474;0;0;0;0;.00nan;0;0
14462;-1;711;48;19;3;16;.842;3582000;0
14462;44200;711;0;0;0;0;.00nan;0;0
14462;72229;2474;100;41;2;39;.951;3600000;0
14463;-1;707;37;24;5;19;.792;2327000;0
14463;85507;2473;0;0;0;0;.00nan;0;0
14463;145843;707;65;28;3;25;.893;1273000;0
14463;148503;2473;82;24;1;23;.958;3600000;0
14464;-1;2465;53;2;0;2;1.000;577000;0
14464;181748;714;55;19;2;17;.895;3600000;0
14464;70115;2465;17;23;6;17;.739;3023000;0
14464;145636;714;0;0;0;0;.00nan;0;0
14465;1213;713;95;40;4;36;.900;3900000;0
14465;8478;713;0;0;0;0;.00nan;0;0
14465;26308;706;82;38;4;34;.895;3900000;0
14465;156932;706;0;0;0;0;.00nan;0;0
14466;180990;710;0;0;0;0;.00nan;0;0
14466;43925;712;100;46;1;45;.978;3600000;0
14466;81085;710;60;21;2;19;.905;3569000;0
14466;160866;712;0;0;0;0;.00nan;0;0
14467;-1;2465;81;39;2;37;.949;3900000;0
14467;70115;2465;0;0;0;0;.00nan;0;0
14467;85507;2473;0;0;0;0;.00nan;0;0
14467;148503;2473;66;28;2;26;.929;3900000;0
14468;-1;711;0;0;0;0;.00nan;0;0
14468;180990;710;13;10;5;5;.500;775000;0
14468;44200;711;84;25;1;24;.960;3600000;0
14468;81085;710;60;36;4;32;.889;2825000;0
14469;-1;707;37;33;6;27;.818;3600000;0
14469;43925;712;95;20;0;20;1.000;3600000;0
14469;145843;707;0;0;0;0;.00nan;0;0
14469;160866;712;0;0;0;0;.00nan;0;0
14470;26308;706;84;30;2;28;.933;3600000;0
14470;181748;714;0;0;0;0;.00nan;0;0
14470;145636;714;34;26;5;21;.808;3600000;0
14470;156932;706;0;0;0;0;.00nan;0;0
14471;181748;714;35;44;8;36;.818;3600000;0
14471;85507;2473;60;24;2;22;.917;3600000;0
14471;145636;714;0;0;0;0;.00nan;0;0
14471;148503;2473;0;0;0;0;.00nan;0;0
14472;-1;711;0;0;0;0;.00nan;0;0
14472;-1;707;96;45;2;43;.956;3600000;0
14472;44200;711;81;12;0;12;1.000;3600000;0
14472;145843;707;0;0;0;0;.00nan;0;0
14473;1213;713;45;27;4;23;.852;3600000;0
14473;8478;713;0;0;0;0;.00nan;0;0
14473;180990;710;0;0;0;0;.00nan;0;0
14473;81085;710;93;30;1;29;.967;3600000;0
14474;-1;2465;60;25;3;22;.880;3600000;0
14474;43925;712;72;19;2;17;.895;3600000;0
14474;70115;2465;0;0;0;0;.00nan;0;0
14474;160866;712;0;0;0;0;.00nan;0;0
14475;5997;2474;87;39;4;35;.897;3630000;0
14475;26308;706;43;15;3;12;.800;3630000;0
14475;72229;2474;0;0;0;0;.00nan;0;0
14475;156932;706;0;0;0;0;.00nan;0;0
14476;26308;706;88;15;0;15;1.000;3600000;0
14476;85507;2473;0;0;0;0;.00nan;0;0
14476;148503;2473;77;22;1;21;.955;3546000;0
14476;156932;706;0;0;0;0;.00nan;0;0
14477;5997;2474;0;0;0;0;.00nan;0;0
14477;180990;710;55;17;2;15;.882;3600000;0
14477;72229;2474;83;46;3;43;.935;3554000;0
14477;81085;710;0;0;0;0;.00nan;0;0
14478;-1;711;0;0;0;0;.00nan;0;0
14478;-1;2465;37;29;5;24;.828;3600000;0
14478;44200;711;82;23;1;22;.957;3600000;0
14478;70115;2465;0;0;0;0;.00nan;0;0
14479;181748;714;0;0;0;0;.00nan;0;0
14479;43925;712;40;25;4;21;.840;3551000;0
14479;145636;714;69;26;2;24;.923;3600000;0
14479;160866;712;0;0;0;0;.00nan;0;0
14480;26308;706;100;47;2;45;.957;3900000;0
14480;180990;710;63;20;2;18;.900;3900000;0
14480;81085;710;0;0;0;0;.00nan;0;0
14480;156932;706;0;0;0;0;.00nan;0;0
14481;-1;711;0;0;0;0;.00nan;0;0
14481;181748;714;14;27;7;20;.741;3331000;0
14481;44200;711;81;27;2;25;.926;3600000;0
14481;145636;714;48;0;0;0;.00nan;269000;0
14482;1213;713;58;26;3;23;.885;3600000;0
14482;8478;713;0;0;0;0;.00nan;0;0
14482;-1;2465;40;37;6;31;.838;3114000;0
14482;70115;2465;55;7;1;6;.857;486000;0
14483;43925;712;26;17;5;12;.706;1065000;0
14483;85507;2473;0;0;0;0;.00nan;0;0
14483;148503;2473;73;22;1;21;.955;3600000;0
14483;160866;712;79;26;1;25;.962;2535000;0
14484;5997;2474;59;27;3;24;.889;3875000;0
14484;-1;707;0;0;0;0;.00nan;0;0
14484;72229;2474;0;0;0;0;.00nan;0;0
14484;145843;707;63;34;3;31;.912;3900000;0
14485;26308;706;52;9;1;8;.889;3600000;0
14485;-1;707;0;0;0;0;.00nan;0;0
14485;145843;707;52;46;7;39;.848;3600000;0
14485;156932;706;0;0;0;0;.00nan;0;0
14486;-1;711;0;0;0;0;.00nan;0;0
14486;43925;712;69;39;3;36;.923;3594000;0
14486;44200;711;64;11;1;10;.909;3600000;0
14486;160866;712;0;0;0;0;.00nan;0;0
14487;5997;2474;0;0;0;0;.00nan;0;0
14487;181748;714;0;0;0;0;.00nan;0;0
14487;72229;2474;81;32;1;31;.969;3600000;0
14487;145636;714;64;21;3;18;.857;3581000;0
14488;-1;2465;73;30;2;28;.933;3600000;0
14488;180990;710;0;0;0;0;.00nan;0;0
14488;70115;2465;0;0;0;0;.00nan;0;0
14488;81085;710;68;17;1;16;.941;3600000;0
14489;1213;713;83;23;1;22;.957;3600000;0
14489;8478;713;0;0;0;0;.00nan;0;0
14489;85507;2473;0;0;0;0;.00nan;0;0
14489;148503;2473;54;28;3;25;.893;3530000;0
14490;-1;711;0;0;0;0;.00nan;0;0
14490;-1;2465;41;30;5;25;.833;3600000;0
14490;44200;711;47;15;2;13;.867;3600000;0
14490;70115;2465;0;0;0;0;.00nan;0;0
14491;5997;2474;66;36;3;33;.917;3551000;0
14491;72229;2474;0;0;0;0;.00nan;0;0
14491;85507;2473;0;0;0;0;.00nan;0;0
14491;148503;2473;82;29;2;27;.931;3600000;0
14492;1213;713;42;13;3;10;.769;3900000;0
14492;8478;713;0;0;0;0;.00nan;0;0
14492;43925;712;68;32;3;29;.906;3900000;0
14492;160866;712;0;0;0;0;.00nan;0;0
14493;180990;710;0;0;0;0;.00nan;0;0
14493;181748;714;65;32;3;29;.906;3600000;0
14493;81085;710;44;24;4;20;.833;3575000;0
14493;145636;714;0;0;0;0;.00nan;0;0
14494;1213;713;52;11;1;10;.909;3600000;0
14494;8478;713;0;0;0;0;.00nan;0;0
14494;-1;707;0;0;0;0;.00nan;0;0
14494;145843;707;96;51;3;48;.941;3538000;0
14495;26308;706;85;30;1;29;.967;3600000;0
14495;-1;2465;58;29;3;26;.897;3600000;0
14495;70115;2465;0;0;0;0;.00nan;0;0
14495;156932;706;0;0;0;0;.00nan;0;0
14496;5997;2474;0;0;0;0;.00nan;0;0
14496;43925;712;61;39;5;34;.872;3558000;0
14496;72229;2474;80;39;3;36;.923;3600000;0
14496;160866;712;0;0;0;0;.00nan;0;0
14497;180990;710;52;31;4;27;.871;3600000;0
14497;81085;710;0;0;0;0;.00nan;0;0
14497;85507;2473;0;0;0;0;.00nan;0;0
14497;148503;2473;57;23;3;20;.870;3600000;0
14498;181748;714;0;0;0;0;.00nan;0;0
14498;-1;707;73;35;3;32;.914;3600000;0
14498;145636;714;37;22;4;18;.818;3555000;0
14498;145843;707;0;0;0;0;.00nan;0;0
14499;1213;713;59;34;4;30;.882;3569000;0
14499;8478;713;0;0;0;0;.00nan;0;0
14499;-1;711;0;0;0;0;.00nan;0;0
14499;44200;711;64;24;2;22;.917;3600000;0
14500;1213;713;62;43;6;37;.860;3600000;0
14500;8478;713;0;0;0;0;.00nan;0;0
14500;26308;706;76;32;2;30;.938;3600000;0
14500;156932;706;0;0;0;0;.00nan;0;0
14501;-1;707;75;54;4;50;.926;3600000;0
14501;85507;2473;83;31;1;30;.968;3600000;0
14501;145843;707;0;0;0;0;.00nan;0;0
14501;148503;2473;0;0;0;0;.00nan;0;0
14502;180990;710;86;33;2;31;.939;3600000;0
14502;43925;712;68;36;4;32;.889;3521000;0
14502;81085;710;0;0;0;0;.00nan;0;0
14502;160866;712;0;0;0;0;.00nan;0;0
14503;-1;2465;48;17;2;15;.882;3557000;0
14503;181748;714;100;31;0;31;1.000;3600000;0
14503;70115;2465;0;0;0;0;.00nan;0;0
14503;145636;714;0;0;0;0;.00nan;0;0
14504;5997;2474;49;42;6;36;.857;3324000;0
14504;-1;711;0;0;0;0;.00nan;0;0
14504;44200;711;61;16;2;14;.875;3600000;0
14504;72229;2474;49;2;0;2;1.000;276000;0
14505;26308;706;97;33;1;32;.970;3600000;0
14505;181748;714;0;0;0;0;.00nan;0;0
14505;145636;714;78;36;2;34;.944;3563000;0
14505;156932;706;0;0;0;0;.00nan;0;0
14506;-1;711;0;0;0;0;.00nan;0;0
14506;180990;710;0;0;0;0;.00nan;0;0
14506;44200;711;90;30;1;29;.967;3600000;0
14506;81085;710;53;31;4;27;.871;3600000;0
14507;-1;707;0;0;0;0;.00nan;0;0
14507;43925;712;100;22;0;22;1.000;3600000;0
14507;145843;707;58;44;6;38;.864;3600000;0
14507;160866;712;0;0;0;0;.00nan;0;0
14508;1213;713;84;25;1;24;.960;3600000;0
14508;5997;2474;70;24;2;22;.917;3073000;0
14508;8478;713;0;0;0;0;.00nan;0;0
14508;72229;2474;32;10;3;7;.700;527000;0
14509;-1;2465;0;0;0;0;.00nan;0;0
14509;70115;2465;72;31;3;28;.903;3600000;0
14509;85507;2473;0;0;0;0;.00nan;0;0
14509;148503;2473;38;28;5;23;.821;3600000;0
14510;1213;713;96;38;2;36;.947;3600000;0
14510;8478;713;0;0;0;0;.00nan;0;0
14510;180990;710;0;0;0;0;.00nan;0;0
14510;81085;710;41;23;4;19;.826;3557000;0
14511;-1;711;0;0;0;0;.00nan;0;0
14511;-1;707;35;39;7;32;.821;2128000;0
14511;44200;711;46;5;1;4;.800;3600000;0
14511;145843;707;50;25;4;21;.840;1472000;0
14512;-1;2465;74;23;2;21;.913;3600000;0
14512;43925;712;96;48;3;45;.938;3529000;0
14512;70115;2465;0;0;0;0;.00nan;0;0
14512;160866;712;0;0;0;0;.00nan;0;0
14513;181748;714;84;31;1;30;.968;3600000;0
14513;85507;2473;0;0;0;0;.00nan;0;0
14513;145636;714;0;0;0;0;.00nan;0;0
14513;148503;2473;65;27;2;25;.926;3563000;0
14514;5997;2474;88;41;3;38;.927;3600000;0
14514;26308;706;0;0;0;0;.00nan;0;0
14514;72229;2474;0;0;0;0;.00nan;0;0
14514;156932;706;45;25;4;21;.840;3592000;0
14515;1213;713;78;27;1;26;.963;3600000;0
14515;8478;713;0;0;0;0;.00nan;0;0
14515;181748;714;0;0;0;0;.00nan;0;0
14515;145636;714;54;29;4;25;.862;3600000;0
14516;26308;706;67;27;2;25;.926;3737000;0
14516;85507;2473;0;0;0;0;.00nan;0;0
14516;148503;2473;85;29;1;28;.966;3737000;0
14516;156932;706;0;0;0;0;.00nan;0;0
14517;-1;711;52;18;3;15;.833;3600000;0
14517;-1;2465;69;41;4;37;.902;3574000;0
14517;44200;711;0;0;0;0;.00nan;0;0
14517;70115;2465;0;0;0;0;.00nan;0;0
14518;5997;2474;0;0;0;0;.00nan;0;0
14518;180990;710;99;22;0;22;1.000;3600000;0
14518;72229;2474;67;42;5;37;.881;3600000;0
14518;81085;710;0;0;0;0;.00nan;0;0
14519;1213;713;74;27;3;24;.889;3600000;0
14519;8478;713;0;0;0;0;.00nan;0;0
14519;-1;707;0;0;0;0;.00nan;0;0
14519;145843;707;100;32;0;32;1.000;3600000;0
14520;181748;714;71;17;1;16;.941;3600000;0
14520;43925;712;84;36;2;34;.944;3582000;0
14520;145636;714;0;0;0;0;.00nan;0;0
14520;160866;712;0;0;0;0;.00nan;0;0
14521;43925;712;54;31;4;27;.871;3570000;0
14521;85507;2473;0;0;0;0;.00nan;0;0
14521;148503;2473;43;17;3;14;.824;3600000;0
14521;160866;712;0;0;0;0;.00nan;0;0
14522;5997;2474;60;23;2;21;.913;3900000;0
14522;-1;707;0;0;0;0;.00nan;0;0
14522;72229;2474;0;0;0;0;.00nan;0;0
14522;145843;707;94;45;2;43;.956;3900000;0
14523;1213;713;76;19;1;18;.947;3600000;0
14523;8478;713;0;0;0;0;.00nan;0;0
14523;-1;2465;74;33;2;31;.939;3543000;0
14523;70115;2465;0;0;0;0;.00nan;0;0
14524;26308;706;92;34;1;33;.971;3600000;0
14524;180990;710;56;33;4;29;.879;3600000;0
14524;81085;710;0;0;0;0;.00nan;0;0
14524;156932;706;0;0;0;0;.00nan;0;0
14525;-1;711;0;0;0;0;.00nan;0;0
14525;181748;714;68;32;3;29;.906;3528000;0
14525;44200;711;73;23;1;22;.957;3600000;0
14525;145636;714;0;0;0;0;.00nan;0;0
14526;26308;706;58;27;3;24;.889;3600000;0
14526;43925;712;86;47;4;43;.915;3583000;0
14526;156932;706;0;0;0;0;.00nan;0;0
14526;160866;712;0;0;0;0;.00nan;0;0
14527;-1;711;0;0;0;0;.00nan;0;0
14527;44200;711;63;22;2;20;.909;3600000;0
14527;85507;2473;0;0;0;0;.00nan;0;0
14527;148503;2473;39;30;5;25;.833;3600000;0
14528;5997;2474;0;0;0;0;.00nan;0;0
14528;-1;2465;64;19;2;17;.895;3702000;0
14528;70115;2465;0;0;0;0;.00nan;0;0
14528;72229;2474;69;27;3;24;.889;3702000;0
14529;180990;710;68;13;1;12;.923;3600000;0
14529;-1;707;60;43;5;38;.884;3600000;0
14529;81085;710;0;0;0;0;.00nan;0;0
14529;145843;707;0;0;0;0;.00nan;0;0
14530;1213;713;65;25;2;23;.920;3900000;0
14530;8478;713;0;0;0;0;.00nan;0;0
14530;85507;2473;0;0;0;0;.00nan;0;0
14530;148503;2473;76;25;2;23;.920;3900000;0
14531;26308;706;54;15;2;13;.867;3600000;0
14531;-1;707;21;22;6;16;.727;2535000;0
14531;145843;707;36;13;3;10;.769;1065000;0
14531;156932;706;0;0;0;0;.00nan;0;0
14532;-1;711;0;0;0;0;.00nan;0;0
14532;43925;712;43;3;1;2;.667;521000;0
14532;44200;711;72;25;2;23;.920;3600000;0
14532;160866;712;59;42;6;36;.857;3079000;0
14533;-1;2465;62;38;4;34;.895;3178000;0
14533;180990;710;57;18;2;16;.889;3600000;0
14533;70115;2465;26;6;3;3;.500;422000;0
14533;81085;710;0;0;0;0;.00nan;0;0
14534;5997;2474;0;0;0;0;.00nan;0;0
14534;181748;714;70;22;1;21;.955;3600000;0
14534;72229;2474;62;38;4;34;.895;3600000;0
14534;145636;714;0;0;0;0;.00nan;0;0
14535;-1;711;0;0;0;0;.00nan;0;0
14535;26308;706;49;33;5;28;.848;3590000;0
14535;44200;711;43;20;4;16;.800;3600000;0
14535;156932;706;0;0;0;0;.00nan;0;0
14536;5997;2474;86;43;3;40;.930;3900000;0
14536;72229;2474;0;0;0;0;.00nan;0;0
14536;85507;2473;0;0;0;0;.00nan;0;0
14536;148503;2473;65;26;3;23;.885;3900000;0
14537;180990;710;0;0;0;0;.00nan;0;0
14537;181748;714;69;33;3;30;.909;3876000;0
14537;81085;710;61;29;3;26;.897;3900000;0
14537;145636;714;0;0;0;0;.00nan;0;0
14538;-1;2465;64;25;2;23;.920;3600000;0
14538;-1;707;0;0;0;0;.00nan;0;0
14538;70115;2465;0;0;0;0;.00nan;0;0
14538;145843;707;63;36;3;33;.917;3568000;0
14539;1213;713;0;0;0;0;.00nan;0;0
14539;8478;713;67;17;1;16;.941;3600000;0
14539;43925;712;41;27;5;22;.815;3600000;0
14539;160866;712;0;0;0;0;.00nan;0;0
14540;180990;710;64;23;2;21;.913;3547000;0
14540;81085;710;0;0;0;0;.00nan;0;0
14540;85507;2473;90;33;1;32;.970;3600000;0
14540;148503;2473;0;0;0;0;.00nan;0;0
14541;1213;713;75;37;3;34;.919;3545000;0
14541;8478;713;0;0;0;0;.00nan;0;0
14541;-1;711;0;0;0;0;.00nan;0;0
14541;44200;711;58;14;2;12;.857;3600000;0
14542;5997;2474;0;0;0;0;.00nan;0;0
14542;43925;712;52;22;3;19;.864;3566000;0
14542;72229;2474;70;28;2;26;.929;3600000;0
14542;160866;712;0;0;0;0;.00nan;0;0
14543;26308;706;60;36;5;31;.861;3737000;0
14543;-1;2465;33;20;4;16;.800;2930000;0
14543;70115;2465;54;14;2;12;.857;807000;0
14543;156932;706;0;0;0;0;.00nan;0;0
14544;181748;714;100;30;0;30;1.000;3600000;0
14544;-1;707;22;27;6;21;.778;1609000;0
14544;145636;714;0;0;0;0;.00nan;0;0
14544;145843;707;70;16;0;16;1.000;1991000;0
14545;5997;2474;76;42;4;38;.905;3600000;0
14545;-1;711;0;0;0;0;.00nan;0;0
14545;44200;711;63;13;1;12;.923;3600000;0
14545;72229;2474;0;0;0;0;.00nan;0;0
14546;180990;710;62;15;1;14;.933;3600000;0
14546;43925;712;83;42;3;39;.929;3550000;0
14546;81085;710;0;0;0;0;.00nan;0;0
14546;160866;712;0;0;0;0;.00nan;0;0
14547;-1;707;0;0;0;0;.00nan;0;0
14547;85507;2473;0;0;0;0;.00nan;0;0
14547;145843;707;63;44;5;39;.886;3600000;0
14547;148503;2473;51;17;3;14;.824;3600000;0
14548;1213;713;48;23;4;19;.826;3528000;0
14548;8478;713;0;0;0;0;.00nan;0;0
14548;26308;706;100;40;2;38;.950;3600000;0
14548;156932;706;0;0;0;0;.00nan;0;0
14549;-1;2465;76;31;2;29;.935;3600000;0
14549;181748;714;51;28;4;24;.857;3600000;0
14549;70115;2465;0;0;0;0;.00nan;0;0
14549;145636;714;0;0;0;0;.00nan;0;0
14550;-1;2465;100;35;0;35;1.000;3600000;0
14550;70115;2465;0;0;0;0;.00nan;0;0
14550;85507;2473;0;0;0;0;.00nan;0;0
14550;148503;2473;17;24;6;18;.750;3600000;0
14551;-1;711;73;33;3;30;.909;3873000;0
14551;180990;710;73;33;2;31;.939;3873000;0
14551;44200;711;0;0;0;0;.00nan;0;0
14551;81085;710;0;0;0;0;.00nan;0;0
14552;1213;713;46;14;3;11;.786;3900000;0
14552;5997;2474;0;0;0;0;.00nan;0;0
14552;8478;713;0;0;0;0;.00nan;0;0
14552;72229;2474;78;49;3;46;.939;3900000;0
14553;26308;706;41;19;4;15;.789;3713000;0
14553;181748;714;88;35;3;32;.914;3713000;0
14553;145636;714;0;0;0;0;.00nan;0;0
14553;156932;706;0;0;0;0;.00nan;0;0
14554;-1;707;3;15;6;9;.600;1660000;0
14554;43925;712;51;37;5;32;.865;3600000;0
14554;145843;707;54;16;2;14;.875;1940000;0
14554;160866;712;0;0;0;0;.00nan;0;0
14555;181748;714;63;38;4;34;.895;3563000;0
14555;85507;2473;0;0;0;0;.00nan;0;0
14555;145636;714;0;0;0;0;.00nan;0;0
14555;148503;2473;90;42;2;40;.952;3600000;0
14556;-1;711;0;0;0;0;.00nan;0;0
14556;-1;707;59;41;4;37;.902;3278000;0
14556;44200;711;99;22;0;22;1.000;3600000;0
14556;145843;707;31;10;3;7;.700;322000;0
14557;5997;2474;62;35;5;30;.857;3600000;0
14557;26308;706;95;23;0;23;1.000;3600000;0
14557;72229;2474;0;0;0;0;.00nan;0;0
14557;156932;706;0;0;0;0;.00nan;0;0
14558;1213;713;73;27;2;25;.926;3600000;0
14558;8478;713;0;0;0;0;.00nan;0;0
14558;180990;710;39;17;3;14;.824;3549000;0
14558;81085;710;0;0;0;0;.00nan;0;0
14559;-1;2465;72;27;2;25;.926;3600000;0
14559;43925;712;85;32;1;31;.969;3600000;0
14559;70115;2465;0;0;0;0;.00nan;0;0
14559;160866;712;0;0;0;0;.00nan;0;0
14560;26308;706;42;30;5;25;.833;3576000;0
14560;85507;2473;55;32;4;28;.875;3600000;0
14560;148503;2473;0;0;0;0;.00nan;0;0
14560;156932;706;0;0;0;0;.00nan;0;0
14561;5997;2474;0;0;0;0;.00nan;0;0
14561;180990;710;58;19;2;17;.895;3600000;0
14561;72229;2474;28;33;6;27;.818;3600000;0
14561;81085;710;0;0;0;0;.00nan;0;0
14562;1213;713;51;15;2;13;.867;3600000;0
14562;8478;713;0;0;0;0;.00nan;0;0
14562;-1;707;88;52;4;48;.923;3600000;0
14562;145843;707;0;0;0;0;.00nan;0;0
14563;-1;711;0;0;0;0;.00nan;0;0
14563;-1;2465;0;0;0;0;.00nan;0;0
14563;44200;711;88;27;1;26;.963;3600000;0
14563;70115;2465;72;30;2;28;.933;3574000;0
14564;181748;714;46;32;5;27;.844;3600000;0
14564;43925;712;86;35;2;33;.943;3600000;0
14564;145636;714;0;0;0;0;.00nan;0;0
14564;160866;712;0;0;0;0;.00nan;0;0
14565;26308;706;74;35;4;31;.886;3756000;0
14565;180990;710;68;28;3;25;.893;3756000;0
14565;81085;710;0;0;0;0;.00nan;0;0
14565;156932;706;0;0;0;0;.00nan;0;0
14566;-1;711;0;0;0;0;.00nan;0;0
14566;181748;714;62;39;5;34;.872;3560000;0
14566;44200;711;54;24;3;21;.875;3600000;0
14566;145636;714;0;0;0;0;.00nan;0;0
14567;5997;2474;69;32;4;28;.875;3900000;0
14567;-1;707;79;37;4;33;.892;3900000;0
14567;72229;2474;0;0;0;0;.00nan;0;0
14567;145843;707;0;0;0;0;.00nan;0;0
14568;1213;713;82;14;0;14;1.000;3600000;0
14568;8478;713;0;0;0;0;.00nan;0;0
14568;-1;2465;44;30;5;25;.833;3600000;0
14568;70115;2465;0;0;0;0;.00nan;0;0
14569;43925;712;78;32;2;30;.938;3900000;0
14569;85507;2473;100;36;2;34;.944;3900000;0
14569;148503;2473;0;0;0;0;.00nan;0;0
14569;160866;712;0;0;0;0;.00nan;0;0
14570;-1;711;0;0;0;0;.00nan;0;0
14570;44200;711;87;17;0;17;1.000;3600000;0
14570;85507;2473;0;0;0;0;.00nan;0;0
14570;148503;2473;84;40;2;38;.950;3529000;0
14571;180990;710;76;23;1;22;.957;3600000;0
14571;-1;707;0;0;0;0;.00nan;0;0
14571;81085;710;0;0;0;0;.00nan;0;0
14571;145843;707;62;44;6;38;.864;3600000;0
14572;26308;706;71;30;3;27;.900;3585000;0
14572;43925;712;83;35;2;33;.943;3600000;0
14572;156932;706;0;0;0;0;.00nan;0;0
14572;160866;712;0;0;0;0;.00nan;0;0
14573;5997;2474;0;0;0;0;.00nan;0;0
14573;-1;2465;40;19;3;16;.842;3571000;0
14573;70115;2465;0;0;0;0;.00nan;0;0
14573;72229;2474;75;32;2;30;.938;3600000;0
14574;1213;713;26;7;3;4;.571;424000;0
14574;8478;713;56;22;2;20;.909;3176000;0
14574;181748;714;90;35;2;33;.943;3600000;0
14574;145636;714;0;0;0;0;.00nan;0;0
14575;26308;706;0;0;0;0;.00nan;0;0
14575;-1;707;55;4;0;4;1.000;355000;0
14575;145843;707;45;40;6;34;.850;3245000;0
14575;156932;706;83;19;0;19;1.000;3600000;0
14576;-1;711;0;0;0;0;.00nan;0;0
14576;43925;712;72;38;3;35;.921;3600000;0
14576;44200;711;88;17;0;17;1.000;3600000;0
14576;160866;712;0;0;0;0;.00nan;0;0
14577;5997;2474;81;21;1;20;.952;3600000;0
14577;181748;714;82;31;2;29;.935;3600000;0
14577;72229;2474;0;0;0;0;.00nan;0;0
14577;145636;714;0;0;0;0;.00nan;0;0
14578;-1;2465;82;36;2;34;.944;3600000;0
14578;180990;710;0;0;0;0;.00nan;0;0
14578;70115;2465;0;0;0;0;.00nan;0;0
14578;81085;710;68;20;1;19;.950;3600000;0
14579;1213;713;95;35;1;34;.971;3600000;0
14579;8478;713;0;0;0;0;.00nan;0;0
14579;85507;2473;0;0;0;0;.00nan;0;0
14579;148503;2473;83;32;2;30;.938;3574000;0
14580;-1;711;0;0;0;0;.00nan;0;0
14580;26308;706;0;0;0;0;.00nan;0;0
14580;44200;711;68;29;3;26;.897;3544000;0
14580;156932;706;99;48;1;47;.979;3600000;0
14581;1213;713;43;21;3;18;.857;3600000;0
14581;8478;713;0;0;0;0;.00nan;0;0
14581;43925;712;55;40;5;35;.875;3600000;0
14581;160866;712;0;0;0;0;.00nan;0;0
14582;-1;2465;0;0;0;0;.00nan;0;0
14582;-1;707;89;36;2;34;.944;3600000;0
14582;70115;2465;67;34;3;31;.912;3549000;0
14582;145843;707;0;0;0;0;.00nan;0;0
14583;180990;710;73;21;1;20;.952;3600000;0
14583;181748;714;40;32;6;26;.813;3035000;0
14583;81085;710;0;0;0;0;.00nan;0;0
14583;145636;714;53;8;1;7;.875;565000;0
14584;5997;2474;0;0;0;0;.00nan;0;0
14584;72229;2474;56;43;5;38;.884;3900000;0
14584;85507;2473;75;23;1;22;.957;2781000;0
14584;148503;2473;24;12;4;8;.667;1107000;0
14585;26308;706;51;25;4;21;.840;3555000;0
14585;-1;2465;90;31;2;29;.935;3600000;0
14585;70115;2465;0;0;0;0;.00nan;0;0
14585;156932;706;0;0;0;0;.00nan;0;0
14586;5997;2474;72;26;2;24;.923;3600000;0
14586;43925;712;50;30;4;26;.867;3517000;0
14586;72229;2474;0;0;0;0;.00nan;0;0
14586;160866;712;0;0;0;0;.00nan;0;0
14587;180990;710;100;26;0;26;1.000;3600000;0
14587;81085;710;0;0;0;0;.00nan;0;0
14587;85507;2473;0;0;0;0;.00nan;0;0
14587;148503;2473;70;36;3;33;.917;3600000;0
14588;181748;714;0;0;0;0;.00nan;0;0
14588;-1;707;82;45;5;40;.889;3600000;0
14588;145636;714;100;24;0;24;1.000;3600000;0
14588;145843;707;0;0;0;0;.00nan;0;0
14589;1213;713;98;25;0;25;1.000;3600000;0
14589;8478;713;0;0;0;0;.00nan;0;0
14589;-1;711;0;0;0;0;.00nan;0;0
14589;44200;711;72;29;2;27;.931;3600000;0
14590;-1;707;0;0;0;0;.00nan;0;0
14590;85507;2473;83;15;0;15;1.000;3600000;0
14590;145843;707;46;39;5;34;.872;3600000;0
14590;148503;2473;0;0;0;0;.00nan;0;0
14591;1213;713;61;25;3;22;.880;3600000;0
14591;8478;713;0;0;0;0;.00nan;0;0
14591;26308;706;29;35;7;28;.800;3600000;0
14591;156932;706;0;0;0;0;.00nan;0;0
14592;180990;710;66;17;2;15;.882;3900000;0
14592;43925;712;93;43;2;41;.953;3900000;0
14592;81085;710;0;0;0;0;.00nan;0;0
14592;160866;712;0;0;0;0;.00nan;0;0
14593;-1;2465;71;29;3;26;.897;3900000;0
14593;181748;714;0;0;0;0;.00nan;0;0
14593;70115;2465;0;0;0;0;.00nan;0;0
14593;145636;714;63;34;3;31;.912;3900000;0
14594;5997;2474;0;0;0;0;.00nan;0;0
14594;-1;711;0;0;0;0;.00nan;0;0
14594;44200;711;93;17;0;17;1.000;3600000;0
14594;72229;2474;79;43;4;39;.907;3600000;0
14595;5997;2474;0;0;0;0;.00nan;0;0
14595;26308;706;49;23;3;20;.870;3564000;0
14595;72229;2474;97;32;1;31;.969;3600000;0
14595;156932;706;0;0;0;0;.00nan;0;0
14596;1213;713;65;34;4;30;.882;3600000;0
14596;8478;713;0;0;0;0;.00nan;0;0
14596;180990;710;31;23;5;18;.783;3552000;0
14596;81085;710;0;0;0;0;.00nan;0;0
14597;-1;711;0;0;0;0;.00nan;0;0
14597;-1;707;82;55;5;50;.909;3600000;0
14597;44200;711;69;18;1;17;.944;3600000;0
14597;145843;707;0;0;0;0;.00nan;0;0
14598;-1;2465;72;17;1;16;.941;3808000;0
14598;43925;712;94;47;2;45;.957;3808000;0
14598;70115;2465;0;0;0;0;.00nan;0;0
14598;160866;712;0;0;0;0;.00nan;0;0
14599;181748;714;74;28;2;26;.929;3900000;0
14599;85507;2473;59;21;2;19;.905;3900000;0
14599;145636;714;0;0;0;0;.00nan;0;0
14599;148503;2473;0;0;0;0;.00nan;0;0
14600;-1;711;59;23;3;20;.870;3512000;0
14600;-1;2465;73;24;1;23;.958;3600000;0
14600;44200;711;0;0;0;0;.00nan;0;0
14600;70115;2465;0;0;0;0;.00nan;0;0
14601;1213;713;42;14;3;11;.786;3549000;0
14601;8478;713;0;0;0;0;.00nan;0;0
14601;-1;707;99;37;1;36;.973;3600000;0
14601;145843;707;0;0;0;0;.00nan;0;0
14602;181748;714;60;19;2;17;.895;3600000;0
14602;43925;712;58;26;3;23;.885;3600000;0
14602;145636;714;0;0;0;0;.00nan;0;0
14602;160866;712;0;0;0;0;.00nan;0;0
14603;26308;706;100;24;0;24;1.000;3600000;0
14603;85507;2473;28;18;4;14;.778;3600000;0
14603;148503;2473;0;0;0;0;.00nan;0;0
14603;156932;706;0;0;0;0;.00nan;0;0
14604;5997;2474;94;47;2;45;.957;3900000;0
14604;180990;710;69;26;2;24;.923;3900000;0
14604;72229;2474;0;0;0;0;.00nan;0;0
14604;81085;710;0;0;0;0;.00nan;0;0
14605;43925;712;87;33;2;31;.939;3900000;0
14605;85507;2473;0;0;0;0;.00nan;0;0
14605;148503;2473;97;31;2;29;.935;3900000;0
14605;160866;712;0;0;0;0;.00nan;0;0
14606;26308;706;37;34;6;28;.824;3600000;0
14606;180990;710;77;25;1;24;.960;3600000;0
14606;81085;710;0;0;0;0;.00nan;0;0
14606;156932;706;0;0;0;0;.00nan;0;0
14607;5997;2474;63;29;3;26;.897;3900000;0
14607;-1;707;0;0;0;0;.00nan;0;0
14607;72229;2474;0;0;0;0;.00nan;0;0
14607;145843;707;84;46;3;43;.935;3900000;0
14608;1213;713;70;28;2;26;.929;3600000;0
14608;8478;713;0;0;0;0;.00nan;0;0
14608;-1;2465;0;0;0;0;.00nan;0;0
14608;70115;2465;57;34;4;30;.882;3581000;0
14609;-1;711;0;0;0;0;.00nan;0;0
14609;181748;714;60;26;3;23;.885;3535000;0
14609;44200;711;86;31;1;30;.968;3600000;0
14609;145636;714;0;0;0;0;.00nan;0;0
14610;26308;706;60;22;3;19;.864;3548000;0
14610;43925;712;79;33;2;31;.939;3600000;0
14610;156932;706;0;0;0;0;.00nan;0;0
14610;160866;712;0;0;0;0;.00nan;0;0
14611;180990;710;83;13;0;13;1.000;3600000;0
14611;-1;707;90;57;4;53;.930;3600000;0
14611;81085;710;0;0;0;0;.00nan;0;0
14611;145843;707;0;0;0;0;.00nan;0;0
14612;1213;713;78;18;1;17;.944;3600000;0
14612;8478;713;0;0;0;0;.00nan;0;0
14612;181748;714;38;34;6;28;.824;3600000;0
14612;145636;714;0;0;0;0;.00nan;0;0
14613;-1;711;0;0;0;0;.00nan;0;0
14613;44200;711;72;33;2;31;.939;3545000;0
14613;85507;2473;0;0;0;0;.00nan;0;0
14613;148503;2473;91;31;1;30;.968;3600000;0
14614;5997;2474;0;0;0;0;.00nan;0;0
14614;-1;2465;73;25;2;23;.920;3900000;0
14614;70115;2465;0;0;0;0;.00nan;0;0
14614;72229;2474;72;26;2;24;.923;3900000;0
14615;1213;713;93;29;1;28;.966;3600000;0
14615;8478;713;0;0;0;0;.00nan;0;0
14615;85507;2473;98;42;2;40;.952;3552000;0
14615;148503;2473;0;0;0;0;.00nan;0;0
14616;-1;711;0;0;0;0;.00nan;0;0
14616;43925;712;0;0;0;0;.00nan;0;0
14616;44200;711;64;24;3;21;.875;3600000;0
14616;160866;712;50;39;5;34;.872;3554000;0
14617;-1;2465;0;0;0;0;.00nan;0;0
14617;180990;710;69;29;3;26;.897;3900000;0
14617;70115;2465;48;23;3;20;.870;3900000;0
14617;81085;710;0;0;0;0;.00nan;0;0
14618;5997;2474;60;33;3;30;.909;3900000;0
14618;181748;714;40;18;3;15;.833;3900000;0
14618;72229;2474;0;0;0;0;.00nan;0;0
14618;145636;714;0;0;0;0;.00nan;0;0
14619;26308;706;47;11;2;9;.818;3600000;0
14619;-1;707;0;0;0;0;.00nan;0;0
14619;145843;707;89;47;3;44;.936;3591000;0
14619;156932;706;0;0;0;0;.00nan;0;0
14620;1213;713;0;0;0;0;.00nan;0;0
14620;8478;713;95;26;0;26;1.000;3600000;0
14620;43925;712;94;44;3;41;.932;3600000;0
14620;160866;712;0;0;0;0;.00nan;0;0
14621;-1;711;0;0;0;0;.00nan;0;0
14621;26308;706;82;37;2;35;.946;3900000;0
14621;44200;711;73;30;2;28;.933;3900000;0
14621;156932;706;0;0;0;0;.00nan;0;0
14622;5997;2474;58;6;0;6;1.000;303000;0
14622;72229;2474;60;47;6;41;.872;3290000;0
14622;85507;2473;65;35;4;31;.886;3600000;0
14622;148503;2473;0;0;0;0;.00nan;0;0
14623;180990;710;0;0;0;0;.00nan;0;0
14623;181748;714;0;0;0;0;.00nan;0;0
14623;81085;710;69;34;3;31;.912;3600000;0
14623;145636;714;73;47;5;42;.894;3567000;0
14624;-1;2465;0;0;0;0;.00nan;0;0
14624;-1;707;0;0;0;0;.00nan;0;0
14624;70115;2465;59;26;3;23;.885;3600000;0
14624;145843;707;44;27;4;23;.852;3556000;0
14625;180990;710;92;29;1;28;.966;3600000;0
14625;81085;710;0;0;0;0;.00nan;0;0
14625;85507;2473;68;37;4;33;.892;3600000;0
14625;148503;2473;0;0;0;0;.00nan;0;0
14626;1213;713;0;0;0;0;.00nan;0;0
14626;8478;713;62;16;1;15;.938;3554000;0
14626;-1;711;0;0;0;0;.00nan;0;0
14626;44200;711;100;29;0;29;1.000;3600000;0
14627;5997;2474;0;0;0;0;.00nan;0;0
14627;43925;712;67;27;2;25;.926;3545000;0
14627;72229;2474;85;27;1;26;.963;3600000;0
14627;160866;712;0;0;0;0;.00nan;0;0
14628;26308;706;82;14;0;14;1.000;3600000;0
14628;-1;2465;75;23;1;22;.957;3559000;0
14628;70115;2465;0;0;0;0;.00nan;0;0
14628;156932;706;0;0;0;0;.00nan;0;0
14629;181748;714;88;14;0;14;1.000;3600000;0
14629;-1;707;41;27;5;22;.815;2231000;0
14629;145636;714;0;0;0;0;.00nan;0;0
14629;145843;707;64;19;1;18;.947;1369000;0
14630;180990;710;50;15;2;13;.867;3600000;0
14630;43925;712;79;46;4;42;.913;3572000;0
14630;81085;710;0;0;0;0;.00nan;0;0
14630;160866;712;0;0;0;0;.00nan;0;0
14631;-1;707;100;33;0;33;1.000;3600000;0
14631;85507;2473;51;20;3;17;.850;3600000;0
14631;145843;707;0;0;0;0;.00nan;0;0
14631;148503;2473;0;0;0;0;.00nan;0;0
14632;-1;2465;84;29;1;28;.966;3600000;0
14632;181748;714;56;27;3;24;.889;3600000;0
14632;70115;2465;0;0;0;0;.00nan;0;0
14632;145636;714;0;0;0;0;.00nan;0;0
14633;1213;713;95;26;1;25;.962;3600000;0
14633;8478;713;0;0;0;0;.00nan;0;0
14633;26308;706;92;18;0;18;1.000;3600000;0
14633;156932;706;0;0;0;0;.00nan;0;0
14634;5997;2474;78;35;2;33;.943;3570000;0
14634;-1;711;0;0;0;0;.00nan;0;0
14634;44200;711;93;14;0;14;1.000;3600000;0
14634;72229;2474;0;0;0;0;.00nan;0;0
14635;-1;2465;47;38;6;32;.842;3600000;0
14635;70115;2465;0;0;0;0;.00nan;0;0
14635;85507;2473;57;18;2;16;.889;3600000;0
14635;148503;2473;0;0;0;0;.00nan;0;0
14636;-1;711;0;0;0;0;.00nan;0;0
14636;180990;710;59;35;4;31;.886;3600000;0
14636;44200;711;99;41;1;40;.976;3600000;0
14636;81085;710;0;0;0;0;.00nan;0;0
14637;1213;713;80;24;1;23;.958;3600000;0
14637;5997;2474;0;0;0;0;.00nan;0;0
14637;8478;713;0;0;0;0;.00nan;0;0
14637;72229;2474;92;51;3;48;.941;3552000;0
14638;-1;707;59;42;5;37;.881;3560000;0
14638;43925;712;87;36;3;33;.917;3600000;0
14638;145843;707;0;0;0;0;.00nan;0;0
14638;160866;712;0;0;0;0;.00nan;0;0
14639;26308;706;63;22;2;20;.909;3900000;0
14639;181748;714;84;34;2;32;.941;3900000;0
14639;145636;714;0;0;0;0;.00nan;0;0
14639;156932;706;0;0;0;0;.00nan;0;0
14640;26308;706;74;32;3;29;.906;3600000;0
14640;85507;2473;53;36;6;30;.833;3600000;0
14640;148503;2473;0;0;0;0;.00nan;0;0
14640;156932;706;0;0;0;0;.00nan;0;0
14641;1213;713;82;11;0;11;1.000;3600000;0
14641;8478;713;0;0;0;0;.00nan;0;0
14641;-1;707;0;0;0;0;.00nan;0;0
14641;145843;707;97;51;3;48;.941;3600000;0
14642;181748;714;66;19;1;18;.947;3600000;0
14642;43925;712;73;25;2;23;.920;3563000;0
14642;145636;714;0;0;0;0;.00nan;0;0
14642;160866;712;0;0;0;0;.00nan;0;0
14643;5997;2474;88;45;3;42;.933;3600000;0
14643;180990;710;97;21;0;21;1.000;3600000;0
14643;72229;2474;0;0;0;0;.00nan;0;0
14643;81085;710;0;0;0;0;.00nan;0;0
14655;5997;2474;0;0;0;0;.00nan;0;0
14655;26308;706;84;15;0;15;1.000;3600000;0
14655;72229;2474;75;39;3;36;.923;3600000;0
14655;156932;706;0;0;0;0;.00nan;0;0
14657;1213;713;71;18;1;17;.944;3600000;0
14657;8478;713;0;0;0;0;.00nan;0;0
14657;145787;2473;0;0;0;0;.00nan;0;0
14657;148503;2473;63;27;3;24;.889;3537000;0
14659;180990;710;69;20;1;19;.950;3600000;0
14659;-1;707;82;39;3;36;.923;3592000;0
14659;81085;710;0;0;0;0;.00nan;0;0
14659;145843;707;0;0;0;0;.00nan;0;0
14661;-1;711;0;0;0;0;.00nan;0;0
14661;181748;714;0;0;0;0;.00nan;0;0
14661;44200;711;42;21;4;17;.810;3596000;0
14661;145636;714;66;36;3;33;.917;3600000;0
14663;8477;2465;0;0;0;0;.00nan;0;0
14663;-1;2465;99;26;1;25;.962;3600000;0
14663;43925;712;77;44;4;40;.909;3600000;0
14663;160866;712;0;0;0;0;.00nan;0;0
14665;5997;2474;97;49;2;47;.959;3560000;0
14665;180990;710;0;0;0;0;.00nan;0;0
14665;72229;2474;0;0;0;0;.00nan;0;0
14665;81085;710;75;21;1;20;.952;3600000;0
14667;-1;707;54;25;3;22;.880;3551000;0
14667;43925;712;68;32;2;30;.938;3600000;0
14667;145843;707;0;0;0;0;.00nan;0;0
14667;160866;712;0;0;0;0;.00nan;0;0
14669;-1;711;0;0;0;0;.00nan;0;0
14669;44200;711;74;11;0;11;1.000;3600000;0
14669;145787;2473;0;0;0;0;.00nan;0;0
14669;148503;2473;48;36;6;30;.833;3600000;0
14671;1213;713;63;35;3;32;.914;3600000;0
14671;8478;713;0;0;0;0;.00nan;0;0
14671;181748;714;67;21;2;19;.905;3600000;0
14671;145636;714;0;0;0;0;.00nan;0;0
14673;8477;2465;0;0;0;0;.00nan;0;0
14673;26308;706;69;25;2;23;.920;3600000;0
14673;-1;2465;33;28;5;23;.821;3600000;0
14673;156932;706;0;0;0;0;.00nan;0;0
14675;-1;711;61;15;1;14;.933;3600000;0
14675;-1;707;0;0;0;0;.00nan;0;0
14675;44200;711;0;0;0;0;.00nan;0;0
14675;145843;707;65;49;5;44;.898;3600000;0
14677;8477;706;0;0;0;0;.00nan;0;0
14677;180990;710;82;38;3;35;.921;3900000;0
14677;81085;710;0;0;0;0;.00nan;0;0
14677;156932;706;76;39;3;36;.923;3900000;0
14679;-1;2465;80;28;2;26;.929;3600000;0
14679;70115;2465;0;0;0;0;.00nan;0;0
14679;145787;2473;100;31;0;31;1.000;3600000;0
14679;148503;2473;0;0;0;0;.00nan;0;0
14681;1213;713;50;32;5;27;.844;3596000;0
14681;8478;713;0;0;0;0;.00nan;0;0
14681;145636;714;65;34;4;30;.882;3600000;0
14681;145733;714;0;0;0;0;.00nan;0;0
14683;5997;2474;0;0;0;0;.00nan;0;0
14683;43925;712;0;0;0;0;.00nan;0;0
14683;72229;2474;94;23;0;23;1.000;3600000;0
14683;160866;712;85;34;2;32;.941;3570000;0
14685;-1;2465;0;0;0;0;.00nan;0;0
14685;70115;2465;46;34;5;29;.853;3515000;0
14685;145636;714;70;35;3;32;.914;3600000;0
14685;145733;714;0;0;0;0;.00nan;0;0
14687;-1;711;49;15;2;13;.867;3600000;0
14687;43925;712;44;30;6;24;.800;2555000;0
14687;44200;711;0;0;0;0;.00nan;0;0
14687;160866;712;54;10;1;9;.900;1045000;0
14689;5997;2474;0;0;0;0;.00nan;0;0
14689;-1;707;94;47;3;44;.936;3555000;0
14689;72229;2474;73;26;2;24;.923;3600000;0
14689;145843;707;0;0;0;0;.00nan;0;0
14691;1213;713;38;22;4;18;.818;3512000;0
14691;8477;706;0;0;0;0;.00nan;0;0
14691;8478;713;0;0;0;0;.00nan;0;0
14691;156932;706;68;27;2;25;.926;3600000;0
14693;180990;710;69;22;1;21;.955;3600000;0
14693;81085;710;0;0;0;0;.00nan;0;0
14693;145787;2473;61;34;4;30;.882;3600000;0
14693;148503;2473;0;0;0;0;.00nan;0;0
14695;145636;714;0;0;0;0;.00nan;0;0
14695;145733;714;67;28;3;25;.893;3608000;0
14695;145787;2473;0;0;0;0;.00nan;0;0
14695;148503;2473;75;27;2;25;.926;3608000;0
14697;180990;710;0;0;0;0;.00nan;0;0
14697;43925;712;0;0;0;0;.00nan;0;0
14697;81085;710;52;27;4;23;.852;3600000;0
14697;160866;712;100;43;2;41;.953;3600000;0
14699;-1;711;0;0;0;0;.00nan;0;0
14699;-1;707;0;0;0;0;.00nan;0;0
14699;44200;711;73;16;1;15;.938;3900000;0
14699;145843;707;98;47;1;46;.979;3900000;0
14701;1213;713;0;0;0;0;.00nan;0;0
14701;8478;713;100;29;0;29;1.000;3600000;0
14701;-1;2465;23;26;6;20;.769;3125000;0
14701;70115;2465;46;7;1;6;.857;475000;0
14703;5997;2474;41;30;5;25;.833;3600000;0
14703;8477;706;61;23;2;21;.913;3600000;0
14703;72229;2474;0;0;0;0;.00nan;0;0
14703;156932;706;0;0;0;0;.00nan;0;0
14705;1213;713;97;26;0;26;1.000;3186000;0
14705;8478;713;24;5;3;2;.400;363000;0
14705;26308;706;68;21;1;20;.952;3600000;0
14705;156932;706;0;0;0;0;.00nan;0;0
14707;5997;2474;0;0;0;0;.00nan;0;0
14707;-1;2465;0;0;0;0;.00nan;0;0
14707;70115;2465;47;18;3;15;.833;3900000;0
14707;72229;2474;71;35;3;32;.914;3900000;0
14709;181748;714;37;32;5;27;.844;3600000;0
14709;145636;714;0;0;0;0;.00nan;0;0
14709;145787;2473;0;0;0;0;.00nan;0;0
14709;148503;2473;68;30;3;27;.900;3600000;0
14711;-1;711;53;2;0;2;1.000;415000;0
14711;180990;710;83;27;1;26;.963;3600000;0
14711;44200;711;33;24;5;19;.792;3185000;0
14711;81085;710;0;0;0;0;.00nan;0;0
14713;-1;707;86;38;2;36;.947;3524000;0
14713;43925;712;100;22;0;22;1.000;3600000;0
14713;145843;707;0;0;0;0;.00nan;0;0
14713;160866;712;0;0;0;0;.00nan;0;0
14715;5997;2474;55;25;3;22;.880;3582000;0
14715;26308;706;0;0;0;0;.00nan;0;0
14715;72229;2474;0;0;0;0;.00nan;0;0
14715;156932;706;49;16;2;14;.875;3600000;0
14717;-1;2465;95;25;0;25;1.000;3600000;0
14717;70115;2465;0;0;0;0;.00nan;0;0
14717;145787;2473;65;33;4;29;.879;3600000;0
14717;148503;2473;0;0;0;0;.00nan;0;0
14719;181748;714;0;0;0;0;.00nan;0;0
14719;-1;707;0;0;0;0;.00nan;0;0
14719;145636;714;45;14;3;11;.786;3600000;0
14719;145843;707;83;47;4;43;.915;3545000;0
14721;-1;711;72;31;2;29;.935;3600000;0
14721;180990;710;0;0;0;0;.00nan;0;0
14721;44200;711;0;0;0;0;.00nan;0;0
14721;81085;710;48;29;5;24;.828;3600000;0
14723;1213;713;0;0;0;0;.00nan;0;0
14723;8478;713;63;28;3;25;.893;3769000;0
14723;43925;712;71;36;4;32;.889;3769000;0
14723;160866;712;0;0;0;0;.00nan;0;0
14724;32712;611;0;0;0;0;.00nan;0;0
14724;73639;617;27;21;5;16;.762;3600000;0
14724;143100;611;100;43;0;43;1.000;3600000;0
14724;156221;617;0;0;0;0;.00nan;0;0
14725;168441;3923;80;49;4;45;.918;3600000;0
14725;173279;4644;72;24;1;23;.958;3600000;0
14725;30393;3923;0;0;0;0;.00nan;0;0
14725;84525;4644;0;0;0;0;.00nan;0;0
14726;10141;1910;72;27;2;25;.926;3600000;0
14726;78262;620;66;29;3;26;.897;3544000;0
14726;144410;1910;0;0;0;0;.00nan;0;0
14726;156298;620;0;0;0;0;.00nan;0;0
14727;175651;2319;51;27;4;23;.852;3558000;0
14727;73187;614;0;0;0;0;.00nan;0;0
14727;73699;2319;0;0;0;0;.00nan;0;0
14727;76406;614;67;28;3;25;.893;3600000;0
14728;192118;622;0;0;0;0;.00nan;0;0
14728;86394;619;0;0;0;0;.00nan;0;0
14728;149584;619;56;32;3;29;.906;3600000;0
14728;156322;622;62;18;2;16;.889;3600000;0
14729;32712;611;42;34;5;29;.853;2662000;0
14729;192118;622;0;0;0;0;.00nan;0;0
14729;143100;611;31;18;4;14;.778;938000;0
14729;156322;622;57;21;3;18;.857;3600000;0
14730;63402;612;80;22;1;21;.955;3600000;0
14730;76486;612;0;0;0;0;.00nan;0;0
14730;78262;620;76;40;4;36;.900;3600000;0
14730;156298;620;0;0;0;0;.00nan;0;0
14731;1061;2308;66;35;4;31;.886;3600000;0
14731;175651;2319;46;33;5;28;.848;3569000;0
14731;73699;2319;0;0;0;0;.00nan;0;0
14731;156254;2308;0;0;0;0;.00nan;0;0
14732;10141;1910;0;0;0;0;.00nan;0;0
14732;73639;617;0;0;0;0;.00nan;0;0
14732;144410;1910;65;34;4;30;.882;3600000;0
14732;156221;617;39;24;5;19;.792;3571000;0
14733;173279;4644;61;37;4;33;.892;3600000;0
14733;73187;614;0;0;0;0;.00nan;0;0
14733;76406;614;70;22;2;20;.909;3600000;0
14733;84525;4644;0;0;0;0;.00nan;0;0
14734;168441;3923;28;25;6;19;.760;2635000;0
14734;30393;3923;55;20;2;18;.900;965000;0
14734;86394;619;0;0;0;0;.00nan;0;0
14734;149584;619;79;26;1;25;.962;3600000;0
14735;73639;617;0;0;0;0;.00nan;0;0
14735;78262;620;28;31;6;25;.806;3600000;0
14735;156221;617;51;27;4;23;.852;3600000;0
14735;156298;620;0;0;0;0;.00nan;0;0
14736;168441;3923;57;43;5;38;.884;3600000;0
14736;30393;3923;0;0;0;0;.00nan;0;0
14736;32712;611;0;0;0;0;.00nan;0;0
14736;143100;611;65;33;4;29;.879;3600000;0
14737;1061;2308;65;34;3;31;.912;3600000;0
14737;173279;4644;81;42;4;38;.905;3544000;0
14737;84525;4644;0;0;0;0;.00nan;0;0
14737;156254;2308;0;0;0;0;.00nan;0;0
14738;10141;1910;0;0;0;0;.00nan;0;0
14738;192118;622;0;0;0;0;.00nan;0;0
14738;144410;1910;68;28;2;26;.929;3600000;0
14738;156322;622;59;15;1;14;.933;3600000;0
14739;73187;614;0;0;0;0;.00nan;0;0
14739;76406;614;80;33;3;30;.909;3552000;0
14739;86394;619;74;24;1;23;.958;3600000;0
14739;149584;619;0;0;0;0;.00nan;0;0
14740;175651;2319;65;53;6;47;.887;3600000;0
14740;176445;612;0;0;0;0;.00nan;0;0
14740;63402;612;73;21;1;20;.952;3600000;0
14740;73699;2319;0;0;0;0;.00nan;0;0
14741;1061;2308;70;26;2;24;.923;3600000;0
14741;176445;612;0;0;0;0;.00nan;0;0
14741;63402;612;70;39;5;34;.872;3600000;0
14741;156254;2308;0;0;0;0;.00nan;0;0
14742;192118;622;0;0;0;0;.00nan;0;0
14742;78262;620;0;0;0;0;.00nan;0;0
14742;156298;620;74;47;4;43;.915;3600000;0
14742;156322;622;98;21;0;21;1.000;3600000;0
14743;1061;2308;90;20;0;20;1.000;3600000;0
14743;86394;619;0;0;0;0;.00nan;0;0
14743;149584;619;96;58;3;55;.948;3600000;0
14743;156254;2308;0;0;0;0;.00nan;0;0
14744;63402;612;78;29;2;27;.931;3600000;0
14744;73639;617;0;0;0;0;.00nan;0;0
14744;76486;612;0;0;0;0;.00nan;0;0
14744;156221;617;63;28;4;24;.857;3577000;0
14745;32712;611;50;9;1;8;.889;1000000;0
14745;73187;614;0;0;0;0;.00nan;0;0
14745;76406;614;77;34;2;32;.941;3600000;0
14745;143100;611;12;26;7;19;.731;2600000;0
14746;10141;1910;56;10;1;9;.900;1226000;0
14746;168441;3923;92;41;2;39;.951;3600000;0
14746;30393;3923;0;0;0;0;.00nan;0;0
14746;144410;1910;16;24;6;18;.750;2374000;0
14747;173279;4644;75;24;1;23;.958;3600000;0
14747;175651;2319;89;34;2;32;.941;3551000;0
14747;73699;2319;0;0;0;0;.00nan;0;0
14747;84525;4644;0;0;0;0;.00nan;0;0
14748;168441;3923;22;32;7;25;.781;3102000;0
14748;30393;3923;51;2;0;2;1.000;425000;0
14748;78262;620;51;37;5;32;.865;3600000;0
14748;156298;620;0;0;0;0;.00nan;0;0
14749;1061;2308;72;25;2;23;.920;3600000;0
14749;32712;611;0;0;0;0;.00nan;0;0
14749;143100;611;47;36;5;31;.861;3600000;0
14749;156254;2308;0;0;0;0;.00nan;0;0
14750;192118;622;0;0;0;0;.00nan;0;0
14750;73639;617;77;35;3;32;.914;3600000;0
14750;156221;617;0;0;0;0;.00nan;0;0
14750;156322;622;100;25;0;25;1.000;3600000;0
14751;10141;1910;34;19;4;15;.789;1932000;0
14751;73187;614;0;0;0;0;.00nan;0;0
14751;76406;614;75;23;1;22;.957;3600000;0
14751;144410;1910;60;25;2;23;.920;1668000;0
14752;175651;2319;46;36;6;30;.833;3600000;0
14752;73699;2319;0;0;0;0;.00nan;0;0
14752;86394;619;0;0;0;0;.00nan;0;0
14752;149584;619;89;32;1;31;.969;3600000;0
14753;173279;4644;43;25;4;21;.840;3600000;0
14753;63402;612;84;31;1;30;.968;3600000;0
14753;76486;612;0;0;0;0;.00nan;0;0
14753;84525;4644;0;0;0;0;.00nan;0;0
14754;192118;622;0;0;0;0;.00nan;0;0
14754;63402;612;0;0;0;0;.00nan;0;0
14754;76486;612;64;53;5;48;.906;3600000;0
14754;156322;622;94;23;0;23;1.000;3600000;0
14755;1061;2308;66;32;3;29;.906;4200000;0
14755;10141;1910;0;0;0;0;.00nan;0;0
14755;144410;1910;54;23;3;20;.870;4200000;0
14755;156254;2308;0;0;0;0;.00nan;0;0
14756;173279;4644;0;0;0;0;.00nan;0;0
14756;84525;4644;57;25;3;22;.880;3600000;0
14756;86394;619;0;0;0;0;.00nan;0;0
14756;149584;619;49;34;5;29;.853;3554000;0
14757;73187;614;0;0;0;0;.00nan;0;0
14757;76406;614;55;19;3;16;.842;3629000;0
14757;78262;620;0;0;0;0;.00nan;0;0
14757;156298;620;90;40;2;38;.950;3629000;0
14758;168441;3923;0;0;0;0;.00nan;0;0
14758;30393;3923;83;54;6;48;.889;3600000;0
14758;73639;617;43;18;3;15;.833;2737000;0
14758;156221;617;20;6;4;2;.333;842000;0
14759;175651;2319;45;22;3;19;.864;3530000;0
14759;32712;611;0;0;0;0;.00nan;0;0
14759;73699;2319;0;0;0;0;.00nan;0;0
14759;143100;611;100;39;1;38;.974;3600000;0
14760;1061;2308;22;33;7;26;.788;2323000;0
14760;78262;620;0;0;0;0;.00nan;0;0
14760;156254;2308;49;6;1;5;.833;1277000;0
14760;156298;620;70;35;3;32;.914;3600000;0
14761;173279;4644;33;13;4;9;.692;1131000;0
14761;32712;611;0;0;0;0;.00nan;0;0
14761;84525;4644;28;28;6;22;.786;2469000;0
14761;143100;611;56;22;3;19;.864;3600000;0
14762;73187;614;0;0;0;0;.00nan;0;0
14762;73639;617;59;34;4;30;.882;3550000;0
14762;76406;614;59;28;3;25;.893;3600000;0
14762;156221;617;0;0;0;0;.00nan;0;0
14763;10141;1910;0;0;0;0;.00nan;0;0
14763;175651;2319;0;0;0;0;.00nan;0;0
14763;73699;2319;92;18;0;18;1.000;3600000;0
14763;144410;1910;78;34;2;32;.941;3549000;0
14764;63402;612;49;37;5;32;.865;3600000;0
14764;76486;612;0;0;0;0;.00nan;0;0
14764;86394;619;94;38;1;37;.974;3600000;0
14764;149584;619;0;0;0;0;.00nan;0;0
14765;1061;2308;89;35;2;33;.943;3610000;0
14765;73639;617;0;0;0;0;.00nan;0;0
14765;156221;617;69;30;3;27;.900;3610000;0
14765;156254;2308;0;0;0;0;.00nan;0;0
14766;10141;1910;0;0;0;0;.00nan;0;0
14766;173279;4644;73;29;2;27;.931;3600000;0
14766;84525;4644;0;0;0;0;.00nan;0;0
14766;144410;1910;60;31;3;28;.903;3600000;0
14767;192118;622;0;0;0;0;.00nan;0;0
14767;73187;614;59;44;5;39;.886;3600000;0
14767;76406;614;0;0;0;0;.00nan;0;0
14767;156322;622;90;29;1;28;.966;3600000;0
14768;168441;3923;83;49;4;45;.918;4200000;0
14768;30393;3923;0;0;0;0;.00nan;0;0
14768;63402;612;0;0;0;0;.00nan;0;0
14768;76486;612;63;35;4;31;.886;4200000;0
14769;175651;2319;0;0;0;0;.00nan;0;0
14769;73699;2319;67;24;2;22;.917;3600000;0
14769;78262;620;36;30;6;24;.800;3600000;0
14769;156298;620;0;0;0;0;.00nan;0;0
14770;32712;611;0;0;0;0;.00nan;0;0
14770;86394;619;0;0;0;0;.00nan;0;0
14770;143100;611;88;33;2;31;.939;4200000;0
14770;149584;619;70;28;2;26;.929;4200000;0
14771;1061;2308;56;35;5;30;.857;3597000;0
14771;192118;622;0;0;0;0;.00nan;0;0
14771;156254;2308;0;0;0;0;.00nan;0;0
14771;156322;622;51;21;3;18;.857;3600000;0
14772;173279;4644;95;23;0;23;1.000;3600000;0
14772;78262;620;79;30;2;28;.933;2455000;0
14772;84525;4644;0;0;0;0;.00nan;0;0
14772;156298;620;25;11;4;7;.636;1145000;0
14773;175651;2319;0;0;0;0;.00nan;0;0
14773;73639;617;41;30;5;25;.833;4200000;0
14773;73699;2319;71;40;5;35;.875;4200000;0
14773;156221;617;0;0;0;0;.00nan;0;0
14774;10141;1910;0;0;0;0;.00nan;0;0
14774;86394;619;0;0;0;0;.00nan;0;0
14774;144410;1910;82;41;3;38;.927;4200000;0
14774;149584;619;69;34;3;31;.912;4200000;0
14775;168441;3923;88;44;2;42;.955;3579000;0
14775;30393;3923;0;0;0;0;.00nan;0;0
14775;73187;614;0;0;0;0;.00nan;0;0
14775;76406;614;93;32;1;31;.969;3600000;0
14776;32712;611;0;0;0;0;.00nan;0;0
14776;63402;612;43;28;5;23;.821;2043000;0
14776;76486;612;81;22;0;22;1.000;1557000;0
14776;143100;611;70;18;1;17;.944;3600000;0
14777;10141;1910;0;0;0;0;.00nan;0;0
14777;32712;611;69;23;2;21;.913;3600000;0
14777;143100;611;0;0;0;0;.00nan;0;0
14777;144410;1910;55;31;4;27;.871;3563000;0
14778;1061;2308;0;0;0;0;.00nan;0;0
14778;168441;3923;27;31;6;25;.806;2713000;0
14778;30393;3923;52;16;2;14;.875;887000;0
14778;156254;2308;70;21;2;19;.905;3600000;0
14779;173279;4644;95;21;0;21;1.000;3600000;0
14779;73639;617;0;0;0;0;.00nan;0;0
14779;84525;4644;0;0;0;0;.00nan;0;0
14779;156221;617;55;35;4;31;.886;3600000;0
14780;175651;2319;89;57;3;54;.947;3600000;0
14780;192118;622;0;0;0;0;.00nan;0;0
14780;73699;2319;0;0;0;0;.00nan;0;0
14780;156322;622;55;16;2;14;.875;3600000;0
14781;78262;620;80;36;3;33;.917;3600000;0
14781;86394;619;58;17;2;15;.882;3600000;0
14781;149584;619;0;0;0;0;.00nan;0;0
14781;156298;620;0;0;0;0;.00nan;0;0
14782;173279;4644;82;54;5;49;.907;3600000;0
14782;192118;622;0;0;0;0;.00nan;0;0
14782;84525;4644;0;0;0;0;.00nan;0;0
14782;156322;622;85;14;0;14;1.000;3600000;0
14783;32712;611;0;0;0;0;.00nan;0;0
14783;78262;620;0;0;0;0;.00nan;0;0
14783;143100;611;42;23;4;19;.826;3514000;0
14783;156298;620;78;31;2;29;.935;3600000;0
14784;73639;617;0;0;0;0;.00nan;0;0
14784;86394;619;0;0;0;0;.00nan;0;0
14784;149584;619;68;34;3;31;.912;3600000;0
14784;156221;617;30;26;5;21;.808;3532000;0
14785;1061;2308;57;30;4;26;.867;3713000;0
14785;73187;614;0;0;0;0;.00nan;0;0
14785;76406;614;74;47;5;42;.894;3713000;0
14785;156254;2308;0;0;0;0;.00nan;0;0
14786;168441;3923;0;0;0;0;.00nan;0;0
14786;175651;2319;0;0;0;0;.00nan;0;0
14786;30393;3923;77;46;3;43;.935;4200000;0
14786;73699;2319;55;31;3;28;.903;4200000;0
14787;10141;1910;0;0;0;0;.00nan;0;0
14787;63402;612;0;0;0;0;.00nan;0;0
14787;76486;612;73;21;1;20;.952;3600000;0
14787;144410;1910;70;45;3;42;.933;3592000;0
14788;32712;611;0;0;0;0;.00nan;0;0
14788;78262;620;27;14;4;10;.714;888000;0
14788;143100;611;88;19;0;19;1.000;3600000;0
14788;156298;620;61;24;3;21;.875;2712000;0
14789;1061;2308;100;22;0;22;1.000;3600000;0
14789;73187;614;0;0;0;0;.00nan;0;0
14789;76406;614;75;43;3;40;.930;3600000;0
14789;156254;2308;0;0;0;0;.00nan;0;0
14790;173279;4644;98;50;2;48;.960;3560000;0
14790;192118;622;0;0;0;0;.00nan;0;0
14790;84525;4644;0;0;0;0;.00nan;0;0
14790;156322;622;84;15;0;15;1.000;3600000;0
14791;168441;3923;68;38;4;34;.895;3933000;0
14791;175651;2319;0;0;0;0;.00nan;0;0
14791;30393;3923;0;0;0;0;.00nan;0;0
14791;73699;2319;56;25;3;22;.880;3933000;0
14792;73639;617;65;17;1;16;.941;1939000;0
14792;86394;619;0;0;0;0;.00nan;0;0
14792;149584;619;78;28;2;26;.929;3600000;0
14792;156221;617;15;18;6;12;.667;1661000;0
14793;175651;2319;0;0;0;0;.00nan;0;0
14793;192118;622;0;0;0;0;.00nan;0;0
14793;73699;2319;33;40;7;33;.825;3600000;0
14793;156322;622;80;20;2;18;.900;3600000;0
14794;78262;620;70;29;2;27;.931;3600000;0
14794;86394;619;0;0;0;0;.00nan;0;0
14794;149584;619;92;21;0;21;1.000;3600000;0
14794;156298;620;0;0;0;0;.00nan;0;0
14795;173279;4644;98;32;1;31;.969;4200000;0
14795;73639;617;85;34;1;33;.971;4200000;0
14795;84525;4644;0;0;0;0;.00nan;0;0
14795;156221;617;0;0;0;0;.00nan;0;0
14796;10141;1910;61;22;2;20;.909;3600000;0
14796;32712;611;0;0;0;0;.00nan;0;0
14796;143100;611;72;34;3;31;.912;3600000;0
14796;144410;1910;0;0;0;0;.00nan;0;0
14797;1061;2308;55;24;3;21;.875;3539000;0
14797;168441;3923;0;0;0;0;.00nan;0;0
14797;30393;3923;90;39;2;37;.949;3600000;0
14797;156254;2308;0;0;0;0;.00nan;0;0
14798;63402;612;93;36;2;34;.944;3600000;0
14798;73187;614;0;0;0;0;.00nan;0;0
14798;76406;614;39;22;4;18;.818;3575000;0
14798;76486;612;0;0;0;0;.00nan;0;0
14799;63402;612;100;31;0;31;1.000;3600000;0
14799;73187;614;0;0;0;0;.00nan;0;0
14799;76406;614;63;45;5;40;.889;3600000;0
14799;76486;612;0;0;0;0;.00nan;0;0
14800;32712;611;0;0;0;0;.00nan;0;0
14800;63402;612;72;33;3;30;.909;4183000;0
14800;76486;612;0;0;0;0;.00nan;0;0
14800;143100;611;91;36;3;33;.917;4200000;0
14801;1061;2308;100;46;3;43;.935;3680000;0
14801;192118;622;0;0;0;0;.00nan;0;0
14801;156254;2308;0;0;0;0;.00nan;0;0
14801;156322;622;42;20;4;16;.800;3680000;0
14802;173279;4644;34;33;6;27;.818;3600000;0
14802;78262;620;0;0;0;0;.00nan;0;0
14802;84525;4644;0;0;0;0;.00nan;0;0
14802;156298;620;70;29;3;26;.897;3600000;0
14803;168441;3923;0;0;0;0;.00nan;0;0
14803;30393;3923;75;40;3;37;.925;3600000;0
14803;73187;614;0;0;0;0;.00nan;0;0
14803;76406;614;32;19;4;15;.789;3544000;0
14804;175651;2319;63;26;2;24;.923;3600000;0
14804;73639;617;51;25;4;21;.840;3547000;0
14804;73699;2319;0;0;0;0;.00nan;0;0
14804;156221;617;0;0;0;0;.00nan;0;0
14805;10141;1910;45;18;3;15;.833;1490000;0
14805;86394;619;0;0;0;0;.00nan;0;0
14805;144410;1910;40;25;4;21;.840;2110000;0
14805;149584;619;68;19;1;18;.947;3600000;0
14806;192118;622;0;0;0;0;.00nan;0;0
14806;73187;614;0;0;0;0;.00nan;0;0
14806;76406;614;94;51;3;48;.941;3600000;0
14806;156322;622;87;15;0;15;1.000;3600000;0
14807;32712;611;0;0;0;0;.00nan;0;0
14807;86394;619;0;0;0;0;.00nan;0;0
14807;143100;611;77;22;1;21;.955;3600000;0
14807;149584;619;77;33;3;30;.909;3540000;0
14808;1061;2308;78;33;3;30;.909;3600000;0
14808;73639;617;0;0;0;0;.00nan;0;0
14808;156221;617;62;32;4;28;.875;3600000;0
14808;156254;2308;0;0;0;0;.00nan;0;0
14809;10141;1910;0;0;0;0;.00nan;0;0
14809;173279;4644;70;32;2;30;.938;4078000;0
14809;84525;4644;0;0;0;0;.00nan;0;0
14809;144410;1910;74;27;1;26;.963;4078000;0
14810;168441;3923;41;2;1;1;.500;660000;0
14810;30393;3923;41;39;6;33;.846;2940000;0
14810;63402;612;100;19;0;19;1.000;3600000;0
14810;76486;612;0;0;0;0;.00nan;0;0
14811;1061;2308;66;21;2;19;.905;3600000;0
14811;78262;620;62;24;3;21;.875;1610000;0
14811;156254;2308;0;0;0;0;.00nan;0;0
14811;156298;620;37;25;5;20;.800;1990000;0
14812;173279;4644;0;0;0;0;.00nan;0;0
14812;32712;611;0;0;0;0;.00nan;0;0
14812;84525;4644;50;24;3;21;.875;3550000;0
14812;143100;611;76;31;2;29;.935;3600000;0
14813;73187;614;0;0;0;0;.00nan;0;0
14813;73639;617;71;32;3;29;.906;3544000;0
14813;76406;614;68;26;2;24;.923;3600000;0
14813;156221;617;0;0;0;0;.00nan;0;0
14814;168441;3923;99;48;2;46;.958;3600000;0
14814;30393;3923;0;0;0;0;.00nan;0;0
14814;192118;622;0;0;0;0;.00nan;0;0
14814;156322;622;49;29;4;25;.862;3600000;0
14815;10141;1910;0;0;0;0;.00nan;0;0
14815;175651;2319;0;0;0;0;.00nan;0;0
14815;73699;2319;54;15;2;13;.867;3600000;0
14815;144410;1910;53;39;5;34;.872;3600000;0
14816;63402;612;79;38;3;35;.921;4200000;0
14816;76486;612;0;0;0;0;.00nan;0;0
14816;86394;619;0;0;0;0;.00nan;0;0
14816;149584;619;93;42;3;39;.929;4200000;0
14817;73187;614;0;0;0;0;.00nan;0;0
14817;76406;614;88;16;0;16;1.000;3600000;0
14817;78262;620;81;52;5;47;.904;3600000;0
14817;156298;620;0;0;0;0;.00nan;0;0
14818;175651;2319;76;39;3;36;.923;3709000;0
14818;32712;611;0;0;0;0;.00nan;0;0
14818;73699;2319;0;0;0;0;.00nan;0;0
14818;143100;611;62;25;4;21;.840;3709000;0
14819;1061;2308;72;26;3;23;.885;4200000;0
14819;10141;1910;70;39;3;36;.923;4200000;0
14819;144410;1910;0;0;0;0;.00nan;0;0
14819;156254;2308;0;0;0;0;.00nan;0;0
14820;173279;4644;42;42;6;36;.857;3726000;0
14820;84525;4644;0;0;0;0;.00nan;0;0
14820;86394;619;39;27;5;22;.815;3726000;0
14820;149584;619;0;0;0;0;.00nan;0;0
14821;192118;622;0;0;0;0;.00nan;0;0
14821;63402;612;86;28;1;27;.964;3600000;0
14821;76486;612;0;0;0;0;.00nan;0;0
14821;156322;622;78;35;2;33;.943;3600000;0
14822;175651;2319;0;0;0;0;.00nan;0;0
14822;73699;2319;50;25;4;21;.840;3557000;0
14822;78262;620;88;42;3;39;.929;3600000;0
14822;156298;620;0;0;0;0;.00nan;0;0
14823;192118;622;0;0;0;0;.00nan;0;0
14823;73639;617;16;25;7;18;.720;1686000;0
14823;156221;617;65;17;1;16;.941;1914000;0
14823;156322;622;80;15;0;15;1.000;3600000;0
14824;1061;2308;57;28;4;24;.857;3600000;0
14824;32712;611;0;0;0;0;.00nan;0;0
14824;143100;611;100;36;1;35;.972;3600000;0
14824;156254;2308;0;0;0;0;.00nan;0;0
14825;173279;4644;34;28;6;22;.786;3008000;0
14825;63402;612;93;19;0;19;1.000;3600000;0
14825;76486;612;0;0;0;0;.00nan;0;0
14825;84525;4644;59;7;0;7;1.000;592000;0
14826;10141;1910;52;4;0;4;1.000;310000;0
14826;73187;614;0;0;0;0;.00nan;0;0
14826;76406;614;24;20;5;15;.750;3600000;0
14826;144410;1910;35;34;6;28;.824;3290000;0
14827;168441;3923;54;28;4;24;.857;3560000;0
14827;30393;3923;0;0;0;0;.00nan;0;0
14827;78262;620;0;0;0;0;.00nan;0;0
14827;156298;620;73;28;3;25;.893;3600000;0
14828;175651;2319;63;36;4;32;.889;3564000;0
14828;73699;2319;0;0;0;0;.00nan;0;0
14828;86394;619;0;0;0;0;.00nan;0;0
14828;149584;619;90;45;3;42;.933;3600000;0
14829;192118;622;0;0;0;0;.00nan;0;0
14829;78262;620;42;40;6;34;.850;1805000;0
14829;156298;620;67;23;2;21;.913;1795000;0
14829;156322;622;28;20;5;15;.750;3600000;0
14830;32712;611;0;0;0;0;.00nan;0;0
14830;73187;614;0;0;0;0;.00nan;0;0
14830;76406;614;91;34;1;33;.971;3600000;0
14830;143100;611;68;24;2;22;.917;3600000;0
14831;173279;4644;84;36;2;34;.944;3600000;0
14831;175651;2319;0;0;0;0;.00nan;0;0
14831;73699;2319;54;21;4;17;.810;3541000;0
14831;84525;4644;0;0;0;0;.00nan;0;0
14832;10141;1910;72;31;3;28;.903;3600000;0
14832;168441;3923;0;0;0;0;.00nan;0;0
14832;30393;3923;50;30;4;26;.867;3577000;0
14832;144410;1910;0;0;0;0;.00nan;0;0
14833;1061;2308;84;34;3;31;.912;3600000;0
14833;86394;619;79;24;1;23;.958;2990000;0
14833;149584;619;34;9;3;6;.667;571000;0
14833;156254;2308;0;0;0;0;.00nan;0;0
14834;63402;612;75;34;3;31;.912;4200000;0
14834;73639;617;0;0;0;0;.00nan;0;0
14834;76486;612;0;0;0;0;.00nan;0;0
14834;156221;617;78;33;3;30;.909;4200000;0
14835;10141;1910;0;0;0;0;.00nan;0;0
14835;192118;622;0;0;0;0;.00nan;0;0
14835;144410;1910;63;33;4;29;.879;3600000;0
14835;156322;622;73;9;0;9;1.000;3600000;0
14836;1061;2308;64;20;1;19;.950;2788000;0
14836;173279;4644;93;33;1;32;.970;3600000;0
14836;84525;4644;0;0;0;0;.00nan;0;0
14836;156254;2308;21;11;4;7;.636;812000;0
14837;73639;617;0;0;0;0;.00nan;0;0
14837;78262;620;0;0;0;0;.00nan;0;0
14837;156221;617;63;25;2;23;.920;3600000;0
14837;156298;620;75;37;3;34;.919;3562000;0
14838;73187;614;71;29;3;26;.897;3600000;0
14838;76406;614;0;0;0;0;.00nan;0;0
14838;86394;619;0;0;0;0;.00nan;0;0
14838;149584;619;61;37;5;32;.865;3533000;0
14839;168441;3923;48;45;6;39;.867;3600000;0
14839;30393;3923;0;0;0;0;.00nan;0;0
14839;32712;611;0;0;0;0;.00nan;0;0
14839;143100;611;36;25;5;20;.800;3600000;0
14840;175651;2319;68;29;3;26;.897;3767000;0
14840;63402;612;63;36;4;32;.889;3767000;0
14840;73699;2319;0;0;0;0;.00nan;0;0
14840;76486;612;0;0;0;0;.00nan;0;0
14841;32712;611;75;46;4;42;.913;3600000;0
14841;192118;622;0;0;0;0;.00nan;0;0
14841;143100;611;0;0;0;0;.00nan;0;0
14841;156322;622;50;20;3;17;.850;3600000;0
14842;173279;4644;71;43;3;40;.930;3572000;0
14842;73187;614;0;0;0;0;.00nan;0;0
14842;76406;614;84;24;1;23;.958;3600000;0
14842;84525;4644;0;0;0;0;.00nan;0;0
14843;10141;1910;44;30;5;25;.833;3644000;0
14843;73639;617;0;0;0;0;.00nan;0;0
14843;144410;1910;0;0;0;0;.00nan;0;0
14843;156221;617;55;31;4;27;.871;3644000;0
14844;1061;2308;73;27;2;25;.926;3600000;0
14844;175651;2319;69;34;3;31;.912;3600000;0
14844;73699;2319;0;0;0;0;.00nan;0;0
14844;156254;2308;0;0;0;0;.00nan;0;0
14845;168441;3923;30;16;4;12;.750;941000;0
14845;30393;3923;70;30;2;28;.933;2659000;0
14845;86394;619;45;18;3;15;.833;3600000;0
14845;149584;619;0;0;0;0;.00nan;0;0
14846;63402;612;88;29;1;28;.966;3600000;0
14846;76486;612;0;0;0;0;.00nan;0;0
14846;78262;620;69;30;2;28;.933;3560000;0
14846;156298;620;0;0;0;0;.00nan;0;0
14847;192118;622;0;0;0;0;.00nan;0;0
14847;86394;619;0;0;0;0;.00nan;0;0
14847;149584;619;69;44;4;40;.909;3600000;0
14847;156322;622;60;13;2;11;.846;3600000;0
14848;10141;1910;0;0;0;0;.00nan;0;0
14848;78262;620;0;0;0;0;.00nan;0;0
14848;144410;1910;37;30;5;25;.833;3970000;0
14848;156298;620;58;37;6;31;.838;3970000;0
14849;1061;2308;82;51;4;47;.922;4200000;0
14849;63402;612;63;32;4;28;.875;4200000;0
14849;76486;612;0;0;0;0;.00nan;0;0
14849;156254;2308;0;0;0;0;.00nan;0;0
14850;32712;611;0;0;0;0;.00nan;0;0
14850;73639;617;80;32;2;30;.938;3600000;0
14850;143100;611;65;35;5;30;.857;3600000;0
14850;156221;617;0;0;0;0;.00nan;0;0
14851;175651;2319;27;30;6;24;.800;3600000;0
14851;73187;614;0;0;0;0;.00nan;0;0
14851;73699;2319;0;0;0;0;.00nan;0;0
14851;76406;614;88;39;2;37;.949;3600000;0
14852;168441;3923;0;0;0;0;.00nan;0;0
14852;173279;4644;76;41;3;38;.927;3600000;0
14852;30393;3923;60;35;4;31;.886;3600000;0
14852;84525;4644;0;0;0;0;.00nan;0;0
14853;175651;2319;0;0;0;0;.00nan;0;0
14853;192118;622;0;0;0;0;.00nan;0;0
14853;73699;2319;73;61;7;54;.885;3600000;0
14853;156322;622;44;22;4;18;.818;3600000;0
14854;10141;1910;0;0;0;0;.00nan;0;0
14854;78262;620;0;0;0;0;.00nan;0;0
14854;144410;1910;58;37;4;33;.892;3542000;0
14854;156298;620;60;24;3;21;.875;3600000;0
14855;1061;2308;61;28;3;25;.893;3600000;0
14855;32712;611;0;0;0;0;.00nan;0;0
14855;143100;611;59;31;4;27;.871;3600000;0
14855;156254;2308;0;0;0;0;.00nan;0;0
14856;173279;4644;69;37;2;35;.946;4200000;0
14856;73639;617;0;0;0;0;.00nan;0;0
14856;84525;4644;0;0;0;0;.00nan;0;0
14856;156221;617;96;35;2;33;.943;4200000;0
14857;73187;614;0;0;0;0;.00nan;0;0
14857;76406;614;51;36;5;31;.861;3600000;0
14857;86394;619;68;24;2;22;.917;3600000;0
14857;149584;619;0;0;0;0;.00nan;0;0
14858;168441;3923;46;52;8;44;.846;3600000;0
14858;30393;3923;0;0;0;0;.00nan;0;0
14858;63402;612;0;0;0;0;.00nan;0;0
14858;76486;612;49;24;4;20;.833;3600000;0
14859;1061;2308;80;40;3;37;.925;3556000;0
14859;192118;622;0;0;0;0;.00nan;0;0
14859;156254;2308;0;0;0;0;.00nan;0;0
14859;156322;622;73;20;1;19;.950;3600000;0
14860;73639;617;69;20;1;19;.950;3600000;0
14860;78262;620;63;8;0;8;1.000;842000;0
14860;156221;617;0;0;0;0;.00nan;0;0
14860;156298;620;24;28;6;22;.786;2758000;0
14861;10141;1910;16;23;6;17;.739;1953000;0
14861;63402;612;64;18;1;17;.944;3600000;0
14861;76486;612;0;0;0;0;.00nan;0;0
14861;144410;1910;57;18;2;16;.889;1647000;0
14862;32712;611;65;14;1;13;.929;1662000;0
14862;73187;614;0;0;0;0;.00nan;0;0
14862;76406;614;66;27;2;25;.926;3600000;0
14862;143100;611;19;19;6;13;.684;1938000;0
14863;168441;3923;65;36;4;32;.889;3561000;0
14863;30393;3923;0;0;0;0;.00nan;0;0
14863;86394;619;0;0;0;0;.00nan;0;0
14863;149584;619;68;24;2;22;.917;3600000;0
14864;173279;4644;34;22;5;17;.773;3600000;0
14864;175651;2319;0;0;0;0;.00nan;0;0
14864;73699;2319;78;27;2;25;.926;3600000;0
14864;84525;4644;0;0;0;0;.00nan;0;0
14865;192118;622;0;0;0;0;.00nan;0;0
14865;73187;614;64;19;2;17;.895;945000;0
14865;76406;614;59;50;7;43;.860;2655000;0
14865;156322;622;63;19;2;17;.895;3600000;0
14866;168441;3923;0;0;0;0;.00nan;0;0
14866;30393;3923;94;33;1;32;.970;3600000;0
14866;32712;611;0;0;0;0;.00nan;0;0
14866;143100;611;71;22;2;20;.909;3578000;0
14867;173279;4644;100;26;0;26;1.000;3600000;0
14867;78262;620;0;0;0;0;.00nan;0;0
14867;84525;4644;0;0;0;0;.00nan;0;0
14867;156298;620;82;30;2;28;.933;3562000;0
14868;1061;2308;38;28;5;23;.821;3761000;0
14868;175651;2319;50;31;4;27;.871;3761000;0
14868;73699;2319;0;0;0;0;.00nan;0;0
14868;156254;2308;0;0;0;0;.00nan;0;0
14869;10141;1910;0;0;0;0;.00nan;0;0
14869;86394;619;0;0;0;0;.00nan;0;0
14869;144410;1910;82;49;3;46;.939;3598000;0
14869;149584;619;70;20;2;18;.900;3600000;0
14870;63402;612;75;27;2;25;.926;3600000;0
14870;73639;617;0;0;0;0;.00nan;0;0
14870;76486;612;0;0;0;0;.00nan;0;0
14870;156221;617;66;39;4;35;.897;3577000;0
14871;63402;612;50;27;4;23;.852;3600000;0
14871;76486;612;0;0;0;0;.00nan;0;0
14871;78262;620;54;11;1;10;.909;778000;0
14871;156298;620;48;42;6;36;.857;2822000;0
14872;1061;2308;73;24;1;23;.958;3600000;0
14872;173279;4644;45;17;3;14;.824;552000;0
14872;84525;4644;49;24;4;20;.833;3048000;0
14872;156254;2308;0;0;0;0;.00nan;0;0
14873;73639;617;0;0;0;0;.00nan;0;0
14873;86394;619;60;11;0;11;1.000;785000;0
14873;149584;619;36;31;6;25;.806;2781000;0
14873;156221;617;56;27;4;23;.852;3600000;0
14874;10141;1910;0;0;0;0;.00nan;0;0
14874;32712;611;0;0;0;0;.00nan;0;0
14874;143100;611;57;36;4;32;.889;4126000;0
14874;144410;1910;57;42;5;37;.881;4126000;0
14875;175651;2319;0;0;0;0;.00nan;0;0
14875;73187;614;0;0;0;0;.00nan;0;0
14875;73699;2319;81;33;3;30;.909;3557000;0
14875;76406;614;86;31;1;30;.968;3600000;0
14876;168441;3923;55;48;6;42;.875;3600000;0
14876;30393;3923;0;0;0;0;.00nan;0;0
14876;192118;622;0;0;0;0;.00nan;0;0
14876;156322;622;52;9;1;8;.889;3600000;0
14877;10141;1910;35;33;6;27;.818;2279000;0
14877;192118;622;0;0;0;0;.00nan;0;0
14877;144410;1910;58;18;2;16;.889;1321000;0
14877;156322;622;59;19;2;17;.895;3600000;0
14878;32712;611;0;0;0;0;.00nan;0;0
14878;73639;617;0;0;0;0;.00nan;0;0
14878;143100;611;56;30;4;26;.867;3545000;0
14878;156221;617;85;36;3;33;.917;3600000;0
14879;1061;2308;95;33;2;31;.939;3587000;0
14879;73187;614;0;0;0;0;.00nan;0;0
14879;76406;614;100;29;0;29;1.000;3600000;0
14879;156254;2308;0;0;0;0;.00nan;0;0
14880;173279;4644;100;44;0;44;1.000;3600000;0
14880;63402;612;82;22;1;21;.955;3574000;0
14880;76486;612;0;0;0;0;.00nan;0;0
14880;84525;4644;0;0;0;0;.00nan;0;0
14881;168441;3923;0;0;0;0;.00nan;0;0
14881;175651;2319;57;25;3;22;.880;3600000;0
14881;30393;3923;71;48;4;44;.917;3555000;0
14881;73699;2319;0;0;0;0;.00nan;0;0
14882;78262;620;0;0;0;0;.00nan;0;0
14882;86394;619;69;24;2;22;.917;3600000;0
14882;149584;619;0;0;0;0;.00nan;0;0
14882;156298;620;61;40;4;36;.900;3600000;0
14883;32712;611;0;0;0;0;.00nan;0;0
14883;78262;620;59;24;2;22;.917;3600000;0
14883;143100;611;100;25;0;25;1.000;3600000;0
14883;156298;620;0;0;0;0;.00nan;0;0
14884;192118;622;0;0;0;0;.00nan;0;0
14884;73639;617;24;11;4;7;.636;448000;0
14884;156221;617;50;47;7;40;.851;3152000;0
14884;156322;622;77;17;1;16;.941;3600000;0
14885;10141;1910;0;0;0;0;.00nan;0;0
14885;175651;2319;0;0;0;0;.00nan;0;0
14885;73699;2319;70;19;1;18;.947;3600000;0
14885;144410;1910;100;26;0;26;1.000;3600000;0
14886;173279;4644;65;39;3;36;.923;3600000;0
14886;73187;614;0;0;0;0;.00nan;0;0
14886;76406;614;100;30;0;30;1.000;3600000;0
14886;84525;4644;0;0;0;0;.00nan;0;0
14887;1061;2308;67;14;1;13;.929;3600000;0
14887;168441;3923;59;41;6;35;.854;3347000;0
14887;30393;3923;50;7;1;6;.857;253000;0
14887;156254;2308;0;0;0;0;.00nan;0;0
14888;63402;612;71;36;3;33;.917;3545000;0
14888;76486;612;0;0;0;0;.00nan;0;0
14888;86394;619;75;26;2;24;.923;3600000;0
14888;149584;619;0;0;0;0;.00nan;0;0
14889;192118;622;60;13;1;12;.923;3600000;0
14889;78262;620;50;1;0;1;1.000;329000;0
14889;156298;620;65;54;6;48;.889;3271000;0
14889;156322;622;0;0;0;0;.00nan;0;0
14890;32712;611;0;0;0;0;.00nan;0;0
14890;63402;612;79;25;1;24;.960;3600000;0
14890;76486;612;0;0;0;0;.00nan;0;0
14890;143100;611;73;29;2;27;.931;3572000;0
14891;1061;2308;38;16;4;12;.750;3543000;0
14891;10141;1910;0;0;0;0;.00nan;0;0
14891;144410;1910;88;50;3;47;.940;3600000;0
14891;156254;2308;0;0;0;0;.00nan;0;0
14892;173279;4644;0;0;0;0;.00nan;0;0
14892;84525;4644;84;31;1;30;.968;3600000;0
14892;86394;619;6;17;6;11;.647;3600000;0
14892;149584;619;0;0;0;0;.00nan;0;0
14893;168441;3923;59;37;5;32;.865;3600000;0
14893;30393;3923;0;0;0;0;.00nan;0;0
14893;73187;614;0;0;0;0;.00nan;0;0
14893;76406;614;48;17;3;14;.824;3600000;0
14894;175651;2319;59;25;3;22;.880;3995000;0
14894;73639;617;58;39;4;35;.897;3995000;0
14894;73699;2319;0;0;0;0;.00nan;0;0
14894;156221;617;0;0;0;0;.00nan;0;0
14895;175651;2319;72;21;1;20;.952;3600000;0
14895;73699;2319;0;0;0;0;.00nan;0;0
14895;78262;620;54;30;4;26;.867;3600000;0
14895;156298;620;0;0;0;0;.00nan;0;0
14896;1061;2308;67;24;2;22;.917;3600000;0
14896;73639;617;0;0;0;0;.00nan;0;0
14896;156221;617;72;35;3;32;.914;3600000;0
14896;156254;2308;0;0;0;0;.00nan;0;0
14897;10141;1910;0;0;0;0;.00nan;0;0
14897;73187;614;0;0;0;0;.00nan;0;0
14897;76406;614;94;40;2;38;.950;4200000;0
14897;144410;1910;93;43;2;41;.953;4200000;0
14898;168441;3923;64;8;0;8;1.000;601000;0
14898;173279;4644;69;17;1;16;.941;3600000;0
14898;30393;3923;41;46;7;39;.848;2999000;0
14898;84525;4644;0;0;0;0;.00nan;0;0
14899;32712;611;0;0;0;0;.00nan;0;0
14899;86394;619;80;23;1;22;.957;3600000;0
14899;143100;611;44;29;5;24;.828;3600000;0
14899;149584;619;0;0;0;0;.00nan;0;0
14900;192118;622;0;0;0;0;.00nan;0;0
14900;63402;612;0;0;0;0;.00nan;0;0
14900;76486;612;77;38;3;35;.921;3531000;0
14900;156322;622;75;20;1;19;.950;3600000;0
14901;192118;622;0;0;0;0;.00nan;0;0
14901;86394;619;50;36;5;31;.861;3600000;0
14901;149584;619;0;0;0;0;.00nan;0;0
14901;156322;622;65;23;2;21;.913;3600000;0
14902;1061;2308;77;16;0;16;1.000;3600000;0
14902;78262;620;0;0;0;0;.00nan;0;0
14902;156254;2308;0;0;0;0;.00nan;0;0
14902;156298;620;60;38;5;33;.868;3600000;0
14903;173279;4644;62;35;4;31;.886;3600000;0
14903;32712;611;0;0;0;0;.00nan;0;0
14903;84525;4644;0;0;0;0;.00nan;0;0
14903;143100;611;68;30;3;27;.900;3600000;0
14904;73187;614;0;0;0;0;.00nan;0;0
14904;73639;617;0;0;0;0;.00nan;0;0
14904;76406;614;60;35;5;30;.857;3580000;0
14904;156221;617;71;40;4;36;.900;3600000;0
14905;10141;1910;0;0;0;0;.00nan;0;0
14905;168441;3923;100;39;2;37;.949;3600000;0
14905;30393;3923;0;0;0;0;.00nan;0;0
14905;144410;1910;27;27;6;21;.778;3600000;0
14906;175651;2319;37;19;4;15;.789;3015000;0
14906;63402;612;92;20;0;20;1.000;3600000;0
14906;73699;2319;28;13;4;9;.692;585000;0
14906;76486;612;0;0;0;0;.00nan;0;0
14907;73187;614;0;0;0;0;.00nan;0;0
14907;76406;614;62;20;2;18;.900;3600000;0
14907;78262;620;42;30;6;24;.800;3600000;0
14907;156298;620;0;0;0;0;.00nan;0;0
14908;32712;611;0;0;0;0;.00nan;0;0
14908;192118;622;0;0;0;0;.00nan;0;0
14908;143100;611;60;54;7;47;.870;3600000;0
14908;156322;622;72;20;1;19;.950;3600000;0
14909;168441;3923;71;56;6;50;.893;3600000;0
14909;30393;3923;0;0;0;0;.00nan;0;0
14909;73639;617;85;27;1;26;.963;3600000;0
14909;156221;617;0;0;0;0;.00nan;0;0
14910;10141;1910;58;28;2;26;.929;3584000;0
14910;173279;4644;66;20;1;19;.950;3600000;0
14910;84525;4644;0;0;0;0;.00nan;0;0
14910;144410;1910;0;0;0;0;.00nan;0;0
14911;175651;2319;54;34;4;30;.882;3533000;0
14911;73699;2319;0;0;0;0;.00nan;0;0
14911;86394;619;85;35;2;33;.943;3600000;0
14911;149584;619;0;0;0;0;.00nan;0;0
14912;1061;2308;71;29;3;26;.897;4200000;0
14912;63402;612;86;38;3;35;.921;4200000;0
14912;76486;612;0;0;0;0;.00nan;0;0
14912;156254;2308;0;0;0;0;.00nan;0;0
14913;1061;2308;54;35;5;30;.857;3600000;0
14913;86394;619;44;40;6;34;.850;3156000;0
14913;149584;619;48;6;1;5;.833;391000;0
14913;156254;2308;0;0;0;0;.00nan;0;0
14914;173279;4644;64;49;6;43;.878;3600000;0
14914;192118;622;0;0;0;0;.00nan;0;0
14914;84525;4644;0;0;0;0;.00nan;0;0
14914;156322;622;63;27;3;24;.889;3600000;0
14915;10141;1910;0;0;0;0;.00nan;0;0
14915;73639;617;0;0;0;0;.00nan;0;0
14915;144410;1910;83;39;2;37;.949;4200000;0
14915;156221;617;66;21;2;19;.905;4200000;0
14916;63402;612;60;26;3;23;.885;4200000;0
14916;73187;614;0;0;0;0;.00nan;0;0
14916;76406;614;94;41;3;38;.927;4196000;0
14916;76486;612;0;0;0;0;.00nan;0;0
14917;168441;3923;0;0;0;0;.00nan;0;0
14917;30393;3923;78;41;3;38;.927;3575000;0
14917;78262;620;0;0;0;0;.00nan;0;0
14917;156298;620;67;24;2;22;.917;3600000;0
14918;175651;2319;0;0;0;0;.00nan;0;0
14918;32712;611;63;10;0;10;1.000;1324000;0
14918;73699;2319;84;27;1;26;.963;3600000;0
14918;143100;611;26;20;5;15;.750;2276000;0
14919;168441;3923;31;44;8;36;.818;2768000;0
14919;30393;3923;27;16;4;12;.750;832000;0
14919;192118;622;0;0;0;0;.00nan;0;0
14919;156322;622;50;7;1;6;.857;3600000;0
14920;1061;2308;70;42;4;38;.905;3600000;0
14920;192118;622;0;0;0;0;.00nan;0;0
14920;156254;2308;0;0;0;0;.00nan;0;0
14920;156322;622;94;17;0;17;1.000;3600000;0
14921;73639;617;42;17;3;14;.824;3546000;0
14921;78262;620;100;56;2;54;.964;3600000;0
14921;156221;617;0;0;0;0;.00nan;0;0
14921;156298;620;0;0;0;0;.00nan;0;0
14922;32712;611;0;0;0;0;.00nan;0;0
14922;73187;614;0;0;0;0;.00nan;0;0
14922;76406;614;35;30;6;24;.800;3600000;0
14922;143100;611;87;21;1;20;.952;3600000;0
14923;173279;4644;55;39;5;34;.872;3594000;0
14923;175651;2319;64;33;4;29;.879;3600000;0
14923;73699;2319;0;0;0;0;.00nan;0;0
14923;84525;4644;0;0;0;0;.00nan;0;0
14924;168441;3923;68;47;7;40;.851;2989000;0
14924;30393;3923;58;13;1;12;.923;611000;0
14924;86394;619;0;0;0;0;.00nan;0;0
14924;149584;619;44;24;4;20;.833;3600000;0
14925;10141;1910;0;0;0;0;.00nan;0;0
14925;63402;612;82;31;3;28;.903;3600000;0
14925;76486;612;0;0;0;0;.00nan;0;0
14925;144410;1910;45;33;5;28;.848;3563000;0
14926;173279;4644;100;31;0;31;1.000;3600000;0
14926;78262;620;0;0;0;0;.00nan;0;0
14926;84525;4644;0;0;0;0;.00nan;0;0
14926;156298;620;74;41;3;38;.927;3600000;0
14927;1061;2308;0;0;0;0;.00nan;0;0
14927;175651;2319;59;29;3;26;.897;3600000;0
14927;73699;2319;0;0;0;0;.00nan;0;0
14927;156254;2308;48;32;5;27;.844;3528000;0
14928;63402;612;70;28;3;25;.893;3600000;0
14928;73639;617;66;36;4;32;.889;3600000;0
14928;76486;612;0;0;0;0;.00nan;0;0
14928;156221;617;0;0;0;0;.00nan;0;0
14929;10141;1910;0;0;0;0;.00nan;0;0
14929;86394;619;0;0;0;0;.00nan;0;0
14929;144410;1910;88;46;3;43;.935;3849000;0
14929;149584;619;67;26;2;24;.923;3849000;0
14930;192118;622;0;0;0;0;.00nan;0;0
14930;73187;614;0;0;0;0;.00nan;0;0
14930;76406;614;92;53;2;51;.962;3889000;0
14930;156322;622;68;17;1;16;.941;3889000;0
14931;168441;3923;0;0;0;0;.00nan;0;0
14931;30393;3923;96;35;1;34;.971;3600000;0
14931;32712;611;0;0;0;0;.00nan;0;0
14931;143100;611;74;29;2;27;.931;3600000;0
14932;168441;3923;53;45;6;39;.867;3600000;0
14932;30393;3923;0;0;0;0;.00nan;0;0
14932;192118;622;0;0;0;0;.00nan;0;0
14932;156322;622;55;20;3;17;.850;3600000;0
14933;10141;1910;0;0;0;0;.00nan;0;0
14933;32712;611;77;19;1;18;.947;3600000;0
14933;143100;611;0;0;0;0;.00nan;0;0
14933;144410;1910;62;39;4;35;.897;3600000;0
14934;1061;2308;97;17;0;17;1.000;3600000;0
14934;173279;4644;66;50;6;44;.880;3600000;0
14934;84525;4644;0;0;0;0;.00nan;0;0
14934;156254;2308;0;0;0;0;.00nan;0;0
14935;175651;2319;0;0;0;0;.00nan;0;0
14935;73187;614;0;0;0;0;.00nan;0;0
14935;73699;2319;100;41;0;41;1.000;3600000;0
14935;76406;614;79;32;2;30;.938;3583000;0
14936;73639;617;0;0;0;0;.00nan;0;0
14936;86394;619;52;24;3;21;.875;3564000;0
14936;149584;619;0;0;0;0;.00nan;0;0
14936;156221;617;96;39;1;38;.974;3600000;0
14937;63402;612;0;0;0;0;.00nan;0;0
14937;76486;612;81;27;2;25;.926;4200000;0
14937;78262;620;100;41;2;39;.951;4200000;0
14937;156298;620;0;0;0;0;.00nan;0;0
14938;78262;620;0;0;0;0;.00nan;0;0
14938;86394;619;0;0;0;0;.00nan;0;0
14938;149584;619;42;26;5;21;.808;3916000;0
14938;156298;620;72;41;4;37;.902;3916000;0
14939;32712;611;0;0;0;0;.00nan;0;0
14939;73639;617;40;22;4;18;.818;3600000;0
14939;143100;611;97;39;1;38;.974;3600000;0
14939;156221;617;0;0;0;0;.00nan;0;0
14940;10141;1910;52;42;6;36;.857;2096000;0
14940;192118;622;0;0;0;0;.00nan;0;0
14940;144410;1910;61;15;1;14;.933;1504000;0
14940;156322;622;76;23;1;22;.957;3600000;0
14941;1061;2308;39;36;6;30;.833;3600000;0
14941;73187;614;68;36;3;33;.917;3600000;0
14941;76406;614;0;0;0;0;.00nan;0;0
14941;156254;2308;0;0;0;0;.00nan;0;0
14942;168441;3923;80;37;4;33;.892;3600000;0
14942;175651;2319;53;12;1;11;.917;1418000;0
14942;30393;3923;0;0;0;0;.00nan;0;0
14942;73699;2319;26;20;5;15;.750;2097000;0
14943;173279;4644;62;33;4;29;.879;3600000;0
14943;63402;612;100;31;0;31;1.000;3600000;0
14943;76486;612;0;0;0;0;.00nan;0;0
14943;84525;4644;0;0;0;0;.00nan;0;0
14944;192118;622;0;0;0;0;.00nan;0;0
14944;73639;617;0;0;0;0;.00nan;0;0
14944;156221;617;85;48;3;45;.938;3600000;0
14944;156322;622;64;11;1;10;.909;3600000;0
14945;32712;611;0;0;0;0;.00nan;0;0
14945;78262;620;0;0;0;0;.00nan;0;0
14945;143100;611;42;14;3;11;.786;3600000;0
14945;156298;620;70;43;4;39;.907;3600000;0
14946;1061;2308;60;17;2;15;.882;3600000;0
14946;168441;3923;49;50;6;44;.880;3600000;0
14946;30393;3923;0;0;0;0;.00nan;0;0
14946;156254;2308;0;0;0;0;.00nan;0;0
14947;173279;4644;0;0;0;0;.00nan;0;0
14947;73187;614;0;0;0;0;.00nan;0;0
14947;76406;614;50;19;3;16;.842;3600000;0
14947;84525;4644;86;32;1;31;.969;3600000;0
14948;10141;1910;0;0;0;0;.00nan;0;0
14948;175651;2319;44;22;4;18;.818;3783000;0
14948;73699;2319;0;0;0;0;.00nan;0;0
14948;144410;1910;75;34;3;31;.912;3783000;0
14949;63402;612;66;36;4;32;.889;3596000;0
14949;76486;612;0;0;0;0;.00nan;0;0
14949;86394;619;76;32;2;30;.938;3600000;0
14949;149584;619;0;0;0;0;.00nan;0;0
14950;192118;622;0;0;0;0;.00nan;0;0
14950;78262;620;22;35;8;27;.771;3600000;0
14950;156298;620;0;0;0;0;.00nan;0;0
14950;156322;622;54;30;4;26;.867;3600000;0
14951;175651;2319;78;28;2;26;.929;3062000;0
14951;73639;617;46;13;2;11;.846;1362000;0
14951;73699;2319;25;4;3;1;.250;538000;0
14951;156221;617;34;28;5;23;.821;2230000;0
14952;1061;2308;67;29;2;27;.931;3581000;0
14952;10141;1910;0;0;0;0;.00nan;0;0
14952;144410;1910;81;34;1;33;.971;3600000;0
14952;156254;2308;0;0;0;0;.00nan;0;0
14953;168441;3923;0;0;0;0;.00nan;0;0
14953;30393;3923;97;65;5;60;.923;4200000;0
14953;73187;614;0;0;0;0;.00nan;0;0
14953;76406;614;49;32;5;27;.844;4200000;0
14954;173279;4644;75;41;3;38;.927;4200000;0
14954;84525;4644;0;0;0;0;.00nan;0;0
14954;86394;619;0;0;0;0;.00nan;0;0
14954;149584;619;68;31;3;28;.903;4200000;0
14955;32712;611;0;0;0;0;.00nan;0;0
14955;63402;612;60;13;1;12;.923;3600000;0
14955;76486;612;0;0;0;0;.00nan;0;0
14955;143100;611;64;34;4;30;.882;3600000;0
14956;192118;622;39;26;5;21;.808;4200000;0
14956;63402;612;67;48;5;43;.896;4200000;0
14956;76486;612;0;0;0;0;.00nan;0;0
14956;156322;622;0;0;0;0;.00nan;0;0
14957;32712;611;0;0;0;0;.00nan;0;0
14957;86394;619;0;0;0;0;.00nan;0;0
14957;143100;611;76;36;3;33;.917;3600000;0
14957;149584;619;46;34;5;29;.853;3593000;0
14958;1061;2308;66;21;1;20;.952;3600000;0
14958;73639;617;55;4;0;4;1.000;393000;0
14958;156221;617;56;40;6;34;.850;3207000;0
14958;156254;2308;0;0;0;0;.00nan;0;0
14959;168441;3923;98;46;1;45;.978;3600000;0
14959;173279;4644;73;31;2;29;.935;3545000;0
14959;30393;3923;0;0;0;0;.00nan;0;0
14959;84525;4644;0;0;0;0;.00nan;0;0
14960;10141;1910;0;0;0;0;.00nan;0;0
14960;73187;614;0;0;0;0;.00nan;0;0
14960;76406;614;89;33;1;32;.970;3600000;0
14960;144410;1910;62;41;4;37;.902;3600000;0
14961;175651;2319;64;22;2;20;.909;3600000;0
14961;73699;2319;0;0;0;0;.00nan;0;0
14961;78262;620;0;0;0;0;.00nan;0;0
14961;156298;620;64;44;5;39;.886;3600000;0
14962;1061;2308;69;18;1;17;.944;3600000;0
14962;78262;620;0;0;0;0;.00nan;0;0
14962;156254;2308;0;0;0;0;.00nan;0;0
14962;156298;620;75;27;2;25;.926;3559000;0
14963;173279;4644;40;18;4;14;.778;1137000;0
14963;32712;611;60;15;1;14;.933;3600000;0
14963;84525;4644;67;23;1;22;.957;2463000;0
14963;143100;611;0;0;0;0;.00nan;0;0
14964;73187;614;0;0;0;0;.00nan;0;0
14964;73639;617;91;32;1;31;.969;3600000;0
14964;76406;614;43;31;5;26;.839;3600000;0
14964;156221;617;0;0;0;0;.00nan;0;0
14965;10141;1910;88;20;0;20;1.000;3600000;0
14965;168441;3923;75;50;5;45;.900;3600000;0
14965;30393;3923;0;0;0;0;.00nan;0;0
14965;144410;1910;0;0;0;0;.00nan;0;0
14966;192118;622;0;0;0;0;.00nan;0;0
14966;86394;619;0;0;0;0;.00nan;0;0
14966;149584;619;98;50;2;48;.960;3568000;0
14966;156322;622;58;8;1;7;.875;3600000;0
14967;175651;2319;86;35;2;33;.943;3600000;0
14967;63402;612;55;31;4;27;.871;3584000;0
14967;73699;2319;0;0;0;0;.00nan;0;0
14967;76486;612;0;0;0;0;.00nan;0;0
14968;32712;611;0;0;0;0;.00nan;0;0
14968;192118;622;0;0;0;0;.00nan;0;0
14968;143100;611;98;53;3;50;.943;3542000;0
14968;156322;622;87;20;1;19;.950;3600000;0
14969;1061;2308;61;36;4;32;.889;3560000;0
14969;63402;612;45;18;3;15;.833;3600000;0
14969;76486;612;0;0;0;0;.00nan;0;0
14969;156254;2308;0;0;0;0;.00nan;0;0
14970;10141;1910;43;30;4;26;.867;3593000;0
14970;173279;4644;49;22;3;19;.864;3600000;0
14970;84525;4644;0;0;0;0;.00nan;0;0
14970;144410;1910;0;0;0;0;.00nan;0;0
14971;73187;614;0;0;0;0;.00nan;0;0
14971;76406;614;66;23;2;21;.913;3600000;0
14971;78262;620;89;41;3;38;.927;3600000;0
14971;156298;620;0;0;0;0;.00nan;0;0
14972;168441;3923;85;47;3;44;.936;3600000;0
14972;30393;3923;0;0;0;0;.00nan;0;0
14972;73639;617;0;0;0;0;.00nan;0;0
14972;156221;617;76;17;1;16;.941;3600000;0
14973;175651;2319;91;38;2;36;.947;3600000;0
14973;73699;2319;0;0;0;0;.00nan;0;0
14973;86394;619;58;23;3;20;.870;3542000;0
14973;149584;619;0;0;0;0;.00nan;0;0
14974;168441;3923;0;0;0;0;.00nan;0;0
14974;30393;3923;59;32;3;29;.906;3600000;0
14974;73639;617;0;0;0;0;.00nan;0;0
14974;156221;617;37;19;4;15;.789;3553000;0
14975;10141;1910;0;0;0;0;.00nan;0;0
14975;63402;612;72;25;2;23;.920;3600000;0
14975;76486;612;0;0;0;0;.00nan;0;0
14975;144410;1910;91;42;3;39;.929;3600000;0
14976;173279;4644;82;52;5;47;.904;3600000;0
14976;192118;622;0;0;0;0;.00nan;0;0
14976;84525;4644;0;0;0;0;.00nan;0;0
14976;156322;622;43;10;2;8;.800;3600000;0
14977;168441;3923;33;40;7;33;.825;3600000;0
14977;30393;3923;0;0;0;0;.00nan;0;0
14977;78262;620;57;22;3;19;.864;3600000;0
14977;156298;620;0;0;0;0;.00nan;0;0
14978;175651;2319;46;25;4;21;.840;3600000;0
14978;32712;611;0;0;0;0;.00nan;0;0
14978;73699;2319;0;0;0;0;.00nan;0;0
14978;143100;611;50;33;5;28;.848;3554000;0
14979;10141;1910;0;0;0;0;.00nan;0;0
14979;73639;617;78;24;1;23;.958;3600000;0
14979;144410;1910;63;40;4;36;.900;3600000;0
14979;156221;617;0;0;0;0;.00nan;0;0
14980;1061;2308;62;29;4;25;.862;3600000;0
14980;86394;619;0;0;0;0;.00nan;0;0
14980;149584;619;77;26;1;25;.962;3600000;0
14980;156254;2308;0;0;0;0;.00nan;0;0
14981;63402;612;77;42;4;38;.905;3600000;0
14981;73187;614;0;0;0;0;.00nan;0;0
14981;76406;614;58;40;5;35;.875;3577000;0
14981;76486;612;0;0;0;0;.00nan;0;0
14982;1061;2308;66;24;2;22;.917;3600000;0
14982;32712;611;0;0;0;0;.00nan;0;0
14982;143100;611;20;32;7;25;.781;3600000;0
14982;156254;2308;0;0;0;0;.00nan;0;0
14983;173279;4644;58;47;5;42;.894;3547000;0
14983;73639;617;0;0;0;0;.00nan;0;0
14983;84525;4644;0;0;0;0;.00nan;0;0
14983;156221;617;57;24;3;21;.875;3600000;0
14984;10141;1910;35;25;5;20;.800;3584000;0
14984;78262;620;0;0;0;0;.00nan;0;0
14984;144410;1910;0;0;0;0;.00nan;0;0
14984;156298;620;76;37;3;34;.919;3600000;0
14985;73187;614;0;0;0;0;.00nan;0;0
14985;76406;614;70;26;3;23;.885;3600000;0
14985;86394;619;46;34;5;29;.853;1933000;0
14985;149584;619;54;17;2;15;.882;1667000;0
14986;168441;3923;0;0;0;0;.00nan;0;0
14986;30393;3923;95;45;2;43;.956;3549000;0
14986;63402;612;71;18;1;17;.944;3600000;0
14986;76486;612;0;0;0;0;.00nan;0;0
14987;175651;2319;53;53;7;46;.868;3914000;0
14987;192118;622;0;0;0;0;.00nan;0;0
14987;73699;2319;0;0;0;0;.00nan;0;0
14987;156322;622;44;34;6;28;.824;3914000;0
14989;173279;4644;76;31;2;29;.935;3600000;0
14989;73187;614;0;0;0;0;.00nan;0;0
14989;76406;614;80;25;1;24;.960;3600000;0
14989;84525;4644;0;0;0;0;.00nan;0;0
14991;86394;619;0;0;0;0;.00nan;0;0
14991;144410;1910;0;0;0;0;.00nan;0;0
14991;149584;619;87;27;1;26;.963;3600000;0
14991;156221;1910;68;36;4;32;.889;3600000;0
14993;168441;3923;67;44;5;39;.886;3600000;0
14993;30393;3923;0;0;0;0;.00nan;0;0
14993;73396;620;0;0;0;0;.00nan;0;0
14993;73639;620;65;27;3;24;.889;3600000;0
14995;192118;622;0;0;0;0;.00nan;0;0
14995;78262;617;86;40;2;38;.950;4200000;0
14995;156298;617;0;0;0;0;.00nan;0;0
14995;156322;622;82;31;2;29;.935;4200000;0
14997;175651;2319;66;21;2;19;.905;3600000;0
14997;32712;611;0;0;0;0;.00nan;0;0
14997;73699;2319;0;0;0;0;.00nan;0;0
14997;143100;611;58;26;3;23;.885;3562000;0
14999;1061;2308;93;34;2;32;.941;3600000;0
14999;176445;612;0;0;0;0;.00nan;0;0
14999;63402;612;25;25;6;19;.760;3600000;0
14999;156254;2308;0;0;0;0;.00nan;0;0
15001;1061;2308;0;0;0;0;.00nan;0;0
15001;173279;4644;0;0;0;0;.00nan;0;0
15001;84525;4644;33;24;5;19;.792;3600000;0
15001;156254;2308;80;27;1;26;.963;3600000;0
15003;176445;612;0;0;0;0;.00nan;0;0
15003;63402;612;86;18;0;18;1.000;3600000;0
15003;144410;1910;48;45;6;39;.867;3600000;0
15003;156221;1910;0;0;0;0;.00nan;0;0
15005;192118;622;76;10;0;10;1.000;3600000;0
15005;86394;619;62;55;7;48;.873;3600000;0
15005;149584;619;0;0;0;0;.00nan;0;0
15005;156322;622;0;0;0;0;.00nan;0;0
15007;32712;611;73;18;1;17;.944;3600000;0
15007;78262;617;0;0;0;0;.00nan;0;0
15007;143100;611;0;0;0;0;.00nan;0;0
15007;156298;617;60;34;4;30;.882;3600000;0
15009;175651;2319;0;0;0;0;.00nan;0;0
15009;73396;620;35;33;6;27;.818;3600000;0
15009;73639;620;0;0;0;0;.00nan;0;0
15009;73699;2319;97;20;0;20;1.000;3600000;0
15011;168441;3923;0;0;0;0;.00nan;0;0
15011;30393;3923;57;40;4;36;.900;3545000;0
15011;73187;614;45;18;3;15;.833;3600000;0
15011;76406;614;0;0;0;0;.00nan;0;0
15013;86394;619;0;0;0;0;.00nan;0;0
15013;144410;1910;70;34;3;31;.912;3544000;0
15013;149584;619;67;21;2;19;.905;3600000;0
15013;156221;1910;0;0;0;0;.00nan;0;0
15015;168441;3923;74;49;5;44;.898;3600000;0
15015;30393;3923;0;0;0;0;.00nan;0;0
15015;78262;617;66;16;1;15;.938;3600000;0
15015;156298;617;0;0;0;0;.00nan;0;0
15017;175651;2319;0;0;0;0;.00nan;0;0
15017;32712;611;0;0;0;0;.00nan;0;0
15017;73699;2319;65;30;3;27;.900;3556000;0
15017;143100;611;63;22;2;20;.909;3600000;0
15019;1061;2308;80;38;4;34;.895;3600000;0
15019;176445;612;0;0;0;0;.00nan;0;0
15019;63402;612;28;23;5;18;.783;3575000;0
15019;156254;2308;0;0;0;0;.00nan;0;0
15021;192118;622;67;19;1;18;.947;3600000;0
15021;73396;620;42;10;2;8;.800;512000;0
15021;73639;620;44;36;6;30;.833;3088000;0
15021;156322;622;0;0;0;0;.00nan;0;0
15023;173279;4644;33;26;5;21;.808;3544000;0
15023;73187;614;0;0;0;0;.00nan;0;0
15023;76406;614;47;28;4;24;.857;3600000;0
15023;84525;4644;0;0;0;0;.00nan;0;0
15025;78262;617;90;34;1;33;.971;4200000;0
15025;86394;619;0;0;0;0;.00nan;0;0
15025;149584;619;100;40;1;39;.975;4200000;0
15025;156298;617;0;0;0;0;.00nan;0;0
15027;176445;612;0;0;0;0;.00nan;0;0
15027;63402;612;80;19;1;18;.947;3600000;0
15027;144410;1910;0;0;0;0;.00nan;0;0
15027;156221;1910;64;37;4;33;.892;3600000;0
15029;1061;2308;48;20;3;17;.850;3543000;0
15029;173279;4644;0;0;0;0;.00nan;0;0
15029;84525;4644;82;34;2;32;.941;3600000;0
15029;156254;2308;0;0;0;0;.00nan;0;0
15031;168441;3923;37;19;4;15;.789;1108000;0
15031;30393;3923;68;53;5;48;.906;2492000;0
15031;192118;622;0;0;0;0;.00nan;0;0
15031;156322;622;54;13;1;12;.923;3600000;0
15033;175651;2319;27;33;6;27;.818;2628000;0
15033;73187;614;0;0;0;0;.00nan;0;0
15033;73699;2319;61;9;0;9;1.000;972000;0
15033;76406;614;100;24;0;24;1.000;3600000;0
15035;32712;611;0;0;0;0;.00nan;0;0
15035;73396;620;0;0;0;0;.00nan;0;0
15035;73639;620;65;32;3;29;.906;3706000;0
15035;143100;611;58;22;2;20;.909;3706000;0
15037;192118;622;46;11;2;9;.818;3600000;0
15037;73396;620;88;50;4;46;.920;3600000;0
15037;73639;620;0;0;0;0;.00nan;0;0
15037;156322;622;0;0;0;0;.00nan;0;0
15039;175651;2319;0;0;0;0;.00nan;0;0
15039;176445;612;67;24;2;22;.917;3600000;0
15039;63402;612;0;0;0;0;.00nan;0;0
15039;73699;2319;81;40;3;37;.925;3561000;0
15041;32712;611;68;33;3;30;.909;3600000;0
15041;78262;617;0;0;0;0;.00nan;0;0
15041;143100;611;0;0;0;0;.00nan;0;0
15041;156298;617;51;38;5;33;.868;3573000;0
15043;173279;4644;67;35;4;31;.886;3569000;0
15043;84525;4644;0;0;0;0;.00nan;0;0
15043;86394;619;76;32;3;29;.906;3600000;0
15043;149584;619;0;0;0;0;.00nan;0;0
15045;168441;3923;87;47;3;44;.936;4200000;0
15045;30393;3923;0;0;0;0;.00nan;0;0
15045;144410;1910;44;24;3;21;.875;4200000;0
15045;156221;1910;0;0;0;0;.00nan;0;0
15047;1061;2308;0;0;0;0;.00nan;0;0
15047;73187;614;0;0;0;0;.00nan;0;0
15047;76406;614;48;30;4;26;.867;3579000;0
15047;156254;2308;61;26;3;23;.885;3600000;0
15049;168441;3923;23;24;6;18;.750;2172000;0
15049;30393;3923;53;16;2;14;.875;1428000;0
15049;73187;614;60;17;2;15;.882;3600000;0
15049;76406;614;0;0;0;0;.00nan;0;0
15051;78262;617;71;27;2;25;.926;3723000;0
15051;144410;1910;0;0;0;0;.00nan;0;0
15051;156221;1910;77;24;1;23;.958;3723000;0
15051;156298;617;0;0;0;0;.00nan;0;0
15055;175651;2319;77;41;4;37;.902;3524000;0
15055;73699;2319;0;0;0;0;.00nan;0;0
15055;86394;619;0;0;0;0;.00nan;0;0
15055;149584;619;85;32;2;30;.938;3600000;0
15057;1061;2308;100;26;0;26;1.000;3600000;0
15057;192118;622;0;0;0;0;.00nan;0;0
15057;156254;2308;0;0;0;0;.00nan;0;0
15057;156322;622;50;26;3;23;.885;3600000;0
15059;173279;4644;42;37;6;31;.838;3600000;0
15059;32712;611;0;0;0;0;.00nan;0;0
15059;84525;4644;0;0;0;0;.00nan;0;0
15059;143100;611;89;26;2;24;.923;3600000;0
15063;173279;4644;0;0;0;0;.00nan;0;0
15063;84525;4644;56;29;3;26;.897;3558000;0
15063;86394;619;65;16;1;15;.938;3600000;0
15063;149584;619;0;0;0;0;.00nan;0;0
15065;192118;622;55;14;1;13;.929;3600000;0
15065;78262;620;0;0;0;0;.00nan;0;0
15065;156298;620;76;42;3;39;.929;3569000;0
15065;156322;622;0;0;0;0;.00nan;0;0
15067;1061;2308;96;35;2;33;.943;3600000;0
15067;32712;611;53;29;4;25;.862;3593000;0
15067;143100;611;0;0;0;0;.00nan;0;0
15067;156254;2308;0;0;0;0;.00nan;0;0
15069;168441;3923;98;48;3;45;.938;3600000;0
15069;30393;3923;0;0;0;0;.00nan;0;0
15069;73639;617;76;20;1;19;.950;3600000;0
15069;156221;617;0;0;0;0;.00nan;0;0
15071;175651;2319;0;0;0;0;.00nan;0;0
15071;73187;614;0;0;0;0;.00nan;0;0
15071;73699;2319;33;26;5;21;.808;3576000;0
15071;76406;614;58;35;4;31;.886;3600000;0
15072;181446;2188;21;10;4;6;.600;1085000;0
15072;185775;720;85;18;0;18;1.000;3600000;0
15072;-1;720;0;0;0;0;.00nan;0;0
15072;-1;2188;84;30;1;29;.967;2515000;0
15073;161540;716;48;26;3;23;.885;3564000;0
15073;168842;2529;86;36;2;34;.944;3600000;0
15073;184437;716;0;0;0;0;.00nan;0;0
15073;62884;2529;0;0;0;0;.00nan;0;0
15074;179151;718;54;13;2;11;.846;3600000;0
15074;-1;721;47;34;6;28;.824;3324000;0
15074;-1;718;0;0;0;0;.00nan;0;0
15074;-1;721;54;2;0;2;1.000;276000;0
15075;182339;715;84;43;3;40;.930;3600000;0
15075;54658;719;11;20;6;14;.700;2435000;0
15075;56611;719;71;14;0;14;1.000;1165000;0
15075;161163;715;0;0;0;0;.00nan;0;0
15076;883;717;0;0;0;0;.00nan;0;0
15076;175712;717;57;27;3;24;.889;3600000;0
15076;-1;721;71;44;5;39;.886;3310000;0
15076;-1;721;49;2;0;2;1.000;285000;0
15077;179151;718;0;0;0;0;.00nan;0;0
15077;-1;718;42;22;4;18;.818;3600000;0
15077;54658;719;74;25;1;24;.960;3600000;0
15077;56611;719;0;0;0;0;.00nan;0;0
15078;161540;716;0;0;0;0;.00nan;0;0
15078;184437;716;63;19;2;17;.895;3511000;0
15078;181446;2188;100;29;0;29;1.000;3600000;0
15078;-1;2188;0;0;0;0;.00nan;0;0
15079;182339;715;36;37;6;31;.838;3600000;0
15079;168842;2529;64;32;3;29;.906;3600000;0
15079;62884;2529;0;0;0;0;.00nan;0;0
15079;161163;715;0;0;0;0;.00nan;0;0
15080;182339;715;43;33;6;27;.818;3600000;0
15080;181446;2188;90;32;1;31;.969;3600000;0
15080;-1;2188;0;0;0;0;.00nan;0;0
15080;161163;715;0;0;0;0;.00nan;0;0
15081;168842;2529;0;0;0;0;.00nan;0;0
15081;179151;718;43;23;4;19;.826;3600000;0
15081;-1;718;0;0;0;0;.00nan;0;0
15081;62884;2529;54;32;5;27;.844;3600000;0
15082;161540;716;0;0;0;0;.00nan;0;0
15082;184437;716;57;30;4;26;.867;3600000;0
15082;185775;720;57;15;1;14;.933;3600000;0
15082;-1;720;0;0;0;0;.00nan;0;0
15083;883;717;0;0;0;0;.00nan;0;0
15083;175712;717;70;32;3;29;.906;3795000;0
15083;54658;719;87;33;2;31;.939;3795000;0
15083;56611;719;0;0;0;0;.00nan;0;0
15084;883;717;83;24;1;23;.958;3600000;0
15084;168842;2529;47;31;5;26;.839;3600000;0
15084;175712;717;0;0;0;0;.00nan;0;0
15084;62884;2529;0;0;0;0;.00nan;0;0
15085;179151;718;67;23;2;21;.913;3600000;0
15085;181446;2188;71;47;5;42;.894;3600000;0
15085;-1;718;0;0;0;0;.00nan;0;0
15085;-1;2188;0;0;0;0;.00nan;0;0
15086;-1;721;62;32;4;28;.875;3600000;0
15086;-1;721;0;0;0;0;.00nan;0;0
15086;54658;719;95;27;1;26;.963;3600000;0
15086;56611;719;0;0;0;0;.00nan;0;0
15087;182339;715;76;45;4;41;.911;3600000;0
15087;185775;720;66;18;1;17;.944;3600000;0
15087;-1;720;0;0;0;0;.00nan;0;0
15087;161163;715;0;0;0;0;.00nan;0;0
15088;883;717;0;0;0;0;.00nan;0;0
15088;175712;717;47;29;4;25;.862;3600000;0
15088;181446;2188;0;0;0;0;.00nan;0;0
15088;-1;2188;23;32;7;25;.781;3600000;0
15089;168842;2529;51;13;2;11;.846;3600000;0
15089;-1;721;76;45;4;41;.911;3600000;0
15089;-1;721;0;0;0;0;.00nan;0;0
15089;62884;2529;0;0;0;0;.00nan;0;0
15090;179151;718;28;8;3;5;.625;559000;0
15090;185775;720;68;30;3;27;.900;3600000;0
15090;-1;718;44;26;4;22;.846;3041000;0
15090;-1;720;0;0;0;0;.00nan;0;0
15091;161540;716;0;0;0;0;.00nan;0;0
15091;182339;715;43;24;4;20;.833;3531000;0
15091;184437;716;71;25;2;23;.920;3600000;0
15091;161163;715;0;0;0;0;.00nan;0;0
15092;883;717;73;31;2;29;.935;3575000;0
15092;175712;717;0;0;0;0;.00nan;0;0
15092;185775;720;95;32;1;31;.969;3600000;0
15092;-1;720;0;0;0;0;.00nan;0;0
15093;161540;716;0;0;0;0;.00nan;0;0
15093;184437;716;61;22;3;19;.864;3600000;0
15093;179151;718;54;35;4;31;.886;3558000;0
15093;-1;718;0;0;0;0;.00nan;0;0
15094;-1;721;58;41;5;36;.878;3600000;0
15094;181446;2188;73;24;1;23;.958;3600000;0
15094;-1;721;0;0;0;0;.00nan;0;0
15094;-1;2188;0;0;0;0;.00nan;0;0
15095;168842;2529;72;20;1;19;.950;3600000;0
15095;54658;719;68;22;2;20;.909;3600000;0
15095;56611;719;0;0;0;0;.00nan;0;0
15095;62884;2529;0;0;0;0;.00nan;0;0
15096;181446;2188;77;29;2;27;.931;3543000;0
15096;-1;2188;0;0;0;0;.00nan;0;0
15096;54658;719;99;40;1;39;.975;3600000;0
15096;56611;719;0;0;0;0;.00nan;0;0
15097;-1;721;87;50;5;45;.900;3600000;0
15097;185775;720;66;12;1;11;.917;3600000;0
15097;-1;721;0;0;0;0;.00nan;0;0
15097;-1;720;0;0;0;0;.00nan;0;0
15098;883;717;0;0;0;0;.00nan;0;0
15098;161540;716;49;27;4;23;.852;3576000;0
15098;184437;716;0;0;0;0;.00nan;0;0
15098;175712;717;73;29;2;27;.931;3600000;0
15099;182339;715;72;29;2;27;.931;3600000;0
15099;179151;718;52;21;3;18;.857;3576000;0
15099;-1;718;0;0;0;0;.00nan;0;0
15099;161163;715;0;0;0;0;.00nan;0;0
15100;883;717;54;28;4;24;.857;3900000;0
15100;182339;715;92;54;4;50;.926;3900000;0
15100;175712;717;0;0;0;0;.00nan;0;0
15100;161163;715;0;0;0;0;.00nan;0;0
15101;168842;2529;75;22;1;21;.955;3600000;0
15101;181446;2188;86;31;2;29;.935;3547000;0
15101;-1;2188;0;0;0;0;.00nan;0;0
15101;62884;2529;0;0;0;0;.00nan;0;0
15102;161540;716;0;0;0;0;.00nan;0;0
15102;184437;716;65;28;3;25;.893;3600000;0
15102;-1;721;0;0;0;0;.00nan;0;0
15102;-1;721;42;28;5;23;.821;3594000;0
15103;185775;720;64;15;1;14;.933;3600000;0
15103;-1;720;0;0;0;0;.00nan;0;0
15103;54658;719;92;42;3;39;.929;3555000;0
15103;56611;719;0;0;0;0;.00nan;0;0
15104;883;717;0;0;0;0;.00nan;0;0
15104;179151;718;75;33;2;31;.939;3582000;0
15104;175712;717;88;31;1;30;.968;3600000;0
15104;-1;718;0;0;0;0;.00nan;0;0
15105;168842;2529;71;40;3;37;.925;3600000;0
15105;185775;720;44;28;4;24;.857;3586000;0
15105;-1;720;0;0;0;0;.00nan;0;0
15105;62884;2529;0;0;0;0;.00nan;0;0
15106;161540;716;0;0;0;0;.00nan;0;0
15106;184437;716;70;20;1;19;.950;3600000;0
15106;54658;719;74;41;4;37;.902;3600000;0
15106;56611;719;0;0;0;0;.00nan;0;0
15107;182339;715;58;20;2;18;.900;3600000;0
15107;-1;721;28;12;4;8;.667;1117000;0
15107;-1;721;78;35;3;32;.914;2483000;0
15107;161163;715;0;0;0;0;.00nan;0;0
15108;179151;718;64;14;1;13;.929;3600000;0
15108;-1;721;43;35;5;30;.857;3600000;0
15108;-1;718;0;0;0;0;.00nan;0;0
15108;-1;721;0;0;0;0;.00nan;0;0
15109;181446;2188;56;28;4;24;.857;3600000;0
15109;185775;720;57;4;0;4;1.000;1390000;0
15109;-1;720;14;19;6;13;.684;2175000;0
15109;-1;2188;0;0;0;0;.00nan;0;0
15110;161540;716;0;0;0;0;.00nan;0;0
15110;168842;2529;75;32;2;30;.938;3600000;0
15110;184437;716;56;29;4;25;.862;3513000;0
15110;62884;2529;0;0;0;0;.00nan;0;0
15111;182339;715;86;42;2;40;.952;3600000;0
15111;54658;719;59;27;3;24;.889;3582000;0
15111;56611;719;0;0;0;0;.00nan;0;0
15111;161163;715;0;0;0;0;.00nan;0;0
15112;161540;716;0;0;0;0;.00nan;0;0
15112;184437;716;79;36;3;33;.917;3563000;0
15112;181446;2188;64;21;2;19;.905;3600000;0
15112;-1;2188;0;0;0;0;.00nan;0;0
15113;182339;715;76;29;3;26;.897;3600000;0
15113;168842;2529;49;29;4;25;.862;3600000;0
15113;62884;2529;0;0;0;0;.00nan;0;0
15113;161163;715;0;0;0;0;.00nan;0;0
15114;883;717;0;0;0;0;.00nan;0;0
15114;175712;717;62;24;3;21;.875;3581000;0
15114;-1;721;96;47;2;45;.957;3600000;0
15114;-1;721;0;0;0;0;.00nan;0;0
15115;179151;718;59;23;2;21;.913;3600000;0
15115;-1;718;0;0;0;0;.00nan;0;0
15115;54658;719;59;36;4;32;.889;3579000;0
15115;56611;719;0;0;0;0;.00nan;0;0
15116;883;717;38;23;4;19;.826;3600000;0
15116;175712;717;0;0;0;0;.00nan;0;0
15116;54658;719;100;29;0;29;1.000;3600000;0
15116;56611;719;0;0;0;0;.00nan;0;0
15117;168842;2529;69;33;3;30;.909;3900000;0
15117;179151;718;51;15;2;13;.867;3900000;0
15117;-1;718;0;0;0;0;.00nan;0;0
15117;62884;2529;0;0;0;0;.00nan;0;0
15118;161540;716;69;31;3;28;.903;3600000;0
15118;184437;716;0;0;0;0;.00nan;0;0
15118;185775;720;54;36;4;32;.889;3575000;0
15118;-1;720;0;0;0;0;.00nan;0;0
15119;182339;715;86;34;2;32;.941;3600000;0
15119;181446;2188;36;29;5;24;.828;3600000;0
15119;-1;2188;0;0;0;0;.00nan;0;0
15119;161163;715;0;0;0;0;.00nan;0;0
15120;179151;718;56;26;3;23;.885;3600000;0
15120;181446;2188;75;29;3;26;.897;3040000;0
15120;-1;718;0;0;0;0;.00nan;0;0
15120;-1;2188;26;6;3;3;.500;560000;0
15121;883;717;71;29;2;27;.931;3600000;0
15121;168842;2529;88;32;1;31;.969;3600000;0
15121;175712;717;0;0;0;0;.00nan;0;0
15121;62884;2529;0;0;0;0;.00nan;0;0
15122;182339;715;93;37;2;35;.946;3900000;0
15122;185775;720;71;26;2;24;.923;3900000;0
15122;-1;720;0;0;0;0;.00nan;0;0
15122;161163;715;0;0;0;0;.00nan;0;0
15123;-1;721;54;30;3;27;.900;3517000;0
15123;-1;721;0;0;0;0;.00nan;0;0
15123;54658;719;0;0;0;0;.00nan;0;0
15123;56611;719;74;21;1;20;.952;3600000;0
15124;883;717;0;0;0;0;.00nan;0;0
15124;175712;717;35;22;4;18;.818;3562000;0
15124;181446;2188;90;40;2;38;.950;3600000;0
15124;-1;2188;0;0;0;0;.00nan;0;0
15125;179151;718;50;36;5;31;.861;3600000;0
15125;185775;720;89;30;2;28;.933;3600000;0
15125;-1;718;0;0;0;0;.00nan;0;0
15125;-1;720;0;0;0;0;.00nan;0;0
15126;168842;2529;79;12;0;12;1.000;3600000;0
15126;-1;721;68;30;3;27;.900;3600000;0
15126;-1;721;0;0;0;0;.00nan;0;0
15126;62884;2529;0;0;0;0;.00nan;0;0
15127;161540;716;0;0;0;0;.00nan;0;0
15127;182339;715;88;33;2;31;.939;3600000;0
15127;184437;716;72;24;3;21;.875;3544000;0
15127;161163;715;0;0;0;0;.00nan;0;0
15128;-1;721;55;36;5;31;.861;3600000;0
15128;181446;2188;94;33;1;32;.970;3600000;0
15128;-1;721;0;0;0;0;.00nan;0;0
15128;-1;2188;0;0;0;0;.00nan;0;0
15129;168842;2529;60;16;2;14;.875;3600000;0
15129;54658;719;29;34;7;27;.794;3600000;0
15129;56611;719;0;0;0;0;.00nan;0;0
15129;62884;2529;0;0;0;0;.00nan;0;0
15130;883;717;72;24;1;23;.958;3600000;0
15130;175712;717;0;0;0;0;.00nan;0;0
15130;185775;720;41;24;4;20;.833;3600000;0
15130;-1;720;0;0;0;0;.00nan;0;0
15131;161540;716;48;27;4;23;.852;3600000;0
15131;184437;716;0;0;0;0;.00nan;0;0
15131;179151;718;86;30;1;29;.967;3600000;0
15131;-1;718;0;0;0;0;.00nan;0;0
15132;883;717;0;0;0;0;.00nan;0;0
15132;161540;716;0;0;0;0;.00nan;0;0
15132;184437;716;85;31;1;30;.968;3600000;0
15132;175712;717;80;33;3;30;.909;3600000;0
15133;182339;715;100;23;0;23;1.000;3692000;0
15133;179151;718;88;30;1;29;.967;3692000;0
15133;-1;718;0;0;0;0;.00nan;0;0
15133;161163;715;0;0;0;0;.00nan;0;0
15134;-1;721;43;41;6;35;.854;3600000;0
15134;185775;720;58;23;3;20;.870;3600000;0
15134;-1;721;0;0;0;0;.00nan;0;0
15134;-1;720;0;0;0;0;.00nan;0;0
15135;181446;2188;7;17;6;11;.647;2952000;0
15135;-1;2188;50;5;1;4;.800;648000;0
15135;54658;719;81;28;2;26;.929;3600000;0
15135;56611;719;0;0;0;0;.00nan;0;0
15136;168842;2529;72;40;4;36;.900;3600000;0
15136;181446;2188;38;29;5;24;.828;3600000;0
15136;-1;2188;0;0;0;0;.00nan;0;0
15136;62884;2529;0;0;0;0;.00nan;0;0
15137;185775;720;47;15;3;12;.800;3600000;0
15137;-1;720;0;0;0;0;.00nan;0;0
15137;54658;719;73;44;4;40;.909;3600000;0
15137;56611;719;0;0;0;0;.00nan;0;0
15138;161540;716;0;0;0;0;.00nan;0;0
15138;184437;716;74;41;5;36;.878;3686000;0
15138;-1;721;83;46;4;42;.913;3686000;0
15138;-1;721;0;0;0;0;.00nan;0;0
15139;883;717;0;0;0;0;.00nan;0;0
15139;182339;715;97;43;2;41;.953;3600000;0
15139;175712;717;79;25;1;24;.960;3600000;0
15139;161163;715;0;0;0;0;.00nan;0;0
15140;883;717;0;0;0;0;.00nan;0;0
15140;179151;718;71;25;2;23;.920;3571000;0
15140;175712;717;86;31;1;30;.968;3600000;0
15140;-1;718;0;0;0;0;.00nan;0;0
15141;168842;2529;0;0;0;0;.00nan;0;0
15141;185775;720;28;21;5;16;.762;3552000;0
15141;-1;720;0;0;0;0;.00nan;0;0
15141;62884;2529;58;34;4;30;.882;3600000;0
15142;161540;716;72;27;3;24;.889;3600000;0
15142;184437;716;0;0;0;0;.00nan;0;0
15142;54658;719;15;21;6;15;.714;2200000;0
15142;56611;719;53;15;2;13;.867;1400000;0
15143;182339;715;47;18;3;15;.833;3600000;0
15143;-1;721;69;41;3;38;.927;2465000;0
15143;-1;721;38;19;4;15;.789;1135000;0
15143;161163;715;0;0;0;0;.00nan;0;0
15144;181446;2188;71;39;4;35;.897;3558000;0
15144;185775;720;67;24;2;22;.917;3600000;0
15144;-1;720;0;0;0;0;.00nan;0;0
15144;-1;2188;0;0;0;0;.00nan;0;0
15145;161540;716;0;0;0;0;.00nan;0;0
15145;168842;2529;69;31;3;28;.903;3565000;0
15145;184437;716;72;29;2;27;.931;3600000;0
15145;62884;2529;0;0;0;0;.00nan;0;0
15146;179151;718;80;22;1;21;.955;3600000;0
15146;-1;721;76;31;2;29;.935;3600000;0
15146;-1;718;0;0;0;0;.00nan;0;0
15146;-1;721;0;0;0;0;.00nan;0;0
15147;182339;715;100;36;0;36;1.000;3600000;0
15147;54658;719;48;35;6;29;.829;3600000;0
15147;56611;719;0;0;0;0;.00nan;0;0
15147;161163;715;0;0;0;0;.00nan;0;0
15148;883;717;0;0;0;0;.00nan;0;0
15148;175712;717;89;18;0;18;1.000;3600000;0
15148;-1;721;48;44;6;38;.864;3600000;0
15148;-1;721;0;0;0;0;.00nan;0;0
15149;179151;718;84;22;1;21;.955;3600000;0
15149;-1;718;0;0;0;0;.00nan;0;0
15149;54658;719;69;30;3;27;.900;3600000;0
15149;56611;719;0;0;0;0;.00nan;0;0
15150;161540;716;0;0;0;0;.00nan;0;0
15150;184437;716;96;22;0;22;1.000;3600000;0
15150;181446;2188;80;24;2;22;.917;3563000;0
15150;-1;2188;0;0;0;0;.00nan;0;0
15151;182339;715;63;43;5;38;.884;3551000;0
15151;168842;2529;27;21;5;16;.762;3600000;0
15151;62884;2529;0;0;0;0;.00nan;0;0
15151;161163;715;0;0;0;0;.00nan;0;0
15152;182339;715;83;40;2;38;.950;3600000;0
15152;181446;2188;30;24;5;19;.792;2267000;0
15152;-1;2188;58;16;1;15;.938;1333000;0
15152;161163;715;0;0;0;0;.00nan;0;0
15153;168842;2529;46;31;5;26;.839;3600000;0
15153;179151;718;83;24;1;23;.958;3600000;0
15153;-1;718;0;0;0;0;.00nan;0;0
15153;62884;2529;0;0;0;0;.00nan;0;0
15154;161540;716;0;0;0;0;.00nan;0;0
15154;184437;716;71;43;5;38;.884;3600000;0
15154;185775;720;76;18;1;17;.944;3600000;0
15154;-1;720;0;0;0;0;.00nan;0;0
15155;883;717;0;0;0;0;.00nan;0;0
15155;175712;717;41;16;3;13;.813;3600000;0
15155;54658;719;75;50;5;45;.900;3574000;0
15155;56611;719;0;0;0;0;.00nan;0;0
15156;883;717;0;0;0;0;.00nan;0;0
15156;168842;2529;42;29;5;24;.828;3600000;0
15156;175712;717;54;20;2;18;.900;3600000;0
15156;62884;2529;0;0;0;0;.00nan;0;0
15157;179151;718;51;24;3;21;.875;3600000;0
15157;181446;2188;56;43;5;38;.884;3571000;0
15157;-1;718;0;0;0;0;.00nan;0;0
15157;-1;2188;0;0;0;0;.00nan;0;0
15158;-1;721;68;23;1;22;.957;3600000;0
15158;-1;721;0;0;0;0;.00nan;0;0
15158;54658;719;61;21;2;19;.905;3554000;0
15158;56611;719;0;0;0;0;.00nan;0;0
15159;182339;715;0;0;0;0;.00nan;0;0
15159;185775;720;76;32;3;29;.906;3600000;0
15159;-1;720;0;0;0;0;.00nan;0;0
15159;161163;715;45;27;4;23;.852;3549000;0
15160;883;717;0;0;0;0;.00nan;0;0
15160;175712;717;55;21;3;18;.857;3900000;0
15160;181446;2188;69;37;3;34;.919;3900000;0
15160;-1;2188;0;0;0;0;.00nan;0;0
15161;168842;2529;68;17;1;16;.941;3880000;0
15161;-1;721;78;39;2;37;.949;3880000;0
15161;-1;721;0;0;0;0;.00nan;0;0
15161;62884;2529;0;0;0;0;.00nan;0;0
15162;179151;718;62;24;2;22;.917;3600000;0
15162;185775;720;0;0;0;0;.00nan;0;0
15162;-1;718;0;0;0;0;.00nan;0;0
15162;-1;720;68;32;3;29;.906;3600000;0
15163;161540;716;31;23;5;18;.783;3600000;0
15163;182339;715;87;29;2;27;.931;3600000;0
15163;184437;716;0;0;0;0;.00nan;0;0
15163;161163;715;0;0;0;0;.00nan;0;0
15164;883;717;0;0;0;0;.00nan;0;0
15164;175712;717;53;36;4;32;.889;3592000;0
15164;185775;720;76;26;2;24;.923;3600000;0
15164;-1;720;0;0;0;0;.00nan;0;0
15165;161540;716;0;0;0;0;.00nan;0;0
15165;184437;716;91;35;3;32;.914;3900000;0
15165;179151;718;63;28;3;25;.893;3900000;0
15165;-1;718;0;0;0;0;.00nan;0;0
15166;-1;721;49;21;3;18;.857;3600000;0
15166;181446;2188;10;17;6;11;.647;3110000;0
15166;-1;721;0;0;0;0;.00nan;0;0
15166;-1;2188;62;4;0;4;1.000;490000;0
15167;168842;2529;83;26;1;25;.962;3600000;0
15167;54658;719;94;37;3;34;.919;3592000;0
15167;56611;719;0;0;0;0;.00nan;0;0
15167;62884;2529;0;0;0;0;.00nan;0;0
15168;181446;2188;0;0;0;0;.00nan;0;0
15168;-1;2188;81;24;1;23;.958;3600000;0
15168;54658;719;37;21;4;17;.810;3600000;0
15168;56611;719;0;0;0;0;.00nan;0;0
15169;-1;721;88;36;2;34;.944;3653000;0
15169;185775;720;69;15;1;14;.933;3653000;0
15169;-1;721;0;0;0;0;.00nan;0;0
15169;-1;720;0;0;0;0;.00nan;0;0
15170;883;717;0;0;0;0;.00nan;0;0
15170;161540;716;0;0;0;0;.00nan;0;0
15170;184437;716;88;30;1;29;.967;3600000;0
15170;175712;717;65;23;2;21;.913;3600000;0
15171;182339;715;85;28;1;27;.964;3575000;0
15171;179151;718;100;27;0;27;1.000;3600000;0
15171;-1;718;0;0;0;0;.00nan;0;0
15171;161163;715;0;0;0;0;.00nan;0;0
15172;883;717;45;12;2;10;.833;3600000;0
15172;182339;715;32;31;6;25;.806;3600000;0
15172;175712;717;0;0;0;0;.00nan;0;0
15172;161163;715;0;0;0;0;.00nan;0;0
15173;168842;2529;100;31;0;31;1.000;3600000;0
15173;181446;2188;50;23;3;20;.870;3600000;0
15173;-1;2188;0;0;0;0;.00nan;0;0
15173;62884;2529;0;0;0;0;.00nan;0;0
15174;161540;716;0;0;0;0;.00nan;0;0
15174;184437;716;47;18;3;15;.833;3541000;0
15174;-1;721;95;40;2;38;.950;3600000;0
15174;-1;721;0;0;0;0;.00nan;0;0
15175;185775;720;47;23;4;19;.826;3600000;0
15175;-1;720;0;0;0;0;.00nan;0;0
15175;54658;719;0;0;0;0;.00nan;0;0
15175;56611;719;57;45;5;40;.889;3561000;0
15176;883;717;0;0;0;0;.00nan;0;0
15176;179151;718;98;38;1;37;.974;3600000;0
15176;175712;717;78;33;3;30;.909;3548000;0
15176;-1;718;0;0;0;0;.00nan;0;0
15177;168842;2529;32;30;6;24;.800;3600000;0
15177;185775;720;63;31;4;27;.871;3600000;0
15177;-1;720;0;0;0;0;.00nan;0;0
15177;62884;2529;0;0;0;0;.00nan;0;0
15178;161540;716;0;0;0;0;.00nan;0;0
15178;184437;716;76;32;3;29;.906;3900000;0
15178;54658;719;81;39;3;36;.923;3900000;0
15178;56611;719;0;0;0;0;.00nan;0;0
15179;182339;715;57;18;2;16;.889;3600000;0
15179;-1;721;51;42;6;36;.857;3042000;0
15179;55918;721;53;3;0;3;1.000;558000;0
15179;161163;715;0;0;0;0;.00nan;0;0
15180;179151;718;45;16;3;13;.813;3900000;0
15180;-1;721;65;37;3;34;.919;3900000;0
15180;-1;718;0;0;0;0;.00nan;0;0
15180;55918;721;0;0;0;0;.00nan;0;0
15181;181446;2188;84;35;2;33;.943;3600000;0
15181;185775;720;94;23;0;23;1.000;3600000;0
15181;-1;720;0;0;0;0;.00nan;0;0
15181;77009;2188;0;0;0;0;.00nan;0;0
15182;161540;716;71;35;3;32;.914;3702000;0
15182;168842;2529;70;35;4;31;.886;3702000;0
15182;184437;716;0;0;0;0;.00nan;0;0
15182;62884;2529;0;0;0;0;.00nan;0;0
15183;182339;715;82;28;2;26;.929;3600000;0
15183;54658;719;74;35;3;32;.914;3586000;0
15183;56611;719;0;0;0;0;.00nan;0;0
15183;161163;715;0;0;0;0;.00nan;0;0
15184;161540;716;0;0;0;0;.00nan;0;0
15184;184437;716;64;37;4;33;.892;3565000;0
15184;181446;2188;59;29;3;26;.897;3600000;0
15184;77009;2188;0;0;0;0;.00nan;0;0
15185;182339;715;89;45;4;41;.911;3600000;0
15185;168842;2529;42;34;6;28;.824;3534000;0
15185;62884;2529;0;0;0;0;.00nan;0;0
15185;161163;715;0;0;0;0;.00nan;0;0
15186;883;717;0;0;0;0;.00nan;0;0
15186;175712;717;58;21;2;19;.905;3600000;0
15186;-1;721;34;11;3;8;.727;597000;0
15186;55918;721;71;32;3;29;.906;3003000;0
15187;179151;718;70;18;1;17;.944;3600000;0
15187;-1;718;0;0;0;0;.00nan;0;0
15187;54658;719;75;39;4;35;.897;3600000;0
15187;56611;719;0;0;0;0;.00nan;0;0
15188;883;717;0;0;0;0;.00nan;0;0
15188;175712;717;52;18;2;16;.889;3600000;0
15188;54658;719;80;52;5;47;.904;3600000;0
15188;56611;719;0;0;0;0;.00nan;0;0
15189;168842;2529;83;44;3;41;.932;3600000;0
15189;179151;718;0;0;0;0;.00nan;0;0
15189;-1;718;42;22;4;18;.818;3591000;0
15189;62884;2529;0;0;0;0;.00nan;0;0
15190;161540;716;0;0;0;0;.00nan;0;0
15190;184437;716;85;43;3;40;.930;3600000;0
15190;185775;720;100;21;0;21;1.000;3600000;0
15190;-1;720;0;0;0;0;.00nan;0;0
15191;182339;715;72;22;1;21;.955;3600000;0
15191;181446;2188;63;25;3;22;.880;3562000;0
15191;77009;2188;0;0;0;0;.00nan;0;0
15191;161163;715;0;0;0;0;.00nan;0;0
15192;179151;718;60;20;2;18;.900;3600000;0
15192;181446;2188;71;30;3;27;.900;3600000;0
15192;-1;718;0;0;0;0;.00nan;0;0
15192;77009;2188;0;0;0;0;.00nan;0;0
15193;883;717;0;0;0;0;.00nan;0;0
15193;168842;2529;44;5;1;4;.800;505000;0
15193;175712;717;64;21;2;19;.905;3600000;0
15193;62884;2529;30;33;7;26;.788;3095000;0
15194;182339;715;79;52;5;47;.904;3600000;0
15194;185775;720;65;15;1;14;.933;3600000;0
15194;-1;720;0;0;0;0;.00nan;0;0
15194;161163;715;0;0;0;0;.00nan;0;0
15195;-1;721;34;13;4;9;.692;775000;0
15195;54658;719;100;25;0;25;1.000;3600000;0
15195;55918;721;42;26;4;22;.846;2825000;0
15195;56611;719;0;0;0;0;.00nan;0;0
15196;883;717;71;24;2;22;.917;3656000;0
15196;175712;717;0;0;0;0;.00nan;0;0
15196;181446;2188;55;23;3;20;.870;3656000;0
15196;77009;2188;0;0;0;0;.00nan;0;0
15197;179151;718;57;32;4;28;.875;3600000;0
15197;185775;720;90;34;2;32;.941;3600000;0
15197;-1;718;0;0;0;0;.00nan;0;0
15197;-1;720;0;0;0;0;.00nan;0;0
15198;168842;2529;68;20;1;19;.950;3600000;0
15198;-1;721;0;0;0;0;.00nan;0;0
15198;55918;721;76;39;2;37;.949;3600000;0
15198;62884;2529;0;0;0;0;.00nan;0;0
15199;161540;716;0;0;0;0;.00nan;0;0
15199;182339;715;50;41;6;35;.854;3600000;0
15199;184437;716;77;32;3;29;.906;3600000;0
15199;161163;715;0;0;0;0;.00nan;0;0
15200;-1;721;57;31;5;26;.839;3551000;0
15200;181446;2188;0;0;0;0;.00nan;0;0
15200;55918;721;0;0;0;0;.00nan;0;0
15200;77009;2188;61;27;3;24;.889;3600000;0
15201;168842;2529;63;30;3;27;.900;3900000;0
15201;54658;719;72;35;3;32;.914;3900000;0
15201;56611;719;0;0;0;0;.00nan;0;0
15201;62884;2529;0;0;0;0;.00nan;0;0
15202;883;717;0;0;0;0;.00nan;0;0
15202;175712;717;50;34;4;30;.882;3544000;0
15202;185775;720;99;44;3;41;.932;3600000;0
15202;-1;720;0;0;0;0;.00nan;0;0
15203;161540;716;0;0;0;0;.00nan;0;0
15203;184437;716;60;28;3;25;.893;3582000;0
15203;179151;718;62;24;2;22;.917;3600000;0
15203;-1;718;0;0;0;0;.00nan;0;0
15204;883;717;0;0;0;0;.00nan;0;0
15204;161540;716;0;0;0;0;.00nan;0;0
15204;184437;716;78;30;2;28;.933;3543000;0
15204;175712;717;76;24;1;23;.958;3600000;0
15205;182339;715;67;20;2;18;.900;3900000;0
15205;179151;718;78;28;2;26;.929;3900000;0
15205;-1;718;0;0;0;0;.00nan;0;0
15205;161163;715;0;0;0;0;.00nan;0;0
15206;-1;721;68;45;4;41;.911;3600000;0
15206;185775;720;90;15;0;15;1.000;3600000;0
15206;-1;720;0;0;0;0;.00nan;0;0
15206;55918;721;0;0;0;0;.00nan;0;0
15207;181446;2188;45;22;3;19;.864;3900000;0
15207;54658;719;92;38;3;35;.921;3900000;0
15207;56611;719;0;0;0;0;.00nan;0;0
15207;77009;2188;0;0;0;0;.00nan;0;0
15208;168842;2529;83;25;1;24;.960;3900000;0
15208;181446;2188;97;39;1;38;.974;3900000;0
15208;62884;2529;0;0;0;0;.00nan;0;0
15208;77009;2188;0;0;0;0;.00nan;0;0
15209;185775;720;84;18;0;18;1.000;3600000;0
15209;-1;720;0;0;0;0;.00nan;0;0
15209;54658;719;93;37;2;35;.946;3600000;0
15209;56611;719;0;0;0;0;.00nan;0;0
15210;161540;716;0;0;0;0;.00nan;0;0
15210;184437;716;59;24;3;21;.875;3600000;0
15210;-1;721;51;35;5;30;.857;3600000;0
15210;55918;721;0;0;0;0;.00nan;0;0
15211;883;717;0;0;0;0;.00nan;0;0
15211;182339;715;40;39;6;33;.846;2859000;0
15211;175712;717;54;20;3;17;.850;3600000;0
15211;161163;715;40;8;2;6;.750;741000;0
15212;883;717;55;27;3;24;.889;3569000;0
15212;179151;718;77;25;1;24;.960;3600000;0
15212;175712;717;0;0;0;0;.00nan;0;0
15212;-1;718;0;0;0;0;.00nan;0;0
15213;168842;2529;70;28;2;26;.929;3900000;0
15213;185775;720;77;38;2;36;.947;3891000;0
15213;-1;720;0;0;0;0;.00nan;0;0
15213;62884;2529;0;0;0;0;.00nan;0;0
15214;182339;715;55;30;4;26;.867;3600000;0
15214;-1;721;63;36;5;31;.861;3545000;0
15214;55918;721;0;0;0;0;.00nan;0;0
15214;161163;715;0;0;0;0;.00nan;0;0
15215;161540;716;0;0;0;0;.00nan;0;0
15215;184437;716;46;30;5;25;.833;3600000;0
15215;54658;719;56;19;2;17;.895;3600000;0
15215;56611;719;0;0;0;0;.00nan;0;0
15217;168842;2529;60;28;3;25;.893;3600000;0
15217;179151;718;48;27;4;23;.852;3600000;0
15217;-1;718;0;0;0;0;.00nan;0;0
15217;62884;2529;0;0;0;0;.00nan;0;0
15219;161540;716;0;0;0;0;.00nan;0;0
15219;184437;716;42;20;3;17;.850;3900000;0
15219;-1;721;76;41;3;38;.927;3900000;0
15219;-1;721;0;0;0;0;.00nan;0;0
15221;181446;2188;86;21;1;20;.952;3900000;0
15221;-1;2188;0;0;0;0;.00nan;0;0
15221;54658;719;85;30;1;29;.967;3900000;0
15221;77009;719;0;0;0;0;.00nan;0;0
15223;182339;715;38;38;7;31;.816;3600000;0
15223;185775;720;52;26;3;23;.885;3600000;0
15223;-1;720;0;0;0;0;.00nan;0;0
15223;161163;715;0;0;0;0;.00nan;0;0
15225;182339;715;80;33;2;31;.939;3544000;0
15225;179151;718;78;21;1;20;.952;3600000;0
15225;-1;718;0;0;0;0;.00nan;0;0
15225;161163;715;0;0;0;0;.00nan;0;0
15227;168842;2529;71;23;2;21;.913;3600000;0
15227;-1;721;59;39;4;35;.897;3542000;0
15227;-1;721;0;0;0;0;.00nan;0;0
15227;62884;2529;0;0;0;0;.00nan;0;0
15229;181446;2188;61;41;5;36;.878;3600000;0
15229;185775;720;69;26;2;24;.923;3600000;0
15229;-1;720;0;0;0;0;.00nan;0;0
15229;-1;2188;0;0;0;0;.00nan;0;0
15231;161540;716;0;0;0;0;.00nan;0;0
15231;184437;716;71;19;2;17;.895;3764000;0
15231;54658;719;91;41;3;38;.927;3764000;0
15231;77009;719;0;0;0;0;.00nan;0;0
15233;883;717;93;31;1;30;.968;3600000;0
15233;175712;717;0;0;0;0;.00nan;0;0
15233;-1;721;0;0;0;0;.00nan;0;0
15233;-1;721;54;28;4;24;.857;3600000;0
15235;181446;2188;0;0;0;0;.00nan;0;0
15235;185775;720;0;0;0;0;.00nan;0;0
15235;-1;720;76;28;2;26;.929;3600000;0
15235;-1;2188;61;32;3;29;.906;3575000;0
15237;161540;716;56;31;4;27;.871;3600000;0
15237;182339;715;0;0;0;0;.00nan;0;0
15237;184437;716;0;0;0;0;.00nan;0;0
15237;161163;715;42;27;5;22;.815;3562000;0
15239;168842;2529;0;0;0;0;.00nan;0;0
15239;54658;719;0;0;0;0;.00nan;0;0
15239;62884;2529;68;25;2;23;.920;3600000;0
15239;77009;719;33;23;5;18;.783;3600000;0
15243;883;717;0;0;0;0;.00nan;0;0
15243;182339;715;91;32;1;31;.969;3600000;0
15243;175712;717;57;26;3;23;.885;3540000;0
15243;161163;715;0;0;0;0;.00nan;0;0
15245;168842;2529;100;24;0;24;1.000;3600000;0
15245;-1;721;63;23;2;21;.913;3600000;0
15245;-1;721;0;0;0;0;.00nan;0;0
15245;62884;2529;0;0;0;0;.00nan;0;0
15247;161540;716;0;0;0;0;.00nan;0;0
15247;184437;716;42;22;4;18;.818;3600000;0
15247;185775;720;24;5;3;2;.400;462000;0
15247;-1;720;73;26;2;24;.923;3138000;0
15249;161540;716;88;22;0;22;1.000;3600000;0
15249;184437;716;0;0;0;0;.00nan;0;0
15249;-1;721;0;0;0;0;.00nan;0;0
15249;-1;721;76;45;4;41;.911;3600000;0
15251;182339;715;0;0;0;0;.00nan;0;0
15251;181446;2188;80;27;2;25;.926;3600000;0
15251;-1;2188;0;0;0;0;.00nan;0;0
15251;161163;715;72;41;4;37;.902;3600000;0
15255;883;717;71;20;1;19;.950;3600000;0
15255;168842;2529;69;29;2;27;.931;3600000;0
15255;175712;717;0;0;0;0;.00nan;0;0
15255;62884;2529;0;0;0;0;.00nan;0;0
22293;182339;715;89;46;3;43;.935;3713000;0
22293;179151;718;43;19;4;15;.789;3713000;0
22293;-1;718;0;0;0;0;.00nan;0;0
22293;161163;715;0;0;0;0;.00nan;0;0
22294;883;717;0;0;0;0;.00nan;0;0
22294;168842;2529;86;41;2;39;.951;3600000;0
22294;175712;717;31;21;5;16;.762;3600000;0
22294;62884;2529;0;0;0;0;.00nan;0;0
22295;182339;715;66;39;4;35;.897;3558000;0
22295;185775;720;46;20;3;17;.850;3600000;0
22295;-1;720;0;0;0;0;.00nan;0;0
22295;161163;715;0;0;0;0;.00nan;0;0
22296;168842;2529;52;28;4;24;.857;3534000;0
22296;179151;718;84;39;2;37;.949;3600000;0
22296;-1;718;0;0;0;0;.00nan;0;0
22296;62884;2529;0;0;0;0;.00nan;0;0
22297;883;717;0;0;0;0;.00nan;0;0
22297;175712;717;79;24;1;23;.958;3600000;0
22297;185775;720;68;29;3;26;.897;3555000;0
22297;-1;720;0;0;0;0;.00nan;0;0
22298;182339;715;75;36;3;33;.917;3611000;0
22298;168842;2529;0;0;0;0;.00nan;0;0
22298;62884;2529;78;28;2;26;.929;3602000;0
22298;161163;715;0;0;0;0;.00nan;0;0
22299;168842;2529;81;55;5;50;.909;3600000;0
22299;185775;720;50;13;3;10;.769;3600000;0
22299;-1;720;0;0;0;0;.00nan;0;0
22299;62884;2529;0;0;0;0;.00nan;0;0
22300;883;717;71;24;1;23;.958;3600000;0
22300;179151;718;82;33;2;31;.939;3600000;0
22300;175712;717;0;0;0;0;.00nan;0;0
22300;-1;718;0;0;0;0;.00nan;0;0
22301;179151;718;59;26;3;23;.885;3600000;0
22301;185775;720;77;31;2;29;.935;3600000;0
22301;-1;718;0;0;0;0;.00nan;0;0
22301;-1;720;0;0;0;0;.00nan;0;0
22302;883;717;0;0;0;0;.00nan;0;0
22302;182339;715;0;0;0;0;.00nan;0;0
22302;175712;717;79;31;1;30;.968;3600000;0
22302;161163;715;97;70;5;65;.929;3600000;0
22303;182339;715;78;46;5;41;.891;3562000;0
22303;179151;718;55;23;3;20;.870;3600000;0
22303;-1;718;0;0;0;0;.00nan;0;0
22303;161163;715;0;0;0;0;.00nan;0;0
22304;883;717;46;26;4;22;.846;3600000;0
22304;168842;2529;23;27;6;21;.778;2328000;0
22304;175712;717;0;0;0;0;.00nan;0;0
22304;62884;2529;49;14;2;12;.857;1272000;0
22305;182339;715;74;39;3;36;.923;3600000;0
22305;185775;720;70;18;1;17;.944;3600000;0
22305;-1;720;0;0;0;0;.00nan;0;0
22305;161163;715;0;0;0;0;.00nan;0;0
22306;168842;2529;97;39;2;37;.949;3600000;0
22306;179151;718;43;23;4;19;.826;3558000;0
22306;-1;718;0;0;0;0;.00nan;0;0
22306;62884;2529;0;0;0;0;.00nan;0;0
22307;883;717;0;0;0;0;.00nan;0;0
22307;175712;717;59;36;5;31;.861;3585000;0
22307;185775;720;53;17;3;14;.824;3600000;0
22307;-1;720;0;0;0;0;.00nan;0;0
22308;182339;715;77;42;4;38;.905;3600000;0
22308;168842;2529;52;23;3;20;.870;3600000;0
22308;62884;2529;0;0;0;0;.00nan;0;0
22308;161163;715;0;0;0;0;.00nan;0;0
22309;168842;2529;0;0;0;0;.00nan;0;0
22309;185775;720;94;22;0;22;1.000;3600000;0
22309;-1;720;0;0;0;0;.00nan;0;0
22309;62884;2529;88;29;1;28;.966;3560000;0
22310;883;717;0;0;0;0;.00nan;0;0
22310;179151;718;68;44;4;40;.909;3600000;0
22310;175712;717;37;35;6;29;.829;3521000;0
22310;-1;718;0;0;0;0;.00nan;0;0
22311;179151;718;65;35;3;32;.914;3900000;0
22311;185775;720;62;28;3;25;.893;3900000;0
22311;-1;718;0;0;0;0;.00nan;0;0
22311;-1;720;0;0;0;0;.00nan;0;0
22312;883;717;53;28;4;24;.857;3600000;0
22312;182339;715;25;14;4;10;.714;1055000;0
22312;175712;717;0;0;0;0;.00nan;0;0
22312;161163;715;50;24;3;21;.875;2545000;0
22313;161540;716;0;0;0;0;.00nan;0;0
22313;184437;716;50;18;3;15;.833;3600000;0
22313;-1;721;52;39;6;33;.846;3003000;0
22313;55918;721;42;8;2;6;.750;597000;0
22314;181446;2188;54;26;4;22;.846;3600000;0
22314;54658;719;84;27;1;26;.963;3600000;0
22314;56611;719;0;0;0;0;.00nan;0;0
22314;77009;2188;0;0;0;0;.00nan;0;0
22315;161540;716;0;0;0;0;.00nan;0;0
22315;184437;716;52;28;3;25;.893;3562000;0
22315;54658;719;76;31;2;29;.935;3600000;0
22315;56611;719;0;0;0;0;.00nan;0;0
22316;-1;721;0;0;0;0;.00nan;0;0
22316;181446;2188;78;23;1;22;.957;3814000;0
22316;55918;721;84;38;2;36;.947;3814000;0
22316;77009;2188;0;0;0;0;.00nan;0;0
22317;161540;716;0;0;0;0;.00nan;0;0
22317;184437;716;46;31;5;26;.839;3600000;0
22317;181446;2188;63;25;2;23;.920;3600000;0
22317;77009;2188;0;0;0;0;.00nan;0;0
22318;-1;721;81;32;1;31;.969;3736000;0
22318;54658;719;76;25;2;23;.920;3736000;0
22318;55918;721;0;0;0;0;.00nan;0;0
22318;56611;719;0;0;0;0;.00nan;0;0
22319;161540;716;91;16;0;16;1.000;3600000;0
22319;184437;716;0;0;0;0;.00nan;0;0
22319;-1;721;30;27;6;21;.778;3600000;0
22319;55918;721;0;0;0;0;.00nan;0;0
22320;181446;2188;0;0;0;0;.00nan;0;0
22320;54658;719;88;26;1;25;.962;3600000;0
22320;56611;719;0;0;0;0;.00nan;0;0
22320;77009;2188;90;18;0;18;1.000;3600000;0
22321;161540;716;0;0;0;0;.00nan;0;0
22321;184437;716;48;23;4;19;.826;3600000;0
22321;54658;719;82;31;2;29;.935;3600000;0
22321;56611;719;0;0;0;0;.00nan;0;0
22322;-1;721;58;22;2;20;.909;3581000;0
22322;181446;2188;0;0;0;0;.00nan;0;0
22322;55918;721;0;0;0;0;.00nan;0;0
22322;77009;2188;82;28;1;27;.964;3600000;0
22323;161540;716;0;0;0;0;.00nan;0;0
22323;184437;716;94;39;3;36;.923;3714000;0
22323;181446;2188;42;21;4;17;.810;3714000;0
22323;77009;2188;0;0;0;0;.00nan;0;0
22324;-1;721;87;31;2;29;.935;3600000;0
22324;54658;719;69;34;3;31;.912;3549000;0
22324;55918;721;0;0;0;0;.00nan;0;0
22324;56611;719;0;0;0;0;.00nan;0;0
22571;185775;720;81;14;0;14;1.000;3600000;0
22571;-1;720;0;0;0;0;.00nan;0;0
22571;54658;719;70;37;4;33;.892;3600000;0
22571;56611;719;0;0;0;0;.00nan;0;0
22572;883;717;63;17;1;16;.941;3655000;0
22572;175712;717;0;0;0;0;.00nan;0;0
22572;181446;2188;81;27;2;25;.926;3655000;0
22572;77009;2188;0;0;0;0;.00nan;0;0
22573;161540;716;0;0;0;0;.00nan;0;0
22573;184437;716;73;34;3;31;.912;3600000;0
22573;179151;718;99;21;0;21;1.000;3600000;0
22573;-1;718;0;0;0;0;.00nan;0;0
22574;182339;715;70;42;4;38;.905;3600000;0
22574;168842;2529;81;22;1;21;.955;3600000;0
22574;62884;2529;0;0;0;0;.00nan;0;0
22574;161163;715;0;0;0;0;.00nan;0;0
22575;185775;720;86;14;0;14;1.000;3600000;0
22575;-1;720;0;0;0;0;.00nan;0;0
22575;54658;719;43;45;6;39;.867;3600000;0
22575;56611;719;0;0;0;0;.00nan;0;0
22576;883;717;0;0;0;0;.00nan;0;0
22576;175712;717;62;16;1;15;.938;3600000;0
22576;181446;2188;62;39;4;35;.897;3600000;0
22576;77009;2188;0;0;0;0;.00nan;0;0
22577;161540;716;0;0;0;0;.00nan;0;0
22577;184437;716;85;35;3;32;.914;3553000;0
22577;179151;718;55;15;2;13;.867;3600000;0
22577;-1;718;0;0;0;0;.00nan;0;0
22578;182339;715;82;34;3;31;.912;3718000;0
22578;168842;2529;58;19;2;17;.895;3718000;0
22578;62884;2529;0;0;0;0;.00nan;0;0
22578;161163;715;0;0;0;0;.00nan;0;0
22579;185775;720;60;18;2;16;.889;3600000;0
22579;-1;720;0;0;0;0;.00nan;0;0
22579;54658;719;42;29;5;24;.828;3600000;0
22579;56611;719;0;0;0;0;.00nan;0;0
22581;161540;716;0;0;0;0;.00nan;0;0
22581;184437;716;74;32;3;29;.906;3582000;0
22581;179151;718;63;23;2;21;.913;3600000;0
22581;-1;718;0;0;0;0;.00nan;0;0
15256;61425;474;0;0;0;0;.00nan;0;0
15256;66491;474;100;42;1;41;.976;3600000;0
15256;71297;472;12;18;6;12;.667;2709000;0
15256;85127;472;42;3;1;2;.667;891000;0
15257;20958;4535;0;0;0;0;.00nan;0;0
15257;-1;480;0;0;0;0;.00nan;0;0
15257;63107;480;65;24;2;22;.917;3549000;0
15257;70573;4535;77;33;2;31;.939;3600000;0
15258;168926;5004;92;47;3;44;.936;3600000;0
15258;190235;481;64;22;2;20;.909;3600000;0
15258;56296;481;0;0;0;0;.00nan;0;0
15258;153779;5004;0;0;0;0;.00nan;0;0
15259;3435;675;0;0;0;0;.00nan;0;0
15259;66552;482;0;0;0;0;.00nan;0;0
15259;67222;482;51;24;3;21;.875;3522000;0
15259;142583;675;82;25;1;24;.960;3600000;0
15260;43158;676;0;0;0;0;.00nan;0;0
15260;-1;676;86;41;2;39;.951;4020000;0
15260;81096;490;86;32;2;30;.938;4020000;0
15260;87894;490;0;0;0;0;.00nan;0;0
15261;163528;682;96;20;0;20;1.000;3600000;0
15261;46139;473;62;35;4;31;.886;3600000;0
15261;66551;682;0;0;0;0;.00nan;0;0
15261;78422;473;0;0;0;0;.00nan;0;0
15262;61425;474;88;50;4;46;.920;3589000;0
15262;66491;474;0;0;0;0;.00nan;0;0
15262;81096;490;53;16;2;14;.875;3600000;0
15262;87894;490;0;0;0;0;.00nan;0;0
15263;11500;476;0;0;0;0;.00nan;0;0
15263;168926;5004;67;36;3;33;.917;3600000;0
15263;176765;476;88;17;0;17;1.000;3600000;0
15263;153779;5004;0;0;0;0;.00nan;0;0
15264;3435;675;55;38;5;33;.868;3600000;0
15264;-1;480;0;0;0;0;.00nan;0;0
15264;63107;480;70;27;2;25;.926;3600000;0
15264;142583;675;0;0;0;0;.00nan;0;0
15265;163528;682;88;32;2;30;.938;3632000;0
15265;43158;676;77;42;3;39;.929;3632000;0
15265;-1;676;0;0;0;0;.00nan;0;0
15265;66551;682;0;0;0;0;.00nan;0;0
15266;20958;4535;0;0;0;0;.00nan;0;0
15266;190235;481;0;0;0;0;.00nan;0;0
15266;56296;481;84;28;2;26;.929;3600000;0
15266;70573;4535;54;31;4;27;.871;3563000;0
15267;46139;473;93;32;1;31;.969;3600000;0
15267;71297;472;57;21;2;19;.905;3600000;0
15267;78422;473;0;0;0;0;.00nan;0;0
15267;85127;472;0;0;0;0;.00nan;0;0
15268;11500;476;0;0;0;0;.00nan;0;0
15268;176765;476;36;26;5;21;.808;3600000;0
15268;81096;490;73;28;2;26;.929;3600000;0
15268;87894;490;0;0;0;0;.00nan;0;0
15269;66552;482;0;0;0;0;.00nan;0;0
15269;67222;482;58;31;4;27;.871;3600000;0
15269;81096;490;46;33;5;28;.848;3600000;0
15269;87894;490;0;0;0;0;.00nan;0;0
15270;3435;675;58;12;1;11;.917;3600000;0
15270;61425;474;88;41;2;39;.951;3583000;0
15270;66491;474;0;0;0;0;.00nan;0;0
15270;142583;675;0;0;0;0;.00nan;0;0
15271;190235;481;0;0;0;0;.00nan;0;0
15271;-1;480;90;32;1;31;.969;3600000;0
15271;56296;481;58;31;4;27;.871;3600000;0
15271;63107;480;0;0;0;0;.00nan;0;0
15272;163528;682;76;19;1;18;.947;3600000;0
15272;66551;682;0;0;0;0;.00nan;0;0
15272;71297;472;61;34;4;30;.882;3600000;0
15272;85127;472;0;0;0;0;.00nan;0;0
15273;11500;476;0;0;0;0;.00nan;0;0
15273;24593;676;56;45;6;39;.867;3569000;0
15273;176765;476;55;25;4;21;.840;3600000;0
15273;43158;676;0;0;0;0;.00nan;0;0
15274;168926;5004;70;35;2;33;.943;3600000;0
15274;173840;5004;0;0;0;0;.00nan;0;0
15274;46139;473;51;28;4;24;.857;3574000;0
15274;78422;473;0;0;0;0;.00nan;0;0
15275;24593;676;91;34;1;33;.971;3600000;0
15275;190235;481;0;0;0;0;.00nan;0;0
15275;43158;676;0;0;0;0;.00nan;0;0
15275;56296;481;69;23;2;21;.913;3566000;0
15276;71297;472;59;26;3;23;.885;3600000;0
15276;81096;490;77;40;4;36;.900;3552000;0
15276;85127;472;0;0;0;0;.00nan;0;0
15276;87894;490;0;0;0;0;.00nan;0;0
15277;163528;682;89;16;0;16;1.000;3600000;0
15277;168926;5004;58;56;7;49;.875;3600000;0
15277;173840;5004;0;0;0;0;.00nan;0;0
15277;66551;682;0;0;0;0;.00nan;0;0
15278;61425;474;29;15;4;11;.733;1068000;0
15278;66491;474;94;27;0;27;1.000;2525000;0
15278;66552;482;0;0;0;0;.00nan;0;0
15278;67222;482;71;28;2;26;.929;3600000;0
15279;3435;675;46;16;3;13;.813;3600000;0
15279;46139;473;15;6;4;2;.333;942000;0
15279;78422;473;81;25;1;24;.960;2574000;0
15279;142583;675;0;0;0;0;.00nan;0;0
15280;11500;476;0;0;0;0;.00nan;0;0
15280;20958;4535;0;0;0;0;.00nan;0;0
15280;176765;476;58;23;3;20;.870;3826000;0
15280;70573;4535;66;37;4;33;.892;3826000;0
15281;190235;481;27;16;4;12;.750;3581000;0
15281;56296;481;0;0;0;0;.00nan;0;0
15281;81096;490;68;29;2;27;.931;3600000;0
15281;87894;490;0;0;0;0;.00nan;0;0
15282;-1;480;0;0;0;0;.00nan;0;0
15282;61425;474;0;0;0;0;.00nan;0;0
15282;63107;480;52;26;4;22;.846;3567000;0
15282;66491;474;64;32;3;29;.906;3600000;0
15283;3435;675;0;0;0;0;.00nan;0;0
15283;24593;676;65;31;4;27;.871;3544000;0
15283;43158;676;0;0;0;0;.00nan;0;0
15283;142583;675;83;32;3;29;.906;3600000;0
15284;163528;682;74;26;1;25;.962;3600000;0
15284;66551;682;0;0;0;0;.00nan;0;0
15284;66552;482;0;0;0;0;.00nan;0;0
15284;67222;482;63;35;4;31;.886;3600000;0
15285;11500;476;0;0;0;0;.00nan;0;0
15285;176765;476;50;23;4;19;.826;3600000;0
15285;71297;472;50;34;5;29;.853;3543000;0
15285;85127;472;0;0;0;0;.00nan;0;0
15286;20958;4535;0;0;0;0;.00nan;0;0
15286;46139;473;63;15;1;14;.933;3600000;0
15286;70573;4535;77;37;3;34;.919;3600000;0
15286;78422;473;0;0;0;0;.00nan;0;0
15287;163528;682;58;25;3;22;.880;3600000;0
15287;66551;682;0;0;0;0;.00nan;0;0
15287;81096;490;60;33;4;29;.879;3600000;0
15287;87894;490;0;0;0;0;.00nan;0;0
15288;24593;676;71;46;3;43;.935;4020000;0
15288;-1;480;0;0;0;0;.00nan;0;0
15288;43158;676;0;0;0;0;.00nan;0;0
15288;63107;480;76;31;3;28;.903;3985000;0
15289;190235;481;0;0;0;0;.00nan;0;0
15289;46139;473;62;31;4;27;.871;3600000;0
15289;56296;481;62;42;5;37;.881;3578000;0
15289;78422;473;0;0;0;0;.00nan;0;0
15290;168926;5004;74;36;4;32;.889;3600000;0
15290;173840;5004;0;0;0;0;.00nan;0;0
15290;66552;482;0;0;0;0;.00nan;0;0
15290;67222;482;84;24;1;23;.958;3600000;0
15291;3435;675;80;37;2;35;.946;3600000;0
15291;11500;476;0;0;0;0;.00nan;0;0
15291;176765;476;63;27;3;24;.889;3543000;0
15291;142583;675;0;0;0;0;.00nan;0;0
15292;20958;4535;0;0;0;0;.00nan;0;0
15292;61425;474;87;36;2;34;.944;3576000;0
15292;66491;474;0;0;0;0;.00nan;0;0
15292;70573;4535;84;26;1;25;.962;3600000;0
15293;24593;676;0;0;0;0;.00nan;0;0
15293;43158;676;43;24;5;19;.792;3546000;0
15293;61425;474;0;0;0;0;.00nan;0;0
15293;66491;474;100;53;4;49;.925;3600000;0
15294;168926;5004;86;49;4;45;.918;3600000;0
15294;173840;5004;0;0;0;0;.00nan;0;0
15294;71297;472;84;25;1;24;.960;3600000;0
15294;85127;472;0;0;0;0;.00nan;0;0
15295;-1;480;0;0;0;0;.00nan;0;0
15295;46139;473;65;43;4;39;.907;3517000;0
15295;63107;480;63;23;2;21;.913;3600000;0
15295;78422;473;0;0;0;0;.00nan;0;0
15296;163528;682;70;29;3;26;.897;3600000;0
15296;190235;481;0;0;0;0;.00nan;0;0
15296;56296;481;48;25;4;21;.840;3570000;0
15296;66551;682;0;0;0;0;.00nan;0;0
15297;3435;675;32;26;5;21;.808;3600000;0
15297;20958;4535;0;0;0;0;.00nan;0;0
15297;70573;4535;58;31;3;28;.903;3600000;0
15297;142583;675;0;0;0;0;.00nan;0;0
15298;11500;476;43;24;4;20;.833;3557000;0
15298;176765;476;0;0;0;0;.00nan;0;0
15298;66552;482;0;0;0;0;.00nan;0;0
15298;67222;482;60;26;3;23;.885;3600000;0
15299;-1;480;0;0;0;0;.00nan;0;0
15299;63107;480;64;41;5;36;.878;3600000;0
15299;71297;472;69;24;1;23;.958;3600000;0
15299;85127;472;0;0;0;0;.00nan;0;0
15300;20958;4535;0;0;0;0;.00nan;0;0
15300;66552;482;0;0;0;0;.00nan;0;0
15300;67222;482;43;30;5;25;.833;3600000;0
15300;70573;4535;94;23;0;23;1.000;3600000;0
15301;3435;675;0;0;0;0;.00nan;0;0
15301;163528;682;69;21;1;20;.952;3600000;0
15301;66551;682;0;0;0;0;.00nan;0;0
15301;142583;675;72;30;2;28;.933;3600000;0
15302;168926;5004;44;23;4;19;.826;3600000;0
15302;173840;5004;0;0;0;0;.00nan;0;0
15302;24593;676;80;26;1;25;.962;3600000;0
15302;43158;676;0;0;0;0;.00nan;0;0
15303;11500;476;0;0;0;0;.00nan;0;0
15303;176765;476;62;17;2;15;.882;4020000;0
15303;61425;474;97;54;2;52;.963;3984000;0
15303;66491;474;0;0;0;0;.00nan;0;0
15304;46139;473;69;42;5;37;.881;3600000;0
15304;78422;473;0;0;0;0;.00nan;0;0
15304;81096;490;73;17;1;16;.941;3600000;0
15304;87894;490;0;0;0;0;.00nan;0;0
15305;20958;4535;0;0;0;0;.00nan;0;0
15305;70573;4535;91;26;1;25;.962;3600000;0
15305;71297;472;72;31;2;29;.935;3566000;0
15305;85127;472;0;0;0;0;.00nan;0;0
15306;168926;5004;0;0;0;0;.00nan;0;0
15306;173840;5004;65;26;2;24;.923;3600000;0
15306;61425;474;0;0;0;0;.00nan;0;0
15306;66491;474;47;36;5;31;.861;3600000;0
15307;3435;675;0;0;0;0;.00nan;0;0
15307;190235;481;0;0;0;0;.00nan;0;0
15307;56296;481;99;34;1;33;.971;3600000;0
15307;142583;675;57;25;3;22;.880;3579000;0
15308;24593;676;89;30;1;29;.967;3600000;0
15308;43158;676;0;0;0;0;.00nan;0;0
15308;66552;482;0;0;0;0;.00nan;0;0
15308;67222;482;56;35;4;31;.886;3600000;0
15309;163528;682;0;0;0;0;.00nan;0;0
15309;-1;480;0;0;0;0;.00nan;0;0
15309;63107;480;63;36;4;32;.889;3581000;0
15309;66551;682;59;22;2;20;.909;3600000;0
15310;20958;4535;0;0;0;0;.00nan;0;0
15310;70573;4535;74;32;2;30;.938;4020000;0
15310;81096;490;93;42;2;40;.952;4020000;0
15310;87894;490;0;0;0;0;.00nan;0;0
15311;190235;481;66;20;2;18;.900;3600000;0
15311;56296;481;0;0;0;0;.00nan;0;0
15311;61425;474;59;36;4;32;.889;3555000;0
15311;66491;474;0;0;0;0;.00nan;0;0
15312;168926;5004;99;39;1;38;.974;3600000;0
15312;173840;5004;0;0;0;0;.00nan;0;0
15312;-1;480;0;0;0;0;.00nan;0;0
15312;63107;480;73;34;3;31;.912;3576000;0
15313;66552;482;0;0;0;0;.00nan;0;0
15313;67222;482;63;22;2;20;.909;3600000;0
15313;71297;472;29;31;6;25;.806;3159000;0
15313;85127;472;59;5;0;5;1.000;441000;0
15314;163528;682;100;36;0;36;1.000;3600000;0
15314;11500;476;0;0;0;0;.00nan;0;0
15314;176765;476;57;22;2;20;.909;3513000;0
15314;66551;682;0;0;0;0;.00nan;0;0
15315;24593;676;68;35;4;31;.886;3533000;0
15315;43158;676;0;0;0;0;.00nan;0;0
15315;46139;473;0;0;0;0;.00nan;0;0
15315;78422;473;64;21;2;19;.905;3600000;0
15316;168926;5004;24;15;4;11;.733;1181000;0
15316;173840;5004;52;17;2;15;.882;2419000;0
15316;190235;481;0;0;0;0;.00nan;0;0
15316;56296;481;52;17;3;14;.824;3600000;0
15317;3435;675;77;29;2;27;.931;3579000;0
15317;168926;5004;100;32;0;32;1.000;3600000;0
15317;173840;5004;0;0;0;0;.00nan;0;0
15317;142583;675;0;0;0;0;.00nan;0;0
15318;-1;480;0;0;0;0;.00nan;0;0
15318;63107;480;98;36;1;35;.972;3600000;0
15318;81096;490;0;0;0;0;.00nan;0;0
15318;87894;490;100;31;0;31;1.000;3600000;0
15319;11500;476;0;0;0;0;.00nan;0;0
15319;176765;476;64;35;5;30;.857;3719000;0
15319;190235;481;44;22;4;18;.818;3719000;0
15319;56296;481;0;0;0;0;.00nan;0;0
15320;46139;473;51;30;4;26;.867;3600000;0
15320;66552;482;0;0;0;0;.00nan;0;0
15320;67222;482;75;21;2;19;.905;3600000;0
15320;78422;473;0;0;0;0;.00nan;0;0
15321;163528;682;59;33;5;28;.848;3752000;0
15321;20958;4535;0;0;0;0;.00nan;0;0
15321;66551;682;0;0;0;0;.00nan;0;0
15321;70573;4535;50;39;6;33;.846;3752000;0
15322;163528;682;78;10;0;10;1.000;3600000;0
15322;61425;474;45;38;5;33;.868;3600000;0
15322;66491;474;0;0;0;0;.00nan;0;0
15322;66551;682;0;0;0;0;.00nan;0;0
15323;11500;476;68;17;1;16;.941;3696000;0
15323;176765;476;0;0;0;0;.00nan;0;0
15323;46139;473;74;30;2;28;.933;3696000;0
15323;78422;473;0;0;0;0;.00nan;0;0
15324;190235;481;0;0;0;0;.00nan;0;0
15324;56296;481;99;34;1;33;.971;3600000;0
15324;71297;472;0;0;0;0;.00nan;0;0
15324;85127;472;93;36;2;34;.944;3585000;0
15325;-1;480;0;0;0;0;.00nan;0;0
15325;63107;480;68;31;3;28;.903;3561000;0
15325;66552;482;0;0;0;0;.00nan;0;0
15325;67222;482;86;37;2;35;.946;3600000;0
15326;3435;675;0;0;0;0;.00nan;0;0
15326;81096;490;100;25;0;25;1.000;3600000;0
15326;87894;490;0;0;0;0;.00nan;0;0
15326;142583;675;70;19;1;18;.947;3556000;0
15327;168926;5004;60;26;3;23;.885;3600000;0
15327;20958;4535;0;0;0;0;.00nan;0;0
15327;173840;5004;0;0;0;0;.00nan;0;0
15327;70573;4535;35;22;4;18;.818;3600000;0
15328;168926;5004;24;26;6;20;.769;2719000;0
15328;173840;5004;46;13;2;11;.846;881000;0
15328;81096;490;79;28;3;25;.893;3600000;0
15328;87894;490;0;0;0;0;.00nan;0;0
15329;11500;476;0;0;0;0;.00nan;0;0
15329;176765;476;53;23;3;20;.870;3600000;0
15329;-1;480;0;0;0;0;.00nan;0;0
15329;63107;480;100;28;0;28;1.000;3600000;0
15330;190235;481;0;0;0;0;.00nan;0;0
15330;56296;481;58;30;4;26;.867;3600000;0
15330;66552;482;0;0;0;0;.00nan;0;0
15330;67222;482;100;24;0;24;1.000;3600000;0
15331;3435;675;82;39;3;36;.923;3600000;0
15331;71297;472;74;27;2;25;.926;3600000;0
15331;85127;472;0;0;0;0;.00nan;0;0
15331;142583;675;0;0;0;0;.00nan;0;0
15332;20958;4535;0;0;0;0;.00nan;0;0
15332;24593;676;91;31;2;29;.935;3600000;0
15332;43158;676;0;0;0;0;.00nan;0;0
15332;70573;4535;41;23;4;19;.826;3600000;0
15333;46139;473;85;24;1;23;.958;3600000;0
15333;61425;474;0;0;0;0;.00nan;0;0
15333;66491;474;30;32;6;26;.813;3600000;0
15333;78422;473;0;0;0;0;.00nan;0;0
15334;24593;676;69;24;2;22;.917;4020000;0
15334;43158;676;0;0;0;0;.00nan;0;0
15334;61425;474;84;36;2;34;.944;4020000;0
15334;66491;474;0;0;0;0;.00nan;0;0
15335;163528;682;88;16;0;16;1.000;3600000;0
15335;20958;4535;0;0;0;0;.00nan;0;0
15335;66551;682;0;0;0;0;.00nan;0;0
15335;70573;4535;53;17;2;15;.882;3565000;0
15336;46139;473;75;39;3;36;.923;3600000;0
15336;71297;472;41;21;4;17;.810;3543000;0
15336;78422;473;0;0;0;0;.00nan;0;0
15336;85127;472;0;0;0;0;.00nan;0;0
15337;168926;5004;53;3;0;3;1.000;409000;0
15337;173840;5004;47;35;6;29;.829;3191000;0
15337;66552;482;0;0;0;0;.00nan;0;0
15337;67222;482;59;19;2;17;.895;3600000;0
15338;190235;481;68;26;2;24;.923;3600000;0
15338;56296;481;0;0;0;0;.00nan;0;0
15338;81096;490;51;31;4;27;.871;3552000;0
15338;87894;490;0;0;0;0;.00nan;0;0
15339;3435;675;50;42;6;36;.857;3600000;0
15339;11500;476;0;0;0;0;.00nan;0;0
15339;176765;476;89;20;0;20;1.000;3600000;0
15339;142583;675;0;0;0;0;.00nan;0;0
15340;168926;5004;76;38;3;35;.921;3600000;0
15340;173840;5004;0;0;0;0;.00nan;0;0
15340;-1;480;0;0;0;0;.00nan;0;0
15340;63107;480;55;17;2;15;.882;3600000;0
15341;71297;472;66;27;2;25;.926;3563000;0
15341;81096;490;100;33;1;32;.970;3600000;0
15341;85127;472;0;0;0;0;.00nan;0;0
15341;87894;490;0;0;0;0;.00nan;0;0
15342;190235;481;0;0;0;0;.00nan;0;0
15342;56296;481;74;19;1;18;.947;3600000;0
15342;61425;474;0;0;0;0;.00nan;0;0
15342;66491;474;74;36;3;33;.917;3600000;0
15343;3435;675;100;40;1;39;.975;4020000;0
15343;163528;682;62;18;1;17;.944;4020000;0
15343;66551;682;0;0;0;0;.00nan;0;0
15343;142583;675;0;0;0;0;.00nan;0;0
15344;20958;4535;55;10;1;9;.900;1800000;0
15344;66552;482;0;0;0;0;.00nan;0;0
15344;67222;482;65;38;4;34;.895;3948000;0
15344;70573;4535;35;20;4;16;.800;2148000;0
15345;11500;476;0;0;0;0;.00nan;0;0
15345;176765;476;43;19;4;15;.789;3704000;0
15345;46139;473;69;31;3;28;.903;3704000;0
15345;78422;473;0;0;0;0;.00nan;0;0
15346;163528;682;92;35;1;34;.971;3600000;0
15346;66551;682;0;0;0;0;.00nan;0;0
15346;71297;472;34;19;4;15;.789;3600000;0
15346;85127;472;0;0;0;0;.00nan;0;0
15347;61425;474;60;33;4;29;.879;3600000;0
15347;66491;474;0;0;0;0;.00nan;0;0
15347;81096;490;19;19;5;14;.737;3594000;0
15347;87894;490;0;0;0;0;.00nan;0;0
15348;-1;480;0;0;0;0;.00nan;0;0
15348;63107;480;97;33;1;32;.970;3541000;0
15348;66552;482;0;0;0;0;.00nan;0;0
15348;67222;482;100;23;0;23;1.000;3600000;0
15349;3435;675;42;26;4;22;.846;3574000;0
15349;20958;4535;0;0;0;0;.00nan;0;0
15349;70573;4535;61;27;3;24;.889;3600000;0
15349;142583;675;0;0;0;0;.00nan;0;0
15350;24593;676;0;0;0;0;.00nan;0;0
15350;43158;676;100;31;0;31;1.000;3600000;0
15350;46139;473;33;36;7;29;.806;3600000;0
15350;78422;473;0;0;0;0;.00nan;0;0
15351;11500;476;0;0;0;0;.00nan;0;0
15351;168926;5004;66;39;4;35;.897;3600000;0
15351;173840;5004;0;0;0;0;.00nan;0;0
15351;176765;476;52;16;2;14;.875;3600000;0
15352;168926;5004;100;38;0;38;1.000;3600000;0
15352;173840;5004;0;0;0;0;.00nan;0;0
15352;24593;676;0;0;0;0;.00nan;0;0
15352;43158;676;46;21;3;18;.857;3600000;0
15353;3435;675;83;29;2;27;.931;3600000;0
15353;-1;480;71;33;4;29;.879;3549000;0
15353;63107;480;0;0;0;0;.00nan;0;0
15353;142583;675;0;0;0;0;.00nan;0;0
15354;190235;481;0;0;0;0;.00nan;0;0
15354;56296;481;87;45;5;40;.889;4020000;0
15354;71297;472;44;22;5;17;.773;4020000;0
15354;85127;472;0;0;0;0;.00nan;0;0
15355;163528;682;83;12;0;12;1.000;3600000;0
15355;61425;474;0;0;0;0;.00nan;0;0
15355;66491;474;78;46;4;42;.913;3600000;0
15355;66551;682;0;0;0;0;.00nan;0;0
15356;20958;4535;0;0;0;0;.00nan;0;0
15356;70573;4535;80;27;1;26;.963;3600000;0
15356;81096;490;68;26;3;23;.885;3576000;0
15356;87894;490;0;0;0;0;.00nan;0;0
15357;46139;473;68;34;4;30;.882;3600000;0
15357;66552;482;0;0;0;0;.00nan;0;0
15357;67222;482;67;27;3;24;.889;3600000;0
15357;78422;473;0;0;0;0;.00nan;0;0
15358;11500;476;0;0;0;0;.00nan;0;0
15358;176765;476;81;29;2;27;.931;3600000;0
15358;71297;472;56;34;5;29;.853;3600000;0
15358;85127;472;0;0;0;0;.00nan;0;0
15359;163528;682;100;25;0;25;1.000;3600000;0
15359;-1;480;0;0;0;0;.00nan;0;0
15359;63107;480;77;34;3;31;.912;3600000;0
15359;66551;682;0;0;0;0;.00nan;0;0
15360;20958;4535;0;0;0;0;.00nan;0;0
15360;190235;481;0;0;0;0;.00nan;0;0
15360;56296;481;65;26;2;24;.923;3589000;0
15360;70573;4535;99;47;1;46;.979;3600000;0
15361;66552;482;0;0;0;0;.00nan;0;0
15361;67222;482;66;20;1;19;.950;3600000;0
15361;81096;490;65;26;3;23;.885;3600000;0
15361;87894;490;0;0;0;0;.00nan;0;0
15362;3435;675;95;23;0;23;1.000;3600000;0
15362;24593;676;77;30;1;29;.967;3577000;0
15362;43158;676;0;0;0;0;.00nan;0;0
15362;142583;675;0;0;0;0;.00nan;0;0
15363;66552;482;0;0;0;0;.00nan;0;0
15363;67222;482;75;34;4;30;.882;3828000;0
15363;71297;472;0;0;0;0;.00nan;0;0
15363;85127;472;68;33;3;30;.909;3828000;0
15364;168926;5004;84;47;2;45;.957;4020000;0
15364;173840;5004;0;0;0;0;.00nan;0;0
15364;190235;481;57;13;2;11;.846;4020000;0
15364;56296;481;0;0;0;0;.00nan;0;0
15365;3435;675;75;40;4;36;.900;3600000;0
15365;81096;490;31;31;6;25;.806;3573000;0
15365;87894;490;0;0;0;0;.00nan;0;0
15365;142583;675;0;0;0;0;.00nan;0;0
15366;163528;682;49;25;4;21;.840;3600000;0
15366;24593;676;73;22;1;21;.955;3600000;0
15366;43158;676;0;0;0;0;.00nan;0;0
15366;66551;682;0;0;0;0;.00nan;0;0
15367;20958;4535;0;0;0;0;.00nan;0;0
15367;46139;473;56;30;4;26;.867;3585000;0
15367;70573;4535;63;18;2;16;.889;3600000;0
15367;78422;473;0;0;0;0;.00nan;0;0
15368;11500;476;0;0;0;0;.00nan;0;0
15368;176765;476;63;20;2;18;.900;3600000;0
15368;-1;480;55;32;5;27;.844;3600000;0
15368;63107;480;0;0;0;0;.00nan;0;0
15369;46139;473;83;25;1;24;.960;3600000;0
15369;61425;474;59;37;5;32;.865;3600000;0
15369;66491;474;0;0;0;0;.00nan;0;0
15369;78422;473;0;0;0;0;.00nan;0;0
15370;20958;4535;0;0;0;0;.00nan;0;0
15370;61425;474;0;0;0;0;.00nan;0;0
15370;66491;474;100;43;0;43;1.000;3600000;0
15370;70573;4535;77;22;1;21;.955;3559000;0
15371;-1;480;65;26;3;23;.885;3600000;0
15371;63107;480;0;0;0;0;.00nan;0;0
15371;81096;490;39;21;4;17;.810;2221000;0
15371;87894;490;50;19;3;16;.842;1379000;0
15372;163528;682;66;13;1;12;.923;3600000;0
15372;190235;481;0;0;0;0;.00nan;0;0
15372;56296;481;74;38;4;34;.895;3600000;0
15372;66551;682;0;0;0;0;.00nan;0;0
15373;11500;476;0;0;0;0;.00nan;0;0
15373;176765;476;64;38;4;34;.895;3569000;0
15373;66552;482;63;32;3;29;.906;3600000;0
15373;67222;482;0;0;0;0;.00nan;0;0
15374;3435;675;0;0;0;0;.00nan;0;0
15374;168926;5004;0;0;0;0;.00nan;0;0
15374;173840;5004;97;41;2;39;.951;3588000;0
15374;142583;675;100;23;0;23;1.000;3600000;0
15375;24593;676;35;25;5;20;.800;2372000;0
15375;43158;676;28;18;4;14;.778;1228000;0
15375;71297;472;56;19;2;17;.895;3600000;0
15375;85127;472;0;0;0;0;.00nan;0;0
15376;163528;682;69;15;1;14;.933;3600000;0
15376;168926;5004;61;47;6;41;.872;3600000;0
15376;173840;5004;0;0;0;0;.00nan;0;0
15376;66551;682;0;0;0;0;.00nan;0;0
15377;11500;476;0;0;0;0;.00nan;0;0
15377;176765;476;63;26;3;23;.885;3717000;0
15377;81096;490;87;39;2;37;.949;3717000;0
15377;87894;490;0;0;0;0;.00nan;0;0
15378;61425;474;0;0;0;0;.00nan;0;0
15378;66491;474;49;30;4;26;.867;3600000;0
15378;66552;482;0;0;0;0;.00nan;0;0
15378;67222;482;88;25;1;24;.960;3600000;0
15379;24593;676;52;22;3;19;.864;3523000;0
15379;190235;481;0;0;0;0;.00nan;0;0
15379;43158;676;0;0;0;0;.00nan;0;0
15379;56296;481;79;25;1;24;.960;3600000;0
15380;20958;4535;43;24;4;20;.833;3600000;0
15380;70573;4535;0;0;0;0;.00nan;0;0
15380;71297;472;71;20;1;19;.950;3600000;0
15380;85127;472;0;0;0;0;.00nan;0;0
15381;-1;480;0;0;0;0;.00nan;0;0
15381;46139;473;77;41;3;38;.927;3600000;0
15381;63107;480;62;39;4;35;.897;3600000;0
15381;78422;473;0;0;0;0;.00nan;0;0
15382;61425;474;90;53;5;48;.906;3724000;0
15382;66491;474;0;0;0;0;.00nan;0;0
15382;71297;472;0;0;0;0;.00nan;0;0
15382;85127;472;58;27;4;23;.852;3724000;0
15383;24593;676;100;33;0;33;1.000;3764000;0
15383;-1;480;0;0;0;0;.00nan;0;0
15383;43158;676;0;0;0;0;.00nan;0;0
15383;63107;480;84;29;1;28;.966;3764000;0
15384;190235;481;63;24;2;22;.917;3600000;0
15384;46139;473;0;0;0;0;.00nan;0;0
15384;56296;481;0;0;0;0;.00nan;0;0
15384;78422;473;74;34;3;31;.912;3550000;0
15385;168926;5004;89;36;1;35;.972;3600000;0
15385;20958;4535;0;0;0;0;.00nan;0;0
15385;173840;5004;0;0;0;0;.00nan;0;0
15385;70573;4535;84;19;0;19;1.000;3600000;0
15386;3435;675;0;0;0;0;.00nan;0;0
15386;66552;482;0;0;0;0;.00nan;0;0
15386;67222;482;68;26;2;24;.923;3600000;0
15386;142583;675;61;25;3;22;.880;3600000;0
15387;163528;682;78;35;2;33;.943;3600000;0
15387;11500;476;0;0;0;0;.00nan;0;0
15387;176765;476;59;26;3;23;.885;3600000;0
15387;66551;682;0;0;0;0;.00nan;0;0
15388;168926;5004;0;0;0;0;.00nan;0;0
15388;173840;5004;64;28;3;25;.893;3600000;0
15388;46139;473;66;25;2;23;.920;3600000;0
15388;78422;473;0;0;0;0;.00nan;0;0
15389;24593;676;35;26;5;21;.808;3600000;0
15389;43158;676;0;0;0;0;.00nan;0;0
15389;81096;490;77;26;2;24;.923;3600000;0
15389;87894;490;0;0;0;0;.00nan;0;0
15390;-1;480;0;0;0;0;.00nan;0;0
15390;61425;474;94;41;1;40;.976;3866000;0
15390;63107;480;94;18;0;18;1.000;3866000;0
15390;66491;474;0;0;0;0;.00nan;0;0
15391;163528;682;79;24;1;23;.958;3600000;0
15391;66551;682;0;0;0;0;.00nan;0;0
15391;66552;482;0;0;0;0;.00nan;0;0
15391;67222;482;4;26;8;18;.692;3600000;0
15392;3435;675;71;46;5;41;.891;3600000;0
15392;190235;481;0;0;0;0;.00nan;0;0
15392;56296;481;59;21;2;19;.905;3600000;0
15392;142583;675;0;0;0;0;.00nan;0;0
15393;11500;476;0;0;0;0;.00nan;0;0
15393;20958;4535;0;0;0;0;.00nan;0;0
15393;176765;476;52;24;3;21;.875;3579000;0
15393;70573;4535;91;34;1;33;.971;3600000;0
15394;3435;675;66;31;4;27;.871;3600000;0
15394;71297;472;99;30;0;30;1.000;3600000;0
15394;85127;472;0;0;0;0;.00nan;0;0
15394;142583;675;0;0;0;0;.00nan;0;0
15395;46139;473;70;32;3;29;.906;3600000;0
15395;78422;473;0;0;0;0;.00nan;0;0
15395;81096;490;78;40;4;36;.900;3544000;0
15395;87894;490;0;0;0;0;.00nan;0;0
15396;168926;5004;51;31;4;27;.871;3600000;0
15396;173840;5004;0;0;0;0;.00nan;0;0
15396;61425;474;74;20;1;19;.950;3600000;0
15396;66491;474;0;0;0;0;.00nan;0;0
15397;190235;481;73;30;3;27;.900;3600000;0
15397;56296;481;0;0;0;0;.00nan;0;0
15397;66552;482;0;0;0;0;.00nan;0;0
15397;67222;482;42;24;4;20;.833;3589000;0
15398;11500;476;0;0;0;0;.00nan;0;0
15398;24593;676;64;32;3;29;.906;3600000;0
15398;176765;476;46;12;2;10;.833;3600000;0
15398;43158;676;0;0;0;0;.00nan;0;0
15399;20958;4535;0;0;0;0;.00nan;0;0
15399;-1;480;0;0;0;0;.00nan;0;0
15399;63107;480;72;19;1;18;.947;3600000;0
15399;70573;4535;62;39;5;34;.872;3600000;0
15400;168926;5004;99;23;0;23;1.000;3600000;0
15400;173840;5004;0;0;0;0;.00nan;0;0
15400;81096;490;43;26;5;21;.808;3600000;0
15400;87894;490;0;0;0;0;.00nan;0;0
15401;-1;480;0;0;0;0;.00nan;0;0
15401;63107;480;71;38;4;34;.895;3600000;0
15401;71297;472;25;25;6;19;.760;1628000;0
15401;85127;472;30;15;4;11;.733;1972000;0
15402;24593;676;61;39;4;35;.897;3600000;0
15402;43158;676;0;0;0;0;.00nan;0;0
15402;66552;482;61;5;0;5;1.000;1372000;0
15402;67222;482;7;14;6;8;.571;2143000;0
15403;3435;675;74;25;1;24;.960;3600000;0
15403;61425;474;0;0;0;0;.00nan;0;0
15403;66491;474;66;27;3;24;.889;3557000;0
15403;142583;675;0;0;0;0;.00nan;0;0
15404;11500;476;0;0;0;0;.00nan;0;0
15404;176765;476;82;41;2;39;.951;3600000;0
15404;190235;481;0;0;0;0;.00nan;0;0
15404;56296;481;71;34;4;30;.882;3535000;0
15405;163528;682;49;29;4;25;.862;3549000;0
15405;46139;473;58;23;3;20;.870;3600000;0
15405;66551;682;0;0;0;0;.00nan;0;0
15405;78422;473;0;0;0;0;.00nan;0;0
15406;168926;5004;75;28;2;26;.929;3592000;0
15406;173840;5004;0;0;0;0;.00nan;0;0
15406;71297;472;0;0;0;0;.00nan;0;0
15406;85127;472;82;28;1;27;.964;3600000;0
15407;11500;476;0;0;0;0;.00nan;0;0
15407;176765;476;92;20;0;20;1.000;3600000;0
15407;61425;474;89;42;3;39;.929;3600000;0
15407;66491;474;0;0;0;0;.00nan;0;0
15408;190235;481;0;0;0;0;.00nan;0;0
15408;-1;480;0;0;0;0;.00nan;0;0
15408;56296;481;62;23;2;21;.913;3600000;0
15408;63107;480;44;28;5;23;.821;3600000;0
15409;163528;682;70;22;2;20;.909;4020000;0
15409;66551;682;0;0;0;0;.00nan;0;0
15409;81096;490;70;28;2;26;.929;4020000;0
15409;87894;490;0;0;0;0;.00nan;0;0
15410;20958;4535;0;0;0;0;.00nan;0;0
15410;24593;676;59;27;3;24;.889;3563000;0
15410;43158;676;0;0;0;0;.00nan;0;0
15410;70573;4535;68;19;2;17;.895;3600000;0
15411;3435;675;77;21;1;20;.952;3600000;0
15411;46139;473;96;21;0;21;1.000;3600000;0
15411;78422;473;0;0;0;0;.00nan;0;0
15411;142583;675;0;0;0;0;.00nan;0;0
15412;24593;676;77;30;2;28;.933;3650000;0
15412;43158;676;0;0;0;0;.00nan;0;0
15412;61425;474;0;0;0;0;.00nan;0;0
15412;66491;474;66;29;3;26;.897;3650000;0
15413;163528;682;78;13;0;13;1.000;3600000;0
15413;168926;5004;0;0;0;0;.00nan;0;0
15413;173840;5004;37;37;6;31;.838;3600000;0
15413;66551;682;0;0;0;0;.00nan;0;0
15414;66552;482;0;0;0;0;.00nan;0;0
15414;67222;482;63;34;4;30;.882;3600000;0
15414;71297;472;0;0;0;0;.00nan;0;0
15414;85127;472;69;16;1;15;.938;3600000;0
15415;-1;480;0;0;0;0;.00nan;0;0
15415;63107;480;61;18;1;17;.944;3600000;0
15415;81096;490;59;41;5;36;.878;3600000;0
15415;87894;490;0;0;0;0;.00nan;0;0
15416;20958;4535;0;0;0;0;.00nan;0;0
15416;46139;473;64;30;3;27;.900;3600000;0
15416;70573;4535;67;36;4;32;.889;3600000;0
15416;78422;473;0;0;0;0;.00nan;0;0
15417;3435;675;71;37;4;33;.892;3600000;0
15417;11500;476;0;0;0;0;.00nan;0;0
15417;176765;476;63;29;3;26;.897;3600000;0
15417;142583;675;0;0;0;0;.00nan;0;0
15418;46139;473;61;12;1;11;.917;3546000;0
15418;61425;474;100;27;0;27;1.000;3600000;0
15418;66491;474;0;0;0;0;.00nan;0;0
15418;78422;473;0;0;0;0;.00nan;0;0
15419;168926;5004;61;29;3;26;.897;3600000;0
15419;20958;4535;0;0;0;0;.00nan;0;0
15419;173840;5004;0;0;0;0;.00nan;0;0
15419;70573;4535;79;22;1;21;.955;3600000;0
15420;61425;474;66;36;4;32;.889;3519000;0
15420;66491;474;0;0;0;0;.00nan;0;0
15420;71297;472;49;13;2;11;.846;3600000;0
15420;85127;472;0;0;0;0;.00nan;0;0
15421;163528;682;54;30;4;26;.867;3576000;0
15421;-1;480;79;29;2;27;.931;3600000;0
15421;63107;480;0;0;0;0;.00nan;0;0
15421;66551;682;0;0;0;0;.00nan;0;0
15422;66552;482;61;32;3;29;.906;3513000;0
15422;67222;482;0;0;0;0;.00nan;0;0
15422;81096;490;93;38;1;37;.974;3600000;0
15422;87894;490;0;0;0;0;.00nan;0;0
15423;24593;676;0;0;0;0;.00nan;0;0
15423;190235;481;0;0;0;0;.00nan;0;0
15423;43158;676;67;31;3;28;.903;3576000;0
15423;56296;481;58;21;2;19;.905;3600000;0
15424;11500;476;0;0;0;0;.00nan;0;0
15424;176765;476;55;22;3;19;.864;4020000;0
15424;46139;473;75;30;3;27;.900;4020000;0
15424;78422;473;0;0;0;0;.00nan;0;0
15425;20958;4535;0;0;0;0;.00nan;0;0
15425;70573;4535;85;28;1;27;.964;3600000;0
15425;71297;472;0;0;0;0;.00nan;0;0
15425;85127;472;62;36;4;32;.889;3600000;0
15426;190235;481;72;25;2;23;.920;3600000;0
15426;46139;473;44;27;4;23;.852;3600000;0
15426;56296;481;0;0;0;0;.00nan;0;0
15426;78422;473;0;0;0;0;.00nan;0;0
15427;168926;5004;85;28;1;27;.964;3600000;0
15427;173840;5004;0;0;0;0;.00nan;0;0
15427;81096;490;92;15;0;15;1.000;3600000;0
15427;87894;490;0;0;0;0;.00nan;0;0
15428;3435;675;36;24;5;19;.792;3558000;0
15428;24593;676;59;35;4;31;.886;3600000;0
15428;43158;676;0;0;0;0;.00nan;0;0
15428;142583;675;0;0;0;0;.00nan;0;0
15429;163528;682;66;18;1;17;.944;3600000;0
15429;61425;474;91;48;3;45;.938;3571000;0
15429;66491;474;0;0;0;0;.00nan;0;0
15429;66551;682;0;0;0;0;.00nan;0;0
15430;11500;476;75;26;2;24;.923;3600000;0
15430;176765;476;0;0;0;0;.00nan;0;0
15430;66552;482;0;0;0;0;.00nan;0;0
15430;67222;482;81;38;3;35;.921;3576000;0
15431;24593;676;43;29;5;24;.828;2235000;0
15431;43158;676;69;13;0;13;1.000;1316000;0
15431;71297;472;32;15;4;11;.733;3600000;0
15431;85127;472;0;0;0;0;.00nan;0;0
15432;-1;480;0;0;0;0;.00nan;0;0
15432;63107;480;99;21;0;21;1.000;3600000;0
15432;71297;472;54;21;2;19;.905;3599000;0
15432;85127;472;0;0;0;0;.00nan;0;0
15433;3435;675;33;41;7;34;.829;3600000;0
15433;66552;482;0;0;0;0;.00nan;0;0
15433;67222;482;100;24;0;24;1.000;3600000;0
15433;142583;675;0;0;0;0;.00nan;0;0
15434;163528;682;62;13;1;12;.923;3600000;0
15434;24593;676;67;48;6;42;.875;3600000;0
15434;43158;676;0;0;0;0;.00nan;0;0
15434;66551;682;0;0;0;0;.00nan;0;0
15435;20958;4535;0;0;0;0;.00nan;0;0
15435;70573;4535;71;27;2;25;.926;3600000;0
15435;81096;490;59;33;4;29;.879;3566000;0
15435;87894;490;0;0;0;0;.00nan;0;0
15436;46139;473;57;21;2;19;.905;3600000;0
15436;61425;474;72;42;5;37;.881;3600000;0
15436;66491;474;0;0;0;0;.00nan;0;0
15436;78422;473;0;0;0;0;.00nan;0;0
15437;168926;5004;77;28;2;26;.929;4020000;0
15437;173840;5004;0;0;0;0;.00nan;0;0
15437;61425;474;70;28;2;26;.929;4020000;0
15437;66491;474;0;0;0;0;.00nan;0;0
15438;190235;481;0;0;0;0;.00nan;0;0
15438;56296;481;100;29;0;29;1.000;3600000;0
15438;81096;490;56;24;3;21;.875;3600000;0
15438;87894;490;0;0;0;0;.00nan;0;0
15439;-1;480;0;0;0;0;.00nan;0;0
15439;63107;480;44;17;3;14;.824;3600000;0
15439;66552;482;25;20;5;15;.750;1629000;0
15439;67222;482;45;27;5;22;.815;1971000;0
15440;3435;675;45;32;5;27;.844;3600000;0
15440;163528;682;81;24;1;23;.958;3600000;0
15440;66551;682;0;0;0;0;.00nan;0;0
15440;142583;675;0;0;0;0;.00nan;0;0
15441;20958;4535;0;0;0;0;.00nan;0;0
15441;24593;676;24;11;4;7;.636;1618000;0
15441;43158;676;68;24;2;22;.917;1982000;0
15441;70573;4535;65;26;2;24;.923;3600000;0
15442;11500;476;0;0;0;0;.00nan;0;0
15442;176765;476;84;28;2;26;.929;3600000;0
15442;71297;472;54;26;4;22;.846;3554000;0
15442;85127;472;0;0;0;0;.00nan;0;0
15443;168926;5004;82;32;1;31;.969;3600000;0
15443;173840;5004;0;0;0;0;.00nan;0;0
15443;24593;676;58;29;4;25;.862;3600000;0
15443;43158;676;0;0;0;0;.00nan;0;0
15444;11500;476;0;0;0;0;.00nan;0;0
15444;176765;476;55;22;3;19;.864;3600000;0
15444;81096;490;84;33;1;32;.970;3600000;0
15444;87894;490;0;0;0;0;.00nan;0;0
15445;-1;480;0;0;0;0;.00nan;0;0
15445;61425;474;74;34;3;31;.912;3600000;0
15445;63107;480;50;20;4;16;.800;3572000;0
15445;66491;474;0;0;0;0;.00nan;0;0
15446;190235;481;0;0;0;0;.00nan;0;0
15446;56296;481;91;34;1;33;.971;3600000;0
15446;66552;482;0;0;0;0;.00nan;0;0
15446;67222;482;59;24;3;21;.875;3519000;0
15447;163528;682;52;17;2;15;.882;3534000;0
15447;46139;473;100;34;0;34;1.000;3600000;0
15447;66551;682;0;0;0;0;.00nan;0;0
15447;78422;473;0;0;0;0;.00nan;0;0
15448;3435;675;55;31;4;27;.871;3600000;0
15448;20958;4535;0;0;0;0;.00nan;0;0
15448;70573;4535;42;35;6;29;.829;3600000;0
15448;142583;675;0;0;0;0;.00nan;0;0
15449;71297;472;0;0;0;0;.00nan;0;0
15449;81096;490;83;37;3;34;.919;3588000;0
15449;85127;472;77;22;1;21;.955;3600000;0
15449;87894;490;0;0;0;0;.00nan;0;0
15450;20958;4535;0;0;0;0;.00nan;0;0
15450;-1;480;0;0;0;0;.00nan;0;0
15450;63107;480;65;33;3;30;.909;3550000;0
15450;70573;4535;81;24;1;23;.958;3600000;0
15451;163528;682;99;22;0;22;1.000;3600000;0
15451;66551;682;0;0;0;0;.00nan;0;0
15451;66552;482;93;45;2;43;.956;3549000;0
15451;67222;482;0;0;0;0;.00nan;0;0
15452;3435;675;0;0;0;0;.00nan;0;0
15452;190235;481;0;0;0;0;.00nan;0;0
15452;56296;481;71;34;3;31;.912;3596000;0
15452;142583;675;66;21;2;19;.905;3600000;0
15453;11500;476;0;0;0;0;.00nan;0;0
15453;176765;476;84;17;0;17;1.000;3600000;0
15453;61425;474;76;45;4;41;.911;3600000;0
15453;66491;474;0;0;0;0;.00nan;0;0
15454;168926;5004;88;41;2;39;.951;4020000;0
15454;173840;5004;0;0;0;0;.00nan;0;0
15454;46139;473;59;24;2;22;.917;4020000;0
15454;78422;473;0;0;0;0;.00nan;0;0
15455;168926;5004;0;0;0;0;.00nan;0;0
15455;173840;5004;70;31;3;28;.903;3581000;0
15455;-1;480;0;0;0;0;.00nan;0;0
15455;63107;480;60;16;1;15;.938;3600000;0
15456;61425;474;0;0;0;0;.00nan;0;0
15456;66491;474;97;48;1;47;.979;3600000;0
15456;66552;482;0;0;0;0;.00nan;0;0
15456;67222;482;92;18;0;18;1.000;3600000;0
15457;190235;481;95;18;0;18;1.000;3600000;0
15457;56296;481;0;0;0;0;.00nan;0;0
15457;71297;472;38;32;6;26;.813;3177000;0
15457;85127;472;45;6;1;5;.833;423000;0
15458;3435;675;69;24;2;22;.917;3571000;0
15458;81096;490;75;28;1;27;.964;3600000;0
15458;87894;490;0;0;0;0;.00nan;0;0
15458;142583;675;0;0;0;0;.00nan;0;0
15459;24593;676;47;9;1;8;.889;444000;0
15459;43158;676;35;35;6;29;.829;3156000;0
15459;46139;473;69;25;2;23;.920;3600000;0
15459;78422;473;0;0;0;0;.00nan;0;0
15460;163528;682;76;27;2;25;.926;4020000;0
15460;11500;476;0;0;0;0;.00nan;0;0
15460;176765;476;88;41;2;39;.951;4020000;0
15460;66551;682;0;0;0;0;.00nan;0;0
15461;46139;473;67;27;3;24;.889;3600000;0
15461;71297;472;51;39;5;34;.872;3521000;0
15461;78422;473;0;0;0;0;.00nan;0;0
15461;85127;472;0;0;0;0;.00nan;0;0
15462;24593;676;75;22;1;21;.955;3600000;0
15462;43158;676;0;0;0;0;.00nan;0;0
15462;81096;490;28;29;6;23;.793;3283000;0
15462;87894;490;49;1;0;1;1.000;317000;0
15463;190235;481;89;19;0;19;1.000;3600000;0
15463;56296;481;0;0;0;0;.00nan;0;0
15463;61425;474;97;45;1;44;.978;3600000;0
15463;66491;474;0;0;0;0;.00nan;0;0
15464;3435;675;44;32;5;27;.844;3600000;0
15464;-1;480;64;24;2;22;.917;3600000;0
15464;63107;480;0;0;0;0;.00nan;0;0
15464;142583;675;0;0;0;0;.00nan;0;0
15465;20958;4535;0;0;0;0;.00nan;0;0
15465;66552;482;0;0;0;0;.00nan;0;0
15465;67222;482;76;38;3;35;.921;3600000;0
15465;70573;4535;59;13;1;12;.923;3600000;0
15466;11500;476;87;16;0;16;1.000;3600000;0
15466;168926;5004;71;48;5;43;.896;3600000;0
15466;173840;5004;0;0;0;0;.00nan;0;0
15466;176765;476;0;0;0;0;.00nan;0;0
15467;190235;481;28;27;6;21;.778;3583000;0
15467;-1;480;0;0;0;0;.00nan;0;0
15467;56296;481;0;0;0;0;.00nan;0;0
15467;63107;480;50;33;5;28;.848;3600000;0
15468;3435;675;56;22;3;19;.864;3600000;0
15468;168926;5004;66;39;4;35;.897;3574000;0
15468;173840;5004;0;0;0;0;.00nan;0;0
15468;142583;675;0;0;0;0;.00nan;0;0
15469;11500;476;70;23;2;21;.913;4020000;0
15469;24593;676;82;38;2;36;.947;4006000;0
15469;176765;476;0;0;0;0;.00nan;0;0
15469;43158;676;0;0;0;0;.00nan;0;0
15470;163528;682;0;0;0;0;.00nan;0;0
15470;66551;682;53;19;2;17;.895;3561000;0
15470;71297;472;84;29;1;28;.966;3600000;0
15470;85127;472;0;0;0;0;.00nan;0;0
15471;20958;4535;67;22;1;21;.955;3600000;0
15471;61425;474;85;44;3;41;.932;3577000;0
15471;66491;474;0;0;0;0;.00nan;0;0
15471;70573;4535;0;0;0;0;.00nan;0;0
15472;46139;473;0;0;0;0;.00nan;0;0
15472;78422;473;69;32;3;29;.906;3899000;0
15472;81096;490;86;40;2;38;.950;3899000;0
15472;87894;490;0;0;0;0;.00nan;0;0
15473;24593;676;73;24;1;23;.958;3554000;0
15473;43158;676;0;0;0;0;.00nan;0;0
15473;71297;472;0;0;0;0;.00nan;0;0
15473;85127;472;100;22;0;22;1.000;3600000;0
15474;163528;682;69;26;2;24;.923;4020000;0
15474;66551;682;0;0;0;0;.00nan;0;0
15474;81096;490;97;39;2;37;.949;4020000;0
15474;87894;490;0;0;0;0;.00nan;0;0
15475;11500;476;0;0;0;0;.00nan;0;0
15475;176765;476;89;32;1;31;.969;3578000;0
15475;-1;480;0;0;0;0;.00nan;0;0
15475;63107;480;93;23;0;23;1.000;3600000;0
15476;168926;5004;87;48;4;44;.917;3600000;0
15476;173840;5004;0;0;0;0;.00nan;0;0
15476;66552;482;0;0;0;0;.00nan;0;0
15476;67222;482;100;22;0;22;1.000;3600000;0
15477;20958;4535;0;0;0;0;.00nan;0;0
15477;190235;481;0;0;0;0;.00nan;0;0
15477;56296;481;56;17;2;15;.882;3566000;0
15477;70573;4535;86;29;1;28;.966;3600000;0
15478;3435;675;95;43;1;42;.977;4020000;0
15478;46139;473;87;27;1;26;.963;4020000;0
15478;78422;473;0;0;0;0;.00nan;0;0
15478;142583;675;0;0;0;0;.00nan;0;0
15479;61425;474;61;31;4;27;.871;3600000;0
15479;66491;474;0;0;0;0;.00nan;0;0
15479;81096;490;94;20;0;20;1.000;3600000;0
15479;87894;490;0;0;0;0;.00nan;0;0
15480;3435;675;0;0;0;0;.00nan;0;0
15480;71297;472;0;0;0;0;.00nan;0;0
15480;85127;472;70;33;3;30;.909;3561000;0
15480;142583;675;87;26;1;25;.962;3600000;0
15481;24593;676;73;36;3;33;.917;3600000;0
15481;43158;676;0;0;0;0;.00nan;0;0
15481;66552;482;0;0;0;0;.00nan;0;0
15481;67222;482;33;21;5;16;.762;3527000;0
15482;163528;682;46;32;5;27;.844;3581000;0
15482;190235;481;0;0;0;0;.00nan;0;0
15482;56296;481;47;27;4;23;.852;3600000;0
15482;66551;682;0;0;0;0;.00nan;0;0
15483;11500;476;0;0;0;0;.00nan;0;0
15483;20958;4535;0;0;0;0;.00nan;0;0
15483;176765;476;64;22;2;20;.909;4020000;0
15483;70573;4535;69;27;2;25;.926;4020000;0
15484;-1;480;0;0;0;0;.00nan;0;0
15484;46139;473;75;31;2;29;.935;3568000;0
15484;63107;480;89;32;1;31;.969;3600000;0
15484;78422;473;0;0;0;0;.00nan;0;0
15485;168926;5004;99;44;2;42;.955;3600000;0
15485;173840;5004;0;0;0;0;.00nan;0;0
15485;71297;472;62;31;3;28;.903;3543000;0
15485;85127;472;0;0;0;0;.00nan;0;0
15486;3435;675;58;19;3;16;.842;3600000;0
15486;61425;474;63;35;4;31;.886;3565000;0
15486;66491;474;0;0;0;0;.00nan;0;0
15486;142583;675;0;0;0;0;.00nan;0;0
15487;24593;676;89;40;3;37;.925;4020000;0
15487;-1;480;0;0;0;0;.00nan;0;0
15487;43158;676;0;0;0;0;.00nan;0;0
15487;63107;480;52;21;3;18;.857;4020000;0
15488;11500;476;0;0;0;0;.00nan;0;0
15488;176765;476;63;22;2;20;.909;3600000;0
15488;190235;481;0;0;0;0;.00nan;0;0
15488;56296;481;85;42;3;39;.929;3600000;0
15489;46139;473;43;31;5;26;.839;3545000;0
15489;66552;482;0;0;0;0;.00nan;0;0
15489;67222;482;78;32;3;29;.906;3600000;0
15489;78422;473;0;0;0;0;.00nan;0;0
15490;163528;682;60;21;2;19;.905;3556000;0
15490;20958;4535;0;0;0;0;.00nan;0;0
15490;66551;682;0;0;0;0;.00nan;0;0
15490;70573;4535;96;32;1;31;.969;3600000;0
15491;163528;682;45;12;3;9;.750;3600000;0
15491;61425;474;40;3;1;2;.667;400000;0
15491;66491;474;40;46;8;38;.826;3200000;0
15491;66551;682;0;0;0;0;.00nan;0;0
15492;20958;4535;0;0;0;0;.00nan;0;0
15492;24593;676;59;6;0;6;1.000;964000;0
15492;43158;676;15;25;7;18;.720;2636000;0
15492;70573;4535;100;36;1;35;.972;3600000;0
15493;11500;476;52;30;5;25;.833;3600000;0
15493;176765;476;0;0;0;0;.00nan;0;0
15493;46139;473;100;26;0;26;1.000;3600000;0
15493;78422;473;0;0;0;0;.00nan;0;0
15494;168926;5004;86;44;4;40;.909;3538000;0
15494;173840;5004;0;0;0;0;.00nan;0;0
15494;-1;480;54;16;2;14;.875;3600000;0
15494;63107;480;0;0;0;0;.00nan;0;0
15495;190235;481;62;20;2;18;.900;3600000;0
15495;56296;481;0;0;0;0;.00nan;0;0
15495;81096;490;39;24;4;20;.833;2345000;0
15495;87894;490;65;18;1;17;.944;1255000;0
15496;3435;675;55;22;3;19;.864;3600000;0
15496;66552;482;0;0;0;0;.00nan;0;0
15496;67222;482;66;34;4;30;.882;3564000;0
15496;142583;675;0;0;0;0;.00nan;0;0
15497;190235;481;0;0;0;0;.00nan;0;0
15497;56296;481;46;34;6;28;.824;3580000;0
15497;71297;472;47;25;4;21;.840;3600000;0
15497;85127;472;0;0;0;0;.00nan;0;0
15498;61425;474;71;40;3;37;.925;3547000;0
15498;66491;474;0;0;0;0;.00nan;0;0
15498;81096;490;0;0;0;0;.00nan;0;0
15498;87894;490;77;32;2;30;.938;3600000;0
15499;-1;480;0;0;0;0;.00nan;0;0
15499;63107;480;39;27;5;22;.815;3961000;0
15499;66552;482;0;0;0;0;.00nan;0;0
15499;67222;482;39;33;6;27;.818;3961000;0
15500;3435;675;88;39;2;37;.949;3804000;0
15500;24593;676;85;49;3;46;.939;3822000;0
15500;43158;676;0;0;0;0;.00nan;0;0
15500;142583;675;0;0;0;0;.00nan;0;0
15501;163528;682;42;21;4;17;.810;3549000;0
15501;11500;476;0;0;0;0;.00nan;0;0
15501;176765;476;71;34;3;31;.912;3600000;0
15501;66551;682;0;0;0;0;.00nan;0;0
15502;20958;4535;0;0;0;0;.00nan;0;0
15502;46139;473;68;29;3;26;.897;4020000;0
15502;70573;4535;65;35;3;32;.914;4020000;0
15502;78422;473;0;0;0;0;.00nan;0;0
15503;61425;474;0;0;0;0;.00nan;0;0
15503;66491;474;96;41;2;39;.951;3600000;0
15503;71297;472;0;0;0;0;.00nan;0;0
15503;85127;472;43;15;3;12;.800;3545000;0
15504;3435;675;0;0;0;0;.00nan;0;0
15504;81096;490;88;38;2;36;.947;3580000;0
15504;87894;490;0;0;0;0;.00nan;0;0
15504;142583;675;100;36;1;35;.972;3600000;0
15505;163528;682;60;13;1;12;.923;3600000;0
15505;20958;4535;0;0;0;0;.00nan;0;0
15505;66551;682;0;0;0;0;.00nan;0;0
15505;70573;4535;38;37;6;31;.838;3600000;0
15506;190235;481;0;0;0;0;.00nan;0;0
15506;-1;480;0;0;0;0;.00nan;0;0
15506;56296;481;57;23;3;20;.870;3600000;0
15506;63107;480;53;32;5;27;.844;3600000;0
15507;168926;5004;50;38;5;33;.868;3574000;0
15507;173840;5004;0;0;0;0;.00nan;0;0
15507;24593;676;54;25;3;22;.880;3600000;0
15507;43158;676;0;0;0;0;.00nan;0;0
15508;46139;473;90;52;4;48;.923;3600000;0
15508;66552;482;0;0;0;0;.00nan;0;0
15508;67222;482;71;20;1;19;.950;3600000;0
15508;78422;473;0;0;0;0;.00nan;0;0
15509;3435;675;82;21;1;20;.952;3600000;0
15509;168926;5004;0;0;0;0;.00nan;0;0
15509;173840;5004;65;29;3;26;.897;3582000;0
15509;142583;675;0;0;0;0;.00nan;0;0
15510;11500;476;0;0;0;0;.00nan;0;0
15510;176765;476;78;13;0;13;1.000;3600000;0
15510;61425;474;98;38;1;37;.974;3600000;0
15510;66491;474;0;0;0;0;.00nan;0;0
15511;163528;682;70;16;1;15;.938;3600000;0
15511;190235;481;66;45;5;40;.889;3600000;0
15511;56296;481;0;0;0;0;.00nan;0;0
15511;66551;682;0;0;0;0;.00nan;0;0
15512;66552;482;61;30;3;27;.900;3949000;0
15512;67222;482;0;0;0;0;.00nan;0;0
15512;71297;472;76;35;2;33;.943;3949000;0
15512;85127;472;0;0;0;0;.00nan;0;0
15513;24593;676;100;34;1;33;.971;3600000;0
15513;43158;676;0;0;0;0;.00nan;0;0
15513;81096;490;59;21;2;19;.905;3547000;0
15513;87894;490;0;0;0;0;.00nan;0;0
15514;20958;4535;0;0;0;0;.00nan;0;0
15514;-1;480;0;0;0;0;.00nan;0;0
15514;63107;480;41;19;3;16;.842;3600000;0
15514;70573;4535;92;24;1;23;.958;3600000;0
15515;20958;4535;36;11;3;8;.727;1314000;0
15515;70573;4535;14;24;7;17;.708;2286000;0
15515;71297;472;73;30;3;27;.900;3600000;0
15515;85127;472;0;0;0;0;.00nan;0;0
15516;190235;481;0;0;0;0;.00nan;0;0
15516;46139;473;87;35;2;33;.943;3600000;0
15516;56296;481;48;17;3;14;.824;3600000;0
15516;78422;473;0;0;0;0;.00nan;0;0
15517;24593;676;52;36;5;31;.861;3543000;0
15517;43158;676;0;0;0;0;.00nan;0;0
15517;66552;482;0;0;0;0;.00nan;0;0
15517;67222;482;72;33;4;29;.879;3600000;0
15518;163528;682;62;14;1;13;.929;3600000;0
15518;168926;5004;73;39;4;35;.897;3600000;0
15518;173840;5004;0;0;0;0;.00nan;0;0
15518;66551;682;0;0;0;0;.00nan;0;0
15519;11500;476;0;0;0;0;.00nan;0;0
15519;176765;476;52;29;4;25;.862;3600000;0
15519;-1;480;0;0;0;0;.00nan;0;0
15519;63107;480;64;16;1;15;.938;3600000;0
15520;20958;4535;0;0;0;0;.00nan;0;0
15520;70573;4535;70;33;3;30;.909;3600000;0
15520;81096;490;92;21;0;21;1.000;3600000;0
15520;87894;490;0;0;0;0;.00nan;0;0
15521;-1;480;91;31;1;30;.968;3567000;0
15521;46139;473;0;0;0;0;.00nan;0;0
15521;63107;480;0;0;0;0;.00nan;0;0
15521;78422;473;95;24;0;24;1.000;3600000;0
15522;24593;676;0;0;0;0;.00nan;0;0
15522;190235;481;74;30;3;27;.900;4020000;0
15522;43158;676;61;33;3;30;.909;4020000;0
15522;56296;481;0;0;0;0;.00nan;0;0
15523;163528;682;69;25;2;23;.920;3600000;0
15523;66551;682;0;0;0;0;.00nan;0;0
15523;71297;472;83;41;3;38;.927;3557000;0
15523;85127;472;0;0;0;0;.00nan;0;0
15524;168926;5004;60;37;5;32;.865;3600000;0
15524;173840;5004;0;0;0;0;.00nan;0;0
15524;66552;482;0;0;0;0;.00nan;0;0
15524;67222;482;75;21;1;20;.952;3600000;0
15525;3435;675;99;40;1;39;.975;3600000;0
15525;11500;476;0;0;0;0;.00nan;0;0
15525;176765;476;65;24;2;22;.917;3600000;0
15525;142583;675;0;0;0;0;.00nan;0;0
15526;3435;675;83;14;0;14;1.000;3600000;0
15526;61425;474;82;38;2;36;.947;3520000;0
15526;66491;474;0;0;0;0;.00nan;0;0
15526;142583;675;0;0;0;0;.00nan;0;0
15527;168926;5004;56;28;3;25;.893;3600000;0
15527;173840;5004;0;0;0;0;.00nan;0;0
15527;81096;490;83;24;1;23;.958;3600000;0
15527;87894;490;0;0;0;0;.00nan;0;0
15528;20958;4535;0;0;0;0;.00nan;0;0
15528;61425;474;58;32;4;28;.875;3592000;0
15528;66491;474;0;0;0;0;.00nan;0;0
15528;70573;4535;57;24;3;21;.875;3600000;0
15529;3435;675;81;25;1;24;.960;3600000;0
15529;-1;480;0;0;0;0;.00nan;0;0
15529;63107;480;100;33;0;33;1.000;3600000;0
15529;142583;675;0;0;0;0;.00nan;0;0
15530;163528;682;34;24;5;19;.792;3842000;0
15530;66551;682;0;0;0;0;.00nan;0;0
15530;66552;482;0;0;0;0;.00nan;0;0
15530;67222;482;69;37;4;33;.892;3842000;0
15531;11500;476;40;29;6;23;.793;3566000;0
15531;176765;476;0;0;0;0;.00nan;0;0
15531;190235;481;0;0;0;0;.00nan;0;0
15531;56296;481;48;32;5;27;.844;3600000;0
15532;46139;473;0;0;0;0;.00nan;0;0
15532;71297;472;78;30;2;28;.933;3600000;0
15532;78422;473;58;27;3;24;.889;3566000;0
15532;85127;472;0;0;0;0;.00nan;0;0
15533;3435;675;45;39;6;33;.846;3229000;0
15533;71297;472;0;0;0;0;.00nan;0;0
15533;85127;472;54;7;1;6;.857;3600000;0
15533;142583;675;53;3;0;3;1.000;371000;0
15534;46139;473;60;33;4;29;.879;3600000;0
15534;78422;473;0;0;0;0;.00nan;0;0
15534;81096;490;100;27;0;27;1.000;3600000;0
15534;87894;490;0;0;0;0;.00nan;0;0
15535;11500;476;0;0;0;0;.00nan;0;0
15535;176765;476;64;28;3;25;.893;3560000;0
15535;66552;482;0;0;0;0;.00nan;0;0
15535;67222;482;85;36;2;34;.944;3600000;0
15536;163528;682;43;20;4;16;.800;3839000;0
15536;24593;676;49;36;5;31;.861;3839000;0
15536;43158;676;0;0;0;0;.00nan;0;0
15536;66551;682;0;0;0;0;.00nan;0;0
15537;168926;5004;97;28;0;28;1.000;3600000;0
15537;20958;4535;0;0;0;0;.00nan;0;0
15537;173840;5004;0;0;0;0;.00nan;0;0
15537;70573;4535;84;31;2;29;.935;3516000;0
15538;11500;476;0;0;0;0;.00nan;0;0
15538;176765;476;57;33;4;29;.879;3525000;0
15538;71297;472;78;32;2;30;.938;3600000;0
15538;85127;472;0;0;0;0;.00nan;0;0
15539;168926;5004;71;45;5;40;.889;3600000;0
15539;173840;5004;0;0;0;0;.00nan;0;0
15539;46139;473;94;17;0;17;1.000;3600000;0
15539;78422;473;0;0;0;0;.00nan;0;0
15540;20958;4535;0;0;0;0;.00nan;0;0
15540;190235;481;100;20;0;20;1.000;3600000;0
15540;56296;481;0;0;0;0;.00nan;0;0
15540;70573;4535;95;40;2;38;.950;3600000;0
15541;61425;474;83;44;4;40;.909;3554000;0
15541;66491;474;0;0;0;0;.00nan;0;0
15541;66552;482;0;0;0;0;.00nan;0;0
15541;67222;482;56;18;2;16;.889;3600000;0
15542;24593;676;68;32;4;28;.875;3582000;0
15542;-1;480;0;0;0;0;.00nan;0;0
15542;43158;676;0;0;0;0;.00nan;0;0
15542;63107;480;60;25;3;22;.880;3600000;0
15543;163528;682;57;16;2;14;.875;3600000;0
15543;66551;682;0;0;0;0;.00nan;0;0
15543;81096;490;58;24;3;21;.875;3592000;0
15543;87894;490;0;0;0;0;.00nan;0;0
15544;168926;5004;52;21;3;18;.857;3600000;0
15544;173840;5004;0;0;0;0;.00nan;0;0
15544;61425;474;52;27;4;23;.852;3600000;0
15544;66491;474;0;0;0;0;.00nan;0;0
15545;-1;480;0;0;0;0;.00nan;0;0
15545;63107;480;68;33;3;30;.909;3600000;0
15545;71297;472;41;24;5;19;.792;3514000;0
15545;85127;472;0;0;0;0;.00nan;0;0
15546;3435;675;96;37;2;35;.946;3600000;0
15546;190235;481;40;31;6;25;.806;3600000;0
15546;56296;481;0;0;0;0;.00nan;0;0
15546;142583;675;0;0;0;0;.00nan;0;0
15547;20958;4535;0;0;0;0;.00nan;0;0
15547;66552;482;0;0;0;0;.00nan;0;0
15547;67222;482;100;29;0;29;1.000;3600000;0
15547;70573;4535;68;37;4;33;.892;3600000;0
15548;11500;476;0;0;0;0;.00nan;0;0
15548;176765;476;62;22;3;19;.864;3600000;0
15548;81096;490;80;42;4;38;.905;3566000;0
15548;87894;490;0;0;0;0;.00nan;0;0
15549;24593;676;63;23;2;21;.913;3543000;0
15549;43158;676;0;0;0;0;.00nan;0;0
15549;46139;473;82;24;1;23;.958;3600000;0
15549;78422;473;0;0;0;0;.00nan;0;0
15550;11500;476;0;0;0;0;.00nan;0;0
15550;168926;5004;60;49;7;42;.857;3328000;0
15550;173840;5004;52;2;0;2;1.000;272000;0
15550;176765;476;65;13;1;12;.923;3600000;0
15551;71297;472;64;34;3;31;.912;3600000;0
15551;81096;490;71;23;2;21;.913;3600000;0
15551;85127;472;0;0;0;0;.00nan;0;0
15551;87894;490;0;0;0;0;.00nan;0;0
15552;190235;481;0;0;0;0;.00nan;0;0
15552;56296;481;97;42;0;42;1.000;4020000;0
15552;66552;482;0;0;0;0;.00nan;0;0
15552;67222;482;100;37;0;37;1.000;4020000;0
15553;3435;675;0;0;0;0;.00nan;0;0
15553;46139;473;100;32;0;32;1.000;3600000;0
15553;78422;473;0;0;0;0;.00nan;0;0
15553;142583;675;34;25;5;20;.800;3600000;0
15554;24593;676;42;29;5;24;.828;3589000;0
15554;43158;676;0;0;0;0;.00nan;0;0
15554;61425;474;32;19;4;15;.789;914000;0
15554;66491;474;74;15;0;15;1.000;2686000;0
15555;163528;682;82;26;1;25;.962;3547000;0
15555;-1;480;0;0;0;0;.00nan;0;0
15555;63107;480;100;45;0;45;1.000;3600000;0
15555;66551;682;0;0;0;0;.00nan;0;0
15556;168926;5004;95;45;2;43;.956;4020000;0
15556;173840;5004;0;0;0;0;.00nan;0;0
15556;71297;472;57;17;2;15;.882;4020000;0
15556;85127;472;0;0;0;0;.00nan;0;0
15557;-1;480;0;0;0;0;.00nan;0;0
15557;63107;480;68;17;1;16;.941;3600000;0
15557;81096;490;63;28;3;25;.893;3600000;0
15557;87894;490;0;0;0;0;.00nan;0;0
15558;190235;481;0;0;0;0;.00nan;0;0
15558;56296;481;61;11;1;10;.909;3600000;0
15558;61425;474;78;32;2;30;.938;3600000;0
15558;66491;474;0;0;0;0;.00nan;0;0
15559;3435;675;61;22;2;20;.909;3564000;0
15559;20958;4535;0;0;0;0;.00nan;0;0
15559;70573;4535;81;28;1;27;.964;3600000;0
15559;142583;675;0;0;0;0;.00nan;0;0
15560;11500;476;0;0;0;0;.00nan;0;0
15560;24593;676;56;34;3;31;.912;4020000;0
15560;176765;476;64;22;3;19;.864;4020000;0
15560;43158;676;0;0;0;0;.00nan;0;0
15561;163528;682;20;22;6;16;.727;3600000;0
15561;46139;473;79;32;2;30;.938;3600000;0
15561;66551;682;0;0;0;0;.00nan;0;0
15561;78422;473;0;0;0;0;.00nan;0;0
15562;168926;5004;67;34;3;31;.912;3600000;0
15562;173840;5004;0;0;0;0;.00nan;0;0
15562;190235;481;87;16;0;16;1.000;3600000;0
15562;56296;481;0;0;0;0;.00nan;0;0
15563;66552;482;0;0;0;0;.00nan;0;0
15563;67222;482;28;30;6;24;.800;3600000;0
15563;81096;490;66;19;1;18;.947;3600000;0
15563;87894;490;0;0;0;0;.00nan;0;0
15564;-1;480;48;13;2;11;.846;3546000;0
15564;61425;474;99;42;1;41;.976;3600000;0
15564;63107;480;0;0;0;0;.00nan;0;0
15564;66491;474;0;0;0;0;.00nan;0;0
15565;24593;676;76;36;3;33;.917;3590000;0
15565;43158;676;0;0;0;0;.00nan;0;0
15565;71297;472;69;25;2;23;.920;3600000;0
15565;85127;472;0;0;0;0;.00nan;0;0
15566;3435;675;46;34;5;29;.853;3600000;0
15566;163528;682;100;30;0;30;1.000;3600000;0
15566;66551;682;0;0;0;0;.00nan;0;0
15566;142583;675;0;0;0;0;.00nan;0;0
15567;11500;476;0;0;0;0;.00nan;0;0
15567;20958;4535;0;0;0;0;.00nan;0;0
15567;176765;476;48;22;4;18;.818;3600000;0
15567;70573;4535;95;39;1;38;.974;3600000;0
15569;190235;481;74;28;2;26;.929;3600000;0
15569;56296;481;0;0;0;0;.00nan;0;0
15569;67222;482;58;31;4;27;.871;3530000;0
15569;87894;482;0;0;0;0;.00nan;0;0
15571;168926;5004;66;29;3;26;.897;3913000;0
15571;190243;5004;0;0;0;0;.00nan;0;0
15571;61425;474;0;0;0;0;.00nan;0;0
15571;66491;474;75;20;2;18;.900;3913000;0
15573;3435;675;65;24;2;22;.917;3600000;0
15573;67276;490;55;3;0;3;1.000;1287000;0
15573;81096;490;35;33;6;27;.818;2313000;0
15573;142583;675;0;0;0;0;.00nan;0;0
15575;163528;682;71;24;1;23;.958;3600000;0
15575;43158;676;64;30;2;28;.933;3591000;0
15575;-1;676;0;0;0;0;.00nan;0;0
15575;66551;682;0;0;0;0;.00nan;0;0
15577;20958;4535;0;0;0;0;.00nan;0;0
15577;46139;473;67;32;3;29;.906;3600000;0
15577;70573;4535;65;40;4;36;.900;3598000;0
15577;85127;473;0;0;0;0;.00nan;0;0
15579;-1;480;0;0;0;0;.00nan;0;0
15579;63107;480;80;33;2;31;.939;3600000;0
15579;66552;472;0;0;0;0;.00nan;0;0
15579;71297;472;59;33;4;29;.879;3541000;0
15581;67222;482;59;29;4;25;.862;3799000;0
15581;67276;490;0;0;0;0;.00nan;0;0
15581;81096;490;78;40;3;37;.925;3799000;0
15581;87894;482;0;0;0;0;.00nan;0;0
15587;3435;675;72;29;2;27;.931;3600000;0
15587;66552;472;0;0;0;0;.00nan;0;0
15587;71297;472;30;12;3;9;.750;3556000;0
15587;142583;675;0;0;0;0;.00nan;0;0
15589;190235;481;0;0;0;0;.00nan;0;0
15589;-1;480;62;42;5;37;.881;4020000;0
15589;56296;481;58;39;5;34;.872;4020000;0
15589;63107;480;0;0;0;0;.00nan;0;0
15591;168926;5004;61;35;4;31;.886;3574000;0
15591;190243;5004;0;0;0;0;.00nan;0;0
15591;61425;474;0;0;0;0;.00nan;0;0
15591;66491;474;80;35;3;32;.914;3600000;0
15597;3435;675;0;0;0;0;.00nan;0;0
15597;-1;480;0;0;0;0;.00nan;0;0
15597;63107;480;80;40;3;37;.925;3600000;0
15597;142583;675;49;36;5;31;.861;3547000;0
15601;168926;5004;42;47;8;39;.830;3600000;0
15601;71297;472;0;0;0;0;.00nan;0;0
15601;85127;472;55;11;1;10;.909;3600000;0
15601;153779;5004;0;0;0;0;.00nan;0;0
15603;175593;474;100;44;1;43;.977;3600000;0
15603;190235;481;63;24;3;21;.875;3598000;0
15603;56296;481;0;0;0;0;.00nan;0;0
15603;66491;474;0;0;0;0;.00nan;0;0
15605;175593;474;88;48;3;45;.938;3600000;0
15605;-1;480;81;14;0;14;1.000;3600000;0
15605;63107;480;0;0;0;0;.00nan;0;0
15605;66491;474;0;0;0;0;.00nan;0;0
15607;67276;490;73;36;3;33;.917;3600000;0
15607;71297;472;30;22;5;17;.773;3578000;0
15607;85127;472;0;0;0;0;.00nan;0;0
15607;87894;490;0;0;0;0;.00nan;0;0
15615;46139;473;77;39;3;36;.923;3590000;0
15615;66552;482;0;0;0;0;.00nan;0;0
15615;67222;482;100;38;1;37;.974;3600000;0
15615;78422;473;0;0;0;0;.00nan;0;0
15617;66552;482;78;24;1;23;.958;3600000;0
15617;67222;482;0;0;0;0;.00nan;0;0
15617;67276;490;0;0;0;0;.00nan;0;0
15617;87894;490;84;36;2;34;.944;3550000;0
15619;46139;473;0;0;0;0;.00nan;0;0
15619;71297;472;0;0;0;0;.00nan;0;0
15619;78422;473;76;44;5;39;.886;3582000;0
15619;85127;472;41;23;4;19;.826;3600000;0
15621;3435;675;42;15;3;12;.800;3534000;0
15621;175593;474;0;0;0;0;.00nan;0;0
15621;66491;474;92;43;2;41;.953;3600000;0
15621;142583;675;0;0;0;0;.00nan;0;0
15625;193870;4535;0;0;0;0;.00nan;0;0
15625;190235;481;0;0;0;0;.00nan;0;0
15625;56296;481;82;28;1;27;.964;3600000;0
15625;70573;4535;55;27;3;24;.889;3576000;0
15629;20958;4535;0;0;0;0;.00nan;0;0
15629;61425;474;0;0;0;0;.00nan;0;0
15629;66491;474;90;57;5;52;.912;3600000;0
15629;70573;4535;70;23;1;22;.957;3600000;0
15635;190235;481;74;31;3;28;.903;3600000;0
15635;46139;473;100;27;0;27;1.000;3600000;0
15635;56296;481;0;0;0;0;.00nan;0;0
15635;78422;473;0;0;0;0;.00nan;0;0
15637;3435;675;0;0;0;0;.00nan;0;0
15637;71297;472;39;27;5;22;.815;3582000;0
15637;85127;472;0;0;0;0;.00nan;0;0
15637;142583;675;71;40;4;36;.900;3600000;0
15641;11500;476;0;0;0;0;.00nan;0;0
15641;176765;476;43;37;6;31;.838;3600000;0
15641;81096;490;91;33;1;32;.970;3600000;0
15641;87894;490;0;0;0;0;.00nan;0;0
15643;20958;4535;43;29;5;24;.828;3630000;0
15643;-1;480;59;31;4;27;.871;3630000;0
15643;63107;480;0;0;0;0;.00nan;0;0
15643;70573;4535;0;0;0;0;.00nan;0;0
15649;168926;5004;86;30;2;28;.933;4020000;0
15649;46139;473;82;41;2;39;.951;4020000;0
15649;78422;473;0;0;0;0;.00nan;0;0
15649;153779;5004;0;0;0;0;.00nan;0;0
15651;3435;675;80;18;1;17;.944;3600000;0
15651;61425;474;93;40;2;38;.950;3571000;0
15651;66491;474;0;0;0;0;.00nan;0;0
15651;142583;675;0;0;0;0;.00nan;0;0
22551;3435;675;76;36;3;33;.917;3600000;0
22551;11500;476;0;0;0;0;.00nan;0;0
22551;176765;476;69;19;1;18;.947;3600000;0
22551;142583;675;0;0;0;0;.00nan;0;0
22552;71297;472;62;27;2;25;.926;4146000;0
22552;81096;490;69;30;3;27;.900;4146000;0
22552;85127;472;0;0;0;0;.00nan;0;0
22552;87894;490;0;0;0;0;.00nan;0;0
22553;3435;675;99;40;2;38;.950;3600000;0
22553;11500;476;0;0;0;0;.00nan;0;0
22553;176765;476;61;36;3;33;.917;3549000;0
22553;142583;675;0;0;0;0;.00nan;0;0
22554;71297;472;58;17;2;15;.882;3668000;0
22554;81096;490;88;48;3;45;.938;3668000;0
22554;85127;472;0;0;0;0;.00nan;0;0
22554;87894;490;0;0;0;0;.00nan;0;0
22603;3435;675;100;35;1;34;.971;3600000;0
22603;11500;476;0;0;0;0;.00nan;0;0
22603;176765;476;83;35;2;33;.943;3579000;0
22603;142583;675;0;0;0;0;.00nan;0;0
22618;3435;675;72;50;6;44;.880;2989000;0
22618;163528;682;61;13;2;11;.846;3600000;0
22618;66551;682;0;0;0;0;.00nan;0;0
22618;142583;675;64;7;0;7;1.000;611000;0
22619;190235;481;64;26;3;23;.885;3600000;0
22619;56296;481;0;0;0;0;.00nan;0;0
22619;71297;472;100;29;0;29;1.000;3600000;0
22619;85127;472;0;0;0;0;.00nan;0;0
22620;20958;4535;0;0;0;0;.00nan;0;0
22620;-1;480;0;0;0;0;.00nan;0;0
22620;63107;480;100;19;0;19;1.000;3600000;0
22620;70573;4535;74;34;3;31;.912;3600000;0
22621;46139;473;94;40;3;37;.925;3600000;0
22621;66552;482;0;0;0;0;.00nan;0;0
22621;67222;482;45;32;5;27;.844;3546000;0
22621;78422;473;0;0;0;0;.00nan;0;0
15652;164521;500;0;0;0;0;.00nan;0;0
15652;170547;500;67;26;2;24;.923;3600000;0
15652;180188;4636;0;0;0;0;.00nan;0;0
15652;185413;4636;91;49;1;48;.980;3600000;0
15653;185442;2591;100;31;0;31;1.000;3600000;0
15653;-1;502;74;22;1;21;.955;3543000;0
15653;197409;502;0;0;0;0;.00nan;0;0
15653;-1;2591;0;0;0;0;.00nan;0;0
15654;187813;495;0;0;0;0;.00nan;0;0
15654;181910;497;0;0;0;0;.00nan;0;0
15654;148508;495;100;21;0;21;1.000;3600000;0
15654;158630;497;67;32;3;29;.906;3600000;0
15655;3075;505;0;0;0;0;.00nan;0;0
15655;-1;504;71;36;3;33;.917;3575000;0
15655;-1;504;0;0;0;0;.00nan;0;0
15655;94508;505;70;18;1;17;.944;3600000;0
15656;170536;503;0;0;0;0;.00nan;0;0
15656;67446;499;0;0;0;0;.00nan;0;0
15656;94134;503;82;34;2;32;.941;3600000;0
15656;148652;499;100;29;0;29;1.000;3600000;0
15657;504;496;65;22;2;20;.909;3600000;0
15657;203533;496;0;0;0;0;.00nan;0;0
15657;49674;498;0;0;0;0;.00nan;0;0
15657;148956;498;76;46;4;42;.913;3527000;0
15658;187813;495;0;0;0;0;.00nan;0;0
15658;-1;504;77;29;2;27;.931;3527000;0
15658;-1;504;0;0;0;0;.00nan;0;0
15658;148508;495;82;12;0;12;1.000;3600000;0
15659;3075;505;86;31;1;30;.968;3698000;0
15659;67446;499;0;0;0;0;.00nan;0;0
15659;94508;505;0;0;0;0;.00nan;0;0
15659;148652;499;76;26;2;24;.923;3698000;0
15660;504;496;86;33;2;31;.939;3532000;0
15660;203533;496;0;0;0;0;.00nan;0;0
15660;170536;503;0;0;0;0;.00nan;0;0
15660;94134;503;100;36;0;36;1.000;3600000;0
15661;185442;2591;56;16;2;14;.875;3600000;0
15661;-1;2591;0;0;0;0;.00nan;0;0
15661;49674;498;71;37;3;34;.919;3600000;0
15661;148956;498;0;0;0;0;.00nan;0;0
15662;164521;500;0;0;0;0;.00nan;0;0
15662;170547;500;91;19;0;19;1.000;3600000;0
15662;181910;497;0;0;0;0;.00nan;0;0
15662;158630;497;82;39;3;36;.923;3600000;0
15663;180188;4636;0;0;0;0;.00nan;0;0
15663;185413;4636;85;34;2;32;.941;3822000;0
15663;-1;502;0;0;0;0;.00nan;0;0
15663;197409;502;79;21;1;20;.952;3822000;0
15664;3199;495;0;0;0;0;.00nan;0;0
15664;-1;504;54;33;4;29;.879;3650000;0
15664;-1;504;0;0;0;0;.00nan;0;0
15664;148508;495;61;37;5;32;.865;3650000;0
15665;3075;505;69;20;1;19;.950;3900000;0
15665;67446;499;79;22;1;21;.955;3900000;0
15665;94508;505;0;0;0;0;.00nan;0;0
15665;148652;499;0;0;0;0;.00nan;0;0
15666;504;496;58;21;3;18;.857;3600000;0
15666;203533;496;0;0;0;0;.00nan;0;0
15666;170536;503;0;0;0;0;.00nan;0;0
15666;94134;503;86;46;4;42;.913;3593000;0
15667;185442;2591;0;0;0;0;.00nan;0;0
15667;-1;2591;100;37;0;37;1.000;3600000;0
15667;49674;498;0;0;0;0;.00nan;0;0
15667;148956;498;63;32;3;29;.906;3600000;0
15668;164521;500;0;0;0;0;.00nan;0;0
15668;170547;500;78;20;1;19;.950;3600000;0
15668;181910;497;0;0;0;0;.00nan;0;0
15668;158630;497;56;30;3;27;.900;3568000;0
15669;180188;4636;83;29;2;27;.931;3581000;0
15669;185413;4636;0;0;0;0;.00nan;0;0
15669;-1;502;0;0;0;0;.00nan;0;0
15669;197409;502;85;27;1;26;.963;3600000;0
15670;181910;497;0;0;0;0;.00nan;0;0
15670;-1;502;0;0;0;0;.00nan;0;0
15670;197409;502;73;23;2;21;.913;3600000;0
15670;158630;497;38;40;6;34;.850;3600000;0
15671;165611;4636;47;40;6;34;.850;3159000;0
15671;185413;4636;40;2;1;1;.500;441000;0
15671;49674;498;0;0;0;0;.00nan;0;0
15671;148956;498;84;34;2;32;.941;3600000;0
15672;187813;495;0;0;0;0;.00nan;0;0
15672;164521;500;0;0;0;0;.00nan;0;0
15672;170547;500;78;28;2;26;.929;3560000;0
15672;148508;495;84;30;1;29;.967;3600000;0
15673;504;496;85;29;1;28;.966;3900000;0
15673;3075;505;100;35;1;34;.971;3900000;0
15673;203533;496;0;0;0;0;.00nan;0;0
15673;94508;505;0;0;0;0;.00nan;0;0
15674;-1;504;89;39;2;37;.949;3900000;0
15674;-1;504;0;0;0;0;.00nan;0;0
15674;67446;499;0;0;0;0;.00nan;0;0
15674;148652;499;66;22;2;20;.909;3900000;0
15675;170536;503;0;0;0;0;.00nan;0;0
15675;185442;2591;38;35;7;28;.800;3600000;0
15675;-1;2591;0;0;0;0;.00nan;0;0
15675;94134;503;79;27;1;26;.963;3600000;0
15676;181910;497;0;0;0;0;.00nan;0;0
15676;-1;502;32;25;5;20;.800;3544000;0
15676;197409;502;0;0;0;0;.00nan;0;0
15676;158630;497;69;37;4;33;.892;3600000;0
15677;165611;4636;65;25;3;22;.880;3571000;0
15677;185413;4636;0;0;0;0;.00nan;0;0
15677;49674;498;0;0;0;0;.00nan;0;0
15677;148956;498;64;21;2;19;.905;3600000;0
15678;187813;495;0;0;0;0;.00nan;0;0
15678;164521;500;0;0;0;0;.00nan;0;0
15678;170547;500;56;25;2;23;.920;3900000;0
15678;148508;495;86;34;2;32;.941;3900000;0
15679;504;496;77;31;2;29;.935;3900000;0
15679;3075;505;0;0;0;0;.00nan;0;0
15679;203533;496;0;0;0;0;.00nan;0;0
15679;94508;505;81;32;2;30;.938;3900000;0
15680;-1;504;0;0;0;0;.00nan;0;0
15680;-1;504;79;36;2;34;.944;3900000;0
15680;67446;499;0;0;0;0;.00nan;0;0
15680;148652;499;45;18;2;16;.889;3900000;0
15681;170536;503;0;0;0;0;.00nan;0;0
15681;185442;2591;80;25;1;24;.960;3900000;0
15681;-1;2591;0;0;0;0;.00nan;0;0
15681;94134;503;95;45;1;44;.978;3900000;0
15682;3075;505;100;26;0;26;1.000;3600000;0
15682;185442;2591;74;28;2;26;.929;3532000;0
15682;-1;2591;0;0;0;0;.00nan;0;0
15682;94508;505;0;0;0;0;.00nan;0;0
15683;170536;503;0;0;0;0;.00nan;0;0
15683;180188;4636;0;0;0;0;.00nan;0;0
15683;185413;4636;58;21;2;19;.905;3600000;0
15683;94134;503;57;30;4;26;.867;3540000;0
15684;504;496;0;0;0;0;.00nan;0;0
15684;203533;496;41;28;5;23;.821;3600000;0
15684;-1;504;100;26;0;26;1.000;3600000;0
15684;-1;504;0;0;0;0;.00nan;0;0
15685;164521;500;0;0;0;0;.00nan;0;0
15685;170547;500;63;19;2;17;.895;3600000;0
15685;-1;502;0;0;0;0;.00nan;0;0
15685;197409;502;97;45;3;42;.933;3567000;0
15686;187813;495;0;0;0;0;.00nan;0;0
15686;67446;499;68;24;2;22;.917;3600000;0
15686;148508;495;34;34;6;28;.824;3600000;0
15686;148652;499;0;0;0;0;.00nan;0;0
15687;181910;497;54;32;4;28;.875;3600000;0
15687;49674;498;0;0;0;0;.00nan;0;0
15687;148956;498;82;26;1;25;.962;3600000;0
15687;158630;497;0;0;0;0;.00nan;0;0
15688;3075;505;68;24;2;22;.917;3563000;0
15688;185442;2591;0;0;0;0;.00nan;0;0
15688;-1;2591;89;32;1;31;.969;3600000;0
15688;94508;505;0;0;0;0;.00nan;0;0
15689;170536;503;0;0;0;0;.00nan;0;0
15689;180188;4636;90;16;0;16;1.000;3600000;0
15689;185413;4636;0;0;0;0;.00nan;0;0
15689;94134;503;89;50;3;47;.940;3600000;0
15690;504;496;74;39;3;36;.923;3600000;0
15690;203533;496;0;0;0;0;.00nan;0;0
15690;-1;504;54;35;4;31;.886;3552000;0
15690;-1;504;0;0;0;0;.00nan;0;0
15691;164521;500;0;0;0;0;.00nan;0;0
15691;170547;500;73;21;1;20;.952;3600000;0
15691;-1;502;70;30;3;27;.900;3571000;0
15691;197409;502;0;0;0;0;.00nan;0;0
15692;187813;495;0;0;0;0;.00nan;0;0
15692;67446;499;0;0;0;0;.00nan;0;0
15692;148508;495;70;43;5;38;.884;3600000;0
15692;148652;499;53;14;2;12;.857;3600000;0
15693;181910;497;0;0;0;0;.00nan;0;0
15693;49674;498;100;39;0;39;1.000;3600000;0
15693;148956;498;0;0;0;0;.00nan;0;0
15693;158630;497;74;19;1;18;.947;3600000;0
15694;-1;504;88;44;3;41;.932;3819000;0
15694;-1;504;0;0;0;0;.00nan;0;0
15694;185442;2591;73;26;2;24;.923;3819000;0
15694;-1;2591;0;0;0;0;.00nan;0;0
15695;170536;503;0;0;0;0;.00nan;0;0
15695;78596;497;53;26;4;22;.846;3600000;0
15695;94134;503;49;33;5;28;.848;3551000;0
15695;158630;497;0;0;0;0;.00nan;0;0
15696;164521;500;0;0;0;0;.00nan;0;0
15696;170547;500;77;26;2;24;.923;3600000;0
15696;49674;498;0;0;0;0;.00nan;0;0
15696;148956;498;80;40;3;37;.925;3594000;0
15697;3075;505;0;0;0;0;.00nan;0;0
15697;165611;4636;27;42;8;34;.810;2773000;0
15697;185413;4636;49;1;0;1;1.000;827000;0
15697;94508;505;95;20;0;20;1.000;3600000;0
15698;504;496;48;35;5;30;.857;3600000;0
15698;203533;496;0;0;0;0;.00nan;0;0
15698;86343;499;68;20;1;19;.950;3600000;0
15698;148652;499;0;0;0;0;.00nan;0;0
15699;-1;495;0;0;0;0;.00nan;0;0
15699;-1;502;0;0;0;0;.00nan;0;0
15699;197409;502;76;39;2;37;.949;3599000;0
15699;148508;495;79;23;1;22;.957;3600000;0
15700;-1;504;52;53;7;46;.868;3600000;0
15700;-1;504;0;0;0;0;.00nan;0;0
15700;185442;2591;47;18;3;15;.833;3600000;0
15700;-1;2591;0;0;0;0;.00nan;0;0
15701;170536;503;0;0;0;0;.00nan;0;0
15701;78596;497;79;25;1;24;.960;3559000;0
15701;94134;503;100;26;0;26;1.000;3600000;0
15701;158630;497;0;0;0;0;.00nan;0;0
15702;164521;500;0;0;0;0;.00nan;0;0
15702;170547;500;77;11;0;11;1.000;3600000;0
15702;49674;498;0;0;0;0;.00nan;0;0
15702;148956;498;91;41;2;39;.951;3568000;0
15703;3075;505;0;0;0;0;.00nan;0;0
15703;165611;4636;98;44;2;42;.955;3900000;0
15703;185413;4636;0;0;0;0;.00nan;0;0
15703;94508;505;70;25;2;23;.920;3900000;0
15704;504;496;73;31;2;29;.935;3600000;0
15704;203533;496;0;0;0;0;.00nan;0;0
15704;86343;499;58;31;4;27;.871;3586000;0
15704;148652;499;0;0;0;0;.00nan;0;0
15705;-1;495;0;0;0;0;.00nan;0;0
15705;-1;502;0;0;0;0;.00nan;0;0
15705;197409;502;68;24;2;22;.917;3589000;0
15705;148508;495;62;16;1;15;.938;3600000;0
15706;-1;502;65;19;1;18;.947;3600000;0
15706;197409;502;0;0;0;0;.00nan;0;0
15706;49674;498;0;0;0;0;.00nan;0;0
15706;148956;498;64;31;4;27;.871;3600000;0
15707;185442;2591;0;0;0;0;.00nan;0;0
15707;-1;2591;89;34;1;33;.971;3558000;0
15707;86343;499;100;32;0;32;1.000;3600000;0
15707;148652;499;0;0;0;0;.00nan;0;0
15708;165611;4636;81;30;2;28;.933;3900000;0
15708;-1;504;76;26;2;24;.923;3900000;0
15708;-1;504;0;0;0;0;.00nan;0;0
15708;185413;4636;0;0;0;0;.00nan;0;0
15709;164521;500;0;0;0;0;.00nan;0;0
15709;170536;503;0;0;0;0;.00nan;0;0
15709;170547;500;61;17;2;15;.882;3859000;0
15709;94134;503;82;38;3;35;.921;3859000;0
15710;3075;505;58;32;4;28;.875;3544000;0
15710;78596;497;62;28;3;25;.893;3600000;0
15710;94508;505;0;0;0;0;.00nan;0;0
15710;158630;497;0;0;0;0;.00nan;0;0
15711;504;496;69;21;1;20;.952;2747000;0
15711;203533;496;27;14;4;10;.714;853000;0
15711;-1;495;0;0;0;0;.00nan;0;0
15711;148508;495;75;28;1;27;.964;3600000;0
15712;-1;502;0;0;0;0;.00nan;0;0
15712;197409;502;60;31;3;28;.903;3540000;0
15712;49674;498;0;0;0;0;.00nan;0;0
15712;148956;498;98;36;1;35;.972;3600000;0
15713;185442;2591;92;48;4;44;.917;3900000;0
15713;-1;2591;0;0;0;0;.00nan;0;0
15713;86343;499;46;26;4;22;.846;3900000;0
15713;148652;499;0;0;0;0;.00nan;0;0
15714;165611;4636;31;31;6;25;.806;2785000;0
15714;-1;504;73;19;1;18;.947;3600000;0
15714;-1;504;0;0;0;0;.00nan;0;0
15714;185413;4636;53;2;0;2;1.000;815000;0
15715;164521;500;0;0;0;0;.00nan;0;0
15715;170536;503;0;0;0;0;.00nan;0;0
15715;170547;500;61;11;1;10;.909;3600000;0
15715;94134;503;74;45;5;40;.889;3600000;0
15716;3075;505;0;0;0;0;.00nan;0;0
15716;78596;497;75;31;2;29;.935;3600000;0
15716;94508;505;42;18;3;15;.833;3600000;0
15716;158630;497;0;0;0;0;.00nan;0;0
15717;504;496;95;35;1;34;.971;3600000;0
15717;203533;496;0;0;0;0;.00nan;0;0
15717;-1;495;0;0;0;0;.00nan;0;0
15717;148508;495;63;42;5;37;.881;3600000;0
15718;3075;505;100;43;2;41;.953;3900000;0
15718;164521;500;0;0;0;0;.00nan;0;0
15718;170547;500;63;21;2;19;.905;3900000;0
15718;94508;505;0;0;0;0;.00nan;0;0
15719;170536;503;0;0;0;0;.00nan;0;0
15719;-1;502;83;29;1;28;.966;3600000;0
15719;197409;502;0;0;0;0;.00nan;0;0
15719;94134;503;67;22;2;20;.909;3584000;0
15720;504;496;100;21;0;21;1.000;3600000;0
15720;203533;496;0;0;0;0;.00nan;0;0
15720;185442;2591;0;0;0;0;.00nan;0;0
15720;-1;2591;92;40;2;38;.950;3588000;0
15721;-1;504;0;0;0;0;.00nan;0;0
15721;-1;504;59;22;2;20;.909;3629000;0
15721;78596;497;71;30;3;27;.900;3629000;0
15721;158630;497;0;0;0;0;.00nan;0;0
15722;165611;4636;89;48;3;45;.938;3900000;0
15722;185413;4636;0;0;0;0;.00nan;0;0
15722;86343;499;49;20;3;17;.850;3900000;0
15722;148652;499;0;0;0;0;.00nan;0;0
15723;-1;495;0;0;0;0;.00nan;0;0
15723;49674;498;0;0;0;0;.00nan;0;0
15723;148508;495;87;30;1;29;.967;3600000;0
15723;148956;498;48;21;3;18;.857;3585000;0
15724;3075;505;0;0;0;0;.00nan;0;0
15724;164521;500;0;0;0;0;.00nan;0;0
15724;170547;500;92;35;1;34;.971;3600000;0
15724;94508;505;53;16;2;14;.875;3600000;0
15725;170536;503;0;0;0;0;.00nan;0;0
15725;-1;502;48;16;2;14;.875;3600000;0
15725;197409;502;0;0;0;0;.00nan;0;0
15725;94134;503;84;41;3;38;.927;3541000;0
15726;504;496;100;27;0;27;1.000;3600000;0
15726;203533;496;0;0;0;0;.00nan;0;0
15726;185442;2591;71;19;1;18;.947;3543000;0
15726;-1;2591;0;0;0;0;.00nan;0;0
15727;-1;504;38;24;4;20;.833;3556000;0
15727;-1;504;0;0;0;0;.00nan;0;0
15727;78596;497;88;37;2;35;.946;3600000;0
15727;158630;497;0;0;0;0;.00nan;0;0
15728;165611;4636;62;32;3;29;.906;3543000;0
15728;185413;4636;0;0;0;0;.00nan;0;0
15728;86343;499;77;21;1;20;.952;3600000;0
15728;148652;499;0;0;0;0;.00nan;0;0
15729;-1;495;67;26;3;23;.885;3600000;0
15729;49674;498;66;27;2;25;.926;3223000;0
15729;148508;495;0;0;0;0;.00nan;0;0
15729;148956;498;33;8;3;5;.625;337000;0
15730;3075;505;73;20;1;19;.950;3600000;0
15730;-1;502;0;0;0;0;.00nan;0;0
15730;197409;502;88;38;3;35;.921;3545000;0
15730;94508;505;0;0;0;0;.00nan;0;0
15731;78596;497;91;32;1;31;.969;3900000;0
15731;86343;499;100;38;1;37;.974;3900000;0
15731;148652;499;0;0;0;0;.00nan;0;0
15731;158630;497;0;0;0;0;.00nan;0;0
15732;504;496;98;24;0;24;1.000;3600000;0
15732;203533;496;0;0;0;0;.00nan;0;0
15732;165611;4636;0;0;0;0;.00nan;0;0
15732;185413;4636;67;29;2;27;.931;3541000;0
15733;164521;500;0;0;0;0;.00nan;0;0
15733;170547;500;66;24;2;22;.917;3600000;0
15733;-1;504;46;26;4;22;.846;3539000;0
15733;-1;504;0;0;0;0;.00nan;0;0
15734;-1;495;0;0;0;0;.00nan;0;0
15734;185442;2591;72;21;2;19;.905;3900000;0
15734;-1;2591;0;0;0;0;.00nan;0;0
15734;148508;495;72;31;2;29;.935;3900000;0
15735;170536;503;0;0;0;0;.00nan;0;0
15735;49674;498;56;35;4;31;.886;3544000;0
15735;94134;503;70;32;3;29;.906;3600000;0
15735;148956;498;0;0;0;0;.00nan;0;0
15736;3075;505;0;0;0;0;.00nan;0;0
15736;-1;502;80;35;2;33;.943;3829000;0
15736;197409;502;0;0;0;0;.00nan;0;0
15736;94508;505;69;21;1;20;.952;3829000;0
15737;78596;497;61;31;4;27;.871;3600000;0
15737;86343;499;92;21;0;21;1.000;3600000;0
15737;148652;499;0;0;0;0;.00nan;0;0
15737;158630;497;0;0;0;0;.00nan;0;0
15738;504;496;50;23;3;20;.870;3691000;0
15738;203533;496;0;0;0;0;.00nan;0;0
15738;165611;4636;71;44;4;40;.909;3706000;0
15738;185413;4636;0;0;0;0;.00nan;0;0
15739;164521;500;0;0;0;0;.00nan;0;0
15739;170547;500;48;25;4;21;.840;3539000;0
15739;-1;504;73;32;2;30;.938;3600000;0
15739;-1;504;0;0;0;0;.00nan;0;0
15740;-1;495;66;10;0;10;1.000;1348000;0
15740;185442;2591;0;0;0;0;.00nan;0;0
15740;-1;2591;70;42;5;37;.881;3563000;0
15740;148508;495;45;20;4;16;.800;2252000;0
15741;170536;503;0;0;0;0;.00nan;0;0
15741;49674;498;64;26;3;23;.885;3621000;0
15741;94134;503;69;38;4;34;.895;3621000;0
15741;148956;498;0;0;0;0;.00nan;0;0
15742;3075;505;47;16;3;13;.813;3554000;0
15742;49674;498;0;0;0;0;.00nan;0;0
15742;94508;505;0;0;0;0;.00nan;0;0
15742;148956;498;80;35;2;33;.943;3600000;0
15743;-1;504;0;0;0;0;.00nan;0;0
15743;-1;504;84;36;2;34;.944;3900000;0
15743;-1;502;0;0;0;0;.00nan;0;0
15743;197409;502;70;26;2;24;.923;3900000;0
15744;164521;500;0;0;0;0;.00nan;0;0
15744;170547;500;51;41;6;35;.854;3600000;0
15744;86343;499;91;19;0;19;1.000;3600000;0
15744;148652;499;0;0;0;0;.00nan;0;0
15745;165611;4636;71;33;2;31;.939;3600000;0
15745;185413;4636;0;0;0;0;.00nan;0;0
15745;185442;2591;97;40;3;37;.925;3582000;0
15745;-1;2591;0;0;0;0;.00nan;0;0
15746;504;496;46;26;4;22;.846;3600000;0
15746;203533;496;0;0;0;0;.00nan;0;0
15746;78596;497;99;39;1;38;.974;3600000;0
15746;158630;497;0;0;0;0;.00nan;0;0
15747;-1;495;97;42;1;41;.976;3545000;0
15747;170536;503;0;0;0;0;.00nan;0;0
15747;94134;503;100;24;0;24;1.000;3600000;0
15747;148508;495;0;0;0;0;.00nan;0;0
15748;3075;505;0;0;0;0;.00nan;0;0
15748;49674;498;0;0;0;0;.00nan;0;0
15748;94508;505;92;16;0;16;1.000;3600000;0
15748;148956;498;82;48;4;44;.917;3600000;0
15749;-1;504;91;40;2;38;.950;3600000;0
15749;-1;504;0;0;0;0;.00nan;0;0
15749;-1;502;78;24;1;23;.958;3600000;0
15749;197409;502;0;0;0;0;.00nan;0;0
15750;164521;500;0;0;0;0;.00nan;0;0
15750;170547;500;100;36;0;36;1.000;3600000;0
15750;86343;499;48;23;3;20;.870;3600000;0
15750;148652;499;0;0;0;0;.00nan;0;0
15751;165611;4636;92;43;3;40;.930;3900000;0
15751;185413;4636;0;0;0;0;.00nan;0;0
15751;185442;2591;0;0;0;0;.00nan;0;0
15751;-1;2591;64;27;3;24;.889;3900000;0
15752;504;496;64;24;3;21;.875;3590000;0
15752;203533;496;0;0;0;0;.00nan;0;0
15752;78596;497;91;27;1;26;.963;3600000;0
15752;158630;497;0;0;0;0;.00nan;0;0
15753;-1;495;100;31;1;30;.968;3900000;0
15753;170536;503;0;0;0;0;.00nan;0;0
15753;94134;503;96;46;1;45;.978;3900000;0
15753;148508;495;0;0;0;0;.00nan;0;0
15754;504;496;46;24;4;20;.833;3540000;0
15754;203533;496;0;0;0;0;.00nan;0;0
15754;164521;500;0;0;0;0;.00nan;0;0
15754;170547;500;82;32;2;30;.938;3600000;0
15755;185442;2591;89;37;2;35;.946;3523000;0
15755;-1;2591;0;0;0;0;.00nan;0;0
15755;78596;497;100;21;0;21;1.000;3600000;0
15755;158630;497;0;0;0;0;.00nan;0;0
15756;165611;4636;82;14;0;14;1.000;3600000;0
15756;-1;495;78;33;2;31;.939;3558000;0
15756;185413;4636;0;0;0;0;.00nan;0;0
15756;148508;495;0;0;0;0;.00nan;0;0
15757;-1;502;0;0;0;0;.00nan;0;0
15757;197409;502;58;29;3;26;.897;3900000;0
15757;86343;499;65;29;3;26;.897;3900000;0
15757;148652;499;0;0;0;0;.00nan;0;0
15758;3075;505;70;19;2;17;.895;3600000;0
15758;170536;503;0;0;0;0;.00nan;0;0
15758;94134;503;84;40;4;36;.900;3592000;0
15758;94508;505;0;0;0;0;.00nan;0;0
15759;-1;504;82;31;1;30;.968;3600000;0
15759;-1;504;0;0;0;0;.00nan;0;0
15759;49674;498;71;26;2;24;.923;3562000;0
15759;148956;498;0;0;0;0;.00nan;0;0
15760;504;496;86;30;1;29;.967;3900000;0
15760;203533;496;0;0;0;0;.00nan;0;0
15760;164521;500;0;0;0;0;.00nan;0;0
15760;170547;500;98;43;1;42;.977;3900000;0
15761;185442;2591;100;35;0;35;1.000;3600000;0
15761;-1;2591;0;0;0;0;.00nan;0;0
15761;78596;497;63;26;3;23;.885;3600000;0
15761;158630;497;0;0;0;0;.00nan;0;0
15762;165611;4636;71;20;1;19;.950;3600000;0
15762;-1;495;0;0;0;0;.00nan;0;0
15762;185413;4636;0;0;0;0;.00nan;0;0
15762;148508;495;63;31;4;27;.871;3600000;0
15763;-1;502;84;32;2;30;.938;3600000;0
15763;197409;502;0;0;0;0;.00nan;0;0
15763;86343;499;50;29;4;25;.862;3573000;0
15763;148652;499;0;0;0;0;.00nan;0;0
15764;3075;505;0;0;0;0;.00nan;0;0
15764;170536;503;0;0;0;0;.00nan;0;0
15764;94134;503;82;36;3;33;.917;3600000;0
15764;94508;505;81;26;1;25;.962;3600000;0
15765;-1;504;79;39;3;36;.923;3600000;0
15765;-1;504;0;0;0;0;.00nan;0;0
15765;49674;498;0;0;0;0;.00nan;0;0
15765;148956;498;57;22;2;20;.909;3600000;0
15766;170536;503;0;0;0;0;.00nan;0;0
15766;-1;504;0;0;0;0;.00nan;0;0
15766;-1;504;54;29;3;26;.897;3900000;0
15766;94134;503;88;44;3;41;.932;3900000;0
15767;49674;498;0;0;0;0;.00nan;0;0
15767;86343;499;70;19;1;18;.947;3900000;0
15767;148652;499;0;0;0;0;.00nan;0;0
15767;148956;498;93;33;1;32;.970;3900000;0
15768;3075;505;56;25;3;22;.880;3763000;0
15768;-1;495;45;21;4;17;.810;3763000;0
15768;94508;505;0;0;0;0;.00nan;0;0
15768;148508;495;0;0;0;0;.00nan;0;0
15769;164521;500;0;0;0;0;.00nan;0;0
15769;170547;500;85;30;1;29;.967;3581000;0
15769;185442;2591;89;19;0;19;1.000;3600000;0
15769;-1;2591;0;0;0;0;.00nan;0;0
15770;165611;4636;0;0;0;0;.00nan;0;0
15770;185413;4636;57;28;3;25;.893;3572000;0
15770;78596;497;63;24;2;22;.917;3600000;0
15770;158630;497;0;0;0;0;.00nan;0;0
15771;504;496;0;0;0;0;.00nan;0;0
15771;203533;496;44;33;5;28;.848;3600000;0
15771;-1;502;0;0;0;0;.00nan;0;0
15771;197409;502;92;38;2;36;.947;3600000;0
15772;170536;503;0;0;0;0;.00nan;0;0
15772;-1;504;57;22;2;20;.909;3514000;0
15772;-1;504;0;0;0;0;.00nan;0;0
15772;94134;503;100;31;0;31;1.000;3600000;0
15773;49674;498;0;0;0;0;.00nan;0;0
15773;86343;499;0;0;0;0;.00nan;0;0
15773;148652;499;63;17;1;16;.941;3600000;0
15773;148956;498;63;32;3;29;.906;3564000;0
15774;3075;505;93;23;0;23;1.000;3600000;0
15774;-1;495;0;0;0;0;.00nan;0;0
15774;94508;505;0;0;0;0;.00nan;0;0
15774;148508;495;59;29;3;26;.897;3600000;0
15775;164521;500;0;0;0;0;.00nan;0;0
15775;170547;500;100;33;0;33;1.000;3600000;0
15775;185442;2591;62;26;2;24;.923;3555000;0
15775;-1;2591;0;0;0;0;.00nan;0;0
15776;165611;4636;95;42;2;40;.952;3559000;0
15776;185413;4636;0;0;0;0;.00nan;0;0
15776;78596;497;71;21;1;20;.952;3600000;0
15776;158630;497;0;0;0;0;.00nan;0;0
15777;504;496;93;29;1;28;.966;3600000;0
15777;203533;496;0;0;0;0;.00nan;0;0
15777;-1;502;0;0;0;0;.00nan;0;0
15777;197409;502;37;28;4;24;.857;3600000;0
15778;3075;505;0;0;0;0;.00nan;0;0
15778;-1;504;81;37;2;35;.946;3600000;0
15778;-1;504;0;0;0;0;.00nan;0;0
15778;94508;505;79;31;3;28;.903;3587000;0
15779;170536;503;0;0;0;0;.00nan;0;0
15779;86343;499;55;16;2;14;.875;3600000;0
15779;94134;503;95;41;1;40;.976;3600000;0
15779;148652;499;0;0;0;0;.00nan;0;0
15780;504;496;62;16;1;15;.938;3600000;0
15780;203533;496;0;0;0;0;.00nan;0;0
15780;49674;498;0;0;0;0;.00nan;0;0
15780;148956;498;63;49;6;43;.878;3600000;0
15781;185442;2591;57;31;4;27;.871;3600000;0
15781;-1;502;82;31;3;28;.903;3600000;0
15781;197409;502;0;0;0;0;.00nan;0;0
15781;-1;2591;0;0;0;0;.00nan;0;0
15782;-1;495;77;31;2;29;.935;3600000;0
15782;78596;497;78;36;3;33;.917;3543000;0
15782;148508;495;0;0;0;0;.00nan;0;0
15782;158630;497;0;0;0;0;.00nan;0;0
15783;164521;500;0;0;0;0;.00nan;0;0
15783;165611;4636;89;27;1;26;.963;3600000;0
15783;170547;500;69;27;2;25;.926;3568000;0
15783;185413;4636;0;0;0;0;.00nan;0;0
15784;3075;505;86;32;2;30;.938;3523000;0
15784;-1;504;0;0;0;0;.00nan;0;0
15784;-1;504;100;35;0;35;1.000;3600000;0
15784;94508;505;0;0;0;0;.00nan;0;0
15785;170536;503;0;0;0;0;.00nan;0;0
15785;86343;499;68;20;2;18;.900;3600000;0
15785;94134;503;86;39;3;36;.923;3600000;0
15785;148652;499;0;0;0;0;.00nan;0;0
15786;504;496;64;28;2;26;.929;3600000;0
15786;203533;496;0;0;0;0;.00nan;0;0
15786;49674;498;0;0;0;0;.00nan;0;0
15786;148956;498;72;36;4;32;.889;3588000;0
15787;185442;2591;48;26;4;22;.846;3693000;0
15787;-1;502;0;0;0;0;.00nan;0;0
15787;197409;502;60;33;3;30;.909;3693000;0
15787;-1;2591;0;0;0;0;.00nan;0;0
15788;-1;495;0;0;0;0;.00nan;0;0
15788;78596;497;64;29;3;26;.897;3547000;0
15788;148508;495;65;26;2;24;.923;3600000;0
15788;158630;497;0;0;0;0;.00nan;0;0
15789;164521;500;0;0;0;0;.00nan;0;0
15789;165611;4636;58;34;4;30;.882;3600000;0
15789;170547;500;86;29;1;28;.966;3600000;0
15789;185413;4636;0;0;0;0;.00nan;0;0
15790;164521;500;78;33;2;31;.939;3600000;0
15790;170547;500;0;0;0;0;.00nan;0;0
15790;78596;497;57;33;4;29;.879;3587000;0
15790;158630;497;0;0;0;0;.00nan;0;0
15791;165611;4636;37;30;6;24;.800;3600000;0
15791;185413;4636;0;0;0;0;.00nan;0;0
15791;-1;502;0;0;0;0;.00nan;0;0
15791;197409;502;100;29;0;29;1.000;3600000;0
15792;185442;2591;92;20;0;20;1.000;3600000;0
15792;-1;2591;0;0;0;0;.00nan;0;0
15792;49674;498;0;0;0;0;.00nan;0;0
15792;148956;498;69;30;3;27;.900;3600000;0
15793;3075;505;64;26;2;24;.923;3668000;0
15793;86343;499;88;26;1;25;.962;3668000;0
15793;94508;505;0;0;0;0;.00nan;0;0
15793;148652;499;0;0;0;0;.00nan;0;0
15794;504;496;62;21;2;19;.905;3600000;0
15794;203533;496;0;0;0;0;.00nan;0;0
15794;170536;503;81;42;3;39;.929;3600000;0
15794;94134;503;0;0;0;0;.00nan;0;0
15795;-1;495;43;30;5;25;.833;3600000;0
15795;-1;504;0;0;0;0;.00nan;0;0
15795;-1;504;97;22;0;22;1.000;3600000;0
15795;148508;495;0;0;0;0;.00nan;0;0
15796;164521;500;0;0;0;0;.00nan;0;0
15796;170547;500;95;32;1;31;.969;3900000;0
15796;78596;497;90;35;1;34;.971;3900000;0
15796;158630;497;0;0;0;0;.00nan;0;0
15797;165611;4636;66;25;2;23;.920;3600000;0
15797;185413;4636;0;0;0;0;.00nan;0;0
15797;-1;502;0;0;0;0;.00nan;0;0
15797;197409;502;58;32;4;28;.875;3584000;0
15798;185442;2591;66;18;1;17;.944;3600000;0
15798;-1;2591;0;0;0;0;.00nan;0;0
15798;49674;498;0;0;0;0;.00nan;0;0
15798;148956;498;82;33;2;31;.939;3600000;0
15799;3075;505;0;0;0;0;.00nan;0;0
15799;86343;499;73;35;3;32;.914;3600000;0
15799;94508;505;69;27;2;25;.926;3600000;0
15799;148652;499;0;0;0;0;.00nan;0;0
15800;504;496;86;29;1;28;.966;3600000;0
15800;203533;496;0;0;0;0;.00nan;0;0
15800;170536;503;0;0;0;0;.00nan;0;0
15800;94134;503;81;28;2;26;.929;3597000;0
15801;-1;495;0;0;0;0;.00nan;0;0
15801;-1;504;0;0;0;0;.00nan;0;0
15801;-1;504;48;40;6;34;.850;3600000;0
15801;148508;495;63;26;2;24;.923;3600000;0
15802;170536;503;0;0;0;0;.00nan;0;0
15802;185442;2591;100;32;0;32;1.000;3600000;0
15802;-1;2591;0;0;0;0;.00nan;0;0
15802;94134;503;65;26;2;24;.923;3537000;0
15803;-1;504;68;29;3;26;.897;3572000;0
15803;-1;504;0;0;0;0;.00nan;0;0
15803;86343;499;74;29;2;27;.931;3600000;0
15803;148652;499;0;0;0;0;.00nan;0;0
15804;504;496;73;27;1;26;.963;3553000;0
15804;3075;505;93;20;0;20;1.000;3600000;0
15804;203533;496;0;0;0;0;.00nan;0;0
15804;94508;505;0;0;0;0;.00nan;0;0
15805;164521;500;0;0;0;0;.00nan;0;0
15805;-1;495;75;40;3;37;.925;3600000;0
15805;170547;500;94;33;1;32;.970;3600000;0
15805;148508;495;0;0;0;0;.00nan;0;0
15806;-1;502;0;0;0;0;.00nan;0;0
15806;197409;502;80;38;3;35;.921;3577000;0
15806;78596;497;0;0;0;0;.00nan;0;0
15806;158630;497;62;22;2;20;.909;3600000;0
15807;165611;4636;60;22;2;20;.909;3600000;0
15807;185413;4636;0;0;0;0;.00nan;0;0
15807;49674;498;0;0;0;0;.00nan;0;0
15807;148956;498;75;30;3;27;.900;3544000;0
15808;170536;503;0;0;0;0;.00nan;0;0
15808;185442;2591;89;19;0;19;1.000;3600000;0
15808;-1;2591;0;0;0;0;.00nan;0;0
15808;94134;503;63;44;6;38;.864;3600000;0
15809;-1;504;63;37;4;33;.892;3572000;0
15809;-1;504;0;0;0;0;.00nan;0;0
15809;86343;499;57;17;2;15;.882;3600000;0
15809;148652;499;0;0;0;0;.00nan;0;0
15810;504;496;68;19;1;18;.947;3600000;0
15810;3075;505;62;40;5;35;.875;3600000;0
15810;203533;496;0;0;0;0;.00nan;0;0
15810;94508;505;0;0;0;0;.00nan;0;0
15811;164521;500;0;0;0;0;.00nan;0;0
15811;-1;495;46;35;5;30;.857;3600000;0
15811;170547;500;100;37;1;36;.973;3600000;0
15811;148508;495;0;0;0;0;.00nan;0;0
15812;-1;502;97;24;0;24;1.000;3600000;0
15812;197409;502;0;0;0;0;.00nan;0;0
15812;78596;497;58;38;4;34;.895;3600000;0
15812;158630;497;0;0;0;0;.00nan;0;0
15813;165611;4636;68;27;2;25;.926;3572000;0
15813;185413;4636;0;0;0;0;.00nan;0;0
15813;49674;498;0;0;0;0;.00nan;0;0
15813;148956;498;100;25;0;25;1.000;3600000;0
15814;164521;500;0;0;0;0;.00nan;0;0
15814;170547;500;98;37;2;35;.946;3600000;0
15814;-1;502;54;30;4;26;.867;3566000;0
15814;197409;502;0;0;0;0;.00nan;0;0
15815;49674;498;0;0;0;0;.00nan;0;0
15815;78596;497;72;31;3;28;.903;3579000;0
15815;148956;498;71;23;2;21;.913;3600000;0
15815;158630;497;0;0;0;0;.00nan;0;0
15816;-1;495;0;0;0;0;.00nan;0;0
15816;86343;499;70;22;2;20;.909;3600000;0
15816;148508;495;64;30;3;27;.900;3600000;0
15816;148652;499;0;0;0;0;.00nan;0;0
15817;3075;505;0;0;0;0;.00nan;0;0
15817;185442;2591;18;24;6;18;.750;1712000;0
15817;-1;2591;54;18;1;17;.944;1888000;0
15817;94508;505;43;23;4;19;.826;3600000;0
15818;504;496;69;30;3;27;.900;3569000;0
15818;203533;496;0;0;0;0;.00nan;0;0
15818;-1;504;0;0;0;0;.00nan;0;0
15818;-1;504;81;29;2;27;.931;3600000;0
15819;165611;4636;62;18;2;16;.889;3600000;0
15819;170536;503;0;0;0;0;.00nan;0;0
15819;185413;4636;0;0;0;0;.00nan;0;0
15819;94134;503;84;38;4;34;.895;3587000;0
15820;164521;500;0;0;0;0;.00nan;0;0
15820;170547;500;49;19;3;16;.842;3900000;0
15820;-1;502;0;0;0;0;.00nan;0;0
15820;197409;502;66;33;3;30;.909;3900000;0
15821;49674;498;68;38;4;34;.895;3551000;0
15821;78596;497;61;24;3;21;.875;3600000;0
15821;148956;498;0;0;0;0;.00nan;0;0
15821;158630;497;0;0;0;0;.00nan;0;0
15822;-1;495;69;40;4;36;.900;3600000;0
15822;86343;499;69;25;2;23;.920;3600000;0
15822;148508;495;0;0;0;0;.00nan;0;0
15822;148652;499;0;0;0;0;.00nan;0;0
15823;3075;505;67;16;1;15;.938;3600000;0
15823;185442;2591;22;4;3;1;.250;289000;0
15823;-1;2591;76;32;1;31;.969;3311000;0
15823;94508;505;0;0;0;0;.00nan;0;0
15824;504;496;59;32;5;27;.844;3538000;0
15824;203533;496;0;0;0;0;.00nan;0;0
15824;-1;504;84;39;3;36;.923;3600000;0
15824;-1;504;0;0;0;0;.00nan;0;0
15825;165611;4636;100;29;0;29;1.000;3600000;0
15825;170536;503;0;0;0;0;.00nan;0;0
15825;185413;4636;0;0;0;0;.00nan;0;0
15825;94134;503;76;30;2;28;.933;3517000;0
15826;-1;495;61;30;4;26;.867;3537000;0
15826;-1;502;75;28;2;26;.929;3600000;0
15826;197409;502;0;0;0;0;.00nan;0;0
15826;148508;495;0;0;0;0;.00nan;0;0
15827;3075;505;0;0;0;0;.00nan;0;0
15827;165611;4636;68;31;3;28;.903;3600000;0
15827;185413;4636;0;0;0;0;.00nan;0;0
15827;94508;505;53;17;2;15;.882;3600000;0
15828;504;496;72;40;4;36;.900;3600000;0
15828;203533;496;0;0;0;0;.00nan;0;0
15828;86343;499;61;15;1;14;.933;3600000;0
15828;148652;499;0;0;0;0;.00nan;0;0
15829;164521;500;0;0;0;0;.00nan;0;0
15829;170547;500;93;26;1;25;.962;3600000;0
15829;49674;498;54;12;1;11;.917;1698000;0
15829;148956;498;27;27;6;21;.778;1902000;0
15830;-1;504;85;30;2;28;.933;3900000;0
15830;-1;504;0;0;0;0;.00nan;0;0
15830;185442;2591;73;32;2;30;.938;3900000;0
15830;-1;2591;0;0;0;0;.00nan;0;0
15831;170536;503;0;0;0;0;.00nan;0;0
15831;78596;497;100;20;0;20;1.000;3600000;0
15831;94134;503;84;36;2;34;.944;3600000;0
15831;158630;497;0;0;0;0;.00nan;0;0
15832;-1;495;89;43;2;41;.953;3900000;0
15832;-1;502;81;30;2;28;.933;3900000;0
15832;197409;502;0;0;0;0;.00nan;0;0
15832;148508;495;0;0;0;0;.00nan;0;0
15833;3075;505;68;19;1;18;.947;3600000;0
15833;165611;4636;62;44;5;39;.886;3600000;0
15833;185413;4636;0;0;0;0;.00nan;0;0
15833;94508;505;0;0;0;0;.00nan;0;0
15834;504;496;88;45;4;41;.911;3600000;0
15834;203533;496;0;0;0;0;.00nan;0;0
15834;86343;499;70;22;1;21;.955;3600000;0
15834;148652;499;0;0;0;0;.00nan;0;0
15835;164521;500;0;0;0;0;.00nan;0;0
15835;170547;500;62;17;2;15;.882;3900000;0
15835;49674;498;0;0;0;0;.00nan;0;0
15835;148956;498;100;50;2;48;.960;3900000;0
15836;-1;504;0;0;0;0;.00nan;0;0
15836;-1;504;50;40;5;35;.875;3600000;0
15836;185442;2591;84;30;2;28;.933;3600000;0
15836;-1;2591;0;0;0;0;.00nan;0;0
15837;170536;503;0;0;0;0;.00nan;0;0
15837;78596;497;53;13;2;11;.846;3545000;0
15837;94134;503;99;39;1;38;.974;3600000;0
15837;158630;497;0;0;0;0;.00nan;0;0
15838;3075;505;87;29;1;28;.966;3592000;0
15838;78596;497;100;34;0;34;1.000;3600000;0
15838;94508;505;0;0;0;0;.00nan;0;0
15838;158630;497;0;0;0;0;.00nan;0;0
15839;164521;500;0;0;0;0;.00nan;0;0
15839;170536;503;99;56;1;55;.982;3600000;0
15839;170547;500;46;13;2;11;.846;3563000;0
15839;94134;503;0;0;0;0;.00nan;0;0
15840;504;496;75;25;1;24;.960;3600000;0
15840;203533;496;0;0;0;0;.00nan;0;0
15840;-1;495;69;33;3;30;.909;3547000;0
15840;148508;495;0;0;0;0;.00nan;0;0
15841;165611;4636;95;22;0;22;1.000;3659000;0
15841;-1;504;82;26;1;25;.962;3659000;0
15841;-1;504;0;0;0;0;.00nan;0;0
15841;185413;4636;0;0;0;0;.00nan;0;0
15842;185442;2591;64;24;2;22;.917;3900000;0
15842;-1;2591;0;0;0;0;.00nan;0;0
15842;86343;499;64;22;2;20;.909;3900000;0
15842;148652;499;0;0;0;0;.00nan;0;0
15843;-1;502;12;20;6;14;.700;3600000;0
15843;197409;502;0;0;0;0;.00nan;0;0
15843;49674;498;0;0;0;0;.00nan;0;0
15843;148956;498;99;43;2;41;.953;3600000;0
15844;3075;505;0;0;0;0;.00nan;0;0
15844;78596;497;70;22;1;21;.955;3600000;0
15844;94508;505;59;23;2;21;.913;3543000;0
15844;158630;497;0;0;0;0;.00nan;0;0
15845;164521;500;0;0;0;0;.00nan;0;0
15845;170536;503;0;0;0;0;.00nan;0;0
15845;170547;500;75;30;2;28;.933;3600000;0
15845;94134;503;67;30;3;27;.900;3600000;0
15846;504;496;48;25;4;21;.840;3900000;0
15846;203533;496;0;0;0;0;.00nan;0;0
15846;-1;495;0;0;0;0;.00nan;0;0
15846;148508;495;53;31;4;27;.871;3870000;0
15847;165611;4636;65;18;1;17;.944;3546000;0
15847;-1;504;98;25;0;25;1.000;3600000;0
15847;-1;504;0;0;0;0;.00nan;0;0
15847;185413;4636;0;0;0;0;.00nan;0;0
15848;185442;2591;90;41;2;39;.951;3600000;0
15848;-1;2591;0;0;0;0;.00nan;0;0
15848;86343;499;54;22;3;19;.864;3559000;0
15848;148652;499;0;0;0;0;.00nan;0;0
15849;-1;502;0;0;0;0;.00nan;0;0
15849;197409;502;78;24;1;23;.958;3600000;0
15849;49674;498;49;1;0;1;1.000;290000;0
15849;148956;498;45;39;6;33;.846;3310000;0
15850;-1;504;49;29;4;25;.862;3600000;0
15850;-1;504;0;0;0;0;.00nan;0;0
15850;78596;497;80;24;1;23;.958;3600000;0
15850;158630;497;0;0;0;0;.00nan;0;0
15851;-1;495;85;27;1;26;.963;3708000;0
15851;49674;498;0;0;0;0;.00nan;0;0
15851;148508;495;0;0;0;0;.00nan;0;0
15851;148956;498;100;30;0;30;1.000;3708000;0
15852;165611;4636;0;0;0;0;.00nan;0;0
15852;185413;4636;95;37;1;36;.973;3900000;0
15852;86343;499;69;17;1;16;.941;3900000;0
15852;148652;499;0;0;0;0;.00nan;0;0
15853;3075;505;83;30;1;29;.967;3600000;0
15853;164521;500;0;0;0;0;.00nan;0;0
15853;170547;500;55;20;2;18;.900;3570000;0
15853;94508;505;0;0;0;0;.00nan;0;0
15854;170536;503;0;0;0;0;.00nan;0;0
15854;-1;502;0;0;0;0;.00nan;0;0
15854;197409;502;81;32;2;30;.938;3560000;0
15854;94134;503;75;22;1;21;.955;3600000;0
15855;504;496;72;35;3;32;.914;3600000;0
15855;185442;2591;100;27;0;27;1.000;3600000;0
15855;81733;496;0;0;0;0;.00nan;0;0
15855;94018;2591;0;0;0;0;.00nan;0;0
15856;-1;504;81;31;2;29;.935;3900000;0
15856;-1;504;0;0;0;0;.00nan;0;0
15856;78596;497;64;23;2;21;.913;3900000;0
15856;158630;497;0;0;0;0;.00nan;0;0
15857;-1;495;61;26;3;23;.885;3646000;0
15857;49674;498;0;0;0;0;.00nan;0;0
15857;148508;495;0;0;0;0;.00nan;0;0
15857;148956;498;79;35;2;33;.943;3646000;0
15858;165611;4636;85;25;1;24;.960;3600000;0
15858;185413;4636;0;0;0;0;.00nan;0;0
15858;86343;499;66;33;3;30;.909;3600000;0
15858;148652;499;0;0;0;0;.00nan;0;0
15859;3075;505;65;26;3;23;.885;3600000;0
15859;164521;500;0;0;0;0;.00nan;0;0
15859;170547;500;100;32;0;32;1.000;3600000;0
15859;94508;505;0;0;0;0;.00nan;0;0
15860;170536;503;91;32;2;30;.938;3228000;0
15860;-1;502;56;13;1;12;.923;3600000;0
15860;197409;502;0;0;0;0;.00nan;0;0
15860;94134;503;23;6;3;3;.500;372000;0
15861;504;496;90;44;2;42;.955;3600000;0
15861;185442;2591;34;20;4;16;.800;3600000;0
15861;81733;496;0;0;0;0;.00nan;0;0
15861;94018;2591;0;0;0;0;.00nan;0;0
15862;164521;500;0;0;0;0;.00nan;0;0
15862;170547;500;100;25;0;25;1.000;3600000;0
15862;-1;504;0;0;0;0;.00nan;0;0
15862;-1;504;66;32;3;29;.906;3600000;0
15863;170536;503;0;0;0;0;.00nan;0;0
15863;49674;498;0;0;0;0;.00nan;0;0
15863;94134;503;79;32;2;30;.938;3559000;0
15863;148956;498;74;23;1;22;.957;3600000;0
15864;504;496;85;27;2;25;.926;3900000;0
15864;165611;4636;86;33;2;31;.939;3900000;0
15864;185413;4636;0;0;0;0;.00nan;0;0
15864;81733;496;0;0;0;0;.00nan;0;0
15865;3075;505;88;26;1;25;.962;3600000;0
15865;-1;502;0;0;0;0;.00nan;0;0
15865;197409;502;69;36;4;32;.889;3600000;0
15865;94508;505;0;0;0;0;.00nan;0;0
15866;78596;497;97;35;1;34;.971;3600000;0
15866;86343;499;59;26;3;23;.885;3565000;0
15866;148652;499;0;0;0;0;.00nan;0;0
15866;158630;497;0;0;0;0;.00nan;0;0
15867;-1;495;83;29;2;27;.931;3600000;0
15867;185442;2591;57;26;3;23;.885;3558000;0
15867;94018;2591;0;0;0;0;.00nan;0;0
15867;148508;495;0;0;0;0;.00nan;0;0
15868;164521;500;0;0;0;0;.00nan;0;0
15868;170547;500;61;20;2;18;.900;3619000;0
15868;-1;504;73;36;3;33;.917;3619000;0
15868;-1;504;0;0;0;0;.00nan;0;0
15869;170536;503;0;0;0;0;.00nan;0;0
15869;49674;498;0;0;0;0;.00nan;0;0
15869;94134;503;97;52;3;49;.942;3600000;0
15869;148956;498;94;22;0;22;1.000;3600000;0
15870;504;496;80;37;3;34;.919;3600000;0
15870;165611;4636;56;31;4;27;.871;3600000;0
15870;185413;4636;0;0;0;0;.00nan;0;0
15870;81733;496;0;0;0;0;.00nan;0;0
15871;3075;505;0;0;0;0;.00nan;0;0
15871;-1;502;76;33;2;31;.939;3552000;0
15871;197409;502;0;0;0;0;.00nan;0;0
15871;94508;505;79;21;1;20;.952;3600000;0
15872;78596;497;64;32;4;28;.875;3600000;0
15872;86343;499;78;22;1;21;.955;3600000;0
15872;148652;499;0;0;0;0;.00nan;0;0
15872;158630;497;0;0;0;0;.00nan;0;0
15873;-1;495;71;42;4;38;.905;3600000;0
15873;185442;2591;34;26;5;21;.808;3600000;0
15873;94018;2591;0;0;0;0;.00nan;0;0
15873;148508;495;0;0;0;0;.00nan;0;0
15874;504;496;63;37;5;32;.865;3600000;0
15874;78596;497;0;0;0;0;.00nan;0;0
15874;81733;496;0;0;0;0;.00nan;0;0
15874;158630;497;65;19;1;18;.947;3600000;0
15875;-1;495;0;0;0;0;.00nan;0;0
15875;170536;503;0;0;0;0;.00nan;0;0
15875;94134;503;67;43;4;39;.907;3589000;0
15875;148508;495;69;23;2;21;.913;3600000;0
15876;165611;4636;31;31;6;25;.806;2702000;0
15876;185413;4636;46;7;1;6;.857;898000;0
15876;185442;2591;51;17;3;14;.824;3600000;0
15876;94018;2591;0;0;0;0;.00nan;0;0
15877;164521;500;0;0;0;0;.00nan;0;0
15877;170547;500;86;27;1;26;.963;3600000;0
15877;86343;499;66;23;2;21;.913;3567000;0
15877;148652;499;0;0;0;0;.00nan;0;0
15878;-1;504;100;35;0;35;1.000;3900000;0
15878;-1;504;0;0;0;0;.00nan;0;0
15878;-1;502;0;0;0;0;.00nan;0;0
15878;197409;502;89;28;0;28;1.000;3900000;0
15879;3075;505;48;23;3;20;.870;3560000;0
15879;49674;498;0;0;0;0;.00nan;0;0
15879;94508;505;0;0;0;0;.00nan;0;0
15879;148956;498;84;34;2;32;.941;3600000;0
15880;504;496;78;42;2;40;.952;3584000;0
15880;78596;497;98;33;1;32;.970;3600000;0
15880;81733;496;0;0;0;0;.00nan;0;0
15880;158630;497;0;0;0;0;.00nan;0;0
15881;-1;495;23;16;5;11;.688;3600000;0
15881;170536;503;0;0;0;0;.00nan;0;0
15881;94134;503;99;42;2;40;.952;3600000;0
15881;148508;495;0;0;0;0;.00nan;0;0
15882;165611;4636;100;31;0;31;1.000;3600000;0
15882;185413;4636;0;0;0;0;.00nan;0;0
15882;185442;2591;85;33;2;31;.939;3537000;0
15882;94018;2591;0;0;0;0;.00nan;0;0
15883;164521;500;0;0;0;0;.00nan;0;0
15883;170547;500;69;33;3;30;.909;3600000;0
15883;86343;499;85;26;1;25;.962;3600000;0
15883;148652;499;0;0;0;0;.00nan;0;0
15884;-1;504;70;45;5;40;.889;3600000;0
15884;-1;504;0;0;0;0;.00nan;0;0
15884;-1;502;0;0;0;0;.00nan;0;0
15884;197409;502;70;25;2;23;.920;3600000;0
15885;3075;505;0;0;0;0;.00nan;0;0
15885;49674;498;63;25;2;23;.920;3600000;0
15885;94508;505;72;30;3;27;.900;3561000;0
15885;148956;498;0;0;0;0;.00nan;0;0
15886;185442;2591;0;0;0;0;.00nan;0;0
15886;78596;497;91;20;0;20;1.000;3600000;0
15886;94018;2591;73;27;2;25;.926;3516000;0
15886;158630;497;0;0;0;0;.00nan;0;0
15887;504;496;56;27;4;23;.852;3600000;0
15887;164521;500;0;0;0;0;.00nan;0;0
15887;170547;500;86;29;1;28;.966;3600000;0
15887;81733;496;0;0;0;0;.00nan;0;0
15888;165611;4636;72;26;2;24;.923;3600000;0
15888;-1;495;0;0;0;0;.00nan;0;0
15888;185413;4636;0;0;0;0;.00nan;0;0
15888;148508;495;62;31;3;28;.903;3546000;0
15889;3075;505;87;19;0;19;1.000;3600000;0
15889;170536;503;0;0;0;0;.00nan;0;0
15889;94134;503;66;41;4;37;.902;3600000;0
15889;94508;505;0;0;0;0;.00nan;0;0
15890;-1;504;61;32;3;29;.906;3588000;0
15890;-1;504;0;0;0;0;.00nan;0;0
15890;49674;498;0;0;0;0;.00nan;0;0
15890;148956;498;80;29;2;27;.931;3600000;0
15891;-1;502;0;0;0;0;.00nan;0;0
15891;197409;502;95;31;1;30;.968;3600000;0
15891;86343;499;0;0;0;0;.00nan;0;0
15891;148652;499;64;24;2;22;.917;3565000;0
15892;185442;2591;47;14;2;12;.857;3521000;0
15892;78596;497;100;35;0;35;1.000;3600000;0
15892;94018;2591;0;0;0;0;.00nan;0;0
15892;158630;497;0;0;0;0;.00nan;0;0
15893;504;496;0;0;0;0;.00nan;0;0
15893;164521;500;0;0;0;0;.00nan;0;0
15893;170547;500;88;27;1;26;.963;3900000;0
15893;81733;496;73;27;1;26;.963;3900000;0
15894;165611;4636;95;40;2;38;.950;3600000;0
15894;-1;495;49;21;3;18;.857;3554000;0
15894;185413;4636;0;0;0;0;.00nan;0;0
15894;148508;495;0;0;0;0;.00nan;0;0
15895;3075;505;43;13;2;11;.846;3600000;0
15895;170536;503;0;0;0;0;.00nan;0;0
15895;94134;503;62;41;5;36;.878;3600000;0
15895;94508;505;0;0;0;0;.00nan;0;0
15896;-1;504;70;30;2;28;.933;3900000;0
15896;-1;504;0;0;0;0;.00nan;0;0
15896;49674;498;0;0;0;0;.00nan;0;0
15896;148956;498;83;33;2;31;.939;3900000;0
15897;-1;502;89;43;2;41;.953;3600000;0
15897;197409;502;0;0;0;0;.00nan;0;0
15897;86343;499;83;24;1;23;.958;3600000;0
15897;148652;499;0;0;0;0;.00nan;0;0
15898;3075;505;0;0;0;0;.00nan;0;0
15898;-1;495;0;0;0;0;.00nan;0;0
15898;94508;505;50;33;5;28;.848;3600000;0
15898;148508;495;95;21;0;21;1.000;3600000;0
15899;164521;500;0;0;0;0;.00nan;0;0
15899;170547;500;69;22;2;20;.909;3540000;0
15899;185442;2591;100;29;0;29;1.000;3600000;0
15899;94018;2591;0;0;0;0;.00nan;0;0
15900;165611;4636;71;40;4;36;.900;3600000;0
15900;185413;4636;0;0;0;0;.00nan;0;0
15900;78596;497;71;20;1;19;.950;3600000;0
15900;158630;497;0;0;0;0;.00nan;0;0
15901;504;496;66;31;3;28;.903;3702000;0
15901;-1;502;0;0;0;0;.00nan;0;0
15901;197409;502;97;49;2;47;.959;3702000;0
15901;81733;496;0;0;0;0;.00nan;0;0
15902;170536;503;0;0;0;0;.00nan;0;0
15902;-1;504;56;22;3;19;.864;3552000;0
15902;-1;504;0;0;0;0;.00nan;0;0
15902;94134;503;72;26;2;24;.923;3600000;0
15903;49674;498;0;0;0;0;.00nan;0;0
15903;86343;499;55;18;2;16;.889;3600000;0
15903;148652;499;0;0;0;0;.00nan;0;0
15903;148956;498;97;50;3;47;.940;3559000;0
15904;3075;505;0;0;0;0;.00nan;0;0
15904;-1;495;0;0;0;0;.00nan;0;0
15904;94508;505;64;20;2;18;.900;3600000;0
15904;148508;495;87;41;3;38;.927;3600000;0
15905;164521;500;0;0;0;0;.00nan;0;0
15905;170547;500;94;35;1;34;.971;3600000;0
15905;185442;2591;89;44;2;42;.955;3592000;0
15905;94018;2591;0;0;0;0;.00nan;0;0
15906;165611;4636;68;29;3;26;.897;3600000;0
15906;185413;4636;0;0;0;0;.00nan;0;0
15906;78596;497;69;24;2;22;.917;3600000;0
15906;158630;497;0;0;0;0;.00nan;0;0
15907;504;496;65;27;2;25;.926;3573000;0
15907;-1;502;74;26;1;25;.962;3600000;0
15907;197409;502;0;0;0;0;.00nan;0;0
15907;81733;496;0;0;0;0;.00nan;0;0
15908;170536;503;0;0;0;0;.00nan;0;0
15908;-1;504;66;29;2;27;.931;3900000;0
15908;-1;504;0;0;0;0;.00nan;0;0
15908;94134;503;94;37;2;35;.946;3900000;0
15909;49674;498;0;0;0;0;.00nan;0;0
15909;86343;499;51;17;2;15;.882;3600000;0
15909;148652;499;0;0;0;0;.00nan;0;0
15909;148956;498;97;40;3;37;.925;3552000;0
15910;-1;504;64;37;3;34;.919;3763000;0
15910;-1;504;0;0;0;0;.00nan;0;0
15910;49674;498;0;0;0;0;.00nan;0;0
15910;148956;498;80;28;2;26;.929;3763000;0
15911;170536;503;0;0;0;0;.00nan;0;0
15911;86343;499;66;14;1;13;.929;3600000;0
15911;94134;503;87;41;2;39;.951;3600000;0
15911;148652;499;0;0;0;0;.00nan;0;0
15912;504;496;72;33;3;30;.909;3713000;0
15912;165611;4636;0;0;0;0;.00nan;0;0
15912;185413;4636;79;33;2;31;.939;3713000;0
15912;81733;496;0;0;0;0;.00nan;0;0
15913;3075;505;0;0;0;0;.00nan;0;0
15913;164521;500;0;0;0;0;.00nan;0;0
15913;170547;500;60;23;3;20;.870;3566000;0
15913;94508;505;86;28;1;27;.964;3600000;0
15914;185442;2591;73;33;3;30;.909;3600000;0
15914;-1;502;0;0;0;0;.00nan;0;0
15914;197409;502;51;30;4;26;.867;3600000;0
15914;94018;2591;0;0;0;0;.00nan;0;0
15915;-1;495;0;0;0;0;.00nan;0;0
15915;78596;497;96;32;1;31;.969;3600000;0
15915;148508;495;57;24;2;22;.917;3600000;0
15915;158630;497;0;0;0;0;.00nan;0;0
15916;-1;504;0;0;0;0;.00nan;0;0
15916;-1;504;94;43;2;41;.953;3769000;0
15916;86343;499;89;25;1;24;.960;3769000;0
15916;148652;499;0;0;0;0;.00nan;0;0
15917;504;496;94;22;0;22;1.000;3600000;0
15917;170536;503;59;6;0;6;1.000;513000;0
15917;81733;496;0;0;0;0;.00nan;0;0
15917;94134;503;43;31;6;25;.806;3087000;0
15918;165611;4636;60;34;3;31;.912;3568000;0
15918;185413;4636;0;0;0;0;.00nan;0;0
15918;49674;498;0;0;0;0;.00nan;0;0
15918;148956;498;78;30;2;28;.933;3600000;0
15919;164521;500;0;0;0;0;.00nan;0;0
15919;170547;500;61;34;4;30;.882;3523000;0
15919;78596;497;81;33;2;31;.939;3600000;0
15919;158630;497;0;0;0;0;.00nan;0;0
15920;3075;505;71;28;2;26;.929;3600000;0
15920;185442;2591;57;30;3;27;.900;3586000;0
15920;94018;2591;0;0;0;0;.00nan;0;0
15920;94508;505;0;0;0;0;.00nan;0;0
15921;-1;495;91;32;1;31;.969;3600000;0
15921;-1;502;0;0;0;0;.00nan;0;0
15921;197409;502;68;27;2;25;.926;3555000;0
15921;148508;495;0;0;0;0;.00nan;0;0
15922;504;496;59;29;3;26;.897;3573000;0
15922;-1;504;70;23;2;21;.913;3600000;0
15922;-1;504;0;0;0;0;.00nan;0;0
15922;81733;496;0;0;0;0;.00nan;0;0
15923;170536;503;0;0;0;0;.00nan;0;0
15923;49674;498;0;0;0;0;.00nan;0;0
15923;94134;503;90;28;1;27;.964;3600000;0
15923;148956;498;79;32;2;30;.938;3574000;0
15924;165611;4636;63;22;2;20;.909;3545000;0
15924;185413;4636;0;0;0;0;.00nan;0;0
15924;86343;499;87;24;1;23;.958;3600000;0
15924;148652;499;0;0;0;0;.00nan;0;0
15925;164521;500;0;0;0;0;.00nan;0;0
15925;170547;500;73;29;3;26;.897;3519000;0
15925;-1;502;85;29;1;28;.966;3600000;0
15925;197409;502;0;0;0;0;.00nan;0;0
15926;185442;2591;0;0;0;0;.00nan;0;0
15926;78596;497;97;37;2;35;.946;3600000;0
15926;94018;2591;94;21;0;21;1.000;3600000;0
15926;158630;497;0;0;0;0;.00nan;0;0
15927;3075;505;0;0;0;0;.00nan;0;0
15927;-1;495;60;19;2;17;.895;3600000;0
15927;94508;505;41;29;5;24;.828;3600000;0
15927;148508;495;0;0;0;0;.00nan;0;0
15928;185442;2591;0;0;0;0;.00nan;0;0
15928;86343;499;0;0;0;0;.00nan;0;0
15928;94018;2591;88;44;3;41;.932;3580000;0
15928;148652;499;80;27;1;26;.963;3600000;0
15929;-1;495;0;0;0;0;.00nan;0;0
15929;49674;498;35;34;6;28;.824;2955000;0
15929;148508;495;75;30;2;28;.933;3600000;0
15929;148956;498;55;5;0;5;1.000;645000;0
15930;504;496;19;7;4;3;.429;367000;0
15930;164521;500;0;0;0;0;.00nan;0;0
15930;170547;500;64;25;2;23;.920;3600000;0
15930;81733;496;40;24;4;20;.833;3233000;0
15931;3075;505;0;0;0;0;.00nan;0;0
15931;-1;504;46;26;4;22;.846;3600000;0
15931;-1;504;0;0;0;0;.00nan;0;0
15931;94508;505;79;30;3;27;.900;3600000;0
15932;170536;503;0;0;0;0;.00nan;0;0
15932;-1;502;51;15;2;13;.867;3600000;0
15932;197409;502;0;0;0;0;.00nan;0;0
15932;94134;503;59;33;4;29;.879;3545000;0
15933;165611;4636;84;48;4;44;.917;3600000;0
15933;185413;4636;0;0;0;0;.00nan;0;0
15933;78596;497;62;21;2;19;.905;3600000;0
15933;158630;497;0;0;0;0;.00nan;0;0
15934;164521;500;0;0;0;0;.00nan;0;0
15934;170547;500;56;33;5;28;.848;3563000;0
15934;86343;499;54;27;4;23;.852;3600000;0
15934;148652;499;0;0;0;0;.00nan;0;0
15935;185442;2591;71;21;1;20;.952;3600000;0
15935;49674;498;0;0;0;0;.00nan;0;0
15935;94018;2591;0;0;0;0;.00nan;0;0
15935;148956;498;87;34;2;32;.941;3542000;0
15936;504;496;70;33;4;29;.879;3600000;0
15936;-1;495;23;22;5;17;.773;3572000;0
15936;81733;496;0;0;0;0;.00nan;0;0
15936;148508;495;0;0;0;0;.00nan;0;0
15937;3075;505;77;26;1;25;.962;3600000;0
15937;165611;4636;61;28;3;25;.893;3565000;0
15937;185413;4636;0;0;0;0;.00nan;0;0
15937;94508;505;0;0;0;0;.00nan;0;0
15938;-1;504;73;40;4;36;.900;3520000;0
15938;-1;504;0;0;0;0;.00nan;0;0
15938;-1;502;0;0;0;0;.00nan;0;0
15938;197409;502;75;24;2;22;.917;3600000;0
15939;170536;503;0;0;0;0;.00nan;0;0
15939;78596;497;60;13;1;12;.923;3600000;0
15939;94134;503;97;51;3;48;.941;3530000;0
15939;158630;497;0;0;0;0;.00nan;0;0
15940;-1;495;64;31;3;28;.903;3547000;0
15940;86343;499;72;22;1;21;.955;3600000;0
15940;148508;495;0;0;0;0;.00nan;0;0
15940;148652;499;0;0;0;0;.00nan;0;0
15941;164521;500;0;0;0;0;.00nan;0;0
15941;170547;500;62;18;2;16;.889;3545000;0
15941;49674;498;0;0;0;0;.00nan;0;0
15941;148956;498;96;35;1;34;.971;3600000;0
15942;504;496;0;0;0;0;.00nan;0;0
15942;185442;2591;44;33;5;28;.848;3600000;0
15942;81733;496;100;34;1;33;.971;3600000;0
15942;94018;2591;0;0;0;0;.00nan;0;0
15943;3075;505;0;0;0;0;.00nan;0;0
15943;170536;503;0;0;0;0;.00nan;0;0
15943;94134;503;98;61;3;58;.951;3600000;0
15943;94508;505;89;21;0;21;1.000;3600000;0
15944;165611;4636;79;31;2;29;.935;3600000;0
15944;185413;4636;0;0;0;0;.00nan;0;0
15944;-1;502;78;26;1;25;.962;3600000;0
15944;197409;502;0;0;0;0;.00nan;0;0
15945;-1;504;81;36;2;34;.944;3600000;0
15945;-1;504;0;0;0;0;.00nan;0;0
15945;78596;497;60;30;3;27;.900;3595000;0
15945;158630;497;0;0;0;0;.00nan;0;0
15946;3075;505;46;31;5;26;.839;3600000;0
15946;-1;502;0;0;0;0;.00nan;0;0
15946;197409;502;73;32;2;30;.938;3600000;0
15946;94508;505;0;0;0;0;.00nan;0;0
15947;78596;497;78;25;1;24;.960;3900000;0
15947;86343;499;83;21;1;20;.952;3900000;0
15947;148652;499;0;0;0;0;.00nan;0;0
15947;158630;497;0;0;0;0;.00nan;0;0
15948;504;496;76;34;2;32;.941;3545000;0
15948;49674;498;0;0;0;0;.00nan;0;0
15948;81733;496;0;0;0;0;.00nan;0;0
15948;148956;498;63;16;1;15;.938;3600000;0
15949;164521;500;78;25;1;24;.960;3600000;0
15949;165611;4636;85;48;4;44;.917;3600000;0
15949;170547;500;0;0;0;0;.00nan;0;0
15949;185413;4636;0;0;0;0;.00nan;0;0
15950;-1;504;30;19;4;15;.789;3586000;0
15950;-1;504;0;0;0;0;.00nan;0;0
15950;185442;2591;90;30;2;28;.933;3600000;0
15950;94018;2591;0;0;0;0;.00nan;0;0
15951;-1;495;0;0;0;0;.00nan;0;0
15951;170536;503;97;56;2;54;.964;3573000;0
15951;94134;503;0;0;0;0;.00nan;0;0
15951;148508;495;57;15;1;14;.933;3600000;0
15952;3075;505;0;0;0;0;.00nan;0;0
15952;86343;499;90;17;0;17;1.000;3600000;0
15952;94508;505;66;27;2;25;.926;3534000;0
15952;148652;499;0;0;0;0;.00nan;0;0
15953;-1;502;89;37;1;36;.973;3600000;0
15953;197409;502;0;0;0;0;.00nan;0;0
15953;49674;498;0;0;0;0;.00nan;0;0
15953;148956;498;74;44;4;40;.909;3600000;0
15954;504;496;89;31;2;29;.935;3900000;0
15954;78596;497;71;28;2;26;.929;3900000;0
15954;81733;496;0;0;0;0;.00nan;0;0
15954;158630;497;0;0;0;0;.00nan;0;0
15955;170536;503;0;0;0;0;.00nan;0;0
15955;-1;504;0;0;0;0;.00nan;0;0
15955;-1;504;77;32;2;30;.938;3900000;0
15955;94134;503;98;46;2;44;.957;3900000;0
15956;164521;500;0;0;0;0;.00nan;0;0
15956;170547;500;95;36;2;34;.944;3600000;0
15956;185442;2591;66;32;3;29;.906;3544000;0
15956;94018;2591;0;0;0;0;.00nan;0;0
15957;165611;4636;0;0;0;0;.00nan;0;0
15957;-1;495;86;30;1;29;.967;3600000;0
15957;185413;4636;68;27;2;25;.926;3559000;0
15957;148508;495;0;0;0;0;.00nan;0;0
15958;504;496;89;43;2;41;.953;3900000;0
15958;3075;505;69;26;2;24;.923;3900000;0
15958;81733;496;0;0;0;0;.00nan;0;0
15958;94508;505;0;0;0;0;.00nan;0;0
15959;-1;502;0;0;0;0;.00nan;0;0
15959;197409;502;53;29;3;26;.897;3900000;0
15959;86343;499;89;40;3;37;.925;3900000;0
15959;148652;499;0;0;0;0;.00nan;0;0
15960;49674;498;0;0;0;0;.00nan;0;0
15960;78596;497;94;24;0;24;1.000;3600000;0
15960;148956;498;98;49;4;45;.918;3600000;0
15960;158630;497;0;0;0;0;.00nan;0;0
15961;165611;4636;48;21;4;17;.810;3568000;0
15961;-1;504;75;29;2;27;.931;3600000;0
15961;-1;504;0;0;0;0;.00nan;0;0
15961;185413;4636;0;0;0;0;.00nan;0;0
15962;170536;503;0;0;0;0;.00nan;0;0
15962;185442;2591;73;25;1;24;.960;3900000;0
15962;94018;2591;0;0;0;0;.00nan;0;0
15962;94134;503;97;32;1;31;.969;3900000;0
15963;164521;500;0;0;0;0;.00nan;0;0
15963;-1;495;0;0;0;0;.00nan;0;0
15963;170547;500;100;28;0;28;1.000;3600000;0
15963;148508;495;57;26;3;23;.885;3600000;0
15964;3075;505;0;0;0;0;.00nan;0;0
15964;78596;497;71;20;1;19;.950;3900000;0
15964;94508;505;88;28;1;27;.964;3900000;0
15964;158630;497;0;0;0;0;.00nan;0;0
15965;49674;498;0;0;0;0;.00nan;0;0
15965;86343;499;18;23;6;17;.739;2624000;0
15965;148652;499;49;7;1;6;.857;976000;0
15965;148956;498;73;34;3;31;.912;3600000;0
15966;504;496;54;34;5;29;.853;3763000;0
15966;-1;502;72;41;4;37;.902;3763000;0
15966;197409;502;0;0;0;0;.00nan;0;0
15966;81733;496;0;0;0;0;.00nan;0;0
15967;164521;500;0;0;0;0;.00nan;0;0
15967;170536;503;0;0;0;0;.00nan;0;0
15967;170547;500;76;10;0;10;1.000;3600000;0
15967;94134;503;67;37;3;34;.919;3600000;0
15968;165611;4636;81;16;0;16;1.000;3600000;0
15968;185413;4636;0;0;0;0;.00nan;0;0
15968;185442;2591;70;27;2;25;.926;3525000;0
15968;94018;2591;0;0;0;0;.00nan;0;0
15969;-1;495;0;0;0;0;.00nan;0;0
15969;-1;504;66;26;2;24;.923;3900000;0
15969;-1;504;0;0;0;0;.00nan;0;0
15969;148508;495;90;40;2;38;.950;3900000;0
15970;-1;502;0;0;0;0;.00nan;0;0
15970;197409;502;91;34;1;33;.971;3600000;0
15970;78596;497;90;36;2;34;.944;3600000;0
15970;158630;497;0;0;0;0;.00nan;0;0
15971;3075;505;87;41;3;38;.927;3622000;0
15971;49674;498;0;0;0;0;.00nan;0;0
15971;94508;505;0;0;0;0;.00nan;0;0
15971;148956;498;64;24;2;22;.917;3622000;0
15972;504;496;77;35;2;33;.943;3900000;0
15972;81733;496;0;0;0;0;.00nan;0;0
15972;86343;499;61;22;2;20;.909;3900000;0
15972;148652;499;0;0;0;0;.00nan;0;0
15973;164521;500;0;0;0;0;.00nan;0;0
15973;170547;500;66;19;1;18;.947;3757000;0
15973;-1;504;83;36;2;34;.944;3757000;0
15973;-1;504;0;0;0;0;.00nan;0;0
15974;165611;4636;86;18;0;18;1.000;3600000;0
15974;170536;503;0;0;0;0;.00nan;0;0
15974;185413;4636;0;0;0;0;.00nan;0;0
15974;94134;503;77;48;5;43;.896;3600000;0
15975;-1;495;85;17;0;17;1.000;3600000;0
15975;185442;2591;0;0;0;0;.00nan;0;0
15975;94018;2591;97;40;1;39;.975;3549000;0
15975;148508;495;0;0;0;0;.00nan;0;0
15976;164521;500;0;0;0;0;.00nan;0;0
15976;165611;4636;67;31;3;28;.903;3600000;0
15976;170547;500;100;28;0;28;1.000;3600000;0
15976;185413;4636;0;0;0;0;.00nan;0;0
15977;185442;2591;70;39;4;35;.897;3515000;0
15977;-1;502;65;22;2;20;.909;3600000;0
15977;197409;502;0;0;0;0;.00nan;0;0
15977;94018;2591;0;0;0;0;.00nan;0;0
15978;-1;495;95;46;3;43;.935;3581000;0
15978;78596;497;95;27;1;26;.963;3600000;0
15978;148508;495;0;0;0;0;.00nan;0;0
15978;158630;497;0;0;0;0;.00nan;0;0
15979;3075;505;0;0;0;0;.00nan;0;0
15979;-1;504;57;25;3;22;.880;3600000;0
15979;-1;504;0;0;0;0;.00nan;0;0
15979;94508;505;54;30;5;25;.833;3513000;0
15980;170536;503;0;0;0;0;.00nan;0;0
15980;86343;499;38;19;4;15;.789;3786000;0
15980;94134;503;85;40;3;37;.925;3786000;0
15980;148652;499;0;0;0;0;.00nan;0;0
15981;504;496;70;32;3;29;.906;3900000;0
15981;49674;498;0;0;0;0;.00nan;0;0
15981;81733;496;0;0;0;0;.00nan;0;0
15981;148956;498;55;26;3;23;.885;3900000;0
15983;187813;495;0;0;0;0;.00nan;0;0
15983;185442;2591;72;47;4;43;.915;3600000;0
15983;-1;2591;0;0;0;0;.00nan;0;0
15983;148508;495;64;24;3;21;.875;3600000;0
15985;180188;4636;0;0;0;0;.00nan;0;0
15985;185413;4636;78;30;2;28;.933;3582000;0
15985;-1;502;0;0;0;0;.00nan;0;0
15985;197409;502;91;23;0;23;1.000;3600000;0
15987;504;496;79;29;2;27;.931;3600000;0
15987;3075;505;0;0;0;0;.00nan;0;0
15987;203533;496;0;0;0;0;.00nan;0;0
15987;94508;505;58;35;4;31;.886;3600000;0
15989;170536;503;0;0;0;0;.00nan;0;0
15989;181910;497;0;0;0;0;.00nan;0;0
15989;94134;503;100;28;0;28;1.000;3600000;0
15989;158630;497;68;24;2;22;.917;3562000;0
15991;-1;504;61;28;3;25;.893;3600000;0
15991;-1;504;0;0;0;0;.00nan;0;0
15991;49674;498;0;0;0;0;.00nan;0;0
15991;148956;498;42;24;4;20;.833;3553000;0
15993;164521;500;0;0;0;0;.00nan;0;0
15993;170547;500;93;36;1;35;.972;3749000;0
15993;67446;499;0;0;0;0;.00nan;0;0
15993;148652;499;99;22;0;22;1.000;3749000;0
15995;164521;500;67;32;3;29;.906;3550000;0
15995;170547;500;0;0;0;0;.00nan;0;0
15995;67446;499;0;0;0;0;.00nan;0;0
15995;148652;499;79;33;2;31;.939;3600000;0
15997;504;496;0;0;0;0;.00nan;0;0
15997;203533;496;62;29;3;26;.897;3539000;0
15997;180188;4636;94;33;1;32;.970;3600000;0
15997;185413;4636;0;0;0;0;.00nan;0;0
15999;187813;495;73;22;1;21;.955;3600000;0
15999;181910;497;98;48;2;46;.958;3556000;0
15999;148508;495;0;0;0;0;.00nan;0;0
15999;158630;497;0;0;0;0;.00nan;0;0
16001;170536;503;0;0;0;0;.00nan;0;0
16001;185442;2591;0;0;0;0;.00nan;0;0
16001;-1;2591;81;37;2;35;.946;3600000;0
16001;94134;503;40;35;5;30;.857;3600000;0
16003;-1;504;0;0;0;0;.00nan;0;0
16003;-1;504;85;21;0;21;1.000;3900000;0
16003;49674;498;100;28;0;28;1.000;3900000;0
16003;148956;498;0;0;0;0;.00nan;0;0
16005;3075;505;80;28;1;27;.964;3600000;0
16005;-1;502;0;0;0;0;.00nan;0;0
16005;197409;502;65;28;2;26;.929;3537000;0
16005;94508;505;0;0;0;0;.00nan;0;0
16007;-1;502;78;31;2;29;.935;3600000;0
16007;197409;502;0;0;0;0;.00nan;0;0
16007;67446;499;65;30;3;27;.900;3566000;0
16007;148652;499;0;0;0;0;.00nan;0;0
16009;3075;505;0;0;0;0;.00nan;0;0
16009;164521;500;0;0;0;0;.00nan;0;0
16009;170547;500;51;7;1;6;.857;3600000;0
16009;94508;505;96;59;3;56;.949;3600000;0
16011;170536;503;0;0;0;0;.00nan;0;0
16011;49674;498;53;25;3;22;.880;3600000;0
16011;94134;503;59;35;4;31;.886;3578000;0
16011;148956;498;0;0;0;0;.00nan;0;0
16013;180188;4636;0;0;0;0;.00nan;0;0
16013;185413;4636;81;21;1;20;.952;3600000;0
16013;185442;2591;83;41;3;38;.927;3529000;0
16013;-1;2591;0;0;0;0;.00nan;0;0
16015;187813;495;82;12;0;12;1.000;3600000;0
16015;181910;497;0;0;0;0;.00nan;0;0
16015;148508;495;0;0;0;0;.00nan;0;0
16015;158630;497;95;43;2;41;.953;3550000;0
16017;504;496;66;26;2;24;.923;3900000;0
16017;203533;496;0;0;0;0;.00nan;0;0
16017;-1;504;0;0;0;0;.00nan;0;0
16017;-1;504;75;35;2;33;.943;3900000;0
16019;504;496;0;0;0;0;.00nan;0;0
16019;203533;496;85;26;1;25;.962;3825000;0
16019;181910;497;92;35;2;33;.943;3825000;0
16019;158630;497;0;0;0;0;.00nan;0;0
16021;164521;500;14;22;6;16;.727;1860000;0
16021;170547;500;47;6;1;5;.833;1740000;0
16021;67446;499;0;0;0;0;.00nan;0;0
16021;148652;499;74;37;4;33;.892;3600000;0
16023;170536;503;68;39;4;35;.897;3587000;0
16023;-1;504;63;31;3;28;.903;3600000;0
16023;-1;504;0;0;0;0;.00nan;0;0
16023;94134;503;0;0;0;0;.00nan;0;0
16025;3075;505;81;30;3;27;.900;3600000;0
16025;187813;495;34;32;5;27;.844;3577000;0
16025;94508;505;0;0;0;0;.00nan;0;0
16025;148508;495;0;0;0;0;.00nan;0;0
16027;180188;4636;100;28;0;28;1.000;3600000;0
16027;185413;4636;0;0;0;0;.00nan;0;0
16027;49674;498;0;0;0;0;.00nan;0;0
16027;148956;498;83;29;1;28;.966;3600000;0
16029;185442;2591;0;0;0;0;.00nan;0;0
16029;-1;502;0;0;0;0;.00nan;0;0
16029;197409;502;94;34;1;33;.971;3791000;0
16029;-1;2591;90;43;2;41;.953;3791000;0
16031;164521;500;0;0;0;0;.00nan;0;0
16031;170547;500;75;29;2;27;.931;3900000;0
16031;185442;2591;91;44;2;42;.955;3900000;0
16031;-1;2591;0;0;0;0;.00nan;0;0
16033;3075;505;0;0;0;0;.00nan;0;0
16033;187813;495;0;0;0;0;.00nan;0;0
16033;94508;505;71;29;2;27;.931;3536000;0
16033;148508;495;90;19;0;19;1.000;3600000;0
16035;181910;497;0;0;0;0;.00nan;0;0
16035;67446;499;65;37;4;33;.892;3600000;0
16035;148652;499;0;0;0;0;.00nan;0;0
16035;158630;497;88;19;0;19;1.000;3600000;0
16037;170536;503;0;0;0;0;.00nan;0;0
16037;180188;4636;100;26;0;26;1.000;3600000;0
16037;185413;4636;0;0;0;0;.00nan;0;0
16037;94134;503;79;33;2;31;.939;3520000;0
16039;-1;504;0;0;0;0;.00nan;0;0
16039;-1;504;71;21;2;19;.905;3900000;0
16039;49674;498;0;0;0;0;.00nan;0;0
16039;148956;498;95;43;2;41;.953;3900000;0
16041;504;496;25;28;6;22;.786;3600000;0
16041;203533;496;0;0;0;0;.00nan;0;0
16041;-1;502;70;24;2;22;.917;3600000;0
16041;197409;502;0;0;0;0;.00nan;0;0
16043;504;496;95;33;1;32;.970;3600000;0
16043;203533;496;0;0;0;0;.00nan;0;0
16043;49674;498;0;0;0;0;.00nan;0;0
16043;148956;498;79;33;3;30;.909;3600000;0
16045;185442;2591;88;26;1;25;.962;3600000;0
16045;181910;497;0;0;0;0;.00nan;0;0
16045;-1;2591;0;0;0;0;.00nan;0;0
16045;158630;497;53;21;2;19;.905;3591000;0
16047;170536;503;52;28;4;24;.857;3537000;0
16047;-1;504;79;26;2;24;.923;3600000;0
16047;-1;504;0;0;0;0;.00nan;0;0
16047;94134;503;0;0;0;0;.00nan;0;0
16049;180188;4636;80;41;2;39;.951;3600000;0
16049;185413;4636;0;0;0;0;.00nan;0;0
16049;67446;499;89;17;0;17;1.000;3600000;0
16049;148652;499;0;0;0;0;.00nan;0;0
16051;187813;495;0;0;0;0;.00nan;0;0
16051;-1;502;91;34;1;33;.971;3900000;0
16051;197409;502;0;0;0;0;.00nan;0;0
16051;148508;495;62;10;1;9;.900;3900000;0
16053;3075;505;0;0;0;0;.00nan;0;0
16053;164521;500;0;0;0;0;.00nan;0;0
16053;170547;500;76;24;1;23;.958;3600000;0
16053;94508;505;61;36;4;32;.889;3600000;0
16055;-1;504;0;0;0;0;.00nan;0;0
16055;-1;504;100;43;1;42;.977;3600000;0
16055;67446;499;60;20;2;18;.900;3600000;0
16055;148652;499;0;0;0;0;.00nan;0;0
16057;504;496;0;0;0;0;.00nan;0;0
16057;203533;496;39;30;5;25;.833;3600000;0
16057;164521;500;91;32;1;31;.969;3600000;0
16057;170547;500;0;0;0;0;.00nan;0;0
16059;180188;4636;0;0;0;0;.00nan;0;0
16059;185413;4636;47;22;4;18;.818;3600000;0
16059;49674;498;91;35;1;34;.971;3600000;0
16059;148956;498;0;0;0;0;.00nan;0;0
16061;170536;503;73;18;1;17;.944;1451000;0
16061;-1;502;0;0;0;0;.00nan;0;0
16061;197409;502;78;24;1;23;.958;3600000;0
16061;94134;503;11;20;6;14;.700;2149000;0
16063;3075;505;78;44;3;41;.932;3600000;0
16063;187813;495;43;22;4;18;.818;3543000;0
16063;94508;505;0;0;0;0;.00nan;0;0
16063;148508;495;0;0;0;0;.00nan;0;0
16065;185442;2591;0;0;0;0;.00nan;0;0
16065;181910;497;91;34;3;31;.912;3900000;0
16065;-1;2591;76;36;3;33;.917;3868000;0
16065;158630;497;0;0;0;0;.00nan;0;0
22610;3075;505;80;45;3;42;.933;5157000;0
22610;86343;499;89;40;2;38;.950;5157000;0
22610;94508;505;0;0;0;0;.00nan;0;0
22610;148652;499;0;0;0;0;.00nan;0;0
22611;164521;500;0;0;0;0;.00nan;0;0
22611;170547;500;79;41;3;38;.927;3593000;0
22611;-1;502;0;0;0;0;.00nan;0;0
22611;197409;502;74;21;1;20;.952;3600000;0
16066;6389;545;48;21;3;18;.857;3555000;0
16066;67683;545;0;0;0;0;.00nan;0;0
16066;71660;546;87;29;1;28;.966;3600000;0
16066;150187;546;0;0;0;0;.00nan;0;0
16067;483;2190;0;0;0;0;.00nan;0;0
16067;167061;2190;54;17;2;15;.882;3600000;0
16067;12406;551;0;0;0;0;.00nan;0;0
16067;59933;551;60;30;4;26;.867;3580000;0
16068;147;543;0;0;0;0;.00nan;0;0
16068;193222;548;0;0;0;0;.00nan;0;0
16068;162979;548;88;37;2;35;.946;3793000;0
16068;73939;543;51;21;3;18;.857;3793000;0
16069;193222;548;0;0;0;0;.00nan;0;0
16069;162979;548;92;39;1;38;.974;3866000;0
16069;64368;547;0;0;0;0;.00nan;0;0
16069;158979;547;100;46;0;46;1.000;3866000;0
16070;147;543;92;37;2;35;.946;3600000;0
16070;483;2190;46;32;5;27;.844;3600000;0
16070;167061;2190;0;0;0;0;.00nan;0;0
16070;73939;543;0;0;0;0;.00nan;0;0
16071;6389;545;84;32;1;31;.969;3600000;0
16071;-1;550;66;24;2;22;.917;3600000;0
16071;150203;550;0;0;0;0;.00nan;0;0
16071;158979;545;0;0;0;0;.00nan;0;0
16072;64368;549;0;0;0;0;.00nan;0;0
16072;67683;546;56;38;5;33;.868;3534000;0
16072;72108;549;59;28;3;25;.893;3600000;0
16072;150187;546;0;0;0;0;.00nan;0;0
16073;12406;551;0;0;0;0;.00nan;0;0
16073;-1;547;45;38;6;32;.842;3600000;0
16073;59933;551;56;24;3;21;.875;3600000;0
16073;73792;547;0;0;0;0;.00nan;0;0
16074;6389;545;70;28;2;26;.929;3600000;0
16074;-1;547;54;30;4;26;.867;3581000;0
16074;73792;547;0;0;0;0;.00nan;0;0
16074;158979;545;0;0;0;0;.00nan;0;0
16075;147;543;0;0;0;0;.00nan;0;0
16075;64368;549;56;31;3;28;.903;2663000;0
16075;72108;549;31;13;4;9;.692;937000;0
16075;73939;543;56;25;3;22;.880;3600000;0
16076;483;2190;87;25;1;24;.960;3600000;0
16076;172303;2190;0;0;0;0;.00nan;0;0
16076;67683;546;0;0;0;0;.00nan;0;0
16076;150187;546;65;31;3;28;.903;3600000;0
16077;193222;548;0;0;0;0;.00nan;0;0
16077;162979;548;67;31;3;28;.903;3556000;0
16077;12406;551;0;0;0;0;.00nan;0;0
16077;59933;551;65;16;1;15;.938;3600000;0
16078;483;2190;0;0;0;0;.00nan;0;0
16078;167061;2190;99;29;0;29;1.000;3600000;0
16078;6389;545;0;0;0;0;.00nan;0;0
16078;158979;545;81;33;2;31;.939;3536000;0
16079;193222;548;0;0;0;0;.00nan;0;0
16079;162979;548;58;24;3;21;.875;3600000;0
16079;71660;546;63;33;4;29;.879;3547000;0
16079;150187;546;0;0;0;0;.00nan;0;0
16080;147;543;97;19;0;19;1.000;3600000;0
16080;-1;550;0;0;0;0;.00nan;0;0
16080;73939;543;0;0;0;0;.00nan;0;0
16080;150203;550;95;41;2;39;.951;3540000;0
16081;483;2190;64;19;1;18;.947;3810000;0
16081;167061;2190;0;0;0;0;.00nan;0;0
16081;-1;550;0;0;0;0;.00nan;0;0
16081;150203;550;86;46;2;44;.957;3810000;0
16082;147;543;0;0;0;0;.00nan;0;0
16082;-1;547;87;54;4;50;.926;3600000;0
16082;73792;547;0;0;0;0;.00nan;0;0
16082;73939;543;77;25;2;23;.920;3600000;0
16083;193222;548;0;0;0;0;.00nan;0;0
16083;162979;548;55;28;3;25;.893;3545000;0
16083;6389;545;97;34;1;33;.971;3600000;0
16083;158979;545;0;0;0;0;.00nan;0;0
16084;12406;551;64;18;1;17;.944;3600000;0
16084;59933;551;0;0;0;0;.00nan;0;0
16084;72108;549;0;0;0;0;.00nan;0;0
16084;150345;549;98;44;2;42;.955;3562000;0
16085;-1;547;70;34;3;31;.912;3600000;0
16085;71660;546;85;29;2;27;.931;3600000;0
16085;73792;547;0;0;0;0;.00nan;0;0
16085;150187;546;0;0;0;0;.00nan;0;0
16086;193222;548;0;0;0;0;.00nan;0;0
16086;162979;548;81;39;3;36;.923;3514000;0
16086;-1;550;0;0;0;0;.00nan;0;0
16086;150203;550;92;40;1;39;.975;3600000;0
16087;483;2190;54;16;2;14;.875;3600000;0
16087;167061;2190;0;0;0;0;.00nan;0;0
16087;72108;549;0;0;0;0;.00nan;0;0
16087;150345;549;62;27;3;24;.889;3550000;0
16088;6389;545;52;28;4;24;.857;3541000;0
16088;12406;551;0;0;0;0;.00nan;0;0
16088;59933;551;71;37;3;34;.919;3600000;0
16088;158979;545;0;0;0;0;.00nan;0;0
16089;6389;545;70;21;1;20;.952;3600000;0
16089;72108;549;0;0;0;0;.00nan;0;0
16089;150345;549;78;43;4;39;.907;3600000;0
16089;158979;545;0;0;0;0;.00nan;0;0
16090;483;2190;73;28;2;26;.929;3600000;0
16090;167061;2190;0;0;0;0;.00nan;0;0
16090;-1;547;60;41;5;36;.878;3600000;0
16090;73792;547;0;0;0;0;.00nan;0;0
16091;147;543;0;0;0;0;.00nan;0;0
16091;71660;546;37;21;4;17;.810;1813000;0
16091;73939;543;82;37;3;34;.919;3600000;0
16091;150187;546;62;19;2;17;.895;1787000;0
16092;12406;551;0;0;0;0;.00nan;0;0
16092;-1;550;53;42;5;37;.881;3600000;0
16092;59933;551;72;25;2;23;.920;3600000;0
16092;150203;550;0;0;0;0;.00nan;0;0
16093;-1;547;0;0;0;0;.00nan;0;0
16093;72108;549;0;0;0;0;.00nan;0;0
16093;73792;547;100;44;0;44;1.000;3600000;0
16093;150345;549;50;30;4;26;.867;3600000;0
16094;-1;550;0;0;0;0;.00nan;0;0
16094;71660;546;82;41;3;38;.927;3900000;0
16094;150187;546;0;0;0;0;.00nan;0;0
16094;150203;550;60;28;3;25;.893;3900000;0
16095;483;2190;0;0;0;0;.00nan;0;0
16095;167061;2190;62;23;3;20;.870;3784000;0
16095;193222;548;0;0;0;0;.00nan;0;0
16095;162979;548;100;42;2;40;.952;3784000;0
16096;-1;550;0;0;0;0;.00nan;0;0
16096;-1;547;0;0;0;0;.00nan;0;0
16096;73792;547;45;20;3;17;.850;3600000;0
16096;150203;550;100;36;0;36;1.000;3600000;0
16097;193222;548;0;0;0;0;.00nan;0;0
16097;162979;548;83;36;3;33;.917;3900000;0
16097;72108;549;0;0;0;0;.00nan;0;0
16097;150345;549;75;30;3;27;.900;3900000;0
16098;147;543;88;35;2;33;.943;3545000;0
16098;6389;545;83;28;1;27;.964;3600000;0
16098;73939;543;0;0;0;0;.00nan;0;0
16098;158979;545;0;0;0;0;.00nan;0;0
16099;12406;551;0;0;0;0;.00nan;0;0
16099;59933;551;55;20;3;17;.850;3600000;0
16099;71660;546;0;0;0;0;.00nan;0;0
16099;150187;546;51;34;4;30;.882;3586000;0
16100;-1;550;0;0;0;0;.00nan;0;0
16100;72108;549;45;35;6;29;.829;2845000;0
16100;150203;550;51;19;3;16;.842;3600000;0
16100;150345;549;56;4;0;4;1.000;755000;0
16101;147;543;64;23;2;21;.913;3600000;0
16101;-1;547;26;10;4;6;.600;974000;0
16101;73792;547;65;20;1;19;.950;2626000;0
16101;73939;543;0;0;0;0;.00nan;0;0
16102;6389;545;62;20;2;18;.900;3600000;0
16102;12406;551;0;0;0;0;.00nan;0;0
16102;59933;551;56;40;6;34;.850;3600000;0
16102;158979;545;0;0;0;0;.00nan;0;0
16103;147;543;52;29;4;25;.862;3645000;0
16103;-1;550;49;32;5;27;.844;3645000;0
16103;73939;543;0;0;0;0;.00nan;0;0
16103;150203;550;0;0;0;0;.00nan;0;0
16104;483;2190;0;0;0;0;.00nan;0;0
16104;167061;2190;83;25;1;24;.960;3600000;0
16104;72108;549;56;5;0;5;1.000;284000;0
16104;150345;549;40;52;8;44;.846;3316000;0
16105;193222;548;0;0;0;0;.00nan;0;0
16105;162979;548;76;23;1;22;.957;3600000;0
16105;71660;546;75;24;2;22;.917;3600000;0
16105;150187;546;0;0;0;0;.00nan;0;0
16106;483;2190;53;26;4;22;.846;3900000;0
16106;167061;2190;0;0;0;0;.00nan;0;0
16106;-1;547;0;0;0;0;.00nan;0;0
16106;73792;547;74;39;4;35;.897;3900000;0
16107;12406;551;0;0;0;0;.00nan;0;0
16107;59933;551;40;29;5;24;.828;3600000;0
16107;72108;549;0;0;0;0;.00nan;0;0
16107;150345;549;90;31;1;30;.968;3600000;0
16108;6389;545;0;0;0;0;.00nan;0;0
16108;-1;550;0;0;0;0;.00nan;0;0
16108;150203;550;87;30;1;29;.967;3600000;0
16108;158979;545;58;21;2;19;.905;3583000;0
16109;147;543;60;27;3;24;.889;3600000;0
16109;193222;548;0;0;0;0;.00nan;0;0
16109;162979;548;100;44;0;44;1.000;3600000;0
16109;73939;543;0;0;0;0;.00nan;0;0
16110;193222;548;0;0;0;0;.00nan;0;0
16110;162979;548;44;20;3;17;.850;3560000;0
16110;-1;550;0;0;0;0;.00nan;0;0
16110;150203;550;74;33;2;31;.939;3600000;0
16111;147;543;77;32;3;29;.906;3876000;0
16111;12406;551;100;46;2;44;.957;3876000;0
16111;59933;551;0;0;0;0;.00nan;0;0
16111;73939;543;0;0;0;0;.00nan;0;0
16112;71660;546;66;23;2;21;.913;3600000;0
16112;72108;549;39;1;1;0;.000;377000;0
16112;150187;546;0;0;0;0;.00nan;0;0
16112;150345;549;36;31;6;25;.806;3223000;0
16113;483;2190;53;18;3;15;.833;3574000;0
16113;167061;2190;0;0;0;0;.00nan;0;0
16113;193222;548;0;0;0;0;.00nan;0;0
16113;162979;548;78;37;2;35;.946;3600000;0
16114;6389;545;38;28;5;23;.821;3600000;0
16114;-1;547;0;0;0;0;.00nan;0;0
16114;73792;547;61;26;2;24;.923;3600000;0
16114;158979;545;0;0;0;0;.00nan;0;0
16115;12406;551;0;0;0;0;.00nan;0;0
16115;-1;547;0;0;0;0;.00nan;0;0
16115;59933;551;98;34;1;33;.971;3600000;0
16115;73792;547;68;25;3;22;.880;3594000;0
16116;483;2190;0;0;0;0;.00nan;0;0
16116;167061;2190;67;28;3;25;.893;3553000;0
16116;-1;550;0;0;0;0;.00nan;0;0
16116;150203;550;65;27;2;25;.926;3600000;0
16117;6389;545;49;13;2;11;.846;3600000;0
16117;71660;546;49;29;4;25;.862;3310000;0
16117;150187;546;53;2;0;2;1.000;275000;0
16117;158979;545;0;0;0;0;.00nan;0;0
16118;193222;548;0;0;0;0;.00nan;0;0
16118;162979;548;92;38;2;36;.947;3600000;0
16118;72108;549;0;0;0;0;.00nan;0;0
16118;150345;549;37;21;4;17;.810;3513000;0
16119;147;543;0;0;0;0;.00nan;0;0
16119;12406;551;0;0;0;0;.00nan;0;0
16119;59933;551;47;32;4;28;.875;3600000;0
16119;73939;543;96;60;5;55;.917;3579000;0
16120;-1;547;60;33;4;29;.879;3749000;0
16120;72108;549;59;22;3;19;.864;3749000;0
16120;73792;547;0;0;0;0;.00nan;0;0
16120;150345;549;0;0;0;0;.00nan;0;0
16121;483;2190;31;21;5;16;.762;1894000;0
16121;167061;2190;62;15;1;14;.933;1706000;0
16121;71660;546;77;34;3;31;.912;3600000;0
16121;150187;546;0;0;0;0;.00nan;0;0
16122;193222;548;0;0;0;0;.00nan;0;0
16122;162979;548;86;33;2;31;.939;3559000;0
16122;6389;545;85;15;0;15;1.000;3600000;0
16122;158979;545;0;0;0;0;.00nan;0;0
16123;147;543;63;33;4;29;.879;3600000;0
16123;72108;549;0;0;0;0;.00nan;0;0
16123;73939;543;0;0;0;0;.00nan;0;0
16123;150345;549;54;34;5;29;.853;3564000;0
16124;12406;551;59;36;4;32;.889;3600000;0
16124;59933;551;0;0;0;0;.00nan;0;0
16124;71660;546;24;28;6;22;.786;3514000;0
16124;150187;546;0;0;0;0;.00nan;0;0
16125;-1;550;0;0;0;0;.00nan;0;0
16125;-1;547;0;0;0;0;.00nan;0;0
16125;73792;547;86;38;2;36;.947;3600000;0
16125;150203;550;75;41;4;37;.902;3524000;0
16126;193222;548;0;0;0;0;.00nan;0;0
16126;162979;548;69;35;4;31;.886;3600000;0
16126;-1;547;39;25;5;20;.800;3551000;0
16126;73792;547;0;0;0;0;.00nan;0;0
16127;12406;551;0;0;0;0;.00nan;0;0
16127;-1;550;0;0;0;0;.00nan;0;0
16127;59933;551;50;24;4;20;.833;3582000;0
16127;150203;550;53;23;3;20;.870;3600000;0
16128;483;2190;0;0;0;0;.00nan;0;0
16128;167061;2190;60;25;3;22;.880;3562000;0
16128;6389;545;100;42;1;41;.976;3600000;0
16128;158979;545;0;0;0;0;.00nan;0;0
16129;147;543;0;0;0;0;.00nan;0;0
16129;71660;546;92;30;1;29;.967;3600000;0
16129;73939;543;31;32;6;26;.813;3600000;0
16129;150187;546;0;0;0;0;.00nan;0;0
16130;-1;550;0;0;0;0;.00nan;0;0
16130;72108;549;0;0;0;0;.00nan;0;0
16130;150203;550;82;25;1;24;.960;3600000;0
16130;150345;549;56;31;4;27;.871;3565000;0
16131;147;543;0;0;0;0;.00nan;0;0
16131;6389;545;34;29;5;24;.828;3537000;0
16131;73939;543;87;40;3;37;.925;3600000;0
16131;158979;545;0;0;0;0;.00nan;0;0
16132;483;2190;0;0;0;0;.00nan;0;0
16132;167061;2190;90;33;1;32;.970;3600000;0
16132;12406;551;0;0;0;0;.00nan;0;0
16132;59933;551;97;47;3;44;.936;3582000;0
16133;-1;547;61;6;0;6;1.000;1239000;0
16133;71660;546;72;25;2;23;.920;3600000;0
16133;73792;547;48;31;6;25;.806;2361000;0
16133;150187;546;0;0;0;0;.00nan;0;0
16134;6389;545;75;31;3;28;.903;3900000;0
16134;72108;549;0;0;0;0;.00nan;0;0
16134;150345;549;84;36;3;33;.917;3900000;0
16134;158979;545;0;0;0;0;.00nan;0;0
16135;147;543;0;0;0;0;.00nan;0;0
16135;483;2190;61;18;2;16;.889;3600000;0
16135;167061;2190;0;0;0;0;.00nan;0;0
16135;73939;543;66;39;4;35;.897;3537000;0
16136;-1;550;0;0;0;0;.00nan;0;0
16136;71660;546;0;0;0;0;.00nan;0;0
16136;150187;546;91;46;2;44;.957;3600000;0
16136;150203;550;39;16;3;13;.813;3564000;0
16137;193222;548;0;0;0;0;.00nan;0;0
16137;162979;548;69;41;5;36;.878;3600000;0
16137;12406;551;68;17;1;16;.941;3600000;0
16137;59933;551;0;0;0;0;.00nan;0;0
16138;6389;545;81;27;1;26;.963;3600000;0
16138;72108;549;0;0;0;0;.00nan;0;0
16138;150345;549;78;41;3;38;.927;3600000;0
16138;158979;545;0;0;0;0;.00nan;0;0
16139;193222;548;0;0;0;0;.00nan;0;0
16139;162979;548;86;38;3;35;.921;3547000;0
16139;12406;551;0;0;0;0;.00nan;0;0
16139;59933;551;65;13;1;12;.923;3600000;0
16140;-1;550;84;26;1;25;.962;3900000;0
16140;71660;546;79;25;1;24;.960;3900000;0
16140;150187;546;0;0;0;0;.00nan;0;0
16140;150203;550;0;0;0;0;.00nan;0;0
16141;147;543;0;0;0;0;.00nan;0;0
16141;483;2190;0;0;0;0;.00nan;0;0
16141;167061;2190;70;23;2;21;.913;3600000;0
16141;73939;543;98;56;4;52;.929;3600000;0
16142;-1;550;0;0;0;0;.00nan;0;0
16142;72108;549;0;0;0;0;.00nan;0;0
16142;150203;550;62;24;3;21;.875;3600000;0
16142;150345;549;42;27;4;23;.852;3547000;0
16143;-1;547;70;36;3;33;.917;3900000;0
16143;71660;546;81;34;3;31;.912;3900000;0
16143;73792;547;0;0;0;0;.00nan;0;0
16143;150187;546;0;0;0;0;.00nan;0;0
16144;483;2190;64;30;3;27;.900;3600000;0
16144;167061;2190;0;0;0;0;.00nan;0;0
16144;193222;548;0;0;0;0;.00nan;0;0
16144;162979;548;48;36;5;31;.861;3575000;0
16145;147;543;0;0;0;0;.00nan;0;0
16145;12406;551;0;0;0;0;.00nan;0;0
16145;59933;551;67;42;5;37;.881;3600000;0
16145;73939;543;84;32;2;30;.938;3600000;0
16146;193222;548;0;0;0;0;.00nan;0;0
16146;162979;548;73;43;4;39;.907;3576000;0
16146;-1;550;0;0;0;0;.00nan;0;0
16146;150203;550;53;23;3;20;.870;3600000;0
16147;6389;545;83;31;2;29;.935;3600000;0
16147;-1;547;95;37;1;36;.973;2937000;0
16147;73792;547;25;12;4;8;.667;663000;0
16147;158979;545;0;0;0;0;.00nan;0;0
16148;147;543;49;23;3;20;.870;3564000;0
16148;71660;546;99;43;1;42;.977;3600000;0
16148;73939;543;0;0;0;0;.00nan;0;0
16148;150187;546;0;0;0;0;.00nan;0;0
16149;483;2190;0;0;0;0;.00nan;0;0
16149;167061;2190;67;17;1;16;.941;3600000;0
16149;-1;550;0;0;0;0;.00nan;0;0
16149;150203;550;76;38;3;35;.921;3524000;0
16150;147;543;0;0;0;0;.00nan;0;0
16150;-1;547;100;43;0;43;1.000;3600000;0
16150;73792;547;0;0;0;0;.00nan;0;0
16150;73939;543;90;27;1;26;.963;3568000;0
16151;193222;548;0;0;0;0;.00nan;0;0
16151;162979;548;94;41;1;40;.976;3900000;0
16151;72108;549;93;33;1;32;.970;3900000;0
16151;150345;549;0;0;0;0;.00nan;0;0
16152;6389;545;0;0;0;0;.00nan;0;0
16152;12406;551;0;0;0;0;.00nan;0;0
16152;59933;551;91;35;2;33;.943;3802000;0
16152;158979;545;61;28;3;25;.893;3802000;0
16153;71660;546;0;0;0;0;.00nan;0;0
16153;72108;549;0;0;0;0;.00nan;0;0
16153;150187;546;67;18;1;17;.944;3600000;0
16153;150345;549;66;29;3;26;.897;3549000;0
16154;193222;548;0;0;0;0;.00nan;0;0
16154;162979;548;52;29;4;25;.862;3554000;0
16154;6389;545;59;16;2;14;.875;3600000;0
16154;158979;545;0;0;0;0;.00nan;0;0
16155;12406;551;71;26;2;24;.923;3600000;0
16155;-1;547;86;46;3;43;.935;3543000;0
16155;59933;551;0;0;0;0;.00nan;0;0
16155;73792;547;0;0;0;0;.00nan;0;0
16156;147;543;0;0;0;0;.00nan;0;0
16156;-1;550;0;0;0;0;.00nan;0;0
16156;73939;543;99;31;1;30;.968;3600000;0
16156;150203;550;67;34;4;30;.882;3600000;0
16157;147;543;73;17;1;16;.941;3600000;0
16157;72108;549;76;18;0;18;1.000;625000;0
16157;73939;543;0;0;0;0;.00nan;0;0
16157;150345;549;38;32;6;26;.813;2975000;0
16158;193222;548;0;0;0;0;.00nan;0;0
16158;162979;548;85;41;2;39;.951;3844000;0
16158;-1;547;89;28;1;27;.964;3844000;0
16158;73792;547;0;0;0;0;.00nan;0;0
16159;483;2190;74;27;1;26;.963;3600000;0
16159;167061;2190;0;0;0;0;.00nan;0;0
16159;6389;545;63;38;4;34;.895;3600000;0
16159;158979;545;0;0;0;0;.00nan;0;0
16160;12406;551;0;0;0;0;.00nan;0;0
16160;-1;550;0;0;0;0;.00nan;0;0
16160;59933;551;97;37;1;36;.973;3900000;0
16160;150203;550;97;37;1;36;.973;3900000;0
16161;6389;545;33;19;4;15;.789;3542000;0
16161;-1;550;100;39;2;37;.949;3600000;0
16161;150203;550;0;0;0;0;.00nan;0;0
16161;158979;545;0;0;0;0;.00nan;0;0
16162;483;2190;79;26;1;25;.962;3600000;0
16162;167061;2190;0;0;0;0;.00nan;0;0
16162;-1;547;94;38;2;36;.947;3572000;0
16162;73792;547;0;0;0;0;.00nan;0;0
16163;12406;551;0;0;0;0;.00nan;0;0
16163;59933;551;97;30;1;29;.967;3797000;0
16163;71660;546;92;42;2;40;.952;3797000;0
16163;150187;546;0;0;0;0;.00nan;0;0
16164;147;543;0;0;0;0;.00nan;0;0
16164;193222;548;0;0;0;0;.00nan;0;0
16164;162979;548;52;39;5;34;.872;3600000;0
16164;73939;543;74;30;2;28;.933;3600000;0
16165;12406;551;60;22;2;20;.909;3600000;0
16165;59933;551;0;0;0;0;.00nan;0;0
16165;72108;549;0;0;0;0;.00nan;0;0
16165;150345;549;61;30;3;27;.900;3545000;0
16166;147;543;0;0;0;0;.00nan;0;0
16166;483;2190;38;33;6;27;.818;3330000;0
16166;167061;2190;52;4;0;4;1.000;270000;0
16166;73939;543;60;42;5;37;.881;3600000;0
16167;193222;548;0;0;0;0;.00nan;0;0
16167;162979;548;59;23;2;21;.913;3900000;0
16167;12406;551;0;0;0;0;.00nan;0;0
16167;59933;551;68;28;2;26;.929;3900000;0
16168;-1;547;0;0;0;0;.00nan;0;0
16168;72108;549;0;0;0;0;.00nan;0;0
16168;73792;547;72;27;3;24;.889;3600000;0
16168;150345;549;67;41;4;37;.902;3600000;0
16169;6389;545;78;40;4;36;.900;3521000;0
16169;71660;546;69;27;2;25;.926;3600000;0
16169;150187;546;0;0;0;0;.00nan;0;0
16169;158979;545;0;0;0;0;.00nan;0;0
16170;483;2190;0;0;0;0;.00nan;0;0
16170;167061;2190;48;19;3;16;.842;3565000;0
16170;12406;551;0;0;0;0;.00nan;0;0
16170;59933;551;78;31;2;29;.935;3600000;0
16171;-1;550;0;0;0;0;.00nan;0;0
16171;-1;547;67;35;4;31;.886;3533000;0
16171;73792;547;0;0;0;0;.00nan;0;0
16171;150203;550;53;14;2;12;.857;3600000;0
16172;483;2190;77;29;2;27;.931;3900000;0
16172;167061;2190;0;0;0;0;.00nan;0;0
16172;72108;549;88;49;2;47;.959;3900000;0
16172;150345;549;0;0;0;0;.00nan;0;0
16173;147;543;0;0;0;0;.00nan;0;0
16173;6389;545;65;24;2;22;.917;3600000;0
16173;73939;543;97;55;5;50;.909;3600000;0
16173;158979;545;0;0;0;0;.00nan;0;0
16174;193222;548;0;0;0;0;.00nan;0;0
16174;162979;548;49;30;4;26;.867;3572000;0
16174;71660;546;78;32;3;29;.906;3600000;0
16174;150187;546;0;0;0;0;.00nan;0;0
16175;147;543;0;0;0;0;.00nan;0;0
16175;483;2190;0;0;0;0;.00nan;0;0
16175;167061;2190;56;37;5;32;.865;3585000;0
16175;73939;543;74;35;3;32;.914;3600000;0
16176;6389;545;93;31;1;30;.968;3900000;0
16176;12406;551;86;24;1;23;.958;3900000;0
16176;59933;551;0;0;0;0;.00nan;0;0
16176;158979;545;0;0;0;0;.00nan;0;0
16177;193222;548;0;0;0;0;.00nan;0;0
16177;162979;548;76;37;5;32;.865;3600000;0
16177;72108;549;0;0;0;0;.00nan;0;0
16177;150345;549;100;41;2;39;.951;3600000;0
16178;147;543;0;0;0;0;.00nan;0;0
16178;12406;551;0;0;0;0;.00nan;0;0
16178;59933;551;74;28;2;26;.929;3600000;0
16178;73939;543;84;38;3;35;.921;3600000;0
16179;6389;545;84;32;2;30;.938;3900000;0
16179;-1;550;0;0;0;0;.00nan;0;0
16179;150203;550;84;34;2;32;.941;3900000;0
16179;158979;545;0;0;0;0;.00nan;0;0
16180;483;2190;79;24;1;23;.958;3600000;0
16180;167061;2190;0;0;0;0;.00nan;0;0
16180;-1;550;98;39;2;37;.949;3543000;0
16180;150203;550;0;0;0;0;.00nan;0;0
16181;193222;548;0;0;0;0;.00nan;0;0
16181;162979;548;76;38;4;34;.895;3600000;0
16181;6389;545;93;26;1;25;.962;3600000;0
16181;158979;545;0;0;0;0;.00nan;0;0
16182;147;543;0;0;0;0;.00nan;0;0
16182;-1;547;80;41;3;38;.927;3600000;0
16182;73792;547;0;0;0;0;.00nan;0;0
16182;73939;543;42;32;5;27;.844;3573000;0
16183;12406;551;0;0;0;0;.00nan;0;0
16183;59933;551;83;27;2;25;.926;3600000;0
16183;71660;546;62;36;5;31;.861;3600000;0
16183;150187;546;0;0;0;0;.00nan;0;0
16184;12406;551;0;0;0;0;.00nan;0;0
16184;59933;551;53;14;2;12;.857;3600000;0
16184;72108;549;0;0;0;0;.00nan;0;0
16184;150345;549;85;43;3;40;.930;3600000;0
16185;-1;550;0;0;0;0;.00nan;0;0
16185;71660;546;0;0;0;0;.00nan;0;0
16185;150187;546;57;32;4;28;.875;3561000;0
16185;150203;550;54;20;3;17;.850;3600000;0
16186;-1;550;0;0;0;0;.00nan;0;0
16186;-1;547;0;0;0;0;.00nan;0;0
16186;73792;547;100;42;1;41;.976;3600000;0
16186;150203;550;39;24;4;20;.833;3600000;0
16187;147;543;0;0;0;0;.00nan;0;0
16187;-1;550;0;0;0;0;.00nan;0;0
16187;73939;543;72;21;2;19;.905;3600000;0
16187;150203;550;54;28;3;25;.893;3544000;0
16188;71660;546;80;29;2;27;.931;3600000;0
16188;72108;549;0;0;0;0;.00nan;0;0
16188;150187;546;0;0;0;0;.00nan;0;0
16188;150345;549;67;34;3;31;.912;3556000;0
16189;483;2190;13;19;6;13;.684;2947000;0
16189;167061;2190;39;2;1;1;.500;945000;0
16189;6389;545;30;36;7;29;.806;3900000;0
16189;158979;545;0;0;0;0;.00nan;0;0
16190;193222;548;98;21;0;21;1.000;3600000;0
16190;162979;548;0;0;0;0;.00nan;0;0
16190;-1;547;51;32;5;27;.844;3600000;0
16190;73792;547;0;0;0;0;.00nan;0;0
16191;71660;546;87;26;1;25;.962;3600000;0
16191;72108;549;0;0;0;0;.00nan;0;0
16191;150187;546;0;0;0;0;.00nan;0;0
16191;150345;549;80;31;2;29;.935;3561000;0
16192;483;2190;24;21;6;15;.714;3687000;0
16192;167061;2190;0;0;0;0;.00nan;0;0
16192;-1;547;0;0;0;0;.00nan;0;0
16192;73792;547;62;53;7;46;.868;3679000;0
16193;193222;548;86;39;2;37;.949;3600000;0
16193;162979;548;0;0;0;0;.00nan;0;0
16193;71660;546;33;38;7;31;.816;3600000;0
16193;150187;546;0;0;0;0;.00nan;0;0
16194;6389;545;80;26;1;25;.962;3600000;0
16194;72108;549;0;0;0;0;.00nan;0;0
16194;150345;549;62;30;3;27;.900;3574000;0
16194;158979;545;0;0;0;0;.00nan;0;0
16195;-1;547;100;25;0;25;1.000;3600000;0
16195;71660;546;77;25;1;24;.960;3600000;0
16195;73792;547;0;0;0;0;.00nan;0;0
16195;150187;546;0;0;0;0;.00nan;0;0
16196;483;2190;0;0;0;0;.00nan;0;0
16196;167061;2190;99;25;0;25;1.000;3600000;0
16196;72108;549;0;0;0;0;.00nan;0;0
16196;150345;549;74;41;4;37;.902;3600000;0
16197;147;543;0;0;0;0;.00nan;0;0
16197;6389;545;42;36;6;30;.833;3600000;0
16197;73939;543;62;15;1;14;.933;3600000;0
16197;158979;545;0;0;0;0;.00nan;0;0
16198;193222;548;0;0;0;0;.00nan;0;0
16198;162979;548;80;37;3;34;.919;3600000;0
16198;12406;551;99;25;0;25;1.000;3600000;0
16198;59933;551;0;0;0;0;.00nan;0;0
16199;12406;551;82;17;0;17;1.000;3600000;0
16199;-1;550;90;30;1;29;.967;3600000;0
16199;59933;551;0;0;0;0;.00nan;0;0
16199;150203;550;0;0;0;0;.00nan;0;0
16200;-1;547;66;34;3;31;.912;3600000;0
16200;72108;549;84;28;2;26;.929;3600000;0
16200;73792;547;0;0;0;0;.00nan;0;0
16200;150345;549;0;0;0;0;.00nan;0;0
16201;6389;545;43;17;3;14;.824;3600000;0
16201;71660;546;57;45;6;39;.867;3600000;0
16201;150187;546;0;0;0;0;.00nan;0;0
16201;158979;545;0;0;0;0;.00nan;0;0
16202;147;543;0;0;0;0;.00nan;0;0
16202;193222;548;0;0;0;0;.00nan;0;0
16202;162979;548;91;40;2;38;.950;3900000;0
16202;73939;543;65;21;2;19;.905;3900000;0
16203;-1;550;61;31;4;27;.871;3600000;0
16203;72108;549;0;0;0;0;.00nan;0;0
16203;150203;550;0;0;0;0;.00nan;0;0
16203;150345;549;86;42;3;39;.929;3600000;0
16204;12406;551;56;23;3;20;.870;3900000;0
16204;-1;547;0;0;0;0;.00nan;0;0
16204;59933;551;0;0;0;0;.00nan;0;0
16204;73792;547;93;50;3;47;.940;3900000;0
16205;483;2190;0;0;0;0;.00nan;0;0
16205;167061;2190;86;21;0;21;1.000;3600000;0
16205;71660;546;0;0;0;0;.00nan;0;0
16205;150187;546;60;41;5;36;.878;3600000;0
16206;147;543;0;0;0;0;.00nan;0;0
16206;193222;548;0;0;0;0;.00nan;0;0
16206;162979;548;98;56;3;53;.946;3600000;0
16206;73939;543;93;23;1;22;.957;3600000;0
16207;-1;550;0;0;0;0;.00nan;0;0
16207;72108;549;97;25;0;25;1.000;3600000;0
16207;150203;550;56;31;3;28;.903;3600000;0
16207;150345;549;0;0;0;0;.00nan;0;0
16208;147;543;0;0;0;0;.00nan;0;0
16208;6389;545;85;30;1;29;.967;3900000;0
16208;73939;543;75;23;1;22;.957;3900000;0
16208;158979;545;0;0;0;0;.00nan;0;0
16209;483;2190;0;0;0;0;.00nan;0;0
16209;167061;2190;62;28;3;25;.893;3766000;0
16209;71660;546;85;44;4;40;.909;3766000;0
16209;150187;546;0;0;0;0;.00nan;0;0
16210;12406;551;0;0;0;0;.00nan;0;0
16210;-1;547;70;43;5;38;.884;3600000;0
16210;59933;551;100;30;0;30;1.000;3600000;0
16210;73792;547;0;0;0;0;.00nan;0;0
16211;147;543;0;0;0;0;.00nan;0;0
16211;71660;546;71;41;5;36;.878;3547000;0
16211;73939;543;57;30;4;26;.867;3600000;0
16211;150187;546;0;0;0;0;.00nan;0;0
16212;147;543;0;0;0;0;.00nan;0;0
16212;72108;549;73;43;5;38;.884;3600000;0
16212;73939;543;48;13;2;11;.846;3600000;0
16212;150345;549;0;0;0;0;.00nan;0;0
16213;6389;545;80;32;2;30;.938;3900000;0
16213;-1;547;0;0;0;0;.00nan;0;0
16213;73792;547;79;33;2;31;.939;3900000;0
16213;158979;545;0;0;0;0;.00nan;0;0
16214;193222;548;0;0;0;0;.00nan;0;0
16214;162979;548;89;29;1;28;.966;3600000;0
16214;-1;550;71;28;2;26;.929;3544000;0
16214;150203;550;0;0;0;0;.00nan;0;0
16215;483;2190;0;0;0;0;.00nan;0;0
16215;167061;2190;62;46;5;41;.891;3587000;0
16215;12406;551;0;0;0;0;.00nan;0;0
16215;59933;551;79;40;3;37;.925;3600000;0
16216;193222;548;0;0;0;0;.00nan;0;0
16216;162979;548;67;29;2;27;.931;3590000;0
16216;-1;550;0;0;0;0;.00nan;0;0
16216;150203;550;73;18;1;17;.944;3600000;0
16217;483;2190;61;22;2;20;.909;3600000;0
16217;167061;2190;0;0;0;0;.00nan;0;0
16217;71660;546;49;43;6;37;.860;3600000;0
16217;150187;546;0;0;0;0;.00nan;0;0
16218;-1;547;70;11;0;11;1.000;1232000;0
16218;72108;549;0;0;0;0;.00nan;0;0
16218;73792;547;44;31;4;27;.871;2368000;0
16218;150345;549;66;32;3;29;.906;3600000;0
16219;6389;545;79;26;2;24;.923;3600000;0
16219;-1;550;0;0;0;0;.00nan;0;0
16219;150203;550;71;31;3;28;.903;3583000;0
16219;158979;545;0;0;0;0;.00nan;0;0
16220;483;2190;0;0;0;0;.00nan;0;0
16220;167061;2190;100;25;0;25;1.000;3600000;0
16220;-1;547;89;40;2;38;.950;3580000;0
16220;73792;547;0;0;0;0;.00nan;0;0
16221;193222;548;0;0;0;0;.00nan;0;0
16221;162979;548;82;26;1;25;.962;3600000;0
16221;72108;549;0;0;0;0;.00nan;0;0
16221;150345;549;87;34;2;32;.941;3580000;0
16222;12406;551;0;0;0;0;.00nan;0;0
16222;59933;551;66;24;3;21;.875;3808000;0
16222;71660;546;90;47;2;45;.957;3808000;0
16222;150187;546;0;0;0;0;.00nan;0;0
16223;147;543;45;35;5;30;.857;3567000;0
16223;-1;550;52;27;3;24;.889;3600000;0
16223;73939;543;0;0;0;0;.00nan;0;0
16223;150203;550;0;0;0;0;.00nan;0;0
16224;6389;545;64;31;3;28;.903;3600000;0
16224;-1;547;55;30;4;26;.867;3548000;0
16224;73792;547;0;0;0;0;.00nan;0;0
16224;158979;545;0;0;0;0;.00nan;0;0
16225;483;2190;61;22;2;20;.909;3600000;0
16225;167061;2190;0;0;0;0;.00nan;0;0
16225;193222;548;0;0;0;0;.00nan;0;0
16225;162979;548;83;47;3;44;.936;3600000;0
16226;147;543;0;0;0;0;.00nan;0;0
16226;12406;551;84;31;2;29;.935;3600000;0
16226;59933;551;0;0;0;0;.00nan;0;0
16226;73939;543;53;25;3;22;.880;3571000;0
16227;6389;545;53;32;4;28;.875;3574000;0
16227;12406;551;0;0;0;0;.00nan;0;0
16227;59933;551;47;19;3;16;.842;3600000;0
16227;158979;545;0;0;0;0;.00nan;0;0
16228;483;2190;0;0;0;0;.00nan;0;0
16228;167061;2190;64;15;1;14;.933;3600000;0
16228;193222;548;0;0;0;0;.00nan;0;0
16228;162979;548;85;49;5;44;.898;3600000;0
16229;147;543;76;30;2;28;.933;3600000;0
16229;71660;546;75;34;4;30;.882;3600000;0
16229;73939;543;0;0;0;0;.00nan;0;0
16229;150187;546;0;0;0;0;.00nan;0;0
16230;-1;550;88;34;1;33;.971;3600000;0
16230;71660;546;57;37;6;31;.838;3600000;0
16230;150187;546;0;0;0;0;.00nan;0;0
16230;150203;550;0;0;0;0;.00nan;0;0
16231;193222;548;0;0;0;0;.00nan;0;0
16231;162979;548;65;17;1;16;.941;3600000;0
16231;-1;547;85;42;3;39;.929;3600000;0
16231;73792;547;0;0;0;0;.00nan;0;0
16232;483;2190;60;26;3;23;.885;3600000;0
16232;167061;2190;0;0;0;0;.00nan;0;0
16232;6389;545;74;47;4;43;.915;3544000;0
16232;158979;545;0;0;0;0;.00nan;0;0
16233;12406;551;0;0;0;0;.00nan;0;0
16233;59933;551;60;20;3;17;.850;3900000;0
16233;72108;549;0;0;0;0;.00nan;0;0
16233;150345;549;91;48;3;45;.938;3900000;0
16234;-1;550;0;0;0;0;.00nan;0;0
16234;-1;547;100;40;0;40;1.000;3600000;0
16234;73792;547;0;0;0;0;.00nan;0;0
16234;150203;550;53;16;2;14;.875;3536000;0
16235;483;2190;0;0;0;0;.00nan;0;0
16235;167061;2190;59;34;4;30;.882;3585000;0
16235;12406;551;0;0;0;0;.00nan;0;0
16235;59933;551;95;39;2;37;.949;3600000;0
16236;6389;545;85;31;2;29;.935;3600000;0
16236;71660;546;0;0;0;0;.00nan;0;0
16236;150187;546;52;31;5;26;.839;3600000;0
16236;158979;545;0;0;0;0;.00nan;0;0
16237;147;543;0;0;0;0;.00nan;0;0
16237;72108;549;0;0;0;0;.00nan;0;0
16237;73939;543;55;26;3;23;.885;3711000;0
16237;150345;549;68;37;4;33;.892;3711000;0
16238;6389;545;66;32;3;29;.906;3791000;0
16238;72108;549;0;0;0;0;.00nan;0;0
16238;150345;549;99;48;2;46;.958;3791000;0
16238;158979;545;0;0;0;0;.00nan;0;0
16239;147;543;0;0;0;0;.00nan;0;0
16239;-1;547;29;20;5;15;.750;3600000;0
16239;73792;547;0;0;0;0;.00nan;0;0
16239;73939;543;90;41;2;39;.951;3600000;0
16240;193222;548;0;0;0;0;.00nan;0;0
16240;162979;548;100;31;1;30;.968;3600000;0
16240;71660;546;81;34;2;32;.941;3600000;0
16240;150187;546;0;0;0;0;.00nan;0;0
16241;12406;551;89;32;1;31;.969;3900000;0
16241;-1;550;0;0;0;0;.00nan;0;0
16241;59933;551;0;0;0;0;.00nan;0;0
16241;150203;550;73;20;1;19;.950;3900000;0
16242;483;2190;60;33;4;29;.879;3578000;0
16242;167061;2190;0;0;0;0;.00nan;0;0
16242;-1;550;0;0;0;0;.00nan;0;0
16242;150203;550;60;28;3;25;.893;3600000;0
16243;-1;547;31;34;6;28;.824;2623000;0
16243;71660;546;64;25;2;23;.920;3600000;0
16243;73792;547;77;16;0;16;1.000;977000;0
16243;150187;546;0;0;0;0;.00nan;0;0
16244;193222;548;0;0;0;0;.00nan;0;0
16244;162979;548;98;34;1;33;.971;3600000;0
16244;6389;545;100;25;0;25;1.000;3600000;0
16244;158979;545;0;0;0;0;.00nan;0;0
16245;12406;551;58;33;5;28;.848;3554000;0
16245;-1;550;67;24;3;21;.875;3600000;0
16245;59933;551;0;0;0;0;.00nan;0;0
16245;150203;550;0;0;0;0;.00nan;0;0
16246;483;2190;72;24;2;22;.917;3600000;0
16246;167061;2190;0;0;0;0;.00nan;0;0
16246;71660;546;29;31;6;25;.806;2771000;0
16246;150187;546;56;6;0;6;1.000;829000;0
16247;147;543;0;0;0;0;.00nan;0;0
16247;-1;547;56;25;3;22;.880;3572000;0
16247;73792;547;0;0;0;0;.00nan;0;0
16247;73939;543;73;24;1;23;.958;3600000;0
16248;193222;548;0;0;0;0;.00nan;0;0
16248;162979;548;64;20;2;18;.900;3555000;0
16248;72108;549;0;0;0;0;.00nan;0;0
16248;150345;549;80;30;1;29;.967;3600000;0
16249;483;2190;0;0;0;0;.00nan;0;0
16249;167061;2190;70;23;1;22;.957;3549000;0
16249;-1;550;0;0;0;0;.00nan;0;0
16249;150203;550;97;27;0;27;1.000;3600000;0
16250;-1;547;0;0;0;0;.00nan;0;0
16250;71660;546;50;29;4;25;.862;3878000;0
16250;73792;547;71;49;5;44;.898;3869000;0
16250;150187;546;0;0;0;0;.00nan;0;0
16251;12406;551;0;0;0;0;.00nan;0;0
16251;59933;551;60;25;3;22;.880;3561000;0
16251;72108;549;99;42;2;40;.952;3600000;0
16251;150345;549;0;0;0;0;.00nan;0;0
16252;147;543;0;0;0;0;.00nan;0;0
16252;6389;545;69;20;2;18;.900;3562000;0
16252;73939;543;94;23;0;23;1.000;3600000;0
16252;158979;545;0;0;0;0;.00nan;0;0
16253;-1;547;75;29;2;27;.931;3600000;0
16253;72108;549;0;0;0;0;.00nan;0;0
16253;73792;547;0;0;0;0;.00nan;0;0
16253;150345;549;48;33;6;27;.818;3600000;0
16254;6389;545;0;0;0;0;.00nan;0;0
16254;-1;550;0;0;0;0;.00nan;0;0
16254;150203;550;90;33;1;32;.970;3600000;0
16254;158979;545;100;28;0;28;1.000;3600000;0
16255;147;543;0;0;0;0;.00nan;0;0
16255;483;2190;51;26;4;22;.846;3745000;0
16255;167061;2190;0;0;0;0;.00nan;0;0
16255;73939;543;74;41;3;38;.927;3745000;0
16256;193222;548;0;0;0;0;.00nan;0;0
16256;162979;548;82;34;2;32;.941;3544000;0
16256;12406;551;98;29;1;28;.966;3600000;0
16256;59933;551;0;0;0;0;.00nan;0;0
16257;-1;550;0;0;0;0;.00nan;0;0
16257;-1;547;55;30;4;26;.867;3538000;0
16257;73792;547;0;0;0;0;.00nan;0;0
16257;150203;550;62;25;2;23;.920;3600000;0
16258;483;2190;0;0;0;0;.00nan;0;0
16258;167061;2190;100;28;0;28;1.000;3600000;0
16258;72108;549;0;0;0;0;.00nan;0;0
16258;150345;549;62;46;6;40;.870;3600000;0
16259;193222;548;83;35;2;33;.943;3600000;0
16259;162979;548;0;0;0;0;.00nan;0;0
16259;71660;546;37;26;5;21;.808;3600000;0
16259;150187;546;0;0;0;0;.00nan;0;0
16260;6389;545;0;0;0;0;.00nan;0;0
16260;12406;551;88;28;1;27;.964;3900000;0
16260;59933;551;0;0;0;0;.00nan;0;0
16260;158979;545;97;34;1;33;.971;3900000;0
16261;-1;550;74;18;1;17;.944;3600000;0
16261;72108;549;0;0;0;0;.00nan;0;0
16261;150203;550;0;0;0;0;.00nan;0;0
16261;150345;549;86;34;2;32;.941;3571000;0
16262;12406;551;71;26;2;24;.923;3600000;0
16262;-1;547;60;38;5;33;.868;3600000;0
16262;59933;551;0;0;0;0;.00nan;0;0
16262;73792;547;0;0;0;0;.00nan;0;0
16263;193222;548;0;0;0;0;.00nan;0;0
16263;162979;548;51;37;5;32;.865;3600000;0
16263;6389;545;13;5;4;1;.200;542000;0
16263;158979;545;70;23;2;21;.913;3018000;0
16264;147;543;0;0;0;0;.00nan;0;0
16264;71660;546;0;0;0;0;.00nan;0;0
16264;73939;543;77;29;2;27;.931;3600000;0
16264;150187;546;95;23;0;23;1.000;3600000;0
16265;483;2190;84;23;1;22;.957;3600000;0
16265;167061;2190;0;0;0;0;.00nan;0;0
16265;72108;549;51;11;1;10;.909;730000;0
16265;150345;549;24;24;6;18;.750;2870000;0
16266;193222;548;0;0;0;0;.00nan;0;0
16266;162979;548;75;30;3;27;.900;3900000;0
16266;-1;547;70;37;3;34;.919;3900000;0
16266;73792;547;0;0;0;0;.00nan;0;0
16267;483;2190;0;0;0;0;.00nan;0;0
16267;167061;2190;49;18;3;15;.833;3585000;0
16267;6389;545;85;25;1;24;.960;3600000;0
16267;158979;545;0;0;0;0;.00nan;0;0
16268;-1;550;0;0;0;0;.00nan;0;0
16268;71660;546;47;7;1;6;.857;974000;0
16268;150187;546;18;18;6;12;.667;2626000;0
16268;150203;550;61;22;2;20;.909;3600000;0
16269;147;543;0;0;0;0;.00nan;0;0
16269;12406;551;39;42;7;35;.833;3600000;0
16269;59933;551;0;0;0;0;.00nan;0;0
16269;73939;543;100;31;0;31;1.000;3600000;0
16270;483;2190;65;26;3;23;.885;3544000;0
16270;167061;2190;0;0;0;0;.00nan;0;0
16270;-1;547;93;45;2;43;.956;3600000;0
16270;73792;547;0;0;0;0;.00nan;0;0
16271;6389;545;74;19;1;18;.947;3600000;0
16271;72108;549;0;0;0;0;.00nan;0;0
16271;150345;549;77;40;3;37;.925;3600000;0
16271;158979;545;0;0;0;0;.00nan;0;0
16272;147;543;0;0;0;0;.00nan;0;0
16272;193222;548;0;0;0;0;.00nan;0;0
16272;162979;548;64;45;5;40;.889;3600000;0
16272;73939;543;46;37;6;31;.838;3555000;0
16273;12406;551;0;0;0;0;.00nan;0;0
16273;59933;551;100;22;0;22;1.000;3600000;0
16273;71660;546;92;29;1;28;.966;3543000;0
16273;150187;546;0;0;0;0;.00nan;0;0
16274;147;543;62;5;0;5;1.000;807000;0
16274;-1;550;86;33;1;32;.970;3600000;0
16274;73939;543;28;25;6;19;.760;2793000;0
16274;150203;550;0;0;0;0;.00nan;0;0
16275;71660;546;98;38;1;37;.974;3545000;0
16275;72108;549;100;26;0;26;1.000;3600000;0
16275;150187;546;0;0;0;0;.00nan;0;0
16275;150345;549;0;0;0;0;.00nan;0;0
16276;6389;545;63;20;2;18;.900;3600000;0
16276;-1;547;69;36;3;33;.917;3543000;0
16276;73792;547;0;0;0;0;.00nan;0;0
16276;158979;545;0;0;0;0;.00nan;0;0
16277;483;2190;0;0;0;0;.00nan;0;0
16277;167061;2190;68;29;2;27;.931;3812000;0
16277;193222;548;0;0;0;0;.00nan;0;0
16277;162979;548;85;38;3;35;.921;3812000;0
16283;12406;551;0;0;0;0;.00nan;0;0
16283;59933;551;85;23;1;22;.957;3600000;0
16283;72108;549;0;0;0;0;.00nan;0;0
16283;150345;549;80;42;3;39;.929;3576000;0
16285;6389;545;39;23;4;19;.826;3546000;0
16285;67683;545;0;0;0;0;.00nan;0;0
16285;71660;546;71;35;3;32;.914;3600000;0
16285;150187;546;0;0;0;0;.00nan;0;0
16287;147;543;65;20;2;18;.900;3600000;0
16287;193222;548;0;0;0;0;.00nan;0;0
16287;162979;548;98;48;3;45;.938;3600000;0
16287;73939;543;0;0;0;0;.00nan;0;0
16289;-1;550;78;21;1;20;.952;3600000;0
16289;64368;547;0;0;0;0;.00nan;0;0
16289;150203;550;0;0;0;0;.00nan;0;0
16289;158979;547;85;38;2;36;.947;3544000;0
16291;193222;548;0;0;0;0;.00nan;0;0
16291;162979;548;85;34;2;32;.941;3600000;0
16291;64368;547;0;0;0;0;.00nan;0;0
16291;158979;547;63;30;3;27;.900;3554000;0
16293;147;543;100;28;0;28;1.000;3600000;0
16293;-1;550;0;0;0;0;.00nan;0;0
16293;73939;543;0;0;0;0;.00nan;0;0
16293;150203;550;20;31;7;24;.774;3600000;0
16295;483;2190;66;21;2;19;.905;3600000;0
16295;167061;2190;0;0;0;0;.00nan;0;0
16295;6389;545;48;42;5;37;.881;3600000;0
16295;67683;545;0;0;0;0;.00nan;0;0
16297;71660;546;35;41;7;34;.829;3559000;0
16297;72108;549;0;0;0;0;.00nan;0;0
16297;150187;546;0;0;0;0;.00nan;0;0
16297;150345;549;51;36;5;31;.861;3600000;0
16299;483;2190;0;0;0;0;.00nan;0;0
16299;167061;2190;75;25;1;24;.960;3600000;0
16299;64368;547;69;45;4;41;.911;3600000;0
16299;158979;547;0;0;0;0;.00nan;0;0
16301;193222;548;0;0;0;0;.00nan;0;0
16301;162979;548;83;25;0;25;1.000;3900000;0
16301;-1;550;96;20;0;20;1.000;3900000;0
16301;150203;550;0;0;0;0;.00nan;0;0
16303;147;543;0;0;0;0;.00nan;0;0
16303;71660;546;18;11;4;7;.636;855000;0
16303;73939;543;60;21;2;19;.905;3600000;0
16303;150187;546;26;31;6;25;.806;2745000;0
16305;6389;545;0;0;0;0;.00nan;0;0
16305;67683;545;48;20;3;17;.850;3546000;0
16305;72108;549;0;0;0;0;.00nan;0;0
16305;150345;549;82;30;1;29;.967;3600000;0
16307;193222;548;0;0;0;0;.00nan;0;0
16307;162979;548;68;30;3;27;.900;3600000;0
16307;72108;549;0;0;0;0;.00nan;0;0
16307;150345;549;50;29;5;24;.828;3573000;0
16309;12406;551;0;0;0;0;.00nan;0;0
16309;59933;551;83;12;0;12;1.000;3600000;0
16309;64368;547;0;0;0;0;.00nan;0;0
16309;158979;547;68;41;4;37;.902;3600000;0
16311;-1;550;45;29;4;25;.862;3564000;0
16311;71660;546;76;36;3;33;.917;3600000;0
16311;150187;546;0;0;0;0;.00nan;0;0
16311;150203;550;0;0;0;0;.00nan;0;0
16313;147;543;57;21;2;19;.905;3600000;0
16313;6389;545;67;38;3;35;.921;3600000;0
16313;67683;545;0;0;0;0;.00nan;0;0
16313;73939;543;0;0;0;0;.00nan;0;0
16315;12406;551;0;0;0;0;.00nan;0;0
16315;59933;551;88;29;1;28;.966;3600000;0
16315;64368;547;37;36;6;30;.833;3600000;0
16315;158979;547;0;0;0;0;.00nan;0;0
16317;147;543;0;0;0;0;.00nan;0;0
16317;6389;545;0;0;0;0;.00nan;0;0
16317;67683;545;79;39;3;36;.923;3544000;0
16317;73939;543;87;37;2;35;.946;3600000;0
16319;483;2190;70;21;1;20;.952;3600000;0
16319;167061;2190;0;0;0;0;.00nan;0;0
16319;-1;550;72;12;0;12;1.000;543000;0
16319;150203;550;31;38;7;31;.816;3057000;0
16321;71660;546;64;26;2;24;.923;3600000;0
16321;72108;549;79;35;3;32;.914;3553000;0
16321;150187;546;0;0;0;0;.00nan;0;0
16321;150345;549;0;0;0;0;.00nan;0;0
16323;64368;547;0;0;0;0;.00nan;0;0
16323;72108;549;0;0;0;0;.00nan;0;0
16323;150345;549;54;31;4;27;.871;3548000;0
16323;158979;547;88;46;3;43;.935;3600000;0
16325;12406;551;53;19;2;17;.895;3852000;0
16325;59933;551;0;0;0;0;.00nan;0;0
16325;71660;546;93;50;3;47;.940;3852000;0
16325;150187;546;0;0;0;0;.00nan;0;0
16327;483;2190;39;21;5;16;.762;3600000;0
16327;167061;2190;0;0;0;0;.00nan;0;0
16327;-1;550;100;25;0;25;1.000;3600000;0
16327;150203;550;0;0;0;0;.00nan;0;0
16329;147;543;69;27;2;25;.926;3600000;0
16329;6389;545;60;42;5;37;.881;3600000;0
16329;67683;545;0;0;0;0;.00nan;0;0
16329;73939;543;0;0;0;0;.00nan;0;0
16331;483;2190;0;0;0;0;.00nan;0;0
16331;167061;2190;92;18;0;18;1.000;3600000;0
16331;12406;551;0;0;0;0;.00nan;0;0
16331;59933;551;64;35;3;32;.914;3600000;0
16333;6389;545;0;0;0;0;.00nan;0;0
16333;64368;547;79;42;4;38;.905;3600000;0
16333;67683;545;45;32;5;27;.844;3534000;0
16333;158979;547;0;0;0;0;.00nan;0;0
16335;193222;548;0;0;0;0;.00nan;0;0
16335;162979;548;25;13;4;9;.692;3600000;0
16335;71660;546;0;0;0;0;.00nan;0;0
16335;150187;546;91;49;1;48;.980;3600000;0
16337;147;543;0;0;0;0;.00nan;0;0
16337;72108;549;67;43;5;38;.884;3600000;0
16337;73939;543;81;28;1;27;.964;3600000;0
16337;150345;549;0;0;0;0;.00nan;0;0
16338;188428;460;45;11;2;9;.818;1582000;0
16338;168066;460;18;23;6;17;.739;2018000;0
16338;15564;452;49;37;5;32;.865;3600000;0
16338;92283;452;0;0;0;0;.00nan;0;0
16339;172079;1086;55;26;3;23;.885;3600000;0
16339;15564;452;35;35;6;29;.829;3600000;0
16339;22349;1086;0;0;0;0;.00nan;0;0
16339;92283;452;0;0;0;0;.00nan;0;0
16340;198243;459;0;0;0;0;.00nan;0;0
16340;9216;2579;0;0;0;0;.00nan;0;0
16340;188429;459;43;22;4;18;.818;3600000;0
16340;15558;2579;31;28;6;22;.786;3516000;0
16341;161695;4337;0;0;0;0;.00nan;0;0
16341;166839;4337;88;32;2;30;.938;3600000;0
16341;10422;457;0;0;0;0;.00nan;0;0
16341;53830;457;62;34;4;30;.882;3562000;0
16342;2153;455;0;0;0;0;.00nan;0;0
16342;182561;456;38;35;7;28;.800;3600000;0
16342;203466;456;0;0;0;0;.00nan;0;0
16342;75464;455;66;29;3;26;.897;3600000;0
16343;167492;458;65;38;4;34;.895;3600000;0
16343;9216;2579;0;0;0;0;.00nan;0;0
16343;10565;458;0;0;0;0;.00nan;0;0
16343;15558;2579;4;22;7;15;.682;3600000;0
16344;2153;455;0;0;0;0;.00nan;0;0
16344;188428;460;0;0;0;0;.00nan;0;0
16344;168066;460;71;29;2;27;.931;3600000;0
16344;75464;455;51;26;3;23;.885;3546000;0
16345;208725;460;48;0;0;0;.00nan;274000;0
16345;188428;460;7;39;9;30;.769;3326000;0
16345;15564;452;50;15;2;13;.867;3600000;0
16345;92283;452;0;0;0;0;.00nan;0;0
16346;161695;4337;70;30;2;28;.933;3600000;0
16346;166839;4337;0;0;0;0;.00nan;0;0
16346;203466;456;9;16;6;10;.625;2084000;0
16346;188431;456;50;21;3;18;.857;1516000;0
16347;208725;460;0;0;0;0;.00nan;0;0
16347;188428;460;75;43;4;39;.907;3600000;0
16347;15564;452;64;8;0;8;1.000;1795000;0
16347;92283;452;36;22;5;17;.773;1784000;0
16348;2153;455;46;24;4;20;.833;3600000;0
16348;172079;1086;0;0;0;0;.00nan;0;0
16348;187263;1086;57;39;6;33;.846;3600000;0
16348;75464;455;0;0;0;0;.00nan;0;0
16349;198243;459;0;0;0;0;.00nan;0;0
16349;188429;459;69;20;2;18;.900;3600000;0
16349;10422;457;0;0;0;0;.00nan;0;0
16349;53830;457;36;26;5;21;.808;3600000;0
16350;167492;458;61;22;3;19;.864;3600000;0
16350;10422;457;0;0;0;0;.00nan;0;0
16350;10565;458;0;0;0;0;.00nan;0;0
16350;53830;457;44;22;4;18;.818;3568000;0
16351;203466;456;0;0;0;0;.00nan;0;0
16351;172079;1086;0;0;0;0;.00nan;0;0
16351;188431;456;50;38;5;33;.868;3565000;0
16351;187263;1086;55;30;4;26;.867;3600000;0
16352;161695;4337;88;43;3;40;.930;3600000;0
16352;166839;4337;0;0;0;0;.00nan;0;0
16352;15564;452;35;25;5;20;.800;3594000;0
16352;92283;452;0;0;0;0;.00nan;0;0
16353;198243;459;0;0;0;0;.00nan;0;0
16353;167492;458;46;41;6;35;.854;3600000;0
16353;188429;459;73;25;2;23;.920;3600000;0
16353;10565;458;0;0;0;0;.00nan;0;0
16354;161695;4337;88;45;3;42;.933;3600000;0
16354;166839;4337;0;0;0;0;.00nan;0;0
16354;15564;452;0;0;0;0;.00nan;0;0
16354;92283;452;30;28;6;22;.786;3600000;0
16355;198243;459;59;33;4;29;.879;3600000;0
16355;172079;1086;0;0;0;0;.00nan;0;0
16355;188429;459;0;0;0;0;.00nan;0;0
16355;187263;1086;63;17;1;16;.941;3600000;0
16356;208725;460;50;1;0;1;1.000;574000;0
16356;188428;460;8;28;7;21;.750;3026000;0
16356;10422;457;0;0;0;0;.00nan;0;0
16356;53830;457;43;18;3;15;.833;3600000;0
16357;203466;456;50;35;5;30;.857;3588000;0
16357;9216;2579;44;24;4;20;.833;3600000;0
16357;188431;456;0;0;0;0;.00nan;0;0
16357;15558;2579;0;0;0;0;.00nan;0;0
16358;172079;1086;84;29;2;27;.931;3600000;0
16358;167492;458;52;23;3;20;.870;3542000;0
16358;10565;458;0;0;0;0;.00nan;0;0
16358;187263;1086;0;0;0;0;.00nan;0;0
16359;161695;4337;31;31;6;25;.806;3577000;0
16359;166839;4337;0;0;0;0;.00nan;0;0
16359;208725;460;48;29;4;25;.862;3600000;0
16359;188428;460;0;0;0;0;.00nan;0;0
16360;2153;455;0;0;0;0;.00nan;0;0
16360;203466;456;79;47;4;43;.915;3560000;0
16360;188431;456;0;0;0;0;.00nan;0;0
16360;75464;455;70;27;2;25;.926;3600000;0
16361;161695;4337;0;0;0;0;.00nan;0;0
16361;166839;4337;53;34;4;30;.882;3514000;0
16361;208725;460;0;0;0;0;.00nan;0;0
16361;188428;460;67;24;2;22;.917;3600000;0
16362;172079;1086;0;0;0;0;.00nan;0;0
16362;9216;2579;51;2;0;2;1.000;477000;0
16362;15558;2579;32;29;6;23;.793;3123000;0
16362;187263;1086;56;24;3;21;.875;3600000;0
16363;9216;2579;89;28;1;27;.964;3600000;0
16363;15558;2579;0;0;0;0;.00nan;0;0
16363;15564;452;79;26;2;24;.923;3566000;0
16363;92283;452;0;0;0;0;.00nan;0;0
16364;167492;458;83;44;4;40;.909;3716000;0
16364;10422;457;0;0;0;0;.00nan;0;0
16364;10565;458;0;0;0;0;.00nan;0;0
16364;53830;457;57;25;3;22;.880;3716000;0
16365;198243;459;0;0;0;0;.00nan;0;0
16365;203466;456;0;0;0;0;.00nan;0;0
16365;188429;459;59;18;3;15;.833;3889000;0
16365;188431;456;57;35;4;31;.886;3889000;0
16366;167492;458;0;0;0;0;.00nan;0;0
16366;10422;457;0;0;0;0;.00nan;0;0
16366;10565;458;12;35;8;27;.771;3600000;0
16366;53830;457;69;16;1;15;.938;3600000;0
16367;2153;455;57;37;5;32;.865;3571000;0
16367;198243;459;62;32;3;29;.906;3600000;0
16367;188429;459;0;0;0;0;.00nan;0;0
16367;75464;455;0;0;0;0;.00nan;0;0
16368;172079;1086;0;0;0;0;.00nan;0;0
16368;15564;452;17;31;7;24;.774;3600000;0
16368;187263;1086;54;32;5;27;.844;3600000;0
16368;92283;452;0;0;0;0;.00nan;0;0
16369;161695;4337;48;34;5;29;.853;3539000;0
16369;2153;455;0;0;0;0;.00nan;0;0
16369;166839;4337;0;0;0;0;.00nan;0;0
16369;75464;455;64;30;3;27;.900;3600000;0
16370;198243;459;0;0;0;0;.00nan;0;0
16370;208725;460;4;21;7;14;.667;3600000;0
16370;188428;460;0;0;0;0;.00nan;0;0
16370;188429;459;64;36;4;32;.889;3600000;0
16371;9216;2579;0;0;0;0;.00nan;0;0
16371;10422;457;0;0;0;0;.00nan;0;0
16371;15558;2579;44;19;3;16;.842;3900000;0
16371;53830;457;49;24;3;21;.875;3868000;0
16372;208725;460;0;0;0;0;.00nan;0;0
16372;167492;458;45;33;5;28;.848;3594000;0
16372;188428;460;43;17;3;14;.824;3600000;0
16372;10565;458;0;0;0;0;.00nan;0;0
16373;203466;456;47;40;5;35;.875;3580000;0
16373;188431;456;0;0;0;0;.00nan;0;0
16373;15564;452;31;16;4;12;.750;3600000;0
16373;92283;452;0;0;0;0;.00nan;0;0
16374;208725;460;44;29;4;25;.862;3600000;0
16374;188428;460;0;0;0;0;.00nan;0;0
16374;10422;457;0;0;0;0;.00nan;0;0
16374;53830;457;21;25;6;19;.760;3521000;0
16375;198243;459;0;0;0;0;.00nan;0;0
16375;203466;456;0;0;0;0;.00nan;0;0
16375;188429;459;28;40;8;32;.800;3600000;0
16375;188431;456;21;43;9;34;.791;3596000;0
16376;9216;2579;18;8;4;4;.500;649000;0
16376;15558;2579;51;32;4;28;.875;2951000;0
16376;15564;452;72;27;1;26;.963;3600000;0
16376;92283;452;0;0;0;0;.00nan;0;0
16377;2153;455;4;20;7;13;.650;2859000;0
16377;180593;1086;53;2;0;2;1.000;305000;0
16377;187263;1086;41;33;6;27;.818;3295000;0
16377;75464;455;43;7;2;5;.714;741000;0
16378;203466;456;41;23;5;18;.783;3524000;0
16378;167492;458;61;39;4;35;.897;3600000;0
16378;188431;456;0;0;0;0;.00nan;0;0
16378;10565;458;0;0;0;0;.00nan;0;0
16379;198243;459;0;0;0;0;.00nan;0;0
16379;167492;458;67;42;6;36;.857;3599000;0
16379;188429;459;42;27;4;23;.852;3600000;0
16379;10565;458;0;0;0;0;.00nan;0;0
16380;161695;4337;34;34;6;28;.824;3600000;0
16380;166839;4337;0;0;0;0;.00nan;0;0
16380;198243;459;0;0;0;0;.00nan;0;0
16380;188429;459;79;26;1;25;.962;3600000;0
16381;203466;456;46;24;4;20;.833;3600000;0
16381;188431;456;0;0;0;0;.00nan;0;0
16381;180593;1086;0;0;0;0;.00nan;0;0
16381;187263;1086;32;23;5;18;.783;3563000;0
16382;167492;458;0;0;0;0;.00nan;0;0
16382;10422;457;0;0;0;0;.00nan;0;0
16382;10565;458;81;42;3;39;.929;3600000;0
16382;53830;457;76;28;2;26;.929;3600000;0
16383;208725;460;65;31;3;28;.903;3600000;0
16383;9216;2579;0;0;0;0;.00nan;0;0
16383;188428;460;0;0;0;0;.00nan;0;0
16383;15558;2579;39;22;4;18;.818;3600000;0
16384;2153;455;0;0;0;0;.00nan;0;0
16384;15564;452;52;26;4;22;.846;3600000;0
16384;75464;455;51;37;5;32;.865;3594000;0
16384;92283;452;0;0;0;0;.00nan;0;0
16385;198243;459;76;33;2;31;.939;3600000;0
16385;188429;459;0;0;0;0;.00nan;0;0
16385;10422;457;0;0;0;0;.00nan;0;0
16385;53830;457;26;31;7;24;.774;3600000;0
16386;208725;460;46;13;2;11;.846;1528000;0
16386;188428;460;14;12;5;7;.583;2072000;0
16386;180593;1086;66;38;4;34;.895;3600000;0
16386;187263;1086;0;0;0;0;.00nan;0;0
16387;2153;455;0;0;0;0;.00nan;0;0
16387;198243;459;76;34;2;32;.941;2489000;0
16387;188429;459;29;14;4;10;.714;1068000;0
16387;75464;455;57;31;4;27;.871;3600000;0
16388;161695;4337;30;36;7;29;.806;3600000;0
16388;166839;4337;0;0;0;0;.00nan;0;0
16388;9216;2579;53;24;3;21;.875;3600000;0
16388;15558;2579;0;0;0;0;.00nan;0;0
16389;10422;457;0;0;0;0;.00nan;0;0
16389;15564;452;87;39;3;36;.923;3600000;0
16389;53830;457;29;18;4;14;.778;3554000;0
16389;92283;452;0;0;0;0;.00nan;0;0
16390;2153;455;80;32;2;30;.938;3600000;0
16390;167492;458;48;30;5;25;.833;3600000;0
16390;10565;458;0;0;0;0;.00nan;0;0
16390;75464;455;0;0;0;0;.00nan;0;0
16391;161695;4337;0;0;0;0;.00nan;0;0
16391;166839;4337;56;31;4;27;.871;3600000;0
16391;203466;456;19;31;7;24;.774;3600000;0
16391;188431;456;0;0;0;0;.00nan;0;0
16392;208725;460;65;32;3;29;.906;3600000;0
16392;188428;460;0;0;0;0;.00nan;0;0
16392;180593;1086;0;0;0;0;.00nan;0;0
16392;187263;1086;49;32;5;27;.844;3523000;0
16393;161695;4337;0;0;0;0;.00nan;0;0
16393;166839;4337;39;40;6;34;.850;3900000;0
16393;15564;452;38;34;6;28;.824;3900000;0
16393;92283;452;0;0;0;0;.00nan;0;0
16394;198243;459;0;0;0;0;.00nan;0;0
16394;208725;460;0;0;0;0;.00nan;0;0
16394;188428;460;50;43;6;37;.860;3600000;0
16394;188429;459;51;31;4;27;.871;3600000;0
16395;167492;458;5;16;7;9;.563;1857000;0
16395;10565;458;53;20;2;18;.900;1743000;0
16395;180593;1086;0;0;0;0;.00nan;0;0
16395;187263;1086;62;23;3;20;.870;3600000;0
16396;9216;2579;0;0;0;0;.00nan;0;0
16396;10422;457;0;0;0;0;.00nan;0;0
16396;15558;2579;62;40;5;35;.875;3600000;0
16396;53830;457;76;18;1;17;.944;3600000;0
16397;167492;458;7;26;8;18;.692;2266000;0
16397;9216;2579;77;26;2;24;.923;3600000;0
16397;10565;458;70;20;1;19;.950;1334000;0
16397;15558;2579;0;0;0;0;.00nan;0;0
16398;203466;456;41;24;4;20;.833;1749000;0
16398;188431;456;52;15;2;13;.867;1851000;0
16398;10422;457;0;0;0;0;.00nan;0;0
16398;53830;457;7;23;8;15;.652;3551000;0
16399;161695;4337;86;30;1;29;.967;3600000;0
16399;166839;4337;0;0;0;0;.00nan;0;0
16399;15564;452;51;21;3;18;.857;3526000;0
16399;92283;452;0;0;0;0;.00nan;0;0
16400;2153;455;0;0;0;0;.00nan;0;0
16400;198243;459;57;33;4;29;.879;3600000;0
16400;188429;459;0;0;0;0;.00nan;0;0
16400;75464;455;39;27;5;22;.815;3589000;0
16401;198243;459;0;0;0;0;.00nan;0;0
16401;188429;459;41;32;5;27;.844;3600000;0
16401;15564;452;0;0;0;0;.00nan;0;0
16401;92283;452;70;32;3;29;.906;3600000;0
16402;161695;4337;80;31;2;29;.935;3556000;0
16402;166839;4337;0;0;0;0;.00nan;0;0
16402;208725;460;0;0;0;0;.00nan;0;0
16402;188428;460;100;25;0;25;1.000;3600000;0
16403;9216;2579;0;0;0;0;.00nan;0;0
16403;15558;2579;30;16;4;12;.750;3600000;0
16403;180593;1086;59;11;1;10;.909;1658000;0
16403;187263;1086;40;27;4;23;.852;1897000;0
16404;2153;455;47;33;5;28;.848;3597000;0
16404;10422;457;0;0;0;0;.00nan;0;0
16404;53830;457;65;31;4;27;.871;3600000;0
16404;75464;455;0;0;0;0;.00nan;0;0
16405;198243;459;0;0;0;0;.00nan;0;0
16405;188429;459;68;27;2;25;.926;3600000;0
16405;180593;1086;77;42;3;39;.929;3540000;0
16405;187263;1086;0;0;0;0;.00nan;0;0
16406;9216;2579;31;25;5;20;.800;3900000;0
16406;15558;2579;0;0;0;0;.00nan;0;0
16406;15564;452;39;25;5;20;.800;3900000;0
16406;92283;452;0;0;0;0;.00nan;0;0
16407;161695;4337;0;0;0;0;.00nan;0;0
16407;166839;4337;68;45;5;40;.889;3624000;0
16407;208725;460;0;0;0;0;.00nan;0;0
16407;188428;460;58;33;4;29;.879;3624000;0
16408;203466;456;0;0;0;0;.00nan;0;0
16408;188431;456;40;28;4;24;.857;3600000;0
16408;10422;457;0;0;0;0;.00nan;0;0
16408;53830;457;37;33;6;27;.818;3554000;0
16409;198243;459;51;24;3;21;.875;3900000;0
16409;167492;458;72;35;3;32;.914;3900000;0
16409;188429;459;0;0;0;0;.00nan;0;0
16409;10565;458;0;0;0;0;.00nan;0;0
16410;203466;456;0;0;0;0;.00nan;0;0
16410;208725;460;48;33;5;28;.848;3693000;0
16410;188428;460;0;0;0;0;.00nan;0;0
16410;188431;456;37;29;6;23;.793;3693000;0
16411;198243;459;0;0;0;0;.00nan;0;0
16411;188429;459;28;34;7;27;.794;3572000;0
16411;15564;452;39;27;5;22;.815;3600000;0
16411;92283;452;0;0;0;0;.00nan;0;0
16412;161695;4337;0;0;0;0;.00nan;0;0
16412;166839;4337;89;34;2;32;.941;3600000;0
16412;9216;2579;0;0;0;0;.00nan;0;0
16412;15558;2579;50;22;4;18;.818;3586000;0
16413;10422;457;42;3;1;2;.667;425000;0
16413;180593;1086;75;34;3;31;.912;3600000;0
16413;187263;1086;0;0;0;0;.00nan;0;0
16413;53830;457;32;28;6;22;.786;3175000;0
16414;167492;458;81;45;4;41;.911;3213000;0
16414;10565;458;55;3;0;3;1.000;387000;0
16414;15564;452;33;19;5;14;.737;3559000;0
16414;92283;452;0;0;0;0;.00nan;0;0
16415;161695;4337;60;39;5;34;.872;3600000;0
16415;2153;455;42;21;4;17;.810;3600000;0
16415;166839;4337;0;0;0;0;.00nan;0;0
16415;75464;455;0;0;0;0;.00nan;0;0
16416;167492;458;100;27;0;27;1.000;3600000;0
16416;10565;458;0;0;0;0;.00nan;0;0
16416;15564;452;65;16;1;15;.938;3574000;0
16416;92283;452;0;0;0;0;.00nan;0;0
16417;161695;4337;0;0;0;0;.00nan;0;0
16417;166839;4337;50;41;6;35;.854;3594000;0
16417;10422;457;0;0;0;0;.00nan;0;0
16417;53830;457;40;20;4;16;.800;3600000;0
16418;208725;460;0;0;0;0;.00nan;0;0
16418;188428;460;51;26;4;22;.846;3600000;0
16418;180593;1086;55;38;5;33;.868;3580000;0
16418;187263;1086;0;0;0;0;.00nan;0;0
16419;2153;455;0;0;0;0;.00nan;0;0
16419;9216;2579;70;28;2;26;.929;3600000;0
16419;15558;2579;0;0;0;0;.00nan;0;0
16419;75464;455;48;29;4;25;.862;3516000;0
16420;198243;459;0;0;0;0;.00nan;0;0
16420;203466;456;49;32;4;28;.875;3760000;0
16420;188429;459;62;36;5;31;.861;3760000;0
16420;188431;456;0;0;0;0;.00nan;0;0
16421;2153;455;53;22;3;19;.864;3600000;0
16421;15564;452;65;38;4;34;.895;3590000;0
16421;75464;455;0;0;0;0;.00nan;0;0
16421;92283;452;0;0;0;0;.00nan;0;0
16422;198243;459;40;31;6;25;.806;3725000;0
16422;9216;2579;0;0;0;0;.00nan;0;0
16422;188429;459;0;0;0;0;.00nan;0;0
16422;15558;2579;32;26;5;21;.808;3725000;0
16423;208725;460;48;14;3;11;.786;3600000;0
16423;188428;460;0;0;0;0;.00nan;0;0
16423;180593;1086;0;0;0;0;.00nan;0;0
16423;187263;1086;71;45;4;41;.911;3560000;0
16424;203466;456;0;0;0;0;.00nan;0;0
16424;167492;458;55;38;5;33;.868;3600000;0
16424;188431;456;44;22;4;18;.818;3600000;0
16424;10565;458;0;0;0;0;.00nan;0;0
16425;208725;460;0;0;0;0;.00nan;0;0
16425;167492;458;26;6;3;3;.500;393000;0
16425;188428;460;34;20;4;16;.800;3600000;0
16425;10565;458;64;29;3;26;.897;3125000;0
16426;161695;4337;62;31;3;28;.903;3559000;0
16426;166839;4337;0;0;0;0;.00nan;0;0
16426;180593;1086;0;0;0;0;.00nan;0;0
16426;187263;1086;69;23;2;21;.913;3600000;0
16427;198243;459;0;0;0;0;.00nan;0;0
16427;188429;459;56;24;3;21;.875;3600000;0
16427;10422;457;0;0;0;0;.00nan;0;0
16427;53830;457;25;13;4;9;.692;3575000;0
16428;2153;455;0;0;0;0;.00nan;0;0
16428;9216;2579;0;0;0;0;.00nan;0;0
16428;15558;2579;17;22;6;16;.727;3600000;0
16428;75464;455;63;34;3;31;.912;3600000;0
16429;161695;4337;0;0;0;0;.00nan;0;0
16429;166839;4337;49;41;6;35;.854;3712000;0
16429;180593;1086;35;40;7;33;.825;3712000;0
16429;187263;1086;0;0;0;0;.00nan;0;0
16430;198243;459;85;42;3;39;.929;3600000;0
16430;188429;459;0;0;0;0;.00nan;0;0
16430;10422;457;0;0;0;0;.00nan;0;0
16430;53830;457;34;23;4;19;.826;3600000;0
16431;2153;455;88;26;1;25;.962;3600000;0
16431;167492;458;78;46;4;42;.913;3600000;0
16431;10565;458;0;0;0;0;.00nan;0;0
16431;75464;455;0;0;0;0;.00nan;0;0
16432;2153;455;0;0;0;0;.00nan;0;0
16432;203466;456;22;4;3;1;.250;357000;0
16432;188431;456;37;33;5;28;.848;3243000;0
16432;75464;455;77;16;0;16;1.000;3600000;0
16433;161695;4337;28;22;6;16;.727;2800000;0
16433;166839;4337;49;6;1;5;.833;800000;0
16433;9216;2579;0;0;0;0;.00nan;0;0
16433;15558;2579;67;28;3;25;.893;3600000;0
16434;10422;457;0;0;0;0;.00nan;0;0
16434;180593;1086;64;42;4;38;.905;3600000;0
16434;187263;1086;0;0;0;0;.00nan;0;0
16434;53830;457;18;30;7;23;.767;3600000;0
16435;203466;456;57;19;2;17;.895;3600000;0
16435;167492;458;67;53;5;48;.906;3600000;0
16435;188431;456;0;0;0;0;.00nan;0;0
16435;10565;458;0;0;0;0;.00nan;0;0
16436;161695;4337;54;4;0;4;1.000;564000;0
16436;166839;4337;43;33;5;28;.848;3036000;0
16436;9216;2579;53;16;2;14;.875;3600000;0
16436;15558;2579;0;0;0;0;.00nan;0;0
16437;2153;455;0;0;0;0;.00nan;0;0
16437;167492;458;70;22;1;21;.955;1331000;0
16437;10565;458;33;22;5;17;.773;2269000;0
16437;75464;455;31;15;4;11;.733;3600000;0
16438;198243;459;0;0;0;0;.00nan;0;0
16438;167492;458;27;37;7;30;.811;3131000;0
16438;188429;459;46;20;3;17;.850;3600000;0
16438;10565;458;55;6;0;6;1.000;469000;0
16439;193005;460;0;0;0;0;.00nan;0;0
16439;9216;2579;0;0;0;0;.00nan;0;0
16439;188428;460;86;39;2;37;.949;3653000;0
16439;15558;2579;51;19;3;16;.842;3653000;0
16440;172079;1086;83;46;4;42;.913;3600000;0
16440;15564;452;7;14;6;8;.571;1967000;0
16440;180593;1086;0;0;0;0;.00nan;0;0
16440;92283;452;47;7;1;6;.857;1633000;0
16441;198243;459;61;23;2;21;.913;3600000;0
16441;183205;456;42;11;2;9;.818;1606000;0
16441;188429;459;0;0;0;0;.00nan;0;0
16441;188431;456;1;21;8;13;.619;1994000;0
16442;2153;455;26;32;8;24;.750;3106000;0
16442;10422;457;0;0;0;0;.00nan;0;0
16442;53830;457;66;27;3;24;.889;3600000;0
16442;75464;455;56;5;0;5;1.000;494000;0
16443;167492;458;55;37;5;32;.865;3243000;0
16443;183205;456;0;0;0;0;.00nan;0;0
16443;188431;456;64;22;2;20;.909;3600000;0
16443;10565;458;51;2;0;2;1.000;357000;0
16444;193005;460;46;40;6;34;.850;2485000;0
16444;9216;2579;67;26;3;23;.885;3600000;0
16444;188428;460;38;7;2;5;.714;1115000;0
16444;15558;2579;0;0;0;0;.00nan;0;0
16445;2153;455;57;18;2;16;.889;1635000;0
16445;10422;457;0;0;0;0;.00nan;0;0
16445;53830;457;18;22;6;16;.727;3600000;0
16445;75464;455;24;31;7;24;.774;1965000;0
16446;10422;457;0;0;0;0;.00nan;0;0
16446;15564;452;63;24;2;22;.917;3600000;0
16446;53830;457;82;33;3;30;.909;3585000;0
16446;92283;452;0;0;0;0;.00nan;0;0
16447;2153;455;72;38;4;34;.895;3549000;0
16447;203466;456;0;0;0;0;.00nan;0;0
16447;188431;456;66;25;2;23;.920;3600000;0
16447;75464;455;0;0;0;0;.00nan;0;0
16448;203466;456;37;31;5;26;.839;3600000;0
16448;188431;456;0;0;0;0;.00nan;0;0
16448;15564;452;0;0;0;0;.00nan;0;0
16448;92283;452;62;24;2;22;.917;3600000;0
16449;161695;4337;51;34;5;29;.853;3546000;0
16449;166839;4337;0;0;0;0;.00nan;0;0
16449;198243;459;0;0;0;0;.00nan;0;0
16449;188429;459;41;23;4;19;.826;3600000;0
16450;172079;1086;61;24;2;22;.917;2402000;0
16450;9216;2579;0;0;0;0;.00nan;0;0
16450;15558;2579;57;26;3;23;.885;3600000;0
16450;180593;1086;26;16;4;12;.750;1198000;0
16451;161695;4337;0;0;0;0;.00nan;0;0
16451;166839;4337;42;29;5;24;.828;3833000;0
16451;167492;458;54;34;4;30;.882;3833000;0
16451;10565;458;0;0;0;0;.00nan;0;0
16452;208725;460;0;0;0;0;.00nan;0;0
16452;9216;2579;37;22;4;18;.818;3600000;0
16452;188428;460;63;45;5;40;.889;3600000;0
16452;15558;2579;0;0;0;0;.00nan;0;0
16453;2153;455;0;0;0;0;.00nan;0;0
16453;10422;457;0;0;0;0;.00nan;0;0
16453;53830;457;63;29;3;26;.897;3600000;0
16453;75464;455;76;32;2;30;.938;3600000;0
16454;208725;460;0;0;0;0;.00nan;0;0
16454;188428;460;63;31;3;28;.903;3600000;0
16454;15564;452;53;32;4;28;.875;3587000;0
16454;92283;452;0;0;0;0;.00nan;0;0
16455;203466;456;36;35;6;29;.829;2481000;0
16455;9216;2579;0;0;0;0;.00nan;0;0
16455;188431;456;72;16;1;15;.938;1078000;0
16455;15558;2579;35;25;5;20;.800;3600000;0
16456;161695;4337;55;37;6;31;.838;3638000;0
16456;166839;4337;0;0;0;0;.00nan;0;0
16456;172079;1086;0;0;0;0;.00nan;0;0
16456;180593;1086;49;30;5;25;.833;3638000;0
16457;9216;2579;61;38;5;33;.868;3600000;0
16457;15558;2579;0;0;0;0;.00nan;0;0
16457;15564;452;0;0;0;0;.00nan;0;0
16457;92283;452;61;31;4;27;.871;3600000;0
16458;2153;455;85;22;1;21;.955;3600000;0
16458;198243;459;0;0;0;0;.00nan;0;0
16458;188429;459;69;38;4;34;.895;3600000;0
16458;75464;455;0;0;0;0;.00nan;0;0
16459;2153;455;25;31;7;24;.774;3600000;0
16459;167492;458;41;25;5;20;.800;3600000;0
16459;10565;458;0;0;0;0;.00nan;0;0
16459;75464;455;0;0;0;0;.00nan;0;0
16460;161695;4337;0;0;0;0;.00nan;0;0
16460;166839;4337;14;25;7;18;.720;3600000;0
16460;172079;1086;77;46;4;42;.913;3600000;0
16460;180593;1086;0;0;0;0;.00nan;0;0
16461;203466;456;0;0;0;0;.00nan;0;0
16461;208725;460;49;21;3;18;.857;3600000;0
16461;188428;460;0;0;0;0;.00nan;0;0
16461;188431;456;33;27;5;22;.815;3561000;0
16462;161695;4337;0;0;0;0;.00nan;0;0
16462;166839;4337;42;17;3;14;.824;3600000;0
16462;167492;458;79;49;4;45;.918;3600000;0
16462;10565;458;0;0;0;0;.00nan;0;0
16463;2153;455;93;24;0;24;1.000;3600000;0
16463;208725;460;33;34;6;28;.824;3600000;0
16463;188428;460;0;0;0;0;.00nan;0;0
16463;75464;455;0;0;0;0;.00nan;0;0
16464;172079;1086;52;33;4;29;.879;3591000;0
16464;15564;452;78;38;3;35;.921;3600000;0
16464;180593;1086;0;0;0;0;.00nan;0;0
16464;92283;452;0;0;0;0;.00nan;0;0
16465;172079;1086;0;0;0;0;.00nan;0;0
16465;9216;2579;0;0;0;0;.00nan;0;0
16465;15558;2579;57;27;4;23;.852;3600000;0
16465;180593;1086;58;43;6;37;.860;3547000;0
16466;203466;456;38;46;8;38;.826;3600000;0
16466;188431;456;0;0;0;0;.00nan;0;0
16466;10422;457;0;0;0;0;.00nan;0;0
16466;53830;457;56;24;3;21;.875;3600000;0
16467;203466;456;0;0;0;0;.00nan;0;0
16467;188431;456;32;31;6;25;.806;3572000;0
16467;10422;457;0;0;0;0;.00nan;0;0
16467;53830;457;43;23;4;19;.826;3600000;0
16469;198243;459;0;0;0;0;.00nan;0;0
16469;188428;460;51;3;0;3;1.000;346000;0
16469;188429;459;48;21;3;18;.857;3600000;0
16469;168066;460;31;43;7;36;.837;3254000;0
16471;182561;456;59;37;4;33;.892;3900000;0
16471;203466;456;0;0;0;0;.00nan;0;0
16471;172079;1086;48;26;4;22;.846;3900000;0
16471;22349;1086;0;0;0;0;.00nan;0;0
16473;9216;2579;18;36;8;28;.778;3600000;0
16473;15558;2579;0;0;0;0;.00nan;0;0
16473;15564;452;56;25;4;21;.840;3600000;0
16473;92283;452;0;0;0;0;.00nan;0;0
16475;2153;455;63;33;3;30;.909;3565000;0
16475;10422;457;0;0;0;0;.00nan;0;0
16475;53830;457;98;42;2;40;.952;3600000;0
16475;75464;455;0;0;0;0;.00nan;0;0
16477;161695;4337;47;24;3;21;.875;3600000;0
16477;166839;4337;0;0;0;0;.00nan;0;0
16477;167492;458;6;33;8;25;.758;2706000;0
16477;10565;458;56;7;0;7;1.000;894000;0
16479;198243;459;0;0;0;0;.00nan;0;0
16479;172079;1086;25;41;8;33;.805;3600000;0
16479;188429;459;81;25;1;24;.960;3600000;0
16479;22349;1086;0;0;0;0;.00nan;0;0
16481;161695;4337;0;0;0;0;.00nan;0;0
16481;166839;4337;81;43;3;40;.930;3600000;0
16481;167492;458;58;18;2;16;.889;3600000;0
16481;10565;458;0;0;0;0;.00nan;0;0
16483;9216;2579;52;1;0;1;1.000;674000;0
16483;15558;2579;21;26;6;20;.769;2926000;0
16483;15564;452;20;26;6;20;.769;2309000;0
16483;92283;452;61;13;1;12;.923;1291000;0
16485;2153;455;0;0;0;0;.00nan;0;0
16485;10422;457;0;0;0;0;.00nan;0;0
16485;53830;457;70;39;4;35;.897;3900000;0
16485;75464;455;55;32;4;28;.875;3900000;0
16487;182561;456;77;34;3;31;.912;3600000;0
16487;203466;456;0;0;0;0;.00nan;0;0
16487;188428;460;72;16;1;15;.938;2485000;0
16487;168066;460;31;21;4;17;.810;1103000;0
16489;9216;2579;36;24;5;19;.792;3600000;0
16489;10422;457;60;17;1;16;.941;1159000;0
16489;15558;2579;0;0;0;0;.00nan;0;0
16489;53830;457;26;23;5;18;.783;2384000;0
16491;161695;4337;65;24;2;22;.917;3600000;0
16491;166839;4337;0;0;0;0;.00nan;0;0
16491;198243;459;56;28;4;24;.857;3515000;0
16491;188429;459;0;0;0;0;.00nan;0;0
16493;2153;455;69;35;4;31;.886;3801000;0
16493;182561;456;55;17;2;15;.882;3402000;0
16493;203466;456;22;4;3;1;.250;399000;0
16493;75464;455;0;0;0;0;.00nan;0;0
16495;167492;458;0;0;0;0;.00nan;0;0
16495;10565;458;60;37;4;33;.892;3900000;0
16495;15564;452;41;26;4;22;.846;3900000;0
16495;92283;452;0;0;0;0;.00nan;0;0
16497;172079;1086;0;0;0;0;.00nan;0;0
16497;188428;460;0;0;0;0;.00nan;0;0
16497;168066;460;74;30;2;28;.933;3868000;0
16497;22349;1086;71;32;2;30;.938;3900000;0
16499;167492;458;37;30;6;24;.800;2099000;0
16499;9216;2579;63;16;1;15;.938;3600000;0
16499;10565;458;24;18;5;13;.722;1501000;0
16499;15558;2579;0;0;0;0;.00nan;0;0
16501;2153;455;36;29;5;24;.828;3585000;0
16501;198243;459;0;0;0;0;.00nan;0;0
16501;188429;459;45;24;4;20;.833;3600000;0
16501;75464;455;0;0;0;0;.00nan;0;0
16503;161695;4337;39;21;4;17;.810;1681000;0
16503;166839;4337;8;22;7;15;.682;1919000;0
16503;10422;457;0;0;0;0;.00nan;0;0
16503;53830;457;65;24;2;22;.917;3600000;0
16505;182561;456;0;0;0;0;.00nan;0;0
16505;203466;456;13;32;8;24;.750;3600000;0
16505;15564;452;56;27;3;24;.889;3600000;0
16505;92283;452;0;0;0;0;.00nan;0;0
16507;172079;1086;3;22;7;15;.682;3537000;0
16507;188428;460;0;0;0;0;.00nan;0;0
16507;168066;460;23;18;5;13;.722;3600000;0
16507;22349;1086;0;0;0;0;.00nan;0;0
22430;2153;455;0;0;0;0;.00nan;0;0
22430;208725;460;0;0;0;0;.00nan;0;0
22430;188428;460;30;20;5;15;.750;3600000;0
22430;75464;455;50;43;6;37;.860;3600000;0
22431;9216;2579;0;0;0;0;.00nan;0;0
22431;15558;2579;70;26;2;24;.923;3600000;0
22431;15564;452;62;31;3;28;.903;3540000;0
22431;92283;452;0;0;0;0;.00nan;0;0
22469;198243;459;0;0;0;0;.00nan;0;0
22469;208725;460;0;0;0;0;.00nan;0;0
22469;188428;460;34;27;5;22;.815;3600000;0
22469;188429;459;65;33;2;31;.939;3600000;0
22470;172079;1086;75;39;4;35;.897;3600000;0
22470;9216;2579;0;0;0;0;.00nan;0;0
22470;15558;2579;41;31;5;26;.839;3575000;0
22470;22349;1086;0;0;0;0;.00nan;0;0
22549;198243;459;0;0;0;0;.00nan;0;0
22549;172079;1086;30;30;6;24;.800;3600000;0
22549;188429;459;79;25;1;24;.960;3600000;0
22549;22349;1086;0;0;0;0;.00nan;0;0
16508;189333;4998;0;0;0;0;.00nan;0;0
16508;189628;4998;55;37;5;32;.865;3600000;0
16508;189639;4715;68;22;2;20;.909;3600000;0
16508;173918;4715;0;0;0;0;.00nan;0;0
16509;183730;4919;0;0;0;0;.00nan;0;0
16509;171608;4919;79;20;1;19;.950;3600000;0
16509;-1;4992;37;26;5;21;.808;3600000;0
16509;187391;4992;0;0;0;0;.00nan;0;0
16510;189333;4998;46;19;3;16;.842;1564000;0
16510;189628;4998;27;25;6;19;.760;2036000;0
16510;189639;4715;58;21;3;18;.857;3600000;0
16510;173918;4715;0;0;0;0;.00nan;0;0
16511;183730;4919;0;0;0;0;.00nan;0;0
16511;171608;4919;41;27;5;22;.815;3600000;0
16511;-1;4992;50;26;3;23;.885;3186000;0
16511;187391;4992;15;6;4;2;.333;406000;0
16512;4487;4246;66;32;3;29;.906;3514000;0
16512;164987;4714;67;21;1;20;.952;3600000;0
16512;86347;4714;0;0;0;0;.00nan;0;0
16512;161129;4246;0;0;0;0;.00nan;0;0
16513;183730;4919;88;41;2;39;.951;3600000;0
16513;189639;4715;55;25;3;22;.880;3554000;0
16513;173918;4715;0;0;0;0;.00nan;0;0
16513;171608;4919;0;0;0;0;.00nan;0;0
16514;169478;4991;0;0;0;0;.00nan;0;0
16514;-1;165;0;0;0;0;.00nan;0;0
16514;85336;4991;87;33;2;31;.939;3600000;0
16514;146184;165;69;33;3;30;.909;3547000;0
16515;189333;4998;0;0;0;0;.00nan;0;0
16515;189628;4998;59;27;3;24;.889;3572000;0
16515;-1;4992;0;0;0;0;.00nan;0;0
16515;187391;4992;78;33;2;31;.939;3600000;0
16516;4487;4246;54;27;3;24;.889;3571000;0
16516;164987;4714;75;24;2;22;.917;3600000;0
16516;86347;4714;0;0;0;0;.00nan;0;0
16516;161129;4246;0;0;0;0;.00nan;0;0
16517;189333;4998;68;29;4;25;.862;3600000;0
16517;189628;4998;0;0;0;0;.00nan;0;0
16517;-1;4992;63;8;0;8;1.000;416000;0
16517;187391;4992;32;33;6;27;.818;3140000;0
16518;183730;4919;0;0;0;0;.00nan;0;0
16518;189639;4715;0;0;0;0;.00nan;0;0
16518;173918;4715;71;35;3;32;.914;3600000;0
16518;171608;4919;100;27;0;27;1.000;3600000;0
16519;169478;4991;0;0;0;0;.00nan;0;0
16519;-1;165;0;0;0;0;.00nan;0;0
16519;85336;4991;52;29;4;25;.862;3600000;0
16519;146184;165;86;28;1;27;.964;3600000;0
16520;189333;4998;0;0;0;0;.00nan;0;0
16520;189628;4998;80;30;2;28;.933;3600000;0
16520;189639;4715;0;0;0;0;.00nan;0;0
16520;173918;4715;54;24;3;21;.875;3559000;0
16521;187657;4997;0;0;0;0;.00nan;0;0
16521;176206;1368;21;10;4;6;.600;768000;0
16521;87164;1368;33;35;7;28;.800;2832000;0
16521;141850;4997;65;31;3;28;.903;3600000;0
16522;189333;4998;45;45;6;39;.867;3600000;0
16522;189628;4998;0;0;0;0;.00nan;0;0
16522;189639;4715;64;14;1;13;.929;3600000;0
16522;173918;4715;0;0;0;0;.00nan;0;0
16523;164987;4714;0;0;0;0;.00nan;0;0
16523;169478;4991;0;0;0;0;.00nan;0;0
16523;85336;4991;95;34;1;33;.971;3600000;0
16523;86347;4714;55;23;3;20;.870;3562000;0
16524;183730;4919;0;0;0;0;.00nan;0;0
16524;20122;4839;0;0;0;0;.00nan;0;0
16524;171608;4919;83;34;2;32;.941;4200000;0
16524;64925;4839;83;29;2;27;.931;4200000;0
16525;4487;4246;84;46;5;41;.891;3600000;0
16525;-1;165;0;0;0;0;.00nan;0;0
16525;146184;165;59;22;3;19;.864;3600000;0
16525;161129;4246;0;0;0;0;.00nan;0;0
16526;187657;4997;55;5;0;5;1.000;676000;0
16526;176206;1368;0;0;0;0;.00nan;0;0
16526;87164;1368;56;31;4;27;.871;3600000;0
16526;141850;4997;16;29;7;22;.759;2924000;0
16527;4487;4246;0;0;0;0;.00nan;0;0
16527;-1;165;60;33;4;29;.879;3600000;0
16527;146184;165;0;0;0;0;.00nan;0;0
16527;161129;4246;64;26;2;24;.923;3600000;0
16528;183730;4919;72;33;3;30;.909;3600000;0
16528;20122;4839;0;0;0;0;.00nan;0;0
16528;171608;4919;0;0;0;0;.00nan;0;0
16528;64925;4839;41;23;4;19;.826;3550000;0
16529;164987;4714;92;23;0;23;1.000;3600000;0
16529;169478;4991;79;44;3;41;.932;3600000;0
16529;85336;4991;0;0;0;0;.00nan;0;0
16529;86347;4714;0;0;0;0;.00nan;0;0
16530;189639;4715;0;0;0;0;.00nan;0;0
16530;173918;4715;49;41;5;36;.878;3574000;0
16530;-1;4992;0;0;0;0;.00nan;0;0
16530;187391;4992;64;34;3;31;.912;3600000;0
16531;187657;4997;98;22;0;22;1.000;3600000;0
16531;176206;1368;0;0;0;0;.00nan;0;0
16531;87164;1368;69;32;3;29;.906;3600000;0
16531;141850;4997;0;0;0;0;.00nan;0;0
16532;4487;4246;77;35;3;32;.914;3600000;0
16532;189333;4998;0;0;0;0;.00nan;0;0
16532;189628;4998;51;42;6;36;.857;3600000;0
16532;161129;4246;0;0;0;0;.00nan;0;0
16533;20122;4839;50;8;1;7;.875;1089000;0
16533;-1;165;0;0;0;0;.00nan;0;0
16533;64925;4839;40;36;6;30;.833;2511000;0
16533;146184;165;62;26;3;23;.885;3600000;0
16534;183730;4919;62;36;4;32;.889;3659000;0
16534;171608;4919;0;0;0;0;.00nan;0;0
16534;-1;4992;64;36;5;31;.861;3659000;0
16534;187391;4992;0;0;0;0;.00nan;0;0
16535;187657;4997;0;0;0;0;.00nan;0;0
16535;169478;4991;0;0;0;0;.00nan;0;0
16535;85336;4991;51;23;3;20;.870;4200000;0
16535;141850;4997;56;22;3;19;.864;4200000;0
16536;20122;4839;65;40;5;35;.875;3560000;0
16536;-1;165;27;14;4;10;.714;3600000;0
16536;64925;4839;0;0;0;0;.00nan;0;0
16536;146184;165;0;0;0;0;.00nan;0;0
16537;4487;4246;0;0;0;0;.00nan;0;0
16537;189333;4998;61;46;5;41;.891;3600000;0
16537;189628;4998;0;0;0;0;.00nan;0;0
16537;161129;4246;56;19;2;17;.895;3600000;0
16538;183730;4919;0;0;0;0;.00nan;0;0
16538;189639;4715;26;30;6;24;.800;3194000;0
16538;173918;4715;49;1;0;1;1.000;406000;0
16538;171608;4919;57;25;3;22;.880;3600000;0
16539;187657;4997;85;28;1;27;.964;3600000;0
16539;176206;1368;0;0;0;0;.00nan;0;0
16539;87164;1368;69;31;3;28;.903;3528000;0
16539;141850;4997;0;0;0;0;.00nan;0;0
16540;20122;4839;100;47;2;45;.957;3600000;0
16540;189639;4715;57;35;4;31;.886;3548000;0
16540;173918;4715;0;0;0;0;.00nan;0;0
16540;64925;4839;0;0;0;0;.00nan;0;0
16541;189333;4998;0;0;0;0;.00nan;0;0
16541;189628;4998;49;40;5;35;.875;3562000;0
16541;-1;4992;69;30;3;27;.900;3600000;0
16541;187391;4992;0;0;0;0;.00nan;0;0
16542;169478;4991;0;0;0;0;.00nan;0;0
16542;-1;165;0;0;0;0;.00nan;0;0
16542;85336;4991;51;40;6;34;.850;3600000;0
16542;146184;165;70;17;1;16;.941;3600000;0
16543;4487;4246;47;44;6;38;.864;3586000;0
16543;164987;4714;44;29;4;25;.862;3600000;0
16543;86347;4714;0;0;0;0;.00nan;0;0
16543;161129;4246;0;0;0;0;.00nan;0;0
16544;187657;4997;0;0;0;0;.00nan;0;0
16544;176206;1368;32;25;5;20;.800;3600000;0
16544;87164;1368;0;0;0;0;.00nan;0;0
16544;141850;4997;87;23;1;22;.957;3600000;0
16545;4487;4246;0;0;0;0;.00nan;0;0
16545;164987;4714;0;0;0;0;.00nan;0;0
16545;86347;4714;53;34;5;29;.853;4200000;0
16545;161129;4246;82;46;5;41;.891;4200000;0
16546;183730;4919;76;24;1;23;.958;3600000;0
16546;189333;4998;64;42;5;37;.881;3600000;0
16546;189628;4998;0;0;0;0;.00nan;0;0
16546;171608;4919;0;0;0;0;.00nan;0;0
16547;20122;4839;0;0;0;0;.00nan;0;0
16547;189639;4715;0;0;0;0;.00nan;0;0
16547;173918;4715;49;29;5;24;.828;3600000;0
16547;64925;4839;76;32;3;29;.906;3600000;0
16548;169478;4991;59;29;3;26;.897;3600000;0
16548;-1;165;75;39;4;35;.897;3548000;0
16548;85336;4991;0;0;0;0;.00nan;0;0
16548;146184;165;0;0;0;0;.00nan;0;0
16549;189333;4998;20;23;6;17;.739;2641000;0
16549;189628;4998;71;21;1;20;.952;959000;0
16549;189639;4715;67;30;3;27;.900;3600000;0
16549;173918;4715;0;0;0;0;.00nan;0;0
16550;183730;4919;0;0;0;0;.00nan;0;0
16550;171608;4919;60;29;3;26;.897;3560000;0
16550;-1;4992;0;0;0;0;.00nan;0;0
16550;187391;4992;98;41;1;40;.976;3600000;0
16551;169478;4991;0;0;0;0;.00nan;0;0
16551;176206;1368;0;0;0;0;.00nan;0;0
16551;85336;4991;20;23;6;17;.739;3600000;0
16551;87164;1368;74;36;2;34;.944;3600000;0
16552;20122;4839;82;45;3;42;.933;3543000;0
16552;-1;165;0;0;0;0;.00nan;0;0
16552;64925;4839;0;0;0;0;.00nan;0;0
16552;146184;165;84;25;1;24;.960;3600000;0
16553;187657;4997;69;29;3;26;.897;3600000;0
16553;164987;4714;39;24;4;20;.833;3600000;0
16553;86347;4714;0;0;0;0;.00nan;0;0
16553;141850;4997;0;0;0;0;.00nan;0;0
16554;183730;4919;48;26;4;22;.846;3600000;0
16554;189333;4998;0;0;0;0;.00nan;0;0
16554;189628;4998;99;40;1;39;.975;3600000;0
16554;171608;4919;0;0;0;0;.00nan;0;0
16555;20122;4839;51;5;0;5;1.000;615000;0
16555;-1;165;52;31;4;27;.871;3600000;0
16555;64925;4839;40;35;6;29;.829;2985000;0
16555;146184;165;0;0;0;0;.00nan;0;0
16556;189639;4715;0;0;0;0;.00nan;0;0
16556;173918;4715;66;26;3;23;.885;3636000;0
16556;-1;4992;67;26;2;24;.923;3636000;0
16556;187391;4992;0;0;0;0;.00nan;0;0
16557;187657;4997;0;0;0;0;.00nan;0;0
16557;164987;4714;0;0;0;0;.00nan;0;0
16557;86347;4714;68;42;5;37;.881;3631000;0
16557;141850;4997;58;30;4;26;.867;3636000;0
16558;169478;4991;66;21;2;19;.905;3600000;0
16558;176206;1368;59;33;4;29;.879;3516000;0
16558;85336;4991;0;0;0;0;.00nan;0;0
16558;87164;1368;0;0;0;0;.00nan;0;0
16559;183730;4919;0;0;0;0;.00nan;0;0
16559;189639;4715;73;26;2;24;.923;3600000;0
16559;173918;4715;0;0;0;0;.00nan;0;0
16559;171608;4919;49;27;4;23;.852;3539000;0
16560;4487;4246;63;46;6;40;.870;3600000;0
16560;-1;4992;0;0;0;0;.00nan;0;0
16560;187391;4992;61;27;3;24;.889;3600000;0
16560;161129;4246;0;0;0;0;.00nan;0;0
16561;187657;4997;34;17;4;13;.765;1332000;0
16561;169478;4991;0;0;0;0;.00nan;0;0
16561;85336;4991;63;26;4;22;.846;3600000;0
16561;141850;4997;37;31;6;25;.806;2268000;0
16562;4487;4246;100;44;1;43;.977;3600000;0
16562;189333;4998;41;22;4;18;.818;3600000;0
16562;189628;4998;0;0;0;0;.00nan;0;0
16562;161129;4246;0;0;0;0;.00nan;0;0
16563;183730;4919;60;28;4;24;.857;3600000;0
16563;189639;4715;26;28;6;22;.786;3566000;0
16563;173918;4715;0;0;0;0;.00nan;0;0
16563;171608;4919;0;0;0;0;.00nan;0;0
16564;20122;4839;65;20;2;18;.900;3600000;0
16564;176206;1368;80;19;0;19;1.000;2585000;0
16564;64925;4839;0;0;0;0;.00nan;0;0
16564;87164;1368;40;23;4;19;.826;959000;0
16565;164987;4714;52;38;6;32;.842;3600000;0
16565;169478;4991;0;0;0;0;.00nan;0;0
16565;85336;4991;67;31;3;28;.903;3600000;0
16565;86347;4714;0;0;0;0;.00nan;0;0
16566;187657;4997;57;14;1;13;.929;1203000;0
16566;-1;165;0;0;0;0;.00nan;0;0
16566;141850;4997;13;25;7;18;.720;2397000;0
16566;146184;165;81;30;2;28;.933;3600000;0
16567;20122;4839;0;0;0;0;.00nan;0;0
16567;176206;1368;0;0;0;0;.00nan;0;0
16567;64925;4839;100;38;1;37;.974;3600000;0
16567;87164;1368;56;33;5;28;.848;3600000;0
16568;4487;4246;0;0;0;0;.00nan;0;0
16568;189333;4998;65;46;5;41;.891;3600000;0
16568;189628;4998;0;0;0;0;.00nan;0;0
16568;161129;4246;62;26;4;22;.846;3600000;0
16569;183730;4919;0;0;0;0;.00nan;0;0
16569;189639;4715;0;0;0;0;.00nan;0;0
16569;173918;4715;83;36;3;33;.917;3600000;0
16569;171608;4919;64;34;4;30;.882;3553000;0
16570;187657;4997;40;9;2;7;.778;1560000;0
16570;-1;165;42;28;5;23;.821;3600000;0
16570;141850;4997;14;25;7;18;.720;2040000;0
16570;146184;165;0;0;0;0;.00nan;0;0
16571;164987;4714;0;0;0;0;.00nan;0;0
16571;169478;4991;79;38;5;33;.868;3600000;0
16571;85336;4991;0;0;0;0;.00nan;0;0
16571;86347;4714;64;24;2;22;.917;3600000;0
16572;189333;4998;70;44;5;39;.886;3600000;0
16572;189628;4998;0;0;0;0;.00nan;0;0
16572;189639;4715;51;22;3;19;.864;3600000;0
16572;173918;4715;0;0;0;0;.00nan;0;0
16573;176206;1368;56;28;3;25;.893;3029000;0
16573;-1;165;0;0;0;0;.00nan;0;0
16573;87164;1368;27;8;3;5;.625;571000;0
16573;146184;165;73;24;1;23;.958;3600000;0
16574;4487;4246;46;30;5;25;.833;4099000;0
16574;183730;4919;0;0;0;0;.00nan;0;0
16574;171608;4919;64;39;4;35;.897;4099000;0
16574;161129;4246;0;0;0;0;.00nan;0;0
16575;164987;4714;42;28;5;23;.821;3698000;0
16575;20122;4839;48;35;6;29;.829;3669000;0
16575;64925;4839;0;0;0;0;.00nan;0;0
16575;86347;4714;0;0;0;0;.00nan;0;0
16576;187657;4997;0;0;0;0;.00nan;0;0
16576;169478;4991;0;0;0;0;.00nan;0;0
16576;85336;4991;56;31;4;27;.871;3545000;0
16576;141850;4997;90;35;2;33;.943;3600000;0
16577;164987;4714;0;0;0;0;.00nan;0;0
16577;20122;4839;0;0;0;0;.00nan;0;0
16577;64925;4839;44;33;5;28;.848;3585000;0
16577;86347;4714;47;28;4;24;.857;3600000;0
16578;189333;4998;93;42;3;39;.929;4200000;0
16578;189628;4998;0;0;0;0;.00nan;0;0
16578;-1;4992;0;0;0;0;.00nan;0;0
16578;187391;4992;68;32;3;29;.906;4186000;0
16579;176206;1368;0;0;0;0;.00nan;0;0
16579;-1;165;69;22;2;20;.909;3600000;0
16579;87164;1368;47;32;5;27;.844;3600000;0
16579;146184;165;0;0;0;0;.00nan;0;0
16580;4487;4246;37;11;3;8;.727;1156000;0
16580;183730;4919;57;26;3;23;.885;3600000;0
16580;171608;4919;0;0;0;0;.00nan;0;0
16580;161129;4246;24;26;6;20;.769;2444000;0
16581;187657;4997;70;29;2;27;.931;3596000;0
16581;169478;4991;79;22;1;21;.955;3600000;0
16581;85336;4991;0;0;0;0;.00nan;0;0
16581;141850;4997;0;0;0;0;.00nan;0;0
16582;164987;4714;49;31;5;26;.839;3600000;0
16582;20122;4839;98;41;2;39;.951;3600000;0
16582;64925;4839;0;0;0;0;.00nan;0;0
16582;86347;4714;0;0;0;0;.00nan;0;0
16583;4487;4246;55;25;3;22;.880;3600000;0
16583;-1;4992;47;27;4;23;.852;3600000;0
16583;187391;4992;0;0;0;0;.00nan;0;0
16583;161129;4246;0;0;0;0;.00nan;0;0
16584;4487;4246;49;31;5;26;.839;3600000;0
16584;164987;4714;0;0;0;0;.00nan;0;0
16584;86347;4714;68;24;2;22;.917;3600000;0
16584;161129;4246;0;0;0;0;.00nan;0;0
16585;189333;4998;0;0;0;0;.00nan;0;0
16585;189628;4998;76;52;5;47;.904;3550000;0
16585;-1;4992;0;0;0;0;.00nan;0;0
16585;187391;4992;53;27;4;23;.852;3600000;0
16586;169478;4991;0;0;0;0;.00nan;0;0
16586;176206;1368;40;31;5;26;.839;3582000;0
16586;85336;4991;62;26;3;23;.885;3600000;0
16586;87164;1368;0;0;0;0;.00nan;0;0
16587;20122;4839;0;0;0;0;.00nan;0;0
16587;189639;4715;0;0;0;0;.00nan;0;0
16587;173918;4715;16;22;6;16;.727;3600000;0
16587;64925;4839;83;34;2;32;.941;3600000;0
16588;187657;4997;0;0;0;0;.00nan;0;0
16588;-1;165;0;0;0;0;.00nan;0;0
16588;141850;4997;83;33;2;31;.939;3600000;0
16588;146184;165;81;35;3;32;.914;3553000;0
16589;20122;4839;71;37;4;33;.892;3600000;0
16589;189639;4715;38;27;5;22;.815;3573000;0
16589;173918;4715;0;0;0;0;.00nan;0;0
16589;64925;4839;0;0;0;0;.00nan;0;0
16590;4487;4246;74;34;3;31;.912;3600000;0
16590;164987;4714;39;19;4;15;.789;3574000;0
16590;86347;4714;0;0;0;0;.00nan;0;0
16590;161129;4246;0;0;0;0;.00nan;0;0
16591;169478;4991;67;37;4;33;.892;3600000;0
16591;176206;1368;0;0;0;0;.00nan;0;0
16591;85336;4991;0;0;0;0;.00nan;0;0
16591;87164;1368;72;20;1;19;.950;3600000;0
16592;183730;4919;0;0;0;0;.00nan;0;0
16592;171608;4919;62;32;4;28;.875;3600000;0
16592;-1;4992;87;30;1;29;.967;3600000;0
16592;187391;4992;0;0;0;0;.00nan;0;0
16593;187657;4997;24;31;7;24;.774;3600000;0
16593;-1;165;0;0;0;0;.00nan;0;0
16593;141850;4997;0;0;0;0;.00nan;0;0
16593;146184;165;42;19;4;15;.789;3600000;0
16594;187657;4997;0;0;0;0;.00nan;0;0
16594;169478;4991;0;0;0;0;.00nan;0;0
16594;85336;4991;71;23;1;22;.957;3600000;0
16594;141850;4997;41;30;5;25;.833;3600000;0
16595;183730;4919;0;0;0;0;.00nan;0;0
16595;189639;4715;0;0;0;0;.00nan;0;0
16595;173918;4715;75;26;2;24;.923;3600000;0
16595;171608;4919;33;30;5;25;.833;3600000;0
16596;189333;4998;65;49;6;43;.878;3600000;0
16596;189628;4998;0;0;0;0;.00nan;0;0
16596;-1;4992;0;0;0;0;.00nan;0;0
16596;187391;4992;94;20;0;20;1.000;3600000;0
16597;4487;4246;50;38;7;31;.816;3600000;0
16597;20122;4839;0;0;0;0;.00nan;0;0
16597;64925;4839;50;26;4;22;.846;3600000;0
16597;161129;4246;0;0;0;0;.00nan;0;0
16598;169478;4991;100;24;0;24;1.000;3600000;0
16598;176206;1368;0;0;0;0;.00nan;0;0
16598;85336;4991;0;0;0;0;.00nan;0;0
16598;87164;1368;80;31;2;29;.935;3586000;0
16599;187657;4997;72;35;3;32;.914;3600000;0
16599;-1;165;0;0;0;0;.00nan;0;0
16599;141850;4997;0;0;0;0;.00nan;0;0
16599;146184;165;18;26;6;20;.769;3600000;0
16600;164987;4714;0;0;0;0;.00nan;0;0
16600;20122;4839;48;35;6;29;.829;2954000;0
16600;64925;4839;50;8;1;7;.875;646000;0
16600;86347;4714;63;21;2;19;.905;3600000;0
16601;183730;4919;51;22;3;19;.864;3600000;0
16601;189333;4998;0;0;0;0;.00nan;0;0
16601;189628;4998;41;32;6;26;.813;3600000;0
16601;171608;4919;0;0;0;0;.00nan;0;0
16602;189639;4715;76;37;3;34;.919;3600000;0
16602;173918;4715;0;0;0;0;.00nan;0;0
16602;-1;4992;0;0;0;0;.00nan;0;0
16602;187391;4992;33;26;5;21;.808;3586000;0
16603;176206;1368;43;33;5;28;.848;3550000;0
16603;-1;165;57;31;4;27;.871;3600000;0
16603;87164;1368;0;0;0;0;.00nan;0;0
16603;146184;165;0;0;0;0;.00nan;0;0
16604;187657;4997;0;0;0;0;.00nan;0;0
16604;169478;4991;55;35;4;31;.886;3269000;0
16604;85336;4991;51;2;0;2;1.000;276000;0
16604;141850;4997;94;33;2;31;.939;3600000;0
16605;189639;4715;0;0;0;0;.00nan;0;0
16605;173918;4715;76;24;2;22;.917;3600000;0
16605;-1;4992;0;0;0;0;.00nan;0;0
16605;187391;4992;69;36;3;33;.917;3573000;0
16606;20122;4839;57;7;0;7;1.000;552000;0
16606;-1;165;0;0;0;0;.00nan;0;0
16606;64925;4839;44;38;7;31;.816;3048000;0
16606;146184;165;59;13;1;12;.923;3600000;0
16607;164987;4714;49;23;3;20;.870;3522000;0
16607;183730;4919;0;0;0;0;.00nan;0;0
16607;171608;4919;63;15;1;14;.933;3600000;0
16607;86347;4714;0;0;0;0;.00nan;0;0
16608;189333;4998;91;43;3;40;.930;3600000;0
16608;189628;4998;0;0;0;0;.00nan;0;0
16608;91212;4246;0;0;0;0;.00nan;0;0
16608;161129;4246;41;36;7;29;.806;3600000;0
16609;20122;4839;74;36;3;33;.917;3600000;0
16609;176206;1368;54;27;4;23;.852;3555000;0
16609;64925;4839;0;0;0;0;.00nan;0;0
16609;87164;1368;0;0;0;0;.00nan;0;0
16610;189333;4998;48;40;6;34;.850;3172000;0
16610;189628;4998;44;5;1;4;.800;428000;0
16610;91212;4246;79;30;2;28;.933;3600000;0
16610;161129;4246;0;0;0;0;.00nan;0;0
16611;164987;4714;0;0;0;0;.00nan;0;0
16611;183730;4919;79;25;2;23;.920;3600000;0
16611;171608;4919;0;0;0;0;.00nan;0;0
16611;86347;4714;51;26;4;22;.846;3526000;0
16612;189639;4715;62;35;4;31;.886;3546000;0
16612;173918;4715;0;0;0;0;.00nan;0;0
16612;-1;4992;57;26;3;23;.885;3600000;0
16612;187391;4992;0;0;0;0;.00nan;0;0
16613;187657;4997;0;0;0;0;.00nan;0;0
16613;169478;4991;0;0;0;0;.00nan;0;0
16613;85336;4991;29;25;5;20;.800;3551000;0
16613;141850;4997;53;37;4;33;.892;3600000;0
16614;164987;4714;56;23;3;20;.870;3600000;0
16614;86347;4714;0;0;0;0;.00nan;0;0
16614;91212;4246;31;22;6;16;.727;1956000;0
16614;161129;4246;47;27;4;23;.852;1644000;0
16615;189333;4998;0;0;0;0;.00nan;0;0
16615;189628;4998;71;41;4;37;.902;3600000;0
16615;189639;4715;0;0;0;0;.00nan;0;0
16615;173918;4715;57;21;3;18;.857;3600000;0
16616;183730;4919;59;16;1;15;.938;1491000;0
16616;171608;4919;36;19;4;15;.789;2109000;0
16616;-1;4992;0;0;0;0;.00nan;0;0
16616;187391;4992;100;32;1;31;.969;3600000;0
16617;20122;4839;0;0;0;0;.00nan;0;0
16617;176206;1368;33;18;4;14;.778;4094000;0
16617;64925;4839;73;48;5;43;.896;4094000;0
16617;87164;1368;0;0;0;0;.00nan;0;0
16618;187657;4997;0;0;0;0;.00nan;0;0
16618;169478;4991;0;0;0;0;.00nan;0;0
16618;85336;4991;60;22;3;19;.864;3600000;0
16618;141850;4997;53;31;4;27;.871;3569000;0
16619;20122;4839;0;0;0;0;.00nan;0;0
16619;176206;1368;0;0;0;0;.00nan;0;0
16619;64925;4839;93;31;1;30;.968;4200000;0
16619;87164;1368;83;32;1;31;.969;4200000;0
16620;183730;4919;0;0;0;0;.00nan;0;0
16620;189639;4715;28;29;6;23;.793;3577000;0
16620;173918;4715;0;0;0;0;.00nan;0;0
16620;171608;4919;49;27;4;23;.852;3600000;0
16621;164987;4714;0;0;0;0;.00nan;0;0
16621;86347;4714;71;31;4;27;.871;3600000;0
16621;91212;4246;45;30;5;25;.833;3573000;0
16621;161129;4246;0;0;0;0;.00nan;0;0
16622;189333;4998;29;24;6;18;.750;1941000;0
16622;189628;4998;41;19;5;14;.737;1659000;0
16622;-1;4992;96;22;0;22;1.000;3600000;0
16622;187391;4992;0;0;0;0;.00nan;0;0
16623;187657;4997;74;23;1;22;.957;3600000;0
16623;169478;4991;41;26;4;22;.846;3600000;0
16623;85336;4991;0;0;0;0;.00nan;0;0
16623;141850;4997;0;0;0;0;.00nan;0;0
16624;164987;4714;73;44;4;40;.909;4200000;0
16624;86347;4714;0;0;0;0;.00nan;0;0
16624;91212;4246;65;36;4;32;.889;4200000;0
16624;161129;4246;0;0;0;0;.00nan;0;0
16625;20122;4839;41;33;6;27;.818;3600000;0
16625;176206;1368;53;19;2;17;.895;3600000;0
16625;64925;4839;0;0;0;0;.00nan;0;0
16625;87164;1368;0;0;0;0;.00nan;0;0
16626;183730;4919;29;36;8;28;.778;3281000;0
16626;189639;4715;0;0;0;0;.00nan;0;0
16626;173918;4715;48;25;4;21;.840;3600000;0
16626;171608;4919;51;2;0;2;1.000;319000;0
16627;189333;4998;75;35;2;33;.943;3600000;0
16627;189628;4998;0;0;0;0;.00nan;0;0
16627;-1;4992;35;19;4;15;.789;3580000;0
16627;187391;4992;0;0;0;0;.00nan;0;0
16628;164987;4714;0;0;0;0;.00nan;0;0
16628;169478;4991;0;0;0;0;.00nan;0;0
16628;85336;4991;61;19;3;16;.842;3828000;0
16628;86347;4714;80;32;2;30;.938;3828000;0
16629;164987;4714;68;36;4;32;.889;3870000;0
16629;169478;4991;46;32;5;27;.844;3868000;0
16629;85336;4991;0;0;0;0;.00nan;0;0
16629;86347;4714;0;0;0;0;.00nan;0;0
16630;183730;4919;54;27;3;24;.889;3600000;0
16630;189333;4998;0;0;0;0;.00nan;0;0
16630;189628;4998;62;42;5;37;.881;3543000;0
16630;171608;4919;0;0;0;0;.00nan;0;0
16631;-1;4992;0;0;0;0;.00nan;0;0
16631;187391;4992;56;27;3;24;.889;3567000;0
16631;91212;4246;73;27;2;25;.926;3600000;0
16631;161129;4246;0;0;0;0;.00nan;0;0
16632;176206;1368;58;45;6;39;.867;4200000;0
16632;-1;165;62;10;0;10;1.000;1475000;0
16632;87164;1368;0;0;0;0;.00nan;0;0
16632;146184;165;28;27;6;21;.778;2687000;0
16633;164987;4714;89;20;0;20;1.000;3600000;0
16633;20122;4839;0;0;0;0;.00nan;0;0
16633;64925;4839;61;34;4;30;.882;3600000;0
16633;86347;4714;0;0;0;0;.00nan;0;0
16634;187657;4997;0;0;0;0;.00nan;0;0
16634;169478;4991;0;0;0;0;.00nan;0;0
16634;85336;4991;77;26;1;25;.962;3600000;0
16634;141850;4997;56;24;3;21;.875;3534000;0
16635;164987;4714;31;18;4;14;.778;3564000;0
16635;20122;4839;100;41;2;39;.951;3600000;0
16635;64925;4839;0;0;0;0;.00nan;0;0
16635;86347;4714;0;0;0;0;.00nan;0;0
16636;189639;4715;0;0;0;0;.00nan;0;0
16636;173918;4715;69;24;3;21;.875;3600000;0
16636;91212;4246;52;32;5;27;.844;3600000;0
16636;161129;4246;0;0;0;0;.00nan;0;0
16637;176206;1368;42;3;1;2;.667;366000;0
16637;-1;165;0;0;0;0;.00nan;0;0
16637;87164;1368;61;44;6;38;.864;3234000;0
16637;146184;165;74;36;2;34;.944;3600000;0
16638;183730;4919;0;0;0;0;.00nan;0;0
16638;171608;4919;76;39;4;35;.897;3600000;0
16638;-1;4992;90;33;1;32;.970;3600000;0
16638;187391;4992;0;0;0;0;.00nan;0;0
16639;187657;4997;55;32;4;28;.875;3600000;0
16639;169478;4991;49;31;5;26;.839;3584000;0
16639;85336;4991;0;0;0;0;.00nan;0;0
16639;141850;4997;0;0;0;0;.00nan;0;0
16640;169478;4991;0;0;0;0;.00nan;0;0
16640;-1;165;48;34;5;29;.853;3262000;0
16640;85336;4991;100;39;2;37;.949;3600000;0
16640;146184;165;39;1;1;0;.000;338000;0
16641;20122;4839;0;0;0;0;.00nan;0;0
16641;-1;165;0;0;0;0;.00nan;0;0
16641;64925;4839;79;25;2;23;.920;4200000;0
16641;146184;165;68;29;2;27;.931;4200000;0
16642;164987;4714;65;32;3;29;.906;3600000;0
16642;-1;4992;0;0;0;0;.00nan;0;0
16642;187391;4992;41;29;5;24;.828;3553000;0
16642;86347;4714;0;0;0;0;.00nan;0;0
16643;183730;4919;56;24;3;21;.875;3600000;0
16643;189639;4715;48;30;4;26;.867;3556000;0
16643;173918;4715;0;0;0;0;.00nan;0;0
16643;171608;4919;0;0;0;0;.00nan;0;0
16644;-1;165;0;0;0;0;.00nan;0;0
16644;91212;4246;54;32;4;28;.875;3600000;0
16644;146184;165;45;34;6;28;.824;3600000;0
16644;161129;4246;0;0;0;0;.00nan;0;0
16645;189333;4998;31;34;7;27;.794;2871000;0
16645;189628;4998;26;14;4;10;.714;729000;0
16645;176206;1368;63;25;3;22;.880;3600000;0
16645;87164;1368;0;0;0;0;.00nan;0;0
16646;187657;4997;0;0;0;0;.00nan;0;0
16646;169478;4991;0;0;0;0;.00nan;0;0
16646;85336;4991;62;24;3;21;.875;3600000;0
16646;141850;4997;56;40;6;34;.850;3600000;0
16647;164987;4714;0;0;0;0;.00nan;0;0
16647;-1;4992;26;7;3;4;.571;318000;0
16647;187391;4992;86;31;1;30;.968;3229000;0
16647;86347;4714;69;25;3;22;.880;3600000;0
16648;183730;4919;0;0;0;0;.00nan;0;0
16648;189639;4715;0;0;0;0;.00nan;0;0
16648;173918;4715;46;27;4;23;.852;3719000;0
16648;171608;4919;64;42;5;37;.881;3719000;0
16649;-1;165;53;47;7;40;.851;3600000;0
16649;91212;4246;78;25;2;23;.920;3600000;0
16649;146184;165;0;0;0;0;.00nan;0;0
16649;161129;4246;0;0;0;0;.00nan;0;0
16650;189333;4998;0;0;0;0;.00nan;0;0
16650;189628;4998;60;41;5;36;.878;3600000;0
16650;176206;1368;0;0;0;0;.00nan;0;0
16650;87164;1368;65;17;2;15;.882;3600000;0
16651;187657;4997;89;39;3;36;.923;3600000;0
16651;169478;4991;46;48;8;40;.833;3600000;0
16651;85336;4991;0;0;0;0;.00nan;0;0
16651;141850;4997;0;0;0;0;.00nan;0;0
16652;164987;4714;66;20;2;18;.900;3600000;0
16652;-1;4992;68;38;4;34;.895;3569000;0
16652;187391;4992;0;0;0;0;.00nan;0;0
16652;86347;4714;0;0;0;0;.00nan;0;0
16653;183730;4919;0;0;0;0;.00nan;0;0
16653;189639;4715;24;11;4;7;.636;1034000;0
16653;173918;4715;29;18;4;14;.778;2566000;0
16653;171608;4919;58;24;3;21;.875;3600000;0
16654;189333;4998;0;0;0;0;.00nan;0;0
16654;189628;4998;96;40;2;38;.950;3600000;0
16654;-1;4992;0;0;0;0;.00nan;0;0
16654;187391;4992;78;34;3;31;.912;3578000;0
16655;176206;1368;28;27;6;21;.778;1557000;0
16655;-1;165;0;0;0;0;.00nan;0;0
16655;87164;1368;24;12;4;8;.667;2043000;0
16655;146184;165;72;29;2;27;.931;3600000;0
16656;164987;4714;93;33;2;31;.939;3600000;0
16656;65125;4246;0;0;0;0;.00nan;0;0
16656;86347;4714;0;0;0;0;.00nan;0;0
16656;161129;4246;50;27;4;23;.852;3600000;0
16657;20122;4839;79;45;4;41;.911;3600000;0
16657;169478;4991;0;0;0;0;.00nan;0;0
16657;64925;4839;0;0;0;0;.00nan;0;0
16657;85336;4991;60;20;3;17;.850;3600000;0
16658;20122;4839;0;0;0;0;.00nan;0;0
16658;169478;4991;40;24;5;19;.792;3963000;0
16658;64925;4839;43;34;6;28;.824;3963000;0
16658;85336;4991;0;0;0;0;.00nan;0;0
16659;176206;1368;24;26;6;20;.769;3600000;0
16659;-1;165;0;0;0;0;.00nan;0;0
16659;87164;1368;0;0;0;0;.00nan;0;0
16659;146184;165;99;22;0;22;1.000;3600000;0
16660;183730;4919;100;35;0;35;1.000;3600000;0
16660;189639;4715;57;25;3;22;.880;3600000;0
16660;173918;4715;0;0;0;0;.00nan;0;0
16660;171608;4919;0;0;0;0;.00nan;0;0
16661;189333;4998;89;47;5;42;.894;3568000;0
16661;189628;4998;0;0;0;0;.00nan;0;0
16661;-1;4992;46;23;4;19;.826;3600000;0
16661;187391;4992;0;0;0;0;.00nan;0;0
16662;164987;4714;0;0;0;0;.00nan;0;0
16662;65125;4246;62;32;3;29;.906;3563000;0
16662;86347;4714;65;19;2;17;.895;3600000;0
16662;161129;4246;0;0;0;0;.00nan;0;0
16663;164987;4714;87;24;1;23;.958;3600000;0
16663;189333;4998;0;0;0;0;.00nan;0;0
16663;189628;4998;79;40;3;37;.925;3590000;0
16663;86347;4714;0;0;0;0;.00nan;0;0
16664;164987;4714;0;0;0;0;.00nan;0;0
16664;189333;4998;64;33;4;29;.879;2320000;0
16664;189628;4998;30;7;3;4;.571;1280000;0
16664;86347;4714;63;13;1;12;.923;3600000;0
16665;189639;4715;0;0;0;0;.00nan;0;0
16665;173918;4715;67;40;4;36;.900;3600000;0
16665;-1;4992;0;0;0;0;.00nan;0;0
16665;187391;4992;60;26;3;23;.885;3600000;0
16666;-1;165;0;0;0;0;.00nan;0;0
16666;65125;4246;78;36;3;33;.917;3638000;0
16666;146184;165;58;29;4;25;.862;3638000;0
16666;161129;4246;0;0;0;0;.00nan;0;0
16667;187657;4997;0;0;0;0;.00nan;0;0
16667;176206;1368;69;35;3;32;.914;4200000;0
16667;87164;1368;0;0;0;0;.00nan;0;0
16667;141850;4997;77;44;3;41;.932;4200000;0
16668;20122;4839;84;40;3;37;.925;3563000;0
16668;169478;4991;0;0;0;0;.00nan;0;0
16668;64925;4839;0;0;0;0;.00nan;0;0
16668;85336;4991;59;15;1;14;.933;3600000;0
16669;-1;165;0;0;0;0;.00nan;0;0
16669;65125;4246;74;36;3;33;.917;3600000;0
16669;146184;165;34;17;4;13;.765;3574000;0
16669;161129;4246;0;0;0;0;.00nan;0;0
16670;183730;4919;63;35;5;30;.857;3600000;0
16670;171608;4919;0;0;0;0;.00nan;0;0
16670;-1;4992;60;29;4;25;.862;3600000;0
16670;187391;4992;0;0;0;0;.00nan;0;0
16671;189333;4998;87;32;2;30;.938;3600000;0
16671;189628;4998;0;0;0;0;.00nan;0;0
16671;189639;4715;54;26;5;21;.808;3600000;0
16671;173918;4715;0;0;0;0;.00nan;0;0
16672;187657;4997;67;23;2;21;.913;3600000;0
16672;176206;1368;51;13;2;11;.846;751000;0
16672;87164;1368;26;30;7;23;.767;2849000;0
16672;141850;4997;0;0;0;0;.00nan;0;0
16673;20122;4839;0;0;0;0;.00nan;0;0
16673;169478;4991;73;25;2;23;.920;3600000;0
16673;64925;4839;51;34;5;29;.853;3600000;0
16673;85336;4991;0;0;0;0;.00nan;0;0
16674;-1;165;61;26;4;22;.846;3597000;0
16674;65125;4246;71;33;3;30;.909;3600000;0
16674;146184;165;0;0;0;0;.00nan;0;0
16674;161129;4246;0;0;0;0;.00nan;0;0
16675;189639;4715;0;0;0;0;.00nan;0;0
16675;173918;4715;100;23;0;23;1.000;3600000;0
16675;65125;4246;45;32;5;27;.844;3600000;0
16675;161129;4246;0;0;0;0;.00nan;0;0
16676;164987;4714;52;22;3;19;.864;3600000;0
16676;189333;4998;0;0;0;0;.00nan;0;0
16676;189628;4998;48;39;6;33;.846;3600000;0
16676;86347;4714;0;0;0;0;.00nan;0;0
16677;187657;4997;0;0;0;0;.00nan;0;0
16677;-1;165;0;0;0;0;.00nan;0;0
16677;141850;4997;55;42;6;36;.857;3600000;0
16677;146184;165;73;31;3;28;.903;3600000;0
16678;183730;4919;58;40;4;36;.900;3511000;0
16678;20122;4839;89;34;2;32;.941;3600000;0
16678;171608;4919;0;0;0;0;.00nan;0;0
16678;64925;4839;0;0;0;0;.00nan;0;0
16679;169478;4991;50;2;0;2;1.000;252000;0
16679;176206;1368;72;29;2;27;.931;3600000;0
16679;85336;4991;25;23;6;17;.739;3348000;0
16679;87164;1368;0;0;0;0;.00nan;0;0
16680;183730;4919;61;29;3;26;.897;3600000;0
16680;20122;4839;63;11;1;10;.909;1275000;0
16680;171608;4919;0;0;0;0;.00nan;0;0
16680;64925;4839;16;19;6;13;.684;2325000;0
16681;187657;4997;68;20;3;17;.850;3824000;0
16681;-1;165;0;0;0;0;.00nan;0;0
16681;141850;4997;0;0;0;0;.00nan;0;0
16681;146184;165;78;33;2;31;.939;3824000;0
16682;164987;4714;0;0;0;0;.00nan;0;0
16682;189333;4998;76;34;2;32;.941;3600000;0
16682;189628;4998;0;0;0;0;.00nan;0;0
16682;86347;4714;50;20;3;17;.850;3577000;0
16683;169478;4991;87;16;0;16;1.000;3600000;0
16683;176206;1368;0;0;0;0;.00nan;0;0
16683;85336;4991;0;0;0;0;.00nan;0;0
16683;87164;1368;56;27;4;23;.852;3600000;0
16684;-1;4992;0;0;0;0;.00nan;0;0
16684;187391;4992;24;30;6;24;.800;3600000;0
16684;65125;4246;8;30;8;22;.733;3090000;0
16684;161129;4246;48;8;1;7;.875;510000;0
16685;187657;4997;0;0;0;0;.00nan;0;0
16685;-1;165;0;0;0;0;.00nan;0;0
16685;141850;4997;52;25;4;21;.840;3600000;0
16685;146184;165;48;47;6;41;.872;3600000;0
16686;-1;4992;44;28;5;23;.821;3600000;0
16686;187391;4992;0;0;0;0;.00nan;0;0
16686;65125;4246;23;29;7;22;.759;2660000;0
16686;161129;4246;51;17;2;15;.882;940000;0
16687;20122;4839;23;28;6;22;.786;2219000;0
16687;176206;1368;56;23;3;20;.870;3600000;0
16687;64925;4839;56;10;2;8;.800;1381000;0
16687;87164;1368;0;0;0;0;.00nan;0;0
16688;183730;4919;48;14;2;12;.857;3600000;0
16688;189333;4998;58;14;1;13;.929;844000;0
16688;189628;4998;35;31;6;25;.806;2756000;0
16688;171608;4919;0;0;0;0;.00nan;0;0
16689;164987;4714;80;30;1;29;.967;3600000;0
16689;-1;4992;0;0;0;0;.00nan;0;0
16689;187391;4992;64;23;2;21;.913;3567000;0
16689;86347;4714;0;0;0;0;.00nan;0;0
16690;187657;4997;65;40;5;35;.875;3600000;0
16690;176206;1368;72;21;1;20;.952;3600000;0
16690;87164;1368;0;0;0;0;.00nan;0;0
16690;141850;4997;0;0;0;0;.00nan;0;0
16691;189639;4715;0;0;0;0;.00nan;0;0
16691;173918;4715;99;30;1;29;.967;3600000;0
16691;65125;4246;26;28;6;22;.786;3136000;0
16691;161129;4246;49;1;0;1;1.000;464000;0
16692;189639;4715;71;22;1;21;.955;4200000;0
16692;173918;4715;0;0;0;0;.00nan;0;0
16692;65125;4246;94;27;1;26;.963;4200000;0
16692;161129;4246;0;0;0;0;.00nan;0;0
16693;164987;4714;0;0;0;0;.00nan;0;0
16693;-1;4992;76;43;4;39;.907;3608000;0
16693;187391;4992;0;0;0;0;.00nan;0;0
16693;86347;4714;44;28;5;23;.821;3608000;0
16694;183730;4919;55;17;2;15;.882;3600000;0
16694;189333;4998;28;34;7;27;.794;2755000;0
16694;189628;4998;34;13;3;10;.769;845000;0
16694;171608;4919;0;0;0;0;.00nan;0;0
16695;20122;4839;0;0;0;0;.00nan;0;0
16695;-1;165;0;0;0;0;.00nan;0;0
16695;64925;4839;50;34;5;29;.853;3600000;0
16695;146184;165;86;19;0;19;1.000;3600000;0
16696;169478;4991;74;27;2;25;.926;3600000;0
16696;176206;1368;0;0;0;0;.00nan;0;0
16696;85336;4991;0;0;0;0;.00nan;0;0
16696;87164;1368;64;30;3;27;.900;3547000;0
16697;189333;4998;0;0;0;0;.00nan;0;0
16697;189628;4998;80;48;4;44;.917;3600000;0
16697;189639;4715;0;0;0;0;.00nan;0;0
16697;173918;4715;81;23;1;22;.957;3600000;0
16698;189333;4998;0;0;0;0;.00nan;0;0
16698;189628;4998;68;44;4;40;.909;3600000;0
16698;189639;4715;60;16;1;15;.938;3600000;0
16698;173918;4715;0;0;0;0;.00nan;0;0
16699;20122;4839;82;45;4;41;.911;3537000;0
16699;-1;165;0;0;0;0;.00nan;0;0
16699;64925;4839;0;0;0;0;.00nan;0;0
16699;146184;165;64;22;2;20;.909;3600000;0
16700;164987;4714;77;25;2;23;.920;3600000;0
16700;65125;4246;69;28;3;25;.893;3551000;0
16700;86347;4714;0;0;0;0;.00nan;0;0
16700;161129;4246;0;0;0;0;.00nan;0;0
16701;189333;4998;18;24;7;17;.708;1344000;0
16701;189628;4998;35;33;6;27;.818;2256000;0
16701;-1;165;0;0;0;0;.00nan;0;0
16701;146184;165;91;19;0;19;1.000;3600000;0
16702;183730;4919;71;17;1;16;.941;3600000;0
16702;171608;4919;0;0;0;0;.00nan;0;0
16702;-1;4992;0;0;0;0;.00nan;0;0
16702;187391;4992;86;46;4;42;.913;3600000;0
16703;187657;4997;41;16;3;13;.813;3582000;0
16703;176206;1368;72;30;2;28;.933;3600000;0
16703;87164;1368;0;0;0;0;.00nan;0;0
16703;141850;4997;0;0;0;0;.00nan;0;0
16704;20122;4839;0;0;0;0;.00nan;0;0
16704;169478;4991;0;0;0;0;.00nan;0;0
16704;64925;4839;100;45;1;44;.978;4200000;0
16704;85336;4991;72;23;1;22;.957;4200000;0
16705;164987;4714;0;0;0;0;.00nan;0;0
16705;65125;4246;0;0;0;0;.00nan;0;0
16705;86347;4714;86;17;0;17;1.000;3600000;0
16705;161129;4246;52;33;4;29;.879;3600000;0
16706;189333;4998;84;43;4;39;.907;3600000;0
16706;189628;4998;0;0;0;0;.00nan;0;0
16706;-1;165;0;0;0;0;.00nan;0;0
16706;146184;165;32;26;5;21;.808;3585000;0
16707;187657;4997;0;0;0;0;.00nan;0;0
16707;176206;1368;0;0;0;0;.00nan;0;0
16707;87164;1368;90;22;0;22;1.000;3600000;0
16707;141850;4997;65;27;3;24;.889;3600000;0
16708;183730;4919;73;27;2;25;.926;3636000;0
16708;171608;4919;0;0;0;0;.00nan;0;0
16708;-1;4992;61;29;3;26;.897;3636000;0
16708;187391;4992;0;0;0;0;.00nan;0;0
16709;20122;4839;81;35;3;32;.914;3600000;0
16709;169478;4991;28;16;4;12;.750;1078000;0
16709;64925;4839;0;0;0;0;.00nan;0;0
16709;85336;4991;76;22;2;20;.909;2522000;0
16710;183730;4919;0;0;0;0;.00nan;0;0
16710;171608;4919;76;28;1;27;.964;3600000;0
16710;-1;4992;0;0;0;0;.00nan;0;0
16710;187391;4992;68;31;3;28;.903;3585000;0
16711;189639;4715;0;0;0;0;.00nan;0;0
16711;173918;4715;82;25;1;24;.960;3600000;0
16711;-1;4992;0;0;0;0;.00nan;0;0
16711;187391;4992;29;25;6;19;.760;3600000;0
16712;183730;4919;44;25;4;21;.840;3551000;0
16712;189628;4998;76;40;3;37;.925;3600000;0
16712;171608;4919;0;0;0;0;.00nan;0;0
16712;191698;4998;0;0;0;0;.00nan;0;0
16713;169478;4991;52;4;0;4;1.000;782000;0
16713;-1;165;0;0;0;0;.00nan;0;0
16713;85336;4991;7;16;6;10;.625;2818000;0
16713;146184;165;67;25;2;23;.920;3600000;0
16714;187657;4997;0;0;0;0;.00nan;0;0
16714;20122;4839;0;0;0;0;.00nan;0;0
16714;64925;4839;91;41;2;39;.951;3600000;0
16714;141850;4997;58;23;3;20;.870;3547000;0
16715;176206;1368;0;0;0;0;.00nan;0;0
16715;65125;4246;40;22;4;18;.818;3600000;0
16715;87164;1368;33;32;6;26;.813;3530000;0
16715;161129;4246;0;0;0;0;.00nan;0;0
16716;20122;4839;95;43;2;41;.953;3600000;0
16716;169478;4991;31;15;4;11;.733;3596000;0
16716;64925;4839;0;0;0;0;.00nan;0;0
16716;85336;4991;0;0;0;0;.00nan;0;0
16717;176206;1368;52;27;4;23;.852;3600000;0
16717;65125;4246;52;40;6;34;.850;3568000;0
16717;87164;1368;0;0;0;0;.00nan;0;0
16717;161129;4246;0;0;0;0;.00nan;0;0
16718;189639;4715;56;17;3;14;.824;3600000;0
16718;173918;4715;0;0;0;0;.00nan;0;0
16718;-1;4992;46;29;4;25;.862;3562000;0
16718;187391;4992;0;0;0;0;.00nan;0;0
16719;183730;4919;0;0;0;0;.00nan;0;0
16719;189628;4998;0;0;0;0;.00nan;0;0
16719;171608;4919;64;20;2;18;.900;3600000;0
16719;191698;4998;67;53;6;47;.887;3600000;0
16720;187657;4997;65;35;4;31;.886;3600000;0
16720;-1;165;0;0;0;0;.00nan;0;0
16720;141850;4997;0;0;0;0;.00nan;0;0
16720;146184;165;87;28;1;27;.964;3600000;0
16721;176206;1368;0;0;0;0;.00nan;0;0
16721;65125;4246;0;0;0;0;.00nan;0;0
16721;87164;1368;67;36;4;32;.889;3600000;0
16721;161129;4246;54;28;3;25;.893;3600000;0
16722;183730;4919;71;23;2;21;.913;3600000;0
16722;189639;4715;46;29;5;24;.828;3600000;0
16722;173918;4715;0;0;0;0;.00nan;0;0
16722;171608;4919;0;0;0;0;.00nan;0;0
16723;187657;4997;0;0;0;0;.00nan;0;0
16723;-1;165;35;33;7;26;.788;3600000;0
16723;141850;4997;76;41;4;37;.902;3600000;0
16723;146184;165;0;0;0;0;.00nan;0;0
16724;187657;4997;50;29;4;25;.862;3600000;0
16724;20122;4839;0;0;0;0;.00nan;0;0
16724;64925;4839;61;43;5;38;.884;3586000;0
16724;141850;4997;0;0;0;0;.00nan;0;0
16725;189628;4998;0;0;0;0;.00nan;0;0
16725;-1;4992;0;0;0;0;.00nan;0;0
16725;187391;4992;57;29;4;25;.862;3674000;0
16725;191698;4998;59;24;3;21;.875;3674000;0
16726;164987;4714;0;0;0;0;.00nan;0;0
16726;183730;4919;0;0;0;0;.00nan;0;0
16726;171608;4919;51;23;3;20;.870;3681000;0
16726;86347;4714;59;30;4;26;.867;3681000;0
16727;-1;165;0;0;0;0;.00nan;0;0
16727;65125;4246;71;28;2;26;.929;3600000;0
16727;146184;165;72;33;3;30;.909;3554000;0
16727;161129;4246;0;0;0;0;.00nan;0;0
16728;169478;4991;0;0;0;0;.00nan;0;0
16728;176206;1368;0;0;0;0;.00nan;0;0
16728;85336;4991;72;24;1;23;.958;3600000;0
16728;87164;1368;73;30;2;28;.933;3547000;0
16729;187657;4997;51;2;0;2;1.000;346000;0
16729;20122;4839;0;0;0;0;.00nan;0;0
16729;64925;4839;59;31;4;27;.871;3600000;0
16729;141850;4997;38;35;6;29;.829;3206000;0
16730;-1;165;0;0;0;0;.00nan;0;0
16730;65125;4246;82;34;2;32;.941;3600000;0
16730;146184;165;61;32;3;29;.906;3534000;0
16730;161129;4246;0;0;0;0;.00nan;0;0
16731;189628;4998;70;51;6;45;.882;3600000;0
16731;-1;4992;63;20;1;19;.950;3600000;0
16731;187391;4992;0;0;0;0;.00nan;0;0
16731;191698;4998;0;0;0;0;.00nan;0;0
16732;164987;4714;21;8;4;4;.500;964000;0
16732;183730;4919;70;21;2;19;.905;3600000;0
16732;171608;4919;0;0;0;0;.00nan;0;0
16732;86347;4714;66;35;2;33;.943;2636000;0
16733;187657;4997;80;26;1;25;.962;3600000;0
16733;20122;4839;52;37;6;31;.838;3600000;0
16733;64925;4839;0;0;0;0;.00nan;0;0
16733;141850;4997;0;0;0;0;.00nan;0;0
16734;164987;4714;29;29;6;23;.793;3600000;0
16734;183730;4919;73;34;3;31;.912;3600000;0
16734;171608;4919;0;0;0;0;.00nan;0;0
16734;86347;4714;0;0;0;0;.00nan;0;0
16735;189639;4715;0;0;0;0;.00nan;0;0
16735;173918;4715;76;35;4;31;.886;3523000;0
16735;-1;4992;0;0;0;0;.00nan;0;0
16735;187391;4992;63;25;2;23;.920;3600000;0
16817;169478;4991;0;0;0;0;.00nan;0;0
16817;176206;1368;0;0;0;0;.00nan;0;0
16817;85336;4991;59;27;3;24;.889;3600000;0
16817;87164;1368;74;27;2;25;.926;3600000;0
16819;187657;4997;31;26;6;20;.769;3588000;0
16819;-1;165;54;25;4;21;.840;3600000;0
16819;-1;165;0;0;0;0;.00nan;0;0
16819;141850;4997;0;0;0;0;.00nan;0;0
16821;161583;4839;0;0;0;0;.00nan;0;0
16821;189639;4715;100;26;0;26;1.000;3600000;0
16821;173918;4715;0;0;0;0;.00nan;0;0
16821;64925;4839;77;28;2;26;.929;3567000;0
16823;164987;4714;0;0;0;0;.00nan;0;0
16823;189333;4998;46;31;6;25;.806;3582000;0
16823;189628;4998;0;0;0;0;.00nan;0;0
16823;86347;4714;33;21;4;17;.810;3600000;0
16825;183730;4919;24;21;5;16;.762;3548000;0
16825;171608;4919;0;0;0;0;.00nan;0;0
16825;-1;4992;71;9;0;9;1.000;1325000;0
16825;187391;4992;37;20;4;16;.800;2275000;0
16826;173961;172;0;0;0;0;.00nan;0;0
16826;191026;172;64;19;1;18;.947;3600000;0
16826;44561;171;91;42;3;39;.929;3600000;0
16826;91703;171;0;0;0;0;.00nan;0;0
16827;161583;170;0;0;0;0;.00nan;0;0
16827;-1;4247;0;0;0;0;.00nan;0;0
16827;44189;4247;76;35;2;33;.943;3600000;0
16827;57434;170;51;26;3;23;.885;3595000;0
16828;6541;174;65;9;0;9;1.000;850000;0
16828;165532;3916;0;0;0;0;.00nan;0;0
16828;178695;174;42;40;6;34;.850;2750000;0
16828;86875;3916;91;31;1;30;.968;3600000;0
16829;161583;170;0;0;0;0;.00nan;0;0
16829;57434;170;38;30;5;25;.833;3600000;0
16829;86344;1527;65;23;2;21;.913;3600000;0
16829;91202;1527;0;0;0;0;.00nan;0;0
16830;-1;4247;0;0;0;0;.00nan;0;0
16830;175658;167;0;0;0;0;.00nan;0;0
16830;44189;4247;87;34;2;32;.941;3600000;0
16830;78587;167;56;27;3;24;.889;3600000;0
16831;6541;174;0;0;0;0;.00nan;0;0
16831;165532;3916;0;0;0;0;.00nan;0;0
16831;178695;174;60;37;4;33;.892;3600000;0
16831;86875;3916;79;34;3;31;.912;3600000;0
16832;-1;175;0;0;0;0;.00nan;0;0
16832;77084;175;75;22;1;21;.955;3600000;0
16832;78820;169;0;0;0;0;.00nan;0;0
16832;85228;169;73;33;3;30;.909;3516000;0
16833;173961;172;0;0;0;0;.00nan;0;0
16833;191026;172;51;21;3;18;.857;3600000;0
16833;44561;171;0;0;0;0;.00nan;0;0
16833;91703;171;90;49;4;45;.918;3600000;0
16834;161583;170;0;0;0;0;.00nan;0;0
16834;6541;174;64;28;3;25;.893;3599000;0
16834;178695;174;0;0;0;0;.00nan;0;0
16834;57434;170;74;28;2;26;.929;3600000;0
16835;-1;175;0;0;0;0;.00nan;0;0
16835;175658;167;0;0;0;0;.00nan;0;0
16835;77084;175;68;20;1;19;.950;3600000;0
16835;78587;167;69;35;3;32;.914;3582000;0
16836;165532;3916;73;42;3;39;.929;3600000;0
16836;173961;172;79;28;1;27;.964;3600000;0
16836;191026;172;0;0;0;0;.00nan;0;0
16836;86875;3916;0;0;0;0;.00nan;0;0
16837;-1;4247;67;32;3;29;.906;3578000;0
16837;44189;4247;0;0;0;0;.00nan;0;0
16837;86344;1527;0;0;0;0;.00nan;0;0
16837;91202;1527;74;20;1;19;.950;3600000;0
16838;44561;171;0;0;0;0;.00nan;0;0
16838;78820;169;0;0;0;0;.00nan;0;0
16838;85228;169;69;33;3;30;.909;3581000;0
16838;91703;171;72;26;2;24;.923;3600000;0
16839;165532;3916;0;0;0;0;.00nan;0;0
16839;173961;172;0;0;0;0;.00nan;0;0
16839;191026;172;94;38;2;36;.947;3600000;0
16839;86875;3916;70;28;3;25;.893;3600000;0
16840;-1;4247;63;16;1;15;.938;1756000;0
16840;44189;4247;10;20;6;14;.700;1844000;0
16840;86344;1527;0;0;0;0;.00nan;0;0
16840;91202;1527;56;17;2;15;.882;3600000;0
16841;161583;170;85;26;1;25;.962;3600000;0
16841;6541;174;0;0;0;0;.00nan;0;0
16841;178695;174;85;48;3;45;.938;3515000;0
16841;57434;170;0;0;0;0;.00nan;0;0
16842;44561;171;0;0;0;0;.00nan;0;0
16842;78820;169;89;32;2;30;.938;3600000;0
16842;85228;169;0;0;0;0;.00nan;0;0
16842;91703;171;48;26;4;22;.846;3587000;0
16843;-1;175;73;23;1;22;.957;3600000;0
16843;77084;175;0;0;0;0;.00nan;0;0
16843;78820;169;0;0;0;0;.00nan;0;0
16843;85228;169;77;33;3;30;.909;3600000;0
16844;161583;170;0;0;0;0;.00nan;0;0
16844;-1;4247;0;0;0;0;.00nan;0;0
16844;44189;4247;85;28;1;27;.964;3600000;0
16844;57434;170;58;35;4;31;.886;3600000;0
16845;6541;174;0;0;0;0;.00nan;0;0
16845;178695;174;75;44;3;41;.932;3600000;0
16845;173961;172;0;0;0;0;.00nan;0;0
16845;191026;172;54;32;4;28;.875;3600000;0
16846;165532;3916;0;0;0;0;.00nan;0;0
16846;175658;167;40;27;5;22;.815;3600000;0
16846;78587;167;0;0;0;0;.00nan;0;0
16846;86875;3916;37;34;6;28;.824;3563000;0
16847;44561;171;0;0;0;0;.00nan;0;0
16847;86344;1527;0;0;0;0;.00nan;0;0
16847;91202;1527;54;15;2;13;.867;3600000;0
16847;91703;171;98;53;3;50;.943;3600000;0
16848;-1;175;0;0;0;0;.00nan;0;0
16848;77084;175;77;31;3;28;.903;3600000;0
16848;78820;169;92;37;2;35;.946;3600000;0
16848;85228;169;0;0;0;0;.00nan;0;0
16849;161583;170;65;35;4;31;.886;3600000;0
16849;-1;4247;91;31;1;30;.968;3600000;0
16849;44189;4247;0;0;0;0;.00nan;0;0
16849;57434;170;0;0;0;0;.00nan;0;0
16850;6541;174;87;50;4;46;.920;3593000;0
16850;178695;174;0;0;0;0;.00nan;0;0
16850;173961;172;71;26;2;24;.923;3600000;0
16850;191026;172;0;0;0;0;.00nan;0;0
16851;165532;3916;100;41;1;40;.976;3600000;0
16851;175658;167;0;0;0;0;.00nan;0;0
16851;78587;167;66;36;3;33;.917;3541000;0
16851;86875;3916;0;0;0;0;.00nan;0;0
16852;44561;171;90;38;1;37;.974;3600000;0
16852;86344;1527;72;28;2;26;.929;3558000;0
16852;91202;1527;0;0;0;0;.00nan;0;0
16852;91703;171;0;0;0;0;.00nan;0;0
16853;173961;172;0;0;0;0;.00nan;0;0
16853;191026;172;100;34;0;34;1.000;3600000;0
16853;86344;1527;0;0;0;0;.00nan;0;0
16853;91202;1527;72;27;2;25;.926;3514000;0
16854;6541;174;0;0;0;0;.00nan;0;0
16854;178695;174;83;23;1;22;.957;3600000;0
16854;-1;4247;47;30;5;25;.833;3600000;0
16854;44189;4247;0;0;0;0;.00nan;0;0
16855;161583;170;0;0;0;0;.00nan;0;0
16855;57434;170;78;28;2;26;.929;3600000;0
16855;86344;1527;70;35;3;32;.914;3570000;0
16855;91202;1527;0;0;0;0;.00nan;0;0
16856;-1;175;72;30;3;27;.900;3600000;0
16856;175658;167;0;0;0;0;.00nan;0;0
16856;77084;175;0;0;0;0;.00nan;0;0
16856;78587;167;34;17;4;13;.765;3560000;0
16857;173961;172;0;0;0;0;.00nan;0;0
16857;191026;172;65;38;4;34;.895;3600000;0
16857;78820;169;0;0;0;0;.00nan;0;0
16857;85228;169;95;30;1;29;.967;3600000;0
16858;6541;174;0;0;0;0;.00nan;0;0
16858;178695;174;90;36;2;34;.944;3600000;0
16858;86344;1527;0;0;0;0;.00nan;0;0
16858;91202;1527;46;25;4;21;.840;3571000;0
16859;161583;170;52;36;4;32;.889;3571000;0
16859;165532;3916;0;0;0;0;.00nan;0;0
16859;57434;170;0;0;0;0;.00nan;0;0
16859;86875;3916;59;24;3;21;.875;3600000;0
16860;-1;4247;0;0;0;0;.00nan;0;0
16860;44189;4247;72;31;2;29;.935;3600000;0
16860;44561;171;0;0;0;0;.00nan;0;0
16860;91703;171;58;19;3;16;.842;3543000;0
16861;173961;172;0;0;0;0;.00nan;0;0
16861;191026;172;72;27;2;25;.926;3600000;0
16861;78820;169;69;32;3;29;.906;3551000;0
16861;85228;169;0;0;0;0;.00nan;0;0
16862;-1;4247;61;39;4;35;.897;3900000;0
16862;175658;167;48;28;4;24;.857;3900000;0
16862;44189;4247;0;0;0;0;.00nan;0;0
16862;78587;167;0;0;0;0;.00nan;0;0
16863;6541;174;0;0;0;0;.00nan;0;0
16863;178695;174;64;31;3;28;.903;3600000;0
16863;86344;1527;86;30;2;28;.933;3600000;0
16863;91202;1527;0;0;0;0;.00nan;0;0
16864;165532;3916;44;26;5;21;.808;3561000;0
16864;44561;171;72;40;4;36;.900;3600000;0
16864;86875;3916;0;0;0;0;.00nan;0;0
16864;91703;171;0;0;0;0;.00nan;0;0
16865;-1;175;0;0;0;0;.00nan;0;0
16865;175658;167;58;29;4;25;.862;3600000;0
16865;77084;175;44;29;5;24;.828;3532000;0
16865;78587;167;0;0;0;0;.00nan;0;0
16866;6541;174;0;0;0;0;.00nan;0;0
16866;178695;174;84;42;3;39;.929;3532000;0
16866;173961;172;0;0;0;0;.00nan;0;0
16866;191026;172;75;16;1;15;.938;3600000;0
16867;6541;174;0;0;0;0;.00nan;0;0
16867;178695;174;100;39;1;38;.974;3896000;0
16867;175658;167;0;0;0;0;.00nan;0;0
16867;78587;167;82;31;1;30;.968;3900000;0
16868;173961;172;0;0;0;0;.00nan;0;0
16868;-1;4247;80;29;2;27;.931;3551000;0
16868;191026;172;89;19;0;19;1.000;3600000;0
16868;44189;4247;0;0;0;0;.00nan;0;0
16869;161583;170;0;0;0;0;.00nan;0;0
16869;57434;170;57;18;2;16;.889;3600000;0
16869;86344;1527;0;0;0;0;.00nan;0;0
16869;91202;1527;53;21;3;18;.857;3585000;0
16870;-1;175;0;0;0;0;.00nan;0;0
16870;44561;171;0;0;0;0;.00nan;0;0
16870;77084;175;73;24;2;22;.917;3600000;0
16870;91703;171;77;37;3;34;.919;3578000;0
16871;173961;172;0;0;0;0;.00nan;0;0
16871;-1;4247;93;39;1;38;.974;2664000;0
16871;191026;172;66;17;1;16;.941;3600000;0
16871;44189;4247;19;8;4;4;.500;936000;0
16872;161583;170;51;30;4;26;.867;3600000;0
16872;6541;174;0;0;0;0;.00nan;0;0
16872;178695;174;43;31;5;26;.839;3600000;0
16872;57434;170;0;0;0;0;.00nan;0;0
16873;165532;3916;0;0;0;0;.00nan;0;0
16873;86344;1527;73;29;3;26;.897;3600000;0
16873;86875;3916;61;30;4;26;.867;3551000;0
16873;91202;1527;0;0;0;0;.00nan;0;0
16874;175658;167;84;31;2;29;.935;3900000;0
16874;78587;167;0;0;0;0;.00nan;0;0
16874;78820;169;0;0;0;0;.00nan;0;0
16874;85228;169;90;42;2;40;.952;3900000;0
16875;-1;175;78;30;2;28;.933;3565000;0
16875;44561;171;93;34;1;33;.971;3600000;0
16875;77084;175;0;0;0;0;.00nan;0;0
16875;91703;171;0;0;0;0;.00nan;0;0
16876;161583;170;0;0;0;0;.00nan;0;0
16876;57434;170;68;35;4;31;.886;3600000;0
16876;86344;1527;0;0;0;0;.00nan;0;0
16876;91202;1527;69;16;1;15;.938;3600000;0
16877;175658;167;0;0;0;0;.00nan;0;0
16877;78587;167;61;29;3;26;.897;3539000;0
16877;78820;169;0;0;0;0;.00nan;0;0
16877;85228;169;87;30;1;29;.967;3600000;0
16878;-1;4247;47;28;5;23;.821;3588000;0
16878;44189;4247;0;0;0;0;.00nan;0;0
16878;44561;171;0;0;0;0;.00nan;0;0
16878;91703;171;65;29;3;26;.897;3600000;0
16879;165532;3916;0;0;0;0;.00nan;0;0
16879;191026;172;87;28;1;27;.964;3600000;0
16879;78581;172;0;0;0;0;.00nan;0;0
16879;86875;3916;84;36;2;34;.944;3586000;0
16880;-1;175;0;0;0;0;.00nan;0;0
16880;178695;174;0;0;0;0;.00nan;0;0
16880;57426;174;23;15;5;10;.667;3579000;0
16880;77084;175;75;33;3;30;.909;3600000;0
16881;-1;175;37;24;5;19;.792;3600000;0
16881;-1;4247;0;0;0;0;.00nan;0;0
16881;44189;4247;74;29;2;27;.931;3600000;0
16881;77084;175;0;0;0;0;.00nan;0;0
16882;175658;167;37;25;5;20;.800;3576000;0
16882;78587;167;0;0;0;0;.00nan;0;0
16882;78820;169;84;40;3;37;.925;3600000;0
16882;85228;169;0;0;0;0;.00nan;0;0
16883;191026;172;0;0;0;0;.00nan;0;0
16883;44561;171;62;35;5;30;.857;3600000;0
16883;78581;172;83;30;1;29;.967;3600000;0
16883;91703;171;0;0;0;0;.00nan;0;0
16884;165532;3916;0;0;0;0;.00nan;0;0
16884;178695;174;0;0;0;0;.00nan;0;0
16884;57426;174;95;38;2;36;.947;3900000;0
16884;86875;3916;83;33;2;31;.939;3900000;0
16885;161583;170;50;28;4;24;.857;3600000;0
16885;57434;170;0;0;0;0;.00nan;0;0
16885;86344;1527;100;31;0;31;1.000;3600000;0
16885;91202;1527;0;0;0;0;.00nan;0;0
16886;-1;175;0;0;0;0;.00nan;0;0
16886;-1;4247;88;43;3;40;.930;3900000;0
16886;44189;4247;0;0;0;0;.00nan;0;0
16886;77084;175;60;33;3;30;.909;3900000;0
16887;175658;167;48;0;0;0;.00nan;465000;0
16887;78587;167;38;32;6;26;.813;3135000;0
16887;78820;169;0;0;0;0;.00nan;0;0
16887;85228;169;82;27;1;26;.963;3600000;0
16888;165532;3916;99;43;2;41;.953;3900000;0
16888;178695;174;0;0;0;0;.00nan;0;0
16888;57426;174;98;47;2;45;.957;3900000;0
16888;86875;3916;0;0;0;0;.00nan;0;0
16889;165532;3916;0;0;0;0;.00nan;0;0
16889;86344;1527;0;0;0;0;.00nan;0;0
16889;86875;3916;43;32;5;27;.844;3611000;0
16889;91202;1527;30;24;6;18;.750;3593000;0
16890;161583;170;0;0;0;0;.00nan;0;0
16890;165532;3916;0;0;0;0;.00nan;0;0
16890;57434;170;63;32;3;29;.906;3547000;0
16890;86875;3916;85;35;2;33;.943;3600000;0
16891;-1;175;0;0;0;0;.00nan;0;0
16891;77084;175;64;30;2;28;.933;3548000;0
16891;86344;1527;69;23;1;22;.957;3600000;0
16891;91202;1527;0;0;0;0;.00nan;0;0
16892;175658;167;70;32;3;29;.906;3582000;0
16892;44561;171;0;0;0;0;.00nan;0;0
16892;78587;167;0;0;0;0;.00nan;0;0
16892;91703;171;65;16;2;14;.875;3600000;0
16893;161583;170;90;34;3;31;.912;3600000;0
16893;165532;3916;63;24;2;22;.917;3600000;0
16893;57434;170;0;0;0;0;.00nan;0;0
16893;86875;3916;0;0;0;0;.00nan;0;0
16894;-1;4247;67;35;4;31;.886;3600000;0
16894;191026;172;0;0;0;0;.00nan;0;0
16894;44189;4247;0;0;0;0;.00nan;0;0
16894;78581;172;30;29;6;23;.793;3539000;0
16895;-1;175;81;34;2;32;.941;3559000;0
16895;77084;175;0;0;0;0;.00nan;0;0
16895;86344;1527;0;0;0;0;.00nan;0;0
16895;91202;1527;62;16;1;15;.938;3600000;0
16896;175658;167;0;0;0;0;.00nan;0;0
16896;44561;171;66;29;3;26;.897;3900000;0
16896;78587;167;56;31;3;28;.903;3900000;0
16896;91703;171;0;0;0;0;.00nan;0;0
16897;-1;4247;60;30;4;26;.867;3591000;0
16897;191026;172;0;0;0;0;.00nan;0;0
16897;44189;4247;0;0;0;0;.00nan;0;0
16897;78581;172;73;34;3;31;.912;3600000;0
16898;-1;175;0;0;0;0;.00nan;0;0
16898;175658;167;80;20;1;19;.950;3600000;0
16898;77084;175;59;35;4;31;.886;3600000;0
16898;78587;167;0;0;0;0;.00nan;0;0
16899;161583;170;0;0;0;0;.00nan;0;0
16899;-1;4247;100;32;0;32;1.000;3600000;0
16899;44189;4247;0;0;0;0;.00nan;0;0
16899;57434;170;49;30;4;26;.867;3600000;0
16900;165532;3916;0;0;0;0;.00nan;0;0
16900;178695;174;0;0;0;0;.00nan;0;0
16900;57426;174;57;39;5;34;.872;3600000;0
16900;86875;3916;93;31;1;30;.968;3600000;0
16901;78820;169;87;29;2;27;.931;3544000;0
16901;85228;169;0;0;0;0;.00nan;0;0
16901;86344;1527;81;24;1;23;.958;3600000;0
16901;91202;1527;0;0;0;0;.00nan;0;0
16902;191026;172;0;0;0;0;.00nan;0;0
16902;44561;171;0;0;0;0;.00nan;0;0
16902;78581;172;48;21;3;18;.857;3600000;0
16902;91703;171;85;35;2;33;.943;3600000;0
16903;161583;170;61;17;2;15;.882;3600000;0
16903;-1;4247;72;36;3;33;.917;3590000;0
16903;44189;4247;0;0;0;0;.00nan;0;0
16903;57434;170;0;0;0;0;.00nan;0;0
16904;165532;3916;73;26;2;24;.923;3900000;0
16904;178695;174;0;0;0;0;.00nan;0;0
16904;57426;174;90;29;2;27;.931;3900000;0
16904;86875;3916;0;0;0;0;.00nan;0;0
16905;78820;169;0;0;0;0;.00nan;0;0
16905;85228;169;84;42;3;39;.929;3600000;0
16905;86344;1527;0;0;0;0;.00nan;0;0
16905;91202;1527;39;29;6;23;.793;3600000;0
16906;-1;175;100;28;0;28;1.000;3600000;0
16906;175658;167;0;0;0;0;.00nan;0;0
16906;77084;175;0;0;0;0;.00nan;0;0
16906;78587;167;98;37;1;36;.973;3552000;0
16907;191026;172;0;0;0;0;.00nan;0;0
16907;44561;171;81;51;4;47;.922;3600000;0
16907;78581;172;53;25;3;22;.880;3600000;0
16907;91703;171;0;0;0;0;.00nan;0;0
16908;-1;175;90;28;1;27;.964;3600000;0
16908;77084;175;0;0;0;0;.00nan;0;0
16908;78820;169;0;0;0;0;.00nan;0;0
16908;85228;169;58;25;3;22;.880;3535000;0
16909;161583;170;88;29;2;27;.931;3600000;0
16909;191026;172;0;0;0;0;.00nan;0;0
16909;57434;170;0;0;0;0;.00nan;0;0
16909;78581;172;42;19;3;16;.842;3541000;0
16910;-1;4247;93;38;2;36;.947;3593000;0
16910;175658;167;0;0;0;0;.00nan;0;0
16910;44189;4247;0;0;0;0;.00nan;0;0
16910;78587;167;97;25;0;25;1.000;3600000;0
16911;-1;175;0;0;0;0;.00nan;0;0
16911;77084;175;77;26;2;24;.923;3544000;0
16911;78820;169;100;32;1;31;.969;3600000;0
16911;85228;169;0;0;0;0;.00nan;0;0
16912;178695;174;0;0;0;0;.00nan;0;0
16912;44561;171;0;0;0;0;.00nan;0;0
16912;57426;174;77;25;1;24;.960;3600000;0
16912;91703;171;80;37;3;34;.919;3590000;0
16913;161583;170;0;0;0;0;.00nan;0;0
16913;44561;171;65;38;4;34;.895;3600000;0
16913;57434;170;63;23;2;21;.913;3600000;0
16913;91703;171;0;0;0;0;.00nan;0;0
16914;165532;3916;0;0;0;0;.00nan;0;0
16914;191026;172;0;0;0;0;.00nan;0;0
16914;78581;172;53;21;3;18;.857;3600000;0
16914;86875;3916;71;30;2;28;.933;3600000;0
16915;-1;4247;0;0;0;0;.00nan;0;0
16915;44189;4247;93;39;3;36;.923;3600000;0
16915;86344;1527;36;19;4;15;.789;3576000;0
16915;91202;1527;0;0;0;0;.00nan;0;0
16916;-1;175;67;32;3;29;.906;3600000;0
16916;175658;167;0;0;0;0;.00nan;0;0
16916;77084;175;0;0;0;0;.00nan;0;0
16916;78587;167;78;24;1;23;.958;3600000;0
16917;178695;174;0;0;0;0;.00nan;0;0
16917;57426;174;44;19;4;15;.789;3518000;0
16917;78820;169;0;0;0;0;.00nan;0;0
16917;85228;169;86;35;2;33;.943;3600000;0
16918;161583;170;65;29;3;26;.897;3600000;0
16918;57434;170;0;0;0;0;.00nan;0;0
16918;78820;169;52;32;5;27;.844;3515000;0
16918;91225;169;0;0;0;0;.00nan;0;0
16919;161583;170;0;0;0;0;.00nan;0;0
16919;178695;174;0;0;0;0;.00nan;0;0
16919;57426;174;67;34;3;31;.912;3600000;0
16919;57434;170;42;26;4;22;.846;3560000;0
16920;-1;175;0;0;0;0;.00nan;0;0
16920;175658;167;43;26;4;22;.846;3564000;0
16920;77084;175;75;37;3;34;.919;3600000;0
16920;78587;167;0;0;0;0;.00nan;0;0
16921;165532;3916;0;0;0;0;.00nan;0;0
16921;86344;1527;0;0;0;0;.00nan;0;0
16921;86875;3916;70;34;3;31;.912;3585000;0
16921;91202;1527;93;26;1;25;.962;3600000;0
16922;-1;4247;68;38;4;34;.895;3891000;0
16922;44189;4247;0;0;0;0;.00nan;0;0
16922;78820;169;0;0;0;0;.00nan;0;0
16922;91225;169;51;28;5;23;.821;3891000;0
16923;191026;172;0;0;0;0;.00nan;0;0
16923;44561;171;0;0;0;0;.00nan;0;0
16923;78581;172;77;19;1;18;.947;3600000;0
16923;91703;171;90;42;2;40;.952;3544000;0
16924;161583;170;0;0;0;0;.00nan;0;0
16924;-1;4247;0;0;0;0;.00nan;0;0
16924;44189;4247;78;29;1;28;.966;3600000;0
16924;57434;170;63;25;2;23;.920;3555000;0
16925;-1;175;56;22;3;19;.864;3600000;0
16925;175658;167;0;0;0;0;.00nan;0;0
16925;77084;175;0;0;0;0;.00nan;0;0
16925;78587;167;59;36;4;32;.889;3562000;0
16926;191026;172;0;0;0;0;.00nan;0;0
16926;44561;171;52;34;5;29;.853;3572000;0
16926;78581;172;54;25;4;21;.840;3600000;0
16926;91703;171;0;0;0;0;.00nan;0;0
16927;165532;3916;77;42;3;39;.929;3600000;0
16927;86344;1527;0;0;0;0;.00nan;0;0
16927;86875;3916;0;0;0;0;.00nan;0;0
16927;91202;1527;90;19;0;19;1.000;3600000;0
16928;178695;174;0;0;0;0;.00nan;0;0
16928;57426;174;91;35;1;34;.971;3600000;0
16928;78820;169;88;39;2;37;.949;3560000;0
16928;91225;169;0;0;0;0;.00nan;0;0
16929;161583;170;60;34;3;31;.912;3600000;0
16929;57434;170;0;0;0;0;.00nan;0;0
16929;86344;1527;0;0;0;0;.00nan;0;0
16929;91202;1527;97;23;0;23;1.000;3600000;0
16930;-1;4247;46;24;4;20;.833;3600000;0
16930;175658;167;0;0;0;0;.00nan;0;0
16930;44189;4247;0;0;0;0;.00nan;0;0
16930;78587;167;44;38;6;32;.842;3559000;0
16931;-1;175;0;0;0;0;.00nan;0;0
16931;77084;175;62;21;2;19;.905;3900000;0
16931;78820;169;100;46;2;44;.957;3900000;0
16931;91225;169;0;0;0;0;.00nan;0;0
16932;178695;174;0;0;0;0;.00nan;0;0
16932;44561;171;0;0;0;0;.00nan;0;0
16932;57426;174;91;30;1;29;.967;3792000;0
16932;91703;171;87;30;2;28;.933;3792000;0
16933;175658;167;0;0;0;0;.00nan;0;0
16933;78587;167;67;30;3;27;.900;3600000;0
16933;78820;169;67;22;2;20;.909;3600000;0
16933;91225;169;0;0;0;0;.00nan;0;0
16934;178695;174;0;0;0;0;.00nan;0;0
16934;191026;172;0;0;0;0;.00nan;0;0
16934;57426;174;62;41;5;36;.878;3600000;0
16934;78581;172;87;39;2;37;.949;3600000;0
16935;-1;4247;80;37;2;35;.946;3558000;0
16935;44189;4247;0;0;0;0;.00nan;0;0
16935;44561;171;92;29;1;28;.966;3600000;0
16935;91703;171;0;0;0;0;.00nan;0;0
16936;165532;3916;0;0;0;0;.00nan;0;0
16936;-1;175;64;25;2;23;.920;3600000;0
16936;77084;175;0;0;0;0;.00nan;0;0
16936;86875;3916;73;33;3;30;.909;3600000;0
16937;161583;170;0;0;0;0;.00nan;0;0
16937;57434;170;68;33;3;30;.909;3596000;0
16937;86344;1527;0;0;0;0;.00nan;0;0
16937;91202;1527;100;34;1;33;.971;3600000;0
16938;161583;170;54;26;3;23;.885;3600000;0
16938;57434;170;0;0;0;0;.00nan;0;0
16938;86344;1527;73;27;2;25;.926;3600000;0
16938;91202;1527;0;0;0;0;.00nan;0;0
16939;175658;167;65;28;2;26;.929;3600000;0
16939;78587;167;0;0;0;0;.00nan;0;0
16939;78820;169;0;0;0;0;.00nan;0;0
16939;91225;169;76;23;1;22;.957;3600000;0
16940;-1;4247;0;0;0;0;.00nan;0;0
16940;44189;4247;78;50;5;45;.900;3900000;0
16940;44561;171;0;0;0;0;.00nan;0;0
16940;91703;171;62;35;5;30;.857;3900000;0
16941;178695;174;0;0;0;0;.00nan;0;0
16941;191026;172;0;0;0;0;.00nan;0;0
16941;57426;174;93;42;2;40;.952;3600000;0
16941;78581;172;54;42;5;37;.881;3600000;0
16942;165532;3916;72;19;1;18;.947;3600000;0
16942;-1;175;0;0;0;0;.00nan;0;0
16942;77084;175;63;25;2;23;.920;3543000;0
16942;86875;3916;0;0;0;0;.00nan;0;0
16943;178695;174;0;0;0;0;.00nan;0;0
16943;44561;171;57;27;3;24;.889;3569000;0
16943;57426;174;77;23;1;22;.957;3600000;0
16943;91703;171;0;0;0;0;.00nan;0;0
16944;165532;3916;0;0;0;0;.00nan;0;0
16944;175658;167;0;0;0;0;.00nan;0;0
16944;78587;167;77;23;1;22;.957;3600000;0
16944;86875;3916;53;36;5;31;.861;3600000;0
16945;-1;175;74;39;4;35;.897;3600000;0
16945;77084;175;0;0;0;0;.00nan;0;0
16945;78820;169;43;32;6;26;.813;3524000;0
16945;91225;169;0;0;0;0;.00nan;0;0
16946;-1;175;0;0;0;0;.00nan;0;0
16946;77084;175;70;23;1;22;.957;3546000;0
16946;86344;1527;0;0;0;0;.00nan;0;0
16946;91202;1527;100;33;0;33;1.000;3600000;0
16947;161583;170;0;0;0;0;.00nan;0;0
16947;44561;171;0;0;0;0;.00nan;0;0
16947;57434;170;73;22;1;21;.955;3600000;0
16947;91703;171;77;33;2;31;.939;3549000;0
16948;178695;174;0;0;0;0;.00nan;0;0
16948;191026;172;0;0;0;0;.00nan;0;0
16948;57426;174;69;45;4;41;.911;3622000;0
16948;78581;172;59;25;3;22;.880;3622000;0
16949;165532;3916;69;32;3;29;.906;3600000;0
16949;86344;1527;0;0;0;0;.00nan;0;0
16949;86875;3916;0;0;0;0;.00nan;0;0
16949;91202;1527;38;31;5;26;.839;3600000;0
16950;-1;175;96;45;1;44;.978;3900000;0
16950;-1;4247;87;28;1;27;.964;3900000;0
16950;44189;4247;0;0;0;0;.00nan;0;0
16950;77084;175;0;0;0;0;.00nan;0;0
16951;175658;167;100;31;0;31;1.000;3600000;0
16951;78587;167;0;0;0;0;.00nan;0;0
16951;78820;169;85;31;1;30;.968;3585000;0
16951;91225;169;0;0;0;0;.00nan;0;0
16952;178695;174;67;27;2;25;.926;3600000;0
16952;44561;171;55;26;3;23;.885;3600000;0
16952;57426;174;0;0;0;0;.00nan;0;0
16952;91703;171;0;0;0;0;.00nan;0;0
16953;165532;3916;0;0;0;0;.00nan;0;0
16953;191026;172;0;0;0;0;.00nan;0;0
16953;78581;172;61;24;3;21;.875;3600000;0
16953;86875;3916;55;44;6;38;.864;3600000;0
16954;161583;170;99;39;1;38;.974;3600000;0
16954;57434;170;0;0;0;0;.00nan;0;0
16954;86344;1527;51;31;4;27;.871;3600000;0
16954;91202;1527;0;0;0;0;.00nan;0;0
16955;-1;175;0;0;0;0;.00nan;0;0
16955;-1;4247;0;0;0;0;.00nan;0;0
16955;44189;4247;97;23;0;23;1.000;3600000;0
16955;77084;175;80;32;2;30;.938;3514000;0
16956;175658;167;63;23;2;21;.913;3600000;0
16956;78587;167;0;0;0;0;.00nan;0;0
16956;78820;169;76;18;0;18;1.000;1217000;0
16956;91225;169;36;31;6;25;.806;2383000;0
16957;178695;174;0;0;0;0;.00nan;0;0
16957;175658;167;51;26;4;22;.846;3600000;0
16957;57426;174;50;25;3;22;.880;3600000;0
16957;78587;167;0;0;0;0;.00nan;0;0
16958;165532;3916;36;21;4;17;.810;1199000;0
16958;191026;172;0;0;0;0;.00nan;0;0
16958;78581;172;40;29;5;24;.828;3545000;0
16958;86875;3916;100;23;0;23;1.000;2401000;0
16959;-1;175;74;24;1;23;.958;3600000;0
16959;-1;4247;0;0;0;0;.00nan;0;0
16959;44189;4247;82;35;2;33;.943;3588000;0
16959;77084;175;0;0;0;0;.00nan;0;0
16960;161583;170;0;0;0;0;.00nan;0;0
16960;57434;170;68;29;2;27;.931;3900000;0
16960;78820;169;94;38;2;36;.947;3900000;0
16960;91225;169;0;0;0;0;.00nan;0;0
16961;44561;171;0;0;0;0;.00nan;0;0
16961;86344;1527;0;0;0;0;.00nan;0;0
16961;91202;1527;81;36;3;33;.917;3900000;0
16961;91703;171;94;47;3;44;.936;3900000;0
16962;178695;174;82;15;0;15;1.000;3600000;0
16962;175658;167;0;0;0;0;.00nan;0;0
16962;57426;174;0;0;0;0;.00nan;0;0
16962;78587;167;65;32;3;29;.906;3600000;0
16963;165532;3916;100;31;0;31;1.000;3600000;0
16963;191026;172;70;23;2;21;.913;3560000;0
16963;78581;172;0;0;0;0;.00nan;0;0
16963;86875;3916;0;0;0;0;.00nan;0;0
16964;-1;175;0;0;0;0;.00nan;0;0
16964;-1;4247;59;21;2;19;.905;3900000;0
16964;44189;4247;0;0;0;0;.00nan;0;0
16964;77084;175;87;32;2;30;.938;3900000;0
16965;161583;170;66;28;2;26;.929;3600000;0
16965;57434;170;0;0;0;0;.00nan;0;0
16965;78820;169;0;0;0;0;.00nan;0;0
16965;91225;169;37;30;6;24;.800;3600000;0
16966;44561;171;51;36;5;31;.861;3568000;0
16966;86344;1527;52;22;3;19;.864;3600000;0
16966;91202;1527;0;0;0;0;.00nan;0;0
16966;91703;171;0;0;0;0;.00nan;0;0
16967;-1;175;97;43;1;42;.977;3543000;0
16967;-1;4247;0;0;0;0;.00nan;0;0
16967;44189;4247;96;23;0;23;1.000;3600000;0
16967;77084;175;0;0;0;0;.00nan;0;0
16968;161583;170;0;0;0;0;.00nan;0;0
16968;178695;174;32;31;6;25;.806;3263000;0
16968;57426;174;43;3;1;2;.667;337000;0
16968;57434;170;100;35;0;35;1.000;3600000;0
16969;165532;3916;84;31;1;30;.968;3600000;0
16969;78820;169;66;48;6;42;.875;3600000;0
16969;86875;3916;0;0;0;0;.00nan;0;0
16969;91225;169;0;0;0;0;.00nan;0;0
16970;165532;3916;0;0;0;0;.00nan;0;0
16970;44561;171;0;0;0;0;.00nan;0;0
16970;86875;3916;54;29;3;26;.897;3534000;0
16970;91703;171;70;21;1;20;.952;3600000;0
16971;161583;170;0;0;0;0;.00nan;0;0
16971;191026;172;0;0;0;0;.00nan;0;0
16971;57434;170;82;45;4;41;.911;3550000;0
16971;78581;172;54;23;3;20;.870;3600000;0
16972;-1;175;0;0;0;0;.00nan;0;0
16972;175658;167;66;24;1;23;.958;1931000;0
16972;77084;175;85;26;1;25;.962;3600000;0
16972;78587;167;41;20;4;16;.800;1669000;0
16973;-1;4247;0;0;0;0;.00nan;0;0
16973;44189;4247;67;29;2;27;.931;3900000;0
16973;86344;1527;0;0;0;0;.00nan;0;0
16973;91202;1527;92;44;2;42;.955;3900000;0
16974;178695;174;0;0;0;0;.00nan;0;0
16974;57426;174;37;32;5;27;.844;3600000;0
16974;78820;169;81;25;1;24;.960;3600000;0
16974;91225;169;0;0;0;0;.00nan;0;0
16975;165532;3916;96;21;0;21;1.000;3600000;0
16975;44561;171;89;35;1;34;.971;3600000;0
16975;86875;3916;0;0;0;0;.00nan;0;0
16975;91703;171;0;0;0;0;.00nan;0;0
16976;161583;170;65;50;6;44;.880;3600000;0
16976;191026;172;99;46;1;45;.978;3600000;0
16976;57434;170;0;0;0;0;.00nan;0;0
16976;78581;172;0;0;0;0;.00nan;0;0
16977;178695;174;64;28;2;26;.929;3900000;0
16977;57426;174;0;0;0;0;.00nan;0;0
16977;78820;169;0;0;0;0;.00nan;0;0
16977;91225;169;90;38;2;36;.947;3900000;0
16978;165532;3916;76;40;4;36;.900;3531000;0
16978;86344;1527;66;19;2;17;.895;3600000;0
16978;86875;3916;0;0;0;0;.00nan;0;0
16978;91202;1527;0;0;0;0;.00nan;0;0
16979;-1;175;82;37;2;35;.946;3554000;0
16979;175658;167;97;30;1;29;.967;3600000;0
16979;77084;175;0;0;0;0;.00nan;0;0
16979;78587;167;0;0;0;0;.00nan;0;0
16980;-1;4247;100;28;0;28;1.000;3600000;0
16980;44189;4247;0;0;0;0;.00nan;0;0
16980;44561;171;0;0;0;0;.00nan;0;0
16980;91703;171;51;28;4;24;.857;3600000;0
16981;161583;170;0;0;0;0;.00nan;0;0
16981;191026;172;0;0;0;0;.00nan;0;0
16981;57434;170;62;40;4;36;.900;3600000;0
16981;78581;172;99;40;1;39;.975;3600000;0
16982;161583;170;0;0;0;0;.00nan;0;0
16982;175658;167;0;0;0;0;.00nan;0;0
16982;57434;170;29;22;5;17;.773;3570000;0
16982;78587;167;76;26;2;24;.923;3600000;0
16983;-1;4247;84;32;2;30;.938;3900000;0
16983;191026;172;0;0;0;0;.00nan;0;0
16983;44189;4247;0;0;0;0;.00nan;0;0
16983;78581;172;60;33;2;31;.939;3900000;0
16984;165532;3916;19;24;6;18;.750;3600000;0
16984;78820;169;44;41;7;34;.829;3552000;0
16984;86875;3916;0;0;0;0;.00nan;0;0
16984;91225;169;0;0;0;0;.00nan;0;0
16985;44561;171;90;45;2;43;.956;3586000;0
16985;86344;1527;0;0;0;0;.00nan;0;0
16985;91202;1527;59;10;1;9;.900;3600000;0
16985;91703;171;0;0;0;0;.00nan;0;0
16986;-1;175;0;0;0;0;.00nan;0;0
16986;178695;174;0;0;0;0;.00nan;0;0
16986;57426;174;98;40;1;39;.975;3600000;0
16986;77084;175;76;28;2;26;.929;3558000;0
16987;161583;170;76;39;2;37;.949;3600000;0
16987;175658;167;60;26;3;23;.885;3565000;0
16987;57434;170;0;0;0;0;.00nan;0;0
16987;78587;167;0;0;0;0;.00nan;0;0
16988;-1;4247;0;0;0;0;.00nan;0;0
16988;191026;172;67;31;3;28;.903;3600000;0
16988;44189;4247;57;26;4;22;.846;3600000;0
16988;78581;172;0;0;0;0;.00nan;0;0
16989;165532;3916;0;0;0;0;.00nan;0;0
16989;78820;169;0;0;0;0;.00nan;0;0
16989;86875;3916;44;35;5;30;.857;3600000;0
16989;91225;169;93;37;2;35;.946;3600000;0
16990;44561;171;0;0;0;0;.00nan;0;0
16990;86344;1527;31;28;5;23;.821;3600000;0
16990;91202;1527;0;0;0;0;.00nan;0;0
16990;91703;171;75;24;2;22;.917;3600000;0
16991;-1;175;65;22;1;21;.955;3600000;0
16991;178695;174;50;26;4;22;.846;3600000;0
16991;57426;174;0;0;0;0;.00nan;0;0
16991;77084;175;0;0;0;0;.00nan;0;0
16992;161583;170;0;0;0;0;.00nan;0;0
16992;165532;3916;71;37;3;34;.919;3527000;0
16992;57434;170;79;24;1;23;.958;3600000;0
16992;86875;3916;0;0;0;0;.00nan;0;0
16993;175658;167;0;0;0;0;.00nan;0;0
16993;78587;167;57;18;2;16;.889;3600000;0
16993;78820;169;30;30;6;24;.800;3600000;0
16993;91225;169;0;0;0;0;.00nan;0;0
16994;-1;175;0;0;0;0;.00nan;0;0
16994;44561;171;81;34;3;31;.912;3900000;0
16994;77084;175;73;34;3;31;.912;3900000;0
16994;91703;171;0;0;0;0;.00nan;0;0
16995;161583;170;42;28;5;23;.821;3600000;0
16995;57434;170;0;0;0;0;.00nan;0;0
16995;86344;1527;0;0;0;0;.00nan;0;0
16995;91202;1527;80;25;1;24;.960;3600000;0
16996;-1;4247;62;22;2;20;.909;3573000;0
16996;44189;4247;0;0;0;0;.00nan;0;0
16996;78820;169;0;0;0;0;.00nan;0;0
16996;91225;169;100;33;0;33;1.000;3600000;0
16997;178695;174;0;0;0;0;.00nan;0;0
16997;175658;167;21;14;4;10;.714;915000;0
16997;57426;174;100;27;0;27;1.000;3600000;0
16997;78587;167;65;26;2;24;.923;2685000;0
16998;-1;175;83;51;4;47;.922;3736000;0
16998;191026;172;0;0;0;0;.00nan;0;0
16998;77084;175;0;0;0;0;.00nan;0;0
16998;78581;172;56;21;3;18;.857;3736000;0
16999;165532;3916;0;0;0;0;.00nan;0;0
16999;44561;171;0;0;0;0;.00nan;0;0
16999;86875;3916;71;19;1;18;.947;3657000;0
16999;91703;171;87;39;2;37;.949;3657000;0
17000;-1;4247;0;0;0;0;.00nan;0;0
17000;44189;4247;53;23;4;19;.826;3600000;0
17000;78820;169;0;0;0;0;.00nan;0;0
17000;91225;169;84;27;1;26;.963;3600000;0
17001;178695;174;0;0;0;0;.00nan;0;0
17001;175658;167;92;41;3;38;.927;3600000;0
17001;57426;174;52;33;5;28;.848;3568000;0
17001;78587;167;0;0;0;0;.00nan;0;0
17002;165532;3916;60;42;5;37;.881;3600000;0
17002;86344;1527;65;22;2;20;.909;3600000;0
17002;86875;3916;0;0;0;0;.00nan;0;0
17002;91202;1527;0;0;0;0;.00nan;0;0
17003;-1;175;0;0;0;0;.00nan;0;0
17003;191026;172;57;28;3;25;.893;3600000;0
17003;77084;175;100;29;0;29;1.000;3600000;0
17003;78581;172;0;0;0;0;.00nan;0;0
17004;161583;170;0;0;0;0;.00nan;0;0
17004;44561;171;71;38;3;35;.921;3542000;0
17004;57434;170;62;23;2;21;.913;3600000;0
17004;91703;171;0;0;0;0;.00nan;0;0
17005;161583;170;0;0;0;0;.00nan;0;0
17005;175658;167;0;0;0;0;.00nan;0;0
17005;57434;170;78;23;1;22;.957;3720000;0
17005;78587;167;63;22;2;20;.909;3720000;0
17006;178695;174;0;0;0;0;.00nan;0;0
17006;191026;172;0;0;0;0;.00nan;0;0
17006;57426;174;100;49;2;47;.959;3900000;0
17006;78581;172;74;20;2;18;.900;3900000;0
17007;165532;3916;0;0;0;0;.00nan;0;0
17007;44561;171;0;0;0;0;.00nan;0;0
17007;86875;3916;78;32;3;29;.906;3900000;0
17007;91703;171;59;36;3;33;.917;3900000;0
17008;-1;4247;100;29;0;29;1.000;3900000;0
17008;44189;4247;0;0;0;0;.00nan;0;0
17008;86344;1527;0;0;0;0;.00nan;0;0
17008;91202;1527;83;13;0;13;1.000;3900000;0
17009;-1;175;0;0;0;0;.00nan;0;0
17009;77084;175;74;32;3;29;.906;3600000;0
17009;78820;169;35;27;5;22;.815;3535000;0
17009;91225;169;0;0;0;0;.00nan;0;0
17010;161583;170;100;24;0;24;1.000;3600000;0
17010;175658;167;77;26;2;24;.923;3566000;0
17010;57434;170;0;0;0;0;.00nan;0;0
17010;78587;167;0;0;0;0;.00nan;0;0
17011;178695;174;57;27;4;23;.852;3600000;0
17011;44561;171;52;39;5;34;.872;3545000;0
17011;57426;174;0;0;0;0;.00nan;0;0
17011;91703;171;0;0;0;0;.00nan;0;0
17012;165532;3916;88;42;2;40;.952;3600000;0
17012;191026;172;66;31;3;28;.903;3565000;0
17012;78581;172;0;0;0;0;.00nan;0;0
17012;86875;3916;0;0;0;0;.00nan;0;0
17013;-1;4247;0;0;0;0;.00nan;0;0
17013;44189;4247;30;26;6;20;.769;3600000;0
17013;86344;1527;51;9;1;8;.889;750000;0
17013;91202;1527;24;28;6;22;.786;2786000;0
17014;-1;175;46;31;5;26;.839;3600000;0
17014;77084;175;0;0;0;0;.00nan;0;0
17014;78820;169;0;0;0;0;.00nan;0;0
17014;91225;169;75;30;2;28;.933;3600000;0
17015;175658;167;0;0;0;0;.00nan;0;0
17015;78587;167;60;33;4;29;.879;3600000;0
17015;78820;169;0;0;0;0;.00nan;0;0
17015;91225;169;96;23;0;23;1.000;3600000;0
17016;175658;167;0;0;0;0;.00nan;0;0
17016;44561;171;0;0;0;0;.00nan;0;0
17016;78587;167;64;28;3;25;.893;3600000;0
17016;91703;171;32;23;5;18;.783;3573000;0
17017;-1;175;0;0;0;0;.00nan;0;0
17017;191026;172;0;0;0;0;.00nan;0;0
17017;77084;175;85;33;1;32;.970;3600000;0
17017;78581;172;64;30;3;27;.900;3576000;0
17018;161583;170;64;26;3;23;.885;3547000;0
17018;-1;4247;91;28;1;27;.964;3600000;0
17018;44189;4247;0;0;0;0;.00nan;0;0
17018;57434;170;0;0;0;0;.00nan;0;0
17019;165532;3916;0;0;0;0;.00nan;0;0
17019;178695;174;0;0;0;0;.00nan;0;0
17019;57426;174;100;46;2;44;.957;3900000;0
17019;86875;3916;91;36;2;34;.944;3900000;0
17020;78820;169;0;0;0;0;.00nan;0;0
17020;86344;1527;0;0;0;0;.00nan;0;0
17020;91202;1527;74;18;1;17;.944;3600000;0
17020;91225;169;78;39;3;36;.923;3572000;0
17021;175658;167;62;33;4;29;.879;3600000;0
17021;44561;171;0;0;0;0;.00nan;0;0
17021;78587;167;0;0;0;0;.00nan;0;0
17021;91703;171;97;36;1;35;.972;3600000;0
17022;-1;175;74;21;1;20;.952;3600000;0
17022;191026;172;55;38;6;32;.842;3159000;0
17022;77084;175;0;0;0;0;.00nan;0;0
17022;78581;172;48;5;1;4;.800;441000;0
17023;161583;170;0;0;0;0;.00nan;0;0
17023;-1;4247;0;0;0;0;.00nan;0;0
17023;44189;4247;66;21;2;19;.905;3600000;0
17023;57434;170;81;32;3;29;.906;3562000;0
17024;165532;3916;0;0;0;0;.00nan;0;0
17024;178695;174;55;32;4;28;.875;3600000;0
17024;57426;174;0;0;0;0;.00nan;0;0
17024;86875;3916;76;14;0;14;1.000;3600000;0
17025;78820;169;88;33;1;32;.970;3900000;0
17025;86344;1527;70;21;1;20;.952;3900000;0
17025;91202;1527;0;0;0;0;.00nan;0;0
17025;91225;169;0;0;0;0;.00nan;0;0
17026;-1;175;0;0;0;0;.00nan;0;0
17026;191026;172;0;0;0;0;.00nan;0;0
17026;77084;175;86;33;2;31;.939;3600000;0
17026;78581;172;51;25;4;21;.840;3546000;0
17027;178695;174;0;0;0;0;.00nan;0;0
17027;-1;4247;79;32;2;30;.938;3750000;0
17027;44189;4247;0;0;0;0;.00nan;0;0
17027;57426;174;74;34;3;31;.912;3750000;0
17028;78820;169;0;0;0;0;.00nan;0;0
17028;86344;1527;0;0;0;0;.00nan;0;0
17028;91202;1527;99;24;0;24;1.000;3600000;0
17028;91225;169;63;33;4;29;.879;3600000;0
17029;161583;170;40;14;3;11;.786;3600000;0
17029;175658;167;0;0;0;0;.00nan;0;0
17029;57434;170;0;0;0;0;.00nan;0;0
17029;78587;167;57;35;4;31;.886;3593000;0
17030;165532;3916;0;0;0;0;.00nan;0;0
17030;44561;171;25;26;7;19;.731;2199000;0
17030;86875;3916;94;33;1;32;.970;3600000;0
17030;91703;171;57;13;1;12;.923;1401000;0
17031;161583;170;0;0;0;0;.00nan;0;0
17031;165532;3916;93;35;1;34;.971;3600000;0
17031;57434;170;63;35;4;31;.886;3600000;0
17031;86875;3916;0;0;0;0;.00nan;0;0
17032;-1;175;0;0;0;0;.00nan;0;0
17032;175658;167;0;0;0;0;.00nan;0;0
17032;77084;175;88;34;2;32;.941;3900000;0
17032;78587;167;91;36;2;34;.944;3900000;0
17033;178695;174;0;0;0;0;.00nan;0;0
17033;57426;174;80;34;2;32;.941;3600000;0
17033;86344;1527;0;0;0;0;.00nan;0;0
17033;91202;1527;42;14;3;11;.786;3561000;0
17034;191026;172;0;0;0;0;.00nan;0;0
17034;78581;172;89;27;1;26;.963;3600000;0
17034;78820;169;0;0;0;0;.00nan;0;0
17034;91225;169;52;29;4;25;.862;3600000;0
17035;-1;4247;82;22;1;21;.955;3600000;0
17035;44189;4247;0;0;0;0;.00nan;0;0
17035;44561;171;0;0;0;0;.00nan;0;0
17035;91703;171;71;41;4;37;.902;3600000;0
17036;161583;170;66;37;3;34;.919;3900000;0
17036;165532;3916;0;0;0;0;.00nan;0;0
17036;57434;170;0;0;0;0;.00nan;0;0
17036;86875;3916;71;32;3;29;.906;3900000;0
17037;178695;174;100;31;0;31;1.000;3600000;0
17037;57426;174;0;0;0;0;.00nan;0;0
17037;86344;1527;0;0;0;0;.00nan;0;0
17037;91202;1527;82;30;2;28;.933;3600000;0
17038;-1;175;66;41;4;37;.902;3600000;0
17038;175658;167;47;33;5;28;.848;3600000;0
17038;77084;175;0;0;0;0;.00nan;0;0
17038;78587;167;0;0;0;0;.00nan;0;0
17039;191026;172;56;16;2;14;.875;3600000;0
17039;78581;172;0;0;0;0;.00nan;0;0
17039;78820;169;66;28;3;25;.893;3544000;0
17039;91225;169;0;0;0;0;.00nan;0;0
17040;-1;4247;0;0;0;0;.00nan;0;0
17040;44189;4247;81;26;2;24;.923;3900000;0
17040;44561;171;65;29;2;27;.931;3900000;0
17040;91703;171;0;0;0;0;.00nan;0;0
17041;191026;172;0;0;0;0;.00nan;0;0
17041;78581;172;76;26;2;24;.923;3600000;0
17041;78820;169;0;0;0;0;.00nan;0;0
17041;91225;169;83;51;4;47;.922;3545000;0
17042;178695;174;53;32;4;28;.875;3900000;0
17042;-1;4247;86;46;4;42;.913;3900000;0
17042;44189;4247;0;0;0;0;.00nan;0;0
17042;57426;174;0;0;0;0;.00nan;0;0
17043;161583;170;0;0;0;0;.00nan;0;0
17043;57434;170;87;30;2;28;.933;3600000;0
17043;77084;175;0;0;0;0;.00nan;0;0
17043;78587;175;56;26;4;22;.846;3514000;0
17044;191026;172;0;0;0;0;.00nan;0;0
17044;78581;172;83;34;2;32;.941;3634000;0
17044;86344;1527;0;0;0;0;.00nan;0;0
17044;91202;1527;57;26;3;23;.885;3634000;0
17045;165532;3916;0;0;0;0;.00nan;0;0
17045;-1;4247;0;0;0;0;.00nan;0;0
17045;44189;4247;100;34;0;34;1.000;3600000;0
17045;86875;3916;85;32;1;31;.969;3545000;0
17046;178695;174;0;0;0;0;.00nan;0;0
17046;44561;171;35;5;2;3;.600;717000;0
17046;57426;174;78;37;2;35;.946;3600000;0
17046;91703;171;26;18;5;13;.722;2883000;0
17047;189333;167;0;0;0;0;.00nan;0;0
17047;175658;167;27;27;6;21;.778;3555000;0
17047;78820;169;0;0;0;0;.00nan;0;0
17047;91225;169;36;26;5;21;.808;3600000;0
17048;161583;170;75;22;1;21;.955;3795000;0
17048;57434;170;0;0;0;0;.00nan;0;0
17048;77084;175;91;38;2;36;.947;3795000;0
17048;78587;175;0;0;0;0;.00nan;0;0
17049;191026;172;63;35;4;31;.886;3793000;0
17049;78581;172;0;0;0;0;.00nan;0;0
17049;86344;1527;57;25;3;22;.880;3793000;0
17049;91202;1527;0;0;0;0;.00nan;0;0
17050;178695;174;45;24;4;20;.833;3568000;0
17050;44561;171;71;28;2;26;.929;3600000;0
17050;57426;174;0;0;0;0;.00nan;0;0
17050;91703;171;0;0;0;0;.00nan;0;0
17051;165532;3916;0;0;0;0;.00nan;0;0
17051;-1;4247;19;9;4;5;.556;1171000;0
17051;44189;4247;42;16;3;13;.813;2429000;0
17051;86875;3916;90;38;2;36;.947;3600000;0
17052;189333;167;75;29;2;27;.931;3900000;0
17052;175658;167;0;0;0;0;.00nan;0;0
17052;78820;169;91;34;2;32;.941;3900000;0
17052;91225;169;0;0;0;0;.00nan;0;0
17107;-1;175;74;41;4;37;.902;3600000;0
17107;77084;175;0;0;0;0;.00nan;0;0
17107;78820;169;0;0;0;0;.00nan;0;0
17107;85228;169;81;22;1;21;.955;3600000;0
17109;44203;170;79;30;2;28;.933;3600000;0
17109;57434;170;0;0;0;0;.00nan;0;0
17109;86344;1527;49;26;4;22;.846;3600000;0
17109;91202;1527;0;0;0;0;.00nan;0;0
17111;165532;3916;0;0;0;0;.00nan;0;0
17111;44561;171;0;0;0;0;.00nan;0;0
17111;86875;3916;69;24;2;22;.917;3748000;0
17111;91703;171;73;28;3;25;.893;3748000;0
17113;173961;172;0;0;0;0;.00nan;0;0
17113;175658;167;73;39;3;36;.923;3600000;0
17113;191026;172;99;26;0;26;1.000;3600000;0
17113;78587;167;0;0;0;0;.00nan;0;0
17115;6541;174;0;0;0;0;.00nan;0;0
17115;178695;174;59;19;2;17;.895;3545000;0
17115;-1;4247;100;36;1;35;.972;3600000;0
17115;44189;4247;0;0;0;0;.00nan;0;0
17116;-1;428;0;0;0;0;.00nan;0;0
17116;173519;441;0;0;0;0;.00nan;0;0
17116;174386;428;69;20;1;19;.950;3600000;0
17116;179657;441;75;31;2;29;.935;3576000;0
17117;189288;419;58;22;2;20;.909;3600000;0
17117;184024;444;0;0;0;0;.00nan;0;0
17117;-1;419;0;0;0;0;.00nan;0;0
17117;191812;444;52;33;4;29;.879;3600000;0
17118;171930;422;88;40;3;37;.925;3580000;0
17118;188965;423;83;31;1;30;.968;3600000;0
17118;179127;422;0;0;0;0;.00nan;0;0
17118;179143;423;0;0;0;0;.00nan;0;0
17119;189288;419;0;0;0;0;.00nan;0;0
17119;184024;444;0;0;0;0;.00nan;0;0
17119;-1;419;49;23;3;20;.870;3559000;0
17119;191812;444;85;25;1;24;.960;3600000;0
17120;171930;422;61;35;4;31;.886;3852000;0
17120;188965;423;57;28;3;25;.893;3852000;0
17120;179127;422;0;0;0;0;.00nan;0;0
17120;179143;423;0;0;0;0;.00nan;0;0
17121;183885;449;92;28;1;27;.964;3600000;0
17121;179071;420;0;0;0;0;.00nan;0;0
17121;186076;420;42;32;5;27;.844;3600000;0
17121;141530;449;0;0;0;0;.00nan;0;0
17122;187689;421;80;26;1;25;.962;3596000;0
17122;194598;418;0;0;0;0;.00nan;0;0
17122;184060;421;0;0;0;0;.00nan;0;0
17122;180965;418;100;36;0;36;1.000;3600000;0
17123;183885;449;74;26;2;24;.923;3600000;0
17123;179071;420;89;28;1;27;.964;3600000;0
17123;186076;420;0;0;0;0;.00nan;0;0
17123;141530;449;0;0;0;0;.00nan;0;0
17124;187689;421;49;28;3;25;.893;3600000;0
17124;194598;418;0;0;0;0;.00nan;0;0
17124;184060;421;0;0;0;0;.00nan;0;0
17124;180965;418;76;20;1;19;.950;3600000;0
17125;190073;413;68;32;3;29;.906;3600000;0
17125;181346;414;0;0;0;0;.00nan;0;0
17125;187309;414;83;28;1;27;.964;3600000;0
17125;192627;413;0;0;0;0;.00nan;0;0
17126;178679;435;0;0;0;0;.00nan;0;0
17126;-1;433;71;34;3;31;.912;3903000;0
17126;-1;433;0;0;0;0;.00nan;0;0
17126;-1;435;92;39;2;37;.949;3903000;0
17127;163177;425;0;0;0;0;.00nan;0;0
17127;173339;430;61;24;3;21;.875;3600000;0
17127;170878;430;0;0;0;0;.00nan;0;0
17127;-1;425;62;44;5;39;.886;3527000;0
17128;186671;434;58;23;3;20;.870;3600000;0
17128;-1;426;68;34;4;30;.882;3600000;0
17128;-1;426;0;0;0;0;.00nan;0;0
17128;152650;434;0;0;0;0;.00nan;0;0
17129;182475;437;0;0;0;0;.00nan;0;0
17129;190157;442;94;31;1;30;.968;3600000;0
17129;181100;442;0;0;0;0;.00nan;0;0
17129;139865;437;56;38;4;34;.895;3600000;0
17130;194650;410;0;0;0;0;.00nan;0;0
17130;184183;410;90;25;1;24;.960;3899000;0
17130;-1;412;100;26;0;26;1.000;3899000;0
17130;-1;412;0;0;0;0;.00nan;0;0
17131;187689;421;0;0;0;0;.00nan;0;0
17131;183885;449;47;21;3;18;.857;4200000;0
17131;184060;421;70;28;3;25;.893;4200000;0
17131;141530;449;0;0;0;0;.00nan;0;0
17132;183832;436;55;29;4;25;.862;3600000;0
17132;189783;440;75;27;1;26;.963;3600000;0
17132;175723;440;0;0;0;0;.00nan;0;0
17132;191861;436;0;0;0;0;.00nan;0;0
17133;171787;4849;0;0;0;0;.00nan;0;0
17133;189288;419;0;0;0;0;.00nan;0;0
17133;-1;419;71;24;2;22;.917;3813000;0
17133;196412;4849;83;35;3;32;.914;3813000;0
17134;163177;425;0;0;0;0;.00nan;0;0
17134;170499;427;36;20;4;16;.800;1086000;0
17134;-1;425;69;29;3;26;.897;3600000;0
17134;186468;427;63;25;2;23;.920;2514000;0
17135;184336;429;0;0;0;0;.00nan;0;0
17135;170928;443;0;0;0;0;.00nan;0;0
17135;182180;443;99;25;0;25;1.000;3600000;0
17135;-1;429;63;33;3;30;.909;3600000;0
17136;194598;418;0;0;0;0;.00nan;0;0
17136;179071;420;43;34;5;29;.853;3600000;0
17136;180965;418;68;23;2;21;.913;3600000;0
17136;186076;420;0;0;0;0;.00nan;0;0
17137;177155;411;45;34;6;28;.824;3600000;0
17137;184033;411;0;0;0;0;.00nan;0;0
17137;194854;417;0;0;0;0;.00nan;0;0
17137;178890;417;79;35;2;33;.943;3600000;0
17138;171930;422;100;25;0;25;1.000;3600000;0
17138;184024;444;0;0;0;0;.00nan;0;0
17138;179127;422;0;0;0;0;.00nan;0;0
17138;191812;444;72;24;1;23;.958;3550000;0
17139;165023;438;0;0;0;0;.00nan;0;0
17139;173954;438;79;32;3;29;.906;3729000;0
17139;179478;432;0;0;0;0;.00nan;0;0
17139;187412;432;49;27;4;23;.852;3729000;0
17140;174420;439;0;0;0;0;.00nan;0;0
17140;182210;439;64;17;1;16;.941;3600000;0
17140;182225;431;0;0;0;0;.00nan;0;0
17140;191171;431;52;44;5;39;.886;3600000;0
17141;190073;413;43;26;4;22;.846;3580000;0
17141;179689;415;61;31;3;28;.903;3600000;0
17141;191877;415;0;0;0;0;.00nan;0;0
17141;192627;413;0;0;0;0;.00nan;0;0
17142;178679;435;0;0;0;0;.00nan;0;0
17142;186671;434;80;33;2;31;.939;4200000;0
17142;-1;435;70;34;2;32;.941;4200000;0
17142;152650;434;0;0;0;0;.00nan;0;0
17143;183832;436;72;30;2;28;.933;3600000;0
17143;189783;440;61;26;3;23;.885;3569000;0
17143;175723;440;0;0;0;0;.00nan;0;0
17143;191861;436;0;0;0;0;.00nan;0;0
17144;171787;4849;0;0;0;0;.00nan;0;0
17144;189288;419;0;0;0;0;.00nan;0;0
17144;-1;419;72;13;1;12;.923;3600000;0
17144;196412;4849;84;49;4;45;.918;3600000;0
17145;170499;427;63;18;2;16;.889;3600000;0
17145;170928;443;0;0;0;0;.00nan;0;0
17145;182180;443;46;36;5;31;.861;3600000;0
17145;186468;427;0;0;0;0;.00nan;0;0
17146;177155;411;0;0;0;0;.00nan;0;0
17146;184033;411;65;31;3;28;.903;4200000;0
17146;-1;412;89;45;3;42;.933;4200000;0
17146;-1;412;0;0;0;0;.00nan;0;0
17147;182475;437;0;0;0;0;.00nan;0;0
17147;165023;438;0;0;0;0;.00nan;0;0
17147;173954;438;99;44;2;42;.955;4200000;0
17147;139865;437;67;29;2;27;.931;4200000;0
17148;187689;421;90;29;1;28;.966;3600000;0
17148;183885;449;0;0;0;0;.00nan;0;0
17148;184060;421;0;0;0;0;.00nan;0;0
17148;141530;449;64;37;4;33;.892;3600000;0
17149;194598;418;88;35;2;33;.943;3600000;0
17149;179071;420;49;28;4;24;.857;3573000;0
17149;180965;418;0;0;0;0;.00nan;0;0
17149;186076;420;0;0;0;0;.00nan;0;0
17150;171930;422;51;36;5;31;.861;3565000;0
17150;184024;444;72;30;2;28;.933;3600000;0
17150;179127;422;0;0;0;0;.00nan;0;0
17150;191812;444;0;0;0;0;.00nan;0;0
17151;194650;410;25;16;4;12;.750;1164000;0
17151;194854;417;31;16;4;12;.750;3600000;0
17151;184183;410;64;16;1;15;.938;2381000;0
17151;178890;417;0;0;0;0;.00nan;0;0
17152;174420;439;0;0;0;0;.00nan;0;0
17152;179478;432;0;0;0;0;.00nan;0;0
17152;182210;439;35;30;6;24;.800;3600000;0
17152;187412;432;65;19;2;17;.895;3600000;0
17153;179689;415;93;45;2;43;.956;4057000;0
17153;181346;414;0;0;0;0;.00nan;0;0
17153;187309;414;86;33;1;32;.970;4057000;0
17153;191877;415;0;0;0;0;.00nan;0;0
17154;190157;442;73;24;2;22;.917;3600000;0
17154;181100;442;0;0;0;0;.00nan;0;0
17154;182225;431;55;4;0;4;1.000;263000;0
17154;191171;431;37;46;7;39;.848;3337000;0
17155;163177;425;69;22;1;21;.955;3600000;0
17155;-1;425;0;0;0;0;.00nan;0;0
17155;-1;426;0;0;0;0;.00nan;0;0
17155;-1;426;95;55;4;51;.927;3600000;0
17156;182475;437;0;0;0;0;.00nan;0;0
17156;179478;432;0;0;0;0;.00nan;0;0
17156;187412;432;62;25;2;23;.920;3600000;0
17156;139865;437;63;38;4;34;.895;3532000;0
17157;194854;417;80;43;3;40;.930;3754000;0
17157;178890;417;0;0;0;0;.00nan;0;0
17157;181346;414;0;0;0;0;.00nan;0;0
17157;187309;414;65;25;2;23;.920;3754000;0
17158;183832;436;61;17;1;16;.941;3600000;0
17158;-1;428;0;0;0;0;.00nan;0;0
17158;174386;428;64;43;5;38;.884;3600000;0
17158;191861;436;0;0;0;0;.00nan;0;0
17159;179478;432;70;37;3;34;.919;3513000;0
17159;182225;431;80;27;1;26;.963;3600000;0
17159;191171;431;0;0;0;0;.00nan;0;0
17159;187412;432;0;0;0;0;.00nan;0;0
17160;170928;443;72;19;1;18;.947;3600000;0
17160;182180;443;0;0;0;0;.00nan;0;0
17160;-1;426;0;0;0;0;.00nan;0;0
17160;-1;426;64;25;3;22;.880;3521000;0
17161;181346;414;0;0;0;0;.00nan;0;0
17161;-1;412;99;41;2;39;.951;3600000;0
17161;187309;414;59;28;3;25;.893;3594000;0
17161;-1;412;0;0;0;0;.00nan;0;0
17162;183885;449;98;57;4;53;.930;3600000;0
17162;189288;419;63;15;1;14;.933;3600000;0
17162;-1;419;0;0;0;0;.00nan;0;0
17162;141530;449;0;0;0;0;.00nan;0;0
17163;163177;425;0;0;0;0;.00nan;0;0
17163;178679;435;67;14;0;14;1.000;1854000;0
17163;-1;425;65;21;2;19;.905;3600000;0
17163;-1;435;46;25;4;21;.840;1746000;0
17164;189783;440;0;0;0;0;.00nan;0;0
17164;175723;440;79;29;2;27;.931;3600000;0
17164;190157;442;36;31;5;26;.839;3600000;0
17164;181100;442;0;0;0;0;.00nan;0;0
17165;187689;421;78;31;2;29;.935;3600000;0
17165;184024;444;43;30;5;25;.833;3019000;0
17165;184060;421;0;0;0;0;.00nan;0;0
17165;191812;444;31;9;3;6;.667;581000;0
17166;194650;410;71;35;3;32;.914;3576000;0
17166;184183;410;0;0;0;0;.00nan;0;0
17166;190073;413;76;26;2;24;.923;3600000;0
17166;192627;413;0;0;0;0;.00nan;0;0
17167;184336;429;0;0;0;0;.00nan;0;0
17167;-1;429;35;21;4;17;.810;3525000;0
17167;186671;434;82;35;2;33;.943;3600000;0
17167;152650;434;0;0;0;0;.00nan;0;0
17168;170499;427;69;37;3;34;.919;4187000;0
17168;-1;433;96;49;2;47;.959;4187000;0
17168;186468;427;0;0;0;0;.00nan;0;0
17168;-1;433;0;0;0;0;.00nan;0;0
17169;171787;4849;0;0;0;0;.00nan;0;0
17169;179071;420;53;22;2;20;.909;4009000;0
17169;196412;4849;73;30;3;27;.900;4009000;0
17169;186076;420;0;0;0;0;.00nan;0;0
17170;188965;423;91;35;2;33;.943;3600000;0
17170;194598;418;0;0;0;0;.00nan;0;0
17170;179143;423;0;0;0;0;.00nan;0;0
17170;180965;418;42;26;4;22;.846;3575000;0
17171;177155;411;0;0;0;0;.00nan;0;0
17171;184033;411;73;31;3;28;.903;3839000;0
17171;179689;415;68;38;4;34;.895;3839000;0
17171;191877;415;0;0;0;0;.00nan;0;0
17172;165023;438;54;34;4;30;.882;3802000;0
17172;183832;436;0;0;0;0;.00nan;0;0
17172;173954;438;0;0;0;0;.00nan;0;0
17172;191861;436;53;26;3;23;.885;3802000;0
17173;173519;441;0;0;0;0;.00nan;0;0
17173;174420;439;0;0;0;0;.00nan;0;0
17173;179657;441;76;46;4;42;.913;3600000;0
17173;182210;439;79;13;0;13;1.000;3600000;0
17174;187689;421;0;0;0;0;.00nan;0;0
17174;184024;444;0;0;0;0;.00nan;0;0
17174;184060;421;48;39;5;34;.872;3514000;0
17174;191812;444;69;30;3;27;.900;3600000;0
17175;182475;437;0;0;0;0;.00nan;0;0
17175;-1;428;0;0;0;0;.00nan;0;0
17175;174386;428;73;34;3;31;.912;3600000;0
17175;139865;437;45;20;4;16;.800;3571000;0
17176;189783;440;81;27;2;25;.926;3674000;0
17176;175723;440;0;0;0;0;.00nan;0;0
17176;190157;442;0;0;0;0;.00nan;0;0
17176;181100;442;82;37;3;34;.919;3674000;0
17177;173339;430;72;45;4;41;.911;3600000;0
17177;170878;430;0;0;0;0;.00nan;0;0
17177;-1;426;0;0;0;0;.00nan;0;0
17177;-1;426;94;31;1;30;.968;3600000;0
17178;177155;411;0;0;0;0;.00nan;0;0
17178;184033;411;50;28;4;24;.857;3600000;0
17178;190073;413;0;0;0;0;.00nan;0;0
17178;192627;413;72;41;3;38;.927;3600000;0
17179;183885;449;0;0;0;0;.00nan;0;0
17179;189288;419;0;0;0;0;.00nan;0;0
17179;-1;419;82;24;1;23;.958;3600000;0
17179;141530;449;74;37;3;34;.919;3566000;0
17180;170499;427;81;41;4;37;.902;3600000;0
17180;186468;427;0;0;0;0;.00nan;0;0
17180;186671;434;0;0;0;0;.00nan;0;0
17180;152650;434;78;12;0;12;1.000;3600000;0
17181;184336;429;50;17;2;15;.882;3600000;0
17181;-1;429;0;0;0;0;.00nan;0;0
17181;-1;433;0;0;0;0;.00nan;0;0
17181;-1;433;53;31;4;27;.871;3600000;0
17182;194854;417;55;6;0;6;1.000;1018000;0
17182;178890;417;23;29;6;23;.793;2582000;0
17182;-1;412;52;1;0;1;1.000;316000;0
17182;-1;412;42;28;5;23;.821;3284000;0
17183;171787;4849;92;35;2;33;.943;3600000;0
17183;179071;420;0;0;0;0;.00nan;0;0
17183;196412;4849;0;0;0;0;.00nan;0;0
17183;186076;420;55;26;3;23;.885;3600000;0
17184;188965;423;0;0;0;0;.00nan;0;0
17184;194598;418;54;33;4;29;.879;3546000;0
17184;179143;423;75;25;2;23;.920;3600000;0
17184;180965;418;0;0;0;0;.00nan;0;0
17185;194650;410;93;43;3;40;.930;3600000;0
17185;184183;410;0;0;0;0;.00nan;0;0
17185;179689;415;0;0;0;0;.00nan;0;0
17185;191877;415;48;28;4;24;.857;3558000;0
17186;178679;435;0;0;0;0;.00nan;0;0
17186;170928;443;0;0;0;0;.00nan;0;0
17186;182180;443;67;18;1;17;.944;3600000;0
17186;-1;435;65;29;3;26;.897;3581000;0
17187;173519;441;12;21;6;15;.714;1652000;0
17187;174420;439;0;0;0;0;.00nan;0;0
17187;179657;441;68;21;1;20;.952;1948000;0
17187;182210;439;72;18;1;17;.944;3600000;0
17188;177155;411;89;19;0;19;1.000;3600000;0
17188;194650;410;0;0;0;0;.00nan;0;0
17188;184033;411;0;0;0;0;.00nan;0;0
17188;184183;410;43;25;4;21;.840;3600000;0
17189;173339;430;92;36;1;35;.972;3600000;0
17189;170878;430;0;0;0;0;.00nan;0;0
17189;170928;443;0;0;0;0;.00nan;0;0
17189;182180;443;51;39;5;34;.872;3600000;0
17190;165023;438;0;0;0;0;.00nan;0;0
17190;173954;438;56;21;3;18;.857;3600000;0
17190;182225;431;0;0;0;0;.00nan;0;0
17190;191171;431;45;25;4;21;.840;3562000;0
17191;171787;4849;0;0;0;0;.00nan;0;0
17191;194598;418;0;0;0;0;.00nan;0;0
17191;196412;4849;64;36;3;33;.917;3582000;0
17191;180965;418;84;30;1;29;.967;3600000;0
17192;165023;438;70;46;5;41;.891;3547000;0
17192;173954;438;0;0;0;0;.00nan;0;0
17192;179478;432;53;19;3;16;.842;3600000;0
17192;187412;432;0;0;0;0;.00nan;0;0
17193;179689;415;42;22;4;18;.818;3581000;0
17193;-1;412;62;31;3;28;.903;3600000;0
17193;191877;415;0;0;0;0;.00nan;0;0
17193;-1;412;0;0;0;0;.00nan;0;0
17194;187689;421;85;44;2;42;.955;4186000;0
17194;189288;419;76;28;2;26;.929;4200000;0
17194;184060;421;0;0;0;0;.00nan;0;0
17194;-1;419;0;0;0;0;.00nan;0;0
17195;183832;436;72;18;2;16;.889;3600000;0
17195;186671;434;0;0;0;0;.00nan;0;0
17195;191861;436;0;0;0;0;.00nan;0;0
17195;152650;434;64;33;3;30;.909;3592000;0
17196;170499;427;50;23;4;19;.826;4200000;0
17196;190157;442;59;36;4;32;.889;4200000;0
17196;181100;442;0;0;0;0;.00nan;0;0
17196;186468;427;0;0;0;0;.00nan;0;0
17197;-1;428;0;0;0;0;.00nan;0;0
17197;174386;428;46;25;4;21;.840;3641000;0
17197;-1;433;87;42;3;39;.929;3641000;0
17197;-1;433;0;0;0;0;.00nan;0;0
17198;188965;423;27;12;4;8;.667;1069000;0
17198;184024;444;0;0;0;0;.00nan;0;0
17198;179143;423;75;24;2;22;.917;2531000;0
17198;191812;444;49;21;3;18;.857;3600000;0
17199;173339;430;0;0;0;0;.00nan;0;0
17199;170878;430;74;34;2;32;.941;3895000;0
17199;170928;443;0;0;0;0;.00nan;0;0
17199;182180;443;77;25;1;24;.960;3895000;0
17200;173519;441;0;0;0;0;.00nan;0;0
17200;178679;435;0;0;0;0;.00nan;0;0
17200;179657;441;85;36;3;33;.917;3564000;0
17200;-1;435;63;16;1;15;.938;3600000;0
17201;182475;437;0;0;0;0;.00nan;0;0
17201;184336;429;0;0;0;0;.00nan;0;0
17201;-1;429;38;26;5;21;.808;3593000;0
17201;139865;437;77;43;3;40;.930;3600000;0
17202;194854;417;49;31;4;27;.871;3972000;0
17202;178890;417;0;0;0;0;.00nan;0;0
17202;190073;413;0;0;0;0;.00nan;0;0
17202;192627;413;64;38;5;33;.868;3972000;0
17203;171930;422;79;30;3;27;.900;3600000;0
17203;179071;420;0;0;0;0;.00nan;0;0
17203;179127;422;0;0;0;0;.00nan;0;0
17203;186076;420;78;44;4;40;.909;3544000;0
17204;163177;425;0;0;0;0;.00nan;0;0
17204;179478;432;0;0;0;0;.00nan;0;0
17204;-1;425;48;23;4;19;.826;3544000;0
17204;187412;432;81;38;3;35;.921;3600000;0
17205;177155;411;0;0;0;0;.00nan;0;0
17205;184033;411;66;41;4;37;.902;3573000;0
17205;181346;414;0;0;0;0;.00nan;0;0
17205;187309;414;79;35;3;32;.914;3600000;0
17206;190073;413;46;13;3;10;.769;542000;0
17206;-1;412;0;0;0;0;.00nan;0;0
17206;192627;413;53;31;4;27;.871;3058000;0
17206;-1;412;56;32;4;28;.875;3600000;0
17207;183832;436;0;0;0;0;.00nan;0;0
17207;-1;433;0;0;0;0;.00nan;0;0
17207;191861;436;46;26;4;22;.846;3558000;0
17207;-1;433;97;41;2;39;.951;3600000;0
17208;187689;421;0;0;0;0;.00nan;0;0
17208;189288;419;0;0;0;0;.00nan;0;0
17208;184060;421;94;43;1;42;.977;4200000;0
17208;-1;419;72;24;1;23;.958;4200000;0
17209;182475;437;72;37;3;34;.919;3600000;0
17209;170499;427;0;0;0;0;.00nan;0;0
17209;186468;427;78;33;2;31;.939;3600000;0
17209;139865;437;0;0;0;0;.00nan;0;0
17210;-1;428;92;21;0;21;1.000;3600000;0
17210;174386;428;0;0;0;0;.00nan;0;0
17210;186671;434;70;23;1;22;.957;3574000;0
17210;152650;434;0;0;0;0;.00nan;0;0
17211;189783;440;0;0;0;0;.00nan;0;0
17211;175723;440;58;26;3;23;.885;3600000;0
17211;-1;426;0;0;0;0;.00nan;0;0
17211;-1;426;83;16;0;16;1.000;3600000;0
17212;188965;423;38;18;4;14;.778;3623000;0
17212;184024;444;78;37;3;34;.919;3623000;0
17212;179143;423;0;0;0;0;.00nan;0;0
17212;191812;444;0;0;0;0;.00nan;0;0
17213;163177;425;55;10;1;9;.900;3600000;0
17213;173519;441;76;51;4;47;.922;3600000;0
17213;179657;441;0;0;0;0;.00nan;0;0
17213;-1;425;0;0;0;0;.00nan;0;0
17214;184336;429;25;23;5;18;.783;3600000;0
17214;190157;442;68;20;1;19;.950;1158000;0
17214;181100;442;26;26;6;20;.769;2357000;0
17214;-1;429;0;0;0;0;.00nan;0;0
17215;171930;422;0;0;0;0;.00nan;0;0
17215;179071;420;70;33;3;30;.909;3600000;0
17215;179127;422;56;30;4;26;.867;3590000;0
17215;186076;420;0;0;0;0;.00nan;0;0
17216;194854;417;0;0;0;0;.00nan;0;0
17216;178890;417;72;40;4;36;.900;4026000;0
17216;179689;415;0;0;0;0;.00nan;0;0
17216;191877;415;77;29;3;26;.897;4026000;0
17217;171787;4849;0;0;0;0;.00nan;0;0
17217;194598;418;0;0;0;0;.00nan;0;0
17217;196412;4849;62;30;3;27;.900;3537000;0
17217;180965;418;83;28;1;27;.964;3600000;0
17218;194650;410;58;27;3;24;.889;3676000;0
17218;184183;410;0;0;0;0;.00nan;0;0
17218;181346;414;59;32;4;28;.875;3676000;0
17218;187309;414;0;0;0;0;.00nan;0;0
17219;177155;411;0;0;0;0;.00nan;0;0
17219;194650;410;0;0;0;0;.00nan;0;0
17219;184033;411;44;32;5;27;.844;3600000;0
17219;184183;410;84;33;2;31;.939;3600000;0
17220;182475;437;0;0;0;0;.00nan;0;0
17220;178679;435;46;5;1;4;.800;621000;0
17220;-1;435;29;28;6;22;.786;2979000;0
17220;139865;437;54;28;4;24;.857;3600000;0
17221;163177;425;0;0;0;0;.00nan;0;0
17221;-1;428;93;52;3;49;.942;3600000;0
17221;174386;428;0;0;0;0;.00nan;0;0
17221;-1;425;73;9;0;9;1.000;3600000;0
17222;194598;418;33;17;4;13;.765;1769000;0
17222;184024;444;0;0;0;0;.00nan;0;0
17222;180965;418;11;19;6;13;.684;1831000;0
17222;191812;444;58;37;5;32;.865;3600000;0
17223;188965;423;87;18;0;18;1.000;3600000;0
17223;183885;449;41;39;6;33;.846;2391000;0
17223;179143;423;0;0;0;0;.00nan;0;0
17223;141530;449;59;20;2;18;.900;1209000;0
17224;183832;436;52;44;6;38;.864;3600000;0
17224;173339;430;48;20;3;17;.850;3600000;0
17224;170878;430;0;0;0;0;.00nan;0;0
17224;191861;436;0;0;0;0;.00nan;0;0
17225;194854;417;0;0;0;0;.00nan;0;0
17225;178890;417;71;36;4;32;.889;3551000;0
17225;190073;413;0;0;0;0;.00nan;0;0
17225;192627;413;76;38;3;35;.921;3600000;0
17226;178679;435;73;30;2;28;.933;3600000;0
17226;-1;426;0;0;0;0;.00nan;0;0
17226;-1;426;70;26;3;23;.885;3543000;0
17226;-1;435;0;0;0;0;.00nan;0;0
17227;170928;443;0;0;0;0;.00nan;0;0
17227;182180;443;88;29;1;28;.966;3600000;0
17227;186671;434;69;32;3;29;.906;3538000;0
17227;152650;434;0;0;0;0;.00nan;0;0
17228;182225;431;94;33;2;31;.939;3577000;0
17228;-1;433;89;32;1;31;.969;3600000;0
17228;191171;431;0;0;0;0;.00nan;0;0
17228;-1;433;0;0;0;0;.00nan;0;0
17229;171787;4849;0;0;0;0;.00nan;0;0
17229;171930;422;75;37;3;34;.919;3543000;0
17229;179127;422;0;0;0;0;.00nan;0;0
17229;196412;4849;100;45;1;44;.978;3600000;0
17230;189783;440;47;36;5;31;.861;3519000;0
17230;179478;432;0;0;0;0;.00nan;0;0
17230;175723;440;0;0;0;0;.00nan;0;0
17230;187412;432;55;27;3;24;.889;3600000;0
17231;179689;415;43;34;5;29;.853;3600000;0
17231;-1;412;97;28;0;28;1.000;3600000;0
17231;191877;415;0;0;0;0;.00nan;0;0
17231;-1;412;0;0;0;0;.00nan;0;0
17232;177155;411;89;26;1;25;.962;4200000;0
17232;184033;411;0;0;0;0;.00nan;0;0
17232;181346;414;0;0;0;0;.00nan;0;0
17232;187309;414;99;44;1;43;.977;4200000;0
17233;173519;441;52;4;0;4;1.000;668000;0
17233;190157;442;77;25;1;24;.960;3600000;0
17233;179657;441;38;39;6;33;.846;2932000;0
17233;181100;442;0;0;0;0;.00nan;0;0
17234;165023;438;0;0;0;0;.00nan;0;0
17234;170499;427;64;26;2;24;.923;3600000;0
17234;173954;438;69;35;3;32;.914;3560000;0
17234;186468;427;0;0;0;0;.00nan;0;0
17235;184336;429;73;41;3;38;.927;3600000;0
17235;174420;439;0;0;0;0;.00nan;0;0
17235;182210;439;54;17;2;15;.882;3600000;0
17235;-1;429;0;0;0;0;.00nan;0;0
17236;163177;425;0;0;0;0;.00nan;0;0
17236;183832;436;0;0;0;0;.00nan;0;0
17236;-1;425;76;27;2;25;.926;3600000;0
17236;191861;436;58;35;4;31;.886;3527000;0
17237;182475;437;0;0;0;0;.00nan;0;0
17237;173519;441;0;0;0;0;.00nan;0;0
17237;179657;441;84;44;3;41;.932;3527000;0
17237;139865;437;80;23;1;22;.957;3600000;0
17238;194598;418;0;0;0;0;.00nan;0;0
17238;184024;444;84;36;3;33;.917;3600000;0
17238;180965;418;46;38;5;33;.868;3515000;0
17238;191812;444;0;0;0;0;.00nan;0;0
17239;188965;423;69;18;1;17;.944;3600000;0
17239;183885;449;30;6;3;3;.500;418000;0
17239;179143;423;0;0;0;0;.00nan;0;0
17239;141530;449;97;40;1;39;.975;3182000;0
17240;173339;430;0;0;0;0;.00nan;0;0
17240;-1;428;0;0;0;0;.00nan;0;0
17240;170878;430;41;19;3;16;.842;3600000;0
17240;174386;428;44;37;5;32;.865;3589000;0
17241;190073;413;92;36;2;34;.944;3600000;0
17241;-1;412;32;32;6;26;.813;3600000;0
17241;192627;413;0;0;0;0;.00nan;0;0
17241;-1;412;0;0;0;0;.00nan;0;0
17242;190157;442;0;0;0;0;.00nan;0;0
17242;181100;442;88;29;1;28;.966;3600000;0
17242;-1;426;35;28;5;23;.821;3600000;0
17242;-1;426;0;0;0;0;.00nan;0;0
17243;182225;431;73;35;2;33;.943;3600000;0
17243;186671;434;0;0;0;0;.00nan;0;0
17243;191171;431;0;0;0;0;.00nan;0;0
17243;152650;434;55;24;3;21;.875;3557000;0
17244;170928;443;100;23;0;23;1.000;3600000;0
17244;182180;443;0;0;0;0;.00nan;0;0
17244;-1;433;0;0;0;0;.00nan;0;0
17244;-1;433;76;41;4;37;.902;3600000;0
17245;171787;4849;36;23;4;19;.826;1868000;0
17245;171930;422;0;0;0;0;.00nan;0;0
17245;179127;422;63;28;3;25;.893;3600000;0
17245;196412;4849;44;27;4;23;.852;1732000;0
17246;189783;440;0;0;0;0;.00nan;0;0
17246;179478;432;84;26;1;25;.962;3600000;0
17246;175723;440;45;31;6;25;.806;3600000;0
17246;187412;432;0;0;0;0;.00nan;0;0
17247;194854;417;55;27;3;24;.889;3600000;0
17247;178890;417;0;0;0;0;.00nan;0;0
17247;179689;415;0;0;0;0;.00nan;0;0
17247;191877;415;91;39;2;37;.949;3600000;0
17248;194650;410;60;32;4;28;.875;4082000;0
17248;184183;410;0;0;0;0;.00nan;0;0
17248;181346;414;60;33;3;30;.909;4082000;0
17248;187309;414;0;0;0;0;.00nan;0;0
17249;165023;438;18;27;7;20;.741;3600000;0
17249;173954;438;0;0;0;0;.00nan;0;0
17249;184336;429;53;28;4;24;.857;3600000;0
17249;-1;429;0;0;0;0;.00nan;0;0
17250;170499;427;66;31;2;29;.935;3543000;0
17250;174420;439;82;23;1;22;.957;3600000;0
17250;182210;439;0;0;0;0;.00nan;0;0
17250;186468;427;0;0;0;0;.00nan;0;0
17251;190073;413;0;0;0;0;.00nan;0;0
17251;181346;414;0;0;0;0;.00nan;0;0
17251;187309;414;53;34;5;29;.853;3600000;0
17251;192627;413;77;27;2;25;.926;3600000;0
17252;-1;433;67;39;5;34;.872;3578000;0
17252;-1;426;0;0;0;0;.00nan;0;0
17252;-1;426;65;26;3;23;.885;3600000;0
17252;-1;433;0;0;0;0;.00nan;0;0
17253;163177;425;0;0;0;0;.00nan;0;0
17253;170928;443;76;34;3;31;.912;3562000;0
17253;-1;425;66;20;1;19;.950;3600000;0
17253;182180;443;0;0;0;0;.00nan;0;0
17254;178679;435;0;0;0;0;.00nan;0;0
17254;190157;442;15;22;6;16;.727;2861000;0
17254;181100;442;45;6;1;5;.833;739000;0
17254;-1;435;56;25;3;22;.880;3600000;0
17255;182475;437;0;0;0;0;.00nan;0;0
17255;182225;431;56;25;3;22;.880;3520000;0
17255;191171;431;0;0;0;0;.00nan;0;0
17255;139865;437;87;33;1;32;.970;3600000;0
17256;171787;4849;0;0;0;0;.00nan;0;0
17256;188965;423;0;0;0;0;.00nan;0;0
17256;179143;423;68;29;2;27;.931;3600000;0
17256;196412;4849;75;59;6;53;.898;3600000;0
17257;194650;410;0;0;0;0;.00nan;0;0
17257;184183;410;73;41;3;38;.927;3600000;0
17257;-1;412;42;28;5;23;.821;3514000;0
17257;-1;412;0;0;0;0;.00nan;0;0
17258;171930;422;65;35;4;31;.886;3546000;0
17258;187689;421;83;37;3;34;.919;3600000;0
17258;184060;421;0;0;0;0;.00nan;0;0
17258;179127;422;0;0;0;0;.00nan;0;0
17259;183832;436;70;53;6;47;.887;3600000;0
17259;174420;439;0;0;0;0;.00nan;0;0
17259;182210;439;70;25;2;23;.920;3600000;0
17259;191861;436;0;0;0;0;.00nan;0;0
17260;-1;428;0;0;0;0;.00nan;0;0
17260;174386;428;93;47;1;46;.979;3600000;0
17260;-1;426;0;0;0;0;.00nan;0;0
17260;-1;426;23;20;5;15;.750;3600000;0
17261;165023;438;0;0;0;0;.00nan;0;0
17261;173954;438;51;24;3;21;.875;3591000;0
17261;189783;440;85;32;1;31;.969;3600000;0
17261;175723;440;0;0;0;0;.00nan;0;0
17262;171787;4849;68;35;3;32;.914;3799000;0
17262;188965;423;80;32;2;30;.938;3799000;0
17262;179143;423;0;0;0;0;.00nan;0;0
17262;196412;4849;0;0;0;0;.00nan;0;0
17263;183885;449;0;0;0;0;.00nan;0;0
17263;194598;418;0;0;0;0;.00nan;0;0
17263;180965;418;71;34;3;31;.912;3600000;0
17263;141530;449;77;42;4;38;.905;3600000;0
17264;170499;427;71;36;3;33;.917;3674000;0
17264;184336;429;65;38;4;34;.895;3674000;0
17264;-1;429;0;0;0;0;.00nan;0;0
17264;186468;427;0;0;0;0;.00nan;0;0
17265;173519;441;0;0;0;0;.00nan;0;0
17265;179657;441;48;45;6;39;.867;3600000;0
17265;186671;434;72;20;1;19;.950;3600000;0
17265;152650;434;0;0;0;0;.00nan;0;0
17266;189288;419;79;14;0;14;1.000;3600000;0
17266;179071;420;88;38;2;36;.947;3515000;0
17266;-1;419;0;0;0;0;.00nan;0;0
17266;186076;420;0;0;0;0;.00nan;0;0
17267;173339;430;77;22;1;21;.955;3600000;0
17267;170878;430;0;0;0;0;.00nan;0;0
17267;-1;433;60;44;5;39;.886;3600000;0
17267;-1;433;0;0;0;0;.00nan;0;0
17268;177155;411;0;0;0;0;.00nan;0;0
17268;184033;411;84;31;2;29;.935;3600000;0
17268;194854;417;0;0;0;0;.00nan;0;0
17268;178890;417;90;43;3;40;.930;3600000;0
17269;182475;437;61;40;4;36;.900;3576000;0
17269;179478;432;0;0;0;0;.00nan;0;0
17269;187412;432;55;23;3;20;.870;3600000;0
17269;139865;437;0;0;0;0;.00nan;0;0
17270;190073;413;93;37;1;36;.973;3566000;0
17270;179689;415;100;34;0;34;1.000;3600000;0
17270;191877;415;0;0;0;0;.00nan;0;0
17270;192627;413;0;0;0;0;.00nan;0;0
17271;177155;411;64;25;2;23;.920;3600000;0
17271;184033;411;0;0;0;0;.00nan;0;0
17271;-1;412;0;0;0;0;.00nan;0;0
17271;-1;412;62;38;4;34;.895;3555000;0
17272;171930;422;0;0;0;0;.00nan;0;0
17272;187689;421;0;0;0;0;.00nan;0;0
17272;184060;421;77;29;2;27;.931;3600000;0
17272;179127;422;53;33;5;28;.848;3600000;0
17273;183832;436;0;0;0;0;.00nan;0;0
17273;-1;426;60;36;5;31;.861;3579000;0
17273;-1;426;0;0;0;0;.00nan;0;0
17273;191861;436;56;28;3;25;.893;3600000;0
17274;170499;427;0;0;0;0;.00nan;0;0
17274;184336;429;0;0;0;0;.00nan;0;0
17274;-1;429;49;44;6;38;.864;3600000;0
17274;186468;427;66;22;2;20;.909;3600000;0
17275;-1;428;68;34;3;31;.912;3600000;0
17275;174386;428;0;0;0;0;.00nan;0;0
17275;174420;439;44;25;4;21;.840;3543000;0
17275;182210;439;0;0;0;0;.00nan;0;0
17276;165023;438;78;24;2;22;.917;3600000;0
17276;173954;438;0;0;0;0;.00nan;0;0
17276;189783;440;0;0;0;0;.00nan;0;0
17276;175723;440;84;44;4;40;.909;3543000;0
17277;183885;449;82;26;1;25;.962;3574000;0
17277;194598;418;89;24;0;24;1.000;3600000;0
17277;180965;418;0;0;0;0;.00nan;0;0
17277;141530;449;0;0;0;0;.00nan;0;0
17278;173339;430;0;0;0;0;.00nan;0;0
17278;170878;430;51;36;5;31;.861;3572000;0
17278;186671;434;0;0;0;0;.00nan;0;0
17278;152650;434;62;29;4;25;.862;3600000;0
17279;189288;419;0;0;0;0;.00nan;0;0
17279;179071;420;0;0;0;0;.00nan;0;0
17279;-1;419;66;20;2;18;.900;3600000;0
17279;186076;420;91;41;3;38;.927;3544000;0
17280;173519;441;0;0;0;0;.00nan;0;0
17280;179657;441;100;21;0;21;1.000;3600000;0
17280;-1;433;0;0;0;0;.00nan;0;0
17280;-1;433;52;40;5;35;.875;3600000;0
17281;194650;410;44;36;5;31;.861;3565000;0
17281;194854;417;65;34;3;31;.912;3600000;0
17281;184183;410;0;0;0;0;.00nan;0;0
17281;178890;417;0;0;0;0;.00nan;0;0
17282;178679;435;0;0;0;0;.00nan;0;0
17282;182225;431;55;20;3;17;.850;3545000;0
17282;191171;431;0;0;0;0;.00nan;0;0
17282;-1;435;66;22;2;20;.909;3600000;0
17283;179689;415;51;40;5;35;.875;3600000;0
17283;181346;414;0;0;0;0;.00nan;0;0
17283;187309;414;73;27;2;25;.926;3600000;0
17283;191877;415;0;0;0;0;.00nan;0;0
17284;179478;432;53;36;5;31;.861;3600000;0
17284;190157;442;81;42;3;39;.929;3600000;0
17284;181100;442;0;0;0;0;.00nan;0;0
17284;187412;432;0;0;0;0;.00nan;0;0
17285;163177;425;0;0;0;0;.00nan;0;0
17285;170928;443;0;0;0;0;.00nan;0;0
17285;-1;425;64;32;3;29;.906;4125000;0
17285;182180;443;77;38;2;36;.947;4125000;0
17286;194854;417;57;9;0;9;1.000;1256000;0
17286;178890;417;61;31;4;27;.871;2287000;0
17286;181346;414;0;0;0;0;.00nan;0;0
17286;187309;414;66;17;2;15;.882;3600000;0
17287;173339;430;64;35;4;31;.886;3953000;0
17287;170878;430;0;0;0;0;.00nan;0;0
17287;170928;443;0;0;0;0;.00nan;0;0
17287;182180;443;78;39;3;36;.923;3953000;0
17288;182475;437;69;16;0;16;1.000;3395000;0
17288;-1;428;0;0;0;0;.00nan;0;0
17288;174386;428;90;51;4;47;.922;4200000;0
17288;139865;437;15;8;4;4;.500;805000;0
17289;173519;441;0;0;0;0;.00nan;0;0
17289;189783;440;55;29;3;26;.897;3600000;0
17289;175723;440;0;0;0;0;.00nan;0;0
17289;179657;441;58;42;5;37;.881;3537000;0
17290;178679;435;0;0;0;0;.00nan;0;0
17290;179478;432;0;0;0;0;.00nan;0;0
17290;187412;432;75;30;2;28;.933;3600000;0
17290;-1;435;79;49;4;45;.918;3600000;0
17291;181346;414;0;0;0;0;.00nan;0;0
17291;-1;412;44;17;3;14;.824;3526000;0
17291;187309;414;88;30;1;29;.967;3600000;0
17291;-1;412;0;0;0;0;.00nan;0;0
17292;170499;427;96;43;1;42;.977;4124000;0
17292;-1;433;83;45;2;43;.956;4129000;0
17292;186468;427;0;0;0;0;.00nan;0;0
17292;-1;433;0;0;0;0;.00nan;0;0
17293;177155;411;0;0;0;0;.00nan;0;0
17293;184033;411;54;20;3;17;.850;3600000;0
17293;179689;415;49;38;5;33;.868;3600000;0
17293;191877;415;0;0;0;0;.00nan;0;0
17294;-1;428;90;31;1;30;.968;3600000;0
17294;174386;428;0;0;0;0;.00nan;0;0
17294;182225;431;84;37;2;35;.946;3574000;0
17294;191171;431;0;0;0;0;.00nan;0;0
17295;187689;421;40;14;3;11;.786;3993000;0
17295;183885;449;83;50;4;46;.920;3993000;0
17295;184060;421;0;0;0;0;.00nan;0;0
17295;141530;449;0;0;0;0;.00nan;0;0
17296;173519;441;43;34;5;29;.853;3513000;0
17296;189783;440;0;0;0;0;.00nan;0;0
17296;175723;440;55;20;3;17;.850;3600000;0
17296;179657;441;0;0;0;0;.00nan;0;0
17297;184336;429;49;25;3;22;.880;4200000;0
17297;-1;429;0;0;0;0;.00nan;0;0
17297;186671;434;67;32;3;29;.906;4200000;0
17297;152650;434;0;0;0;0;.00nan;0;0
17298;188965;423;67;18;1;17;.944;3600000;0
17298;179071;420;100;35;0;35;1.000;3600000;0
17298;179143;423;0;0;0;0;.00nan;0;0
17298;186076;420;0;0;0;0;.00nan;0;0
17299;171930;422;100;30;0;30;1.000;3600000;0
17299;189288;419;0;0;0;0;.00nan;0;0
17299;179127;422;0;0;0;0;.00nan;0;0
17299;-1;419;35;27;6;21;.778;3600000;0
17300;194650;410;0;0;0;0;.00nan;0;0
17300;184183;410;43;35;5;30;.857;3600000;0
17300;190073;413;77;26;1;25;.962;3600000;0
17300;192627;413;0;0;0;0;.00nan;0;0
17301;171787;4849;30;30;6;24;.800;2598000;0
17301;184024;444;0;0;0;0;.00nan;0;0
17301;196412;4849;25;18;5;13;.722;1002000;0
17301;191812;444;63;28;3;25;.893;3600000;0
17302;183832;436;51;30;4;26;.867;3589000;0
17302;190157;442;75;38;3;35;.921;3600000;0
17302;181100;442;0;0;0;0;.00nan;0;0
17302;191861;436;0;0;0;0;.00nan;0;0
17303;163177;425;0;0;0;0;.00nan;0;0
17303;165023;438;0;0;0;0;.00nan;0;0
17303;173954;438;67;44;5;39;.886;3968000;0
17303;-1;425;43;24;4;20;.833;3957000;0
17304;174420;439;0;0;0;0;.00nan;0;0
17304;182210;439;60;15;1;14;.933;3600000;0
17304;-1;426;97;44;3;41;.932;2709000;0
17304;-1;426;20;10;4;6;.600;891000;0
17305;187689;421;0;0;0;0;.00nan;0;0
17305;183885;449;0;0;0;0;.00nan;0;0
17305;184060;421;60;15;1;14;.933;3600000;0
17305;141530;449;75;45;4;41;.911;3600000;0
17306;170499;427;0;0;0;0;.00nan;0;0
17306;186468;427;76;33;2;31;.939;4200000;0
17306;186671;434;0;0;0;0;.00nan;0;0
17306;152650;434;77;29;2;27;.931;4200000;0
17307;177155;411;77;24;1;23;.958;3600000;0
17307;184033;411;0;0;0;0;.00nan;0;0
17307;190073;413;0;0;0;0;.00nan;0;0
17307;192627;413;82;40;2;38;.950;3600000;0
17308;173339;430;74;33;2;31;.939;3600000;0
17308;178679;435;0;0;0;0;.00nan;0;0
17308;170878;430;0;0;0;0;.00nan;0;0
17308;-1;435;85;45;3;42;.933;3578000;0
17309;184336;429;0;0;0;0;.00nan;0;0
17309;-1;429;91;29;1;28;.966;3600000;0
17309;-1;433;0;0;0;0;.00nan;0;0
17309;-1;433;98;46;2;44;.957;3600000;0
17310;188965;423;0;0;0;0;.00nan;0;0
17310;179071;420;91;30;1;29;.967;3600000;0
17310;179143;423;73;23;2;21;.913;3575000;0
17310;186076;420;0;0;0;0;.00nan;0;0
17311;194854;417;0;0;0;0;.00nan;0;0
17311;178890;417;82;22;1;21;.955;3600000;0
17311;-1;412;0;0;0;0;.00nan;0;0
17311;-1;412;35;31;6;25;.806;3600000;0
17312;171930;422;86;54;6;48;.889;3600000;0
17312;189288;419;52;24;3;21;.875;3600000;0
17312;179127;422;0;0;0;0;.00nan;0;0
17312;-1;419;0;0;0;0;.00nan;0;0
17313;194650;410;53;27;3;24;.889;3526000;0
17313;184183;410;0;0;0;0;.00nan;0;0
17313;179689;415;0;0;0;0;.00nan;0;0
17313;191877;415;89;33;1;32;.970;3600000;0
17314;190157;442;0;0;0;0;.00nan;0;0
17314;181100;442;60;32;4;28;.875;3600000;0
17314;182225;431;0;0;0;0;.00nan;0;0
17314;191171;431;50;36;5;31;.861;3550000;0
17315;171787;4849;0;0;0;0;.00nan;0;0
17315;184024;444;52;18;3;15;.833;3600000;0
17315;196412;4849;70;49;5;44;.898;3573000;0
17315;191812;444;0;0;0;0;.00nan;0;0
17316;170928;443;85;36;2;34;.944;3600000;0
17316;179478;432;0;0;0;0;.00nan;0;0
17316;182180;443;0;0;0;0;.00nan;0;0
17316;187412;432;69;33;3;30;.909;3600000;0
17317;165023;438;84;32;2;30;.938;3557000;0
17317;173954;438;0;0;0;0;.00nan;0;0
17317;-1;426;0;0;0;0;.00nan;0;0
17317;-1;426;72;22;1;21;.955;3600000;0
17318;163177;425;0;0;0;0;.00nan;0;0
17318;174420;439;0;0;0;0;.00nan;0;0
17318;-1;425;59;32;4;28;.875;3600000;0
17318;182210;439;45;31;5;26;.839;3595000;0
17319;182475;437;0;0;0;0;.00nan;0;0
17319;183832;436;54;29;3;26;.897;3600000;0
17319;191861;436;0;0;0;0;.00nan;0;0
17319;139865;437;94;34;2;32;.941;3600000;0
17320;177155;411;0;0;0;0;.00nan;0;0
17320;194650;410;0;0;0;0;.00nan;0;0
17320;184033;411;76;23;1;22;.957;3600000;0
17320;184183;410;54;39;5;34;.872;3600000;0
17321;-1;433;94;48;3;45;.938;3600000;0
17321;186671;434;62;14;1;13;.929;3600000;0
17321;-1;433;0;0;0;0;.00nan;0;0
17321;152650;434;0;0;0;0;.00nan;0;0
17322;178679;435;0;0;0;0;.00nan;0;0
17322;-1;426;66;24;2;22;.917;3600000;0
17322;-1;426;0;0;0;0;.00nan;0;0
17322;-1;435;76;42;4;38;.905;3597000;0
17323;-1;428;0;0;0;0;.00nan;0;0
17323;174386;428;75;37;3;34;.919;3890000;0
17323;179478;432;0;0;0;0;.00nan;0;0
17323;187412;432;69;36;4;32;.889;3890000;0
17324;184336;429;81;31;2;29;.935;3600000;0
17324;182225;431;61;38;4;34;.895;3576000;0
17324;-1;429;0;0;0;0;.00nan;0;0
17324;191171;431;0;0;0;0;.00nan;0;0
17325;187689;421;79;15;0;15;1.000;3600000;0
17325;184060;421;0;0;0;0;.00nan;0;0
17325;179071;420;0;0;0;0;.00nan;0;0
17325;186076;420;77;28;1;27;.964;3550000;0
17326;183832;436;57;20;2;18;.900;3664000;0
17326;-1;428;70;37;3;34;.919;3664000;0
17326;174386;428;0;0;0;0;.00nan;0;0
17326;191861;436;0;0;0;0;.00nan;0;0
17327;188965;423;100;55;3;52;.945;3600000;0
17327;189288;419;40;22;4;18;.818;3554000;0
17327;179143;423;0;0;0;0;.00nan;0;0
17327;-1;419;0;0;0;0;.00nan;0;0
17328;182475;437;0;0;0;0;.00nan;0;0
17328;173339;430;64;31;4;27;.871;3767000;0
17328;170878;430;0;0;0;0;.00nan;0;0
17328;139865;437;63;31;3;28;.903;3767000;0
17329;183885;449;44;48;8;40;.833;3600000;0
17329;184024;444;0;0;0;0;.00nan;0;0
17329;191812;444;72;22;2;20;.909;3600000;0
17329;141530;449;0;0;0;0;.00nan;0;0
17330;194854;417;0;0;0;0;.00nan;0;0
17330;178890;417;50;29;5;24;.828;3617000;0
17330;190073;413;52;26;4;22;.846;3617000;0
17330;192627;413;0;0;0;0;.00nan;0;0
17331;173519;441;0;0;0;0;.00nan;0;0
17331;184336;429;0;0;0;0;.00nan;0;0
17331;179657;441;61;36;4;32;.889;3589000;0
17331;-1;429;66;13;1;12;.923;3600000;0
17332;-1;433;94;54;4;50;.926;3961000;0
17332;186671;434;61;30;3;27;.900;3961000;0
17332;-1;433;0;0;0;0;.00nan;0;0
17332;152650;434;0;0;0;0;.00nan;0;0
17333;194650;410;82;29;1;28;.966;3562000;0
17333;184183;410;0;0;0;0;.00nan;0;0
17333;181346;414;0;0;0;0;.00nan;0;0
17333;187309;414;100;30;0;30;1.000;3600000;0
17334;170499;427;59;28;3;25;.893;3674000;0
17334;182225;431;0;0;0;0;.00nan;0;0
17334;186468;427;0;0;0;0;.00nan;0;0
17334;191171;431;73;38;4;34;.895;3674000;0
17335;171930;422;72;33;3;30;.909;3625000;0
17335;194598;418;65;30;4;26;.867;3625000;0
17335;179127;422;0;0;0;0;.00nan;0;0
17335;180965;418;0;0;0;0;.00nan;0;0
17336;179689;415;61;23;2;21;.913;3600000;0
17336;-1;412;72;20;1;19;.950;3600000;0
17336;191877;415;0;0;0;0;.00nan;0;0
17336;-1;412;0;0;0;0;.00nan;0;0
17337;170928;443;0;0;0;0;.00nan;0;0
17337;190157;442;70;46;4;42;.913;3600000;0
17337;181100;442;0;0;0;0;.00nan;0;0
17337;182180;443;66;21;1;20;.952;3600000;0
17338;165023;438;0;0;0;0;.00nan;0;0
17338;173954;438;81;49;4;45;.918;3600000;0
17338;174420;439;0;0;0;0;.00nan;0;0
17338;182210;439;52;15;2;13;.867;3600000;0
17339;178679;435;55;42;5;37;.881;3600000;0
17339;189783;440;65;21;2;19;.905;3600000;0
17339;175723;440;0;0;0;0;.00nan;0;0
17339;-1;435;0;0;0;0;.00nan;0;0
17340;187689;421;71;29;2;27;.931;3600000;0
17340;184060;421;0;0;0;0;.00nan;0;0
17340;179071;420;44;33;6;27;.818;3600000;0
17340;186076;420;0;0;0;0;.00nan;0;0
17341;188965;423;0;0;0;0;.00nan;0;0
17341;189288;419;0;0;0;0;.00nan;0;0
17341;179143;423;100;47;0;47;1.000;3600000;0
17341;-1;419;53;19;2;17;.895;3574000;0
17342;163177;425;0;0;0;0;.00nan;0;0
17342;189783;440;0;0;0;0;.00nan;0;0
17342;175723;440;56;38;5;33;.868;3600000;0
17342;-1;425;42;12;2;10;.833;3600000;0
17343;177155;411;45;38;6;32;.842;3580000;0
17343;184033;411;0;0;0;0;.00nan;0;0
17343;181346;414;0;0;0;0;.00nan;0;0
17343;187309;414;36;15;4;11;.733;3600000;0
17344;182475;437;84;46;3;43;.935;3922000;0
17344;170928;443;75;30;2;28;.933;3922000;0
17344;182180;443;0;0;0;0;.00nan;0;0
17344;139865;437;0;0;0;0;.00nan;0;0
17345;190073;413;0;0;0;0;.00nan;0;0
17345;-1;412;71;26;2;24;.923;4200000;0
17345;192627;413;75;42;2;40;.952;4200000;0
17345;-1;412;0;0;0;0;.00nan;0;0
17346;183885;449;0;0;0;0;.00nan;0;0
17346;184024;444;51;15;2;13;.867;3600000;0
17346;191812;444;0;0;0;0;.00nan;0;0
17346;141530;449;83;41;3;38;.927;3568000;0
17347;173519;441;0;0;0;0;.00nan;0;0
17347;170499;427;75;29;2;27;.931;3600000;0
17347;179657;441;52;24;3;21;.875;3600000;0
17347;186468;427;0;0;0;0;.00nan;0;0
17348;183832;436;0;0;0;0;.00nan;0;0
17348;179478;432;80;34;2;32;.941;3600000;0
17348;187412;432;0;0;0;0;.00nan;0;0
17348;191861;436;60;32;3;29;.906;3600000;0
17349;171930;422;0;0;0;0;.00nan;0;0
17349;194598;418;0;0;0;0;.00nan;0;0
17349;179127;422;58;42;5;37;.881;3561000;0
17349;180965;418;51;31;4;27;.871;3600000;0
17350;194854;417;73;33;3;30;.909;3595000;0
17350;178890;417;0;0;0;0;.00nan;0;0
17350;179689;415;0;0;0;0;.00nan;0;0
17350;191877;415;68;23;2;21;.913;3600000;0
17351;173339;430;0;0;0;0;.00nan;0;0
17351;170878;430;85;27;1;26;.963;3600000;0
17351;190157;442;0;0;0;0;.00nan;0;0
17351;181100;442;60;36;5;31;.861;3600000;0
17352;165023;438;33;34;6;28;.824;2633000;0
17352;173954;438;39;11;2;9;.818;967000;0
17352;174420;439;0;0;0;0;.00nan;0;0
17352;182210;439;52;24;4;20;.833;3600000;0
17353;-1;433;0;0;0;0;.00nan;0;0
17353;-1;426;67;30;3;27;.900;3587000;0
17353;-1;426;0;0;0;0;.00nan;0;0
17353;-1;433;89;41;2;39;.951;3600000;0
17354;190073;413;57;12;1;11;.917;1247000;0
17354;181346;414;0;0;0;0;.00nan;0;0
17354;187309;414;81;34;3;31;.912;3600000;0
17354;192627;413;45;33;5;28;.848;2353000;0
17355;177155;411;0;0;0;0;.00nan;0;0
17355;184033;411;76;16;1;15;.938;3600000;0
17355;-1;412;80;34;2;32;.941;3589000;0
17355;-1;412;0;0;0;0;.00nan;0;0
17356;179478;432;0;0;0;0;.00nan;0;0
17356;182225;431;78;29;2;27;.931;3600000;0
17356;191171;431;0;0;0;0;.00nan;0;0
17356;187412;432;66;31;3;28;.903;3600000;0
17357;163177;425;0;0;0;0;.00nan;0;0
17357;173339;430;100;30;0;30;1.000;3600000;0
17357;170878;430;0;0;0;0;.00nan;0;0
17357;-1;425;56;25;3;22;.880;3600000;0
17358;183832;436;70;33;3;30;.909;3873000;0
17358;182225;431;80;34;2;32;.941;3873000;0
17358;191171;431;0;0;0;0;.00nan;0;0
17358;191861;436;0;0;0;0;.00nan;0;0
17359;194598;418;0;0;0;0;.00nan;0;0
17359;189288;419;82;12;0;12;1.000;3600000;0
17359;-1;419;0;0;0;0;.00nan;0;0
17359;180965;418;97;44;2;42;.955;3586000;0
17360;177155;411;99;45;1;44;.978;3600000;0
17360;184033;411;0;0;0;0;.00nan;0;0
17360;194854;417;83;34;2;32;.941;3567000;0
17360;178890;417;0;0;0;0;.00nan;0;0
17361;170928;443;0;0;0;0;.00nan;0;0
17361;189783;440;61;32;3;29;.906;3599000;0
17361;175723;440;0;0;0;0;.00nan;0;0
17361;182180;443;56;16;2;14;.875;3600000;0
17362;182475;437;0;0;0;0;.00nan;0;0
17362;173519;441;0;0;0;0;.00nan;0;0
17362;179657;441;61;29;3;26;.897;3600000;0
17362;139865;437;47;29;5;24;.828;3561000;0
17363;187689;421;56;18;2;16;.889;3574000;0
17363;188965;423;0;0;0;0;.00nan;0;0
17363;184060;421;0;0;0;0;.00nan;0;0
17363;179143;423;93;39;1;38;.974;3600000;0
17364;171787;4849;0;0;0;0;.00nan;0;0
17364;183885;449;53;35;5;30;.857;3573000;0
17364;196412;4849;52;28;4;24;.857;3600000;0
17364;141530;449;0;0;0;0;.00nan;0;0
17365;170499;427;100;29;0;29;1.000;3600000;0
17365;186468;427;0;0;0;0;.00nan;0;0
17365;-1;426;0;0;0;0;.00nan;0;0
17365;-1;426;98;51;3;48;.941;3600000;0
17366;174420;439;0;0;0;0;.00nan;0;0
17366;182210;439;85;15;0;15;1.000;3600000;0
17366;186671;434;85;49;4;45;.918;3600000;0
17366;152650;434;0;0;0;0;.00nan;0;0
17367;184024;444;0;0;0;0;.00nan;0;0
17367;179071;420;44;4;1;3;.750;554000;0
17367;186076;420;47;45;6;39;.867;3046000;0
17367;191812;444;63;10;1;9;.900;3600000;0
17368;165023;438;0;0;0;0;.00nan;0;0
17368;173954;438;56;32;4;28;.875;3600000;0
17368;-1;433;84;35;3;32;.914;3600000;0
17368;-1;433;0;0;0;0;.00nan;0;0
17369;194650;410;0;0;0;0;.00nan;0;0
17369;184183;410;68;25;2;23;.920;3600000;0
17369;-1;412;0;0;0;0;.00nan;0;0
17369;-1;412;38;21;4;17;.810;3564000;0
17370;179689;415;0;0;0;0;.00nan;0;0
17370;181346;414;0;0;0;0;.00nan;0;0
17370;187309;414;64;32;3;29;.906;3600000;0
17370;191877;415;99;23;0;23;1.000;3600000;0
17371;-1;428;0;0;0;0;.00nan;0;0
17371;174386;428;63;34;4;30;.882;3600000;0
17371;190157;442;75;23;1;22;.957;3600000;0
17371;181100;442;0;0;0;0;.00nan;0;0
17372;178679;435;0;0;0;0;.00nan;0;0
17372;184336;429;73;26;1;25;.962;3600000;0
17372;-1;429;0;0;0;0;.00nan;0;0
17372;-1;435;82;34;2;32;.941;3579000;0
17373;194598;418;20;23;6;17;.739;2611000;0
17373;189288;419;0;0;0;0;.00nan;0;0
17373;-1;419;85;17;0;17;1.000;3600000;0
17373;180965;418;55;17;2;15;.882;989000;0
17374;173339;430;96;34;1;33;.971;3600000;0
17374;170878;430;0;0;0;0;.00nan;0;0
17374;189783;440;0;0;0;0;.00nan;0;0
17374;175723;440;68;28;2;26;.929;3588000;0
17375;182475;437;100;30;0;30;1.000;3600000;0
17375;183832;436;0;0;0;0;.00nan;0;0
17375;191861;436;64;16;1;15;.938;3552000;0
17375;139865;437;0;0;0;0;.00nan;0;0
17376;187689;421;0;0;0;0;.00nan;0;0
17376;188965;423;92;38;1;37;.974;3600000;0
17376;184060;421;60;22;2;20;.909;3544000;0
17376;179143;423;0;0;0;0;.00nan;0;0
17377;190073;413;68;46;5;41;.891;3600000;0
17377;179689;415;0;0;0;0;.00nan;0;0
17377;191877;415;60;13;1;12;.923;3600000;0
17377;192627;413;0;0;0;0;.00nan;0;0
17378;171787;4849;80;37;3;34;.919;3823000;0
17378;183885;449;0;0;0;0;.00nan;0;0
17378;196412;4849;0;0;0;0;.00nan;0;0
17378;141530;449;68;24;2;22;.917;3823000;0
17379;163177;425;0;0;0;0;.00nan;0;0
17379;-1;425;51;17;2;15;.882;3600000;0
17379;-1;426;53;38;5;33;.868;3600000;0
17379;-1;426;0;0;0;0;.00nan;0;0
17380;165023;438;83;51;4;47;.922;3600000;0
17380;173954;438;0;0;0;0;.00nan;0;0
17380;186671;434;0;0;0;0;.00nan;0;0
17380;152650;434;70;18;1;17;.944;3600000;0
17381;184024;444;49;17;2;15;.882;3563000;0
17381;179071;420;97;26;0;26;1.000;3600000;0
17381;186076;420;0;0;0;0;.00nan;0;0
17381;191812;444;0;0;0;0;.00nan;0;0
17382;174420;439;0;0;0;0;.00nan;0;0
17382;182210;439;76;29;2;27;.931;3600000;0
17382;-1;433;0;0;0;0;.00nan;0;0
17382;-1;433;73;42;4;38;.905;3555000;0
17383;194650;410;72;33;3;30;.909;3516000;0
17383;194854;417;0;0;0;0;.00nan;0;0
17383;184183;410;0;0;0;0;.00nan;0;0
17383;178890;417;94;34;1;33;.971;3600000;0
17384;-1;428;82;33;2;31;.939;3600000;0
17384;174386;428;0;0;0;0;.00nan;0;0
17384;179478;432;0;0;0;0;.00nan;0;0
17384;187412;432;55;26;3;23;.885;3566000;0
17385;173519;441;50;35;5;30;.857;3706000;0
17385;190157;442;0;0;0;0;.00nan;0;0
17385;179657;441;0;0;0;0;.00nan;0;0
17385;181100;442;51;25;4;21;.840;3706000;0
17386;178679;435;75;39;3;36;.923;3812000;0
17386;170499;427;80;33;2;31;.939;3812000;0
17386;186468;427;0;0;0;0;.00nan;0;0
17386;-1;435;0;0;0;0;.00nan;0;0
17387;-1;428;0;0;0;0;.00nan;0;0
17387;173519;441;0;0;0;0;.00nan;0;0
17387;174386;428;73;38;3;35;.921;3600000;0
17387;179657;441;97;25;0;25;1.000;3600000;0
17388;194854;417;60;36;4;32;.889;3600000;0
17388;178890;417;0;0;0;0;.00nan;0;0
17388;181346;414;0;0;0;0;.00nan;0;0
17388;187309;414;94;33;1;32;.970;3600000;0
17389;194650;410;0;0;0;0;.00nan;0;0
17389;184183;410;49;31;4;27;.871;3548000;0
17389;190073;413;78;28;2;26;.929;3600000;0
17389;192627;413;0;0;0;0;.00nan;0;0
17390;182475;437;77;39;3;36;.923;3557000;0
17390;-1;426;0;0;0;0;.00nan;0;0
17390;-1;426;71;21;1;20;.952;3600000;0
17390;139865;437;0;0;0;0;.00nan;0;0
17391;194854;417;66;33;3;30;.909;3600000;0
17391;178890;417;0;0;0;0;.00nan;0;0
17391;-1;412;39;32;5;27;.844;3569000;0
17391;-1;412;0;0;0;0;.00nan;0;0
17392;187689;421;52;27;4;23;.852;3600000;0
17392;184024;444;0;0;0;0;.00nan;0;0
17392;184060;421;0;0;0;0;.00nan;0;0
17392;191812;444;60;16;1;15;.938;3600000;0
17393;-1;428;51;2;0;2;1.000;885000;0
17393;170499;427;68;25;2;23;.920;3600000;0
17393;174386;428;25;25;6;19;.760;2715000;0
17393;186468;427;0;0;0;0;.00nan;0;0
17394;182475;437;0;0;0;0;.00nan;0;0
17394;163177;425;56;8;0;8;1.000;2697000;0
17394;-1;425;22;13;4;9;.692;882000;0
17394;139865;437;75;32;2;30;.938;3600000;0
17395;177155;411;81;29;2;27;.931;3600000;0
17395;184033;411;0;0;0;0;.00nan;0;0
17395;190073;413;22;13;4;9;.692;1122000;0
17395;192627;413;20;22;6;16;.727;2478000;0
17396;173339;430;0;0;0;0;.00nan;0;0
17396;170878;430;41;34;5;29;.853;3600000;0
17396;186671;434;54;24;3;21;.875;3600000;0
17396;152650;434;0;0;0;0;.00nan;0;0
17397;183832;436;71;31;3;28;.903;3545000;0
17397;184336;429;0;0;0;0;.00nan;0;0
17397;-1;429;83;25;1;24;.960;3600000;0
17397;191861;436;0;0;0;0;.00nan;0;0
17398;171930;422;86;28;1;27;.964;3600000;0
17398;183885;449;89;58;4;54;.931;3600000;0
17398;179127;422;0;0;0;0;.00nan;0;0
17398;141530;449;0;0;0;0;.00nan;0;0
17399;194650;410;84;38;2;36;.947;3581000;0
17399;184183;410;0;0;0;0;.00nan;0;0
17399;179689;415;0;0;0;0;.00nan;0;0
17399;191877;415;97;27;0;27;1.000;3600000;0
17400;179478;432;95;20;0;20;1.000;3600000;0
17400;190157;442;92;42;1;41;.976;3562000;0
17400;181100;442;0;0;0;0;.00nan;0;0
17400;187412;432;0;0;0;0;.00nan;0;0
17401;189783;440;55;42;6;36;.857;3600000;0
17401;175723;440;0;0;0;0;.00nan;0;0
17401;182225;431;99;29;1;28;.966;3600000;0
17401;191171;431;0;0;0;0;.00nan;0;0
17402;171787;4849;0;0;0;0;.00nan;0;0
17402;189288;419;0;0;0;0;.00nan;0;0
17402;-1;419;63;16;1;15;.938;3600000;0
17402;196412;4849;87;41;3;38;.927;3556000;0
17403;194598;418;0;0;0;0;.00nan;0;0
17403;179071;420;60;30;4;26;.867;3969000;0
17403;180965;418;61;40;5;35;.875;3969000;0
17403;186076;420;0;0;0;0;.00nan;0;0
17404;170928;443;0;0;0;0;.00nan;0;0
17404;182180;443;49;13;2;11;.846;3600000;0
17404;-1;433;80;51;4;47;.922;3600000;0
17404;-1;433;0;0;0;0;.00nan;0;0
17405;165023;438;0;0;0;0;.00nan;0;0
17405;173954;438;97;43;2;41;.953;3600000;0
17405;174420;439;0;0;0;0;.00nan;0;0
17405;182210;439;54;26;3;23;.885;3563000;0
17406;183832;436;0;0;0;0;.00nan;0;0
17406;170499;427;0;0;0;0;.00nan;0;0
17406;186468;427;65;26;2;24;.923;3600000;0
17406;191861;436;70;43;4;39;.907;3567000;0
17407;163177;425;0;0;0;0;.00nan;0;0
17407;190157;442;58;5;0;5;1.000;496000;0
17407;-1;425;63;24;2;22;.917;3600000;0
17407;181100;442;62;47;6;41;.872;3104000;0
17408;177155;411;0;0;0;0;.00nan;0;0
17408;184033;411;86;32;1;31;.969;3600000;0
17408;179689;415;56;22;2;20;.909;3545000;0
17408;191877;415;0;0;0;0;.00nan;0;0
17409;187689;421;0;0;0;0;.00nan;0;0
17409;184024;444;80;27;1;26;.963;3600000;0
17409;184060;421;62;41;5;36;.878;3600000;0
17409;191812;444;0;0;0;0;.00nan;0;0
17410;173339;430;63;34;4;30;.882;3595000;0
17410;170878;430;0;0;0;0;.00nan;0;0
17410;-1;433;0;0;0;0;.00nan;0;0
17410;-1;433;87;40;2;38;.950;3600000;0
17411;173519;441;0;0;0;0;.00nan;0;0
17411;179657;441;67;22;2;20;.909;3600000;0
17411;-1;426;39;29;5;24;.828;3600000;0
17411;-1;426;0;0;0;0;.00nan;0;0
17412;-1;428;30;30;6;24;.800;2993000;0
17412;184336;429;92;28;1;27;.964;3600000;0
17412;174386;428;58;11;1;10;.909;607000;0
17412;-1;429;0;0;0;0;.00nan;0;0
17413;171930;422;0;0;0;0;.00nan;0;0
17413;183885;449;0;0;0;0;.00nan;0;0
17413;179127;422;53;32;4;28;.875;3527000;0
17413;141530;449;82;37;2;35;.946;3600000;0
17414;189783;440;0;0;0;0;.00nan;0;0
17414;175723;440;56;18;2;16;.889;3559000;0
17414;182225;431;0;0;0;0;.00nan;0;0
17414;191171;431;83;30;1;29;.967;3600000;0
17415;171787;4849;83;37;2;35;.946;3568000;0
17415;189288;419;100;29;0;29;1.000;3600000;0
17415;-1;419;0;0;0;0;.00nan;0;0
17415;196412;4849;0;0;0;0;.00nan;0;0
17416;194598;418;24;23;6;17;.739;3105000;0
17416;179071;420;0;0;0;0;.00nan;0;0
17416;180965;418;49;1;0;1;1.000;495000;0
17416;186076;420;78;32;2;30;.938;3600000;0
17417;181346;414;49;25;4;21;.840;3600000;0
17417;-1;412;83;34;1;33;.971;3600000;0
17417;187309;414;0;0;0;0;.00nan;0;0
17417;-1;412;0;0;0;0;.00nan;0;0
17418;170928;443;8;17;6;11;.647;2620000;0
17418;182180;443;23;10;4;6;.600;980000;0
17418;186671;434;0;0;0;0;.00nan;0;0
17418;152650;434;49;27;4;23;.852;3600000;0
17419;165023;438;69;31;3;28;.903;3763000;0
17419;178679;435;0;0;0;0;.00nan;0;0
17419;173954;438;0;0;0;0;.00nan;0;0
17419;-1;435;65;34;4;30;.882;3763000;0
17420;178679;435;35;31;5;26;.839;1665000;0
17420;174420;439;0;0;0;0;.00nan;0;0
17420;182210;439;56;17;2;15;.882;3600000;0
17420;-1;435;24;19;5;14;.737;1935000;0
17421;173339;430;0;0;0;0;.00nan;0;0
17421;184336;429;79;43;3;40;.930;3880000;0
17421;170878;430;65;37;4;33;.892;3880000;0
17421;-1;429;0;0;0;0;.00nan;0;0
17422;194854;417;0;0;0;0;.00nan;0;0
17422;178890;417;62;38;4;34;.895;3560000;0
17422;-1;412;70;31;3;28;.903;3600000;0
17422;-1;412;0;0;0;0;.00nan;0;0
17423;170499;427;26;29;6;23;.793;3202000;0
17423;184336;429;75;31;2;29;.935;3600000;0
17423;-1;429;0;0;0;0;.00nan;0;0
17423;186468;427;61;7;0;7;1.000;398000;0
17424;183832;436;60;29;3;26;.897;3591000;0
17424;182225;431;0;0;0;0;.00nan;0;0
17424;191171;431;69;27;2;25;.926;3600000;0
17424;191861;436;0;0;0;0;.00nan;0;0
17425;171787;4849;0;0;0;0;.00nan;0;0
17425;187689;421;60;26;3;23;.885;3600000;0
17425;184060;421;0;0;0;0;.00nan;0;0
17425;196412;4849;36;31;5;26;.839;3561000;0
17426;189288;419;55;30;4;26;.867;3581000;0
17426;184024;444;0;0;0;0;.00nan;0;0
17426;-1;419;0;0;0;0;.00nan;0;0
17426;191812;444;58;20;2;18;.900;3600000;0
17427;-1;428;0;0;0;0;.00nan;0;0
17427;178679;435;0;0;0;0;.00nan;0;0
17427;174386;428;79;13;0;13;1.000;3600000;0
17427;-1;435;83;32;2;30;.938;3600000;0
17428;189783;440;87;40;2;38;.950;3600000;0
17428;175723;440;0;0;0;0;.00nan;0;0
17428;186671;434;69;16;1;15;.938;3600000;0
17428;152650;434;0;0;0;0;.00nan;0;0
17429;188965;423;66;35;4;31;.886;3583000;0
17429;194598;418;0;0;0;0;.00nan;0;0
17429;179143;423;0;0;0;0;.00nan;0;0
17429;180965;418;75;28;2;26;.929;3600000;0
17430;165023;438;0;0;0;0;.00nan;0;0
17430;173339;430;0;0;0;0;.00nan;0;0
17430;173954;438;68;31;2;29;.935;4148000;0
17430;170878;430;50;25;3;22;.880;4148000;0
17431;177155;411;53;29;4;25;.862;3600000;0
17431;184033;411;0;0;0;0;.00nan;0;0
17431;190073;413;48;27;5;22;.815;2382000;0
17431;192627;413;53;10;1;9;.900;1157000;0
17432;173519;441;0;0;0;0;.00nan;0;0
17432;179478;432;51;16;2;14;.875;3600000;0
17432;179657;441;91;45;3;42;.933;3586000;0
17432;187412;432;0;0;0;0;.00nan;0;0
17433;163177;425;0;0;0;0;.00nan;0;0
17433;-1;425;94;18;0;18;1.000;3600000;0
17433;182225;431;90;41;2;39;.951;3550000;0
17433;191171;431;0;0;0;0;.00nan;0;0
17434;194650;410;86;49;4;45;.918;3588000;0
17434;184183;410;0;0;0;0;.00nan;0;0
17434;179689;415;0;0;0;0;.00nan;0;0
17434;191877;415;63;26;3;23;.885;3600000;0
17435;194854;417;100;28;0;28;1.000;3600000;0
17435;178890;417;0;0;0;0;.00nan;0;0
17435;181346;414;0;0;0;0;.00nan;0;0
17435;187309;414;47;26;4;22;.846;3600000;0
17436;170928;443;0;0;0;0;.00nan;0;0
17436;174420;439;0;0;0;0;.00nan;0;0
17436;182180;443;89;59;3;56;.949;4200000;0
17436;182210;439;60;26;3;23;.885;4200000;0
17437;182475;437;0;0;0;0;.00nan;0;0
17437;190157;442;28;23;6;17;.739;3184000;0
17437;181100;442;49;1;0;1;1.000;416000;0
17437;139865;437;71;38;4;34;.895;3600000;0
17438;171787;4849;83;39;2;37;.949;3544000;0
17438;187689;421;0;0;0;0;.00nan;0;0
17438;184060;421;100;27;0;27;1.000;3600000;0
17438;196412;4849;0;0;0;0;.00nan;0;0
17439;183832;436;36;31;5;26;.839;3600000;0
17439;-1;428;54;16;2;14;.875;1332000;0
17439;174386;428;36;36;6;30;.833;2268000;0
17439;191861;436;0;0;0;0;.00nan;0;0
17440;170499;427;88;27;1;26;.963;3600000;0
17440;186468;427;0;0;0;0;.00nan;0;0
17440;-1;426;0;0;0;0;.00nan;0;0
17440;-1;426;65;27;2;25;.926;3551000;0
17441;189783;440;0;0;0;0;.00nan;0;0
17441;175723;440;72;34;3;31;.912;3600000;0
17441;-1;433;25;7;3;4;.571;581000;0
17441;-1;433;66;33;3;30;.909;3019000;0
17442;189288;419;0;0;0;0;.00nan;0;0
17442;184024;444;75;44;4;40;.909;3573000;0
17442;-1;419;55;16;2;14;.875;3600000;0
17442;191812;444;0;0;0;0;.00nan;0;0
17443;188965;423;0;0;0;0;.00nan;0;0
17443;194598;418;36;19;4;15;.789;3580000;0
17443;179143;423;89;39;3;36;.923;3600000;0
17443;180965;418;0;0;0;0;.00nan;0;0
17444;173339;430;70;46;5;41;.891;3644000;0
17444;170878;430;0;0;0;0;.00nan;0;0
17444;174420;439;0;0;0;0;.00nan;0;0
17444;182210;439;54;29;4;25;.862;3644000;0
17445;194650;410;0;0;0;0;.00nan;0;0
17445;184183;410;95;38;2;36;.947;3600000;0
17445;190073;413;0;0;0;0;.00nan;0;0
17445;192627;413;78;34;3;31;.912;3579000;0
17446;173519;441;0;0;0;0;.00nan;0;0
17446;179478;432;0;0;0;0;.00nan;0;0
17446;179657;441;52;27;3;24;.889;3600000;0
17446;187412;432;83;32;2;30;.938;3600000;0
17447;171930;422;79;30;2;28;.933;3937000;0
17447;179071;420;58;27;3;24;.889;3937000;0
17447;179127;422;0;0;0;0;.00nan;0;0
17447;186076;420;0;0;0;0;.00nan;0;0
17448;177155;411;0;0;0;0;.00nan;0;0
17448;184033;411;59;21;2;19;.905;3600000;0
17448;179689;415;63;23;3;20;.870;3550000;0
17448;191877;415;0;0;0;0;.00nan;0;0
17449;181346;414;74;39;3;36;.923;3600000;0
17449;-1;412;47;25;4;21;.840;3542000;0
17449;187309;414;0;0;0;0;.00nan;0;0
17449;-1;412;0;0;0;0;.00nan;0;0
17450;165023;438;56;29;4;25;.862;3512000;0
17450;173954;438;0;0;0;0;.00nan;0;0
17450;170928;443;80;32;2;30;.938;3600000;0
17450;182180;443;0;0;0;0;.00nan;0;0
17451;163177;425;0;0;0;0;.00nan;0;0
17451;178679;435;83;51;4;47;.922;3600000;0
17451;-1;425;55;14;2;12;.857;3600000;0
17451;-1;435;0;0;0;0;.00nan;0;0
17452;184336;429;0;0;0;0;.00nan;0;0
17452;-1;429;50;26;4;22;.846;3586000;0
17452;-1;426;82;34;2;32;.941;3600000;0
17452;-1;426;0;0;0;0;.00nan;0;0
17453;171930;422;0;0;0;0;.00nan;0;0
17453;179071;420;0;0;0;0;.00nan;0;0
17453;179127;422;77;39;3;36;.923;3554000;0
17453;186076;420;83;28;1;27;.964;3600000;0
17454;177155;411;0;0;0;0;.00nan;0;0
17454;194650;410;99;53;2;51;.962;3600000;0
17454;184033;411;51;25;3;22;.880;3545000;0
17454;184183;410;0;0;0;0;.00nan;0;0
17455;183832;436;77;14;0;14;1.000;3600000;0
17455;178679;435;0;0;0;0;.00nan;0;0
17455;191861;436;0;0;0;0;.00nan;0;0
17455;-1;435;58;31;4;27;.871;3600000;0
17456;178679;435;100;27;0;27;1.000;3600000;0
17456;-1;426;0;0;0;0;.00nan;0;0
17456;-1;426;42;37;5;32;.865;3600000;0
17456;-1;435;0;0;0;0;.00nan;0;0
17457;163177;425;0;0;0;0;.00nan;0;0
17457;184336;429;60;22;2;20;.909;3600000;0
17457;-1;425;72;39;4;35;.897;3557000;0
17457;-1;429;0;0;0;0;.00nan;0;0
17458;190073;413;36;25;5;20;.800;3548000;0
17458;-1;412;0;0;0;0;.00nan;0;0
17458;192627;413;0;0;0;0;.00nan;0;0
17458;-1;412;72;31;3;28;.903;3600000;0
17459;187689;421;0;0;0;0;.00nan;0;0
17459;189288;419;0;0;0;0;.00nan;0;0
17459;184060;421;97;41;1;40;.976;3645000;0
17459;-1;419;80;36;2;34;.944;3645000;0
17460;177155;411;93;35;2;33;.943;3600000;0
17460;184033;411;0;0;0;0;.00nan;0;0
17460;181346;414;0;0;0;0;.00nan;0;0
17460;187309;414;28;26;5;21;.808;3600000;0
17461;-1;428;0;0;0;0;.00nan;0;0
17461;170928;443;0;0;0;0;.00nan;0;0
17461;174386;428;78;35;3;32;.914;3852000;0
17461;182180;443;63;28;2;26;.929;3852000;0
17462;182475;437;0;0;0;0;.00nan;0;0
17462;189783;440;67;20;1;19;.950;3551000;0
17462;175723;440;0;0;0;0;.00nan;0;0
17462;139865;437;99;21;0;21;1.000;3600000;0
17463;188965;423;61;16;1;15;.938;3600000;0
17463;183885;449;0;0;0;0;.00nan;0;0
17463;179143;423;0;0;0;0;.00nan;0;0
17463;141530;449;60;44;5;39;.886;3600000;0
17464;194854;417;87;35;1;34;.971;3600000;0
17464;178890;417;0;0;0;0;.00nan;0;0
17464;179689;415;84;38;3;35;.921;3587000;0
17464;191877;415;0;0;0;0;.00nan;0;0
17465;173339;430;80;32;2;30;.938;4200000;0
17465;170878;430;0;0;0;0;.00nan;0;0
17465;179478;432;0;0;0;0;.00nan;0;0
17465;187412;432;87;35;2;33;.943;4200000;0
17466;171787;4849;0;0;0;0;.00nan;0;0
17466;171930;422;84;27;1;26;.963;3600000;0
17466;179127;422;0;0;0;0;.00nan;0;0
17466;196412;4849;53;26;2;24;.923;3576000;0
17467;194598;418;0;0;0;0;.00nan;0;0
17467;184024;444;0;0;0;0;.00nan;0;0
17467;180965;418;89;41;2;39;.951;3600000;0
17467;191812;444;51;30;4;26;.867;3551000;0
17468;165023;438;0;0;0;0;.00nan;0;0
17468;173519;441;0;0;0;0;.00nan;0;0
17468;173954;438;28;23;5;18;.783;3594000;0
17468;179657;441;75;37;3;34;.919;3600000;0
17469;174420;439;0;0;0;0;.00nan;0;0
17469;182210;439;77;20;1;19;.950;3600000;0
17469;182225;431;75;39;2;37;.949;3600000;0
17469;191171;431;0;0;0;0;.00nan;0;0
17470;179689;415;0;0;0;0;.00nan;0;0
17470;-1;412;87;24;2;22;.917;4200000;0
17470;191877;415;82;38;2;36;.947;4200000;0
17470;-1;412;0;0;0;0;.00nan;0;0
17471;187689;421;25;39;8;31;.795;2322000;0
17471;189288;419;81;9;0;9;1.000;3600000;0
17471;184060;421;63;19;1;18;.947;1278000;0
17471;-1;419;0;0;0;0;.00nan;0;0
17472;183832;436;67;25;2;23;.920;4135000;0
17472;170928;443;94;48;3;45;.938;4135000;0
17472;182180;443;0;0;0;0;.00nan;0;0
17472;191861;436;0;0;0;0;.00nan;0;0
17473;163177;425;50;20;3;17;.850;3600000;0
17473;170499;427;65;31;4;27;.871;3590000;0
17473;-1;425;0;0;0;0;.00nan;0;0
17473;186468;427;0;0;0;0;.00nan;0;0
17474;-1;428;0;0;0;0;.00nan;0;0
17474;174386;428;56;23;3;20;.870;3537000;0
17474;190157;442;94;41;1;40;.976;3600000;0
17474;181100;442;0;0;0;0;.00nan;0;0
17475;182475;437;0;0;0;0;.00nan;0;0
17475;189783;440;84;44;3;41;.932;3600000;0
17475;175723;440;0;0;0;0;.00nan;0;0
17475;139865;437;100;23;0;23;1.000;3600000;0
17476;188965;423;0;0;0;0;.00nan;0;0
17476;183885;449;79;49;4;45;.918;3589000;0
17476;179143;423;59;17;2;15;.882;3600000;0
17476;141530;449;0;0;0;0;.00nan;0;0
17477;184336;429;39;28;5;23;.821;3566000;0
17477;-1;429;0;0;0;0;.00nan;0;0
17477;-1;426;76;42;4;38;.905;3600000;0
17477;-1;426;0;0;0;0;.00nan;0;0
17478;-1;433;48;31;5;26;.839;3600000;0
17478;186671;434;92;33;1;32;.970;3600000;0
17478;-1;433;0;0;0;0;.00nan;0;0
17478;152650;434;0;0;0;0;.00nan;0;0
17479;194854;417;0;0;0;0;.00nan;0;0
17479;178890;417;61;42;5;37;.881;3546000;0
17479;190073;413;0;0;0;0;.00nan;0;0
17479;192627;413;72;35;3;32;.914;3600000;0
17480;194650;410;0;0;0;0;.00nan;0;0
17480;184183;410;68;46;4;42;.913;3553000;0
17480;181346;414;71;26;2;24;.923;3600000;0
17480;187309;414;0;0;0;0;.00nan;0;0
17481;173339;430;0;0;0;0;.00nan;0;0
17481;170878;430;44;30;5;25;.833;3600000;0
17481;182225;431;0;0;0;0;.00nan;0;0
17481;191171;431;73;31;2;29;.935;3600000;0
17482;171787;4849;89;37;1;36;.973;3600000;0
17482;171930;422;0;0;0;0;.00nan;0;0
17482;179127;422;79;39;3;36;.923;3524000;0
17482;196412;4849;0;0;0;0;.00nan;0;0
17483;194598;418;84;39;2;37;.949;3600000;0
17483;184024;444;42;17;3;14;.824;3600000;0
17483;180965;418;0;0;0;0;.00nan;0;0
17483;191812;444;0;0;0;0;.00nan;0;0
17484;165023;438;0;0;0;0;.00nan;0;0
17484;173519;441;0;0;0;0;.00nan;0;0
17484;173954;438;67;29;2;27;.931;3896000;0
17484;179657;441;70;41;3;38;.927;3896000;0
17485;174420;439;68;33;4;29;.879;3600000;0
17485;179478;432;29;24;5;19;.792;1907000;0
17485;182210;439;0;0;0;0;.00nan;0;0
17485;187412;432;51;22;3;19;.864;1693000;0
17486;190073;413;52;23;4;19;.826;3600000;0
17486;181346;414;0;0;0;0;.00nan;0;0
17486;187309;414;95;21;0;21;1.000;3600000;0
17486;192627;413;0;0;0;0;.00nan;0;0
17487;165023;438;0;0;0;0;.00nan;0;0
17487;183832;436;52;27;4;23;.852;3569000;0
17487;173954;438;63;29;3;26;.897;3600000;0
17487;191861;436;0;0;0;0;.00nan;0;0
17488;163177;425;0;0;0;0;.00nan;0;0
17488;-1;425;26;23;5;18;.783;3514000;0
17488;-1;433;75;38;3;35;.921;3600000;0
17488;-1;433;0;0;0;0;.00nan;0;0
17489;-1;428;0;0;0;0;.00nan;0;0
17489;189783;440;100;31;1;30;.968;3600000;0
17489;174386;428;51;22;3;19;.864;3553000;0
17489;175723;440;0;0;0;0;.00nan;0;0
17490;182475;437;0;0;0;0;.00nan;0;0
17490;182225;431;87;43;3;40;.930;3600000;0
17490;191171;431;0;0;0;0;.00nan;0;0
17490;139865;437;89;29;1;28;.966;3600000;0
17491;171787;4849;91;34;1;33;.971;3028000;0
17491;194598;418;0;0;0;0;.00nan;0;0
17491;196412;4849;15;7;4;3;.429;572000;0
17491;180965;418;66;15;1;14;.933;3600000;0
17492;178679;435;71;44;4;40;.909;3600000;0
17492;170499;427;83;29;1;28;.966;3600000;0
17492;186468;427;0;0;0;0;.00nan;0;0
17492;-1;435;0;0;0;0;.00nan;0;0
17493;177155;411;0;0;0;0;.00nan;0;0
17493;184033;411;53;23;3;20;.870;3569000;0
17493;-1;412;75;27;1;26;.963;3600000;0
17493;-1;412;0;0;0;0;.00nan;0;0
17494;-1;428;0;0;0;0;.00nan;0;0
17494;189783;440;0;0;0;0;.00nan;0;0
17494;174386;428;82;24;1;23;.958;3600000;0
17494;175723;440;62;40;5;35;.875;3600000;0
17495;171930;422;77;48;5;43;.896;3600000;0
17495;184024;444;0;0;0;0;.00nan;0;0
17495;179127;422;0;0;0;0;.00nan;0;0
17495;191812;444;95;32;1;31;.969;3600000;0
17496;188965;423;76;38;3;35;.921;3561000;0
17496;189288;419;0;0;0;0;.00nan;0;0
17496;179143;423;0;0;0;0;.00nan;0;0
17496;-1;419;56;18;2;16;.889;3600000;0
17497;173339;430;31;17;4;13;.765;1882000;0
17497;184336;429;75;32;2;30;.938;3600000;0
17497;170878;430;61;16;1;15;.938;1718000;0
17497;-1;429;0;0;0;0;.00nan;0;0
17498;179478;432;0;0;0;0;.00nan;0;0
17498;186671;434;58;18;2;16;.889;3600000;0
17498;187412;432;97;53;3;50;.943;3600000;0
17498;152650;434;0;0;0;0;.00nan;0;0
17499;183885;449;100;45;1;44;.978;3600000;0
17499;179071;420;60;21;2;19;.905;3559000;0
17499;186076;420;0;0;0;0;.00nan;0;0
17499;141530;449;0;0;0;0;.00nan;0;0
17500;194650;410;44;24;4;20;.833;3537000;0
17500;194854;417;72;31;2;29;.935;3600000;0
17500;184183;410;0;0;0;0;.00nan;0;0
17500;178890;417;0;0;0;0;.00nan;0;0
17501;171787;4849;0;0;0;0;.00nan;0;0
17501;194598;418;90;27;1;26;.963;3600000;0
17501;196412;4849;79;50;4;46;.920;3600000;0
17501;180965;418;0;0;0;0;.00nan;0;0
17502;190073;413;0;0;0;0;.00nan;0;0
17502;179689;415;90;21;0;21;1.000;3600000;0
17502;191877;415;0;0;0;0;.00nan;0;0
17502;192627;413;74;48;5;43;.896;3600000;0
17503;173519;441;0;0;0;0;.00nan;0;0
17503;170928;443;0;0;0;0;.00nan;0;0
17503;179657;441;70;31;2;29;.935;3600000;0
17503;182180;443;52;25;3;22;.880;3546000;0
17504;174420;439;0;0;0;0;.00nan;0;0
17504;190157;442;90;44;2;42;.955;3541000;0
17504;181100;442;0;0;0;0;.00nan;0;0
17504;182210;439;85;16;0;16;1.000;3600000;0
17505;194650;410;0;0;0;0;.00nan;0;0
17505;184183;410;52;25;3;22;.880;3523000;0
17505;-1;412;0;0;0;0;.00nan;0;0
17505;-1;412;66;25;2;23;.920;3600000;0
17506;183832;436;0;0;0;0;.00nan;0;0
17506;190157;442;0;0;0;0;.00nan;0;0
17506;181100;442;67;35;3;32;.914;3600000;0
17506;191861;436;100;31;0;31;1.000;3600000;0
17507;163177;425;0;0;0;0;.00nan;0;0
17507;-1;425;48;30;5;25;.833;3600000;0
17507;186671;434;0;0;0;0;.00nan;0;0
17507;152650;434;53;29;4;25;.862;3600000;0
17508;182475;437;65;26;2;24;.923;3600000;0
17508;174420;439;0;0;0;0;.00nan;0;0
17508;182210;439;37;22;4;18;.818;3595000;0
17508;139865;437;0;0;0;0;.00nan;0;0
17509;171930;422;0;0;0;0;.00nan;0;0
17509;184024;444;93;28;1;27;.964;3751000;0
17509;179127;422;94;41;2;39;.951;3751000;0
17509;191812;444;0;0;0;0;.00nan;0;0
17510;188965;423;0;0;0;0;.00nan;0;0
17510;189288;419;46;31;5;26;.839;3600000;0
17510;179143;423;78;22;1;21;.955;3600000;0
17510;-1;419;0;0;0;0;.00nan;0;0
17511;173339;430;0;0;0;0;.00nan;0;0
17511;173519;441;0;0;0;0;.00nan;0;0
17511;170878;430;75;28;2;26;.929;3600000;0
17511;179657;441;46;33;5;28;.848;3600000;0
17512;182225;431;40;35;6;29;.829;2988000;0
17512;191171;431;44;4;1;3;.750;612000;0
17512;-1;426;100;31;0;31;1.000;3600000;0
17512;-1;426;0;0;0;0;.00nan;0;0
17513;178679;435;0;0;0;0;.00nan;0;0
17513;184336;429;0;0;0;0;.00nan;0;0
17513;-1;429;21;17;5;12;.706;3529000;0
17513;-1;435;80;44;3;41;.932;3600000;0
17514;183885;449;88;28;1;27;.964;3600000;0
17514;179071;420;0;0;0;0;.00nan;0;0
17514;186076;420;56;19;2;17;.895;3543000;0
17514;141530;449;0;0;0;0;.00nan;0;0
17515;179478;432;22;33;7;26;.788;3600000;0
17515;-1;433;0;0;0;0;.00nan;0;0
17515;187412;432;0;0;0;0;.00nan;0;0
17515;-1;433;93;32;1;31;.969;3600000;0
17516;177155;411;60;18;2;16;.889;3600000;0
17516;184033;411;0;0;0;0;.00nan;0;0
17516;194854;417;0;0;0;0;.00nan;0;0
17516;178890;417;78;40;3;37;.925;3600000;0
17517;179689;415;46;38;5;33;.868;3600000;0
17517;181346;414;0;0;0;0;.00nan;0;0
17517;187309;414;84;25;1;24;.960;3600000;0
17517;191877;415;0;0;0;0;.00nan;0;0
17518;182475;437;0;0;0;0;.00nan;0;0
17518;190157;442;94;38;1;37;.974;4200000;0
17518;181100;442;0;0;0;0;.00nan;0;0
17518;139865;437;94;47;1;46;.979;4200000;0
17519;177155;411;0;0;0;0;.00nan;0;0
17519;194650;410;79;33;2;31;.939;3600000;0
17519;184033;411;44;23;4;19;.826;3512000;0
17519;184183;410;0;0;0;0;.00nan;0;0
17520;170499;427;52;38;6;32;.842;3600000;0
17520;179478;432;0;0;0;0;.00nan;0;0
17520;186468;427;0;0;0;0;.00nan;0;0
17520;187412;432;55;29;3;26;.897;3600000;0
17521;163177;425;0;0;0;0;.00nan;0;0
17521;-1;425;100;32;0;32;1.000;3600000;0
17521;-1;433;88;39;2;37;.949;3541000;0
17521;-1;433;0;0;0;0;.00nan;0;0
17522;184024;444;0;0;0;0;.00nan;0;0
17522;179071;420;42;6;1;5;.833;531000;0
17522;186076;420;34;28;5;23;.821;3069000;0
17522;191812;444;38;15;3;12;.800;3600000;0
17523;190073;413;72;41;4;37;.902;3579000;0
17523;-1;412;80;39;3;36;.923;3600000;0
17523;192627;413;0;0;0;0;.00nan;0;0
17523;-1;412;0;0;0;0;.00nan;0;0
17524;183885;449;100;43;1;42;.977;3600000;0
17524;189288;419;0;0;0;0;.00nan;0;0
17524;-1;419;57;22;3;19;.864;3513000;0
17524;141530;449;0;0;0;0;.00nan;0;0
17525;173519;441;0;0;0;0;.00nan;0;0
17525;179657;441;75;25;1;24;.960;3553000;0
17525;182225;431;0;0;0;0;.00nan;0;0
17525;191171;431;100;26;0;26;1.000;3600000;0
17526;170928;443;0;0;0;0;.00nan;0;0
17526;182180;443;67;42;4;38;.905;3600000;0
17526;-1;426;87;20;1;19;.950;3600000;0
17526;-1;426;0;0;0;0;.00nan;0;0
17527;184336;429;76;28;2;26;.929;3988000;0
17527;189783;440;78;44;3;41;.932;3988000;0
17527;175723;440;0;0;0;0;.00nan;0;0
17527;-1;429;0;0;0;0;.00nan;0;0
17528;163177;425;0;0;0;0;.00nan;0;0
17528;-1;425;25;34;7;27;.794;3600000;0
17528;186671;434;100;30;0;30;1.000;3600000;0
17528;152650;434;0;0;0;0;.00nan;0;0
17529;171930;422;81;27;2;25;.926;3600000;0
17529;187689;421;0;0;0;0;.00nan;0;0
17529;184060;421;58;28;4;24;.857;3560000;0
17529;179127;422;0;0;0;0;.00nan;0;0
17530;171787;4849;52;33;4;29;.879;3562000;0
17530;188965;423;70;32;3;29;.906;3600000;0
17530;179143;423;0;0;0;0;.00nan;0;0
17530;196412;4849;0;0;0;0;.00nan;0;0
17531;194854;417;59;16;2;14;.875;3600000;0
17531;178890;417;0;0;0;0;.00nan;0;0
17531;179689;415;0;0;0;0;.00nan;0;0
17531;191877;415;60;24;3;21;.875;3588000;0
17532;194650;410;0;0;0;0;.00nan;0;0
17532;184183;410;90;46;2;44;.957;4200000;0
17532;181346;414;0;0;0;0;.00nan;0;0
17532;187309;414;61;29;2;27;.931;4200000;0
17533;182475;437;0;0;0;0;.00nan;0;0
17533;165023;438;57;33;4;29;.879;3600000;0
17533;173954;438;0;0;0;0;.00nan;0;0
17533;139865;437;55;18;3;15;.833;3600000;0
17534;-1;428;0;0;0;0;.00nan;0;0
17534;174386;428;96;50;3;47;.940;3547000;0
17534;174420;439;0;0;0;0;.00nan;0;0
17534;182210;439;71;19;1;18;.947;3600000;0
17535;173339;430;78;35;2;33;.943;3575000;0
17535;178679;435;95;33;1;32;.970;3600000;0
17535;170878;430;0;0;0;0;.00nan;0;0
17535;-1;435;0;0;0;0;.00nan;0;0
17536;183885;449;99;57;1;56;.982;3600000;0
17536;189288;419;50;15;2;13;.867;3564000;0
17536;-1;419;0;0;0;0;.00nan;0;0
17536;141530;449;0;0;0;0;.00nan;0;0
17537;170499;427;55;21;3;18;.857;3600000;0
17537;189783;440;0;0;0;0;.00nan;0;0
17537;175723;440;44;32;5;27;.844;3561000;0
17537;186468;427;0;0;0;0;.00nan;0;0
17538;184024;444;42;11;2;9;.818;3600000;0
17538;179071;420;49;37;5;32;.865;3600000;0
17538;186076;420;0;0;0;0;.00nan;0;0
17538;191812;444;0;0;0;0;.00nan;0;0
17539;194854;417;0;0;0;0;.00nan;0;0
17539;178890;417;81;36;3;33;.917;3600000;0
17539;190073;413;0;0;0;0;.00nan;0;0
17539;192627;413;51;37;5;32;.865;3531000;0
17540;173519;441;55;18;2;16;.889;3600000;0
17540;179657;441;0;0;0;0;.00nan;0;0
17540;182225;431;0;0;0;0;.00nan;0;0
17540;191171;431;90;30;1;29;.967;3600000;0
17541;173339;430;86;19;0;19;1.000;2774000;0
17541;170878;430;20;8;4;4;.500;826000;0
17541;-1;426;0;0;0;0;.00nan;0;0
17541;-1;426;51;32;5;27;.844;3563000;0
17542;171930;422;0;0;0;0;.00nan;0;0
17542;187689;421;66;38;4;34;.895;3567000;0
17542;184060;421;0;0;0;0;.00nan;0;0
17542;179127;422;84;33;2;31;.939;3600000;0
17543;184336;429;60;23;2;21;.913;3600000;0
17543;179478;432;70;31;3;28;.903;3591000;0
17543;-1;429;0;0;0;0;.00nan;0;0
17543;187412;432;0;0;0;0;.00nan;0;0
17544;171787;4849;0;0;0;0;.00nan;0;0
17544;188965;423;0;0;0;0;.00nan;0;0
17544;179143;423;19;24;6;18;.750;3600000;0
17544;196412;4849;61;31;3;28;.903;3600000;0
17545;179689;415;66;24;2;22;.917;3529000;0
17545;-1;412;0;0;0;0;.00nan;0;0
17545;191877;415;0;0;0;0;.00nan;0;0
17545;-1;412;97;32;0;32;1.000;3600000;0
17546;177155;411;78;34;2;32;.941;3600000;0
17546;184033;411;0;0;0;0;.00nan;0;0
17546;181346;414;74;44;4;40;.909;3600000;0
17546;187309;414;0;0;0;0;.00nan;0;0
17547;165023;438;0;0;0;0;.00nan;0;0
17547;173954;438;66;30;3;27;.900;3600000;0
17547;190157;442;85;20;1;19;.950;3600000;0
17547;181100;442;0;0;0;0;.00nan;0;0
17548;183832;436;0;0;0;0;.00nan;0;0
17548;174420;439;76;33;3;30;.909;3847000;0
17548;182210;439;0;0;0;0;.00nan;0;0
17548;191861;436;94;63;4;59;.937;3847000;0
17549;178679;435;0;0;0;0;.00nan;0;0
17549;170928;443;60;30;3;27;.900;3600000;0
17549;182180;443;0;0;0;0;.00nan;0;0
17549;-1;435;87;29;1;28;.966;3600000;0
17550;194854;417;93;34;1;33;.971;3600000;0
17550;178890;417;0;0;0;0;.00nan;0;0
17550;-1;412;0;0;0;0;.00nan;0;0
17550;-1;412;57;29;3;26;.897;3547000;0
17551;163177;425;0;0;0;0;.00nan;0;0
17551;173339;430;84;49;5;44;.898;3600000;0
17551;170878;430;0;0;0;0;.00nan;0;0
17551;-1;425;81;22;1;21;.955;3600000;0
17552;178679;435;82;50;5;45;.900;3532000;0
17552;186671;434;54;27;3;24;.889;3600000;0
17552;-1;435;0;0;0;0;.00nan;0;0
17552;152650;434;0;0;0;0;.00nan;0;0
17553;165023;438;0;0;0;0;.00nan;0;0
17553;173954;438;72;29;2;27;.931;3745000;0
17553;182225;431;0;0;0;0;.00nan;0;0
17553;191171;431;73;29;3;26;.897;3745000;0
17554;179478;432;0;0;0;0;.00nan;0;0
17554;187412;432;66;34;3;31;.912;4046000;0
17554;-1;426;53;29;4;25;.862;4046000;0
17554;-1;426;0;0;0;0;.00nan;0;0
17555;187689;421;0;0;0;0;.00nan;0;0
17555;194598;418;0;0;0;0;.00nan;0;0
17555;184060;421;70;23;2;21;.913;3600000;0
17555;180965;418;61;41;4;37;.902;3575000;0
17556;177155;411;0;0;0;0;.00nan;0;0
17556;184033;411;58;19;2;17;.895;3599000;0
17556;190073;413;99;46;1;45;.978;3600000;0
17556;192627;413;0;0;0;0;.00nan;0;0
17557;189783;440;98;48;2;46;.958;3600000;0
17557;174420;439;0;0;0;0;.00nan;0;0
17557;175723;440;0;0;0;0;.00nan;0;0
17557;182210;439;78;16;1;15;.938;3600000;0
17558;182475;437;0;0;0;0;.00nan;0;0
17558;-1;433;68;35;3;32;.914;4200000;0
17558;-1;433;0;0;0;0;.00nan;0;0
17558;139865;437;62;28;3;25;.893;4200000;0
17559;188965;423;26;12;4;8;.667;831000;0
17559;184024;444;0;0;0;0;.00nan;0;0
17559;179143;423;62;20;2;18;.900;2769000;0
17559;191812;444;80;30;1;29;.967;3600000;0
17560;171930;422;62;35;4;31;.886;4044000;0
17560;183885;449;58;38;5;33;.868;4044000;0
17560;179127;422;0;0;0;0;.00nan;0;0
17560;141530;449;0;0;0;0;.00nan;0;0
17561;183832;436;0;0;0;0;.00nan;0;0
17561;173519;441;0;0;0;0;.00nan;0;0
17561;179657;441;100;40;1;39;.975;3600000;0
17561;191861;436;46;25;4;21;.840;3600000;0
17562;171787;4849;0;0;0;0;.00nan;0;0
17562;179071;420;0;0;0;0;.00nan;0;0
17562;196412;4849;61;24;2;22;.917;4200000;0
17562;186076;420;88;40;2;38;.950;4200000;0
17563;194854;417;89;48;3;45;.938;3586000;0
17563;178890;417;0;0;0;0;.00nan;0;0
17563;181346;414;0;0;0;0;.00nan;0;0
17563;187309;414;55;19;2;17;.895;3600000;0
17564;194650;410;39;37;6;31;.838;2643000;0
17564;184183;410;56;13;1;12;.923;957000;0
17564;179689;415;0;0;0;0;.00nan;0;0
17564;191877;415;65;18;1;17;.944;3600000;0
17565;179478;432;95;28;1;27;.964;3600000;0
17565;182225;431;0;0;0;0;.00nan;0;0
17565;191171;431;60;25;2;23;.920;3600000;0
17565;187412;432;0;0;0;0;.00nan;0;0
17566;170499;427;98;47;2;45;.957;4200000;0
17566;170928;443;0;0;0;0;.00nan;0;0
17566;182180;443;94;37;2;35;.946;4200000;0
17566;186468;427;0;0;0;0;.00nan;0;0
17567;190157;442;0;0;0;0;.00nan;0;0
17567;181100;442;85;34;2;32;.941;3600000;0
17567;186671;434;59;28;3;25;.893;3543000;0
17567;152650;434;0;0;0;0;.00nan;0;0
17568;165023;438;0;0;0;0;.00nan;0;0
17568;-1;428;0;0;0;0;.00nan;0;0
17568;173954;438;44;17;3;14;.824;3600000;0
17568;174386;428;76;43;5;38;.884;3541000;0
17569;181346;414;19;23;6;17;.739;3214000;0
17569;-1;412;0;0;0;0;.00nan;0;0
17569;187309;414;63;8;0;8;1.000;386000;0
17569;-1;412;58;27;4;23;.852;3600000;0
17570;187689;421;40;20;3;17;.850;3571000;0
17570;194598;418;90;42;2;40;.952;3600000;0
17570;184060;421;0;0;0;0;.00nan;0;0
17570;180965;418;0;0;0;0;.00nan;0;0
17571;163177;425;0;0;0;0;.00nan;0;0
17571;184336;429;49;28;4;24;.857;3546000;0
17571;-1;425;75;34;3;31;.912;3600000;0
17571;-1;429;0;0;0;0;.00nan;0;0
17572;177155;411;100;26;0;26;1.000;3600000;0
17572;184033;411;0;0;0;0;.00nan;0;0
17572;179689;415;70;34;3;31;.912;3600000;0
17572;191877;415;0;0;0;0;.00nan;0;0
17573;189783;440;0;0;0;0;.00nan;0;0
17573;174420;439;0;0;0;0;.00nan;0;0
17573;175723;440;82;38;3;35;.921;3584000;0
17573;182210;439;67;24;2;22;.917;3600000;0
17574;182475;437;76;31;2;29;.935;3600000;0
17574;186671;434;0;0;0;0;.00nan;0;0
17574;139865;437;0;0;0;0;.00nan;0;0
17574;152650;434;53;24;3;21;.875;3600000;0
17575;188965;423;80;32;2;30;.938;3600000;0
17575;184024;444;62;25;3;22;.880;3600000;0
17575;179143;423;0;0;0;0;.00nan;0;0
17575;191812;444;0;0;0;0;.00nan;0;0
17576;173339;430;69;29;3;26;.897;3545000;0
17576;170499;427;95;37;2;35;.946;3600000;0
17576;170878;430;0;0;0;0;.00nan;0;0
17576;186468;427;0;0;0;0;.00nan;0;0
17577;171930;422;0;0;0;0;.00nan;0;0
17577;183885;449;0;0;0;0;.00nan;0;0
17577;179127;422;52;31;4;27;.871;3561000;0
17577;141530;449;49;23;3;20;.870;3600000;0
17578;183832;436;100;37;1;36;.973;3600000;0
17578;173519;441;63;31;3;28;.903;3600000;0
17578;179657;441;0;0;0;0;.00nan;0;0
17578;191861;436;0;0;0;0;.00nan;0;0
17579;171787;4849;70;37;3;34;.919;3600000;0
17579;179071;420;93;21;0;21;1.000;3600000;0
17579;196412;4849;0;0;0;0;.00nan;0;0
17579;186076;420;0;0;0;0;.00nan;0;0
17580;194650;410;0;0;0;0;.00nan;0;0
17580;184183;410;78;32;1;31;.969;4200000;0
17580;190073;413;0;0;0;0;.00nan;0;0
17580;192627;413;73;27;1;26;.963;4200000;0
17581;-1;428;0;0;0;0;.00nan;0;0
17581;174386;428;73;39;3;36;.923;4149000;0
17581;182225;431;80;36;3;33;.917;4200000;0
17581;191171;431;0;0;0;0;.00nan;0;0
17582;190157;442;88;24;1;23;.958;3600000;0
17582;181100;442;0;0;0;0;.00nan;0;0
17582;-1;433;0;0;0;0;.00nan;0;0
17582;-1;433;68;36;3;33;.917;3584000;0
17583;178679;435;0;0;0;0;.00nan;0;0
17583;-1;426;0;0;0;0;.00nan;0;0
17583;-1;426;81;27;1;26;.963;3600000;0
17583;-1;435;83;42;3;39;.929;3570000;0
17584;184336;429;59;31;3;28;.903;3767000;0
17584;170928;443;0;0;0;0;.00nan;0;0
17584;182180;443;63;35;4;31;.886;3767000;0
17584;-1;429;0;0;0;0;.00nan;0;0
17585;190073;413;99;27;0;27;1.000;3600000;0
17585;179689;415;0;0;0;0;.00nan;0;0
17585;191877;415;33;27;5;22;.815;3600000;0
17585;192627;413;0;0;0;0;.00nan;0;0
17586;163177;425;0;0;0;0;.00nan;0;0
17586;170928;443;74;38;3;35;.921;3902000;0
17586;-1;425;74;27;2;25;.926;3902000;0
17586;182180;443;0;0;0;0;.00nan;0;0
17587;165023;438;0;0;0;0;.00nan;0;0
17587;-1;428;0;0;0;0;.00nan;0;0
17587;173954;438;84;30;2;28;.933;3600000;0
17587;174386;428;86;37;3;34;.919;3600000;0
17588;170499;427;90;30;2;28;.933;3600000;0
17588;184336;429;63;30;3;27;.900;3600000;0
17588;-1;429;0;0;0;0;.00nan;0;0
17588;186468;427;0;0;0;0;.00nan;0;0
17589;-1;433;94;47;2;45;.957;4059000;0
17589;186671;434;82;29;1;28;.966;4059000;0
17589;-1;433;0;0;0;0;.00nan;0;0
17589;152650;434;0;0;0;0;.00nan;0;0
17590;177155;411;0;0;0;0;.00nan;0;0
17590;184033;411;49;30;4;26;.867;3600000;0
17590;-1;412;75;26;1;25;.962;3600000;0
17590;-1;412;0;0;0;0;.00nan;0;0
17591;183832;436;0;0;0;0;.00nan;0;0
17591;179478;432;0;0;0;0;.00nan;0;0
17591;187412;432;94;44;1;43;.977;4200000;0
17591;191861;436;87;29;1;28;.966;4200000;0
17592;189288;419;0;0;0;0;.00nan;0;0
17592;179071;420;80;43;4;39;.907;3600000;0
17592;-1;419;65;19;1;18;.947;3600000;0
17592;186076;420;0;0;0;0;.00nan;0;0
17593;173519;441;0;0;0;0;.00nan;0;0
17593;189783;440;97;35;2;33;.943;3600000;0
17593;175723;440;0;0;0;0;.00nan;0;0
17593;179657;441;38;39;7;32;.821;3600000;0
17594;194650;410;78;33;2;31;.939;3600000;0
17594;194854;417;55;26;3;23;.885;3586000;0
17594;184183;410;0;0;0;0;.00nan;0;0
17594;178890;417;0;0;0;0;.00nan;0;0
17595;171930;422;90;28;1;27;.964;3600000;0
17595;188965;423;100;29;0;29;1.000;3600000;0
17595;179127;422;0;0;0;0;.00nan;0;0
17595;179143;423;0;0;0;0;.00nan;0;0
17596;171787;4849;72;36;3;33;.917;3554000;0
17596;187689;421;71;18;1;17;.944;3600000;0
17596;184060;421;0;0;0;0;.00nan;0;0
17596;196412;4849;0;0;0;0;.00nan;0;0
17597;183885;449;48;40;5;35;.875;3575000;0
17597;194598;418;0;0;0;0;.00nan;0;0
17597;180965;418;52;27;4;23;.852;3600000;0
17597;141530;449;0;0;0;0;.00nan;0;0
17598;190073;413;76;41;4;37;.902;3565000;0
17598;181346;414;0;0;0;0;.00nan;0;0
17598;187309;414;53;21;3;18;.857;3600000;0
17598;192627;413;0;0;0;0;.00nan;0;0
17599;170928;443;0;0;0;0;.00nan;0;0
17599;182180;443;74;26;1;25;.962;3600000;0
17599;182225;431;0;0;0;0;.00nan;0;0
17599;191171;431;47;26;4;22;.846;3600000;0
17600;165023;438;36;24;5;19;.792;3634000;0
17600;173954;438;0;0;0;0;.00nan;0;0
17600;190157;442;0;0;0;0;.00nan;0;0
17600;181100;442;33;29;6;23;.793;3634000;0
17601;182475;437;0;0;0;0;.00nan;0;0
17601;174420;439;0;0;0;0;.00nan;0;0
17601;182210;439;79;41;3;38;.927;4154000;0
17601;139865;437;99;44;3;41;.932;4200000;0
17602;189288;419;60;12;1;11;.917;3600000;0
17602;179071;420;0;0;0;0;.00nan;0;0
17602;-1;419;0;0;0;0;.00nan;0;0
17602;186076;420;56;50;6;44;.880;3600000;0
17603;173339;430;64;38;4;34;.895;3600000;0
17603;170499;427;100;31;0;31;1.000;3600000;0
17603;170878;430;0;0;0;0;.00nan;0;0
17603;186468;427;0;0;0;0;.00nan;0;0
17604;177155;411;59;19;2;17;.895;3600000;0
17604;184033;411;0;0;0;0;.00nan;0;0
17604;194854;417;0;0;0;0;.00nan;0;0
17604;178890;417;95;36;1;35;.972;3600000;0
17605;186671;434;90;36;2;34;.944;3600000;0
17605;-1;426;41;29;5;24;.828;3600000;0
17605;-1;426;0;0;0;0;.00nan;0;0
17605;152650;434;0;0;0;0;.00nan;0;0
17606;178679;435;0;0;0;0;.00nan;0;0
17606;-1;433;97;49;2;47;.959;4200000;0
17606;-1;433;0;0;0;0;.00nan;0;0
17606;-1;435;73;26;2;24;.923;4200000;0
17607;171930;422;0;0;0;0;.00nan;0;0
17607;188965;423;57;31;3;28;.903;3600000;0
17607;179127;422;93;21;0;21;1.000;3600000;0
17607;179143;423;0;0;0;0;.00nan;0;0
17608;194650;410;0;0;0;0;.00nan;0;0
17608;184183;410;100;37;1;36;.973;3600000;0
17608;-1;412;0;0;0;0;.00nan;0;0
17608;-1;412;54;19;2;17;.895;3600000;0
17609;171787;4849;0;0;0;0;.00nan;0;0
17609;187689;421;0;0;0;0;.00nan;0;0
17609;184060;421;100;26;0;26;1.000;3600000;0
17609;196412;4849;53;28;3;25;.893;3600000;0
17610;183885;449;33;25;5;20;.800;1698000;0
17610;194598;418;74;26;1;25;.962;3600000;0
17610;180965;418;0;0;0;0;.00nan;0;0
17610;141530;449;56;31;4;27;.871;1902000;0
17611;179689;415;100;37;0;37;1.000;3600000;0
17611;181346;414;42;31;5;26;.839;3600000;0
17611;187309;414;0;0;0;0;.00nan;0;0
17611;191877;415;0;0;0;0;.00nan;0;0
17612;174420;439;0;0;0;0;.00nan;0;0
17612;190157;442;47;34;5;29;.853;3600000;0
17612;181100;442;0;0;0;0;.00nan;0;0
17612;182210;439;100;22;0;22;1.000;3600000;0
17614;171787;4849;0;0;0;0;.00nan;0;0
17614;196412;4849;60;36;4;32;.889;4163000;0
17614;-1;412;51;38;5;33;.868;4163000;0
17614;-1;412;0;0;0;0;.00nan;0;0
17616;170928;443;0;0;0;0;.00nan;0;0
17616;179689;415;43;35;5;30;.857;3600000;0
17616;182180;443;65;25;2;23;.920;3600000;0
17616;191877;415;0;0;0;0;.00nan;0;0
17618;194854;417;0;0;0;0;.00nan;0;0
17618;178890;417;79;38;3;35;.921;3600000;0
17618;184336;429;41;30;5;25;.833;3553000;0
17618;-1;429;0;0;0;0;.00nan;0;0
17620;177155;411;92;30;1;29;.967;3600000;0
17620;183885;449;72;39;4;35;.897;3600000;0
17620;184033;411;0;0;0;0;.00nan;0;0
17620;141530;449;0;0;0;0;.00nan;0;0
17622;186671;434;68;25;2;23;.920;3600000;0
17622;-1;426;0;0;0;0;.00nan;0;0
17622;-1;426;53;28;4;24;.857;3600000;0
17622;152650;434;0;0;0;0;.00nan;0;0
17624;178679;435;0;0;0;0;.00nan;0;0
17624;190073;413;0;0;0;0;.00nan;0;0
17624;192627;413;79;26;1;25;.962;3600000;0
17624;-1;435;53;32;4;28;.875;3600000;0
17626;194598;418;46;14;3;11;.786;1478000;0
17626;184024;444;0;0;0;0;.00nan;0;0
17626;180965;418;19;24;6;18;.750;2122000;0
17626;191812;444;92;19;0;19;1.000;3600000;0
17628;187689;421;66;35;3;32;.914;3600000;0
17628;184060;421;0;0;0;0;.00nan;0;0
17628;170499;427;80;35;2;33;.943;3600000;0
17628;186468;427;0;0;0;0;.00nan;0;0
17630;-1;428;0;0;0;0;.00nan;0;0
17630;174386;428;59;33;4;29;.879;3600000;0
17630;181346;414;73;24;1;23;.958;3600000;0
17630;187309;414;0;0;0;0;.00nan;0;0
17632;188965;423;71;23;2;21;.913;3563000;0
17632;179071;420;0;0;0;0;.00nan;0;0
17632;179143;423;0;0;0;0;.00nan;0;0
17632;186076;420;82;25;1;24;.960;3600000;0
17634;171930;422;64;16;1;15;.938;4200000;0
17634;179127;422;0;0;0;0;.00nan;0;0
17634;182225;431;0;0;0;0;.00nan;0;0
17634;191171;431;97;40;1;39;.975;4200000;0
17636;182475;437;0;0;0;0;.00nan;0;0
17636;189288;419;95;23;0;23;1.000;3600000;0
17636;-1;419;0;0;0;0;.00nan;0;0
17636;139865;437;97;41;2;39;.951;3576000;0
17638;173339;430;82;37;2;35;.946;3600000;0
17638;170878;430;0;0;0;0;.00nan;0;0
17638;189783;440;79;26;1;25;.962;3600000;0
17638;175723;440;0;0;0;0;.00nan;0;0
17640;173519;441;0;0;0;0;.00nan;0;0
17640;179657;441;53;42;6;36;.857;3600000;0
17640;-1;433;82;31;2;29;.935;3600000;0
17640;-1;433;0;0;0;0;.00nan;0;0
17642;165023;438;0;0;0;0;.00nan;0;0
17642;183832;436;61;37;4;33;.892;3580000;0
17642;173954;438;79;31;2;29;.935;3600000;0
17642;191861;436;0;0;0;0;.00nan;0;0
17644;163177;425;0;0;0;0;.00nan;0;0
17644;174420;439;0;0;0;0;.00nan;0;0
17644;-1;425;67;25;3;22;.880;4200000;0
17644;182210;439;61;27;3;24;.889;4200000;0
17646;194650;410;76;41;4;37;.902;3730000;0
17646;184183;410;0;0;0;0;.00nan;0;0
17646;179478;432;0;0;0;0;.00nan;0;0
17646;187412;432;47;22;3;19;.864;3730000;0
17648;183832;436;79;35;2;33;.943;3600000;0
17648;173519;441;0;0;0;0;.00nan;0;0
17648;179657;441;65;34;3;31;.912;3561000;0
17648;191861;436;0;0;0;0;.00nan;0;0
17650;181346;414;0;0;0;0;.00nan;0;0
17650;187309;414;55;47;6;41;.872;3600000;0
17650;-1;426;56;16;2;14;.875;3600000;0
17650;-1;426;0;0;0;0;.00nan;0;0
17652;188965;423;0;0;0;0;.00nan;0;0
17652;194854;417;0;0;0;0;.00nan;0;0
17652;178890;417;75;40;4;36;.900;4089000;0
17652;179143;423;67;33;3;30;.909;4089000;0
17654;178679;435;46;32;4;28;.875;3564000;0
17654;-1;412;69;34;3;31;.912;3600000;0
17654;-1;412;0;0;0;0;.00nan;0;0
17654;-1;435;0;0;0;0;.00nan;0;0
17656;171930;422;0;0;0;0;.00nan;0;0
17656;194598;418;84;35;2;33;.943;3600000;0
17656;179127;422;83;44;3;41;.932;3547000;0
17656;180965;418;0;0;0;0;.00nan;0;0
17658;177155;411;39;25;4;21;.840;4200000;0
17658;184033;411;0;0;0;0;.00nan;0;0
17658;190157;442;68;40;4;36;.900;4200000;0
17658;181100;442;0;0;0;0;.00nan;0;0
17660;190073;413;0;0;0;0;.00nan;0;0
17660;186671;434;62;15;1;14;.933;3600000;0
17660;192627;413;97;38;2;36;.947;3552000;0
17660;152650;434;0;0;0;0;.00nan;0;0
17662;179071;420;47;28;5;23;.821;3600000;0
17662;-1;433;14;18;6;12;.667;2679000;0
17662;186076;420;0;0;0;0;.00nan;0;0
17662;-1;433;57;6;0;6;1.000;921000;0
17664;173339;430;58;28;3;25;.893;3538000;0
17664;184024;444;0;0;0;0;.00nan;0;0
17664;170878;430;0;0;0;0;.00nan;0;0
17664;191812;444;82;28;1;27;.964;3600000;0
17666;170499;427;73;36;3;33;.917;3600000;0
17666;179478;432;95;26;0;26;1.000;3600000;0
17666;186468;427;0;0;0;0;.00nan;0;0
17666;187412;432;0;0;0;0;.00nan;0;0
17668;182475;437;0;0;0;0;.00nan;0;0
17668;182225;431;68;25;2;23;.920;3600000;0
17668;191171;431;0;0;0;0;.00nan;0;0
17668;139865;437;91;48;3;45;.938;3569000;0
17670;163177;425;0;0;0;0;.00nan;0;0
17670;183885;449;98;48;1;47;.979;4200000;0
17670;-1;425;79;24;1;23;.958;4200000;0
17670;141530;449;0;0;0;0;.00nan;0;0
17672;184336;429;86;37;2;35;.946;3600000;0
17672;174420;439;0;0;0;0;.00nan;0;0
17672;182210;439;47;28;4;24;.857;3577000;0
17672;-1;429;0;0;0;0;.00nan;0;0
17674;171787;4849;59;44;6;38;.864;3600000;0
17674;-1;428;0;0;0;0;.00nan;0;0
17674;174386;428;71;19;2;17;.895;3600000;0
17674;196412;4849;0;0;0;0;.00nan;0;0
17676;189288;419;100;22;0;22;1.000;3600000;0
17676;189783;440;51;29;4;25;.862;3600000;0
17676;175723;440;0;0;0;0;.00nan;0;0
17676;-1;419;0;0;0;0;.00nan;0;0
17678;170928;443;0;0;0;0;.00nan;0;0
17678;179689;415;47;22;3;19;.864;4200000;0
17678;182180;443;52;27;3;24;.889;4200000;0
17678;191877;415;0;0;0;0;.00nan;0;0
17680;187689;421;82;25;1;24;.960;3600000;0
17680;165023;438;0;0;0;0;.00nan;0;0
17680;184060;421;0;0;0;0;.00nan;0;0
17680;173954;438;88;43;2;41;.953;3590000;0
17682;173519;441;84;44;3;41;.932;3600000;0
17682;170499;427;0;0;0;0;.00nan;0;0
17682;179657;441;0;0;0;0;.00nan;0;0
17682;186468;427;65;22;2;20;.909;3600000;0
17684;183832;436;0;0;0;0;.00nan;0;0
17684;179071;420;90;31;1;30;.968;3170000;0
17684;186076;420;30;10;3;7;.700;430000;0
17684;191861;436;100;24;0;24;1.000;3600000;0
17686;189288;419;76;27;3;24;.889;3600000;0
17686;194854;417;66;41;5;36;.878;3538000;0
17686;178890;417;0;0;0;0;.00nan;0;0
17686;-1;419;0;0;0;0;.00nan;0;0
17688;184024;444;75;13;0;13;1.000;3600000;0
17688;170928;443;44;40;6;34;.850;3600000;0
17688;182180;443;0;0;0;0;.00nan;0;0
17688;191812;444;0;0;0;0;.00nan;0;0
17690;165023;438;45;31;5;26;.839;3586000;0
17690;173954;438;0;0;0;0;.00nan;0;0
17690;190157;442;0;0;0;0;.00nan;0;0
17690;181100;442;61;27;3;24;.889;3600000;0
17692;-1;428;77;24;1;23;.958;3600000;0
17692;174386;428;0;0;0;0;.00nan;0;0
17692;-1;412;0;0;0;0;.00nan;0;0
17692;-1;412;47;38;6;32;.842;3600000;0
17694;174420;439;88;20;0;20;1.000;3600000;0
17694;182210;439;0;0;0;0;.00nan;0;0
17694;182225;431;0;0;0;0;.00nan;0;0
17694;191171;431;49;35;5;30;.857;3600000;0
17696;-1;433;0;0;0;0;.00nan;0;0
17696;-1;426;0;0;0;0;.00nan;0;0
17696;-1;426;86;23;1;22;.957;3600000;0
17696;-1;433;68;23;2;21;.913;3586000;0
17698;178679;435;0;0;0;0;.00nan;0;0
17698;181346;414;53;18;2;16;.889;3593000;0
17698;187309;414;0;0;0;0;.00nan;0;0
17698;-1;435;100;52;0;52;1.000;3600000;0
17700;187689;421;60;18;1;17;.944;2583000;0
17700;184060;421;17;9;4;5;.556;1017000;0
17700;189783;440;0;0;0;0;.00nan;0;0
17700;175723;440;100;37;0;37;1.000;3600000;0
17702;173339;430;0;0;0;0;.00nan;0;0
17702;194598;418;0;0;0;0;.00nan;0;0
17702;170878;430;41;31;5;26;.839;3600000;0
17702;180965;418;87;29;2;27;.931;3600000;0
17704;188965;423;73;33;2;31;.939;3600000;0
17704;179143;423;0;0;0;0;.00nan;0;0
17704;190073;413;82;31;1;30;.968;3600000;0
17704;192627;413;0;0;0;0;.00nan;0;0
17706;163177;425;56;19;2;17;.895;3600000;0
17706;183885;449;0;0;0;0;.00nan;0;0
17706;-1;425;0;0;0;0;.00nan;0;0
17706;141530;449;71;40;4;36;.900;3550000;0
17708;171930;422;84;25;1;24;.960;3600000;0
17708;179127;422;0;0;0;0;.00nan;0;0
17708;179478;432;0;0;0;0;.00nan;0;0
17708;187412;432;74;43;4;39;.907;3600000;0
17710;184336;429;0;0;0;0;.00nan;0;0
17710;-1;429;90;29;1;28;.966;3600000;0
17710;186671;434;0;0;0;0;.00nan;0;0
17710;152650;434;59;30;3;27;.900;3577000;0
17712;177155;411;61;20;2;18;.900;2518000;0
17712;182475;437;60;25;3;22;.880;3600000;0
17712;184033;411;33;16;4;12;.750;1082000;0
17712;139865;437;0;0;0;0;.00nan;0;0
17714;171787;4849;0;0;0;0;.00nan;0;0
17714;179689;415;41;11;2;9;.818;1639000;0
17714;196412;4849;77;36;2;34;.944;3600000;0
17714;191877;415;10;15;6;9;.600;1961000;0
17716;182475;437;0;0;0;0;.00nan;0;0
17716;183885;449;63;24;2;22;.917;3600000;0
17716;139865;437;32;31;5;26;.839;3600000;0
17716;141530;449;0;0;0;0;.00nan;0;0
17718;183832;436;0;0;0;0;.00nan;0;0
17718;194598;418;0;0;0;0;.00nan;0;0
17718;180965;418;70;38;3;35;.921;3569000;0
17718;191861;436;66;22;2;20;.909;3600000;0
17720;165023;438;0;0;0;0;.00nan;0;0
17720;173954;438;86;33;2;31;.939;3600000;0
17720;181346;414;53;16;2;14;.875;1794000;0
17720;187309;414;37;22;4;18;.818;1806000;0
17722;187689;421;62;35;4;31;.886;3542000;0
17722;184024;444;54;22;3;19;.864;3600000;0
17722;184060;421;0;0;0;0;.00nan;0;0
17722;191812;444;0;0;0;0;.00nan;0;0
17724;171787;4849;0;0;0;0;.00nan;0;0
17724;194854;417;91;32;1;31;.969;3600000;0
17724;178890;417;0;0;0;0;.00nan;0;0
17724;196412;4849;50;28;4;24;.857;3600000;0
17726;163177;425;0;0;0;0;.00nan;0;0
17726;-1;425;88;19;0;19;1.000;3600000;0
17726;-1;412;60;26;2;24;.923;3527000;0
17726;-1;412;0;0;0;0;.00nan;0;0
17728;189783;440;0;0;0;0;.00nan;0;0
17728;175723;440;74;43;4;39;.907;3600000;0
17728;190157;442;78;23;1;22;.957;3600000;0
17728;181100;442;0;0;0;0;.00nan;0;0
17730;171930;422;90;26;0;26;1.000;2545000;0
17730;179127;422;21;12;4;8;.667;979000;0
17730;186671;434;60;22;2;20;.909;3600000;0
17730;152650;434;0;0;0;0;.00nan;0;0
17732;-1;428;0;0;0;0;.00nan;0;0
17732;173519;441;0;0;0;0;.00nan;0;0
17732;174386;428;56;28;3;25;.893;3600000;0
17732;179657;441;66;26;2;24;.923;3600000;0
17734;188965;423;0;0;0;0;.00nan;0;0
17734;179143;423;67;16;1;15;.938;3600000;0
17734;179478;432;60;23;2;21;.913;3582000;0
17734;187412;432;0;0;0;0;.00nan;0;0
17736;189288;419;64;24;2;22;.917;3517000;0
17736;-1;419;0;0;0;0;.00nan;0;0
17736;-1;426;83;18;0;18;1.000;3600000;0
17736;-1;426;0;0;0;0;.00nan;0;0
17738;170928;443;0;0;0;0;.00nan;0;0
17738;182180;443;96;33;1;32;.970;3600000;0
17738;182225;431;53;29;4;25;.862;3600000;0
17738;191171;431;0;0;0;0;.00nan;0;0
17740;177155;411;0;0;0;0;.00nan;0;0
17740;184033;411;71;28;2;26;.929;3563000;0
17740;174420;439;68;27;2;25;.926;3600000;0
17740;182210;439;0;0;0;0;.00nan;0;0
17742;170499;427;77;29;2;27;.931;3600000;0
17742;179689;415;50;25;3;22;.880;3576000;0
17742;186468;427;0;0;0;0;.00nan;0;0
17742;191877;415;0;0;0;0;.00nan;0;0
17744;194650;410;0;0;0;0;.00nan;0;0
17744;184183;410;70;33;2;31;.939;3600000;0
17744;190073;413;0;0;0;0;.00nan;0;0
17744;192627;413;69;31;3;28;.903;3545000;0
17746;184336;429;48;22;3;19;.864;3600000;0
17746;-1;429;0;0;0;0;.00nan;0;0
17746;-1;433;33;40;8;32;.800;3323000;0
17746;-1;433;53;3;0;3;1.000;277000;0
17748;173339;430;66;24;2;22;.917;3600000;0
17748;170878;430;0;0;0;0;.00nan;0;0
17748;179071;420;0;0;0;0;.00nan;0;0
17748;186076;420;54;38;5;33;.868;3600000;0
17749;7624;890;69;33;3;30;.909;3600000;0
17749;76885;897;39;17;4;13;.765;2314000;0
17749;147492;897;52;10;1;9;.900;1263000;0
17749;159705;890;0;0;0;0;.00nan;0;0
17750;4219;874;51;20;3;17;.850;3600000;0
17750;83678;874;0;0;0;0;.00nan;0;0
17750;146445;894;62;36;4;32;.889;3575000;0
17750;157416;894;0;0;0;0;.00nan;0;0
17751;190831;880;61;37;5;32;.865;3546000;0
17751;80596;3965;0;0;0;0;.00nan;0;0
17751;147164;880;0;0;0;0;.00nan;0;0
17751;149353;3965;66;28;4;24;.857;3600000;0
17752;183905;2571;66;60;6;54;.900;3600000;0
17752;196005;966;56;18;2;16;.889;3600000;0
17752;76329;2571;0;0;0;0;.00nan;0;0
17752;157295;966;0;0;0;0;.00nan;0;0
17753;57426;879;92;19;0;19;1.000;3600000;0
17753;82245;872;90;52;3;49;.942;3600000;0
17753;86283;879;0;0;0;0;.00nan;0;0
17753;157396;872;0;0;0;0;.00nan;0;0
17754;170042;891;83;40;3;37;.925;3600000;0
17754;196055;945;0;0;0;0;.00nan;0;0
17754;86686;891;0;0;0;0;.00nan;0;0
17754;146479;945;93;32;1;31;.969;3600000;0
17755;8519;978;41;38;6;32;.842;2384000;0
17755;201288;957;0;0;0;0;.00nan;0;0
17755;56306;978;83;14;0;14;1.000;1216000;0
17755;161128;957;77;16;1;15;.938;3600000;0
17756;8519;978;92;37;2;35;.946;3600000;0
17756;56306;978;0;0;0;0;.00nan;0;0
17756;76885;897;82;23;1;22;.957;3600000;0
17756;147492;897;0;0;0;0;.00nan;0;0
17757;4219;874;0;0;0;0;.00nan;0;0
17757;183905;2571;84;43;3;40;.930;3571000;0
17757;76329;2571;0;0;0;0;.00nan;0;0
17757;83678;874;58;21;2;19;.905;3600000;0
17758;196055;945;0;0;0;0;.00nan;0;0
17758;82245;872;67;25;2;23;.920;3542000;0
17758;146479;945;86;34;1;33;.971;3600000;0
17758;157396;872;0;0;0;0;.00nan;0;0
17759;196005;966;48;34;5;29;.853;3600000;0
17759;190831;880;72;28;2;26;.929;3600000;0
17759;147164;880;0;0;0;0;.00nan;0;0
17759;157295;966;0;0;0;0;.00nan;0;0
17760;80596;3965;0;0;0;0;.00nan;0;0
17760;146445;894;38;35;6;29;.829;2573000;0
17760;149353;3965;63;18;2;16;.889;3600000;0
17760;157416;894;71;13;0;13;1.000;1027000;0
17761;7624;890;28;28;6;22;.786;1716000;0
17761;57426;879;0;0;0;0;.00nan;0;0
17761;86283;879;68;16;1;15;.938;3600000;0
17761;159705;890;68;15;1;14;.933;1884000;0
17762;170042;891;65;38;3;35;.921;3900000;0
17762;201288;957;0;0;0;0;.00nan;0;0
17762;86686;891;0;0;0;0;.00nan;0;0
17762;161128;957;58;25;3;22;.880;3900000;0
17763;4219;874;0;0;0;0;.00nan;0;0
17763;82245;872;0;0;0;0;.00nan;0;0
17763;83678;874;82;35;3;32;.914;3900000;0
17763;157396;872;92;42;3;39;.929;3900000;0
17764;7624;890;0;0;0;0;.00nan;0;0
17764;190831;880;0;0;0;0;.00nan;0;0
17764;147164;880;53;30;4;26;.867;3600000;0
17764;159705;890;34;26;5;21;.808;3557000;0
17765;8519;978;0;0;0;0;.00nan;0;0
17765;170042;891;76;25;2;23;.920;3600000;0
17765;56306;978;69;35;4;31;.886;3540000;0
17765;86686;891;0;0;0;0;.00nan;0;0
17766;196005;966;81;17;0;17;1.000;3600000;0
17766;146445;894;38;27;5;22;.815;3600000;0
17766;157295;966;0;0;0;0;.00nan;0;0
17766;157416;894;0;0;0;0;.00nan;0;0
17767;57426;879;0;0;0;0;.00nan;0;0
17767;80596;3965;0;0;0;0;.00nan;0;0
17767;86283;879;74;25;1;24;.960;3600000;0
17767;149353;3965;80;34;2;32;.941;3564000;0
17768;183905;2571;81;49;4;45;.918;3600000;0
17768;201288;957;71;10;0;10;1.000;3600000;0
17768;76329;2571;0;0;0;0;.00nan;0;0
17768;161128;957;0;0;0;0;.00nan;0;0
17769;196055;945;0;0;0;0;.00nan;0;0
17769;76885;897;66;17;1;16;.941;3600000;0
17769;146479;945;66;40;5;35;.875;3600000;0
17769;147492;897;0;0;0;0;.00nan;0;0
17770;8519;978;48;25;4;21;.840;2068000;0
17770;170042;891;99;24;0;24;1.000;3600000;0
17770;56306;978;31;18;4;14;.778;1532000;0
17770;86686;891;0;0;0;0;.00nan;0;0
17771;196005;966;82;23;1;22;.957;3600000;0
17771;146445;894;69;33;3;30;.909;3600000;0
17771;157295;966;0;0;0;0;.00nan;0;0
17771;157416;894;0;0;0;0;.00nan;0;0
17772;170042;891;79;34;3;31;.912;3600000;0
17772;86686;891;0;0;0;0;.00nan;0;0
17772;146445;894;58;32;4;28;.875;3561000;0
17772;157416;894;0;0;0;0;.00nan;0;0
17773;80596;3965;0;0;0;0;.00nan;0;0
17773;82245;872;68;23;2;21;.913;3600000;0
17773;149353;3965;81;36;3;33;.917;3583000;0
17773;157396;872;0;0;0;0;.00nan;0;0
17774;201288;957;0;0;0;0;.00nan;0;0
17774;190831;880;94;49;2;47;.959;3600000;0
17774;147164;880;0;0;0;0;.00nan;0;0
17774;161128;957;38;17;3;14;.824;3600000;0
17775;4219;874;0;0;0;0;.00nan;0;0
17775;196055;945;0;0;0;0;.00nan;0;0
17775;83678;874;57;31;4;27;.871;3600000;0
17775;146479;945;50;46;7;39;.848;3600000;0
17776;196005;966;57;34;5;29;.853;3585000;0
17776;76885;897;63;26;3;23;.885;3600000;0
17776;147492;897;0;0;0;0;.00nan;0;0
17776;157295;966;0;0;0;0;.00nan;0;0
17777;8519;978;83;35;2;33;.943;3600000;0
17777;56306;978;0;0;0;0;.00nan;0;0
17777;57426;879;0;0;0;0;.00nan;0;0
17777;86283;879;56;27;3;24;.889;3600000;0
17778;183905;2571;55;37;4;33;.892;3600000;0
17778;76329;2571;0;0;0;0;.00nan;0;0
17778;76885;897;83;14;0;14;1.000;3600000;0
17778;147492;897;0;0;0;0;.00nan;0;0
17779;4219;874;59;26;3;23;.885;3529000;0
17779;196005;966;95;33;1;32;.970;3600000;0
17779;83678;874;0;0;0;0;.00nan;0;0
17779;157295;966;0;0;0;0;.00nan;0;0
17780;8519;978;0;0;0;0;.00nan;0;0
17780;56306;978;94;48;2;46;.958;3549000;0
17780;82245;872;69;21;1;20;.952;3600000;0
17780;157396;872;0;0;0;0;.00nan;0;0
17781;190831;880;0;0;0;0;.00nan;0;0
17781;57426;879;48;18;3;15;.833;3545000;0
17781;86283;879;0;0;0;0;.00nan;0;0
17781;147164;880;82;35;2;33;.943;3600000;0
17782;201288;957;60;16;1;15;.938;3600000;0
17782;146445;894;0;0;0;0;.00nan;0;0
17782;157416;894;83;48;4;44;.917;3600000;0
17782;161128;957;0;0;0;0;.00nan;0;0
17783;196055;945;0;0;0;0;.00nan;0;0
17783;80596;3965;85;36;2;34;.944;3600000;0
17783;146479;945;59;26;3;23;.885;3600000;0
17783;149353;3965;0;0;0;0;.00nan;0;0
17784;7624;890;73;33;2;31;.939;3600000;0
17784;170042;891;68;36;4;32;.889;3532000;0
17784;86686;891;0;0;0;0;.00nan;0;0
17784;159705;890;0;0;0;0;.00nan;0;0
17785;196005;966;87;36;1;35;.972;3600000;0
17785;80596;3965;0;0;0;0;.00nan;0;0
17785;149353;3965;69;33;3;30;.909;3568000;0
17785;157295;966;0;0;0;0;.00nan;0;0
17786;76885;897;90;28;1;27;.964;3600000;0
17786;82245;872;0;0;0;0;.00nan;0;0
17786;147492;897;0;0;0;0;.00nan;0;0
17786;157396;872;81;29;2;27;.931;3549000;0
17787;4219;874;0;0;0;0;.00nan;0;0
17787;7624;890;59;19;2;17;.895;3565000;0
17787;83678;874;93;27;1;26;.963;3600000;0
17787;159705;890;0;0;0;0;.00nan;0;0
17788;201288;957;0;0;0;0;.00nan;0;0
17788;57426;879;0;0;0;0;.00nan;0;0
17788;86283;879;67;33;3;30;.909;3600000;0
17788;161128;957;95;18;0;18;1.000;3600000;0
17789;196055;945;91;37;1;36;.973;3600000;0
17789;146445;894;68;31;3;28;.903;3575000;0
17789;146479;945;0;0;0;0;.00nan;0;0
17789;157416;894;0;0;0;0;.00nan;0;0
17790;8519;978;85;18;0;18;1.000;3600000;0
17790;183905;2571;96;51;3;48;.941;3600000;0
17790;56306;978;0;0;0;0;.00nan;0;0
17790;76329;2571;0;0;0;0;.00nan;0;0
17791;170042;891;29;19;5;14;.737;3556000;0
17791;190831;880;58;21;3;18;.857;3600000;0
17791;86686;891;0;0;0;0;.00nan;0;0
17791;147164;880;0;0;0;0;.00nan;0;0
17792;4219;874;58;15;1;14;.933;3600000;0
17792;170042;891;81;42;3;39;.929;3584000;0
17792;83678;874;0;0;0;0;.00nan;0;0
17792;86686;891;0;0;0;0;.00nan;0;0
17793;8519;978;71;25;1;24;.960;3900000;0
17793;196055;945;0;0;0;0;.00nan;0;0
17793;56306;978;0;0;0;0;.00nan;0;0
17793;146479;945;90;35;1;34;.971;3900000;0
17794;190831;880;0;0;0;0;.00nan;0;0
17794;82245;872;66;23;2;21;.913;3900000;0
17794;147164;880;75;35;2;33;.943;3900000;0
17794;157396;872;0;0;0;0;.00nan;0;0
17795;7624;890;58;19;2;17;.895;3570000;0
17795;196005;966;93;30;1;29;.967;3600000;0
17795;157295;966;0;0;0;0;.00nan;0;0
17795;159705;890;0;0;0;0;.00nan;0;0
17796;183905;2571;100;42;1;41;.976;3600000;0
17796;76329;2571;0;0;0;0;.00nan;0;0
17796;146445;894;84;25;2;23;.920;3600000;0
17796;157416;894;0;0;0;0;.00nan;0;0
17797;57426;879;75;24;2;22;.917;3600000;0
17797;76885;897;46;40;7;33;.825;3600000;0
17797;86283;879;0;0;0;0;.00nan;0;0
17797;147492;897;0;0;0;0;.00nan;0;0
17798;201288;957;0;0;0;0;.00nan;0;0
17798;80596;3965;84;36;2;34;.944;3600000;0
17798;149353;3965;0;0;0;0;.00nan;0;0
17798;161128;957;52;22;3;19;.864;3571000;0
17799;7624;890;0;0;0;0;.00nan;0;0
17799;183905;2571;50;40;5;35;.875;3526000;0
17799;76329;2571;0;0;0;0;.00nan;0;0
17799;159705;890;65;29;3;26;.897;3600000;0
17800;4219;874;0;0;0;0;.00nan;0;0
17800;76885;897;68;36;4;32;.889;3600000;0
17800;83678;874;81;25;2;23;.920;3600000;0
17800;147492;897;0;0;0;0;.00nan;0;0
17801;7624;890;70;21;1;20;.952;3600000;0
17801;201288;957;0;0;0;0;.00nan;0;0
17801;159705;890;0;0;0;0;.00nan;0;0
17801;161128;957;53;25;3;22;.880;3535000;0
17802;8519;978;100;45;1;44;.978;3600000;0
17802;196005;966;68;25;2;23;.920;3600000;0
17802;56306;978;0;0;0;0;.00nan;0;0
17802;157295;966;0;0;0;0;.00nan;0;0
17803;196055;945;0;0;0;0;.00nan;0;0
17803;190831;880;57;24;3;21;.875;3707000;0
17803;146479;945;66;34;4;30;.882;3707000;0
17803;147164;880;0;0;0;0;.00nan;0;0
17804;82245;872;57;18;2;16;.889;3600000;0
17804;146445;894;66;34;4;30;.882;3571000;0
17804;157396;872;0;0;0;0;.00nan;0;0
17804;157416;894;0;0;0;0;.00nan;0;0
17805;183905;2571;38;49;9;40;.816;3600000;0
17805;76329;2571;0;0;0;0;.00nan;0;0
17805;80596;3965;0;0;0;0;.00nan;0;0
17805;149353;3965;52;10;1;9;.900;3600000;0
17806;170042;891;51;30;4;26;.867;3579000;0
17806;57426;879;0;0;0;0;.00nan;0;0
17806;86283;879;74;33;3;30;.909;3600000;0
17806;86686;891;0;0;0;0;.00nan;0;0
17807;190831;880;0;0;0;0;.00nan;0;0
17807;76885;897;91;30;1;29;.967;3600000;0
17807;147164;880;61;31;3;28;.903;3541000;0
17807;147492;897;0;0;0;0;.00nan;0;0
17808;196005;966;42;34;5;29;.853;3600000;0
17808;82245;872;0;0;0;0;.00nan;0;0
17808;157295;966;0;0;0;0;.00nan;0;0
17808;157396;872;99;26;0;26;1.000;3600000;0
17809;4219;874;63;23;2;21;.913;3600000;0
17809;8519;978;59;37;5;32;.865;3600000;0
17809;56306;978;0;0;0;0;.00nan;0;0
17809;83678;874;0;0;0;0;.00nan;0;0
17810;7624;890;70;23;1;22;.957;3549000;0
17810;146445;894;100;40;0;40;1.000;3600000;0
17810;157416;894;0;0;0;0;.00nan;0;0
17810;159705;890;0;0;0;0;.00nan;0;0
17811;14266;879;62;9;1;8;.889;3600000;0
17811;183905;2571;83;50;5;45;.900;3600000;0
17811;76329;2571;0;0;0;0;.00nan;0;0
17811;86283;879;0;0;0;0;.00nan;0;0
17812;170042;891;0;0;0;0;.00nan;0;0
17812;80596;3965;60;45;6;39;.867;3600000;0
17812;86686;891;51;22;3;19;.864;3600000;0
17812;149353;3965;0;0;0;0;.00nan;0;0
17813;201288;957;0;0;0;0;.00nan;0;0
17813;196055;945;0;0;0;0;.00nan;0;0
17813;146479;945;99;42;1;41;.976;3600000;0
17813;161128;957;52;24;3;21;.875;3515000;0
17814;183905;2571;89;34;1;33;.971;3562000;0
17814;190831;880;88;18;0;18;1.000;3600000;0
17814;76329;2571;0;0;0;0;.00nan;0;0
17814;147164;880;0;0;0;0;.00nan;0;0
17815;183905;2571;0;0;0;0;.00nan;0;0
17815;190831;880;63;17;1;16;.941;3600000;0
17815;76329;2571;58;41;5;36;.878;3600000;0
17815;147164;880;0;0;0;0;.00nan;0;0
17816;170042;891;95;22;0;22;1.000;3600000;0
17816;82245;872;0;0;0;0;.00nan;0;0
17816;86686;891;0;0;0;0;.00nan;0;0
17816;157396;872;85;27;2;25;.926;3514000;0
17817;4219;874;0;0;0;0;.00nan;0;0
17817;80596;3965;0;0;0;0;.00nan;0;0
17817;83678;874;83;42;4;38;.905;3557000;0
17817;149353;3965;76;28;2;26;.929;3600000;0
17818;201288;957;89;32;2;30;.938;3600000;0
17818;76885;897;72;40;4;36;.900;3522000;0
17818;147492;897;0;0;0;0;.00nan;0;0
17818;161128;957;0;0;0;0;.00nan;0;0
17819;8519;978;80;33;3;30;.909;3900000;0
17819;56306;978;0;0;0;0;.00nan;0;0
17819;146445;894;60;22;3;19;.864;3900000;0
17819;157416;894;0;0;0;0;.00nan;0;0
17820;7624;890;92;28;1;27;.964;3600000;0
17820;196055;945;59;21;2;19;.905;3578000;0
17820;146479;945;0;0;0;0;.00nan;0;0
17820;159705;890;0;0;0;0;.00nan;0;0
17821;14266;879;57;10;1;9;.900;3600000;0
17821;196005;966;97;53;3;50;.943;3600000;0
17821;86283;879;0;0;0;0;.00nan;0;0
17821;157295;966;0;0;0;0;.00nan;0;0
17822;76885;897;66;33;3;30;.909;3576000;0
17822;80596;3965;0;0;0;0;.00nan;0;0
17822;147492;897;0;0;0;0;.00nan;0;0
17822;149353;3965;78;35;2;33;.943;3600000;0
17823;201288;957;0;0;0;0;.00nan;0;0
17823;82245;872;73;43;3;40;.930;3600000;0
17823;157396;872;0;0;0;0;.00nan;0;0
17823;161128;957;85;25;1;24;.960;3600000;0
17824;183905;2571;79;41;4;37;.902;3600000;0
17824;196055;945;0;0;0;0;.00nan;0;0
17824;76329;2571;0;0;0;0;.00nan;0;0
17824;146479;945;65;21;2;19;.905;3600000;0
17825;4219;874;58;23;3;20;.870;3589000;0
17825;14266;879;84;32;2;30;.938;3600000;0
17825;83678;874;0;0;0;0;.00nan;0;0
17825;86283;879;0;0;0;0;.00nan;0;0
17826;170042;891;93;21;0;21;1.000;3600000;0
17826;196005;966;66;29;2;27;.931;3562000;0
17826;86686;891;0;0;0;0;.00nan;0;0
17826;157295;966;0;0;0;0;.00nan;0;0
17827;7624;890;0;0;0;0;.00nan;0;0
17827;8519;978;89;29;1;28;.966;3600000;0
17827;56306;978;0;0;0;0;.00nan;0;0
17827;159705;890;76;32;2;30;.938;3585000;0
17828;190831;880;100;29;0;29;1.000;3600000;0
17828;146445;894;0;0;0;0;.00nan;0;0
17828;147164;880;0;0;0;0;.00nan;0;0
17828;157416;894;70;32;2;30;.938;3554000;0
17829;170042;891;62;36;4;32;.889;3600000;0
17829;76885;897;79;27;1;26;.963;3600000;0
17829;86686;891;0;0;0;0;.00nan;0;0
17829;147492;897;0;0;0;0;.00nan;0;0
17830;183905;2571;70;28;3;25;.893;3705000;0
17830;76329;2571;0;0;0;0;.00nan;0;0
17830;82245;872;45;23;4;19;.826;3705000;0
17830;157396;872;0;0;0;0;.00nan;0;0
17831;4219;874;46;12;2;10;.833;1147000;0
17831;201288;957;0;0;0;0;.00nan;0;0
17831;83678;874;37;23;5;18;.783;2367000;0
17831;161128;957;52;33;5;28;.848;3600000;0
17832;8519;978;82;31;2;29;.935;3600000;0
17832;190831;880;77;32;3;29;.906;3549000;0
17832;56306;978;0;0;0;0;.00nan;0;0
17832;147164;880;0;0;0;0;.00nan;0;0
17833;196005;966;63;25;2;23;.920;3600000;0
17833;196055;945;0;0;0;0;.00nan;0;0
17833;146479;945;60;31;4;27;.871;3586000;0
17833;157295;966;0;0;0;0;.00nan;0;0
17834;7624;890;74;49;5;44;.898;3600000;0
17834;80596;3965;0;0;0;0;.00nan;0;0
17834;149353;3965;65;26;2;24;.923;3600000;0
17834;159705;890;0;0;0;0;.00nan;0;0
17835;14266;879;94;23;0;23;1.000;3600000;0
17835;86283;879;0;0;0;0;.00nan;0;0
17835;146445;894;59;52;6;46;.885;3600000;0
17835;157416;894;0;0;0;0;.00nan;0;0
17836;7624;890;90;30;1;29;.967;3600000;0
17836;82245;872;0;0;0;0;.00nan;0;0
17836;157396;872;60;20;2;18;.900;3544000;0
17836;159705;890;0;0;0;0;.00nan;0;0
17837;201288;957;60;18;2;16;.889;3600000;0
17837;196005;966;73;40;3;37;.925;3600000;0
17837;157295;966;0;0;0;0;.00nan;0;0
17837;161128;957;0;0;0;0;.00nan;0;0
17838;8519;978;0;0;0;0;.00nan;0;0
17838;56306;978;72;22;2;20;.909;3572000;0
17838;80596;3965;0;0;0;0;.00nan;0;0
17838;149353;3965;100;30;0;30;1.000;3600000;0
17839;14266;879;43;22;4;18;.818;3554000;0
17839;196055;945;74;37;3;34;.919;3600000;0
17839;86283;879;0;0;0;0;.00nan;0;0
17839;146479;945;0;0;0;0;.00nan;0;0
17840;4219;874;69;37;5;32;.865;3600000;0
17840;190831;880;0;0;0;0;.00nan;0;0
17840;83678;874;0;0;0;0;.00nan;0;0
17840;147164;880;81;29;1;28;.966;3600000;0
17841;76885;897;33;16;4;12;.750;3552000;0
17841;146445;894;100;40;2;38;.950;3600000;0
17841;147492;897;0;0;0;0;.00nan;0;0
17841;157416;894;0;0;0;0;.00nan;0;0
17842;183905;2571;100;39;0;39;1.000;3600000;0
17842;170042;891;68;21;1;20;.952;3570000;0
17842;76329;2571;0;0;0;0;.00nan;0;0
17842;86686;891;0;0;0;0;.00nan;0;0
17843;7624;890;0;0;0;0;.00nan;0;0
17843;190831;880;77;27;2;25;.926;3900000;0
17843;147164;880;0;0;0;0;.00nan;0;0
17843;159705;890;66;31;2;29;.935;3900000;0
17844;14266;879;70;20;1;19;.950;3600000;0
17844;76885;897;0;0;0;0;.00nan;0;0
17844;86283;879;0;0;0;0;.00nan;0;0
17844;147492;897;98;40;2;38;.950;3543000;0
17845;4219;874;0;0;0;0;.00nan;0;0
17845;183905;2571;94;45;2;43;.956;3585000;0
17845;76329;2571;0;0;0;0;.00nan;0;0
17845;83678;874;83;13;0;13;1.000;3600000;0
17846;170042;891;69;29;2;27;.931;3572000;0
17846;196055;945;0;0;0;0;.00nan;0;0
17846;86686;891;0;0;0;0;.00nan;0;0
17846;146479;945;87;19;0;19;1.000;3600000;0
17847;8519;978;64;23;2;21;.913;3563000;0
17847;196005;966;92;28;1;27;.964;3600000;0
17847;56306;978;0;0;0;0;.00nan;0;0
17847;157295;966;0;0;0;0;.00nan;0;0
17848;80596;3965;0;0;0;0;.00nan;0;0
17848;146445;894;78;36;2;34;.944;3900000;0
17848;149353;3965;81;33;2;31;.939;3900000;0
17848;157416;894;0;0;0;0;.00nan;0;0
17849;183905;2571;70;45;4;41;.911;3600000;0
17849;201288;957;77;11;0;11;1.000;3600000;0
17849;76329;2571;0;0;0;0;.00nan;0;0
17849;161128;957;0;0;0;0;.00nan;0;0
17850;8519;978;93;30;2;28;.933;3900000;0
17850;170042;891;73;23;2;21;.913;3900000;0
17850;56306;978;0;0;0;0;.00nan;0;0
17850;86686;891;0;0;0;0;.00nan;0;0
17851;76885;897;42;18;3;15;.833;3900000;0
17851;82245;872;0;0;0;0;.00nan;0;0
17851;147492;897;0;0;0;0;.00nan;0;0
17851;157396;872;57;26;3;23;.885;3900000;0
17852;4219;874;0;0;0;0;.00nan;0;0
17852;14266;879;53;24;4;20;.833;3568000;0
17852;83678;874;78;29;2;27;.931;3600000;0
17852;86283;879;0;0;0;0;.00nan;0;0
17853;4219;874;68;28;3;25;.893;3525000;0
17853;190831;880;76;28;1;27;.964;3600000;0
17853;83678;874;0;0;0;0;.00nan;0;0
17853;147164;880;0;0;0;0;.00nan;0;0
17854;7624;890;73;38;3;35;.921;3600000;0
17854;183905;2571;33;31;6;25;.806;3600000;0
17854;76329;2571;0;0;0;0;.00nan;0;0
17854;159705;890;0;0;0;0;.00nan;0;0
17855;8519;978;96;45;1;44;.978;3900000;0
17855;201288;957;55;15;1;14;.933;3900000;0
17855;56306;978;0;0;0;0;.00nan;0;0
17855;161128;957;0;0;0;0;.00nan;0;0
17856;196005;966;53;26;4;22;.846;3600000;0
17856;146445;894;99;40;1;39;.975;3600000;0
17856;157295;966;0;0;0;0;.00nan;0;0
17856;157416;894;0;0;0;0;.00nan;0;0
17857;170042;891;67;43;5;38;.884;3600000;0
17857;80596;3965;54;24;4;20;.833;3600000;0
17857;86686;891;0;0;0;0;.00nan;0;0
17857;149353;3965;0;0;0;0;.00nan;0;0
17858;5354;879;0;0;0;0;.00nan;0;0
17858;196055;945;81;37;3;34;.919;3145000;0
17858;86283;879;88;25;1;24;.960;3600000;0
17858;146479;945;37;13;3;10;.769;455000;0
17859;14266;879;88;25;1;24;.960;3584000;0
17859;82245;872;97;29;0;29;1.000;3600000;0
17859;86283;879;0;0;0;0;.00nan;0;0
17859;157396;872;0;0;0;0;.00nan;0;0
17860;196055;945;0;0;0;0;.00nan;0;0
17860;76885;897;69;19;1;18;.947;3600000;0
17860;146479;945;63;40;4;36;.900;3600000;0
17860;147492;897;0;0;0;0;.00nan;0;0
17861;8519;978;69;25;3;22;.880;3600000;0
17861;190831;880;23;16;5;11;.688;3319000;0
17861;56306;978;0;0;0;0;.00nan;0;0
17861;147164;880;49;1;0;1;1.000;204000;0
17862;4219;874;0;0;0;0;.00nan;0;0
17862;196005;966;100;37;1;36;.973;3600000;0
17862;83678;874;54;16;2;14;.875;3572000;0
17862;157295;966;0;0;0;0;.00nan;0;0
17863;183905;2571;98;55;3;52;.945;3600000;0
17863;76329;2571;0;0;0;0;.00nan;0;0
17863;80596;3965;0;0;0;0;.00nan;0;0
17863;149353;3965;100;34;0;34;1.000;3600000;0
17864;7624;890;41;34;5;29;.853;3600000;0
17864;170042;891;0;0;0;0;.00nan;0;0
17864;86686;891;77;28;1;27;.964;3600000;0
17864;159705;890;0;0;0;0;.00nan;0;0
17865;183905;2571;53;39;5;34;.872;3600000;0
17865;76329;2571;0;0;0;0;.00nan;0;0
17865;80596;3965;0;0;0;0;.00nan;0;0
17865;149353;3965;74;27;2;25;.926;3600000;0
17866;4219;874;62;36;4;32;.889;3682000;0
17866;8519;978;0;0;0;0;.00nan;0;0
17866;56306;978;82;35;3;32;.914;3682000;0
17866;83678;874;0;0;0;0;.00nan;0;0
17867;170042;891;74;40;4;36;.900;3600000;0
17867;86686;891;0;0;0;0;.00nan;0;0
17867;146445;894;44;29;5;24;.828;3586000;0
17867;157416;894;0;0;0;0;.00nan;0;0
17868;196055;945;0;0;0;0;.00nan;0;0
17868;82245;872;68;25;2;23;.920;3900000;0
17868;146479;945;97;39;2;37;.949;3900000;0
17868;157396;872;0;0;0;0;.00nan;0;0
17869;7624;890;0;0;0;0;.00nan;0;0
17869;80596;3965;0;0;0;0;.00nan;0;0
17869;149353;3965;70;37;4;33;.892;3572000;0
17869;159705;890;83;36;2;34;.944;3600000;0
17870;4219;874;0;0;0;0;.00nan;0;0
17870;201288;957;67;25;2;23;.920;3732000;0
17870;83678;874;65;31;3;28;.903;3732000;0
17870;161128;957;0;0;0;0;.00nan;0;0
17871;8519;978;61;27;4;23;.852;3544000;0
17871;56306;978;0;0;0;0;.00nan;0;0
17871;76885;897;73;28;2;26;.929;3600000;0
17871;147492;897;0;0;0;0;.00nan;0;0
17872;183905;2571;25;29;6;23;.793;2805000;0
17872;196005;966;75;21;1;20;.952;3600000;0
17872;76329;2571;45;7;1;6;.857;795000;0
17872;157295;966;0;0;0;0;.00nan;0;0
17873;14266;879;75;29;2;27;.931;3900000;0
17873;190831;880;73;35;2;33;.943;3900000;0
17873;86283;879;0;0;0;0;.00nan;0;0
17873;147164;880;0;0;0;0;.00nan;0;0
17874;201288;957;0;0;0;0;.00nan;0;0
17874;80596;3965;81;38;2;36;.947;3600000;0
17874;149353;3965;0;0;0;0;.00nan;0;0
17874;161128;957;64;27;3;24;.889;3545000;0
17875;4219;874;76;34;3;31;.912;3600000;0
17875;82245;872;86;34;2;32;.941;3600000;0
17875;83678;874;0;0;0;0;.00nan;0;0
17875;157396;872;0;0;0;0;.00nan;0;0
17876;8519;978;88;47;4;43;.915;3600000;0
17876;14266;879;61;19;2;17;.895;3600000;0
17876;56306;978;0;0;0;0;.00nan;0;0
17876;86283;879;0;0;0;0;.00nan;0;0
17877;183905;2571;80;46;4;42;.913;3634000;0
17877;196055;945;0;0;0;0;.00nan;0;0
17877;76329;2571;0;0;0;0;.00nan;0;0
17877;146479;945;63;26;3;23;.885;3634000;0
17878;190831;880;90;32;1;31;.969;3600000;0
17878;146445;894;43;30;5;25;.833;3600000;0
17878;147164;880;0;0;0;0;.00nan;0;0
17878;157416;894;0;0;0;0;.00nan;0;0
17879;170042;891;43;31;6;25;.806;3631000;0
17879;196005;966;43;28;5;23;.821;3604000;0
17879;86686;891;0;0;0;0;.00nan;0;0
17879;157295;966;0;0;0;0;.00nan;0;0
17880;7624;890;66;32;3;29;.906;3563000;0
17880;76885;897;79;30;2;28;.933;3600000;0
17880;147492;897;0;0;0;0;.00nan;0;0
17880;159705;890;0;0;0;0;.00nan;0;0
17881;4219;874;0;0;0;0;.00nan;0;0
17881;83678;874;77;23;1;22;.957;3600000;0
17881;146445;894;0;0;0;0;.00nan;0;0
17881;157416;894;74;33;3;30;.909;3537000;0
17882;14266;879;0;0;0;0;.00nan;0;0
17882;80596;3965;0;0;0;0;.00nan;0;0
17882;86283;879;78;16;0;16;1.000;3600000;0
17882;149353;3965;96;52;2;50;.962;3556000;0
17883;190831;880;71;39;3;36;.923;3565000;0
17883;82245;872;0;0;0;0;.00nan;0;0
17883;147164;880;0;0;0;0;.00nan;0;0
17883;157396;872;75;23;1;22;.957;3600000;0
17884;7624;890;0;0;0;0;.00nan;0;0
17884;196005;966;79;26;2;24;.923;3600000;0
17884;157295;966;0;0;0;0;.00nan;0;0
17884;159705;890;48;29;4;25;.862;3525000;0
17885;201288;957;57;20;2;18;.900;3517000;0
17885;196055;945;0;0;0;0;.00nan;0;0
17885;146479;945;100;32;0;32;1.000;3600000;0
17885;161128;957;0;0;0;0;.00nan;0;0
17886;183905;2571;32;37;6;31;.838;2772000;0
17886;76329;2571;47;8;1;7;.875;828000;0
17886;76885;897;48;13;2;11;.846;3600000;0
17886;147492;897;0;0;0;0;.00nan;0;0
17887;4219;874;72;19;1;18;.947;3600000;0
17887;196055;945;0;0;0;0;.00nan;0;0
17887;83678;874;0;0;0;0;.00nan;0;0
17887;146479;945;66;31;4;27;.871;3600000;0
17888;7624;890;68;36;4;32;.889;3540000;0
17888;8519;978;60;23;2;21;.913;3600000;0
17888;56306;978;0;0;0;0;.00nan;0;0
17888;159705;890;0;0;0;0;.00nan;0;0
17889;190831;880;41;31;5;26;.839;3600000;0
17889;76885;897;51;14;2;12;.857;3600000;0
17889;147164;880;0;0;0;0;.00nan;0;0
17889;147492;897;0;0;0;0;.00nan;0;0
17890;196005;966;52;30;4;26;.867;3600000;0
17890;80596;3965;0;0;0;0;.00nan;0;0
17890;149353;3965;78;24;1;23;.958;3600000;0
17890;157295;966;0;0;0;0;.00nan;0;0
17891;14266;879;0;0;0;0;.00nan;0;0
17891;86283;879;57;21;3;18;.857;3600000;0
17891;146445;894;87;46;4;42;.913;3577000;0
17891;157416;894;0;0;0;0;.00nan;0;0
17892;170042;891;90;44;3;41;.932;3600000;0
17892;82245;872;86;13;0;13;1.000;3600000;0
17892;86686;891;0;0;0;0;.00nan;0;0
17892;157396;872;0;0;0;0;.00nan;0;0
17893;196005;966;87;40;2;38;.950;3600000;0
17893;76885;897;45;18;3;15;.833;3543000;0
17893;147492;897;0;0;0;0;.00nan;0;0
17893;157295;966;0;0;0;0;.00nan;0;0
17894;8519;978;84;24;1;23;.958;3900000;0
17894;56306;978;0;0;0;0;.00nan;0;0
17894;82245;872;68;22;1;21;.955;3900000;0
17894;157396;872;0;0;0;0;.00nan;0;0
17895;7624;890;0;0;0;0;.00nan;0;0
17895;146445;894;18;8;4;4;.500;501000;0
17895;157416;894;63;18;1;17;.944;3045000;0
17895;159705;890;47;24;4;20;.833;3600000;0
17896;196055;945;37;34;5;29;.853;3600000;0
17896;190831;880;74;30;2;28;.933;3600000;0
17896;146479;945;0;0;0;0;.00nan;0;0
17896;147164;880;0;0;0;0;.00nan;0;0
17897;183905;2571;97;56;3;53;.946;3600000;0
17897;170042;891;66;17;1;16;.941;3600000;0
17897;76329;2571;0;0;0;0;.00nan;0;0
17897;86686;891;0;0;0;0;.00nan;0;0
17898;14266;879;29;32;6;26;.813;3564000;0
17898;201288;957;48;26;4;22;.846;3600000;0
17898;86283;879;0;0;0;0;.00nan;0;0
17898;161128;957;0;0;0;0;.00nan;0;0
17899;4219;874;0;0;0;0;.00nan;0;0
17899;80596;3965;89;35;2;33;.943;3587000;0
17899;83678;874;86;25;1;24;.960;3600000;0
17899;149353;3965;0;0;0;0;.00nan;0;0
17900;201288;957;0;0;0;0;.00nan;0;0
17900;82245;872;76;36;3;33;.917;3600000;0
17900;157396;872;0;0;0;0;.00nan;0;0
17900;161128;957;72;8;0;8;1.000;3600000;0
17901;76885;897;72;22;1;21;.955;3600000;0
17901;80596;3965;0;0;0;0;.00nan;0;0
17901;147492;897;0;0;0;0;.00nan;0;0
17901;149353;3965;91;45;3;42;.933;3512000;0
17902;7624;890;59;43;5;38;.884;3600000;0
17902;14266;879;0;0;0;0;.00nan;0;0
17902;86283;879;71;19;1;18;.947;3600000;0
17902;159705;890;0;0;0;0;.00nan;0;0
17903;8519;978;0;0;0;0;.00nan;0;0
17903;196055;945;0;0;0;0;.00nan;0;0
17903;56306;978;72;21;1;20;.952;3600000;0
17903;146479;945;55;27;4;23;.852;3600000;0
17904;201288;957;0;0;0;0;.00nan;0;0
17904;190831;880;0;0;0;0;.00nan;0;0
17904;147164;880;87;37;2;35;.946;3586000;0
17904;161128;957;68;17;1;16;.941;3600000;0
17905;196005;966;100;32;1;31;.969;3600000;0
17905;82245;872;73;24;2;22;.917;3569000;0
17905;157295;966;0;0;0;0;.00nan;0;0
17905;157396;872;0;0;0;0;.00nan;0;0
17906;183905;2571;99;42;2;40;.952;3600000;0
17906;76329;2571;0;0;0;0;.00nan;0;0
17906;146445;894;50;30;5;25;.833;3600000;0
17906;157416;894;0;0;0;0;.00nan;0;0
17907;4219;874;0;0;0;0;.00nan;0;0
17907;170042;891;0;0;0;0;.00nan;0;0
17907;83678;874;95;26;0;26;1.000;3600000;0
17907;86686;891;68;30;3;27;.900;3600000;0
17908;76885;897;84;32;2;30;.938;3900000;0
17908;82245;872;0;0;0;0;.00nan;0;0
17908;147492;897;0;0;0;0;.00nan;0;0
17908;157396;872;54;18;2;16;.889;3900000;0
17909;4219;874;0;0;0;0;.00nan;0;0
17909;7624;890;71;32;3;29;.906;3600000;0
17909;83678;874;100;24;0;24;1.000;3600000;0
17909;159705;890;0;0;0;0;.00nan;0;0
17910;170042;891;39;42;7;35;.833;3600000;0
17910;201288;957;79;36;2;34;.944;3600000;0
17910;86686;891;0;0;0;0;.00nan;0;0
17910;161128;957;0;0;0;0;.00nan;0;0
17911;8519;978;71;22;1;21;.955;3600000;0
17911;183905;2571;90;43;2;41;.953;3564000;0
17911;56306;978;0;0;0;0;.00nan;0;0
17911;76329;2571;0;0;0;0;.00nan;0;0
17912;196055;945;0;0;0;0;.00nan;0;0
17912;146445;894;0;0;0;0;.00nan;0;0
17912;146479;945;25;16;5;11;.688;3598000;0
17912;157416;894;80;48;4;44;.917;3600000;0
17913;190831;880;100;24;0;24;1.000;3600000;0
17913;80596;3965;0;0;0;0;.00nan;0;0
17913;147164;880;0;0;0;0;.00nan;0;0
17913;149353;3965;86;28;1;27;.964;3573000;0
17914;14266;879;49;9;2;7;.778;3600000;0
17914;196005;966;94;49;3;46;.939;3555000;0
17914;86283;879;0;0;0;0;.00nan;0;0
17914;157295;966;0;0;0;0;.00nan;0;0
17915;82245;872;54;15;2;13;.867;3600000;0
17915;146445;894;66;41;4;37;.902;3600000;0
17915;157396;872;0;0;0;0;.00nan;0;0
17915;157416;894;0;0;0;0;.00nan;0;0
17916;4219;874;73;25;2;23;.920;3600000;0
17916;76885;897;64;33;4;29;.879;3531000;0
17916;83678;874;0;0;0;0;.00nan;0;0
17916;147492;897;0;0;0;0;.00nan;0;0
17917;7624;890;0;0;0;0;.00nan;0;0
17917;201288;957;0;0;0;0;.00nan;0;0
17917;159705;890;83;36;2;34;.944;3574000;0
17917;161128;957;73;21;1;20;.952;3600000;0
17918;196005;966;82;25;1;24;.960;3600000;0
17918;196055;945;0;0;0;0;.00nan;0;0
17918;146479;945;75;30;2;28;.933;3550000;0
17918;157295;966;0;0;0;0;.00nan;0;0
17919;8519;978;73;28;2;26;.929;3545000;0
17919;56306;978;0;0;0;0;.00nan;0;0
17919;80596;3965;78;21;1;20;.952;3600000;0
17919;149353;3965;0;0;0;0;.00nan;0;0
17920;14266;879;0;0;0;0;.00nan;0;0
17920;170042;891;0;0;0;0;.00nan;0;0
17920;86283;879;91;35;1;34;.971;3600000;0
17920;86686;891;89;38;2;36;.947;3559000;0
17921;76885;897;60;26;3;23;.885;3544000;0
17921;146445;894;64;24;2;22;.917;3600000;0
17921;147492;897;0;0;0;0;.00nan;0;0
17921;157416;894;0;0;0;0;.00nan;0;0
17922;7624;890;62;35;4;31;.886;3900000;0
17922;82245;872;62;31;4;27;.871;3900000;0
17922;157396;872;0;0;0;0;.00nan;0;0
17922;159705;890;0;0;0;0;.00nan;0;0
17923;4219;874;0;0;0;0;.00nan;0;0
17923;8519;978;35;32;6;26;.813;3600000;0
17923;56306;978;0;0;0;0;.00nan;0;0
17923;83678;874;57;21;2;19;.905;3600000;0
17924;196055;945;0;0;0;0;.00nan;0;0
17924;80596;3965;0;0;0;0;.00nan;0;0
17924;146479;945;73;26;2;24;.923;3900000;0
17924;149353;3965;75;28;2;26;.929;3900000;0
17925;170042;891;39;23;4;19;.826;3556000;0
17925;190831;880;80;32;2;30;.938;3600000;0
17925;86686;891;0;0;0;0;.00nan;0;0
17925;147164;880;0;0;0;0;.00nan;0;0
17926;201288;957;0;0;0;0;.00nan;0;0
17926;196005;966;95;41;2;39;.951;3600000;0
17926;157295;966;0;0;0;0;.00nan;0;0
17926;161128;957;63;12;1;11;.917;3600000;0
17927;14266;879;73;21;2;19;.905;3600000;0
17927;183905;2571;83;49;4;45;.918;3573000;0
17927;76329;2571;0;0;0;0;.00nan;0;0
17927;86283;879;0;0;0;0;.00nan;0;0
17928;190831;880;70;28;2;26;.929;3544000;0
17928;76885;897;86;29;1;28;.966;3600000;0
17928;147164;880;0;0;0;0;.00nan;0;0
17928;147492;897;0;0;0;0;.00nan;0;0
17929;80596;3965;56;31;5;26;.839;3600000;0
17929;82245;872;81;25;1;24;.960;3600000;0
17929;149353;3965;0;0;0;0;.00nan;0;0
17929;157396;872;0;0;0;0;.00nan;0;0
17930;170042;891;0;0;0;0;.00nan;0;0
17930;201288;957;63;19;2;17;.895;3600000;0
17930;86686;891;84;35;3;32;.914;3600000;0
17930;161128;957;0;0;0;0;.00nan;0;0
17931;183905;2571;63;38;5;33;.868;3600000;0
17931;196005;966;89;26;1;25;.962;3600000;0
17931;76329;2571;0;0;0;0;.00nan;0;0
17931;157295;966;0;0;0;0;.00nan;0;0
17932;7624;890;0;0;0;0;.00nan;0;0
17932;196055;945;0;0;0;0;.00nan;0;0
17932;146479;945;67;31;3;28;.903;3600000;0
17932;159705;890;100;31;0;31;1.000;3600000;0
17933;8519;978;39;23;4;19;.826;3568000;0
17933;56306;978;0;0;0;0;.00nan;0;0
17933;146445;894;79;36;3;33;.917;3600000;0
17933;157416;894;0;0;0;0;.00nan;0;0
17934;7624;890;0;0;0;0;.00nan;0;0
17934;82245;872;0;0;0;0;.00nan;0;0
17934;157396;872;73;28;2;26;.929;3655000;0
17934;159705;890;80;36;3;33;.917;3655000;0
17935;4219;874;60;14;2;12;.857;3600000;0
17935;196005;966;63;27;3;24;.889;3600000;0
17935;83678;874;0;0;0;0;.00nan;0;0
17935;157295;966;0;0;0;0;.00nan;0;0
17936;201288;957;0;0;0;0;.00nan;0;0
17936;196055;945;0;0;0;0;.00nan;0;0
17936;146479;945;51;28;4;24;.857;3600000;0
17936;161128;957;60;15;1;14;.933;3600000;0
17937;76885;897;56;18;2;16;.889;3600000;0
17937;146445;894;90;49;4;45;.918;3546000;0
17937;147492;897;0;0;0;0;.00nan;0;0
17937;157416;894;0;0;0;0;.00nan;0;0
17938;14266;879;0;0;0;0;.00nan;0;0
17938;190831;880;57;27;4;23;.852;3600000;0
17938;86283;879;69;30;3;27;.900;3600000;0
17938;147164;880;0;0;0;0;.00nan;0;0
17939;201288;957;0;0;0;0;.00nan;0;0
17939;76885;897;70;36;4;32;.889;3656000;0
17939;147492;897;0;0;0;0;.00nan;0;0
17939;161128;957;71;24;3;21;.875;3656000;0
17940;7624;890;0;0;0;0;.00nan;0;0
17940;146445;894;86;41;3;38;.927;3581000;0
17940;157416;894;0;0;0;0;.00nan;0;0
17940;159705;890;61;13;1;12;.923;3600000;0
17941;14266;879;72;22;1;21;.955;3600000;0
17941;196055;945;66;32;3;29;.906;3554000;0
17941;86283;879;0;0;0;0;.00nan;0;0
17941;146479;945;0;0;0;0;.00nan;0;0
17942;8519;978;72;28;2;26;.929;3900000;0
17942;190831;880;71;25;2;23;.920;3900000;0
17942;56306;978;0;0;0;0;.00nan;0;0
17942;147164;880;0;0;0;0;.00nan;0;0
17943;170042;891;94;33;1;32;.970;3600000;0
17943;196005;966;80;31;2;29;.935;3600000;0
17943;86686;891;0;0;0;0;.00nan;0;0
17943;157295;966;0;0;0;0;.00nan;0;0
17944;4219;874;67;26;2;24;.923;3900000;0
17944;80596;3965;0;0;0;0;.00nan;0;0
17944;83678;874;0;0;0;0;.00nan;0;0
17944;149353;3965;93;42;2;40;.952;3900000;0
17945;4219;874;0;0;0;0;.00nan;0;0
17945;196055;945;0;0;0;0;.00nan;0;0
17945;83678;874;93;28;1;27;.964;3600000;0
17945;146479;945;48;40;6;34;.850;3600000;0
17946;80596;3965;0;0;0;0;.00nan;0;0
17946;149353;3965;54;48;7;41;.854;3600000;0
17946;154414;957;0;0;0;0;.00nan;0;0
17946;161128;957;67;17;1;16;.941;3600000;0
17947;8519;978;0;0;0;0;.00nan;0;0
17947;196005;966;67;45;5;40;.889;3600000;0
17947;56306;978;87;19;0;19;1.000;3600000;0
17947;157295;966;0;0;0;0;.00nan;0;0
17948;190831;880;70;37;4;33;.892;3600000;0
17948;146445;894;0;0;0;0;.00nan;0;0
17948;147164;880;0;0;0;0;.00nan;0;0
17948;157416;894;90;44;1;43;.977;3600000;0
17949;183905;2571;88;40;2;38;.950;3599000;0
17949;76329;2571;0;0;0;0;.00nan;0;0
17949;82245;872;75;20;1;19;.950;3600000;0
17949;157396;872;0;0;0;0;.00nan;0;0
17950;14266;879;0;0;0;0;.00nan;0;0
17950;76885;897;100;42;1;41;.976;3600000;0
17950;86283;879;53;20;3;17;.850;3548000;0
17950;147492;897;0;0;0;0;.00nan;0;0
17951;7624;890;72;27;2;25;.926;3600000;0
17951;170042;891;0;0;0;0;.00nan;0;0
17951;86686;891;100;27;0;27;1.000;3600000;0
17951;159705;890;0;0;0;0;.00nan;0;0
17952;183905;2571;0;0;0;0;.00nan;0;0
17952;76329;2571;96;58;4;54;.931;3600000;0
17952;82245;872;0;0;0;0;.00nan;0;0
17952;157396;872;43;11;2;9;.818;3600000;0
17953;146445;894;81;49;4;45;.918;3600000;0
17953;154414;957;0;0;0;0;.00nan;0;0
17953;157416;894;0;0;0;0;.00nan;0;0
17953;161128;957;73;7;0;7;1.000;3600000;0
17954;8519;978;0;0;0;0;.00nan;0;0
17954;56306;978;80;27;2;25;.926;3600000;0
17954;76885;897;0;0;0;0;.00nan;0;0
17954;147492;897;47;28;4;24;.857;3600000;0
17955;14266;879;61;20;2;18;.900;3600000;0
17955;82245;872;46;33;5;28;.848;3600000;0
17955;86283;879;0;0;0;0;.00nan;0;0
17955;157396;872;0;0;0;0;.00nan;0;0
17956;7624;890;0;0;0;0;.00nan;0;0
17956;190831;880;50;40;6;34;.850;3600000;0
17956;147164;880;0;0;0;0;.00nan;0;0
17956;159705;890;80;29;2;27;.931;3600000;0
17957;196005;966;61;31;3;28;.903;3900000;0
17957;154414;957;0;0;0;0;.00nan;0;0
17957;157295;966;0;0;0;0;.00nan;0;0
17957;161128;957;40;15;3;12;.800;3900000;0
17958;80596;3965;0;0;0;0;.00nan;0;0
17958;146445;894;45;36;6;30;.833;3600000;0
17958;149353;3965;100;33;0;33;1.000;3600000;0
17958;157416;894;0;0;0;0;.00nan;0;0
17959;4219;874;0;0;0;0;.00nan;0;0
17959;183905;2571;95;39;1;38;.974;3600000;0
17959;76329;2571;0;0;0;0;.00nan;0;0
17959;83678;874;61;19;2;17;.895;3545000;0
17960;170042;891;0;0;0;0;.00nan;0;0
17960;196055;945;0;0;0;0;.00nan;0;0
17960;86686;891;50;25;4;21;.840;3834000;0
17960;146479;945;68;39;3;36;.923;3790000;0
17961;8519;978;73;32;3;29;.906;3592000;0
17961;14266;879;0;0;0;0;.00nan;0;0
17961;56306;978;0;0;0;0;.00nan;0;0
17961;86283;879;69;22;2;20;.909;3600000;0
17962;170042;891;83;55;5;50;.909;3600000;0
17962;86686;891;0;0;0;0;.00nan;0;0
17962;154414;957;0;0;0;0;.00nan;0;0
17962;161128;957;86;15;0;15;1.000;3600000;0
17963;183905;2571;79;49;5;44;.898;3546000;0
17963;76329;2571;0;0;0;0;.00nan;0;0
17963;76885;897;51;27;4;23;.852;3600000;0
17963;147492;897;0;0;0;0;.00nan;0;0
17964;82245;872;66;20;2;18;.900;3900000;0
17964;146445;894;82;36;2;34;.944;3900000;0
17964;157396;872;0;0;0;0;.00nan;0;0
17964;157416;894;0;0;0;0;.00nan;0;0
17965;4219;874;57;17;2;15;.882;3900000;0
17965;170042;891;87;37;2;35;.946;3900000;0
17965;83678;874;0;0;0;0;.00nan;0;0
17965;86686;891;0;0;0;0;.00nan;0;0
17966;7624;890;0;0;0;0;.00nan;0;0
17966;196055;945;83;30;1;29;.967;3600000;0
17966;146479;945;0;0;0;0;.00nan;0;0
17966;159705;890;72;24;2;22;.917;3543000;0
17967;190831;880;0;0;0;0;.00nan;0;0
17967;147164;880;84;28;1;27;.964;3600000;0
17967;154414;957;0;0;0;0;.00nan;0;0
17967;161128;957;46;13;2;11;.846;3564000;0
17968;196005;966;72;48;4;44;.917;3564000;0
17968;80596;3965;0;0;0;0;.00nan;0;0
17968;149353;3965;60;22;3;19;.864;3600000;0
17968;157295;966;0;0;0;0;.00nan;0;0
17969;7624;890;41;28;5;23;.821;3600000;0
17969;76885;897;80;26;1;25;.962;3600000;0
17969;147492;897;0;0;0;0;.00nan;0;0
17969;159705;890;0;0;0;0;.00nan;0;0
17970;4219;874;0;0;0;0;.00nan;0;0
17970;8519;978;75;39;4;35;.897;3600000;0
17970;56306;978;0;0;0;0;.00nan;0;0
17970;83678;874;92;22;0;22;1.000;3600000;0
17971;196005;966;77;39;3;36;.923;3530000;0
17971;190831;880;64;24;2;22;.917;3600000;0
17971;147164;880;0;0;0;0;.00nan;0;0
17971;157295;966;0;0;0;0;.00nan;0;0
17972;14266;879;66;11;1;10;.909;3600000;0
17972;86283;879;0;0;0;0;.00nan;0;0
17972;146445;894;77;46;4;42;.913;3600000;0
17972;157416;894;0;0;0;0;.00nan;0;0
17973;183905;2571;79;35;3;32;.914;3600000;0
17973;196055;945;0;0;0;0;.00nan;0;0
17973;76329;2571;0;0;0;0;.00nan;0;0
17973;146479;945;66;22;2;20;.909;3600000;0
17974;170042;891;0;0;0;0;.00nan;0;0
17974;80596;3965;0;0;0;0;.00nan;0;0
17974;86686;891;86;35;2;33;.943;3552000;0
17974;149353;3965;100;35;0;35;1.000;3600000;0
17975;82245;872;90;50;3;47;.940;3600000;0
17975;154414;957;58;28;4;24;.857;3600000;0
17975;157396;872;0;0;0;0;.00nan;0;0
17975;161128;957;0;0;0;0;.00nan;0;0
17976;8519;978;80;28;2;26;.929;3900000;0
17976;196005;966;62;21;2;19;.905;3891000;0
17976;56306;978;0;0;0;0;.00nan;0;0
17976;157295;966;0;0;0;0;.00nan;0;0
17977;76885;897;55;30;4;26;.867;3553000;0
17977;80596;3965;0;0;0;0;.00nan;0;0
17977;147492;897;0;0;0;0;.00nan;0;0
17977;149353;3965;76;33;3;30;.909;3600000;0
17978;4219;874;0;0;0;0;.00nan;0;0
17978;83678;874;100;22;0;22;1.000;3600000;0
17978;154414;957;0;0;0;0;.00nan;0;0
17978;161128;957;47;15;2;13;.867;3512000;0
17979;7624;890;46;51;7;44;.863;3600000;0
17979;14266;879;0;0;0;0;.00nan;0;0
17979;86283;879;73;20;1;19;.950;3600000;0
17979;159705;890;0;0;0;0;.00nan;0;0
17980;8519;978;0;0;0;0;.00nan;0;0
17980;196055;945;73;27;2;25;.926;3788000;0
17980;56306;978;70;35;3;32;.914;3788000;0
17980;146479;945;0;0;0;0;.00nan;0;0
17981;190831;880;60;34;4;30;.882;3600000;0
17981;82245;872;64;18;1;17;.944;3600000;0
17981;147164;880;0;0;0;0;.00nan;0;0
17981;157396;872;0;0;0;0;.00nan;0;0
17982;183905;2571;33;25;5;20;.800;3600000;0
17982;170042;891;83;32;2;30;.938;3600000;0
17982;76329;2571;0;0;0;0;.00nan;0;0
17982;86686;891;0;0;0;0;.00nan;0;0
17983;4219;874;0;0;0;0;.00nan;0;0
17983;82245;872;0;0;0;0;.00nan;0;0
17983;83678;874;86;41;2;39;.951;3900000;0
17983;157396;872;76;32;2;30;.938;3900000;0
17984;196055;945;0;0;0;0;.00nan;0;0
17984;146445;894;76;32;3;29;.906;3600000;0
17984;146479;945;57;29;4;25;.862;3561000;0
17984;157416;894;0;0;0;0;.00nan;0;0
17985;196005;966;64;35;4;31;.886;3600000;0
17985;190831;880;100;24;0;24;1.000;3600000;0
17985;147164;880;0;0;0;0;.00nan;0;0
17985;157295;966;0;0;0;0;.00nan;0;0
17986;7624;890;0;0;0;0;.00nan;0;0
17986;80596;3965;71;22;1;21;.955;3544000;0
17986;149353;3965;0;0;0;0;.00nan;0;0
17986;159705;890;100;28;0;28;1.000;3600000;0
17987;8519;978;80;20;1;19;.950;3600000;0
17987;183905;2571;62;31;4;27;.871;3600000;0
17987;56306;978;0;0;0;0;.00nan;0;0
17987;76329;2571;0;0;0;0;.00nan;0;0
17988;14266;879;76;30;2;28;.933;3600000;0
17988;170042;891;46;30;5;25;.833;3600000;0
17988;86283;879;0;0;0;0;.00nan;0;0
17988;86686;891;0;0;0;0;.00nan;0;0
17989;170042;891;0;0;0;0;.00nan;0;0
17989;86686;891;53;30;4;26;.867;3600000;0
17989;146445;894;51;40;6;34;.850;3597000;0
17989;157416;894;0;0;0;0;.00nan;0;0
17990;76885;897;51;42;6;36;.857;3600000;0
17990;147492;897;0;0;0;0;.00nan;0;0
17990;154414;957;0;0;0;0;.00nan;0;0
17990;161128;957;82;14;0;14;1.000;3600000;0
17991;7624;890;0;0;0;0;.00nan;0;0
17991;196005;966;59;36;5;31;.861;3533000;0
17991;157295;966;0;0;0;0;.00nan;0;0
17991;159705;890;63;32;3;29;.906;3600000;0
17992;196055;945;0;0;0;0;.00nan;0;0
17992;76885;897;62;28;3;25;.893;3600000;0
17992;146479;945;74;43;4;39;.907;3600000;0
17992;147492;897;0;0;0;0;.00nan;0;0
17993;8519;978;47;22;3;19;.864;3531000;0
17993;56306;978;0;0;0;0;.00nan;0;0
17993;154414;957;69;21;1;20;.952;3600000;0
17993;161128;957;0;0;0;0;.00nan;0;0
17994;4219;874;0;0;0;0;.00nan;0;0
17994;83678;874;59;28;3;25;.893;3600000;0
17994;146445;894;79;44;4;40;.909;3569000;0
17994;157416;894;0;0;0;0;.00nan;0;0
17995;80596;3965;0;0;0;0;.00nan;0;0
17995;82245;872;93;37;3;34;.919;3583000;0
17995;149353;3965;68;25;2;23;.920;3600000;0
17995;157396;872;0;0;0;0;.00nan;0;0
17996;14266;879;89;17;0;17;1.000;3600000;0
17996;183905;2571;84;53;5;48;.906;3600000;0
17996;76329;2571;0;0;0;0;.00nan;0;0
17996;86283;879;0;0;0;0;.00nan;0;0
17997;170042;891;72;26;2;24;.923;3600000;0
17997;190831;880;74;35;3;32;.914;3600000;0
17997;86686;891;0;0;0;0;.00nan;0;0
17997;147164;880;0;0;0;0;.00nan;0;0
17998;7624;890;59;30;3;27;.900;3600000;0
17998;154414;957;84;13;0;13;1.000;3600000;0
17998;159705;890;0;0;0;0;.00nan;0;0
17998;161128;957;0;0;0;0;.00nan;0;0
17999;170042;891;58;27;3;24;.889;3516000;0
17999;82245;872;69;18;1;17;.944;3600000;0
17999;86686;891;0;0;0;0;.00nan;0;0
17999;157396;872;0;0;0;0;.00nan;0;0
18000;4219;874;86;28;1;27;.964;3600000;0
18000;14266;879;55;24;3;21;.875;3514000;0
18000;83678;874;0;0;0;0;.00nan;0;0
18000;86283;879;0;0;0;0;.00nan;0;0
18001;196055;945;0;0;0;0;.00nan;0;0
18001;190831;880;0;0;0;0;.00nan;0;0
18001;146479;945;48;27;4;23;.852;3600000;0
18001;147164;880;64;18;1;17;.944;3600000;0
18002;196005;966;94;22;0;22;1.000;3600000;0
18002;76885;897;52;14;2;12;.857;3513000;0
18002;147492;897;0;0;0;0;.00nan;0;0
18002;157295;966;0;0;0;0;.00nan;0;0
18003;183905;2571;86;56;4;52;.929;3600000;0
18003;76329;2571;0;0;0;0;.00nan;0;0
18003;146445;894;71;18;1;17;.944;3600000;0
18003;157416;894;0;0;0;0;.00nan;0;0
18004;8519;978;53;31;5;26;.839;3600000;0
18004;56306;978;0;0;0;0;.00nan;0;0
18004;80596;3965;0;0;0;0;.00nan;0;0
18004;149353;3965;83;27;1;26;.963;3600000;0
18005;4219;874;100;29;0;29;1.000;3600000;0
18005;76885;897;0;0;0;0;.00nan;0;0
18005;83678;874;0;0;0;0;.00nan;0;0
18005;147492;897;55;29;4;25;.862;3600000;0
18006;183905;2571;35;41;7;34;.829;2128000;0
18006;76329;2571;59;22;2;20;.909;1472000;0
18006;154414;957;56;11;1;10;.909;3600000;0
18006;161128;957;0;0;0;0;.00nan;0;0
18007;14266;879;0;0;0;0;.00nan;0;0
18007;196005;966;94;44;2;42;.955;3900000;0
18007;86283;879;79;26;2;24;.923;3900000;0
18007;157295;966;0;0;0;0;.00nan;0;0
18008;196055;945;0;0;0;0;.00nan;0;0
18008;82245;872;0;0;0;0;.00nan;0;0
18008;146479;945;89;33;1;32;.970;3600000;0
18008;157396;872;44;11;2;9;.818;3600000;0
18009;7624;890;0;0;0;0;.00nan;0;0
18009;8519;978;97;24;0;24;1.000;3600000;0
18009;56306;978;0;0;0;0;.00nan;0;0
18009;159705;890;78;31;2;29;.935;3546000;0
18010;190831;880;75;29;2;27;.931;3600000;0
18010;80596;3965;0;0;0;0;.00nan;0;0
18010;147164;880;0;0;0;0;.00nan;0;0
18010;149353;3965;41;22;4;18;.818;3526000;0
18011;4219;874;60;20;2;18;.900;3600000;0
18011;7624;890;59;31;3;28;.903;3594000;0
18011;83678;874;0;0;0;0;.00nan;0;0
18011;159705;890;0;0;0;0;.00nan;0;0
18012;14266;879;76;39;3;36;.923;3600000;0
18012;86283;879;0;0;0;0;.00nan;0;0
18012;154414;957;99;27;0;27;1.000;3600000;0
18012;161128;957;0;0;0;0;.00nan;0;0
18013;8519;978;49;38;6;32;.842;2256000;0
18013;56306;978;40;8;2;6;.750;1344000;0
18013;146445;894;63;30;3;27;.900;3600000;0
18013;157416;894;0;0;0;0;.00nan;0;0
18014;196005;966;76;33;2;31;.939;3600000;0
18014;82245;872;51;21;3;18;.857;3600000;0
18014;157295;966;0;0;0;0;.00nan;0;0
18014;157396;872;0;0;0;0;.00nan;0;0
18015;196055;945;0;0;0;0;.00nan;0;0
18015;80596;3965;0;0;0;0;.00nan;0;0
18015;146479;945;97;29;0;29;1.000;3900000;0
18015;149353;3965;100;25;0;25;1.000;3900000;0
18016;170042;891;68;42;5;37;.881;3549000;0
18016;76885;897;69;27;3;24;.889;3600000;0
18016;86686;891;0;0;0;0;.00nan;0;0
18016;147492;897;0;0;0;0;.00nan;0;0
18017;170042;891;59;32;4;28;.875;3576000;0
18017;76885;897;76;27;2;25;.926;3600000;0
18017;86686;891;0;0;0;0;.00nan;0;0
18017;147492;897;0;0;0;0;.00nan;0;0
18018;8519;978;45;29;5;24;.828;3600000;0
18018;56306;978;0;0;0;0;.00nan;0;0
18018;82245;872;68;22;2;20;.909;3600000;0
18018;157396;872;0;0;0;0;.00nan;0;0
18019;7624;890;84;13;0;13;1.000;3600000;0
18019;183905;2571;72;50;4;46;.920;3600000;0
18019;76329;2571;0;0;0;0;.00nan;0;0
18019;159705;890;0;0;0;0;.00nan;0;0
18020;196005;966;67;40;4;36;.900;3600000;0
18020;196055;945;0;0;0;0;.00nan;0;0
18020;146479;945;90;19;0;19;1.000;3600000;0
18020;157295;966;0;0;0;0;.00nan;0;0
18021;4219;874;0;0;0;0;.00nan;0;0
18021;190831;880;100;25;0;25;1.000;3600000;0
18021;83678;874;83;34;3;31;.912;3600000;0
18021;147164;880;0;0;0;0;.00nan;0;0
18022;146445;894;0;0;0;0;.00nan;0;0
18022;154414;957;59;19;2;17;.895;3513000;0
18022;157416;894;100;31;0;31;1.000;3600000;0
18022;161128;957;0;0;0;0;.00nan;0;0
18023;14266;879;0;0;0;0;.00nan;0;0
18023;80596;3965;0;0;0;0;.00nan;0;0
18023;86283;879;65;21;2;19;.905;3595000;0
18023;149353;3965;86;32;1;31;.969;3600000;0
18024;14266;879;65;31;3;28;.903;3891000;0
18024;80596;3965;60;27;4;23;.852;3891000;0
18024;86283;879;0;0;0;0;.00nan;0;0
18024;149353;3965;0;0;0;0;.00nan;0;0
18025;183905;2571;32;22;4;18;.818;981000;0
18025;76329;2571;66;48;5;43;.896;2619000;0
18025;154414;957;61;12;1;11;.917;3600000;0
18025;161128;957;0;0;0;0;.00nan;0;0
18026;190831;880;64;23;2;21;.913;3600000;0
18026;76885;897;41;23;4;19;.826;3585000;0
18026;147164;880;0;0;0;0;.00nan;0;0
18026;147492;897;0;0;0;0;.00nan;0;0
18027;82245;872;55;17;2;15;.882;3600000;0
18027;146445;894;0;0;0;0;.00nan;0;0
18027;157396;872;0;0;0;0;.00nan;0;0
18027;157416;894;55;30;3;27;.900;3600000;0
18028;4219;874;62;29;4;25;.862;3749000;0
18028;196055;945;0;0;0;0;.00nan;0;0
18028;83678;874;0;0;0;0;.00nan;0;0
18028;146479;945;69;36;3;33;.917;3749000;0
18029;7624;890;34;33;6;27;.818;3119000;0
18029;8519;978;0;0;0;0;.00nan;0;0
18029;56306;978;53;30;5;25;.833;3600000;0
18029;159705;890;49;1;0;1;1.000;450000;0
18030;170042;891;0;0;0;0;.00nan;0;0
18030;196005;966;59;16;2;14;.875;3571000;0
18030;86686;891;100;39;1;38;.974;3600000;0
18030;157295;966;0;0;0;0;.00nan;0;0
18031;76885;897;66;19;2;17;.895;3600000;0
18031;146445;894;75;46;5;41;.891;3600000;0
18031;147492;897;0;0;0;0;.00nan;0;0
18031;157416;894;0;0;0;0;.00nan;0;0
18032;4219;874;47;20;3;17;.850;3600000;0
18032;80596;3965;0;0;0;0;.00nan;0;0
18032;83678;874;0;0;0;0;.00nan;0;0
18032;149353;3965;45;40;7;33;.825;3600000;0
18033;7624;890;64;10;0;10;1.000;811000;0
18033;154414;957;43;16;3;13;.813;3600000;0
18033;159705;890;26;26;6;20;.769;2789000;0
18033;161128;957;0;0;0;0;.00nan;0;0
18034;8519;978;55;33;4;29;.879;3532000;0
18034;56306;978;0;0;0;0;.00nan;0;0
18034;82245;872;78;27;2;25;.926;3600000;0
18034;157396;872;0;0;0;0;.00nan;0;0
18035;196005;966;81;28;1;27;.964;3560000;0
18035;190831;880;97;24;0;24;1.000;3600000;0
18035;147164;880;0;0;0;0;.00nan;0;0
18035;157295;966;0;0;0;0;.00nan;0;0
18036;183905;2571;95;45;3;42;.933;3523000;0
18036;170042;891;0;0;0;0;.00nan;0;0
18036;76329;2571;0;0;0;0;.00nan;0;0
18036;86686;891;60;9;1;8;.889;3600000;0
18037;14266;879;64;14;1;13;.929;3600000;0
18037;196055;945;0;0;0;0;.00nan;0;0
18037;86283;879;0;0;0;0;.00nan;0;0
18037;146479;945;86;50;4;46;.920;3600000;0
18038;196005;966;43;37;6;31;.838;3600000;0
18038;82245;872;0;0;0;0;.00nan;0;0
18038;157295;966;0;0;0;0;.00nan;0;0
18038;157396;872;50;14;2;12;.857;3600000;0
18039;4219;874;0;0;0;0;.00nan;0;0
18039;83678;874;79;41;3;38;.927;3600000;0
18039;154414;957;33;33;6;27;.818;3600000;0
18039;161128;957;0;0;0;0;.00nan;0;0
18040;183905;2571;98;50;3;47;.940;3586000;0
18040;196055;945;71;24;2;22;.917;3600000;0
18040;76329;2571;0;0;0;0;.00nan;0;0
18040;146479;945;0;0;0;0;.00nan;0;0
18041;7624;890;83;32;1;31;.969;3600000;0
18041;190831;880;89;19;0;19;1.000;3600000;0
18041;147164;880;0;0;0;0;.00nan;0;0
18041;159705;890;0;0;0;0;.00nan;0;0
18042;8519;978;0;0;0;0;.00nan;0;0
18042;56306;978;63;19;2;17;.895;3600000;0
18042;146445;894;84;40;4;36;.900;3553000;0
18042;157416;894;0;0;0;0;.00nan;0;0
18043;76885;897;87;29;1;28;.966;3600000;0
18043;80596;3965;0;0;0;0;.00nan;0;0
18043;147492;897;0;0;0;0;.00nan;0;0
18043;149353;3965;68;26;2;24;.923;3600000;0
18044;14266;879;65;31;3;28;.903;3820000;0
18044;170042;891;0;0;0;0;.00nan;0;0
18044;86283;879;0;0;0;0;.00nan;0;0
18044;86686;891;76;30;2;28;.933;3820000;0
18045;7624;890;0;0;0;0;.00nan;0;0
18045;82245;872;48;24;4;20;.833;3600000;0
18045;157396;872;0;0;0;0;.00nan;0;0
18045;159705;890;78;29;2;27;.931;3600000;0
18046;190831;880;88;32;1;31;.969;3600000;0
18046;146445;894;0;0;0;0;.00nan;0;0
18046;147164;880;0;0;0;0;.00nan;0;0
18046;157416;894;57;30;5;25;.833;3600000;0
18047;14266;879;0;0;0;0;.00nan;0;0
18047;196005;966;0;0;0;0;.00nan;0;0
18047;86283;879;61;15;1;14;.933;3600000;0
18047;157295;966;63;44;5;39;.886;3600000;0
18048;183905;2571;72;41;4;37;.902;3644000;0
18048;76329;2571;0;0;0;0;.00nan;0;0
18048;76885;897;57;22;3;19;.864;3644000;0
18048;147492;897;0;0;0;0;.00nan;0;0
18049;196055;945;0;0;0;0;.00nan;0;0
18049;80596;3965;0;0;0;0;.00nan;0;0
18049;146479;945;85;40;2;38;.950;3600000;0
18049;149353;3965;85;38;3;35;.921;3600000;0
18050;190831;880;100;40;1;39;.975;3600000;0
18050;82245;872;34;17;3;14;.824;3600000;0
18050;147164;880;0;0;0;0;.00nan;0;0
18050;157396;872;0;0;0;0;.00nan;0;0
18051;7624;890;0;0;0;0;.00nan;0;0
18051;80596;3965;0;0;0;0;.00nan;0;0
18051;149353;3965;90;38;2;36;.947;3583000;0
18051;159705;890;100;27;0;27;1.000;3600000;0
18052;9858;966;0;0;0;0;.00nan;0;0
18052;154414;957;54;18;2;16;.889;3600000;0
18052;157295;966;99;48;1;47;.979;3600000;0
18052;161128;957;0;0;0;0;.00nan;0;0
18053;8519;978;91;32;1;31;.969;3900000;0
18053;183905;2571;93;41;1;40;.976;3900000;0
18053;56306;978;0;0;0;0;.00nan;0;0
18053;76329;2571;0;0;0;0;.00nan;0;0
18054;196055;945;0;0;0;0;.00nan;0;0
18054;146445;894;80;31;2;29;.935;3600000;0
18054;146479;945;54;28;4;24;.857;3577000;0
18054;157416;894;0;0;0;0;.00nan;0;0
18055;4219;874;0;0;0;0;.00nan;0;0
18055;71075;879;0;0;0;0;.00nan;0;0
18055;83678;874;75;33;3;30;.909;3564000;0
18055;86283;879;84;29;1;28;.966;3600000;0
18056;170042;891;0;0;0;0;.00nan;0;0
18056;76885;897;83;26;2;24;.923;3900000;0
18056;86686;891;95;46;2;44;.957;3900000;0
18056;147492;897;0;0;0;0;.00nan;0;0
18057;76885;897;64;26;2;24;.923;3600000;0
18057;147492;897;0;0;0;0;.00nan;0;0
18057;154414;957;61;32;4;28;.875;3553000;0
18057;161128;957;0;0;0;0;.00nan;0;0
18058;4219;874;65;34;3;31;.912;3586000;0
18058;82245;872;48;14;2;12;.857;3600000;0
18058;83678;874;0;0;0;0;.00nan;0;0
18058;157396;872;0;0;0;0;.00nan;0;0
18059;8519;978;0;0;0;0;.00nan;0;0
18059;196055;945;0;0;0;0;.00nan;0;0
18059;56306;978;48;32;5;27;.844;3600000;0
18059;146479;945;62;20;2;18;.900;3600000;0
18060;3077;2571;0;0;0;0;.00nan;0;0
18060;183905;2571;89;46;3;43;.935;3515000;0
18060;190831;880;0;0;0;0;.00nan;0;0
18060;147164;880;57;15;1;14;.933;3600000;0
18061;7624;890;0;0;0;0;.00nan;0;0
18061;196005;966;100;29;0;29;1.000;3600000;0
18061;157295;966;0;0;0;0;.00nan;0;0
18061;159705;890;43;17;3;14;.824;3600000;0
18062;170042;891;0;0;0;0;.00nan;0;0
18062;80596;3965;70;20;1;19;.950;3600000;0
18062;86686;891;80;33;2;31;.939;3586000;0
18062;149353;3965;0;0;0;0;.00nan;0;0
18063;14266;879;80;21;1;20;.952;3900000;0
18063;86283;879;0;0;0;0;.00nan;0;0
18063;146445;894;100;36;1;35;.972;3900000;0
18063;157416;894;0;0;0;0;.00nan;0;0
18064;3077;2571;0;0;0;0;.00nan;0;0
18064;183905;2571;75;38;3;35;.921;3600000;0
18064;190831;880;86;18;0;18;1.000;3600000;0
18064;147164;880;0;0;0;0;.00nan;0;0
18065;3077;2571;0;0;0;0;.00nan;0;0
18065;14266;879;68;20;1;19;.950;3600000;0
18065;183905;2571;90;50;2;48;.960;3597000;0
18065;86283;879;0;0;0;0;.00nan;0;0
18066;80596;3965;53;3;0;3;1.000;388000;0
18066;82245;872;0;0;0;0;.00nan;0;0
18066;149353;3965;44;31;5;26;.839;3212000;0
18066;157396;872;72;26;2;24;.923;3600000;0
18067;4219;874;0;0;0;0;.00nan;0;0
18067;76885;897;64;31;3;28;.903;3590000;0
18067;83678;874;65;23;2;21;.913;3600000;0
18067;147492;897;0;0;0;0;.00nan;0;0
18068;190831;880;17;32;8;24;.750;3077000;0
18068;147164;880;68;9;0;9;1.000;523000;0
18068;154414;957;56;13;1;12;.923;3600000;0
18068;161128;957;0;0;0;0;.00nan;0;0
18069;170042;891;0;0;0;0;.00nan;0;0
18069;196055;945;0;0;0;0;.00nan;0;0
18069;86686;891;72;29;3;26;.897;3784000;0
18069;146479;945;77;27;2;25;.926;3784000;0
18070;7624;890;72;22;1;21;.955;3900000;0
18070;146445;894;100;34;1;33;.971;3900000;0
18070;157416;894;0;0;0;0;.00nan;0;0
18070;159705;890;0;0;0;0;.00nan;0;0
18071;8519;978;100;37;0;37;1.000;3600000;0
18071;14266;879;71;29;2;27;.931;3521000;0
18071;56306;978;0;0;0;0;.00nan;0;0
18071;86283;879;0;0;0;0;.00nan;0;0
18072;196005;966;79;27;1;26;.963;3600000;0
18072;76885;897;100;20;0;20;1.000;3600000;0
18072;147492;897;0;0;0;0;.00nan;0;0
18072;157295;966;0;0;0;0;.00nan;0;0
18073;4219;874;0;0;0;0;.00nan;0;0
18073;7624;890;0;0;0;0;.00nan;0;0
18073;83678;874;85;13;0;13;1.000;3600000;0
18073;159705;890;59;34;4;30;.882;3600000;0
18074;196055;945;66;24;1;23;.958;3600000;0
18074;190831;880;55;19;3;16;.842;3532000;0
18074;146479;945;0;0;0;0;.00nan;0;0
18074;147164;880;0;0;0;0;.00nan;0;0
18075;3077;2571;0;0;0;0;.00nan;0;0
18075;183905;2571;80;36;3;33;.917;3514000;0
18075;146445;894;86;24;1;23;.958;3600000;0
18075;157416;894;0;0;0;0;.00nan;0;0
18076;170042;891;0;0;0;0;.00nan;0;0
18076;82245;872;75;28;2;26;.929;3885000;0
18076;86686;891;92;38;2;36;.947;3900000;0
18076;157396;872;0;0;0;0;.00nan;0;0
18077;80596;3965;0;0;0;0;.00nan;0;0
18077;149353;3965;80;42;4;38;.905;3566000;0
18077;154414;957;57;15;2;13;.867;3600000;0
18077;161128;957;0;0;0;0;.00nan;0;0
18078;4219;874;0;0;0;0;.00nan;0;0
18078;83678;874;93;15;0;15;1.000;3600000;0
18078;146445;894;97;34;1;33;.971;2681000;0
18078;157416;894;32;20;4;16;.800;919000;0
18079;7624;890;16;24;6;18;.750;3213000;0
18079;76885;897;75;22;1;21;.955;3600000;0
18079;147492;897;0;0;0;0;.00nan;0;0
18079;159705;890;39;1;1;0;.000;387000;0
18080;3077;2571;77;34;2;32;.941;1847000;0
18080;183905;2571;5;21;7;14;.667;1753000;0
18080;82245;872;64;12;1;11;.917;3600000;0
18080;157396;872;0;0;0;0;.00nan;0;0
18081;170042;891;0;0;0;0;.00nan;0;0
18081;190831;880;74;26;1;25;.962;3900000;0
18081;86686;891;84;24;1;23;.958;3900000;0
18081;147164;880;0;0;0;0;.00nan;0;0
18082;196005;966;100;35;1;34;.971;3600000;0
18082;196055;945;0;0;0;0;.00nan;0;0
18082;146479;945;45;15;2;13;.867;3600000;0
18082;157295;966;0;0;0;0;.00nan;0;0
18083;8519;978;60;35;4;31;.886;3600000;0
18083;56306;978;0;0;0;0;.00nan;0;0
18083;80596;3965;0;0;0;0;.00nan;0;0
18083;149353;3965;89;26;1;25;.962;3600000;0
18084;8519;978;60;32;4;28;.875;3600000;0
18084;56306;978;0;0;0;0;.00nan;0;0
18084;154414;957;71;20;1;19;.950;3600000;0
18084;161128;957;0;0;0;0;.00nan;0;0
18085;196055;945;0;0;0;0;.00nan;0;0
18085;76885;897;70;17;1;16;.941;3600000;0
18085;146479;945;75;45;3;42;.933;3600000;0
18085;147492;897;0;0;0;0;.00nan;0;0
18086;190831;880;59;30;4;26;.867;3597000;0
18086;80596;3965;0;0;0;0;.00nan;0;0
18086;147164;880;0;0;0;0;.00nan;0;0
18086;149353;3965;69;24;2;22;.917;3600000;0
18087;196005;966;40;20;3;17;.850;3522000;0
18087;146445;894;93;34;1;33;.971;3600000;0
18087;157295;966;0;0;0;0;.00nan;0;0
18087;157416;894;0;0;0;0;.00nan;0;0
18088;3077;2571;0;0;0;0;.00nan;0;0
18088;7624;890;59;14;1;13;.929;3600000;0
18088;183905;2571;89;43;2;41;.953;3563000;0
18088;159705;890;0;0;0;0;.00nan;0;0
18089;14266;879;0;0;0;0;.00nan;0;0
18089;82245;872;16;30;7;23;.767;2601000;0
18089;86283;879;55;30;4;26;.867;3600000;0
18089;157396;872;59;10;0;10;1.000;999000;0
18090;4219;874;0;0;0;0;.00nan;0;0
18090;170042;891;0;0;0;0;.00nan;0;0
18090;83678;874;66;40;5;35;.875;3900000;0
18090;86686;891;42;34;5;29;.853;3870000;0
18091;14266;879;0;0;0;0;.00nan;0;0
18091;76885;897;70;19;1;18;.947;3600000;0
18091;86283;879;52;38;5;33;.868;3600000;0
18091;147492;897;0;0;0;0;.00nan;0;0
18092;82245;872;48;33;5;28;.848;3600000;0
18092;154414;957;72;20;2;18;.900;3600000;0
18092;157396;872;0;0;0;0;.00nan;0;0
18092;161128;957;0;0;0;0;.00nan;0;0
18093;3077;2571;0;0;0;0;.00nan;0;0
18093;4219;874;53;19;3;16;.842;3600000;0
18093;183905;2571;67;52;6;46;.885;3600000;0
18093;83678;874;0;0;0;0;.00nan;0;0
18094;7624;890;0;0;0;0;.00nan;0;0
18094;196055;945;0;0;0;0;.00nan;0;0
18094;146479;945;40;17;3;14;.824;3600000;0
18094;159705;890;74;34;2;32;.941;3600000;0
18095;8519;978;0;0;0;0;.00nan;0;0
18095;190831;880;58;37;4;33;.892;3789000;0
18095;56306;978;53;22;3;19;.864;3789000;0
18095;147164;880;0;0;0;0;.00nan;0;0
18096;170042;891;0;0;0;0;.00nan;0;0
18096;86686;891;64;33;3;30;.909;3600000;0
18096;146445;894;26;32;7;25;.781;2899000;0
18096;157416;894;45;3;1;2;.667;701000;0
18097;196005;966;85;35;3;32;.914;3570000;0
18097;80596;3965;0;0;0;0;.00nan;0;0
18097;149353;3965;56;14;2;12;.857;3600000;0
18097;157295;966;0;0;0;0;.00nan;0;0
18098;14266;879;99;38;1;37;.974;3600000;0
18098;86283;879;0;0;0;0;.00nan;0;0
18098;154414;957;83;26;2;24;.923;3567000;0
18098;161128;957;0;0;0;0;.00nan;0;0
18114;7624;890;70;39;4;35;.897;3600000;0
18114;80596;3965;0;0;0;0;.00nan;0;0
18114;149353;3965;85;28;1;27;.964;3600000;0
18114;159705;890;0;0;0;0;.00nan;0;0
18116;9858;966;0;0;0;0;.00nan;0;0
18116;201288;957;62;17;1;16;.941;3600000;0
18116;157295;966;37;27;5;22;.815;3600000;0
18116;161128;957;0;0;0;0;.00nan;0;0
18118;183905;2571;32;36;6;30;.833;1960000;0
18118;57426;879;0;0;0;0;.00nan;0;0
18118;76329;2571;53;18;2;16;.889;1640000;0
18118;86283;879;61;15;1;14;.933;3600000;0
18120;8519;978;74;28;2;26;.929;3600000;0
18120;56306;978;0;0;0;0;.00nan;0;0
18120;146445;894;32;18;4;14;.778;964000;0
18120;157416;894;73;30;2;28;.933;2636000;0
18122;4219;874;0;0;0;0;.00nan;0;0
18122;196055;945;0;0;0;0;.00nan;0;0
18122;83678;874;52;17;3;14;.824;3600000;0
18122;146479;945;60;46;5;41;.891;3600000;0
18124;76885;897;100;31;0;31;1.000;3600000;0
18124;82245;872;55;19;2;17;.895;3557000;0
18124;147492;897;0;0;0;0;.00nan;0;0
18124;157396;872;0;0;0;0;.00nan;0;0
18126;170042;891;50;27;5;22;.815;3600000;0
18126;190831;880;10;20;6;14;.700;2604000;0
18126;86686;891;0;0;0;0;.00nan;0;0
18126;147164;880;51;4;0;4;1.000;949000;0
18128;9858;966;79;30;2;28;.933;3600000;0
18128;80596;3965;47;28;4;24;.857;3579000;0
18128;149353;3965;0;0;0;0;.00nan;0;0
18128;157295;966;0;0;0;0;.00nan;0;0
18130;190831;880;63;48;6;42;.875;3600000;0
18130;76885;897;100;28;1;27;.964;3600000;0
18130;147164;880;0;0;0;0;.00nan;0;0
18130;147492;897;0;0;0;0;.00nan;0;0
18132;4219;874;0;0;0;0;.00nan;0;0
18132;57426;879;0;0;0;0;.00nan;0;0
18132;83678;874;83;38;2;36;.947;3900000;0
18132;86283;879;86;29;2;27;.931;3900000;0
18134;7624;890;0;0;0;0;.00nan;0;0
18134;201288;957;72;24;1;23;.958;3790000;0
18134;159705;890;93;32;2;30;.938;3790000;0
18134;161128;957;0;0;0;0;.00nan;0;0
18136;170042;891;50;28;3;25;.893;3600000;0
18136;196055;945;0;0;0;0;.00nan;0;0
18136;86686;891;0;0;0;0;.00nan;0;0
18136;146479;945;97;23;0;23;1.000;3600000;0
18138;183905;2571;87;36;2;34;.944;3600000;0
18138;76329;2571;0;0;0;0;.00nan;0;0
18138;146445;894;30;25;5;20;.800;3600000;0
18138;157416;894;0;0;0;0;.00nan;0;0
18140;8519;978;0;0;0;0;.00nan;0;0
18140;56306;978;64;46;5;41;.891;3580000;0
18140;82245;872;76;36;4;32;.889;3600000;0
18140;157396;872;0;0;0;0;.00nan;0;0
18142;8519;978;72;36;3;33;.917;3900000;0
18142;56306;978;0;0;0;0;.00nan;0;0
18142;82245;872;0;0;0;0;.00nan;0;0
18142;157396;872;61;27;3;24;.889;3900000;0
18144;201288;957;0;0;0;0;.00nan;0;0
18144;146445;894;0;0;0;0;.00nan;0;0
18144;157416;894;100;37;0;37;1.000;3600000;0
18144;161128;957;55;11;1;10;.909;3600000;0
18146;57426;879;96;15;0;15;1.000;3600000;0
18146;76885;897;62;38;4;34;.895;3600000;0
18146;86283;879;0;0;0;0;.00nan;0;0
18146;147492;897;0;0;0;0;.00nan;0;0
18148;183905;2571;71;23;2;21;.913;3848000;0
18148;170042;891;0;0;0;0;.00nan;0;0
18148;76329;2571;0;0;0;0;.00nan;0;0
18148;86686;891;68;20;1;19;.950;3848000;0
18150;7624;890;65;30;3;27;.900;3548000;0
18150;80596;3965;0;0;0;0;.00nan;0;0
18150;149353;3965;92;39;2;37;.949;3600000;0
18150;159705;890;0;0;0;0;.00nan;0;0
18152;9858;966;0;0;0;0;.00nan;0;0
18152;196055;945;61;20;2;18;.900;3600000;0
18152;146479;945;0;0;0;0;.00nan;0;0
18152;157295;966;32;21;4;17;.810;3559000;0
18154;4219;874;96;20;0;20;1.000;3600000;0
18154;190831;880;0;0;0;0;.00nan;0;0
18154;83678;874;0;0;0;0;.00nan;0;0
18154;147164;880;80;42;4;38;.905;3600000;0
18156;201288;957;52;21;3;18;.857;3600000;0
18156;190831;880;0;0;0;0;.00nan;0;0
18156;147164;880;61;36;4;32;.889;3583000;0
18156;161128;957;0;0;0;0;.00nan;0;0
18158;170042;891;0;0;0;0;.00nan;0;0
18158;76885;897;85;19;1;18;.947;3600000;0
18158;86686;891;84;41;3;38;.927;3559000;0
18158;147492;897;0;0;0;0;.00nan;0;0
18160;7624;890;98;50;2;48;.960;3600000;0
18160;82245;872;55;12;1;11;.917;3600000;0
18160;157396;872;0;0;0;0;.00nan;0;0
18160;159705;890;0;0;0;0;.00nan;0;0
18162;183905;2571;75;31;2;29;.935;3558000;0
18162;196055;945;0;0;0;0;.00nan;0;0
18162;76329;2571;0;0;0;0;.00nan;0;0
18162;146479;945;76;19;1;18;.947;3600000;0
18164;8519;978;67;31;3;28;.903;3591000;0
18164;9858;966;71;25;2;23;.920;3600000;0
18164;56306;978;0;0;0;0;.00nan;0;0
18164;157295;966;0;0;0;0;.00nan;0;0
18166;57426;879;69;17;1;16;.941;3600000;0
18166;86283;879;0;0;0;0;.00nan;0;0
18166;146445;894;0;0;0;0;.00nan;0;0
18166;157416;894;88;35;2;33;.943;3554000;0
18168;4219;874;100;17;0;17;1.000;3600000;0
18168;80596;3965;0;0;0;0;.00nan;0;0
18168;83678;874;0;0;0;0;.00nan;0;0
18168;149353;3965;72;34;3;31;.912;3600000;0
18170;4219;874;74;25;2;23;.920;3600000;0
18170;76885;897;43;10;2;8;.800;1411000;0
18170;83678;874;0;0;0;0;.00nan;0;0
18170;147492;897;20;24;6;18;.750;2189000;0
18172;9858;966;0;0;0;0;.00nan;0;0
18172;183905;2571;60;43;5;38;.884;3600000;0
18172;76329;2571;0;0;0;0;.00nan;0;0
18172;157295;966;63;13;1;12;.923;3600000;0
18174;8519;978;0;0;0;0;.00nan;0;0
18174;196055;945;79;32;2;30;.938;3600000;0
18174;56306;978;57;27;3;24;.889;3600000;0
18174;146479;945;0;0;0;0;.00nan;0;0
18176;82245;872;0;0;0;0;.00nan;0;0
18176;146445;894;81;46;4;42;.913;3591000;0
18176;157396;872;59;24;2;22;.917;3600000;0
18176;157416;894;0;0;0;0;.00nan;0;0
18178;170042;891;80;28;2;26;.929;3600000;0
18178;190831;880;66;29;3;26;.897;3590000;0
18178;86686;891;0;0;0;0;.00nan;0;0
18178;147164;880;0;0;0;0;.00nan;0;0
18180;57426;879;0;0;0;0;.00nan;0;0
18180;80596;3965;90;43;3;40;.930;3562000;0
18180;86283;879;58;18;2;16;.889;3600000;0
18180;149353;3965;0;0;0;0;.00nan;0;0
18182;7624;890;0;0;0;0;.00nan;0;0
18182;201288;957;0;0;0;0;.00nan;0;0
18182;159705;890;46;37;6;31;.838;3575000;0
18182;161128;957;49;26;4;22;.846;3600000;0
18184;7624;890;79;39;3;36;.923;3600000;0
18184;201288;957;88;17;0;17;1.000;3600000;0
18184;159705;890;0;0;0;0;.00nan;0;0
18184;161128;957;0;0;0;0;.00nan;0;0
18186;190831;880;0;0;0;0;.00nan;0;0
18186;76885;897;60;19;2;17;.895;3600000;0
18186;147164;880;67;30;3;27;.900;3554000;0
18186;147492;897;0;0;0;0;.00nan;0;0
18188;9858;966;83;27;2;25;.926;3600000;0
18188;170042;891;62;30;4;26;.867;3578000;0
18188;86686;891;0;0;0;0;.00nan;0;0
18188;157295;966;0;0;0;0;.00nan;0;0
18190;4219;874;56;19;2;17;.895;3600000;0
18190;80596;3965;25;7;3;4;.571;288000;0
18190;83678;874;0;0;0;0;.00nan;0;0
18190;149353;3965;67;33;3;30;.909;3312000;0
18192;196055;945;0;0;0;0;.00nan;0;0
18192;82245;872;84;16;0;16;1.000;3600000;0
18192;146479;945;86;32;1;31;.969;3600000;0
18192;157396;872;0;0;0;0;.00nan;0;0
18194;8519;978;87;46;3;43;.935;3900000;0
18194;56306;978;0;0;0;0;.00nan;0;0
18194;57426;879;53;23;3;20;.870;3900000;0
18194;86283;879;0;0;0;0;.00nan;0;0
18196;183905;2571;52;33;4;29;.879;3543000;0
18196;76329;2571;0;0;0;0;.00nan;0;0
18196;146445;894;63;22;2;20;.909;3600000;0
18196;157416;894;0;0;0;0;.00nan;0;0
18198;7624;890;0;0;0;0;.00nan;0;0
18198;190831;880;69;26;2;24;.923;3559000;0
18198;147164;880;0;0;0;0;.00nan;0;0
18198;159705;890;68;20;1;19;.950;3600000;0
18200;201288;957;50;23;3;20;.870;3600000;0
18200;76885;897;45;28;5;23;.821;3600000;0
18200;147492;897;0;0;0;0;.00nan;0;0
18200;161128;957;0;0;0;0;.00nan;0;0
18202;8519;978;0;0;0;0;.00nan;0;0
18202;196055;945;48;22;4;18;.818;3600000;0
18202;56306;978;88;58;5;53;.914;3600000;0
18202;146479;945;0;0;0;0;.00nan;0;0
18204;4219;874;0;0;0;0;.00nan;0;0
18204;183905;2571;77;46;4;42;.913;3600000;0
18204;76329;2571;0;0;0;0;.00nan;0;0
18204;83678;874;72;12;0;12;1.000;3600000;0
18206;170042;891;66;11;0;11;1.000;1295000;0
18206;80596;3965;64;29;3;26;.897;3600000;0
18206;86686;891;32;31;6;25;.806;2305000;0
18206;149353;3965;0;0;0;0;.00nan;0;0
18208;82245;872;34;26;6;20;.769;3095000;0
18208;146445;894;0;0;0;0;.00nan;0;0
18208;157396;872;48;9;1;8;.889;505000;0
18208;157416;894;76;32;3;29;.906;3600000;0
18210;9858;966;0;0;0;0;.00nan;0;0
18210;57426;879;0;0;0;0;.00nan;0;0
18210;86283;879;80;13;0;13;1.000;3600000;0
18210;157295;966;92;37;1;36;.973;3576000;0
18211;177124;775;0;0;0;0;.00nan;0;0
18211;180606;2197;58;26;3;23;.885;3600000;0
18211;190589;2197;0;0;0;0;.00nan;0;0
18211;146249;775;38;20;4;16;.800;3548000;0
18212;-1;1093;70;43;5;38;.884;3600000;0
18212;186234;754;65;22;2;20;.909;3600000;0
18212;68233;1093;0;0;0;0;.00nan;0;0
18212;148904;754;0;0;0;0;.00nan;0;0
18213;164456;1492;0;0;0;0;.00nan;0;0
18213;170530;1492;57;36;4;32;.889;3828000;0
18213;180738;750;63;27;3;24;.889;3828000;0
18213;-1;750;0;0;0;0;.00nan;0;0
18214;166023;1503;0;0;0;0;.00nan;0;0
18214;-1;746;0;0;0;0;.00nan;0;0
18214;142810;1503;89;26;1;25;.962;3900000;0
18214;149191;746;76;28;1;27;.964;3900000;0
18215;188815;762;0;0;0;0;.00nan;0;0
18215;201933;774;0;0;0;0;.00nan;0;0
18215;82817;762;79;31;2;29;.935;3725000;0
18215;149280;774;66;22;1;21;.955;3725000;0
18216;1756;1497;68;35;3;32;.914;3884000;0
18216;-1;4989;0;0;0;0;.00nan;0;0
18216;63529;1497;0;0;0;0;.00nan;0;0
18216;71485;4989;83;29;2;27;.931;3884000;0
18217;3165;767;0;0;0;0;.00nan;0;0
18217;11708;772;0;0;0;0;.00nan;0;0
18217;63932;772;56;30;3;27;.900;3900000;0
18217;91358;767;65;26;3;23;.885;3900000;0
18218;169680;3730;81;39;2;37;.949;3600000;0
18218;170548;2545;42;15;3;12;.800;3600000;0
18218;171113;3730;0;0;0;0;.00nan;0;0
18218;149048;2545;0;0;0;0;.00nan;0;0
18219;80222;768;52;9;1;8;.889;3600000;0
18219;81691;768;0;0;0;0;.00nan;0;0
18219;142648;769;0;0;0;0;.00nan;0;0
18219;149221;769;82;62;6;56;.903;3600000;0
18220;189264;4923;47;20;3;17;.850;3577000;0
18220;176686;4923;0;0;0;0;.00nan;0;0
18220;180606;2197;0;0;0;0;.00nan;0;0
18220;190589;2197;87;28;2;26;.929;3600000;0
18221;174858;755;0;0;0;0;.00nan;0;0
18221;175757;759;61;29;3;26;.897;3568000;0
18221;180154;755;66;25;2;23;.920;3600000;0
18221;197595;759;0;0;0;0;.00nan;0;0
18222;177124;775;81;32;2;30;.938;3701000;0
18222;174898;4924;0;0;0;0;.00nan;0;0
18222;186219;4924;70;34;3;31;.912;3701000;0
18222;146249;775;0;0;0;0;.00nan;0;0
18223;279;766;98;29;1;28;.966;3600000;0
18223;164424;3913;36;30;5;25;.833;3600000;0
18223;82711;766;0;0;0;0;.00nan;0;0
18223;148576;3913;0;0;0;0;.00nan;0;0
18224;186234;754;36;23;4;19;.826;3555000;0
18224;82817;762;0;0;0;0;.00nan;0;0
18224;94107;762;77;40;3;37;.925;3600000;0
18224;148904;754;0;0;0;0;.00nan;0;0
18225;189433;758;78;25;1;24;.960;3600000;0
18225;169680;3730;89;43;2;41;.953;3546000;0
18225;171113;3730;0;0;0;0;.00nan;0;0
18225;196374;758;0;0;0;0;.00nan;0;0
18226;3241;1093;0;0;0;0;.00nan;0;0
18226;-1;1093;82;33;2;31;.939;3594000;0
18226;201933;774;0;0;0;0;.00nan;0;0
18226;149280;774;94;32;1;31;.969;3600000;0
18227;3165;767;0;0;0;0;.00nan;0;0
18227;-1;4989;0;0;0;0;.00nan;0;0
18227;71485;4989;91;35;1;34;.971;3600000;0
18227;91358;767;49;29;4;25;.862;3600000;0
18228;1756;1497;94;40;2;38;.950;3600000;0
18228;11708;772;0;0;0;0;.00nan;0;0
18228;63529;1497;0;0;0;0;.00nan;0;0
18228;94018;772;58;32;4;28;.875;3540000;0
18229;170543;2199;52;38;5;33;.868;3600000;0
18229;170548;2545;87;27;1;26;.963;3600000;0
18229;149048;2545;0;0;0;0;.00nan;0;0
18229;149262;2199;0;0;0;0;.00nan;0;0
18230;164424;3913;92;31;1;30;.968;3600000;0
18230;67818;3721;47;24;3;21;.875;3549000;0
18230;91194;3721;0;0;0;0;.00nan;0;0
18230;148576;3913;0;0;0;0;.00nan;0;0
18231;174894;760;68;37;3;34;.919;3600000;0
18231;180606;2197;0;0;0;0;.00nan;0;0
18231;190589;2197;100;25;0;25;1.000;3600000;0
18231;149112;760;0;0;0;0;.00nan;0;0
18232;169615;911;82;34;2;32;.941;3579000;0
18232;175757;759;0;0;0;0;.00nan;0;0
18232;197595;759;73;23;1;22;.957;3600000;0
18232;93756;911;0;0;0;0;.00nan;0;0
18233;189264;4923;0;0;0;0;.00nan;0;0
18233;174898;4924;65;32;4;28;.875;3600000;0
18233;176686;4923;84;26;1;25;.962;3600000;0
18233;186219;4924;0;0;0;0;.00nan;0;0
18234;279;766;78;26;1;25;.962;3600000;0
18234;177124;775;54;22;2;20;.909;3570000;0
18234;82711;766;0;0;0;0;.00nan;0;0
18234;146249;775;0;0;0;0;.00nan;0;0
18235;189433;758;90;28;1;27;.964;3600000;0
18235;170543;2199;74;31;2;29;.935;3583000;0
18235;196374;758;0;0;0;0;.00nan;0;0
18235;149262;2199;0;0;0;0;.00nan;0;0
18236;166023;1503;86;14;0;14;1.000;3600000;0
18236;169680;3730;0;0;0;0;.00nan;0;0
18236;171113;3730;66;45;4;41;.911;3600000;0
18236;148675;1503;0;0;0;0;.00nan;0;0
18237;164456;1492;0;0;0;0;.00nan;0;0
18237;-1;4989;0;0;0;0;.00nan;0;0
18237;170530;1492;93;21;0;21;1.000;3600000;0
18237;71485;4989;74;30;2;28;.933;3564000;0
18238;11708;772;0;0;0;0;.00nan;0;0
18238;180738;750;93;17;0;17;1.000;3600000;0
18238;-1;750;0;0;0;0;.00nan;0;0
18238;94018;772;78;31;2;29;.935;3600000;0
18239;170548;2545;95;55;3;52;.945;3600000;0
18239;80222;768;60;9;1;8;.889;3600000;0
18239;81691;768;0;0;0;0;.00nan;0;0
18239;149048;2545;0;0;0;0;.00nan;0;0
18240;177124;775;41;35;6;29;.829;3548000;0
18240;67818;3721;55;28;4;24;.857;3600000;0
18240;91194;3721;0;0;0;0;.00nan;0;0
18240;146249;775;0;0;0;0;.00nan;0;0
18241;169615;911;53;19;3;16;.842;3674000;0
18241;174858;755;0;0;0;0;.00nan;0;0
18241;180154;755;96;40;2;38;.950;3674000;0
18241;93756;911;0;0;0;0;.00nan;0;0
18242;164424;3913;59;22;2;20;.909;3551000;0
18242;180606;2197;0;0;0;0;.00nan;0;0
18242;190589;2197;79;28;1;27;.964;3600000;0
18242;148576;3913;0;0;0;0;.00nan;0;0
18243;174894;760;74;24;1;23;.958;3600000;0
18243;174898;4924;0;0;0;0;.00nan;0;0
18243;186219;4924;53;23;3;20;.870;3521000;0
18243;149112;760;0;0;0;0;.00nan;0;0
18244;279;766;77;33;3;30;.909;3529000;0
18244;189264;4923;0;0;0;0;.00nan;0;0
18244;176686;4923;74;24;1;23;.958;3600000;0
18244;82711;766;0;0;0;0;.00nan;0;0
18245;1756;1497;100;28;0;28;1.000;3600000;0
18245;63529;1497;0;0;0;0;.00nan;0;0
18245;82817;762;54;28;4;24;.857;3600000;0
18245;94107;762;0;0;0;0;.00nan;0;0
18246;189433;758;32;43;8;35;.814;3600000;0
18246;196374;758;0;0;0;0;.00nan;0;0
18246;80222;768;100;24;0;24;1.000;3600000;0
18246;81691;768;0;0;0;0;.00nan;0;0
18247;166023;1503;41;21;4;17;.810;3600000;0
18247;170543;2199;75;38;3;35;.921;3600000;0
18247;148675;1503;0;0;0;0;.00nan;0;0
18247;149262;2199;0;0;0;0;.00nan;0;0
18248;201933;774;0;0;0;0;.00nan;0;0
18248;186234;754;75;20;1;19;.950;3600000;0
18248;148904;754;0;0;0;0;.00nan;0;0
18248;149280;774;74;34;2;32;.941;3571000;0
18249;-1;4989;73;28;2;26;.929;3600000;0
18249;180738;750;73;33;3;30;.909;3577000;0
18249;-1;750;0;0;0;0;.00nan;0;0
18249;71485;4989;0;0;0;0;.00nan;0;0
18250;164456;1492;0;0;0;0;.00nan;0;0
18250;11708;772;72;23;2;21;.913;3900000;0
18250;170530;1492;64;23;2;21;.913;3900000;0
18250;94018;772;0;0;0;0;.00nan;0;0
18251;169680;3730;83;43;3;40;.930;3548000;0
18251;171113;3730;0;0;0;0;.00nan;0;0
18251;-1;746;0;0;0;0;.00nan;0;0
18251;149191;746;70;27;2;25;.926;3600000;0
18252;170548;2545;54;23;3;20;.870;3600000;0
18252;142648;769;0;0;0;0;.00nan;0;0
18252;149048;2545;0;0;0;0;.00nan;0;0
18252;149221;769;57;34;5;29;.853;3581000;0
18253;189264;4923;0;0;0;0;.00nan;0;0
18253;176686;4923;98;35;2;33;.943;3600000;0
18253;67818;3721;69;37;4;33;.892;3535000;0
18253;91194;3721;0;0;0;0;.00nan;0;0
18254;164424;3913;100;33;0;33;1.000;3600000;0
18254;174898;4924;75;42;4;38;.905;3600000;0
18254;186219;4924;0;0;0;0;.00nan;0;0
18254;148576;3913;0;0;0;0;.00nan;0;0
18255;279;766;78;13;0;13;1.000;3600000;0
18255;174894;760;0;0;0;0;.00nan;0;0
18255;82711;766;0;0;0;0;.00nan;0;0
18255;149112;760;64;31;4;27;.871;3600000;0
18256;1756;1497;80;27;1;26;.963;3900000;0
18256;3241;1093;0;0;0;0;.00nan;0;0
18256;-1;1093;65;18;1;17;.944;3900000;0
18256;63529;1497;0;0;0;0;.00nan;0;0
18257;11882;758;74;16;1;15;.938;3600000;0
18257;189433;758;0;0;0;0;.00nan;0;0
18257;142648;769;0;0;0;0;.00nan;0;0
18257;149221;769;80;43;3;40;.930;3588000;0
18258;3165;767;74;27;2;25;.926;3600000;0
18258;188815;762;59;29;3;26;.897;3578000;0
18258;82817;762;0;0;0;0;.00nan;0;0
18258;91358;767;0;0;0;0;.00nan;0;0
18259;166023;1503;45;7;1;6;.857;1165000;0
18259;80222;768;70;19;1;18;.947;3600000;0
18259;81691;768;0;0;0;0;.00nan;0;0
18259;142810;1503;34;35;6;29;.829;2435000;0
18260;170543;2199;55;25;3;22;.880;3600000;0
18260;-1;746;0;0;0;0;.00nan;0;0
18260;149191;746;99;22;0;22;1.000;3600000;0
18260;149262;2199;0;0;0;0;.00nan;0;0
18261;174894;760;33;34;6;28;.824;3600000;0
18261;67818;3721;84;28;1;27;.964;3600000;0
18261;91194;3721;0;0;0;0;.00nan;0;0
18261;149112;760;0;0;0;0;.00nan;0;0
18262;175757;759;0;0;0;0;.00nan;0;0
18262;180606;2197;0;0;0;0;.00nan;0;0
18262;190589;2197;55;28;3;25;.893;3553000;0
18262;197595;759;68;21;1;20;.952;3600000;0
18263;1756;1497;100;45;1;44;.978;3600000;0
18263;201933;774;0;0;0;0;.00nan;0;0
18263;63529;1497;0;0;0;0;.00nan;0;0
18263;149280;774;64;22;2;20;.909;3546000;0
18264;188815;762;61;32;3;29;.906;3522000;0
18264;180738;750;70;17;1;16;.941;3600000;0
18264;-1;750;0;0;0;0;.00nan;0;0
18264;82817;762;0;0;0;0;.00nan;0;0
18265;3165;767;0;0;0;0;.00nan;0;0
18265;3241;1093;0;0;0;0;.00nan;0;0
18265;-1;1093;31;30;6;24;.800;3600000;0
18265;91358;767;56;27;3;24;.889;3600000;0
18266;164456;1492;0;0;0;0;.00nan;0;0
18266;170530;1492;88;38;2;36;.947;3900000;0
18266;186234;754;81;21;2;19;.905;3900000;0
18266;148904;754;0;0;0;0;.00nan;0;0
18267;166023;1503;0;0;0;0;.00nan;0;0
18267;142648;769;0;0;0;0;.00nan;0;0
18267;142810;1503;37;18;4;14;.778;3600000;0
18267;149221;769;100;39;0;39;1.000;3600000;0
18268;177124;775;0;0;0;0;.00nan;0;0
18268;170548;2545;76;26;2;24;.923;3610000;0
18268;146249;775;74;21;1;20;.952;3610000;0
18268;149048;2545;0;0;0;0;.00nan;0;0
18269;-1;746;0;0;0;0;.00nan;0;0
18269;80222;768;75;27;2;25;.926;3804000;0
18269;81691;768;0;0;0;0;.00nan;0;0
18269;149191;746;52;21;3;18;.857;3804000;0
18270;11708;772;0;0;0;0;.00nan;0;0
18270;169680;3730;42;26;4;22;.846;3600000;0
18270;171113;3730;0;0;0;0;.00nan;0;0
18270;63932;772;99;30;1;29;.967;3600000;0
18271;174858;755;90;29;1;28;.966;3600000;0
18271;180154;755;0;0;0;0;.00nan;0;0
18271;180606;2197;0;0;0;0;.00nan;0;0
18271;190589;2197;53;21;2;19;.905;3563000;0
18272;174898;4924;68;39;4;35;.897;3551000;0
18272;175757;759;0;0;0;0;.00nan;0;0
18272;186219;4924;0;0;0;0;.00nan;0;0
18272;197595;759;88;34;2;32;.941;3600000;0
18273;1756;1497;75;30;3;27;.900;3556000;0
18273;186234;754;67;22;2;20;.909;3600000;0
18273;63529;1497;0;0;0;0;.00nan;0;0
18273;148904;754;0;0;0;0;.00nan;0;0
18274;3241;1093;0;0;0;0;.00nan;0;0
18274;-1;1093;47;33;5;28;.848;3576000;0
18274;180738;750;60;22;3;19;.864;3600000;0
18274;-1;750;0;0;0;0;.00nan;0;0
18275;3165;767;87;33;2;31;.939;3900000;0
18275;201933;774;0;0;0;0;.00nan;0;0
18275;91358;767;0;0;0;0;.00nan;0;0
18275;149280;774;68;23;2;21;.913;3900000;0
18276;164456;1492;0;0;0;0;.00nan;0;0
18276;188815;762;75;36;3;33;.917;3551000;0
18276;170530;1492;78;29;2;27;.931;3600000;0
18276;82817;762;0;0;0;0;.00nan;0;0
18277;177124;775;87;40;2;38;.950;3900000;0
18277;11882;758;64;25;2;23;.920;3900000;0
18277;189433;758;0;0;0;0;.00nan;0;0
18277;146249;775;0;0;0;0;.00nan;0;0
18278;11708;772;0;0;0;0;.00nan;0;0
18278;170543;2199;79;32;3;29;.906;3600000;0
18278;63932;772;68;19;1;18;.947;3600000;0
18278;149262;2199;0;0;0;0;.00nan;0;0
18279;-1;746;0;0;0;0;.00nan;0;0
18279;142648;769;39;20;3;17;.850;1118000;0
18279;149191;746;56;18;2;16;.889;3600000;0
18279;149221;769;45;48;7;41;.854;2482000;0
18280;-1;4989;0;0;0;0;.00nan;0;0
18280;169680;3730;0;0;0;0;.00nan;0;0
18280;171113;3730;85;34;1;33;.971;3693000;0
18280;71485;4989;80;29;2;27;.931;3693000;0
18281;189264;4923;97;49;3;46;.939;3900000;0
18281;170548;2545;57;25;3;22;.880;3900000;0
18281;176686;4923;0;0;0;0;.00nan;0;0
18281;149048;2545;0;0;0;0;.00nan;0;0
18282;174858;755;0;0;0;0;.00nan;0;0
18282;174898;4924;0;0;0;0;.00nan;0;0
18282;180154;755;89;33;1;32;.970;3600000;0
18282;186219;4924;52;37;5;32;.865;3600000;0
18283;169615;911;63;20;2;18;.900;3600000;0
18283;180606;2197;0;0;0;0;.00nan;0;0
18283;190589;2197;61;36;4;32;.889;3589000;0
18283;93756;911;0;0;0;0;.00nan;0;0
18284;279;766;95;38;2;36;.947;3600000;0
18284;175757;759;44;30;5;25;.833;3600000;0
18284;197595;759;0;0;0;0;.00nan;0;0
18284;82711;766;0;0;0;0;.00nan;0;0
18285;201933;774;0;0;0;0;.00nan;0;0
18285;180738;750;71;32;3;29;.906;3600000;0
18285;-1;750;0;0;0;0;.00nan;0;0
18285;149280;774;54;30;4;26;.867;3581000;0
18286;11708;772;0;0;0;0;.00nan;0;0
18286;63932;772;90;40;3;37;.925;3600000;0
18286;80222;768;0;0;0;0;.00nan;0;0
18286;81691;768;54;23;4;19;.826;3554000;0
18287;3165;767;0;0;0;0;.00nan;0;0
18287;186234;754;77;24;1;23;.958;3600000;0
18287;91358;767;79;31;2;29;.935;3571000;0
18287;148904;754;0;0;0;0;.00nan;0;0
18288;3241;1093;0;0;0;0;.00nan;0;0
18288;164456;1492;58;46;5;41;.891;3600000;0
18288;-1;1093;66;30;2;28;.933;3600000;0
18288;170530;1492;0;0;0;0;.00nan;0;0
18289;177124;775;0;0;0;0;.00nan;0;0
18289;166023;1503;0;0;0;0;.00nan;0;0
18289;142810;1503;84;23;1;22;.957;3600000;0
18289;146249;775;67;25;2;23;.920;3545000;0
18290;-1;4989;0;0;0;0;.00nan;0;0
18290;170543;2199;0;0;0;0;.00nan;0;0
18290;71485;4989;100;35;0;35;1.000;3600000;0
18290;149262;2199;49;24;3;21;.875;3600000;0
18291;11882;758;81;25;1;24;.960;3600000;0
18291;189264;4923;0;0;0;0;.00nan;0;0
18291;189433;758;0;0;0;0;.00nan;0;0
18291;176686;4923;66;33;3;30;.909;3520000;0
18292;164424;3913;56;24;3;21;.875;3900000;0
18292;170548;2545;71;25;3;22;.880;3883000;0
18292;148576;3913;0;0;0;0;.00nan;0;0
18292;149048;2545;0;0;0;0;.00nan;0;0
18293;279;766;80;19;1;18;.947;3600000;0
18293;174858;755;0;0;0;0;.00nan;0;0
18293;180154;755;69;28;2;26;.929;3544000;0
18293;82711;766;0;0;0;0;.00nan;0;0
18294;169615;911;76;24;1;23;.958;3600000;0
18294;174898;4924;80;39;3;36;.923;3568000;0
18294;186219;4924;0;0;0;0;.00nan;0;0
18294;93756;911;0;0;0;0;.00nan;0;0
18295;175757;759;0;0;0;0;.00nan;0;0
18295;197595;759;61;31;4;27;.871;3566000;0
18295;67818;3721;66;35;3;32;.914;3600000;0
18295;91194;3721;0;0;0;0;.00nan;0;0
18296;170548;2545;0;0;0;0;.00nan;0;0
18296;174894;760;84;30;1;29;.967;3600000;0
18296;149048;2545;45;15;3;12;.800;3587000;0
18296;149112;760;0;0;0;0;.00nan;0;0
18297;180738;750;100;30;0;30;1.000;3600000;0
18297;186234;754;66;30;2;28;.933;3565000;0
18297;-1;750;0;0;0;0;.00nan;0;0
18297;148904;754;0;0;0;0;.00nan;0;0
18298;-1;4989;0;0;0;0;.00nan;0;0
18298;71485;4989;63;28;3;25;.893;3522000;0
18298;80222;768;0;0;0;0;.00nan;0;0
18298;81691;768;73;22;1;21;.955;3600000;0
18299;164456;1492;0;0;0;0;.00nan;0;0
18299;170530;1492;91;31;1;30;.968;3900000;0
18299;201933;774;0;0;0;0;.00nan;0;0
18299;149280;774;66;16;1;15;.938;3900000;0
18300;177124;775;54;29;4;25;.862;3600000;0
18300;-1;746;0;0;0;0;.00nan;0;0
18300;146249;775;0;0;0;0;.00nan;0;0
18300;149191;746;100;20;0;20;1.000;3600000;0
18301;166023;1503;0;0;0;0;.00nan;0;0
18301;189264;4923;42;33;5;28;.848;3600000;0
18301;176686;4923;0;0;0;0;.00nan;0;0
18301;142810;1503;69;25;2;23;.920;3600000;0
18302;188815;762;54;20;2;18;.900;3600000;0
18302;169680;3730;79;36;3;33;.917;3551000;0
18302;171113;3730;0;0;0;0;.00nan;0;0
18302;82817;762;0;0;0;0;.00nan;0;0
18303;11708;772;0;0;0;0;.00nan;0;0
18303;63932;772;52;31;4;27;.871;3600000;0
18303;142648;769;0;0;0;0;.00nan;0;0
18303;149221;769;97;37;1;36;.973;3600000;0
18304;164424;3913;84;40;3;37;.925;3600000;0
18304;11882;758;100;33;0;33;1.000;3600000;0
18304;189433;758;0;0;0;0;.00nan;0;0
18304;148576;3913;0;0;0;0;.00nan;0;0
18305;174858;755;0;0;0;0;.00nan;0;0
18305;180154;755;79;30;2;28;.933;3900000;0
18305;67818;3721;70;25;2;23;.920;3900000;0
18305;91194;3721;0;0;0;0;.00nan;0;0
18306;279;766;80;26;1;25;.962;3900000;0
18306;169615;911;82;31;1;30;.968;3900000;0
18306;82711;766;0;0;0;0;.00nan;0;0
18306;93756;911;0;0;0;0;.00nan;0;0
18307;11882;758;82;26;1;25;.962;3600000;0
18307;189433;758;0;0;0;0;.00nan;0;0
18307;174894;760;0;0;0;0;.00nan;0;0
18307;149112;760;85;33;2;31;.939;3558000;0
18308;1756;1497;0;0;0;0;.00nan;0;0
18308;3165;767;64;31;3;28;.903;3539000;0
18308;63529;1497;92;33;1;32;.970;3600000;0
18308;91358;767;0;0;0;0;.00nan;0;0
18309;3241;1093;90;21;0;21;1.000;3600000;0
18309;-1;1093;0;0;0;0;.00nan;0;0
18309;169680;3730;73;47;4;43;.915;3600000;0
18309;171113;3730;0;0;0;0;.00nan;0;0
18310;189264;4923;0;0;0;0;.00nan;0;0
18310;176686;4923;73;33;2;31;.939;3600000;0
18310;-1;746;0;0;0;0;.00nan;0;0
18310;149191;746;54;22;3;19;.864;3559000;0
18311;188815;762;100;25;0;25;1.000;3600000;0
18311;170543;2199;52;25;3;22;.880;3600000;0
18311;82817;762;0;0;0;0;.00nan;0;0
18311;149262;2199;0;0;0;0;.00nan;0;0
18312;-1;4989;0;0;0;0;.00nan;0;0
18312;71485;4989;72;21;1;20;.952;3600000;0
18312;142648;769;0;0;0;0;.00nan;0;0
18312;149221;769;76;32;2;30;.938;3582000;0
18313;164424;3913;0;0;0;0;.00nan;0;0
18313;166023;1503;0;0;0;0;.00nan;0;0
18313;142810;1503;86;27;1;26;.963;3600000;0
18313;148576;3913;69;26;2;24;.923;3600000;0
18314;169615;911;94;40;2;38;.950;3670000;0
18314;67818;3721;97;34;1;33;.971;3670000;0
18314;91194;3721;0;0;0;0;.00nan;0;0
18314;93756;911;0;0;0;0;.00nan;0;0
18315;166023;1503;0;0;0;0;.00nan;0;0
18315;174894;760;62;13;1;12;.923;3600000;0
18315;142810;1503;43;17;3;14;.824;3600000;0
18315;149112;760;0;0;0;0;.00nan;0;0
18316;3165;767;0;0;0;0;.00nan;0;0
18316;180738;750;53;24;3;21;.875;3567000;0
18316;-1;750;0;0;0;0;.00nan;0;0
18316;91358;767;72;34;2;32;.941;3600000;0
18317;169680;3730;78;41;4;37;.902;3600000;0
18317;171113;3730;0;0;0;0;.00nan;0;0
18317;186234;754;0;0;0;0;.00nan;0;0
18317;148904;754;89;20;0;20;1.000;3600000;0
18318;1756;1497;24;19;5;14;.737;3600000;0
18318;164456;1492;0;0;0;0;.00nan;0;0
18318;170530;1492;87;32;1;31;.969;3600000;0
18318;63529;1497;0;0;0;0;.00nan;0;0
18319;177124;775;95;50;3;47;.940;3900000;0
18319;11708;772;0;0;0;0;.00nan;0;0
18319;63932;772;52;16;3;13;.813;3900000;0
18319;146249;775;0;0;0;0;.00nan;0;0
18320;3241;1093;100;28;0;28;1.000;3600000;0
18320;-1;1093;0;0;0;0;.00nan;0;0
18320;170543;2199;80;28;1;27;.964;3544000;0
18320;149262;2199;0;0;0;0;.00nan;0;0
18321;170548;2545;66;34;3;31;.912;3600000;0
18321;175757;759;0;0;0;0;.00nan;0;0
18321;197595;759;100;32;0;32;1.000;3600000;0
18321;149048;2545;0;0;0;0;.00nan;0;0
18322;188815;762;76;34;3;31;.912;3900000;0
18322;80222;768;40;15;3;12;.800;3900000;0
18322;81691;768;0;0;0;0;.00nan;0;0
18322;82817;762;0;0;0;0;.00nan;0;0
18323;164424;3913;89;36;1;35;.972;3600000;0
18323;-1;746;0;0;0;0;.00nan;0;0
18323;148576;3913;0;0;0;0;.00nan;0;0
18323;149191;746;82;29;2;27;.931;3588000;0
18324;174898;4924;74;29;2;27;.931;3600000;0
18324;180606;2197;66;43;4;39;.907;3515000;0
18324;190589;2197;0;0;0;0;.00nan;0;0
18324;186219;4924;0;0;0;0;.00nan;0;0
18325;174894;760;46;5;1;4;.800;477000;0
18325;-1;746;0;0;0;0;.00nan;0;0
18325;149112;760;36;32;6;26;.813;3123000;0
18325;149191;746;75;31;2;29;.935;3600000;0
18326;1756;1497;49;25;4;21;.840;3600000;0
18326;180738;750;38;31;5;26;.839;3583000;0
18326;-1;750;0;0;0;0;.00nan;0;0
18326;63529;1497;0;0;0;0;.00nan;0;0
18327;170543;2199;68;52;6;46;.885;3600000;0
18327;186234;754;0;0;0;0;.00nan;0;0
18327;148904;754;63;16;1;15;.938;3600000;0
18327;149262;2199;0;0;0;0;.00nan;0;0
18328;11882;758;64;32;3;29;.906;3570000;0
18328;189433;758;0;0;0;0;.00nan;0;0
18328;175757;759;0;0;0;0;.00nan;0;0
18328;197595;759;60;18;2;16;.889;3600000;0
18329;3165;767;92;25;0;25;1.000;3900000;0
18329;164456;1492;0;0;0;0;.00nan;0;0
18329;170530;1492;96;35;0;35;1.000;3900000;0
18329;91358;767;0;0;0;0;.00nan;0;0
18330;169680;3730;52;31;4;27;.871;3600000;0
18330;171113;3730;0;0;0;0;.00nan;0;0
18330;201933;774;0;0;0;0;.00nan;0;0
18330;149280;774;80;23;1;22;.957;3600000;0
18331;177124;775;0;0;0;0;.00nan;0;0
18331;-1;4989;0;0;0;0;.00nan;0;0
18331;71485;4989;76;26;2;24;.923;3900000;0
18331;146249;775;78;30;2;28;.933;3900000;0
18332;11708;772;0;0;0;0;.00nan;0;0
18332;189264;4923;0;0;0;0;.00nan;0;0
18332;176686;4923;76;35;3;32;.914;3600000;0
18332;63932;772;100;32;0;32;1.000;3600000;0
18333;3241;1093;90;48;3;45;.938;3545000;0
18333;-1;1093;0;0;0;0;.00nan;0;0
18333;80222;768;53;14;2;12;.857;3600000;0
18333;81691;768;0;0;0;0;.00nan;0;0
18334;170548;2545;68;26;2;24;.923;3600000;0
18334;174858;755;0;0;0;0;.00nan;0;0
18334;180154;755;69;38;4;34;.895;3600000;0
18334;149048;2545;0;0;0;0;.00nan;0;0
18335;188815;762;30;22;5;17;.773;3532000;0
18335;82817;762;0;0;0;0;.00nan;0;0
18335;142648;769;0;0;0;0;.00nan;0;0
18335;149221;769;59;27;3;24;.889;3600000;0
18336;279;766;55;15;2;13;.867;3600000;0
18336;206313;2197;0;0;0;0;.00nan;0;0
18336;190589;2197;79;39;4;35;.897;3582000;0
18336;82711;766;0;0;0;0;.00nan;0;0
18337;186234;754;63;28;3;25;.893;3600000;0
18337;80222;768;83;32;2;30;.938;3600000;0
18337;81691;768;0;0;0;0;.00nan;0;0
18337;148904;754;0;0;0;0;.00nan;0;0
18338;11882;758;79;27;1;26;.963;3600000;0
18338;189433;758;0;0;0;0;.00nan;0;0
18338;174858;755;0;0;0;0;.00nan;0;0
18338;180154;755;56;34;5;29;.853;3600000;0
18339;166023;1503;64;30;3;27;.900;3561000;0
18339;175757;759;90;40;2;38;.950;3600000;0
18339;197595;759;0;0;0;0;.00nan;0;0
18339;142810;1503;0;0;0;0;.00nan;0;0
18340;170543;2199;46;35;5;30;.857;3600000;0
18340;201933;774;0;0;0;0;.00nan;0;0
18340;149262;2199;0;0;0;0;.00nan;0;0
18340;149280;774;70;32;3;29;.906;3600000;0
18341;-1;4989;58;19;2;17;.895;3600000;0
18341;189264;4923;67;30;3;27;.900;3600000;0
18341;176686;4923;0;0;0;0;.00nan;0;0
18341;71485;4989;0;0;0;0;.00nan;0;0
18342;164424;3913;99;35;1;34;.971;3600000;0
18342;11708;772;0;0;0;0;.00nan;0;0
18342;63932;772;59;40;5;35;.875;3600000;0
18342;148576;3913;0;0;0;0;.00nan;0;0
18343;3241;1093;0;0;0;0;.00nan;0;0
18343;-1;1093;54;18;2;16;.889;3600000;0
18343;142648;769;69;17;1;16;.941;1608000;0
18343;149221;769;36;31;6;25;.806;1992000;0
18344;169615;911;97;28;0;28;1.000;3600000;0
18344;170548;2545;0;0;0;0;.00nan;0;0
18344;93756;911;0;0;0;0;.00nan;0;0
18344;149048;2545;77;26;1;25;.962;3600000;0
18345;206313;2197;0;0;0;0;.00nan;0;0
18345;190589;2197;55;32;5;27;.844;3572000;0
18345;67818;3721;61;28;3;25;.893;3600000;0
18345;91194;3721;0;0;0;0;.00nan;0;0
18346;279;766;45;29;4;25;.862;3552000;0
18346;174898;4924;69;33;3;30;.909;3600000;0
18346;186219;4924;0;0;0;0;.00nan;0;0
18346;82711;766;0;0;0;0;.00nan;0;0
18347;186234;754;85;33;2;31;.939;3600000;0
18347;142648;769;0;0;0;0;.00nan;0;0
18347;148904;754;0;0;0;0;.00nan;0;0
18347;149221;769;98;67;4;63;.940;3600000;0
18348;11882;758;59;28;4;24;.857;3600000;0
18348;189433;758;0;0;0;0;.00nan;0;0
18348;169615;911;77;21;1;20;.952;3600000;0
18348;93756;911;0;0;0;0;.00nan;0;0
18349;166023;1503;0;0;0;0;.00nan;0;0
18349;174858;755;0;0;0;0;.00nan;0;0
18349;180154;755;81;33;3;30;.909;3514000;0
18349;142810;1503;72;20;1;19;.950;3600000;0
18350;201933;774;73;14;0;14;1.000;915000;0
18350;80222;768;83;24;1;23;.958;3600000;0
18350;81691;768;0;0;0;0;.00nan;0;0
18350;149280;774;26;27;6;21;.778;2685000;0
18351;177124;775;0;0;0;0;.00nan;0;0
18351;188815;762;92;40;2;38;.950;3781000;0
18351;82817;762;0;0;0;0;.00nan;0;0
18351;146249;775;74;23;1;22;.957;3781000;0
18352;164424;3913;83;24;1;23;.958;3600000;0
18352;-1;4989;0;0;0;0;.00nan;0;0
18352;71485;4989;47;23;4;19;.826;3600000;0
18352;148576;3913;0;0;0;0;.00nan;0;0
18353;11708;772;0;0;0;0;.00nan;0;0
18353;201075;760;61;36;4;32;.889;3600000;0
18353;174894;760;0;0;0;0;.00nan;0;0
18353;63932;772;61;10;1;9;.900;3600000;0
18354;175757;759;0;0;0;0;.00nan;0;0
18354;-1;746;0;0;0;0;.00nan;0;0
18354;197595;759;82;40;4;36;.900;3600000;0
18354;149191;746;70;17;1;16;.941;3600000;0
18355;174898;4924;0;0;0;0;.00nan;0;0
18355;186219;4924;61;33;3;30;.909;3600000;0
18355;67818;3721;35;17;4;13;.765;3594000;0
18355;91194;3721;0;0;0;0;.00nan;0;0
18356;166023;1503;0;0;0;0;.00nan;0;0
18356;169615;911;60;21;2;19;.905;3544000;0
18356;93756;911;0;0;0;0;.00nan;0;0
18356;142810;1503;79;28;1;27;.964;3600000;0
18357;201933;774;50;23;3;20;.870;3600000;0
18357;142648;769;0;0;0;0;.00nan;0;0
18357;149221;769;77;40;4;36;.900;3553000;0
18357;149280;774;0;0;0;0;.00nan;0;0
18358;177124;775;95;18;0;18;1.000;3600000;0
18358;3241;1093;0;0;0;0;.00nan;0;0
18358;-1;1093;66;31;3;28;.903;3600000;0
18358;146249;775;0;0;0;0;.00nan;0;0
18359;-1;4989;0;0;0;0;.00nan;0;0
18359;201075;760;76;20;1;19;.950;3600000;0
18359;174894;760;0;0;0;0;.00nan;0;0
18359;71485;4989;58;34;4;30;.882;3600000;0
18360;3165;767;70;37;4;33;.892;3600000;0
18360;170543;2199;84;23;1;22;.957;3600000;0
18360;91358;767;0;0;0;0;.00nan;0;0
18360;149262;2199;0;0;0;0;.00nan;0;0
18361;174858;755;0;0;0;0;.00nan;0;0
18361;180154;755;79;40;3;37;.925;3600000;0
18361;-1;746;0;0;0;0;.00nan;0;0
18361;149191;746;27;15;4;11;.733;3600000;0
18362;1756;1497;100;20;0;20;1.000;3600000;0
18362;169680;3730;83;31;1;30;.968;3546000;0
18362;171113;3730;0;0;0;0;.00nan;0;0
18362;63529;1497;0;0;0;0;.00nan;0;0
18363;188815;762;23;26;6;20;.769;3162000;0
18363;189264;4923;0;0;0;0;.00nan;0;0
18363;176686;4923;79;39;3;36;.923;3600000;0
18363;82817;762;40;3;1;2;.667;438000;0
18364;170548;2545;78;22;1;21;.955;3600000;0
18364;206313;2197;0;0;0;0;.00nan;0;0
18364;190589;2197;57;28;3;25;.893;3538000;0
18364;149048;2545;0;0;0;0;.00nan;0;0
18365;279;766;0;0;0;0;.00nan;0;0
18365;67818;3721;64;28;3;25;.893;3525000;0
18365;82711;766;72;23;1;22;.957;3600000;0
18365;91194;3721;0;0;0;0;.00nan;0;0
18366;3165;767;45;32;5;27;.844;3600000;0
18366;80222;768;0;0;0;0;.00nan;0;0
18366;81691;768;88;18;0;18;1.000;3600000;0
18366;91358;767;0;0;0;0;.00nan;0;0
18367;177124;775;86;32;1;31;.969;3600000;0
18367;186234;754;48;15;3;12;.800;3554000;0
18367;146249;775;0;0;0;0;.00nan;0;0
18367;148904;754;0;0;0;0;.00nan;0;0
18368;1756;1497;45;22;4;18;.818;3529000;0
18368;170543;2199;82;26;2;24;.923;3600000;0
18368;63529;1497;0;0;0;0;.00nan;0;0
18368;149262;2199;0;0;0;0;.00nan;0;0
18369;169615;911;86;28;2;26;.929;3600000;0
18369;-1;746;0;0;0;0;.00nan;0;0
18369;93756;911;0;0;0;0;.00nan;0;0
18369;149191;746;66;31;4;27;.871;3533000;0
18370;164456;1492;0;0;0;0;.00nan;0;0
18370;169680;3730;54;30;4;26;.867;3559000;0
18370;170530;1492;73;31;3;28;.903;3600000;0
18370;171113;3730;0;0;0;0;.00nan;0;0
18371;3241;1093;0;0;0;0;.00nan;0;0
18371;189264;4923;98;38;1;37;.974;3600000;0
18371;-1;1093;60;21;2;19;.905;3577000;0
18371;176686;4923;0;0;0;0;.00nan;0;0
18372;164424;3913;73;16;1;15;.938;3600000;0
18372;188815;762;71;32;3;29;.906;3543000;0
18372;82817;762;0;0;0;0;.00nan;0;0
18372;148576;3913;0;0;0;0;.00nan;0;0
18373;11882;758;95;21;0;21;1.000;3600000;0
18373;189433;758;0;0;0;0;.00nan;0;0
18373;206313;2197;0;0;0;0;.00nan;0;0
18373;190589;2197;55;39;5;34;.872;3600000;0
18374;11708;772;0;0;0;0;.00nan;0;0
18374;175757;759;82;20;1;19;.950;3600000;0
18374;197595;759;0;0;0;0;.00nan;0;0
18374;63932;772;84;30;2;28;.933;3600000;0
18375;170548;2545;91;22;0;22;1.000;3600000;0
18375;174898;4924;88;41;3;38;.927;3600000;0
18375;186219;4924;0;0;0;0;.00nan;0;0
18375;149048;2545;0;0;0;0;.00nan;0;0
18376;188815;762;60;29;4;25;.862;3573000;0
18376;201075;760;62;31;3;28;.903;3600000;0
18376;174894;760;0;0;0;0;.00nan;0;0
18376;82817;762;0;0;0;0;.00nan;0;0
18377;1756;1497;85;50;3;47;.940;3555000;0
18377;63529;1497;0;0;0;0;.00nan;0;0
18377;80222;768;0;0;0;0;.00nan;0;0
18377;81691;768;67;19;1;18;.947;3600000;0
18378;177124;775;0;0;0;0;.00nan;0;0
18378;201933;774;0;0;0;0;.00nan;0;0
18378;146249;775;65;24;2;22;.917;3600000;0
18378;149280;774;51;23;3;20;.870;3600000;0
18379;164456;1492;0;0;0;0;.00nan;0;0
18379;170530;1492;79;50;4;46;.920;3570000;0
18379;170543;2199;61;16;2;14;.875;3600000;0
18379;149262;2199;0;0;0;0;.00nan;0;0
18380;169680;3730;0;0;0;0;.00nan;0;0
18380;171113;3730;77;35;3;32;.914;3600000;0
18380;180738;750;77;18;1;17;.944;3600000;0
18380;-1;750;0;0;0;0;.00nan;0;0
18381;189264;4923;0;0;0;0;.00nan;0;0
18381;176686;4923;56;29;4;25;.862;3865000;0
18381;186234;754;55;21;3;18;.857;3865000;0
18381;148904;754;0;0;0;0;.00nan;0;0
18382;3165;767;62;32;3;29;.906;3554000;0
18382;91358;767;0;0;0;0;.00nan;0;0
18382;142648;769;0;0;0;0;.00nan;0;0
18382;149221;769;90;36;2;34;.944;3600000;0
18383;3241;1093;0;0;0;0;.00nan;0;0
18383;164424;3913;74;30;3;27;.900;3600000;0
18383;-1;1093;62;28;4;24;.857;3565000;0
18383;148576;3913;0;0;0;0;.00nan;0;0
18384;170548;2545;65;23;2;21;.913;3600000;0
18384;67818;3721;0;0;0;0;.00nan;0;0
18384;91194;3721;46;25;4;21;.840;3571000;0
18384;149048;2545;0;0;0;0;.00nan;0;0
18385;11708;772;0;0;0;0;.00nan;0;0
18385;174858;755;0;0;0;0;.00nan;0;0
18385;180154;755;100;40;1;39;.975;3900000;0
18385;63932;772;64;14;1;13;.929;3900000;0
18386;166023;1503;0;0;0;0;.00nan;0;0
18386;206313;2197;66;28;2;26;.929;3900000;0
18386;190589;2197;0;0;0;0;.00nan;0;0
18386;142810;1503;91;34;2;32;.941;3900000;0
18387;-1;4989;0;0;0;0;.00nan;0;0
18387;175757;759;0;0;0;0;.00nan;0;0
18387;197595;759;64;16;1;15;.938;3600000;0
18387;71485;4989;66;32;3;29;.906;3535000;0
18388;11882;758;50;27;4;23;.852;3587000;0
18388;189433;758;0;0;0;0;.00nan;0;0
18388;174898;4924;61;25;3;22;.880;3600000;0
18388;186219;4924;0;0;0;0;.00nan;0;0
18389;3241;1093;0;0;0;0;.00nan;0;0
18389;-1;1093;79;25;1;24;.960;3600000;0
18389;201075;760;57;28;3;25;.893;3517000;0
18389;174894;760;0;0;0;0;.00nan;0;0
18390;164456;1492;70;17;0;17;1.000;1888000;0
18390;170530;1492;51;25;4;21;.840;1712000;0
18390;80222;768;58;11;1;10;.909;3600000;0
18390;81691;768;0;0;0;0;.00nan;0;0
18391;170543;2199;0;0;0;0;.00nan;0;0
18391;180738;750;45;28;4;24;.857;3065000;0
18391;-1;750;50;2;0;2;1.000;531000;0
18391;149262;2199;70;26;2;24;.923;3600000;0
18392;3165;767;0;0;0;0;.00nan;0;0
18392;169680;3730;67;34;3;31;.912;3575000;0
18392;171113;3730;0;0;0;0;.00nan;0;0
18392;91358;767;74;26;2;24;.923;3600000;0
18393;189264;4923;81;57;5;52;.912;3600000;0
18393;176686;4923;0;0;0;0;.00nan;0;0
18393;201933;774;0;0;0;0;.00nan;0;0
18393;149280;774;90;24;1;23;.958;3600000;0
18394;1756;1497;73;25;2;23;.920;3600000;0
18394;63529;1497;0;0;0;0;.00nan;0;0
18394;142648;769;0;0;0;0;.00nan;0;0
18394;149221;769;74;56;5;51;.911;3600000;0
18395;164424;3913;79;29;1;28;.966;3600000;0
18395;186234;754;73;30;2;28;.933;3544000;0
18395;148576;3913;0;0;0;0;.00nan;0;0
18395;148904;754;0;0;0;0;.00nan;0;0
18396;11882;758;68;22;2;20;.909;3542000;0
18396;189433;758;0;0;0;0;.00nan;0;0
18396;67818;3721;90;28;1;27;.964;3600000;0
18396;91194;3721;0;0;0;0;.00nan;0;0
18397;-1;4989;0;0;0;0;.00nan;0;0
18397;174858;755;59;20;2;18;.900;3600000;0
18397;180154;755;0;0;0;0;.00nan;0;0
18397;71485;4989;73;37;3;34;.919;3548000;0
18398;206313;2197;0;0;0;0;.00nan;0;0
18398;190589;2197;70;43;5;38;.884;3600000;0
18398;-1;746;0;0;0;0;.00nan;0;0
18398;149191;746;88;33;1;32;.970;3600000;0
18399;11708;772;0;0;0;0;.00nan;0;0
18399;169615;911;0;0;0;0;.00nan;0;0
18399;63932;772;52;16;2;14;.875;3562000;0
18399;93756;911;76;26;1;25;.962;3600000;0
18400;166023;1503;0;0;0;0;.00nan;0;0
18400;174898;4924;73;26;2;24;.923;3900000;0
18400;186219;4924;0;0;0;0;.00nan;0;0
18400;142810;1503;73;23;2;21;.913;3900000;0
18401;279;766;64;24;2;22;.917;3600000;0
18401;170548;2545;12;22;7;15;.682;3144000;0
18401;82711;766;0;0;0;0;.00nan;0;0
18401;149048;2545;45;5;1;4;.800;456000;0
18402;201075;760;78;29;2;27;.931;3600000;0
18402;174894;760;0;0;0;0;.00nan;0;0
18402;186234;754;64;21;1;20;.952;3600000;0
18402;148904;754;0;0;0;0;.00nan;0;0
18403;180738;750;34;32;6;26;.813;2875000;0
18403;-1;750;42;4;1;3;.750;725000;0
18403;80222;768;78;26;1;25;.962;3600000;0
18403;81691;768;0;0;0;0;.00nan;0;0
18404;164456;1492;0;0;0;0;.00nan;0;0
18404;170530;1492;83;26;1;25;.962;3551000;0
18404;142648;769;0;0;0;0;.00nan;0;0
18404;149221;769;94;22;0;22;1.000;3600000;0
18405;164424;3913;93;35;1;34;.971;3600000;0
18405;201933;774;0;0;0;0;.00nan;0;0
18405;148576;3913;0;0;0;0;.00nan;0;0
18405;149280;774;70;29;2;27;.931;3558000;0
18406;166023;1503;0;0;0;0;.00nan;0;0
18406;67818;3721;75;24;1;23;.958;3600000;0
18406;91194;3721;0;0;0;0;.00nan;0;0
18406;142810;1503;34;21;4;17;.810;3600000;0
18407;-1;4989;0;0;0;0;.00nan;0;0
18407;169615;911;72;24;1;23;.958;3600000;0
18407;71485;4989;79;32;3;29;.906;3522000;0
18407;93756;911;0;0;0;0;.00nan;0;0
18408;174898;4924;68;30;3;27;.900;3736000;0
18408;186219;4924;0;0;0;0;.00nan;0;0
18408;-1;746;0;0;0;0;.00nan;0;0
18408;149191;746;76;28;2;26;.929;3736000;0
18409;279;766;63;31;3;28;.903;3513000;0
18409;11882;758;75;24;1;23;.958;3600000;0
18409;189433;758;0;0;0;0;.00nan;0;0
18409;82711;766;0;0;0;0;.00nan;0;0
18410;188815;762;0;0;0;0;.00nan;0;0
18410;175757;759;72;18;1;17;.944;3600000;0
18410;197595;759;0;0;0;0;.00nan;0;0
18410;82817;762;92;43;3;40;.930;3541000;0
18411;201075;760;88;53;4;49;.925;3600000;0
18411;174894;760;0;0;0;0;.00nan;0;0
18411;201933;774;0;0;0;0;.00nan;0;0
18411;149280;774;68;18;1;17;.944;3600000;0
18412;1756;1497;100;23;0;23;1.000;3600000;0
18412;189264;4923;0;0;0;0;.00nan;0;0
18412;176686;4923;94;36;2;34;.944;3600000;0
18412;63529;1497;0;0;0;0;.00nan;0;0
18413;180738;750;51;17;2;15;.882;3900000;0
18413;-1;750;0;0;0;0;.00nan;0;0
18413;142648;769;0;0;0;0;.00nan;0;0
18413;149221;769;100;41;2;39;.951;3900000;0
18414;-1;746;0;0;0;0;.00nan;0;0
18414;67818;3721;100;36;0;36;1.000;3600000;0
18414;91194;3721;0;0;0;0;.00nan;0;0
18414;149191;746;47;21;3;18;.857;3600000;0
18415;11708;772;48;16;3;13;.813;3600000;0
18415;206313;2197;0;0;0;0;.00nan;0;0
18415;190589;2197;43;29;5;24;.828;3527000;0
18415;63932;772;0;0;0;0;.00nan;0;0
18416;3241;1093;93;21;0;21;1.000;3600000;0
18416;-1;1093;0;0;0;0;.00nan;0;0
18416;175757;759;0;0;0;0;.00nan;0;0
18416;197595;759;68;28;2;26;.929;3539000;0
18417;279;766;49;29;4;25;.862;3900000;0
18417;166023;1503;0;0;0;0;.00nan;0;0
18417;82711;766;0;0;0;0;.00nan;0;0
18417;142810;1503;42;19;4;15;.789;3900000;0
18418;188815;762;57;22;3;19;.864;3589000;0
18418;174858;755;0;0;0;0;.00nan;0;0
18418;180154;755;90;25;1;24;.960;3600000;0
18418;82817;762;0;0;0;0;.00nan;0;0
18419;177124;775;83;27;1;26;.963;3600000;0
18419;1756;1497;78;30;2;28;.933;3546000;0
18419;63529;1497;0;0;0;0;.00nan;0;0
18419;146249;775;0;0;0;0;.00nan;0;0
18420;3165;767;100;31;0;31;1.000;3600000;0
18420;189264;4923;0;0;0;0;.00nan;0;0
18420;176686;4923;74;36;2;34;.944;3596000;0
18420;91358;767;0;0;0;0;.00nan;0;0
18421;164424;3913;55;27;4;23;.852;3900000;0
18421;164456;1492;0;0;0;0;.00nan;0;0
18421;170530;1492;72;38;4;34;.895;3900000;0
18421;148576;3913;0;0;0;0;.00nan;0;0
18422;175757;759;0;0;0;0;.00nan;0;0
18422;186234;754;0;0;0;0;.00nan;0;0
18422;197595;759;75;41;5;36;.878;3900000;0
18422;148904;754;50;40;5;35;.875;3900000;0
18423;-1;4989;0;0;0;0;.00nan;0;0
18423;206313;2197;64;25;3;22;.880;3600000;0
18423;190589;2197;0;0;0;0;.00nan;0;0
18423;71485;4989;31;25;5;20;.800;3523000;0
18424;11708;772;0;0;0;0;.00nan;0;0
18424;174898;4924;100;30;0;30;1.000;3600000;0
18424;186219;4924;0;0;0;0;.00nan;0;0
18424;63932;772;59;16;2;14;.875;3556000;0
18425;3241;1093;70;23;2;21;.913;3667000;0
18425;-1;1093;0;0;0;0;.00nan;0;0
18425;174858;755;0;0;0;0;.00nan;0;0
18425;180154;755;63;25;3;22;.880;3667000;0
18426;279;766;66;25;2;23;.920;3588000;0
18426;-1;746;0;0;0;0;.00nan;0;0
18426;82711;766;0;0;0;0;.00nan;0;0
18426;149191;746;77;28;1;27;.964;3600000;0
18427;188815;762;60;35;4;31;.886;3860000;0
18427;169615;911;57;28;3;25;.893;3860000;0
18427;82817;762;0;0;0;0;.00nan;0;0
18427;93756;911;0;0;0;0;.00nan;0;0
18428;1756;1497;39;16;3;13;.813;3590000;0
18428;201075;760;65;21;2;19;.905;3600000;0
18428;174894;760;0;0;0;0;.00nan;0;0
18428;63529;1497;0;0;0;0;.00nan;0;0
18429;164424;3913;82;35;2;33;.943;3900000;0
18429;180738;750;0;0;0;0;.00nan;0;0
18429;-1;750;70;20;2;18;.900;3900000;0
18429;148576;3913;0;0;0;0;.00nan;0;0
18430;11882;758;60;25;3;22;.880;3600000;0
18430;189433;758;0;0;0;0;.00nan;0;0
18430;170548;2545;61;18;2;16;.889;3600000;0
18430;149048;2545;0;0;0;0;.00nan;0;0
18431;177124;775;0;0;0;0;.00nan;0;0
18431;3165;767;66;26;2;24;.923;3548000;0
18431;91358;767;0;0;0;0;.00nan;0;0
18431;146249;775;99;38;1;37;.974;3600000;0
18432;164456;1492;56;42;5;37;.881;3600000;0
18432;189264;4923;79;26;1;25;.962;3600000;0
18432;170530;1492;0;0;0;0;.00nan;0;0
18432;176686;4923;0;0;0;0;.00nan;0;0
18433;170543;2199;73;30;2;28;.933;3563000;0
18433;80222;768;97;24;0;24;1.000;3600000;0
18433;81691;768;0;0;0;0;.00nan;0;0
18433;149262;2199;0;0;0;0;.00nan;0;0
18434;169680;3730;69;41;5;36;.878;3600000;0
18434;171113;3730;0;0;0;0;.00nan;0;0
18434;142648;769;0;0;0;0;.00nan;0;0
18434;149221;769;90;32;1;31;.969;3600000;0
18435;174858;755;0;0;0;0;.00nan;0;0
18435;180154;755;79;36;2;34;.944;3900000;0
18435;186234;754;58;15;2;13;.867;3900000;0
18435;148904;754;0;0;0;0;.00nan;0;0
18436;175757;759;41;24;4;20;.833;3600000;0
18436;201933;774;0;0;0;0;.00nan;0;0
18436;197595;759;0;0;0;0;.00nan;0;0
18436;149280;774;76;21;1;20;.952;3600000;0
18437;-1;4989;0;0;0;0;.00nan;0;0
18437;174898;4924;76;25;1;24;.960;3600000;0
18437;186219;4924;0;0;0;0;.00nan;0;0
18437;71485;4989;87;32;2;30;.938;3551000;0
18438;11708;772;0;0;0;0;.00nan;0;0
18438;63932;772;89;40;2;38;.950;3600000;0
18438;67818;3721;55;30;3;27;.900;3559000;0
18438;91194;3721;0;0;0;0;.00nan;0;0
18439;3241;1093;0;0;0;0;.00nan;0;0
18439;-1;1093;82;29;1;28;.966;3600000;0
18439;169615;911;62;28;3;25;.893;3557000;0
18439;93756;911;0;0;0;0;.00nan;0;0
18440;1756;1497;0;0;0;0;.00nan;0;0
18440;164424;3913;77;34;3;31;.912;3624000;0
18440;63529;1497;79;39;4;35;.897;3624000;0
18440;148576;3913;0;0;0;0;.00nan;0;0
18441;189264;4923;0;0;0;0;.00nan;0;0
18441;176686;4923;92;42;3;39;.929;3877000;0
18441;180738;750;80;22;3;19;.864;3900000;0
18441;-1;750;0;0;0;0;.00nan;0;0
18442;3165;767;0;0;0;0;.00nan;0;0
18442;201075;760;97;43;2;41;.953;3567000;0
18442;174894;760;0;0;0;0;.00nan;0;0
18442;91358;767;68;20;1;19;.950;3600000;0
18443;177124;775;96;29;1;28;.966;3900000;0
18443;164456;1492;0;0;0;0;.00nan;0;0
18443;170530;1492;65;16;1;15;.938;3900000;0
18443;146249;775;0;0;0;0;.00nan;0;0
18444;166023;1503;89;32;1;31;.969;3600000;0
18444;170548;2545;56;24;3;21;.875;3571000;0
18444;142810;1503;0;0;0;0;.00nan;0;0
18444;149048;2545;0;0;0;0;.00nan;0;0
18445;170543;2199;67;23;2;21;.913;3600000;0
18445;142648;769;0;0;0;0;.00nan;0;0
18445;149221;769;90;42;3;39;.929;3552000;0
18445;149262;2199;0;0;0;0;.00nan;0;0
18446;169680;3730;0;0;0;0;.00nan;0;0
18446;171113;3730;64;37;3;34;.919;3543000;0
18446;80222;768;72;26;2;24;.923;3600000;0
18446;81691;768;0;0;0;0;.00nan;0;0
18447;169615;911;94;20;0;20;1.000;3600000;0
18447;186234;754;45;21;3;18;.857;3600000;0
18447;93756;911;0;0;0;0;.00nan;0;0
18447;148904;754;0;0;0;0;.00nan;0;0
18448;174858;755;0;0;0;0;.00nan;0;0
18448;180154;755;69;44;4;40;.909;3600000;0
18448;201933;774;0;0;0;0;.00nan;0;0
18448;149280;774;82;16;0;16;1.000;3600000;0
18449;-1;4989;74;34;2;32;.941;3900000;0
18449;67818;3721;77;26;2;24;.923;3900000;0
18449;71485;4989;0;0;0;0;.00nan;0;0
18449;91194;3721;0;0;0;0;.00nan;0;0
18450;279;766;92;17;0;17;1.000;3600000;0
18450;11708;772;0;0;0;0;.00nan;0;0
18450;63932;772;74;48;5;43;.896;3600000;0
18450;82711;766;0;0;0;0;.00nan;0;0
18451;177124;775;0;0;0;0;.00nan;0;0
18451;180738;750;54;31;4;27;.871;3557000;0
18451;-1;750;0;0;0;0;.00nan;0;0
18451;146249;775;71;28;3;25;.893;3600000;0
18452;3165;767;77;29;3;26;.897;3600000;0
18452;164424;3913;63;27;2;25;.926;3600000;0
18452;91358;767;0;0;0;0;.00nan;0;0
18452;148576;3913;0;0;0;0;.00nan;0;0
18453;164456;1492;0;0;0;0;.00nan;0;0
18453;170530;1492;75;26;1;25;.962;3600000;0
18453;201075;760;49;24;4;20;.833;3600000;0
18453;174894;760;0;0;0;0;.00nan;0;0
18454;11882;758;49;27;4;23;.852;3600000;0
18454;166023;1503;0;0;0;0;.00nan;0;0
18454;189433;758;0;0;0;0;.00nan;0;0
18454;142810;1503;84;22;0;22;1.000;3600000;0
18455;188815;762;31;23;5;18;.783;3600000;0
18455;206313;2197;0;0;0;0;.00nan;0;0
18455;190589;2197;89;30;1;29;.967;3600000;0
18455;82817;762;0;0;0;0;.00nan;0;0
18456;170548;2545;82;27;1;26;.963;3600000;0
18456;-1;746;0;0;0;0;.00nan;0;0
18456;149048;2545;0;0;0;0;.00nan;0;0
18456;149191;746;55;25;3;22;.880;3546000;0
18457;169615;911;60;28;3;25;.893;3600000;0
18457;201933;774;0;0;0;0;.00nan;0;0
18457;93756;911;0;0;0;0;.00nan;0;0
18457;149280;774;51;24;4;20;.833;3591000;0
18458;279;766;65;17;1;16;.941;3600000;0
18458;-1;4989;0;0;0;0;.00nan;0;0
18458;71485;4989;65;29;2;27;.931;3600000;0
18458;82711;766;0;0;0;0;.00nan;0;0
18459;201075;760;80;37;3;34;.919;3600000;0
18459;174894;760;0;0;0;0;.00nan;0;0
18459;180738;750;47;26;4;22;.846;3548000;0
18459;-1;750;0;0;0;0;.00nan;0;0
18460;3241;1093;0;0;0;0;.00nan;0;0
18460;-1;1093;53;16;2;14;.875;3600000;0
18460;206313;2197;59;32;3;29;.906;3582000;0
18460;190589;2197;0;0;0;0;.00nan;0;0
18461;11882;758;94;42;1;41;.976;3712000;0
18461;189433;758;0;0;0;0;.00nan;0;0
18461;-1;746;91;18;0;18;1.000;3712000;0
18461;149191;746;0;0;0;0;.00nan;0;0
18462;1756;1497;62;41;4;37;.902;3524000;0
18462;175757;759;81;26;2;24;.923;3600000;0
18462;197595;759;0;0;0;0;.00nan;0;0
18462;63529;1497;0;0;0;0;.00nan;0;0
18463;188815;762;69;28;2;26;.929;3900000;0
18463;174898;4924;76;32;2;30;.938;3900000;0
18463;186219;4924;0;0;0;0;.00nan;0;0
18463;82817;762;0;0;0;0;.00nan;0;0
18464;189264;4923;0;0;0;0;.00nan;0;0
18464;170543;2199;60;38;4;34;.895;3579000;0
18464;176686;4923;96;38;2;36;.947;3600000;0
18464;149262;2199;0;0;0;0;.00nan;0;0
18465;188815;762;98;25;0;25;1.000;3600000;0
18465;67818;3721;27;21;5;16;.762;3600000;0
18465;82817;762;0;0;0;0;.00nan;0;0
18465;91194;3721;0;0;0;0;.00nan;0;0
18466;1756;1497;61;25;3;22;.880;3543000;0
18466;174858;755;0;0;0;0;.00nan;0;0
18466;180154;755;87;33;2;31;.939;3600000;0
18466;63529;1497;0;0;0;0;.00nan;0;0
18467;206313;2197;0;0;0;0;.00nan;0;0
18467;190589;2197;78;34;2;32;.941;3600000;0
18467;186234;754;82;15;0;15;1.000;3600000;0
18467;148904;754;0;0;0;0;.00nan;0;0
18468;3165;767;91;48;3;45;.938;3688000;0
18468;175757;759;0;0;0;0;.00nan;0;0
18468;197595;759;72;24;2;22;.917;3688000;0
18468;91358;767;0;0;0;0;.00nan;0;0
18469;11708;772;0;0;0;0;.00nan;0;0
18469;170548;2545;0;0;0;0;.00nan;0;0
18469;63932;772;93;25;1;24;.960;3900000;0
18469;149048;2545;93;30;1;29;.967;3900000;0
18470;3241;1093;48;26;4;22;.846;3900000;0
18470;-1;1093;0;0;0;0;.00nan;0;0
18470;174898;4924;83;41;4;37;.902;3900000;0
18470;186219;4924;0;0;0;0;.00nan;0;0
18471;177124;775;90;34;1;33;.971;3600000;0
18471;170543;2199;95;46;2;44;.957;3571000;0
18471;146249;775;0;0;0;0;.00nan;0;0
18471;149262;2199;0;0;0;0;.00nan;0;0
18472;189264;4923;75;24;1;23;.958;3600000;0
18472;169680;3730;0;0;0;0;.00nan;0;0
18472;171113;3730;88;44;2;42;.955;3574000;0
18472;176686;4923;0;0;0;0;.00nan;0;0
18473;11708;772;0;0;0;0;.00nan;0;0
18473;11882;758;60;31;4;27;.871;3572000;0
18473;189433;758;0;0;0;0;.00nan;0;0
18473;63932;772;72;22;2;20;.909;3600000;0
18474;3241;1093;0;0;0;0;.00nan;0;0
18474;-1;1093;90;29;1;28;.966;3900000;0
18474;67818;3721;0;0;0;0;.00nan;0;0
18474;91194;3721;92;39;1;38;.974;3900000;0
18475;3165;767;70;19;1;18;.947;3600000;0
18475;174858;755;0;0;0;0;.00nan;0;0
18475;180154;755;53;43;6;37;.860;3600000;0
18475;91358;767;0;0;0;0;.00nan;0;0
18476;206313;2197;100;50;2;48;.960;3600000;0
18476;201933;774;0;0;0;0;.00nan;0;0
18476;190589;2197;0;0;0;0;.00nan;0;0
18476;149280;774;72;31;3;28;.903;3582000;0
18477;1756;1497;59;27;3;24;.889;3548000;0
18477;169615;911;98;31;1;30;.968;3600000;0
18477;63529;1497;0;0;0;0;.00nan;0;0
18477;93756;911;0;0;0;0;.00nan;0;0
18478;175757;759;74;28;2;26;.929;3900000;0
18478;180738;750;73;31;2;29;.935;3900000;0
18478;-1;750;0;0;0;0;.00nan;0;0
18478;197595;759;0;0;0;0;.00nan;0;0
18479;-1;4989;0;0;0;0;.00nan;0;0
18479;170548;2545;86;19;0;19;1.000;3600000;0
18479;71485;4989;70;37;3;34;.919;3600000;0
18479;149048;2545;0;0;0;0;.00nan;0;0
18480;174898;4924;81;30;2;28;.933;3600000;0
18480;186219;4924;0;0;0;0;.00nan;0;0
18480;186234;754;70;19;1;18;.947;3600000;0
18480;148904;754;0;0;0;0;.00nan;0;0
18481;279;766;0;0;0;0;.00nan;0;0
18481;188815;762;34;30;7;23;.767;3600000;0
18481;82711;766;67;37;4;33;.892;3600000;0
18481;82817;762;0;0;0;0;.00nan;0;0
18482;170543;2199;58;17;2;15;.882;3583000;0
18482;201075;760;0;0;0;0;.00nan;0;0
18482;174894;760;88;31;1;30;.968;3600000;0
18482;149262;2199;0;0;0;0;.00nan;0;0
18483;177124;775;0;0;0;0;.00nan;0;0
18483;169680;3730;71;30;2;28;.933;3600000;0
18483;171113;3730;0;0;0;0;.00nan;0;0
18483;146249;775;78;24;1;23;.958;3600000;0
18484;189264;4923;0;0;0;0;.00nan;0;0
18484;176686;4923;77;27;1;26;.963;3600000;0
18484;142648;769;0;0;0;0;.00nan;0;0
18484;149221;769;86;41;2;39;.951;3568000;0
18485;164424;3913;83;40;3;37;.925;3600000;0
18485;80222;768;83;16;0;16;1.000;3600000;0
18485;81691;768;0;0;0;0;.00nan;0;0
18485;148576;3913;0;0;0;0;.00nan;0;0
18486;11882;758;0;0;0;0;.00nan;0;0
18486;-1;4989;54;4;0;4;1.000;289000;0
18486;189433;758;56;19;3;16;.842;3600000;0
18486;71485;4989;40;40;6;34;.850;3311000;0
18487;186234;754;100;29;0;29;1.000;3600000;0
18487;67818;3721;44;26;4;22;.846;3600000;0
18487;91194;3721;0;0;0;0;.00nan;0;0
18487;148904;754;0;0;0;0;.00nan;0;0
18488;174858;755;71;23;1;22;.957;3600000;0
18488;180154;755;0;0;0;0;.00nan;0;0
18488;180738;750;44;27;5;22;.815;3600000;0
18488;-1;750;0;0;0;0;.00nan;0;0
18489;11708;772;0;0;0;0;.00nan;0;0
18489;-1;746;76;23;1;22;.957;3600000;0
18489;63932;772;98;42;3;39;.929;3517000;0
18489;149191;746;0;0;0;0;.00nan;0;0
18490;3165;767;88;49;4;45;.918;3600000;0
18490;169615;911;0;0;0;0;.00nan;0;0
18490;91358;767;0;0;0;0;.00nan;0;0
18490;93756;911;63;17;1;16;.941;3600000;0
18491;164456;1492;0;0;0;0;.00nan;0;0
18491;170530;1492;65;29;3;26;.897;3545000;0
18491;175757;759;0;0;0;0;.00nan;0;0
18491;197595;759;78;23;2;21;.913;3600000;0
18492;174898;4924;87;43;2;41;.953;3572000;0
18492;201933;774;0;0;0;0;.00nan;0;0
18492;186219;4924;0;0;0;0;.00nan;0;0
18492;149280;774;77;24;1;23;.958;3600000;0
18493;279;766;50;20;4;16;.800;3600000;0
18493;3241;1093;50;8;1;7;.875;1089000;0
18493;-1;1093;24;25;6;19;.760;2511000;0
18493;82711;766;0;0;0;0;.00nan;0;0
18494;169680;3730;0;0;0;0;.00nan;0;0
18494;171113;3730;87;32;1;31;.969;3900000;0
18494;201075;760;96;36;1;35;.972;3900000;0
18494;174894;760;0;0;0;0;.00nan;0;0
18495;177124;775;54;34;4;30;.882;3566000;0
18495;142648;769;0;0;0;0;.00nan;0;0
18495;146249;775;0;0;0;0;.00nan;0;0
18495;149221;769;64;25;3;22;.880;3600000;0
18496;189264;4923;79;34;2;32;.941;3600000;0
18496;176686;4923;0;0;0;0;.00nan;0;0
18496;80222;768;93;16;0;16;1.000;3600000;0
18496;81691;768;0;0;0;0;.00nan;0;0
18497;164424;3913;79;20;1;19;.950;3600000;0
18497;170543;2199;57;41;4;37;.902;3600000;0
18497;148576;3913;0;0;0;0;.00nan;0;0
18497;149262;2199;0;0;0;0;.00nan;0;0
18498;201933;774;0;0;0;0;.00nan;0;0
18498;67818;3721;82;32;1;31;.969;3900000;0
18498;91194;3721;0;0;0;0;.00nan;0;0
18498;149280;774;79;25;1;24;.960;3900000;0
18499;164456;1492;0;0;0;0;.00nan;0;0
18499;170530;1492;76;29;2;27;.931;3600000;0
18499;174858;755;0;0;0;0;.00nan;0;0
18499;180154;755;40;25;4;21;.840;3544000;0
18500;11708;772;0;0;0;0;.00nan;0;0
18500;166023;1503;0;0;0;0;.00nan;0;0
18500;63932;772;70;25;2;23;.920;3900000;0
18500;142810;1503;81;30;2;28;.933;3900000;0
18501;-1;4989;0;0;0;0;.00nan;0;0
18501;-1;746;0;0;0;0;.00nan;0;0
18501;71485;4989;95;42;1;41;.976;3595000;0
18501;149191;746;72;11;0;11;1.000;3600000;0
18502;169615;911;28;24;6;18;.750;3600000;0
18502;180738;750;78;23;1;22;.957;3600000;0
18502;-1;750;0;0;0;0;.00nan;0;0
18502;93756;911;0;0;0;0;.00nan;0;0
18503;279;766;59;44;5;39;.886;3600000;0
18503;186234;754;52;18;2;16;.889;3600000;0
18503;82711;766;0;0;0;0;.00nan;0;0
18503;148904;754;0;0;0;0;.00nan;0;0
18504;201075;760;51;23;3;20;.870;3600000;0
18504;174894;760;0;0;0;0;.00nan;0;0
18504;142648;769;0;0;0;0;.00nan;0;0
18504;149221;769;55;31;4;27;.871;3600000;0
18505;177124;775;0;0;0;0;.00nan;0;0
18505;80222;768;75;22;1;21;.955;3600000;0
18505;81691;768;0;0;0;0;.00nan;0;0
18505;146249;775;74;40;3;37;.925;3519000;0
18506;164424;3913;68;17;2;15;.882;3600000;0
18506;169680;3730;91;49;3;46;.939;3600000;0
18506;171113;3730;0;0;0;0;.00nan;0;0
18506;148576;3913;0;0;0;0;.00nan;0;0
18507;1756;1497;79;45;4;41;.911;3900000;0
18507;174898;4924;55;33;4;29;.879;3900000;0
18507;186219;4924;0;0;0;0;.00nan;0;0
18507;63529;1497;0;0;0;0;.00nan;0;0
18508;3165;767;0;0;0;0;.00nan;0;0
18508;206313;2197;0;0;0;0;.00nan;0;0
18508;190589;2197;48;44;5;39;.886;3584000;0
18508;91358;767;36;19;4;15;.789;3600000;0
18509;166023;1503;0;0;0;0;.00nan;0;0
18509;190570;4989;97;41;1;40;.976;3568000;0
18509;71485;4989;0;0;0;0;.00nan;0;0
18509;142810;1503;100;29;0;29;1.000;3600000;0
18510;164456;1492;0;0;0;0;.00nan;0;0
18510;169615;911;79;28;1;27;.964;3600000;0
18510;170530;1492;74;39;3;36;.923;3600000;0
18510;93756;911;0;0;0;0;.00nan;0;0
18511;279;766;83;33;2;31;.939;3585000;0
18511;201933;774;0;0;0;0;.00nan;0;0
18511;82711;766;0;0;0;0;.00nan;0;0
18511;149280;774;90;21;0;21;1.000;3600000;0
18512;201075;760;97;38;2;36;.947;3511000;0
18512;174894;760;0;0;0;0;.00nan;0;0
18512;80222;768;75;13;0;13;1.000;3600000;0
18512;81691;768;0;0;0;0;.00nan;0;0
18513;177124;775;54;24;3;21;.875;3600000;0
18513;189264;4923;0;0;0;0;.00nan;0;0
18513;176686;4923;54;46;6;40;.870;3600000;0
18513;146249;775;0;0;0;0;.00nan;0;0
18514;3241;1093;0;0;0;0;.00nan;0;0
18514;11882;758;86;30;2;28;.933;3900000;0
18514;-1;1093;75;21;2;19;.905;3900000;0
18514;189433;758;0;0;0;0;.00nan;0;0
18515;188815;762;0;0;0;0;.00nan;0;0
18515;170548;2545;50;31;5;26;.839;3600000;0
18515;82817;762;93;20;0;20;1.000;3600000;0
18515;149048;2545;0;0;0;0;.00nan;0;0
18516;164424;3913;29;27;6;21;.778;3514000;0
18516;142648;769;0;0;0;0;.00nan;0;0
18516;148576;3913;0;0;0;0;.00nan;0;0
18516;149221;769;67;37;4;33;.892;3600000;0
18517;1756;1497;100;26;0;26;1.000;3600000;0
18517;206313;2197;76;47;4;43;.915;3600000;0
18517;190589;2197;0;0;0;0;.00nan;0;0
18517;63529;1497;0;0;0;0;.00nan;0;0
18518;174898;4924;72;50;5;45;.900;3600000;0
18518;180738;750;70;6;0;6;1.000;3600000;0
18518;186219;4924;0;0;0;0;.00nan;0;0
18518;-1;750;0;0;0;0;.00nan;0;0
18519;3165;767;0;0;0;0;.00nan;0;0
18519;67818;3721;61;29;3;26;.897;3600000;0
18519;91194;3721;0;0;0;0;.00nan;0;0
18519;91358;767;100;30;0;30;1.000;3600000;0
18520;170543;2199;0;0;0;0;.00nan;0;0
18520;175757;759;0;0;0;0;.00nan;0;0
18520;197595;759;58;11;1;10;.909;3600000;0
18520;149262;2199;84;37;2;35;.946;3595000;0
18521;186234;754;0;0;0;0;.00nan;0;0
18521;-1;746;0;0;0;0;.00nan;0;0
18521;148904;754;92;37;2;35;.946;3600000;0
18521;149191;746;60;35;4;31;.886;3570000;0
18522;3241;1093;66;41;5;36;.878;3600000;0
18522;-1;1093;0;0;0;0;.00nan;0;0
18522;170548;2545;81;30;1;29;.967;3600000;0
18522;149048;2545;0;0;0;0;.00nan;0;0
18523;11882;758;97;42;3;39;.929;3600000;0
18523;188815;762;0;0;0;0;.00nan;0;0
18523;189433;758;0;0;0;0;.00nan;0;0
18523;82817;762;55;22;4;18;.818;3542000;0
18524;1756;1497;92;33;1;32;.970;3600000;0
18524;63529;1497;0;0;0;0;.00nan;0;0
18524;67818;3721;58;21;3;18;.857;3513000;0
18524;91194;3721;0;0;0;0;.00nan;0;0
18525;206313;2197;0;0;0;0;.00nan;0;0
18525;180738;750;86;14;0;14;1.000;3600000;0
18525;190589;2197;70;37;3;34;.919;3600000;0
18525;-1;750;0;0;0;0;.00nan;0;0
18526;279;766;54;30;4;26;.867;3600000;0
18526;3165;767;0;0;0;0;.00nan;0;0
18526;82711;766;0;0;0;0;.00nan;0;0
18526;91358;767;81;33;3;30;.909;3600000;0
18527;164456;1492;0;0;0;0;.00nan;0;0
18527;170530;1492;49;20;3;17;.850;3542000;0
18527;174898;4924;76;27;1;26;.963;3600000;0
18527;186219;4924;0;0;0;0;.00nan;0;0
18528;170543;2199;59;27;3;24;.889;3600000;0
18528;174858;755;0;0;0;0;.00nan;0;0
18528;180154;755;49;26;4;22;.846;3565000;0
18528;149262;2199;0;0;0;0;.00nan;0;0
18529;169680;3730;99;33;1;32;.970;3600000;0
18529;171113;3730;0;0;0;0;.00nan;0;0
18529;175757;759;63;29;3;26;.897;3600000;0
18529;197595;759;0;0;0;0;.00nan;0;0
18530;170548;2545;69;36;3;33;.917;3600000;0
18530;186234;754;14;14;5;9;.643;1128000;0
18530;148904;754;63;11;1;10;.909;2472000;0
18530;149048;2545;0;0;0;0;.00nan;0;0
18531;11882;758;50;27;4;23;.852;3600000;0
18531;189433;758;0;0;0;0;.00nan;0;0
18531;201933;774;0;0;0;0;.00nan;0;0
18531;149280;774;82;24;1;23;.958;3600000;0
18532;177124;775;0;0;0;0;.00nan;0;0
18532;201075;760;82;23;1;22;.957;3600000;0
18532;174894;760;0;0;0;0;.00nan;0;0
18532;146249;775;45;23;3;20;.870;3578000;0
18533;3241;1093;0;0;0;0;.00nan;0;0
18533;-1;1093;79;39;3;36;.923;3561000;0
18533;-1;746;0;0;0;0;.00nan;0;0
18533;149191;746;75;27;2;25;.926;3600000;0
18534;188815;762;100;38;1;37;.974;3600000;0
18534;166023;1503;0;0;0;0;.00nan;0;0
18534;82817;762;0;0;0;0;.00nan;0;0
18534;142810;1503;45;16;2;14;.875;3549000;0
18535;279;766;52;34;4;30;.882;3537000;0
18535;1756;1497;0;0;0;0;.00nan;0;0
18535;63529;1497;68;24;2;22;.917;3600000;0
18535;82711;766;0;0;0;0;.00nan;0;0
18536;180738;750;100;21;0;21;1.000;3600000;0
18536;-1;750;0;0;0;0;.00nan;0;0
18536;67818;3721;98;35;1;34;.971;3578000;0
18536;91194;3721;0;0;0;0;.00nan;0;0
18537;3165;767;0;0;0;0;.00nan;0;0
18537;174898;4924;0;0;0;0;.00nan;0;0
18537;186219;4924;100;35;1;34;.971;3900000;0
18537;91358;767;85;27;1;26;.963;3900000;0
18538;164456;1492;81;45;3;42;.933;3546000;0
18538;170530;1492;0;0;0;0;.00nan;0;0
18538;206313;2197;0;0;0;0;.00nan;0;0
18538;190589;2197;82;26;1;25;.962;3600000;0
18539;11708;772;0;0;0;0;.00nan;0;0
18539;190570;4989;78;32;2;30;.938;3590000;0
18539;63932;772;62;17;1;16;.941;3600000;0
18539;71485;4989;0;0;0;0;.00nan;0;0
18540;169615;911;26;26;6;20;.769;3859000;0
18540;170543;2199;58;38;5;33;.868;3875000;0
18540;93756;911;0;0;0;0;.00nan;0;0
18540;149262;2199;0;0;0;0;.00nan;0;0
18541;169680;3730;0;0;0;0;.00nan;0;0
18541;171113;3730;84;36;2;34;.944;3809000;0
18541;174858;755;0;0;0;0;.00nan;0;0
18541;180154;755;62;19;1;18;.947;3809000;0
18542;175757;759;0;0;0;0;.00nan;0;0
18542;197595;759;60;21;2;19;.905;3600000;0
18542;142648;769;55;38;5;33;.868;3600000;0
18542;149221;769;0;0;0;0;.00nan;0;0
18543;11882;758;65;32;3;29;.906;3573000;0
18543;189433;758;0;0;0;0;.00nan;0;0
18543;186234;754;0;0;0;0;.00nan;0;0
18543;148904;754;68;22;1;21;.955;3600000;0
18544;170548;2545;55;32;4;28;.875;3576000;0
18544;201933;774;0;0;0;0;.00nan;0;0
18544;149048;2545;0;0;0;0;.00nan;0;0
18544;149280;774;69;24;2;22;.917;3600000;0
18545;177124;775;86;16;0;16;1.000;3600000;0
18545;164424;3913;53;18;2;16;.889;3516000;0
18545;146249;775;0;0;0;0;.00nan;0;0
18545;148576;3913;0;0;0;0;.00nan;0;0
18546;3241;1093;0;0;0;0;.00nan;0;0
18546;166023;1503;0;0;0;0;.00nan;0;0
18546;-1;1093;93;32;1;31;.969;3900000;0
18546;142810;1503;96;30;1;29;.967;3900000;0
18547;189264;4923;60;26;3;23;.885;3600000;0
18547;201075;760;0;0;0;0;.00nan;0;0
18547;174894;760;62;42;4;38;.905;3600000;0
18547;176686;4923;0;0;0;0;.00nan;0;0
18548;188815;762;65;46;5;41;.891;3600000;0
18548;-1;746;0;0;0;0;.00nan;0;0
18548;82817;762;0;0;0;0;.00nan;0;0
18548;149191;746;42;19;4;15;.789;3600000;0
18549;279;766;69;31;3;28;.903;3600000;0
18549;180738;750;56;19;2;17;.895;3600000;0
18549;-1;750;0;0;0;0;.00nan;0;0
18549;82711;766;0;0;0;0;.00nan;0;0
18550;175757;759;0;0;0;0;.00nan;0;0
18550;197595;759;76;42;4;38;.905;3600000;0
18550;80222;768;72;20;1;19;.950;3600000;0
18550;81691;768;0;0;0;0;.00nan;0;0
18551;164456;1492;0;0;0;0;.00nan;0;0
18551;170530;1492;99;37;1;36;.973;3600000;0
18551;67818;3721;49;18;3;15;.833;3538000;0
18551;91194;3721;0;0;0;0;.00nan;0;0
18552;169615;911;60;13;1;12;.923;3600000;0
18552;169680;3730;93;44;2;42;.955;3594000;0
18552;171113;3730;0;0;0;0;.00nan;0;0
18552;93756;911;0;0;0;0;.00nan;0;0
18553;174858;755;0;0;0;0;.00nan;0;0
18553;180154;755;58;20;2;18;.900;3600000;0
18553;142648;769;0;0;0;0;.00nan;0;0
18553;149221;769;65;29;3;26;.897;3592000;0
18554;166023;1503;0;0;0;0;.00nan;0;0
18554;186234;754;68;23;2;21;.913;3552000;0
18554;142810;1503;78;26;1;25;.962;3600000;0
18554;148904;754;0;0;0;0;.00nan;0;0
18555;201933;774;0;0;0;0;.00nan;0;0
18555;-1;746;0;0;0;0;.00nan;0;0
18555;149191;746;76;34;3;31;.912;3573000;0
18555;149280;774;84;36;2;34;.944;3600000;0
18556;164424;3913;40;23;4;19;.826;3600000;0
18556;189264;4923;77;47;3;44;.936;3600000;0
18556;176686;4923;0;0;0;0;.00nan;0;0
18556;148576;3913;0;0;0;0;.00nan;0;0
18557;174858;755;0;0;0;0;.00nan;0;0
18557;180154;755;93;53;4;49;.925;3600000;0
18557;80222;768;82;11;0;11;1.000;3600000;0
18557;81691;768;0;0;0;0;.00nan;0;0
18558;279;766;43;17;3;14;.824;3900000;0
18558;164456;1492;0;0;0;0;.00nan;0;0
18558;170530;1492;68;35;3;32;.914;3900000;0
18558;82711;766;0;0;0;0;.00nan;0;0
18559;169615;911;95;25;1;24;.960;3600000;0
18559;93756;911;0;0;0;0;.00nan;0;0
18559;142648;769;0;0;0;0;.00nan;0;0
18559;149221;769;65;41;5;36;.878;3600000;0
18560;164424;3913;85;32;2;30;.938;3900000;0
18560;201075;760;0;0;0;0;.00nan;0;0
18560;174894;760;78;31;2;29;.935;3900000;0
18560;148576;3913;0;0;0;0;.00nan;0;0
18561;166023;1503;0;0;0;0;.00nan;0;0
18561;201933;774;0;0;0;0;.00nan;0;0
18561;142810;1503;61;32;3;29;.906;3587000;0
18561;149280;774;66;18;1;17;.944;3600000;0
18562;169615;911;69;28;2;26;.929;3652000;0
18562;80222;768;94;27;1;26;.963;3652000;0
18562;81691;768;0;0;0;0;.00nan;0;0
18562;93756;911;0;0;0;0;.00nan;0;0
18563;3241;1093;0;0;0;0;.00nan;0;0
18563;-1;1093;79;40;3;37;.925;3600000;0
18563;190570;4989;91;19;0;19;1.000;3600000;0
18563;71485;4989;0;0;0;0;.00nan;0;0
18564;177124;775;96;41;2;39;.951;3600000;0
18564;175757;759;0;0;0;0;.00nan;0;0
18564;197595;759;55;40;5;35;.875;3600000;0
18564;146249;775;0;0;0;0;.00nan;0;0
18565;170543;2199;75;33;2;31;.939;3600000;0
18565;174898;4924;85;26;1;25;.962;3600000;0
18565;186219;4924;0;0;0;0;.00nan;0;0
18565;149262;2199;0;0;0;0;.00nan;0;0
18566;1756;1497;77;28;2;26;.929;3623000;0
18566;11882;758;62;24;3;21;.875;3623000;0
18566;189433;758;0;0;0;0;.00nan;0;0
18566;63529;1497;0;0;0;0;.00nan;0;0
18567;180738;750;36;15;4;11;.733;1023000;0
18567;-1;750;54;27;3;24;.889;2517000;0
18567;-1;746;0;0;0;0;.00nan;0;0
18567;149191;746;32;20;5;15;.750;3600000;0
18568;3165;767;86;28;1;27;.964;3765000;0
18568;170548;2545;86;34;2;32;.941;3765000;0
18568;91358;767;0;0;0;0;.00nan;0;0
18568;149048;2545;0;0;0;0;.00nan;0;0
18569;169680;3730;57;35;4;31;.886;3600000;0
18569;171113;3730;0;0;0;0;.00nan;0;0
18569;67818;3721;71;28;2;26;.929;3600000;0
18569;91194;3721;0;0;0;0;.00nan;0;0
18570;177124;775;62;14;2;12;.857;3600000;0
18570;174858;755;0;0;0;0;.00nan;0;0
18570;180154;755;93;49;3;46;.939;3600000;0
18570;146249;775;0;0;0;0;.00nan;0;0
18571;188815;762;57;35;4;31;.886;3564000;0
18571;190570;4989;60;27;3;24;.889;3600000;0
18571;71485;4989;0;0;0;0;.00nan;0;0
18571;82817;762;0;0;0;0;.00nan;0;0
18572;170543;2199;59;20;2;18;.900;3600000;0
18572;206313;2197;0;0;0;0;.00nan;0;0
18572;190589;2197;70;32;3;29;.906;3572000;0
18572;149262;2199;0;0;0;0;.00nan;0;0
18573;3241;1093;0;0;0;0;.00nan;0;0
18573;11708;772;0;0;0;0;.00nan;0;0
18573;-1;1093;65;26;3;23;.885;3586000;0
18573;63932;772;76;28;2;26;.929;3600000;0
18574;189264;4923;17;13;5;8;.615;980000;0
18574;175757;759;70;26;2;24;.923;3600000;0
18574;176686;4923;97;33;0;33;1.000;2620000;0
18574;197595;759;0;0;0;0;.00nan;0;0
18575;174898;4924;0;0;0;0;.00nan;0;0
18575;186219;4924;100;29;0;29;1.000;3600000;0
18575;142648;769;0;0;0;0;.00nan;0;0
18575;149221;769;52;33;4;29;.879;3600000;0
18576;3165;767;0;0;0;0;.00nan;0;0
18576;11882;758;28;13;4;9;.692;1106000;0
18576;189433;758;57;28;4;24;.857;2494000;0
18576;91358;767;45;28;4;24;.857;3600000;0
18577;166023;1503;0;0;0;0;.00nan;0;0
18577;180738;750;94;38;2;36;.947;3600000;0
18577;-1;750;0;0;0;0;.00nan;0;0
18577;142810;1503;25;21;5;16;.762;3600000;0
18578;1756;1497;75;38;3;35;.921;3557000;0
18578;-1;746;0;0;0;0;.00nan;0;0
18578;63529;1497;0;0;0;0;.00nan;0;0
18578;149191;746;77;23;1;22;.957;3600000;0
18579;164456;1492;0;0;0;0;.00nan;0;0
18579;170530;1492;97;45;2;43;.956;3529000;0
18579;170548;2545;0;0;0;0;.00nan;0;0
18579;149048;2545;88;21;0;21;1.000;3600000;0
18580;170543;2199;63;25;2;23;.920;3615000;0
18580;67818;3721;69;22;1;21;.955;3615000;0
18580;91194;3721;0;0;0;0;.00nan;0;0
18580;149262;2199;0;0;0;0;.00nan;0;0
18581;189264;4923;0;0;0;0;.00nan;0;0
18581;174858;755;0;0;0;0;.00nan;0;0
18581;176686;4923;91;38;2;36;.947;3600000;0
18581;180154;755;52;21;3;18;.857;3551000;0
18582;201933;774;0;0;0;0;.00nan;0;0
18582;190570;4989;88;36;3;33;.917;3600000;0
18582;71485;4989;0;0;0;0;.00nan;0;0
18582;149280;774;96;12;0;12;1.000;3600000;0
18583;206313;2197;71;24;3;21;.875;3900000;0
18583;190589;2197;0;0;0;0;.00nan;0;0
18583;142648;769;0;0;0;0;.00nan;0;0
18583;149221;769;81;42;3;39;.929;3900000;0
18584;11708;772;0;0;0;0;.00nan;0;0
18584;188815;762;72;35;4;31;.886;3900000;0
18584;63932;772;49;25;4;21;.840;3900000;0
18584;82817;762;0;0;0;0;.00nan;0;0
18585;177124;775;58;49;6;43;.878;3600000;0
18585;169615;911;100;36;0;36;1.000;3600000;0
18585;93756;911;0;0;0;0;.00nan;0;0
18585;146249;775;0;0;0;0;.00nan;0;0
18586;201075;760;91;35;2;33;.943;3600000;0
18586;174894;760;0;0;0;0;.00nan;0;0
18586;175757;759;0;0;0;0;.00nan;0;0
18586;197595;759;79;33;3;30;.909;3581000;0
18587;174898;4924;0;0;0;0;.00nan;0;0
18587;186219;4924;87;33;2;31;.939;3514000;0
18587;80222;768;100;29;0;29;1.000;3600000;0
18587;81691;768;0;0;0;0;.00nan;0;0
18588;279;766;0;0;0;0;.00nan;0;0
18588;169680;3730;100;38;1;37;.974;3900000;0
18588;171113;3730;0;0;0;0;.00nan;0;0
18588;82711;766;79;24;1;23;.958;3900000;0
18589;164456;1492;0;0;0;0;.00nan;0;0
18589;11882;758;82;30;2;28;.933;3649000;0
18589;189433;758;0;0;0;0;.00nan;0;0
18589;170530;1492;82;31;3;28;.903;3649000;0
18590;1756;1497;67;21;2;19;.905;3600000;0
18590;166023;1503;52;23;3;20;.870;3591000;0
18590;63529;1497;0;0;0;0;.00nan;0;0
18590;142810;1503;0;0;0;0;.00nan;0;0
18591;3165;767;72;38;3;35;.921;3600000;0
18591;-1;746;0;0;0;0;.00nan;0;0
18591;91358;767;0;0;0;0;.00nan;0;0
18591;149191;746;89;26;1;25;.962;3600000;0
18592;170548;2545;0;0;0;0;.00nan;0;0
18592;180738;750;70;27;2;25;.926;3600000;0
18592;-1;750;0;0;0;0;.00nan;0;0
18592;149048;2545;97;29;0;29;1.000;3600000;0
18593;67818;3721;0;0;0;0;.00nan;0;0
18593;91194;3721;69;21;2;19;.905;3600000;0
18593;142648;769;0;0;0;0;.00nan;0;0
18593;149221;769;72;29;3;26;.897;3569000;0
18594;201075;760;55;26;4;22;.846;3567000;0
18594;174858;755;0;0;0;0;.00nan;0;0
18594;174894;760;0;0;0;0;.00nan;0;0
18594;180154;755;66;29;3;26;.897;3600000;0
18595;190570;4989;78;33;2;31;.939;3600000;0
18595;186234;754;45;17;3;14;.824;3547000;0
18595;71485;4989;0;0;0;0;.00nan;0;0
18595;148904;754;0;0;0;0;.00nan;0;0
18596;206313;2197;0;0;0;0;.00nan;0;0
18596;190589;2197;55;41;5;36;.878;3600000;0
18596;80222;768;100;26;0;26;1.000;3600000;0
18596;81691;768;0;0;0;0;.00nan;0;0
18597;11708;772;0;0;0;0;.00nan;0;0
18597;201933;774;0;0;0;0;.00nan;0;0
18597;63932;772;86;45;3;42;.933;3595000;0
18597;149280;774;63;20;2;18;.900;3600000;0
18598;189264;4923;62;44;5;39;.886;3600000;0
18598;169615;911;67;16;1;15;.938;3600000;0
18598;176686;4923;0;0;0;0;.00nan;0;0
18598;93756;911;0;0;0;0;.00nan;0;0
18599;164424;3913;66;31;3;28;.903;3600000;0
18599;175757;759;100;39;0;39;1.000;3600000;0
18599;197595;759;0;0;0;0;.00nan;0;0
18599;148576;3913;0;0;0;0;.00nan;0;0
18600;169680;3730;96;33;1;32;.970;3600000;0
18600;171113;3730;0;0;0;0;.00nan;0;0
18600;174898;4924;51;22;3;19;.864;3587000;0
18600;186219;4924;0;0;0;0;.00nan;0;0
18601;279;766;66;19;1;18;.947;3854000;0
18601;170543;2199;86;39;2;37;.949;3854000;0
18601;82711;766;0;0;0;0;.00nan;0;0
18601;149262;2199;0;0;0;0;.00nan;0;0
18602;11882;758;63;33;4;29;.879;3600000;0
18602;189433;758;0;0;0;0;.00nan;0;0
18602;180738;750;92;26;1;25;.962;3600000;0
18602;-1;750;0;0;0;0;.00nan;0;0
18603;3165;767;0;0;0;0;.00nan;0;0
18603;166023;1503;0;0;0;0;.00nan;0;0
18603;91358;767;62;37;5;32;.865;3600000;0
18603;142810;1503;90;27;1;26;.963;3600000;0
18604;164456;1492;0;0;0;0;.00nan;0;0
18604;170530;1492;85;44;3;41;.932;3560000;0
18604;-1;746;0;0;0;0;.00nan;0;0
18604;149191;746;68;17;1;16;.941;3600000;0
18605;1756;1497;80;27;2;25;.926;3600000;0
18605;170548;2545;0;0;0;0;.00nan;0;0
18605;63529;1497;0;0;0;0;.00nan;0;0
18605;149048;2545;58;29;3;26;.897;3586000;0
18606;67818;3721;72;31;2;29;.935;3652000;0
18606;80222;768;67;29;3;26;.897;3652000;0
18606;81691;768;0;0;0;0;.00nan;0;0
18606;91194;3721;0;0;0;0;.00nan;0;0
18607;164424;3913;67;27;3;24;.889;3600000;0
18607;174858;755;58;6;0;6;1.000;590000;0
18607;180154;755;27;28;6;22;.786;3010000;0
18607;148576;3913;0;0;0;0;.00nan;0;0
18608;169680;3730;100;29;0;29;1.000;3600000;0
18608;171113;3730;0;0;0;0;.00nan;0;0
18608;206313;2197;70;24;1;23;.958;3561000;0
18608;190589;2197;0;0;0;0;.00nan;0;0
18609;11708;772;0;0;0;0;.00nan;0;0
18609;186234;754;0;0;0;0;.00nan;0;0
18609;63932;772;47;31;4;27;.871;3581000;0
18609;148904;754;71;31;3;28;.903;3600000;0
18610;169615;911;79;23;1;22;.957;3600000;0
18610;201075;760;0;0;0;0;.00nan;0;0
18610;174894;760;39;29;5;24;.828;3600000;0
18610;93756;911;0;0;0;0;.00nan;0;0
18611;279;766;79;21;1;20;.952;3600000;0
18611;82711;766;0;0;0;0;.00nan;0;0
18611;142648;769;0;0;0;0;.00nan;0;0
18611;149221;769;92;43;2;41;.953;3582000;0
18612;164456;1492;0;0;0;0;.00nan;0;0
18612;166023;1503;0;0;0;0;.00nan;0;0
18612;170530;1492;66;42;4;38;.905;3600000;0
18612;142810;1503;57;14;1;13;.929;3600000;0
18613;3241;1093;0;0;0;0;.00nan;0;0
18613;188815;762;50;25;4;21;.840;3900000;0
18613;-1;1093;58;28;4;24;.857;3900000;0
18613;82817;762;0;0;0;0;.00nan;0;0
18614;164424;3913;78;41;4;37;.902;3600000;0
18614;169615;911;33;30;6;24;.800;3520000;0
18614;93756;911;0;0;0;0;.00nan;0;0
18614;148576;3913;0;0;0;0;.00nan;0;0
18615;177124;775;21;22;6;16;.727;3600000;0
18615;189264;4923;0;0;0;0;.00nan;0;0
18615;176686;4923;54;26;3;23;.885;3600000;0
18615;146249;775;0;0;0;0;.00nan;0;0
18616;279;766;0;0;0;0;.00nan;0;0
18616;80222;768;47;24;4;20;.833;3600000;0
18616;81691;768;0;0;0;0;.00nan;0;0
18616;82711;766;55;40;5;35;.875;3570000;0
18617;1756;1497;39;26;5;21;.808;3542000;0
18617;11882;758;60;29;3;26;.897;3600000;0
18617;189433;758;0;0;0;0;.00nan;0;0
18617;63529;1497;0;0;0;0;.00nan;0;0
18618;180738;750;92;33;1;32;.970;3600000;0
18618;-1;750;0;0;0;0;.00nan;0;0
18618;-1;746;0;0;0;0;.00nan;0;0
18618;149191;746;60;20;2;18;.900;3566000;0
18619;201933;774;0;0;0;0;.00nan;0;0
18619;190570;4989;79;46;4;42;.913;3600000;0
18619;71485;4989;0;0;0;0;.00nan;0;0
18619;149280;774;68;16;1;15;.938;3600000;0
18620;201075;760;100;30;0;30;1.000;3600000;0
18620;174858;755;0;0;0;0;.00nan;0;0
18620;174894;760;0;0;0;0;.00nan;0;0
18620;180154;755;65;25;2;23;.920;3570000;0
18621;170543;2199;0;0;0;0;.00nan;0;0
18621;67818;3721;41;22;4;18;.818;3600000;0
18621;91194;3721;0;0;0;0;.00nan;0;0
18621;149262;2199;88;28;1;27;.964;3600000;0
18622;169680;3730;100;25;0;25;1.000;3600000;0
18622;171113;3730;0;0;0;0;.00nan;0;0
18622;174898;4924;48;25;4;21;.840;3600000;0
18622;186219;4924;0;0;0;0;.00nan;0;0
18623;189264;4923;52;44;6;38;.864;3600000;0
18623;175757;759;67;26;3;23;.885;3600000;0
18623;176686;4923;0;0;0;0;.00nan;0;0
18623;197595;759;0;0;0;0;.00nan;0;0
18624;206313;2197;0;0;0;0;.00nan;0;0
18624;190589;2197;92;39;2;37;.949;3900000;0
18624;142648;769;73;24;2;22;.917;3900000;0
18624;149221;769;0;0;0;0;.00nan;0;0
18625;1756;1497;61;38;4;34;.895;3600000;0
18625;170548;2545;66;15;1;14;.933;3600000;0
18625;63529;1497;0;0;0;0;.00nan;0;0
18625;149048;2545;0;0;0;0;.00nan;0;0
18626;11882;758;64;25;2;23;.920;3600000;0
18626;189433;758;0;0;0;0;.00nan;0;0
18626;180738;750;53;22;3;19;.864;3558000;0
18626;-1;750;0;0;0;0;.00nan;0;0
18627;190570;4989;39;29;5;24;.828;3573000;0
18627;186234;754;60;26;3;23;.885;3600000;0
18627;71485;4989;0;0;0;0;.00nan;0;0
18627;148904;754;0;0;0;0;.00nan;0;0
18628;3165;767;79;22;1;21;.955;3600000;0
18628;166023;1503;48;10;1;9;.900;2486000;0
18628;91358;767;0;0;0;0;.00nan;0;0
18628;142810;1503;7;8;5;3;.375;1114000;0
18629;164456;1492;74;31;2;29;.935;3580000;0
18629;170530;1492;0;0;0;0;.00nan;0;0
18629;-1;746;0;0;0;0;.00nan;0;0
18629;149191;746;90;17;0;17;1.000;3600000;0
18630;11708;772;0;0;0;0;.00nan;0;0
18630;201933;774;0;0;0;0;.00nan;0;0
18630;63932;772;65;30;3;27;.900;3600000;0
18630;149280;774;100;26;0;26;1.000;3600000;0
18631;169615;911;48;20;3;17;.850;3600000;0
18631;201075;760;84;45;4;41;.911;3600000;0
18631;174894;760;0;0;0;0;.00nan;0;0
18631;93756;911;0;0;0;0;.00nan;0;0
18632;206313;2197;23;24;6;18;.750;1501000;0
18632;190589;2197;79;26;1;25;.962;2099000;0
18632;80222;768;0;0;0;0;.00nan;0;0
18632;81691;768;71;8;0;8;1.000;3600000;0
18633;177124;775;87;20;0;20;1.000;3600000;0
18633;175757;759;0;0;0;0;.00nan;0;0
18633;197595;759;68;24;2;22;.917;3600000;0
18633;146249;775;0;0;0;0;.00nan;0;0
18634;279;766;51;26;3;23;.885;3900000;0
18634;170543;2199;81;45;3;42;.933;3900000;0
18634;82711;766;0;0;0;0;.00nan;0;0
18634;149262;2199;0;0;0;0;.00nan;0;0
18635;169680;3730;83;28;1;27;.964;3600000;0
18635;171113;3730;0;0;0;0;.00nan;0;0
18635;67818;3721;55;23;3;20;.870;3569000;0
18635;91194;3721;0;0;0;0;.00nan;0;0
18636;174898;4924;0;0;0;0;.00nan;0;0
18636;186219;4924;86;35;3;32;.914;3600000;0
18636;142648;769;0;0;0;0;.00nan;0;0
18636;149221;769;58;41;5;36;.878;3551000;0
18637;164424;3913;0;0;0;0;.00nan;0;0
18637;174858;755;0;0;0;0;.00nan;0;0
18637;180154;755;86;40;2;38;.950;3525000;0
18637;148576;3913;82;11;0;11;1.000;3600000;0
18638;1756;1497;0;0;0;0;.00nan;0;0
18638;166023;1503;51;7;1;6;.857;1364000;0
18638;63529;1497;56;27;4;23;.852;3600000;0
18638;142810;1503;27;27;6;21;.778;2236000;0
18639;170548;2545;0;0;0;0;.00nan;0;0
18639;180738;750;64;22;2;20;.909;3600000;0
18639;-1;750;0;0;0;0;.00nan;0;0
18639;149048;2545;42;27;6;21;.778;3600000;0
18640;11708;772;0;0;0;0;.00nan;0;0
18640;186234;754;0;0;0;0;.00nan;0;0
18640;63932;772;59;26;3;23;.885;3900000;0
18640;148904;754;80;42;3;39;.929;3900000;0
18641;3165;767;0;0;0;0;.00nan;0;0
18641;-1;746;0;0;0;0;.00nan;0;0
18641;91358;767;47;37;5;32;.865;3900000;0
18641;149191;746;47;26;5;21;.808;3900000;0
18642;164456;1492;0;0;0;0;.00nan;0;0
18642;11882;758;71;24;2;22;.917;3600000;0
18642;189433;758;0;0;0;0;.00nan;0;0
18642;170530;1492;76;33;3;30;.909;3561000;0
18643;188815;762;41;17;3;14;.824;3513000;0
18643;190570;4989;99;43;1;42;.977;3600000;0
18643;71485;4989;0;0;0;0;.00nan;0;0
18643;82817;762;0;0;0;0;.00nan;0;0
18644;201075;760;0;0;0;0;.00nan;0;0
18644;174894;760;82;29;1;28;.966;3573000;0
18644;175757;759;100;25;0;25;1.000;3600000;0
18644;197595;759;0;0;0;0;.00nan;0;0
18645;174898;4924;0;0;0;0;.00nan;0;0
18645;186219;4924;98;44;2;42;.955;3569000;0
18645;80222;768;0;0;0;0;.00nan;0;0
18645;81691;768;63;15;1;14;.933;3600000;0
18646;170543;2199;58;14;1;13;.929;3600000;0
18646;206313;2197;0;0;0;0;.00nan;0;0
18646;190589;2197;41;33;5;28;.848;3600000;0
18646;149262;2199;0;0;0;0;.00nan;0;0
18647;279;766;75;20;1;19;.950;3600000;0
18647;169680;3730;72;35;3;32;.914;3597000;0
18647;171113;3730;0;0;0;0;.00nan;0;0
18647;82711;766;0;0;0;0;.00nan;0;0
18648;189264;4923;0;0;0;0;.00nan;0;0
18648;174858;755;0;0;0;0;.00nan;0;0
18648;176686;4923;76;25;2;23;.920;3900000;0
18648;180154;755;71;24;2;22;.917;3900000;0
18649;67818;3721;64;17;1;16;.941;3600000;0
18649;91194;3721;0;0;0;0;.00nan;0;0
18649;142648;769;0;0;0;0;.00nan;0;0
18649;149221;769;50;34;5;29;.853;3600000;0
18650;164424;3913;0;0;0;0;.00nan;0;0
18650;169615;911;83;30;2;28;.933;3594000;0
18650;93756;911;0;0;0;0;.00nan;0;0
18650;148576;3913;93;29;1;28;.966;3600000;0
18651;1756;1497;89;32;2;30;.938;3600000;0
18651;-1;746;0;0;0;0;.00nan;0;0
18651;63529;1497;0;0;0;0;.00nan;0;0
18651;149191;746;38;15;3;12;.800;3556000;0
18652;166023;1503;0;0;0;0;.00nan;0;0
18652;180738;750;0;0;0;0;.00nan;0;0
18652;-1;750;51;26;4;22;.846;3558000;0
18652;142810;1503;52;28;3;25;.893;3600000;0
18653;3165;767;77;27;1;26;.963;3900000;0
18653;11882;758;70;29;2;27;.931;3900000;0
18653;189433;758;0;0;0;0;.00nan;0;0
18653;91358;767;0;0;0;0;.00nan;0;0
18654;164456;1492;0;0;0;0;.00nan;0;0
18654;170530;1492;53;38;6;32;.842;3600000;0
18654;170548;2545;49;30;5;25;.833;3600000;0
18654;149048;2545;0;0;0;0;.00nan;0;0
18655;3241;1093;60;19;2;17;.895;3600000;0
18655;-1;1093;0;0;0;0;.00nan;0;0
18655;190570;4989;78;39;3;36;.923;3583000;0
18655;71485;4989;0;0;0;0;.00nan;0;0
18656;11708;772;0;0;0;0;.00nan;0;0
18656;188815;762;63;26;3;23;.885;3600000;0
18656;63932;772;90;39;2;37;.949;3600000;0
18656;82817;762;0;0;0;0;.00nan;0;0
18657;67818;3721;88;45;2;43;.956;3569000;0
18657;80222;768;61;12;1;11;.917;3600000;0
18657;81691;768;0;0;0;0;.00nan;0;0
18657;91194;3721;0;0;0;0;.00nan;0;0
18658;177124;775;54;15;2;13;.867;3551000;0
18658;174858;755;0;0;0;0;.00nan;0;0
18658;180154;755;91;35;1;34;.971;3600000;0
18658;146249;775;0;0;0;0;.00nan;0;0
18659;170543;2199;95;21;0;21;1.000;3600000;0
18659;174898;4924;0;0;0;0;.00nan;0;0
18659;186219;4924;75;28;1;27;.964;3548000;0
18659;149262;2199;0;0;0;0;.00nan;0;0
18660;169680;3730;84;37;2;35;.946;3600000;0
18660;171113;3730;0;0;0;0;.00nan;0;0
18660;206313;2197;51;23;3;20;.870;3587000;0
18660;190589;2197;0;0;0;0;.00nan;0;0
18661;189264;4923;68;42;4;38;.905;3600000;0
18661;169615;911;85;26;1;25;.962;3600000;0
18661;176686;4923;0;0;0;0;.00nan;0;0
18661;93756;911;0;0;0;0;.00nan;0;0
18662;279;766;59;16;2;14;.875;3600000;0
18662;82711;766;0;0;0;0;.00nan;0;0
18662;142648;769;0;0;0;0;.00nan;0;0
18662;149221;769;69;32;3;29;.906;3600000;0
18663;164424;3913;80;32;2;30;.938;3600000;0
18663;175757;759;89;19;0;19;1.000;3600000;0
18663;197595;759;0;0;0;0;.00nan;0;0
18663;148576;3913;0;0;0;0;.00nan;0;0
18664;3165;767;0;0;0;0;.00nan;0;0
18664;170548;2545;78;34;2;32;.941;3900000;0
18664;91358;767;100;42;2;40;.952;3900000;0
18664;149048;2545;0;0;0;0;.00nan;0;0
18665;164456;1492;0;0;0;0;.00nan;0;0
18665;166023;1503;0;0;0;0;.00nan;0;0
18665;170530;1492;68;36;4;32;.889;3561000;0
18665;142810;1503;47;21;3;18;.857;3600000;0
18666;3241;1093;0;0;0;0;.00nan;0;0
18666;11708;772;0;0;0;0;.00nan;0;0
18666;-1;1093;69;37;3;34;.919;3585000;0
18666;63932;772;71;18;1;17;.944;3600000;0
18667;279;766;93;38;2;36;.947;3541000;0
18667;80222;768;82;14;0;14;1.000;3600000;0
18667;81691;768;0;0;0;0;.00nan;0;0
18667;82711;766;0;0;0;0;.00nan;0;0
18668;177124;775;43;28;4;24;.857;3573000;0
18668;169615;911;69;34;3;31;.912;3600000;0
18668;93756;911;0;0;0;0;.00nan;0;0
18668;146249;775;0;0;0;0;.00nan;0;0
18669;164424;3913;75;26;2;24;.923;3900000;0
18669;201075;760;93;39;2;37;.949;3900000;0
18669;174894;760;0;0;0;0;.00nan;0;0
18669;148576;3913;0;0;0;0;.00nan;0;0
18670;11882;758;0;0;0;0;.00nan;0;0
18670;189433;758;94;35;1;34;.971;3600000;0
18670;201933;774;0;0;0;0;.00nan;0;0
18670;149280;774;63;21;2;19;.905;3600000;0
18671;186234;754;49;30;4;26;.867;3543000;0
18671;-1;746;0;0;0;0;.00nan;0;0
18671;148904;754;0;0;0;0;.00nan;0;0
18671;149191;746;47;21;3;18;.857;3600000;0
18672;180738;750;70;22;2;20;.909;3600000;0
18672;-1;750;0;0;0;0;.00nan;0;0
18672;67818;3721;61;37;4;33;.892;3575000;0
18672;91194;3721;0;0;0;0;.00nan;0;0
18673;174858;755;67;31;3;28;.903;3553000;0
18673;180154;755;0;0;0;0;.00nan;0;0
18673;142648;769;0;0;0;0;.00nan;0;0
18673;149221;769;75;30;2;28;.933;3600000;0
18674;169680;3730;91;40;3;37;.925;3600000;0
18674;170543;2199;84;22;2;20;.909;3600000;0
18674;171113;3730;0;0;0;0;.00nan;0;0
18674;149262;2199;0;0;0;0;.00nan;0;0
18675;1756;1497;79;22;1;21;.955;3600000;0
18675;206313;2197;0;0;0;0;.00nan;0;0
18675;190589;2197;87;41;3;38;.927;3594000;0
18675;63529;1497;0;0;0;0;.00nan;0;0
18676;3241;1093;0;0;0;0;.00nan;0;0
18676;11882;758;42;26;4;22;.846;3600000;0
18676;-1;1093;96;18;0;18;1.000;3600000;0
18676;189433;758;0;0;0;0;.00nan;0;0
18677;166023;1503;0;0;0;0;.00nan;0;0
18677;186234;754;0;0;0;0;.00nan;0;0
18677;142810;1503;49;22;3;19;.864;3664000;0
18677;148904;754;91;34;2;32;.941;3664000;0
18678;201933;774;0;0;0;0;.00nan;0;0
18678;-1;746;0;0;0;0;.00nan;0;0
18678;149191;746;65;22;2;20;.909;3600000;0
18678;149280;774;45;26;4;22;.846;3560000;0
18679;188815;762;84;40;2;38;.950;3600000;0
18679;170548;2545;72;24;1;23;.958;3600000;0
18679;82817;762;0;0;0;0;.00nan;0;0
18679;149048;2545;0;0;0;0;.00nan;0;0
18680;189264;4923;0;0;0;0;.00nan;0;0
18680;201075;760;0;0;0;0;.00nan;0;0
18680;174894;760;91;26;1;25;.962;3600000;0
18680;176686;4923;76;30;3;27;.900;3568000;0
18681;3165;767;61;36;3;33;.917;3598000;0
18681;67818;3721;88;33;2;31;.939;3600000;0
18681;91194;3721;0;0;0;0;.00nan;0;0
18681;91358;767;0;0;0;0;.00nan;0;0
18682;174858;755;0;0;0;0;.00nan;0;0
18682;180154;755;100;38;0;38;1.000;3600000;0
18682;80222;768;45;12;2;10;.833;3537000;0
18682;81691;768;0;0;0;0;.00nan;0;0
18683;164456;1492;0;0;0;0;.00nan;0;0
18683;170530;1492;86;28;1;27;.964;3900000;0
18683;206313;2197;69;22;1;21;.955;3900000;0
18683;190589;2197;0;0;0;0;.00nan;0;0
18684;169615;911;0;0;0;0;.00nan;0;0
18684;93756;911;53;12;2;10;.833;3600000;0
18684;142648;769;0;0;0;0;.00nan;0;0
18684;149221;769;66;36;3;33;.917;3582000;0
18685;1756;1497;68;35;3;32;.914;3600000;0
18685;174898;4924;93;21;0;21;1.000;3600000;0
18685;186219;4924;0;0;0;0;.00nan;0;0
18685;63529;1497;0;0;0;0;.00nan;0;0
18686;279;766;0;0;0;0;.00nan;0;0
18686;180738;750;57;21;3;18;.857;3725000;0
18686;-1;750;0;0;0;0;.00nan;0;0
18686;82711;766;73;45;4;41;.911;3725000;0
18687;11882;758;61;20;2;18;.900;3600000;0
18687;188815;762;40;30;5;25;.833;3600000;0
18687;189433;758;0;0;0;0;.00nan;0;0
18687;82817;762;0;0;0;0;.00nan;0;0
18688;166023;1503;74;21;1;20;.952;3600000;0
18688;201933;774;0;0;0;0;.00nan;0;0
18688;142810;1503;0;0;0;0;.00nan;0;0
18688;149280;774;52;13;2;11;.846;3534000;0
18689;11708;772;57;9;1;8;.889;3546000;0
18689;190570;4989;100;38;0;38;1.000;3600000;0
18689;63932;772;0;0;0;0;.00nan;0;0
18689;71485;4989;0;0;0;0;.00nan;0;0
18690;3241;1093;0;0;0;0;.00nan;0;0
18690;-1;1093;59;34;5;29;.853;3531000;0
18690;-1;746;39;17;3;14;.824;3600000;0
18690;149191;746;0;0;0;0;.00nan;0;0
18691;170548;2545;80;31;2;29;.935;3600000;0
18691;186234;754;76;26;2;24;.923;2474000;0
18691;148904;754;29;10;4;6;.600;1126000;0
18691;149048;2545;0;0;0;0;.00nan;0;0
18692;177124;775;64;22;2;20;.909;3600000;0
18692;201075;760;77;37;3;34;.919;3551000;0
18692;174894;760;0;0;0;0;.00nan;0;0
18692;146249;775;0;0;0;0;.00nan;0;0
18693;1756;1497;59;33;4;29;.879;3600000;0
18693;63529;1497;0;0;0;0;.00nan;0;0
18693;67818;3721;39;35;6;29;.829;3576000;0
18693;91194;3721;0;0;0;0;.00nan;0;0
18694;170543;2199;74;30;3;27;.900;3600000;0
18694;174858;755;0;0;0;0;.00nan;0;0
18694;180154;755;60;32;4;28;.875;3543000;0
18694;149262;2199;0;0;0;0;.00nan;0;0
18695;206313;2197;0;0;0;0;.00nan;0;0
18695;180738;750;71;23;2;21;.913;3682000;0
18695;190589;2197;73;35;3;32;.914;3682000;0
18695;-1;750;0;0;0;0;.00nan;0;0
18696;169615;911;51;41;6;35;.854;3600000;0
18696;80222;768;52;14;2;12;.857;3600000;0
18696;81691;768;0;0;0;0;.00nan;0;0
18696;93756;911;0;0;0;0;.00nan;0;0
18697;175757;759;52;22;3;19;.864;3556000;0
18697;197595;759;0;0;0;0;.00nan;0;0
18697;142648;769;0;0;0;0;.00nan;0;0
18697;149221;769;87;37;2;35;.946;3600000;0
18698;164456;1492;0;0;0;0;.00nan;0;0
18698;170530;1492;83;49;4;45;.918;3597000;0
18698;174898;4924;47;20;3;17;.850;3600000;0
18698;186219;4924;0;0;0;0;.00nan;0;0
18699;279;766;87;28;1;27;.964;3900000;0
18699;3165;767;0;0;0;0;.00nan;0;0
18699;82711;766;0;0;0;0;.00nan;0;0
18699;91358;767;99;39;1;38;.974;3900000;0
18700;164424;3913;55;27;3;24;.889;3573000;0
18700;189264;4923;94;43;2;41;.953;3600000;0
18700;176686;4923;0;0;0;0;.00nan;0;0
18700;148576;3913;0;0;0;0;.00nan;0;0
18701;11882;758;0;0;0;0;.00nan;0;0
18701;189433;758;73;23;1;22;.957;3600000;0
18701;186234;754;0;0;0;0;.00nan;0;0
18701;148904;754;65;23;2;21;.913;3543000;0
18702;3241;1093;0;0;0;0;.00nan;0;0
18702;166023;1503;0;0;0;0;.00nan;0;0
18702;-1;1093;69;29;2;27;.931;3553000;0
18702;142810;1503;100;28;0;28;1.000;3600000;0
18703;188815;762;48;47;7;40;.851;3341000;0
18703;-1;746;0;0;0;0;.00nan;0;0
18703;82817;762;51;2;0;2;1.000;259000;0
18703;149191;746;46;17;3;14;.824;3600000;0
18704;170548;2545;100;39;1;38;.974;3900000;0
18704;201933;774;0;0;0;0;.00nan;0;0
18704;149048;2545;0;0;0;0;.00nan;0;0
18704;149280;774;80;23;1;22;.957;3900000;0
18705;164456;1492;0;0;0;0;.00nan;0;0
18705;170530;1492;93;43;2;41;.953;3600000;0
18705;67818;3721;40;21;5;16;.762;3600000;0
18705;91194;3721;0;0;0;0;.00nan;0;0
18706;169680;3730;84;31;1;30;.968;3600000;0
18706;171113;3730;0;0;0;0;.00nan;0;0
18706;174858;755;0;0;0;0;.00nan;0;0
18706;180154;755;43;32;5;27;.844;3600000;0
18707;3165;767;62;25;2;23;.920;3600000;0
18707;206313;2197;0;0;0;0;.00nan;0;0
18707;190589;2197;92;32;1;31;.969;3600000;0
18707;91358;767;0;0;0;0;.00nan;0;0
18708;169615;911;69;26;1;25;.962;3600000;0
18708;170543;2199;56;26;3;23;.885;3514000;0
18708;93756;911;0;0;0;0;.00nan;0;0
18708;149262;2199;0;0;0;0;.00nan;0;0
18709;175757;759;0;0;0;0;.00nan;0;0
18709;197595;759;97;42;2;40;.952;3598000;0
18709;80222;768;71;18;1;17;.944;3600000;0
18709;81691;768;0;0;0;0;.00nan;0;0
18710;180738;750;78;19;1;18;.947;3600000;0
18710;186219;4924;86;39;2;37;.949;3568000;0
18710;-1;750;0;0;0;0;.00nan;0;0
18710;63529;4924;0;0;0;0;.00nan;0;0
18711;279;766;67;31;3;28;.903;3600000;0
18711;1756;1497;100;24;0;24;1.000;3600000;0
18711;67446;1497;0;0;0;0;.00nan;0;0
18711;82711;766;0;0;0;0;.00nan;0;0
18712;177124;775;100;40;1;39;.975;3600000;0
18712;164424;3913;50;16;2;14;.875;3600000;0
18712;146249;775;0;0;0;0;.00nan;0;0
18712;148576;3913;0;0;0;0;.00nan;0;0
18713;188815;762;61;26;3;23;.885;3600000;0
18713;166023;1503;0;0;0;0;.00nan;0;0
18713;82817;762;0;0;0;0;.00nan;0;0
18713;142810;1503;59;21;2;19;.905;3600000;0
18714;3241;1093;0;0;0;0;.00nan;0;0
18714;-1;1093;100;28;0;28;1.000;3600000;0
18714;170548;2545;70;23;2;21;.913;3515000;0
18714;149048;2545;0;0;0;0;.00nan;0;0
18715;169615;911;73;21;1;20;.952;3600000;0
18715;169680;3730;61;49;5;44;.898;3600000;0
18715;171113;3730;0;0;0;0;.00nan;0;0
18715;93756;911;0;0;0;0;.00nan;0;0
18716;170543;2199;78;29;2;27;.931;3600000;0
18716;175757;759;55;24;3;21;.875;3555000;0
18716;197595;759;0;0;0;0;.00nan;0;0
18716;149262;2199;0;0;0;0;.00nan;0;0
18717;3165;767;0;0;0;0;.00nan;0;0
18717;186219;4924;0;0;0;0;.00nan;0;0
18717;63529;4924;60;24;2;22;.917;3552000;0
18717;91358;767;66;13;1;12;.923;3600000;0
18718;279;766;65;21;2;19;.905;3900000;0
18718;164456;1492;0;0;0;0;.00nan;0;0
18718;170530;1492;85;39;2;37;.949;3900000;0
18718;82711;766;0;0;0;0;.00nan;0;0
18719;190570;4989;88;42;2;40;.952;3515000;0
18719;-1;746;0;0;0;0;.00nan;0;0
18719;71485;4989;0;0;0;0;.00nan;0;0
18719;149191;746;87;14;0;14;1.000;3600000;0
18720;11708;772;0;0;0;0;.00nan;0;0
18720;11882;758;57;19;2;17;.895;3586000;0
18720;189433;758;0;0;0;0;.00nan;0;0
18720;63932;772;81;23;1;22;.957;3600000;0
18721;174858;755;0;0;0;0;.00nan;0;0
18721;180154;755;91;54;4;50;.926;3600000;0
18721;180738;750;85;24;1;23;.958;3600000;0
18721;-1;750;0;0;0;0;.00nan;0;0
18722;186234;754;0;0;0;0;.00nan;0;0
18722;67818;3721;78;32;4;28;.875;3725000;0
18722;91194;3721;0;0;0;0;.00nan;0;0
18722;148904;754;57;23;3;20;.870;3725000;0
18723;201075;760;84;49;5;44;.898;3600000;0
18723;174894;760;0;0;0;0;.00nan;0;0
18723;80222;768;0;0;0;0;.00nan;0;0
18723;81691;768;69;5;0;5;1.000;3600000;0
18724;206313;2197;0;0;0;0;.00nan;0;0
18724;201933;774;48;14;2;12;.857;3900000;0
18724;190589;2197;69;26;2;24;.923;3900000;0
18724;149280;774;0;0;0;0;.00nan;0;0
18725;169680;3730;89;55;3;52;.945;3558000;0
18725;171113;3730;0;0;0;0;.00nan;0;0
18725;175757;759;0;0;0;0;.00nan;0;0
18725;197595;759;77;29;2;27;.931;3600000;0
18726;164424;3913;100;29;0;29;1.000;3600000;0
18726;142648;769;0;0;0;0;.00nan;0;0
18726;148576;3913;0;0;0;0;.00nan;0;0
18726;149221;769;50;41;6;35;.854;3600000;0
18727;11882;758;74;23;1;22;.957;3600000;0
18727;189433;758;0;0;0;0;.00nan;0;0
18727;190570;4989;62;20;2;18;.900;3600000;0
18727;71485;4989;0;0;0;0;.00nan;0;0
18728;11708;772;0;0;0;0;.00nan;0;0
18728;-1;746;0;0;0;0;.00nan;0;0
18728;63932;772;56;36;5;31;.861;3600000;0
18728;149191;746;67;30;2;28;.933;3600000;0
18729;169615;911;78;26;1;25;.962;3900000;0
18729;180738;750;76;20;1;19;.950;3900000;0
18729;-1;750;0;0;0;0;.00nan;0;0
18729;93756;911;0;0;0;0;.00nan;0;0
18730;206313;2197;42;40;6;34;.850;3081000;0
18730;190589;2197;61;10;0;10;1.000;497000;0
18730;186234;754;0;0;0;0;.00nan;0;0
18730;148904;754;38;21;4;17;.810;3600000;0
18731;164424;3913;88;57;5;52;.912;3600000;0
18731;80222;768;0;0;0;0;.00nan;0;0
18731;81691;768;67;24;2;22;.917;3600000;0
18731;148576;3913;0;0;0;0;.00nan;0;0
18732;164456;1492;0;0;0;0;.00nan;0;0
18732;170530;1492;63;19;2;17;.895;3900000;0
18732;174858;755;0;0;0;0;.00nan;0;0
18732;180154;755;72;25;2;23;.920;3900000;0
18733;279;766;84;26;1;25;.962;3584000;0
18733;201933;774;0;0;0;0;.00nan;0;0
18733;82711;766;0;0;0;0;.00nan;0;0
18733;149280;774;85;14;0;14;1.000;3600000;0
18734;170543;2199;0;0;0;0;.00nan;0;0
18734;201075;760;87;28;1;27;.964;3600000;0
18734;174894;760;0;0;0;0;.00nan;0;0
18734;149262;2199;37;24;4;20;.833;3600000;0
18735;3241;1093;0;0;0;0;.00nan;0;0
18735;-1;1093;79;20;1;19;.950;3600000;0
18735;67818;3721;26;27;6;21;.778;2540000;0
18735;91194;3721;58;4;0;4;1.000;1060000;0
18736;188815;762;0;0;0;0;.00nan;0;0
18736;186219;4924;0;0;0;0;.00nan;0;0
18736;63529;4924;91;28;1;27;.964;3600000;0
18736;82817;762;20;34;7;27;.794;3600000;0
18737;189264;4923;0;0;0;0;.00nan;0;0
18737;176686;4923;92;31;1;30;.968;3561000;0
18737;142648;769;0;0;0;0;.00nan;0;0
18737;149221;769;100;26;0;26;1.000;3600000;0
18738;166023;1503;0;0;0;0;.00nan;0;0
18738;190570;4989;96;31;1;30;.968;3900000;0
18738;71485;4989;0;0;0;0;.00nan;0;0
18738;142810;1503;74;19;1;18;.947;3900000;0
18739;11708;772;0;0;0;0;.00nan;0;0
18739;170548;2545;85;26;1;25;.962;3600000;0
18739;63932;772;66;20;2;18;.900;3555000;0
18739;149048;2545;0;0;0;0;.00nan;0;0
18740;175757;759;0;0;0;0;.00nan;0;0
18740;180738;750;90;30;1;29;.967;3600000;0
18740;-1;750;0;0;0;0;.00nan;0;0
18740;197595;759;88;38;2;36;.947;3562000;0
18741;279;766;52;33;4;29;.879;3600000;0
18741;186234;754;0;0;0;0;.00nan;0;0
18741;82711;766;0;0;0;0;.00nan;0;0
18741;148904;754;84;23;1;22;.957;3600000;0
18742;189264;4923;23;30;7;23;.767;3600000;0
18742;176686;4923;0;0;0;0;.00nan;0;0
18742;80222;768;100;25;0;25;1.000;3600000;0
18742;81691;768;0;0;0;0;.00nan;0;0
18743;3165;767;67;17;2;15;.882;3600000;0
18743;174858;755;0;0;0;0;.00nan;0;0
18743;180154;755;84;46;4;42;.913;3600000;0
18743;91358;767;0;0;0;0;.00nan;0;0
18744;164456;1492;0;0;0;0;.00nan;0;0
18744;169615;911;88;30;1;29;.967;3600000;0
18744;170530;1492;56;31;4;27;.871;3600000;0
18744;93756;911;0;0;0;0;.00nan;0;0
18745;201933;774;0;0;0;0;.00nan;0;0
18745;186219;4924;0;0;0;0;.00nan;0;0
18745;63529;4924;95;61;4;57;.934;3600000;0
18745;149280;774;79;25;2;23;.920;3600000;0
18746;164424;3913;74;33;3;30;.909;3600000;0
18746;170543;2199;100;39;0;39;1.000;3600000;0
18746;148576;3913;0;0;0;0;.00nan;0;0
18746;149262;2199;0;0;0;0;.00nan;0;0
18747;3241;1093;94;21;0;21;1.000;3600000;0
18747;-1;1093;0;0;0;0;.00nan;0;0
18747;206313;2197;0;0;0;0;.00nan;0;0
18747;190589;2197;85;30;1;29;.967;3600000;0
18748;169680;3730;85;44;3;41;.932;3585000;0
18748;171113;3730;0;0;0;0;.00nan;0;0
18748;201075;760;0;0;0;0;.00nan;0;0
18748;174894;760;71;26;2;24;.923;3600000;0
18749;188815;762;66;33;4;29;.879;3600000;0
18749;67818;3721;30;8;3;5;.625;601000;0
18749;82817;762;0;0;0;0;.00nan;0;0
18749;91194;3721;66;30;2;28;.933;2943000;0
18750;177124;775;78;21;1;20;.952;3600000;0
18750;142648;769;0;0;0;0;.00nan;0;0
18750;146249;775;0;0;0;0;.00nan;0;0
18750;149221;769;75;42;4;38;.905;3600000;0
18751;170548;2545;64;24;2;22;.917;3900000;0
18751;190570;4989;85;40;2;38;.950;3900000;0
18751;71485;4989;0;0;0;0;.00nan;0;0
18751;149048;2545;0;0;0;0;.00nan;0;0
18752;11708;772;0;0;0;0;.00nan;0;0
18752;166023;1503;0;0;0;0;.00nan;0;0
18752;63932;772;76;23;1;22;.957;3544000;0
18752;142810;1503;84;17;0;17;1.000;3600000;0
18753;1756;1497;85;18;0;18;1.000;3600000;0
18753;174858;755;0;0;0;0;.00nan;0;0
18753;180154;755;98;50;1;49;.980;3577000;0
18753;67446;1497;0;0;0;0;.00nan;0;0
18754;186219;4924;0;0;0;0;.00nan;0;0
18754;186234;754;0;0;0;0;.00nan;0;0
18754;63529;4924;85;30;1;29;.967;3600000;0
18754;148904;754;64;28;3;25;.893;3587000;0
18755;177124;775;69;42;4;38;.905;3600000;0
18755;80222;768;63;16;1;15;.938;3600000;0
18755;81691;768;0;0;0;0;.00nan;0;0
18755;146249;775;0;0;0;0;.00nan;0;0
18756;3165;767;0;0;0;0;.00nan;0;0
18756;169615;911;82;12;0;12;1.000;3600000;0
18756;91358;767;96;37;1;36;.973;3568000;0
18756;93756;911;0;0;0;0;.00nan;0;0
18757;164456;1492;0;0;0;0;.00nan;0;0
18757;170530;1492;69;32;3;29;.906;3600000;0
18757;175757;759;82;12;0;12;1.000;3600000;0
18757;197595;759;0;0;0;0;.00nan;0;0
18758;201933;774;0;0;0;0;.00nan;0;0
18758;67818;3721;84;27;1;26;.963;3600000;0
18758;91194;3721;0;0;0;0;.00nan;0;0
18758;149280;774;54;15;2;13;.867;3559000;0
18759;189264;4923;0;0;0;0;.00nan;0;0
18759;170543;2199;94;34;1;33;.971;3600000;0
18759;176686;4923;79;31;2;29;.935;3545000;0
18759;149262;2199;0;0;0;0;.00nan;0;0
18760;279;766;80;25;1;24;.960;3600000;0
18760;3241;1093;79;36;2;34;.944;3588000;0
18760;-1;1093;0;0;0;0;.00nan;0;0
18760;82711;766;0;0;0;0;.00nan;0;0
18761;164424;3913;73;25;2;23;.920;3600000;0
18761;169680;3730;80;35;3;32;.914;3589000;0
18761;171113;3730;0;0;0;0;.00nan;0;0
18761;148576;3913;0;0;0;0;.00nan;0;0
18762;188815;762;61;22;3;19;.864;3823000;0
18762;206313;2197;0;0;0;0;.00nan;0;0
18762;190589;2197;89;43;2;41;.953;3823000;0
18762;82817;762;0;0;0;0;.00nan;0;0
18763;201075;760;42;18;3;15;.833;3563000;0
18763;174894;760;0;0;0;0;.00nan;0;0
18763;142648;769;0;0;0;0;.00nan;0;0
18763;149221;769;82;34;1;33;.971;3600000;0
18764;1756;1497;63;26;2;24;.923;3544000;0
18764;169615;911;69;19;1;18;.947;3600000;0
18764;67446;1497;0;0;0;0;.00nan;0;0
18764;93756;911;0;0;0;0;.00nan;0;0
18765;3165;767;71;30;2;28;.933;3517000;0
18765;175757;759;100;40;0;40;1.000;3600000;0
18765;197595;759;0;0;0;0;.00nan;0;0
18765;91358;767;0;0;0;0;.00nan;0;0
18766;177124;775;29;8;3;5;.625;422000;0
18766;170543;2199;57;20;2;18;.900;3600000;0
18766;146249;775;82;17;0;17;1.000;3172000;0
18766;149262;2199;0;0;0;0;.00nan;0;0
18767;3241;1093;0;0;0;0;.00nan;0;0
18767;-1;1093;62;13;1;12;.923;3600000;0
18767;186219;4924;0;0;0;0;.00nan;0;0
18767;63529;4924;88;31;2;29;.935;3577000;0
18768;189264;4923;40;24;5;19;.792;3900000;0
18768;169680;3730;0;0;0;0;.00nan;0;0
18768;171113;3730;60;38;5;33;.868;3900000;0
18768;176686;4923;0;0;0;0;.00nan;0;0
18769;279;766;72;18;1;17;.944;3600000;0
18769;188815;762;53;20;2;18;.900;3579000;0
18769;82711;766;0;0;0;0;.00nan;0;0
18769;82817;762;0;0;0;0;.00nan;0;0
18770;11882;758;0;0;0;0;.00nan;0;0
18770;189433;758;45;24;4;20;.833;3532000;0
18770;-1;746;0;0;0;0;.00nan;0;0
18770;149191;746;60;25;3;22;.880;3600000;0
18771;1756;1497;75;35;3;32;.914;3552000;0
18771;175757;759;0;0;0;0;.00nan;0;0
18771;197595;759;66;24;2;22;.917;3600000;0
18771;67446;1497;0;0;0;0;.00nan;0;0
18772;190570;4989;100;28;0;28;1.000;3600000;0
18772;67818;3721;0;0;0;0;.00nan;0;0
18772;71485;4989;0;0;0;0;.00nan;0;0
18772;91194;3721;75;26;1;25;.962;3545000;0
18773;174858;755;72;29;2;27;.931;3552000;0
18773;180154;755;0;0;0;0;.00nan;0;0
18773;201933;774;0;0;0;0;.00nan;0;0
18773;149280;774;55;11;1;10;.909;3600000;0
18774;177124;775;41;18;4;14;.778;3578000;0
18774;169680;3730;85;45;3;42;.933;3600000;0
18774;171113;3730;0;0;0;0;.00nan;0;0
18774;146249;775;0;0;0;0;.00nan;0;0
18775;11882;758;76;37;2;35;.946;3900000;0
18775;166023;1503;0;0;0;0;.00nan;0;0
18775;189433;758;0;0;0;0;.00nan;0;0
18775;142810;1503;63;23;2;21;.913;3900000;0
18776;170548;2545;65;39;4;35;.897;3600000;0
18776;-1;746;0;0;0;0;.00nan;0;0
18776;149048;2545;0;0;0;0;.00nan;0;0
18776;149191;746;72;20;1;19;.950;3600000;0
18777;164424;3913;76;25;2;23;.920;3600000;0
18777;164456;1492;0;0;0;0;.00nan;0;0
18777;170530;1492;56;29;3;26;.897;3554000;0
18777;148576;3913;0;0;0;0;.00nan;0;0
18778;80222;768;76;23;1;22;.957;3600000;0
18778;81691;768;0;0;0;0;.00nan;0;0
18778;142648;769;0;0;0;0;.00nan;0;0
18778;149221;769;69;42;4;38;.905;3600000;0
18779;174858;755;0;0;0;0;.00nan;0;0
18779;180154;755;88;43;3;40;.930;3598000;0
18779;186234;754;0;0;0;0;.00nan;0;0
18779;148904;754;66;22;2;20;.909;3600000;0
18780;169615;911;0;0;0;0;.00nan;0;0
18780;201933;774;0;0;0;0;.00nan;0;0
18780;93756;911;75;19;1;18;.947;3600000;0
18780;149280;774;66;30;3;27;.900;3600000;0
18781;190570;4989;73;38;3;35;.921;3558000;0
18781;68233;766;64;18;1;17;.944;3600000;0
18781;71485;4989;0;0;0;0;.00nan;0;0
18781;82711;766;0;0;0;0;.00nan;0;0
18782;164456;1492;0;0;0;0;.00nan;0;0
18782;170530;1492;90;32;1;31;.969;3900000;0
18782;201075;760;89;19;1;18;.947;3900000;0
18782;174894;760;0;0;0;0;.00nan;0;0
18783;166023;1503;0;0;0;0;.00nan;0;0
18783;170548;2545;56;19;3;16;.842;3900000;0
18783;142810;1503;64;28;3;25;.893;3900000;0
18783;149048;2545;0;0;0;0;.00nan;0;0
18784;279;1093;0;0;0;0;.00nan;0;0
18784;188815;762;0;0;0;0;.00nan;0;0
18784;-1;1093;52;25;3;22;.880;3549000;0
18784;82817;762;60;19;2;17;.895;3600000;0
18785;164424;3913;86;23;1;22;.957;3600000;0
18785;180738;750;66;27;3;24;.889;3556000;0
18785;-1;750;0;0;0;0;.00nan;0;0
18785;148576;3913;0;0;0;0;.00nan;0;0
18786;177124;775;0;0;0;0;.00nan;0;0
18786;1756;1497;85;29;2;27;.931;3900000;0
18786;67446;1497;0;0;0;0;.00nan;0;0
18786;146249;775;88;30;2;28;.933;3900000;0
18787;169615;911;88;16;0;16;1.000;3600000;0
18787;186234;754;0;0;0;0;.00nan;0;0
18787;93756;911;0;0;0;0;.00nan;0;0
18787;148904;754;64;30;3;27;.900;3600000;0
18788;175757;759;0;0;0;0;.00nan;0;0
18788;201933;774;0;0;0;0;.00nan;0;0
18788;197595;759;71;37;3;34;.919;3549000;0
18788;149280;774;67;24;2;22;.917;3600000;0
18789;169680;3730;0;0;0;0;.00nan;0;0
18789;170543;2199;76;22;1;21;.955;3600000;0
18789;171113;3730;54;40;5;35;.875;3600000;0
18789;149262;2199;0;0;0;0;.00nan;0;0
18790;3165;767;40;35;5;30;.857;3600000;0
18790;189264;4923;0;0;0;0;.00nan;0;0
18790;176686;4923;100;30;0;30;1.000;3600000;0
18790;91358;767;0;0;0;0;.00nan;0;0
18791;190570;4989;29;22;5;17;.773;3572000;0
18791;186219;4924;0;0;0;0;.00nan;0;0
18791;63529;4924;66;30;3;27;.900;3600000;0
18791;71485;4989;0;0;0;0;.00nan;0;0
18792;11708;772;0;0;0;0;.00nan;0;0
18792;63932;772;100;49;1;48;.980;3900000;0
18792;68233;766;84;26;1;25;.962;3900000;0
18792;82711;766;0;0;0;0;.00nan;0;0
18793;201075;760;0;0;0;0;.00nan;0;0
18793;174894;760;72;35;3;32;.914;3600000;0
18793;180738;750;36;19;4;15;.789;3547000;0
18793;-1;750;0;0;0;0;.00nan;0;0
18794;166023;1503;0;0;0;0;.00nan;0;0
18794;-1;746;0;0;0;0;.00nan;0;0
18794;142810;1503;63;37;4;33;.892;3592000;0
18794;149191;746;69;33;3;30;.909;3600000;0
18795;11882;758;58;22;2;20;.909;3582000;0
18795;189433;758;0;0;0;0;.00nan;0;0
18795;170548;2545;0;0;0;0;.00nan;0;0
18795;149048;2545;89;28;1;27;.964;3600000;0
18796;11708;772;0;0;0;0;.00nan;0;0
18796;63932;772;100;34;1;33;.971;3600000;0
18796;67818;3721;78;29;2;27;.931;3600000;0
18796;91194;3721;0;0;0;0;.00nan;0;0
18797;177124;775;51;23;3;20;.870;3600000;0
18797;3165;767;0;0;0;0;.00nan;0;0
18797;91358;767;70;37;4;33;.892;3600000;0
18797;146249;775;0;0;0;0;.00nan;0;0
18798;180606;2197;0;0;0;0;.00nan;0;0
18798;190570;4989;94;33;1;32;.970;3900000;0
18798;190589;2197;83;24;1;23;.958;3900000;0
18798;71485;4989;0;0;0;0;.00nan;0;0
18799;175757;759;85;32;1;31;.969;3900000;0
18799;186234;754;0;0;0;0;.00nan;0;0
18799;197595;759;0;0;0;0;.00nan;0;0
18799;148904;754;75;30;1;29;.967;3900000;0
18800;1756;1497;49;30;4;26;.867;3600000;0
18800;189264;4923;0;0;0;0;.00nan;0;0
18800;176686;4923;51;16;2;14;.875;3600000;0
18800;67446;1497;0;0;0;0;.00nan;0;0
18801;279;1093;85;28;2;26;.929;3900000;0
18801;-1;1093;0;0;0;0;.00nan;0;0
18801;174858;755;0;0;0;0;.00nan;0;0
18801;180154;755;78;24;2;22;.917;3900000;0
18802;170543;2199;85;39;2;37;.949;3530000;0
18802;80222;768;100;20;0;20;1.000;3600000;0
18802;81691;768;0;0;0;0;.00nan;0;0
18802;149262;2199;0;0;0;0;.00nan;0;0
18803;169680;3730;68;32;3;29;.906;3600000;0
18803;171113;3730;0;0;0;0;.00nan;0;0
18803;142648;769;0;0;0;0;.00nan;0;0
18803;149221;769;38;25;4;21;.840;3562000;0
18804;188815;762;68;23;2;21;.913;3517000;0
18804;174858;755;0;0;0;0;.00nan;0;0
18804;180154;755;100;27;0;27;1.000;3600000;0
18804;82817;762;0;0;0;0;.00nan;0;0
18805;177124;775;58;21;3;18;.857;3900000;0
18805;164456;1492;79;38;3;35;.921;3900000;0
18805;82711;1492;0;0;0;0;.00nan;0;0
18805;146249;775;0;0;0;0;.00nan;0;0
18806;279;1093;92;55;4;51;.927;3600000;0
18806;-1;1093;0;0;0;0;.00nan;0;0
18806;169615;911;88;26;1;25;.962;3600000;0
18806;93756;911;0;0;0;0;.00nan;0;0
18807;189264;4923;0;0;0;0;.00nan;0;0
18807;176686;4923;34;39;7;32;.821;3600000;0
18807;180738;750;60;19;2;17;.895;3600000;0
18807;-1;750;0;0;0;0;.00nan;0;0
18808;1756;1497;43;15;3;12;.800;3588000;0
18808;174894;760;91;32;1;31;.969;3600000;0
18808;67446;1497;0;0;0;0;.00nan;0;0
18808;149112;760;0;0;0;0;.00nan;0;0
18809;201933;774;0;0;0;0;.00nan;0;0
18809;186234;754;33;35;6;29;.829;3028000;0
18809;148904;754;52;3;0;3;1.000;572000;0
18809;149280;774;88;28;1;27;.964;3600000;0
18810;169680;3730;95;60;3;57;.950;3569000;0
18810;171113;3730;0;0;0;0;.00nan;0;0
18810;80222;768;69;20;1;19;.950;3600000;0
18810;81691;768;0;0;0;0;.00nan;0;0
18811;166023;1503;67;25;2;23;.920;3600000;0
18811;170530;766;56;12;1;11;.917;3600000;0
18811;68233;766;0;0;0;0;.00nan;0;0
18811;142810;1503;0;0;0;0;.00nan;0;0
18812;11708;772;0;0;0;0;.00nan;0;0
18812;186219;4924;0;0;0;0;.00nan;0;0
18812;63529;4924;100;43;0;43;1.000;3600000;0
18812;63932;772;64;31;4;27;.871;3600000;0
18813;170543;2199;82;23;1;22;.957;3600000;0
18813;142648;769;0;0;0;0;.00nan;0;0
18813;149221;769;67;44;4;40;.909;3600000;0
18813;149262;2199;0;0;0;0;.00nan;0;0
18814;3165;767;98;42;2;40;.952;3900000;0
18814;164424;3913;65;20;2;18;.900;3900000;0
18814;49815;767;0;0;0;0;.00nan;0;0
18814;148576;3913;0;0;0;0;.00nan;0;0
18815;177124;775;100;36;0;36;1.000;3600000;0
18815;180738;750;67;33;3;30;.909;3600000;0
18815;-1;750;0;0;0;0;.00nan;0;0
18815;146249;775;0;0;0;0;.00nan;0;0
18816;188815;762;58;43;6;37;.860;3600000;0
18816;169615;911;71;20;1;19;.950;3600000;0
18816;76628;911;0;0;0;0;.00nan;0;0
18816;82817;762;0;0;0;0;.00nan;0;0
18817;279;1093;79;32;2;30;.938;3600000;0
18817;-1;1093;0;0;0;0;.00nan;0;0
18817;175757;759;86;25;1;24;.960;3600000;0
18817;197595;759;0;0;0;0;.00nan;0;0
18818;164456;1492;0;0;0;0;.00nan;0;0
18818;189264;4923;36;16;3;13;.813;3533000;0
18818;176686;4923;0;0;0;0;.00nan;0;0
18818;82711;1492;72;21;1;20;.952;3600000;0
18819;3165;767;82;17;0;17;1.000;3600000;0
18819;174894;760;45;4;1;3;.750;459000;0
18819;49815;767;0;0;0;0;.00nan;0;0
18819;149112;760;38;41;7;34;.829;3141000;0
18820;166023;1503;0;0;0;0;.00nan;0;0
18820;67818;3721;82;32;2;30;.938;3569000;0
18820;91194;3721;0;0;0;0;.00nan;0;0
18820;142810;1503;94;21;0;21;1.000;3600000;0
18821;11708;772;0;0;0;0;.00nan;0;0
18821;180606;2197;0;0;0;0;.00nan;0;0
18821;190589;2197;94;47;3;44;.936;3600000;0
18821;63932;772;66;17;1;16;.941;3600000;0
18822;8504;746;0;0;0;0;.00nan;0;0
18822;170530;766;18;9;4;5;.556;892000;0
18822;68233;766;59;31;3;28;.903;2708000;0
18822;149191;746;96;23;0;23;1.000;3600000;0
18823;1756;1497;99;43;1;42;.977;3600000;0
18823;164424;3913;71;27;2;25;.926;3560000;0
18823;67446;1497;0;0;0;0;.00nan;0;0
18823;148576;3913;0;0;0;0;.00nan;0;0
18824;188815;762;85;27;1;26;.963;3600000;0
18824;175757;759;0;0;0;0;.00nan;0;0
18824;197595;759;63;25;2;23;.920;3581000;0
18824;82817;762;0;0;0;0;.00nan;0;0
18825;11882;758;48;18;2;16;.889;3593000;0
18825;189433;758;0;0;0;0;.00nan;0;0
18825;170530;766;86;26;1;25;.962;3600000;0
18825;68233;766;0;0;0;0;.00nan;0;0
18826;166023;1503;0;0;0;0;.00nan;0;0
18826;186219;4924;0;0;0;0;.00nan;0;0
18826;63529;4924;97;33;1;32;.970;3600000;0
18826;142810;1503;61;24;2;22;.917;3587000;0
18827;174858;755;0;0;0;0;.00nan;0;0
18827;180154;755;99;39;1;38;.974;3600000;0
18827;190570;4989;57;25;4;21;.840;3600000;0
18827;71485;4989;0;0;0;0;.00nan;0;0
18828;8504;746;71;23;2;21;.913;3555000;0
18828;67818;3721;93;34;1;33;.971;3600000;0
18828;91194;3721;0;0;0;0;.00nan;0;0
18828;149191;746;0;0;0;0;.00nan;0;0
18829;212428;750;0;0;0;0;.00nan;0;0
18829;180738;750;65;22;2;20;.909;3600000;0
18829;142648;769;57;11;1;10;.909;495000;0
18829;149221;769;50;45;6;39;.867;3105000;0
18830;164424;3913;89;43;3;40;.930;3575000;0
18830;186234;754;80;23;1;22;.957;3600000;0
18830;148576;3913;0;0;0;0;.00nan;0;0
18830;148904;754;0;0;0;0;.00nan;0;0
18831;164456;1492;0;0;0;0;.00nan;0;0
18831;80222;768;76;24;2;22;.917;3600000;0
18831;81691;768;0;0;0;0;.00nan;0;0
18831;82711;1492;97;57;4;53;.930;3600000;0
18832;174894;760;0;0;0;0;.00nan;0;0
18832;201933;774;0;0;0;0;.00nan;0;0
18832;149112;760;79;46;3;43;.935;3600000;0
18832;149280;774;89;20;0;20;1.000;3600000;0
18833;279;1093;53;25;4;21;.840;3600000;0
18833;189264;4923;0;0;0;0;.00nan;0;0
18833;-1;1093;0;0;0;0;.00nan;0;0
18833;176686;4923;62;19;1;18;.947;3600000;0
18834;11882;758;62;38;3;35;.921;3597000;0
18834;189433;758;0;0;0;0;.00nan;0;0
18834;67818;3721;67;27;2;25;.926;3600000;0
18834;91194;3721;0;0;0;0;.00nan;0;0
18835;166023;1503;0;0;0;0;.00nan;0;0
18835;180606;2197;0;0;0;0;.00nan;0;0
18835;190589;2197;34;28;6;22;.786;3600000;0
18835;142810;1503;56;22;3;19;.864;3600000;0
18836;1756;4989;0;0;0;0;.00nan;0;0
18836;169615;911;82;26;1;25;.962;3788000;0
18836;190570;4989;81;31;2;29;.935;3788000;0
18836;76628;911;0;0;0;0;.00nan;0;0
18837;164424;772;85;26;1;25;.962;3600000;0
18837;11708;772;0;0;0;0;.00nan;0;0
18837;174858;755;0;0;0;0;.00nan;0;0
18837;180154;755;69;26;2;24;.923;3593000;0
18838;8504;746;55;18;2;16;.889;3669000;0
18838;186219;4924;0;0;0;0;.00nan;0;0
18838;63529;4924;72;31;3;28;.903;3669000;0
18838;149191;746;0;0;0;0;.00nan;0;0
18839;170530;766;62;29;3;26;.897;3900000;0
18839;170548;2545;75;33;3;30;.909;3900000;0
18839;68233;766;0;0;0;0;.00nan;0;0
18839;149048;2545;0;0;0;0;.00nan;0;0
18840;67446;1497;64;22;2;20;.909;3600000;0
18840;93756;1497;0;0;0;0;.00nan;0;0
18840;142648;769;0;0;0;0;.00nan;0;0
18840;149221;769;73;41;4;37;.902;3535000;0
18841;170543;2199;75;28;2;26;.929;3599000;0
18841;212428;750;0;0;0;0;.00nan;0;0
18841;180738;750;95;29;1;28;.966;3600000;0
18841;-1;2199;0;0;0;0;.00nan;0;0
18842;189264;4923;0;0;0;0;.00nan;0;0
18842;176686;4923;77;37;3;34;.919;3600000;0
18842;186234;754;0;0;0;0;.00nan;0;0
18842;148904;754;43;33;6;27;.818;3600000;0
18843;3165;767;100;33;0;33;1.000;3600000;0
18843;49815;767;0;0;0;0;.00nan;0;0
18843;80222;768;85;33;3;30;.909;3600000;0
18843;81691;768;0;0;0;0;.00nan;0;0
18844;164456;1492;0;0;0;0;.00nan;0;0
18844;169680;3730;86;30;1;29;.967;3600000;0
18844;171113;3730;0;0;0;0;.00nan;0;0
18844;82711;1492;71;38;4;34;.895;3600000;0
18845;201933;774;0;0;0;0;.00nan;0;0
18845;63932;3913;78;19;1;18;.947;3600000;0
18845;148576;3913;0;0;0;0;.00nan;0;0
18845;149280;774;81;28;2;26;.929;3577000;0
18846;279;1093;63;28;3;25;.893;3600000;0
18846;177124;775;67;40;4;36;.900;3597000;0
18846;-1;1093;0;0;0;0;.00nan;0;0
18846;146249;775;0;0;0;0;.00nan;0;0
18847;188815;762;0;0;0;0;.00nan;0;0
18847;201075;760;73;40;4;36;.900;3600000;0
18847;174894;760;0;0;0;0;.00nan;0;0
18847;82817;762;80;24;1;23;.958;3600000;0
18848;11882;758;69;19;1;18;.947;3600000;0
18848;189433;758;0;0;0;0;.00nan;0;0
18848;63529;4924;31;30;6;24;.800;3045000;0
18848;149262;4924;52;4;0;4;1.000;555000;0
18849;1756;4989;78;35;3;32;.914;3900000;0
18849;175757;759;0;0;0;0;.00nan;0;0
18849;190570;4989;0;0;0;0;.00nan;0;0
18849;197595;759;59;28;3;25;.893;3900000;0
18850;164424;772;86;30;1;29;.967;3600000;0
18850;11708;772;0;0;0;0;.00nan;0;0
18850;169615;911;68;32;3;29;.906;3574000;0
18850;76628;911;0;0;0;0;.00nan;0;0
18851;8504;746;81;15;0;15;1.000;3600000;0
18851;180606;2197;0;0;0;0;.00nan;0;0
18851;190589;2197;63;38;4;34;.895;3600000;0
18851;149191;746;0;0;0;0;.00nan;0;0
18852;170548;2545;97;38;1;37;.974;3900000;0
18852;67818;3721;100;35;1;34;.971;3900000;0
18852;91194;3721;0;0;0;0;.00nan;0;0
18852;149048;2545;0;0;0;0;.00nan;0;0
18853;67446;1497;0;0;0;0;.00nan;0;0
18853;81691;768;0;0;0;0;.00nan;0;0
18853;93756;1497;83;43;4;39;.907;3600000;0
18853;149221;768;83;22;1;21;.955;3600000;0
18854;169680;3730;80;40;2;38;.950;3588000;0
18854;171113;3730;0;0;0;0;.00nan;0;0
18854;212428;750;0;0;0;0;.00nan;0;0
18854;180738;750;94;17;0;17;1.000;3600000;0
18855;177124;775;58;23;3;20;.870;3542000;0
18855;186234;754;69;28;2;26;.929;3600000;0
18855;146249;775;0;0;0;0;.00nan;0;0
18855;148904;754;0;0;0;0;.00nan;0;0
18856;3165;767;42;21;4;17;.810;3600000;0
18856;49815;767;0;0;0;0;.00nan;0;0
18856;80222;769;62;44;6;38;.864;3594000;0
18856;142648;769;0;0;0;0;.00nan;0;0
18857;164456;1492;0;0;0;0;.00nan;0;0
18857;170543;2199;62;34;3;31;.912;3600000;0
18857;-1;2199;0;0;0;0;.00nan;0;0
18857;82711;1492;97;24;0;24;1.000;3600000;0
18858;189264;4923;54;38;6;32;.842;3600000;0
18858;176686;4923;0;0;0;0;.00nan;0;0
18858;201933;774;0;0;0;0;.00nan;0;0
18858;149280;774;64;15;1;14;.933;3600000;0
18859;279;1093;51;37;5;32;.865;3546000;0
18859;-1;1093;0;0;0;0;.00nan;0;0
18859;201075;760;53;28;4;24;.857;3600000;0
18859;174894;760;0;0;0;0;.00nan;0;0
18860;188815;762;87;32;2;30;.938;3600000;0
18860;63932;3913;39;27;5;22;.815;3600000;0
18860;82817;762;0;0;0;0;.00nan;0;0
18860;148576;3913;0;0;0;0;.00nan;0;0
18861;11882;758;0;0;0;0;.00nan;0;0
18861;189433;758;70;30;3;27;.900;3600000;0
18861;180606;2197;46;28;5;23;.821;2353000;0
18861;190589;2197;52;4;0;4;1.000;1247000;0
18862;166023;1503;0;0;0;0;.00nan;0;0
18862;174858;755;0;0;0;0;.00nan;0;0
18862;180154;755;72;41;4;37;.902;3900000;0
18862;142810;1503;36;19;4;15;.789;3900000;0
18863;164424;772;49;18;3;15;.833;3587000;0
18863;11708;772;0;0;0;0;.00nan;0;0
18863;175757;759;99;37;1;36;.973;3600000;0
18863;197595;759;0;0;0;0;.00nan;0;0
18864;170548;2545;84;25;1;24;.960;3600000;0
18864;63529;4924;60;33;4;29;.879;3600000;0
18864;149048;2545;0;0;0;0;.00nan;0;0
18864;149262;4924;0;0;0;0;.00nan;0;0
18865;169680;3730;69;39;4;35;.897;3600000;0
18865;171113;3730;0;0;0;0;.00nan;0;0
18865;67446;1497;0;0;0;0;.00nan;0;0
18865;93756;1497;100;22;0;22;1.000;3600000;0
18866;212428;750;0;0;0;0;.00nan;0;0
18866;180738;750;98;52;2;50;.962;3595000;0
18866;81691;768;0;0;0;0;.00nan;0;0
18866;149221;768;92;17;0;17;1.000;3600000;0
18867;4281;754;52;26;4;22;.846;3600000;0
18867;201075;760;17;14;5;9;.643;1963000;0
18867;174894;760;59;13;1;12;.923;1567000;0
18867;148904;754;0;0;0;0;.00nan;0;0
18868;3165;767;93;31;2;29;.935;3600000;0
18868;170543;2199;92;49;4;45;.918;3528000;0
18868;-1;2199;0;0;0;0;.00nan;0;0
18868;49815;767;0;0;0;0;.00nan;0;0
18869;164456;1492;0;0;0;0;.00nan;0;0
18869;80222;769;64;34;3;31;.912;3568000;0
18869;82711;1492;58;20;2;18;.900;3600000;0
18869;142648;769;0;0;0;0;.00nan;0;0
18870;177124;775;100;42;0;42;1.000;3600000;0
18870;201933;774;0;0;0;0;.00nan;0;0
18870;146249;775;0;0;0;0;.00nan;0;0
18870;149280;774;71;19;2;17;.895;3514000;0
18871;279;1093;99;46;3;43;.935;3900000;0
18871;-1;1093;0;0;0;0;.00nan;0;0
18871;63932;3913;70;29;3;26;.897;3900000;0
18871;148576;3913;0;0;0;0;.00nan;0;0
18872;188815;762;70;26;2;24;.923;3900000;0
18872;189264;4923;0;0;0;0;.00nan;0;0
18872;176686;4923;72;30;2;28;.933;3900000;0
18872;186234;762;0;0;0;0;.00nan;0;0
18873;8504;746;70;11;0;11;1.000;3600000;0
18873;174858;755;0;0;0;0;.00nan;0;0
18873;180154;755;60;44;5;39;.886;3600000;0
18873;149191;746;0;0;0;0;.00nan;0;0
18874;166023;1503;0;0;0;0;.00nan;0;0
18874;169615;911;73;24;1;23;.958;3600000;0
18874;76628;911;0;0;0;0;.00nan;0;0
18874;142810;1503;76;32;2;30;.938;3579000;0
18875;170548;2545;90;19;0;19;1.000;3600000;0
18875;180606;2197;41;40;7;33;.825;3600000;0
18875;190589;2197;0;0;0;0;.00nan;0;0
18875;149048;2545;0;0;0;0;.00nan;0;0
18876;170543;2199;69;24;1;23;.958;3600000;0
18876;-1;2199;0;0;0;0;.00nan;0;0
18876;67446;1497;0;0;0;0;.00nan;0;0
18876;93756;1497;59;31;3;28;.903;3575000;0
18877;3165;767;66;25;2;23;.920;3600000;0
18877;169680;3730;50;36;5;31;.861;3600000;0
18877;171113;3730;0;0;0;0;.00nan;0;0
18877;49815;767;0;0;0;0;.00nan;0;0
18878;170530;766;70;38;4;34;.895;3600000;0
18878;67818;3721;0;0;0;0;.00nan;0;0
18878;68233;766;0;0;0;0;.00nan;0;0
18878;91194;3721;61;19;2;17;.895;3600000;0
18879;177124;775;100;30;0;30;1.000;3600000;0
18879;188815;762;98;46;2;44;.957;3585000;0
18879;186234;762;0;0;0;0;.00nan;0;0
18879;146249;775;0;0;0;0;.00nan;0;0
18880;11882;758;70;19;1;18;.947;3600000;0
18880;189433;758;0;0;0;0;.00nan;0;0
18880;174858;755;0;0;0;0;.00nan;0;0
18880;180154;755;98;40;2;38;.950;3545000;0
18881;8504;746;42;17;3;14;.824;3570000;0
18881;169615;911;97;31;2;29;.935;3600000;0
18881;76628;911;0;0;0;0;.00nan;0;0
18881;149191;746;0;0;0;0;.00nan;0;0
18882;166023;1503;0;0;0;0;.00nan;0;0
18882;175757;759;68;31;3;28;.903;3643000;0
18882;197595;759;0;0;0;0;.00nan;0;0
18882;142810;1503;75;29;2;27;.931;3643000;0
18883;164424;772;60;25;3;22;.880;3539000;0
18883;11708;772;0;0;0;0;.00nan;0;0
18883;201075;760;0;0;0;0;.00nan;0;0
18883;174894;760;68;20;2;18;.900;3600000;0
18884;201933;774;0;0;0;0;.00nan;0;0
18884;81691;768;0;0;0;0;.00nan;0;0
18884;149221;768;45;21;4;17;.810;3559000;0
18884;149280;774;76;32;3;29;.906;3600000;0
18885;170530;766;0;0;0;0;.00nan;0;0
18885;63529;4924;95;43;2;41;.953;3553000;0
18885;68233;766;82;14;0;14;1.000;3600000;0
18885;149262;4924;0;0;0;0;.00nan;0;0
18886;4281;754;0;0;0;0;.00nan;0;0
18886;80222;769;70;49;5;44;.898;3600000;0
18886;142648;769;0;0;0;0;.00nan;0;0
18886;148904;754;66;18;2;16;.889;3600000;0
18887;1756;4989;77;46;5;41;.891;3900000;0
18887;190570;4989;0;0;0;0;.00nan;0;0
18887;63932;3913;33;24;5;19;.792;3900000;0
18887;148576;3913;0;0;0;0;.00nan;0;0
18888;170548;2545;80;31;3;28;.903;3600000;0
18888;174858;755;99;36;2;34;.944;3600000;0
18888;180154;755;0;0;0;0;.00nan;0;0
18888;149048;2545;0;0;0;0;.00nan;0;0
18889;11882;758;58;34;3;31;.912;3600000;0
18889;189433;758;0;0;0;0;.00nan;0;0
18889;169615;911;100;30;0;30;1.000;3600000;0
18889;76628;911;0;0;0;0;.00nan;0;0
18890;8504;746;79;27;2;25;.926;3600000;0
18890;175757;759;0;0;0;0;.00nan;0;0
18890;197595;759;81;46;3;43;.935;3600000;0
18890;149191;746;0;0;0;0;.00nan;0;0
18891;1756;4989;84;16;0;16;1.000;3654000;0
18891;201075;760;83;31;1;30;.968;3654000;0
18891;174894;760;0;0;0;0;.00nan;0;0
18891;190570;4989;0;0;0;0;.00nan;0;0
18892;188815;762;34;28;5;23;.821;3600000;0
18892;186234;762;0;0;0;0;.00nan;0;0
18892;81691;768;0;0;0;0;.00nan;0;0
18892;149221;768;100;23;0;23;1.000;3600000;0
18893;63529;4924;81;37;2;35;.946;3579000;0
18893;67818;3721;62;15;1;14;.933;3600000;0
18893;91194;3721;0;0;0;0;.00nan;0;0
18893;149262;4924;0;0;0;0;.00nan;0;0
18894;170543;2199;0;0;0;0;.00nan;0;0
18894;201933;774;0;0;0;0;.00nan;0;0
18894;-1;2199;80;25;1;24;.960;3600000;0
18894;149280;774;61;23;2;21;.913;3576000;0
18895;4281;754;77;30;2;28;.933;3600000;0
18895;169680;3730;75;38;3;35;.921;3548000;0
18895;171113;3730;0;0;0;0;.00nan;0;0
18895;148904;754;0;0;0;0;.00nan;0;0
18896;170530;766;0;0;0;0;.00nan;0;0
18896;180606;2197;54;24;3;21;.875;3660000;0
18896;190589;2197;0;0;0;0;.00nan;0;0
18896;68233;766;66;28;2;26;.929;3660000;0
18897;279;1093;64;31;4;27;.871;3563000;0
18897;-1;1093;0;0;0;0;.00nan;0;0
18897;80222;769;57;27;3;24;.889;3600000;0
18897;142648;769;0;0;0;0;.00nan;0;0
18898;164424;772;84;40;3;37;.925;3900000;0
18898;11708;772;0;0;0;0;.00nan;0;0
18898;63932;3913;74;28;3;25;.893;3900000;0
18898;148576;3913;0;0;0;0;.00nan;0;0
18899;164456;1492;0;0;0;0;.00nan;0;0
18899;67446;1497;47;27;4;23;.852;3517000;0
18899;82711;1492;67;29;2;27;.931;3600000;0
18899;93756;1497;0;0;0;0;.00nan;0;0
18900;3165;767;90;36;3;33;.917;3544000;0
18900;212428;750;0;0;0;0;.00nan;0;0
18900;180738;750;69;24;2;22;.917;3600000;0
18900;49815;767;0;0;0;0;.00nan;0;0
18901;169615;911;75;30;2;28;.933;3600000;0
18901;170548;2545;57;21;3;18;.857;3593000;0
18901;76628;911;0;0;0;0;.00nan;0;0
18901;149048;2545;0;0;0;0;.00nan;0;0
18902;11882;758;84;34;2;32;.941;3600000;0
18902;189433;758;0;0;0;0;.00nan;0;0
18902;175757;759;63;26;3;23;.885;3572000;0
18902;197595;759;0;0;0;0;.00nan;0;0
18903;279;1093;35;27;6;21;.778;3584000;0
18903;-1;1093;0;0;0;0;.00nan;0;0
18903;81691;768;0;0;0;0;.00nan;0;0
18903;149221;768;63;29;4;25;.862;3600000;0
18904;180606;2197;81;54;5;49;.907;3585000;0
18904;190589;2197;0;0;0;0;.00nan;0;0
18904;67818;3721;44;18;3;15;.833;3600000;0
18904;91194;3721;0;0;0;0;.00nan;0;0
18905;177124;775;90;44;2;42;.955;3600000;0
18905;1756;4989;75;33;3;30;.909;3572000;0
18905;190570;4989;0;0;0;0;.00nan;0;0
18905;146249;775;0;0;0;0;.00nan;0;0
18906;4281;754;0;0;0;0;.00nan;0;0
18906;170543;2199;75;27;2;25;.926;3600000;0
18906;-1;2199;0;0;0;0;.00nan;0;0
18906;148904;754;61;31;3;28;.903;3577000;0
18907;169680;3730;81;49;4;45;.918;3556000;0
18907;171113;3730;0;0;0;0;.00nan;0;0
18907;201933;774;0;0;0;0;.00nan;0;0
18907;149280;774;66;21;2;19;.905;3600000;0
18908;164424;772;87;29;1;28;.966;3600000;0
18908;11708;772;0;0;0;0;.00nan;0;0
18908;189264;4923;0;0;0;0;.00nan;0;0
18908;176686;4923;85;45;2;43;.956;3600000;0
18909;188815;762;0;0;0;0;.00nan;0;0
18909;186234;762;67;17;1;16;.941;3600000;0
18909;80222;769;90;35;2;33;.943;3600000;0
18909;142648;769;0;0;0;0;.00nan;0;0
18910;212428;750;0;0;0;0;.00nan;0;0
18910;180738;750;44;27;5;22;.815;3600000;0
18910;67446;1497;0;0;0;0;.00nan;0;0
18910;93756;1497;64;22;2;20;.909;3600000;0
18911;3165;767;55;31;4;27;.871;3600000;0
18911;164456;1492;0;0;0;0;.00nan;0;0
18911;49815;767;0;0;0;0;.00nan;0;0
18911;82711;1492;89;26;1;25;.962;3600000;0
18912;170548;2545;87;31;2;29;.935;3600000;0
18912;175757;759;0;0;0;0;.00nan;0;0
18912;197595;759;63;27;3;24;.889;3572000;0
18912;149048;2545;0;0;0;0;.00nan;0;0
18913;4281;754;85;35;2;33;.943;3900000;0
18913;81691;768;0;0;0;0;.00nan;0;0
18913;148904;754;0;0;0;0;.00nan;0;0
18913;149221;768;82;29;2;27;.931;3900000;0
18914;177124;775;0;0;0;0;.00nan;0;0
18914;164424;772;57;24;3;21;.875;3553000;0
18914;11708;772;0;0;0;0;.00nan;0;0
18914;146249;775;91;30;1;29;.967;3600000;0
18915;279;1093;90;33;1;32;.970;3581000;0
18915;-1;1093;0;0;0;0;.00nan;0;0
18915;170543;2199;96;17;0;17;1.000;3600000;0
18915;-1;2199;0;0;0;0;.00nan;0;0
18916;188815;762;0;0;0;0;.00nan;0;0
18916;169680;3730;72;30;2;28;.933;3722000;0
18916;171113;3730;0;0;0;0;.00nan;0;0
18916;186234;762;59;29;3;26;.897;3722000;0
18917;1756;4989;72;24;1;23;.958;3600000;0
18917;189264;4923;63;41;4;37;.902;3600000;0
18917;176686;4923;0;0;0;0;.00nan;0;0
18917;190570;4989;0;0;0;0;.00nan;0;0
18918;180606;2197;0;0;0;0;.00nan;0;0
18918;190589;2197;62;32;4;28;.875;3600000;0
18918;63529;4924;0;0;0;0;.00nan;0;0
18918;149262;4924;96;23;0;23;1.000;3600000;0
18919;201933;774;0;0;0;0;.00nan;0;0
18919;80222;769;94;50;3;47;.940;3767000;0
18919;142648;769;0;0;0;0;.00nan;0;0
18919;149280;774;60;21;2;19;.905;3767000;0
18920;170530;766;72;18;1;17;.944;3600000;0
18920;174858;755;0;0;0;0;.00nan;0;0
18920;180154;755;90;35;2;33;.943;3542000;0
18920;68233;766;0;0;0;0;.00nan;0;0
18921;166023;1503;0;0;0;0;.00nan;0;0
18921;201075;760;61;30;4;26;.867;3573000;0
18921;174894;760;0;0;0;0;.00nan;0;0
18921;142810;1503;37;12;3;9;.750;3600000;0
18922;188815;762;78;29;2;27;.931;3558000;0
18922;170543;2199;65;14;1;13;.929;3600000;0
18922;186234;762;0;0;0;0;.00nan;0;0
18922;-1;2199;0;0;0;0;.00nan;0;0
18923;8504;746;73;31;2;29;.935;3600000;0
18923;63932;3913;46;28;4;24;.857;3571000;0
18923;148576;3913;0;0;0;0;.00nan;0;0
18923;149191;746;0;0;0;0;.00nan;0;0
18924;279;1093;57;24;3;21;.875;3767000;0
18924;-1;1093;0;0;0;0;.00nan;0;0
18924;169680;3730;92;40;2;38;.950;3767000;0
18924;171113;3730;0;0;0;0;.00nan;0;0
18925;3165;767;91;27;1;26;.963;3600000;0
18925;49815;767;0;0;0;0;.00nan;0;0
18925;67446;1497;0;0;0;0;.00nan;0;0
18925;93756;1497;69;29;2;27;.931;3570000;0
18926;174858;755;0;0;0;0;.00nan;0;0
18926;180154;755;48;30;6;24;.800;3600000;0
18926;67818;3721;64;17;1;16;.941;3600000;0
18926;91194;3721;0;0;0;0;.00nan;0;0
18927;169615;911;31;18;5;13;.722;3600000;0
18927;63529;4924;0;0;0;0;.00nan;0;0
18927;76628;911;0;0;0;0;.00nan;0;0
18927;149262;4924;95;38;2;36;.947;3600000;0
18928;170530;766;75;31;2;29;.935;3900000;0
18928;175757;759;57;19;2;17;.895;3900000;0
18928;197595;759;0;0;0;0;.00nan;0;0
18928;68233;766;0;0;0;0;.00nan;0;0
18929;4281;754;0;0;0;0;.00nan;0;0
18929;164456;1492;0;0;0;0;.00nan;0;0
18929;82711;1492;98;39;2;37;.949;3900000;0
18929;148904;754;73;22;2;20;.909;3900000;0
18930;11882;758;73;43;4;39;.907;3600000;0
18930;189433;758;0;0;0;0;.00nan;0;0
18930;63932;3913;79;27;1;26;.963;3600000;0
18930;148576;3913;0;0;0;0;.00nan;0;0
18931;166023;1503;0;0;0;0;.00nan;0;0
18931;189264;4923;61;37;4;33;.892;3600000;0
18931;176686;4923;0;0;0;0;.00nan;0;0
18931;142810;1503;55;11;1;10;.909;3600000;0
18932;212428;750;53;9;1;8;.889;458000;0
18932;201933;774;71;18;1;17;.944;3600000;0
18932;180738;750;37;31;7;24;.774;3142000;0
18932;149280;774;0;0;0;0;.00nan;0;0
18933;1756;4989;100;31;0;31;1.000;3600000;0
18933;190570;4989;0;0;0;0;.00nan;0;0
18933;80222;769;65;37;4;33;.892;3600000;0
18933;142648;769;0;0;0;0;.00nan;0;0
18934;164424;772;100;39;0;39;1.000;3600000;0
18934;11708;772;0;0;0;0;.00nan;0;0
18934;81691;768;0;0;0;0;.00nan;0;0
18934;149221;768;59;14;1;13;.929;3600000;0
18935;177124;775;46;46;7;39;.848;3600000;0
18935;8504;746;56;13;2;11;.846;3600000;0
18935;146249;775;0;0;0;0;.00nan;0;0
18935;149191;746;0;0;0;0;.00nan;0;0
18936;170548;2545;47;20;3;17;.850;3548000;0
18936;201075;760;72;28;2;26;.929;3600000;0
18936;174894;760;0;0;0;0;.00nan;0;0
18936;149048;2545;0;0;0;0;.00nan;0;0
18937;175757;759;0;0;0;0;.00nan;0;0
18937;197595;759;51;21;3;18;.857;3579000;0
18937;67818;3721;67;22;1;21;.955;3600000;0
18937;91194;3721;0;0;0;0;.00nan;0;0
18938;169615;911;79;30;2;28;.933;3849000;0
18938;180606;2197;67;30;3;27;.900;3849000;0
18938;190589;2197;0;0;0;0;.00nan;0;0
18938;76628;911;0;0;0;0;.00nan;0;0
18939;174858;755;0;0;0;0;.00nan;0;0
18939;180154;755;58;26;3;23;.885;3716000;0
18939;63529;4924;86;54;4;50;.926;3716000;0
18939;149262;4924;0;0;0;0;.00nan;0;0
18940;4281;754;87;32;2;30;.938;3893000;0
18940;212428;750;0;0;0;0;.00nan;0;0
18940;180738;750;72;31;2;29;.935;3900000;0
18940;148904;754;0;0;0;0;.00nan;0;0
18941;11882;758;68;27;2;25;.926;3600000;0
18941;189433;758;0;0;0;0;.00nan;0;0
18941;201075;760;57;29;3;26;.897;3585000;0
18941;174894;760;0;0;0;0;.00nan;0;0
18942;177124;775;65;32;3;29;.906;3575000;0
18942;166023;1503;88;29;1;28;.966;3600000;0
18942;142810;1503;0;0;0;0;.00nan;0;0
18942;146249;775;0;0;0;0;.00nan;0;0
18943;164456;1492;0;0;0;0;.00nan;0;0
18943;201933;774;0;0;0;0;.00nan;0;0
18943;82711;1492;100;30;0;30;1.000;3600000;0
18943;149280;774;45;24;4;20;.833;3600000;0
18944;1756;4989;95;29;1;28;.966;3570000;0
18944;190570;4989;0;0;0;0;.00nan;0;0
18944;81691;768;0;0;0;0;.00nan;0;0
18944;149221;768;80;12;0;12;1.000;3600000;0
18945;164424;772;99;22;0;22;1.000;3600000;0
18945;11708;772;0;0;0;0;.00nan;0;0
18945;80222;769;77;33;2;31;.939;3550000;0
18945;142648;769;0;0;0;0;.00nan;0;0
18946;8504;746;53;16;2;14;.875;3600000;0
18946;189264;4923;71;56;6;50;.893;3600000;0
18946;176686;4923;0;0;0;0;.00nan;0;0
18946;149191;746;0;0;0;0;.00nan;0;0
18947;170548;2545;79;31;2;29;.935;3600000;0
18947;63932;3913;35;28;5;23;.821;3600000;0
18947;148576;3913;0;0;0;0;.00nan;0;0
18947;149048;2545;0;0;0;0;.00nan;0;0
18948;174858;755;0;0;0;0;.00nan;0;0
18948;180154;755;46;32;5;27;.844;3600000;0
18948;180606;2197;0;0;0;0;.00nan;0;0
18948;190589;2197;100;34;1;33;.971;3600000;0
18949;175757;759;54;17;2;15;.882;3600000;0
18949;197595;759;0;0;0;0;.00nan;0;0
18949;63529;4924;89;44;3;41;.932;3581000;0
18949;149262;4924;0;0;0;0;.00nan;0;0
18950;169615;911;98;40;2;38;.950;3900000;0
18950;170530;766;90;28;2;26;.929;3900000;0
18950;68233;766;0;0;0;0;.00nan;0;0
18950;76628;911;0;0;0;0;.00nan;0;0
18951;4281;754;0;0;0;0;.00nan;0;0
18951;67446;1497;60;34;4;30;.882;3548000;0
18951;93756;1497;0;0;0;0;.00nan;0;0
18951;148904;754;65;26;2;24;.923;3600000;0
18952;11882;758;69;29;2;27;.931;3575000;0
18952;189264;4923;0;0;0;0;.00nan;0;0
18952;189433;758;0;0;0;0;.00nan;0;0
18952;176686;4923;87;35;1;34;.971;3600000;0
18953;166023;1503;0;0;0;0;.00nan;0;0
18953;63932;3913;74;23;1;22;.957;3600000;0
18953;142810;1503;68;35;4;31;.886;3600000;0
18953;148576;3913;0;0;0;0;.00nan;0;0
18954;3165;767;97;45;3;42;.933;3600000;0
18954;201933;774;0;0;0;0;.00nan;0;0
18954;49815;767;0;0;0;0;.00nan;0;0
18954;149280;774;20;17;5;12;.706;3526000;0
18955;1756;4989;0;0;0;0;.00nan;0;0
18955;169680;3730;44;32;5;27;.844;3600000;0
18955;171113;3730;0;0;0;0;.00nan;0;0
18955;190570;4989;75;30;2;28;.933;3600000;0
18956;164424;772;97;33;1;32;.970;3900000;0
18956;11708;772;0;0;0;0;.00nan;0;0
18956;170543;2199;93;27;1;26;.963;3900000;0
18956;-1;2199;0;0;0;0;.00nan;0;0
18957;279;1093;92;31;1;30;.968;3600000;0
18957;-1;1093;0;0;0;0;.00nan;0;0
18957;212428;750;0;0;0;0;.00nan;0;0
18957;180738;750;58;30;4;26;.867;3600000;0
18958;8504;746;74;28;2;26;.929;3600000;0
18958;201075;760;42;4;1;3;.750;478000;0
18958;174894;760;59;53;6;47;.887;3122000;0
18958;149191;746;0;0;0;0;.00nan;0;0
18959;177124;775;91;34;2;32;.941;3600000;0
18959;170548;2545;0;0;0;0;.00nan;0;0
18959;146249;775;0;0;0;0;.00nan;0;0
18959;149048;2545;74;33;3;30;.909;3544000;0
18960;164456;1492;0;0;0;0;.00nan;0;0
18960;188815;762;92;21;0;21;1.000;3600000;0
18960;186234;762;0;0;0;0;.00nan;0;0
18960;82711;1492;78;48;5;43;.896;3600000;0
18961;169615;911;44;31;5;26;.839;3152000;0
18961;67818;3721;0;0;0;0;.00nan;0;0
18961;76628;911;51;2;0;2;1.000;410000;0
18961;91194;3721;54;24;3;21;.875;3600000;0
18962;175757;759;0;0;0;0;.00nan;0;0
18962;180606;2197;91;41;2;39;.951;3581000;0
18962;190589;2197;0;0;0;0;.00nan;0;0
18962;197595;759;100;22;0;22;1.000;3600000;0
18963;3165;767;91;29;2;27;.931;3600000;0
18963;4281;754;0;0;0;0;.00nan;0;0
18963;49815;767;0;0;0;0;.00nan;0;0
18963;148904;754;48;28;4;24;.857;3553000;0
18964;177124;775;91;38;2;36;.947;3600000;0
18964;11882;758;51;27;3;24;.889;3585000;0
18964;189433;758;0;0;0;0;.00nan;0;0
18964;146249;775;0;0;0;0;.00nan;0;0
18965;201933;774;0;0;0;0;.00nan;0;0
18965;67446;1497;0;0;0;0;.00nan;0;0
18965;93756;1497;67;32;3;29;.906;3580000;0
18965;149280;774;75;15;1;14;.933;3600000;0
18966;1756;4989;78;33;2;31;.939;3836000;0
18966;170543;2199;82;21;1;20;.952;3836000;0
18966;190570;4989;0;0;0;0;.00nan;0;0
18966;-1;2199;0;0;0;0;.00nan;0;0
18967;164424;772;0;0;0;0;.00nan;0;0
18967;11708;772;97;23;0;23;1.000;3600000;0
18967;169680;3730;86;36;2;34;.944;3563000;0
18967;171113;3730;0;0;0;0;.00nan;0;0
18968;279;1093;57;19;2;17;.895;3583000;0
18968;164456;1492;0;0;0;0;.00nan;0;0
18968;-1;1093;0;0;0;0;.00nan;0;0
18968;82711;1492;77;23;1;22;.957;3600000;0
18969;189264;4923;85;38;3;35;.921;3590000;0
18969;170548;2545;79;28;2;26;.929;3600000;0
18969;176686;4923;0;0;0;0;.00nan;0;0
18969;149048;2545;0;0;0;0;.00nan;0;0
18970;188815;762;85;38;2;36;.947;3600000;0
18970;212428;750;0;0;0;0;.00nan;0;0
18970;180738;750;53;22;3;19;.864;3544000;0
18970;186234;762;0;0;0;0;.00nan;0;0
18971;279;1093;77;29;2;27;.931;3514000;0
18971;3165;767;94;23;0;23;1.000;3600000;0
18971;-1;1093;0;0;0;0;.00nan;0;0
18971;49815;767;0;0;0;0;.00nan;0;0
18972;188815;762;64;26;3;23;.885;3693000;0
18972;186234;762;0;0;0;0;.00nan;0;0
18972;67446;1497;0;0;0;0;.00nan;0;0
18972;93756;1497;49;33;4;29;.879;3693000;0
18973;201075;760;81;27;1;26;.963;3600000;0
18973;174894;760;0;0;0;0;.00nan;0;0
18973;180606;2197;78;37;2;35;.946;3568000;0
18973;190589;2197;0;0;0;0;.00nan;0;0
18974;1756;4989;98;44;1;43;.977;3600000;0
18974;212428;750;0;0;0;0;.00nan;0;0
18974;190570;4989;0;0;0;0;.00nan;0;0
18974;180738;750;79;13;0;13;1.000;3600000;0
18975;11882;758;70;52;5;47;.904;3600000;0
18975;189433;758;0;0;0;0;.00nan;0;0
18975;81691;768;0;0;0;0;.00nan;0;0
18975;149221;768;90;17;0;17;1.000;3600000;0
18976;164424;772;0;0;0;0;.00nan;0;0
18976;164456;1492;42;37;6;31;.838;3600000;0
18976;11708;772;83;18;0;18;1.000;3600000;0
18976;82711;1492;0;0;0;0;.00nan;0;0
18977;177124;775;39;27;5;22;.815;3600000;0
18977;67818;3721;56;29;3;26;.897;3600000;0
18977;91194;3721;0;0;0;0;.00nan;0;0
18977;146249;775;0;0;0;0;.00nan;0;0
18978;166023;1503;0;0;0;0;.00nan;0;0
18978;170543;2199;87;16;0;16;1.000;3600000;0
18978;-1;2199;0;0;0;0;.00nan;0;0
18978;142810;1503;59;19;2;17;.895;3576000;0
18979;279;1093;78;29;3;26;.897;3600000;0
18979;-1;1093;0;0;0;0;.00nan;0;0
18979;67446;1497;0;0;0;0;.00nan;0;0
18979;93756;1497;58;42;5;37;.881;3514000;0
18980;8504;746;76;20;1;19;.950;3600000;0
18980;169680;3730;78;33;2;31;.939;3600000;0
18980;171113;3730;0;0;0;0;.00nan;0;0
18980;149191;746;0;0;0;0;.00nan;0;0
18981;189264;4923;0;0;0;0;.00nan;0;0
18981;170530;766;77;27;1;26;.963;3600000;0
18981;176686;4923;47;21;3;18;.857;3595000;0
18981;68233;766;0;0;0;0;.00nan;0;0
18982;3165;767;82;27;1;26;.963;3600000;0
18982;188815;762;64;28;3;25;.893;3559000;0
18982;186234;762;0;0;0;0;.00nan;0;0
18982;49815;767;0;0;0;0;.00nan;0;0
18983;170548;2545;85;11;0;11;1.000;3600000;0
18983;80222;769;71;23;3;20;.870;3600000;0
18983;142648;769;0;0;0;0;.00nan;0;0
18983;149048;2545;0;0;0;0;.00nan;0;0
18984;63529;4924;95;23;0;23;1.000;3600000;0
18984;63932;3913;0;0;0;0;.00nan;0;0
18984;148576;3913;48;34;5;29;.853;3600000;0
18984;149262;4924;0;0;0;0;.00nan;0;0
18985;169615;911;0;0;0;0;.00nan;0;0
18985;174858;755;0;0;0;0;.00nan;0;0
18985;180154;755;71;26;2;24;.923;3600000;0
18985;76628;911;39;22;4;18;.818;3580000;0
18986;201075;760;0;0;0;0;.00nan;0;0
18986;174894;760;69;25;1;24;.960;3600000;0
18986;63529;4924;85;36;2;34;.944;3562000;0
18986;149262;4924;0;0;0;0;.00nan;0;0
18987;164424;772;0;0;0;0;.00nan;0;0
18987;11708;772;55;29;4;25;.862;3535000;0
18987;212428;750;0;0;0;0;.00nan;0;0
18987;180738;750;71;26;2;24;.923;3600000;0
18988;170548;2545;65;40;4;36;.900;3600000;0
18988;81691;768;0;0;0;0;.00nan;0;0
18988;149048;2545;0;0;0;0;.00nan;0;0
18988;149221;768;78;15;0;15;1.000;3600000;0
18989;1756;4989;75;20;2;18;.900;3600000;0
18989;164456;1492;0;0;0;0;.00nan;0;0
18989;190570;4989;0;0;0;0;.00nan;0;0
18989;82711;1492;53;24;3;21;.875;3545000;0
18990;177124;775;0;0;0;0;.00nan;0;0
18990;170530;766;41;29;5;24;.828;3600000;0
18990;68233;766;0;0;0;0;.00nan;0;0
18990;146249;775;58;27;3;24;.889;3600000;0
18991;8504;746;57;16;2;14;.875;3600000;0
18991;170543;2199;51;33;5;28;.848;3600000;0
18991;-1;2199;0;0;0;0;.00nan;0;0
18991;149191;746;0;0;0;0;.00nan;0;0
18992;166023;1503;0;0;0;0;.00nan;0;0
18992;169680;3730;87;55;4;51;.927;3900000;0
18992;171113;3730;0;0;0;0;.00nan;0;0
18992;142810;1503;55;21;4;17;.810;3900000;0
18993;189264;4923;85;17;0;17;1.000;3600000;0
18993;176686;4923;0;0;0;0;.00nan;0;0
18993;67818;3721;79;28;2;26;.929;3513000;0
18993;91194;3721;0;0;0;0;.00nan;0;0
18994;11882;758;48;27;4;23;.852;3900000;0
18994;189433;758;0;0;0;0;.00nan;0;0
18994;80222;769;79;38;4;34;.895;3900000;0
18994;142648;769;0;0;0;0;.00nan;0;0
18995;180606;2197;100;28;0;28;1.000;3600000;0
18995;190589;2197;0;0;0;0;.00nan;0;0
18995;63932;3913;57;28;3;25;.893;3600000;0
18995;148576;3913;0;0;0;0;.00nan;0;0
18996;169615;911;56;18;3;15;.833;3600000;0
18996;175757;759;0;0;0;0;.00nan;0;0
18996;197595;759;60;34;4;30;.882;3545000;0
18996;76628;911;0;0;0;0;.00nan;0;0
18997;170530;766;43;11;2;9;.818;3600000;0
18997;201075;760;0;0;0;0;.00nan;0;0
18997;174894;760;67;34;3;31;.912;3576000;0
18997;68233;766;0;0;0;0;.00nan;0;0
18998;164424;772;68;22;2;20;.909;3600000;0
18998;11708;772;0;0;0;0;.00nan;0;0
18998;67446;1497;64;34;4;30;.882;3600000;0
18998;93756;1497;0;0;0;0;.00nan;0;0
18999;8504;746;85;32;2;30;.938;3849000;0
18999;81691;768;59;25;2;23;.920;3900000;0
18999;149191;746;0;0;0;0;.00nan;0;0
18999;149221;768;0;0;0;0;.00nan;0;0
19000;1756;4989;97;39;1;38;.974;3900000;0
19000;3165;767;84;25;1;24;.960;3900000;0
19000;190570;4989;0;0;0;0;.00nan;0;0
19000;49815;767;0;0;0;0;.00nan;0;0
19001;177124;775;36;22;4;18;.818;3519000;0
19001;63529;4924;99;54;2;52;.963;3600000;0
19001;146249;775;0;0;0;0;.00nan;0;0
19001;149262;4924;0;0;0;0;.00nan;0;0
19002;170543;2199;0;0;0;0;.00nan;0;0
19002;170548;2545;51;26;4;22;.846;3552000;0
19002;-1;2199;94;47;3;44;.936;3600000;0
19002;149048;2545;0;0;0;0;.00nan;0;0
19003;279;1093;24;30;7;23;.767;2719000;0
19003;-1;1093;44;5;1;4;.800;881000;0
19003;201933;774;0;0;0;0;.00nan;0;0
19003;149280;774;70;29;2;27;.931;3600000;0
19004;11882;758;100;26;0;26;1.000;3600000;0
19004;189433;758;0;0;0;0;.00nan;0;0
19004;169680;3730;60;36;4;32;.889;3600000;0
19004;171113;3730;0;0;0;0;.00nan;0;0
19005;189264;4923;60;21;2;19;.905;3600000;0
19005;176686;4923;0;0;0;0;.00nan;0;0
19005;180606;2197;48;43;6;37;.860;2896000;0
19005;190589;2197;56;6;0;6;1.000;704000;0
19006;4281;754;0;0;0;0;.00nan;0;0
19006;188815;762;55;45;6;39;.867;3586000;0
19006;186234;762;0;0;0;0;.00nan;0;0
19006;148904;754;46;32;5;27;.844;3600000;0
19007;166023;1503;0;0;0;0;.00nan;0;0
19007;80222;769;78;46;5;41;.891;3600000;0
19007;142648;769;0;0;0;0;.00nan;0;0
19007;142810;1503;74;21;1;20;.952;3600000;0
19008;63932;3913;86;16;0;16;1.000;3600000;0
19008;67818;3721;68;29;3;26;.897;3600000;0
19008;91194;3721;0;0;0;0;.00nan;0;0
19008;148576;3913;0;0;0;0;.00nan;0;0
19009;174858;755;62;34;4;30;.882;3600000;0
19009;175757;759;54;24;3;21;.875;3600000;0
19009;180154;755;0;0;0;0;.00nan;0;0
19009;197595;759;0;0;0;0;.00nan;0;0
19010;201075;760;100;34;0;34;1.000;3600000;0
19010;174894;760;0;0;0;0;.00nan;0;0
19010;67818;3721;31;22;5;17;.773;3600000;0
19010;91194;3721;0;0;0;0;.00nan;0;0
19011;1756;4989;77;26;2;24;.923;3600000;0
19011;190570;4989;0;0;0;0;.00nan;0;0
19011;67446;1497;0;0;0;0;.00nan;0;0
19011;93756;1497;32;19;4;15;.789;3547000;0
19012;164456;1492;0;0;0;0;.00nan;0;0
19012;212428;750;0;0;0;0;.00nan;0;0
19012;180738;750;76;12;0;12;1.000;3600000;0
19012;82711;1492;98;41;1;40;.976;3544000;0
19013;166023;1503;0;0;0;0;.00nan;0;0
19013;81691;768;0;0;0;0;.00nan;0;0
19013;142810;1503;49;38;6;32;.842;3600000;0
19013;149221;768;74;23;2;21;.913;3600000;0
19014;3165;767;65;31;3;28;.903;3900000;0
19014;164424;772;53;29;3;26;.897;3900000;0
19014;11708;772;0;0;0;0;.00nan;0;0
19014;49815;767;0;0;0;0;.00nan;0;0
19015;177124;775;52;24;3;21;.875;3523000;0
19015;180606;2197;0;0;0;0;.00nan;0;0
19015;190589;2197;87;25;1;24;.960;3600000;0
19015;146249;775;0;0;0;0;.00nan;0;0
19016;11882;758;74;29;2;27;.931;3587000;0
19016;189433;758;0;0;0;0;.00nan;0;0
19016;170543;2199;81;23;1;22;.957;3600000;0
19016;-1;2199;0;0;0;0;.00nan;0;0
19017;279;1093;97;25;0;25;1.000;3600000;0
19017;4281;754;61;36;4;32;.889;3600000;0
19017;-1;1093;0;0;0;0;.00nan;0;0
19017;148904;754;0;0;0;0;.00nan;0;0
19018;169680;3730;70;33;4;29;.879;3600000;0
19018;170548;2545;72;21;1;20;.952;3600000;0
19018;171113;3730;0;0;0;0;.00nan;0;0
19018;149048;2545;0;0;0;0;.00nan;0;0
19019;189264;4923;0;0;0;0;.00nan;0;0
19019;176686;4923;51;31;4;27;.871;3553000;0
19019;63529;4924;56;26;3;23;.885;3600000;0
19019;149262;4924;0;0;0;0;.00nan;0;0
19020;188815;762;61;31;3;28;.903;3600000;0
19020;201933;774;0;0;0;0;.00nan;0;0
19020;186234;762;0;0;0;0;.00nan;0;0
19020;149280;774;55;29;4;25;.862;3600000;0
19021;8504;746;60;24;2;22;.917;3786000;0
19021;80222;769;86;44;3;41;.932;3786000;0
19021;142648;769;0;0;0;0;.00nan;0;0
19021;149191;746;0;0;0;0;.00nan;0;0
19022;170530;766;55;29;4;25;.862;3515000;0
19022;63932;3913;73;31;2;29;.935;3600000;0
19022;68233;766;0;0;0;0;.00nan;0;0
19022;148576;3913;0;0;0;0;.00nan;0;0
19024;3165;767;0;0;0;0;.00nan;0;0
19024;175757;759;0;0;0;0;.00nan;0;0
19024;197595;759;47;24;3;21;.875;3513000;0
19024;91358;767;69;17;1;16;.941;3600000;0
19026;212428;750;0;0;0;0;.00nan;0;0
19026;201933;774;0;0;0;0;.00nan;0;0
19026;180738;750;99;49;2;47;.959;3900000;0
19026;149280;774;87;33;2;31;.939;3900000;0
19028;164456;1492;0;0;0;0;.00nan;0;0
19028;170530;1492;75;34;3;31;.912;3521000;0
19028;174898;4924;72;21;1;20;.952;3600000;0
19028;186219;4924;0;0;0;0;.00nan;0;0
19030;189264;4923;0;0;0;0;.00nan;0;0
19030;176686;4923;92;34;1;33;.971;3900000;0
19030;186234;754;76;28;1;27;.964;3900000;0
19030;148904;754;0;0;0;0;.00nan;0;0
19032;279;766;79;49;5;44;.898;3600000;0
19032;11882;758;100;27;0;27;1.000;3600000;0
19032;189433;758;0;0;0;0;.00nan;0;0
19032;82711;766;0;0;0;0;.00nan;0;0
19034;177124;775;0;0;0;0;.00nan;0;0
19034;-1;4989;0;0;0;0;.00nan;0;0
19034;71485;4989;76;20;1;19;.950;3600000;0
19034;146249;775;48;13;2;11;.846;3554000;0
19036;174858;755;0;0;0;0;.00nan;0;0
19036;180154;755;85;47;3;44;.936;3600000;0
19036;67818;3721;54;22;2;20;.909;3600000;0
19036;91194;3721;0;0;0;0;.00nan;0;0
19038;11708;772;0;0;0;0;.00nan;0;0
19038;188815;762;85;37;2;35;.946;3600000;0
19038;63932;772;72;23;1;22;.957;3600000;0
19038;82817;762;0;0;0;0;.00nan;0;0
19040;-1;1093;53;31;4;27;.871;3547000;0
19040;169615;911;55;30;3;27;.900;3600000;0
19040;68233;1093;0;0;0;0;.00nan;0;0
19040;93756;911;0;0;0;0;.00nan;0;0
19042;174894;760;0;0;0;0;.00nan;0;0
19042;-1;746;0;0;0;0;.00nan;0;0
19042;149112;760;72;50;5;45;.900;3600000;0
19042;149191;746;63;15;2;13;.867;3600000;0
19044;169680;3730;0;0;0;0;.00nan;0;0
19044;171113;3730;98;55;3;52;.945;3600000;0
19044;80222;768;60;13;1;12;.923;3600000;0
19044;81691;768;0;0;0;0;.00nan;0;0
19046;170543;2199;34;22;4;18;.818;2285000;0
19046;170548;2545;50;25;4;21;.840;3640000;0
19046;149048;2545;0;0;0;0;.00nan;0;0
19046;149262;2199;65;14;1;13;.929;1355000;0
19048;1756;1497;0;0;0;0;.00nan;0;0
19048;166023;1503;0;0;0;0;.00nan;0;0
19048;63529;1497;79;32;2;30;.938;3900000;0
19048;142810;1503;85;34;2;32;.941;3900000;0
19050;164424;3913;22;22;6;16;.727;3051000;0
19050;142648;769;0;0;0;0;.00nan;0;0
19050;148576;3913;58;10;0;10;1.000;549000;0
19050;149221;769;64;28;3;25;.893;3600000;0
19052;170543;2199;44;17;3;14;.824;3600000;0
19052;180606;2197;0;0;0;0;.00nan;0;0
19052;190589;2197;63;38;4;34;.895;3544000;0
19052;149262;2199;0;0;0;0;.00nan;0;0
19054;170548;2545;41;27;4;23;.852;3600000;0
19054;174898;4924;0;0;0;0;.00nan;0;0
19054;186219;4924;81;38;2;36;.947;3600000;0
19054;149048;2545;0;0;0;0;.00nan;0;0
19056;189264;4923;60;34;4;30;.882;3600000;0
19056;175757;759;63;29;3;26;.897;3600000;0
19056;176686;4923;0;0;0;0;.00nan;0;0
19056;197595;759;0;0;0;0;.00nan;0;0
19058;169615;911;73;24;1;23;.958;3900000;0
19058;186234;754;81;26;1;25;.962;3900000;0
19058;93756;911;0;0;0;0;.00nan;0;0
19058;148904;754;0;0;0;0;.00nan;0;0
19060;-1;746;0;0;0;0;.00nan;0;0
19060;80222;768;49;18;3;15;.833;3536000;0
19060;81691;768;0;0;0;0;.00nan;0;0
19060;149191;746;90;34;1;33;.971;3600000;0
19062;164456;1492;0;0;0;0;.00nan;0;0
19062;166023;1503;0;0;0;0;.00nan;0;0
19062;170530;1492;100;33;0;33;1.000;3600000;0
19062;142810;1503;81;21;1;20;.952;3600000;0
19064;-1;4989;0;0;0;0;.00nan;0;0
19064;174858;755;0;0;0;0;.00nan;0;0
19064;180154;755;71;31;2;29;.935;3522000;0
19064;71485;4989;98;25;0;25;1.000;3600000;0
19066;1756;1497;86;34;2;32;.941;3600000;0
19066;188815;762;63;33;4;29;.879;3578000;0
19066;63529;1497;0;0;0;0;.00nan;0;0
19066;82817;762;0;0;0;0;.00nan;0;0
19068;11708;772;0;0;0;0;.00nan;0;0
19068;212428;750;0;0;0;0;.00nan;0;0
19068;180738;750;70;23;2;21;.913;3900000;0
19068;63932;772;62;24;2;22;.917;3900000;0
19070;177124;775;63;31;3;28;.903;3600000;0
19070;174894;760;60;21;2;19;.905;3600000;0
19070;146249;775;0;0;0;0;.00nan;0;0
19070;149112;760;0;0;0;0;.00nan;0;0
19072;164424;3913;65;35;5;30;.857;3600000;0
19072;67818;3721;0;0;0;0;.00nan;0;0
19072;91194;3721;70;18;2;16;.889;3600000;0
19072;148576;3913;0;0;0;0;.00nan;0;0
19074;279;766;93;30;1;29;.967;3600000;0
19074;82711;766;0;0;0;0;.00nan;0;0
19074;142648;769;0;0;0;0;.00nan;0;0
19074;149221;769;73;26;2;24;.923;3600000;0
19076;-1;1093;98;36;1;35;.972;3573000;0
19076;201933;774;0;0;0;0;.00nan;0;0
19076;68233;1093;0;0;0;0;.00nan;0;0
19076;149280;774;100;27;0;27;1.000;3600000;0
19078;3165;767;0;0;0;0;.00nan;0;0
19078;11882;758;93;18;0;18;1.000;3600000;0
19078;189433;758;0;0;0;0;.00nan;0;0
19078;91358;767;98;35;2;33;.943;3579000;0
19080;175757;759;0;0;0;0;.00nan;0;0
19080;-1;746;52;29;4;25;.862;3572000;0
19080;197595;759;83;37;3;34;.919;3600000;0
19080;149191;746;0;0;0;0;.00nan;0;0
19082;279;766;0;0;0;0;.00nan;0;0
19082;174894;760;0;0;0;0;.00nan;0;0
19082;82711;766;43;35;5;30;.857;3600000;0
19082;149112;760;61;16;1;15;.938;3600000;0
19084;169680;3730;70;43;4;39;.907;3600000;0
19084;170543;2199;0;0;0;0;.00nan;0;0
19084;171113;3730;0;0;0;0;.00nan;0;0
19084;149262;2199;91;21;0;21;1.000;3600000;0
19086;11708;772;78;25;1;24;.960;3600000;0
19086;63932;772;0;0;0;0;.00nan;0;0
19086;67818;3721;20;26;7;19;.731;3600000;0
19086;91194;3721;0;0;0;0;.00nan;0;0
19088;180606;2197;45;32;4;28;.875;3900000;0
19088;190589;2197;0;0;0;0;.00nan;0;0
19088;142648;769;57;33;4;29;.879;3900000;0
19088;149221;769;0;0;0;0;.00nan;0;0
19090;212428;750;37;26;5;21;.808;3581000;0
19090;180738;750;0;0;0;0;.00nan;0;0
19090;80222;768;0;0;0;0;.00nan;0;0
19090;81691;768;80;37;3;34;.919;3600000;0
19092;3165;767;100;24;0;24;1.000;3600000;0
19092;166023;1503;82;32;2;30;.938;3516000;0
19092;91358;767;0;0;0;0;.00nan;0;0
19092;142810;1503;0;0;0;0;.00nan;0;0
19094;-1;4989;0;0;0;0;.00nan;0;0
19094;174858;755;67;23;2;21;.913;3600000;0
19094;180154;755;0;0;0;0;.00nan;0;0
19094;71485;4989;45;25;4;21;.840;3564000;0
19096;11882;758;100;28;0;28;1.000;3600000;0
19096;189264;4923;0;0;0;0;.00nan;0;0
19096;189433;758;0;0;0;0;.00nan;0;0
19096;176686;4923;65;33;3;30;.909;3600000;0
19098;169615;911;43;11;2;9;.818;1365000;0
19098;174898;4924;75;54;6;48;.889;3600000;0
19098;186219;4924;0;0;0;0;.00nan;0;0
19098;93756;911;17;20;6;14;.700;2183000;0
19100;-1;1093;0;0;0;0;.00nan;0;0
19100;170548;2545;0;0;0;0;.00nan;0;0
19100;68233;1093;72;30;2;28;.933;3600000;0
19100;149048;2545;86;31;1;30;.968;3600000;0
19102;164424;3913;0;0;0;0;.00nan;0;0
19102;186234;754;0;0;0;0;.00nan;0;0
19102;148576;3913;100;39;1;38;.974;3900000;0
19102;148904;754;77;17;1;16;.941;3900000;0
19104;177124;775;0;0;0;0;.00nan;0;0
19104;201933;774;0;0;0;0;.00nan;0;0
19104;146249;775;100;43;0;43;1.000;3900000;0
19104;149280;774;96;28;0;28;1.000;3900000;0
19106;1756;1497;0;0;0;0;.00nan;0;0
19106;164456;1492;0;0;0;0;.00nan;0;0
19106;170530;1492;57;36;5;31;.861;3574000;0
19106;63529;1497;72;28;3;25;.893;3600000;0
19108;188815;762;35;26;5;21;.808;3553000;0
19108;174898;4924;0;0;0;0;.00nan;0;0
19108;186219;4924;35;20;4;16;.800;3600000;0
19108;82817;762;0;0;0;0;.00nan;0;0
19110;11882;758;76;39;3;36;.923;3829000;0
19110;189433;758;0;0;0;0;.00nan;0;0
19110;170548;2545;63;34;4;30;.882;3829000;0
19110;149048;2545;0;0;0;0;.00nan;0;0
19112;1756;1497;86;15;0;15;1.000;3600000;0
19112;180606;2197;53;2;0;2;1.000;352000;0
19112;190589;2197;32;32;6;26;.813;3248000;0
19112;63529;1497;0;0;0;0;.00nan;0;0
19114;164424;3913;65;30;3;27;.900;3600000;0
19114;169680;3730;0;0;0;0;.00nan;0;0
19114;171113;3730;34;34;6;28;.824;3600000;0
19114;148576;3913;0;0;0;0;.00nan;0;0
19116;201933;774;0;0;0;0;.00nan;0;0
19116;186234;754;0;0;0;0;.00nan;0;0
19116;148904;754;80;20;1;19;.950;3600000;0
19116;149280;774;58;39;4;35;.897;3600000;0
19118;170543;2199;67;16;1;15;.938;1868000;0
19118;174894;760;88;31;1;30;.968;3600000;0
19118;149112;760;0;0;0;0;.00nan;0;0
19118;149262;2199;24;18;5;13;.722;1732000;0
19120;166023;1503;0;0;0;0;.00nan;0;0
19120;169615;911;87;32;1;31;.969;3600000;0
19120;93756;911;0;0;0;0;.00nan;0;0
19120;142810;1503;68;30;3;27;.900;3522000;0
19122;3165;767;40;20;4;16;.800;3900000;0
19122;164456;1492;59;36;4;32;.889;3900000;0
19122;170530;1492;0;0;0;0;.00nan;0;0
19122;91358;767;0;0;0;0;.00nan;0;0
19124;-1;4989;0;0;0;0;.00nan;0;0
19124;67818;3721;57;16;2;14;.875;3600000;0
19124;71485;4989;79;34;3;31;.912;3600000;0
19124;91194;3721;0;0;0;0;.00nan;0;0
19126;175757;759;0;0;0;0;.00nan;0;0
19126;-1;746;0;0;0;0;.00nan;0;0
19126;197595;759;82;31;2;29;.935;3554000;0
19126;149191;746;74;23;1;22;.957;3600000;0
19128;177124;775;0;0;0;0;.00nan;0;0
19128;189264;4923;75;34;3;31;.912;3600000;0
19128;176686;4923;0;0;0;0;.00nan;0;0
19128;146249;775;71;36;4;32;.889;3543000;0
19130;212428;750;0;0;0;0;.00nan;0;0
19130;180738;750;69;20;1;19;.950;3600000;0
19130;142648;769;0;0;0;0;.00nan;0;0
19130;149221;769;83;39;2;37;.949;3577000;0
19132;11708;772;0;0;0;0;.00nan;0;0
19132;174858;755;0;0;0;0;.00nan;0;0
19132;180154;755;58;37;5;32;.865;3600000;0
19132;63932;772;62;24;2;22;.917;3600000;0
19134;279;766;66;46;4;42;.913;3600000;0
19134;80222;768;76;29;2;27;.931;3600000;0
19134;81691;768;0;0;0;0;.00nan;0;0
19134;82711;766;0;0;0;0;.00nan;0;0
19136;3165;767;0;0;0;0;.00nan;0;0
19136;175757;759;89;26;1;25;.962;3600000;0
19136;197595;759;0;0;0;0;.00nan;0;0
19136;91358;767;86;48;3;45;.938;3569000;0
19138;169615;911;0;0;0;0;.00nan;0;0
19138;80222;768;0;0;0;0;.00nan;0;0
19138;81691;768;53;9;1;8;.889;3600000;0
19138;93756;911;49;30;5;25;.833;3600000;0
19140;177124;775;70;29;3;26;.897;3600000;0
19140;186234;754;100;23;0;23;1.000;3600000;0
19140;146249;775;0;0;0;0;.00nan;0;0
19140;148904;754;0;0;0;0;.00nan;0;0
19142;188815;762;0;0;0;0;.00nan;0;0
19142;212428;750;44;23;4;19;.826;3538000;0
19142;180738;750;0;0;0;0;.00nan;0;0
19142;82817;762;93;46;2;44;.957;3600000;0
19144;279;766;0;0;0;0;.00nan;0;0
19144;174898;4924;47;20;3;17;.850;3600000;0
19144;186219;4924;0;0;0;0;.00nan;0;0
19144;82711;766;56;33;4;29;.879;3600000;0
19146;169680;3730;90;50;3;47;.940;3572000;0
19146;171113;3730;0;0;0;0;.00nan;0;0
19146;201933;774;65;25;2;23;.920;3600000;0
19146;149280;774;0;0;0;0;.00nan;0;0
19148;166023;1503;55;22;3;19;.864;3600000;0
19148;180606;2197;52;48;6;42;.875;3600000;0
19148;190589;2197;0;0;0;0;.00nan;0;0
19148;142810;1503;0;0;0;0;.00nan;0;0
19150;164456;1492;0;0;0;0;.00nan;0;0
19150;170530;1492;99;37;1;36;.973;3600000;0
19150;67818;3721;0;0;0;0;.00nan;0;0
19150;91194;3721;36;25;5;20;.800;3600000;0
19152;11708;772;57;29;3;26;.897;3600000;0
19152;11882;758;0;0;0;0;.00nan;0;0
19152;189433;758;100;28;0;28;1.000;3600000;0
19152;63932;772;0;0;0;0;.00nan;0;0
19154;164424;3913;0;0;0;0;.00nan;0;0
19154;-1;1093;79;21;1;20;.952;3600000;0
19154;68233;1093;0;0;0;0;.00nan;0;0
19154;148576;3913;90;34;2;32;.941;3569000;0
19156;170543;2199;69;28;2;26;.929;3900000;0
19156;170548;2545;0;0;0;0;.00nan;0;0
19156;149048;2545;86;35;2;33;.943;3900000;0
19156;149262;2199;0;0;0;0;.00nan;0;0
19158;189264;4923;0;0;0;0;.00nan;0;0
19158;174858;755;26;6;3;3;.500;487000;0
19158;176686;4923;45;26;4;22;.846;3600000;0
19158;180154;755;45;26;5;21;.808;3113000;0
19160;174894;760;0;0;0;0;.00nan;0;0
19160;142648;769;52;23;3;20;.870;3600000;0
19160;149112;760;100;24;0;24;1.000;3600000;0
19160;149221;769;0;0;0;0;.00nan;0;0
19162;-1;4989;88;42;3;39;.929;3600000;0
19162;-1;746;80;14;0;14;1.000;3600000;0
19162;71485;4989;0;0;0;0;.00nan;0;0
19162;149191;746;0;0;0;0;.00nan;0;0
19164;174858;755;0;0;0;0;.00nan;0;0
19164;180154;755;89;54;4;50;.926;3600000;0
19164;201933;774;0;0;0;0;.00nan;0;0
19164;149280;774;74;11;0;11;1.000;3600000;0
19166;169615;911;53;24;4;20;.833;3557000;0
19166;174898;4924;0;0;0;0;.00nan;0;0
19166;186219;4924;85;41;2;39;.951;3600000;0
19166;93756;911;0;0;0;0;.00nan;0;0
19168;188815;762;84;28;1;27;.964;3600000;0
19168;169680;3730;93;41;2;39;.951;3600000;0
19168;171113;3730;0;0;0;0;.00nan;0;0
19168;82817;762;0;0;0;0;.00nan;0;0
19170;177124;775;0;0;0;0;.00nan;0;0
19170;-1;1093;89;36;1;35;.972;3900000;0
19170;68233;1093;0;0;0;0;.00nan;0;0
19170;146249;775;80;25;1;24;.960;3900000;0
19172;164424;3913;72;27;3;24;.889;3600000;0
19172;164456;1492;49;8;1;7;.875;691000;0
19172;170530;1492;43;39;6;33;.846;2909000;0
19172;148576;3913;0;0;0;0;.00nan;0;0
19174;175757;759;0;0;0;0;.00nan;0;0
19174;186234;754;98;22;0;22;1.000;3600000;0
19174;197595;759;95;35;1;34;.971;3555000;0
19174;148904;754;0;0;0;0;.00nan;0;0
19176;1756;1497;75;26;1;25;.962;3600000;0
19176;-1;4989;0;0;0;0;.00nan;0;0
19176;63529;1497;0;0;0;0;.00nan;0;0
19176;71485;4989;45;28;4;24;.857;3600000;0
19178;11882;758;0;0;0;0;.00nan;0;0
19178;189433;758;52;22;3;19;.864;3900000;0
19178;170548;2545;0;0;0;0;.00nan;0;0
19178;149048;2545;64;31;3;28;.903;3900000;0
19180;174894;760;0;0;0;0;.00nan;0;0
19180;212428;750;0;0;0;0;.00nan;0;0
19180;180738;750;63;24;3;21;.875;3600000;0
19180;149112;760;60;33;4;29;.879;3600000;0
19182;11708;772;0;0;0;0;.00nan;0;0
19182;166023;1503;0;0;0;0;.00nan;0;0
19182;63932;772;67;34;3;31;.912;3600000;0
19182;142810;1503;100;24;0;24;1.000;3600000;0
19184;279;766;48;23;4;19;.826;3600000;0
19184;82711;766;0;0;0;0;.00nan;0;0
19184;142648;769;0;0;0;0;.00nan;0;0
19184;149221;769;61;41;5;36;.878;3579000;0
19186;3165;767;0;0;0;0;.00nan;0;0
19186;80222;768;74;29;2;27;.931;3600000;0
19186;81691;768;0;0;0;0;.00nan;0;0
19186;91358;767;49;38;5;33;.868;3600000;0
19188;170543;2199;54;26;3;23;.885;3600000;0
19188;180606;2197;65;40;4;36;.900;3600000;0
19188;190589;2197;0;0;0;0;.00nan;0;0
19188;149262;2199;0;0;0;0;.00nan;0;0
19190;189264;4923;81;26;1;25;.962;3600000;0
19190;176686;4923;0;0;0;0;.00nan;0;0
19190;-1;746;59;19;2;17;.895;3556000;0
19190;149191;746;0;0;0;0;.00nan;0;0
19192;11882;758;73;30;2;28;.933;3900000;0
19192;189433;758;0;0;0;0;.00nan;0;0
19192;-1;746;0;0;0;0;.00nan;0;0
19192;149191;746;91;38;2;36;.947;3900000;0
19194;1756;1497;0;0;0;0;.00nan;0;0
19194;174858;755;61;9;0;9;1.000;1192000;0
19194;180154;755;13;24;7;17;.708;2408000;0
19194;63529;1497;66;34;4;30;.882;3600000;0
19196;11708;772;65;29;3;26;.897;3563000;0
19196;189264;4923;0;0;0;0;.00nan;0;0
19196;176686;4923;93;34;2;32;.941;3600000;0
19196;63932;772;0;0;0;0;.00nan;0;0
19198;164456;1492;83;35;2;33;.943;3543000;0
19198;170530;1492;0;0;0;0;.00nan;0;0
19198;175757;759;93;21;0;21;1.000;3600000;0
19198;197595;759;0;0;0;0;.00nan;0;0
19200;-1;1093;0;0;0;0;.00nan;0;0
19200;68233;1093;78;32;2;30;.938;3600000;0
19200;80222;768;54;11;1;10;.909;795000;0
19200;81691;768;25;26;6;20;.769;2805000;0
19202;164424;3913;0;0;0;0;.00nan;0;0
19202;170543;2199;0;0;0;0;.00nan;0;0
19202;148576;3913;100;30;1;29;.967;3600000;0
19202;149262;2199;57;19;2;17;.895;3600000;0
19204;166023;1503;0;0;0;0;.00nan;0;0
19204;170548;2545;76;44;3;41;.932;3600000;0
19204;142810;1503;80;15;0;15;1.000;3600000;0
19204;149048;2545;0;0;0;0;.00nan;0;0
19206;169615;911;0;0;0;0;.00nan;0;0
19206;93756;911;79;28;2;26;.929;3600000;0
19206;142648;769;41;35;5;30;.857;3600000;0
19206;149221;769;0;0;0;0;.00nan;0;0
19208;279;766;0;0;0;0;.00nan;0;0
19208;212428;750;54;14;2;12;.857;3600000;0
19208;180738;750;0;0;0;0;.00nan;0;0
19208;82711;766;73;38;3;35;.921;3587000;0
19210;177124;775;95;36;1;35;.972;3600000;0
19210;186234;754;63;19;2;17;.895;3579000;0
19210;146249;775;0;0;0;0;.00nan;0;0
19210;148904;754;0;0;0;0;.00nan;0;0
19212;3165;767;71;22;2;20;.909;3528000;0
19212;-1;4989;91;39;1;38;.974;3600000;0
19212;71485;4989;0;0;0;0;.00nan;0;0
19212;91358;767;0;0;0;0;.00nan;0;0
19214;174894;760;84;44;3;41;.932;3900000;0
19214;67818;3721;72;30;3;27;.900;3900000;0
19214;91194;3721;0;0;0;0;.00nan;0;0
19214;149112;760;0;0;0;0;.00nan;0;0
19216;188815;762;0;0;0;0;.00nan;0;0
19216;169680;3730;0;0;0;0;.00nan;0;0
19216;171113;3730;72;36;3;33;.917;3600000;0
19216;82817;762;77;9;0;9;1.000;3600000;0
19218;201933;774;0;0;0;0;.00nan;0;0
19218;180606;2197;0;0;0;0;.00nan;0;0
19218;190589;2197;60;42;5;37;.881;3600000;0
19218;149280;774;66;17;1;16;.941;3600000;0
22503;11882;758;69;54;5;49;.907;3228000;0
22503;189433;758;56;5;0;5;1.000;372000;0
22503;81691;768;0;0;0;0;.00nan;0;0
22503;149221;768;80;14;0;14;1.000;3600000;0
22504;8504;746;80;25;1;24;.960;3543000;0
22504;164424;772;100;30;0;30;1.000;3600000;0
22504;11708;772;0;0;0;0;.00nan;0;0
22504;149191;746;0;0;0;0;.00nan;0;0
22505;169615;911;74;20;1;19;.950;3600000;0
22505;175757;759;0;0;0;0;.00nan;0;0
22505;197595;759;40;30;5;25;.833;3600000;0
22505;76628;911;0;0;0;0;.00nan;0;0
22506;4281;754;0;0;0;0;.00nan;0;0
22506;170543;2199;96;26;0;26;1.000;3600000;0
22506;-1;2199;0;0;0;0;.00nan;0;0
22506;148904;754;63;29;3;26;.897;3600000;0
22507;177124;775;68;39;4;35;.897;4657000;0
22507;3165;767;60;27;3;24;.889;4657000;0
22507;49815;767;0;0;0;0;.00nan;0;0
22507;146249;775;0;0;0;0;.00nan;0;0
22508;201933;774;0;0;0;0;.00nan;0;0
22508;63932;3913;94;33;1;32;.970;3600000;0
22508;148576;3913;0;0;0;0;.00nan;0;0
22508;149280;774;62;30;4;26;.867;3600000;0
22509;170530;766;68;32;3;29;.906;3568000;0
22509;212428;750;0;0;0;0;.00nan;0;0
22509;180738;750;72;19;1;18;.947;3600000;0
22509;68233;766;0;0;0;0;.00nan;0;0
22510;166023;1503;0;0;0;0;.00nan;0;0
22510;170548;2545;76;30;2;28;.933;3542000;0
22510;142810;1503;70;21;1;20;.952;3600000;0
22510;149048;2545;0;0;0;0;.00nan;0;0
22511;11882;758;65;37;5;32;.865;3600000;0
22511;189433;758;0;0;0;0;.00nan;0;0
22511;81691;768;0;0;0;0;.00nan;0;0
22511;149221;768;10;26;7;19;.731;3528000;0
22512;8504;746;62;27;3;24;.889;3600000;0
22512;164424;772;100;26;0;26;1.000;3600000;0
22512;11708;772;0;0;0;0;.00nan;0;0
22512;149191;746;0;0;0;0;.00nan;0;0
22513;169615;911;88;27;1;26;.963;3600000;0
22513;175757;759;0;0;0;0;.00nan;0;0
22513;197595;759;92;42;3;39;.929;3541000;0
22513;76628;911;0;0;0;0;.00nan;0;0
22514;4281;754;0;0;0;0;.00nan;0;0
22514;170543;2199;55;24;3;21;.875;3600000;0
22514;-1;2199;0;0;0;0;.00nan;0;0
22514;148904;754;61;34;4;30;.882;3577000;0
22515;177124;775;86;29;1;28;.966;3600000;0
22515;3165;767;47;28;4;24;.857;3600000;0
22515;49815;767;0;0;0;0;.00nan;0;0
22515;146249;775;0;0;0;0;.00nan;0;0
22516;201933;774;0;0;0;0;.00nan;0;0
22516;63932;3913;69;46;4;42;.913;3538000;0
22516;148576;3913;0;0;0;0;.00nan;0;0
22516;149280;774;95;43;2;41;.953;3600000;0
22517;170530;766;78;37;3;34;.919;3600000;0
22517;212428;750;0;0;0;0;.00nan;0;0
22517;180738;750;64;38;4;34;.895;3546000;0
22517;68233;766;0;0;0;0;.00nan;0;0
22518;166023;1503;0;0;0;0;.00nan;0;0
22518;170548;2545;73;44;5;39;.886;4570000;0
22518;142810;1503;36;29;4;25;.862;4570000;0
22518;149048;2545;0;0;0;0;.00nan;0;0
22519;11882;758;61;42;4;38;.905;3549000;0
22519;189433;758;0;0;0;0;.00nan;0;0
22519;81691;768;0;0;0;0;.00nan;0;0
22519;149221;768;58;15;2;13;.867;3600000;0
22520;8504;746;96;21;0;21;1.000;3600000;0
22520;164424;772;65;38;4;34;.895;3600000;0
22520;11708;772;0;0;0;0;.00nan;0;0
22520;149191;746;0;0;0;0;.00nan;0;0
22521;169615;911;64;21;2;19;.905;3600000;0
22521;175757;759;0;0;0;0;.00nan;0;0
22521;197595;759;93;35;1;34;.971;3600000;0
22521;76628;911;0;0;0;0;.00nan;0;0
22522;4281;754;0;0;0;0;.00nan;0;0
22522;170543;2199;58;21;3;18;.857;3600000;0
22522;-1;2199;0;0;0;0;.00nan;0;0
22522;148904;754;50;36;4;32;.889;3556000;0
22523;177124;775;79;32;2;30;.938;3544000;0
22523;3165;767;80;25;1;24;.960;3600000;0
22523;49815;767;0;0;0;0;.00nan;0;0
22523;146249;775;0;0;0;0;.00nan;0;0
22524;201933;774;0;0;0;0;.00nan;0;0
22524;63932;3913;77;26;2;24;.923;3600000;0
22524;148576;3913;0;0;0;0;.00nan;0;0
22524;149280;774;100;27;0;27;1.000;3600000;0
22525;170530;766;89;21;0;21;1.000;3600000;0
22525;212428;750;0;0;0;0;.00nan;0;0
22525;180738;750;59;39;5;34;.872;3600000;0
22525;68233;766;0;0;0;0;.00nan;0;0
22526;166023;1503;0;0;0;0;.00nan;0;0
22526;170548;2545;90;32;1;31;.969;3600000;0
22526;142810;1503;58;27;3;24;.889;3518000;0
22526;149048;2545;0;0;0;0;.00nan;0;0
22527;11882;758;73;36;3;33;.917;3600000;0
22527;189433;758;0;0;0;0;.00nan;0;0
22527;81691;768;0;0;0;0;.00nan;0;0
22527;149221;768;61;20;2;18;.900;3600000;0
22528;8504;746;69;23;2;21;.913;3600000;0
22528;164424;772;71;40;5;35;.875;3600000;0
22528;11708;772;0;0;0;0;.00nan;0;0
22528;149191;746;0;0;0;0;.00nan;0;0
22529;169615;911;59;31;3;28;.903;4841000;0
22529;175757;759;0;0;0;0;.00nan;0;0
22529;197595;759;72;30;2;28;.933;4841000;0
22529;76628;911;0;0;0;0;.00nan;0;0
22530;4281;754;0;0;0;0;.00nan;0;0
22530;170543;2199;71;27;3;24;.889;3524000;0
22530;-1;2199;0;0;0;0;.00nan;0;0
22530;148904;754;82;31;1;30;.968;3600000;0
22531;177124;775;65;24;2;22;.917;3600000;0
22531;3165;767;30;30;6;24;.800;3600000;0
22531;49815;767;0;0;0;0;.00nan;0;0
22531;146249;775;0;0;0;0;.00nan;0;0
22532;201933;774;0;0;0;0;.00nan;0;0
22532;63932;3913;45;33;5;28;.848;3600000;0
22532;148576;3913;0;0;0;0;.00nan;0;0
22532;149280;774;70;27;3;24;.889;3600000;0
22533;170530;766;64;32;3;29;.906;3583000;0
22533;212428;750;0;0;0;0;.00nan;0;0
22533;180738;750;96;36;2;34;.944;3600000;0
22533;68233;766;0;0;0;0;.00nan;0;0
22534;166023;1503;0;0;0;0;.00nan;0;0
22534;170548;2545;79;23;1;22;.957;3600000;0
22534;142810;1503;60;20;2;18;.900;3584000;0
22534;149048;2545;0;0;0;0;.00nan;0;0
22634;11882;758;97;46;2;44;.957;3554000;0
22634;189433;758;0;0;0;0;.00nan;0;0
22634;81691;768;0;0;0;0;.00nan;0;0
22634;149221;768;61;15;1;14;.933;3600000;0
22635;8504;746;79;20;1;19;.950;3600000;0
22635;164424;772;70;29;2;27;.931;3549000;0
22635;11708;772;0;0;0;0;.00nan;0;0
22635;149191;746;0;0;0;0;.00nan;0;0
22636;169615;911;95;23;0;23;1.000;3600000;0
22636;175757;759;0;0;0;0;.00nan;0;0
22636;197595;759;65;24;2;22;.917;3600000;0
22636;76628;911;0;0;0;0;.00nan;0;0
22637;4281;754;0;0;0;0;.00nan;0;0
22637;170543;2199;62;15;1;14;.933;3600000;0
22637;-1;2199;0;0;0;0;.00nan;0;0
22637;148904;754;64;28;3;25;.893;3570000;0
22638;177124;775;81;39;3;36;.923;3546000;0
22638;3165;767;93;30;1;29;.967;3600000;0
22638;49815;767;0;0;0;0;.00nan;0;0
22638;146249;775;0;0;0;0;.00nan;0;0
22639;201933;774;0;0;0;0;.00nan;0;0
22639;63932;3913;56;43;5;38;.884;3600000;0
22639;148576;3913;0;0;0;0;.00nan;0;0
22639;149280;774;99;22;0;22;1.000;3600000;0
22640;170530;766;80;27;1;26;.963;3600000;0
22640;212428;750;0;0;0;0;.00nan;0;0
22640;180738;750;72;24;2;22;.917;3571000;0
22640;68233;766;0;0;0;0;.00nan;0;0
22641;166023;1503;0;0;0;0;.00nan;0;0
22641;170548;2545;85;24;1;23;.958;3600000;0
22641;142810;1503;84;29;2;27;.931;3568000;0
22641;149048;2545;0;0;0;0;.00nan;0;0
19219;7412;585;70;28;2;26;.929;2591000;0
19219;13033;586;46;20;3;17;.850;3600000;0
19219;35052;585;29;12;4;8;.667;1009000;0
19219;64923;586;0;0;0;0;.00nan;0;0
19220;13041;580;0;0;0;0;.00nan;0;0
19220;78815;580;73;29;2;27;.931;3600000;0
19220;89930;567;0;0;0;0;.00nan;0;0
19220;143879;567;22;24;6;18;.750;3600000;0
19221;185240;1928;0;0;0;0;.00nan;0;0
19221;56480;2287;82;27;1;26;.963;3600000;0
19221;67626;2287;0;0;0;0;.00nan;0;0
19221;155769;1928;82;40;3;37;.925;3586000;0
19222;13033;586;48;18;4;14;.778;3667000;0
19222;184159;583;72;48;5;43;.896;3668000;0
19222;181071;583;0;0;0;0;.00nan;0;0
19222;64923;586;0;0;0;0;.00nan;0;0
19223;20196;1922;0;0;0;0;.00nan;0;0
19223;179981;2557;48;31;4;27;.871;3585000;0
19223;-1;2557;0;0;0;0;.00nan;0;0
19223;155945;1922;57;24;3;21;.875;3600000;0
19224;11352;2277;58;45;6;39;.867;3600000;0
19224;11438;1918;0;0;0;0;.00nan;0;0
19224;19954;1918;73;36;3;33;.917;3600000;0
19224;185744;2277;0;0;0;0;.00nan;0;0
19225;170037;582;64;29;3;26;.897;3600000;0
19225;61999;563;0;0;0;0;.00nan;0;0
19225;67625;582;0;0;0;0;.00nan;0;0
19225;155943;563;62;22;2;20;.909;3600000;0
19226;11438;1918;77;30;2;28;.933;3900000;0
19226;19954;1918;0;0;0;0;.00nan;0;0
19226;185240;1928;85;27;2;25;.926;3900000;0
19226;155769;1928;0;0;0;0;.00nan;0;0
19227;11352;2277;0;0;0;0;.00nan;0;0
19227;170037;582;94;45;3;42;.933;3900000;0
19227;185744;2277;58;28;3;25;.893;3900000;0
19227;67625;582;0;0;0;0;.00nan;0;0
19228;7412;585;0;0;0;0;.00nan;0;0
19228;35052;585;90;57;4;53;.930;3555000;0
19228;61999;563;48;17;3;14;.824;3600000;0
19228;155943;563;0;0;0;0;.00nan;0;0
19229;20196;1922;0;0;0;0;.00nan;0;0
19229;89930;567;79;24;1;23;.958;3600000;0
19229;143879;567;0;0;0;0;.00nan;0;0
19229;155945;1922;75;33;3;30;.909;3522000;0
19230;13041;580;0;0;0;0;.00nan;0;0
19230;56480;2287;56;25;3;22;.880;3600000;0
19230;67626;2287;0;0;0;0;.00nan;0;0
19230;78815;580;49;28;4;24;.857;3543000;0
19231;185240;1928;87;39;3;36;.923;3545000;0
19231;89930;567;71;27;2;25;.926;3600000;0
19231;143879;567;0;0;0;0;.00nan;0;0
19231;155769;1928;0;0;0;0;.00nan;0;0
19232;13033;586;0;0;0;0;.00nan;0;0
19232;179981;2557;84;52;3;49;.942;3594000;0
19232;-1;2557;0;0;0;0;.00nan;0;0
19232;64923;586;71;21;1;20;.952;3600000;0
19233;7412;585;44;21;3;18;.857;2530000;0
19233;170037;582;64;30;3;27;.900;3600000;0
19233;35052;585;16;7;4;3;.429;1070000;0
19233;67625;582;0;0;0;0;.00nan;0;0
19234;20196;1922;0;0;0;0;.00nan;0;0
19234;184159;583;69;31;2;29;.935;3600000;0
19234;181071;583;0;0;0;0;.00nan;0;0
19234;155945;1922;76;24;1;23;.958;3600000;0
19235;11352;2277;60;38;4;34;.895;3548000;0
19235;13041;580;0;0;0;0;.00nan;0;0
19235;185744;2277;0;0;0;0;.00nan;0;0
19235;78815;580;54;25;3;22;.880;3600000;0
19236;170037;582;75;45;5;40;.889;3557000;0
19236;67625;582;0;0;0;0;.00nan;0;0
19236;89930;567;55;27;3;24;.889;3600000;0
19236;143879;567;0;0;0;0;.00nan;0;0
19237;184159;583;65;37;4;33;.892;3600000;0
19237;181071;583;0;0;0;0;.00nan;0;0
19237;56480;2287;87;17;0;17;1.000;3600000;0
19237;67626;2287;0;0;0;0;.00nan;0;0
19238;179981;2557;59;32;3;29;.906;3900000;0
19238;185240;1928;66;31;3;28;.903;3900000;0
19238;-1;2557;0;0;0;0;.00nan;0;0
19238;155769;1928;0;0;0;0;.00nan;0;0
19239;11438;1918;73;43;4;39;.907;3600000;0
19239;13033;586;98;23;0;23;1.000;3600000;0
19239;19954;1918;0;0;0;0;.00nan;0;0
19239;64923;586;0;0;0;0;.00nan;0;0
19240;7412;585;0;0;0;0;.00nan;0;0
19240;13041;580;57;24;3;21;.875;3555000;0
19240;35052;585;69;23;1;22;.957;3600000;0
19240;78815;580;0;0;0;0;.00nan;0;0
19241;184159;583;0;0;0;0;.00nan;0;0
19241;181071;583;68;32;3;29;.906;3519000;0
19241;89930;567;0;0;0;0;.00nan;0;0
19241;143879;567;69;21;1;20;.952;3600000;0
19242;170037;582;0;0;0;0;.00nan;0;0
19242;56480;2287;60;34;5;29;.853;3600000;0
19242;67625;582;92;37;2;35;.946;3600000;0
19242;67626;2287;0;0;0;0;.00nan;0;0
19243;13033;586;0;0;0;0;.00nan;0;0
19243;13041;580;0;0;0;0;.00nan;0;0
19243;64923;586;61;15;1;14;.933;3600000;0
19243;78815;580;90;40;2;38;.950;3573000;0
19244;11352;2277;0;0;0;0;.00nan;0;0
19244;179981;2557;0;0;0;0;.00nan;0;0
19244;185744;2277;61;27;3;24;.889;3600000;0
19244;-1;2557;100;45;2;43;.956;3600000;0
19245;20196;1922;100;23;0;23;1.000;3600000;0
19245;185240;1928;0;0;0;0;.00nan;0;0
19245;155769;1928;89;32;2;30;.938;3543000;0
19245;155945;1922;0;0;0;0;.00nan;0;0
19246;11438;1918;68;26;2;24;.923;3595000;0
19246;19954;1918;0;0;0;0;.00nan;0;0
19246;61999;563;97;37;1;36;.973;3600000;0
19246;155943;563;0;0;0;0;.00nan;0;0
19247;56480;2287;0;0;0;0;.00nan;0;0
19247;67626;2287;100;35;0;35;1.000;3600000;0
19247;89930;567;47;32;6;26;.813;3600000;0
19247;143879;567;0;0;0;0;.00nan;0;0
19248;184159;583;50;23;3;20;.870;3600000;0
19248;185240;1928;91;40;2;38;.950;3600000;0
19248;181071;583;0;0;0;0;.00nan;0;0
19248;155769;1928;0;0;0;0;.00nan;0;0
19249;185240;1928;43;33;5;28;.848;3600000;0
19249;56480;2287;17;20;6;14;.700;3555000;0
19249;67626;2287;0;0;0;0;.00nan;0;0
19249;155769;1928;0;0;0;0;.00nan;0;0
19250;7412;585;39;15;3;12;.800;1222000;0
19250;35052;585;74;39;4;35;.897;2378000;0
19250;89930;567;24;17;5;12;.706;3600000;0
19250;143879;567;0;0;0;0;.00nan;0;0
19251;11352;2277;57;35;5;30;.857;3600000;0
19251;13033;586;71;25;2;23;.920;3600000;0
19251;185744;2277;0;0;0;0;.00nan;0;0
19251;64923;586;0;0;0;0;.00nan;0;0
19252;184159;583;0;0;0;0;.00nan;0;0
19252;179981;2557;63;34;3;31;.912;3600000;0
19252;181071;583;57;20;2;18;.900;3600000;0
19252;-1;2557;0;0;0;0;.00nan;0;0
19253;11438;1918;0;0;0;0;.00nan;0;0
19253;19954;1918;58;26;3;23;.885;3600000;0
19253;61999;563;49;23;4;19;.826;3600000;0
19253;155943;563;0;0;0;0;.00nan;0;0
19254;13041;580;0;0;0;0;.00nan;0;0
19254;20196;1922;66;19;1;18;.947;3600000;0
19254;78815;580;61;32;3;29;.906;3545000;0
19254;155945;1922;0;0;0;0;.00nan;0;0
19255;11352;2277;0;0;0;0;.00nan;0;0
19255;170037;582;72;24;2;22;.917;3600000;0
19255;185744;2277;29;42;8;34;.810;3600000;0
19255;67625;582;0;0;0;0;.00nan;0;0
19256;20196;1922;0;0;0;0;.00nan;0;0
19256;185240;1928;0;0;0;0;.00nan;0;0
19256;155769;1928;53;39;5;34;.872;3592000;0
19256;155945;1922;62;34;3;31;.912;3600000;0
19257;7412;585;61;32;4;28;.875;2490000;0
19257;35052;585;32;17;4;13;.765;1110000;0
19257;56480;2287;0;0;0;0;.00nan;0;0
19257;67626;2287;83;13;0;13;1.000;3600000;0
19258;11438;1918;86;27;1;26;.963;3600000;0
19258;19954;1918;0;0;0;0;.00nan;0;0
19258;179981;2557;0;0;0;0;.00nan;0;0
19258;-1;2557;36;33;5;28;.848;3600000;0
19259;13033;586;0;0;0;0;.00nan;0;0
19259;61999;563;0;0;0;0;.00nan;0;0
19259;64923;586;100;25;0;25;1.000;3900000;0
19259;155943;563;81;21;0;21;1.000;3900000;0
19260;7412;585;59;28;4;24;.857;3607000;0
19260;179981;2557;0;0;0;0;.00nan;0;0
19260;35052;585;0;0;0;0;.00nan;0;0
19260;-1;2557;69;29;3;26;.897;3607000;0
19261;20196;1922;58;27;3;24;.889;3600000;0
19261;56480;2287;0;0;0;0;.00nan;0;0
19261;67626;2287;69;27;2;25;.926;3600000;0
19261;155945;1922;0;0;0;0;.00nan;0;0
19262;184159;583;55;17;2;15;.882;3600000;0
19262;170037;582;68;33;3;30;.909;3565000;0
19262;181071;583;0;0;0;0;.00nan;0;0
19262;67625;582;0;0;0;0;.00nan;0;0
19263;13041;580;0;0;0;0;.00nan;0;0
19263;185240;1928;0;0;0;0;.00nan;0;0
19263;78815;580;90;40;2;38;.950;3600000;0
19263;155769;1928;49;24;3;21;.875;3593000;0
19264;179981;2557;74;45;4;41;.911;3588000;0
19264;-1;2557;0;0;0;0;.00nan;0;0
19264;89930;567;57;23;3;20;.870;3600000;0
19264;143879;567;0;0;0;0;.00nan;0;0
19265;170037;582;77;24;1;23;.958;3600000;0
19265;185240;1928;60;18;2;16;.889;3557000;0
19265;67625;582;0;0;0;0;.00nan;0;0
19265;155769;1928;0;0;0;0;.00nan;0;0
19266;13033;586;56;51;7;44;.863;3235000;0
19266;56480;2287;77;15;0;15;1.000;1419000;0
19266;64923;586;48;0;0;0;.00nan;323000;0
19266;67626;2287;17;17;6;11;.647;2181000;0
19267;7412;585;0;0;0;0;.00nan;0;0
19267;11352;2277;0;0;0;0;.00nan;0;0
19267;35052;585;67;38;4;34;.895;3848000;0
19267;185744;2277;65;30;3;27;.900;3848000;0
19268;11438;1918;0;0;0;0;.00nan;0;0
19268;19954;1918;40;38;6;32;.842;3600000;0
19268;20196;1922;0;0;0;0;.00nan;0;0
19268;155945;1922;75;25;2;23;.920;3600000;0
19269;13041;580;61;30;3;27;.900;3552000;0
19269;184159;583;0;0;0;0;.00nan;0;0
19269;181071;583;74;20;1;19;.950;3600000;0
19269;78815;580;0;0;0;0;.00nan;0;0
19270;170037;582;0;0;0;0;.00nan;0;0
19270;61999;563;68;23;2;21;.913;3900000;0
19270;67625;582;95;47;2;45;.957;3900000;0
19270;155943;563;0;0;0;0;.00nan;0;0
19271;13033;586;0;0;0;0;.00nan;0;0
19271;64923;586;67;29;3;26;.897;3600000;0
19271;89930;567;98;27;0;27;1.000;3600000;0
19271;143879;567;0;0;0;0;.00nan;0;0
19272;20196;1922;67;16;1;15;.938;3600000;0
19272;179981;2557;0;0;0;0;.00nan;0;0
19272;-1;2557;40;28;5;23;.821;3600000;0
19272;155945;1922;0;0;0;0;.00nan;0;0
19273;11352;2277;97;48;1;47;.979;3900000;0
19273;184159;583;87;25;1;24;.960;3900000;0
19273;181071;583;0;0;0;0;.00nan;0;0
19273;185744;2277;0;0;0;0;.00nan;0;0
19274;179981;2557;76;34;2;32;.941;3773000;0
19274;-1;2557;0;0;0;0;.00nan;0;0
19274;56480;2287;94;27;1;26;.963;3773000;0
19274;67626;2287;0;0;0;0;.00nan;0;0
19275;7412;585;0;0;0;0;.00nan;0;0
19275;170037;582;99;28;0;28;1.000;3600000;0
19275;35052;585;72;24;1;23;.958;3542000;0
19275;161047;582;0;0;0;0;.00nan;0;0
19276;179981;2557;0;0;0;0;.00nan;0;0
19276;185240;1928;62;22;2;20;.909;3600000;0
19276;-1;2557;53;34;4;30;.882;3540000;0
19276;155769;1928;0;0;0;0;.00nan;0;0
19277;11352;2277;0;0;0;0;.00nan;0;0
19277;185744;2277;90;38;1;37;.974;3600000;0
19277;89930;567;94;19;0;19;1.000;3600000;0
19277;143879;567;0;0;0;0;.00nan;0;0
19278;163471;563;47;29;4;25;.862;3600000;0
19278;20196;1922;0;0;0;0;.00nan;0;0
19278;61999;563;0;0;0;0;.00nan;0;0
19278;155945;1922;69;20;2;18;.900;3600000;0
19279;13033;586;71;24;2;22;.917;3600000;0
19279;13041;580;0;0;0;0;.00nan;0;0
19279;64923;586;0;0;0;0;.00nan;0;0
19279;78815;580;58;36;4;32;.889;3591000;0
19280;184159;583;45;36;6;30;.833;3600000;0
19280;170037;582;63;31;3;28;.903;3600000;0
19280;181071;583;0;0;0;0;.00nan;0;0
19280;161047;582;0;0;0;0;.00nan;0;0
19281;163471;563;77;24;1;23;.958;3600000;0
19281;56480;2287;45;38;6;32;.842;3600000;0
19281;61999;563;0;0;0;0;.00nan;0;0
19281;67626;2287;0;0;0;0;.00nan;0;0
19282;11438;1918;78;25;1;24;.960;3600000;0
19282;19954;1918;0;0;0;0;.00nan;0;0
19282;179981;2557;36;35;6;29;.829;3251000;0
19282;-1;2557;47;8;1;7;.875;349000;0
19283;7412;585;0;0;0;0;.00nan;0;0
19283;35052;585;68;50;5;45;.900;3600000;0
19283;89930;567;59;20;2;18;.900;3600000;0
19283;143879;567;0;0;0;0;.00nan;0;0
19284;13033;586;0;0;0;0;.00nan;0;0
19284;13041;580;50;30;5;25;.833;3567000;0
19284;64923;586;54;32;4;28;.875;3600000;0
19284;78815;580;0;0;0;0;.00nan;0;0
19285;11352;2277;59;21;3;18;.857;3600000;0
19285;179981;2557;0;0;0;0;.00nan;0;0
19285;185744;2277;0;0;0;0;.00nan;0;0
19285;-1;2557;49;28;4;24;.857;3600000;0
19286;7412;585;0;0;0;0;.00nan;0;0
19286;184159;583;54;22;3;19;.864;3516000;0
19286;35052;585;73;20;1;19;.950;3600000;0
19286;181071;583;0;0;0;0;.00nan;0;0
19287;11352;2277;0;0;0;0;.00nan;0;0
19287;20196;1922;91;22;0;22;1.000;3600000;0
19287;185744;2277;88;39;2;37;.949;3524000;0
19287;155945;1922;0;0;0;0;.00nan;0;0
19288;185240;1928;56;42;5;37;.881;3600000;0
19288;89930;567;0;0;0;0;.00nan;0;0
19288;143879;567;53;21;3;18;.857;3600000;0
19288;155769;1928;0;0;0;0;.00nan;0;0
19289;170037;582;0;0;0;0;.00nan;0;0
19289;179981;2557;0;0;0;0;.00nan;0;0
19289;-1;2557;97;34;1;33;.971;3600000;0
19289;161047;582;98;24;0;24;1.000;3600000;0
19290;7412;585;0;0;0;0;.00nan;0;0
19290;35052;585;66;41;4;37;.902;3600000;0
19290;185240;1928;0;0;0;0;.00nan;0;0
19290;155769;1928;80;28;1;27;.964;3600000;0
19291;11438;1918;87;38;2;36;.947;3600000;0
19291;19954;1918;0;0;0;0;.00nan;0;0
19291;56480;2287;0;0;0;0;.00nan;0;0
19291;67626;2287;26;18;5;13;.722;3600000;0
19292;163471;563;88;22;0;22;1.000;3600000;0
19292;11352;2277;70;34;3;31;.912;3600000;0
19292;185744;2277;0;0;0;0;.00nan;0;0
19292;61999;563;0;0;0;0;.00nan;0;0
19293;13041;580;0;0;0;0;.00nan;0;0
19293;184159;583;77;31;2;29;.935;3900000;0
19293;181071;583;0;0;0;0;.00nan;0;0
19293;78815;580;91;44;2;42;.955;3900000;0
19294;184159;583;0;0;0;0;.00nan;0;0
19294;181071;583;98;27;0;27;1.000;3600000;0
19294;89930;567;85;24;2;22;.917;3596000;0
19294;143879;567;0;0;0;0;.00nan;0;0
19295;13033;586;37;21;4;17;.810;3600000;0
19295;170037;582;0;0;0;0;.00nan;0;0
19295;64923;586;0;0;0;0;.00nan;0;0
19295;161047;582;90;40;1;39;.975;3600000;0
19296;7412;585;95;47;1;46;.979;3900000;0
19296;11438;1918;0;0;0;0;.00nan;0;0
19296;19954;1918;83;26;1;25;.962;3900000;0
19296;35052;585;0;0;0;0;.00nan;0;0
19297;20196;1922;66;23;2;21;.913;3600000;0
19297;56480;2287;50;26;3;23;.885;3567000;0
19297;67626;2287;0;0;0;0;.00nan;0;0
19297;155945;1922;0;0;0;0;.00nan;0;0
19298;163471;563;44;18;3;15;.833;3600000;0
19298;179981;2557;68;47;4;43;.915;3545000;0
19298;-1;2557;0;0;0;0;.00nan;0;0
19298;61999;563;0;0;0;0;.00nan;0;0
19299;20196;1922;0;0;0;0;.00nan;0;0
19299;56480;2287;0;0;0;0;.00nan;0;0
19299;67626;2287;86;30;1;29;.967;3900000;0
19299;155945;1922;100;35;1;34;.971;3900000;0
19300;163471;563;45;40;7;33;.825;3359000;0
19300;13033;586;60;12;1;11;.917;3600000;0
19300;61999;563;57;4;0;4;1.000;241000;0
19300;64923;586;0;0;0;0;.00nan;0;0
19301;7412;585;0;0;0;0;.00nan;0;0
19301;35052;585;62;30;3;27;.900;3600000;0
19301;185240;1928;24;10;4;6;.600;965000;0
19301;155769;1928;46;18;3;15;.833;2635000;0
19302;11352;2277;0;0;0;0;.00nan;0;0
19302;185240;1928;56;18;2;16;.889;3900000;0
19302;185744;2277;68;27;2;25;.926;3900000;0
19302;155769;1928;0;0;0;0;.00nan;0;0
19303;163471;563;70;30;3;27;.900;3871000;0
19303;13041;580;0;0;0;0;.00nan;0;0
19303;61999;563;0;0;0;0;.00nan;0;0
19303;78815;580;68;29;2;27;.931;3871000;0
19304;13041;580;68;14;1;13;.929;3600000;0
19304;170037;582;62;40;5;35;.875;3600000;0
19304;78815;580;0;0;0;0;.00nan;0;0
19304;161047;582;0;0;0;0;.00nan;0;0
19305;11352;2277;83;36;2;34;.944;3598000;0
19305;185744;2277;0;0;0;0;.00nan;0;0
19305;56480;2287;75;22;1;21;.955;3600000;0
19305;67626;2287;0;0;0;0;.00nan;0;0
19306;7412;585;0;0;0;0;.00nan;0;0
19306;179981;2557;51;36;4;32;.889;3600000;0
19306;35052;585;64;14;1;13;.929;3600000;0
19306;-1;2557;0;0;0;0;.00nan;0;0
19307;11438;1918;97;56;4;52;.929;3600000;0
19307;19954;1918;0;0;0;0;.00nan;0;0
19307;89930;567;51;26;3;23;.885;3600000;0
19307;143879;567;0;0;0;0;.00nan;0;0
19308;13033;586;70;22;1;21;.955;3600000;0
19308;184159;583;0;0;0;0;.00nan;0;0
19308;181071;583;49;31;4;27;.871;3600000;0
19308;64923;586;0;0;0;0;.00nan;0;0
19309;13033;586;0;0;0;0;.00nan;0;0
19309;185240;1928;28;9;3;6;.667;331000;0
19309;64923;586;100;35;0;35;1.000;3600000;0
19309;155769;1928;45;26;4;22;.846;3269000;0
19310;11438;1918;54;10;1;9;.900;557000;0
19310;19954;1918;19;32;7;25;.781;3043000;0
19310;89930;567;0;0;0;0;.00nan;0;0
19310;143879;567;100;21;0;21;1.000;3600000;0
19311;7412;585;40;23;4;19;.826;1034000;0
19311;20196;1922;0;0;0;0;.00nan;0;0
19311;35052;585;73;33;2;31;.939;2566000;0
19311;155945;1922;40;15;3;12;.800;3600000;0
19312;184159;583;76;20;1;19;.950;3600000;0
19312;179981;2557;39;20;4;16;.800;1371000;0
19312;181071;583;0;0;0;0;.00nan;0;0
19312;-1;2557;11;28;7;21;.750;2229000;0
19313;163471;563;58;24;3;21;.875;3625000;0
19313;56480;2287;0;0;0;0;.00nan;0;0
19313;61999;563;0;0;0;0;.00nan;0;0
19313;67626;2287;66;35;4;31;.886;3625000;0
19314;163471;563;59;23;2;21;.913;3597000;0
19314;184159;583;81;21;1;20;.952;3600000;0
19314;181071;583;0;0;0;0;.00nan;0;0
19314;61999;563;0;0;0;0;.00nan;0;0
19315;11438;1918;79;39;3;36;.923;3600000;0
19315;19954;1918;0;0;0;0;.00nan;0;0
19315;170037;582;40;23;4;19;.826;3581000;0
19315;161047;582;0;0;0;0;.00nan;0;0
19316;13041;580;0;0;0;0;.00nan;0;0
19316;56480;2287;98;20;0;20;1.000;3600000;0
19316;67626;2287;0;0;0;0;.00nan;0;0
19316;78815;580;74;33;2;31;.939;3600000;0
19317;20196;1922;78;27;1;26;.963;3600000;0
19317;89930;567;0;0;0;0;.00nan;0;0
19317;143879;567;55;23;3;20;.870;3564000;0
19317;155945;1922;0;0;0;0;.00nan;0;0
19318;7412;585;0;0;0;0;.00nan;0;0
19318;13033;586;0;0;0;0;.00nan;0;0
19318;35052;585;82;52;3;49;.942;3576000;0
19318;64923;586;74;20;1;19;.950;3600000;0
19319;11352;2277;0;0;0;0;.00nan;0;0
19319;11438;1918;58;27;3;24;.889;3900000;0
19319;19954;1918;0;0;0;0;.00nan;0;0
19319;185744;2277;56;24;3;21;.875;3900000;0
19320;20196;1922;0;0;0;0;.00nan;0;0
19320;170037;582;19;9;4;5;.556;1155000;0
19320;155945;1922;45;26;4;22;.846;3600000;0
19320;161047;582;66;22;1;21;.955;2445000;0
19321;163471;563;76;29;2;27;.931;3900000;0
19321;185240;1928;0;0;0;0;.00nan;0;0
19321;61999;563;0;0;0;0;.00nan;0;0
19321;155769;1928;64;24;2;22;.917;3900000;0
19322;184159;583;36;20;4;16;.800;3681000;0
19322;181071;583;0;0;0;0;.00nan;0;0
19322;56480;2287;57;37;5;32;.865;3681000;0
19322;67626;2287;0;0;0;0;.00nan;0;0
19323;170037;582;52;25;4;21;.840;3550000;0
19323;179981;2557;0;0;0;0;.00nan;0;0
19323;-1;2557;73;36;3;33;.917;3600000;0
19323;161047;582;0;0;0;0;.00nan;0;0
19324;11438;1918;0;0;0;0;.00nan;0;0
19324;19954;1918;47;21;3;18;.857;3555000;0
19324;185240;1928;75;28;2;26;.929;3600000;0
19324;155769;1928;0;0;0;0;.00nan;0;0
19325;13041;580;0;0;0;0;.00nan;0;0
19325;78815;580;74;31;2;29;.935;3568000;0
19325;89930;567;78;27;1;26;.963;3600000;0
19325;143879;567;0;0;0;0;.00nan;0;0
19326;20196;1922;73;23;1;22;.957;3600000;0
19326;89930;567;69;30;2;28;.933;3565000;0
19326;143879;567;0;0;0;0;.00nan;0;0
19326;155945;1922;0;0;0;0;.00nan;0;0
19327;163471;563;58;19;2;17;.895;3600000;0
19327;179981;2557;0;0;0;0;.00nan;0;0
19327;-1;2557;52;30;4;26;.867;3591000;0
19327;61999;563;0;0;0;0;.00nan;0;0
19328;11438;1918;100;39;0;39;1.000;3600000;0
19328;19954;1918;0;0;0;0;.00nan;0;0
19328;184159;583;57;18;2;16;.889;3564000;0
19328;181071;583;0;0;0;0;.00nan;0;0
19329;13033;586;100;30;0;30;1.000;3600000;0
19329;20196;1922;0;0;0;0;.00nan;0;0
19329;64923;586;0;0;0;0;.00nan;0;0
19329;155945;1922;62;27;3;24;.889;3600000;0
19330;184159;583;100;30;0;30;1.000;3600000;0
19330;185240;1928;0;0;0;0;.00nan;0;0
19330;181071;583;0;0;0;0;.00nan;0;0
19330;155769;1928;89;30;1;29;.967;3544000;0
19331;179981;2557;69;28;2;26;.929;1786000;0
19331;-1;2557;26;32;6;26;.813;1814000;0
19331;89930;567;84;13;0;13;1.000;3600000;0
19331;143879;567;0;0;0;0;.00nan;0;0
19332;11352;2277;99;51;2;49;.961;3872000;0
19332;185744;2277;0;0;0;0;.00nan;0;0
19332;56480;2287;57;22;3;19;.864;3872000;0
19332;67626;2287;0;0;0;0;.00nan;0;0
19333;11438;1918;88;38;1;37;.974;3600000;0
19333;13033;586;46;20;3;17;.850;3536000;0
19333;19954;1918;0;0;0;0;.00nan;0;0
19333;64923;586;0;0;0;0;.00nan;0;0
19334;13041;580;0;0;0;0;.00nan;0;0
19334;170037;582;0;0;0;0;.00nan;0;0
19334;78815;580;59;28;3;25;.893;3600000;0
19334;161047;582;41;26;4;22;.846;3587000;0
19335;163471;563;72;29;3;26;.897;3600000;0
19335;20196;1922;79;41;4;37;.902;3600000;0
19335;61999;563;0;0;0;0;.00nan;0;0
19335;155945;1922;0;0;0;0;.00nan;0;0
19336;11352;2277;0;0;0;0;.00nan;0;0
19336;185744;2277;73;48;5;43;.896;3600000;0
19336;89930;567;60;21;2;19;.905;3600000;0
19336;143879;567;0;0;0;0;.00nan;0;0
19337;179981;2557;70;27;2;25;.926;1328000;0
19337;-1;2557;39;39;6;33;.846;2272000;0
19337;56480;2287;0;0;0;0;.00nan;0;0
19337;67626;2287;50;13;2;11;.846;3600000;0
19338;11438;1918;0;0;0;0;.00nan;0;0
19338;19954;1918;80;48;4;44;.917;3600000;0
19338;185240;1928;96;21;0;21;1.000;3600000;0
19338;155769;1928;0;0;0;0;.00nan;0;0
19339;13041;580;86;17;0;17;1.000;3600000;0
19339;170037;582;0;0;0;0;.00nan;0;0
19339;78815;580;0;0;0;0;.00nan;0;0
19339;161047;582;87;38;2;36;.947;3514000;0
19340;7412;585;0;0;0;0;.00nan;0;0
19340;163471;563;83;26;1;25;.962;3600000;0
19340;35052;585;52;36;5;31;.861;3600000;0
19340;61999;563;0;0;0;0;.00nan;0;0
19341;11352;2277;44;25;4;21;.840;3565000;0
19341;170037;582;0;0;0;0;.00nan;0;0
19341;185744;2277;0;0;0;0;.00nan;0;0
19341;161047;582;64;21;2;19;.905;3600000;0
19342;11352;2277;0;0;0;0;.00nan;0;0
19342;184159;583;76;28;2;26;.929;3600000;0
19342;181071;583;0;0;0;0;.00nan;0;0
19342;185744;2277;99;40;1;39;.975;3600000;0
19343;13041;580;86;45;4;41;.911;3600000;0
19343;20196;1922;0;0;0;0;.00nan;0;0
19343;78815;580;0;0;0;0;.00nan;0;0
19343;155945;1922;80;27;1;26;.963;3600000;0
19344;184159;583;0;0;0;0;.00nan;0;0
19344;181071;583;89;46;3;43;.935;3600000;0
19344;89930;567;56;17;2;15;.882;3600000;0
19344;143879;567;0;0;0;0;.00nan;0;0
19345;170037;582;0;0;0;0;.00nan;0;0
19345;56480;2287;71;30;3;27;.900;3600000;0
19345;67626;2287;0;0;0;0;.00nan;0;0
19345;161047;582;48;34;5;29;.853;3549000;0
19346;7412;585;0;0;0;0;.00nan;0;0
19346;35052;585;40;37;6;31;.838;3600000;0
19346;185240;1928;75;30;3;27;.900;3600000;0
19346;155769;1928;0;0;0;0;.00nan;0;0
19347;13033;586;78;23;2;21;.913;3600000;0
19347;64923;586;0;0;0;0;.00nan;0;0
19347;89930;567;0;0;0;0;.00nan;0;0
19347;143879;567;78;38;3;35;.921;3570000;0
19348;13041;580;86;25;1;24;.960;3600000;0
19348;179981;2557;70;24;2;22;.917;3600000;0
19348;-1;2557;0;0;0;0;.00nan;0;0
19348;78815;580;0;0;0;0;.00nan;0;0
19349;11438;1918;60;42;5;37;.881;3600000;0
19349;19954;1918;0;0;0;0;.00nan;0;0
19349;20196;1922;0;0;0;0;.00nan;0;0
19349;155945;1922;60;21;2;19;.905;3600000;0
19350;163471;563;82;36;3;33;.917;3600000;0
19350;11352;2277;41;33;5;28;.848;3590000;0
19350;185744;2277;0;0;0;0;.00nan;0;0
19350;61999;563;0;0;0;0;.00nan;0;0
19351;13033;586;84;29;2;27;.931;3600000;0
19351;56480;2287;0;0;0;0;.00nan;0;0
19351;64923;586;0;0;0;0;.00nan;0;0
19351;67626;2287;65;39;5;34;.872;3600000;0
19352;13041;580;0;0;0;0;.00nan;0;0
19352;179981;2557;0;0;0;0;.00nan;0;0
19352;-1;2557;55;26;3;23;.885;3582000;0
19352;78815;580;80;31;2;29;.935;3600000;0
19353;7412;585;31;49;9;40;.816;3600000;0
19353;11438;1918;0;0;0;0;.00nan;0;0
19353;19954;1918;85;15;0;15;1.000;3600000;0
19353;35052;585;0;0;0;0;.00nan;0;0
19354;163471;563;53;20;3;17;.850;3600000;0
19354;184159;583;49;36;5;31;.861;3556000;0
19354;181071;583;0;0;0;0;.00nan;0;0
19354;61999;563;0;0;0;0;.00nan;0;0
19355;11352;2277;0;0;0;0;.00nan;0;0
19355;11438;1918;0;0;0;0;.00nan;0;0
19355;19954;1918;82;30;1;29;.967;3900000;0
19355;185744;2277;84;27;1;26;.963;3900000;0
19356;11352;2277;62;15;1;14;.933;1606000;0
19356;184159;583;75;40;4;36;.900;3600000;0
19356;181071;583;0;0;0;0;.00nan;0;0
19356;185744;2277;40;34;6;28;.824;1994000;0
19357;20196;1922;48;32;5;27;.844;3600000;0
19357;170037;582;38;23;5;18;.783;3095000;0
19357;155945;1922;0;0;0;0;.00nan;0;0
19357;161047;582;33;10;3;7;.700;505000;0
19358;185240;1928;88;44;3;41;.932;3554000;0
19358;89930;567;72;29;2;27;.931;3600000;0
19358;143879;567;0;0;0;0;.00nan;0;0
19358;155769;1928;0;0;0;0;.00nan;0;0
19359;13033;586;80;11;0;11;1.000;3600000;0
19359;179981;2557;74;31;2;29;.935;3541000;0
19359;-1;2557;0;0;0;0;.00nan;0;0
19359;64923;586;0;0;0;0;.00nan;0;0
19360;7412;585;0;0;0;0;.00nan;0;0
19360;11438;1918;62;12;1;11;.917;3600000;0
19360;19954;1918;0;0;0;0;.00nan;0;0
19360;35052;585;71;40;4;36;.900;3600000;0
19361;163471;563;82;37;1;36;.973;3900000;0
19361;13041;580;74;18;1;17;.944;3900000;0
19361;61999;563;0;0;0;0;.00nan;0;0
19361;78815;580;0;0;0;0;.00nan;0;0
19362;185240;1928;0;0;0;0;.00nan;0;0
19362;56480;2287;95;35;1;34;.971;3600000;0
19362;67626;2287;0;0;0;0;.00nan;0;0
19362;155769;1928;58;30;4;26;.867;3600000;0
19363;11352;2277;0;0;0;0;.00nan;0;0
19363;179981;2557;0;0;0;0;.00nan;0;0
19363;185744;2277;71;25;2;23;.920;3600000;0
19363;-1;2557;30;32;7;25;.781;3600000;0
19364;11438;1918;0;0;0;0;.00nan;0;0
19364;19954;1918;28;23;5;18;.783;3851000;0
19364;170037;582;0;0;0;0;.00nan;0;0
19364;161047;582;39;34;6;28;.824;3851000;0
19365;20196;1922;0;0;0;0;.00nan;0;0
19365;184159;583;71;41;4;37;.902;3600000;0
19365;181071;583;0;0;0;0;.00nan;0;0
19365;155945;1922;54;38;5;33;.868;3589000;0
19366;163471;563;54;31;4;27;.871;3522000;0
19366;13041;580;0;0;0;0;.00nan;0;0
19366;61999;563;0;0;0;0;.00nan;0;0
19366;78815;580;73;28;2;26;.929;3600000;0
19367;7412;585;0;0;0;0;.00nan;0;0
19367;179981;2557;0;0;0;0;.00nan;0;0
19367;35052;585;42;24;5;19;.792;3600000;0
19367;-1;2557;65;16;1;15;.938;3600000;0
19368;13033;586;79;27;1;26;.963;3600000;0
19368;184159;583;89;40;2;38;.950;3583000;0
19368;181071;583;0;0;0;0;.00nan;0;0
19368;64923;586;0;0;0;0;.00nan;0;0
19369;11438;1918;0;0;0;0;.00nan;0;0
19369;19954;1918;83;28;1;27;.964;3600000;0
19369;20196;1922;78;34;3;31;.912;3578000;0
19369;155945;1922;0;0;0;0;.00nan;0;0
19370;13033;586;0;0;0;0;.00nan;0;0
19370;13041;580;42;34;5;29;.853;3600000;0
19370;64923;586;77;20;1;19;.950;3600000;0
19370;78815;580;0;0;0;0;.00nan;0;0
19371;163471;563;68;25;2;23;.920;3600000;0
19371;56480;2287;43;38;6;32;.842;3600000;0
19371;61999;563;0;0;0;0;.00nan;0;0
19371;67626;2287;0;0;0;0;.00nan;0;0
19372;170037;582;0;0;0;0;.00nan;0;0
19372;89930;567;50;30;4;26;.867;3697000;0
19372;143879;567;0;0;0;0;.00nan;0;0
19372;161047;582;68;48;5;43;.896;3726000;0
19373;179981;2557;57;35;4;31;.886;3600000;0
19373;185240;1928;52;22;3;19;.864;3600000;0
19373;-1;2557;0;0;0;0;.00nan;0;0
19373;155769;1928;0;0;0;0;.00nan;0;0
19374;11352;2277;0;0;0;0;.00nan;0;0
19374;20196;1922;0;0;0;0;.00nan;0;0
19374;185744;2277;61;49;6;43;.878;3600000;0
19374;155945;1922;66;22;2;20;.909;3600000;0
19375;7412;585;0;0;0;0;.00nan;0;0
19375;13041;580;0;0;0;0;.00nan;0;0
19375;35052;585;87;38;2;36;.947;3600000;0
19375;78815;580;93;30;1;29;.967;3600000;0
19376;184159;583;84;38;2;36;.947;3546000;0
19376;181071;583;0;0;0;0;.00nan;0;0
19376;56480;2287;0;0;0;0;.00nan;0;0
19376;67626;2287;77;25;1;24;.960;3600000;0
19377;13033;586;82;21;1;20;.952;3600000;0
19377;170037;582;0;0;0;0;.00nan;0;0
19377;64923;586;0;0;0;0;.00nan;0;0
19377;161047;582;61;32;3;29;.906;3600000;0
19378;11352;2277;0;0;0;0;.00nan;0;0
19378;13041;580;74;24;2;22;.917;3600000;0
19378;185744;2277;27;26;5;21;.808;3600000;0
19378;78815;580;0;0;0;0;.00nan;0;0
19379;11438;1918;54;21;2;19;.905;3551000;0
19379;19954;1918;0;0;0;0;.00nan;0;0
19379;179981;2557;0;0;0;0;.00nan;0;0
19379;-1;2557;83;28;1;27;.964;3600000;0
19380;7412;585;55;33;6;27;.818;3600000;0
19380;20196;1922;17;33;7;26;.788;3574000;0
19380;35052;585;0;0;0;0;.00nan;0;0
19380;155945;1922;0;0;0;0;.00nan;0;0
19381;163471;563;81;28;1;27;.964;3600000;0
19381;61999;563;0;0;0;0;.00nan;0;0
19381;89930;567;93;21;0;21;1.000;3600000;0
19381;143879;567;0;0;0;0;.00nan;0;0
19382;11352;2277;0;0;0;0;.00nan;0;0
19382;13033;586;84;30;1;29;.967;3600000;0
19382;185744;2277;78;33;2;31;.939;3544000;0
19382;64923;586;0;0;0;0;.00nan;0;0
19383;163471;563;82;42;3;39;.929;3600000;0
19383;170037;582;5;18;6;12;.667;2677000;0
19383;61999;563;0;0;0;0;.00nan;0;0
19383;161047;582;39;9;2;7;.778;923000;0
19384;7412;585;0;0;0;0;.00nan;0;0
19384;11352;2277;0;0;0;0;.00nan;0;0
19384;35052;585;95;41;3;38;.927;3600000;0
19384;185744;2277;44;27;4;23;.852;3552000;0
19385;13041;580;100;39;0;39;1.000;3600000;0
19385;185240;1928;63;16;2;14;.875;3514000;0
19385;78815;580;0;0;0;0;.00nan;0;0
19385;155769;1928;0;0;0;0;.00nan;0;0
19386;56480;2287;98;50;3;47;.940;3600000;0
19386;67626;2287;0;0;0;0;.00nan;0;0
19386;89930;567;62;19;2;17;.895;3600000;0
19386;143879;567;0;0;0;0;.00nan;0;0
19387;7412;585;87;17;0;17;1.000;3600000;0
19387;11352;2277;74;23;1;22;.957;3563000;0
19387;35052;585;0;0;0;0;.00nan;0;0
19387;185744;2277;0;0;0;0;.00nan;0;0
19388;20196;1922;0;0;0;0;.00nan;0;0
19388;179981;2557;0;0;0;0;.00nan;0;0
19388;-1;2557;84;60;5;55;.917;3600000;0
19388;155945;1922;53;14;2;12;.857;3600000;0
19389;11438;1918;100;34;1;33;.971;3600000;0
19389;19954;1918;0;0;0;0;.00nan;0;0
19389;184159;583;89;48;4;44;.917;3600000;0
19389;181071;583;0;0;0;0;.00nan;0;0
19390;163471;563;0;0;0;0;.00nan;0;0
19390;13033;586;35;19;4;15;.789;3632000;0
19390;61999;563;55;39;5;34;.872;3632000;0
19390;64923;586;0;0;0;0;.00nan;0;0
19391;56480;2287;0;0;0;0;.00nan;0;0
19391;67626;2287;22;22;6;16;.727;3600000;0
19391;89930;567;96;22;0;22;1.000;3600000;0
19391;143879;567;0;0;0;0;.00nan;0;0
19392;13033;586;0;0;0;0;.00nan;0;0
19392;170037;582;66;45;6;39;.867;3600000;0
19392;64923;586;78;30;2;28;.933;3600000;0
19392;161047;582;0;0;0;0;.00nan;0;0
19393;20196;1922;60;24;3;21;.875;3600000;0
19393;179981;2557;49;41;6;35;.854;2979000;0
19393;-1;2557;58;6;0;6;1.000;621000;0
19393;155945;1922;0;0;0;0;.00nan;0;0
19394;11438;1918;0;0;0;0;.00nan;0;0
19394;19954;1918;62;19;2;17;.895;3892000;0
19394;184159;583;77;26;1;25;.962;3884000;0
19394;181071;583;0;0;0;0;.00nan;0;0
19395;13041;580;71;37;3;34;.919;3900000;0
19395;185240;1928;0;0;0;0;.00nan;0;0
19395;78815;580;0;0;0;0;.00nan;0;0
19395;155769;1928;54;28;3;25;.893;3900000;0
19396;163471;563;72;20;1;19;.950;3600000;0
19396;11438;1918;54;40;5;35;.875;3600000;0
19396;19954;1918;0;0;0;0;.00nan;0;0
19396;61999;563;0;0;0;0;.00nan;0;0
19397;13033;586;89;17;0;17;1.000;3600000;0
19397;56480;2287;46;42;6;36;.857;2699000;0
19397;64923;586;0;0;0;0;.00nan;0;0
19397;67626;2287;52;9;1;8;.889;901000;0
19398;163471;563;74;39;4;35;.897;3589000;0
19398;185240;1928;94;30;2;28;.933;3600000;0
19398;61999;563;0;0;0;0;.00nan;0;0
19398;155769;1928;0;0;0;0;.00nan;0;0
19399;11352;2277;0;0;0;0;.00nan;0;0
19399;185744;2277;54;36;5;31;.861;3600000;0
19399;89930;567;72;28;2;26;.929;3600000;0
19399;143879;567;0;0;0;0;.00nan;0;0
19400;7412;585;89;44;1;43;.977;3900000;0
19400;35052;585;0;0;0;0;.00nan;0;0
19400;56480;2287;0;0;0;0;.00nan;0;0
19400;67626;2287;79;22;1;21;.955;3900000;0
19401;20196;1922;0;0;0;0;.00nan;0;0
19401;184159;583;62;28;3;25;.893;3600000;0
19401;181071;583;0;0;0;0;.00nan;0;0
19401;155945;1922;44;26;4;22;.846;3594000;0
19402;13041;580;43;39;6;33;.846;3576000;0
19402;179981;2557;38;27;5;22;.815;3600000;0
19402;-1;2557;0;0;0;0;.00nan;0;0
19402;78815;580;0;0;0;0;.00nan;0;0
19403;170037;582;64;39;4;35;.897;3600000;0
19403;185240;1928;0;0;0;0;.00nan;0;0
19403;155769;1928;64;33;3;30;.909;3600000;0
19403;161047;582;0;0;0;0;.00nan;0;0
19404;11438;1918;0;0;0;0;.00nan;0;0
19404;19954;1918;49;34;5;29;.853;3600000;0
19404;20196;1922;69;27;2;25;.926;3600000;0
19404;155945;1922;0;0;0;0;.00nan;0;0
19405;7412;585;0;0;0;0;.00nan;0;0
19405;35052;585;66;49;5;44;.898;3600000;0
19405;89930;567;68;28;2;26;.929;3600000;0
19405;143879;567;0;0;0;0;.00nan;0;0
19406;13041;580;0;0;0;0;.00nan;0;0
19406;179981;2557;0;0;0;0;.00nan;0;0
19406;-1;2557;88;35;1;34;.971;3600000;0
19406;78815;580;44;18;3;15;.833;3513000;0
19407;11438;1918;0;0;0;0;.00nan;0;0
19407;19954;1918;100;36;1;35;.972;3600000;0
19407;89930;567;57;26;3;23;.885;3544000;0
19407;143879;567;0;0;0;0;.00nan;0;0
19408;179981;2557;61;38;4;34;.895;3600000;0
19408;185240;1928;48;19;3;16;.842;3600000;0
19408;-1;2557;0;0;0;0;.00nan;0;0
19408;155769;1928;0;0;0;0;.00nan;0;0
19409;11438;1918;85;33;3;30;.909;3600000;0
19409;19954;1918;0;0;0;0;.00nan;0;0
19409;56480;2287;0;0;0;0;.00nan;0;0
19409;67626;2287;32;33;6;27;.818;3600000;0
19410;7412;585;0;0;0;0;.00nan;0;0
19410;170037;582;0;0;0;0;.00nan;0;0
19410;35052;585;72;28;2;26;.929;3600000;0
19410;161047;582;49;36;4;32;.889;3559000;0
19411;20196;1922;0;0;0;0;.00nan;0;0
19411;185240;1928;0;0;0;0;.00nan;0;0
19411;155769;1928;76;38;4;34;.895;3600000;0
19411;155945;1922;53;40;5;35;.875;3600000;0
19412;7412;585;95;39;2;37;.949;3600000;0
19412;184159;583;0;0;0;0;.00nan;0;0
19412;35052;585;0;0;0;0;.00nan;0;0
19412;181071;583;71;36;3;33;.917;3549000;0
19413;11352;2277;0;0;0;0;.00nan;0;0
19413;185744;2277;56;47;6;41;.872;3586000;0
19413;89930;567;38;14;4;10;.714;3600000;0
19413;143879;567;0;0;0;0;.00nan;0;0
19414;13033;586;81;25;1;24;.960;3600000;0
19414;56480;2287;49;29;4;25;.862;3600000;0
19414;64923;586;0;0;0;0;.00nan;0;0
19414;67626;2287;0;0;0;0;.00nan;0;0
19415;11438;1918;51;29;4;25;.862;3900000;0
19415;13041;580;76;42;4;38;.905;3900000;0
19415;19954;1918;0;0;0;0;.00nan;0;0
19415;78815;580;0;0;0;0;.00nan;0;0
19416;163471;563;70;24;1;23;.958;3600000;0
19416;179981;2557;79;40;3;37;.925;3600000;0
19416;-1;2557;0;0;0;0;.00nan;0;0
19416;61999;563;0;0;0;0;.00nan;0;0
19417;170037;582;0;0;0;0;.00nan;0;0
19417;179981;2557;0;0;0;0;.00nan;0;0
19417;-1;2557;98;46;2;44;.957;3600000;0
19417;161047;582;81;13;0;13;1.000;3600000;0
19418;11352;2277;65;36;4;32;.889;3588000;0
19418;185240;1928;58;28;3;25;.893;3600000;0
19418;185744;2277;0;0;0;0;.00nan;0;0
19418;155769;1928;0;0;0;0;.00nan;0;0
19419;13041;580;0;0;0;0;.00nan;0;0
19419;78815;580;71;28;2;26;.929;3600000;0
19419;89930;567;0;0;0;0;.00nan;0;0
19419;143879;567;50;18;3;15;.833;3574000;0
19420;7412;585;0;0;0;0;.00nan;0;0
19420;163471;563;58;20;3;17;.850;3537000;0
19420;35052;585;96;40;1;39;.975;3600000;0
19420;61999;563;0;0;0;0;.00nan;0;0
19421;13033;586;0;0;0;0;.00nan;0;0
19421;20196;1922;76;35;3;32;.914;3600000;0
19421;64923;586;40;22;4;18;.818;3572000;0
19421;155945;1922;0;0;0;0;.00nan;0;0
19422;13033;586;25;11;4;7;.636;1854000;0
19422;185240;1928;22;26;6;20;.769;2292000;0
19422;64923;586;62;6;0;6;1.000;1746000;0
19422;155769;1928;60;16;1;15;.938;1308000;0
19423;163471;563;83;13;0;13;1.000;3600000;0
19423;184159;583;85;34;2;32;.941;3567000;0
19423;181071;583;0;0;0;0;.00nan;0;0
19423;61999;563;0;0;0;0;.00nan;0;0
19424;179981;2557;31;35;6;29;.829;3591000;0
19424;-1;2557;0;0;0;0;.00nan;0;0
19424;89930;567;51;34;5;29;.853;3600000;0
19424;143879;567;0;0;0;0;.00nan;0;0
19425;7412;585;0;0;0;0;.00nan;0;0
19425;35052;585;54;35;4;31;.886;3600000;0
19425;185240;1928;0;0;0;0;.00nan;0;0
19425;155769;1928;76;19;1;18;.947;3600000;0
19426;13041;580;66;40;4;36;.900;3543000;0
19426;56480;2287;0;0;0;0;.00nan;0;0
19426;67626;2287;74;20;2;18;.900;3600000;0
19426;78815;580;0;0;0;0;.00nan;0;0
19427;163471;563;69;19;1;18;.947;3600000;0
19427;185240;1928;41;34;5;29;.853;3600000;0
19427;61999;563;0;0;0;0;.00nan;0;0
19427;155769;1928;0;0;0;0;.00nan;0;0
19428;170037;582;72;47;5;42;.894;3194000;0
19428;89930;567;54;10;1;9;.900;3600000;0
19428;143879;567;0;0;0;0;.00nan;0;0
19428;161047;582;29;10;3;7;.700;406000;0
19429;11352;2277;0;0;0;0;.00nan;0;0
19429;11438;1918;67;23;1;22;.957;3600000;0
19429;19954;1918;0;0;0;0;.00nan;0;0
19429;185744;2277;51;35;5;30;.857;3600000;0
19430;7412;585;0;0;0;0;.00nan;0;0
19430;179981;2557;0;0;0;0;.00nan;0;0
19430;35052;585;39;23;5;18;.783;3556000;0
19430;-1;2557;81;36;3;33;.917;3600000;0
19431;13041;580;0;0;0;0;.00nan;0;0
19431;184159;583;66;28;2;26;.929;3544000;0
19431;181071;583;0;0;0;0;.00nan;0;0
19431;78815;580;93;32;1;31;.969;3600000;0
19432;163471;563;65;32;3;29;.906;3900000;0
19432;61999;563;0;0;0;0;.00nan;0;0
19432;89930;567;67;23;3;20;.870;3900000;0
19432;143879;567;0;0;0;0;.00nan;0;0
19433;170037;582;45;13;2;11;.846;2492000;0
19433;56480;2287;22;22;6;16;.727;2046000;0
19433;67626;2287;42;15;3;12;.800;1533000;0
19433;161047;582;19;10;5;5;.500;1108000;0
19434;11352;2277;65;48;6;42;.875;3600000;0
19434;13033;586;86;16;0;16;1.000;3600000;0
19434;185744;2277;0;0;0;0;.00nan;0;0
19434;64923;586;0;0;0;0;.00nan;0;0
19435;11438;1918;0;0;0;0;.00nan;0;0
19435;13041;580;74;29;2;27;.931;3585000;0
19435;19954;1918;66;18;1;17;.944;3600000;0
19435;78815;580;0;0;0;0;.00nan;0;0
19436;7412;585;79;41;4;37;.902;3600000;0
19436;20196;1922;0;0;0;0;.00nan;0;0
19436;35052;585;0;0;0;0;.00nan;0;0
19436;155945;1922;100;23;0;23;1.000;3600000;0
19437;13041;580;0;0;0;0;.00nan;0;0
19437;185240;1928;0;0;0;0;.00nan;0;0
19437;78815;580;100;44;1;43;.977;3600000;0
19437;155769;1928;65;23;2;21;.913;3564000;0
19438;13033;586;49;27;5;22;.815;3714000;0
19438;184159;583;82;48;4;44;.917;3714000;0
19438;181071;583;0;0;0;0;.00nan;0;0
19438;64923;586;0;0;0;0;.00nan;0;0
19439;163471;563;45;22;4;18;.818;3600000;0
19439;170037;582;92;40;1;39;.975;3600000;0
19439;61999;563;0;0;0;0;.00nan;0;0
19439;161047;582;0;0;0;0;.00nan;0;0
19440;11352;2277;0;0;0;0;.00nan;0;0
19440;185744;2277;92;32;1;31;.969;3600000;0
19440;56480;2287;46;40;6;34;.850;3600000;0
19440;67626;2287;0;0;0;0;.00nan;0;0
19441;170037;582;0;0;0;0;.00nan;0;0
19441;56480;2287;0;0;0;0;.00nan;0;0
19441;67626;2287;72;24;2;22;.917;3600000;0
19441;161047;582;55;38;5;33;.868;3600000;0
19442;184159;583;74;43;3;40;.930;3578000;0
19442;185240;1928;87;37;2;35;.946;3600000;0
19442;181071;583;0;0;0;0;.00nan;0;0
19442;155769;1928;0;0;0;0;.00nan;0;0
19443;163471;563;69;28;2;26;.929;3600000;0
19443;61999;563;0;0;0;0;.00nan;0;0
19443;89930;567;58;24;3;21;.875;3597000;0
19443;143879;567;0;0;0;0;.00nan;0;0
19444;13033;586;68;17;1;16;.941;3600000;0
19444;179981;2557;54;32;4;28;.875;2292000;0
19444;-1;2557;65;17;1;16;.941;1308000;0
19444;64923;586;0;0;0;0;.00nan;0;0
19445;7412;585;0;0;0;0;.00nan;0;0
19445;11352;2277;47;19;3;16;.842;3544000;0
19445;35052;585;100;50;2;48;.960;3600000;0
19445;185744;2277;0;0;0;0;.00nan;0;0
19446;11438;1918;0;0;0;0;.00nan;0;0
19446;13041;580;74;38;3;35;.921;3600000;0
19446;19954;1918;48;33;5;28;.848;3524000;0
19446;78815;580;0;0;0;0;.00nan;0;0
19447;170037;582;89;29;0;29;1.000;3900000;0
19447;185240;1928;0;0;0;0;.00nan;0;0
19447;155769;1928;98;24;0;24;1.000;3900000;0
19447;161047;582;0;0;0;0;.00nan;0;0
19448;11438;1918;85;34;2;32;.941;3600000;0
19448;19954;1918;0;0;0;0;.00nan;0;0
19448;89930;567;58;30;3;27;.900;3542000;0
19448;143879;567;0;0;0;0;.00nan;0;0
19449;7412;585;64;62;6;56;.903;3281000;0
19449;13033;586;65;17;1;16;.941;3600000;0
19449;35052;585;46;6;1;5;.833;319000;0
19449;64923;586;0;0;0;0;.00nan;0;0
19450;163471;563;72;33;3;30;.909;3545000;0
19450;20196;1922;0;0;0;0;.00nan;0;0
19450;61999;563;0;0;0;0;.00nan;0;0
19450;155945;1922;68;27;2;25;.926;3600000;0
19451;13041;580;0;0;0;0;.00nan;0;0
19451;184159;583;35;23;4;19;.826;3600000;0
19451;181071;583;0;0;0;0;.00nan;0;0
19451;78815;580;99;41;1;40;.976;3600000;0
19452;11352;2277;0;0;0;0;.00nan;0;0
19452;184159;583;66;33;3;30;.909;3900000;0
19452;181071;583;0;0;0;0;.00nan;0;0
19452;185744;2277;60;33;3;30;.909;3900000;0
19453;13033;586;69;19;1;18;.947;3600000;0
19453;170037;582;28;32;6;26;.813;3076000;0
19453;64923;586;0;0;0;0;.00nan;0;0
19453;161047;582;48;0;0;0;.00nan;524000;0
19454;179981;2557;0;0;0;0;.00nan;0;0
19454;-1;2557;38;25;5;20;.800;3600000;0
19454;56480;2287;44;14;2;12;.857;3600000;0
19454;67626;2287;0;0;0;0;.00nan;0;0
19455;184159;583;0;0;0;0;.00nan;0;0
19455;181071;583;44;46;6;40;.870;3600000;0
19455;89930;567;24;19;5;14;.737;3600000;0
19455;143879;567;0;0;0;0;.00nan;0;0
19456;13033;586;30;34;6;28;.824;3190000;0
19456;64923;586;40;2;1;1;.500;409000;0
19456;89930;567;72;47;6;41;.872;3600000;0
19456;143879;567;0;0;0;0;.00nan;0;0
19457;11352;2277;0;0;0;0;.00nan;0;0
19457;185240;1928;0;0;0;0;.00nan;0;0
19457;185744;2277;64;36;4;32;.889;3579000;0
19457;155769;1928;66;30;2;28;.933;3600000;0
19458;11438;1918;84;30;1;29;.967;3600000;0
19458;19954;1918;0;0;0;0;.00nan;0;0
19458;170037;582;52;34;5;29;.853;3600000;0
19458;161047;582;0;0;0;0;.00nan;0;0
19459;7412;585;0;0;0;0;.00nan;0;0
19459;13041;580;83;25;1;24;.960;3600000;0
19459;35052;585;53;24;3;21;.875;3600000;0
19459;78815;580;0;0;0;0;.00nan;0;0
19460;163471;563;55;32;4;28;.875;3600000;0
19460;20196;1922;0;0;0;0;.00nan;0;0
19460;61999;563;0;0;0;0;.00nan;0;0
19460;155945;1922;91;39;1;38;.974;3600000;0
19461;20196;1922;52;31;4;27;.871;3600000;0
19461;170037;582;0;0;0;0;.00nan;0;0
19461;155945;1922;0;0;0;0;.00nan;0;0
19461;161047;582;99;42;1;41;.976;3600000;0
19462;11438;1918;0;0;0;0;.00nan;0;0
19462;19954;1918;92;49;3;46;.939;3535000;0
19462;56480;2287;0;0;0;0;.00nan;0;0
19462;67626;2287;69;20;1;19;.950;3600000;0
19463;13033;586;0;0;0;0;.00nan;0;0
19463;185240;1928;74;23;2;21;.913;3556000;0
19463;64923;586;74;26;1;25;.962;3600000;0
19463;155769;1928;0;0;0;0;.00nan;0;0
19464;163471;563;0;0;0;0;.00nan;0;0
19464;11352;2277;77;27;2;25;.926;3600000;0
19464;185744;2277;0;0;0;0;.00nan;0;0
19464;61999;563;42;21;4;17;.810;3600000;0
19465;184159;583;87;28;1;27;.964;3600000;0
19465;179981;2557;69;25;1;24;.960;2694000;0
19465;181071;583;0;0;0;0;.00nan;0;0
19465;-1;2557;15;15;5;10;.667;906000;0
19466;7412;585;71;36;3;33;.917;3616000;0
19466;13041;580;0;0;0;0;.00nan;0;0
19466;35052;585;0;0;0;0;.00nan;0;0
19466;78815;580;72;40;4;36;.900;3629000;0
19467;179981;2557;63;40;5;35;.875;3600000;0
19467;-1;2557;0;0;0;0;.00nan;0;0
19467;89930;567;64;21;2;19;.905;3600000;0
19467;143879;567;0;0;0;0;.00nan;0;0
19468;179981;2557;0;0;0;0;.00nan;0;0
19468;-1;2557;94;46;3;43;.935;3559000;0
19468;56480;2287;0;0;0;0;.00nan;0;0
19468;67626;2287;55;13;2;11;.846;3600000;0
19469;7412;585;0;0;0;0;.00nan;0;0
19469;184159;583;45;20;3;17;.850;3575000;0
19469;35052;585;91;41;2;39;.951;3600000;0
19469;181071;583;0;0;0;0;.00nan;0;0
19470;11438;1918;51;14;2;12;.857;3600000;0
19470;13041;580;0;0;0;0;.00nan;0;0
19470;19954;1918;0;0;0;0;.00nan;0;0
19470;78815;580;76;43;5;38;.884;3600000;0
19471;13041;580;92;34;1;33;.971;3600000;0
19471;170037;582;58;27;3;24;.889;3569000;0
19471;78815;580;0;0;0;0;.00nan;0;0
19471;161047;582;0;0;0;0;.00nan;0;0
19472;13033;586;100;29;0;29;1.000;3600000;0
19472;185240;1928;55;20;3;17;.850;3600000;0
19472;64923;586;0;0;0;0;.00nan;0;0
19472;155769;1928;0;0;0;0;.00nan;0;0
19473;7412;585;54;26;3;23;.885;1823000;0
19473;35052;585;23;34;7;27;.794;1777000;0
19473;89930;567;34;16;4;12;.750;3600000;0
19473;143879;567;0;0;0;0;.00nan;0;0
19474;11352;2277;68;44;4;40;.909;3600000;0
19474;20196;1922;0;0;0;0;.00nan;0;0
19474;185744;2277;0;0;0;0;.00nan;0;0
19474;155945;1922;47;33;5;28;.848;3551000;0
19475;163471;563;81;28;1;27;.964;3600000;0
19475;184159;583;0;0;0;0;.00nan;0;0
19475;181071;583;51;34;4;30;.882;3600000;0
19475;61999;563;0;0;0;0;.00nan;0;0
19476;13033;586;92;41;2;39;.951;3600000;0
19476;64923;586;0;0;0;0;.00nan;0;0
19476;89930;567;0;0;0;0;.00nan;0;0
19476;143879;567;41;18;3;15;.833;3547000;0
19477;7412;585;96;42;2;40;.952;3600000;0
19477;35052;585;0;0;0;0;.00nan;0;0
19477;56480;2287;0;0;0;0;.00nan;0;0
19477;67626;2287;47;27;5;22;.815;3600000;0
19478;11352;2277;0;0;0;0;.00nan;0;0
19478;179981;2557;0;0;0;0;.00nan;0;0
19478;185744;2277;56;25;2;23;.920;3546000;0
19478;-1;2557;85;30;1;29;.967;3600000;0
19479;184159;583;91;34;2;32;.941;3600000;0
19479;170037;582;0;0;0;0;.00nan;0;0
19479;181071;583;0;0;0;0;.00nan;0;0
19479;161047;582;13;23;7;16;.696;3600000;0
19480;163471;563;0;0;0;0;.00nan;0;0
19480;13041;580;0;0;0;0;.00nan;0;0
19480;61999;563;68;16;1;15;.938;3600000;0
19480;78815;580;90;46;3;43;.935;3537000;0
19481;20196;1922;0;0;0;0;.00nan;0;0
19481;184159;583;91;39;2;37;.949;3600000;0
19481;181071;583;0;0;0;0;.00nan;0;0
19481;155945;1922;42;30;5;25;.833;3600000;0
19482;7412;585;50;23;3;20;.870;2142000;0
19482;11438;1918;0;0;0;0;.00nan;0;0
19482;19954;1918;50;24;3;21;.875;3600000;0
19482;35052;585;12;20;6;14;.700;1458000;0
19483;185240;1928;0;0;0;0;.00nan;0;0
19483;89930;567;37;18;4;14;.778;3600000;0
19483;143879;567;0;0;0;0;.00nan;0;0
19483;155769;1928;69;49;5;44;.898;3557000;0
19484;20196;1922;0;0;0;0;.00nan;0;0
19484;56480;2287;49;38;6;32;.842;3531000;0
19484;67626;2287;0;0;0;0;.00nan;0;0
19484;155945;1922;53;27;4;23;.852;3600000;0
19485;170037;582;66;23;2;21;.913;3600000;0
19485;179981;2557;54;38;5;33;.868;3600000;0
19485;-1;2557;0;0;0;0;.00nan;0;0
19485;161047;582;0;0;0;0;.00nan;0;0
19486;11438;1918;0;0;0;0;.00nan;0;0
19486;13033;586;25;18;6;12;.667;2541000;0
19486;19954;1918;57;39;5;34;.872;3600000;0
19486;64923;586;49;2;0;2;1.000;1034000;0
19487;7412;585;0;0;0;0;.00nan;0;0
19487;184159;583;80;16;0;16;1.000;3600000;0
19487;35052;585;44;29;4;25;.862;3600000;0
19487;181071;583;0;0;0;0;.00nan;0;0
19488;11352;2277;0;0;0;0;.00nan;0;0
19488;13041;580;87;25;1;24;.960;3600000;0
19488;185744;2277;51;30;3;27;.900;3513000;0
19488;78815;580;0;0;0;0;.00nan;0;0
19489;11438;1918;86;29;1;28;.966;3600000;0
19489;19954;1918;0;0;0;0;.00nan;0;0
19489;185240;1928;0;0;0;0;.00nan;0;0
19489;155769;1928;47;28;5;23;.821;3600000;0
19490;56480;2287;0;0;0;0;.00nan;0;0
19490;67626;2287;56;44;6;38;.864;3900000;0
19490;89930;567;24;26;6;20;.769;3900000;0
19490;143879;567;0;0;0;0;.00nan;0;0
19491;163471;563;52;36;5;31;.861;3560000;0
19491;13033;586;44;17;4;13;.765;3600000;0
19491;61999;563;0;0;0;0;.00nan;0;0
19491;64923;586;0;0;0;0;.00nan;0;0
19492;20196;1922;45;30;5;25;.833;3567000;0
19492;170037;582;0;0;0;0;.00nan;0;0
19492;155945;1922;0;0;0;0;.00nan;0;0
19492;161047;582;48;27;4;23;.852;3600000;0
19493;11352;2277;58;29;3;26;.897;3900000;0
19493;13041;580;0;0;0;0;.00nan;0;0
19493;185744;2277;0;0;0;0;.00nan;0;0
19493;78815;580;56;34;3;31;.912;3900000;0
19494;163471;563;62;27;2;25;.926;3600000;0
19494;11438;1918;0;0;0;0;.00nan;0;0
19494;19954;1918;81;42;3;39;.929;3592000;0
19494;61999;563;0;0;0;0;.00nan;0;0
19495;163471;563;44;7;2;5;.714;717000;0
19495;56480;2287;60;25;3;22;.880;3600000;0
19495;61999;563;33;32;6;26;.813;2883000;0
19495;67626;2287;0;0;0;0;.00nan;0;0
19496;11352;2277;93;29;1;28;.966;3900000;0
19496;170037;582;0;0;0;0;.00nan;0;0
19496;185744;2277;0;0;0;0;.00nan;0;0
19496;161047;582;72;21;1;20;.952;3900000;0
19497;13033;586;98;30;1;29;.967;3600000;0
19497;20196;1922;0;0;0;0;.00nan;0;0
19497;64923;586;0;0;0;0;.00nan;0;0
19497;155945;1922;74;36;3;33;.917;3600000;0
19498;184159;583;43;9;2;7;.778;3900000;0
19498;179981;2557;0;0;0;0;.00nan;0;0
19498;181071;583;0;0;0;0;.00nan;0;0
19498;-1;2557;100;65;2;63;.969;3900000;0
19499;170037;582;67;24;2;22;.917;3600000;0
19499;89930;567;58;23;3;20;.870;3558000;0
19499;143879;567;0;0;0;0;.00nan;0;0
19499;161047;582;0;0;0;0;.00nan;0;0
19500;20196;1922;0;0;0;0;.00nan;0;0
19500;185240;1928;0;0;0;0;.00nan;0;0
19500;155769;1928;41;32;6;26;.813;3600000;0
19500;155945;1922;70;25;2;23;.920;3600000;0
19501;11352;2277;100;44;2;42;.955;3600000;0
19501;185744;2277;0;0;0;0;.00nan;0;0
19501;56480;2287;0;0;0;0;.00nan;0;0
19501;67626;2287;70;31;3;28;.903;3588000;0
19502;13033;586;65;16;2;14;.875;3600000;0
19502;179981;2557;68;56;5;51;.911;3600000;0
19502;-1;2557;0;0;0;0;.00nan;0;0
19502;64923;586;0;0;0;0;.00nan;0;0
19503;184159;583;70;23;1;22;.957;3600000;0
19503;170037;582;0;0;0;0;.00nan;0;0
19503;181071;583;0;0;0;0;.00nan;0;0
19503;161047;582;79;32;2;30;.938;3541000;0
19504;11352;2277;0;0;0;0;.00nan;0;0
19504;185240;1928;87;32;2;30;.938;3600000;0
19504;185744;2277;69;33;3;30;.909;3577000;0
19504;155769;1928;0;0;0;0;.00nan;0;0
19505;7412;585;72;34;2;32;.941;2835000;0
19505;13033;586;76;26;1;25;.962;3600000;0
19505;35052;585;30;15;4;11;.733;765000;0
19505;64923;586;0;0;0;0;.00nan;0;0
19506;11438;1918;86;15;0;15;1.000;3600000;0
19506;19954;1918;0;0;0;0;.00nan;0;0
19506;56480;2287;93;36;1;35;.972;3549000;0
19506;67626;2287;0;0;0;0;.00nan;0;0
19507;13041;580;0;0;0;0;.00nan;0;0
19507;20196;1922;35;18;4;14;.778;3900000;0
19507;78815;580;57;36;4;32;.889;3900000;0
19507;155945;1922;0;0;0;0;.00nan;0;0
19508;163471;563;41;34;5;29;.853;3600000;0
19508;61999;563;0;0;0;0;.00nan;0;0
19508;89930;567;68;28;2;26;.929;3600000;0
19508;143879;567;0;0;0;0;.00nan;0;0
19509;7412;585;0;0;0;0;.00nan;0;0
19509;163471;563;87;35;2;33;.943;3600000;0
19509;35052;585;80;37;3;34;.919;3554000;0
19509;61999;563;0;0;0;0;.00nan;0;0
19510;7412;585;66;45;5;40;.889;3600000;0
19510;20196;1922;0;0;0;0;.00nan;0;0
19510;35052;585;0;0;0;0;.00nan;0;0
19510;155945;1922;83;15;0;15;1.000;3600000;0
19511;11352;2277;22;23;6;17;.739;1903000;0
19511;20196;1922;0;0;0;0;.00nan;0;0
19511;185744;2277;54;17;2;15;.882;1697000;0
19511;155945;1922;56;18;2;16;.889;3600000;0
19512;11438;1918;0;0;0;0;.00nan;0;0
19512;19954;1918;69;27;2;25;.926;3565000;0
19512;170037;582;79;23;1;22;.957;3600000;0
19512;161047;582;0;0;0;0;.00nan;0;0
19513;13033;586;60;32;4;28;.875;3900000;0
19513;20196;1922;68;38;4;34;.895;3900000;0
19513;64923;586;0;0;0;0;.00nan;0;0
19513;155945;1922;0;0;0;0;.00nan;0;0
19514;184159;583;0;0;0;0;.00nan;0;0
19514;181071;583;74;29;3;26;.897;3600000;0
19514;56480;2287;37;21;4;17;.810;3578000;0
19514;67626;2287;0;0;0;0;.00nan;0;0
19515;13041;580;90;39;3;36;.923;3900000;0
19515;78815;580;0;0;0;0;.00nan;0;0
19515;89930;567;54;20;3;17;.850;3900000;0
19515;143879;567;0;0;0;0;.00nan;0;0
19516;163471;563;78;39;3;36;.923;3600000;0
19516;185240;1928;0;0;0;0;.00nan;0;0
19516;61999;563;0;0;0;0;.00nan;0;0
19516;155769;1928;62;36;4;32;.889;3552000;0
19517;170037;582;0;0;0;0;.00nan;0;0
19517;185240;1928;81;31;2;29;.935;3600000;0
19517;155769;1928;0;0;0;0;.00nan;0;0
19517;161047;582;46;32;4;28;.875;3569000;0
19518;11352;2277;0;0;0;0;.00nan;0;0
19518;13033;586;100;26;0;26;1.000;3600000;0
19518;185744;2277;92;45;2;43;.956;3542000;0
19518;64923;586;0;0;0;0;.00nan;0;0
19519;163471;563;94;29;2;27;.931;3900000;0
19519;179981;2557;0;0;0;0;.00nan;0;0
19519;-1;2557;84;40;2;38;.950;3900000;0
19519;61999;563;0;0;0;0;.00nan;0;0
19520;11438;1918;90;19;0;19;1.000;3600000;0
19520;19954;1918;0;0;0;0;.00nan;0;0
19520;184159;583;42;41;6;35;.854;3600000;0
19520;181071;583;0;0;0;0;.00nan;0;0
19521;7412;585;0;0;0;0;.00nan;0;0
19521;35052;585;83;32;1;31;.969;3600000;0
19521;56480;2287;0;0;0;0;.00nan;0;0
19521;67626;2287;57;40;5;35;.875;3600000;0
19532;13033;586;81;33;3;30;.909;3900000;0
19532;185240;1928;66;34;3;31;.912;3900000;0
19532;64923;586;0;0;0;0;.00nan;0;0
19532;155769;1928;0;0;0;0;.00nan;0;0
19534;13041;580;0;0;0;0;.00nan;0;0
19534;78815;580;91;34;1;33;.971;3900000;0
19534;89930;567;85;29;1;28;.966;3900000;0
19534;143879;567;0;0;0;0;.00nan;0;0
19536;7412;585;0;0;0;0;.00nan;0;0
19536;35052;585;100;42;1;41;.976;3600000;0
19536;56480;2287;93;39;3;36;.923;3566000;0
19536;67626;2287;0;0;0;0;.00nan;0;0
19538;11438;1918;38;22;4;18;.818;3560000;0
19538;19954;1918;0;0;0;0;.00nan;0;0
19538;170037;582;75;34;2;32;.941;3600000;0
19538;67625;582;0;0;0;0;.00nan;0;0
19540;20196;1922;52;31;4;27;.871;3600000;0
19540;61999;563;83;16;0;16;1.000;3600000;0
19540;155943;563;0;0;0;0;.00nan;0;0
19540;155945;1922;0;0;0;0;.00nan;0;0
19542;11352;2277;0;0;0;0;.00nan;0;0
19542;184159;583;82;30;2;28;.933;3600000;0
19542;181071;583;0;0;0;0;.00nan;0;0
19542;185744;2277;42;28;4;24;.857;3556000;0
19544;7412;585;73;48;5;43;.896;3600000;0
19544;13033;586;0;0;0;0;.00nan;0;0
19544;35052;585;0;0;0;0;.00nan;0;0
19544;64923;586;80;26;2;24;.923;3600000;0
19546;11438;1918;0;0;0;0;.00nan;0;0
19546;19954;1918;73;30;2;28;.933;3900000;0
19546;61999;563;75;24;2;22;.917;3900000;0
19546;155943;563;0;0;0;0;.00nan;0;0
19548;13041;580;79;27;2;25;.926;3516000;0
19548;185240;1928;0;0;0;0;.00nan;0;0
19548;78815;580;0;0;0;0;.00nan;0;0
19548;155769;1928;100;27;0;27;1.000;3600000;0
19550;184159;583;0;0;0;0;.00nan;0;0
19550;181071;583;58;21;2;19;.905;3518000;0
19550;56480;2287;0;0;0;0;.00nan;0;0
19550;67626;2287;100;32;0;32;1.000;3600000;0
19552;179981;2557;66;46;5;41;.891;3600000;0
19552;-1;2557;0;0;0;0;.00nan;0;0
19552;89930;567;0;0;0;0;.00nan;0;0
19552;143879;567;57;11;1;10;.909;3600000;0
19554;11352;2277;69;23;2;21;.913;3600000;0
19554;20196;1922;0;0;0;0;.00nan;0;0
19554;185744;2277;0;0;0;0;.00nan;0;0
19554;155945;1922;36;26;5;21;.808;3600000;0
19556;179981;2557;79;28;2;26;.929;3600000;0
19556;-1;2557;0;0;0;0;.00nan;0;0
19556;89930;567;56;26;3;23;.885;3541000;0
19556;143879;567;0;0;0;0;.00nan;0;0
19558;184159;583;29;32;7;25;.781;3600000;0
19558;170037;582;80;35;3;32;.914;3600000;0
19558;181071;583;0;0;0;0;.00nan;0;0
19558;67625;582;0;0;0;0;.00nan;0;0
19560;13041;580;49;1;0;1;1.000;473000;0
19560;185240;1928;0;0;0;0;.00nan;0;0
19560;78815;580;28;33;7;26;.788;3127000;0
19560;155769;1928;57;21;3;18;.857;3600000;0
19562;11352;2277;51;28;3;25;.893;3899000;0
19562;185744;2277;0;0;0;0;.00nan;0;0
19562;61999;563;0;0;0;0;.00nan;0;0
19562;155943;563;54;20;3;17;.850;3900000;0
19564;13033;586;61;21;3;18;.857;3600000;0
19564;20196;1922;62;36;4;32;.889;3572000;0
19564;64923;586;0;0;0;0;.00nan;0;0
19564;155945;1922;0;0;0;0;.00nan;0;0
19566;7412;585;0;0;0;0;.00nan;0;0
19566;11438;1918;39;28;5;23;.821;3728000;0
19566;19954;1918;0;0;0;0;.00nan;0;0
19566;35052;585;56;31;4;27;.871;3728000;0
19568;13033;586;0;0;0;0;.00nan;0;0
19568;61999;563;67;37;3;34;.919;3900000;0
19568;64923;586;68;29;3;26;.897;3900000;0
19568;155943;563;0;0;0;0;.00nan;0;0
19570;20196;1922;0;0;0;0;.00nan;0;0
19570;170037;582;0;0;0;0;.00nan;0;0
19570;67625;582;81;37;3;34;.919;3791000;0
19570;155945;1922;72;28;2;26;.929;3791000;0
19572;11438;1918;0;0;0;0;.00nan;0;0
19572;19954;1918;58;34;4;30;.882;3600000;0
19572;179981;2557;0;0;0;0;.00nan;0;0
19572;-1;2557;77;25;1;24;.960;3600000;0
19574;13041;580;58;24;3;21;.875;3550000;0
19574;78815;580;0;0;0;0;.00nan;0;0
19574;89930;567;0;0;0;0;.00nan;0;0
19574;143879;567;64;18;1;17;.944;3600000;0
19576;7412;585;61;35;3;32;.914;3600000;0
19576;35052;585;0;0;0;0;.00nan;0;0
19576;56480;2287;0;0;0;0;.00nan;0;0
19576;67626;2287;42;21;4;17;.810;3581000;0
19578;184159;583;0;0;0;0;.00nan;0;0
19578;185240;1928;87;42;2;40;.952;3600000;0
19578;181071;583;76;35;3;32;.914;3585000;0
19578;155769;1928;0;0;0;0;.00nan;0;0
19580;11352;2277;0;0;0;0;.00nan;0;0
19580;185744;2277;90;33;1;32;.970;3900000;0
19580;56480;2287;82;23;1;22;.957;3900000;0
19580;67626;2287;0;0;0;0;.00nan;0;0
19582;20196;1922;65;31;4;27;.871;3588000;0
19582;61999;563;0;0;0;0;.00nan;0;0
19582;155943;563;75;32;2;30;.938;3600000;0
19582;155945;1922;0;0;0;0;.00nan;0;0
19584;13041;580;0;0;0;0;.00nan;0;0
19584;179981;2557;44;29;4;25;.862;3561000;0
19584;-1;2557;0;0;0;0;.00nan;0;0
19584;78815;580;73;30;2;28;.933;3600000;0
19586;7412;585;0;0;0;0;.00nan;0;0
19586;35052;585;84;39;2;37;.949;3890000;0
19586;185240;1928;57;23;2;21;.913;3900000;0
19586;155769;1928;0;0;0;0;.00nan;0;0
19588;13033;586;26;24;5;19;.792;3600000;0
19588;64923;586;0;0;0;0;.00nan;0;0
19588;89930;567;91;18;0;18;1.000;3600000;0
19588;143879;567;0;0;0;0;.00nan;0;0
19590;11438;1918;87;34;1;33;.971;3600000;0
19590;19954;1918;0;0;0;0;.00nan;0;0
19590;184159;583;39;33;6;27;.818;3216000;0
19590;181071;583;51;3;0;3;1.000;384000;0
19592;7412;585;36;33;6;27;.818;3600000;0
19592;179981;2557;0;0;0;0;.00nan;0;0
19592;35052;585;0;0;0;0;.00nan;0;0
19592;-1;2557;74;25;1;24;.960;3600000;0
19594;13041;580;38;22;4;18;.818;844000;0
19594;78815;580;50;28;4;24;.857;2756000;0
19594;89930;567;55;17;2;15;.882;3600000;0
19594;143879;567;0;0;0;0;.00nan;0;0
19596;11438;1918;0;0;0;0;.00nan;0;0
19596;13033;586;0;0;0;0;.00nan;0;0
19596;19954;1918;77;34;2;32;.941;3600000;0
19596;64923;586;31;27;6;21;.778;3600000;0
19598;185240;1928;0;0;0;0;.00nan;0;0
19598;56480;2287;0;0;0;0;.00nan;0;0
19598;67626;2287;73;20;1;19;.950;3900000;0
19598;155769;1928;100;48;1;47;.979;3900000;0
19600;11352;2277;100;34;0;34;1.000;3600000;0
19600;185744;2277;0;0;0;0;.00nan;0;0
19600;61999;563;61;19;2;17;.895;3561000;0
19600;155943;563;0;0;0;0;.00nan;0;0
19602;20196;1922;0;0;0;0;.00nan;0;0
19602;170037;582;67;21;1;20;.952;3600000;0
19602;67625;582;0;0;0;0;.00nan;0;0
19602;155945;1922;46;41;7;34;.829;3600000;0
19604;7412;585;0;0;0;0;.00nan;0;0
19604;13033;586;90;31;1;30;.968;3600000;0
19604;35052;585;90;41;2;39;.951;3600000;0
19604;64923;586;0;0;0;0;.00nan;0;0
19606;20196;1922;0;0;0;0;.00nan;0;0
19606;184159;583;57;37;4;33;.892;3600000;0
19606;181071;583;0;0;0;0;.00nan;0;0
19606;155945;1922;65;24;2;22;.917;3600000;0
19608;170037;582;68;27;2;25;.926;3600000;0
19608;179981;2557;0;0;0;0;.00nan;0;0
19608;-1;2557;61;25;3;22;.880;3544000;0
19608;67625;582;0;0;0;0;.00nan;0;0
19610;13041;580;0;0;0;0;.00nan;0;0
19610;185240;1928;52;16;2;14;.875;3591000;0
19610;78815;580;95;33;1;32;.970;3600000;0
19610;155769;1928;0;0;0;0;.00nan;0;0
19612;11438;1918;73;32;3;29;.906;3600000;0
19612;19954;1918;0;0;0;0;.00nan;0;0
19612;56480;2287;85;19;0;19;1.000;3600000;0
19612;67626;2287;0;0;0;0;.00nan;0;0
19614;61999;563;79;35;3;32;.914;3600000;0
19614;89930;567;46;35;6;29;.829;2586000;0
19614;143879;567;64;11;0;11;1.000;1014000;0
19614;155943;563;0;0;0;0;.00nan;0;0
19615;182872;638;70;44;4;40;.909;3578000;0
19615;-1;1825;0;0;0;0;.00nan;0;0
19615;-1;1825;59;22;2;20;.909;3600000;0
19615;58112;638;0;0;0;0;.00nan;0;0
19616;164404;1838;0;0;0;0;.00nan;0;0
19616;169552;1809;87;30;1;29;.967;3600000;0
19616;174017;1838;46;12;3;9;.750;3517000;0
19616;72747;1809;0;0;0;0;.00nan;0;0
19617;8426;629;76;54;5;49;.907;3523000;0
19617;-1;629;0;0;0;0;.00nan;0;0
19617;-1;648;0;0;0;0;.00nan;0;0
19617;-1;648;45;18;3;15;.833;3600000;0
19618;11104;647;63;28;3;25;.893;3543000;0
19618;11107;649;0;0;0;0;.00nan;0;0
19618;174209;649;78;26;2;24;.923;3600000;0
19618;-1;647;0;0;0;0;.00nan;0;0
19619;180053;1836;0;0;0;0;.00nan;0;0
19619;-1;1836;22;28;6;22;.786;3584000;0
19619;-1;4538;0;0;0;0;.00nan;0;0
19619;145038;4538;74;48;5;43;.896;3600000;0
19620;-1;1835;0;0;0;0;.00nan;0;0
19620;-1;633;90;40;2;38;.950;3600000;0
19620;-1;633;0;0;0;0;.00nan;0;0
19620;156545;1835;53;32;4;28;.875;3552000;0
19621;200985;646;0;0;0;0;.00nan;0;0
19621;185314;644;64;35;4;31;.886;3600000;0
19621;-1;646;74;20;1;19;.950;3600000;0
19621;-1;644;0;0;0;0;.00nan;0;0
19622;164404;1838;0;0;0;0;.00nan;0;0
19622;174017;1838;52;26;4;22;.846;3729000;0
19622;-1;633;84;40;3;37;.925;3729000;0
19622;-1;633;0;0;0;0;.00nan;0;0
19623;182872;638;75;44;5;39;.886;3600000;0
19623;-1;4538;0;0;0;0;.00nan;0;0
19623;58112;638;0;0;0;0;.00nan;0;0
19623;145038;4538;36;29;6;23;.793;3600000;0
19624;8426;629;71;52;6;46;.885;3600000;0
19624;11107;649;0;0;0;0;.00nan;0;0
19624;174209;649;95;21;0;21;1.000;3600000;0
19624;-1;629;0;0;0;0;.00nan;0;0
19625;-1;1825;71;25;2;23;.920;3600000;0
19625;-1;1825;0;0;0;0;.00nan;0;0
19625;185314;644;51;32;5;27;.844;3600000;0
19625;-1;644;0;0;0;0;.00nan;0;0
19626;-1;1835;0;0;0;0;.00nan;0;0
19626;200985;646;0;0;0;0;.00nan;0;0
19626;-1;646;42;36;5;31;.861;3600000;0
19626;156545;1835;57;32;4;28;.875;3600000;0
19627;180053;1836;0;0;0;0;.00nan;0;0
19627;-1;1836;67;16;1;15;.938;3600000;0
19627;-1;648;0;0;0;0;.00nan;0;0
19627;-1;648;73;64;6;58;.906;3600000;0
19628;11104;647;85;43;3;40;.930;3600000;0
19628;169552;1809;24;12;4;8;.667;3550000;0
19628;-1;647;0;0;0;0;.00nan;0;0
19628;72747;1809;0;0;0;0;.00nan;0;0
19629;182872;638;70;40;4;36;.900;3573000;0
19629;-1;633;73;28;2;26;.929;3600000;0
19629;-1;633;0;0;0;0;.00nan;0;0
19629;58112;638;0;0;0;0;.00nan;0;0
19630;164404;1838;0;0;0;0;.00nan;0;0
19630;174017;1838;59;30;4;26;.867;3600000;0
19630;174209;649;83;27;1;26;.963;3600000;0
19630;85947;649;0;0;0;0;.00nan;0;0
19631;8426;629;86;48;3;45;.938;4668000;0
19631;-1;1825;65;25;2;23;.920;4668000;0
19631;-1;1825;0;0;0;0;.00nan;0;0
19631;-1;629;0;0;0;0;.00nan;0;0
19632;11104;647;53;37;4;33;.892;3600000;0
19632;-1;647;0;0;0;0;.00nan;0;0
19632;-1;648;0;0;0;0;.00nan;0;0
19632;-1;648;47;20;3;17;.850;3600000;0
19633;200985;646;0;0;0;0;.00nan;0;0
19633;180053;1836;0;0;0;0;.00nan;0;0
19633;-1;1836;63;28;3;25;.893;3600000;0
19633;-1;646;47;34;5;29;.853;3600000;0
19634;-1;1835;39;36;6;30;.833;5946000;0
19634;169552;1809;0;0;0;0;.00nan;0;0
19634;72747;1809;92;81;5;76;.938;5946000;0
19634;156545;1835;0;0;0;0;.00nan;0;0
19635;185314;644;69;24;1;23;.958;3600000;0
19635;-1;4538;0;0;0;0;.00nan;0;0
19635;-1;644;0;0;0;0;.00nan;0;0
19635;145038;4538;56;38;5;33;.868;3600000;0
19636;8426;629;53;34;4;30;.882;3600000;0
19636;-1;633;0;0;0;0;.00nan;0;0
19636;-1;633;79;23;1;22;.957;3600000;0
19636;-1;629;0;0;0;0;.00nan;0;0
19637;-1;1835;66;17;1;16;.941;3600000;0
19637;-1;4538;0;0;0;0;.00nan;0;0
19637;145038;4538;60;39;5;34;.872;3600000;0
19637;156545;1835;0;0;0;0;.00nan;0;0
19638;174209;649;0;0;0;0;.00nan;0;0
19638;185314;644;0;0;0;0;.00nan;0;0
19638;-1;644;27;23;6;17;.739;3600000;0
19638;85947;649;69;33;3;30;.909;3600000;0
19639;11104;647;0;0;0;0;.00nan;0;0
19639;-1;1825;71;22;2;20;.909;3846000;0
19639;-1;1825;0;0;0;0;.00nan;0;0
19639;-1;647;94;36;1;35;.972;3846000;0
19640;182872;638;73;31;2;29;.935;3600000;0
19640;200985;646;59;29;3;26;.897;3553000;0
19640;-1;646;0;0;0;0;.00nan;0;0
19640;58112;638;0;0;0;0;.00nan;0;0
19641;169552;1809;70;49;5;44;.898;3600000;0
19641;180053;1836;0;0;0;0;.00nan;0;0
19641;-1;1836;55;16;2;14;.875;3600000;0
19641;72747;1809;0;0;0;0;.00nan;0;0
19642;164404;1838;62;19;2;17;.895;2703000;0
19642;174017;1838;23;13;4;9;.692;897000;0
19642;-1;648;79;29;1;28;.966;3600000;0
19642;-1;648;0;0;0;0;.00nan;0;0
19643;-1;633;78;30;3;27;.900;3600000;0
19643;-1;633;0;0;0;0;.00nan;0;0
19643;-1;4538;0;0;0;0;.00nan;0;0
19643;145038;4538;36;26;5;21;.808;3600000;0
19644;182872;638;0;0;0;0;.00nan;0;0
19644;-1;648;49;30;4;26;.867;3600000;0
19644;-1;648;0;0;0;0;.00nan;0;0
19644;58112;638;61;47;5;42;.894;3581000;0
19645;164404;1838;0;0;0;0;.00nan;0;0
19645;174017;1838;64;32;4;28;.875;4372000;0
19645;180053;1836;0;0;0;0;.00nan;0;0
19645;-1;1836;49;26;3;23;.885;4372000;0
19646;8426;629;57;40;5;35;.875;3600000;0
19646;200985;646;0;0;0;0;.00nan;0;0
19646;-1;629;0;0;0;0;.00nan;0;0
19646;-1;646;67;19;1;18;.947;3600000;0
19647;-1;1835;62;14;1;13;.929;3600000;0
19647;174209;649;0;0;0;0;.00nan;0;0
19647;85947;649;88;55;4;51;.927;3600000;0
19647;156545;1835;0;0;0;0;.00nan;0;0
19648;11104;647;33;30;6;24;.800;2147000;0
19648;185314;644;0;0;0;0;.00nan;0;0
19648;-1;647;42;9;2;7;.778;1453000;0
19648;-1;644;75;20;1;19;.950;3600000;0
19649;169552;1809;0;0;0;0;.00nan;0;0
19649;-1;1825;41;23;4;19;.826;3600000;0
19649;-1;1825;0;0;0;0;.00nan;0;0
19649;72747;1809;99;29;0;29;1.000;3600000;0
19650;8426;629;26;29;6;23;.793;2127000;0
19650;-1;629;88;30;1;29;.967;1473000;0
19650;-1;4538;0;0;0;0;.00nan;0;0
19650;145038;4538;96;32;1;31;.969;3600000;0
19651;182872;638;0;0;0;0;.00nan;0;0
19651;11104;647;0;0;0;0;.00nan;0;0
19651;-1;647;69;37;3;34;.919;3600000;0
19651;58112;638;91;36;2;34;.944;3600000;0
19652;174209;649;0;0;0;0;.00nan;0;0
19652;-1;633;63;35;5;30;.857;3651000;0
19652;-1;633;0;0;0;0;.00nan;0;0
19652;85947;649;45;21;4;17;.810;3651000;0
19653;164404;1838;0;0;0;0;.00nan;0;0
19653;174017;1838;58;22;2;20;.909;3600000;0
19653;-1;1825;0;0;0;0;.00nan;0;0
19653;-1;1825;42;25;4;21;.840;3600000;0
19654;180053;1836;0;0;0;0;.00nan;0;0
19654;185314;644;58;38;5;33;.868;3570000;0
19654;-1;1836;71;33;3;30;.909;3600000;0
19654;-1;644;0;0;0;0;.00nan;0;0
19655;169552;1809;64;33;3;30;.909;3600000;0
19655;200985;646;0;0;0;0;.00nan;0;0
19655;-1;646;23;31;6;25;.806;3600000;0
19655;72747;1809;0;0;0;0;.00nan;0;0
19656;-1;1835;71;41;4;37;.902;3600000;0
19656;-1;648;0;0;0;0;.00nan;0;0
19656;-1;648;62;27;3;24;.889;3600000;0
19656;156545;1835;0;0;0;0;.00nan;0;0
19657;200985;646;0;0;0;0;.00nan;0;0
19657;-1;633;0;0;0;0;.00nan;0;0
19657;-1;633;94;46;2;44;.957;3600000;0
19657;-1;646;40;24;4;20;.833;3588000;0
19658;164404;1838;0;0;0;0;.00nan;0;0
19658;11104;647;89;50;4;46;.920;3600000;0
19658;174017;1838;86;17;0;17;1.000;3600000;0
19658;-1;647;0;0;0;0;.00nan;0;0
19659;8426;629;32;36;6;30;.833;1835000;0
19659;180053;1836;0;0;0;0;.00nan;0;0
19659;-1;1836;67;6;0;6;1.000;3600000;0
19659;-1;629;86;22;0;22;1.000;1765000;0
19660;174209;649;0;0;0;0;.00nan;0;0
19660;-1;1825;67;34;4;30;.882;3596000;0
19660;-1;1825;0;0;0;0;.00nan;0;0
19660;85947;649;59;32;3;29;.906;3600000;0
19661;-1;1835;61;30;3;27;.900;3539000;0
19661;185314;644;0;0;0;0;.00nan;0;0
19661;-1;644;75;25;1;24;.960;3600000;0
19661;156545;1835;0;0;0;0;.00nan;0;0
19662;-1;4538;0;0;0;0;.00nan;0;0
19662;-1;648;93;40;2;38;.950;3600000;0
19662;-1;648;0;0;0;0;.00nan;0;0
19662;145038;4538;69;41;4;37;.902;3520000;0
19663;182872;638;0;0;0;0;.00nan;0;0
19663;169552;1809;0;0;0;0;.00nan;0;0
19663;58112;638;89;45;3;42;.933;3564000;0
19663;72747;1809;71;22;2;20;.909;3600000;0
19664;-1;633;78;42;3;39;.929;4176000;0
19664;-1;633;0;0;0;0;.00nan;0;0
19664;-1;648;0;0;0;0;.00nan;0;0
19664;-1;648;63;42;4;38;.905;4176000;0
19665;182872;638;0;0;0;0;.00nan;0;0
19665;185314;644;7;26;7;19;.731;3280000;0
19665;-1;644;50;5;1;4;.800;794000;0
19665;58112;638;71;59;7;52;.881;4074000;0
19666;8426;629;77;41;4;37;.902;3600000;0
19666;164404;1838;0;0;0;0;.00nan;0;0
19666;174017;1838;82;22;1;21;.955;3600000;0
19666;-1;629;0;0;0;0;.00nan;0;0
19667;174209;649;0;0;0;0;.00nan;0;0
19667;180053;1836;0;0;0;0;.00nan;0;0
19667;-1;1836;62;17;1;16;.941;3600000;0
19667;85947;649;79;44;3;41;.932;3527000;0
19668;200985;646;0;0;0;0;.00nan;0;0
19668;-1;1825;0;0;0;0;.00nan;0;0
19668;-1;1825;49;40;5;35;.875;3581000;0
19668;-1;646;35;22;4;18;.818;3600000;0
19669;11104;647;0;0;0;0;.00nan;0;0
19669;-1;1835;54;18;3;15;.833;3754000;0
19669;-1;647;93;47;4;43;.915;3754000;0
19669;156545;1835;0;0;0;0;.00nan;0;0
19670;169552;1809;62;17;2;15;.882;3600000;0
19670;-1;4538;44;4;1;3;.750;366000;0
19670;72747;1809;0;0;0;0;.00nan;0;0
19670;145038;4538;41;39;6;33;.846;3234000;0
19671;-1;1825;85;32;1;31;.969;3600000;0
19671;-1;1825;0;0;0;0;.00nan;0;0
19671;-1;4538;0;0;0;0;.00nan;0;0
19671;145038;4538;68;33;3;30;.909;3564000;0
19672;8426;629;90;39;3;36;.923;3588000;0
19672;-1;1835;68;22;1;21;.955;3600000;0
19672;-1;629;0;0;0;0;.00nan;0;0
19672;156545;1835;0;0;0;0;.00nan;0;0
19673;11104;647;77;28;2;26;.929;3600000;0
19673;-1;633;47;30;4;26;.867;3514000;0
19673;-1;633;0;0;0;0;.00nan;0;0
19673;-1;647;0;0;0;0;.00nan;0;0
19674;182872;638;0;0;0;0;.00nan;0;0
19674;180053;1836;0;0;0;0;.00nan;0;0
19674;-1;1836;53;17;2;15;.882;3918000;0
19674;58112;638;78;40;3;37;.925;3918000;0
19675;174209;649;0;0;0;0;.00nan;0;0
19675;200985;646;63;32;3;29;.906;3600000;0
19675;-1;646;0;0;0;0;.00nan;0;0
19675;85947;649;61;36;4;32;.889;3554000;0
19676;169552;1809;0;0;0;0;.00nan;0;0
19676;-1;648;59;29;3;26;.897;3584000;0
19676;-1;648;0;0;0;0;.00nan;0;0
19676;72747;1809;100;43;2;41;.953;3600000;0
19677;164404;1838;0;0;0;0;.00nan;0;0
19677;174017;1838;50;36;5;31;.861;4298000;0
19677;185314;644;0;0;0;0;.00nan;0;0
19677;-1;644;57;38;6;32;.842;4298000;0
19678;8426;629;94;43;3;40;.930;3600000;0
19678;-1;629;0;0;0;0;.00nan;0;0
19678;-1;648;0;0;0;0;.00nan;0;0
19678;-1;648;40;25;4;21;.840;3598000;0
19679;-1;633;65;43;5;38;.884;3600000;0
19679;185314;644;15;27;7;20;.741;2859000;0
19679;-1;633;0;0;0;0;.00nan;0;0
19679;-1;644;54;7;0;7;1.000;710000;0
19680;182872;638;0;0;0;0;.00nan;0;0
19680;8426;629;70;44;4;40;.909;5159000;0
19680;-1;629;0;0;0;0;.00nan;0;0
19680;58112;638;61;29;3;26;.897;5159000;0
19681;11104;647;0;0;0;0;.00nan;0;0
19681;180053;1836;0;0;0;0;.00nan;0;0
19681;-1;1836;96;14;0;14;1.000;3600000;0
19681;-1;647;86;67;2;65;.970;3539000;0
19682;169552;1809;49;37;6;31;.838;3105000;0
19682;174209;649;0;0;0;0;.00nan;0;0
19682;72747;1809;56;5;0;5;1.000;495000;0
19682;85947;649;84;18;0;18;1.000;3600000;0
19683;-1;1825;62;27;3;24;.889;3600000;0
19683;-1;1825;0;0;0;0;.00nan;0;0
19683;-1;648;27;13;4;9;.692;592000;0
19683;-1;648;46;24;3;21;.875;3008000;0
19684;200985;646;0;0;0;0;.00nan;0;0
19684;-1;646;67;19;1;18;.947;3600000;0
19684;-1;4538;0;0;0;0;.00nan;0;0
19684;145038;4538;82;50;5;45;.900;3600000;0
19685;164404;1838;0;0;0;0;.00nan;0;0
19685;-1;1835;0;0;0;0;.00nan;0;0
19685;174017;1838;60;42;5;37;.881;3600000;0
19685;156545;1835;80;30;2;28;.933;3600000;0
19686;182872;638;72;47;4;43;.915;3537000;0
19686;-1;1835;57;21;3;18;.857;3600000;0
19686;58112;638;0;0;0;0;.00nan;0;0
19686;156545;1835;0;0;0;0;.00nan;0;0
19687;11104;647;70;32;3;29;.906;3552000;0
19687;-1;647;0;0;0;0;.00nan;0;0
19687;-1;4538;0;0;0;0;.00nan;0;0
19687;145038;4538;67;24;2;22;.917;3600000;0
19688;164404;1838;0;0;0;0;.00nan;0;0
19688;174017;1838;100;43;1;42;.977;5020000;0
19688;200985;646;0;0;0;0;.00nan;0;0
19688;-1;646;83;33;2;31;.939;5020000;0
19689;-1;1825;67;30;3;27;.900;3598000;0
19689;-1;1825;0;0;0;0;.00nan;0;0
19689;180053;1836;0;0;0;0;.00nan;0;0
19689;-1;1836;92;25;1;24;.960;3600000;0
19690;174209;649;0;0;0;0;.00nan;0;0
19690;-1;648;0;0;0;0;.00nan;0;0
19690;-1;648;85;26;1;25;.962;3600000;0
19690;85947;649;89;38;2;36;.947;3578000;0
19691;8426;629;40;19;4;15;.789;1195000;0
19691;185314;644;0;0;0;0;.00nan;0;0
19691;-1;629;62;27;3;24;.889;2384000;0
19691;-1;644;38;27;5;22;.815;3600000;0
19692;169552;1809;0;0;0;0;.00nan;0;0
19692;-1;633;58;33;4;29;.879;3537000;0
19692;-1;633;0;0;0;0;.00nan;0;0
19692;72747;1809;75;27;2;25;.926;3600000;0
19693;182872;638;54;21;2;19;.905;1769000;0
19693;174209;649;0;0;0;0;.00nan;0;0
19693;58112;638;1;10;6;4;.400;1831000;0
19693;85947;649;76;36;3;33;.917;3600000;0
19694;164404;1838;0;0;0;0;.00nan;0;0
19694;174017;1838;82;34;2;32;.941;3600000;0
19694;-1;4538;0;0;0;0;.00nan;0;0
19694;145038;4538;70;37;3;34;.919;3574000;0
19695;8426;629;85;54;4;50;.926;4231000;0
19695;169552;1809;47;21;3;18;.857;4231000;0
19695;-1;629;0;0;0;0;.00nan;0;0
19695;72747;1809;0;0;0;0;.00nan;0;0
19696;11104;647;52;31;4;27;.871;3546000;0
19696;200985;646;0;0;0;0;.00nan;0;0
19696;-1;647;0;0;0;0;.00nan;0;0
19696;-1;646;64;26;3;23;.885;3600000;0
19697;-1;1835;49;33;5;28;.848;3558000;0
19697;-1;1825;0;0;0;0;.00nan;0;0
19697;-1;1825;67;34;4;30;.882;3600000;0
19697;156545;1835;0;0;0;0;.00nan;0;0
19698;-1;633;58;44;5;39;.886;3600000;0
19698;180053;1836;0;0;0;0;.00nan;0;0
19698;-1;1836;55;19;2;17;.895;3600000;0
19698;-1;633;0;0;0;0;.00nan;0;0
19699;185314;644;46;36;6;30;.833;2323000;0
19699;-1;648;0;0;0;0;.00nan;0;0
19699;-1;644;65;13;0;13;1.000;1277000;0
19699;-1;648;48;19;3;16;.842;3600000;0
19700;-1;1835;58;26;3;23;.885;3600000;0
19700;-1;633;82;45;4;41;.911;3549000;0
19700;-1;633;0;0;0;0;.00nan;0;0
19700;156545;1835;0;0;0;0;.00nan;0;0
19701;180053;1836;0;0;0;0;.00nan;0;0
19701;-1;1836;57;19;2;17;.895;3600000;0
19701;-1;4538;0;0;0;0;.00nan;0;0
19701;145038;4538;64;42;5;37;.881;3600000;0
19702;11104;647;94;33;1;32;.970;3989000;0
19702;174209;649;0;0;0;0;.00nan;0;0
19702;-1;647;0;0;0;0;.00nan;0;0
19702;85947;649;80;21;0;21;1.000;3989000;0
19703;182872;638;0;0;0;0;.00nan;0;0
19703;-1;1825;0;0;0;0;.00nan;0;0
19703;-1;1825;73;35;3;32;.914;3907000;0
19703;58112;638;54;28;4;24;.857;3907000;0
19704;200985;646;0;0;0;0;.00nan;0;0
19704;185314;644;82;26;1;25;.962;2730000;0
19704;-1;646;78;21;1;20;.952;3600000;0
19704;-1;644;31;18;4;14;.778;870000;0
19705;164404;1838;0;0;0;0;.00nan;0;0
19705;169552;1809;0;0;0;0;.00nan;0;0
19705;174017;1838;59;42;5;37;.881;3600000;0
19705;72747;1809;100;33;0;33;1.000;3600000;0
19706;182872;638;0;0;0;0;.00nan;0;0
19706;-1;633;66;19;1;18;.947;2551000;0
19706;-1;633;28;13;4;9;.692;1049000;0
19706;58112;638;43;48;7;41;.854;3560000;0
19707;185314;644;45;29;4;25;.862;3526000;0
19707;-1;4538;0;0;0;0;.00nan;0;0
19707;-1;644;0;0;0;0;.00nan;0;0
19707;145038;4538;85;31;2;29;.935;3600000;0
19708;164404;1838;0;0;0;0;.00nan;0;0
19708;174017;1838;63;35;3;32;.914;3981000;0
19708;174209;649;0;0;0;0;.00nan;0;0
19708;85947;649;71;33;2;31;.939;3981000;0
19709;8426;629;45;57;9;48;.842;3600000;0
19709;-1;1825;85;16;0;16;1.000;3600000;0
19709;-1;1825;0;0;0;0;.00nan;0;0
19709;-1;629;0;0;0;0;.00nan;0;0
19710;200985;646;67;37;3;34;.919;3572000;0
19710;180053;1836;0;0;0;0;.00nan;0;0
19710;-1;1836;61;20;2;18;.900;3600000;0
19710;-1;646;0;0;0;0;.00nan;0;0
19711;11104;647;92;52;1;51;.981;3600000;0
19711;-1;647;0;0;0;0;.00nan;0;0
19711;-1;648;56;18;2;16;.889;3555000;0
19711;-1;648;0;0;0;0;.00nan;0;0
19712;-1;1835;84;30;1;29;.967;3716000;0
19712;169552;1809;94;37;2;35;.946;3716000;0
19712;72747;1809;0;0;0;0;.00nan;0;0
19712;156545;1835;0;0;0;0;.00nan;0;0
19713;182872;638;39;39;6;33;.846;3032000;0
19713;200985;646;0;0;0;0;.00nan;0;0
19713;-1;646;42;23;4;19;.826;3600000;0
19713;58112;638;40;9;2;7;.778;568000;0
19714;164404;1838;0;0;0;0;.00nan;0;0
19714;174017;1838;99;32;1;31;.969;3600000;0
19714;-1;648;0;0;0;0;.00nan;0;0
19714;-1;648;54;43;7;36;.837;3600000;0
19715;8426;629;63;49;6;43;.878;3041000;0
19715;-1;633;51;19;3;16;.842;3600000;0
19715;-1;633;0;0;0;0;.00nan;0;0
19715;-1;629;68;13;0;13;1.000;559000;0
19716;11104;647;99;43;1;42;.977;4354000;0
19716;-1;1825;67;28;2;26;.929;4354000;0
19716;-1;1825;0;0;0;0;.00nan;0;0
19716;-1;647;0;0;0;0;.00nan;0;0
19717;169552;1809;0;0;0;0;.00nan;0;0
19717;180053;1836;0;0;0;0;.00nan;0;0
19717;-1;1836;47;16;2;14;.875;3600000;0
19717;72747;1809;70;39;4;35;.897;3548000;0
19718;-1;1835;22;19;5;14;.737;2396000;0
19718;-1;4538;0;0;0;0;.00nan;0;0
19718;145038;4538;72;49;5;44;.898;3600000;0
19718;156545;1835;43;4;1;3;.750;1171000;0
19719;174209;649;0;0;0;0;.00nan;0;0
19719;185314;644;0;0;0;0;.00nan;0;0
19719;-1;644;62;50;6;44;.880;5470000;0
19719;85947;649;88;53;5;48;.906;5470000;0
19720;182872;638;0;0;0;0;.00nan;0;0
19720;164404;1838;0;0;0;0;.00nan;0;0
19720;174017;1838;54;23;3;20;.870;3600000;0
19720;58112;638;77;31;2;29;.935;3600000;0
19721;-1;633;28;29;6;23;.793;2414000;0
19721;-1;633;47;6;1;5;.833;1165000;0
19721;-1;4538;0;0;0;0;.00nan;0;0
19721;145038;4538;52;33;5;28;.848;3600000;0
19722;11104;647;78;43;4;39;.907;4228000;0
19722;185314;644;74;38;3;35;.921;4228000;0
19722;-1;647;0;0;0;0;.00nan;0;0
19722;-1;644;0;0;0;0;.00nan;0;0
19723;-1;1835;79;25;1;24;.960;3600000;0
19723;174209;649;0;0;0;0;.00nan;0;0
19723;85947;649;37;43;7;36;.837;3600000;0
19723;156545;1835;0;0;0;0;.00nan;0;0
19724;169552;1809;32;31;6;25;.806;3090000;0
19724;-1;1825;0;0;0;0;.00nan;0;0
19724;-1;1825;79;20;1;19;.950;3600000;0
19724;72747;1809;57;7;0;7;1.000;510000;0
19725;164404;1838;0;0;0;0;.00nan;0;0
19725;174017;1838;72;37;4;33;.892;3546000;0
19725;180053;1836;0;0;0;0;.00nan;0;0
19725;-1;1836;64;18;2;16;.889;3600000;0
19726;8426;629;89;42;3;39;.929;3600000;0
19726;200985;646;0;0;0;0;.00nan;0;0
19726;-1;629;0;0;0;0;.00nan;0;0
19726;-1;646;66;15;1;14;.933;3600000;0
19727;182872;638;0;0;0;0;.00nan;0;0
19727;-1;648;56;29;4;25;.862;3600000;0
19727;-1;648;0;0;0;0;.00nan;0;0
19727;58112;638;85;50;5;45;.900;3572000;0
19728;174209;649;0;0;0;0;.00nan;0;0
19728;-1;633;83;33;3;30;.909;3553000;0
19728;-1;633;0;0;0;0;.00nan;0;0
19728;85947;649;72;27;2;25;.926;3600000;0
19729;182872;638;65;28;3;25;.893;3600000;0
19729;11104;647;37;29;5;24;.828;3571000;0
19729;-1;647;0;0;0;0;.00nan;0;0
19729;58112;638;0;0;0;0;.00nan;0;0
19730;164404;1838;65;21;2;19;.905;3600000;0
19730;174017;1838;0;0;0;0;.00nan;0;0
19730;-1;1825;51;32;5;27;.844;3600000;0
19730;-1;1825;0;0;0;0;.00nan;0;0
19731;8426;629;57;39;5;34;.872;3579000;0
19731;-1;629;0;0;0;0;.00nan;0;0
19731;-1;4538;0;0;0;0;.00nan;0;0
19731;145038;4538;42;22;4;18;.818;3600000;0
19732;-1;1835;36;17;4;13;.765;4323000;0
19732;-1;648;0;0;0;0;.00nan;0;0
19732;156545;1835;0;0;0;0;.00nan;0;0
19732;160906;648;81;53;5;48;.906;4323000;0
19733;180053;1836;0;0;0;0;.00nan;0;0
19733;185314;644;38;31;5;26;.839;1618000;0
19733;-1;1836;45;28;4;24;.857;3600000;0
19733;-1;644;53;32;4;28;.875;1982000;0
19734;169552;1809;0;0;0;0;.00nan;0;0
19734;200985;646;0;0;0;0;.00nan;0;0
19734;-1;646;82;44;4;40;.909;4135000;0
19734;72747;1809;71;32;3;29;.906;4135000;0
19735;182872;638;0;0;0;0;.00nan;0;0
19735;169552;1809;77;25;1;24;.960;3600000;0
19735;58112;638;68;36;4;32;.889;3600000;0
19735;72747;1809;0;0;0;0;.00nan;0;0
19736;-1;4538;80;33;3;30;.909;3600000;0
19736;-1;648;0;0;0;0;.00nan;0;0
19736;145038;4538;0;0;0;0;.00nan;0;0
19736;160906;648;36;32;6;26;.813;3600000;0
19737;174209;649;47;33;6;27;.818;2598000;0
19737;-1;1825;71;38;3;35;.921;3600000;0
19737;-1;1825;0;0;0;0;.00nan;0;0
19737;85947;649;42;15;3;12;.800;1002000;0
19738;8426;629;93;57;5;52;.912;3600000;0
19738;180053;1836;0;0;0;0;.00nan;0;0
19738;-1;1836;76;22;2;20;.909;3600000;0
19738;-1;629;0;0;0;0;.00nan;0;0
19739;200985;646;30;19;4;15;.789;3946000;0
19739;-1;633;81;52;5;47;.904;3946000;0
19739;-1;633;0;0;0;0;.00nan;0;0
19739;-1;646;0;0;0;0;.00nan;0;0
19740;-1;1835;55;41;5;36;.878;5478000;0
19740;185314;644;64;49;4;45;.918;5478000;0
19740;-1;644;0;0;0;0;.00nan;0;0
19740;156545;1835;0;0;0;0;.00nan;0;0
19741;-1;1825;50;22;3;19;.864;3600000;0
19741;-1;1825;0;0;0;0;.00nan;0;0
19741;-1;633;52;31;4;27;.871;3553000;0
19741;-1;633;0;0;0;0;.00nan;0;0
19742;182872;638;0;0;0;0;.00nan;0;0
19742;164404;1838;0;0;0;0;.00nan;0;0
19742;174017;1838;77;23;1;22;.957;3600000;0
19742;58112;638;53;29;4;25;.862;3600000;0
19743;8426;629;74;38;4;34;.895;3541000;0
19743;11104;647;66;33;3;30;.909;3600000;0
19743;-1;629;0;0;0;0;.00nan;0;0
19743;-1;647;0;0;0;0;.00nan;0;0
19744;174209;649;66;7;0;7;1.000;1245000;0
19744;-1;4538;0;0;0;0;.00nan;0;0
19744;85947;649;41;24;5;19;.792;2355000;0
19744;145038;4538;47;37;6;31;.838;3600000;0
19745;-1;1835;0;0;0;0;.00nan;0;0
19745;180053;1836;0;0;0;0;.00nan;0;0
19745;-1;1836;87;35;2;33;.943;3600000;0
19745;156545;1835;52;27;3;24;.889;3600000;0
19746;200985;646;0;0;0;0;.00nan;0;0
19746;-1;646;95;36;2;34;.944;3559000;0
19746;-1;648;0;0;0;0;.00nan;0;0
19746;160906;648;100;28;0;28;1.000;3600000;0
19747;169552;1809;0;0;0;0;.00nan;0;0
19747;185314;644;0;0;0;0;.00nan;0;0
19747;-1;644;48;32;4;28;.875;3554000;0
19747;72747;1809;70;27;2;25;.926;3600000;0
19748;164404;1838;0;0;0;0;.00nan;0;0
19748;11104;647;64;21;1;20;.952;1415000;0
19748;174017;1838;60;13;1;12;.923;3600000;0
19748;-1;647;18;23;6;17;.739;2185000;0
19749;8426;629;68;30;2;28;.933;3600000;0
19749;200985;646;0;0;0;0;.00nan;0;0
19749;-1;629;0;0;0;0;.00nan;0;0
19749;-1;646;42;16;3;13;.813;3545000;0
19750;169552;1809;100;37;1;36;.973;4522000;0
19750;-1;4538;0;0;0;0;.00nan;0;0
19750;72747;1809;0;0;0;0;.00nan;0;0
19750;145038;4538;86;37;2;35;.946;4522000;0
19751;8426;629;76;38;3;35;.921;3564000;0
19751;164404;1838;0;0;0;0;.00nan;0;0
19751;174017;1838;72;22;1;21;.955;3600000;0
19751;-1;629;0;0;0;0;.00nan;0;0
19752;11104;647;97;50;3;47;.940;3600000;0
19752;-1;1835;0;0;0;0;.00nan;0;0
19752;-1;647;0;0;0;0;.00nan;0;0
19752;156545;1835;95;18;0;18;1.000;3600000;0
19753;174209;649;0;0;0;0;.00nan;0;0
19753;180053;1836;0;0;0;0;.00nan;0;0
19753;-1;1836;87;14;0;14;1.000;3600000;0
19753;85947;649;72;45;5;40;.889;3600000;0
19754;200985;646;82;29;1;28;.966;3600000;0
19754;-1;1825;50;25;5;20;.800;3600000;0
19754;-1;1825;0;0;0;0;.00nan;0;0
19754;-1;646;0;0;0;0;.00nan;0;0
19755;-1;633;54;39;5;34;.872;3588000;0
19755;-1;633;0;0;0;0;.00nan;0;0
19755;-1;648;0;0;0;0;.00nan;0;0
19755;160906;648;60;28;3;25;.893;3600000;0
19756;182872;638;0;0;0;0;.00nan;0;0
19756;185314;644;38;30;5;25;.833;3600000;0
19756;-1;644;0;0;0;0;.00nan;0;0
19756;58112;638;100;44;1;43;.977;3600000;0
19757;11104;647;81;30;2;28;.933;3595000;0
19757;-1;633;94;36;1;35;.972;3600000;0
19757;-1;633;0;0;0;0;.00nan;0;0
19757;-1;647;0;0;0;0;.00nan;0;0
19758;182872;638;70;47;6;41;.872;3354000;0
19758;180053;1836;0;0;0;0;.00nan;0;0
19758;-1;1836;28;24;5;19;.792;3600000;0
19758;58112;638;52;2;0;2;1.000;195000;0
19759;164404;1838;0;0;0;0;.00nan;0;0
19759;174017;1838;64;24;3;21;.875;3600000;0
19759;185314;644;46;41;6;35;.854;3600000;0
19759;-1;644;0;0;0;0;.00nan;0;0
19760;174209;649;67;29;4;25;.862;3600000;0
19760;200985;646;0;0;0;0;.00nan;0;0
19760;-1;646;29;27;5;22;.815;3600000;0
19760;85947;649;0;0;0;0;.00nan;0;0
19761;-1;1825;0;0;0;0;.00nan;0;0
19761;-1;1825;42;28;4;24;.857;3571000;0
19761;-1;4538;0;0;0;0;.00nan;0;0
19761;145038;4538;85;41;3;38;.927;3600000;0
19762;8426;629;92;61;5;56;.918;3546000;0
19762;-1;1835;0;0;0;0;.00nan;0;0
19762;-1;629;0;0;0;0;.00nan;0;0
19762;156545;1835;49;20;3;17;.850;3600000;0
19763;169552;1809;68;27;2;25;.926;3553000;0
19763;-1;648;0;0;0;0;.00nan;0;0
19763;72747;1809;0;0;0;0;.00nan;0;0
19763;160906;648;100;28;0;28;1.000;3600000;0
19764;174209;649;0;0;0;0;.00nan;0;0
19764;-1;4538;0;0;0;0;.00nan;0;0
19764;85947;649;60;37;5;32;.865;3600000;0
19764;145038;4538;74;27;2;25;.926;3600000;0
19765;8426;629;88;51;3;48;.941;3555000;0
19765;11104;647;85;28;1;27;.964;3600000;0
19765;-1;629;0;0;0;0;.00nan;0;0
19765;-1;647;0;0;0;0;.00nan;0;0
19766;-1;1825;76;27;1;26;.963;3600000;0
19766;-1;1825;0;0;0;0;.00nan;0;0
19766;-1;633;46;32;4;28;.875;3600000;0
19766;-1;633;0;0;0;0;.00nan;0;0
19767;-1;1835;0;0;0;0;.00nan;0;0
19767;180053;1836;18;22;6;16;.727;2555000;0
19767;-1;1836;66;19;0;19;1.000;1899000;0
19767;156545;1835;23;37;7;30;.811;4454000;0
19768;200985;646;0;0;0;0;.00nan;0;0
19768;-1;646;63;23;2;21;.913;3533000;0
19768;-1;648;0;0;0;0;.00nan;0;0
19768;160906;648;100;33;0;33;1.000;3600000;0
19769;169552;1809;0;0;0;0;.00nan;0;0
19769;185314;644;0;0;0;0;.00nan;0;0
19769;-1;644;80;30;2;28;.933;3600000;0
19769;72747;1809;77;40;3;37;.925;3545000;0
19770;182872;638;0;0;0;0;.00nan;0;0
19770;8426;629;27;35;7;28;.800;3600000;0
19770;-1;629;0;0;0;0;.00nan;0;0
19770;58112;638;81;25;1;24;.960;3600000;0
19771;200985;646;0;0;0;0;.00nan;0;0
19771;-1;646;56;22;3;19;.864;3600000;0
19771;-1;4538;0;0;0;0;.00nan;0;0
19771;145038;4538;51;31;4;27;.871;3546000;0
19772;164404;1838;0;0;0;0;.00nan;0;0
19772;-1;1835;0;0;0;0;.00nan;0;0
19772;174017;1838;63;23;2;21;.913;3578000;0
19772;156545;1835;85;26;1;25;.962;3600000;0
19773;11104;647;40;39;6;33;.846;2947000;0
19773;180053;1836;0;0;0;0;.00nan;0;0
19773;-1;1836;67;17;2;15;.882;3600000;0
19773;-1;647;49;14;2;12;.857;653000;0
19774;-1;1825;20;26;6;20;.769;3173000;0
19774;-1;1825;50;7;1;6;.857;427000;0
19774;-1;648;0;0;0;0;.00nan;0;0
19774;160906;648;72;28;3;25;.893;3600000;0
19775;-1;633;76;34;3;31;.912;3589000;0
19775;185314;644;64;17;1;16;.941;3600000;0
19775;-1;633;0;0;0;0;.00nan;0;0
19775;-1;644;0;0;0;0;.00nan;0;0
19776;169552;1809;20;27;6;21;.778;2750000;0
19776;174209;649;0;0;0;0;.00nan;0;0
19776;72747;1809;53;9;1;8;.889;850000;0
19776;85947;649;44;17;3;14;.824;3600000;0
19777;169552;1809;0;0;0;0;.00nan;0;0
19777;-1;633;93;39;2;37;.949;3600000;0
19777;-1;633;0;0;0;0;.00nan;0;0
19777;72747;1809;49;22;3;19;.864;3600000;0
19778;8426;629;0;0;0;0;.00nan;0;0
19778;185314;644;63;21;2;19;.905;3600000;0
19778;-1;629;98;53;3;50;.943;3578000;0
19778;-1;644;0;0;0;0;.00nan;0;0
19779;11104;647;0;0;0;0;.00nan;0;0
19779;-1;647;80;27;1;26;.963;3600000;0
19779;-1;4538;0;0;0;0;.00nan;0;0
19779;145038;4538;48;26;4;22;.846;3600000;0
19780;174209;649;49;1;0;1;1.000;327000;0
19780;-1;648;0;0;0;0;.00nan;0;0
19780;85947;649;45;40;6;34;.850;3216000;0
19780;160906;648;57;26;5;21;.808;3600000;0
19781;-1;1825;19;24;6;18;.750;2699000;0
19781;-1;1825;38;14;3;11;.786;901000;0
19781;180053;1836;0;0;0;0;.00nan;0;0
19781;-1;1836;78;34;2;32;.941;3600000;0
19782;164404;1838;0;0;0;0;.00nan;0;0
19782;174017;1838;65;28;3;25;.893;3600000;0
19782;200985;646;43;28;4;24;.857;3600000;0
19782;-1;646;0;0;0;0;.00nan;0;0
19783;182872;638;58;6;0;6;1.000;999000;0
19783;-1;1835;63;17;1;16;.941;3600000;0
19783;58112;638;47;39;6;33;.846;2601000;0
19783;156545;1835;0;0;0;0;.00nan;0;0
19784;-1;633;0;0;0;0;.00nan;0;0
19784;180053;1836;0;0;0;0;.00nan;0;0
19784;-1;1836;100;20;0;20;1.000;3600000;0
19784;-1;633;92;46;3;43;.935;3600000;0
19785;164404;1838;0;0;0;0;.00nan;0;0
19785;174017;1838;52;26;4;22;.846;3600000;0
19785;-1;4538;0;0;0;0;.00nan;0;0
19785;145038;4538;81;27;1;26;.963;3600000;0
19786;182872;638;0;0;0;0;.00nan;0;0
19786;174209;649;36;25;5;20;.800;3563000;0
19786;58112;638;83;36;3;33;.917;3600000;0
19786;85947;649;0;0;0;0;.00nan;0;0
19787;11104;647;87;48;3;45;.938;3600000;0
19787;200985;646;0;0;0;0;.00nan;0;0
19787;-1;647;0;0;0;0;.00nan;0;0
19787;-1;646;48;15;2;13;.867;3600000;0
19788;-1;1835;76;32;2;30;.938;3600000;0
19788;-1;1825;49;28;4;24;.857;3595000;0
19788;-1;1825;0;0;0;0;.00nan;0;0
19788;156545;1835;0;0;0;0;.00nan;0;0
19789;185314;644;0;0;0;0;.00nan;0;0
19789;-1;644;100;32;0;32;1.000;3600000;0
19789;-1;648;0;0;0;0;.00nan;0;0
19789;160906;648;88;44;3;41;.932;3600000;0
19790;8426;629;77;41;4;37;.902;3600000;0
19790;169552;1809;20;21;6;15;.714;2792000;0
19790;-1;629;0;0;0;0;.00nan;0;0
19790;72747;1809;42;3;1;2;.667;808000;0
19791;182872;638;57;38;5;33;.868;3552000;0
19791;-1;4538;0;0;0;0;.00nan;0;0
19791;58112;638;0;0;0;0;.00nan;0;0
19791;145038;4538;55;27;4;23;.852;3600000;0
19792;164404;1838;0;0;0;0;.00nan;0;0
19792;174017;1838;64;21;2;19;.905;3600000;0
19792;-1;633;98;55;3;52;.945;3557000;0
19792;-1;633;0;0;0;0;.00nan;0;0
19793;8426;629;97;47;3;44;.936;3600000;0
19793;174209;649;0;0;0;0;.00nan;0;0
19793;-1;629;0;0;0;0;.00nan;0;0
19793;85947;649;73;19;1;18;.947;3600000;0
19794;11104;647;95;39;2;37;.949;3600000;0
19794;169552;1809;0;0;0;0;.00nan;0;0
19794;-1;647;0;0;0;0;.00nan;0;0
19794;72747;1809;63;28;3;25;.893;3592000;0
19795;180053;1836;0;0;0;0;.00nan;0;0
19795;-1;1836;69;16;1;15;.938;3600000;0
19795;-1;648;0;0;0;0;.00nan;0;0
19795;160906;648;80;39;2;37;.949;3567000;0
19796;-1;1835;0;0;0;0;.00nan;0;0
19796;200985;646;0;0;0;0;.00nan;0;0
19796;-1;646;53;32;4;28;.875;3600000;0
19796;156545;1835;83;32;1;31;.969;3600000;0
19797;-1;1825;0;0;0;0;.00nan;0;0
19797;-1;1825;73;28;1;27;.964;3600000;0
19797;185314;644;0;0;0;0;.00nan;0;0
19797;-1;644;66;23;2;21;.913;3568000;0
19798;164404;1838;0;0;0;0;.00nan;0;0
19798;174017;1838;74;25;1;24;.960;3600000;0
19798;-1;633;59;32;4;28;.875;3600000;0
19798;-1;633;0;0;0;0;.00nan;0;0
19799;182872;638;94;43;2;41;.953;3600000;0
19799;-1;4538;29;7;3;4;.571;552000;0
19799;58112;638;0;0;0;0;.00nan;0;0
19799;145038;4538;98;28;0;28;1.000;2991000;0
19800;8426;629;75;42;4;38;.905;3621000;0
19800;174209;649;0;0;0;0;.00nan;0;0
19800;-1;629;0;0;0;0;.00nan;0;0
19800;85947;649;57;23;3;20;.870;3621000;0
19801;-1;1825;63;32;3;29;.906;3600000;0
19801;-1;1825;0;0;0;0;.00nan;0;0
19801;185314;644;64;38;4;34;.895;3567000;0
19801;-1;644;0;0;0;0;.00nan;0;0
19802;-1;1835;0;0;0;0;.00nan;0;0
19802;200985;646;69;29;3;26;.897;3979000;0
19802;-1;646;0;0;0;0;.00nan;0;0
19802;156545;1835;51;25;4;21;.840;3979000;0
19803;180053;1836;0;0;0;0;.00nan;0;0
19803;-1;1836;48;37;5;32;.865;4524000;0
19803;-1;648;0;0;0;0;.00nan;0;0
19803;160906;648;63;37;4;33;.892;4524000;0
19804;11104;647;83;37;2;35;.946;4554000;0
19804;169552;1809;73;21;1;20;.952;4554000;0
19804;-1;647;0;0;0;0;.00nan;0;0
19804;72747;1809;0;0;0;0;.00nan;0;0
19805;182872;638;30;37;7;30;.811;2420000;0
19805;-1;1825;51;1;0;1;1.000;648000;0
19805;-1;1825;23;23;6;17;.739;2952000;0
19805;58112;638;61;16;1;15;.938;1131000;0
19806;164404;1838;0;0;0;0;.00nan;0;0
19806;169552;1809;42;8;2;6;.750;1217000;0
19806;174017;1838;75;23;2;21;.913;3600000;0
19806;72747;1809;23;18;6;12;.667;2383000;0
19807;8426;629;97;55;3;52;.945;3600000;0
19807;-1;629;0;0;0;0;.00nan;0;0
19807;-1;648;0;0;0;0;.00nan;0;0
19807;160906;648;46;24;4;20;.833;3563000;0
19808;11104;647;0;0;0;0;.00nan;0;0
19808;174209;649;0;0;0;0;.00nan;0;0
19808;-1;647;92;54;4;50;.926;4294000;0
19808;85947;649;67;27;3;24;.889;4294000;0
19809;180053;1836;0;0;0;0;.00nan;0;0
19809;-1;1836;50;23;3;20;.870;3600000;0
19809;-1;4538;54;22;3;19;.864;1003000;0
19809;145038;4538;14;23;6;17;.739;2597000;0
19810;-1;1835;55;28;3;25;.893;4336000;0
19810;-1;633;90;41;2;39;.951;4336000;0
19810;-1;633;0;0;0;0;.00nan;0;0
19810;156545;1835;0;0;0;0;.00nan;0;0
19811;200985;646;0;0;0;0;.00nan;0;0
19811;185314;644;0;0;0;0;.00nan;0;0
19811;-1;646;86;23;1;22;.957;3600000;0
19811;-1;644;87;41;3;38;.927;3600000;0
19812;8426;629;54;48;7;41;.854;3095000;0
19812;-1;633;78;26;1;25;.962;3600000;0
19812;-1;633;0;0;0;0;.00nan;0;0
19812;-1;629;50;9;1;8;.889;505000;0
19813;-1;1835;55;26;3;23;.885;3600000;0
19813;-1;4538;0;0;0;0;.00nan;0;0
19813;145038;4538;57;39;5;34;.872;3545000;0
19813;156545;1835;0;0;0;0;.00nan;0;0
19814;174209;649;57;32;4;28;.875;3600000;0
19814;185314;644;36;27;5;22;.815;3566000;0
19814;-1;644;0;0;0;0;.00nan;0;0
19814;85947;649;0;0;0;0;.00nan;0;0
19815;11104;647;47;42;6;36;.857;3568000;0
19815;-1;1825;52;27;4;23;.852;3600000;0
19815;-1;1825;0;0;0;0;.00nan;0;0
19815;-1;647;0;0;0;0;.00nan;0;0
19816;182872;638;0;0;0;0;.00nan;0;0
19816;200985;646;0;0;0;0;.00nan;0;0
19816;-1;646;34;24;5;19;.792;5044000;0
19816;58112;638;64;54;6;48;.889;5044000;0
19817;164404;1838;0;0;0;0;.00nan;0;0
19817;174017;1838;37;34;6;28;.824;3600000;0
19817;-1;648;57;23;3;20;.870;3600000;0
19817;160906;648;0;0;0;0;.00nan;0;0
19818;169552;1809;57;38;4;34;.895;3600000;0
19818;180053;1836;0;0;0;0;.00nan;0;0
19818;-1;1836;61;26;2;24;.923;3600000;0
19818;72747;1809;0;0;0;0;.00nan;0;0
19819;182872;638;0;0;0;0;.00nan;0;0
19819;-1;633;79;26;1;25;.962;3600000;0
19819;-1;633;0;0;0;0;.00nan;0;0
19819;58112;638;97;47;2;45;.957;3600000;0
19820;164404;1838;0;0;0;0;.00nan;0;0
19820;174017;1838;79;26;2;24;.923;3600000;0
19820;174209;649;58;7;0;7;1.000;802000;0
19820;85947;649;42;36;6;30;.833;2798000;0
19821;8426;629;96;48;3;45;.938;3600000;0
19821;-1;1825;48;26;4;22;.846;3566000;0
19821;-1;1825;0;0;0;0;.00nan;0;0
19821;-1;629;0;0;0;0;.00nan;0;0
19822;11104;647;0;0;0;0;.00nan;0;0
19822;-1;647;49;48;7;41;.854;3600000;0
19822;-1;648;0;0;0;0;.00nan;0;0
19822;160906;648;59;32;4;28;.875;3600000;0
19823;200985;646;54;14;1;13;.929;1054000;0
19823;180053;1836;0;0;0;0;.00nan;0;0
19823;-1;1836;51;19;3;16;.842;3600000;0
19823;-1;646;23;24;6;18;.750;2546000;0
19824;-1;1835;71;34;3;31;.912;3739000;0
19824;169552;1809;0;0;0;0;.00nan;0;0
19824;72747;1809;76;31;2;29;.935;3739000;0
19824;156545;1835;0;0;0;0;.00nan;0;0
19825;185314;644;55;28;4;24;.857;2524000;0
19825;-1;4538;0;0;0;0;.00nan;0;0
19825;-1;644;24;11;4;7;.636;1076000;0
19825;145038;4538;68;30;3;27;.900;3600000;0
19826;8426;629;52;40;5;35;.875;3600000;0
19826;-1;629;0;0;0;0;.00nan;0;0
19826;-1;4538;0;0;0;0;.00nan;0;0
19826;145038;4538;54;17;2;15;.882;3600000;0
19827;182872;638;0;0;0;0;.00nan;0;0
19827;11104;647;61;4;0;4;1.000;550000;0
19827;-1;647;44;36;6;30;.833;3050000;0
19827;58112;638;74;23;1;22;.957;3600000;0
19828;174209;649;0;0;0;0;.00nan;0;0
19828;-1;633;40;34;6;28;.824;3600000;0
19828;-1;633;0;0;0;0;.00nan;0;0
19828;85947;649;87;31;1;30;.968;3600000;0
19829;164404;1838;55;8;1;7;.875;1064000;0
19829;174017;1838;14;27;7;20;.741;2536000;0
19829;-1;1825;0;0;0;0;.00nan;0;0
19829;-1;1825;79;36;2;34;.944;3600000;0
19830;180053;1836;0;0;0;0;.00nan;0;0
19830;185314;644;64;45;5;40;.889;3818000;0
19830;-1;1836;60;31;4;27;.871;3818000;0
19830;-1;644;0;0;0;0;.00nan;0;0
19831;169552;1809;63;37;4;33;.892;3600000;0
19831;200985;646;78;27;1;26;.963;3600000;0
19831;-1;646;0;0;0;0;.00nan;0;0
19831;72747;1809;0;0;0;0;.00nan;0;0
19832;-1;1835;0;0;0;0;.00nan;0;0
19832;-1;648;0;0;0;0;.00nan;0;0
19832;156545;1835;67;20;1;19;.950;3600000;0
19832;160906;648;58;30;4;26;.867;3600000;0
19833;-1;633;0;0;0;0;.00nan;0;0
19833;-1;4538;0;0;0;0;.00nan;0;0
19833;-1;633;39;39;6;33;.846;3600000;0
19833;145038;4538;65;22;2;20;.909;3600000;0
19834;182872;638;0;0;0;0;.00nan;0;0
19834;-1;648;0;0;0;0;.00nan;0;0
19834;58112;638;76;36;4;32;.889;3600000;0
19834;160906;648;86;26;1;25;.962;3600000;0
19835;164404;1838;0;0;0;0;.00nan;0;0
19835;174017;1838;62;40;4;36;.900;3527000;0
19835;180053;1836;0;0;0;0;.00nan;0;0
19835;-1;1836;77;28;2;26;.929;3600000;0
19836;8426;629;59;53;6;47;.887;3600000;0
19836;200985;646;0;0;0;0;.00nan;0;0
19836;-1;629;0;0;0;0;.00nan;0;0
19836;-1;646;70;27;2;25;.926;3600000;0
19837;-1;1835;67;13;1;12;.923;3600000;0
19837;174209;649;0;0;0;0;.00nan;0;0
19837;85947;649;66;22;2;20;.909;3575000;0
19837;156545;1835;0;0;0;0;.00nan;0;0
19838;11104;647;94;51;3;48;.941;3997000;0
19838;185314;644;0;0;0;0;.00nan;0;0
19838;-1;647;0;0;0;0;.00nan;0;0
19838;-1;644;45;24;4;20;.833;3997000;0
19839;169552;1809;0;0;0;0;.00nan;0;0
19839;-1;1825;0;0;0;0;.00nan;0;0
19839;-1;1825;36;25;5;20;.800;3600000;0
19839;72747;1809;74;28;2;26;.929;3600000;0
19840;-1;1825;37;34;6;28;.824;3600000;0
19840;-1;1825;0;0;0;0;.00nan;0;0
19840;-1;4538;0;0;0;0;.00nan;0;0
19840;145038;4538;64;23;2;21;.913;3600000;0
19841;8426;629;81;44;3;41;.932;3600000;0
19841;-1;1835;54;18;2;16;.889;3600000;0
19841;-1;629;0;0;0;0;.00nan;0;0
19841;156545;1835;0;0;0;0;.00nan;0;0
19842;11104;647;63;17;1;16;.941;3600000;0
19842;-1;633;50;31;4;27;.871;3600000;0
19842;-1;633;0;0;0;0;.00nan;0;0
19842;-1;647;0;0;0;0;.00nan;0;0
19843;182872;638;0;0;0;0;.00nan;0;0
19843;180053;1836;0;0;0;0;.00nan;0;0
19843;-1;1836;69;31;3;28;.903;3600000;0
19843;58112;638;57;35;4;31;.886;3587000;0
19844;174209;649;0;0;0;0;.00nan;0;0
19844;200985;646;52;30;4;26;.867;3522000;0
19844;-1;646;0;0;0;0;.00nan;0;0
19844;85947;649;84;41;2;39;.951;3600000;0
19845;169552;1809;32;30;7;23;.767;2721000;0
19845;-1;648;0;0;0;0;.00nan;0;0
19845;72747;1809;54;4;0;4;1.000;879000;0
19845;160906;648;55;33;4;29;.879;3600000;0
19846;164404;1838;0;0;0;0;.00nan;0;0
19846;174017;1838;64;28;3;25;.893;3600000;0
19846;185314;644;63;25;2;23;.920;3600000;0
19846;-1;644;0;0;0;0;.00nan;0;0
19847;182872;638;51;44;6;38;.864;3600000;0
19847;164404;1838;0;0;0;0;.00nan;0;0
19847;174017;1838;77;24;1;23;.958;3600000;0
19847;58112;638;0;0;0;0;.00nan;0;0
19848;174209;649;0;0;0;0;.00nan;0;0
19848;-1;4538;0;0;0;0;.00nan;0;0
19848;85947;649;89;57;5;52;.912;3567000;0
19848;145038;4538;53;33;4;29;.879;3600000;0
19849;8426;629;35;35;6;29;.829;2987000;0
19849;11104;647;0;0;0;0;.00nan;0;0
19849;-1;629;55;4;0;4;1.000;613000;0
19849;-1;647;52;31;4;27;.871;3600000;0
19850;-1;1825;0;0;0;0;.00nan;0;0
19850;-1;1825;49;38;5;33;.868;3600000;0
19850;-1;633;84;41;2;39;.951;3600000;0
19850;-1;633;0;0;0;0;.00nan;0;0
19851;-1;1835;55;32;4;28;.875;3556000;0
19851;180053;1836;0;0;0;0;.00nan;0;0
19851;-1;1836;68;34;3;31;.912;3600000;0
19851;156545;1835;0;0;0;0;.00nan;0;0
19852;200985;646;0;0;0;0;.00nan;0;0
19852;-1;646;77;33;2;31;.939;3600000;0
19852;-1;648;0;0;0;0;.00nan;0;0
19852;160906;648;57;34;4;30;.882;3563000;0
19853;169552;1809;0;0;0;0;.00nan;0;0
19853;185314;644;77;28;2;26;.929;3600000;0
19853;-1;644;0;0;0;0;.00nan;0;0
19853;72747;1809;77;35;3;32;.914;3600000;0
19854;200985;646;0;0;0;0;.00nan;0;0
19854;-1;633;58;36;4;32;.889;3545000;0
19854;-1;633;0;0;0;0;.00nan;0;0
19854;-1;646;72;34;3;31;.912;3600000;0
19855;164404;1838;43;19;3;16;.842;3567000;0
19855;11104;647;88;36;2;34;.944;3600000;0
19855;174017;1838;0;0;0;0;.00nan;0;0
19855;-1;647;0;0;0;0;.00nan;0;0
19856;8426;629;93;58;4;54;.931;3600000;0
19856;180053;1836;0;0;0;0;.00nan;0;0
19856;-1;1836;60;16;2;14;.875;3600000;0
19856;-1;629;0;0;0;0;.00nan;0;0
19857;174209;649;0;0;0;0;.00nan;0;0
19857;-1;1825;72;29;2;27;.931;3553000;0
19857;-1;1825;0;0;0;0;.00nan;0;0
19857;85947;649;72;22;1;21;.955;3600000;0
19858;-1;1835;0;0;0;0;.00nan;0;0
19858;185314;644;43;3;1;2;.667;406000;0
19858;-1;644;32;30;6;24;.800;3194000;0
19858;156545;1835;79;38;4;34;.895;3600000;0
19859;-1;4538;0;0;0;0;.00nan;0;0
19859;-1;648;68;24;2;22;.917;3600000;0
19859;145038;4538;54;42;6;36;.857;3600000;0
19859;160906;648;0;0;0;0;.00nan;0;0
19860;182872;638;0;0;0;0;.00nan;0;0
19860;169552;1809;78;24;1;23;.958;3600000;0
19860;58112;638;62;23;2;21;.913;3600000;0
19860;72747;1809;0;0;0;0;.00nan;0;0
19861;-1;633;0;0;0;0;.00nan;0;0
19861;-1;633;85;38;2;36;.947;3600000;0
19861;-1;648;0;0;0;0;.00nan;0;0
19861;160906;648;66;33;4;29;.879;3587000;0
19862;182872;638;0;0;0;0;.00nan;0;0
19862;-1;1835;0;0;0;0;.00nan;0;0
19862;58112;638;94;64;3;61;.953;5194000;0
19862;156545;1835;63;23;2;21;.913;5194000;0
19863;11104;647;25;26;6;20;.769;3267000;0
19863;-1;4538;0;0;0;0;.00nan;0;0
19863;-1;647;40;2;1;1;.500;333000;0
19863;145038;4538;58;21;3;18;.857;3600000;0
19864;164404;1838;0;0;0;0;.00nan;0;0
19864;174017;1838;75;29;3;26;.897;3600000;0
19864;200985;646;0;0;0;0;.00nan;0;0
19864;-1;646;53;29;4;25;.862;3600000;0
19865;-1;1825;0;0;0;0;.00nan;0;0
19865;-1;1825;64;42;4;38;.905;3600000;0
19865;180053;1836;75;22;1;21;.955;3600000;0
19865;-1;1836;0;0;0;0;.00nan;0;0
19866;174209;649;0;0;0;0;.00nan;0;0
19866;-1;648;0;0;0;0;.00nan;0;0
19866;85947;649;83;34;2;32;.941;3600000;0
19866;160906;648;72;39;3;36;.923;3555000;0
19867;8426;629;72;42;4;38;.905;3547000;0
19867;185314;644;0;0;0;0;.00nan;0;0
19867;-1;629;0;0;0;0;.00nan;0;0
19867;-1;644;65;24;2;22;.917;3600000;0
19868;169552;1809;0;0;0;0;.00nan;0;0
19868;-1;633;61;20;2;18;.900;3600000;0
19868;-1;633;0;0;0;0;.00nan;0;0
19868;72747;1809;50;33;5;28;.848;3600000;0
19869;-1;633;60;28;3;25;.893;3600000;0
19869;185314;644;76;13;0;13;1.000;905000;0
19869;-1;633;0;0;0;0;.00nan;0;0
19869;-1;644;19;24;6;18;.750;2695000;0
19870;182872;638;74;33;3;30;.909;3600000;0
19870;8426;629;83;22;1;21;.955;3600000;0
19870;-1;629;0;0;0;0;.00nan;0;0
19870;58112;638;0;0;0;0;.00nan;0;0
19871;11104;647;0;0;0;0;.00nan;0;0
19871;180053;1836;0;0;0;0;.00nan;0;0
19871;-1;1836;51;14;2;12;.857;3600000;0
19871;-1;647;67;38;4;34;.895;3525000;0
19872;169552;1809;61;29;3;26;.897;3784000;0
19872;174209;649;89;32;2;30;.938;3784000;0
19872;72747;1809;0;0;0;0;.00nan;0;0
19872;85947;649;0;0;0;0;.00nan;0;0
19873;-1;1825;0;0;0;0;.00nan;0;0
19873;-1;1825;98;27;0;27;1.000;3600000;0
19873;-1;648;0;0;0;0;.00nan;0;0
19873;160906;648;82;42;4;38;.905;3600000;0
19874;200985;646;93;23;0;23;1.000;3600000;0
19874;-1;4538;0;0;0;0;.00nan;0;0
19874;-1;646;0;0;0;0;.00nan;0;0
19874;145038;4538;85;49;5;44;.898;3600000;0
19875;164404;1838;0;0;0;0;.00nan;0;0
19875;-1;1835;45;37;6;31;.838;3522000;0
19875;174017;1838;38;22;4;18;.818;3600000;0
19875;156545;1835;0;0;0;0;.00nan;0;0
19876;182872;638;0;0;0;0;.00nan;0;0
19876;185314;644;90;22;0;22;1.000;3600000;0
19876;-1;644;0;0;0;0;.00nan;0;0
19876;58112;638;74;46;4;42;.913;3600000;0
19877;8426;629;53;36;5;31;.861;3600000;0
19877;164404;1838;0;0;0;0;.00nan;0;0
19877;174017;1838;75;22;1;21;.955;3600000;0
19877;-1;629;0;0;0;0;.00nan;0;0
19878;174209;649;0;0;0;0;.00nan;0;0
19878;180053;1836;0;0;0;0;.00nan;0;0
19878;-1;1836;39;19;4;15;.789;3823000;0
19878;85947;649;90;50;3;47;.940;3832000;0
19879;200985;646;17;31;8;23;.742;3600000;0
19879;-1;1825;0;0;0;0;.00nan;0;0
19879;-1;1825;68;34;3;31;.912;3600000;0
19879;-1;646;0;0;0;0;.00nan;0;0
19880;11104;647;97;40;3;37;.925;3600000;0
19880;-1;1835;88;19;0;19;1.000;3600000;0
19880;-1;647;0;0;0;0;.00nan;0;0
19880;156545;1835;0;0;0;0;.00nan;0;0
19881;169552;1809;0;0;0;0;.00nan;0;0
19881;-1;4538;0;0;0;0;.00nan;0;0
19881;72747;1809;24;26;6;20;.769;3529000;0
19881;145038;4538;54;33;4;29;.879;3600000;0
19882;-1;1835;36;30;5;25;.833;3600000;0
19882;-1;633;23;24;6;18;.750;2171000;0
19882;-1;633;49;16;2;14;.875;1429000;0
19882;156545;1835;0;0;0;0;.00nan;0;0
19883;-1;4538;0;0;0;0;.00nan;0;0
19883;180053;1836;0;0;0;0;.00nan;0;0
19883;-1;1836;84;12;0;12;1.000;3600000;0
19883;145038;4538;98;47;2;45;.957;3600000;0
19884;11104;647;88;48;3;45;.938;4053000;0
19884;174209;649;0;0;0;0;.00nan;0;0
19884;-1;647;0;0;0;0;.00nan;0;0
19884;85947;649;59;21;2;19;.905;4053000;0
19885;182872;638;0;0;0;0;.00nan;0;0
19885;-1;1825;0;0;0;0;.00nan;0;0
19885;-1;1825;48;26;4;22;.846;3566000;0
19885;58112;638;83;40;3;37;.925;3600000;0
19886;200985;646;0;0;0;0;.00nan;0;0
19886;185314;644;77;31;2;29;.935;3600000;0
19886;-1;646;77;24;1;23;.958;3600000;0
19886;-1;644;0;0;0;0;.00nan;0;0
19887;8426;629;99;45;1;44;.978;3791000;0
19887;-1;629;0;0;0;0;.00nan;0;0
19887;-1;648;69;28;2;26;.929;3791000;0
19887;160906;648;0;0;0;0;.00nan;0;0
19888;164404;1838;0;0;0;0;.00nan;0;0
19888;169552;1809;98;50;3;47;.940;4500000;0
19888;174017;1838;56;28;4;24;.857;4500000;0
19888;72747;1809;0;0;0;0;.00nan;0;0
19889;182872;638;54;11;1;10;.909;810000;0
19889;174209;649;0;0;0;0;.00nan;0;0
19889;58112;638;16;19;6;13;.684;2790000;0
19889;85947;649;65;34;3;31;.912;3600000;0
19890;164404;1838;0;0;0;0;.00nan;0;0
19890;174017;1838;66;30;3;27;.900;3600000;0
19890;-1;4538;0;0;0;0;.00nan;0;0
19890;145038;4538;59;35;4;31;.886;3568000;0
19891;8426;629;61;40;6;34;.850;3177000;0
19891;169552;1809;81;13;0;13;1.000;3600000;0
19891;-1;629;50;1;0;1;1.000;423000;0
19891;72747;1809;0;0;0;0;.00nan;0;0
19892;11104;647;52;8;1;7;.875;384000;0
19892;200985;646;0;0;0;0;.00nan;0;0
19892;-1;647;42;33;6;27;.818;3216000;0
19892;-1;646;59;19;2;17;.895;3600000;0
19893;-1;633;52;43;6;37;.860;3350000;0
19893;180053;1836;0;0;0;0;.00nan;0;0
19893;-1;1836;58;16;2;14;.875;3600000;0
19893;-1;633;54;5;0;5;1.000;250000;0
19894;-1;1835;97;37;1;36;.973;3600000;0
19894;-1;1825;0;0;0;0;.00nan;0;0
19894;-1;1825;44;33;5;28;.848;3600000;0
19894;156545;1835;0;0;0;0;.00nan;0;0
19895;185314;644;55;36;5;31;.861;4330000;0
19895;-1;644;0;0;0;0;.00nan;0;0
19895;-1;648;0;0;0;0;.00nan;0;0
19895;160906;648;54;38;4;34;.895;4330000;0
19896;182872;638;53;39;5;34;.872;3600000;0
19896;200985;646;0;0;0;0;.00nan;0;0
19896;-1;646;78;30;2;28;.933;3600000;0
19896;58112;638;0;0;0;0;.00nan;0;0
19897;164404;1838;0;0;0;0;.00nan;0;0
19897;174017;1838;59;28;3;25;.893;3590000;0
19897;-1;648;0;0;0;0;.00nan;0;0
19897;160906;648;75;32;2;30;.938;3600000;0
19898;8426;629;41;39;7;32;.821;3600000;0
19898;-1;633;0;0;0;0;.00nan;0;0
19898;-1;633;64;26;3;23;.885;3600000;0
19898;-1;629;0;0;0;0;.00nan;0;0
19899;11104;647;59;46;6;40;.870;3600000;0
19899;-1;1825;0;0;0;0;.00nan;0;0
19899;-1;1825;74;19;1;18;.947;3600000;0
19899;-1;647;0;0;0;0;.00nan;0;0
19900;169552;1809;26;22;6;16;.727;2103000;0
19900;180053;1836;0;0;0;0;.00nan;0;0
19900;-1;1836;75;23;1;22;.957;3600000;0
19900;72747;1809;62;15;1;14;.933;1497000;0
19901;-1;1835;67;29;3;26;.897;3600000;0
19901;-1;4538;0;0;0;0;.00nan;0;0
19901;145038;4538;72;53;6;47;.887;3600000;0
19901;156545;1835;0;0;0;0;.00nan;0;0
19902;174209;649;0;0;0;0;.00nan;0;0
19902;185314;644;0;0;0;0;.00nan;0;0
19902;-1;644;61;24;3;21;.875;3600000;0
19902;85947;649;28;27;6;21;.778;3600000;0
19903;182872;638;78;40;3;37;.925;3785000;0
19903;-1;633;85;34;2;32;.941;3785000;0
19903;-1;633;0;0;0;0;.00nan;0;0
19903;58112;638;0;0;0;0;.00nan;0;0
19904;-1;4538;0;0;0;0;.00nan;0;0
19904;185314;644;66;34;3;31;.912;3600000;0
19904;-1;644;0;0;0;0;.00nan;0;0
19904;145038;4538;49;26;4;22;.846;3553000;0
19905;164404;1838;0;0;0;0;.00nan;0;0
19905;174017;1838;62;34;4;30;.882;3600000;0
19905;174209;649;0;0;0;0;.00nan;0;0
19905;85947;649;61;21;2;19;.905;3600000;0
19906;8426;629;93;33;1;32;.970;3600000;0
19906;-1;1825;48;20;3;17;.850;3600000;0
19906;-1;1825;0;0;0;0;.00nan;0;0
19906;-1;629;0;0;0;0;.00nan;0;0
19907;200985;646;0;0;0;0;.00nan;0;0
19907;180053;1836;0;0;0;0;.00nan;0;0
19907;-1;1836;70;23;2;21;.913;3600000;0
19907;-1;646;95;45;3;42;.933;3574000;0
19908;11104;647;43;37;6;31;.838;3600000;0
19908;-1;647;0;0;0;0;.00nan;0;0
19908;-1;648;0;0;0;0;.00nan;0;0
19908;160906;648;79;11;0;11;1.000;3600000;0
19909;-1;1835;87;31;2;29;.935;3600000;0
19909;169552;1809;0;0;0;0;.00nan;0;0
19909;72747;1809;71;30;3;27;.900;3572000;0
19909;156545;1835;0;0;0;0;.00nan;0;0
19910;-1;633;87;33;1;32;.970;3600000;0
19910;-1;4538;0;0;0;0;.00nan;0;0
19910;-1;633;0;0;0;0;.00nan;0;0
19910;145038;4538;97;38;2;36;.947;3544000;0
19911;11104;647;0;0;0;0;.00nan;0;0
19911;185314;644;0;0;0;0;.00nan;0;0
19911;-1;647;36;22;4;18;.818;3572000;0
19911;-1;644;62;23;2;21;.913;3600000;0
19912;-1;1835;57;33;4;29;.879;3717000;0
19912;174209;649;0;0;0;0;.00nan;0;0
19912;85947;649;36;24;5;19;.792;3717000;0
19912;156545;1835;0;0;0;0;.00nan;0;0
19913;169552;1809;0;0;0;0;.00nan;0;0
19913;-1;1825;0;0;0;0;.00nan;0;0
19913;-1;1825;74;36;2;34;.944;3600000;0
19913;72747;1809;49;39;5;34;.872;3600000;0
19914;164404;1838;0;0;0;0;.00nan;0;0
19914;174017;1838;62;44;5;39;.886;3561000;0
19914;180053;1836;0;0;0;0;.00nan;0;0
19914;-1;1836;36;18;4;14;.778;3600000;0
19915;182872;638;49;8;1;7;.875;709000;0
19915;-1;648;41;18;3;15;.833;3600000;0
19915;58112;638;42;40;6;34;.850;2891000;0
19915;160906;648;0;0;0;0;.00nan;0;0
19916;-1;1825;61;27;4;23;.852;3574000;0
19916;-1;1825;0;0;0;0;.00nan;0;0
19916;-1;633;0;0;0;0;.00nan;0;0
19916;-1;633;56;28;3;25;.893;3600000;0
19917;182872;638;0;0;0;0;.00nan;0;0
19917;164404;1838;0;0;0;0;.00nan;0;0
19917;174017;1838;93;18;0;18;1.000;3600000;0
19917;58112;638;68;38;4;34;.895;3600000;0
19918;8426;629;79;41;3;38;.927;4100000;0
19918;11104;647;60;29;4;25;.862;4100000;0
19918;-1;629;0;0;0;0;.00nan;0;0
19918;-1;647;0;0;0;0;.00nan;0;0
19919;174209;649;0;0;0;0;.00nan;0;0
19919;-1;4538;0;0;0;0;.00nan;0;0
19919;85947;649;67;23;2;21;.913;3600000;0
19919;145038;4538;22;36;7;29;.806;3600000;0
19920;-1;1835;86;44;3;41;.932;3600000;0
19920;180053;1836;0;0;0;0;.00nan;0;0
19920;-1;1836;40;23;4;19;.826;3583000;0
19920;156545;1835;0;0;0;0;.00nan;0;0
19921;200985;646;0;0;0;0;.00nan;0;0
19921;-1;646;47;34;5;29;.853;3649000;0
19921;-1;648;0;0;0;0;.00nan;0;0
19921;160906;648;42;35;6;29;.829;3649000;0
19922;169552;1809;75;29;2;27;.931;3600000;0
19922;185314;644;60;24;3;21;.875;3557000;0
19922;-1;644;0;0;0;0;.00nan;0;0
19922;72747;1809;0;0;0;0;.00nan;0;0
19923;182872;638;29;33;6;27;.818;3526000;0
19923;169552;1809;41;14;4;10;.714;3600000;0
19923;58112;638;0;0;0;0;.00nan;0;0
19923;72747;1809;0;0;0;0;.00nan;0;0
19924;-1;4538;0;0;0;0;.00nan;0;0
19924;-1;648;0;0;0;0;.00nan;0;0
19924;145038;4538;46;34;5;29;.853;3600000;0
19924;160906;648;66;31;3;28;.903;3600000;0
19925;164404;1838;0;0;0;0;.00nan;0;0
19925;11104;647;75;18;0;18;1.000;1315000;0
19925;174017;1838;67;17;2;15;.882;3600000;0
19925;-1;647;16;21;6;15;.714;2285000;0
19926;174209;649;0;0;0;0;.00nan;0;0
19926;-1;1825;0;0;0;0;.00nan;0;0
19926;-1;1825;91;37;1;36;.973;3600000;0
19926;85947;649;94;43;3;40;.930;3575000;0
19927;8426;629;40;52;8;44;.846;3273000;0
19927;180053;1836;0;0;0;0;.00nan;0;0
19927;-1;1836;72;20;1;19;.950;3600000;0
19927;-1;629;50;1;0;1;1.000;327000;0
19928;200985;646;0;0;0;0;.00nan;0;0
19928;-1;633;84;44;3;41;.932;3557000;0
19928;-1;633;0;0;0;0;.00nan;0;0
19928;-1;646;77;24;1;23;.958;3600000;0
19929;-1;1835;64;19;2;17;.895;3600000;0
19929;185314;644;0;0;0;0;.00nan;0;0
19929;-1;644;48;43;6;37;.860;3600000;0
19929;156545;1835;0;0;0;0;.00nan;0;0
19930;11104;647;100;23;0;23;1.000;3600000;0
19930;-1;633;80;24;1;23;.958;3597000;0
19930;-1;633;0;0;0;0;.00nan;0;0
19930;-1;647;0;0;0;0;.00nan;0;0
19931;182872;638;0;0;0;0;.00nan;0;0
19931;180053;1836;0;0;0;0;.00nan;0;0
19931;-1;1836;45;30;5;25;.833;3600000;0
19931;58112;638;69;42;4;38;.905;3600000;0
19932;174209;649;23;21;5;16;.762;3561000;0
19932;200985;646;0;0;0;0;.00nan;0;0
19932;-1;646;64;34;4;30;.882;3600000;0
19932;85947;649;0;0;0;0;.00nan;0;0
19933;-1;1825;50;30;4;26;.867;3521000;0
19933;-1;1825;0;0;0;0;.00nan;0;0
19933;-1;4538;0;0;0;0;.00nan;0;0
19933;145038;4538;86;43;2;41;.953;3600000;0
19934;8426;629;99;46;2;44;.957;3600000;0
19934;-1;1835;59;26;3;23;.885;3559000;0
19934;-1;629;0;0;0;0;.00nan;0;0
19934;156545;1835;0;0;0;0;.00nan;0;0
19935;169552;1809;0;0;0;0;.00nan;0;0
19935;-1;648;0;0;0;0;.00nan;0;0
19935;72747;1809;91;19;0;19;1.000;3600000;0
19935;160906;648;64;32;4;28;.875;3600000;0
19936;169552;1809;0;0;0;0;.00nan;0;0
19936;-1;4538;54;31;4;27;.871;3600000;0
19936;72747;1809;66;18;1;17;.944;3600000;0
19936;145038;4538;0;0;0;0;.00nan;0;0
19937;8426;629;0;0;0;0;.00nan;0;0
19937;164404;1838;0;0;0;0;.00nan;0;0
19937;174017;1838;91;34;1;33;.971;3600000;0
19937;-1;629;82;35;2;33;.943;3600000;0
19938;11104;647;62;43;5;38;.884;3600000;0
19938;-1;1835;72;22;1;21;.955;3600000;0
19938;-1;647;0;0;0;0;.00nan;0;0
19938;156545;1835;0;0;0;0;.00nan;0;0
19939;174209;649;0;0;0;0;.00nan;0;0
19939;180053;1836;0;0;0;0;.00nan;0;0
19939;-1;1836;66;17;1;16;.941;3600000;0
19939;85947;649;72;48;5;43;.896;3600000;0
19940;200985;646;58;37;4;33;.892;3783000;0
19940;-1;1825;0;0;0;0;.00nan;0;0
19940;-1;1825;60;33;3;30;.909;3783000;0
19940;-1;646;0;0;0;0;.00nan;0;0
19941;-1;633;0;0;0;0;.00nan;0;0
19941;-1;633;51;21;3;18;.857;3600000;0
19941;-1;648;27;33;6;27;.818;3600000;0
19941;160906;648;0;0;0;0;.00nan;0;0
19942;182872;638;0;0;0;0;.00nan;0;0
19942;185314;644;0;0;0;0;.00nan;0;0
19942;-1;644;72;22;2;20;.909;3600000;0
19942;58112;638;58;39;4;35;.897;3586000;0
19943;164404;1838;0;0;0;0;.00nan;0;0
19943;174017;1838;86;32;2;30;.938;3600000;0
19943;185314;644;52;38;6;32;.842;3038000;0
19943;-1;644;48;0;0;0;.00nan;562000;0
19944;174209;649;0;0;0;0;.00nan;0;0
19944;-1;633;30;29;6;23;.793;1927000;0
19944;-1;633;49;23;3;20;.870;1673000;0
19944;85947;649;59;21;2;19;.905;3600000;0
19945;182872;638;0;0;0;0;.00nan;0;0
19945;11104;647;80;36;2;34;.944;3546000;0
19945;-1;647;0;0;0;0;.00nan;0;0
19945;58112;638;92;22;0;22;1.000;3600000;0
19946;164404;1838;0;0;0;0;.00nan;0;0
19946;174017;1838;73;34;3;31;.912;3600000;0
19946;-1;1825;100;32;0;32;1.000;3600000;0
19946;-1;1825;0;0;0;0;.00nan;0;0
19947;8426;629;78;39;3;36;.923;3600000;0
19947;-1;4538;0;0;0;0;.00nan;0;0
19947;-1;629;0;0;0;0;.00nan;0;0
19947;145038;4538;58;20;2;18;.900;3600000;0
19948;-1;1835;34;28;5;23;.821;3600000;0
19948;-1;648;0;0;0;0;.00nan;0;0
19948;156545;1835;0;0;0;0;.00nan;0;0
19948;160906;648;98;36;2;34;.944;3600000;0
19949;180053;1836;0;0;0;0;.00nan;0;0
19949;185314;644;55;34;4;30;.882;3600000;0
19949;-1;1836;69;23;1;22;.957;3600000;0
19949;-1;644;0;0;0;0;.00nan;0;0
19950;169552;1809;64;36;4;32;.889;4187000;0
19950;200985;646;0;0;0;0;.00nan;0;0
19950;-1;646;54;26;3;23;.885;4187000;0
19950;72747;1809;0;0;0;0;.00nan;0;0
19951;169552;1809;0;0;0;0;.00nan;0;0
19951;-1;633;54;37;5;32;.865;3567000;0
19951;-1;633;0;0;0;0;.00nan;0;0
19951;72747;1809;61;32;4;28;.875;3600000;0
19952;8426;629;86;36;2;34;.944;3569000;0
19952;185314;644;86;24;1;23;.958;3600000;0
19952;-1;629;0;0;0;0;.00nan;0;0
19952;-1;644;0;0;0;0;.00nan;0;0
19953;11104;647;53;34;5;29;.853;3565000;0
19953;-1;4538;0;0;0;0;.00nan;0;0
19953;-1;647;0;0;0;0;.00nan;0;0
19953;145038;4538;47;23;4;19;.826;3600000;0
19954;174209;649;0;0;0;0;.00nan;0;0
19954;-1;648;0;0;0;0;.00nan;0;0
19954;85947;649;100;41;1;40;.976;3600000;0
19954;160906;648;45;20;3;17;.850;3538000;0
19955;-1;1825;71;44;5;39;.886;4417000;0
19955;-1;1825;0;0;0;0;.00nan;0;0
19955;180053;1836;0;0;0;0;.00nan;0;0
19955;-1;1836;44;23;4;19;.826;4417000;0
19956;164404;1838;40;8;2;6;.750;287000;0
19956;174017;1838;50;37;5;32;.865;3313000;0
19956;200985;646;0;0;0;0;.00nan;0;0
19956;-1;646;74;24;1;23;.958;3600000;0
19957;182872;638;0;0;0;0;.00nan;0;0
19957;-1;1835;56;24;3;21;.875;3597000;0
19957;58112;638;99;41;1;40;.976;3600000;0
19957;156545;1835;0;0;0;0;.00nan;0;0
19958;182872;638;0;0;0;0;.00nan;0;0
19958;8426;629;55;22;3;19;.864;3575000;0
19958;-1;629;0;0;0;0;.00nan;0;0
19958;58112;638;82;32;2;30;.938;3600000;0
19959;200985;646;0;0;0;0;.00nan;0;0
19959;-1;4538;0;0;0;0;.00nan;0;0
19959;-1;646;51;28;4;24;.857;3600000;0
19959;145038;4538;95;40;2;38;.950;3600000;0
19960;164404;1838;0;0;0;0;.00nan;0;0
19960;-1;1835;36;34;5;29;.853;3560000;0
19960;174017;1838;58;28;3;25;.893;3600000;0
19960;156545;1835;0;0;0;0;.00nan;0;0
19961;11104;647;97;62;5;57;.919;3600000;0
19961;180053;1836;0;0;0;0;.00nan;0;0
19961;-1;1836;51;16;2;14;.875;3600000;0
19961;-1;647;0;0;0;0;.00nan;0;0
19962;-1;1825;0;0;0;0;.00nan;0;0
19962;-1;1825;67;33;3;30;.909;3600000;0
19962;-1;648;59;34;4;30;.882;3600000;0
19962;160906;648;0;0;0;0;.00nan;0;0
19963;-1;633;87;42;2;40;.952;3579000;0
19963;185314;644;0;0;0;0;.00nan;0;0
19963;-1;633;0;0;0;0;.00nan;0;0
19963;-1;644;77;22;1;21;.955;3600000;0
19964;169552;1809;60;28;3;25;.893;3548000;0
19964;174209;649;0;0;0;0;.00nan;0;0
19964;72747;1809;0;0;0;0;.00nan;0;0
19964;85947;649;85;37;2;35;.946;3600000;0
19965;182872;638;67;35;4;31;.886;3708000;0
19965;-1;4538;0;0;0;0;.00nan;0;0
19965;58112;638;0;0;0;0;.00nan;0;0
19965;145038;4538;38;26;5;21;.808;3708000;0
19966;164404;1838;0;0;0;0;.00nan;0;0
19966;174017;1838;62;17;2;15;.882;3600000;0
19966;-1;633;58;29;3;26;.897;3568000;0
19966;-1;633;0;0;0;0;.00nan;0;0
19967;8426;629;57;33;4;29;.879;3600000;0
19967;174209;649;0;0;0;0;.00nan;0;0
19967;-1;629;0;0;0;0;.00nan;0;0
19967;85947;649;65;15;1;14;.933;3600000;0
19968;11104;647;94;31;1;30;.968;3600000;0
19968;169552;1809;0;0;0;0;.00nan;0;0
19968;-1;647;0;0;0;0;.00nan;0;0
19968;72747;1809;57;25;3;22;.880;3519000;0
19969;180053;1836;0;0;0;0;.00nan;0;0
19969;-1;1836;70;18;1;17;.944;3600000;0
19969;-1;648;0;0;0;0;.00nan;0;0
19969;160906;648;75;45;4;41;.911;3600000;0
19970;-1;1835;87;28;1;27;.964;3600000;0
19970;200985;646;0;0;0;0;.00nan;0;0
19970;-1;646;52;35;5;30;.857;3600000;0
19970;156545;1835;0;0;0;0;.00nan;0;0
19971;-1;1825;0;0;0;0;.00nan;0;0
19971;-1;1825;47;44;6;38;.864;3600000;0
19971;185314;644;50;20;3;17;.850;3600000;0
19971;-1;644;0;0;0;0;.00nan;0;0
19972;-1;633;75;47;5;42;.894;3051000;0
19972;180053;1836;0;0;0;0;.00nan;0;0
19972;-1;1836;77;21;1;20;.952;3600000;0
19972;-1;633;28;9;3;6;.667;549000;0
19973;164404;1838;0;0;0;0;.00nan;0;0
19973;174017;1838;67;27;2;25;.926;3600000;0
19973;-1;4538;0;0;0;0;.00nan;0;0
19973;145038;4538;72;33;3;30;.909;3573000;0
19974;182872;638;0;0;0;0;.00nan;0;0
19974;174209;649;0;0;0;0;.00nan;0;0
19974;58112;638;38;21;4;17;.810;3600000;0
19974;85947;649;85;25;1;24;.960;3600000;0
19975;-1;1835;85;28;1;27;.964;3600000;0
19975;-1;1825;65;30;3;27;.900;3550000;0
19975;-1;1825;0;0;0;0;.00nan;0;0
19975;156545;1835;0;0;0;0;.00nan;0;0
19976;11104;647;36;20;4;16;.800;3600000;0
19976;200985;646;71;22;1;21;.955;3600000;0
19976;-1;647;0;0;0;0;.00nan;0;0
19976;-1;646;0;0;0;0;.00nan;0;0
19977;185314;644;0;0;0;0;.00nan;0;0
19977;-1;644;20;35;8;27;.771;3600000;0
19977;-1;648;68;28;2;26;.929;3600000;0
19977;160906;648;0;0;0;0;.00nan;0;0
19978;8426;629;76;41;4;37;.902;3600000;0
19978;169552;1809;89;16;0;16;1.000;3600000;0
19978;-1;629;0;0;0;0;.00nan;0;0
19978;72747;1809;0;0;0;0;.00nan;0;0
19980;182872;638;74;40;4;36;.900;3600000;0
19980;164404;1838;0;0;0;0;.00nan;0;0
19980;174017;1838;63;20;1;19;.950;3600000;0
19980;58112;638;0;0;0;0;.00nan;0;0
19982;8426;629;67;38;4;34;.895;3600000;0
19982;185314;644;49;1;0;1;1.000;596000;0
19982;-1;629;0;0;0;0;.00nan;0;0
19982;-1;644;19;22;6;16;.727;2916000;0
19984;174806;646;65;19;1;18;.947;3600000;0
19984;-1;646;0;0;0;0;.00nan;0;0
19984;-1;4538;0;0;0;0;.00nan;0;0
19984;145038;4538;76;41;2;39;.951;3600000;0
19986;8942;649;0;0;0;0;.00nan;0;0
19986;11107;649;83;44;3;41;.932;3600000;0
19986;180053;1836;0;0;0;0;.00nan;0;0
19986;-1;1836;43;23;4;19;.826;3575000;0
19988;169552;1809;90;53;3;50;.943;5784000;0
19988;-1;1825;72;41;2;39;.951;5784000;0
19988;-1;1825;0;0;0;0;.00nan;0;0
19988;72747;1809;0;0;0;0;.00nan;0;0
19990;172398;633;14;21;6;15;.714;2622000;0
19990;-1;633;59;13;1;12;.923;978000;0
19990;-1;648;75;21;1;20;.952;3600000;0
19990;-1;648;0;0;0;0;.00nan;0;0
19992;204397;647;0;0;0;0;.00nan;0;0
19992;-1;647;90;52;4;48;.923;3600000;0
19992;82191;1835;54;18;2;16;.889;3600000;0
19992;82444;1835;0;0;0;0;.00nan;0;0
19994;8942;649;0;0;0;0;.00nan;0;0
19994;11107;649;58;39;4;35;.897;3553000;0
19994;82191;1835;0;0;0;0;.00nan;0;0
19994;82444;1835;49;16;3;13;.813;3600000;0
19996;182872;638;75;21;1;20;.952;3600000;0
19996;172398;633;48;44;6;38;.864;3174000;0
19996;-1;633;57;2;0;2;1.000;426000;0
19996;58112;638;0;0;0;0;.00nan;0;0
19998;204397;647;26;31;6;25;.806;2630000;0
19998;-1;1825;0;0;0;0;.00nan;0;0
19998;-1;1825;55;17;3;14;.824;3600000;0
19998;-1;647;55;11;1;10;.909;970000;0
20000;164404;1838;0;0;0;0;.00nan;0;0
20000;169552;1809;0;0;0;0;.00nan;0;0
20000;174017;1838;80;22;1;21;.955;3549000;0
20000;72747;1809;100;36;0;36;1.000;3600000;0
20002;8426;629;100;39;0;39;1.000;3600000;0
20002;200985;646;0;0;0;0;.00nan;0;0
20002;-1;629;0;0;0;0;.00nan;0;0
20002;-1;646;47;23;3;20;.870;3600000;0
20004;180053;1836;0;0;0;0;.00nan;0;0
20004;-1;1836;51;33;5;28;.848;3926000;0
20004;-1;4538;0;0;0;0;.00nan;0;0
20004;145038;4538;89;48;4;44;.917;3926000;0
20006;185314;644;0;0;0;0;.00nan;0;0
20006;-1;648;0;0;0;0;.00nan;0;0
20006;-1;644;68;33;3;30;.909;3600000;0
20006;-1;648;15;19;6;13;.684;3600000;0
20008;-1;633;0;0;0;0;.00nan;0;0
20008;180053;1836;36;25;4;21;.840;4648000;0
20008;-1;1836;0;0;0;0;.00nan;0;0
20008;-1;633;89;62;5;57;.919;4648000;0
20010;11104;647;0;0;0;0;.00nan;0;0
20010;169552;1809;0;0;0;0;.00nan;0;0
20010;-1;647;39;27;4;23;.852;3600000;0
20010;72747;1809;60;28;3;25;.893;3600000;0
20012;-1;4538;0;0;0;0;.00nan;0;0
20012;-1;648;81;32;2;30;.938;3543000;0
20012;-1;648;0;0;0;0;.00nan;0;0
20012;145038;4538;86;28;1;27;.964;3600000;0
20014;164404;1838;41;17;3;14;.824;3547000;0
20014;174017;1838;0;0;0;0;.00nan;0;0
20014;185314;644;86;39;2;37;.949;3600000;0
20014;-1;644;0;0;0;0;.00nan;0;0
20016;182872;638;0;0;0;0;.00nan;0;0
20016;200985;646;86;30;1;29;.967;3600000;0
20016;-1;646;0;0;0;0;.00nan;0;0
20016;58112;638;67;22;2;20;.909;3556000;0
20018;-1;1835;33;33;6;27;.818;3553000;0
20018;-1;1825;55;32;4;28;.875;3600000;0
20018;-1;1825;0;0;0;0;.00nan;0;0
20018;156545;1835;0;0;0;0;.00nan;0;0
20020;8426;629;34;34;6;28;.824;2320000;0
20020;8942;649;73;25;1;24;.960;3600000;0
20020;11107;649;0;0;0;0;.00nan;0;0
20020;-1;629;43;13;2;11;.846;1280000;0
20022;164404;1838;0;0;0;0;.00nan;0;0
20022;174017;1838;67;22;2;20;.909;3600000;0
20022;-1;1825;67;32;3;29;.906;3542000;0
20022;-1;1825;0;0;0;0;.00nan;0;0
20024;182872;638;71;27;3;24;.889;4726000;0
20024;11104;647;94;64;4;60;.938;4726000;0
20024;-1;647;0;0;0;0;.00nan;0;0
20024;58112;638;0;0;0;0;.00nan;0;0
20026;180053;1836;0;0;0;0;.00nan;0;0
20026;-1;1836;55;22;3;19;.864;3600000;0
20026;-1;648;0;0;0;0;.00nan;0;0
20026;-1;648;81;49;5;44;.898;3565000;0
20028;200985;646;0;0;0;0;.00nan;0;0
20028;185314;644;82;38;3;35;.921;3589000;0
20028;-1;646;60;20;2;18;.900;3600000;0
20028;-1;644;0;0;0;0;.00nan;0;0
20030;8426;629;67;35;4;31;.886;3600000;0
20030;-1;1835;0;0;0;0;.00nan;0;0
20030;-1;629;0;0;0;0;.00nan;0;0
20030;156545;1835;86;16;0;16;1.000;3600000;0
20032;8942;649;0;0;0;0;.00nan;0;0
20032;11107;649;80;13;0;13;1.000;3600000;0
20032;-1;4538;77;42;3;39;.929;3600000;0
20032;145038;4538;0;0;0;0;.00nan;0;0
20034;169552;1809;44;21;4;17;.810;3538000;0
20034;-1;633;87;33;2;31;.939;3600000;0
20034;-1;633;0;0;0;0;.00nan;0;0
20034;72747;1809;0;0;0;0;.00nan;0;0
20036;-1;1825;0;0;0;0;.00nan;0;0
20036;-1;1825;62;29;3;26;.897;3634000;0
20036;-1;4538;0;0;0;0;.00nan;0;0
20036;145038;4538;85;33;2;31;.939;3634000;0
20038;8426;629;0;0;0;0;.00nan;0;0
20038;-1;629;78;39;4;35;.897;3553000;0
20038;-1;648;64;26;3;23;.885;3600000;0
20038;-1;648;0;0;0;0;.00nan;0;0
20040;-1;1835;0;0;0;0;.00nan;0;0
20040;169552;1809;0;0;0;0;.00nan;0;0
20040;72747;1809;82;43;4;39;.907;3514000;0
20040;156545;1835;56;19;2;17;.895;3600000;0
20042;182872;638;0;0;0;0;.00nan;0;0
20042;11104;647;0;0;0;0;.00nan;0;0
20042;-1;647;47;32;4;28;.875;3600000;0
20042;58112;638;74;21;1;20;.952;3600000;0
20044;-1;633;0;0;0;0;.00nan;0;0
20044;180053;1836;100;24;0;24;1.000;3600000;0
20044;-1;1836;0;0;0;0;.00nan;0;0
20044;-1;633;73;38;3;35;.921;3600000;0
20046;8942;649;0;0;0;0;.00nan;0;0
20046;11107;649;63;29;3;26;.897;3600000;0
20046;185314;644;0;0;0;0;.00nan;0;0
20046;-1;644;60;42;4;38;.905;3600000;0
20048;164404;1838;65;34;4;30;.882;3935000;0
20048;174017;1838;0;0;0;0;.00nan;0;0
20048;200985;646;73;41;3;38;.927;3935000;0
20048;-1;646;0;0;0;0;.00nan;0;0
20050;200985;646;0;0;0;0;.00nan;0;0
20050;-1;646;66;20;2;18;.900;3600000;0
20050;-1;4538;0;0;0;0;.00nan;0;0
20050;145038;4538;85;41;3;38;.927;3543000;0
20052;8426;629;22;44;9;35;.795;3600000;0
20052;180053;1836;54;17;2;15;.882;3600000;0
20052;-1;1836;0;0;0;0;.00nan;0;0
20052;-1;629;0;0;0;0;.00nan;0;0
20054;182872;638;72;39;4;35;.897;3518000;0
20054;-1;1825;79;28;2;26;.929;3600000;0
20054;-1;1825;0;0;0;0;.00nan;0;0
20054;58112;638;0;0;0;0;.00nan;0;0
20056;-1;1835;43;32;6;26;.813;3600000;0
20056;-1;648;0;0;0;0;.00nan;0;0
20056;-1;648;47;23;3;20;.870;3600000;0
20056;156545;1835;0;0;0;0;.00nan;0;0
20058;164404;1838;0;0;0;0;.00nan;0;0
20058;174017;1838;61;24;3;21;.875;3559000;0
20058;185314;644;79;29;2;27;.931;3600000;0
20058;-1;644;0;0;0;0;.00nan;0;0
20060;11104;647;64;50;6;44;.880;3600000;0
20060;11107;649;0;0;0;0;.00nan;0;0
20060;174209;649;61;24;3;21;.875;3600000;0
20060;-1;647;0;0;0;0;.00nan;0;0
20062;169552;1809;72;31;2;29;.935;3599000;0
20062;-1;633;81;26;1;25;.962;3600000;0
20062;-1;633;0;0;0;0;.00nan;0;0
20062;72747;1809;0;0;0;0;.00nan;0;0
20064;164404;1838;53;40;6;34;.850;4062000;0
20064;174017;1838;0;0;0;0;.00nan;0;0
20064;180053;1836;0;0;0;0;.00nan;0;0
20064;-1;1836;41;28;5;23;.821;4062000;0
20066;182872;638;0;0;0;0;.00nan;0;0
20066;200985;646;56;31;4;27;.871;3900000;0
20066;-1;646;0;0;0;0;.00nan;0;0
20066;58112;638;51;24;3;21;.875;3894000;0
20068;11104;647;0;0;0;0;.00nan;0;0
20068;11107;649;46;17;3;14;.824;3786000;0
20068;174209;649;0;0;0;0;.00nan;0;0
20068;-1;647;76;43;4;39;.907;3786000;0
20070;185314;644;0;0;0;0;.00nan;0;0
20070;-1;4538;78;35;3;32;.914;4170000;0
20070;-1;644;83;39;2;37;.949;4170000;0
20070;145038;4538;0;0;0;0;.00nan;0;0
20072;8426;629;0;0;0;0;.00nan;0;0
20072;-1;629;96;41;2;39;.951;3600000;0
20072;-1;648;42;18;3;15;.833;3553000;0
20072;-1;648;0;0;0;0;.00nan;0;0
20074;-1;1825;0;0;0;0;.00nan;0;0
20074;-1;1825;64;15;1;14;.933;3600000;0
20074;-1;633;50;2;0;2;1.000;393000;0
20074;-1;633;34;32;6;26;.813;3207000;0
20076;-1;1835;0;0;0;0;.00nan;0;0
20076;169552;1809;0;0;0;0;.00nan;0;0
20076;72747;1809;96;49;3;46;.939;3600000;0
20076;156545;1835;71;23;1;22;.957;3600000;0
20077;16588;2517;0;0;0;0;.00nan;0;0
20077;-1;2517;92;36;1;35;.972;3600000;0
20077;-1;844;57;19;2;17;.895;3596000;0
20077;148069;844;0;0;0;0;.00nan;0;0
20078;13373;835;40;35;6;29;.829;3176000;0
20078;47742;841;0;0;0;0;.00nan;0;0
20078;47754;841;52;24;4;20;.833;3600000;0
20078;86485;835;64;6;0;6;1.000;424000;0
20079;5573;845;77;22;1;21;.955;3600000;0
20079;-1;2493;75;41;4;37;.902;3600000;0
20079;89190;2493;0;0;0;0;.00nan;0;0
20079;94240;845;0;0;0;0;.00nan;0;0
20080;5565;843;0;0;0;0;.00nan;0;0
20080;9455;843;89;30;1;29;.967;3600000;0
20080;147845;2508;80;29;2;27;.931;3600000;0
20080;152266;2508;0;0;0;0;.00nan;0;0
20081;805;846;69;20;1;19;.950;3600000;0
20081;179411;2488;66;33;4;29;.879;3600000;0
20081;180311;2488;0;0;0;0;.00nan;0;0
20081;-1;846;0;0;0;0;.00nan;0;0
20082;16588;2517;0;0;0;0;.00nan;0;0
20082;-1;2517;65;22;2;20;.909;3600000;0
20082;-1;2493;0;0;0;0;.00nan;0;0
20082;89190;2493;79;40;4;36;.900;3583000;0
20083;5573;845;39;34;6;28;.824;3600000;0
20083;47742;841;0;0;0;0;.00nan;0;0
20083;47754;841;84;29;1;28;.966;3600000;0
20083;94240;845;0;0;0;0;.00nan;0;0
20084;805;846;84;38;3;35;.921;3548000;0
20084;-1;844;0;0;0;0;.00nan;0;0
20084;-1;846;0;0;0;0;.00nan;0;0
20084;148069;844;79;32;2;30;.938;3600000;0
20085;179411;2488;0;0;0;0;.00nan;0;0
20085;180311;2488;71;31;3;28;.903;3600000;0
20085;147845;2508;0;0;0;0;.00nan;0;0
20085;152266;2508;79;40;4;36;.900;3600000;0
20086;5565;843;0;0;0;0;.00nan;0;0
20086;9455;843;46;39;6;33;.846;3600000;0
20086;13373;835;36;26;5;21;.808;3600000;0
20086;86485;835;0;0;0;0;.00nan;0;0
20087;179411;2488;0;0;0;0;.00nan;0;0
20087;-1;841;52;27;4;23;.852;3600000;0
20087;180311;2488;80;35;3;32;.914;3600000;0
20087;47754;841;0;0;0;0;.00nan;0;0
20088;5565;843;0;0;0;0;.00nan;0;0
20088;9455;843;55;29;4;25;.862;3600000;0
20088;-1;2493;94;31;1;30;.968;3600000;0
20088;89190;2493;0;0;0;0;.00nan;0;0
20089;5573;845;0;0;0;0;.00nan;0;0
20089;13373;835;100;34;1;33;.971;3900000;0
20089;86485;835;0;0;0;0;.00nan;0;0
20089;94240;845;72;17;1;16;.941;3900000;0
20090;805;846;84;27;1;26;.963;3600000;0
20090;16588;2517;0;0;0;0;.00nan;0;0
20090;-1;2517;55;25;3;22;.880;3558000;0
20090;-1;846;0;0;0;0;.00nan;0;0
20091;-1;844;0;0;0;0;.00nan;0;0
20091;147845;2508;0;0;0;0;.00nan;0;0
20091;148069;844;50;21;3;18;.857;3600000;0
20091;152266;2508;66;39;5;34;.872;3547000;0
20092;-1;844;0;0;0;0;.00nan;0;0
20092;-1;2493;32;17;4;13;.765;1032000;0
20092;89190;2493;96;30;0;30;1.000;2568000;0
20092;148069;844;42;16;3;13;.813;3600000;0
20093;-1;841;90;24;1;23;.958;3600000;0
20093;47754;841;0;0;0;0;.00nan;0;0
20093;147845;2508;51;15;2;13;.867;1243000;0
20093;152266;2508;35;32;6;26;.813;2357000;0
20094;805;846;68;30;3;27;.900;3669000;0
20094;13373;835;62;24;2;22;.917;3669000;0
20094;-1;846;0;0;0;0;.00nan;0;0
20094;86485;835;0;0;0;0;.00nan;0;0
20095;5565;843;0;0;0;0;.00nan;0;0
20095;5573;845;74;27;2;25;.926;3600000;0
20095;9455;843;67;36;4;32;.889;3514000;0
20095;94240;845;0;0;0;0;.00nan;0;0
20096;16588;2517;0;0;0;0;.00nan;0;0
20096;-1;2517;76;40;4;36;.900;3540000;0
20096;179411;2488;0;0;0;0;.00nan;0;0
20096;180311;2488;64;23;2;21;.913;3600000;0
20097;-1;844;70;36;4;32;.889;3667000;0
20097;-1;841;51;21;3;18;.857;3667000;0
20097;47754;841;0;0;0;0;.00nan;0;0
20097;148069;844;0;0;0;0;.00nan;0;0
20098;13373;835;38;28;5;23;.821;2319000;0
20098;16588;2517;0;0;0;0;.00nan;0;0
20098;-1;2517;12;22;6;16;.727;3590000;0
20098;86485;835;60;7;0;7;1.000;1281000;0
20099;-1;2493;66;14;1;13;.929;3900000;0
20099;89190;2493;0;0;0;0;.00nan;0;0
20099;147845;2508;88;38;1;37;.974;3900000;0
20099;152266;2508;0;0;0;0;.00nan;0;0
20100;805;846;61;16;1;15;.938;3851000;0
20100;5565;843;0;0;0;0;.00nan;0;0
20100;9455;843;93;48;2;46;.958;3851000;0
20100;-1;846;0;0;0;0;.00nan;0;0
20101;5573;845;37;22;4;18;.818;3562000;0
20101;179411;2488;87;39;2;37;.949;3600000;0
20101;180311;2488;0;0;0;0;.00nan;0;0
20101;94240;845;0;0;0;0;.00nan;0;0
20102;5565;843;0;0;0;0;.00nan;0;0
20102;9455;843;65;30;3;27;.900;3600000;0
20102;-1;841;63;19;1;18;.947;3600000;0
20102;47754;841;0;0;0;0;.00nan;0;0
20103;5573;845;0;0;0;0;.00nan;0;0
20103;-1;844;0;0;0;0;.00nan;0;0
20103;94240;845;89;33;2;31;.939;3600000;0
20103;148069;844;66;33;3;30;.909;3600000;0
20104;805;846;33;26;5;21;.808;2398000;0
20104;-1;2493;78;32;3;29;.906;3600000;0
20104;-1;846;46;6;1;5;.833;1202000;0
20104;89190;2493;0;0;0;0;.00nan;0;0
20105;16588;2517;0;0;0;0;.00nan;0;0
20105;-1;2517;90;39;1;38;.974;3600000;0
20105;147845;2508;0;0;0;0;.00nan;0;0
20105;152266;2508;98;44;2;42;.955;3600000;0
20106;5573;845;0;0;0;0;.00nan;0;0
20106;16588;2517;0;0;0;0;.00nan;0;0
20106;-1;2517;71;32;3;29;.906;3684000;0
20106;94240;845;46;24;4;20;.833;3684000;0
20107;13373;835;50;29;4;25;.862;3600000;0
20107;-1;844;85;22;1;21;.955;3600000;0
20107;86485;835;0;0;0;0;.00nan;0;0
20107;148069;844;0;0;0;0;.00nan;0;0
20108;-1;841;54;25;3;22;.880;3600000;0
20108;-1;2493;0;0;0;0;.00nan;0;0
20108;47754;841;0;0;0;0;.00nan;0;0
20108;89190;2493;64;51;7;44;.863;3600000;0
20109;805;846;0;0;0;0;.00nan;0;0
20109;-1;846;40;23;4;19;.826;3600000;0
20109;147845;2508;39;31;6;25;.806;3031000;0
20109;152266;2508;57;4;0;4;1.000;569000;0
20110;5565;843;0;0;0;0;.00nan;0;0
20110;9455;843;90;36;1;35;.972;3600000;0
20110;179411;2488;0;0;0;0;.00nan;0;0
20110;180311;2488;45;27;4;23;.852;3600000;0
20111;805;846;62;27;3;24;.889;3519000;0
20111;-1;841;0;0;0;0;.00nan;0;0
20111;-1;846;0;0;0;0;.00nan;0;0
20111;47754;841;80;22;1;21;.955;3600000;0
20112;13373;835;0;0;0;0;.00nan;0;0
20112;-1;2493;41;17;4;13;.765;3600000;0
20112;86485;835;47;39;6;33;.846;3538000;0
20112;89190;2493;0;0;0;0;.00nan;0;0
20113;5565;843;73;47;4;43;.915;3711000;0
20113;9455;843;0;0;0;0;.00nan;0;0
20113;16588;2517;0;0;0;0;.00nan;0;0
20113;-1;2517;55;21;3;18;.857;3711000;0
20114;179411;2488;55;45;6;39;.867;3110000;0
20114;-1;844;0;0;0;0;.00nan;0;0
20114;180311;2488;40;9;2;7;.778;490000;0
20114;148069;844;96;24;0;24;1.000;3600000;0
20115;16588;2517;0;0;0;0;.00nan;0;0
20115;-1;2517;72;43;4;39;.907;3566000;0
20115;-1;841;63;28;3;25;.893;3600000;0
20115;47754;841;0;0;0;0;.00nan;0;0
20116;179411;2488;0;0;0;0;.00nan;0;0
20116;-1;2493;85;43;3;40;.930;3600000;0
20116;180311;2488;81;33;2;31;.939;3600000;0
20116;89190;2493;0;0;0;0;.00nan;0;0
20117;805;846;67;27;3;24;.889;3600000;0
20117;5573;845;77;47;4;43;.915;3548000;0
20117;-1;846;0;0;0;0;.00nan;0;0
20117;94240;845;0;0;0;0;.00nan;0;0
20118;13373;835;90;31;2;29;.935;3600000;0
20118;86485;835;0;0;0;0;.00nan;0;0
20118;147845;2508;0;0;0;0;.00nan;0;0
20118;152266;2508;63;32;4;28;.875;3575000;0
20119;16588;2517;0;0;0;0;.00nan;0;0
20119;-1;2517;54;30;4;26;.867;3563000;0
20119;-1;844;0;0;0;0;.00nan;0;0
20119;148069;844;68;28;2;26;.929;3600000;0
20120;5573;845;0;0;0;0;.00nan;0;0
20120;-1;2493;91;30;1;29;.967;3600000;0
20120;89190;2493;0;0;0;0;.00nan;0;0
20120;94240;845;74;32;3;29;.906;3514000;0
20121;805;846;29;32;6;26;.813;2384000;0
20121;179411;2488;0;0;0;0;.00nan;0;0
20121;180311;2488;77;30;3;27;.900;3600000;0
20121;-1;846;55;12;1;11;.917;1216000;0
20122;5565;843;0;0;0;0;.00nan;0;0
20122;9455;843;67;23;2;21;.913;3600000;0
20122;147845;2508;43;32;5;27;.844;3600000;0
20122;152266;2508;0;0;0;0;.00nan;0;0
20123;13373;835;72;29;2;27;.931;3531000;0
20123;-1;841;97;20;0;20;1.000;3600000;0
20123;47754;841;0;0;0;0;.00nan;0;0
20123;86485;835;0;0;0;0;.00nan;0;0
20124;5565;843;0;0;0;0;.00nan;0;0
20124;9455;843;64;50;5;45;.900;3632000;0
20124;-1;844;40;21;4;17;.810;3632000;0
20124;148069;844;0;0;0;0;.00nan;0;0
20125;5573;845;39;38;6;32;.842;3600000;0
20125;-1;841;79;20;1;19;.950;3600000;0
20125;47754;841;0;0;0;0;.00nan;0;0
20125;94240;845;0;0;0;0;.00nan;0;0
20126;16588;2517;72;38;4;34;.895;3588000;0
20126;-1;2517;0;0;0;0;.00nan;0;0
20126;-1;2493;0;0;0;0;.00nan;0;0
20126;89190;2493;83;33;2;31;.939;3600000;0
20127;5565;843;0;0;0;0;.00nan;0;0
20127;9455;843;67;39;4;35;.897;3595000;0
20127;13373;835;0;0;0;0;.00nan;0;0
20127;86485;835;75;25;2;23;.920;3600000;0
20128;179411;2488;65;26;2;24;.923;3600000;0
20128;180311;2488;0;0;0;0;.00nan;0;0
20128;147845;2508;0;0;0;0;.00nan;0;0
20128;152266;2508;80;38;3;35;.921;3595000;0
20129;805;846;66;29;3;26;.897;3761000;0
20129;-1;844;63;33;4;29;.879;3761000;0
20129;-1;846;0;0;0;0;.00nan;0;0
20129;148069;844;0;0;0;0;.00nan;0;0
20130;-1;844;51;13;2;11;.846;3113000;0
20130;147845;2508;27;45;8;37;.822;3262000;0
20130;148069;844;30;7;3;4;.571;487000;0
20130;152266;2508;62;9;0;9;1.000;338000;0
20131;5573;845;43;27;4;23;.852;3550000;0
20131;13373;835;85;41;3;38;.927;3600000;0
20131;86485;835;0;0;0;0;.00nan;0;0
20131;94240;845;0;0;0;0;.00nan;0;0
20132;5565;843;0;0;0;0;.00nan;0;0
20132;9455;843;68;37;3;34;.919;3600000;0
20132;-1;2493;0;0;0;0;.00nan;0;0
20132;89190;2493;92;22;0;22;1.000;3600000;0
20133;179411;2488;0;0;0;0;.00nan;0;0
20133;-1;841;86;27;1;26;.963;3900000;0
20133;180311;2488;95;46;1;45;.978;3900000;0
20133;47754;841;0;0;0;0;.00nan;0;0
20134;-1;844;53;28;4;24;.857;3626000;0
20134;-1;841;62;26;3;23;.885;3626000;0
20134;47754;841;0;0;0;0;.00nan;0;0
20134;148069;844;0;0;0;0;.00nan;0;0
20135;5573;845;0;0;0;0;.00nan;0;0
20135;179411;2488;90;52;3;49;.942;3900000;0
20135;180311;2488;0;0;0;0;.00nan;0;0
20135;94240;845;65;25;3;22;.880;3900000;0
20136;805;846;65;19;2;17;.895;3600000;0
20136;5565;843;0;0;0;0;.00nan;0;0
20136;9455;843;50;36;5;31;.861;3600000;0
20136;-1;846;0;0;0;0;.00nan;0;0
20137;-1;2493;0;0;0;0;.00nan;0;0
20137;89190;2493;54;26;3;23;.885;3552000;0
20137;147845;2508;0;0;0;0;.00nan;0;0
20137;152266;2508;93;30;1;29;.967;3600000;0
20138;13373;835;99;32;1;31;.969;3600000;0
20138;16588;2517;49;21;3;18;.857;3600000;0
20138;-1;2517;0;0;0;0;.00nan;0;0
20138;86485;835;0;0;0;0;.00nan;0;0
20139;5573;845;54;34;5;29;.853;3600000;0
20139;-1;844;0;0;0;0;.00nan;0;0
20139;94240;845;0;0;0;0;.00nan;0;0
20139;148069;844;100;36;0;36;1.000;3600000;0
20140;805;846;54;23;3;20;.870;3545000;0
20140;-1;2493;94;35;2;33;.943;3600000;0
20140;-1;846;0;0;0;0;.00nan;0;0
20140;89190;2493;0;0;0;0;.00nan;0;0
20141;5565;843;92;36;1;35;.972;3900000;0
20141;9455;843;0;0;0;0;.00nan;0;0
20141;-1;841;92;25;1;24;.960;3900000;0
20141;47754;841;0;0;0;0;.00nan;0;0
20142;13373;835;0;0;0;0;.00nan;0;0
20142;179411;2488;67;36;4;32;.889;3560000;0
20142;180311;2488;0;0;0;0;.00nan;0;0
20142;86485;835;57;24;3;21;.875;3600000;0
20143;-1;841;0;0;0;0;.00nan;0;0
20143;-1;2493;0;0;0;0;.00nan;0;0
20143;47754;841;42;17;3;14;.824;3558000;0
20143;89190;2493;98;41;2;39;.951;3600000;0
20144;5573;845;0;0;0;0;.00nan;0;0
20144;16588;2517;0;0;0;0;.00nan;0;0
20144;-1;2517;68;38;4;34;.895;3766000;0
20144;94240;845;61;26;3;23;.885;3744000;0
20145;805;846;53;24;4;20;.833;3600000;0
20145;-1;846;0;0;0;0;.00nan;0;0
20145;147845;2508;99;45;1;44;.978;3600000;0
20145;152266;2508;0;0;0;0;.00nan;0;0
20146;13373;835;54;29;4;25;.862;3592000;0
20146;-1;844;0;0;0;0;.00nan;0;0
20146;86485;835;0;0;0;0;.00nan;0;0
20146;148069;844;59;25;3;22;.880;3600000;0
20147;5565;843;0;0;0;0;.00nan;0;0
20147;9455;843;77;43;4;39;.907;3534000;0
20147;179411;2488;61;20;2;18;.900;3600000;0
20147;180311;2488;0;0;0;0;.00nan;0;0
20148;179411;2488;94;43;1;42;.977;3560000;0
20148;-1;844;96;20;0;20;1.000;3600000;0
20148;180311;2488;0;0;0;0;.00nan;0;0
20148;148069;844;0;0;0;0;.00nan;0;0
20149;13373;835;0;0;0;0;.00nan;0;0
20149;-1;2493;0;0;0;0;.00nan;0;0
20149;86485;835;74;29;2;27;.931;3900000;0
20149;89190;2493;64;31;2;29;.935;3900000;0
20150;805;846;76;32;2;30;.938;3600000;0
20150;-1;841;47;26;4;22;.846;3519000;0
20150;-1;846;0;0;0;0;.00nan;0;0
20150;47754;841;0;0;0;0;.00nan;0;0
20151;5573;845;0;0;0;0;.00nan;0;0
20151;94240;845;59;25;3;22;.880;3600000;0
20151;147845;2508;0;0;0;0;.00nan;0;0
20151;152266;2508;60;38;4;34;.895;3563000;0
20152;5565;843;0;0;0;0;.00nan;0;0
20152;9455;843;82;51;4;47;.922;3555000;0
20152;16588;2517;0;0;0;0;.00nan;0;0
20152;-1;2517;85;23;2;21;.913;3600000;0
20153;16588;2517;64;8;0;8;1.000;1481000;0
20153;-1;2517;30;19;5;14;.737;2119000;0
20153;-1;841;76;24;1;23;.958;3600000;0
20153;47754;841;0;0;0;0;.00nan;0;0
20154;805;846;85;35;2;33;.943;3600000;0
20154;5573;845;0;0;0;0;.00nan;0;0
20154;-1;846;0;0;0;0;.00nan;0;0
20154;94240;845;81;41;3;38;.927;3541000;0
20155;13373;835;73;21;1;20;.952;3588000;0
20155;86485;835;0;0;0;0;.00nan;0;0
20155;147845;2508;100;31;0;31;1.000;3600000;0
20155;152266;2508;0;0;0;0;.00nan;0;0
20156;5565;843;0;0;0;0;.00nan;0;0
20156;9455;843;63;41;4;37;.902;3584000;0
20156;-1;844;68;26;2;24;.923;3600000;0
20156;148069;844;0;0;0;0;.00nan;0;0
20157;179411;2488;71;23;1;22;.957;3900000;0
20157;-1;2493;0;0;0;0;.00nan;0;0
20157;180311;2488;0;0;0;0;.00nan;0;0
20157;89190;2493;93;36;1;35;.972;3900000;0
20158;16588;2517;0;0;0;0;.00nan;0;0
20158;-1;2517;56;25;3;22;.880;3584000;0
20158;179411;2488;70;17;1;16;.941;3600000;0
20158;180311;2488;0;0;0;0;.00nan;0;0
20159;-1;844;0;0;0;0;.00nan;0;0
20159;-1;2493;100;45;0;45;1.000;3600000;0
20159;89190;2493;0;0;0;0;.00nan;0;0
20159;148069;844;63;26;2;24;.923;3581000;0
20160;5565;843;44;12;2;10;.833;1585000;0
20160;5573;845;0;0;0;0;.00nan;0;0
20160;9455;843;19;25;6;19;.760;2015000;0
20160;94240;845;88;29;1;28;.966;3600000;0
20161;805;846;67;17;1;16;.941;3600000;0
20161;13373;835;85;38;3;35;.921;3600000;0
20161;-1;846;0;0;0;0;.00nan;0;0
20161;86485;835;0;0;0;0;.00nan;0;0
20162;-1;841;77;20;1;19;.950;3600000;0
20162;47754;841;0;0;0;0;.00nan;0;0
20162;147845;2508;51;41;6;35;.854;2631000;0
20162;152266;2508;59;7;0;7;1.000;969000;0
20163;179411;2488;32;30;6;24;.800;2690000;0
20163;-1;844;74;37;3;34;.919;3600000;0
20163;180311;2488;61;7;0;7;1.000;910000;0
20163;148069;844;0;0;0;0;.00nan;0;0
20164;5573;845;0;0;0;0;.00nan;0;0
20164;-1;844;0;0;0;0;.00nan;0;0
20164;94240;845;100;41;1;40;.976;3900000;0
20164;148069;844;90;30;1;29;.967;3900000;0
20165;5565;843;0;0;0;0;.00nan;0;0
20165;9455;843;61;36;4;32;.889;3600000;0
20165;-1;841;71;26;2;24;.923;3600000;0
20165;47754;841;0;0;0;0;.00nan;0;0
20166;16588;2517;87;32;3;29;.906;3896000;0
20166;-1;2517;0;0;0;0;.00nan;0;0
20166;-1;2493;48;25;3;22;.880;3900000;0
20166;89190;2493;0;0;0;0;.00nan;0;0
20167;805;846;65;19;1;18;.947;3600000;0
20167;-1;846;0;0;0;0;.00nan;0;0
20167;147845;2508;0;0;0;0;.00nan;0;0
20167;152266;2508;51;45;6;39;.867;3600000;0
20168;13373;835;0;0;0;0;.00nan;0;0
20168;179411;2488;72;33;3;30;.909;3600000;0
20168;180311;2488;0;0;0;0;.00nan;0;0
20168;86485;835;81;24;2;22;.917;3600000;0
20169;805;846;84;24;1;23;.958;3600000;0
20169;16588;2517;0;0;0;0;.00nan;0;0
20169;-1;2517;79;36;2;34;.944;3578000;0
20169;-1;846;0;0;0;0;.00nan;0;0
20170;5573;845;58;37;5;32;.865;3551000;0
20170;-1;841;58;29;4;25;.862;3600000;0
20170;47754;841;0;0;0;0;.00nan;0;0
20170;94240;845;0;0;0;0;.00nan;0;0
20171;-1;2493;56;16;2;14;.875;3900000;0
20171;89190;2493;0;0;0;0;.00nan;0;0
20171;147845;2508;0;0;0;0;.00nan;0;0
20171;152266;2508;91;40;2;38;.950;3900000;0
20172;5565;843;56;5;0;5;1.000;588000;0
20172;9455;843;24;26;6;20;.769;3012000;0
20172;13373;835;74;24;2;22;.917;3600000;0
20172;86485;835;0;0;0;0;.00nan;0;0
20173;805;846;79;27;2;25;.926;3600000;0
20173;179411;2488;0;0;0;0;.00nan;0;0
20173;180311;2488;57;43;5;38;.884;3600000;0
20173;-1;846;0;0;0;0;.00nan;0;0
20174;16588;2517;0;0;0;0;.00nan;0;0
20174;-1;2517;88;29;1;28;.966;3900000;0
20174;147845;2508;0;0;0;0;.00nan;0;0
20174;152266;2508;90;40;1;39;.975;3900000;0
20175;-1;841;72;27;2;25;.926;3600000;0
20175;-1;2493;37;35;6;29;.829;2904000;0
20175;47754;841;0;0;0;0;.00nan;0;0
20175;89190;2493;58;6;0;6;1.000;696000;0
20176;805;846;90;19;0;19;1.000;3600000;0
20176;5565;843;0;0;0;0;.00nan;0;0
20176;9455;843;75;31;2;29;.935;3600000;0
20176;-1;846;0;0;0;0;.00nan;0;0
20177;13373;835;53;23;3;20;.870;3584000;0
20177;-1;844;0;0;0;0;.00nan;0;0
20177;86485;835;0;0;0;0;.00nan;0;0
20177;148069;844;78;20;1;19;.950;3600000;0
20178;5573;845;0;0;0;0;.00nan;0;0
20178;179411;2488;82;38;2;36;.947;3519000;0
20178;180311;2488;0;0;0;0;.00nan;0;0
20178;94240;845;97;26;0;26;1.000;3600000;0
20179;5565;843;0;0;0;0;.00nan;0;0
20179;9455;843;88;18;0;18;1.000;3600000;0
20179;16588;2517;0;0;0;0;.00nan;0;0
20179;-1;2517;45;28;4;24;.857;3600000;0
20180;-1;844;47;18;3;15;.833;3600000;0
20180;-1;2493;52;35;4;31;.886;3554000;0
20180;89190;2493;0;0;0;0;.00nan;0;0
20180;148069;844;0;0;0;0;.00nan;0;0
20181;13373;835;64;40;5;35;.875;3600000;0
20181;-1;841;62;26;2;24;.923;3600000;0
20181;47754;841;0;0;0;0;.00nan;0;0
20181;86485;835;0;0;0;0;.00nan;0;0
20182;805;846;56;20;2;18;.900;3600000;0
20182;5573;845;0;0;0;0;.00nan;0;0
20182;-1;846;0;0;0;0;.00nan;0;0
20182;94240;845;47;34;5;29;.853;3600000;0
20183;179411;2488;67;30;3;27;.900;3600000;0
20183;180311;2488;0;0;0;0;.00nan;0;0
20183;147845;2508;53;28;4;24;.857;3557000;0
20183;152266;2508;0;0;0;0;.00nan;0;0
20184;16588;2517;0;0;0;0;.00nan;0;0
20184;-1;2517;74;32;3;29;.906;3600000;0
20184;-1;841;0;0;0;0;.00nan;0;0
20184;47754;841;42;21;4;17;.810;3569000;0
20185;805;846;30;24;6;18;.750;3096000;0
20185;-1;2493;59;30;4;26;.867;3600000;0
20185;-1;846;49;7;1;6;.857;504000;0
20185;89190;2493;0;0;0;0;.00nan;0;0
20186;5573;845;0;0;0;0;.00nan;0;0
20186;13373;835;0;0;0;0;.00nan;0;0
20186;86485;835;97;38;1;37;.974;3600000;0
20186;94240;845;53;18;2;16;.889;3566000;0
20187;5565;843;0;0;0;0;.00nan;0;0
20187;9455;843;94;32;1;31;.969;3600000;0
20187;147845;2508;45;12;2;10;.833;1270000;0
20187;152266;2508;34;26;5;21;.808;2330000;0
20188;179411;2488;0;0;0;0;.00nan;0;0
20188;-1;844;0;0;0;0;.00nan;0;0
20188;180311;2488;100;32;0;32;1.000;3600000;0
20188;148069;844;83;40;3;37;.925;3600000;0
20189;5573;845;0;0;0;0;.00nan;0;0
20189;94240;845;72;20;2;18;.900;3600000;0
20189;147845;2508;65;56;6;50;.893;3600000;0
20189;152266;2508;0;0;0;0;.00nan;0;0
20190;16588;2517;0;0;0;0;.00nan;0;0
20190;-1;2517;99;38;1;37;.974;3900000;0
20190;179411;2488;0;0;0;0;.00nan;0;0
20190;180311;2488;74;23;1;22;.957;3900000;0
20191;-1;844;73;30;3;27;.900;3900000;0
20191;-1;841;88;38;3;35;.921;3900000;0
20191;47754;841;0;0;0;0;.00nan;0;0
20191;148069;844;0;0;0;0;.00nan;0;0
20192;5565;843;0;0;0;0;.00nan;0;0
20192;9455;843;69;40;3;37;.925;3560000;0
20192;-1;2493;80;27;2;25;.926;3600000;0
20192;89190;2493;0;0;0;0;.00nan;0;0
20193;5573;845;100;34;0;34;1.000;3600000;0
20193;94240;845;0;0;0;0;.00nan;0;0
20193;147845;2508;0;0;0;0;.00nan;0;0
20193;152266;2508;58;52;6;46;.885;3600000;0
20194;805;846;56;28;4;24;.857;3513000;0
20194;13373;835;85;33;2;31;.939;3600000;0
20194;-1;846;0;0;0;0;.00nan;0;0
20194;86485;835;0;0;0;0;.00nan;0;0
20195;179411;2488;0;0;0;0;.00nan;0;0
20195;-1;841;100;25;0;25;1.000;3600000;0
20195;180311;2488;63;36;4;32;.889;3600000;0
20195;47754;841;0;0;0;0;.00nan;0;0
20196;5573;845;82;33;2;31;.939;3600000;0
20196;-1;2493;66;35;4;31;.886;3575000;0
20196;89190;2493;0;0;0;0;.00nan;0;0
20196;94240;845;0;0;0;0;.00nan;0;0
20197;805;846;75;27;2;25;.926;3600000;0
20197;16588;2517;0;0;0;0;.00nan;0;0
20197;-1;2517;73;38;3;35;.921;3554000;0
20197;-1;846;0;0;0;0;.00nan;0;0
20198;13373;835;73;23;1;22;.957;3600000;0
20198;86485;835;0;0;0;0;.00nan;0;0
20198;147845;2508;66;36;4;32;.889;3600000;0
20198;152266;2508;0;0;0;0;.00nan;0;0
20199;5565;843;0;0;0;0;.00nan;0;0
20199;9455;843;90;42;3;39;.929;3513000;0
20199;-1;844;0;0;0;0;.00nan;0;0
20199;148069;844;73;16;1;15;.938;3600000;0
20200;-1;841;85;23;1;22;.957;3600000;0
20200;47754;841;0;0;0;0;.00nan;0;0
20200;147845;2508;0;0;0;0;.00nan;0;0
20200;152266;2508;63;28;2;26;.929;3576000;0
20201;5565;843;0;0;0;0;.00nan;0;0
20201;5573;845;0;0;0;0;.00nan;0;0
20201;9455;843;70;23;2;21;.913;3600000;0
20201;94240;845;47;29;5;24;.828;3600000;0
20202;13373;835;60;21;2;19;.905;3573000;0
20202;16588;2517;0;0;0;0;.00nan;0;0
20202;-1;2517;77;22;1;21;.955;3600000;0
20202;86485;835;0;0;0;0;.00nan;0;0
20203;179411;2488;65;28;3;25;.893;3541000;0
20203;-1;2493;99;30;1;29;.967;3600000;0
20203;180311;2488;0;0;0;0;.00nan;0;0
20203;89190;2493;0;0;0;0;.00nan;0;0
20204;805;846;83;37;3;34;.919;3600000;0
20204;-1;844;64;22;2;20;.909;3600000;0
20204;-1;846;0;0;0;0;.00nan;0;0
20204;148069;844;0;0;0;0;.00nan;0;0
20205;5573;845;0;0;0;0;.00nan;0;0
20205;16588;2517;48;6;1;5;.833;855000;0
20205;-1;2517;20;24;6;18;.750;2745000;0
20205;94240;845;61;22;2;20;.909;3600000;0
20206;13373;835;73;22;1;21;.955;3900000;0
20206;-1;2493;95;31;1;30;.968;3900000;0
20206;86485;835;0;0;0;0;.00nan;0;0
20206;89190;2493;0;0;0;0;.00nan;0;0
20207;805;846;0;0;0;0;.00nan;0;0
20207;-1;841;61;24;2;22;.917;3600000;0
20207;-1;846;48;27;3;24;.889;3545000;0
20207;47754;841;0;0;0;0;.00nan;0;0
20208;-1;844;0;0;0;0;.00nan;0;0
20208;147845;2508;54;48;5;43;.896;3879000;0
20208;148069;844;47;29;5;24;.828;3900000;0
20208;152266;2508;0;0;0;0;.00nan;0;0
20209;5565;843;80;35;2;33;.943;3600000;0
20209;9455;843;0;0;0;0;.00nan;0;0
20209;179411;2488;48;27;4;23;.852;3566000;0
20209;180311;2488;0;0;0;0;.00nan;0;0
20210;5565;843;0;0;0;0;.00nan;0;0
20210;5573;845;0;0;0;0;.00nan;0;0
20210;9455;843;77;41;4;37;.902;3600000;0
20210;94240;845;93;31;1;30;.968;3600000;0
20211;13373;835;49;33;5;28;.848;3600000;0
20211;-1;844;68;25;3;22;.880;3600000;0
20211;86485;835;0;0;0;0;.00nan;0;0
20211;148069;844;0;0;0;0;.00nan;0;0
20212;805;846;74;43;4;39;.907;3600000;0
20212;-1;841;0;0;0;0;.00nan;0;0
20212;-1;846;0;0;0;0;.00nan;0;0
20212;47754;841;53;36;5;31;.861;3579000;0
20213;16588;2517;0;0;0;0;.00nan;0;0
20213;-1;2517;53;23;3;20;.870;3547000;0
20213;-1;2493;74;27;2;25;.926;3600000;0
20213;89190;2493;0;0;0;0;.00nan;0;0
20214;179411;2488;57;8;0;8;1.000;485000;0
20214;180311;2488;41;33;6;27;.818;3115000;0
20214;147845;2508;0;0;0;0;.00nan;0;0
20214;152266;2508;75;32;2;30;.938;3600000;0
20215;16588;2517;53;3;0;3;1.000;638000;0
20215;-1;2517;40;40;6;34;.850;2962000;0
20215;-1;844;0;0;0;0;.00nan;0;0
20215;148069;844;63;28;3;25;.893;3600000;0
20216;5573;845;0;0;0;0;.00nan;0;0
20216;179411;2488;78;31;2;29;.935;3600000;0
20216;180311;2488;0;0;0;0;.00nan;0;0
20216;94240;845;68;41;4;37;.902;3546000;0
20217;805;846;90;20;0;20;1.000;3600000;0
20217;5565;843;0;0;0;0;.00nan;0;0
20217;9455;843;52;35;4;31;.886;3600000;0
20217;-1;846;0;0;0;0;.00nan;0;0
20218;-1;841;60;24;3;21;.875;3600000;0
20218;47754;841;0;0;0;0;.00nan;0;0
20218;147845;2508;89;39;4;35;.897;3565000;0
20218;152266;2508;0;0;0;0;.00nan;0;0
20219;13373;835;0;0;0;0;.00nan;0;0
20219;-1;2493;44;30;5;25;.833;3600000;0
20219;86485;835;36;30;6;24;.800;3557000;0
20219;89190;2493;0;0;0;0;.00nan;0;0
20220;16588;2517;0;0;0;0;.00nan;0;0
20220;-1;2517;69;15;1;14;.933;3600000;0
20220;147845;2508;0;0;0;0;.00nan;0;0
20220;152266;2508;59;42;5;37;.881;3600000;0
20221;13373;835;27;15;4;11;.733;920000;0
20221;-1;841;63;14;1;13;.929;3600000;0
20221;47754;841;0;0;0;0;.00nan;0;0
20221;86485;835;74;36;3;33;.917;2680000;0
20222;16588;2517;0;0;0;0;.00nan;0;0
20222;-1;2517;95;38;1;37;.974;3900000;0
20222;179411;2488;93;38;1;37;.974;3900000;0
20222;180311;2488;0;0;0;0;.00nan;0;0
20223;5565;843;44;4;1;3;.750;454000;0
20223;9455;843;39;36;6;30;.833;3146000;0
20223;-1;2493;58;20;2;18;.900;3600000;0
20223;89190;2493;0;0;0;0;.00nan;0;0
20224;805;846;75;30;2;28;.933;3900000;0
20224;-1;844;97;40;2;38;.950;3900000;0
20224;-1;846;0;0;0;0;.00nan;0;0
20224;148069;844;0;0;0;0;.00nan;0;0
20225;5573;845;0;0;0;0;.00nan;0;0
20225;94240;845;40;28;6;22;.786;3578000;0
20225;147845;2508;78;39;4;35;.897;3600000;0
20225;152266;2508;0;0;0;0;.00nan;0;0
20226;-1;844;0;0;0;0;.00nan;0;0
20226;147845;2508;0;0;0;0;.00nan;0;0
20226;148069;844;91;20;0;20;1.000;3600000;0
20226;152266;2508;92;54;4;50;.926;3600000;0
20227;-1;841;0;0;0;0;.00nan;0;0
20227;-1;2493;58;45;6;39;.867;3302000;0
20227;47754;841;57;25;3;22;.880;3600000;0
20227;89190;2493;49;2;0;2;1.000;298000;0
20228;5573;845;61;24;3;21;.875;3581000;0
20228;13373;835;91;40;1;39;.975;3600000;0
20228;86485;835;0;0;0;0;.00nan;0;0
20228;94240;845;0;0;0;0;.00nan;0;0
20229;5565;843;0;0;0;0;.00nan;0;0
20229;9455;843;78;31;2;29;.935;3600000;0
20229;16588;2517;56;5;0;5;1.000;673000;0
20229;-1;2517;29;26;6;20;.769;2927000;0
20230;805;846;84;34;3;31;.912;3900000;0
20230;179411;2488;87;39;3;36;.923;3900000;0
20230;180311;2488;0;0;0;0;.00nan;0;0
20230;-1;846;0;0;0;0;.00nan;0;0
20231;16588;2517;0;0;0;0;.00nan;0;0
20231;-1;2517;51;35;5;30;.857;3531000;0
20231;-1;841;69;32;3;29;.906;3600000;0
20231;47754;841;0;0;0;0;.00nan;0;0
20232;-1;844;0;0;0;0;.00nan;0;0
20232;-1;2493;53;23;3;20;.870;3574000;0
20232;89190;2493;0;0;0;0;.00nan;0;0
20232;148069;844;59;14;1;13;.929;3600000;0
20233;805;846;70;30;2;28;.933;3600000;0
20233;5573;845;0;0;0;0;.00nan;0;0
20233;-1;846;0;0;0;0;.00nan;0;0
20233;94240;845;70;39;4;35;.897;3529000;0
20234;5565;843;0;0;0;0;.00nan;0;0
20234;9455;843;73;39;4;35;.897;3546000;0
20234;147845;2508;82;31;2;29;.935;3600000;0
20234;152266;2508;0;0;0;0;.00nan;0;0
20235;13373;835;0;0;0;0;.00nan;0;0
20235;179411;2488;48;10;2;8;.800;3900000;0
20235;180311;2488;0;0;0;0;.00nan;0;0
20235;86485;835;78;31;2;29;.935;3900000;0
20236;16588;2517;0;0;0;0;.00nan;0;0
20236;-1;2517;72;27;1;26;.963;3600000;0
20236;147845;2508;0;0;0;0;.00nan;0;0
20236;152266;2508;57;33;4;29;.879;3600000;0
20237;5573;845;63;35;4;31;.886;3580000;0
20237;-1;2493;64;28;3;25;.893;3600000;0
20237;89190;2493;0;0;0;0;.00nan;0;0
20237;94240;845;0;0;0;0;.00nan;0;0
20238;805;846;88;16;0;16;1.000;3600000;0
20238;13373;835;84;45;3;42;.933;3600000;0
20238;-1;846;0;0;0;0;.00nan;0;0
20238;86485;835;0;0;0;0;.00nan;0;0
20239;5565;843;0;0;0;0;.00nan;0;0
20239;9455;843;73;31;2;29;.935;3577000;0
20239;-1;844;99;31;1;30;.968;3600000;0
20239;148069;844;0;0;0;0;.00nan;0;0
20240;179411;2488;100;30;0;30;1.000;3600000;0
20240;-1;841;62;22;3;19;.864;3600000;0
20240;180311;2488;0;0;0;0;.00nan;0;0
20240;47754;841;0;0;0;0;.00nan;0;0
20241;5573;845;81;26;1;25;.962;3600000;0
20241;-1;844;61;34;4;30;.882;3600000;0
20241;94240;845;0;0;0;0;.00nan;0;0
20241;148069;844;0;0;0;0;.00nan;0;0
20242;5565;843;0;0;0;0;.00nan;0;0
20242;9455;843;83;54;4;50;.926;3600000;0
20242;-1;841;44;14;3;11;.786;3600000;0
20242;47754;841;0;0;0;0;.00nan;0;0
20243;179411;2488;78;25;1;24;.960;3548000;0
20243;-1;2493;100;22;0;22;1.000;3600000;0
20243;180311;2488;0;0;0;0;.00nan;0;0
20243;89190;2493;0;0;0;0;.00nan;0;0
20244;805;846;65;19;2;17;.895;3600000;0
20244;-1;846;0;0;0;0;.00nan;0;0
20244;147845;2508;44;32;6;26;.813;3600000;0
20244;152266;2508;0;0;0;0;.00nan;0;0
20245;13373;835;79;28;2;26;.929;3900000;0
20245;16588;2517;0;0;0;0;.00nan;0;0
20245;-1;2517;76;31;2;29;.935;3900000;0
20245;86485;835;0;0;0;0;.00nan;0;0
20246;805;846;66;25;3;22;.880;3582000;0
20246;16588;2517;0;0;0;0;.00nan;0;0
20246;-1;2517;85;26;1;25;.962;3600000;0
20246;-1;846;0;0;0;0;.00nan;0;0
20247;-1;2493;75;22;1;21;.955;3600000;0
20247;89190;2493;0;0;0;0;.00nan;0;0
20247;147845;2508;0;0;0;0;.00nan;0;0
20247;152266;2508;57;37;4;33;.892;3600000;0
20248;5565;843;0;0;0;0;.00nan;0;0
20248;9455;843;95;40;2;38;.950;3900000;0
20248;13373;835;76;26;2;24;.923;3900000;0
20248;86485;835;0;0;0;0;.00nan;0;0
20249;179411;2488;0;0;0;0;.00nan;0;0
20249;-1;844;0;0;0;0;.00nan;0;0
20249;180311;2488;42;31;5;26;.839;3600000;0
20249;148069;844;72;11;0;11;1.000;3600000;0
20250;16588;2517;0;0;0;0;.00nan;0;0
20250;-1;2517;57;33;5;28;.848;3600000;0
20250;-1;844;0;0;0;0;.00nan;0;0
20250;148069;844;67;18;1;17;.944;3600000;0
20251;5573;845;0;0;0;0;.00nan;0;0
20251;-1;841;0;0;0;0;.00nan;0;0
20251;47754;841;61;32;3;29;.906;3600000;0
20251;94240;845;72;42;4;38;.905;3587000;0
20252;-1;844;73;29;2;27;.931;3553000;0
20252;-1;841;89;22;1;21;.955;3600000;0
20252;47754;841;0;0;0;0;.00nan;0;0
20252;148069;844;0;0;0;0;.00nan;0;0
20253;5573;845;0;0;0;0;.00nan;0;0
20253;16588;2517;0;0;0;0;.00nan;0;0
20253;-1;2517;79;40;3;37;.925;3554000;0
20253;94240;845;64;20;2;18;.900;3600000;0
20254;805;846;0;0;0;0;.00nan;0;0
20254;-1;2493;82;37;4;33;.892;3587000;0
20254;-1;846;85;37;2;35;.946;3600000;0
20254;89190;2493;0;0;0;0;.00nan;0;0
20255;13373;835;99;33;1;32;.970;3600000;0
20255;86485;835;0;0;0;0;.00nan;0;0
20255;147845;2508;54;26;3;23;.885;3539000;0
20255;152266;2508;0;0;0;0;.00nan;0;0
20256;5565;843;68;9;0;9;1.000;830000;0
20256;9455;843;32;32;6;26;.813;2770000;0
20256;179411;2488;37;29;5;24;.828;3600000;0
20256;180311;2488;0;0;0;0;.00nan;0;0
20257;16588;2517;0;0;0;0;.00nan;0;0
20257;-1;2517;53;22;3;19;.864;3600000;0
20257;-1;2493;76;29;2;27;.931;3600000;0
20257;89190;2493;0;0;0;0;.00nan;0;0
20258;5565;843;0;0;0;0;.00nan;0;0
20258;5573;845;57;26;3;23;.885;3600000;0
20258;9455;843;54;39;5;34;.872;3574000;0
20258;94240;845;0;0;0;0;.00nan;0;0
20259;805;846;85;34;3;31;.912;3600000;0
20259;-1;841;40;22;5;17;.773;3557000;0
20259;-1;846;0;0;0;0;.00nan;0;0
20259;47754;841;0;0;0;0;.00nan;0;0
20260;179411;2488;45;30;6;24;.800;3600000;0
20260;180311;2488;0;0;0;0;.00nan;0;0
20260;147845;2508;52;2;0;2;1.000;637000;0
20260;152266;2508;46;43;8;35;.814;2883000;0
20261;13373;835;73;28;2;26;.929;3600000;0
20261;-1;844;44;32;5;27;.844;3600000;0
20261;86485;835;0;0;0;0;.00nan;0;0
20261;148069;844;0;0;0;0;.00nan;0;0
20262;13373;835;75;42;4;38;.905;3600000;0
20262;179411;2488;27;26;6;20;.769;3556000;0
20262;180311;2488;0;0;0;0;.00nan;0;0
20262;86485;835;0;0;0;0;.00nan;0;0
20263;-1;841;88;18;0;18;1.000;3600000;0
20263;47754;841;0;0;0;0;.00nan;0;0
20263;147845;2508;59;44;6;38;.864;3600000;0
20263;152266;2508;0;0;0;0;.00nan;0;0
20264;13373;835;55;12;1;11;.917;1616000;0
20264;-1;2493;77;32;3;29;.906;3600000;0
20264;86485;835;19;24;6;18;.750;1984000;0
20264;89190;2493;0;0;0;0;.00nan;0;0
20265;805;846;73;22;1;21;.955;3600000;0
20265;5565;843;0;0;0;0;.00nan;0;0
20265;9455;843;100;39;0;39;1.000;3600000;0
20265;-1;846;0;0;0;0;.00nan;0;0
20266;5573;845;0;0;0;0;.00nan;0;0
20266;179411;2488;0;0;0;0;.00nan;0;0
20266;180311;2488;53;23;3;20;.870;3559000;0
20266;94240;845;75;30;2;28;.933;3600000;0
20267;16588;2517;0;0;0;0;.00nan;0;0
20267;-1;2517;69;34;3;31;.912;3576000;0
20267;-1;844;0;0;0;0;.00nan;0;0
20267;148069;844;60;18;2;16;.889;3600000;0
20268;5573;845;43;32;5;27;.844;3537000;0
20268;-1;841;53;26;3;23;.885;3600000;0
20268;47754;841;0;0;0;0;.00nan;0;0
20268;94240;845;0;0;0;0;.00nan;0;0
20269;805;846;76;33;3;30;.909;3600000;0
20269;16588;2517;0;0;0;0;.00nan;0;0
20269;-1;2517;67;44;5;39;.886;3594000;0
20269;-1;846;0;0;0;0;.00nan;0;0
20270;-1;2493;65;21;2;19;.905;3600000;0
20270;89190;2493;0;0;0;0;.00nan;0;0
20270;147845;2508;0;0;0;0;.00nan;0;0
20270;152266;2508;72;38;3;35;.921;3562000;0
20271;5565;843;0;0;0;0;.00nan;0;0
20271;9455;843;56;28;4;24;.857;3600000;0
20271;13373;835;85;30;1;29;.967;3600000;0
20271;86485;835;0;0;0;0;.00nan;0;0
20272;5573;845;0;0;0;0;.00nan;0;0
20272;16588;2517;0;0;0;0;.00nan;0;0
20272;-1;2517;87;17;0;17;1.000;3600000;0
20272;94240;845;83;27;1;26;.963;3561000;0
20273;-1;844;0;0;0;0;.00nan;0;0
20273;-1;841;75;43;4;39;.907;3872000;0
20273;47754;841;0;0;0;0;.00nan;0;0
20273;148069;844;36;27;5;22;.815;3872000;0
20274;805;846;75;29;2;27;.931;3900000;0
20274;-1;2493;93;37;2;35;.946;3900000;0
20274;-1;846;0;0;0;0;.00nan;0;0
20274;89190;2493;0;0;0;0;.00nan;0;0
20275;13373;835;48;18;3;15;.833;3600000;0
20275;86485;835;0;0;0;0;.00nan;0;0
20275;147845;2508;0;0;0;0;.00nan;0;0
20275;152266;2508;61;38;6;32;.842;3600000;0
20276;5565;843;100;38;1;37;.974;3600000;0
20276;9455;843;0;0;0;0;.00nan;0;0
20276;179411;2488;51;20;3;17;.850;3543000;0
20276;180311;2488;0;0;0;0;.00nan;0;0
20277;805;846;100;35;0;35;1.000;3600000;0
20277;-1;844;0;0;0;0;.00nan;0;0
20277;-1;846;0;0;0;0;.00nan;0;0
20277;148069;844;86;34;1;33;.971;3561000;0
20278;13373;835;71;37;5;32;.865;3600000;0
20278;-1;841;85;34;2;32;.941;3600000;0
20278;47754;841;0;0;0;0;.00nan;0;0
20278;86485;835;0;0;0;0;.00nan;0;0
20279;5573;845;69;24;2;22;.917;3600000;0
20279;94240;845;0;0;0;0;.00nan;0;0
20279;147845;2508;16;8;4;4;.500;946000;0
20279;152266;2508;87;45;4;41;.911;2654000;0
20280;5565;843;0;0;0;0;.00nan;0;0
20280;9455;843;75;36;3;33;.917;3576000;0
20280;-1;2493;80;28;1;27;.964;3600000;0
20280;89190;2493;0;0;0;0;.00nan;0;0
20281;16588;2517;0;0;0;0;.00nan;0;0
20281;-1;2517;83;35;2;33;.943;3600000;0
20281;179411;2488;0;0;0;0;.00nan;0;0
20281;180311;2488;49;28;4;24;.857;3567000;0
20282;5565;843;0;0;0;0;.00nan;0;0
20282;9455;843;75;36;3;33;.917;3600000;0
20282;16588;2517;0;0;0;0;.00nan;0;0
20282;-1;2517;35;20;4;16;.800;3556000;0
20283;-1;841;55;19;2;17;.895;3522000;0
20283;-1;2493;100;31;0;31;1.000;3600000;0
20283;47754;841;0;0;0;0;.00nan;0;0
20283;89190;2493;0;0;0;0;.00nan;0;0
20284;805;846;79;20;1;19;.950;3900000;0
20284;179411;2488;0;0;0;0;.00nan;0;0
20284;180929;2488;77;28;1;27;.964;3900000;0
20284;-1;846;0;0;0;0;.00nan;0;0
20285;-1;844;46;19;3;16;.842;3532000;0
20285;147845;2508;0;0;0;0;.00nan;0;0
20285;148069;844;0;0;0;0;.00nan;0;0
20285;152266;2508;100;35;1;34;.971;3600000;0
20286;5573;845;0;0;0;0;.00nan;0;0
20286;13373;835;82;43;4;39;.907;3600000;0
20286;86485;835;0;0;0;0;.00nan;0;0
20286;94240;845;76;19;1;18;.947;3600000;0
20287;-1;844;0;0;0;0;.00nan;0;0
20287;-1;2493;42;35;6;29;.829;3600000;0
20287;89190;2493;0;0;0;0;.00nan;0;0
20287;148069;844;57;16;2;14;.875;3600000;0
20288;16588;2517;0;0;0;0;.00nan;0;0
20288;-1;2517;65;31;3;28;.903;3555000;0
20288;-1;841;0;0;0;0;.00nan;0;0
20288;47754;841;78;34;2;32;.941;3600000;0
20289;805;846;42;45;7;38;.844;3600000;0
20289;5573;845;0;0;0;0;.00nan;0;0
20289;-1;846;0;0;0;0;.00nan;0;0
20289;94240;845;74;23;1;22;.957;3600000;0
20290;5565;843;0;0;0;0;.00nan;0;0
20290;9455;843;71;23;1;22;.957;3600000;0
20290;147845;2508;61;37;4;33;.892;3600000;0
20290;152266;2508;0;0;0;0;.00nan;0;0
20291;13373;835;70;29;2;27;.931;3552000;0
20291;179411;2488;0;0;0;0;.00nan;0;0
20291;180929;2488;91;29;1;28;.966;3600000;0
20291;86485;835;0;0;0;0;.00nan;0;0
20292;5565;843;65;38;4;34;.895;3561000;0
20292;30431;843;0;0;0;0;.00nan;0;0
20292;-1;844;0;0;0;0;.00nan;0;0
20292;148069;844;47;12;2;10;.833;3600000;0
20293;179411;2488;0;0;0;0;.00nan;0;0
20293;-1;841;40;18;3;15;.833;3600000;0
20293;180929;2488;99;38;1;37;.974;3600000;0
20293;47754;841;0;0;0;0;.00nan;0;0
20294;5573;845;0;0;0;0;.00nan;0;0
20294;-1;2493;77;28;2;26;.929;3585000;0
20294;89190;2493;0;0;0;0;.00nan;0;0
20294;94240;845;80;25;1;24;.960;3600000;0
20295;16588;2517;0;0;0;0;.00nan;0;0
20295;-1;2517;78;28;2;26;.929;3600000;0
20295;147845;2508;0;0;0;0;.00nan;0;0
20295;152266;2508;56;25;3;22;.880;3581000;0
20296;805;846;66;30;3;27;.900;3568000;0
20296;13373;835;0;0;0;0;.00nan;0;0
20296;-1;846;0;0;0;0;.00nan;0;0
20296;86485;835;78;29;1;28;.966;3600000;0
20297;13373;835;84;28;1;27;.964;3600000;0
20297;16588;2517;0;0;0;0;.00nan;0;0
20297;-1;2517;66;35;3;32;.914;3514000;0
20297;86485;835;0;0;0;0;.00nan;0;0
20298;5573;845;55;33;4;29;.879;3526000;0
20298;-1;844;0;0;0;0;.00nan;0;0
20298;94240;845;0;0;0;0;.00nan;0;0
20298;148069;844;82;29;2;27;.931;3600000;0
20299;805;846;0;0;0;0;.00nan;0;0
20299;-1;846;89;20;0;20;1.000;3600000;0
20299;147845;2508;72;25;2;23;.920;3512000;0
20299;152266;2508;0;0;0;0;.00nan;0;0
20300;5565;843;0;0;0;0;.00nan;0;0
20300;30431;843;65;37;6;31;.838;3600000;0
20300;-1;841;97;20;0;20;1.000;3600000;0
20300;47754;841;0;0;0;0;.00nan;0;0
20301;179411;2488;0;0;0;0;.00nan;0;0
20301;-1;2493;67;44;5;39;.886;3574000;0
20301;180929;2488;77;29;3;26;.897;3600000;0
20301;89190;2493;0;0;0;0;.00nan;0;0
20303;805;846;67;27;3;24;.889;3900000;0
20303;185506;846;0;0;0;0;.00nan;0;0
20303;47742;841;0;0;0;0;.00nan;0;0
20303;47754;841;74;30;3;27;.900;3900000;0
20305;179411;2488;0;0;0;0;.00nan;0;0
20305;-1;2493;82;31;2;29;.935;3550000;0
20305;180311;2488;66;16;1;15;.938;3600000;0
20305;89190;2493;0;0;0;0;.00nan;0;0
20307;5573;845;68;22;1;21;.955;3600000;0
20307;13373;835;60;50;6;44;.880;3600000;0
20307;86485;835;0;0;0;0;.00nan;0;0
20307;94240;845;0;0;0;0;.00nan;0;0
20309;5565;843;0;0;0;0;.00nan;0;0
20309;9455;843;45;23;4;19;.826;3701000;0
20309;147845;2508;0;0;0;0;.00nan;0;0
20309;152266;2508;85;49;5;44;.898;3701000;0
20311;16588;2517;0;0;0;0;.00nan;0;0
20311;-1;2517;69;16;1;15;.938;3600000;0
20311;-1;844;0;0;0;0;.00nan;0;0
20311;148069;844;58;25;4;21;.840;3600000;0
20313;805;846;0;0;0;0;.00nan;0;0
20313;185506;846;43;31;5;26;.839;3559000;0
20313;47742;841;62;29;3;26;.897;3600000;0
20313;47754;841;0;0;0;0;.00nan;0;0
20315;16588;2517;70;27;2;25;.926;3900000;0
20315;-1;2517;0;0;0;0;.00nan;0;0
20315;147845;2508;90;32;2;30;.938;3900000;0
20315;152266;2508;0;0;0;0;.00nan;0;0
20317;5565;843;100;43;1;42;.977;3600000;0
20317;9455;843;0;0;0;0;.00nan;0;0
20317;179411;2488;26;25;5;20;.800;3600000;0
20317;180311;2488;0;0;0;0;.00nan;0;0
20319;5573;845;0;0;0;0;.00nan;0;0
20319;13373;835;0;0;0;0;.00nan;0;0
20319;86485;835;63;33;3;30;.909;3900000;0
20319;94240;845;52;29;3;26;.897;3900000;0
20321;-1;844;71;27;2;25;.926;3900000;0
20321;-1;2493;0;0;0;0;.00nan;0;0
20321;89190;2493;92;35;2;33;.943;3900000;0
20321;148069;844;0;0;0;0;.00nan;0;0
20323;5565;843;0;0;0;0;.00nan;0;0
20323;9455;843;44;31;5;26;.839;3600000;0
20323;47742;841;0;0;0;0;.00nan;0;0
20323;47754;841;96;29;1;28;.966;3600000;0
20325;805;846;65;30;3;27;.900;3580000;0
20325;-1;2493;67;17;1;16;.941;3600000;0
20325;185506;846;0;0;0;0;.00nan;0;0
20325;89190;2493;0;0;0;0;.00nan;0;0
20327;179411;2488;0;0;0;0;.00nan;0;0
20327;-1;844;0;0;0;0;.00nan;0;0
20327;180311;2488;55;32;4;28;.875;3594000;0
20327;148069;844;54;26;3;23;.885;3600000;0
20329;5573;845;57;18;2;16;.889;3600000;0
20329;94240;845;0;0;0;0;.00nan;0;0
20329;147845;2508;0;0;0;0;.00nan;0;0
20329;152266;2508;62;45;6;39;.867;3600000;0
20331;13373;835;78;46;4;42;.913;3600000;0
20331;16588;2517;0;0;0;0;.00nan;0;0
20331;-1;2517;70;16;1;15;.938;3600000;0
20331;86485;835;0;0;0;0;.00nan;0;0
20333;179411;2488;79;12;0;12;1.000;3600000;0
20333;180311;2488;0;0;0;0;.00nan;0;0
20333;147845;2508;51;40;6;34;.850;3292000;0
20333;152266;2508;54;5;0;5;1.000;308000;0
20335;5565;843;69;39;4;35;.897;3600000;0
20335;9455;843;0;0;0;0;.00nan;0;0
20335;-1;2493;0;0;0;0;.00nan;0;0
20335;89190;2493;81;25;1;24;.960;3600000;0
20337;5573;845;0;0;0;0;.00nan;0;0
20337;13373;835;0;0;0;0;.00nan;0;0
20337;86485;835;80;36;3;33;.917;3588000;0
20337;94240;845;79;30;2;28;.933;3600000;0
20339;805;846;0;0;0;0;.00nan;0;0
20339;185506;846;58;29;4;25;.862;3568000;0
20339;47742;841;49;14;2;12;.857;3600000;0
20339;47754;841;0;0;0;0;.00nan;0;0
20341;16588;2517;1;17;7;10;.588;2257000;0
20341;-1;2517;85;21;0;21;1.000;1343000;0
20341;-1;844;51;12;2;10;.833;3600000;0
20341;148069;844;0;0;0;0;.00nan;0;0
20343;5565;843;0;0;0;0;.00nan;0;0
20343;5573;845;0;0;0;0;.00nan;0;0
20343;9455;843;90;38;2;36;.947;3600000;0
20343;94240;845;47;29;4;25;.862;3523000;0
20345;805;846;82;36;3;33;.917;3676000;0
20345;16588;2517;0;0;0;0;.00nan;0;0
20345;-1;2517;66;24;2;22;.917;3676000;0
20345;185506;846;0;0;0;0;.00nan;0;0
20347;47742;841;0;0;0;0;.00nan;0;0
20347;47754;841;67;19;1;18;.947;3600000;0
20347;147845;2508;61;28;3;25;.893;3542000;0
20347;152266;2508;0;0;0;0;.00nan;0;0
20349;13373;835;78;29;1;28;.966;3600000;0
20349;179411;2488;72;31;2;29;.935;3600000;0
20349;180311;2488;0;0;0;0;.00nan;0;0
20349;86485;835;0;0;0;0;.00nan;0;0
20351;-1;844;0;0;0;0;.00nan;0;0
20351;-1;2493;70;25;2;23;.920;3600000;0
20351;89190;2493;0;0;0;0;.00nan;0;0
20351;148069;844;66;30;3;27;.900;3588000;0
20353;805;846;0;0;0;0;.00nan;0;0
20353;13373;835;0;0;0;0;.00nan;0;0
20353;185506;846;64;31;3;28;.903;3600000;0
20353;86485;835;75;45;4;41;.911;3550000;0
20355;5565;843;69;50;5;45;.900;3575000;0
20355;9455;843;0;0;0;0;.00nan;0;0
20355;16588;2517;46;20;3;17;.850;3600000;0
20355;-1;2517;0;0;0;0;.00nan;0;0
20357;179411;2488;0;0;0;0;.00nan;0;0
20357;180311;2488;59;29;3;26;.897;3585000;0
20357;47742;841;76;17;1;16;.941;3600000;0
20357;47754;841;0;0;0;0;.00nan;0;0
20359;5573;845;46;12;3;9;.750;3582000;0
20359;-1;844;96;41;1;40;.976;3600000;0
20359;94240;845;0;0;0;0;.00nan;0;0
20359;148069;844;0;0;0;0;.00nan;0;0
20361;-1;2493;0;0;0;0;.00nan;0;0
20361;89190;2493;78;26;2;24;.923;3600000;0
20361;147845;2508;0;0;0;0;.00nan;0;0
20361;152266;2508;76;37;3;34;.919;3600000;0
20363;5565;843;0;0;0;0;.00nan;0;0
20363;9455;843;69;49;5;44;.898;3600000;0
20363;-1;2493;72;22;1;21;.955;3600000;0
20363;89190;2493;0;0;0;0;.00nan;0;0
20365;16588;2517;51;29;3;26;.897;3900000;0
20365;-1;2517;0;0;0;0;.00nan;0;0
20365;-1;844;0;0;0;0;.00nan;0;0
20365;148069;844;64;29;3;26;.897;3900000;0
20367;805;846;36;19;4;15;.789;3600000;0
20367;13373;835;89;31;1;30;.968;3600000;0
20367;-1;846;0;0;0;0;.00nan;0;0
20367;86485;835;0;0;0;0;.00nan;0;0
20369;5573;845;0;0;0;0;.00nan;0;0
20369;94240;845;61;14;2;12;.857;3600000;0
20369;147845;2508;83;41;3;38;.927;3594000;0
20369;152266;2508;0;0;0;0;.00nan;0;0
20371;179411;2488;78;33;2;31;.939;3516000;0
20371;180311;2488;0;0;0;0;.00nan;0;0
20371;47742;841;0;0;0;0;.00nan;0;0
20371;47754;841;100;30;0;30;1.000;3600000;0
22325;16588;2517;0;0;0;0;.00nan;0;0
22325;-1;2517;58;39;4;35;.897;3600000;0
22325;-1;841;80;21;1;20;.952;3600000;0
22325;47754;841;0;0;0;0;.00nan;0;0
22326;5573;845;0;0;0;0;.00nan;0;0
22326;-1;844;0;0;0;0;.00nan;0;0
22326;94240;845;87;42;3;39;.929;3544000;0
22326;148069;844;95;34;1;33;.971;3600000;0
22327;805;846;71;33;3;30;.909;3566000;0
22327;179411;2488;0;0;0;0;.00nan;0;0
22327;180929;2488;74;21;1;20;.952;3600000;0
22327;-1;846;0;0;0;0;.00nan;0;0
22328;13373;835;64;43;5;38;.884;3600000;0
22328;-1;2493;73;25;2;23;.920;3600000;0
22328;86485;835;0;0;0;0;.00nan;0;0
22328;89190;2493;0;0;0;0;.00nan;0;0
22329;16588;2517;0;0;0;0;.00nan;0;0
22329;-1;2517;57;32;4;28;.875;3993000;0
22329;-1;841;67;25;3;22;.880;3993000;0
22329;47754;841;0;0;0;0;.00nan;0;0
22330;5573;845;0;0;0;0;.00nan;0;0
22330;-1;844;0;0;0;0;.00nan;0;0
22330;94240;845;74;22;1;21;.955;3600000;0
22330;148069;844;60;24;2;22;.917;3544000;0
22331;805;846;83;36;3;33;.917;4159000;0
22331;179411;2488;0;0;0;0;.00nan;0;0
22331;180929;2488;54;18;2;16;.889;4159000;0
22331;-1;846;0;0;0;0;.00nan;0;0
22332;13373;835;37;32;6;26;.813;3303000;0
22332;-1;2493;76;17;1;16;.941;3600000;0
22332;86485;835;41;4;1;3;.750;297000;0
22332;89190;2493;0;0;0;0;.00nan;0;0
22333;16588;2517;0;0;0;0;.00nan;0;0
22333;-1;2517;92;37;2;35;.946;3543000;0
22333;-1;841;65;18;1;17;.944;3600000;0
22333;47754;841;0;0;0;0;.00nan;0;0
22334;5573;845;0;0;0;0;.00nan;0;0
22334;-1;844;0;0;0;0;.00nan;0;0
22334;94240;845;46;32;5;27;.844;3600000;0
22334;148069;844;80;31;1;30;.968;3600000;0
22335;805;846;73;28;2;26;.929;3600000;0
22335;179411;2488;0;0;0;0;.00nan;0;0
22335;180929;2488;43;27;4;23;.852;3592000;0
22335;-1;846;0;0;0;0;.00nan;0;0
22336;13373;835;62;42;5;37;.881;3591000;0
22336;-1;2493;59;26;3;23;.885;3600000;0
22336;86485;835;0;0;0;0;.00nan;0;0
22336;89190;2493;0;0;0;0;.00nan;0;0
22337;16588;2517;0;0;0;0;.00nan;0;0
22337;-1;2517;99;30;1;29;.967;3600000;0
22337;-1;841;71;27;2;25;.926;3589000;0
22337;47754;841;0;0;0;0;.00nan;0;0
22338;5573;845;0;0;0;0;.00nan;0;0
22338;-1;844;0;0;0;0;.00nan;0;0
22338;94240;845;83;42;3;39;.929;3600000;0
22338;148069;844;50;28;4;24;.857;3553000;0
22339;805;846;40;37;7;30;.811;3600000;0
22339;179411;2488;0;0;0;0;.00nan;0;0
22339;180929;2488;70;22;2;20;.909;3600000;0
22339;-1;846;0;0;0;0;.00nan;0;0
22340;13373;835;85;32;1;31;.969;3600000;0
22340;-1;2493;77;29;2;27;.931;3563000;0
22340;86485;835;0;0;0;0;.00nan;0;0
22340;89190;2493;0;0;0;0;.00nan;0;0
22421;16588;2517;0;0;0;0;.00nan;0;0
22421;-1;2517;100;28;0;28;1.000;3600000;0
22421;-1;841;86;47;4;43;.915;3600000;0
22421;47754;841;0;0;0;0;.00nan;0;0
22422;5573;845;0;0;0;0;.00nan;0;0
22422;-1;844;60;9;0;9;1.000;966000;0
22422;94240;845;60;30;3;27;.900;3600000;0
22422;148069;844;18;24;6;18;.750;2634000;0
22423;805;846;79;34;2;32;.941;3600000;0
22423;179411;2488;0;0;0;0;.00nan;0;0
22423;180929;2488;50;31;5;26;.839;3600000;0
22423;-1;846;0;0;0;0;.00nan;0;0
22424;13373;835;100;33;0;33;1.000;3600000;0
22424;-1;2493;41;23;4;19;.826;3600000;0
22424;86485;835;0;0;0;0;.00nan;0;0
22424;89190;2493;0;0;0;0;.00nan;0;0
22426;16588;2517;0;0;0;0;.00nan;0;0
22426;-1;2517;74;34;2;32;.941;3600000;0
22426;-1;841;33;17;4;13;.765;3600000;0
22426;47754;841;0;0;0;0;.00nan;0;0
22427;5573;845;0;0;0;0;.00nan;0;0
22427;-1;844;0;0;0;0;.00nan;0;0
22427;94240;845;86;32;1;31;.969;3600000;0
22427;148069;844;68;36;4;32;.889;3600000;0
22428;805;846;86;40;3;37;.925;3588000;0
22428;179411;2488;0;0;0;0;.00nan;0;0
22428;180929;2488;89;25;1;24;.960;3600000;0
22428;-1;846;0;0;0;0;.00nan;0;0
22429;13373;835;51;28;5;23;.821;3600000;0
22429;-1;2493;71;46;4;42;.913;3600000;0
22429;86485;835;0;0;0;0;.00nan;0;0
22429;89190;2493;0;0;0;0;.00nan;0;0
22432;16588;2517;0;0;0;0;.00nan;0;0
22432;-1;2517;74;35;3;32;.914;3552000;0
22432;-1;841;72;24;2;22;.917;3600000;0
22432;47754;841;0;0;0;0;.00nan;0;0
22471;5573;845;44;4;1;3;.750;706000;0
22471;-1;841;83;29;1;28;.966;3600000;0
22471;47754;841;0;0;0;0;.00nan;0;0
22471;94240;845;45;36;6;30;.833;2894000;0
22472;179411;2488;0;0;0;0;.00nan;0;0
22472;-1;2493;82;45;3;42;.933;3541000;0
22472;180929;2488;100;45;2;43;.956;3600000;0
22472;89190;2493;0;0;0;0;.00nan;0;0
22473;5573;845;0;0;0;0;.00nan;0;0
22473;-1;841;73;40;4;36;.900;3874000;0
22473;47754;841;0;0;0;0;.00nan;0;0
22473;94240;845;81;42;3;39;.929;3874000;0
22474;179411;2488;0;0;0;0;.00nan;0;0
22474;-1;2493;85;28;1;27;.964;3800000;0
22474;180929;2488;100;38;0;38;1.000;3800000;0
22474;89190;2493;0;0;0;0;.00nan;0;0
22475;5573;845;0;0;0;0;.00nan;0;0
22475;-1;841;76;20;1;19;.950;3600000;0
22475;47754;841;0;0;0;0;.00nan;0;0
22475;94240;845;52;27;4;23;.852;3600000;0
22476;179411;2488;0;0;0;0;.00nan;0;0
22476;-1;2493;37;32;6;26;.813;3572000;0
22476;180929;2488;46;31;5;26;.839;3600000;0
22476;89190;2493;0;0;0;0;.00nan;0;0
22477;5573;845;0;0;0;0;.00nan;0;0
22477;-1;841;68;26;2;24;.923;3600000;0
22477;47754;841;0;0;0;0;.00nan;0;0
22477;94240;845;79;41;3;38;.927;3567000;0
22478;179411;2488;0;0;0;0;.00nan;0;0
22478;-1;2493;75;38;3;35;.921;3760000;0
22478;180929;2488;60;32;4;28;.875;3764000;0
22478;89190;2493;0;0;0;0;.00nan;0;0
22569;5573;845;0;0;0;0;.00nan;0;0
22569;-1;841;83;34;2;32;.941;3731000;0
22569;47754;841;0;0;0;0;.00nan;0;0
22569;94240;845;52;23;3;20;.870;3731000;0
22570;179411;2488;0;0;0;0;.00nan;0;0
22570;-1;2493;66;25;2;23;.920;3573000;0
22570;180929;2488;87;26;1;25;.962;3600000;0
22570;89190;2493;0;0;0;0;.00nan;0;0
22599;179411;2488;0;0;0;0;.00nan;0;0
22599;-1;841;57;35;4;31;.886;4580000;0
22599;180929;2488;62;30;3;27;.900;4580000;0
22599;47754;841;0;0;0;0;.00nan;0;0
22600;179411;2488;0;0;0;0;.00nan;0;0
22600;-1;841;72;40;4;36;.900;3600000;0
22600;180929;2488;93;30;1;29;.967;3600000;0
22600;47754;841;0;0;0;0;.00nan;0;0
22601;179411;2488;0;0;0;0;.00nan;0;0
22601;-1;841;88;38;2;36;.947;3558000;0
22601;180929;2488;100;26;0;26;1.000;3600000;0
22601;47754;841;0;0;0;0;.00nan;0;0
20372;7487;3922;0;0;0;0;.00nan;0;0
20372;13613;1869;43;25;4;21;.840;3600000;0
20372;68565;3922;59;28;3;25;.893;3600000;0
20372;73973;1869;0;0;0;0;.00nan;0;0
20373;9373;1854;82;28;1;27;.964;3600000;0
20373;185041;2173;74;30;2;28;.933;3576000;0
20373;62279;2173;0;0;0;0;.00nan;0;0
20373;155529;1854;0;0;0;0;.00nan;0;0
20374;6944;1477;48;26;4;22;.846;3590000;0
20374;62530;1477;0;0;0;0;.00nan;0;0
20374;76951;2193;53;20;3;17;.850;3600000;0
20374;143063;2193;0;0;0;0;.00nan;0;0
20375;174589;522;0;0;0;0;.00nan;0;0
20375;186520;522;78;37;2;35;.946;3600000;0
20375;-1;1871;0;0;0;0;.00nan;0;0
20375;67764;1871;39;20;4;16;.800;3550000;0
20376;64230;1861;73;39;4;35;.897;3541000;0
20376;68627;1475;61;19;2;17;.895;3600000;0
20376;143479;1475;0;0;0;0;.00nan;0;0
20376;152202;1861;0;0;0;0;.00nan;0;0
20377;6947;521;72;44;4;40;.909;3600000;0
20377;179830;523;0;0;0;0;.00nan;0;0
20377;143036;521;0;0;0;0;.00nan;0;0
20377;147264;523;61;22;2;20;.909;3600000;0
20378;7534;1481;0;0;0;0;.00nan;0;0
20378;164170;4560;0;0;0;0;.00nan;0;0
20378;206007;1481;78;30;2;28;.933;3600000;0
20378;143421;4560;41;28;4;24;.857;3527000;0
20379;7487;3922;0;0;0;0;.00nan;0;0
20379;7534;1481;49;14;2;12;.857;3600000;0
20379;206007;1481;0;0;0;0;.00nan;0;0
20379;68565;3922;32;31;6;25;.806;3600000;0
20380;6944;1477;0;0;0;0;.00nan;0;0
20380;-1;1871;80;36;3;33;.917;3550000;0
20380;62530;1477;69;27;2;25;.926;3600000;0
20380;67764;1871;0;0;0;0;.00nan;0;0
20381;68627;1475;0;0;0;0;.00nan;0;0
20381;76951;2193;73;27;1;26;.963;3753000;0
20381;143063;2193;0;0;0;0;.00nan;0;0
20381;143479;1475;79;33;2;31;.939;3753000;0
20382;6947;521;100;30;0;30;1.000;3600000;0
20382;185041;2173;69;24;1;23;.958;3546000;0
20382;62279;2173;0;0;0;0;.00nan;0;0
20382;143036;521;0;0;0;0;.00nan;0;0
20383;9373;1854;67;18;1;17;.944;3600000;0
20383;164170;4560;0;0;0;0;.00nan;0;0
20383;143421;4560;64;28;3;25;.893;3564000;0
20383;155529;1854;0;0;0;0;.00nan;0;0
20384;13613;1869;68;42;4;38;.905;3559000;0
20384;179830;523;0;0;0;0;.00nan;0;0
20384;73973;1869;0;0;0;0;.00nan;0;0
20384;147264;523;52;16;2;14;.875;3600000;0
20385;174589;522;0;0;0;0;.00nan;0;0
20385;186520;522;54;27;4;23;.852;3600000;0
20385;64230;1861;0;0;0;0;.00nan;0;0
20385;152202;1861;46;29;5;24;.828;3561000;0
20386;7487;3922;69;53;6;47;.887;3600000;0
20386;68565;3922;0;0;0;0;.00nan;0;0
20386;76951;2193;64;18;1;17;.944;3600000;0
20386;86228;2193;0;0;0;0;.00nan;0;0
20387;7534;1481;84;28;1;27;.964;3600000;0
20387;206007;1481;0;0;0;0;.00nan;0;0
20387;185041;2173;73;37;3;34;.919;3579000;0
20387;62279;2173;0;0;0;0;.00nan;0;0
20388;6944;1477;0;0;0;0;.00nan;0;0
20388;13613;1869;89;32;1;31;.969;3565000;0
20388;62530;1477;100;27;0;27;1.000;3600000;0
20388;73973;1869;0;0;0;0;.00nan;0;0
20389;9373;1854;27;8;3;5;.625;566000;0
20389;174589;522;0;0;0;0;.00nan;0;0
20389;186520;522;99;42;1;41;.976;3600000;0
20389;155529;1854;71;23;2;21;.913;3034000;0
20390;6947;521;58;29;3;26;.897;3558000;0
20390;163695;1475;64;25;2;23;.920;3600000;0
20390;68627;1475;0;0;0;0;.00nan;0;0
20390;143036;521;0;0;0;0;.00nan;0;0
20391;-1;1871;64;27;3;24;.889;3586000;0
20391;64230;1861;100;42;1;41;.976;3600000;0
20391;67764;1871;0;0;0;0;.00nan;0;0
20391;152202;1861;0;0;0;0;.00nan;0;0
20392;164170;4560;63;45;5;40;.889;2813000;0
20392;179830;523;82;23;1;22;.957;3600000;0
20392;143421;4560;26;15;4;11;.733;787000;0
20392;147264;523;0;0;0;0;.00nan;0;0
20393;7534;1481;76;34;3;31;.912;3560000;0
20393;206007;1481;0;0;0;0;.00nan;0;0
20393;64230;1861;81;33;2;31;.939;3600000;0
20393;152202;1861;0;0;0;0;.00nan;0;0
20394;163695;1475;100;26;0;26;1.000;3600000;0
20394;-1;1871;71;25;2;23;.920;3555000;0
20394;67764;1871;0;0;0;0;.00nan;0;0
20394;68627;1475;0;0;0;0;.00nan;0;0
20395;185041;2173;78;46;4;42;.913;3596000;0
20395;62279;2173;0;0;0;0;.00nan;0;0
20395;76951;2193;0;0;0;0;.00nan;0;0
20395;86228;2193;48;21;3;18;.857;3600000;0
20396;6947;521;59;16;2;14;.875;3600000;0
20396;174589;522;0;0;0;0;.00nan;0;0
20396;186520;522;60;45;5;40;.889;3600000;0
20396;143036;521;0;0;0;0;.00nan;0;0
20397;6944;1477;0;0;0;0;.00nan;0;0
20397;9373;1854;63;38;4;34;.895;3600000;0
20397;62530;1477;47;18;3;15;.833;3600000;0
20397;155529;1854;0;0;0;0;.00nan;0;0
20398;164170;4560;0;0;0;0;.00nan;0;0
20398;13613;1869;79;24;1;23;.958;3678000;0
20398;73973;1869;0;0;0;0;.00nan;0;0
20398;143421;4560;79;30;2;28;.933;3678000;0
20399;7487;3922;61;32;3;29;.906;2480000;0
20399;179830;523;0;0;0;0;.00nan;0;0
20399;68565;3922;29;18;4;14;.778;1120000;0
20399;147264;523;45;13;2;11;.846;3600000;0
20400;7487;3922;66;35;4;31;.886;3600000;0
20400;9373;1854;68;33;3;30;.909;3600000;0
20400;68565;3922;0;0;0;0;.00nan;0;0
20400;155529;1854;0;0;0;0;.00nan;0;0
20401;164170;4560;48;29;4;25;.862;3900000;0
20401;185041;2173;0;0;0;0;.00nan;0;0
20401;62279;2173;49;30;4;26;.867;3900000;0
20401;143421;4560;0;0;0;0;.00nan;0;0
20402;-1;1871;0;0;0;0;.00nan;0;0
20402;67764;1871;72;25;1;24;.960;3629000;0
20402;76951;2193;0;0;0;0;.00nan;0;0
20402;86228;2193;82;30;2;28;.933;3629000;0
20403;6944;1477;0;0;0;0;.00nan;0;0
20403;179830;523;0;0;0;0;.00nan;0;0
20403;62530;1477;91;40;2;38;.950;3600000;0
20403;147264;523;85;39;3;36;.923;3600000;0
20404;13613;1869;66;34;3;31;.912;3600000;0
20404;174589;522;0;0;0;0;.00nan;0;0
20404;186520;522;57;33;4;29;.879;3560000;0
20404;73973;1869;0;0;0;0;.00nan;0;0
20405;7534;1481;80;27;1;26;.963;3600000;0
20405;163695;1475;12;27;7;20;.741;3600000;0
20405;206007;1481;0;0;0;0;.00nan;0;0
20405;68627;1475;0;0;0;0;.00nan;0;0
20406;6947;521;72;18;1;17;.944;3867000;0
20406;64230;1861;0;0;0;0;.00nan;0;0
20406;143036;521;0;0;0;0;.00nan;0;0
20406;152202;1861;85;39;2;37;.949;3867000;0
20407;6944;1477;0;0;0;0;.00nan;0;0
20407;7534;1481;80;33;3;30;.909;3600000;0
20407;206007;1481;0;0;0;0;.00nan;0;0
20407;62530;1477;40;21;4;17;.810;3563000;0
20408;174589;522;51;19;2;17;.895;1359000;0
20408;186520;522;27;23;6;17;.739;2241000;0
20408;76951;2193;0;0;0;0;.00nan;0;0
20408;86228;2193;67;19;1;18;.947;3600000;0
20409;6947;521;72;36;3;33;.917;3861000;0
20409;-1;1871;86;36;2;34;.944;3861000;0
20409;67764;1871;0;0;0;0;.00nan;0;0
20409;143036;521;0;0;0;0;.00nan;0;0
20410;9373;1854;0;0;0;0;.00nan;0;0
20410;64230;1861;40;33;6;27;.818;2817000;0
20410;152202;1861;60;7;0;7;1.000;783000;0
20410;155529;1854;69;20;2;18;.900;3600000;0
20411;163695;1475;61;30;3;27;.900;3561000;0
20411;13613;1869;70;23;2;21;.913;3600000;0
20411;68627;1475;0;0;0;0;.00nan;0;0
20411;73973;1869;0;0;0;0;.00nan;0;0
20412;185041;2173;93;48;3;45;.938;3600000;0
20412;179830;523;77;8;0;8;1.000;3600000;0
20412;62279;2173;0;0;0;0;.00nan;0;0
20412;147264;523;0;0;0;0;.00nan;0;0
20413;7487;3922;0;0;0;0;.00nan;0;0
20413;164170;4560;0;0;0;0;.00nan;0;0
20413;68565;3922;88;29;1;28;.966;3600000;0
20413;143421;4560;72;28;3;25;.893;3577000;0
20414;13613;1869;74;28;2;26;.929;3600000;0
20414;185041;2173;48;28;4;24;.857;3590000;0
20414;62279;2173;0;0;0;0;.00nan;0;0
20414;73973;1869;0;0;0;0;.00nan;0;0
20415;7534;1481;20;30;7;23;.767;3159000;0
20415;206007;1481;50;1;0;1;1.000;441000;0
20415;-1;1871;63;20;2;18;.900;3600000;0
20415;67764;1871;0;0;0;0;.00nan;0;0
20416;6947;521;0;0;0;0;.00nan;0;0
20416;9373;1854;98;36;1;35;.972;3600000;0
20416;143036;521;65;20;2;18;.900;3561000;0
20416;155529;1854;0;0;0;0;.00nan;0;0
20417;6944;1477;0;0;0;0;.00nan;0;0
20417;7487;3922;0;0;0;0;.00nan;0;0
20417;62530;1477;42;24;4;20;.833;3635000;0
20417;68565;3922;55;27;3;24;.889;3635000;0
20418;174589;522;21;3;3;0;.000;89000;0
20418;179830;523;50;19;3;16;.842;3600000;0
20418;186520;522;87;49;4;45;.918;3511000;0
20418;147264;523;0;0;0;0;.00nan;0;0
20419;163695;1475;59;23;3;20;.870;3600000;0
20419;164170;4560;0;0;0;0;.00nan;0;0
20419;68627;1475;0;0;0;0;.00nan;0;0
20419;143421;4560;73;40;4;36;.900;3577000;0
20420;64230;1861;0;0;0;0;.00nan;0;0
20420;76951;2193;0;0;0;0;.00nan;0;0
20420;86228;2193;66;20;2;18;.900;3600000;0
20420;152202;1861;55;48;6;42;.875;3600000;0
20421;7487;3922;76;36;3;33;.917;3600000;0
20421;185041;2173;100;28;0;28;1.000;3600000;0
20421;62279;2173;0;0;0;0;.00nan;0;0
20421;68565;3922;0;0;0;0;.00nan;0;0
20422;7534;1481;55;28;4;24;.857;3900000;0
20422;206007;1481;0;0;0;0;.00nan;0;0
20422;174589;522;0;0;0;0;.00nan;0;0
20422;186520;522;66;35;4;31;.886;3900000;0
20423;6947;521;82;27;2;25;.926;3563000;0
20423;76951;2193;0;0;0;0;.00nan;0;0
20423;86228;2193;96;30;1;29;.967;3600000;0
20423;143036;521;0;0;0;0;.00nan;0;0
20424;9373;1854;85;45;3;42;.933;3900000;0
20424;-1;1871;42;17;3;14;.824;3900000;0
20424;143063;1871;0;0;0;0;.00nan;0;0
20424;155529;1854;0;0;0;0;.00nan;0;0
20425;13613;1869;72;23;1;22;.957;3600000;0
20425;64230;1861;83;29;2;27;.931;3559000;0
20425;73973;1869;0;0;0;0;.00nan;0;0
20425;152202;1861;0;0;0;0;.00nan;0;0
20426;163695;1475;64;36;4;32;.889;3581000;0
20426;179830;523;0;0;0;0;.00nan;0;0
20426;68627;1475;0;0;0;0;.00nan;0;0
20426;147264;523;54;20;3;17;.850;3600000;0
20427;6944;1477;0;0;0;0;.00nan;0;0
20427;164170;4560;0;0;0;0;.00nan;0;0
20427;62530;1477;84;17;0;17;1.000;3600000;0
20427;143421;4560;72;40;4;36;.900;3600000;0
20428;6944;1477;0;0;0;0;.00nan;0;0
20428;185041;2173;68;37;3;34;.919;3600000;0
20428;62279;2173;0;0;0;0;.00nan;0;0
20428;62530;1477;42;20;4;16;.800;3545000;0
20429;13613;1869;72;31;2;29;.935;3580000;0
20429;-1;1871;78;24;1;23;.958;3600000;0
20429;73973;1869;0;0;0;0;.00nan;0;0
20429;143063;1871;0;0;0;0;.00nan;0;0
20430;6947;521;63;24;3;21;.875;3524000;0
20430;7534;1481;100;42;1;41;.976;3600000;0
20430;206007;1481;0;0;0;0;.00nan;0;0
20430;143036;521;0;0;0;0;.00nan;0;0
20431;9373;1854;94;39;1;38;.974;3611000;0
20431;76951;2193;0;0;0;0;.00nan;0;0
20431;86228;2193;86;15;0;15;1.000;3611000;0
20431;155529;1854;0;0;0;0;.00nan;0;0
20432;164170;4560;0;0;0;0;.00nan;0;0
20432;174589;522;0;0;0;0;.00nan;0;0
20432;186520;522;69;21;1;20;.952;3600000;0
20432;143421;4560;66;25;2;23;.920;3600000;0
20433;7487;3922;78;36;2;34;.944;3569000;0
20433;163695;1475;89;18;0;18;1.000;3600000;0
20433;68565;3922;0;0;0;0;.00nan;0;0
20433;68627;1475;0;0;0;0;.00nan;0;0
20434;179830;523;0;0;0;0;.00nan;0;0
20434;64230;1861;0;0;0;0;.00nan;0;0
20434;147264;523;66;19;2;17;.895;3900000;0
20434;152202;1861;97;53;2;51;.962;3892000;0
20435;7487;3922;0;0;0;0;.00nan;0;0
20435;64230;1861;49;28;4;24;.857;3551000;0
20435;68565;3922;73;20;2;18;.900;3600000;0
20435;152202;1861;0;0;0;0;.00nan;0;0
20436;7534;1481;69;49;5;44;.898;3600000;0
20436;206007;1481;0;0;0;0;.00nan;0;0
20436;76951;2193;0;0;0;0;.00nan;0;0
20436;86228;2193;76;25;1;24;.960;3600000;0
20437;163695;1475;54;17;2;15;.882;3600000;0
20437;185041;2173;56;6;0;6;1.000;1460000;0
20437;62279;2173;33;23;5;18;.783;2140000;0
20437;68627;1475;0;0;0;0;.00nan;0;0
20438;6944;1477;0;0;0;0;.00nan;0;0
20438;174589;522;0;0;0;0;.00nan;0;0
20438;186520;522;66;45;4;41;.911;3571000;0
20438;62530;1477;78;28;2;26;.929;3600000;0
20439;9373;1854;93;41;3;38;.927;3900000;0
20439;13613;1869;64;22;3;19;.864;3900000;0
20439;73973;1869;0;0;0;0;.00nan;0;0
20439;155529;1854;0;0;0;0;.00nan;0;0
20440;179830;523;57;21;2;19;.905;3600000;0
20440;-1;1871;87;31;1;30;.968;3600000;0
20440;143063;1871;0;0;0;0;.00nan;0;0
20440;147264;523;0;0;0;0;.00nan;0;0
20441;6947;521;61;24;3;21;.875;3584000;0
20441;164170;4560;0;0;0;0;.00nan;0;0
20441;143036;521;0;0;0;0;.00nan;0;0
20441;143421;4560;93;44;2;42;.955;3600000;0
20442;185041;2173;80;40;3;37;.925;3674000;0
20442;-1;1871;82;27;2;25;.926;3674000;0
20442;62279;2173;0;0;0;0;.00nan;0;0
20442;143063;1871;0;0;0;0;.00nan;0;0
20443;179830;523;0;0;0;0;.00nan;0;0
20443;76951;2193;0;0;0;0;.00nan;0;0
20443;86228;2193;68;36;4;32;.889;3578000;0
20443;147264;523;66;29;3;26;.897;3600000;0
20444;6947;521;0;0;0;0;.00nan;0;0
20444;13613;1869;62;54;7;47;.870;3025000;0
20444;73973;1869;59;7;0;7;1.000;575000;0
20444;143036;521;71;21;1;20;.952;3600000;0
20445;7534;1481;65;17;1;16;.941;3600000;0
20445;9373;1854;0;0;0;0;.00nan;0;0
20445;206007;1481;0;0;0;0;.00nan;0;0
20445;155529;1854;75;28;2;26;.929;3600000;0
20446;7487;3922;0;0;0;0;.00nan;0;0
20446;174589;522;0;0;0;0;.00nan;0;0
20446;186520;522;92;19;0;19;1.000;3600000;0
20446;68565;3922;98;43;1;42;.977;3553000;0
20447;6944;1477;0;0;0;0;.00nan;0;0
20447;163695;1475;81;35;2;33;.943;3600000;0
20447;62530;1477;46;25;4;21;.840;3574000;0
20447;68627;1475;0;0;0;0;.00nan;0;0
20448;164170;4560;0;0;0;0;.00nan;0;0
20448;64230;1861;0;0;0;0;.00nan;0;0
20448;143421;4560;82;35;2;33;.943;3540000;0
20448;152202;1861;100;34;0;34;1.000;3600000;0
20449;7487;3922;65;48;5;43;.896;3547000;0
20449;-1;1871;60;23;3;20;.870;3600000;0
20449;68565;3922;0;0;0;0;.00nan;0;0
20449;143063;1871;0;0;0;0;.00nan;0;0
20450;185041;2173;74;42;4;38;.905;3585000;0
20450;62279;2173;0;0;0;0;.00nan;0;0
20450;64230;1861;79;34;3;31;.912;3600000;0
20450;152202;1861;0;0;0;0;.00nan;0;0
20451;6944;1477;99;37;1;36;.973;3600000;0
20451;6947;521;72;28;3;25;.893;3523000;0
20451;62530;1477;0;0;0;0;.00nan;0;0
20451;143036;521;0;0;0;0;.00nan;0;0
20452;7534;1481;71;37;4;33;.892;3600000;0
20452;13613;1869;23;14;5;9;.643;3548000;0
20452;206007;1481;0;0;0;0;.00nan;0;0
20452;73973;1869;0;0;0;0;.00nan;0;0
20453;163695;1475;71;30;2;28;.933;3596000;0
20453;174589;522;0;0;0;0;.00nan;0;0
20453;186520;522;99;45;1;44;.978;3600000;0
20453;68627;1475;0;0;0;0;.00nan;0;0
20454;9373;1854;63;41;5;36;.878;3600000;0
20454;179830;523;0;0;0;0;.00nan;0;0
20454;147264;523;98;20;1;19;.950;3600000;0
20454;155529;1854;0;0;0;0;.00nan;0;0
20455;164170;4560;0;0;0;0;.00nan;0;0
20455;76951;2193;0;0;0;0;.00nan;0;0
20455;86228;2193;56;17;2;15;.882;3600000;0
20455;143421;4560;80;48;4;44;.917;3600000;0
20456;7534;1481;71;30;3;27;.900;3559000;0
20456;206007;1481;0;0;0;0;.00nan;0;0
20456;179830;523;0;0;0;0;.00nan;0;0
20456;147264;523;71;17;1;16;.941;3600000;0
20457;164170;4560;0;0;0;0;.00nan;0;0
20457;-1;1871;0;0;0;0;.00nan;0;0
20457;143063;1871;63;20;2;18;.900;3600000;0
20457;143421;4560;86;43;3;40;.930;3600000;0
20458;13613;1869;64;24;3;21;.875;3600000;0
20458;73973;1869;0;0;0;0;.00nan;0;0
20458;76951;2193;0;0;0;0;.00nan;0;0
20458;86228;2193;96;22;0;22;1.000;3600000;0
20459;6947;521;69;20;1;19;.950;3600000;0
20459;7487;3922;0;0;0;0;.00nan;0;0
20459;68565;3922;80;34;2;32;.941;3542000;0
20459;143036;521;0;0;0;0;.00nan;0;0
20460;163695;1475;65;18;1;17;.944;3600000;0
20460;9373;1854;0;0;0;0;.00nan;0;0
20460;68627;1475;0;0;0;0;.00nan;0;0
20460;155529;1854;70;35;4;31;.886;3600000;0
20461;174589;522;0;0;0;0;.00nan;0;0
20461;185041;2173;87;39;4;35;.897;3822000;0
20461;186520;522;83;40;3;37;.925;3822000;0
20461;62279;2173;0;0;0;0;.00nan;0;0
20462;6944;1477;0;0;0;0;.00nan;0;0
20462;62530;1477;46;27;4;23;.852;3600000;0
20462;64230;1861;0;0;0;0;.00nan;0;0
20462;152202;1861;83;47;3;44;.936;3600000;0
20463;7534;1481;72;18;1;17;.944;3600000;0
20463;164170;4560;0;0;0;0;.00nan;0;0
20463;206007;1481;0;0;0;0;.00nan;0;0
20463;143421;4560;63;29;4;25;.862;3600000;0
20464;174589;522;0;0;0;0;.00nan;0;0
20464;186520;522;82;35;3;32;.914;3600000;0
20464;-1;1871;41;30;5;25;.833;3545000;0
20464;143063;1871;0;0;0;0;.00nan;0;0
20465;6944;1477;0;0;0;0;.00nan;0;0
20465;62530;1477;87;29;1;28;.966;3600000;0
20465;76951;2193;0;0;0;0;.00nan;0;0
20465;86228;2193;52;19;2;17;.895;3584000;0
20466;6947;521;98;39;2;37;.949;3600000;0
20466;179830;523;61;28;3;25;.893;3570000;0
20466;143036;521;0;0;0;0;.00nan;0;0
20466;147264;523;0;0;0;0;.00nan;0;0
20467;9373;1854;71;34;3;31;.912;3593000;0
20467;185041;2173;67;22;1;21;.955;3600000;0
20467;62279;2173;0;0;0;0;.00nan;0;0
20467;155529;1854;0;0;0;0;.00nan;0;0
20468;7487;3922;90;30;2;28;.933;3900000;0
20468;13613;1869;64;17;2;15;.882;3900000;0
20468;68565;3922;0;0;0;0;.00nan;0;0
20468;73973;1869;0;0;0;0;.00nan;0;0
20469;163695;1475;70;17;1;16;.941;3600000;0
20469;64230;1861;51;33;5;28;.848;3600000;0
20469;68627;1475;0;0;0;0;.00nan;0;0
20469;152202;1861;0;0;0;0;.00nan;0;0
20470;7487;3922;43;15;3;12;.800;3571000;0
20470;7534;1481;80;23;1;22;.957;3600000;0
20470;206007;1481;0;0;0;0;.00nan;0;0
20470;68565;3922;0;0;0;0;.00nan;0;0
20471;6947;521;0;0;0;0;.00nan;0;0
20471;185041;2173;75;35;3;32;.914;3600000;0
20471;62279;2173;0;0;0;0;.00nan;0;0
20471;143036;521;50;26;4;22;.846;3577000;0
20472;6944;1477;0;0;0;0;.00nan;0;0
20472;-1;1871;68;26;2;24;.923;3575000;0
20472;62530;1477;95;23;0;23;1.000;3600000;0
20472;143063;1871;0;0;0;0;.00nan;0;0
20473;174589;522;0;0;0;0;.00nan;0;0
20473;186520;522;60;27;3;24;.889;3724000;0
20473;64230;1861;0;0;0;0;.00nan;0;0
20473;152202;1861;80;42;4;38;.905;3724000;0
20474;163695;1475;0;0;0;0;.00nan;0;0
20474;68627;1475;75;32;3;29;.906;3600000;0
20474;76951;2193;0;0;0;0;.00nan;0;0
20474;86228;2193;100;26;0;26;1.000;3600000;0
20475;13613;1869;68;37;4;33;.892;3600000;0
20475;179830;523;0;0;0;0;.00nan;0;0
20475;73973;1869;0;0;0;0;.00nan;0;0
20475;147264;523;73;27;3;24;.889;3600000;0
20476;9373;1854;89;40;1;39;.975;3581000;0
20476;164170;4560;100;24;0;24;1.000;3600000;0
20476;143421;4560;0;0;0;0;.00nan;0;0
20476;155529;1854;0;0;0;0;.00nan;0;0
20477;7534;1481;86;30;1;29;.967;3600000;0
20477;206007;1481;0;0;0;0;.00nan;0;0
20477;185041;2173;60;34;4;30;.882;3600000;0
20477;62279;2173;0;0;0;0;.00nan;0;0
20478;-1;1871;58;24;3;21;.875;3600000;0
20478;64230;1861;51;33;6;27;.818;2720000;0
20478;143063;1871;0;0;0;0;.00nan;0;0
20478;152202;1861;55;5;0;5;1.000;880000;0
20479;7487;3922;0;0;0;0;.00nan;0;0
20479;68565;3922;55;38;5;33;.868;3600000;0
20479;76951;2193;0;0;0;0;.00nan;0;0
20479;86228;2193;73;6;0;6;1.000;3600000;0
20480;6947;521;69;34;4;30;.882;3782000;0
20480;163695;1475;58;36;5;31;.861;3766000;0
20480;68627;1475;0;0;0;0;.00nan;0;0
20480;143036;521;0;0;0;0;.00nan;0;0
20481;9373;1854;0;0;0;0;.00nan;0;0
20481;174589;522;0;0;0;0;.00nan;0;0
20481;186520;522;76;34;3;31;.912;3900000;0
20481;155529;1854;72;30;3;27;.900;3900000;0
20482;6944;1477;0;0;0;0;.00nan;0;0
20482;13613;1869;0;0;0;0;.00nan;0;0
20482;62530;1477;93;31;1;30;.968;3600000;0
20482;73973;1869;56;35;4;31;.886;3600000;0
20483;164170;4560;58;44;5;39;.886;3600000;0
20483;179830;523;66;23;2;21;.913;3600000;0
20483;143421;4560;0;0;0;0;.00nan;0;0
20483;147264;523;0;0;0;0;.00nan;0;0
20484;7487;3922;78;40;4;36;.900;3600000;0
20484;179830;523;0;0;0;0;.00nan;0;0
20484;68565;3922;0;0;0;0;.00nan;0;0
20484;147264;523;79;12;0;12;1.000;3600000;0
20485;185041;2173;100;54;2;52;.963;3710000;0
20485;62279;2173;0;0;0;0;.00nan;0;0
20485;76951;2193;0;0;0;0;.00nan;0;0
20485;86228;2193;54;22;3;19;.864;3710000;0
20486;6944;1477;0;0;0;0;.00nan;0;0
20486;9373;1854;84;41;2;39;.951;3600000;0
20486;62530;1477;92;20;0;20;1.000;3600000;0
20486;155529;1854;0;0;0;0;.00nan;0;0
20487;6947;521;62;16;1;15;.938;3600000;0
20487;174589;522;0;0;0;0;.00nan;0;0
20487;186520;522;73;31;2;29;.935;3554000;0
20487;143036;521;0;0;0;0;.00nan;0;0
20488;163695;1475;88;35;1;34;.971;3600000;0
20488;-1;1871;59;24;3;21;.875;3527000;0
20488;68627;1475;0;0;0;0;.00nan;0;0
20488;143063;1871;0;0;0;0;.00nan;0;0
20489;7534;1481;78;34;2;32;.941;3544000;0
20489;206007;1481;0;0;0;0;.00nan;0;0
20489;64230;1861;0;0;0;0;.00nan;0;0
20489;152202;1861;79;28;1;27;.964;3600000;0
20490;164170;4560;0;0;0;0;.00nan;0;0
20490;13613;1869;71;16;1;15;.938;3600000;0
20490;73973;1869;0;0;0;0;.00nan;0;0
20490;143421;4560;53;29;4;25;.862;3600000;0
20491;7534;1481;83;38;3;35;.921;3600000;0
20491;163695;1475;100;32;0;32;1.000;3600000;0
20491;206007;1481;0;0;0;0;.00nan;0;0
20491;68627;1475;0;0;0;0;.00nan;0;0
20492;-1;1871;56;33;4;29;.879;3600000;0
20492;76951;2193;0;0;0;0;.00nan;0;0
20492;86228;2193;100;19;0;19;1.000;3600000;0
20492;143063;1871;0;0;0;0;.00nan;0;0
20493;6947;521;0;0;0;0;.00nan;0;0
20493;64230;1861;77;50;5;45;.900;3600000;0
20493;143036;521;65;15;1;14;.933;3600000;0
20493;152202;1861;0;0;0;0;.00nan;0;0
20494;7487;3922;0;0;0;0;.00nan;0;0
20494;9373;1854;80;25;1;24;.960;3900000;0
20494;68565;3922;88;31;1;30;.968;3900000;0
20494;155529;1854;0;0;0;0;.00nan;0;0
20495;13613;1869;91;16;0;16;1.000;3600000;0
20495;174589;522;0;0;0;0;.00nan;0;0
20495;186520;522;44;16;3;13;.813;3600000;0
20495;73973;1869;0;0;0;0;.00nan;0;0
20496;6944;1477;0;0;0;0;.00nan;0;0
20496;179830;523;0;0;0;0;.00nan;0;0
20496;62530;1477;72;39;4;35;.897;3600000;0
20496;147264;523;84;17;0;17;1.000;3600000;0
20497;164170;4560;0;0;0;0;.00nan;0;0
20497;185041;2173;57;22;3;19;.864;3575000;0
20497;62279;2173;0;0;0;0;.00nan;0;0
20497;143421;4560;93;31;1;30;.968;3600000;0
20498;7487;3922;81;26;1;25;.962;3600000;0
20498;164170;4560;0;0;0;0;.00nan;0;0
20498;68565;3922;0;0;0;0;.00nan;0;0
20498;143421;4560;68;26;2;24;.923;3600000;0
20499;185041;2173;0;0;0;0;.00nan;0;0
20499;179830;523;0;0;0;0;.00nan;0;0
20499;62279;2173;66;36;4;32;.889;3600000;0
20499;147264;523;75;9;0;9;1.000;3600000;0
20500;6947;521;92;34;1;33;.971;3600000;0
20500;-1;1871;82;30;2;28;.933;3600000;0
20500;143036;521;0;0;0;0;.00nan;0;0
20500;143063;1871;0;0;0;0;.00nan;0;0
20501;6944;1477;0;0;0;0;.00nan;0;0
20501;7534;1481;85;43;3;40;.930;3570000;0
20501;206007;1481;0;0;0;0;.00nan;0;0
20501;62530;1477;81;24;1;23;.958;3600000;0
20502;174589;522;0;0;0;0;.00nan;0;0
20502;186520;522;95;34;1;33;.971;3591000;0
20502;76951;2193;0;0;0;0;.00nan;0;0
20502;86228;2193;97;16;0;16;1.000;3600000;0
20503;163695;1475;99;39;1;38;.974;3600000;0
20503;13613;1869;45;28;5;23;.821;3600000;0
20503;68627;1475;0;0;0;0;.00nan;0;0
20503;73973;1869;0;0;0;0;.00nan;0;0
20504;9373;1854;95;21;0;21;1.000;3600000;0
20504;64230;1861;0;0;0;0;.00nan;0;0
20504;152202;1861;49;18;2;16;.889;3583000;0
20504;155529;1854;0;0;0;0;.00nan;0;0
20505;6944;1477;0;0;0;0;.00nan;0;0
20505;7487;3922;0;0;0;0;.00nan;0;0
20505;62530;1477;65;32;3;29;.906;3720000;0
20505;68565;3922;58;36;4;32;.889;3720000;0
20506;7534;1481;0;0;0;0;.00nan;0;0
20506;206007;1481;66;22;2;20;.909;3600000;0
20506;-1;1871;37;27;4;23;.852;3600000;0
20506;143063;1871;0;0;0;0;.00nan;0;0
20507;64230;1861;89;43;2;41;.953;3900000;0
20507;76951;2193;0;0;0;0;.00nan;0;0
20507;86228;2193;64;16;2;14;.875;3900000;0
20507;152202;1861;0;0;0;0;.00nan;0;0
20508;6947;521;49;31;5;26;.839;3550000;0
20508;9373;1854;65;27;3;24;.889;3600000;0
20508;143036;521;0;0;0;0;.00nan;0;0
20508;155529;1854;0;0;0;0;.00nan;0;0
20509;13613;1869;87;31;1;30;.968;3600000;0
20509;185041;2173;72;29;2;27;.931;3561000;0
20509;62279;2173;0;0;0;0;.00nan;0;0
20509;73973;1869;0;0;0;0;.00nan;0;0
20510;174589;522;0;0;0;0;.00nan;0;0
20510;179830;523;0;0;0;0;.00nan;0;0
20510;186520;522;98;48;4;44;.917;3589000;0
20510;147264;523;49;14;2;12;.857;3600000;0
20511;163695;1475;36;13;3;10;.769;3522000;0
20511;164170;4560;0;0;0;0;.00nan;0;0
20511;68627;1475;0;0;0;0;.00nan;0;0
20511;143421;4560;100;64;1;63;.984;3600000;0
20512;7487;3922;0;0;0;0;.00nan;0;0
20512;185041;2173;75;31;2;29;.935;3548000;0
20512;62279;2173;0;0;0;0;.00nan;0;0
20512;68565;3922;62;15;1;14;.933;3600000;0
20513;9373;1854;70;25;2;23;.920;3600000;0
20513;-1;1871;0;0;0;0;.00nan;0;0
20513;143063;1871;46;18;3;15;.833;3600000;0
20513;155529;1854;0;0;0;0;.00nan;0;0
20514;6947;521;90;33;1;32;.970;3600000;0
20514;76951;2193;0;0;0;0;.00nan;0;0
20514;86228;2193;52;16;2;14;.875;3586000;0
20514;143036;521;0;0;0;0;.00nan;0;0
20515;6944;1477;0;0;0;0;.00nan;0;0
20515;164170;4560;0;0;0;0;.00nan;0;0
20515;62530;1477;72;21;1;20;.952;3600000;0
20515;143421;4560;85;34;3;31;.912;3546000;0
20516;7534;1481;47;21;3;18;.857;3600000;0
20516;206007;1481;0;0;0;0;.00nan;0;0
20516;174589;522;0;0;0;0;.00nan;0;0
20516;186520;522;56;40;5;35;.875;3578000;0
20517;163695;1475;83;48;4;44;.917;3600000;0
20517;179830;523;0;0;0;0;.00nan;0;0
20517;68627;1475;0;0;0;0;.00nan;0;0
20517;147264;523;82;28;1;27;.964;3600000;0
20518;13613;1869;0;0;0;0;.00nan;0;0
20518;64230;1861;87;41;2;39;.951;3600000;0
20518;73973;1869;34;16;4;12;.750;3514000;0
20518;152202;1861;0;0;0;0;.00nan;0;0
20519;7487;3922;0;0;0;0;.00nan;0;0
20519;163695;1475;64;15;1;14;.933;3600000;0
20519;68565;3922;91;44;3;41;.932;3600000;0
20519;68627;1475;0;0;0;0;.00nan;0;0
20520;6947;521;23;23;6;17;.739;3564000;0
20520;7534;1481;58;33;4;29;.879;3600000;0
20520;206007;1481;0;0;0;0;.00nan;0;0
20520;143036;521;0;0;0;0;.00nan;0;0
20521;9373;1854;95;53;5;48;.906;3600000;0
20521;76951;2193;65;23;2;21;.913;3600000;0
20521;86228;2193;0;0;0;0;.00nan;0;0
20521;155529;1854;0;0;0;0;.00nan;0;0
20522;6944;1477;0;0;0;0;.00nan;0;0
20522;185041;2173;58;33;4;29;.879;3593000;0
20522;62279;2173;0;0;0;0;.00nan;0;0
20522;62530;1477;68;27;3;24;.889;3600000;0
20523;13613;1869;69;29;2;27;.931;3600000;0
20523;-1;1871;44;29;5;24;.828;3600000;0
20523;73973;1869;0;0;0;0;.00nan;0;0
20523;143063;1871;0;0;0;0;.00nan;0;0
20524;179830;523;92;14;0;14;1.000;3600000;0
20524;64230;1861;88;53;5;48;.906;3600000;0
20524;147264;523;0;0;0;0;.00nan;0;0
20524;152202;1861;0;0;0;0;.00nan;0;0
20525;164170;4560;0;0;0;0;.00nan;0;0
20525;174589;522;0;0;0;0;.00nan;0;0
20525;186520;522;42;16;3;13;.813;3631000;0
20525;143421;4560;70;32;2;30;.938;3631000;0
20526;179830;523;45;26;5;21;.808;3600000;0
20526;-1;1871;41;36;6;30;.833;3600000;0
20526;143063;1871;0;0;0;0;.00nan;0;0
20526;147264;523;0;0;0;0;.00nan;0;0
20527;7534;1481;74;22;1;21;.955;3900000;0
20527;206007;1481;0;0;0;0;.00nan;0;0
20527;76951;2193;0;0;0;0;.00nan;0;0
20527;86228;2193;60;15;1;14;.933;3900000;0
20528;6947;521;0;0;0;0;.00nan;0;0
20528;164170;4560;0;0;0;0;.00nan;0;0
20528;143036;521;93;17;0;17;1.000;3600000;0
20528;143421;4560;98;53;1;52;.981;3571000;0
20529;9373;1854;90;32;1;31;.969;3600000;0
20529;13613;1869;54;14;2;12;.857;3546000;0
20529;73973;1869;0;0;0;0;.00nan;0;0
20529;155529;1854;0;0;0;0;.00nan;0;0
20530;6944;1477;0;0;0;0;.00nan;0;0
20530;174589;522;0;0;0;0;.00nan;0;0
20530;186520;522;82;41;3;38;.927;3600000;0
20530;62530;1477;32;22;5;17;.773;3560000;0
20531;1072;1475;0;0;0;0;.00nan;0;0
20531;163695;1475;93;14;0;14;1.000;3600000;0
20531;185041;2173;82;39;3;36;.923;3600000;0
20531;62279;2173;0;0;0;0;.00nan;0;0
20532;7487;3922;0;0;0;0;.00nan;0;0
20532;64230;1861;0;0;0;0;.00nan;0;0
20532;68565;3922;58;30;3;27;.900;3600000;0
20532;152202;1861;80;25;1;24;.960;3600000;0
20533;7487;3922;0;0;0;0;.00nan;0;0
20533;174589;522;0;0;0;0;.00nan;0;0
20533;186520;522;87;26;1;25;.962;3600000;0
20533;68565;3922;65;30;3;27;.900;3517000;0
20534;7534;1481;59;27;3;24;.889;3600000;0
20534;9373;1854;100;30;0;30;1.000;3600000;0
20534;206007;1481;0;0;0;0;.00nan;0;0
20534;155529;1854;0;0;0;0;.00nan;0;0
20535;185041;2173;39;38;6;32;.842;3079000;0
20535;-1;1871;47;20;4;16;.800;3600000;0
20535;62279;2173;48;0;0;0;.00nan;521000;0
20535;143063;1871;0;0;0;0;.00nan;0;0
20536;1072;1475;0;0;0;0;.00nan;0;0
20536;6944;1477;0;0;0;0;.00nan;0;0
20536;163695;1475;88;42;3;39;.929;3589000;0
20536;62530;1477;56;20;2;18;.900;3600000;0
20537;6947;521;0;0;0;0;.00nan;0;0
20537;13613;1869;57;34;5;29;.853;3600000;0
20537;73973;1869;0;0;0;0;.00nan;0;0
20537;143036;521;75;32;2;30;.938;3600000;0
20538;179830;523;75;32;3;29;.906;3600000;0
20538;76951;2193;0;0;0;0;.00nan;0;0
20538;86228;2193;58;35;5;30;.857;3572000;0
20538;147264;523;0;0;0;0;.00nan;0;0
20539;164170;4560;79;29;2;27;.931;3596000;0
20539;64230;1861;90;33;1;32;.970;3600000;0
20539;143421;4560;0;0;0;0;.00nan;0;0
20539;152202;1861;0;0;0;0;.00nan;0;0
20540;7534;1481;77;25;1;24;.960;3600000;0
20540;13613;1869;61;35;4;31;.886;3600000;0
20540;206007;1481;0;0;0;0;.00nan;0;0
20540;73973;1869;0;0;0;0;.00nan;0;0
20541;7487;3922;0;0;0;0;.00nan;0;0
20541;-1;1871;79;13;0;13;1.000;3600000;0
20541;68565;3922;87;50;3;47;.940;3600000;0
20541;143063;1871;0;0;0;0;.00nan;0;0
20542;164170;4560;0;0;0;0;.00nan;0;0
20542;76951;2193;0;0;0;0;.00nan;0;0
20542;86228;2193;53;11;2;9;.818;3600000;0
20542;143421;4560;81;60;6;54;.900;3600000;0
20543;6944;1477;0;0;0;0;.00nan;0;0
20543;6947;521;70;25;2;23;.920;3600000;0
20543;62530;1477;80;38;3;35;.921;3577000;0
20543;143036;521;0;0;0;0;.00nan;0;0
20544;9373;1854;74;48;4;44;.917;3535000;0
20544;179830;523;0;0;0;0;.00nan;0;0
20544;147264;523;44;12;2;10;.833;3600000;0
20544;155529;1854;0;0;0;0;.00nan;0;0
20545;1072;1475;0;0;0;0;.00nan;0;0
20545;163695;1475;42;23;4;19;.826;3553000;0
20545;174589;522;0;0;0;0;.00nan;0;0
20545;186520;522;72;36;3;33;.917;3600000;0
20546;185041;2173;87;38;3;35;.921;3600000;0
20546;62279;2173;0;0;0;0;.00nan;0;0
20546;64230;1861;93;22;0;22;1.000;3600000;0
20546;152202;1861;0;0;0;0;.00nan;0;0
20547;6947;521;48;15;3;12;.800;3600000;0
20547;7487;3922;29;30;6;24;.800;3088000;0
20547;68565;3922;49;2;0;2;1.000;512000;0
20547;143036;521;0;0;0;0;.00nan;0;0
20548;174589;522;0;0;0;0;.00nan;0;0
20548;185041;2173;77;32;3;29;.906;3593000;0
20548;186520;522;99;36;1;35;.972;3600000;0
20548;62279;2173;0;0;0;0;.00nan;0;0
20549;6944;1477;0;0;0;0;.00nan;0;0
20549;62530;1477;92;18;0;18;1.000;3600000;0
20549;64230;1861;72;40;3;37;.925;3600000;0
20549;152202;1861;0;0;0;0;.00nan;0;0
20550;13613;1869;0;0;0;0;.00nan;0;0
20550;73973;1869;80;41;3;38;.927;3900000;0
20550;76951;2193;0;0;0;0;.00nan;0;0
20550;86228;2193;69;29;3;26;.897;3900000;0
20551;1072;1475;0;0;0;0;.00nan;0;0
20551;163695;1475;51;23;4;19;.826;3547000;0
20551;9373;1854;83;44;3;41;.932;3600000;0
20551;155529;1854;0;0;0;0;.00nan;0;0
20552;7534;1481;47;35;6;29;.829;3600000;0
20552;206007;1481;0;0;0;0;.00nan;0;0
20552;179830;523;0;0;0;0;.00nan;0;0
20552;147264;523;73;16;1;15;.938;3600000;0
20553;164170;4560;0;0;0;0;.00nan;0;0
20553;-1;1871;85;23;1;22;.957;3600000;0
20553;143063;1871;0;0;0;0;.00nan;0;0
20553;143421;4560;89;50;4;46;.920;3600000;0
20554;7487;3922;0;0;0;0;.00nan;0;0
20554;13613;1869;69;16;1;15;.938;3600000;0
20554;68565;3922;84;42;2;40;.952;3583000;0
20554;73973;1869;0;0;0;0;.00nan;0;0
20555;9373;1854;81;25;1;24;.960;3600000;0
20555;185041;2173;100;35;0;35;1.000;3600000;0
20555;62279;2173;0;0;0;0;.00nan;0;0
20555;155529;1854;0;0;0;0;.00nan;0;0
20556;6944;1477;46;5;1;4;.800;673000;0
20556;62530;1477;58;43;6;37;.860;2927000;0
20556;76951;2193;0;0;0;0;.00nan;0;0
20556;86228;2193;63;23;2;21;.913;3600000;0
20557;174589;522;0;0;0;0;.00nan;0;0
20557;186520;522;97;45;2;43;.956;3567000;0
20557;-1;1871;77;22;1;21;.955;3600000;0
20557;143063;1871;0;0;0;0;.00nan;0;0
20558;1072;1475;0;0;0;0;.00nan;0;0
20558;163695;1475;60;25;4;21;.840;3900000;0
20558;64230;1861;69;43;4;39;.907;3853000;0
20558;152202;1861;0;0;0;0;.00nan;0;0
20559;6947;521;82;33;2;31;.939;3600000;0
20559;179830;523;0;0;0;0;.00nan;0;0
20559;143036;521;0;0;0;0;.00nan;0;0
20559;147264;523;66;31;3;28;.903;3544000;0
20560;7534;1481;71;19;1;18;.947;3900000;0
20560;164170;4560;0;0;0;0;.00nan;0;0
20560;206007;1481;0;0;0;0;.00nan;0;0
20560;143421;4560;91;34;1;33;.971;3900000;0
20561;7487;3922;0;0;0;0;.00nan;0;0
20561;7534;1481;75;22;1;21;.955;3600000;0
20561;206007;1481;0;0;0;0;.00nan;0;0
20561;68565;3922;77;30;2;28;.933;3600000;0
20562;6944;1477;0;0;0;0;.00nan;0;0
20562;-1;1871;0;0;0;0;.00nan;0;0
20562;62530;1477;68;31;3;28;.903;3600000;0
20562;143063;1871;32;22;5;17;.773;3541000;0
20563;1072;1475;0;0;0;0;.00nan;0;0
20563;163695;1475;98;42;2;40;.952;3564000;0
20563;76951;2193;0;0;0;0;.00nan;0;0
20563;86228;2193;69;20;1;19;.950;3600000;0
20564;6947;521;55;27;3;24;.889;3519000;0
20564;185041;2173;99;36;1;35;.972;3600000;0
20564;62279;2173;0;0;0;0;.00nan;0;0
20564;143036;521;0;0;0;0;.00nan;0;0
20565;9373;1854;0;0;0;0;.00nan;0;0
20565;164170;4560;0;0;0;0;.00nan;0;0
20565;143421;4560;35;26;5;21;.808;3600000;0
20565;155529;1854;85;32;2;30;.938;3600000;0
20566;13613;1869;41;28;5;23;.821;2262000;0
20566;179830;523;0;0;0;0;.00nan;0;0
20566;73973;1869;54;9;1;8;.889;1338000;0
20566;147264;523;45;18;3;15;.833;3600000;0
20567;174589;522;0;0;0;0;.00nan;0;0
20567;186520;522;100;32;0;32;1.000;3600000;0
20567;64230;1861;0;0;0;0;.00nan;0;0
20567;152202;1861;63;24;2;22;.917;3523000;0
20568;7487;3922;0;0;0;0;.00nan;0;0
20568;68565;3922;97;49;3;46;.939;3600000;0
20568;76951;2193;0;0;0;0;.00nan;0;0
20568;86228;2193;77;16;1;15;.938;3600000;0
20569;7534;1481;95;31;1;30;.968;3600000;0
20569;206007;1481;0;0;0;0;.00nan;0;0
20569;185041;2173;85;33;3;30;.909;3514000;0
20569;62279;2173;0;0;0;0;.00nan;0;0
20570;6944;1477;100;25;0;25;1.000;3600000;0
20570;13613;1869;0;0;0;0;.00nan;0;0
20570;62530;1477;0;0;0;0;.00nan;0;0
20570;73973;1869;97;33;1;32;.970;3584000;0
20571;9373;1854;84;36;2;34;.944;3600000;0
20571;174589;522;0;0;0;0;.00nan;0;0
20571;186520;522;52;36;5;31;.861;3600000;0
20571;155529;1854;0;0;0;0;.00nan;0;0
20572;1072;1475;0;0;0;0;.00nan;0;0
20572;6947;521;60;25;3;22;.880;3537000;0
20572;163695;1475;99;41;1;40;.976;3600000;0
20572;143036;521;0;0;0;0;.00nan;0;0
20573;-1;1871;71;25;2;23;.920;3600000;0
20573;64230;1861;66;40;4;36;.900;3548000;0
20573;143063;1871;0;0;0;0;.00nan;0;0
20573;152202;1861;0;0;0;0;.00nan;0;0
20574;164170;4560;0;0;0;0;.00nan;0;0
20574;179830;523;0;0;0;0;.00nan;0;0
20574;143421;4560;83;56;5;51;.911;3600000;0
20574;147264;523;57;11;1;10;.909;3600000;0
20575;7534;1481;61;15;1;14;.933;3600000;0
20575;206007;1481;0;0;0;0;.00nan;0;0
20575;64230;1861;61;31;4;27;.871;3600000;0
20575;152202;1861;0;0;0;0;.00nan;0;0
20576;1072;1475;0;0;0;0;.00nan;0;0
20576;163695;1475;83;30;2;28;.933;3600000;0
20576;-1;1871;34;35;6;29;.829;3155000;0
20576;143063;1871;54;4;0;4;1.000;445000;0
20577;185041;2173;81;47;3;44;.936;3555000;0
20577;62279;2173;0;0;0;0;.00nan;0;0
20577;76951;2193;0;0;0;0;.00nan;0;0
20577;86228;2193;53;16;2;14;.875;3600000;0
20578;6947;521;0;0;0;0;.00nan;0;0
20578;174589;522;0;0;0;0;.00nan;0;0
20578;186520;522;58;36;4;32;.889;3600000;0
20578;143036;521;80;14;0;14;1.000;3600000;0
20579;6944;1477;73;20;1;19;.950;3600000;0
20579;9373;1854;70;37;3;34;.919;3572000;0
20579;62530;1477;0;0;0;0;.00nan;0;0
20579;155529;1854;0;0;0;0;.00nan;0;0
20580;164170;4560;0;0;0;0;.00nan;0;0
20580;13613;1869;71;31;3;28;.903;3600000;0
20580;73973;1869;0;0;0;0;.00nan;0;0
20580;143421;4560;66;31;4;27;.871;3567000;0
20581;7487;3922;0;0;0;0;.00nan;0;0
20581;179830;523;73;23;2;21;.913;3900000;0
20581;68565;3922;84;39;2;37;.949;3900000;0
20581;147264;523;0;0;0;0;.00nan;0;0
20582;7487;3922;44;30;4;26;.867;3578000;0
20582;9373;1854;50;17;2;15;.882;3600000;0
20582;68565;3922;0;0;0;0;.00nan;0;0
20582;155529;1854;0;0;0;0;.00nan;0;0
20583;164170;4560;0;0;0;0;.00nan;0;0
20583;185041;2173;0;0;0;0;.00nan;0;0
20583;62279;2173;84;31;2;29;.935;3900000;0
20583;143421;4560;66;26;2;24;.923;3900000;0
20584;-1;1871;100;39;0;39;1.000;3600000;0
20584;76951;2193;0;0;0;0;.00nan;0;0
20584;86228;2193;76;25;1;24;.960;3569000;0
20584;143063;1871;0;0;0;0;.00nan;0;0
20585;6944;1477;0;0;0;0;.00nan;0;0
20585;179830;523;0;0;0;0;.00nan;0;0
20585;62530;1477;98;45;1;44;.978;3579000;0
20585;147264;523;89;17;0;17;1.000;3600000;0
20586;13613;1869;62;32;3;29;.906;3589000;0
20586;174589;522;0;0;0;0;.00nan;0;0
20586;186520;522;69;30;2;28;.933;3600000;0
20586;73973;1869;0;0;0;0;.00nan;0;0
20587;1072;1475;0;0;0;0;.00nan;0;0
20587;7534;1481;91;35;1;34;.971;3600000;0
20587;163695;1475;77;26;2;24;.923;3566000;0
20587;206007;1481;0;0;0;0;.00nan;0;0
20588;6947;521;0;0;0;0;.00nan;0;0
20588;64230;1861;64;37;5;32;.865;3600000;0
20588;143036;521;73;28;2;26;.929;3600000;0
20588;152202;1861;0;0;0;0;.00nan;0;0
20589;6944;1477;0;0;0;0;.00nan;0;0
20589;7534;1481;73;25;2;23;.920;3600000;0
20589;206007;1481;0;0;0;0;.00nan;0;0
20589;62530;1477;63;14;1;13;.929;3600000;0
20590;174589;522;0;0;0;0;.00nan;0;0
20590;186520;522;89;59;5;54;.915;3599000;0
20590;76951;2193;0;0;0;0;.00nan;0;0
20590;86228;2193;50;16;3;13;.813;3600000;0
20591;6947;521;66;17;1;16;.941;3600000;0
20591;-1;1871;59;29;3;26;.897;3565000;0
20591;143036;521;0;0;0;0;.00nan;0;0
20591;143063;1871;0;0;0;0;.00nan;0;0
20592;9373;1854;34;37;7;30;.811;3867000;0
20592;64230;1861;39;36;6;30;.833;3851000;0
20592;152202;1861;0;0;0;0;.00nan;0;0
20592;155529;1854;0;0;0;0;.00nan;0;0
20593;1072;1475;0;0;0;0;.00nan;0;0
20593;163695;1475;59;27;4;23;.852;3657000;0
20593;13613;1869;0;0;0;0;.00nan;0;0
20593;73973;1869;71;34;3;31;.912;3657000;0
20594;185041;2173;98;61;3;58;.951;3600000;0
20594;179830;523;0;0;0;0;.00nan;0;0
20594;62279;2173;0;0;0;0;.00nan;0;0
20594;147264;523;73;22;2;20;.909;3600000;0
20595;7487;3922;0;0;0;0;.00nan;0;0
20595;164170;4560;54;21;2;19;.905;3600000;0
20595;68565;3922;51;38;5;33;.868;3600000;0
20595;143421;4560;0;0;0;0;.00nan;0;0
20596;13613;1869;100;38;1;37;.974;3600000;0
20596;185041;2173;90;34;2;32;.941;3600000;0
20596;62279;2173;0;0;0;0;.00nan;0;0
20596;73973;1869;0;0;0;0;.00nan;0;0
20597;7534;1481;44;44;6;38;.864;3600000;0
20597;-1;1871;0;0;0;0;.00nan;0;0
20597;68627;1481;0;0;0;0;.00nan;0;0
20597;143063;1871;59;11;1;10;.909;3600000;0
20598;6947;521;0;0;0;0;.00nan;0;0
20598;9373;1854;48;50;7;43;.860;3225000;0
20598;143036;521;62;13;1;12;.923;3600000;0
20598;155529;1854;52;3;0;3;1.000;375000;0
20599;6944;1477;0;0;0;0;.00nan;0;0
20599;7487;3922;0;0;0;0;.00nan;0;0
20599;62530;1477;73;17;1;16;.941;3600000;0
20599;68565;3922;59;33;4;29;.879;3571000;0
20600;174589;522;62;22;2;20;.909;2645000;0
20600;179830;523;0;0;0;0;.00nan;0;0
20600;186520;522;32;16;4;12;.750;955000;0
20600;147264;523;48;19;3;16;.842;3600000;0
20601;1072;1475;0;0;0;0;.00nan;0;0
20601;163695;1475;78;17;1;16;.941;3644000;0
20601;164170;4560;0;0;0;0;.00nan;0;0
20601;143421;4560;93;37;2;35;.946;3644000;0
20602;64230;1861;90;37;2;35;.946;3699000;0
20602;76951;2193;0;0;0;0;.00nan;0;0
20602;86228;2193;63;13;1;12;.923;3699000;0
20602;152202;1861;0;0;0;0;.00nan;0;0
20603;7487;3922;0;0;0;0;.00nan;0;0
20603;185041;2173;66;29;3;26;.897;3900000;0
20603;62279;2173;0;0;0;0;.00nan;0;0
20603;68565;3922;93;45;3;42;.933;3900000;0
20604;7534;1481;69;24;2;22;.917;3600000;0
20604;174589;522;0;0;0;0;.00nan;0;0
20604;186520;522;60;28;3;25;.893;3600000;0
20604;68627;1481;0;0;0;0;.00nan;0;0
20605;6947;521;65;28;3;25;.893;3600000;0
20605;76951;2193;0;0;0;0;.00nan;0;0
20605;86228;2193;67;32;4;28;.875;3593000;0
20605;143036;521;0;0;0;0;.00nan;0;0
20606;9373;1854;0;0;0;0;.00nan;0;0
20606;-1;1871;75;28;2;26;.929;3593000;0
20606;143063;1871;0;0;0;0;.00nan;0;0
20606;155529;1854;84;26;1;25;.962;3600000;0
20607;13613;1869;77;28;2;26;.929;3600000;0
20607;64230;1861;72;40;4;36;.900;3541000;0
20607;73973;1869;0;0;0;0;.00nan;0;0
20607;152202;1861;0;0;0;0;.00nan;0;0
20608;1072;1475;0;0;0;0;.00nan;0;0
20608;163695;1475;100;58;2;56;.966;3900000;0
20608;179830;523;45;13;2;11;.846;3900000;0
20608;147264;523;0;0;0;0;.00nan;0;0
20609;6944;1477;0;0;0;0;.00nan;0;0
20609;164170;4560;0;0;0;0;.00nan;0;0
20609;62530;1477;52;22;3;19;.864;3600000;0
20609;143421;4560;81;52;5;47;.904;3576000;0
20610;6944;1477;0;0;0;0;.00nan;0;0
20610;185041;2173;100;26;0;26;1.000;3600000;0
20610;62279;2173;0;0;0;0;.00nan;0;0
20610;62530;1477;61;24;3;21;.875;3600000;0
20611;13613;1869;55;25;3;22;.880;3572000;0
20611;-1;1871;69;23;2;21;.913;3600000;0
20611;73973;1869;0;0;0;0;.00nan;0;0
20611;143063;1871;0;0;0;0;.00nan;0;0
20612;6947;521;0;0;0;0;.00nan;0;0
20612;7534;1481;99;39;1;38;.974;3600000;0
20612;68627;1481;0;0;0;0;.00nan;0;0
20612;143036;521;56;19;2;17;.895;3551000;0
20613;9373;1854;41;26;4;22;.846;2176000;0
20613;76951;2193;79;10;0;10;1.000;3600000;0
20613;86228;2193;0;0;0;0;.00nan;0;0
20613;155529;1854;60;13;1;12;.923;1424000;0
20614;164170;4560;0;0;0;0;.00nan;0;0
20614;174589;522;50;22;3;19;.864;3600000;0
20614;186520;522;0;0;0;0;.00nan;0;0
20614;143421;4560;93;55;4;51;.927;3544000;0
20615;1072;1475;50;20;3;17;.850;3600000;0
20615;7487;3922;33;5;2;3;.600;360000;0
20615;163695;1475;0;0;0;0;.00nan;0;0
20615;68565;3922;29;42;8;34;.810;3240000;0
20616;179830;523;0;0;0;0;.00nan;0;0
20616;64230;1861;0;0;0;0;.00nan;0;0
20616;147264;523;39;20;4;16;.800;3511000;0
20616;152202;1861;81;32;2;30;.938;3600000;0
20617;7487;3922;68;28;2;26;.929;3545000;0
20617;64230;1861;100;28;0;28;1.000;3600000;0
20617;68565;3922;0;0;0;0;.00nan;0;0
20617;152202;1861;0;0;0;0;.00nan;0;0
20618;7534;1481;69;54;6;48;.889;3200000;0
20618;68627;1481;28;8;3;5;.625;400000;0
20618;76951;2193;57;13;1;12;.923;3600000;0
20618;86228;2193;0;0;0;0;.00nan;0;0
20619;1072;1475;0;0;0;0;.00nan;0;0
20619;163695;1475;100;24;0;24;1.000;3600000;0
20619;185041;2173;85;34;1;33;.971;3591000;0
20619;62279;2173;0;0;0;0;.00nan;0;0
20620;6944;1477;0;0;0;0;.00nan;0;0
20620;174589;522;0;0;0;0;.00nan;0;0
20620;186520;522;84;38;4;34;.895;3703000;0
20620;62530;1477;49;23;3;20;.870;3703000;0
20621;9373;1854;49;33;5;28;.848;3600000;0
20621;13613;1869;51;15;2;13;.867;3600000;0
20621;73973;1869;0;0;0;0;.00nan;0;0
20621;155529;1854;0;0;0;0;.00nan;0;0
20622;179830;523;0;0;0;0;.00nan;0;0
20622;-1;1871;40;30;5;25;.833;3570000;0
20622;143063;1871;0;0;0;0;.00nan;0;0
20622;147264;523;58;25;3;22;.880;3600000;0
20623;6947;521;0;0;0;0;.00nan;0;0
20623;164170;4560;0;0;0;0;.00nan;0;0
20623;143036;521;55;14;2;12;.857;3600000;0
20623;143421;4560;68;49;5;44;.898;3600000;0
20624;185041;2173;66;41;4;37;.902;3600000;0
20624;-1;1871;0;0;0;0;.00nan;0;0
20624;62279;2173;0;0;0;0;.00nan;0;0
20624;143063;1871;84;14;0;14;1.000;3600000;0
20625;179830;523;0;0;0;0;.00nan;0;0
20625;76951;2193;59;24;2;22;.917;3585000;0
20625;86228;2193;0;0;0;0;.00nan;0;0
20625;147264;523;94;23;0;23;1.000;3600000;0
20626;6947;521;0;0;0;0;.00nan;0;0
20626;13613;1869;46;41;6;35;.854;2814000;0
20626;73973;1869;46;13;2;11;.846;786000;0
20626;143036;521;67;23;2;21;.913;3600000;0
20627;7534;1481;100;22;0;22;1.000;3600000;0
20627;9373;1854;61;24;2;22;.917;3515000;0
20627;68627;1481;0;0;0;0;.00nan;0;0
20627;155529;1854;0;0;0;0;.00nan;0;0
20628;7487;3922;0;0;0;0;.00nan;0;0
20628;174589;522;0;0;0;0;.00nan;0;0
20628;186520;522;50;19;3;16;.842;3600000;0
20628;68565;3922;60;34;4;30;.882;3548000;0
20629;1072;1475;0;0;0;0;.00nan;0;0
20629;6944;1477;0;0;0;0;.00nan;0;0
20629;163695;1475;60;20;2;18;.900;3900000;0
20629;62530;1477;98;42;2;40;.952;3877000;0
20630;164170;4560;0;0;0;0;.00nan;0;0
20630;64230;1861;63;22;2;20;.909;3600000;0
20630;143421;4560;74;40;4;36;.900;3600000;0
20630;152202;1861;0;0;0;0;.00nan;0;0
20631;7487;3922;73;40;4;36;.900;3565000;0
20631;-1;1871;0;0;0;0;.00nan;0;0
20631;68565;3922;0;0;0;0;.00nan;0;0
20631;143063;1871;49;21;3;18;.857;3600000;0
20632;185041;2173;64;27;3;24;.889;3900000;0
20632;62279;2173;0;0;0;0;.00nan;0;0
20632;64230;1861;0;0;0;0;.00nan;0;0
20632;152202;1861;61;33;3;30;.909;3900000;0
20633;6944;1477;0;0;0;0;.00nan;0;0
20633;6947;521;0;0;0;0;.00nan;0;0
20633;62530;1477;66;31;3;28;.903;3881000;0
20633;143036;521;62;31;4;27;.871;3881000;0
20634;7534;1481;78;20;1;19;.950;3600000;0
20634;13613;1869;65;32;3;29;.906;3515000;0
20634;68627;1481;0;0;0;0;.00nan;0;0
20634;73973;1869;0;0;0;0;.00nan;0;0
20635;1072;1475;0;0;0;0;.00nan;0;0
20635;163695;1475;72;24;2;22;.917;3600000;0
20635;174589;522;55;6;0;6;1.000;416000;0
20635;186520;522;62;42;5;37;.881;3184000;0
20636;9373;1854;70;39;3;36;.923;3600000;0
20636;179830;523;0;0;0;0;.00nan;0;0
20636;147264;523;73;26;2;24;.923;3600000;0
20636;155529;1854;0;0;0;0;.00nan;0;0
20637;164170;4560;0;0;0;0;.00nan;0;0
20637;76951;2193;0;0;0;0;.00nan;0;0
20637;86228;2193;49;7;1;6;.857;3600000;0
20637;143421;4560;98;50;2;48;.960;3600000;0
20638;7534;1481;90;50;4;46;.920;3684000;0
20638;179830;523;0;0;0;0;.00nan;0;0
20638;68627;1481;0;0;0;0;.00nan;0;0
20638;147264;523;58;24;3;21;.875;3684000;0
20639;164170;4560;0;0;0;0;.00nan;0;0
20639;-1;1871;70;17;1;16;.941;3600000;0
20639;143063;1871;0;0;0;0;.00nan;0;0
20639;143421;4560;59;33;4;29;.879;3600000;0
20640;13613;1869;65;37;4;33;.892;3600000;0
20640;73973;1869;0;0;0;0;.00nan;0;0
20640;76951;2193;67;18;1;17;.944;3600000;0
20640;86228;2193;0;0;0;0;.00nan;0;0
20641;6947;521;0;0;0;0;.00nan;0;0
20641;7487;3922;65;16;0;16;1.000;969000;0
20641;68565;3922;64;46;6;40;.870;2631000;0
20641;143036;521;68;14;1;13;.929;3600000;0
20642;1072;1475;0;0;0;0;.00nan;0;0
20642;163695;1475;68;24;2;22;.917;3900000;0
20642;9373;1854;0;0;0;0;.00nan;0;0
20642;155529;1854;92;36;2;34;.944;3900000;0
20643;174589;522;0;0;0;0;.00nan;0;0
20643;185041;2173;95;37;1;36;.973;3600000;0
20643;186520;522;56;21;2;19;.905;3554000;0
20643;62279;2173;0;0;0;0;.00nan;0;0
20644;6944;1477;0;0;0;0;.00nan;0;0
20644;62530;1477;67;21;1;20;.952;3600000;0
20644;64230;1861;0;0;0;0;.00nan;0;0
20644;152202;1861;85;33;2;31;.939;3565000;0
20645;7534;1481;72;17;1;16;.941;3600000;0
20645;164170;4560;0;0;0;0;.00nan;0;0
20645;68627;1481;0;0;0;0;.00nan;0;0
20645;143421;4560;57;44;5;39;.886;3600000;0
20646;174589;522;0;0;0;0;.00nan;0;0
20646;186520;522;83;48;2;46;.958;3600000;0
20646;-1;1871;51;32;4;28;.875;3580000;0
20646;143063;1871;0;0;0;0;.00nan;0;0
20647;6944;1477;0;0;0;0;.00nan;0;0
20647;62530;1477;78;54;6;48;.889;3580000;0
20647;76951;2193;0;0;0;0;.00nan;0;0
20647;86228;2193;36;17;4;13;.765;3600000;0
20648;6947;521;0;0;0;0;.00nan;0;0
20648;179830;523;0;0;0;0;.00nan;0;0
20648;143036;521;72;35;3;32;.914;3543000;0
20648;147264;523;73;31;2;29;.935;3600000;0
20649;9373;1854;0;0;0;0;.00nan;0;0
20649;185041;2173;60;28;4;24;.857;3600000;0
20649;62279;2173;0;0;0;0;.00nan;0;0
20649;155529;1854;46;33;5;28;.848;3562000;0
20650;7487;3922;52;48;6;42;.875;3600000;0
20650;13613;1869;56;19;2;17;.895;3600000;0
20650;68565;3922;0;0;0;0;.00nan;0;0
20650;73973;1869;0;0;0;0;.00nan;0;0
20651;1072;1475;0;0;0;0;.00nan;0;0
20651;163695;1475;57;15;1;14;.933;3900000;0
20651;64230;1861;100;49;1;48;.980;3900000;0
20651;152202;1861;0;0;0;0;.00nan;0;0
20652;7487;3922;77;24;1;23;.958;3600000;0
20652;7534;1481;48;20;3;17;.850;3516000;0
20652;68565;3922;0;0;0;0;.00nan;0;0
20652;68627;1481;0;0;0;0;.00nan;0;0
20653;6947;521;0;0;0;0;.00nan;0;0
20653;185041;2173;99;41;1;40;.976;3600000;0
20653;62279;2173;0;0;0;0;.00nan;0;0
20653;143036;521;66;24;2;22;.917;3563000;0
20654;6944;1477;0;0;0;0;.00nan;0;0
20654;-1;1871;66;23;3;20;.870;3550000;0
20654;62530;1477;95;35;2;33;.943;3600000;0
20654;143063;1871;0;0;0;0;.00nan;0;0
20655;174589;522;0;0;0;0;.00nan;0;0
20655;186520;522;100;25;0;25;1.000;3600000;0
20655;64230;1861;30;25;6;19;.760;3600000;0
20655;152202;1861;0;0;0;0;.00nan;0;0
20656;1072;1475;0;0;0;0;.00nan;0;0
20656;163695;1475;61;46;5;41;.891;3554000;0
20656;76951;2193;0;0;0;0;.00nan;0;0
20656;86228;2193;30;16;4;12;.750;3600000;0
20657;13613;1869;91;52;4;48;.923;3600000;0
20657;179830;523;78;24;1;23;.958;3600000;0
20657;73973;1869;0;0;0;0;.00nan;0;0
20657;147264;523;0;0;0;0;.00nan;0;0
20658;9373;1854;56;31;4;27;.871;3600000;0
20658;164170;4560;0;0;0;0;.00nan;0;0
20658;143421;4560;43;31;6;25;.806;3579000;0
20658;155529;1854;0;0;0;0;.00nan;0;0
20659;7534;1481;61;25;3;22;.880;3600000;0
20659;185041;2173;100;40;0;40;1.000;3600000;0
20659;62279;2173;0;0;0;0;.00nan;0;0
20659;68627;1481;0;0;0;0;.00nan;0;0
20660;-1;1871;0;0;0;0;.00nan;0;0
20660;64230;1861;67;29;3;26;.897;2634000;0
20660;143063;1871;92;20;0;20;1.000;3600000;0
20660;152202;1861;40;21;4;17;.810;966000;0
20661;7487;3922;92;67;1;66;.985;3893000;0
20661;68565;3922;0;0;0;0;.00nan;0;0
20661;76951;2193;0;0;0;0;.00nan;0;0
20661;86228;2193;88;16;0;16;1.000;3893000;0
20662;1072;1475;0;0;0;0;.00nan;0;0
20662;6947;521;0;0;0;0;.00nan;0;0
20662;163695;1475;84;33;2;31;.939;3600000;0
20662;143036;521;76;21;1;20;.952;3600000;0
20663;9373;1854;87;30;1;29;.967;3600000;0
20663;174589;522;0;0;0;0;.00nan;0;0
20663;186520;522;44;27;4;23;.852;3600000;0
20663;155529;1854;0;0;0;0;.00nan;0;0
20664;6944;1477;0;0;0;0;.00nan;0;0
20664;13613;1869;86;34;2;32;.941;3600000;0
20664;62530;1477;68;27;3;24;.889;3582000;0
20664;73973;1869;0;0;0;0;.00nan;0;0
20665;164170;4560;0;0;0;0;.00nan;0;0
20665;179830;523;0;0;0;0;.00nan;0;0
20665;143421;4560;74;56;5;51;.911;3600000;0
20665;147264;523;64;11;1;10;.909;3600000;0
20666;7487;3922;78;42;4;38;.905;3067000;0
20666;179830;523;0;0;0;0;.00nan;0;0
20666;68565;3922;24;10;4;6;.600;533000;0
20666;147264;523;64;4;0;4;1.000;3600000;0
20667;185041;2173;75;52;5;47;.904;3600000;0
20667;62279;2173;0;0;0;0;.00nan;0;0
20667;76951;2193;0;0;0;0;.00nan;0;0
20667;86228;2193;56;22;3;19;.864;3600000;0
20668;6944;1477;0;0;0;0;.00nan;0;0
20668;9373;1854;75;42;3;39;.929;3600000;0
20668;62530;1477;68;21;1;20;.952;3600000;0
20668;155529;1854;0;0;0;0;.00nan;0;0
20669;6947;521;0;0;0;0;.00nan;0;0
20669;174589;522;49;9;1;8;.889;624000;0
20669;186520;522;52;41;6;35;.854;2976000;0
20669;143036;521;51;14;2;12;.857;3600000;0
20670;1072;1475;0;0;0;0;.00nan;0;0
20670;163695;1475;100;31;0;31;1.000;3600000;0
20670;-1;1871;44;36;6;30;.833;3248000;0
20670;54290;1871;50;1;0;1;1.000;352000;0
20671;7534;1481;91;35;1;34;.971;3600000;0
20671;64230;1861;0;0;0;0;.00nan;0;0
20671;68627;1481;0;0;0;0;.00nan;0;0
20671;152202;1861;78;34;2;32;.941;3577000;0
20672;164170;4560;89;41;2;39;.951;3546000;0
20672;13613;1869;74;23;1;22;.957;3600000;0
20672;73973;1869;0;0;0;0;.00nan;0;0
20672;143421;4560;0;0;0;0;.00nan;0;0
20673;1072;1475;0;0;0;0;.00nan;0;0
20673;7534;1481;86;36;2;34;.944;3600000;0
20673;163695;1475;97;24;0;24;1.000;3600000;0
20673;68627;1481;0;0;0;0;.00nan;0;0
20674;-1;1871;97;40;2;38;.950;3574000;0
20674;54290;1871;0;0;0;0;.00nan;0;0
20674;76951;2193;93;17;0;17;1.000;3600000;0
20674;86228;2193;0;0;0;0;.00nan;0;0
20675;6947;521;0;0;0;0;.00nan;0;0
20675;64230;1861;49;47;7;40;.851;3600000;0
20675;143036;521;76;10;0;10;1.000;3600000;0
20675;152202;1861;0;0;0;0;.00nan;0;0
20676;7487;3922;77;31;2;29;.935;3567000;0
20676;9373;1854;69;22;1;21;.955;3600000;0
20676;68565;3922;0;0;0;0;.00nan;0;0
20676;155529;1854;0;0;0;0;.00nan;0;0
20677;13613;1869;60;23;3;20;.870;3613000;0
20677;174589;522;0;0;0;0;.00nan;0;0
20677;186520;522;83;41;4;37;.902;3613000;0
20677;73973;1869;0;0;0;0;.00nan;0;0
20678;6944;1477;0;0;0;0;.00nan;0;0
20678;179830;523;0;0;0;0;.00nan;0;0
20678;62530;1477;75;36;3;33;.917;3900000;0
20678;147264;523;63;28;3;25;.893;3900000;0
20679;164170;4560;0;0;0;0;.00nan;0;0
20679;185041;2173;66;23;2;21;.913;3600000;0
20679;62279;2173;0;0;0;0;.00nan;0;0
20679;143421;4560;74;37;3;34;.919;3559000;0
20680;7487;3922;78;22;1;21;.955;3600000;0
20680;164170;4560;0;0;0;0;.00nan;0;0
20680;68565;3922;0;0;0;0;.00nan;0;0
20680;143421;4560;57;31;3;28;.903;3565000;0
20681;185041;2173;64;8;0;8;1.000;337000;0
20681;179830;523;0;0;0;0;.00nan;0;0
20681;62279;2173;75;56;6;50;.893;3263000;0
20681;147264;523;81;14;0;14;1.000;3600000;0
20682;6947;521;0;0;0;0;.00nan;0;0
20682;-1;1871;0;0;0;0;.00nan;0;0
20682;54290;1871;77;44;4;40;.909;3600000;0
20682;143036;521;88;19;0;19;1.000;3600000;0
20683;6944;1477;0;0;0;0;.00nan;0;0
20683;7534;1481;50;32;4;28;.875;3570000;0
20683;62530;1477;55;18;2;16;.889;3600000;0
20683;68627;1481;0;0;0;0;.00nan;0;0
20684;174589;522;98;62;4;58;.935;3033000;0
20684;186520;522;24;13;4;9;.692;567000;0
20684;76951;2193;27;13;4;9;.692;3600000;0
20684;86228;2193;0;0;0;0;.00nan;0;0
20685;1072;1475;50;23;4;19;.826;3600000;0
20685;163695;1475;0;0;0;0;.00nan;0;0
20685;13613;1869;31;28;6;22;.786;3600000;0
20685;73973;1869;0;0;0;0;.00nan;0;0
20686;9373;1854;62;21;1;20;.952;3600000;0
20686;64230;1861;53;9;1;8;.889;739000;0
20686;152202;1861;34;32;6;26;.813;2861000;0
20686;155529;1854;0;0;0;0;.00nan;0;0
20687;6944;1477;0;0;0;0;.00nan;0;0
20687;7487;3922;0;0;0;0;.00nan;0;0
20687;62530;1477;59;20;2;18;.900;3600000;0
20687;68565;3922;67;41;4;37;.902;3533000;0
20688;7534;1481;81;31;2;29;.935;3900000;0
20688;-1;1871;90;33;2;31;.939;3900000;0
20688;54290;1871;0;0;0;0;.00nan;0;0
20688;68627;1481;0;0;0;0;.00nan;0;0
20689;64230;1861;80;41;3;38;.927;3791000;0
20689;76951;2193;0;0;0;0;.00nan;0;0
20689;86228;2193;65;19;2;17;.895;3791000;0
20689;152202;1861;0;0;0;0;.00nan;0;0
20690;6947;521;0;0;0;0;.00nan;0;0
20690;9373;1854;90;42;2;40;.952;3572000;0
20690;143036;521;74;22;1;21;.955;3600000;0
20690;155529;1854;0;0;0;0;.00nan;0;0
20691;13613;1869;70;22;1;21;.955;3600000;0
20691;185041;2173;60;41;4;37;.902;3567000;0
20691;62279;2173;0;0;0;0;.00nan;0;0
20691;73973;1869;0;0;0;0;.00nan;0;0
20692;174589;522;0;0;0;0;.00nan;0;0
20692;179830;523;0;0;0;0;.00nan;0;0
20692;186520;522;100;37;0;37;1.000;3600000;0
20692;147264;523;54;15;2;13;.867;3563000;0
20693;1072;1475;0;0;0;0;.00nan;0;0
20693;163695;1475;66;15;1;14;.933;3900000;0
20693;164170;4560;0;0;0;0;.00nan;0;0
20693;143421;4560;87;27;1;26;.963;3886000;0
20694;7487;3922;100;33;0;33;1.000;3600000;0
20694;185041;2173;85;29;1;28;.966;3600000;0
20694;62279;2173;0;0;0;0;.00nan;0;0
20694;68565;3922;0;0;0;0;.00nan;0;0
20695;9373;1854;49;29;4;25;.862;3600000;0
20695;-1;1871;0;0;0;0;.00nan;0;0
20695;54290;1871;86;14;0;14;1.000;3600000;0
20695;155529;1854;0;0;0;0;.00nan;0;0
20696;6947;521;0;0;0;0;.00nan;0;0
20696;76951;2193;0;0;0;0;.00nan;0;0
20696;86228;2193;100;46;0;46;1.000;3600000;0
20696;143036;521;82;31;2;29;.935;3560000;0
20697;6944;1477;0;0;0;0;.00nan;0;0
20697;164170;4560;0;0;0;0;.00nan;0;0
20697;62530;1477;69;18;1;17;.944;3600000;0
20697;143421;4560;73;45;5;40;.889;3600000;0
20698;7534;1481;98;44;3;41;.932;3573000;0
20698;174589;522;0;0;0;0;.00nan;0;0
20698;186520;522;70;28;2;26;.929;3600000;0
20698;68627;1481;0;0;0;0;.00nan;0;0
20699;1072;1475;0;0;0;0;.00nan;0;0
20699;163695;1475;91;32;2;30;.938;3543000;0
20699;179830;523;0;0;0;0;.00nan;0;0
20699;147264;523;100;19;0;19;1.000;3600000;0
20700;13613;1869;71;27;2;25;.926;3580000;0
20700;64230;1861;100;26;0;26;1.000;3600000;0
20700;73973;1869;0;0;0;0;.00nan;0;0
20700;152202;1861;0;0;0;0;.00nan;0;0
20701;1072;1475;0;0;0;0;.00nan;0;0
20701;7487;3922;25;13;4;9;.692;2061000;0
20701;163695;1475;81;11;0;11;1.000;3600000;0
20701;68565;3922;71;14;0;14;1.000;1539000;0
20702;6947;521;0;0;0;0;.00nan;0;0
20702;7534;1481;75;50;6;44;.880;2983000;0
20702;68627;1481;47;5;1;4;.800;617000;0
20702;143036;521;39;14;3;11;.786;3600000;0
20703;9373;1854;96;46;1;45;.978;3900000;0
20703;76951;2193;0;0;0;0;.00nan;0;0
20703;86228;2193;61;11;1;10;.909;3900000;0
20703;155529;1854;0;0;0;0;.00nan;0;0
20704;6944;1477;0;0;0;0;.00nan;0;0
20704;185041;2173;47;36;6;30;.833;3246000;0
20704;62279;2173;49;2;0;2;1.000;354000;0
20704;62530;1477;100;19;0;19;1.000;3600000;0
20705;179830;523;0;0;0;0;.00nan;0;0
20705;64230;1861;76;53;6;47;.887;3600000;0
20705;147264;523;46;15;3;12;.800;3600000;0
20705;152202;1861;0;0;0;0;.00nan;0;0
20706;164170;4560;0;0;0;0;.00nan;0;0
20706;174589;522;0;0;0;0;.00nan;0;0
20706;186520;522;85;36;2;34;.944;3865000;0
20706;143421;4560;58;25;3;22;.880;3865000;0
20707;13613;1869;40;29;5;24;.828;3600000;0
20707;-1;1871;0;0;0;0;.00nan;0;0
20707;54290;1871;47;28;4;24;.857;3600000;0
20707;73973;1869;0;0;0;0;.00nan;0;0
20708;179830;523;0;0;0;0;.00nan;0;0
20708;-1;1871;71;31;3;28;.903;3570000;0
20708;54290;1871;0;0;0;0;.00nan;0;0
20708;147264;523;55;17;2;15;.882;3600000;0
20709;7534;1481;45;28;5;23;.821;2125000;0
20709;68627;1481;70;27;2;25;.926;1475000;0
20709;76951;2193;0;0;0;0;.00nan;0;0
20709;86228;2193;65;13;1;12;.923;3600000;0
20710;6947;521;0;0;0;0;.00nan;0;0
20710;164170;4560;0;0;0;0;.00nan;0;0
20710;143036;521;73;7;0;7;1.000;3600000;0
20710;143421;4560;98;43;1;42;.977;3563000;0
20711;9373;1854;73;23;1;22;.957;3600000;0
20711;13613;1869;100;42;0;42;1.000;3600000;0
20711;73973;1869;0;0;0;0;.00nan;0;0
20711;155529;1854;0;0;0;0;.00nan;0;0
20712;6944;1477;0;0;0;0;.00nan;0;0
20712;174589;522;95;39;2;37;.949;3600000;0
20712;186520;522;0;0;0;0;.00nan;0;0
20712;62530;1477;51;21;3;18;.857;3562000;0
20713;1072;1475;0;0;0;0;.00nan;0;0
20713;163695;1475;65;16;1;15;.938;3600000;0
20713;185041;2173;71;38;3;35;.921;3570000;0
20713;62279;2173;0;0;0;0;.00nan;0;0
20714;7487;3922;34;18;4;14;.778;1106000;0
20714;64230;1861;65;26;3;23;.885;3600000;0
20714;68565;3922;85;35;1;34;.971;2482000;0
20714;152202;1861;0;0;0;0;.00nan;0;0
20715;7487;3922;100;27;0;27;1.000;3600000;0
20715;174589;522;0;0;0;0;.00nan;0;0
20715;186520;522;72;21;1;20;.952;3590000;0
20715;68565;3922;0;0;0;0;.00nan;0;0
20716;7534;1481;0;0;0;0;.00nan;0;0
20716;9373;1854;44;34;5;29;.853;3600000;0
20716;68627;1481;70;21;1;20;.952;3600000;0
20716;155529;1854;0;0;0;0;.00nan;0;0
20717;185041;2173;92;33;2;31;.939;3720000;0
20717;-1;1871;87;29;1;28;.966;3720000;0
20717;54290;1871;0;0;0;0;.00nan;0;0
20717;62279;2173;0;0;0;0;.00nan;0;0
20718;1072;1475;0;0;0;0;.00nan;0;0
20718;6944;1477;0;0;0;0;.00nan;0;0
20718;163695;1475;72;39;4;35;.897;3530000;0
20718;62530;1477;64;22;2;20;.909;3600000;0
20719;6947;521;0;0;0;0;.00nan;0;0
20719;13613;1869;65;41;5;36;.878;3600000;0
20719;73973;1869;0;0;0;0;.00nan;0;0
20719;143036;521;71;19;1;18;.947;3600000;0
20720;179830;523;72;31;2;29;.935;3587000;0
20720;76951;2193;0;0;0;0;.00nan;0;0
20720;86228;2193;66;19;1;18;.947;3600000;0
20720;147264;523;0;0;0;0;.00nan;0;0
20721;164170;4560;0;0;0;0;.00nan;0;0
20721;64230;1861;100;20;0;20;1.000;3600000;0
20721;143421;4560;96;53;3;50;.943;3600000;0
20721;152202;1861;0;0;0;0;.00nan;0;0
20722;7534;1481;87;29;2;27;.931;3600000;0
20722;13613;1869;85;41;3;38;.927;3578000;0
20722;68627;1481;0;0;0;0;.00nan;0;0
20722;73973;1869;0;0;0;0;.00nan;0;0
20723;7487;3922;98;44;2;42;.955;3600000;0
20723;-1;1871;87;26;1;25;.962;3600000;0
20723;54290;1871;0;0;0;0;.00nan;0;0
20723;68565;3922;0;0;0;0;.00nan;0;0
20724;164170;4560;64;17;1;16;.941;1374000;0
20724;76951;2193;0;0;0;0;.00nan;0;0
20724;86228;2193;59;11;1;10;.909;3600000;0
20724;143421;4560;39;40;6;34;.850;2226000;0
20725;6944;1477;0;0;0;0;.00nan;0;0
20725;6947;521;0;0;0;0;.00nan;0;0
20725;62530;1477;77;45;4;41;.911;3600000;0
20725;143036;521;98;20;0;20;1.000;3600000;0
20726;9373;1854;82;28;1;27;.964;1640000;0
20726;179830;523;0;0;0;0;.00nan;0;0
20726;147264;523;74;8;0;8;1.000;3600000;0
20726;155529;1854;34;35;6;29;.829;1960000;0
20727;1072;1475;0;0;0;0;.00nan;0;0
20727;163695;1475;88;26;2;24;.923;3600000;0
20727;174589;522;0;0;0;0;.00nan;0;0
20727;186520;522;80;34;3;31;.912;3595000;0
20728;185041;2173;95;32;1;31;.969;3600000;0
20728;62279;2173;0;0;0;0;.00nan;0;0
20728;64230;1861;58;23;3;20;.870;3593000;0
20728;152202;1861;0;0;0;0;.00nan;0;0
20729;6947;521;0;0;0;0;.00nan;0;0
20729;7487;3922;0;0;0;0;.00nan;0;0
20729;68565;3922;93;53;4;49;.925;3600000;0
20729;143036;521;66;15;1;14;.933;3600000;0
20730;174589;522;0;0;0;0;.00nan;0;0
20730;185041;2173;0;0;0;0;.00nan;0;0
20730;186520;522;71;30;3;27;.900;3576000;0
20730;62279;2173;78;23;1;22;.957;3600000;0
20731;6944;1477;60;19;2;17;.895;3600000;0
20731;62530;1477;0;0;0;0;.00nan;0;0
20731;64230;1861;86;40;4;36;.900;3556000;0
20731;152202;1861;0;0;0;0;.00nan;0;0
20732;13613;1869;99;45;1;44;.978;3600000;0
20732;73973;1869;0;0;0;0;.00nan;0;0
20732;76951;2193;0;0;0;0;.00nan;0;0
20732;86228;2193;50;17;2;15;.882;3574000;0
20733;1072;1475;59;18;2;16;.889;3600000;0
20733;163695;1475;0;0;0;0;.00nan;0;0
20733;9373;1854;40;40;6;34;.850;3600000;0
20733;155529;1854;0;0;0;0;.00nan;0;0
20734;7534;1481;36;33;6;27;.818;3238000;0
20734;179830;523;0;0;0;0;.00nan;0;0
20734;68627;1481;64;12;0;12;1.000;362000;0
20734;147264;523;65;16;1;15;.938;3600000;0
20735;164170;4560;0;0;0;0;.00nan;0;0
20735;-1;1871;60;27;3;24;.889;3557000;0
20735;54290;1871;0;0;0;0;.00nan;0;0
20735;143421;4560;80;26;2;24;.923;3600000;0
20737;185041;2173;29;35;6;29;.829;3600000;0
20737;-1;1871;90;21;0;21;1.000;3600000;0
20737;62279;2173;0;0;0;0;.00nan;0;0
20737;67764;1871;0;0;0;0;.00nan;0;0
20739;13613;1869;92;60;3;57;.950;3745000;0
20739;179830;523;0;0;0;0;.00nan;0;0
20739;73973;1869;0;0;0;0;.00nan;0;0
20739;147264;523;82;33;2;31;.939;3745000;0
20741;164170;4560;100;33;0;33;1.000;3600000;0
20741;64230;1861;0;0;0;0;.00nan;0;0
20741;64254;4560;0;0;0;0;.00nan;0;0
20741;152202;1861;49;18;3;15;.833;3600000;0
20743;68627;1475;60;35;4;31;.886;3600000;0
20743;76951;2193;100;35;0;35;1.000;3600000;0
20743;143063;2193;0;0;0;0;.00nan;0;0
20743;143479;1475;0;0;0;0;.00nan;0;0
20745;6944;1477;0;0;0;0;.00nan;0;0
20745;7487;3922;83;46;3;43;.935;3895000;0
20745;62530;1477;61;14;2;12;.857;3895000;0
20745;68565;3922;0;0;0;0;.00nan;0;0
20747;7534;1481;62;28;3;25;.893;3600000;0
20747;206007;1481;0;0;0;0;.00nan;0;0
20747;174589;522;0;0;0;0;.00nan;0;0
20747;186520;522;36;26;5;21;.808;3576000;0
20749;6947;521;100;19;0;19;1.000;3600000;0
20749;9373;1854;76;35;2;33;.943;3514000;0
20749;143036;521;0;0;0;0;.00nan;0;0
20749;155529;1854;0;0;0;0;.00nan;0;0
20751;9373;1854;0;0;0;0;.00nan;0;0
20751;164170;4560;99;29;0;29;1.000;3600000;0
20751;64254;4560;0;0;0;0;.00nan;0;0
20751;155529;1854;54;26;3;23;.885;3600000;0
20753;6944;1477;57;32;4;28;.875;3600000;0
20753;174589;522;35;34;6;28;.824;3562000;0
20753;186520;522;0;0;0;0;.00nan;0;0
20753;62530;1477;0;0;0;0;.00nan;0;0
20755;7487;3922;0;0;0;0;.00nan;0;0
20755;185041;2173;0;0;0;0;.00nan;0;0
20755;62279;2173;56;19;2;17;.895;3600000;0
20755;68565;3922;50;35;5;30;.857;3600000;0
20757;7534;1481;0;0;0;0;.00nan;0;0
20757;206007;1481;54;28;3;25;.893;3767000;0
20757;68627;1475;0;0;0;0;.00nan;0;0
20757;143479;1475;63;27;2;25;.926;3767000;0
20759;13613;1869;45;35;5;30;.857;3133000;0
20759;179830;523;79;15;0;15;1.000;3600000;0
20759;73973;1869;33;15;4;11;.733;467000;0
20759;147264;523;0;0;0;0;.00nan;0;0
20761;64230;1861;88;56;5;51;.911;3656000;0
20761;76951;2193;33;18;4;14;.778;3656000;0
20761;143063;2193;0;0;0;0;.00nan;0;0
20761;152202;1861;0;0;0;0;.00nan;0;0
20763;6947;521;46;31;5;26;.839;3523000;0
20763;-1;1871;55;25;3;22;.880;3600000;0
20763;67764;1871;0;0;0;0;.00nan;0;0
20763;143036;521;0;0;0;0;.00nan;0;0
20765;174589;522;0;0;0;0;.00nan;0;0
20765;186520;522;94;43;2;41;.953;3600000;0
20765;76951;2193;53;21;3;18;.857;3550000;0
20765;143063;2193;0;0;0;0;.00nan;0;0
20767;7487;3922;34;29;6;23;.793;3600000;0
20767;-1;1871;0;0;0;0;.00nan;0;0
20767;67764;1871;72;26;2;24;.923;3600000;0
20767;68565;3922;0;0;0;0;.00nan;0;0
20769;7534;1481;77;39;4;35;.897;3600000;0
20769;164170;4560;42;32;5;27;.844;3563000;0
20769;206007;1481;0;0;0;0;.00nan;0;0
20769;64254;4560;0;0;0;0;.00nan;0;0
20771;13613;1869;97;17;0;17;1.000;3900000;0
20771;64230;1861;98;45;0;45;1.000;3900000;0
20771;73973;1869;0;0;0;0;.00nan;0;0
20771;152202;1861;0;0;0;0;.00nan;0;0
20773;179830;523;63;18;1;17;.944;3600000;0
20773;68627;1475;48;37;5;32;.865;3247000;0
20773;143479;1475;51;2;0;2;1.000;353000;0
20773;147264;523;0;0;0;0;.00nan;0;0
20775;6947;521;82;22;1;21;.955;3600000;0
20775;185041;2173;58;23;2;21;.913;3580000;0
20775;62279;2173;0;0;0;0;.00nan;0;0
20775;143036;521;0;0;0;0;.00nan;0;0
20777;6944;1477;0;0;0;0;.00nan;0;0
20777;9373;1854;78;45;4;41;.911;3600000;0
20777;62530;1477;70;26;2;24;.923;3600000;0
20777;155529;1854;0;0;0;0;.00nan;0;0
20779;7534;1481;0;0;0;0;.00nan;0;0
20779;206007;1481;42;31;5;26;.839;3512000;0
20779;185041;2173;0;0;0;0;.00nan;0;0
20779;62279;2173;69;36;3;33;.917;3600000;0
20781;174589;522;70;17;1;16;.941;3600000;0
20781;186520;522;0;0;0;0;.00nan;0;0
20781;64230;1861;0;0;0;0;.00nan;0;0
20781;152202;1861;40;26;5;21;.808;3600000;0
20783;6947;521;0;0;0;0;.00nan;0;0
20783;13613;1869;54;23;3;20;.870;3600000;0
20783;73973;1869;0;0;0;0;.00nan;0;0
20783;143036;521;78;30;2;28;.933;3600000;0
20785;164170;4560;52;11;1;10;.909;909000;0
20785;179830;523;0;0;0;0;.00nan;0;0
20785;64254;4560;22;27;6;21;.778;2691000;0
20785;147264;523;45;16;3;13;.813;3600000;0
20787;7487;3922;0;0;0;0;.00nan;0;0
20787;68565;3922;42;33;5;28;.848;3600000;0
20787;68627;1475;0;0;0;0;.00nan;0;0
20787;143479;1475;68;23;2;21;.913;3600000;0
20789;9373;1854;45;5;1;4;.800;499000;0
20789;76951;2193;0;0;0;0;.00nan;0;0
20789;143063;2193;80;13;0;13;1.000;3600000;0
20789;155529;1854;38;32;6;26;.813;3101000;0
20791;6944;1477;82;33;2;31;.939;3600000;0
20791;-1;1871;41;28;5;23;.821;3600000;0
20791;62530;1477;0;0;0;0;.00nan;0;0
20791;67764;1871;0;0;0;0;.00nan;0;0
20793;13613;1869;99;38;1;37;.974;3600000;0
20793;-1;1871;53;16;2;14;.875;3564000;0
20793;67764;1871;0;0;0;0;.00nan;0;0
20793;73973;1869;0;0;0;0;.00nan;0;0
20795;6944;1477;0;0;0;0;.00nan;0;0
20795;179830;523;77;31;2;29;.935;3897000;0
20795;62530;1477;100;39;1;38;.974;3897000;0
20795;147264;523;0;0;0;0;.00nan;0;0
20797;185041;2173;56;32;4;28;.875;3600000;0
20797;62279;2173;0;0;0;0;.00nan;0;0
20797;68627;1475;88;17;0;17;1.000;3600000;0
20797;143479;1475;0;0;0;0;.00nan;0;0
20799;7487;3922;59;26;3;23;.885;2792000;0
20799;68565;3922;42;20;4;16;.800;808000;0
20799;76951;2193;0;0;0;0;.00nan;0;0
20799;143063;2193;66;16;1;15;.938;3600000;0
20801;6947;521;62;14;1;13;.929;3600000;0
20801;164170;4560;0;0;0;0;.00nan;0;0
20801;143036;521;0;0;0;0;.00nan;0;0
20801;143421;4560;77;59;6;53;.898;3600000;0
20803;174589;522;0;0;0;0;.00nan;0;0
20803;186520;522;72;27;2;25;.926;3823000;0
20803;64230;1861;58;24;3;21;.875;3823000;0
20803;152202;1861;0;0;0;0;.00nan;0;0
20805;7534;1481;66;34;3;31;.912;3548000;0
20805;9373;1854;72;23;2;21;.913;3600000;0
20805;206007;1481;0;0;0;0;.00nan;0;0
20805;155529;1854;0;0;0;0;.00nan;0;0
20807;174589;522;0;0;0;0;.00nan;0;0
20807;179830;523;88;24;0;24;1.000;3600000;0
20807;186520;522;88;41;3;38;.927;3600000;0
20807;147264;523;0;0;0;0;.00nan;0;0
20809;7534;1481;83;31;2;29;.935;3548000;0
20809;206007;1481;0;0;0;0;.00nan;0;0
20809;76951;2193;73;21;1;20;.952;3600000;0
20809;143063;2193;0;0;0;0;.00nan;0;0
20811;13613;1869;0;0;0;0;.00nan;0;0
20811;68627;1475;59;33;4;29;.879;3581000;0
20811;73973;1869;72;31;2;29;.935;3600000;0
20811;143479;1475;0;0;0;0;.00nan;0;0
20813;6944;1477;0;0;0;0;.00nan;0;0
20813;6947;521;71;39;4;35;.897;3600000;0
20813;62530;1477;69;37;3;34;.919;3600000;0
20813;143036;521;0;0;0;0;.00nan;0;0
20815;7487;3922;71;21;1;20;.952;3600000;0
20815;9373;1854;38;34;6;28;.824;3600000;0
20815;68565;3922;0;0;0;0;.00nan;0;0
20815;155529;1854;0;0;0;0;.00nan;0;0
20817;164170;4560;72;29;2;27;.931;3900000;0
20817;64230;1861;77;24;2;22;.917;3900000;0
20817;143421;4560;0;0;0;0;.00nan;0;0
20817;152202;1861;0;0;0;0;.00nan;0;0
20819;185041;2173;81;43;3;40;.930;3600000;0
20819;-1;1871;0;0;0;0;.00nan;0;0
20819;62279;2173;0;0;0;0;.00nan;0;0
20819;67764;1871;67;16;1;15;.938;3600000;0
20821;13613;1869;91;37;2;35;.946;3600000;0
20821;73973;1869;0;0;0;0;.00nan;0;0
20821;76951;2193;41;19;4;15;.789;3599000;0
20821;143063;2193;0;0;0;0;.00nan;0;0
20823;7487;3922;0;0;0;0;.00nan;0;0
20823;174589;522;77;33;2;31;.939;3600000;0
20823;186520;522;0;0;0;0;.00nan;0;0
20823;68565;3922;62;43;5;38;.884;3600000;0
20825;7534;1481;0;0;0;0;.00nan;0;0
20825;164170;4560;76;30;2;28;.933;2499000;0
20825;206007;1481;83;13;0;13;1.000;3600000;0
20825;143421;4560;20;11;4;7;.636;1101000;0
20827;6944;1477;82;36;2;34;.944;3600000;0
20827;179830;523;63;16;1;15;.938;3600000;0
20827;62530;1477;0;0;0;0;.00nan;0;0
20827;147264;523;0;0;0;0;.00nan;0;0
20829;6947;521;0;0;0;0;.00nan;0;0
20829;9373;1854;0;0;0;0;.00nan;0;0
20829;143036;521;62;17;1;16;.941;3600000;0
20829;155529;1854;62;25;2;23;.920;3600000;0
20831;185041;2173;0;0;0;0;.00nan;0;0
20831;62279;2173;88;37;2;35;.946;3600000;0
20831;68627;1475;0;0;0;0;.00nan;0;0
20831;143479;1475;55;24;3;21;.875;3600000;0
20833;-1;1871;75;17;1;16;.941;3900000;0
20833;64230;1861;0;0;0;0;.00nan;0;0
20833;67764;1871;0;0;0;0;.00nan;0;0
20833;152202;1861;91;32;1;31;.969;3900000;0
20834;6202;1930;0;0;0;0;.00nan;0;0
20834;11687;1934;0;0;0;0;.00nan;0;0
20834;-1;1930;51;31;4;27;.871;3549000;0
20834;72514;1934;54;24;3;21;.875;3600000;0
20835;-1;1923;40;28;6;22;.786;3600000;0
20835;56653;1923;0;0;0;0;.00nan;0;0
20835;67162;5013;64;29;3;26;.897;3600000;0
20835;67663;5013;0;0;0;0;.00nan;0;0
20836;218;4794;73;33;3;30;.909;3900000;0
20836;14459;4794;0;0;0;0;.00nan;0;0
20836;-1;1927;82;45;3;42;.933;3900000;0
20836;153618;1927;0;0;0;0;.00nan;0;0
20837;174736;1920;0;0;0;0;.00nan;0;0
20837;180535;2632;32;25;5;20;.800;3600000;0
20837;53936;2632;0;0;0;0;.00nan;0;0
20837;149981;1920;97;40;2;38;.950;3600000;0
20838;14259;584;23;5;3;2;.400;532000;0
20838;19010;1925;0;0;0;0;.00nan;0;0
20838;-1;584;32;29;6;23;.793;3068000;0
20838;56901;1925;55;39;5;34;.872;3600000;0
20839;218;4794;79;44;4;40;.909;3600000;0
20839;14259;584;0;0;0;0;.00nan;0;0
20839;14459;4794;0;0;0;0;.00nan;0;0
20839;-1;584;48;28;5;23;.821;3556000;0
20840;195672;2259;48;41;6;35;.854;3600000;0
20840;28453;2259;0;0;0;0;.00nan;0;0
20840;67162;5013;0;0;0;0;.00nan;0;0
20840;67663;5013;88;31;2;29;.935;3600000;0
20841;19473;579;60;28;3;25;.893;3567000;0
20841;-1;1923;68;28;2;26;.929;3600000;0
20841;56653;1923;0;0;0;0;.00nan;0;0
20841;160650;579;0;0;0;0;.00nan;0;0
20842;19010;1925;69;33;3;30;.909;3600000;0
20842;-1;1927;43;30;5;25;.833;3547000;0
20842;56901;1925;0;0;0;0;.00nan;0;0
20842;153618;1927;0;0;0;0;.00nan;0;0
20843;19473;579;0;0;0;0;.00nan;0;0
20843;174736;1920;0;0;0;0;.00nan;0;0
20843;149981;1920;74;26;2;24;.923;3545000;0
20843;160650;579;100;30;0;30;1.000;3600000;0
20844;174736;1920;0;0;0;0;.00nan;0;0
20844;195672;2259;70;39;4;35;.897;3600000;0
20844;28453;2259;0;0;0;0;.00nan;0;0
20844;149981;1920;85;27;1;26;.963;3600000;0
20845;218;4794;28;27;6;21;.778;3600000;0
20845;14459;4794;0;0;0;0;.00nan;0;0
20845;178950;2632;91;30;1;29;.967;3600000;0
20845;53936;2632;0;0;0;0;.00nan;0;0
20846;218;4794;0;0;0;0;.00nan;0;0
20846;6202;1930;0;0;0;0;.00nan;0;0
20846;14459;4794;93;35;2;33;.943;3600000;0
20846;-1;1930;61;36;4;32;.889;3585000;0
20847;19473;579;0;0;0;0;.00nan;0;0
20847;195672;2259;0;0;0;0;.00nan;0;0
20847;28453;2259;42;30;5;25;.833;3600000;0
20847;160650;579;16;23;6;17;.739;3555000;0
20848;178950;2632;78;36;2;34;.944;3600000;0
20848;-1;1927;0;0;0;0;.00nan;0;0
20848;53936;2632;0;0;0;0;.00nan;0;0
20848;153618;1927;57;37;5;32;.865;3600000;0
20849;19010;1925;0;0;0;0;.00nan;0;0
20849;-1;1923;0;0;0;0;.00nan;0;0
20849;56653;1923;35;24;5;19;.792;3786000;0
20849;77086;1925;68;37;4;33;.892;3786000;0
20850;170728;5013;56;55;7;48;.873;3600000;0
20850;-1;584;0;0;0;0;.00nan;0;0
20850;67663;5013;0;0;0;0;.00nan;0;0
20850;85984;584;60;20;2;18;.900;3600000;0
20851;170728;5013;52;44;5;39;.886;3600000;0
20851;44487;1934;75;29;2;27;.931;3600000;0
20851;67663;5013;0;0;0;0;.00nan;0;0
20851;72514;1934;0;0;0;0;.00nan;0;0
20852;19473;579;0;0;0;0;.00nan;0;0
20852;-1;1923;18;32;8;24;.750;2721000;0
20852;56653;1923;58;5;0;5;1.000;879000;0
20852;160650;579;53;28;4;24;.857;3600000;0
20853;19473;579;48;38;6;32;.842;3600000;0
20853;-1;1927;79;32;3;29;.906;3600000;0
20853;153618;1927;0;0;0;0;.00nan;0;0
20853;160650;579;0;0;0;0;.00nan;0;0
20854;44487;1934;56;26;3;23;.885;3600000;0
20854;-1;584;0;0;0;0;.00nan;0;0
20854;72514;1934;0;0;0;0;.00nan;0;0
20854;85984;584;76;32;2;30;.938;3600000;0
20855;218;4794;48;38;5;33;.868;3515000;0
20855;14459;4794;0;0;0;0;.00nan;0;0
20855;19010;1925;0;0;0;0;.00nan;0;0
20855;77086;1925;87;38;3;35;.921;3600000;0
20856;178950;2632;58;21;2;19;.905;3862000;0
20856;195672;2259;88;40;3;37;.925;3862000;0
20856;28453;2259;0;0;0;0;.00nan;0;0
20856;53936;2632;0;0;0;0;.00nan;0;0
20857;6202;1930;52;24;3;21;.875;3573000;0
20857;170728;5013;94;44;2;42;.955;3600000;0
20857;-1;1930;0;0;0;0;.00nan;0;0
20857;67663;5013;0;0;0;0;.00nan;0;0
20858;218;4794;76;22;1;21;.955;3600000;0
20858;14459;4794;0;0;0;0;.00nan;0;0
20858;195672;2259;0;0;0;0;.00nan;0;0
20858;28453;2259;74;42;3;39;.929;3552000;0
20859;-1;1927;0;0;0;0;.00nan;0;0
20859;-1;584;0;0;0;0;.00nan;0;0
20859;85984;584;52;25;4;21;.840;3606000;0
20859;153618;1927;61;47;5;42;.894;3641000;0
20860;19010;1925;0;0;0;0;.00nan;0;0
20860;174736;1920;0;0;0;0;.00nan;0;0
20860;77086;1925;46;30;4;26;.867;3600000;0
20860;149981;1920;89;30;1;29;.967;3600000;0
20861;6202;1930;0;0;0;0;.00nan;0;0
20861;-1;1923;0;0;0;0;.00nan;0;0
20861;-1;1930;60;36;4;32;.889;3600000;0
20861;56653;1923;41;19;3;16;.842;3600000;0
20862;6202;1930;50;6;1;5;.833;583000;0
20862;-1;1930;31;31;6;25;.806;3017000;0
20862;-1;584;0;0;0;0;.00nan;0;0
20862;85984;584;53;29;4;25;.862;3600000;0
20863;218;4794;59;28;3;25;.893;3600000;0
20863;14459;4794;0;0;0;0;.00nan;0;0
20863;170728;5013;67;34;4;30;.882;3600000;0
20863;67663;5013;0;0;0;0;.00nan;0;0
20864;19010;1925;0;0;0;0;.00nan;0;0
20864;178950;2632;25;23;5;18;.783;3600000;0
20864;53936;2632;0;0;0;0;.00nan;0;0
20864;77086;1925;77;30;2;28;.933;3600000;0
20865;6202;1930;63;29;3;26;.897;3600000;0
20865;19010;1925;0;0;0;0;.00nan;0;0
20865;-1;1930;0;0;0;0;.00nan;0;0
20865;77086;1925;61;42;4;38;.905;3568000;0
20866;195672;2259;51;30;4;26;.867;3600000;0
20866;28453;2259;0;0;0;0;.00nan;0;0
20866;-1;1927;61;20;3;17;.850;3600000;0
20866;153618;1927;0;0;0;0;.00nan;0;0
20867;218;4794;64;28;3;25;.893;3555000;0
20867;14459;4794;0;0;0;0;.00nan;0;0
20867;-1;1923;59;20;2;18;.900;3600000;0
20867;56653;1923;0;0;0;0;.00nan;0;0
20868;174736;1920;0;0;0;0;.00nan;0;0
20868;44487;1934;52;38;5;33;.868;3600000;0
20868;72514;1934;0;0;0;0;.00nan;0;0
20868;149981;1920;33;36;7;29;.806;3594000;0
20869;178950;2632;65;39;4;35;.897;3540000;0
20869;-1;584;54;16;2;14;.875;3600000;0
20869;53936;2632;0;0;0;0;.00nan;0;0
20869;85984;584;0;0;0;0;.00nan;0;0
20870;19473;579;0;0;0;0;.00nan;0;0
20870;44487;1934;52;34;5;29;.853;3600000;0
20870;72514;1934;0;0;0;0;.00nan;0;0
20870;160650;579;83;41;2;39;.951;3600000;0
20871;-1;1927;65;22;2;20;.909;3600000;0
20871;44487;1934;73;36;3;33;.917;3553000;0
20871;72514;1934;0;0;0;0;.00nan;0;0
20871;153618;1927;0;0;0;0;.00nan;0;0
20872;19010;1925;0;0;0;0;.00nan;0;0
20872;170728;5013;98;41;2;39;.951;3600000;0
20872;67663;5013;0;0;0;0;.00nan;0;0
20872;77086;1925;25;33;7;26;.788;3600000;0
20873;174736;1920;0;0;0;0;.00nan;0;0
20873;195672;2259;65;36;4;32;.889;3600000;0
20873;28453;2259;0;0;0;0;.00nan;0;0
20873;149981;1920;100;24;0;24;1.000;3600000;0
20874;178950;2632;67;12;1;11;.917;3600000;0
20874;-1;1923;53;45;6;39;.867;3600000;0
20874;53936;2632;0;0;0;0;.00nan;0;0
20874;56653;1923;0;0;0;0;.00nan;0;0
20875;19473;579;0;0;0;0;.00nan;0;0
20875;-1;1927;0;0;0;0;.00nan;0;0
20875;153618;1927;61;36;4;32;.889;3600000;0
20875;160650;579;83;31;1;30;.968;3600000;0
20876;19010;1925;60;20;2;18;.900;3600000;0
20876;-1;1923;0;0;0;0;.00nan;0;0
20876;56653;1923;53;38;5;33;.868;3600000;0
20876;77086;1925;0;0;0;0;.00nan;0;0
20877;174736;1920;0;0;0;0;.00nan;0;0
20877;-1;584;0;0;0;0;.00nan;0;0
20877;85984;584;60;28;4;24;.857;3736000;0
20877;149981;1920;58;38;5;33;.868;3736000;0
20878;6202;1930;51;21;3;18;.857;3600000;0
20878;178950;2632;44;4;1;3;.750;519000;0
20878;-1;1930;0;0;0;0;.00nan;0;0
20878;53936;2632;9;31;8;23;.742;3081000;0
20879;218;4794;36;33;6;27;.818;3600000;0
20879;14459;4794;0;0;0;0;.00nan;0;0
20879;44487;1934;52;15;2;13;.867;3600000;0
20879;72514;1934;0;0;0;0;.00nan;0;0
20880;6202;1930;0;0;0;0;.00nan;0;0
20880;195672;2259;0;0;0;0;.00nan;0;0
20880;28453;2259;83;47;3;44;.936;3572000;0
20880;-1;1930;70;16;1;15;.938;3600000;0
20881;19473;579;71;28;2;26;.929;3521000;0
20881;-1;584;88;21;0;21;1.000;3600000;0
20881;85984;584;0;0;0;0;.00nan;0;0
20881;160650;579;0;0;0;0;.00nan;0;0
20882;6202;1930;0;0;0;0;.00nan;0;0
20882;-1;1923;75;29;3;26;.897;3591000;0
20882;-1;1930;58;14;1;13;.929;3600000;0
20882;56653;1923;0;0;0;0;.00nan;0;0
20883;218;4794;87;35;2;33;.943;3600000;0
20883;14459;4794;0;0;0;0;.00nan;0;0
20883;44487;1934;45;34;6;28;.824;3600000;0
20883;72514;1934;0;0;0;0;.00nan;0;0
20884;19010;1925;0;0;0;0;.00nan;0;0
20884;170728;5013;100;40;2;38;.950;3600000;0
20884;67663;5013;0;0;0;0;.00nan;0;0
20884;77086;1925;56;29;3;26;.897;3589000;0
20885;195672;2259;24;28;6;22;.786;1774000;0
20885;28453;2259;22;27;6;21;.778;1826000;0
20885;67122;584;0;0;0;0;.00nan;0;0
20885;85984;584;67;25;3;22;.880;3600000;0
20886;178950;2632;88;33;1;32;.970;3600000;0
20886;-1;1927;56;40;6;34;.850;3302000;0
20886;53936;2632;0;0;0;0;.00nan;0;0
20886;153618;1927;53;3;0;3;1.000;298000;0
20887;195672;2259;77;56;6;50;.893;3600000;0
20887;28453;2259;0;0;0;0;.00nan;0;0
20887;44487;1934;69;23;2;21;.913;3600000;0
20887;72514;1934;0;0;0;0;.00nan;0;0
20888;19473;579;0;0;0;0;.00nan;0;0
20888;170728;5013;52;34;5;29;.853;3900000;0
20888;67663;5013;0;0;0;0;.00nan;0;0
20888;160650;579;41;28;5;23;.821;3900000;0
20889;6202;1930;0;0;0;0;.00nan;0;0
20889;-1;1927;74;28;2;26;.929;3600000;0
20889;-1;1930;72;37;3;34;.919;3572000;0
20889;153618;1927;0;0;0;0;.00nan;0;0
20890;170728;5013;46;22;3;19;.864;3558000;0
20890;-1;1923;79;32;2;30;.938;3600000;0
20890;56653;1923;0;0;0;0;.00nan;0;0
20890;67663;5013;0;0;0;0;.00nan;0;0
20891;174736;1920;0;0;0;0;.00nan;0;0
20891;44487;1934;35;26;5;21;.808;3672000;0
20891;72514;1934;0;0;0;0;.00nan;0;0
20891;149981;1920;47;38;6;32;.842;3672000;0
20892;218;4794;14;23;7;16;.696;3560000;0
20892;14459;4794;0;0;0;0;.00nan;0;0
20892;178950;2632;61;46;6;40;.870;3600000;0
20892;53936;2632;0;0;0;0;.00nan;0;0
20893;195672;2259;93;51;3;48;.941;3575000;0
20893;28453;2259;0;0;0;0;.00nan;0;0
20893;-1;1927;0;0;0;0;.00nan;0;0
20893;153618;1927;75;18;1;17;.944;3600000;0
20894;-1;1923;0;0;0;0;.00nan;0;0
20894;56653;1923;44;32;5;27;.844;3600000;0
20894;67122;584;0;0;0;0;.00nan;0;0
20894;85984;584;65;23;2;21;.913;3600000;0
20895;6202;1930;82;21;1;20;.952;3600000;0
20895;174736;1920;0;0;0;0;.00nan;0;0
20895;-1;1930;0;0;0;0;.00nan;0;0
20895;149981;1920;70;50;6;44;.880;3600000;0
20896;170728;5013;52;27;4;23;.852;3514000;0
20896;67122;584;78;27;2;25;.926;3600000;0
20896;67663;5013;0;0;0;0;.00nan;0;0
20896;85984;584;0;0;0;0;.00nan;0;0
20897;6202;1930;46;6;1;5;.833;535000;0
20897;-1;1930;30;28;6;22;.786;3019000;0
20897;67122;584;0;0;0;0;.00nan;0;0
20897;85984;584;32;20;5;15;.750;3600000;0
20898;178950;2632;42;18;3;15;.833;3600000;0
20898;195672;2259;58;46;5;41;.891;3555000;0
20898;28453;2259;0;0;0;0;.00nan;0;0
20898;53936;2632;0;0;0;0;.00nan;0;0
20899;-1;1927;90;37;2;35;.946;3600000;0
20899;44487;1934;74;42;5;37;.881;3600000;0
20899;72514;1934;0;0;0;0;.00nan;0;0
20899;153618;1927;0;0;0;0;.00nan;0;0
20900;19473;579;38;21;4;17;.810;1966000;0
20900;44487;1934;66;13;1;12;.923;3600000;0
20900;72514;1934;0;0;0;0;.00nan;0;0
20900;160650;579;50;33;5;28;.848;1634000;0
20901;218;4794;54;30;4;26;.867;3600000;0
20901;14459;4794;0;0;0;0;.00nan;0;0
20901;174736;1920;0;0;0;0;.00nan;0;0
20901;149981;1920;39;37;6;31;.838;3565000;0
20902;195672;2259;0;0;0;0;.00nan;0;0
20902;28453;2259;100;35;0;35;1.000;3600000;0
20902;-1;1923;38;27;6;21;.778;3149000;0
20902;56653;1923;55;3;0;3;1.000;451000;0
20903;19010;1925;0;0;0;0;.00nan;0;0
20903;67122;584;0;0;0;0;.00nan;0;0
20903;77086;1925;34;34;6;28;.824;3600000;0
20903;85984;584;52;19;3;16;.842;3600000;0
20904;6202;1930;48;22;3;19;.864;3564000;0
20904;174736;1920;99;42;1;41;.976;3600000;0
20904;-1;1930;0;0;0;0;.00nan;0;0
20904;149981;1920;0;0;0;0;.00nan;0;0
20905;178950;2632;75;34;3;31;.912;3600000;0
20905;170728;5013;100;30;0;30;1.000;3600000;0
20905;53936;2632;0;0;0;0;.00nan;0;0
20905;67663;5013;0;0;0;0;.00nan;0;0
20906;218;4794;49;22;3;19;.864;3569000;0
20906;14459;4794;0;0;0;0;.00nan;0;0
20906;-1;1927;67;23;2;21;.913;3600000;0
20906;153618;1927;0;0;0;0;.00nan;0;0
20907;178950;2632;95;50;3;47;.940;3600000;0
20907;44487;1934;97;22;0;22;1.000;3600000;0
20907;53936;2632;0;0;0;0;.00nan;0;0
20907;72514;1934;0;0;0;0;.00nan;0;0
20908;170728;5013;100;27;0;27;1.000;3600000;0
20908;-1;1927;0;0;0;0;.00nan;0;0
20908;67663;5013;0;0;0;0;.00nan;0;0
20908;153618;1927;71;36;3;33;.917;3600000;0
20909;174736;1920;0;0;0;0;.00nan;0;0
20909;-1;1923;51;23;3;20;.870;3600000;0
20909;56653;1923;0;0;0;0;.00nan;0;0
20909;149981;1920;75;39;4;35;.897;3559000;0
20910;19010;1925;0;0;0;0;.00nan;0;0
20910;195672;2259;0;0;0;0;.00nan;0;0
20910;28453;2259;36;26;5;21;.808;3600000;0
20910;77086;1925;65;19;2;17;.895;3600000;0
20911;19473;579;76;36;3;33;.917;2899000;0
20911;67122;584;0;0;0;0;.00nan;0;0
20911;85984;584;42;20;4;16;.800;3600000;0
20911;160650;579;41;22;4;18;.818;701000;0
20912;6202;1930;0;0;0;0;.00nan;0;0
20912;178950;2632;53;43;5;38;.884;3900000;0
20912;-1;1930;43;31;5;26;.839;3900000;0
20912;53936;2632;0;0;0;0;.00nan;0;0
20913;218;4794;0;0;0;0;.00nan;0;0
20913;14459;4794;64;33;3;30;.909;3600000;0
20913;170728;5013;55;44;6;38;.864;3600000;0
20913;67663;5013;0;0;0;0;.00nan;0;0
20914;19473;579;0;0;0;0;.00nan;0;0
20914;195672;2259;57;23;3;20;.870;3900000;0
20914;28453;2259;0;0;0;0;.00nan;0;0
20914;160650;579;72;35;3;32;.914;3900000;0
20915;19010;1925;0;0;0;0;.00nan;0;0
20915;178950;2632;16;26;7;19;.731;3600000;0
20915;53936;2632;0;0;0;0;.00nan;0;0
20915;77086;1925;48;19;3;16;.842;3600000;0
20916;6202;1930;70;19;1;18;.947;3600000;0
20916;19473;579;0;0;0;0;.00nan;0;0
20916;-1;1930;0;0;0;0;.00nan;0;0
20916;160650;579;59;24;2;22;.917;3544000;0
20917;170728;5013;96;48;2;46;.958;3600000;0
20917;-1;1927;48;36;6;30;.833;3600000;0
20917;67663;5013;0;0;0;0;.00nan;0;0
20917;153618;1927;0;0;0;0;.00nan;0;0
20918;19010;1925;0;0;0;0;.00nan;0;0
20918;195672;2259;39;38;6;32;.842;3600000;0
20918;28453;2259;0;0;0;0;.00nan;0;0
20918;77086;1925;52;24;3;21;.875;3600000;0
20919;218;4794;53;27;4;23;.852;3600000;0
20919;14459;4794;0;0;0;0;.00nan;0;0
20919;174736;1920;0;0;0;0;.00nan;0;0
20919;149981;1920;44;32;5;27;.844;3600000;0
20920;218;4794;82;28;2;26;.929;3600000;0
20920;14459;4794;0;0;0;0;.00nan;0;0
20920;19473;579;0;0;0;0;.00nan;0;0
20920;160650;579;65;33;3;30;.909;3561000;0
20921;-1;1927;0;0;0;0;.00nan;0;0
20921;-1;1923;0;0;0;0;.00nan;0;0
20921;56653;1923;88;45;4;41;.911;3600000;0
20921;153618;1927;31;30;6;24;.800;3600000;0
20922;19010;1925;0;0;0;0;.00nan;0;0
20922;19473;579;42;25;4;21;.840;3600000;0
20922;77086;1925;19;26;6;20;.769;3547000;0
20922;160650;579;0;0;0;0;.00nan;0;0
20923;6202;1930;60;28;3;25;.893;3600000;0
20923;170728;5013;66;40;5;35;.875;3520000;0
20923;-1;1930;0;0;0;0;.00nan;0;0
20923;67663;5013;0;0;0;0;.00nan;0;0
20924;19010;1925;100;43;0;43;1.000;3600000;0
20924;44487;1934;54;23;3;20;.870;3600000;0
20924;72514;1934;0;0;0;0;.00nan;0;0
20924;77086;1925;0;0;0;0;.00nan;0;0
20925;-1;1923;0;0;0;0;.00nan;0;0
20925;56653;1923;52;47;6;41;.872;3600000;0
20925;67122;584;0;0;0;0;.00nan;0;0
20925;85984;584;56;16;3;13;.813;3600000;0
20926;-1;1923;57;35;5;30;.857;3832000;0
20926;44487;1934;0;0;0;0;.00nan;0;0
20926;56653;1923;0;0;0;0;.00nan;0;0
20926;72514;1934;47;25;4;21;.840;3832000;0
20927;218;4794;54;14;2;12;.857;3600000;0
20927;14459;4794;0;0;0;0;.00nan;0;0
20927;195672;2259;28;21;5;16;.762;1784000;0
20927;28453;2259;60;20;2;18;.900;1816000;0
20928;19473;579;0;0;0;0;.00nan;0;0
20928;178950;2632;65;19;1;18;.947;3600000;0
20928;53936;2632;0;0;0;0;.00nan;0;0
20928;160650;579;66;33;3;30;.909;3514000;0
20929;174736;1920;0;0;0;0;.00nan;0;0
20929;-1;1927;55;30;3;27;.900;3900000;0
20929;149981;1920;70;30;3;27;.900;3900000;0
20929;153618;1927;0;0;0;0;.00nan;0;0
20930;6202;1930;59;32;4;28;.875;3600000;0
20930;44487;1934;93;30;1;29;.967;3600000;0
20930;-1;1930;0;0;0;0;.00nan;0;0
20930;72514;1934;0;0;0;0;.00nan;0;0
20931;174736;1920;0;0;0;0;.00nan;0;0
20931;-1;1927;31;23;6;17;.739;2749000;0
20931;149981;1920;63;32;4;28;.875;3600000;0
20931;153618;1927;44;3;1;2;.667;851000;0
20932;178950;2632;73;38;4;34;.895;3900000;0
20932;-1;1923;0;0;0;0;.00nan;0;0
20932;53936;2632;0;0;0;0;.00nan;0;0
20932;56653;1923;71;40;4;36;.900;3900000;0
20933;170728;5013;74;41;4;37;.902;3600000;0
20933;195672;2259;59;27;3;24;.889;3600000;0
20933;28453;2259;0;0;0;0;.00nan;0;0
20933;67663;5013;0;0;0;0;.00nan;0;0
20934;19473;579;0;0;0;0;.00nan;0;0
20934;174736;1920;62;47;7;40;.851;3600000;0
20934;149981;1920;0;0;0;0;.00nan;0;0
20934;160650;579;82;26;1;25;.962;3600000;0
20935;218;4794;21;12;4;8;.667;668000;0
20935;14459;4794;73;30;3;27;.900;2932000;0
20935;19010;1925;61;33;4;29;.879;3600000;0
20935;77086;1925;0;0;0;0;.00nan;0;0
20936;-1;1927;64;11;0;11;1.000;522000;0
20936;67122;584;0;0;0;0;.00nan;0;0
20936;85984;584;82;28;1;27;.964;3600000;0
20936;153618;1927;54;47;6;41;.872;3078000;0
20937;6202;1930;0;0;0;0;.00nan;0;0
20937;19473;579;34;27;5;22;.815;2455000;0
20937;-1;1930;88;33;1;32;.970;3600000;0
20937;160650;579;30;14;4;10;.714;1145000;0
20938;195672;2259;94;44;2;42;.955;3600000;0
20938;28453;2259;0;0;0;0;.00nan;0;0
20938;-1;1923;0;0;0;0;.00nan;0;0
20938;56653;1923;57;27;3;24;.889;3600000;0
20939;6202;1930;98;40;2;38;.950;3900000;0
20939;19010;1925;0;0;0;0;.00nan;0;0
20939;-1;1930;0;0;0;0;.00nan;0;0
20939;77086;1925;80;34;2;32;.941;3900000;0
20940;178950;2632;53;23;3;20;.870;3900000;0
20940;174736;1920;0;0;0;0;.00nan;0;0
20940;53936;2632;0;0;0;0;.00nan;0;0
20940;149981;1920;83;38;3;35;.921;3900000;0
20941;6202;1930;0;0;0;0;.00nan;0;0
20941;-1;1927;97;42;3;39;.929;3557000;0
20941;-1;1930;97;33;1;32;.970;3600000;0
20941;153618;1927;0;0;0;0;.00nan;0;0
20942;195672;2259;58;47;6;41;.872;3181000;0
20942;28453;2259;39;13;3;10;.769;419000;0
20942;44487;1934;64;14;1;13;.929;3600000;0
20942;72514;1934;0;0;0;0;.00nan;0;0
20943;170728;5013;48;27;5;22;.815;3515000;0
20943;174736;1920;62;30;3;27;.900;3600000;0
20943;67663;5013;0;0;0;0;.00nan;0;0
20943;149981;1920;0;0;0;0;.00nan;0;0
20944;19010;1925;0;0;0;0;.00nan;0;0
20944;19473;579;0;0;0;0;.00nan;0;0
20944;77086;1925;91;22;0;22;1.000;3600000;0
20944;160650;579;26;31;7;24;.774;3600000;0
20945;218;4794;77;36;4;32;.889;3542000;0
20945;14459;4794;0;0;0;0;.00nan;0;0
20945;67122;584;0;0;0;0;.00nan;0;0
20945;85984;584;72;26;2;24;.923;3600000;0
20946;19473;579;85;35;2;33;.943;3600000;0
20946;170728;5013;0;0;0;0;.00nan;0;0
20946;67663;5013;75;41;4;37;.902;3587000;0
20946;160650;579;0;0;0;0;.00nan;0;0
20947;178950;2632;74;29;2;27;.931;3600000;0
20947;44487;1934;50;28;4;24;.857;3540000;0
20947;53936;2632;0;0;0;0;.00nan;0;0
20947;72514;1934;0;0;0;0;.00nan;0;0
20948;44487;1934;70;52;6;46;.885;3600000;0
20948;67122;584;0;0;0;0;.00nan;0;0
20948;72514;1934;0;0;0;0;.00nan;0;0
20948;85984;584;83;26;1;25;.962;3600000;0
20949;19473;579;43;35;6;29;.829;2783000;0
20949;178950;2632;0;0;0;0;.00nan;0;0
20949;53936;2632;82;28;1;27;.964;3600000;0
20949;160650;579;60;8;0;8;1.000;817000;0
20950;6202;1930;0;0;0;0;.00nan;0;0
20950;195672;2259;72;35;3;32;.914;3582000;0
20950;28453;2259;0;0;0;0;.00nan;0;0
20950;155943;1930;80;27;1;26;.963;3600000;0
20951;178950;2632;65;37;4;33;.892;3900000;0
20951;170728;5013;79;39;4;35;.897;3900000;0
20951;53936;2632;0;0;0;0;.00nan;0;0
20951;67663;5013;0;0;0;0;.00nan;0;0
20952;218;4794;0;0;0;0;.00nan;0;0
20952;14459;4794;60;30;3;27;.900;3562000;0
20952;-1;1923;99;38;1;37;.974;3600000;0
20952;56653;1923;0;0;0;0;.00nan;0;0
20953;19010;1925;0;0;0;0;.00nan;0;0
20953;174736;1920;46;5;1;4;.800;482000;0
20953;77086;1925;59;22;2;20;.909;3600000;0
20953;149981;1920;1;33;10;23;.697;3118000;0
20954;19010;1925;0;0;0;0;.00nan;0;0
20954;44487;1934;70;25;2;23;.920;3600000;0
20954;72514;1934;0;0;0;0;.00nan;0;0
20954;77086;1925;52;36;5;31;.861;3600000;0
20955;-1;1927;65;28;3;25;.893;3600000;0
20955;-1;1923;46;7;1;6;.857;674000;0
20955;56653;1923;39;33;6;27;.818;2926000;0
20955;153618;1927;0;0;0;0;.00nan;0;0
20956;174736;1920;0;0;0;0;.00nan;0;0
20956;67122;584;0;0;0;0;.00nan;0;0
20956;85984;584;65;23;2;21;.913;3600000;0
20956;149981;1920;94;51;3;48;.941;3600000;0
20957;218;4794;49;32;4;28;.875;3900000;0
20957;14459;4794;0;0;0;0;.00nan;0;0
20957;-1;1930;0;0;0;0;.00nan;0;0
20957;155943;1930;79;43;4;39;.907;3900000;0
20958;19010;1925;0;0;0;0;.00nan;0;0
20958;-1;1927;0;0;0;0;.00nan;0;0
20958;77086;1925;57;26;3;23;.885;3600000;0
20958;153618;1927;46;31;5;26;.839;3554000;0
20959;170728;5013;95;32;1;31;.969;3600000;0
20959;174736;1920;0;0;0;0;.00nan;0;0
20959;67663;5013;0;0;0;0;.00nan;0;0
20959;149981;1920;87;39;2;37;.949;3551000;0
20960;195672;2259;89;62;3;59;.952;3588000;0
20960;28453;2259;0;0;0;0;.00nan;0;0
20960;67122;584;0;0;0;0;.00nan;0;0
20960;85984;584;66;17;2;15;.882;3600000;0
20961;-1;1923;98;21;0;21;1.000;3600000;0
20961;44487;1934;80;24;2;22;.917;3584000;0
20961;56653;1923;0;0;0;0;.00nan;0;0
20961;72514;1934;0;0;0;0;.00nan;0;0
20962;170728;5013;70;51;6;45;.882;3332000;0
20962;44487;1934;83;21;1;20;.952;3600000;0
20962;67663;5013;50;1;0;1;1.000;268000;0
20962;72514;1934;0;0;0;0;.00nan;0;0
20963;218;4794;21;39;8;31;.795;3600000;0
20963;14459;4794;0;0;0;0;.00nan;0;0
20963;19473;579;84;46;3;43;.935;3600000;0
20963;160650;579;0;0;0;0;.00nan;0;0
20964;174736;1920;0;0;0;0;.00nan;0;0
20964;-1;1923;41;33;6;27;.818;3600000;0
20964;56653;1923;0;0;0;0;.00nan;0;0
20964;149981;1920;97;39;2;37;.949;3600000;0
20965;178950;2632;17;36;8;28;.778;3600000;0
20965;53936;2632;0;0;0;0;.00nan;0;0
20965;67122;584;0;0;0;0;.00nan;0;0
20965;85984;584;53;20;3;17;.850;3600000;0
20966;44487;1934;48;37;5;32;.865;3851000;0
20966;-1;1930;0;0;0;0;.00nan;0;0
20966;72514;1934;0;0;0;0;.00nan;0;0
20966;155943;1930;43;29;5;24;.828;3900000;0
20967;218;4794;72;34;3;31;.912;3900000;0
20967;14459;4794;0;0;0;0;.00nan;0;0
20967;-1;1927;78;34;3;31;.912;3900000;0
20967;153618;1927;0;0;0;0;.00nan;0;0
20968;19010;1925;0;0;0;0;.00nan;0;0
20968;67122;584;0;0;0;0;.00nan;0;0
20968;77086;1925;75;42;4;38;.905;3600000;0
20968;85984;584;73;21;1;20;.952;3600000;0
20969;218;4794;55;40;6;34;.850;3600000;0
20969;14459;4794;0;0;0;0;.00nan;0;0
20969;-1;1930;0;0;0;0;.00nan;0;0
20969;155943;1930;85;33;2;31;.939;3600000;0
20970;170728;5013;49;30;5;25;.833;3798000;0
20970;-1;1923;57;30;4;26;.867;3742000;0
20970;56653;1923;0;0;0;0;.00nan;0;0
20970;67663;5013;0;0;0;0;.00nan;0;0
20971;174736;1920;0;0;0;0;.00nan;0;0
20971;195672;2259;44;41;6;35;.854;3600000;0
20971;28453;2259;0;0;0;0;.00nan;0;0
20971;149981;1920;47;22;3;19;.864;3600000;0
20972;-1;1927;85;53;5;48;.906;3600000;0
20972;67122;584;0;0;0;0;.00nan;0;0
20972;85984;584;100;22;0;22;1.000;3600000;0
20972;153618;1927;0;0;0;0;.00nan;0;0
20973;170728;5013;31;29;6;23;.793;2618000;0
20973;195672;2259;0;0;0;0;.00nan;0;0
20973;28453;2259;35;37;6;31;.838;3600000;0
20973;67663;5013;31;4;2;2;.500;897000;0
20974;-1;1927;0;0;0;0;.00nan;0;0
20974;44487;1934;97;26;1;25;.962;3600000;0
20974;72514;1934;0;0;0;0;.00nan;0;0
20974;153618;1927;76;45;4;41;.911;3600000;0
20975;19473;579;55;28;3;25;.893;3600000;0
20975;178950;2632;62;36;4;32;.889;3600000;0
20975;53936;2632;0;0;0;0;.00nan;0;0
20975;160650;579;0;0;0;0;.00nan;0;0
20976;19010;1925;0;0;0;0;.00nan;0;0
20976;-1;1930;0;0;0;0;.00nan;0;0
20976;77086;1925;48;34;5;29;.853;3600000;0
20976;155943;1930;56;22;3;19;.864;3600000;0
20977;218;4794;0;0;0;0;.00nan;0;0
20977;14459;4794;35;26;5;21;.808;3621000;0
20977;19010;1925;0;0;0;0;.00nan;0;0
20977;77086;1925;62;34;4;30;.882;3621000;0
20978;19473;579;0;0;0;0;.00nan;0;0
20978;174736;1920;0;0;0;0;.00nan;0;0
20978;149981;1920;85;26;1;25;.962;3600000;0
20978;160650;579;64;30;3;27;.900;3600000;0
20979;178950;2632;0;0;0;0;.00nan;0;0
20979;-1;1923;68;24;2;22;.917;3600000;0
20979;53936;2632;45;36;5;31;.861;3600000;0
20979;56653;1923;0;0;0;0;.00nan;0;0
20980;44487;1934;70;26;3;23;.885;3600000;0
20980;67122;584;0;0;0;0;.00nan;0;0
20980;72514;1934;0;0;0;0;.00nan;0;0
20980;85984;584;40;21;4;17;.810;3551000;0
20981;170728;5013;72;36;3;33;.917;3540000;0
20981;-1;1923;88;29;1;28;.966;3600000;0
20981;56653;1923;0;0;0;0;.00nan;0;0
20981;67663;5013;0;0;0;0;.00nan;0;0
20982;19010;1925;0;0;0;0;.00nan;0;0
20982;-1;1927;55;46;6;40;.870;3557000;0
20982;77086;1925;62;30;4;26;.867;3600000;0
20982;153618;1927;0;0;0;0;.00nan;0;0
20983;178950;2632;91;21;0;21;1.000;3600000;0
20983;174736;1920;0;0;0;0;.00nan;0;0
20983;53936;2632;0;0;0;0;.00nan;0;0
20983;149981;1920;40;25;4;21;.840;3600000;0
20984;19473;579;0;0;0;0;.00nan;0;0
20984;195672;2259;26;29;6;23;.793;2703000;0
20984;28453;2259;40;8;2;6;.750;897000;0
20984;160650;579;100;35;0;35;1.000;3600000;0
20985;-1;1927;0;0;0;0;.00nan;0;0
20985;-1;1930;0;0;0;0;.00nan;0;0
20985;153618;1927;60;55;7;48;.873;3527000;0
20985;155943;1930;36;22;5;17;.773;3600000;0
20986;174736;1920;0;0;0;0;.00nan;0;0
20986;-1;1923;0;0;0;0;.00nan;0;0
20986;56653;1923;72;33;3;30;.909;3600000;0
20986;149981;1920;40;30;5;25;.833;3545000;0
20987;19010;1925;0;0;0;0;.00nan;0;0
20987;67122;584;0;0;0;0;.00nan;0;0
20987;77086;1925;55;34;5;29;.853;3600000;0
20987;85984;584;71;31;3;28;.903;3600000;0
20988;218;4794;36;30;5;25;.833;3600000;0
20988;14459;4794;0;0;0;0;.00nan;0;0
20988;44487;1934;97;34;2;32;.941;3600000;0
20988;72514;1934;0;0;0;0;.00nan;0;0
20989;19473;579;0;0;0;0;.00nan;0;0
20989;170728;5013;27;18;6;12;.667;2383000;0
20989;67663;5013;50;12;2;10;.833;1217000;0
20989;160650;579;68;34;3;31;.912;3600000;0
20990;178950;2632;35;21;4;17;.810;3524000;0
20990;195672;2259;0;0;0;0;.00nan;0;0
20990;28453;2259;100;44;2;42;.955;3600000;0
20990;53936;2632;0;0;0;0;.00nan;0;0
20991;44487;1934;91;40;2;38;.950;3582000;0
20991;-1;1930;0;0;0;0;.00nan;0;0
20991;72514;1934;0;0;0;0;.00nan;0;0
20991;155943;1930;74;15;1;14;.933;3600000;0
20992;218;4794;57;33;4;29;.879;3528000;0
20992;14459;4794;0;0;0;0;.00nan;0;0
20992;-1;1927;77;29;2;27;.931;3600000;0
20992;153618;1927;0;0;0;0;.00nan;0;0
20993;195672;2259;86;27;1;26;.963;3600000;0
20993;28453;2259;0;0;0;0;.00nan;0;0
20993;-1;1923;74;29;2;27;.931;3546000;0
20993;56653;1923;0;0;0;0;.00nan;0;0
20994;178950;2632;64;41;4;37;.902;3600000;0
20994;174736;1920;0;0;0;0;.00nan;0;0
20994;53936;2632;0;0;0;0;.00nan;0;0
20994;149981;1920;79;27;2;25;.926;3600000;0
20995;-1;1930;0;0;0;0;.00nan;0;0
20995;67122;584;0;0;0;0;.00nan;0;0
20995;85984;584;46;43;6;37;.860;3861000;0
20995;155943;1930;30;26;6;20;.769;3900000;0
20996;19010;1925;0;0;0;0;.00nan;0;0
20996;44487;1934;62;26;3;23;.885;3600000;0
20996;72514;1934;0;0;0;0;.00nan;0;0
20996;77086;1925;68;44;5;39;.886;3600000;0
20997;218;4794;45;39;6;33;.846;2841000;0
20997;14459;4794;19;12;4;8;.667;759000;0
20997;67122;584;0;0;0;0;.00nan;0;0
20997;85984;584;63;31;4;27;.871;3600000;0
20998;19473;579;64;12;0;12;1.000;1633000;0
20998;-1;1923;0;0;0;0;.00nan;0;0
20998;56653;1923;69;28;2;26;.929;3600000;0
20998;160650;579;1;18;8;10;.556;1967000;0
20999;170728;5013;70;35;4;31;.886;3568000;0
20999;174736;1920;0;0;0;0;.00nan;0;0
20999;67663;5013;0;0;0;0;.00nan;0;0
20999;149981;1920;86;36;3;33;.917;3600000;0
21000;178950;2632;82;24;1;23;.958;3600000;0
21000;170728;5013;48;0;0;0;.00nan;246000;0
21000;53936;2632;0;0;0;0;.00nan;0;0
21000;67663;5013;1;32;9;23;.719;3354000;0
21001;19473;579;70;19;1;18;.947;3600000;0
21001;195672;2259;88;50;4;46;.920;3600000;0
21001;28453;2259;0;0;0;0;.00nan;0;0
21001;160650;579;0;0;0;0;.00nan;0;0
21003;11687;1934;87;25;0;25;1.000;3600000;0
21003;174736;1920;0;0;0;0;.00nan;0;0
21003;72514;1934;0;0;0;0;.00nan;0;0
21003;149981;1920;47;33;5;28;.848;3600000;0
21005;14459;4794;0;0;0;0;.00nan;0;0
21005;19473;579;74;38;4;34;.895;3600000;0
21005;190423;4794;72;26;2;24;.923;3600000;0
21005;160650;579;0;0;0;0;.00nan;0;0
21007;-1;1927;0;0;0;0;.00nan;0;0
21007;-1;1923;71;21;1;20;.952;3600000;0
21007;56653;1923;0;0;0;0;.00nan;0;0
21007;153618;1927;23;36;8;28;.778;3600000;0
21009;19010;1925;57;23;3;20;.870;3600000;0
21009;56901;1925;0;0;0;0;.00nan;0;0
21009;67162;5013;0;0;0;0;.00nan;0;0
21009;67663;5013;52;42;5;37;.881;3569000;0
21011;6202;1930;0;0;0;0;.00nan;0;0
21011;180535;2632;39;24;5;19;.792;3540000;0
21011;-1;1930;99;60;3;57;.950;3600000;0
21011;53936;2632;0;0;0;0;.00nan;0;0
21013;14259;584;66;22;1;21;.955;2818000;0
21013;195672;2259;26;30;7;23;.767;2211000;0
21013;28453;2259;66;17;1;16;.941;1389000;0
21013;-1;584;34;17;4;13;.765;782000;0
21015;6202;1930;70;35;3;32;.914;3600000;0
21015;14259;584;0;0;0;0;.00nan;0;0
21015;-1;1930;0;0;0;0;.00nan;0;0
21015;-1;584;86;14;0;14;1.000;3600000;0
21017;174736;1920;57;25;3;22;.880;3600000;0
21017;195672;2259;49;24;4;20;.833;3542000;0
21017;28453;2259;0;0;0;0;.00nan;0;0
21017;149981;1920;0;0;0;0;.00nan;0;0
21019;14459;4794;30;27;6;21;.778;3600000;0
21019;190423;4794;0;0;0;0;.00nan;0;0
21019;180535;2632;0;0;0;0;.00nan;0;0
21019;53936;2632;79;42;3;39;.929;3600000;0
21021;11687;1934;59;31;4;27;.871;3600000;0
21021;67162;5013;42;36;6;30;.833;3527000;0
21021;67663;5013;0;0;0;0;.00nan;0;0
21021;72514;1934;0;0;0;0;.00nan;0;0
21023;-1;1927;95;40;1;39;.975;3600000;0
21023;-1;1923;0;0;0;0;.00nan;0;0
21023;56653;1923;49;29;4;25;.862;3600000;0
21023;153618;1927;0;0;0;0;.00nan;0;0
21025;19010;1925;0;0;0;0;.00nan;0;0
21025;19473;579;0;0;0;0;.00nan;0;0
21025;56901;1925;56;35;5;30;.857;3631000;0
21025;160650;579;46;28;4;24;.857;3631000;0
21027;14259;584;0;0;0;0;.00nan;0;0
21027;180535;2632;67;37;4;33;.892;3600000;0
21027;-1;584;84;21;1;20;.952;3600000;0
21027;53936;2632;0;0;0;0;.00nan;0;0
21029;19473;579;88;35;2;33;.943;3708000;0
21029;-1;1927;77;37;3;34;.919;3715000;0
21029;153618;1927;0;0;0;0;.00nan;0;0
21029;160650;579;0;0;0;0;.00nan;0;0
21031;174736;1920;0;0;0;0;.00nan;0;0
21031;67162;5013;31;37;7;30;.811;3041000;0
21031;67663;5013;53;3;0;3;1.000;559000;0
21031;149981;1920;79;29;2;27;.931;3600000;0
21033;218;4794;63;23;2;21;.913;3600000;0
21033;14459;4794;0;0;0;0;.00nan;0;0
21033;195672;2259;0;0;0;0;.00nan;0;0
21033;28453;2259;65;33;3;30;.909;3595000;0
21035;11687;1934;0;0;0;0;.00nan;0;0
21035;19010;1925;0;0;0;0;.00nan;0;0
21035;56901;1925;50;31;5;26;.839;3600000;0
21035;72514;1934;75;25;3;22;.880;3600000;0
21037;6202;1930;54;5;0;5;1.000;855000;0
21037;-1;1923;75;21;2;19;.905;3600000;0
21037;-1;1930;18;25;6;19;.760;2745000;0
21037;56653;1923;0;0;0;0;.00nan;0;0
21039;19473;579;0;0;0;0;.00nan;0;0
21039;195672;2259;61;41;5;36;.878;3600000;0
21039;28453;2259;0;0;0;0;.00nan;0;0
21039;160650;579;53;20;3;17;.850;3600000;0
21041;174736;1920;76;31;3;28;.903;3600000;0
21041;-1;1927;0;0;0;0;.00nan;0;0
21041;149981;1920;0;0;0;0;.00nan;0;0
21041;153618;1927;41;29;5;24;.828;3529000;0
21043;11687;1934;66;14;1;13;.929;3600000;0
21043;67162;5013;0;0;0;0;.00nan;0;0
21043;67663;5013;78;41;4;37;.902;3576000;0
21043;72514;1934;0;0;0;0;.00nan;0;0
21045;218;4794;0;0;0;0;.00nan;0;0
21045;6202;1930;49;20;3;17;.850;3600000;0
21045;14459;4794;46;29;4;25;.862;3574000;0
21045;-1;1930;0;0;0;0;.00nan;0;0
21047;14259;584;41;22;4;18;.818;3750000;0
21047;19010;1925;42;34;5;29;.853;3750000;0
21047;-1;584;0;0;0;0;.00nan;0;0
21047;56901;1925;0;0;0;0;.00nan;0;0
21049;180535;2632;0;0;0;0;.00nan;0;0
21049;-1;1923;0;0;0;0;.00nan;0;0
21049;53936;2632;55;30;4;26;.867;3600000;0
21049;56653;1923;65;46;5;41;.891;3554000;0
22341;-1;1923;94;34;2;32;.941;3566000;0
22341;56653;1923;0;0;0;0;.00nan;0;0
22341;67122;584;0;0;0;0;.00nan;0;0
22341;85984;584;83;24;1;23;.958;3600000;0
22342;174736;1920;88;48;4;44;.917;3596000;0
22342;44487;1934;61;18;2;16;.889;3600000;0
22342;72514;1934;0;0;0;0;.00nan;0;0
22342;149981;1920;0;0;0;0;.00nan;0;0
22343;19010;1925;0;0;0;0;.00nan;0;0
22343;-1;1930;0;0;0;0;.00nan;0;0
22343;77086;1925;83;28;1;27;.964;3600000;0
22343;155943;1930;35;25;5;20;.800;3600000;0
22344;174736;1920;0;0;0;0;.00nan;0;0
22344;67122;584;0;0;0;0;.00nan;0;0
22344;85984;584;63;20;2;18;.900;3900000;0
22344;149981;1920;92;36;2;34;.944;3900000;0
22345;19010;1925;68;32;4;28;.875;3290000;0
22345;-1;1923;0;0;0;0;.00nan;0;0
22345;56653;1923;61;19;2;17;.895;3600000;0
22345;77086;1925;25;5;3;2;.400;310000;0
22346;44487;1934;0;0;0;0;.00nan;0;0
22346;-1;1930;0;0;0;0;.00nan;0;0
22346;72514;1934;62;25;3;22;.880;3600000;0
22346;155943;1930;58;33;4;29;.879;3575000;0
22347;19010;1925;28;14;4;10;.714;749000;0
22347;67122;584;0;0;0;0;.00nan;0;0
22347;77086;1925;34;32;6;26;.813;2851000;0
22347;85984;584;53;23;3;20;.870;3600000;0
22348;174736;1920;0;0;0;0;.00nan;0;0
22348;-1;1930;0;0;0;0;.00nan;0;0
22348;149981;1920;75;35;3;32;.914;3587000;0
22348;155943;1930;87;30;2;28;.933;3600000;0
22349;-1;1923;82;28;1;27;.964;3600000;0
22349;44487;1934;35;23;5;18;.783;3600000;0
22349;56653;1923;0;0;0;0;.00nan;0;0
22349;72514;1934;0;0;0;0;.00nan;0;0
22350;-1;1930;0;0;0;0;.00nan;0;0
22350;67122;584;0;0;0;0;.00nan;0;0
22350;85984;584;82;23;1;22;.957;3600000;0
22350;155943;1930;51;36;5;31;.861;3600000;0
22351;19010;1925;0;0;0;0;.00nan;0;0
22351;44487;1934;60;27;3;24;.889;3708000;0
22351;72514;1934;0;0;0;0;.00nan;0;0
22351;77086;1925;74;29;2;27;.931;3708000;0
22352;174736;1920;0;0;0;0;.00nan;0;0
22352;-1;1923;16;31;7;24;.774;3600000;0
22352;56653;1923;0;0;0;0;.00nan;0;0
22352;149981;1920;75;33;3;30;.909;3600000;0
22353;44487;1934;38;23;4;19;.826;3600000;0
22353;67122;584;0;0;0;0;.00nan;0;0
22353;72514;1934;0;0;0;0;.00nan;0;0
22353;85984;584;77;24;1;23;.958;3600000;0
22354;-1;1923;0;0;0;0;.00nan;0;0
22354;-1;1930;0;0;0;0;.00nan;0;0
22354;56653;1923;98;45;2;43;.956;3568000;0
22354;155943;1930;86;21;1;20;.952;3600000;0
22355;19010;1925;0;0;0;0;.00nan;0;0
22355;174736;1920;0;0;0;0;.00nan;0;0
22355;77086;1925;41;22;4;18;.818;3900000;0
22355;149981;1920;56;29;4;25;.862;3900000;0
22356;-1;1923;48;25;4;21;.840;1744000;0
22356;56653;1923;21;21;6;15;.714;1856000;0
22356;67122;584;0;0;0;0;.00nan;0;0
22356;85984;584;69;17;1;16;.941;3600000;0
22357;174736;1920;0;0;0;0;.00nan;0;0
22357;44487;1934;87;32;2;30;.938;3600000;0
22357;72514;1934;0;0;0;0;.00nan;0;0
22357;149981;1920;57;36;5;31;.861;3600000;0
22358;19010;1925;0;0;0;0;.00nan;0;0
22358;-1;1930;0;0;0;0;.00nan;0;0
22358;77086;1925;75;43;3;40;.930;3804000;0
22358;155943;1930;64;21;2;19;.905;3804000;0
22359;174736;1920;88;53;5;48;.906;3600000;0
22359;67122;584;0;0;0;0;.00nan;0;0
22359;85984;584;62;16;2;14;.875;3600000;0
22359;149981;1920;0;0;0;0;.00nan;0;0
22360;19010;1925;0;0;0;0;.00nan;0;0
22360;-1;1923;16;7;4;3;.429;375000;0
22360;56653;1923;40;36;6;30;.833;3225000;0
22360;77086;1925;78;35;3;32;.914;3600000;0
22361;44487;1934;57;27;4;23;.852;3600000;0
22361;-1;1930;32;40;7;33;.825;3600000;0
22361;72514;1934;0;0;0;0;.00nan;0;0
22361;155943;1930;0;0;0;0;.00nan;0;0
22362;19010;1925;0;0;0;0;.00nan;0;0
22362;67122;584;0;0;0;0;.00nan;0;0
22362;77086;1925;74;58;6;52;.897;3563000;0
22362;85984;584;32;18;5;13;.722;3600000;0
22363;174736;1920;0;0;0;0;.00nan;0;0
22363;-1;1930;0;0;0;0;.00nan;0;0
22363;149981;1920;72;37;4;33;.892;3515000;0
22363;155943;1930;54;17;2;15;.882;3600000;0
22364;-1;1923;96;22;0;22;1.000;3600000;0
22364;44487;1934;59;11;1;10;.909;3544000;0
22364;56653;1923;0;0;0;0;.00nan;0;0
22364;72514;1934;0;0;0;0;.00nan;0;0
22371;178950;2632;52;26;3;23;.885;3900000;0
22371;195672;2259;59;29;3;26;.897;3900000;0
22371;28453;2259;0;0;0;0;.00nan;0;0
22371;53936;2632;0;0;0;0;.00nan;0;0
22372;19473;579;0;0;0;0;.00nan;0;0
22372;170728;5013;31;39;7;32;.821;3600000;0
22372;67663;5013;0;0;0;0;.00nan;0;0
22372;160650;579;70;25;2;23;.920;3600000;0
22373;218;4794;83;38;4;34;.895;3900000;0
22373;14459;4794;0;0;0;0;.00nan;0;0
22373;-1;1927;0;0;0;0;.00nan;0;0
22373;153618;1927;67;37;4;33;.892;3900000;0
22374;178950;2632;88;19;0;19;1.000;3600000;0
22374;170728;5013;95;38;1;37;.974;3570000;0
22374;53936;2632;0;0;0;0;.00nan;0;0
22374;67663;5013;0;0;0;0;.00nan;0;0
22375;195672;2259;0;0;0;0;.00nan;0;0
22375;28453;2259;83;50;4;46;.920;3600000;0
22375;-1;1927;37;28;6;22;.786;3524000;0
22375;153618;1927;0;0;0;0;.00nan;0;0
22376;218;4794;83;30;1;29;.967;3600000;0
22376;14459;4794;0;0;0;0;.00nan;0;0
22376;19473;579;0;0;0;0;.00nan;0;0
22376;160650;579;52;30;5;25;.833;3600000;0
22377;178950;2632;68;35;3;32;.914;3560000;0
22377;-1;1927;0;0;0;0;.00nan;0;0
22377;53936;2632;0;0;0;0;.00nan;0;0
22377;153618;1927;56;16;2;14;.875;3600000;0
22378;218;4794;78;33;2;31;.939;3600000;0
22378;14459;4794;0;0;0;0;.00nan;0;0
22378;170728;5013;58;31;4;27;.871;3569000;0
22378;67663;5013;0;0;0;0;.00nan;0;0
22379;19473;579;0;0;0;0;.00nan;0;0
22379;195672;2259;0;0;0;0;.00nan;0;0
22379;28453;2259;73;41;4;37;.902;3860000;0
22379;160650;579;63;29;3;26;.897;3860000;0
22380;218;4794;33;38;7;31;.816;3600000;0
22380;14459;4794;0;0;0;0;.00nan;0;0
22380;178950;2632;74;33;3;30;.909;3600000;0
22380;53936;2632;0;0;0;0;.00nan;0;0
22381;19473;579;0;0;0;0;.00nan;0;0
22381;-1;1927;28;24;6;18;.750;3785000;0
22381;153618;1927;0;0;0;0;.00nan;0;0
22381;160650;579;57;36;5;31;.861;3785000;0
22382;170728;5013;74;23;2;21;.913;3600000;0
22382;195672;2259;66;41;4;37;.902;3600000;0
22382;28453;2259;0;0;0;0;.00nan;0;0
22382;67663;5013;0;0;0;0;.00nan;0;0
22383;19473;579;0;0;0;0;.00nan;0;0
22383;178950;2632;78;38;3;35;.921;3600000;0
22383;53936;2632;0;0;0;0;.00nan;0;0
22383;160650;579;54;34;5;29;.853;3555000;0
22384;218;4794;62;16;1;15;.938;3600000;0
22384;14459;4794;0;0;0;0;.00nan;0;0
22384;195672;2259;0;0;0;0;.00nan;0;0
22384;28453;2259;53;42;6;36;.857;3600000;0
22385;170728;5013;54;32;5;27;.844;3600000;0
22385;-1;1927;100;46;0;46;1.000;3600000;0
22385;67663;5013;0;0;0;0;.00nan;0;0
22385;153618;1927;0;0;0;0;.00nan;0;0
22386;178950;2632;60;33;5;28;.848;3600000;0
22386;195672;2259;32;30;6;24;.800;3600000;0
22386;28453;2259;0;0;0;0;.00nan;0;0
22386;53936;2632;0;0;0;0;.00nan;0;0
22387;19473;579;0;0;0;0;.00nan;0;0
22387;170728;5013;20;23;6;17;.739;2677000;0
22387;67663;5013;35;8;3;5;.625;923000;0
22387;160650;579;91;41;3;38;.927;3600000;0
22388;218;4794;59;24;4;20;.833;3900000;0
22388;14459;4794;0;0;0;0;.00nan;0;0
22388;-1;1927;71;35;4;31;.886;3900000;0
22388;153618;1927;0;0;0;0;.00nan;0;0
22389;178950;2632;31;6;3;3;.500;394000;0
22389;170728;5013;90;58;4;54;.931;3600000;0
22389;53936;2632;53;19;3;16;.842;3153000;0
22389;67663;5013;0;0;0;0;.00nan;0;0
22390;195672;2259;35;35;6;29;.829;3600000;0
22390;28453;2259;0;0;0;0;.00nan;0;0
22390;-1;1927;70;29;3;26;.897;3600000;0
22390;153618;1927;0;0;0;0;.00nan;0;0
22391;218;4794;88;30;1;29;.967;3600000;0
22391;14459;4794;0;0;0;0;.00nan;0;0
22391;19473;579;0;0;0;0;.00nan;0;0
22391;160650;579;50;35;5;30;.857;3600000;0
22392;178950;2632;78;26;2;24;.923;3600000;0
22392;-1;1927;0;0;0;0;.00nan;0;0
22392;53936;2632;0;0;0;0;.00nan;0;0
22392;153618;1927;37;43;7;36;.837;3600000;0
22393;218;4794;63;24;2;22;.917;3600000;0
22393;14459;4794;0;0;0;0;.00nan;0;0
22393;170728;5013;17;22;6;16;.727;1629000;0
22393;67663;5013;56;28;3;25;.893;1971000;0
22394;19473;579;0;0;0;0;.00nan;0;0
22394;195672;2259;0;0;0;0;.00nan;0;0
22394;28453;2259;60;36;5;31;.861;3600000;0
22394;160650;579;76;29;1;28;.966;3600000;0
21050;6998;2161;59;30;3;27;.900;3586000;0
21050;193486;2161;0;0;0;0;.00nan;0;0
21050;177771;2163;84;30;2;28;.933;3600000;0
21050;161081;2163;0;0;0;0;.00nan;0;0
21051;21607;2162;0;0;0;0;.00nan;0;0
21051;-1;2164;30;27;6;21;.778;3545000;0
21051;-1;2162;55;33;5;28;.848;3600000;0
21051;-1;2164;0;0;0;0;.00nan;0;0
21052;19346;2158;70;6;0;6;1.000;3600000;0
21052;179350;4840;0;0;0;0;.00nan;0;0
21052;-1;4840;88;66;1;65;.985;3600000;0
21052;161069;2158;0;0;0;0;.00nan;0;0
21053;6998;2161;56;5;0;5;1.000;255000;0
21053;193486;2161;41;36;6;30;.833;3345000;0
21053;177771;2163;58;14;1;13;.929;1696000;0
21053;161081;2163;27;27;6;21;.778;1859000;0
21054;21607;2162;0;0;0;0;.00nan;0;0
21054;-1;2164;93;39;2;37;.949;3600000;0
21054;-1;2162;67;33;3;30;.909;3576000;0
21054;-1;2164;0;0;0;0;.00nan;0;0
21055;19346;2158;83;17;0;17;1.000;3600000;0
21055;179350;4840;83;61;5;56;.918;3600000;0
21055;-1;4840;0;0;0;0;.00nan;0;0
21055;161069;2158;0;0;0;0;.00nan;0;0
21056;-1;2164;79;29;2;27;.931;3600000;0
21056;179350;4840;87;46;3;43;.935;3600000;0
21056;-1;4840;0;0;0;0;.00nan;0;0
21056;-1;2164;0;0;0;0;.00nan;0;0
21057;177771;2163;0;0;0;0;.00nan;0;0
21057;21607;2162;0;0;0;0;.00nan;0;0
21057;-1;2162;97;52;1;51;.981;3584000;0
21057;161081;2163;96;21;0;21;1.000;3600000;0
21058;6998;2161;0;0;0;0;.00nan;0;0
21058;193486;2161;100;56;3;53;.946;3701000;0
21058;19346;2158;39;17;4;13;.765;3701000;0
21058;161069;2158;0;0;0;0;.00nan;0;0
21059;-1;2164;0;0;0;0;.00nan;0;0
21059;179350;4840;39;37;6;31;.838;3600000;0
21059;-1;4840;0;0;0;0;.00nan;0;0
21059;-1;2164;75;24;2;22;.917;3600000;0
21060;177771;2163;0;0;0;0;.00nan;0;0
21060;21607;2162;30;36;7;29;.806;2677000;0
21060;-1;2162;61;6;0;6;1.000;923000;0
21060;161081;2163;76;21;1;20;.952;3600000;0
21061;6998;2161;0;0;0;0;.00nan;0;0
21061;193486;2161;63;39;4;35;.897;3600000;0
21061;19346;2158;0;0;0;0;.00nan;0;0
21061;161069;2158;53;12;1;11;.917;3600000;0
21062;6998;2161;0;0;0;0;.00nan;0;0
21062;193486;2161;64;26;2;24;.923;3600000;0
21062;179350;4840;64;47;5;42;.894;3600000;0
21062;-1;4840;0;0;0;0;.00nan;0;0
21063;19346;2158;64;19;1;18;.947;3600000;0
21063;21607;2162;0;0;0;0;.00nan;0;0
21063;-1;2162;92;46;3;43;.935;3534000;0
21063;161069;2158;0;0;0;0;.00nan;0;0
21064;6998;2161;95;18;0;18;1.000;3600000;0
21064;193486;2161;0;0;0;0;.00nan;0;0
21064;179350;4840;0;0;0;0;.00nan;0;0
21064;-1;4840;88;45;3;42;.933;3600000;0
21065;19346;2158;80;23;1;22;.957;3600000;0
21065;21607;2162;66;30;2;28;.933;3600000;0
21065;-1;2162;0;0;0;0;.00nan;0;0
21065;161069;2158;0;0;0;0;.00nan;0;0
21066;19346;2158;60;30;3;27;.900;3525000;0
21066;-1;2164;86;50;2;48;.960;3600000;0
21066;-1;2164;0;0;0;0;.00nan;0;0
21066;161069;2158;0;0;0;0;.00nan;0;0
21067;6998;2161;57;23;3;20;.870;3600000;0
21067;193486;2161;0;0;0;0;.00nan;0;0
21067;179350;4840;89;53;4;49;.925;3575000;0
21067;-1;4840;0;0;0;0;.00nan;0;0
21068;19346;2158;0;0;0;0;.00nan;0;0
21068;-1;2164;0;0;0;0;.00nan;0;0
21068;-1;2164;87;54;4;50;.926;3600000;0
21068;161069;2158;68;19;1;18;.947;3600000;0
21069;6998;2161;0;0;0;0;.00nan;0;0
21069;193486;2161;55;12;1;11;.917;3600000;0
21069;179350;4840;0;0;0;0;.00nan;0;0
21069;-1;4840;89;44;3;41;.932;3591000;0
21070;177771;2163;0;0;0;0;.00nan;0;0
21070;-1;2164;94;42;2;40;.952;3515000;0
21070;-1;2164;0;0;0;0;.00nan;0;0
21070;161081;2163;82;13;0;13;1.000;3600000;0
21071;21607;2162;0;0;0;0;.00nan;0;0
21071;-1;2162;75;19;1;18;.947;3567000;0
21071;179350;4840;100;45;0;45;1.000;3600000;0
21071;-1;4840;0;0;0;0;.00nan;0;0
21072;6998;2161;93;46;3;43;.935;3900000;0
21072;193486;2161;0;0;0;0;.00nan;0;0
21072;19346;2158;56;16;3;13;.813;3872000;0
21072;161069;2158;0;0;0;0;.00nan;0;0
21073;177771;2163;0;0;0;0;.00nan;0;0
21073;-1;2164;0;0;0;0;.00nan;0;0
21073;-1;2164;68;51;5;46;.902;3600000;0
21073;161081;2163;59;19;2;17;.895;3600000;0
21074;21607;2162;58;16;1;15;.938;3900000;0
21074;-1;2162;0;0;0;0;.00nan;0;0
21074;179350;4840;100;39;1;38;.974;3900000;0
21074;-1;4840;0;0;0;0;.00nan;0;0
21075;6998;2161;0;0;0;0;.00nan;0;0
21075;193486;2161;100;36;0;36;1.000;3900000;0
21075;19346;2158;0;0;0;0;.00nan;0;0
21075;161069;2158;84;23;0;23;1.000;3900000;0
21076;-1;2164;62;30;3;27;.900;3526000;0
21076;179350;4840;76;25;1;24;.960;3600000;0
21076;-1;4840;0;0;0;0;.00nan;0;0
21076;-1;2164;0;0;0;0;.00nan;0;0
21077;19346;2158;0;0;0;0;.00nan;0;0
21077;21607;2162;0;0;0;0;.00nan;0;0
21077;-1;2162;82;55;4;51;.927;3561000;0
21077;161069;2158;46;12;2;10;.833;3600000;0
21078;6998;2161;0;0;0;0;.00nan;0;0
21078;193486;2161;45;29;4;25;.862;3600000;0
21078;177771;2163;0;0;0;0;.00nan;0;0
21078;161081;2163;84;33;1;32;.970;3600000;0
21079;-1;2164;0;0;0;0;.00nan;0;0
21079;179350;4840;0;0;0;0;.00nan;0;0
21079;-1;4840;66;48;6;42;.875;3600000;0
21079;-1;2164;60;22;3;19;.864;3600000;0
21080;19346;2158;71;17;1;16;.941;3600000;0
21080;21607;2162;73;38;4;34;.895;3600000;0
21080;-1;2162;0;0;0;0;.00nan;0;0
21080;161069;2158;0;0;0;0;.00nan;0;0
21081;6998;2161;97;33;1;32;.970;3600000;0
21081;193486;2161;0;0;0;0;.00nan;0;0
21081;177771;2163;82;31;2;29;.935;3551000;0
21081;161081;2163;0;0;0;0;.00nan;0;0
21082;177771;2163;0;0;0;0;.00nan;0;0
21082;179350;4840;88;47;3;44;.936;3900000;0
21082;-1;4840;0;0;0;0;.00nan;0;0
21082;161081;2163;60;19;3;16;.842;3896000;0
21083;19346;2158;54;20;3;17;.850;3900000;0
21083;-1;2164;80;42;3;39;.929;3900000;0
21083;-1;2164;0;0;0;0;.00nan;0;0
21083;161069;2158;0;0;0;0;.00nan;0;0
21084;6998;2161;0;0;0;0;.00nan;0;0
21084;193486;2161;56;25;3;22;.880;3543000;0
21084;21607;2162;0;0;0;0;.00nan;0;0
21084;-1;2162;90;37;2;35;.946;3600000;0
21085;177771;2163;0;0;0;0;.00nan;0;0
21085;179350;4840;89;71;3;68;.958;3600000;0
21085;-1;4840;0;0;0;0;.00nan;0;0
21085;161081;2163;68;5;0;5;1.000;3600000;0
21086;19346;2158;51;19;3;16;.842;3600000;0
21086;-1;2164;0;0;0;0;.00nan;0;0
21086;-1;2164;86;53;4;49;.925;3590000;0
21086;161069;2158;0;0;0;0;.00nan;0;0
21087;6998;2161;97;24;0;24;1.000;3600000;0
21087;193486;2161;0;0;0;0;.00nan;0;0
21087;21607;2162;0;0;0;0;.00nan;0;0
21087;-1;2162;79;33;2;31;.939;3572000;0
21088;177771;2163;0;0;0;0;.00nan;0;0
21088;19346;2158;76;31;2;29;.935;3600000;0
21088;161069;2158;0;0;0;0;.00nan;0;0
21088;161081;2163;56;45;6;39;.867;3600000;0
21089;6998;2161;49;27;4;23;.852;3548000;0
21089;193486;2161;0;0;0;0;.00nan;0;0
21089;-1;2164;99;35;2;33;.943;3600000;0
21089;-1;2164;0;0;0;0;.00nan;0;0
21090;21607;2162;0;0;0;0;.00nan;0;0
21090;-1;2162;72;17;1;16;.941;3600000;0
21090;179350;4840;72;51;5;46;.902;3600000;0
21090;-1;4840;0;0;0;0;.00nan;0;0
21091;177771;2163;98;48;1;47;.979;3600000;0
21091;19346;2158;0;0;0;0;.00nan;0;0
21091;161069;2158;78;15;0;15;1.000;3600000;0
21091;161081;2163;0;0;0;0;.00nan;0;0
21092;6998;2161;0;0;0;0;.00nan;0;0
21092;193486;2161;83;19;1;18;.947;3600000;0
21092;-1;2164;0;0;0;0;.00nan;0;0
21092;-1;2164;82;42;3;39;.929;3535000;0
21093;21607;2162;0;0;0;0;.00nan;0;0
21093;-1;2162;65;26;2;24;.923;3600000;0
21093;179350;4840;66;33;3;30;.909;3595000;0
21093;-1;4840;0;0;0;0;.00nan;0;0
21094;177771;2163;0;0;0;0;.00nan;0;0
21094;21607;2162;0;0;0;0;.00nan;0;0
21094;-1;2162;100;42;0;42;1.000;3600000;0
21094;161081;2163;20;22;6;16;.727;3600000;0
21095;19346;2158;0;0;0;0;.00nan;0;0
21095;179350;4840;55;53;7;46;.868;3600000;0
21095;-1;4840;0;0;0;0;.00nan;0;0
21095;161069;2158;75;22;1;21;.955;3600000;0
21096;6998;2161;46;24;4;20;.833;3543000;0
21096;193486;2161;0;0;0;0;.00nan;0;0
21096;-1;2164;91;35;2;33;.943;3600000;0
21096;-1;2164;0;0;0;0;.00nan;0;0
21097;177771;2163;89;27;1;26;.963;3600000;0
21097;21607;2162;0;0;0;0;.00nan;0;0
21097;-1;2162;74;32;2;30;.938;3547000;0
21097;161081;2163;0;0;0;0;.00nan;0;0
21098;19346;2158;56;14;2;12;.857;3600000;0
21098;179350;4840;45;22;4;18;.818;1128000;0
21098;-1;4840;55;46;6;40;.870;2472000;0
21098;161069;2158;0;0;0;0;.00nan;0;0
21099;6998;2161;0;0;0;0;.00nan;0;0
21099;193486;2161;64;18;1;17;.944;3600000;0
21099;-1;2164;0;0;0;0;.00nan;0;0
21099;-1;2164;63;33;3;30;.909;3532000;0
21100;21607;2162;0;0;0;0;.00nan;0;0
21100;-1;2164;59;27;3;24;.889;3900000;0
21100;-1;2162;68;29;3;26;.897;3900000;0
21100;-1;2164;0;0;0;0;.00nan;0;0
21101;177771;2163;59;19;2;17;.895;1983000;0
21101;19346;2158;61;16;1;15;.938;3600000;0
21101;161069;2158;0;0;0;0;.00nan;0;0
21101;161081;2163;4;13;6;7;.538;1617000;0
21102;21607;2162;0;0;0;0;.00nan;0;0
21102;-1;2164;0;0;0;0;.00nan;0;0
21102;-1;2162;71;33;3;30;.909;3566000;0
21102;-1;2164;79;27;2;25;.926;3600000;0
21103;177771;2163;0;0;0;0;.00nan;0;0
21103;19346;2158;0;0;0;0;.00nan;0;0
21103;161069;2158;74;12;0;12;1.000;3600000;0
21103;161081;2163;84;54;5;49;.907;3600000;0
21104;177771;2163;0;0;0;0;.00nan;0;0
21104;-1;2164;62;35;4;31;.886;3600000;0
21104;-1;2164;0;0;0;0;.00nan;0;0
21104;161081;2163;67;15;1;14;.933;3600000;0
21105;6998;2161;0;0;0;0;.00nan;0;0
21105;193486;2161;38;30;5;25;.833;3600000;0
21105;21607;2162;0;0;0;0;.00nan;0;0
21105;-1;2162;79;38;2;36;.947;3600000;0
21106;177771;2163;59;25;3;22;.880;3600000;0
21106;-1;2164;0;0;0;0;.00nan;0;0
21106;-1;2164;72;33;2;31;.939;3600000;0
21106;161081;2163;0;0;0;0;.00nan;0;0
21107;6998;2161;56;19;2;17;.895;3600000;0
21107;193486;2161;0;0;0;0;.00nan;0;0
21107;21607;2162;84;47;4;43;.915;3600000;0
21107;-1;2162;0;0;0;0;.00nan;0;0
21108;177771;2163;0;0;0;0;.00nan;0;0
21108;179350;4840;27;29;6;23;.793;2142000;0
21108;-1;4840;48;8;1;7;.875;1458000;0
21108;161081;2163;62;21;2;19;.905;3600000;0
21109;19346;2158;0;0;0;0;.00nan;0;0
21109;21607;2162;71;31;3;28;.903;2483000;0
21109;-1;2162;38;21;4;17;.810;1117000;0
21109;161069;2158;45;18;3;15;.833;3600000;0
21110;6998;2161;0;0;0;0;.00nan;0;0
21110;193486;2161;76;34;2;32;.941;3600000;0
21110;-1;2164;75;38;3;35;.921;3544000;0
21110;-1;2164;0;0;0;0;.00nan;0;0
21111;177771;2163;48;21;4;17;.810;3600000;0
21111;179350;4840;71;49;5;44;.898;3600000;0
21111;-1;4840;0;0;0;0;.00nan;0;0
21111;161081;2163;0;0;0;0;.00nan;0;0
21112;19346;2158;42;15;3;12;.800;3600000;0
21112;21607;2162;0;0;0;0;.00nan;0;0
21112;-1;2162;72;53;5;48;.906;3572000;0
21112;161069;2158;0;0;0;0;.00nan;0;0
21113;6998;2161;60;32;3;29;.906;3600000;0
21113;193486;2161;0;0;0;0;.00nan;0;0
21113;-1;2164;0;0;0;0;.00nan;0;0
21113;-1;2164;81;35;2;33;.943;3600000;0
21114;6998;2161;0;0;0;0;.00nan;0;0
21114;193486;2161;63;12;1;11;.917;3600000;0
21114;179350;4840;31;16;4;12;.750;1156000;0
21114;-1;4840;67;31;3;28;.903;2444000;0
21115;177771;2163;58;6;0;6;1.000;243000;0
21115;19346;2158;48;20;3;17;.850;3600000;0
21115;161069;2158;0;0;0;0;.00nan;0;0
21115;161081;2163;66;47;6;41;.872;3357000;0
21116;6998;2161;100;33;1;32;.970;3600000;0
21116;193486;2161;0;0;0;0;.00nan;0;0
21116;179350;4840;95;58;6;52;.897;3600000;0
21116;-1;4840;0;0;0;0;.00nan;0;0
21117;177771;2163;52;22;3;19;.864;3524000;0
21117;19346;2158;0;0;0;0;.00nan;0;0
21117;161069;2158;56;12;1;11;.917;3600000;0
21117;161081;2163;0;0;0;0;.00nan;0;0
21118;177771;2163;0;0;0;0;.00nan;0;0
21118;179350;4840;94;43;2;41;.953;3900000;0
21118;-1;4840;0;0;0;0;.00nan;0;0
21118;161081;2163;58;17;2;15;.882;3900000;0
21119;19346;2158;67;14;1;13;.929;3600000;0
21119;-1;2164;65;56;7;49;.875;3600000;0
21119;-1;2164;0;0;0;0;.00nan;0;0
21119;161069;2158;0;0;0;0;.00nan;0;0
21120;6998;2161;0;0;0;0;.00nan;0;0
21120;193486;2161;68;18;1;17;.944;3900000;0
21120;21607;2162;83;31;1;30;.968;3900000;0
21120;-1;2162;0;0;0;0;.00nan;0;0
21121;177771;2163;48;13;2;11;.846;3600000;0
21121;179350;4840;91;44;3;41;.932;3564000;0
21121;-1;4840;0;0;0;0;.00nan;0;0
21121;161081;2163;0;0;0;0;.00nan;0;0
21122;19346;2158;0;0;0;0;.00nan;0;0
21122;-1;2164;0;0;0;0;.00nan;0;0
21122;-1;2164;98;45;2;43;.956;3522000;0
21122;161069;2158;96;21;0;21;1.000;3600000;0
21123;6998;2161;79;25;1;24;.960;3600000;0
21123;193486;2161;0;0;0;0;.00nan;0;0
21123;21607;2162;0;0;0;0;.00nan;0;0
21123;-1;2162;40;24;4;20;.833;3600000;0
21124;177771;2163;0;0;0;0;.00nan;0;0
21124;-1;2164;74;35;3;32;.914;3784000;0
21124;-1;2164;0;0;0;0;.00nan;0;0
21124;161081;2163;76;29;2;27;.931;3784000;0
21125;21607;2162;0;0;0;0;.00nan;0;0
21125;-1;2162;39;16;3;13;.813;3545000;0
21125;179350;4840;0;0;0;0;.00nan;0;0
21125;-1;4840;80;33;2;31;.939;3600000;0
21126;6998;2161;0;0;0;0;.00nan;0;0
21126;193486;2161;97;53;3;50;.943;3587000;0
21126;19346;2158;0;0;0;0;.00nan;0;0
21126;161069;2158;58;18;2;16;.889;3600000;0
21127;177771;2163;79;25;1;24;.960;3600000;0
21127;-1;2164;0;0;0;0;.00nan;0;0
21127;-1;2164;65;40;5;35;.875;3600000;0
21127;161081;2163;0;0;0;0;.00nan;0;0
21128;21607;2162;0;0;0;0;.00nan;0;0
21128;-1;2162;47;32;5;27;.844;3554000;0
21128;179350;4840;62;34;4;30;.882;3600000;0
21128;-1;4840;0;0;0;0;.00nan;0;0
21129;6998;2161;98;55;3;52;.945;3548000;0
21129;193486;2161;0;0;0;0;.00nan;0;0
21129;19346;2158;63;14;1;13;.929;3600000;0
21129;161069;2158;0;0;0;0;.00nan;0;0
21130;177771;2163;0;0;0;0;.00nan;0;0
21130;21607;2162;0;0;0;0;.00nan;0;0
21130;-1;2162;84;40;2;38;.950;3900000;0
21130;161081;2163;70;29;2;27;.931;3900000;0
21131;6998;2161;0;0;0;0;.00nan;0;0
21131;193486;2161;54;20;2;18;.900;3600000;0
21131;-1;2164;43;21;4;17;.810;1945000;0
21131;-1;2164;36;13;3;10;.769;1655000;0
21132;19346;2158;71;6;0;6;1.000;3600000;0
21132;179350;4840;92;77;5;72;.935;3600000;0
21132;-1;4840;0;0;0;0;.00nan;0;0
21132;161069;2158;0;0;0;0;.00nan;0;0
21133;177771;2163;67;32;3;29;.906;3600000;0
21133;21607;2162;54;34;4;30;.882;3600000;0
21133;-1;2162;0;0;0;0;.00nan;0;0
21133;161081;2163;0;0;0;0;.00nan;0;0
21134;6998;2161;69;18;1;17;.944;3600000;0
21134;193486;2161;0;0;0;0;.00nan;0;0
21134;-1;2164;0;0;0;0;.00nan;0;0
21134;-1;2164;80;31;2;29;.935;3559000;0
21135;19346;2158;35;5;2;3;.600;3600000;0
21135;179350;4840;0;0;0;0;.00nan;0;0
21135;-1;4840;81;44;4;40;.909;3600000;0
21135;161069;2158;0;0;0;0;.00nan;0;0
21136;177771;2163;0;0;0;0;.00nan;0;0
21136;-1;2164;91;45;2;43;.956;3587000;0
21136;-1;2164;0;0;0;0;.00nan;0;0
21136;161081;2163;61;12;1;11;.917;3600000;0
21137;19346;2158;78;15;1;14;.933;3600000;0
21137;179350;4840;47;41;6;35;.854;2587000;0
21137;-1;4840;65;14;0;14;1.000;1013000;0
21137;161069;2158;0;0;0;0;.00nan;0;0
21138;6998;2161;0;0;0;0;.00nan;0;0
21138;193486;2161;88;16;0;16;1.000;3600000;0
21138;21607;2162;73;12;0;12;1.000;802000;0
21138;-1;2162;26;26;6;20;.769;2798000;0
21139;177771;2163;72;16;1;15;.938;3600000;0
21139;-1;2164;0;0;0;0;.00nan;0;0
21139;-1;2164;61;42;5;37;.881;3600000;0
21139;161081;2163;0;0;0;0;.00nan;0;0
21140;19346;2158;0;0;0;0;.00nan;0;0
21140;179350;4840;0;0;0;0;.00nan;0;0
21140;-1;4840;94;72;0;72;1.000;3900000;0
21140;161069;2158;84;14;0;14;1.000;3900000;0
21141;6998;2161;0;0;0;0;.00nan;0;0
21141;193486;2161;59;18;2;16;.889;3600000;0
21141;21607;2162;0;0;0;0;.00nan;0;0
21141;-1;2162;59;42;5;37;.881;3600000;0
21142;-1;2164;64;22;3;19;.864;3900000;0
21142;179350;4840;0;0;0;0;.00nan;0;0
21142;-1;4840;62;27;3;24;.889;3900000;0
21142;-1;2164;0;0;0;0;.00nan;0;0
21143;19346;2158;0;0;0;0;.00nan;0;0
21143;21607;2162;0;0;0;0;.00nan;0;0
21143;-1;2162;86;54;4;50;.926;3592000;0
21143;161069;2158;83;24;1;23;.958;3600000;0
21144;6998;2161;0;0;0;0;.00nan;0;0
21144;193486;2161;61;31;3;28;.903;3600000;0
21144;177771;2163;0;0;0;0;.00nan;0;0
21144;161081;2163;79;30;2;28;.933;3600000;0
21145;-1;2164;0;0;0;0;.00nan;0;0
21145;179350;4840;70;26;2;24;.923;3600000;0
21145;-1;4840;0;0;0;0;.00nan;0;0
21145;-1;2164;54;20;3;17;.850;3544000;0
21146;19346;2158;68;17;1;16;.941;3600000;0
21146;21607;2162;53;16;2;14;.875;1074000;0
21146;-1;2162;41;40;6;34;.850;2526000;0
21146;161069;2158;0;0;0;0;.00nan;0;0
21147;6998;2161;68;37;3;34;.919;3546000;0
21147;193486;2161;0;0;0;0;.00nan;0;0
21147;177771;2163;72;29;2;27;.931;3600000;0
21147;161081;2163;0;0;0;0;.00nan;0;0
21148;177771;2163;0;0;0;0;.00nan;0;0
21148;179350;4840;60;41;6;35;.854;3600000;0
21148;-1;4840;0;0;0;0;.00nan;0;0
21148;161081;2163;54;17;2;15;.882;3600000;0
21149;21607;2162;0;0;0;0;.00nan;0;0
21149;-1;2164;85;40;3;37;.925;3600000;0
21149;-1;2162;59;21;2;19;.905;3600000;0
21149;-1;2164;0;0;0;0;.00nan;0;0
21150;177771;2163;87;14;0;14;1.000;3600000;0
21150;179350;4840;0;0;0;0;.00nan;0;0
21150;-1;4840;82;40;2;38;.950;3543000;0
21150;161081;2163;0;0;0;0;.00nan;0;0
21151;21607;2162;0;0;0;0;.00nan;0;0
21151;-1;2164;0;0;0;0;.00nan;0;0
21151;-1;2162;90;17;0;17;1.000;3600000;0
21151;-1;2164;76;27;2;25;.926;3581000;0
21171;177771;2163;0;0;0;0;.00nan;0;0
21171;21607;2162;0;0;0;0;.00nan;0;0
21171;-1;2162;63;33;4;29;.879;3900000;0
21171;161081;2163;69;45;4;41;.911;3900000;0
21173;6998;2161;0;0;0;0;.00nan;0;0
21173;193486;2161;73;33;2;31;.939;3600000;0
21173;19346;2158;85;32;1;31;.969;3600000;0
21173;161069;2158;0;0;0;0;.00nan;0;0
21175;-1;2164;75;22;2;20;.909;3600000;0
21175;179350;4840;34;27;5;22;.815;3600000;0
21175;-1;4840;0;0;0;0;.00nan;0;0
21175;-1;2164;0;0;0;0;.00nan;0;0
21177;177771;2163;36;28;5;23;.821;3573000;0
21177;21607;2162;66;30;3;27;.900;3600000;0
21177;-1;2162;0;0;0;0;.00nan;0;0
21177;161081;2163;0;0;0;0;.00nan;0;0
21179;19346;2158;0;0;0;0;.00nan;0;0
21179;179350;4840;0;0;0;0;.00nan;0;0
21179;-1;4840;98;65;3;62;.954;3558000;0
21179;161069;2158;60;15;1;14;.933;3600000;0
21181;6998;2161;62;25;2;23;.920;3573000;0
21181;193486;2161;0;0;0;0;.00nan;0;0
21181;-1;2164;0;0;0;0;.00nan;0;0
21181;-1;2164;91;32;1;31;.969;3600000;0
21183;21607;2162;0;0;0;0;.00nan;0;0
21183;-1;2164;66;32;3;29;.906;3577000;0
21183;-1;2162;62;22;2;20;.909;3600000;0
21183;-1;2164;0;0;0;0;.00nan;0;0
21185;177771;2163;0;0;0;0;.00nan;0;0
21185;19346;2158;65;22;2;20;.909;3546000;0
21185;161069;2158;0;0;0;0;.00nan;0;0
21185;161081;2163;85;29;1;28;.966;3600000;0
21187;6998;2161;0;0;0;0;.00nan;0;0
21187;193486;2161;54;18;2;16;.889;3600000;0
21187;179350;4840;69;37;4;33;.892;3564000;0
21187;-1;4840;0;0;0;0;.00nan;0;0
21189;177771;2163;82;9;0;9;1.000;3600000;0
21189;-1;2164;38;15;3;12;.800;2149000;0
21189;-1;2164;33;32;6;26;.813;1451000;0
21189;161081;2163;0;0;0;0;.00nan;0;0
21191;19346;2158;0;0;0;0;.00nan;0;0
21191;21607;2162;28;16;4;12;.750;638000;0
21191;-1;2162;45;46;7;39;.848;2962000;0
21191;161069;2158;88;19;0;19;1.000;3600000;0
21193;6998;2161;70;17;1;16;.941;3600000;0
21193;193486;2161;0;0;0;0;.00nan;0;0
21193;179350;4840;64;49;6;43;.878;3600000;0
21193;-1;4840;0;0;0;0;.00nan;0;0
21195;21607;2162;0;0;0;0;.00nan;0;0
21195;-1;2162;35;19;4;15;.789;3536000;0
21195;179350;4840;99;49;2;47;.959;3600000;0
21195;-1;4840;0;0;0;0;.00nan;0;0
21197;177771;2163;100;28;0;28;1.000;3600000;0
21197;19346;2158;66;17;1;16;.941;3600000;0
21197;161069;2158;0;0;0;0;.00nan;0;0
21197;161081;2163;0;0;0;0;.00nan;0;0
21199;6998;2161;89;18;0;18;1.000;3600000;0
21199;193486;2161;0;0;0;0;.00nan;0;0
21199;-1;2164;98;40;1;39;.975;3600000;0
21199;-1;2164;0;0;0;0;.00nan;0;0
21201;177771;2163;0;0;0;0;.00nan;0;0
21201;-1;2164;0;0;0;0;.00nan;0;0
21201;-1;2164;68;44;4;40;.909;3600000;0
21201;161081;2163;65;16;1;15;.938;3600000;0
21203;6998;2161;91;51;4;47;.922;3580000;0
21203;193486;2161;0;0;0;0;.00nan;0;0
21203;19346;2158;0;0;0;0;.00nan;0;0
21203;161069;2158;46;19;3;16;.842;3600000;0
21205;21607;2162;66;18;1;17;.944;3600000;0
21205;-1;2162;0;0;0;0;.00nan;0;0
21205;179350;4840;65;41;5;36;.878;3600000;0
21205;-1;4840;0;0;0;0;.00nan;0;0
21206;168021;3796;18;26;6;20;.769;3157000;0
21206;-1;4635;0;0;0;0;.00nan;0;0
21206;57152;4635;81;30;2;28;.933;3600000;0
21206;64736;3796;44;10;2;8;.800;443000;0
21207;-1;3798;0;0;0;0;.00nan;0;0
21207;57390;3800;52;28;4;24;.857;3578000;0
21207;78845;3800;0;0;0;0;.00nan;0;0
21207;85709;3798;51;18;3;15;.833;3600000;0
21208;37638;3797;0;0;0;0;.00nan;0;0
21208;-1;4635;0;0;0;0;.00nan;0;0
21208;57152;4635;100;25;0;25;1.000;3600000;0
21208;91413;3797;68;39;4;35;.897;3600000;0
21209;162846;3795;0;0;0;0;.00nan;0;0
21209;168021;3796;47;30;5;25;.833;3600000;0
21209;59231;3795;53;44;6;38;.864;3594000;0
21209;64736;3796;0;0;0;0;.00nan;0;0
21210;162846;3795;0;0;0;0;.00nan;0;0
21210;-1;3798;0;0;0;0;.00nan;0;0
21210;59231;3795;83;31;2;29;.935;3600000;0
21210;85709;3798;53;34;5;29;.853;3600000;0
21211;37638;3797;0;0;0;0;.00nan;0;0
21211;57390;3800;100;37;0;37;1.000;3600000;0
21211;78845;3800;0;0;0;0;.00nan;0;0
21211;91413;3797;53;22;3;19;.864;3600000;0
21212;-1;3798;0;0;0;0;.00nan;0;0
21212;-1;4635;0;0;0;0;.00nan;0;0
21212;57152;4635;49;20;3;17;.850;3531000;0
21212;85709;3798;93;27;1;26;.963;3600000;0
21213;162846;3795;0;0;0;0;.00nan;0;0
21213;168021;3796;64;36;5;31;.861;3600000;0
21213;59231;3795;65;20;2;18;.900;3600000;0
21213;64736;3796;0;0;0;0;.00nan;0;0
21214;162846;3795;66;38;4;34;.895;3600000;0
21214;37638;3797;82;28;1;27;.964;3600000;0
21214;59231;3795;0;0;0;0;.00nan;0;0
21214;91413;3797;0;0;0;0;.00nan;0;0
21215;168021;3796;0;0;0;0;.00nan;0;0
21215;57390;3800;83;28;1;27;.964;3600000;0
21215;64736;3796;81;36;4;32;.889;3600000;0
21215;78845;3800;0;0;0;0;.00nan;0;0
21216;-1;3798;0;0;0;0;.00nan;0;0
21216;-1;4635;0;0;0;0;.00nan;0;0
21216;57152;4635;45;20;4;16;.800;3545000;0
21216;85709;3798;76;41;3;38;.927;3600000;0
21217;162846;3795;0;0;0;0;.00nan;0;0
21217;57390;3800;78;30;2;28;.933;3600000;0
21217;59231;3795;26;35;7;28;.800;3600000;0
21217;78845;3800;0;0;0;0;.00nan;0;0
21218;168021;3796;50;34;5;29;.853;3600000;0
21218;37638;3797;0;0;0;0;.00nan;0;0
21218;64736;3796;0;0;0;0;.00nan;0;0
21218;91413;3797;100;21;0;21;1.000;3600000;0
21219;-1;3798;60;36;5;31;.861;3600000;0
21219;57390;3800;0;0;0;0;.00nan;0;0
21219;78845;3800;79;24;1;23;.958;3600000;0
21219;85709;3798;0;0;0;0;.00nan;0;0
21220;168021;3796;0;0;0;0;.00nan;0;0
21220;37638;3797;0;0;0;0;.00nan;0;0
21220;64736;3796;28;30;6;24;.800;3600000;0
21220;91413;3797;66;21;2;19;.905;3600000;0
21221;162846;3795;85;25;0;25;1.000;2577000;0
21221;-1;4635;68;22;2;20;.909;3600000;0
21221;57152;4635;0;0;0;0;.00nan;0;0
21221;59231;3795;43;21;4;17;.810;993000;0
21222;168021;3796;51;36;4;32;.889;3600000;0
21222;-1;3798;0;0;0;0;.00nan;0;0
21222;64736;3796;0;0;0;0;.00nan;0;0
21222;85709;3798;87;21;1;20;.952;3600000;0
21223;162846;3795;0;0;0;0;.00nan;0;0
21223;57390;3800;63;24;2;22;.917;3600000;0
21223;59231;3795;56;42;5;37;.881;3600000;0
21223;78845;3800;0;0;0;0;.00nan;0;0
21224;37638;3797;0;0;0;0;.00nan;0;0
21224;-1;4635;0;0;0;0;.00nan;0;0
21224;57152;4635;60;30;3;27;.900;3600000;0
21224;91413;3797;58;30;4;26;.867;3575000;0
21225;168021;3796;0;0;0;0;.00nan;0;0
21225;37638;3797;47;21;3;18;.857;3560000;0
21225;64736;3796;80;29;2;27;.931;3600000;0
21225;91413;3797;0;0;0;0;.00nan;0;0
21226;-1;3798;46;6;1;5;.833;953000;0
21226;37638;3797;0;0;0;0;.00nan;0;0
21226;85709;3798;1;20;7;13;.650;2647000;0
21226;91413;3797;80;31;2;29;.935;3600000;0
21227;162846;3795;0;0;0;0;.00nan;0;0
21227;-1;4635;0;0;0;0;.00nan;0;0
21227;57152;4635;95;19;0;19;1.000;3600000;0
21227;59231;3795;95;52;3;49;.942;3600000;0
21228;168021;3796;53;35;4;31;.886;3900000;0
21228;57390;3800;61;33;4;29;.879;3900000;0
21228;64736;3796;0;0;0;0;.00nan;0;0
21228;78845;3800;0;0;0;0;.00nan;0;0
21229;-1;3798;65;44;5;39;.886;3658000;0
21229;57390;3800;0;0;0;0;.00nan;0;0
21229;78845;3800;59;31;4;27;.871;3658000;0
21229;85709;3798;0;0;0;0;.00nan;0;0
21230;162846;3795;0;0;0;0;.00nan;0;0
21230;-1;3798;0;0;0;0;.00nan;0;0
21230;59231;3795;80;30;2;28;.933;3600000;0
21230;85709;3798;50;25;3;22;.880;3600000;0
21231;37638;3797;0;0;0;0;.00nan;0;0
21231;57390;3800;46;25;4;21;.840;3600000;0
21231;78845;3800;0;0;0;0;.00nan;0;0
21231;91413;3797;88;27;1;26;.963;3600000;0
21232;168021;3796;22;27;6;21;.778;2566000;0
21232;-1;4635;0;0;0;0;.00nan;0;0
21232;57152;4635;89;18;0;18;1.000;3600000;0
21232;64736;3796;21;13;4;9;.692;1034000;0
21233;162846;3795;73;45;4;41;.911;3749000;0
21233;37638;3797;53;22;3;19;.864;3749000;0
21233;59231;3795;0;0;0;0;.00nan;0;0
21233;91413;3797;0;0;0;0;.00nan;0;0
21234;-1;4635;0;0;0;0;.00nan;0;0
21234;57152;4635;74;24;2;22;.917;3600000;0
21234;57390;3800;46;24;4;20;.833;1541000;0
21234;78845;3800;23;27;6;21;.778;2059000;0
21235;168021;3796;69;30;3;27;.900;3600000;0
21235;-1;3798;0;0;0;0;.00nan;0;0
21235;64736;3796;0;0;0;0;.00nan;0;0
21235;85709;3798;39;30;5;25;.833;3545000;0
21236;168021;3796;0;0;0;0;.00nan;0;0
21236;37638;3797;0;0;0;0;.00nan;0;0
21236;64736;3796;93;21;0;21;1.000;3600000;0
21236;91413;3797;57;24;3;21;.875;3600000;0
21237;162846;3795;0;0;0;0;.00nan;0;0
21237;-1;3798;63;40;4;36;.900;3567000;0
21237;59231;3795;73;25;2;23;.920;3600000;0
21237;85709;3798;0;0;0;0;.00nan;0;0
21238;-1;3798;0;0;0;0;.00nan;0;0
21238;37638;3797;0;0;0;0;.00nan;0;0
21238;85709;3798;60;28;3;25;.893;3600000;0
21238;91413;3797;100;46;1;45;.978;3600000;0
21239;-1;4635;0;0;0;0;.00nan;0;0
21239;57152;4635;83;29;1;28;.966;3600000;0
21239;57390;3800;54;30;4;26;.867;1964000;0
21239;78845;3800;59;20;2;18;.900;1636000;0
21240;162846;3795;0;0;0;0;.00nan;0;0
21240;168021;3796;0;0;0;0;.00nan;0;0
21240;59231;3795;86;35;2;33;.943;3595000;0
21240;64736;3796;72;20;1;19;.950;3600000;0
21241;-1;3798;38;29;5;24;.828;3583000;0
21241;57390;3800;59;24;3;21;.875;3600000;0
21241;78845;3800;0;0;0;0;.00nan;0;0
21241;85709;3798;0;0;0;0;.00nan;0;0
21242;168021;3796;0;0;0;0;.00nan;0;0
21242;37638;3797;0;0;0;0;.00nan;0;0
21242;64736;3796;67;39;4;35;.897;3600000;0
21242;91413;3797;51;35;5;30;.857;3558000;0
21243;162846;3795;0;0;0;0;.00nan;0;0
21243;57390;3800;32;24;5;19;.792;3600000;0
21243;59231;3795;96;40;2;38;.950;3600000;0
21243;78845;3800;0;0;0;0;.00nan;0;0
21244;-1;3798;0;0;0;0;.00nan;0;0
21244;-1;4635;0;0;0;0;.00nan;0;0
21244;57152;4635;37;26;5;21;.808;3600000;0
21244;85709;3798;96;33;1;32;.970;3600000;0
21245;162846;3795;48;29;4;25;.862;3571000;0
21245;37638;3797;0;0;0;0;.00nan;0;0
21245;59231;3795;0;0;0;0;.00nan;0;0
21245;91413;3797;54;16;2;14;.875;3600000;0
21246;-1;4635;0;0;0;0;.00nan;0;0
21246;57152;4635;99;22;0;22;1.000;3600000;0
21246;57390;3800;72;52;5;47;.904;3600000;0
21246;78845;3800;0;0;0;0;.00nan;0;0
21247;-1;3798;0;0;0;0;.00nan;0;0
21247;37638;3797;0;0;0;0;.00nan;0;0
21247;85709;3798;60;25;3;22;.880;3536000;0
21247;91413;3797;91;38;2;36;.947;3600000;0
21248;168021;3796;0;0;0;0;.00nan;0;0
21248;57390;3800;0;0;0;0;.00nan;0;0
21248;64736;3796;64;23;3;20;.870;3568000;0
21248;78845;3800;73;29;2;27;.931;3600000;0
21249;162846;3795;0;0;0;0;.00nan;0;0
21249;-1;4635;24;10;4;6;.600;2789000;0
21249;57152;4635;22;10;4;6;.600;811000;0
21249;59231;3795;91;38;2;36;.947;3600000;0
21250;168021;3796;50;33;5;28;.848;3600000;0
21250;-1;4635;0;0;0;0;.00nan;0;0
21250;57152;4635;65;24;2;22;.917;3600000;0
21250;64736;3796;0;0;0;0;.00nan;0;0
21251;37638;3797;77;25;2;23;.920;3049000;0
21251;-1;4635;41;2;1;1;.500;301000;0
21251;57152;4635;17;33;7;26;.788;3299000;0
21251;91413;3797;32;10;3;7;.700;551000;0
21252;168021;3796;0;0;0;0;.00nan;0;0
21252;-1;3798;0;0;0;0;.00nan;0;0
21252;64736;3796;52;36;5;31;.861;3554000;0
21252;85709;3798;58;31;4;27;.871;3600000;0
21253;162846;3795;0;0;0;0;.00nan;0;0
21253;57390;3800;58;37;4;33;.892;3900000;0
21253;59231;3795;62;32;4;28;.875;3899000;0
21253;78845;3800;0;0;0;0;.00nan;0;0
21254;-1;3798;47;21;4;17;.810;1193000;0
21254;57390;3800;22;29;7;22;.759;3324000;0
21254;78845;3800;50;3;0;3;1.000;276000;0
21254;85709;3798;78;19;0;19;1.000;2407000;0
21255;162846;3795;0;0;0;0;.00nan;0;0
21255;37638;3797;0;0;0;0;.00nan;0;0
21255;59231;3795;75;23;2;21;.913;3600000;0
21255;91413;3797;57;28;3;25;.893;3587000;0
21256;162846;3795;0;0;0;0;.00nan;0;0
21256;-1;3798;0;0;0;0;.00nan;0;0
21256;59231;3795;79;29;2;27;.931;3600000;0
21256;85709;3798;50;30;4;26;.867;3529000;0
21257;37638;3797;0;0;0;0;.00nan;0;0
21257;57390;3800;89;29;1;28;.966;3600000;0
21257;78845;3800;0;0;0;0;.00nan;0;0
21257;91413;3797;65;31;4;27;.871;3600000;0
21258;168021;3796;35;46;8;38;.826;3206000;0
21258;-1;4635;0;0;0;0;.00nan;0;0
21258;57152;4635;59;28;3;25;.893;3600000;0
21258;64736;3796;49;2;0;2;1.000;394000;0
21259;-1;3798;79;33;3;30;.909;3600000;0
21259;-1;4635;0;0;0;0;.00nan;0;0
21259;57152;4635;38;25;5;20;.800;3555000;0
21259;85709;3798;0;0;0;0;.00nan;0;0
21260;162846;3795;0;0;0;0;.00nan;0;0
21260;37638;3797;73;24;1;23;.958;3600000;0
21260;59231;3795;68;46;6;40;.870;3600000;0
21260;91413;3797;0;0;0;0;.00nan;0;0
21261;37638;3797;0;0;0;0;.00nan;0;0
21261;57390;3800;47;33;5;28;.848;3600000;0
21261;78845;3800;0;0;0;0;.00nan;0;0
21261;91413;3797;97;35;2;33;.943;3600000;0
21262;162846;3795;0;0;0;0;.00nan;0;0
21262;-1;4635;0;0;0;0;.00nan;0;0
21262;57152;4635;46;20;4;16;.800;3582000;0
21262;59231;3795;100;43;2;41;.953;3600000;0
21263;168021;3796;41;2;1;1;.500;594000;0
21263;-1;3798;0;0;0;0;.00nan;0;0
21263;64736;3796;45;30;6;24;.800;3006000;0
21263;85709;3798;69;33;3;30;.909;3600000;0
21264;162846;3795;37;6;2;4;.667;407000;0
21264;-1;3798;69;23;2;21;.913;3600000;0
21264;59231;3795;63;48;7;41;.854;3193000;0
21264;85709;3798;0;0;0;0;.00nan;0;0
21265;168021;3796;69;42;4;38;.905;3600000;0
21265;-1;4635;0;0;0;0;.00nan;0;0
21265;57152;4635;89;27;1;26;.963;3600000;0
21265;64736;3796;0;0;0;0;.00nan;0;0
21266;-1;3798;0;0;0;0;.00nan;0;0
21266;37638;3797;0;0;0;0;.00nan;0;0
21266;85709;3798;75;29;2;27;.931;3600000;0
21266;91413;3797;100;26;0;26;1.000;3600000;0
21267;-1;4635;0;0;0;0;.00nan;0;0
21267;57152;4635;72;28;2;26;.929;3600000;0
21267;57390;3800;0;0;0;0;.00nan;0;0
21267;78845;3800;65;33;3;30;.909;3600000;0
21268;162846;3795;0;0;0;0;.00nan;0;0
21268;168021;3796;91;35;1;34;.971;3600000;0
21268;59231;3795;49;26;4;22;.846;3600000;0
21268;64736;3796;0;0;0;0;.00nan;0;0
21269;162846;3795;53;30;4;26;.867;3600000;0
21269;57390;3800;49;19;3;16;.842;3600000;0
21269;59231;3795;0;0;0;0;.00nan;0;0
21269;78845;3800;0;0;0;0;.00nan;0;0
21270;37638;3797;0;0;0;0;.00nan;0;0
21270;57390;3800;34;22;4;18;.818;3600000;0
21270;78845;3800;0;0;0;0;.00nan;0;0
21270;91413;3797;84;23;1;22;.957;3600000;0
21271;168021;3796;85;43;3;40;.930;3669000;0
21271;175530;3796;0;0;0;0;.00nan;0;0
21271;-1;4635;0;0;0;0;.00nan;0;0
21271;57152;4635;55;31;4;27;.871;3666000;0
21272;-1;3798;0;0;0;0;.00nan;0;0
21272;59231;3795;73;33;3;30;.909;3872000;0
21272;64736;3795;0;0;0;0;.00nan;0;0
21272;85709;3798;77;37;3;34;.919;3900000;0
21273;-1;4635;48;27;4;23;.852;3515000;0
21273;57152;4635;0;0;0;0;.00nan;0;0
21273;57390;3800;69;29;2;27;.931;3600000;0
21273;78845;3800;0;0;0;0;.00nan;0;0
21274;-1;3798;0;0;0;0;.00nan;0;0
21274;59231;3795;30;28;6;22;.786;3544000;0
21274;64736;3795;0;0;0;0;.00nan;0;0
21274;85709;3798;94;59;4;55;.932;3600000;0
21275;37638;3797;0;0;0;0;.00nan;0;0
21275;-1;4635;0;0;0;0;.00nan;0;0
21275;57152;4635;34;26;5;21;.808;3551000;0
21275;91413;3797;69;35;3;32;.914;3600000;0
21276;168021;3796;100;51;3;48;.941;3600000;0
21276;175530;3796;0;0;0;0;.00nan;0;0
21276;57390;3800;37;19;4;15;.789;3575000;0
21276;78845;3800;0;0;0;0;.00nan;0;0
21277;-1;3798;0;0;0;0;.00nan;0;0
21277;37638;3797;0;0;0;0;.00nan;0;0
21277;85709;3798;52;23;3;20;.870;3600000;0
21277;91413;3797;100;28;0;28;1.000;3600000;0
21278;168021;3796;54;27;3;24;.889;3600000;0
21278;175530;3796;0;0;0;0;.00nan;0;0
21278;57390;3800;35;21;5;16;.762;3570000;0
21278;78845;3800;0;0;0;0;.00nan;0;0
21279;-1;4635;0;0;0;0;.00nan;0;0
21279;57152;4635;40;30;5;25;.833;3600000;0
21279;59231;3795;77;34;2;32;.941;3600000;0
21279;64736;3795;0;0;0;0;.00nan;0;0
21280;37638;3797;0;0;0;0;.00nan;0;0
21280;59231;3795;66;26;3;23;.885;3629000;0
21280;64736;3795;0;0;0;0;.00nan;0;0
21280;91413;3797;94;46;4;42;.913;3629000;0
21281;-1;4635;0;0;0;0;.00nan;0;0
21281;57152;4635;73;29;3;26;.897;3900000;0
21281;57390;3800;68;27;3;24;.889;3900000;0
21281;78845;3800;0;0;0;0;.00nan;0;0
21282;168021;3796;70;46;5;41;.891;3600000;0
21282;-1;3798;0;0;0;0;.00nan;0;0
21282;175530;3796;0;0;0;0;.00nan;0;0
21282;85709;3798;56;22;2;20;.909;3600000;0
21283;168021;3796;82;41;3;38;.927;3600000;0
21283;175530;3796;0;0;0;0;.00nan;0;0
21283;-1;4635;0;0;0;0;.00nan;0;0
21283;57152;4635;41;28;4;24;.857;3600000;0
21284;168021;3796;0;0;0;0;.00nan;0;0
21284;175530;3796;49;25;3;22;.880;3522000;0
21284;37638;3797;0;0;0;0;.00nan;0;0
21284;91413;3797;85;31;1;30;.968;3600000;0
21285;57390;3800;45;30;6;24;.800;3526000;0
21285;59231;3795;42;25;4;21;.840;3600000;0
21285;64736;3795;0;0;0;0;.00nan;0;0
21285;78845;3800;0;0;0;0;.00nan;0;0
21286;37638;3797;0;0;0;0;.00nan;0;0
21286;-1;4635;0;0;0;0;.00nan;0;0
21286;57152;4635;54;20;3;17;.850;3600000;0
21286;91413;3797;79;50;5;45;.900;3547000;0
21287;-1;3798;0;0;0;0;.00nan;0;0
21287;-1;4635;0;0;0;0;.00nan;0;0
21287;57152;4635;65;25;2;23;.920;3715000;0
21287;85709;3798;92;46;3;43;.935;3715000;0
21288;-1;3798;0;0;0;0;.00nan;0;0
21288;37638;3797;0;0;0;0;.00nan;0;0
21288;85709;3798;63;16;1;15;.938;3600000;0
21288;91413;3797;67;44;5;39;.886;3600000;0
21289;-1;4635;35;27;5;22;.815;3600000;0
21289;57152;4635;0;0;0;0;.00nan;0;0
21289;59231;3795;87;32;1;31;.969;3600000;0
21289;64736;3795;0;0;0;0;.00nan;0;0
21290;168021;3796;56;33;4;29;.879;3600000;0
21290;175530;3796;0;0;0;0;.00nan;0;0
21290;57390;3800;27;24;6;18;.750;3600000;0
21290;78845;3800;0;0;0;0;.00nan;0;0
21291;168021;3796;25;6;3;3;.500;478000;0
21291;175530;3796;31;32;6;26;.813;3122000;0
21291;57390;3800;0;0;0;0;.00nan;0;0
21291;78845;3800;59;31;4;27;.871;3600000;0
21292;37638;3797;30;9;3;6;.667;309000;0
21292;59231;3795;51;25;3;22;.880;3600000;0
21292;64736;3795;0;0;0;0;.00nan;0;0
21292;91413;3797;49;40;5;35;.875;3291000;0
21293;-1;3798;0;0;0;0;.00nan;0;0
21293;37638;3797;0;0;0;0;.00nan;0;0
21293;85709;3798;54;29;4;25;.862;3516000;0
21293;91413;3797;97;41;2;39;.951;3600000;0
21294;-1;4635;0;0;0;0;.00nan;0;0
21294;57152;4635;71;30;3;27;.900;3513000;0
21294;57390;3800;89;21;1;20;.952;3600000;0
21294;78845;3800;0;0;0;0;.00nan;0;0
21295;168021;3796;52;47;6;41;.872;3600000;0
21295;175530;3796;0;0;0;0;.00nan;0;0
21295;59231;3795;87;15;0;15;1.000;3600000;0
21295;64736;3795;0;0;0;0;.00nan;0;0
21296;37638;3797;0;0;0;0;.00nan;0;0
21296;-1;4635;67;26;3;23;.885;3600000;0
21296;57152;4635;0;0;0;0;.00nan;0;0
21296;91413;3797;77;37;4;33;.892;3597000;0
21297;-1;3798;39;36;6;30;.833;3542000;0
21297;57390;3800;0;0;0;0;.00nan;0;0
21297;78845;3800;63;34;4;30;.882;3600000;0
21297;85709;3798;0;0;0;0;.00nan;0;0
21298;168021;3796;0;0;0;0;.00nan;0;0
21298;175530;3796;33;43;7;36;.837;3600000;0
21298;59231;3795;73;21;1;20;.952;3600000;0
21298;64736;3795;0;0;0;0;.00nan;0;0
21299;168021;3796;88;30;1;29;.967;3600000;0
21299;-1;3798;0;0;0;0;.00nan;0;0
21299;175530;3796;0;0;0;0;.00nan;0;0
21299;85709;3798;71;36;4;32;.889;3600000;0
21300;37638;3797;0;0;0;0;.00nan;0;0
21300;59231;3795;56;13;2;11;.846;3600000;0
21300;64736;3795;0;0;0;0;.00nan;0;0
21300;91413;3797;47;27;4;23;.852;3600000;0
21301;168021;3796;56;5;0;5;1.000;856000;0
21301;175530;3796;36;33;6;27;.818;2744000;0
21301;-1;4635;0;0;0;0;.00nan;0;0
21301;57152;4635;63;33;3;30;.909;3600000;0
21302;-1;3798;0;0;0;0;.00nan;0;0
21302;57390;3800;93;44;3;41;.932;3900000;0
21302;78845;3800;0;0;0;0;.00nan;0;0
21302;85709;3798;74;34;3;31;.912;3900000;0
21315;-1;3798;0;0;0;0;.00nan;0;0
21315;57390;3800;35;38;6;32;.842;3331000;0
21315;78845;3800;44;5;1;4;.800;269000;0
21315;85709;3798;60;25;3;22;.880;3600000;0
21317;162846;3795;0;0;0;0;.00nan;0;0
21317;168001;4635;78;25;1;24;.960;3600000;0
21317;-1;4635;0;0;0;0;.00nan;0;0
21317;59231;3795;40;32;6;26;.813;3600000;0
21319;168021;3796;0;0;0;0;.00nan;0;0
21319;37638;3797;0;0;0;0;.00nan;0;0
21319;64736;3796;72;28;3;25;.893;3600000;0
21319;91413;3797;60;39;5;34;.872;3567000;0
21321;168021;3796;29;26;6;20;.769;3117000;0
21321;37638;3797;50;36;6;30;.833;3900000;0
21321;64736;3796;74;9;0;9;1.000;783000;0
21321;91413;3797;0;0;0;0;.00nan;0;0
21323;-1;3798;79;31;2;29;.935;3600000;0
21323;57390;3800;0;0;0;0;.00nan;0;0
21323;78845;3800;71;27;3;24;.889;3600000;0
21323;85709;3798;0;0;0;0;.00nan;0;0
21325;162846;3795;39;41;7;34;.829;3600000;0
21325;168001;4635;0;0;0;0;.00nan;0;0
21325;-1;4635;53;22;3;19;.864;3600000;0
21325;59231;3795;0;0;0;0;.00nan;0;0
21327;168021;3796;92;43;2;41;.953;3600000;0
21327;-1;3798;0;0;0;0;.00nan;0;0
21327;64736;3796;0;0;0;0;.00nan;0;0
21327;85709;3798;75;36;3;33;.917;3553000;0
21329;162846;3795;0;0;0;0;.00nan;0;0
21329;37638;3797;0;0;0;0;.00nan;0;0
21329;59231;3795;62;44;6;38;.864;3565000;0
21329;91413;3797;75;43;4;39;.907;3600000;0
21331;168001;4635;93;32;1;31;.969;3600000;0
21331;-1;4635;0;0;0;0;.00nan;0;0
21331;57390;3800;38;36;6;30;.833;3073000;0
21331;78845;3800;57;5;0;5;1.000;527000;0
21333;168001;4635;75;31;3;28;.903;3900000;0
21333;-1;3798;0;0;0;0;.00nan;0;0
21333;-1;4635;0;0;0;0;.00nan;0;0
21333;85709;3798;84;40;3;37;.925;3900000;0
21335;37638;3797;0;0;0;0;.00nan;0;0
21335;57390;3800;84;22;1;21;.955;3600000;0
21335;78845;3800;0;0;0;0;.00nan;0;0
21335;91413;3797;53;25;4;21;.840;3600000;0
21337;162846;3795;0;0;0;0;.00nan;0;0
21337;168021;3796;0;0;0;0;.00nan;0;0
21337;59231;3795;81;25;2;23;.920;3716000;0
21337;64736;3796;72;21;1;20;.952;3716000;0
21339;168001;4635;0;0;0;0;.00nan;0;0
21339;-1;3798;29;10;3;7;.700;596000;0
21339;-1;4635;85;38;2;36;.947;3600000;0
21339;85709;3798;82;27;2;25;.926;3004000;0
21341;162846;3795;48;38;6;32;.842;3600000;0
21341;57390;3800;0;0;0;0;.00nan;0;0
21341;59231;3795;0;0;0;0;.00nan;0;0
21341;78845;3800;58;11;1;10;.909;3600000;0
21343;168021;3796;68;38;3;35;.921;3562000;0
21343;37638;3797;84;33;1;32;.970;3600000;0
21343;64736;3796;0;0;0;0;.00nan;0;0
21343;91413;3797;0;0;0;0;.00nan;0;0
21345;162846;3795;0;0;0;0;.00nan;0;0
21345;168021;3796;51;35;5;30;.857;3600000;0
21345;59231;3795;18;34;8;26;.765;3600000;0
21345;64736;3796;0;0;0;0;.00nan;0;0
21347;37638;3797;0;0;0;0;.00nan;0;0
21347;-1;4635;0;0;0;0;.00nan;0;0
21347;57152;4635;91;24;1;23;.958;3600000;0
21347;91413;3797;89;47;3;44;.936;3571000;0
21349;-1;3798;0;0;0;0;.00nan;0;0
21349;57390;3800;41;34;5;29;.853;3600000;0
21349;78845;3800;0;0;0;0;.00nan;0;0
21349;85709;3798;71;22;2;20;.909;3600000;0
21350;9524;1422;64;23;2;21;.913;3600000;0
21350;185124;1430;0;0;0;0;.00nan;0;0
21350;66271;1422;0;0;0;0;.00nan;0;0
21350;157845;1430;27;31;6;25;.806;3600000;0
21351;-1;4961;66;23;2;21;.913;3600000;0
21351;185124;1430;53;3;0;3;1.000;310000;0
21351;157845;1430;83;53;4;49;.925;3239000;0
21351;157903;4961;0;0;0;0;.00nan;0;0
21352;2037;4742;0;0;0;0;.00nan;0;0
21352;4127;1440;0;0;0;0;.00nan;0;0
21352;36946;4742;82;17;0;17;1.000;3600000;0
21352;143412;1440;89;53;5;48;.906;3600000;0
21353;163361;1443;50;19;2;17;.895;3600000;0
21353;165030;1453;61;48;6;42;.875;3600000;0
21353;174312;1443;0;0;0;0;.00nan;0;0
21353;185136;1453;0;0;0;0;.00nan;0;0
21354;174175;1425;0;0;0;0;.00nan;0;0
21354;195618;1426;0;0;0;0;.00nan;0;0
21354;32819;1425;20;28;6;22;.786;3555000;0
21354;56058;1426;78;40;4;36;.900;3600000;0
21355;1765;1427;0;0;0;0;.00nan;0;0
21355;-1;1429;0;0;0;0;.00nan;0;0
21355;-1;1427;76;44;3;41;.932;3790000;0
21355;148691;1429;57;23;2;21;.913;3790000;0
21356;1765;1427;0;0;0;0;.00nan;0;0
21356;9524;1422;37;29;5;24;.828;3193000;0
21356;-1;1427;67;34;3;31;.912;3600000;0
21356;66271;1422;21;10;4;6;.600;407000;0
21357;2037;4742;0;0;0;0;.00nan;0;0
21357;4127;1440;42;11;2;9;.818;669000;0
21357;36946;4742;66;13;1;12;.923;3600000;0
21357;143412;1440;43;42;6;36;.857;2931000;0
21358;165030;1453;33;35;7;28;.800;2608000;0
21358;174175;1425;0;0;0;0;.00nan;0;0
21358;32819;1425;48;6;1;5;.833;3600000;0
21358;185136;1453;58;14;2;12;.857;992000;0
21359;163361;1443;70;24;2;22;.917;3600000;0
21359;174312;1443;0;0;0;0;.00nan;0;0
21359;-1;1429;0;0;0;0;.00nan;0;0
21359;148691;1429;52;39;6;33;.846;3600000;0
21360;-1;4961;73;31;3;28;.903;3600000;0
21360;195618;1426;0;0;0;0;.00nan;0;0
21360;56058;1426;64;37;4;33;.892;3558000;0
21360;157903;4961;0;0;0;0;.00nan;0;0
21361;163361;1443;80;23;1;22;.957;3600000;0
21361;9524;1422;73;38;4;34;.895;2478000;0
21361;174312;1443;0;0;0;0;.00nan;0;0
21361;66271;1422;42;23;4;19;.826;1122000;0
21362;4127;1440;0;0;0;0;.00nan;0;0
21362;-1;4961;54;25;3;22;.880;3549000;0
21362;143412;1440;77;31;2;29;.935;3600000;0
21362;157903;4961;0;0;0;0;.00nan;0;0
21363;2037;4742;0;0;0;0;.00nan;0;0
21363;185124;1430;0;0;0;0;.00nan;0;0
21363;36946;4742;65;21;2;19;.905;3600000;0
21363;157845;1430;51;41;6;35;.854;3600000;0
21364;174175;1425;0;0;0;0;.00nan;0;0
21364;32819;1425;42;27;5;22;.815;3600000;0
21364;-1;1429;0;0;0;0;.00nan;0;0
21364;148691;1429;70;31;2;29;.935;3600000;0
21365;1765;1427;0;0;0;0;.00nan;0;0
21365;163361;1443;69;20;1;19;.950;3600000;0
21365;174312;1443;0;0;0;0;.00nan;0;0
21365;-1;1427;68;40;4;36;.900;3600000;0
21366;165030;1453;44;48;8;40;.833;3600000;0
21366;195618;1426;0;0;0;0;.00nan;0;0
21366;185136;1453;0;0;0;0;.00nan;0;0
21366;56058;1426;80;11;0;11;1.000;3600000;0
21367;2037;4742;0;0;0;0;.00nan;0;0
21367;-1;4961;0;0;0;0;.00nan;0;0
21367;36946;4742;22;19;5;14;.737;3534000;0
21367;157903;4961;65;27;3;24;.889;3600000;0
21368;9524;1422;47;7;1;6;.857;862000;0
21368;195618;1426;0;0;0;0;.00nan;0;0
21368;56058;1426;99;42;1;41;.976;3600000;0
21368;66271;1422;21;28;7;21;.750;2738000;0
21369;185124;1430;66;32;3;29;.906;3900000;0
21369;-1;1440;0;0;0;0;.00nan;0;0
21369;143412;1440;82;42;3;39;.929;3900000;0
21369;157845;1430;0;0;0;0;.00nan;0;0
21370;1765;1427;17;15;5;10;.667;3600000;0
21370;165030;1453;46;40;6;34;.850;3576000;0
21370;185136;1453;0;0;0;0;.00nan;0;0
21370;-1;1427;0;0;0;0;.00nan;0;0
21371;4127;1429;35;31;6;25;.806;3600000;0
21371;174175;1425;17;7;4;3;.429;544000;0
21371;32819;1425;44;27;4;23;.852;3034000;0
21371;148691;1429;0;0;0;0;.00nan;0;0
21372;4127;1429;0;0;0;0;.00nan;0;0
21372;-1;1440;0;0;0;0;.00nan;0;0
21372;143412;1440;74;31;3;28;.903;3600000;0
21372;148691;1429;74;19;1;18;.947;3600000;0
21373;2037;4742;0;0;0;0;.00nan;0;0
21373;163361;1443;44;31;5;26;.839;3531000;0
21373;174312;1443;0;0;0;0;.00nan;0;0
21373;36946;4742;63;27;3;24;.889;3600000;0
21374;195618;1426;0;0;0;0;.00nan;0;0
21374;185124;1430;50;26;4;22;.846;3600000;0
21374;56058;1426;95;35;3;32;.914;3600000;0
21374;157845;1430;0;0;0;0;.00nan;0;0
21375;-1;4961;67;28;2;26;.929;3816000;0
21375;174175;1425;0;0;0;0;.00nan;0;0
21375;32819;1425;85;43;3;40;.930;3816000;0
21375;157903;4961;0;0;0;0;.00nan;0;0
21376;1765;1427;0;0;0;0;.00nan;0;0
21376;165030;1453;75;41;4;37;.902;3544000;0
21376;185136;1453;0;0;0;0;.00nan;0;0
21376;-1;1427;57;21;2;19;.905;3600000;0
21377;9524;1422;0;0;0;0;.00nan;0;0
21377;-1;4961;74;37;3;34;.919;3600000;0
21377;66271;1422;99;26;0;26;1.000;3600000;0
21377;157903;4961;0;0;0;0;.00nan;0;0
21378;2037;4742;68;44;5;39;.886;3600000;0
21378;163361;1443;0;0;0;0;.00nan;0;0
21378;174312;1443;49;20;3;17;.850;3600000;0
21378;36946;4742;0;0;0;0;.00nan;0;0
21379;165030;1453;66;36;4;32;.889;3600000;0
21379;185124;1430;0;0;0;0;.00nan;0;0
21379;185136;1453;0;0;0;0;.00nan;0;0
21379;157845;1430;37;24;5;19;.792;3550000;0
21380;4127;1429;66;21;2;19;.905;3600000;0
21380;-1;1440;0;0;0;0;.00nan;0;0
21380;143412;1440;51;51;6;45;.882;3600000;0
21380;148691;1429;0;0;0;0;.00nan;0;0
21381;174175;1425;88;26;1;25;.962;3600000;0
21381;195618;1426;0;0;0;0;.00nan;0;0
21381;32819;1425;0;0;0;0;.00nan;0;0
21381;56058;1426;56;27;5;22;.815;3600000;0
21382;165030;1453;69;37;3;34;.919;3639000;0
21382;-1;4961;47;14;2;12;.857;3639000;0
21382;185136;1453;0;0;0;0;.00nan;0;0
21382;157903;4961;0;0;0;0;.00nan;0;0
21383;9524;1422;0;0;0;0;.00nan;0;0
21383;185124;1430;49;1;0;1;1.000;269000;0
21383;66271;1422;71;30;3;27;.900;3600000;0
21383;157845;1430;31;30;6;24;.800;3331000;0
21384;163361;1443;50;14;2;12;.857;3600000;0
21384;174312;1443;0;0;0;0;.00nan;0;0
21384;-1;1440;0;0;0;0;.00nan;0;0
21384;143412;1440;71;45;5;40;.889;3600000;0
21385;4127;1429;0;0;0;0;.00nan;0;0
21385;195618;1426;22;27;6;21;.778;3104000;0
21385;185123;1426;44;4;1;3;.750;496000;0
21385;148691;1429;100;26;0;26;1.000;3600000;0
21386;165030;1453;100;52;2;50;.962;3600000;0
21386;32819;1425;0;0;0;0;.00nan;0;0
21386;185136;1453;0;0;0;0;.00nan;0;0
21386;56058;1425;52;33;5;28;.848;3600000;0
21387;1765;1427;0;0;0;0;.00nan;0;0
21387;2037;4742;0;0;0;0;.00nan;0;0
21387;36946;4742;29;21;5;16;.762;3595000;0
21387;-1;1427;43;20;4;16;.800;3600000;0
21388;-1;4961;84;30;1;29;.967;3600000;0
21388;32819;1425;61;16;2;14;.875;1184000;0
21388;56058;1425;41;32;6;26;.813;2416000;0
21388;157903;4961;0;0;0;0;.00nan;0;0
21389;163361;1443;0;0;0;0;.00nan;0;0
21389;174312;1443;80;12;0;12;1.000;3600000;0
21389;-1;1440;29;31;6;25;.806;1831000;0
21389;143412;1440;60;29;3;26;.897;1769000;0
21390;2037;4742;67;33;3;30;.909;3519000;0
21390;4127;1429;0;0;0;0;.00nan;0;0
21390;36946;4742;0;0;0;0;.00nan;0;0
21390;148691;1429;88;25;1;24;.960;3600000;0
21391;1765;1427;97;32;1;31;.969;3600000;0
21391;185124;1430;71;30;2;28;.933;3545000;0
21391;-1;1427;0;0;0;0;.00nan;0;0
21391;157845;1430;0;0;0;0;.00nan;0;0
21392;9524;1422;62;25;3;22;.880;3520000;0
21392;195618;1426;90;30;1;29;.967;3600000;0
21392;185123;1426;0;0;0;0;.00nan;0;0
21392;66271;1422;0;0;0;0;.00nan;0;0
21393;1765;1427;0;0;0;0;.00nan;0;0
21393;9524;1427;62;29;3;26;.897;3600000;0
21393;-1;1440;0;0;0;0;.00nan;0;0
21393;143412;1440;46;22;4;18;.818;3562000;0
21394;2037;4742;0;0;0;0;.00nan;0;0
21394;-1;4961;41;27;5;22;.815;3600000;0
21394;36946;4742;66;26;2;24;.923;3600000;0
21394;157903;4961;0;0;0;0;.00nan;0;0
21395;163361;1443;0;0;0;0;.00nan;0;0
21395;174175;1425;0;0;0;0;.00nan;0;0
21395;174312;1443;47;22;4;18;.818;3900000;0
21395;56058;1425;90;52;4;48;.923;3900000;0
21396;182561;1426;49;21;3;18;.857;3600000;0
21396;165030;1453;23;25;6;19;.760;3600000;0
21396;168066;1453;0;0;0;0;.00nan;0;0
21396;195618;1426;0;0;0;0;.00nan;0;0
21397;4127;1429;0;0;0;0;.00nan;0;0
21397;176926;1430;64;35;4;31;.886;3600000;0
21397;148691;1429;89;34;2;32;.941;3600000;0
21397;157845;1430;0;0;0;0;.00nan;0;0
21398;-1;4961;83;31;1;30;.968;3600000;0
21398;-1;1422;0;0;0;0;.00nan;0;0
21398;66271;1422;48;25;4;21;.840;3600000;0
21398;157903;4961;0;0;0;0;.00nan;0;0
21399;165030;1453;48;30;4;26;.867;3600000;0
21399;168066;1453;0;0;0;0;.00nan;0;0
21399;176926;1430;56;39;5;34;.872;3582000;0
21399;157845;1430;0;0;0;0;.00nan;0;0
21400;2037;4742;0;0;0;0;.00nan;0;0
21400;174175;1425;0;0;0;0;.00nan;0;0
21400;36946;4742;100;31;0;31;1.000;3600000;0
21400;56058;1425;66;25;2;23;.920;3566000;0
21401;1765;1427;0;0;0;0;.00nan;0;0
21401;9524;1427;72;25;2;23;.920;3600000;0
21401;-1;1440;0;0;0;0;.00nan;0;0
21401;143412;1440;11;40;9;31;.775;3600000;0
21402;182561;1426;100;38;0;38;1.000;3600000;0
21402;163361;1443;84;30;2;28;.933;3573000;0
21402;174312;1443;0;0;0;0;.00nan;0;0
21402;195618;1426;0;0;0;0;.00nan;0;0
21403;2037;4742;0;0;0;0;.00nan;0;0
21403;4127;1429;0;0;0;0;.00nan;0;0
21403;36946;4742;82;37;3;34;.919;3900000;0
21403;148691;1429;58;23;3;20;.870;3900000;0
21404;4127;1429;0;0;0;0;.00nan;0;0
21404;-1;4961;78;45;3;42;.933;3900000;0
21404;148691;1429;57;25;3;22;.880;3900000;0
21404;157903;4961;0;0;0;0;.00nan;0;0
21405;165030;1453;52;26;3;23;.885;3557000;0
21405;168066;1453;0;0;0;0;.00nan;0;0
21405;-1;1440;0;0;0;0;.00nan;0;0
21405;143412;1440;76;20;2;18;.900;3600000;0
21406;182561;1426;79;33;2;31;.939;3600000;0
21406;163361;1443;44;33;5;28;.848;3600000;0
21406;174312;1443;0;0;0;0;.00nan;0;0
21406;195618;1426;0;0;0;0;.00nan;0;0
21407;174175;1425;0;0;0;0;.00nan;0;0
21407;-1;1422;0;0;0;0;.00nan;0;0
21407;56058;1425;58;32;3;29;.906;3900000;0
21407;66271;1422;83;35;3;32;.914;3900000;0
21408;1765;1427;0;0;0;0;.00nan;0;0
21408;9524;1427;37;21;4;17;.810;3600000;0
21408;176926;1430;60;44;5;39;.886;3543000;0
21408;157845;1430;0;0;0;0;.00nan;0;0
21409;174175;1425;0;0;0;0;.00nan;0;0
21409;-1;1422;0;0;0;0;.00nan;0;0
21409;56058;1425;56;30;4;26;.867;3571000;0
21409;66271;1422;75;26;2;24;.923;3600000;0
21410;2037;4742;0;0;0;0;.00nan;0;0
21410;182561;1426;75;38;3;35;.921;3600000;0
21410;195618;1426;0;0;0;0;.00nan;0;0
21410;36946;4742;87;14;0;14;1.000;3600000;0
21411;163361;1443;0;0;0;0;.00nan;0;0
21411;174312;1443;45;12;2;10;.833;3600000;0
21411;176926;1430;35;43;7;36;.837;2703000;0
21411;157845;1430;43;11;2;9;.818;897000;0
21412;165030;1453;0;0;0;0;.00nan;0;0
21412;168066;1453;44;23;4;19;.826;3600000;0
21412;-1;1440;46;17;2;15;.882;2334000;0
21412;143412;1440;25;12;4;8;.667;1178000;0
21413;1765;1427;0;0;0;0;.00nan;0;0
21413;4127;1429;97;21;0;21;1.000;3600000;0
21413;9524;1427;67;35;3;32;.914;3600000;0
21413;148691;1429;0;0;0;0;.00nan;0;0
21414;182561;1426;68;26;2;24;.923;3900000;0
21414;195618;1426;0;0;0;0;.00nan;0;0
21414;176926;1430;85;38;2;36;.947;3900000;0
21414;157845;1430;0;0;0;0;.00nan;0;0
21415;-1;1440;0;0;0;0;.00nan;0;0
21415;-1;1422;0;0;0;0;.00nan;0;0
21415;66271;1422;43;17;3;14;.824;3600000;0
21415;143412;1440;86;39;2;37;.949;3600000;0
21416;163361;1443;76;45;5;40;.889;3600000;0
21416;-1;4961;18;25;6;19;.760;3600000;0
21416;174312;1443;0;0;0;0;.00nan;0;0
21416;157903;4961;0;0;0;0;.00nan;0;0
21417;2037;4742;0;0;0;0;.00nan;0;0
21417;176926;1430;35;29;6;23;.793;2672000;0
21417;36946;4742;76;26;1;25;.962;3600000;0
21417;157845;1430;49;11;2;9;.818;928000;0
21418;4127;1429;63;16;1;15;.938;3600000;0
21418;165030;1453;33;32;6;26;.813;1902000;0
21418;168066;1453;66;21;2;19;.905;1698000;0
21418;148691;1429;0;0;0;0;.00nan;0;0
21419;1765;1427;0;0;0;0;.00nan;0;0
21419;9524;1427;72;31;3;28;.903;3872000;0
21419;174175;1425;0;0;0;0;.00nan;0;0
21419;56058;1425;76;41;4;37;.902;3872000;0
21420;-1;4961;61;18;2;16;.889;3600000;0
21420;176926;1430;40;44;7;37;.841;3042000;0
21420;157845;1430;46;7;1;6;.857;558000;0
21420;157903;4961;0;0;0;0;.00nan;0;0
21421;163361;1443;0;0;0;0;.00nan;0;0
21421;174312;1443;52;31;4;27;.871;3600000;0
21421;-1;1422;0;0;0;0;.00nan;0;0
21421;66271;1422;50;40;6;34;.850;3572000;0
21422;4127;1429;0;0;0;0;.00nan;0;0
21422;165030;1453;0;0;0;0;.00nan;0;0
21422;168066;1453;46;34;5;29;.853;3600000;0
21422;148691;1429;59;23;2;21;.913;3600000;0
21423;1765;1427;94;33;1;32;.970;3600000;0
21423;9524;1427;0;0;0;0;.00nan;0;0
21423;174175;1425;0;0;0;0;.00nan;0;0
21423;56058;1425;55;23;3;20;.870;3563000;0
21424;2037;4742;0;0;0;0;.00nan;0;0
21424;182561;1426;60;45;6;39;.867;3600000;0
21424;195618;1426;0;0;0;0;.00nan;0;0
21424;36946;4742;99;21;0;21;1.000;3600000;0
21425;1765;1427;0;0;0;0;.00nan;0;0
21425;163361;1443;0;0;0;0;.00nan;0;0
21425;9524;1427;98;49;2;47;.959;3600000;0
21425;174312;1443;88;21;0;21;1.000;3600000;0
21426;182561;1426;68;38;4;34;.895;3600000;0
21426;-1;4961;63;35;5;30;.857;3595000;0
21426;195618;1426;0;0;0;0;.00nan;0;0
21426;157903;4961;0;0;0;0;.00nan;0;0
21427;176926;1430;55;22;3;19;.864;3558000;0
21427;-1;1440;0;0;0;0;.00nan;0;0
21427;143412;1440;99;37;1;36;.973;3600000;0
21427;157845;1430;0;0;0;0;.00nan;0;0
21428;2037;4742;0;0;0;0;.00nan;0;0
21428;165030;1453;46;39;6;33;.846;3842000;0
21428;168066;1453;0;0;0;0;.00nan;0;0
21428;36946;4742;33;21;5;16;.762;3842000;0
21429;4127;1429;0;0;0;0;.00nan;0;0
21429;-1;1422;0;0;0;0;.00nan;0;0
21429;66271;1422;67;34;3;31;.912;3900000;0
21429;148691;1429;70;31;3;28;.903;3900000;0
21430;1765;1427;36;20;4;16;.800;3600000;0
21430;9524;1427;0;0;0;0;.00nan;0;0
21430;174175;1425;0;0;0;0;.00nan;0;0
21430;56058;1425;79;22;1;21;.955;3600000;0
21431;-1;1440;55;47;6;41;.872;3600000;0
21431;-1;1422;87;16;0;16;1.000;3600000;0
21431;66271;1422;0;0;0;0;.00nan;0;0
21431;143412;1440;0;0;0;0;.00nan;0;0
21432;2037;4742;47;18;3;15;.833;3600000;0
21432;165030;1453;0;0;0;0;.00nan;0;0
21432;168066;1453;56;45;5;40;.889;3513000;0
21432;36946;4742;0;0;0;0;.00nan;0;0
21433;-1;4961;27;21;5;16;.762;3682000;0
21433;176926;1430;0;0;0;0;.00nan;0;0
21433;157845;1430;91;56;4;52;.929;3703000;0
21433;157903;4961;0;0;0;0;.00nan;0;0
21434;163361;1443;0;0;0;0;.00nan;0;0
21434;174175;1425;67;39;6;33;.846;3600000;0
21434;174312;1443;98;32;1;31;.969;3600000;0
21434;56058;1425;0;0;0;0;.00nan;0;0
21435;182561;1426;76;30;2;28;.933;3600000;0
21435;4127;1429;32;22;5;17;.773;3600000;0
21435;195618;1426;0;0;0;0;.00nan;0;0
21435;148691;1429;0;0;0;0;.00nan;0;0
21436;182561;1426;99;31;1;30;.968;3600000;0
21436;195618;1426;0;0;0;0;.00nan;0;0
21436;-1;1440;0;0;0;0;.00nan;0;0
21436;143412;1440;82;47;4;43;.915;3600000;0
21437;2037;4742;0;0;0;0;.00nan;0;0
21437;-1;4961;91;44;3;41;.932;3900000;0
21437;36946;4742;64;26;3;23;.885;3900000;0
21437;157903;4961;0;0;0;0;.00nan;0;0
21438;163361;1443;0;0;0;0;.00nan;0;0
21438;174312;1443;49;17;3;14;.824;3900000;0
21438;176926;1430;98;63;3;60;.952;3900000;0
21438;157845;1430;0;0;0;0;.00nan;0;0
21439;4127;1429;0;0;0;0;.00nan;0;0
21439;174175;1425;0;0;0;0;.00nan;0;0
21439;56058;1425;74;33;3;30;.909;3550000;0
21439;148691;1429;73;24;2;22;.917;3600000;0
21440;1765;1427;0;0;0;0;.00nan;0;0
21440;9524;1427;94;33;1;32;.970;3600000;0
21440;-1;1422;47;34;4;30;.882;3600000;0
21440;66271;1422;0;0;0;0;.00nan;0;0
21441;163361;1443;48;25;4;21;.840;3879000;0
21441;-1;4961;0;0;0;0;.00nan;0;0
21441;174312;1443;0;0;0;0;.00nan;0;0
21441;157903;4961;73;40;3;37;.925;3879000;0
21442;4127;1429;33;32;6;26;.813;3600000;0
21442;-1;1422;0;0;0;0;.00nan;0;0
21442;66271;1422;59;23;2;21;.913;3600000;0
21442;148691;1429;0;0;0;0;.00nan;0;0
21443;174175;1425;0;0;0;0;.00nan;0;0
21443;176926;1430;0;0;0;0;.00nan;0;0
21443;56058;1425;58;25;3;22;.880;3600000;0
21443;157845;1430;39;33;5;28;.848;3529000;0
21444;1765;1427;74;24;1;23;.958;3600000;0
21444;9524;1427;0;0;0;0;.00nan;0;0
21444;165030;1453;53;38;5;33;.868;3600000;0
21444;168066;1453;0;0;0;0;.00nan;0;0
21445;182561;1426;70;18;1;17;.944;3600000;0
21445;195618;1426;0;0;0;0;.00nan;0;0
21445;-1;1440;36;31;6;25;.806;3331000;0
21445;143412;1440;38;7;2;5;.714;269000;0
21446;4127;1429;0;0;0;0;.00nan;0;0
21446;-1;1440;0;0;0;0;.00nan;0;0
21446;143412;1440;33;33;6;27;.818;3600000;0
21446;148691;1429;39;15;3;12;.800;3600000;0
21447;2037;4742;0;0;0;0;.00nan;0;0
21447;36946;4742;52;26;4;22;.846;3600000;0
21447;-1;1422;0;0;0;0;.00nan;0;0
21447;66271;1422;52;33;5;28;.848;3551000;0
21448;163361;1443;0;0;0;0;.00nan;0;0
21448;165030;1453;28;39;7;32;.821;2058000;0
21448;168066;1453;64;28;2;26;.929;1542000;0
21448;174312;1443;44;21;4;17;.810;3600000;0
21449;174175;1425;0;0;0;0;.00nan;0;0
21449;176926;1430;66;34;3;31;.912;3600000;0
21449;56058;1425;72;24;2;22;.917;3600000;0
21449;157845;1430;0;0;0;0;.00nan;0;0
21450;1765;1427;0;0;0;0;.00nan;0;0
21450;9524;1427;100;33;0;33;1.000;3600000;0
21450;-1;4961;33;28;5;23;.821;3600000;0
21450;157903;4961;0;0;0;0;.00nan;0;0
21451;-1;4961;51;16;2;14;.875;3600000;0
21451;-1;1440;50;27;4;23;.852;3549000;0
21451;143412;1440;0;0;0;0;.00nan;0;0
21451;157903;4961;0;0;0;0;.00nan;0;0
21452;176926;1430;57;17;2;15;.882;1664000;0
21452;-1;1422;68;30;2;28;.933;3600000;0
21452;66271;1422;0;0;0;0;.00nan;0;0
21452;157845;1430;12;20;6;14;.700;1936000;0
21453;163361;1443;68;19;2;17;.895;3600000;0
21453;165030;1453;77;29;1;28;.966;1528000;0
21453;168066;1453;29;31;6;25;.806;2072000;0
21453;174312;1443;0;0;0;0;.00nan;0;0
21454;4127;1429;71;25;2;23;.920;3600000;0
21454;174175;1425;0;0;0;0;.00nan;0;0
21454;56058;1425;46;32;6;26;.813;3600000;0
21454;148691;1429;0;0;0;0;.00nan;0;0
21455;1765;1427;55;6;0;6;1.000;552000;0
21455;182561;1426;59;25;2;23;.920;3600000;0
21455;9524;1427;52;48;7;41;.854;3048000;0
21455;195618;1426;0;0;0;0;.00nan;0;0
21456;174175;1425;0;0;0;0;.00nan;0;0
21456;-1;1440;0;0;0;0;.00nan;0;0
21456;56058;1425;67;20;2;18;.900;3600000;0
21456;143412;1440;87;43;3;40;.930;3551000;0
21457;165030;1453;77;29;3;26;.897;3900000;0
21457;168066;1453;0;0;0;0;.00nan;0;0
21457;-1;1422;0;0;0;0;.00nan;0;0
21457;66271;1422;61;33;3;30;.909;3900000;0
21458;2037;4742;40;7;2;5;.714;934000;0
21458;163361;1443;54;20;3;17;.850;3600000;0
21458;174312;1443;0;0;0;0;.00nan;0;0
21458;36946;4742;20;31;7;24;.774;2666000;0
21459;1765;1427;0;0;0;0;.00nan;0;0
21459;4127;1429;0;0;0;0;.00nan;0;0
21459;9524;1427;67;24;2;22;.917;3649000;0
21459;148691;1429;80;25;1;24;.960;3649000;0
21460;182561;1426;37;22;4;18;.818;2210000;0
21460;-1;4961;63;32;3;29;.906;3600000;0
21460;195618;1426;50;9;1;8;.889;1305000;0
21460;157903;4961;0;0;0;0;.00nan;0;0
21461;1765;1427;60;38;4;34;.895;3600000;0
21461;9524;1427;0;0;0;0;.00nan;0;0
21461;-1;4961;74;17;1;16;.941;3600000;0
21461;157903;4961;0;0;0;0;.00nan;0;0
21462;2037;4742;58;6;0;6;1.000;775000;0
21462;163361;1443;0;0;0;0;.00nan;0;0
21462;174312;1443;41;16;3;13;.813;3600000;0
21462;36946;4742;18;35;8;27;.771;2825000;0
21463;4127;1429;56;19;2;17;.895;3600000;0
21463;176926;1430;48;34;4;30;.882;3569000;0
21463;148691;1429;0;0;0;0;.00nan;0;0
21463;157845;1430;0;0;0;0;.00nan;0;0
21464;165030;1453;0;0;0;0;.00nan;0;0
21464;168066;1453;52;37;5;32;.865;3588000;0
21464;-1;1422;68;37;3;34;.919;3600000;0
21464;66271;1422;0;0;0;0;.00nan;0;0
21465;174175;1425;0;0;0;0;.00nan;0;0
21465;-1;1440;55;40;5;35;.875;3600000;0
21465;56058;1425;58;11;1;10;.909;3600000;0
21465;143412;1440;0;0;0;0;.00nan;0;0
21466;165030;1453;42;25;4;21;.840;3757000;0
21466;168066;1453;0;0;0;0;.00nan;0;0
21466;-1;1440;0;0;0;0;.00nan;0;0
21466;143412;1440;58;40;5;35;.875;3792000;0
21467;2037;4742;0;0;0;0;.00nan;0;0
21467;182561;1426;64;34;3;31;.912;3896000;0
21467;195618;1426;0;0;0;0;.00nan;0;0
21467;36946;4742;75;22;2;20;.909;3896000;0
21468;4127;1429;0;0;0;0;.00nan;0;0
21468;163361;1443;42;30;5;25;.833;3861000;0
21468;174312;1443;0;0;0;0;.00nan;0;0
21468;148691;1429;68;37;4;33;.892;3861000;0
21469;176926;1430;69;31;3;28;.903;3600000;0
21469;-1;1422;0;0;0;0;.00nan;0;0
21469;66271;1422;63;36;4;32;.889;3585000;0
21469;157845;1430;0;0;0;0;.00nan;0;0
21470;1765;1427;0;0;0;0;.00nan;0;0
21470;9524;1427;45;30;5;25;.833;3567000;0
21470;174175;1425;0;0;0;0;.00nan;0;0
21470;56058;1425;77;37;3;34;.919;3600000;0
21471;2037;4742;0;0;0;0;.00nan;0;0
21471;-1;4961;78;28;2;26;.929;3600000;0
21471;36946;4742;46;32;5;27;.844;3600000;0
21471;157903;4961;0;0;0;0;.00nan;0;0
21472;163361;1443;0;0;0;0;.00nan;0;0
21472;174312;1443;34;17;4;13;.765;3600000;0
21472;-1;1422;0;0;0;0;.00nan;0;0
21472;66271;1422;77;52;5;47;.904;3548000;0
21473;165030;1453;0;0;0;0;.00nan;0;0
21473;168066;1453;87;16;0;16;1.000;3600000;0
21473;-1;1440;0;0;0;0;.00nan;0;0
21473;143412;1440;82;38;3;35;.921;3600000;0
21474;1765;1427;0;0;0;0;.00nan;0;0
21474;4127;1429;51;29;4;25;.862;3600000;0
21474;9524;1427;47;33;5;28;.848;3547000;0
21474;148691;1429;0;0;0;0;.00nan;0;0
21475;182561;1426;0;0;0;0;.00nan;0;0
21475;195618;1426;82;28;1;27;.964;3600000;0
21475;176926;1430;0;0;0;0;.00nan;0;0
21475;157845;1430;100;34;0;34;1.000;3600000;0
21476;176926;1430;0;0;0;0;.00nan;0;0
21476;-1;1440;0;0;0;0;.00nan;0;0
21476;143412;1440;100;38;1;37;.974;3600000;0
21476;157845;1430;43;25;4;21;.840;3600000;0
21477;163361;1443;35;12;3;9;.750;3600000;0
21477;-1;4961;62;47;5;42;.894;3580000;0
21477;174312;1443;0;0;0;0;.00nan;0;0
21477;157903;4961;0;0;0;0;.00nan;0;0
21478;1765;1427;0;0;0;0;.00nan;0;0
21478;2037;4742;0;0;0;0;.00nan;0;0
21478;9524;1427;87;35;2;33;.943;3600000;0
21478;36946;4742;60;28;3;25;.893;3600000;0
21479;182561;1426;56;18;2;16;.889;3600000;0
21479;165030;1453;0;0;0;0;.00nan;0;0
21479;168066;1453;78;46;4;42;.913;3600000;0
21479;195618;1426;0;0;0;0;.00nan;0;0
21480;182561;1426;83;29;1;28;.966;3600000;0
21480;-1;4961;0;0;0;0;.00nan;0;0
21480;195618;1426;0;0;0;0;.00nan;0;0
21480;157903;4961;100;25;0;25;1.000;3600000;0
21481;200849;1422;0;0;0;0;.00nan;0;0
21481;-1;1440;0;0;0;0;.00nan;0;0
21481;66271;1422;44;18;3;15;.833;3600000;0
21481;143412;1440;72;42;5;37;.881;3519000;0
21482;1765;1427;80;32;3;29;.906;2593000;0
21482;2037;4742;0;0;0;0;.00nan;0;0
21482;9524;1427;31;14;4;10;.714;1007000;0
21482;36946;4742;53;16;2;14;.875;3600000;0
21483;174175;1425;0;0;0;0;.00nan;0;0
21483;176926;1430;37;35;6;29;.829;3564000;0
21483;56058;1425;56;23;4;19;.826;3600000;0
21483;157845;1430;0;0;0;0;.00nan;0;0
21484;4127;1429;0;0;0;0;.00nan;0;0
21484;165030;1453;61;29;3;26;.897;3600000;0
21484;168066;1453;0;0;0;0;.00nan;0;0
21484;148691;1429;88;17;0;17;1.000;3600000;0
21485;2037;4742;0;0;0;0;.00nan;0;0
21485;36946;4742;100;45;0;45;1.000;3600000;0
21485;-1;1422;0;0;0;0;.00nan;0;0
21485;66271;1422;78;38;3;35;.921;3600000;0
21486;163361;1443;0;0;0;0;.00nan;0;0
21486;174312;1443;31;14;4;10;.714;3531000;0
21486;-1;1440;0;0;0;0;.00nan;0;0
21486;143412;1440;96;43;2;41;.953;3600000;0
21487;2037;4742;0;0;0;0;.00nan;0;0
21487;36946;4742;48;21;3;18;.857;3600000;0
21487;-1;1422;0;0;0;0;.00nan;0;0
21487;66271;1422;57;33;4;29;.879;3549000;0
21488;165030;1453;0;0;0;0;.00nan;0;0
21488;168066;1453;44;40;5;35;.875;3539000;0
21488;174175;1425;0;0;0;0;.00nan;0;0
21488;56058;1425;60;25;3;22;.880;3600000;0
21489;4127;1429;0;0;0;0;.00nan;0;0
21489;-1;4961;0;0;0;0;.00nan;0;0
21489;148691;1429;65;27;3;24;.889;3600000;0
21489;157903;4961;35;26;5;21;.808;3600000;0
21490;182561;1426;48;23;3;20;.870;3600000;0
21490;9524;1427;54;35;4;31;.886;3550000;0
21490;195618;1426;0;0;0;0;.00nan;0;0
21490;148391;1427;0;0;0;0;.00nan;0;0
21491;165030;1453;39;41;6;35;.854;2838000;0
21491;168066;1453;74;16;0;16;1.000;762000;0
21491;-1;4961;75;16;1;15;.938;3600000;0
21491;157903;4961;0;0;0;0;.00nan;0;0
21492;4127;1429;0;0;0;0;.00nan;0;0
21492;-1;1422;0;0;0;0;.00nan;0;0
21492;66271;1422;56;37;5;32;.865;3600000;0
21492;148691;1429;64;17;1;16;.941;3600000;0
21493;2037;4742;43;39;6;33;.846;3534000;0
21493;174175;1425;0;0;0;0;.00nan;0;0
21493;36946;4742;0;0;0;0;.00nan;0;0
21493;56058;1425;49;27;4;23;.852;3600000;0
21494;9524;1427;46;20;4;16;.800;3595000;0
21494;-1;1440;0;0;0;0;.00nan;0;0
21494;143412;1440;44;26;5;21;.808;3599000;0
21494;148391;1427;0;0;0;0;.00nan;0;0
21495;9524;1427;92;21;1;20;.952;3600000;0
21495;-1;1440;0;0;0;0;.00nan;0;0
21495;143412;1440;72;29;2;27;.931;3600000;0
21495;148391;1427;0;0;0;0;.00nan;0;0
21496;163361;1443;62;23;4;19;.826;3600000;0
21496;174312;1443;0;0;0;0;.00nan;0;0
21496;176926;1430;77;65;8;57;.877;3600000;0
21496;157845;1430;0;0;0;0;.00nan;0;0
21497;165030;1453;0;0;0;0;.00nan;0;0
21497;168066;1453;98;41;1;40;.976;3600000;0
21497;-1;4961;48;15;2;13;.867;3600000;0
21497;157903;4961;0;0;0;0;.00nan;0;0
21498;174175;1425;100;32;0;32;1.000;3600000;0
21498;-1;1422;0;0;0;0;.00nan;0;0
21498;56058;1425;0;0;0;0;.00nan;0;0
21498;66271;1422;66;27;2;25;.926;3547000;0
21499;2037;4742;0;0;0;0;.00nan;0;0
21499;182561;1426;51;31;4;27;.871;3571000;0
21499;195618;1426;0;0;0;0;.00nan;0;0
21499;36946;4742;53;21;3;18;.857;3600000;0
21500;163361;1443;0;0;0;0;.00nan;0;0
21500;174312;1443;54;27;3;24;.889;3600000;0
21500;176926;1430;0;0;0;0;.00nan;0;0
21500;157845;1430;63;40;4;36;.900;3544000;0
21501;182561;1426;0;0;0;0;.00nan;0;0
21501;4127;1429;82;49;4;45;.918;3600000;0
21501;195618;1426;27;31;6;25;.806;3530000;0
21501;148691;1429;0;0;0;0;.00nan;0;0
21502;-1;4961;46;25;4;21;.840;3689000;0
21502;-1;1440;0;0;0;0;.00nan;0;0
21502;143412;1440;63;41;5;36;.878;3689000;0
21502;157903;4961;0;0;0;0;.00nan;0;0
21503;2037;4742;0;0;0;0;.00nan;0;0
21503;4127;1429;0;0;0;0;.00nan;0;0
21503;36946;4742;85;32;1;31;.969;3600000;0
21503;148691;1429;56;29;4;25;.862;3600000;0
21504;165030;1453;0;0;0;0;.00nan;0;0
21504;168066;1453;99;44;2;42;.955;3600000;0
21504;176926;1430;67;32;3;29;.906;3583000;0
21504;157845;1430;0;0;0;0;.00nan;0;0
21505;182561;1426;83;34;2;32;.941;3600000;0
21505;174175;1425;71;33;3;30;.909;3556000;0
21505;195618;1426;0;0;0;0;.00nan;0;0
21505;56058;1425;0;0;0;0;.00nan;0;0
21506;163361;1443;46;17;3;14;.824;3600000;0
21506;9524;1427;30;39;7;32;.821;3600000;0
21506;174312;1443;0;0;0;0;.00nan;0;0
21506;148391;1427;0;0;0;0;.00nan;0;0
21507;-1;4961;68;18;2;16;.889;3600000;0
21507;-1;1440;0;0;0;0;.00nan;0;0
21507;143412;1440;90;46;3;43;.935;3600000;0
21507;157903;4961;0;0;0;0;.00nan;0;0
21508;2037;4742;0;0;0;0;.00nan;0;0
21508;4127;1429;56;26;4;22;.846;3587000;0
21508;36946;4742;59;27;3;24;.889;3600000;0
21508;148691;1429;0;0;0;0;.00nan;0;0
21509;174175;1425;0;0;0;0;.00nan;0;0
21509;-1;1422;0;0;0;0;.00nan;0;0
21509;56058;1425;84;37;2;35;.946;3600000;0
21509;66271;1422;45;22;4;18;.818;3537000;0
21510;163361;1443;0;0;0;0;.00nan;0;0
21510;9524;1427;90;42;2;40;.952;3575000;0
21510;174312;1443;94;16;0;16;1.000;3600000;0
21510;148391;1427;0;0;0;0;.00nan;0;0
21511;165030;1453;0;0;0;0;.00nan;0;0
21511;168066;1453;54;22;3;19;.864;3600000;0
21511;176926;1430;37;29;5;24;.828;3525000;0
21511;157845;1430;0;0;0;0;.00nan;0;0
21512;2037;4742;0;0;0;0;.00nan;0;0
21512;176926;1430;71;38;3;35;.921;3536000;0
21512;36946;4742;74;20;1;19;.950;3600000;0
21512;157845;1430;0;0;0;0;.00nan;0;0
21513;4127;1429;39;7;2;5;.714;1472000;0
21513;163361;1443;56;17;2;15;.882;3600000;0
21513;174312;1443;0;0;0;0;.00nan;0;0
21513;148691;1429;31;29;6;23;.793;2128000;0
21514;174175;1425;0;0;0;0;.00nan;0;0
21514;-1;1440;0;0;0;0;.00nan;0;0
21514;56058;1425;52;19;3;16;.842;3566000;0
21514;143412;1440;76;25;2;23;.920;3600000;0
21515;9524;1427;0;0;0;0;.00nan;0;0
21515;165030;1453;0;0;0;0;.00nan;0;0
21515;168066;1453;54;32;4;28;.875;3538000;0
21515;148391;1427;85;39;3;36;.923;3600000;0
21516;182561;1426;61;38;5;33;.868;3900000;0
21516;195618;1426;0;0;0;0;.00nan;0;0
21516;-1;1422;0;0;0;0;.00nan;0;0
21516;66271;1422;92;51;5;46;.902;3900000;0
21517;9524;1427;88;38;2;36;.947;3600000;0
21517;-1;4961;32;17;4;13;.765;3533000;0
21517;148391;1427;0;0;0;0;.00nan;0;0
21517;157903;4961;0;0;0;0;.00nan;0;0
21518;182561;1426;0;0;0;0;.00nan;0;0
21518;195618;1426;79;28;1;27;.964;3600000;0
21518;-1;1422;37;27;5;22;.815;3600000;0
21518;66271;1422;0;0;0;0;.00nan;0;0
21519;2037;4742;26;24;6;18;.750;2867000;0
21519;176926;1430;56;43;6;37;.860;3759000;0
21519;36946;4742;50;6;1;5;.833;892000;0
21519;157845;1430;0;0;0;0;.00nan;0;0
21520;4127;1429;100;25;0;25;1.000;3600000;0
21520;165030;1453;67;34;3;31;.912;3600000;0
21520;168066;1453;0;0;0;0;.00nan;0;0
21520;148691;1429;0;0;0;0;.00nan;0;0
21521;174175;1425;0;0;0;0;.00nan;0;0
21521;-1;1440;0;0;0;0;.00nan;0;0
21521;56058;1425;59;13;2;11;.846;3600000;0
21521;143412;1440;80;40;4;36;.900;3583000;0
21522;2037;4742;0;0;0;0;.00nan;0;0
21522;174175;1425;0;0;0;0;.00nan;0;0
21522;36946;4742;72;23;1;22;.957;3600000;0
21522;56058;1425;71;36;3;33;.917;3579000;0
21523;174175;1425;0;0;0;0;.00nan;0;0
21523;-1;1440;0;0;0;0;.00nan;0;0
21523;56058;1425;63;26;3;23;.885;3900000;0
21523;143412;1440;90;48;3;45;.938;3900000;0
21524;182561;1426;36;43;7;36;.837;3600000;0
21524;163361;1443;0;0;0;0;.00nan;0;0
21524;174312;1443;56;21;3;18;.857;3600000;0
21524;195618;1426;0;0;0;0;.00nan;0;0
21525;165030;1453;0;0;0;0;.00nan;0;0
21525;168066;1453;92;35;1;34;.971;3600000;0
21525;-1;1422;0;0;0;0;.00nan;0;0
21525;66271;1422;46;20;3;17;.850;3561000;0
21526;4127;1429;46;26;4;22;.846;3600000;0
21526;176926;1430;63;47;6;41;.872;3513000;0
21526;148691;1429;0;0;0;0;.00nan;0;0
21526;157845;1430;0;0;0;0;.00nan;0;0
21527;9524;1427;34;35;6;29;.829;2273000;0
21527;-1;4961;70;17;1;16;.941;3600000;0
21527;148391;1427;83;17;0;17;1.000;1327000;0
21527;157903;4961;0;0;0;0;.00nan;0;0
21528;165030;1453;81;41;3;38;.927;3600000;0
21528;168066;1453;0;0;0;0;.00nan;0;0
21528;-1;4961;45;25;4;21;.840;3547000;0
21528;157903;4961;0;0;0;0;.00nan;0;0
21529;163361;1443;61;32;4;28;.875;3600000;0
21529;174312;1443;0;0;0;0;.00nan;0;0
21529;-1;1422;86;28;1;27;.964;3600000;0
21529;66271;1422;0;0;0;0;.00nan;0;0
21530;2037;4742;0;0;0;0;.00nan;0;0
21530;36946;4742;41;14;3;11;.786;3600000;0
21530;-1;1440;0;0;0;0;.00nan;0;0
21530;143412;1440;74;44;5;39;.886;3572000;0
21531;9524;1427;77;42;3;39;.929;3600000;0
21531;176926;1430;90;21;0;21;1.000;3600000;0
21531;148391;1427;0;0;0;0;.00nan;0;0
21531;157845;1430;0;0;0;0;.00nan;0;0
21532;182561;1426;0;0;0;0;.00nan;0;0
21532;4127;1429;0;0;0;0;.00nan;0;0
21532;195618;1426;69;31;3;28;.903;3600000;0
21532;148691;1429;48;34;5;29;.853;3559000;0
21533;2037;4742;0;0;0;0;.00nan;0;0
21533;36946;4742;33;11;3;8;.727;3600000;0
21533;-1;1440;61;9;0;9;1.000;335000;0
21533;143412;1440;58;46;7;39;.848;3265000;0
21534;-1;4961;89;32;2;30;.938;3600000;0
21534;-1;1422;0;0;0;0;.00nan;0;0
21534;66271;1422;55;22;3;19;.864;3600000;0
21534;157903;4961;0;0;0;0;.00nan;0;0
21535;163361;1443;0;0;0;0;.00nan;0;0
21535;165030;1453;0;0;0;0;.00nan;0;0
21535;168066;1453;89;44;3;41;.932;3513000;0
21535;174312;1443;66;19;1;18;.947;3600000;0
21536;4127;1429;0;0;0;0;.00nan;0;0
21536;174175;1425;0;0;0;0;.00nan;0;0
21536;56058;1425;77;25;1;24;.960;3900000;0
21536;148691;1429;72;21;1;20;.952;3900000;0
21537;182561;1426;70;28;2;26;.929;3900000;0
21537;9524;1427;80;38;2;36;.947;3900000;0
21537;195618;1426;0;0;0;0;.00nan;0;0
21537;148391;1427;0;0;0;0;.00nan;0;0
21538;-1;4961;21;11;4;7;.636;872000;0
21538;-1;1422;82;43;3;40;.930;3600000;0
21538;66271;1422;0;0;0;0;.00nan;0;0
21538;157903;4961;60;21;2;19;.905;2728000;0
21539;176926;1430;81;22;1;21;.955;3600000;0
21539;-1;1440;0;0;0;0;.00nan;0;0
21539;143412;1440;66;37;4;33;.892;3600000;0
21539;157845;1430;0;0;0;0;.00nan;0;0
21540;163361;1443;100;33;2;31;.939;3600000;0
21540;165030;1453;64;42;4;38;.905;3600000;0
21540;168066;1453;0;0;0;0;.00nan;0;0
21540;174312;1443;0;0;0;0;.00nan;0;0
21541;4127;1429;57;23;3;20;.870;3600000;0
21541;174175;1425;0;0;0;0;.00nan;0;0
21541;56058;1425;55;31;4;27;.871;3572000;0
21541;148691;1429;0;0;0;0;.00nan;0;0
21542;182561;1426;0;0;0;0;.00nan;0;0
21542;9524;1427;80;33;2;31;.939;3600000;0
21542;195618;1426;51;29;3;26;.897;3576000;0
21542;148391;1427;0;0;0;0;.00nan;0;0
21543;2037;4742;41;9;2;7;.778;1008000;0
21543;163361;1443;69;28;5;23;.821;3600000;0
21543;174312;1443;0;0;0;0;.00nan;0;0
21543;36946;4742;29;29;6;23;.793;2592000;0
21544;163361;1443;0;0;0;0;.00nan;0;0
21544;174312;1443;79;18;1;17;.944;3600000;0
21544;176926;1430;51;37;5;32;.865;3600000;0
21544;157845;1430;0;0;0;0;.00nan;0;0
21545;4127;1429;0;0;0;0;.00nan;0;0
21545;-1;1422;0;0;0;0;.00nan;0;0
21545;66271;1422;47;22;3;19;.864;3600000;0
21545;148691;1429;32;23;4;19;.826;3560000;0
21546;9524;1427;69;29;2;27;.931;3545000;0
21546;174175;1425;0;0;0;0;.00nan;0;0
21546;56058;1425;74;24;1;23;.958;3600000;0
21546;148391;1427;0;0;0;0;.00nan;0;0
21547;182561;1426;61;33;4;29;.879;3600000;0
21547;-1;4961;70;29;3;26;.897;3600000;0
21547;195618;1426;0;0;0;0;.00nan;0;0
21547;157903;4961;0;0;0;0;.00nan;0;0
21548;182561;1426;0;0;0;0;.00nan;0;0
21548;-1;4961;0;0;0;0;.00nan;0;0
21548;195618;1426;56;31;4;27;.871;3600000;0
21548;157903;4961;56;38;5;33;.868;3570000;0
21549;174175;1425;0;0;0;0;.00nan;0;0
21549;-1;1440;0;0;0;0;.00nan;0;0
21549;56058;1425;75;26;2;24;.923;3600000;0
21549;143412;1440;70;32;3;29;.906;3543000;0
21550;9524;1427;74;30;2;28;.933;3560000;0
21550;-1;1422;93;28;1;27;.964;3600000;0
21550;66271;1422;0;0;0;0;.00nan;0;0
21550;148391;1427;0;0;0;0;.00nan;0;0
21551;4127;1429;14;18;6;12;.667;3521000;0
21551;176926;1430;59;33;4;29;.879;3600000;0
21551;148691;1429;0;0;0;0;.00nan;0;0
21551;157845;1430;0;0;0;0;.00nan;0;0
21552;2037;4742;0;0;0;0;.00nan;0;0
21552;165030;1453;0;0;0;0;.00nan;0;0
21552;168066;1453;59;32;4;28;.875;3600000;0
21552;36946;4742;42;32;5;27;.844;3600000;0
21553;4127;1429;0;0;0;0;.00nan;0;0
21553;-1;4961;37;25;5;20;.800;3900000;0
21553;148691;1429;65;44;5;39;.886;3900000;0
21553;157903;4961;0;0;0;0;.00nan;0;0
21554;182561;1426;44;19;3;16;.842;3600000;0
21554;195618;1426;0;0;0;0;.00nan;0;0
21554;-1;1440;0;0;0;0;.00nan;0;0
21554;143412;1440;74;44;4;40;.909;3552000;0
21555;2037;4742;0;0;0;0;.00nan;0;0
21555;165030;1453;0;0;0;0;.00nan;0;0
21555;168066;1453;72;35;3;32;.914;3600000;0
21555;36946;4742;100;32;0;32;1.000;3600000;0
21556;163361;1443;90;18;0;18;1.000;3600000;0
21556;174175;1425;0;0;0;0;.00nan;0;0
21556;174312;1443;0;0;0;0;.00nan;0;0
21556;56058;1425;69;41;5;36;.878;3600000;0
21557;9524;1427;32;30;6;24;.800;3600000;0
21557;176926;1430;94;35;1;34;.971;3600000;0
21557;148391;1427;0;0;0;0;.00nan;0;0
21557;157845;1430;0;0;0;0;.00nan;0;0
21558;-1;1440;0;0;0;0;.00nan;0;0
21558;-1;1422;0;0;0;0;.00nan;0;0
21558;66271;1422;48;16;3;13;.813;3600000;0
21558;143412;1440;87;47;4;43;.915;3600000;0
21559;163361;1443;77;17;1;16;.941;3600000;0
21559;174312;1443;0;0;0;0;.00nan;0;0
21559;176926;1430;23;37;8;29;.784;3247000;0
21559;157845;1430;16;8;4;4;.500;353000;0
21560;9524;1427;54;30;4;26;.867;3753000;0
21560;165030;1453;44;29;5;24;.828;3753000;0
21560;168066;1453;0;0;0;0;.00nan;0;0
21560;148391;1427;0;0;0;0;.00nan;0;0
21561;4127;1429;51;31;5;26;.839;3900000;0
21561;-1;4961;51;37;5;32;.865;3900000;0
21561;148691;1429;0;0;0;0;.00nan;0;0
21561;157903;4961;0;0;0;0;.00nan;0;0
21562;182561;1426;0;0;0;0;.00nan;0;0
21562;174175;1425;0;0;0;0;.00nan;0;0
21562;195618;1426;67;29;3;26;.897;3600000;0
21562;56058;1425;100;30;1;29;.967;3600000;0
21563;-1;4961;90;21;0;21;1.000;3600000;0
21563;174175;1425;0;0;0;0;.00nan;0;0
21563;56058;1425;48;37;5;32;.865;3600000;0
21563;157903;4961;0;0;0;0;.00nan;0;0
21564;163361;1443;99;24;0;24;1.000;3600000;0
21564;174312;1443;0;0;0;0;.00nan;0;0
21564;-1;1440;61;16;1;15;.938;895000;0
21564;143412;1440;32;32;6;26;.813;2705000;0
21565;4127;1429;0;0;0;0;.00nan;0;0
21565;-1;1422;0;0;0;0;.00nan;0;0
21565;66271;1422;41;24;4;20;.833;3590000;0
21565;148691;1429;64;29;3;26;.897;3600000;0
21566;2037;4742;0;0;0;0;.00nan;0;0
21566;9524;1427;67;37;3;34;.919;3600000;0
21566;36946;4742;51;29;4;25;.862;3551000;0
21566;148391;1427;0;0;0;0;.00nan;0;0
21567;182561;1426;19;20;6;14;.700;3600000;0
21567;195618;1426;0;0;0;0;.00nan;0;0
21567;176926;1430;78;37;3;34;.919;3600000;0
21567;157845;1430;0;0;0;0;.00nan;0;0
21568;2037;4742;78;26;2;24;.923;3600000;0
21568;182561;1426;54;12;1;11;.917;1436000;0
21568;195618;1426;36;35;5;30;.857;2164000;0
21568;36946;4742;0;0;0;0;.00nan;0;0
21569;163361;1443;71;18;1;17;.944;3600000;0
21569;9524;1427;73;46;5;41;.891;3600000;0
21569;174312;1443;0;0;0;0;.00nan;0;0
21569;148391;1427;0;0;0;0;.00nan;0;0
21570;-1;4961;57;20;2;18;.900;3900000;0
21570;176926;1430;0;0;0;0;.00nan;0;0
21570;157845;1430;77;45;2;43;.956;3900000;0
21570;157903;4961;0;0;0;0;.00nan;0;0
21571;165030;1453;46;28;4;24;.857;1774000;0
21571;168066;1453;17;24;6;18;.750;1826000;0
21571;-1;1422;96;23;0;23;1.000;3600000;0
21571;66271;1422;0;0;0;0;.00nan;0;0
21572;4127;1429;45;18;3;15;.833;3562000;0
21572;-1;1440;0;0;0;0;.00nan;0;0
21572;143412;1440;87;39;2;37;.949;3600000;0
21572;148691;1429;0;0;0;0;.00nan;0;0
21573;4127;1429;0;0;0;0;.00nan;0;0
21573;-1;1422;12;26;7;19;.731;2686000;0
21573;66271;1422;53;3;0;3;1.000;914000;0
21573;148691;1429;82;45;3;42;.933;3600000;0
21574;-1;4961;62;16;1;15;.938;3600000;0
21574;-1;1440;0;0;0;0;.00nan;0;0
21574;143412;1440;76;37;3;34;.919;3532000;0
21574;157903;4961;0;0;0;0;.00nan;0;0
21575;2037;4742;0;0;0;0;.00nan;0;0
21575;176926;1430;87;31;2;29;.935;3600000;0
21575;36946;4742;51;19;3;16;.842;3572000;0
21575;157845;1430;0;0;0;0;.00nan;0;0
21576;182561;1426;57;34;5;29;.853;3600000;0
21576;165030;1453;0;0;0;0;.00nan;0;0
21576;168066;1453;62;51;6;45;.882;3600000;0
21576;195618;1426;0;0;0;0;.00nan;0;0
21577;163361;1443;76;34;3;31;.912;3826000;0
21577;174175;1425;0;0;0;0;.00nan;0;0
21577;174312;1443;0;0;0;0;.00nan;0;0
21577;56058;1425;66;37;4;33;.892;3826000;0
21578;9524;1427;66;30;3;27;.900;3852000;0
21578;-1;1422;0;0;0;0;.00nan;0;0
21578;66271;1422;57;28;4;24;.857;3852000;0
21578;148391;1427;0;0;0;0;.00nan;0;0
21579;-1;4961;100;34;0;34;1.000;3600000;0
21579;-1;1422;69;34;3;31;.912;3600000;0
21579;66271;1422;0;0;0;0;.00nan;0;0
21579;157903;4961;0;0;0;0;.00nan;0;0
21580;2037;4742;0;0;0;0;.00nan;0;0
21580;176926;1430;56;39;4;35;.897;3600000;0
21580;36946;4742;83;33;1;32;.970;3600000;0
21580;157845;1430;0;0;0;0;.00nan;0;0
21581;4127;1429;0;0;0;0;.00nan;0;0
21581;165030;1453;81;46;3;43;.935;3600000;0
21581;168066;1453;0;0;0;0;.00nan;0;0
21581;148691;1429;97;19;0;19;1.000;3600000;0
21582;163361;1443;0;0;0;0;.00nan;0;0
21582;174175;1425;0;0;0;0;.00nan;0;0
21582;174312;1443;52;19;3;16;.842;3600000;0
21582;56058;1425;65;50;7;43;.860;3600000;0
21583;182561;1426;0;0;0;0;.00nan;0;0
21583;195618;1426;49;21;4;17;.810;3557000;0
21583;-1;1440;0;0;0;0;.00nan;0;0
21583;143412;1440;80;31;2;29;.935;3600000;0
21584;2037;4742;0;0;0;0;.00nan;0;0
21584;36946;4742;72;25;2;23;.920;3600000;0
21584;-1;1440;0;0;0;0;.00nan;0;0
21584;143412;1440;76;33;3;30;.909;3566000;0
21585;163361;1443;98;36;2;34;.944;3600000;0
21585;174312;1443;0;0;0;0;.00nan;0;0
21585;-1;1422;0;0;0;0;.00nan;0;0
21585;66271;1422;57;31;5;26;.839;3600000;0
21586;4127;1429;0;0;0;0;.00nan;0;0
21586;176926;1430;27;27;6;21;.778;2665000;0
21586;148691;1429;100;39;0;39;1.000;3600000;0
21586;157845;1430;59;8;0;8;1.000;935000;0
21587;165030;1453;69;32;2;30;.938;3900000;0
21587;168066;1453;0;0;0;0;.00nan;0;0
21587;174175;1425;0;0;0;0;.00nan;0;0
21587;56058;1425;95;36;2;34;.944;3900000;0
21588;182561;1426;49;22;3;19;.864;3600000;0
21588;9524;1427;99;26;0;26;1.000;3600000;0
21588;195618;1426;0;0;0;0;.00nan;0;0
21588;148391;1427;0;0;0;0;.00nan;0;0
21589;9524;1427;67;34;3;31;.912;3595000;0
21589;-1;4961;72;16;1;15;.938;3600000;0
21589;148391;1427;0;0;0;0;.00nan;0;0
21589;157903;4961;0;0;0;0;.00nan;0;0
21590;174175;1425;0;0;0;0;.00nan;0;0
21590;-1;1422;35;31;5;26;.839;3600000;0
21590;56058;1425;66;18;1;17;.944;3600000;0
21590;66271;1422;0;0;0;0;.00nan;0;0
21591;2037;4742;0;0;0;0;.00nan;0;0
21591;165030;1453;66;32;3;29;.906;3586000;0
21591;168066;1453;0;0;0;0;.00nan;0;0
21591;36946;4742;86;27;1;26;.963;3600000;0
21592;176926;1430;56;29;4;25;.862;3600000;0
21592;-1;1440;46;14;2;12;.857;1220000;0
21592;143412;1440;43;21;4;17;.810;2351000;0
21592;157845;1430;0;0;0;0;.00nan;0;0
21593;182561;1426;0;0;0;0;.00nan;0;0
21593;163361;1443;0;0;0;0;.00nan;0;0
21593;174312;1443;57;20;2;18;.900;3600000;0
21593;195618;1426;39;34;5;29;.853;3600000;0
21594;4127;1429;0;0;0;0;.00nan;0;0
21594;-1;1440;0;0;0;0;.00nan;0;0
21594;143412;1440;71;27;2;25;.926;3600000;0
21594;148691;1429;52;24;3;21;.875;3547000;0
21595;165030;1453;33;32;5;27;.844;3600000;0
21595;168066;1453;0;0;0;0;.00nan;0;0
21595;-1;1422;0;0;0;0;.00nan;0;0
21595;66271;1422;59;21;2;19;.905;3600000;0
21596;182561;1426;44;40;6;34;.850;3600000;0
21596;163361;1443;77;25;1;24;.960;3600000;0
21596;174312;1443;0;0;0;0;.00nan;0;0
21596;195618;1426;0;0;0;0;.00nan;0;0
21597;2037;4742;0;0;0;0;.00nan;0;0
21597;174175;1425;0;0;0;0;.00nan;0;0
21597;36946;4742;42;29;5;24;.828;3835000;0
21597;56058;1425;64;37;4;33;.892;3835000;0
21598;9524;1427;88;26;0;26;1.000;3600000;0
21598;-1;4961;53;17;2;15;.882;3516000;0
21598;148391;1427;0;0;0;0;.00nan;0;0
21598;157903;4961;0;0;0;0;.00nan;0;0
21599;-1;4961;45;17;4;13;.765;3869000;0
21599;-1;1440;0;0;0;0;.00nan;0;0
21599;143412;1440;93;51;4;47;.922;3900000;0
21599;157903;4961;0;0;0;0;.00nan;0;0
21600;2037;4742;49;21;3;18;.857;3600000;0
21600;9524;1427;60;34;4;30;.882;3600000;0
21600;36946;4742;0;0;0;0;.00nan;0;0
21600;148391;1427;0;0;0;0;.00nan;0;0
21601;176926;1430;100;51;1;50;.980;3600000;0
21601;-1;1422;66;28;3;25;.893;3515000;0
21601;66271;1422;0;0;0;0;.00nan;0;0
21601;157845;1430;0;0;0;0;.00nan;0;0
21602;165030;1453;0;0;0;0;.00nan;0;0
21602;168066;1453;90;39;2;37;.949;3900000;0
21602;174175;1425;0;0;0;0;.00nan;0;0
21602;56058;1425;68;24;2;22;.917;3900000;0
21603;182561;1426;75;21;1;20;.952;1483000;0
21603;4127;1429;85;37;2;35;.946;3600000;0
21603;195618;1426;44;32;5;27;.844;2117000;0
21603;148691;1429;0;0;0;0;.00nan;0;0
21648;-1;4961;55;41;6;35;.854;3900000;0
21648;174175;1425;0;0;0;0;.00nan;0;0
21648;32819;1425;30;27;6;21;.778;3900000;0
21648;157903;4961;0;0;0;0;.00nan;0;0
21650;4127;1440;0;0;0;0;.00nan;0;0
21650;9524;1422;0;0;0;0;.00nan;0;0
21650;66271;1422;66;17;1;16;.941;3600000;0
21650;143412;1440;38;39;7;32;.821;3600000;0
21652;1765;1427;0;0;0;0;.00nan;0;0
21652;2037;4742;0;0;0;0;.00nan;0;0
21652;36946;4742;62;28;3;25;.893;3600000;0
21652;-1;1427;55;35;5;30;.857;3571000;0
21654;163361;1443;66;14;1;13;.929;3600000;0
21654;174312;1443;0;0;0;0;.00nan;0;0
21654;-1;1429;0;0;0;0;.00nan;0;0
21654;148691;1429;65;30;3;27;.900;3593000;0
21656;195618;1426;0;0;0;0;.00nan;0;0
21656;185124;1430;52;21;3;18;.857;3567000;0
21656;56058;1426;99;38;2;36;.947;3600000;0
21656;157845;1430;0;0;0;0;.00nan;0;0
21658;195618;1426;0;0;0;0;.00nan;0;0
21658;-1;1429;0;0;0;0;.00nan;0;0
21658;56058;1426;85;29;1;28;.966;3600000;0
21658;148691;1429;47;17;3;14;.824;3564000;0
21660;2037;4742;0;0;0;0;.00nan;0;0
21660;9524;1422;0;0;0;0;.00nan;0;0
21660;36946;4742;67;22;2;20;.909;3600000;0
21660;66271;1422;59;29;4;25;.862;3558000;0
21662;163361;1443;21;18;5;13;.722;3600000;0
21662;174175;1425;0;0;0;0;.00nan;0;0
21662;174312;1443;0;0;0;0;.00nan;0;0
21662;32819;1425;35;41;6;35;.854;3544000;0
21664;165030;1453;74;36;3;33;.917;3588000;0
21664;185124;1430;0;0;0;0;.00nan;0;0
21664;185136;1453;0;0;0;0;.00nan;0;0
21664;157845;1430;69;20;1;19;.950;3600000;0
21666;1765;1427;0;0;0;0;.00nan;0;0
21666;-1;4961;40;24;4;20;.833;3900000;0
21666;-1;1427;48;29;4;25;.862;3900000;0
21666;157903;4961;0;0;0;0;.00nan;0;0
21668;-1;4961;0;0;0;0;.00nan;0;0
21668;-1;1429;65;39;4;35;.897;3600000;0
21668;148691;1429;0;0;0;0;.00nan;0;0
21668;157903;4961;77;22;1;21;.955;3600000;0
21670;165030;1453;73;29;2;27;.931;3900000;0
21670;195618;1426;83;29;2;27;.931;3900000;0
21670;185136;1453;0;0;0;0;.00nan;0;0
21670;56058;1426;0;0;0;0;.00nan;0;0
21672;4127;1440;0;0;0;0;.00nan;0;0
21672;185124;1430;60;14;1;13;.929;3600000;0
21672;143412;1440;67;21;2;19;.905;3562000;0
21672;157845;1430;0;0;0;0;.00nan;0;0
21674;1765;1427;48;27;4;23;.852;3567000;0
21674;174175;1425;75;24;2;22;.917;3600000;0
21674;32819;1425;0;0;0;0;.00nan;0;0
21674;-1;1427;0;0;0;0;.00nan;0;0
21676;2037;4742;97;31;1;30;.968;3600000;0
21676;9524;1422;45;28;4;24;.857;3600000;0
21676;36946;4742;0;0;0;0;.00nan;0;0
21676;66271;1422;0;0;0;0;.00nan;0;0
21678;163361;1443;96;35;2;33;.943;3600000;0
21678;174175;1425;0;0;0;0;.00nan;0;0
21678;174312;1443;0;0;0;0;.00nan;0;0
21678;32819;1425;57;25;3;22;.880;3588000;0
21680;4127;1440;0;0;0;0;.00nan;0;0
21680;185124;1430;0;0;0;0;.00nan;0;0
21680;143412;1440;56;39;5;34;.872;3600000;0
21680;157845;1430;88;28;1;27;.964;3600000;0
21682;1765;1427;0;0;0;0;.00nan;0;0
21682;-1;4961;71;22;1;21;.955;3600000;0
21682;-1;1427;72;27;2;25;.926;3589000;0
21682;157903;4961;0;0;0;0;.00nan;0;0
21684;165030;1453;65;39;4;35;.897;3571000;0
21684;195618;1426;0;0;0;0;.00nan;0;0
21684;185136;1453;0;0;0;0;.00nan;0;0
21684;56058;1426;82;30;2;28;.933;3600000;0
21686;2037;4742;0;0;0;0;.00nan;0;0
21686;9524;1422;63;9;0;9;1.000;1052000;0
21686;36946;4742;49;23;4;19;.826;3600000;0
21686;66271;1422;29;28;6;22;.786;2548000;0
21688;165030;1453;89;19;0;19;1.000;1313000;0
21688;185136;1453;33;32;6;26;.813;2287000;0
21688;-1;1429;0;0;0;0;.00nan;0;0
21688;148691;1429;50;13;2;11;.846;3600000;0
21690;1765;1427;61;39;4;35;.897;3600000;0
21690;9524;1422;89;28;1;27;.964;3600000;0
21690;-1;1427;0;0;0;0;.00nan;0;0
21690;66271;1422;0;0;0;0;.00nan;0;0
21692;4127;1440;23;32;7;25;.781;3600000;0
21692;195618;1426;0;0;0;0;.00nan;0;0
21692;56058;1426;63;26;4;22;.846;3600000;0
21692;143412;1440;0;0;0;0;.00nan;0;0
21694;2037;4742;62;24;2;22;.917;3600000;0
21694;163361;1443;0;0;0;0;.00nan;0;0
21694;174312;1443;49;27;4;23;.852;3579000;0
21694;36946;4742;0;0;0;0;.00nan;0;0
21696;-1;4961;0;0;0;0;.00nan;0;0
21696;174175;1425;23;18;5;13;.722;1072000;0
21696;32819;1425;80;25;1;24;.960;2528000;0
21696;157903;4961;82;18;0;18;1.000;3600000;0
21698;1765;1427;0;0;0;0;.00nan;0;0
21698;9524;1422;0;0;0;0;.00nan;0;0
21698;-1;1427;59;44;6;38;.864;3600000;0
21698;66271;1422;58;18;2;16;.889;3600000;0
21700;2037;4742;0;0;0;0;.00nan;0;0
21700;174175;1425;0;0;0;0;.00nan;0;0
21700;32819;1425;61;21;2;19;.905;3554000;0
21700;36946;4742;62;19;1;18;.947;3600000;0
21702;163361;1443;68;19;2;17;.895;3600000;0
21702;174312;1443;0;0;0;0;.00nan;0;0
21702;185124;1430;35;39;7;32;.821;3257000;0
21702;157845;1430;33;7;2;5;.714;343000;0
21704;-1;4961;0;0;0;0;.00nan;0;0
21704;195618;1426;0;0;0;0;.00nan;0;0
21704;56058;1426;74;37;3;34;.919;3577000;0
21704;157903;4961;68;30;2;28;.933;3600000;0
21706;165030;1453;98;54;3;51;.944;3600000;0
21706;185136;1453;0;0;0;0;.00nan;0;0
21706;-1;1429;0;0;0;0;.00nan;0;0
21706;148691;1429;84;9;0;9;1.000;3600000;0
21708;165030;1453;0;0;0;0;.00nan;0;0
21708;174175;1425;35;23;5;18;.783;3600000;0
21708;32819;1425;0;0;0;0;.00nan;0;0
21708;185136;1453;85;37;2;35;.946;3600000;0
21710;4127;1440;29;29;6;23;.793;3600000;0
21710;9524;1422;76;27;1;26;.963;3600000;0
21710;66271;1422;0;0;0;0;.00nan;0;0
21710;143412;1440;0;0;0;0;.00nan;0;0
21712;2037;4742;85;26;1;25;.962;3600000;0
21712;-1;4961;49;30;5;25;.833;3600000;0
21712;36946;4742;0;0;0;0;.00nan;0;0
21712;157903;4961;0;0;0;0;.00nan;0;0
21714;1765;1427;70;24;1;23;.958;3600000;0
21714;185124;1430;77;18;0;18;1.000;919000;0
21714;-1;1427;0;0;0;0;.00nan;0;0
21714;157845;1430;15;26;6;20;.769;2681000;0
21716;163361;1443;0;0;0;0;.00nan;0;0
21716;174312;1443;36;15;4;11;.733;3600000;0
21716;195618;1426;0;0;0;0;.00nan;0;0
21716;56058;1426;64;40;5;35;.875;3550000;0
