Game Id;PlayerId;TeamId;Game Rating;SA;GA;SV;SV%;TOI;PIM
0;166751;5;0;0;0;0;.00nan;0;0
0;176995;5;77;34;2;32;.941;4200000;0
0;190465;33;0;0;0;0;.00nan;0;0
0;149452;33;67;24;2;22;.917;4200000;0
1;174718;25;0;0;0;0;.00nan;0;0
1;69536;10;0;0;0;0;.00nan;0;0
1;148958;25;68;29;2;27;.931;4200000;0
1;152717;10;99;59;2;57;.966;4200000;0
2;2059;23;54;38;5;33;.868;3600000;0
2;14266;23;0;0;0;0;.00nan;0;0
2;17043;30;75;17;1;16;.941;3600000;0
2;36755;30;0;0;0;0;.00nan;0;0
3;166591;20;0;0;0;0;.00nan;0;0
3;46492;0;74;25;1;24;.960;3600000;0
3;86697;20;55;28;3;25;.893;3515000;0
3;149455;0;0;0;0;0;.00nan;0;0
4;171838;31;100;36;1;35;.972;3600000;0
4;8424;28;0;0;0;0;.00nan;0;0
4;86360;31;0;0;0;0;.00nan;0;0
4;152835;28;55;40;5;35;.875;3600000;0
5;183844;29;0;0;0;0;.00nan;0;0
5;174718;25;88;34;2;32;.941;3600000;0
5;37818;29;47;30;5;25;.833;3600000;0
5;148958;25;0;0;0;0;.00nan;0;0
6;65;11;100;31;0;31;1.000;3600000;0
6;67;11;0;0;0;0;.00nan;0;0
6;1669;32;0;0;0;0;.00nan;0;0
6;58830;32;58;37;4;33;.892;3600000;0
7;163565;19;0;0;0;0;.00nan;0;0
7;13714;8;0;0;0;0;.00nan;0;0
7;14305;19;71;29;3;26;.897;3562000;0
7;18213;8;95;31;1;30;.968;3600000;0
8;9235;4838;0;0;0;0;.00nan;0;0
8;166381;27;87;23;1;22;.957;3600000;0
8;175660;27;0;0;0;0;.00nan;0;0
8;143749;4838;42;31;5;26;.839;3600000;0
9;163695;9;0;0;0;0;.00nan;0;0
9;175092;9;70;20;1;19;.950;3600000;0
9;176921;15;76;55;6;49;.891;3600000;0
9;85727;15;0;0;0;0;.00nan;0;0
10;175084;22;0;0;0;0;.00nan;0;0
10;86192;21;66;36;4;32;.889;3600000;0
10;143156;21;0;0;0;0;.00nan;0;0
10;143473;22;89;27;2;25;.926;3600000;0
11;676;34;0;0;0;0;.00nan;0;0
11;178413;17;0;0;0;0;.00nan;0;0
11;78806;34;57;24;3;21;.875;3600000;0
11;146862;17;65;43;5;38;.884;3596000;0
12;166646;16;0;0;0;0;.00nan;0;0
12;50065;16;94;48;2;46;.958;3876000;0
12;85798;12;0;0;0;0;.00nan;0;0
12;91178;12;84;26;1;25;.962;3876000;0
13;556;3;72;31;2;29;.935;3588000;0
13;163423;26;0;0;0;0;.00nan;0;0
13;179154;26;99;23;0;23;1.000;3600000;0
13;179344;3;0;0;0;0;.00nan;0;0
14;2059;23;50;19;3;16;.842;3600000;0
14;14266;23;0;0;0;0;.00nan;0;0
14;190465;33;0;0;0;0;.00nan;0;0
14;149452;33;100;27;0;27;1.000;3600000;0
15;17043;30;75;28;2;26;.929;4200000;0
15;173727;18;0;0;0;0;.00nan;0;0
15;36755;30;0;0;0;0;.00nan;0;0
15;43757;18;93;44;2;42;.955;4200000;0
16;676;34;90;21;0;21;1.000;3600000;0
16;65762;35;0;0;0;0;.00nan;0;0
16;78806;34;0;0;0;0;.00nan;0;0
16;141998;35;85;35;2;33;.943;3600000;0
17;168712;14;0;0;0;0;.00nan;0;0
17;175912;14;77;40;4;36;.900;3600000;0
17;69536;10;70;15;0;15;1.000;1318000;0
17;152717;10;22;25;6;19;.760;2256000;0
18;175084;22;0;0;0;0;.00nan;0;0
18;46492;0;95;39;2;37;.949;3600000;0
18;143473;22;64;31;3;28;.903;3600000;0
18;149455;0;0;0;0;0;.00nan;0;0
19;556;3;100;31;0;31;1.000;3600000;0
19;1669;32;0;0;0;0;.00nan;0;0
19;179344;3;0;0;0;0;.00nan;0;0
19;58830;32;80;29;2;27;.931;3534000;0
20;183844;29;0;0;0;0;.00nan;0;0
20;190465;33;0;0;0;0;.00nan;0;0
20;37818;29;72;23;1;22;.957;3600000;0
20;149452;33;72;37;4;33;.892;3600000;0
21;176921;15;0;0;0;0;.00nan;0;0
21;85727;15;55;26;3;23;.885;3600000;0
21;86192;21;62;36;5;31;.861;3534000;0
21;143156;21;0;0;0;0;.00nan;0;0
22;166751;5;56;29;4;25;.862;3600000;0
22;178413;17;0;0;0;0;.00nan;0;0
22;176995;5;0;0;0;0;.00nan;0;0
22;146862;17;92;33;1;32;.970;3600000;0
23;8424;28;0;0;0;0;.00nan;0;0
23;174718;25;78;23;1;22;.957;3600000;0
23;148958;25;0;0;0;0;.00nan;0;0
23;152835;28;81;35;3;32;.914;3600000;0
24;65;11;96;58;3;55;.948;4200000;0
24;67;11;0;0;0;0;.00nan;0;0
24;69536;10;54;24;3;21;.875;4200000;0
24;152717;10;0;0;0;0;.00nan;0;0
25;171838;31;100;30;0;30;1.000;3600000;0
25;163423;26;0;0;0;0;.00nan;0;0
25;179154;26;85;44;3;41;.932;3600000;0
25;86360;31;0;0;0;0;.00nan;0;0
26;163695;9;81;41;4;37;.902;3600000;0
26;165582;24;56;7;0;7;1.000;1471000;0
26;168872;24;12;19;6;13;.684;2096000;0
26;175092;9;0;0;0;0;.00nan;0;0
27;2059;23;0;0;0;0;.00nan;0;0
27;14266;23;81;47;3;44;.936;3557000;0
27;85798;12;82;28;1;27;.964;3600000;0
27;91178;12;0;0;0;0;.00nan;0;0
28;9235;4838;0;0;0;0;.00nan;0;0
28;166381;27;48;29;4;25;.862;3600000;0
28;175660;27;0;0;0;0;.00nan;0;0
28;143749;4838;77;48;5;43;.896;3600000;0
29;13714;8;0;0;0;0;.00nan;0;0
29;18213;8;50;27;3;24;.889;4200000;0
29;173727;18;92;41;3;38;.927;4200000;0
29;43757;18;0;0;0;0;.00nan;0;0
30;17043;30;78;25;1;24;.960;3600000;0
30;169868;4182;0;0;0;0;.00nan;0;0
30;36755;30;0;0;0;0;.00nan;0;0
30;147945;4182;58;26;4;22;.846;3600000;0
31;166591;20;0;0;0;0;.00nan;0;0
31;163565;19;0;0;0;0;.00nan;0;0
31;14305;19;85;22;1;21;.955;3600000;0
31;86697;20;37;46;8;38;.826;3600000;0
32;166751;5;92;39;2;37;.949;3600000;0
32;176995;5;0;0;0;0;.00nan;0;0
32;46492;0;0;0;0;0;.00nan;0;0
32;149455;0;28;25;6;19;.760;3600000;0
33;166591;20;65;13;1;12;.923;3600000;0
33;169868;4182;0;0;0;0;.00nan;0;0
33;86697;20;0;0;0;0;.00nan;0;0
33;147945;4182;82;40;2;38;.950;3598000;0
34;178413;17;59;7;0;7;1.000;538000;0
34;86192;21;78;21;2;19;.905;3600000;0
34;143156;21;0;0;0;0;.00nan;0;0
34;146862;17;64;45;6;39;.867;3062000;0
35;556;3;63;32;3;29;.906;3579000;0
35;676;34;63;25;2;23;.920;3600000;0
35;179344;3;0;0;0;0;.00nan;0;0
35;78806;34;0;0;0;0;.00nan;0;0
36;176921;15;0;0;0;0;.00nan;0;0
36;65762;35;0;0;0;0;.00nan;0;0
36;85727;15;79;38;3;35;.921;3595000;0
36;141998;35;94;35;2;33;.943;3600000;0
37;171838;31;65;29;2;27;.931;3600000;0
37;174718;25;44;25;4;21;.840;3568000;0
37;86360;31;0;0;0;0;.00nan;0;0
37;148958;25;0;0;0;0;.00nan;0;0
38;65;11;55;37;5;32;.865;3600000;0
38;67;11;0;0;0;0;.00nan;0;0
38;168712;14;71;22;1;21;.955;3600000;0
38;175912;14;0;0;0;0;.00nan;0;0
39;166751;5;74;33;3;30;.909;3600000;0
39;163695;9;0;0;0;0;.00nan;0;0
39;175092;9;43;27;4;23;.852;3541000;0
39;176995;5;0;0;0;0;.00nan;0;0
40;163423;26;0;0;0;0;.00nan;0;0
40;8424;28;37;37;6;31;.838;3571000;0
40;179154;26;64;28;4;24;.857;3600000;0
40;152835;28;0;0;0;0;.00nan;0;0
41;166381;27;19;10;4;6;.600;755000;0
41;175084;22;69;28;2;26;.929;3600000;0
41;175660;27;43;32;4;28;.875;2845000;0
41;143473;22;0;0;0;0;.00nan;0;0
42;165582;24;0;0;0;0;.00nan;0;0
42;168872;24;42;32;5;27;.844;3568000;0
42;65762;35;83;40;3;37;.925;3600000;0
42;141998;35;0;0;0;0;.00nan;0;0
43;9235;4838;0;0;0;0;.00nan;0;0
43;190465;33;0;0;0;0;.00nan;0;0
43;143749;4838;91;41;3;38;.927;3600000;0
43;149452;33;90;20;0;20;1.000;3600000;0
44;1669;32;0;0;0;0;.00nan;0;0
44;163565;19;0;0;0;0;.00nan;0;0
44;14305;19;88;24;0;24;1.000;3600000;0
44;58830;32;57;29;3;26;.897;3600000;0
45;2059;23;65;34;3;31;.912;3600000;0
45;13714;8;34;21;5;16;.762;3600000;0
45;14266;23;0;0;0;0;.00nan;0;0
45;18213;8;0;0;0;0;.00nan;0;0
46;166591;20;0;0;0;0;.00nan;0;0
46;173727;18;52;31;5;26;.839;3600000;0
46;43757;18;0;0;0;0;.00nan;0;0
46;86697;20;80;28;1;27;.964;3600000;0
47;166646;16;0;0;0;0;.00nan;0;0
47;17043;30;97;42;1;41;.976;4200000;0
47;36755;30;0;0;0;0;.00nan;0;0
47;50065;16;79;35;1;34;.971;4200000;0
48;168712;14;76;26;2;24;.923;3600000;0
48;175912;14;0;0;0;0;.00nan;0;0
48;46492;0;31;29;6;23;.793;3057000;0
48;149455;0;54;4;0;4;1.000;543000;0
49;178413;17;80;36;3;33;.917;4200000;0
49;69536;10;0;0;0;0;.00nan;0;0
49;146862;17;0;0;0;0;.00nan;0;0
49;152717;10;77;42;3;39;.929;4200000;0
50;65;11;100;26;0;26;1.000;3600000;0
50;67;11;0;0;0;0;.00nan;0;0
50;163695;9;59;40;5;35;.875;3600000;0
50;175092;9;0;0;0;0;.00nan;0;0
51;556;3;62;34;4;30;.882;3600000;0
51;171838;31;0;0;0;0;.00nan;0;0
51;179344;3;0;0;0;0;.00nan;0;0
51;86360;31;56;43;6;37;.860;3550000;0
52;176921;15;0;0;0;0;.00nan;0;0
52;190465;33;0;0;0;0;.00nan;0;0
52;85727;15;91;35;1;34;.971;3560000;0
52;149452;33;100;28;0;28;1.000;3600000;0
53;9235;4838;0;0;0;0;.00nan;0;0
53;175084;22;0;0;0;0;.00nan;0;0
53;143473;22;53;15;2;13;.867;3600000;0
53;143749;4838;92;51;5;46;.902;3600000;0
54;166751;5;0;0;0;0;.00nan;0;0
54;166381;27;0;0;0;0;.00nan;0;0
54;175660;27;67;14;1;13;.929;3600000;0
54;176995;5;73;39;3;36;.923;3571000;0
55;163423;26;0;0;0;0;.00nan;0;0
55;163565;19;0;0;0;0;.00nan;0;0
55;14305;19;81;47;4;43;.915;4200000;0
55;179154;26;88;50;4;46;.920;4200000;0
56;65762;35;0;0;0;0;.00nan;0;0
56;85798;12;54;12;2;10;.833;3564000;0
56;91178;12;0;0;0;0;.00nan;0;0
56;141998;35;100;41;1;40;.976;3600000;0
57;1669;32;0;0;0;0;.00nan;0;0
57;17043;30;72;24;1;23;.958;3600000;0
57;36755;30;0;0;0;0;.00nan;0;0
57;58830;32;91;41;3;38;.927;3548000;0
58;166646;16;0;0;0;0;.00nan;0;0
58;169868;4182;56;5;0;5;1.000;613000;0
58;50065;16;91;31;2;29;.935;3600000;0
58;147945;4182;50;35;6;29;.829;2987000;0
59;166591;20;0;0;0;0;.00nan;0;0
59;2059;23;0;0;0;0;.00nan;0;0
59;14266;23;94;40;1;39;.975;3600000;0
59;86697;20;54;29;4;25;.862;3600000;0
60;13714;8;0;0;0;0;.00nan;0;0
60;18213;8;100;30;0;30;1.000;3600000;0
60;174718;25;52;30;4;26;.867;3600000;0
60;148958;25;0;0;0;0;.00nan;0;0
61;183844;29;0;0;0;0;.00nan;0;0
61;173727;18;100;42;0;42;1.000;3600000;0
61;37818;29;53;16;2;14;.875;3540000;0
61;43757;18;0;0;0;0;.00nan;0;0
62;65;11;82;53;4;49;.925;3573000;0
62;67;11;0;0;0;0;.00nan;0;0
62;86192;21;65;22;2;20;.909;3600000;0
62;143156;21;0;0;0;0;.00nan;0;0
63;676;34;9;20;7;13;.650;2262000;0
63;165582;24;0;0;0;0;.00nan;0;0
63;168872;24;73;27;2;25;.926;3600000;0
63;78806;34;57;6;0;6;1.000;1338000;0
64;178413;17;0;0;0;0;.00nan;0;0
64;46492;0;74;18;1;17;.944;3600000;0
64;146862;17;66;38;4;34;.895;3600000;0
64;149455;0;0;0;0;0;.00nan;0;0
65;169868;4182;0;0;0;0;.00nan;0;0
65;65762;35;60;36;4;32;.889;4008000;0
65;141998;35;0;0;0;0;.00nan;0;0
65;147945;4182;49;37;5;32;.865;3959000;0
66;163695;9;0;0;0;0;.00nan;0;0
66;165582;24;81;41;3;38;.927;3600000;0
66;168872;24;0;0;0;0;.00nan;0;0
66;175092;9;48;32;5;27;.844;3600000;0
67;556;3;95;61;6;55;.902;3600000;0
67;166381;27;0;0;0;0;.00nan;0;0
67;179344;3;0;0;0;0;.00nan;0;0
67;175660;27;70;20;2;18;.900;3600000;0
68;8424;28;0;0;0;0;.00nan;0;0
68;168712;14;52;31;5;26;.839;3600000;0
68;175912;14;0;0;0;0;.00nan;0;0
68;152835;28;82;43;3;40;.930;3600000;0
69;171838;31;75;22;1;21;.955;3600000;0
69;166751;5;72;30;2;28;.933;3547000;0
69;176995;5;0;0;0;0;.00nan;0;0
69;86360;31;0;0;0;0;.00nan;0;0
70;17043;30;93;48;3;45;.938;3583000;0
70;174718;25;0;0;0;0;.00nan;0;0
70;36755;30;0;0;0;0;.00nan;0;0
70;148958;25;72;22;2;20;.909;3600000;0
71;166646;16;0;0;0;0;.00nan;0;0
71;175084;22;0;0;0;0;.00nan;0;0
71;50065;16;76;36;3;33;.917;3600000;0
71;143473;22;86;18;0;18;1.000;3600000;0
72;163423;26;0;0;0;0;.00nan;0;0
72;179154;26;90;38;3;35;.921;3600000;0
72;86192;21;0;0;0;0;.00nan;0;0
72;143156;21;86;28;2;26;.929;3600000;0
73;173727;18;85;52;5;47;.904;3600000;0
73;190465;33;0;0;0;0;.00nan;0;0
73;43757;18;0;0;0;0;.00nan;0;0
73;149452;33;82;23;1;22;.957;3600000;0
74;69536;10;0;0;0;0;.00nan;0;0
74;85798;12;0;0;0;0;.00nan;0;0
74;91178;12;80;26;1;25;.962;3600000;0
74;152717;10;82;38;3;35;.921;3560000;0
75;166591;20;59;37;4;33;.892;3578000;0
75;13714;8;0;0;0;0;.00nan;0;0
75;18213;8;100;38;2;36;.947;3600000;0
75;86697;20;0;0;0;0;.00nan;0;0
76;1669;32;0;0;0;0;.00nan;0;0
76;9235;4838;85;26;1;25;.962;3600000;0
76;58830;32;69;32;3;29;.906;3600000;0
76;143749;4838;0;0;0;0;.00nan;0;0
77;2059;23;51;31;4;27;.871;2313000;0
77;14266;23;49;16;2;14;.875;1287000;0
77;176921;15;0;0;0;0;.00nan;0;0
77;85727;15;55;16;2;14;.875;3600000;0
78;163565;19;0;0;0;0;.00nan;0;0
78;14305;19;65;18;1;17;.944;3600000;0
78;183844;29;0;0;0;0;.00nan;0;0
78;37818;29;80;31;2;29;.935;3573000;0
79;65;11;90;41;2;39;.951;3600000;0
79;67;11;0;0;0;0;.00nan;0;0
79;178413;17;42;21;4;17;.810;3573000;0
79;146862;17;0;0;0;0;.00nan;0;0
80;183844;29;41;24;4;20;.833;3553000;0
80;169868;4182;67;29;3;26;.897;3600000;0
80;37818;29;0;0;0;0;.00nan;0;0
80;147945;4182;0;0;0;0;.00nan;0;0
81;163695;9;0;0;0;0;.00nan;0;0
81;8424;28;87;32;2;30;.938;3760000;0
81;175092;9;62;24;3;21;.875;3760000;0
81;152835;28;0;0;0;0;.00nan;0;0
82;171838;31;89;41;2;39;.951;3600000;0
82;168712;14;0;0;0;0;.00nan;0;0
82;175912;14;66;16;1;15;.938;3600000;0
82;86360;31;0;0;0;0;.00nan;0;0
83;169868;4182;64;5;0;5;1.000;445000;0
83;86192;21;65;23;2;21;.913;3600000;0
83;143156;21;0;0;0;0;.00nan;0;0
83;147945;4182;48;29;4;25;.862;3132000;0
84;163695;9;87;38;3;35;.921;3600000;0
84;175092;9;0;0;0;0;.00nan;0;0
84;46492;0;57;30;4;26;.867;3544000;0
84;149455;0;0;0;0;0;.00nan;0;0
85;166591;20;58;22;3;19;.864;4200000;0
85;166751;5;0;0;0;0;.00nan;0;0
85;176995;5;66;35;3;32;.914;4200000;0
85;86697;20;0;0;0;0;.00nan;0;0
86;676;34;0;0;0;0;.00nan;0;0
86;8424;28;0;0;0;0;.00nan;0;0
86;78806;34;68;19;1;18;.947;3600000;0
86;152835;28;70;33;3;30;.909;3527000;0
87;166646;16;0;0;0;0;.00nan;0;0
87;50065;16;66;24;2;22;.917;3600000;0
87;69536;10;93;45;3;42;.933;3597000;0
87;152717;10;0;0;0;0;.00nan;0;0
88;556;3;80;34;2;32;.941;3559000;0
88;173727;18;84;26;1;25;.962;3600000;0
88;179344;3;0;0;0;0;.00nan;0;0
88;43757;18;0;0;0;0;.00nan;0;0
89;13714;8;0;0;0;0;.00nan;0;0
89;165582;24;94;30;1;29;.967;3600000;0
89;18213;8;59;23;3;20;.870;3520000;0
89;168872;24;0;0;0;0;.00nan;0;0
90;2059;23;84;25;0;25;1.000;2458000;0
90;14266;23;24;18;5;13;.722;1142000;0
90;178413;17;0;0;0;0;.00nan;0;0
90;146862;17;90;30;1;29;.967;3600000;0
91;183844;29;57;18;2;16;.889;1752000;0
91;174718;25;0;0;0;0;.00nan;0;0
91;37818;29;17;17;6;11;.647;1848000;0
91;148958;25;70;36;3;33;.917;3600000;0
92;1669;32;0;0;0;0;.00nan;0;0
92;58830;32;68;34;3;31;.912;3536000;0
92;85798;12;0;0;0;0;.00nan;0;0
92;91178;12;82;30;1;29;.967;3600000;0
93;163423;26;0;0;0;0;.00nan;0;0
93;9235;4838;0;0;0;0;.00nan;0;0
93;179154;26;86;30;1;29;.967;3600000;0
93;143749;4838;41;40;7;33;.825;3600000;0
94;166381;27;37;24;5;19;.792;3600000;0
94;175660;27;0;0;0;0;.00nan;0;0
94;190465;33;0;0;0;0;.00nan;0;0
94;149452;33;71;29;2;27;.931;3600000;0
95;65;11;66;42;5;37;.881;3600000;0
95;67;11;0;0;0;0;.00nan;0;0
95;176921;15;0;0;0;0;.00nan;0;0
95;85727;15;64;21;2;19;.905;3600000;0
96;163565;19;0;0;0;0;.00nan;0;0
96;14305;19;60;40;5;35;.875;3530000;0
96;65762;35;0;0;0;0;.00nan;0;0
96;141998;35;82;39;3;36;.923;3600000;0
97;17043;30;84;36;2;34;.944;3600000;0
97;175084;22;0;0;0;0;.00nan;0;0
97;36755;30;0;0;0;0;.00nan;0;0
97;143473;22;91;28;1;27;.964;3600000;0
98;676;34;64;30;3;27;.900;4085000;0
98;168712;14;72;38;4;34;.895;4085000;0
98;175912;14;0;0;0;0;.00nan;0;0
98;78806;34;0;0;0;0;.00nan;0;0
99;183844;29;0;0;0;0;.00nan;0;0
99;169868;4182;0;0;0;0;.00nan;0;0
99;37818;29;78;28;2;26;.929;3600000;0
99;147945;4182;66;42;5;37;.881;3600000;0
100;166591;20;0;0;0;0;.00nan;0;0
100;2059;23;88;29;1;28;.966;3600000;0
100;14266;23;0;0;0;0;.00nan;0;0
100;86697;20;68;24;2;22;.917;3600000;0
101;1669;32;0;0;0;0;.00nan;0;0
101;178413;17;0;0;0;0;.00nan;0;0
101;58830;32;56;32;4;28;.875;3568000;0
101;146862;17;62;21;2;19;.905;3600000;0
102;8424;28;61;36;5;31;.861;3635000;0
102;86192;21;85;40;4;36;.900;3635000;0
102;143156;21;0;0;0;0;.00nan;0;0
102;152835;28;0;0;0;0;.00nan;0;0
103;163423;26;0;0;0;0;.00nan;0;0
103;179154;26;100;33;0;33;1.000;3600000;0
103;175084;22;0;0;0;0;.00nan;0;0
103;143473;22;60;23;3;20;.870;3600000;0
104;13714;8;0;0;0;0;.00nan;0;0
104;18213;8;75;33;3;30;.909;3591000;0
104;69536;10;0;0;0;0;.00nan;0;0
104;152717;10;71;26;2;24;.923;3600000;0
105;166751;5;45;24;4;20;.833;3600000;0
105;173727;18;89;33;1;32;.970;3600000;0
105;176995;5;0;0;0;0;.00nan;0;0
105;43757;18;0;0;0;0;.00nan;0;0
106;165582;24;0;0;0;0;.00nan;0;0
106;168872;24;72;12;1;11;.917;3600000;0
106;46492;0;97;51;2;49;.961;3598000;0
106;149455;0;0;0;0;0;.00nan;0;0
107;171838;31;54;4;0;4;1.000;343000;0
107;166646;16;68;35;4;31;.886;3600000;0
107;50065;16;0;0;0;0;.00nan;0;0
107;86360;31;29;31;7;24;.774;3257000;0
108;65;11;0;0;0;0;.00nan;0;0
108;67;11;81;51;5;46;.902;4103000;0
108;85798;12;61;29;4;25;.862;4103000;0
108;91178;12;0;0;0;0;.00nan;0;0
109;9235;4838;0;0;0;0;.00nan;0;0
109;176921;15;0;0;0;0;.00nan;0;0
109;85727;15;77;37;3;34;.919;3528000;0
109;143749;4838;72;30;2;28;.933;3600000;0
110;17043;30;0;0;0;0;.00nan;0;0
110;174718;25;17;22;6;16;.727;2071000;0
110;36755;30;75;33;2;31;.939;3600000;0
110;148958;25;70;15;0;15;1.000;1529000;0
111;166591;20;68;24;2;22;.917;3600000;0
111;173727;18;0;0;0;0;.00nan;0;0
111;43757;18;73;44;3;41;.932;3568000;0
111;86697;20;0;0;0;0;.00nan;0;0
112;676;34;0;0;0;0;.00nan;0;0
112;163695;9;0;0;0;0;.00nan;0;0
112;175092;9;79;28;1;27;.964;3600000;0
112;78806;34;90;36;2;34;.944;3518000;0
113;163423;26;0;0;0;0;.00nan;0;0
113;168712;14;0;0;0;0;.00nan;0;0
113;179154;26;97;39;2;37;.949;4200000;0
113;175912;14;81;34;2;32;.941;4200000;0
114;163565;19;0;0;0;0;.00nan;0;0
114;14305;19;100;27;0;27;1.000;3600000;0
114;65762;35;0;0;0;0;.00nan;0;0
114;141998;35;36;33;6;27;.818;3600000;0
115;166381;27;0;0;0;0;.00nan;0;0
115;175660;27;92;18;0;18;1.000;3600000;0
115;85798;12;0;0;0;0;.00nan;0;0
115;91178;12;89;33;1;32;.970;3600000;0
116;169868;4182;0;0;0;0;.00nan;0;0
116;175084;22;89;15;0;15;1.000;3600000;0
116;143473;22;0;0;0;0;.00nan;0;0
116;147945;4182;93;50;4;46;.920;3600000;0
117;556;3;98;36;1;35;.972;3574000;0
117;2059;23;100;27;0;27;1.000;3600000;0
117;14266;23;0;0;0;0;.00nan;0;0
117;179344;3;0;0;0;0;.00nan;0;0
118;183844;29;0;0;0;0;.00nan;0;0
118;178413;17;0;0;0;0;.00nan;0;0
118;37818;29;33;17;4;13;.765;3600000;0
118;146862;17;89;34;2;32;.941;3600000;0
119;165582;24;0;0;0;0;.00nan;0;0
119;168872;24;98;32;1;31;.969;4200000;0
119;86192;21;71;21;1;20;.952;4200000;0
119;143156;21;0;0;0;0;.00nan;0;0
120;1669;32;0;0;0;0;.00nan;0;0
120;8424;28;0;0;0;0;.00nan;0;0
120;58830;32;40;28;5;23;.821;3600000;0
120;152835;28;87;39;3;36;.923;3600000;0
121;171838;31;76;30;2;28;.933;3600000;0
121;190465;33;0;0;0;0;.00nan;0;0
121;86360;31;0;0;0;0;.00nan;0;0
121;149452;33;80;36;3;33;.917;3575000;0
122;46492;0;63;33;4;29;.879;4200000;0
122;69536;10;76;46;4;42;.913;4200000;0
122;149455;0;0;0;0;0;.00nan;0;0
122;152717;10;0;0;0;0;.00nan;0;0
123;166381;27;0;0;0;0;.00nan;0;0
123;175660;27;62;27;3;24;.889;3600000;0
123;176921;15;37;7;2;5;.714;491000;0
123;85727;15;57;42;6;36;.857;3109000;0
124;163565;19;67;32;3;29;.906;3600000;0
124;14305;19;0;0;0;0;.00nan;0;0
124;17043;30;49;29;4;25;.862;3581000;0
124;36755;30;0;0;0;0;.00nan;0;0
125;163695;9;48;26;4;22;.846;3600000;0
125;13714;8;0;0;0;0;.00nan;0;0
125;18213;8;79;26;1;25;.962;3600000;0
125;175092;9;0;0;0;0;.00nan;0;0
126;676;34;74;25;2;23;.920;3538000;0
126;163423;26;0;0;0;0;.00nan;0;0
126;179154;26;78;29;1;28;.966;3600000;0
126;78806;34;0;0;0;0;.00nan;0;0
127;168712;14;79;33;3;30;.909;4200000;0
127;173727;18;62;33;3;30;.909;4200000;0
127;175912;14;0;0;0;0;.00nan;0;0
127;43757;18;0;0;0;0;.00nan;0;0
128;65;11;67;34;3;31;.912;3600000;0
128;67;11;0;0;0;0;.00nan;0;0
128;9235;4838;0;0;0;0;.00nan;0;0
128;143749;4838;77;19;1;18;.947;3600000;0
129;556;3;100;35;0;35;1.000;3600000;0
129;183844;29;0;0;0;0;.00nan;0;0
129;179344;3;0;0;0;0;.00nan;0;0
129;37818;29;62;15;1;14;.933;3545000;0
130;166591;20;0;0;0;0;.00nan;0;0
130;175084;22;0;0;0;0;.00nan;0;0
130;86697;20;72;51;6;45;.882;3600000;0
130;143473;22;68;18;2;16;.889;3600000;0
131;169868;4182;0;0;0;0;.00nan;0;0
131;69536;10;85;30;1;29;.967;3600000;0
131;147945;4182;59;22;3;19;.864;3574000;0
131;152717;10;0;0;0;0;.00nan;0;0
132;166751;5;40;36;6;30;.833;2296000;0
132;2059;23;65;29;2;27;.931;3600000;0
132;14266;23;0;0;0;0;.00nan;0;0
132;176995;5;56;7;0;7;1.000;1304000;0
133;165582;24;0;0;0;0;.00nan;0;0
133;178413;17;0;0;0;0;.00nan;0;0
133;168872;24;54;17;2;15;.882;3572000;0
133;146862;17;99;36;1;35;.972;3600000;0
134;1669;32;0;0;0;0;.00nan;0;0
134;176921;15;0;0;0;0;.00nan;0;0
134;58830;32;76;32;2;30;.938;3933000;0
134;85727;15;59;23;3;20;.870;3933000;0
135;166646;16;0;0;0;0;.00nan;0;0
135;50065;16;82;42;4;38;.905;3837000;0
135;86192;21;70;30;3;27;.900;3837000;0
135;143156;21;0;0;0;0;.00nan;0;0
136;174718;25;0;0;0;0;.00nan;0;0
136;65762;35;63;23;2;21;.913;2663000;0
136;141998;35;25;14;4;10;.714;937000;0
136;148958;25;65;22;2;20;.909;3600000;0
137;8424;28;0;0;0;0;.00nan;0;0
137;17043;30;60;24;2;22;.917;3600000;0
137;36755;30;0;0;0;0;.00nan;0;0
137;152835;28;66;29;3;26;.897;3549000;0
138;171838;31;59;33;4;29;.879;3600000;0
138;163565;19;0;0;0;0;.00nan;0;0
138;14305;19;70;21;1;20;.952;3600000;0
138;86360;31;0;0;0;0;.00nan;0;0
139;166381;27;60;30;3;27;.900;3600000;0
139;175660;27;0;0;0;0;.00nan;0;0
139;190465;33;0;0;0;0;.00nan;0;0
139;149452;33;93;46;2;44;.957;3600000;0
140;163695;9;0;0;0;0;.00nan;0;0
140;175084;22;0;0;0;0;.00nan;0;0
140;175092;9;30;52;9;43;.827;3600000;0
140;143473;22;70;20;1;19;.950;3600000;0
141;65;11;73;45;5;40;.889;3600000;0
141;67;11;0;0;0;0;.00nan;0;0
141;166646;16;0;0;0;0;.00nan;0;0
141;50065;16;95;19;0;19;1.000;3600000;0
142;13714;8;56;18;2;16;.889;3600000;0
142;18213;8;0;0;0;0;.00nan;0;0
142;85798;12;58;33;4;29;.879;3536000;0
142;91178;12;0;0;0;0;.00nan;0;0
143;169868;4182;79;30;2;28;.933;3600000;0
143;65762;35;0;0;0;0;.00nan;0;0
143;141998;35;45;27;4;23;.852;3525000;0
143;147945;4182;0;0;0;0;.00nan;0;0
144;171838;31;0;0;0;0;.00nan;0;0
144;183844;29;91;17;0;17;1.000;3600000;0
144;37818;29;0;0;0;0;.00nan;0;0
144;86360;31;62;38;5;33;.868;3600000;0
145;166751;5;45;34;5;29;.853;4131000;0
145;176995;5;0;0;0;0;.00nan;0;0
145;86192;21;52;32;4;28;.875;4131000;0
145;143156;21;0;0;0;0;.00nan;0;0
146;556;3;73;28;2;26;.929;3600000;0
146;178413;17;86;45;3;42;.933;3586000;0
146;179344;3;0;0;0;0;.00nan;0;0
146;146862;17;0;0;0;0;.00nan;0;0
147;166591;20;95;34;1;33;.971;3600000;0
147;176921;15;49;19;3;16;.842;3546000;0
147;85727;15;0;0;0;0;.00nan;0;0
147;86697;20;0;0;0;0;.00nan;0;0
148;163565;19;0;0;0;0;.00nan;0;0
148;14305;19;79;30;2;28;.933;3600000;0
148;46492;0;0;0;0;0;.00nan;0;0
148;149455;0;27;27;6;21;.778;3600000;0
149;165582;24;0;0;0;0;.00nan;0;0
149;168712;14;0;0;0;0;.00nan;0;0
149;168872;24;79;25;1;24;.960;3600000;0
149;175912;14;91;43;2;41;.953;3587000;0
150;676;34;46;36;5;31;.861;3571000;0
150;163423;26;0;0;0;0;.00nan;0;0
150;179154;26;87;31;3;28;.903;3600000;0
150;78806;34;0;0;0;0;.00nan;0;0
151;166646;16;41;25;4;21;.840;3600000;0
151;9235;4838;28;19;5;14;.737;1135000;0
151;50065;16;0;0;0;0;.00nan;0;0
151;143749;4838;38;19;4;15;.789;2465000;0
152;8424;28;0;0;0;0;.00nan;0;0
152;65762;35;65;33;3;30;.909;3588000;0
152;141998;35;0;0;0;0;.00nan;0;0
152;152835;28;67;22;2;20;.909;3600000;0
153;2059;23;0;0;0;0;.00nan;0;0
153;14266;23;81;31;2;29;.935;3592000;0
153;190465;33;0;0;0;0;.00nan;0;0
153;149452;33;78;22;1;21;.955;3600000;0
154;1669;32;0;0;0;0;.00nan;0;0
154;17043;30;93;23;0;23;1.000;3600000;0
154;36755;30;0;0;0;0;.00nan;0;0
154;58830;32;97;38;1;37;.974;3552000;0
155;166381;27;0;0;0;0;.00nan;0;0
155;173727;18;0;0;0;0;.00nan;0;0
155;175660;27;68;21;2;19;.905;3600000;0
155;43757;18;86;43;3;40;.930;3590000;0
156;163695;9;0;0;0;0;.00nan;0;0
156;175084;22;0;0;0;0;.00nan;0;0
156;175092;9;71;27;2;25;.926;4093000;0
156;143473;22;65;28;3;25;.893;4093000;0
157;676;34;0;0;0;0;.00nan;0;0
157;78806;34;99;37;1;36;.973;3600000;0
157;85798;12;0;0;0;0;.00nan;0;0
157;91178;12;67;37;3;34;.919;3566000;0
158;9235;4838;0;0;0;0;.00nan;0;0
158;190465;33;0;0;0;0;.00nan;0;0
158;143749;4838;85;32;1;31;.969;3600000;0
158;149452;33;83;14;0;14;1.000;3600000;0
159;1669;32;0;0;0;0;.00nan;0;0
159;58830;32;82;29;1;28;.966;4200000;0
159;65762;35;0;0;0;0;.00nan;0;0
159;141998;35;73;22;1;21;.955;4200000;0
160;183844;29;64;22;2;20;.909;3600000;0
160;178413;17;0;0;0;0;.00nan;0;0
160;37818;29;0;0;0;0;.00nan;0;0
160;146862;17;83;39;3;36;.923;3600000;0
161;166751;5;66;39;5;34;.872;3600000;0
161;176995;5;0;0;0;0;.00nan;0;0
161;46492;0;0;0;0;0;.00nan;0;0
161;149455;0;64;28;3;25;.893;3600000;0
162;163565;19;0;0;0;0;.00nan;0;0
162;14305;19;48;34;5;29;.853;3600000;0
162;175084;22;84;13;0;13;1.000;3600000;0
162;143473;22;0;0;0;0;.00nan;0;0
163;8424;28;0;0;0;0;.00nan;0;0
163;85798;12;72;25;1;24;.960;3600000;0
163;91178;12;0;0;0;0;.00nan;0;0
163;152835;28;80;43;5;38;.884;3600000;0
164;171838;31;30;34;6;28;.824;3645000;0
164;163695;9;49;40;7;33;.825;3645000;0
164;175092;9;0;0;0;0;.00nan;0;0
164;86360;31;0;0;0;0;.00nan;0;0
165;168712;14;50;28;4;24;.857;3600000;0
165;175912;14;0;0;0;0;.00nan;0;0
165;86192;21;52;35;5;30;.857;3572000;0
165;143156;21;0;0;0;0;.00nan;0;0
166;166591;20;0;0;0;0;.00nan;0;0
166;165582;24;30;30;6;24;.800;3600000;0
166;168872;24;0;0;0;0;.00nan;0;0
166;86697;20;86;31;1;30;.968;3600000;0
167;556;3;63;38;4;34;.895;3600000;0
167;179344;3;0;0;0;0;.00nan;0;0
167;174718;25;0;0;0;0;.00nan;0;0
167;148958;25;20;15;5;10;.667;3567000;0
168;163423;26;0;0;0;0;.00nan;0;0
168;179154;26;93;27;1;26;.963;3600000;0
168;176921;15;0;0;0;0;.00nan;0;0
168;85727;15;29;26;5;21;.808;3600000;0
169;65;11;34;25;5;20;.800;3600000;0
169;67;11;0;0;0;0;.00nan;0;0
169;2059;23;76;25;1;24;.960;3600000;0
169;14266;23;0;0;0;0;.00nan;0;0
170;173727;18;0;0;0;0;.00nan;0;0
170;43757;18;77;39;4;35;.897;3600000;0
170;69536;10;0;0;0;0;.00nan;0;0
170;152717;10;60;13;1;12;.923;3600000;0
171;166646;16;0;0;0;0;.00nan;0;0
171;166381;27;0;0;0;0;.00nan;0;0
171;175660;27;66;28;3;25;.893;3600000;0
171;50065;16;88;49;4;45;.918;3582000;0
172;13714;8;0;0;0;0;.00nan;0;0
172;17043;30;93;32;1;31;.969;3600000;0
172;18213;8;57;46;6;40;.870;3600000;0
172;36755;30;0;0;0;0;.00nan;0;0
173;676;34;0;0;0;0;.00nan;0;0
173;174718;25;44;31;5;26;.839;3583000;0
173;78806;34;82;47;4;43;.915;3600000;0
173;148958;25;0;0;0;0;.00nan;0;0
174;17043;30;46;37;6;31;.838;3600000;0
174;169868;4182;0;0;0;0;.00nan;0;0
174;36755;30;0;0;0;0;.00nan;0;0
174;147945;4182;67;26;2;24;.923;3600000;0
175;556;3;97;49;2;47;.959;3552000;0
175;179344;3;0;0;0;0;.00nan;0;0
175;86192;21;84;32;1;31;.969;3600000;0
175;143156;21;0;0;0;0;.00nan;0;0
176;171838;31;0;0;0;0;.00nan;0;0
176;166751;5;100;28;0;28;1.000;3600000;0
176;176995;5;0;0;0;0;.00nan;0;0
176;86360;31;81;26;1;25;.962;3548000;0
177;166646;16;0;0;0;0;.00nan;0;0
177;183844;29;0;0;0;0;.00nan;0;0
177;37818;29;65;36;4;32;.889;3600000;0
177;50065;16;45;35;5;30;.857;3581000;0
178;9235;4838;0;0;0;0;.00nan;0;0
178;166381;27;67;26;2;24;.923;4200000;0
178;175660;27;0;0;0;0;.00nan;0;0
178;143749;4838;100;47;2;45;.957;4200000;0
179;166591;20;72;27;2;25;.926;3600000;0
179;163695;9;64;32;3;29;.906;3554000;0
179;175092;9;0;0;0;0;.00nan;0;0
179;86697;20;0;0;0;0;.00nan;0;0
180;166751;5;0;0;0;0;.00nan;0;0
180;8424;28;57;32;4;28;.875;3564000;0
180;176995;5;65;31;3;28;.903;3600000;0
180;152835;28;0;0;0;0;.00nan;0;0
181;163423;26;15;19;7;12;.632;1797000;0
181;165582;24;0;0;0;0;.00nan;0;0
181;168872;24;32;23;5;18;.783;3600000;0
181;179154;26;33;22;4;18;.818;1803000;0
182;178413;17;0;0;0;0;.00nan;0;0
182;176921;15;0;0;0;0;.00nan;0;0
182;85727;15;63;20;2;18;.900;3600000;0
182;146862;17;47;27;4;23;.852;3585000;0
183;1669;32;0;0;0;0;.00nan;0;0
183;58830;32;54;30;4;26;.867;3550000;0
183;85798;12;64;31;3;28;.903;3600000;0
183;91178;12;0;0;0;0;.00nan;0;0
184;2059;23;50;34;5;29;.853;3555000;0
184;14266;23;0;0;0;0;.00nan;0;0
184;65762;35;56;28;4;24;.857;3600000;0
184;141998;35;0;0;0;0;.00nan;0;0
185;65;11;83;45;3;42;.933;3703000;0
185;67;11;0;0;0;0;.00nan;0;0
185;190465;33;0;0;0;0;.00nan;0;0
185;149452;33;64;25;2;23;.920;3703000;0
186;169868;4182;0;0;0;0;.00nan;0;0
186;69536;10;0;0;0;0;.00nan;0;0
186;147945;4182;39;32;6;26;.813;3767000;0
186;152717;10;64;43;5;38;.884;3767000;0
187;676;34;21;23;6;17;.739;1869000;0
187;13714;8;0;0;0;0;.00nan;0;0
187;18213;8;82;23;1;22;.957;3600000;0
187;78806;34;78;20;0;20;1.000;1731000;0
188;173727;18;0;0;0;0;.00nan;0;0
188;175084;22;0;0;0;0;.00nan;0;0
188;43757;18;88;38;2;36;.947;3600000;0
188;143473;22;84;28;1;27;.964;3600000;0
189;171838;31;78;30;2;28;.933;3588000;0
189;46492;0;100;33;1;32;.970;3600000;0
189;86360;31;0;0;0;0;.00nan;0;0
189;149455;0;0;0;0;0;.00nan;0;0
190;556;3;74;26;2;24;.923;3600000;0
190;168712;14;41;24;4;20;.833;3528000;0
190;179344;3;0;0;0;0;.00nan;0;0
190;175912;14;0;0;0;0;.00nan;0;0
191;163565;19;0;0;0;0;.00nan;0;0
191;14305;19;51;37;5;32;.865;3600000;0
191;17043;30;67;21;1;20;.952;3600000;0
191;36755;30;0;0;0;0;.00nan;0;0
192;165582;24;0;0;0;0;.00nan;0;0
192;183844;29;60;28;3;25;.893;3587000;0
192;168872;24;62;22;2;20;.909;3600000;0
192;37818;29;0;0;0;0;.00nan;0;0
193;166646;16;0;0;0;0;.00nan;0;0
193;50065;16;77;33;3;30;.909;3581000;0
193;86192;21;100;41;1;40;.976;3600000;0
193;143156;21;0;0;0;0;.00nan;0;0
194;8424;28;0;0;0;0;.00nan;0;0
194;178413;17;0;0;0;0;.00nan;0;0
194;146862;17;90;37;3;34;.919;3618000;0
194;152835;28;70;28;2;26;.929;3618000;0
195;163423;26;0;0;0;0;.00nan;0;0
195;179154;26;95;45;2;43;.956;3600000;0
195;176921;15;38;23;4;19;.826;3535000;0
195;85727;15;0;0;0;0;.00nan;0;0
196;166381;27;0;0;0;0;.00nan;0;0
196;175660;27;81;28;2;26;.929;3600000;0
196;46492;0;0;0;0;0;.00nan;0;0
196;149455;0;43;41;6;35;.854;3600000;0
197;166751;5;64;39;4;35;.897;3560000;0
197;174718;25;0;0;0;0;.00nan;0;0
197;176995;5;0;0;0;0;.00nan;0;0
197;148958;25;62;29;3;26;.897;3600000;0
198;65762;35;0;0;0;0;.00nan;0;0
198;85798;12;0;0;0;0;.00nan;0;0
198;91178;12;99;39;1;38;.974;3600000;0
198;141998;35;90;38;3;35;.921;3588000;0
199;1669;32;0;0;0;0;.00nan;0;0
199;190465;33;0;0;0;0;.00nan;0;0
199;58830;32;76;33;2;31;.939;3612000;0
199;149452;33;59;20;3;17;.850;3612000;0
200;2059;23;45;46;6;40;.870;3600000;0
200;13714;8;0;0;0;0;.00nan;0;0
200;14266;23;0;0;0;0;.00nan;0;0
200;18213;8;68;24;3;21;.875;3600000;0
201;163565;19;61;31;4;27;.871;3600000;0
201;14305;19;0;0;0;0;.00nan;0;0
201;69536;10;0;0;0;0;.00nan;0;0
201;152717;10;93;30;1;29;.967;3600000;0
202;9235;4838;0;0;0;0;.00nan;0;0
202;173727;18;0;0;0;0;.00nan;0;0
202;43757;18;21;28;6;22;.786;3600000;0
202;143749;4838;81;27;2;25;.926;3600000;0
203;163423;26;0;0;0;0;.00nan;0;0
203;163695;9;49;8;1;7;.875;555000;0
203;179154;26;84;25;1;24;.960;3600000;0
203;175092;9;36;33;6;27;.818;3045000;0
204;556;3;77;33;2;31;.939;3576000;0
204;166591;20;0;0;0;0;.00nan;0;0
204;179344;3;0;0;0;0;.00nan;0;0
204;86697;20;99;53;1;52;.981;3600000;0
205;676;34;0;0;0;0;.00nan;0;0
205;168712;14;28;24;5;19;.792;3529000;0
205;175912;14;0;0;0;0;.00nan;0;0
205;78806;34;74;33;3;30;.909;3600000;0
206;65;11;85;47;3;44;.936;3599000;0
206;67;11;0;0;0;0;.00nan;0;0
206;171838;31;0;0;0;0;.00nan;0;0
206;86360;31;72;24;2;22;.917;3600000;0
207;169868;4182;0;0;0;0;.00nan;0;0
207;175084;22;0;0;0;0;.00nan;0;0
207;143473;22;63;17;2;15;.882;3600000;0
207;147945;4182;75;43;4;39;.907;3600000;0
208;17043;30;0;0;0;0;.00nan;0;0
208;173727;18;58;40;5;35;.875;3600000;0
208;36755;30;66;27;2;25;.926;3600000;0
208;43757;18;0;0;0;0;.00nan;0;0
209;178413;17;87;44;3;41;.932;3600000;0
209;86192;21;41;24;4;20;.833;3554000;0
209;143156;21;0;0;0;0;.00nan;0;0
209;146862;17;0;0;0;0;.00nan;0;0
210;166646;16;0;0;0;0;.00nan;0;0
210;1669;32;0;0;0;0;.00nan;0;0
210;50065;16;60;34;4;30;.882;3600000;0
210;58830;32;67;44;5;39;.886;3536000;0
211;8424;28;0;0;0;0;.00nan;0;0
211;183844;29;0;0;0;0;.00nan;0;0
211;37818;29;100;23;0;23;1.000;3600000;0
211;152835;28;68;35;3;32;.914;3600000;0
212;65;11;0;0;0;0;.00nan;0;0
212;67;11;66;36;4;32;.889;3600000;0
212;46492;0;48;23;3;20;.870;3600000;0
212;149455;0;0;0;0;0;.00nan;0;0
213;166591;20;41;21;4;17;.810;3600000;0
213;166751;5;100;34;1;33;.971;3600000;0
213;176995;5;0;0;0;0;.00nan;0;0
213;86697;20;0;0;0;0;.00nan;0;0
214;171838;31;73;39;4;35;.897;3586000;0
214;166381;27;74;26;2;24;.923;3600000;0
214;175660;27;0;0;0;0;.00nan;0;0
214;86360;31;0;0;0;0;.00nan;0;0
215;165582;24;0;0;0;0;.00nan;0;0
215;168712;14;0;0;0;0;.00nan;0;0
215;168872;24;48;19;3;16;.842;3600000;0
215;175912;14;93;26;0;26;1.000;3600000;0
216;163695;9;78;29;2;27;.931;3600000;0
216;175092;9;0;0;0;0;.00nan;0;0
216;69536;10;53;28;4;24;.857;3528000;0
216;152717;10;0;0;0;0;.00nan;0;0
217;190465;33;0;0;0;0;.00nan;0;0
217;65762;35;27;31;6;25;.806;2072000;0
217;141998;35;34;24;5;19;.792;1528000;0
217;149452;33;68;22;2;20;.909;3600000;0
218;13714;8;0;0;0;0;.00nan;0;0
218;18213;8;65;29;3;26;.897;4200000;0
218;85798;12;0;0;0;0;.00nan;0;0
218;91178;12;69;30;3;27;.900;4200000;0
219;2059;23;71;28;3;25;.893;3600000;0
219;9235;4838;0;0;0;0;.00nan;0;0
219;14266;23;0;0;0;0;.00nan;0;0
219;143749;4838;81;44;4;40;.909;3549000;0
220;163565;19;41;8;2;6;.750;567000;0
220;14305;19;47;41;6;35;.854;3033000;0
220;175084;22;35;13;3;10;.769;557000;0
220;143473;22;47;11;2;9;.818;3043000;0
221;556;3;0;0;0;0;.00nan;0;0
221;179344;3;29;31;7;24;.774;3898000;0
221;174718;25;35;38;6;32;.842;3898000;0
221;148958;25;0;0;0;0;.00nan;0;0
222;166646;16;53;20;3;17;.850;3518000;0
222;163423;26;0;0;0;0;.00nan;0;0
222;179154;26;100;42;1;41;.976;3600000;0
222;50065;16;0;0;0;0;.00nan;0;0
223;8424;28;85;40;3;37;.925;3734000;0
223;166381;27;0;0;0;0;.00nan;0;0
223;175660;27;53;25;4;21;.840;3734000;0
223;152835;28;0;0;0;0;.00nan;0;0
224;176921;15;0;0;0;0;.00nan;0;0
224;85727;15;77;36;2;34;.944;3550000;0
224;86192;21;0;0;0;0;.00nan;0;0
224;143156;21;74;22;1;21;.955;3600000;0
225;173727;18;0;0;0;0;.00nan;0;0
225;169868;4182;0;0;0;0;.00nan;0;0
225;43757;18;65;42;5;37;.881;3600000;0
225;147945;4182;42;19;3;16;.842;3600000;0
226;9235;4838;68;29;2;27;.931;3600000;0
226;165582;24;60;29;3;26;.897;3600000;0
226;168872;24;0;0;0;0;.00nan;0;0
226;143749;4838;0;0;0;0;.00nan;0;0
227;2059;23;96;32;1;31;.969;3600000;0
227;13714;8;0;0;0;0;.00nan;0;0
227;14266;23;0;0;0;0;.00nan;0;0
227;18213;8;22;16;5;11;.688;3600000;0
228;163695;9;0;0;0;0;.00nan;0;0
228;183844;29;0;0;0;0;.00nan;0;0
228;175092;9;56;27;3;24;.889;3555000;0
228;37818;29;67;24;2;22;.917;3600000;0
229;69536;10;0;0;0;0;.00nan;0;0
229;86192;21;34;29;5;24;.828;3727000;0
229;143156;21;0;0;0;0;.00nan;0;0
229;152717;10;51;38;6;32;.842;3727000;0
230;65;11;74;34;2;32;.941;3566000;0
230;67;11;0;0;0;0;.00nan;0;0
230;8424;28;0;0;0;0;.00nan;0;0
230;152835;28;89;16;0;16;1.000;3600000;0
231;17043;30;51;23;3;20;.870;3565000;0
231;168712;14;0;0;0;0;.00nan;0;0
231;175912;14;85;38;2;36;.947;3600000;0
231;36755;30;0;0;0;0;.00nan;0;0
232;166646;16;0;0;0;0;.00nan;0;0
232;50065;16;57;26;3;23;.885;4015000;0
232;65762;35;0;0;0;0;.00nan;0;0
232;141998;35;64;35;4;31;.886;4015000;0
233;169868;4182;0;0;0;0;.00nan;0;0
233;190465;33;0;0;0;0;.00nan;0;0
233;147945;4182;48;33;5;28;.848;3600000;0
233;149452;33;79;26;2;24;.923;3600000;0
234;166751;5;58;43;5;38;.884;3600000;0
234;176995;5;0;0;0;0;.00nan;0;0
234;85798;12;80;26;1;25;.962;3600000;0
234;91178;12;0;0;0;0;.00nan;0;0
235;676;34;100;29;0;29;1.000;3600000;0
235;1669;32;0;0;0;0;.00nan;0;0
235;58830;32;69;31;3;28;.903;3600000;0
235;78806;34;0;0;0;0;.00nan;0;0
236;556;3;66;32;3;29;.906;4160000;0
236;173727;18;100;48;2;46;.958;4160000;0
236;179344;3;0;0;0;0;.00nan;0;0
236;43757;18;0;0;0;0;.00nan;0;0
237;166591;20;0;0;0;0;.00nan;0;0
237;175084;22;0;0;0;0;.00nan;0;0
237;86697;20;38;46;8;38;.826;3600000;0
237;143473;22;70;19;1;18;.947;3600000;0
238;2059;23;54;14;2;12;.857;3600000;0
238;9235;4838;0;0;0;0;.00nan;0;0
238;14266;23;0;0;0;0;.00nan;0;0
238;143749;4838;90;46;4;42;.913;3553000;0
239;13714;8;77;23;1;22;.957;3600000;0
239;18213;8;0;0;0;0;.00nan;0;0
239;169868;4182;65;33;3;30;.909;3530000;0
239;147945;4182;0;0;0;0;.00nan;0;0
240;165582;24;72;36;3;33;.917;3600000;0
240;166381;27;43;27;4;23;.852;3569000;0
240;168872;24;0;0;0;0;.00nan;0;0
240;175660;27;0;0;0;0;.00nan;0;0
241;178413;17;0;0;0;0;.00nan;0;0
241;46492;0;0;0;0;0;.00nan;0;0
241;146862;17;77;42;4;38;.905;3600000;0
241;149455;0;85;34;2;32;.941;3600000;0
242;65762;35;0;0;0;0;.00nan;0;0
242;86192;21;82;27;1;26;.963;3600000;0
242;141998;35;84;35;2;33;.943;3544000;0
242;143156;21;0;0;0;0;.00nan;0;0
243;8424;28;0;0;0;0;.00nan;0;0
243;17043;30;85;14;0;14;1.000;3600000;0
243;36755;30;0;0;0;0;.00nan;0;0
243;152835;28;91;48;4;44;.917;3600000;0
244;676;34;47;38;7;31;.816;2534000;0
244;69536;10;73;39;4;35;.897;3600000;0
244;78806;34;30;9;3;6;.667;1066000;0
244;152717;10;0;0;0;0;.00nan;0;0
245;166751;5;0;0;0;0;.00nan;0;0
245;174718;25;46;15;3;12;.800;3600000;0
245;176995;5;100;28;0;28;1.000;3600000;0
245;148958;25;0;0;0;0;.00nan;0;0
246;65;11;42;37;6;31;.838;3600000;0
246;67;11;0;0;0;0;.00nan;0;0
246;166381;27;0;0;0;0;.00nan;0;0
246;175660;27;50;17;3;14;.824;3600000;0
247;2059;23;0;0;0;0;.00nan;0;0
247;165582;24;0;0;0;0;.00nan;0;0
247;14266;23;78;29;2;27;.931;3600000;0
247;168872;24;55;30;3;27;.900;3600000;0
248;556;3;100;46;2;44;.957;3600000;0
248;163565;19;0;0;0;0;.00nan;0;0
248;14305;19;57;34;4;30;.882;3581000;0
248;179344;3;0;0;0;0;.00nan;0;0
249;173727;18;0;0;0;0;.00nan;0;0
249;43757;18;56;50;6;44;.880;3600000;0
249;85798;12;0;0;0;0;.00nan;0;0
249;91178;12;100;17;0;17;1.000;3600000;0
250;171838;31;28;30;6;24;.800;2774000;0
250;178413;17;68;32;3;29;.906;3600000;0
250;86360;31;52;2;0;2;1.000;826000;0
250;146862;17;0;0;0;0;.00nan;0;0
251;1669;32;50;20;3;17;.850;3600000;0
251;163695;9;0;0;0;0;.00nan;0;0
251;175092;9;100;27;0;27;1.000;3600000;0
251;58830;32;0;0;0;0;.00nan;0;0
252;556;3;26;19;5;14;.737;2318000;0
252;169868;4182;0;0;0;0;.00nan;0;0
252;179344;3;52;9;1;8;.889;1282000;0
252;147945;4182;66;28;2;26;.929;3600000;0
253;163423;26;0;0;0;0;.00nan;0;0
253;179154;26;93;40;2;38;.950;3600000;0
253;46492;0;78;33;3;30;.909;3576000;0
253;149455;0;0;0;0;0;.00nan;0;0
254;17043;30;85;44;3;41;.932;3600000;0
254;175084;22;0;0;0;0;.00nan;0;0
254;36755;30;0;0;0;0;.00nan;0;0
254;143473;22;68;15;1;14;.933;3600000;0
255;174718;25;0;0;0;0;.00nan;0;0
255;190465;33;0;0;0;0;.00nan;0;0
255;148958;25;96;33;1;32;.970;3600000;0
255;149452;33;67;21;3;18;.857;3586000;0
256;166751;5;0;0;0;0;.00nan;0;0
256;9235;4838;0;0;0;0;.00nan;0;0
256;176995;5;57;25;3;22;.880;3600000;0
256;143749;4838;66;38;4;34;.895;3546000;0
257;8424;28;0;0;0;0;.00nan;0;0
257;183844;29;0;0;0;0;.00nan;0;0
257;37818;29;67;23;2;21;.913;3600000;0
257;152835;28;81;41;3;38;.927;3578000;0
258;166591;20;28;27;6;21;.778;2113000;0
258;69536;10;41;20;4;16;.800;3600000;0
258;86697;20;53;10;1;9;.900;1487000;0
258;152717;10;0;0;0;0;.00nan;0;0
259;65;11;44;35;6;29;.829;3007000;0
259;67;11;53;8;1;7;.875;593000;0
259;165582;24;0;0;0;0;.00nan;0;0
259;168872;24;72;23;2;21;.913;3600000;0
260;676;34;0;0;0;0;.00nan;0;0
260;176921;15;56;5;0;5;1.000;807000;0
260;78806;34;66;20;1;19;.950;3600000;0
260;85727;15;28;24;6;18;.750;2793000;0
261;1669;32;0;0;0;0;.00nan;0;0
261;58830;32;100;42;1;41;.976;4200000;0
261;65762;35;0;0;0;0;.00nan;0;0
261;141998;35;75;26;1;25;.962;4200000;0
262;168712;14;0;0;0;0;.00nan;0;0
262;175912;14;71;32;3;29;.906;3600000;0
262;86192;21;64;40;5;35;.875;3576000;0
262;143156;21;0;0;0;0;.00nan;0;0
263;166646;16;0;0;0;0;.00nan;0;0
263;13714;8;69;30;3;27;.900;3600000;0
263;18213;8;0;0;0;0;.00nan;0;0
263;50065;16;54;30;4;26;.867;3600000;0
264;2059;23;98;37;1;36;.973;3600000;0
264;14266;23;0;0;0;0;.00nan;0;0
264;166381;27;72;28;2;26;.929;3562000;0
264;175660;27;0;0;0;0;.00nan;0;0
265;163565;19;48;0;0;0;.00nan;277000;0
265;14305;19;25;33;7;26;.788;3323000;0
265;85798;12;0;0;0;0;.00nan;0;0
265;91178;12;84;25;1;24;.960;3600000;0
266;171838;31;76;31;3;28;.903;3600000;0
266;163423;26;57;36;4;32;.889;3545000;0
266;179154;26;0;0;0;0;.00nan;0;0
266;86360;31;0;0;0;0;.00nan;0;0
267;175084;22;52;27;3;24;.889;3570000;0
267;86192;21;0;0;0;0;.00nan;0;0
267;143156;21;90;36;1;35;.972;3600000;0
267;143473;22;0;0;0;0;.00nan;0;0
268;17043;30;55;24;3;21;.875;3572000;0
268;36755;30;0;0;0;0;.00nan;0;0
268;69536;10;0;0;0;0;.00nan;0;0
268;152717;10;99;50;1;49;.980;3600000;0
269;163695;9;0;0;0;0;.00nan;0;0
269;174718;25;77;23;1;22;.957;3600000;0
269;175092;9;62;28;3;25;.893;3527000;0
269;148958;25;0;0;0;0;.00nan;0;0
270;169868;4182;0;0;0;0;.00nan;0;0
270;85798;12;63;36;5;31;.861;3543000;0
270;91178;12;0;0;0;0;.00nan;0;0
270;147945;4182;73;35;4;31;.886;3600000;0
271;556;3;76;22;1;21;.955;3600000;0
271;9235;4838;0;0;0;0;.00nan;0;0
271;179344;3;0;0;0;0;.00nan;0;0
271;143749;4838;90;50;3;47;.940;3541000;0
272;166751;5;86;35;2;33;.943;3600000;0
272;183844;29;0;0;0;0;.00nan;0;0
272;176995;5;0;0;0;0;.00nan;0;0
272;37818;29;88;19;0;19;1.000;3600000;0
273;166646;16;0;0;0;0;.00nan;0;0
273;176921;15;0;0;0;0;.00nan;0;0
273;50065;16;100;26;0;26;1.000;3600000;0
273;85727;15;81;33;2;31;.939;3533000;0
274;13714;8;0;0;0;0;.00nan;0;0
274;18213;8;62;42;5;37;.881;3600000;0
274;190465;33;0;0;0;0;.00nan;0;0
274;149452;33;95;35;2;33;.943;3600000;0
275;163565;19;0;0;0;0;.00nan;0;0
275;14305;19;68;35;3;32;.914;4122000;0
275;65762;35;88;34;2;32;.941;4122000;0
275;141998;35;0;0;0;0;.00nan;0;0
276;65;11;81;36;2;34;.944;4200000;0
276;67;11;0;0;0;0;.00nan;0;0
276;2059;23;64;21;2;19;.905;4200000;0
276;14266;23;0;0;0;0;.00nan;0;0
277;166381;27;0;0;0;0;.00nan;0;0
277;173727;18;94;50;3;47;.940;3600000;0
277;175660;27;100;30;0;30;1.000;3600000;0
277;43757;18;0;0;0;0;.00nan;0;0
278;166591;20;0;0;0;0;.00nan;0;0
278;9235;4838;42;3;1;2;.667;763000;0
278;86697;20;73;29;2;27;.931;3600000;0
278;143749;4838;40;28;5;23;.821;2837000;0
279;174718;25;0;0;0;0;.00nan;0;0
279;86192;21;100;41;1;40;.976;3600000;0
279;143156;21;0;0;0;0;.00nan;0;0
279;148958;25;45;25;4;21;.840;3600000;0
280;676;34;0;0;0;0;.00nan;0;0
280;178413;17;0;0;0;0;.00nan;0;0
280;78806;34;57;39;5;34;.872;4033000;0
280;146862;17;60;30;4;26;.867;4033000;0
281;556;3;82;44;3;41;.932;3600000;0
281;183844;29;64;10;0;10;1.000;1643000;0
281;179344;3;0;0;0;0;.00nan;0;0
281;37818;29;43;36;6;30;.833;1957000;0
282;176921;15;0;0;0;0;.00nan;0;0
282;69536;10;67;30;3;27;.900;3573000;0
282;85727;15;75;18;1;17;.944;3600000;0
282;152717;10;0;0;0;0;.00nan;0;0
283;1669;32;0;0;0;0;.00nan;0;0
283;166751;5;0;0;0;0;.00nan;0;0
283;176995;5;65;34;3;31;.912;3600000;0
283;58830;32;48;26;4;22;.846;3550000;0
284;163695;9;0;0;0;0;.00nan;0;0
284;168712;14;65;24;2;22;.917;3600000;0
284;175092;9;42;36;7;29;.806;3600000;0
284;175912;14;0;0;0;0;.00nan;0;0
285;165582;24;44;40;6;34;.850;3262000;0
285;168872;24;48;0;0;0;.00nan;338000;0
285;175084;22;0;0;0;0;.00nan;0;0
285;143473;22;70;24;2;22;.917;3600000;0
286;65762;35;74;43;4;39;.907;4200000;0
286;85798;12;0;0;0;0;.00nan;0;0
286;91178;12;61;36;4;32;.889;4200000;0
286;141998;35;0;0;0;0;.00nan;0;0
287;65;11;78;29;2;27;.931;4009000;0
287;67;11;0;0;0;0;.00nan;0;0
287;190465;33;73;38;3;35;.921;3966000;0
287;149452;33;0;0;0;0;.00nan;0;0
288;166646;16;0;0;0;0;.00nan;0;0
288;17043;30;100;26;0;26;1.000;3600000;0
288;36755;30;0;0;0;0;.00nan;0;0
288;50065;16;89;37;1;36;.973;3582000;0
289;8424;28;0;0;0;0;.00nan;0;0
289;169868;4182;0;0;0;0;.00nan;0;0
289;147945;4182;61;34;4;30;.882;3600000;0
289;152835;28;100;42;1;41;.976;3600000;0
290;13714;8;0;0;0;0;.00nan;0;0
290;166381;27;0;0;0;0;.00nan;0;0
290;18213;8;61;32;4;28;.875;3600000;0
290;175660;27;100;38;0;38;1.000;3600000;0
291;2059;23;85;15;0;15;1.000;3600000;0
291;14266;23;0;0;0;0;.00nan;0;0
291;173727;18;97;55;1;54;.982;3600000;0
291;43757;18;0;0;0;0;.00nan;0;0
292;183844;29;56;29;4;25;.862;3600000;0
292;178413;17;54;22;2;20;.909;2449000;0
292;37818;29;0;0;0;0;.00nan;0;0
292;146862;17;27;17;5;12;.706;1151000;0
293;175084;22;0;0;0;0;.00nan;0;0
293;176921;15;0;0;0;0;.00nan;0;0
293;85727;15;61;37;4;33;.892;3600000;0
293;143473;22;54;10;1;9;.900;3600000;0
294;171838;31;83;26;1;25;.962;3600000;0
294;174718;25;50;25;3;22;.880;3529000;0
294;86360;31;0;0;0;0;.00nan;0;0
294;148958;25;0;0;0;0;.00nan;0;0
295;676;34;77;26;2;24;.923;3600000;0
295;78806;34;0;0;0;0;.00nan;0;0
295;86192;21;58;34;4;30;.882;3576000;0
295;143156;21;0;0;0;0;.00nan;0;0
296;190465;33;0;0;0;0;.00nan;0;0
296;85798;12;0;0;0;0;.00nan;0;0
296;91178;12;90;28;1;27;.964;3600000;0
296;149452;33;60;27;3;24;.889;3530000;0
297;9235;4838;0;0;0;0;.00nan;0;0
297;168712;14;0;0;0;0;.00nan;0;0
297;175912;14;63;17;1;16;.941;3600000;0
297;143749;4838;34;33;6;27;.818;3600000;0
298;163565;19;0;0;0;0;.00nan;0;0
298;14305;19;79;24;1;23;.958;3600000;0
298;169868;4182;0;0;0;0;.00nan;0;0
298;147945;4182;59;32;5;27;.844;3600000;0
299;8424;28;0;0;0;0;.00nan;0;0
299;173727;18;65;25;3;22;.880;3600000;0
299;43757;18;0;0;0;0;.00nan;0;0
299;152835;28;79;48;4;44;.917;3550000;0
300;163695;9;0;0;0;0;.00nan;0;0
300;175092;9;69;29;3;26;.897;3956000;0
300;69536;10;0;0;0;0;.00nan;0;0
300;152717;10;67;25;2;23;.920;3956000;0
301;165582;24;0;0;0;0;.00nan;0;0
301;168872;24;64;26;2;24;.923;3543000;0
301;46492;0;98;37;1;36;.973;3600000;0
301;149455;0;0;0;0;0;.00nan;0;0
302;166591;20;82;34;2;32;.941;3600000;0
302;166751;5;65;29;3;26;.897;2654000;0
302;176995;5;22;12;4;8;.667;946000;0
302;86697;20;0;0;0;0;.00nan;0;0
303;556;3;67;21;2;19;.905;3600000;0
303;1669;32;0;0;0;0;.00nan;0;0
303;179344;3;0;0;0;0;.00nan;0;0
303;58830;32;92;49;3;46;.939;3600000;0
304;65;11;71;44;4;40;.909;3600000;0
304;67;11;0;0;0;0;.00nan;0;0
304;166646;16;0;0;0;0;.00nan;0;0
304;50065;16;56;17;2;15;.882;3600000;0
305;163423;26;0;0;0;0;.00nan;0;0
305;13714;8;0;0;0;0;.00nan;0;0
305;18213;8;46;27;4;23;.852;3592000;0
305;179154;26;100;41;2;39;.951;3600000;0
306;2059;23;84;43;3;40;.930;3600000;0
306;14266;23;0;0;0;0;.00nan;0;0
306;166381;27;0;0;0;0;.00nan;0;0
306;175660;27;72;30;2;28;.933;3600000;0
307;183844;29;0;0;0;0;.00nan;0;0
307;176921;15;50;36;5;31;.861;3600000;0
307;37818;29;100;20;0;20;1.000;3600000;0
307;85727;15;0;0;0;0;.00nan;0;0
308;163565;19;77;24;1;23;.958;3600000;0
308;8424;28;80;37;3;34;.919;3600000;0
308;14305;19;0;0;0;0;.00nan;0;0
308;152835;28;0;0;0;0;.00nan;0;0
309;676;34;0;0;0;0;.00nan;0;0
309;163695;9;69;26;2;24;.923;3600000;0
309;175092;9;0;0;0;0;.00nan;0;0
309;78806;34;58;22;3;19;.864;3517000;0
310;171838;31;0;0;0;0;.00nan;0;0
310;69536;10;48;20;3;17;.850;3600000;0
310;86360;31;52;53;7;46;.868;3600000;0
310;152717;10;0;0;0;0;.00nan;0;0
311;165582;24;78;34;3;31;.912;3600000;0
311;168872;24;0;0;0;0;.00nan;0;0
311;175084;22;26;26;6;20;.769;3600000;0
311;143473;22;0;0;0;0;.00nan;0;0
312;65;11;0;0;0;0;.00nan;0;0
312;67;11;84;47;4;43;.915;3600000;0
312;13714;8;73;20;1;19;.950;3600000;0
312;18213;8;0;0;0;0;.00nan;0;0
313;166381;27;72;30;3;27;.900;3600000;0
313;173727;18;43;5;1;4;.800;865000;0
313;175660;27;0;0;0;0;.00nan;0;0
313;43757;18;49;41;6;35;.854;2735000;0
314;17043;30;55;37;5;32;.865;3574000;0
314;36755;30;0;0;0;0;.00nan;0;0
314;65762;35;69;33;4;29;.879;3600000;0
314;141998;35;0;0;0;0;.00nan;0;0
315;163423;26;0;0;0;0;.00nan;0;0
315;178413;17;0;0;0;0;.00nan;0;0
315;179154;26;59;30;3;27;.900;3580000;0
315;146862;17;87;41;2;39;.951;3600000;0
316;174718;25;0;0;0;0;.00nan;0;0
316;85798;12;0;0;0;0;.00nan;0;0
316;91178;12;66;31;3;28;.903;3543000;0
316;148958;25;54;17;2;15;.882;3600000;0
317;166591;20;0;0;0;0;.00nan;0;0
317;86192;21;73;18;1;17;.944;3600000;0
317;86697;20;65;45;5;40;.889;3600000;0
317;143156;21;0;0;0;0;.00nan;0;0
318;1669;32;0;0;0;0;.00nan;0;0
318;190465;33;0;0;0;0;.00nan;0;0
318;58830;32;75;42;4;38;.905;3600000;0
318;149452;33;73;19;1;18;.947;3600000;0
319;9235;4838;84;24;1;23;.958;3600000;0
319;169868;4182;0;0;0;0;.00nan;0;0
319;143749;4838;0;0;0;0;.00nan;0;0
319;147945;4182;59;33;3;30;.909;3539000;0
320;183844;29;0;0;0;0;.00nan;0;0
320;37818;29;83;26;1;25;.962;3600000;0
320;86192;21;0;0;0;0;.00nan;0;0
320;143156;21;53;26;4;22;.846;3600000;0
321;163695;9;0;0;0;0;.00nan;0;0
321;175092;9;95;40;2;38;.950;3600000;0
321;176921;15;41;18;4;14;.778;2094000;0
321;85727;15;69;12;0;12;1.000;1465000;0
322;556;3;89;42;1;41;.976;4200000;0
322;179344;3;0;0;0;0;.00nan;0;0
322;46492;0;68;20;1;19;.950;4200000;0
322;149455;0;0;0;0;0;.00nan;0;0
323;166751;5;69;11;0;11;1.000;634000;0
323;13714;8;0;0;0;0;.00nan;0;0
323;18213;8;62;17;2;15;.882;3600000;0
323;176995;5;45;39;6;33;.846;2966000;0
324;65;11;31;26;6;20;.769;2658000;0
324;67;11;43;12;2;10;.833;942000;0
324;17043;30;67;29;3;26;.897;3600000;0
324;36755;30;0;0;0;0;.00nan;0;0
325;168712;14;78;30;2;28;.933;4200000;0
325;173727;18;89;39;2;37;.949;4200000;0
325;175912;14;0;0;0;0;.00nan;0;0
325;43757;18;0;0;0;0;.00nan;0;0
326;676;34;84;34;2;32;.941;3542000;0
326;165582;24;100;38;0;38;1.000;3600000;0
326;168872;24;0;0;0;0;.00nan;0;0
326;78806;34;0;0;0;0;.00nan;0;0
327;166591;20;58;11;1;10;.909;741000;0
327;175084;22;0;0;0;0;.00nan;0;0
327;86697;20;62;43;7;36;.837;2859000;0
327;143473;22;80;21;1;20;.952;3600000;0
328;556;3;88;26;1;25;.962;3600000;0
328;171838;31;67;31;3;28;.903;3514000;0
328;179344;3;0;0;0;0;.00nan;0;0
328;86360;31;0;0;0;0;.00nan;0;0
329;163423;26;0;0;0;0;.00nan;0;0
329;179154;26;100;50;2;48;.960;3600000;0
329;85798;12;0;0;0;0;.00nan;0;0
329;91178;12;43;18;3;15;.833;3544000;0
330;190465;33;0;0;0;0;.00nan;0;0
330;69536;10;0;0;0;0;.00nan;0;0
330;149452;33;70;18;1;17;.944;3600000;0
330;152717;10;78;40;3;37;.925;3523000;0
331;166646;16;0;0;0;0;.00nan;0;0
331;1669;32;0;0;0;0;.00nan;0;0
331;50065;16;76;34;3;31;.912;4091000;0
331;58830;32;88;38;2;36;.947;4091000;0
332;2059;23;70;26;3;23;.885;3600000;0
332;14266;23;0;0;0;0;.00nan;0;0
332;174718;25;54;39;5;34;.872;3565000;0
332;148958;25;0;0;0;0;.00nan;0;0
333;166751;5;80;28;1;27;.964;3600000;0
333;176995;5;0;0;0;0;.00nan;0;0
333;65762;35;70;28;3;25;.893;3583000;0
333;141998;35;0;0;0;0;.00nan;0;0
334;9235;4838;0;0;0;0;.00nan;0;0
334;17043;30;56;20;3;17;.850;3606000;0
334;36755;30;0;0;0;0;.00nan;0;0
334;143749;4838;92;36;2;34;.944;3606000;0
335;166381;27;0;0;0;0;.00nan;0;0
335;169868;4182;0;0;0;0;.00nan;0;0
335;175660;27;38;27;5;22;.815;3522000;0
335;147945;4182;69;31;3;28;.903;3600000;0
336;8424;28;0;0;0;0;.00nan;0;0
336;86192;21;67;22;1;21;.955;3600000;0
336;143156;21;0;0;0;0;.00nan;0;0
336;152835;28;88;50;5;45;.900;3600000;0
337;178413;17;0;0;0;0;.00nan;0;0
337;176921;15;0;0;0;0;.00nan;0;0
337;85727;15;74;37;3;34;.919;4200000;0
337;146862;17;67;39;3;36;.923;4200000;0
338;163565;19;0;0;0;0;.00nan;0;0
338;14305;19;99;40;1;39;.975;3600000;0
338;168712;14;0;0;0;0;.00nan;0;0
338;175912;14;72;27;2;25;.926;3546000;0
339;183844;29;0;0;0;0;.00nan;0;0
339;173727;18;88;44;3;41;.932;3600000;0
339;37818;29;90;18;0;18;1.000;3600000;0
339;43757;18;0;0;0;0;.00nan;0;0
340;166591;20;45;39;5;34;.872;4200000;0
340;165582;24;65;36;5;31;.861;4200000;0
340;168872;24;0;0;0;0;.00nan;0;0
340;86697;20;0;0;0;0;.00nan;0;0
341;178413;17;73;42;3;39;.929;3600000;0
341;174718;25;0;0;0;0;.00nan;0;0
341;146862;17;0;0;0;0;.00nan;0;0
341;148958;25;94;22;0;22;1.000;3600000;0
342;556;3;63;34;4;30;.882;3557000;0
342;8424;28;90;43;3;40;.930;3600000;0
342;179344;3;0;0;0;0;.00nan;0;0
342;152835;28;0;0;0;0;.00nan;0;0
343;676;34;99;34;1;33;.971;3600000;0
343;175084;22;0;0;0;0;.00nan;0;0
343;78806;34;0;0;0;0;.00nan;0;0
343;143473;22;62;22;2;20;.909;3567000;0
344;166751;5;76;29;2;27;.931;3600000;0
344;176995;5;0;0;0;0;.00nan;0;0
344;69536;10;0;0;0;0;.00nan;0;0
344;152717;10;74;37;3;34;.919;3592000;0
345;171838;31;99;40;2;38;.950;3600000;0
345;2059;23;54;22;3;19;.864;3579000;0
345;14266;23;0;0;0;0;.00nan;0;0
345;86360;31;0;0;0;0;.00nan;0;0
346;163423;26;0;0;0;0;.00nan;0;0
346;179154;26;59;24;3;21;.875;3549000;0
346;190465;33;0;0;0;0;.00nan;0;0
346;149452;33;75;29;2;27;.931;3600000;0
347;163695;9;100;50;2;48;.960;3600000;0
347;175092;9;0;0;0;0;.00nan;0;0
347;85798;12;40;21;4;17;.810;3592000;0
347;91178;12;0;0;0;0;.00nan;0;0
348;1669;32;0;0;0;0;.00nan;0;0
348;9235;4838;0;0;0;0;.00nan;0;0
348;58830;32;77;24;1;23;.958;3600000;0
348;143749;4838;84;36;2;34;.944;3576000;0
349;13714;8;0;0;0;0;.00nan;0;0
349;18213;8;68;35;5;30;.857;3514000;0
349;65762;35;65;29;3;26;.897;3600000;0
349;141998;35;0;0;0;0;.00nan;0;0
350;65;11;81;55;5;50;.909;3600000;0
350;67;11;0;0;0;0;.00nan;0;0
350;166646;16;0;0;0;0;.00nan;0;0
350;50065;16;90;20;0;20;1.000;3600000;0
351;168712;14;100;29;0;29;1.000;3609000;0
351;169868;4182;0;0;0;0;.00nan;0;0
351;175912;14;0;0;0;0;.00nan;0;0
351;147945;4182;94;31;1;30;.968;3609000;0
352;166381;27;0;0;0;0;.00nan;0;0
352;17043;30;72;38;5;33;.868;3600000;0
352;175660;27;52;28;4;24;.857;3600000;0
352;36755;30;0;0;0;0;.00nan;0;0
353;46492;0;63;36;3;33;.917;4200000;0
353;86192;21;99;43;3;40;.930;4200000;0
353;143156;21;0;0;0;0;.00nan;0;0
353;149455;0;0;0;0;0;.00nan;0;0
354;676;34;0;0;0;0;.00nan;0;0
354;173727;18;0;0;0;0;.00nan;0;0
354;43757;18;90;53;4;49;.925;3600000;0
354;78806;34;42;14;3;11;.786;3600000;0
355;166646;16;52;32;4;28;.875;3546000;0
355;166751;5;77;33;3;30;.909;3600000;0
355;176995;5;0;0;0;0;.00nan;0;0
355;50065;16;0;0;0;0;.00nan;0;0
356;1669;32;0;0;0;0;.00nan;0;0
356;170314;25;0;0;0;0;.00nan;0;0
356;58830;32;91;32;2;30;.938;4200000;0
356;148958;25;77;35;2;33;.943;4200000;0
357;13337;15;0;0;0;0;.00nan;0;0
357;190465;33;0;0;0;0;.00nan;0;0
357;85727;15;73;36;4;32;.889;3600000;0
357;149452;33;99;26;0;26;1.000;3600000;0
358;556;3;66;34;4;30;.882;3600000;0
358;165582;24;28;9;3;6;.667;555000;0
358;168872;24;40;31;5;26;.839;3045000;0
358;179344;3;0;0;0;0;.00nan;0;0
359;166591;20;0;0;0;0;.00nan;0;0
359;163695;9;63;30;3;27;.900;3600000;0
359;175092;9;0;0;0;0;.00nan;0;0
359;86697;20;67;33;4;29;.879;3571000;0
360;8424;28;0;0;0;0;.00nan;0;0
360;178413;17;0;0;0;0;.00nan;0;0
360;146862;17;79;31;2;29;.935;3600000;0
360;152835;28;41;25;4;21;.840;3588000;0
361;2059;23;57;33;4;29;.879;3600000;0
361;14266;23;0;0;0;0;.00nan;0;0
361;46492;0;0;0;0;0;.00nan;0;0
361;149455;0;90;25;0;25;1.000;3600000;0
362;175084;22;0;0;0;0;.00nan;0;0
362;69536;10;97;49;1;48;.980;3600000;0
362;143473;22;73;8;0;8;1.000;3600000;0
362;152717;10;0;0;0;0;.00nan;0;0
363;171838;31;0;0;0;0;.00nan;0;0
363;183844;29;0;0;0;0;.00nan;0;0
363;37818;29;54;14;2;12;.857;3600000;0
363;86360;31;75;33;3;30;.909;3573000;0
364;65762;35;0;0;0;0;.00nan;0;0
364;85798;12;83;20;1;19;.950;3600000;0
364;91178;12;0;0;0;0;.00nan;0;0
364;141998;35;40;29;5;24;.828;3600000;0
365;13714;8;0;0;0;0;.00nan;0;0
365;18213;8;100;30;0;30;1.000;3600000;0
365;169868;4182;0;0;0;0;.00nan;0;0
365;147945;4182;58;17;2;15;.882;3516000;0
366;65;11;82;51;4;47;.922;4200000;0
366;67;11;0;0;0;0;.00nan;0;0
366;166381;27;0;0;0;0;.00nan;0;0
366;175660;27;64;33;4;29;.879;4200000;0
367;17043;30;0;0;0;0;.00nan;0;0
367;168712;14;71;41;4;37;.902;3600000;0
367;175912;14;0;0;0;0;.00nan;0;0
367;36755;30;77;24;1;23;.958;3600000;0
368;163423;26;0;0;0;0;.00nan;0;0
368;170314;25;97;32;1;31;.969;3600000;0
368;179154;26;68;26;2;24;.923;3551000;0
368;148958;25;0;0;0;0;.00nan;0;0
369;13337;15;72;25;2;23;.920;3600000;0
369;173727;18;34;29;6;23;.793;3000000;0
369;43757;18;58;10;0;10;1.000;600000;0
369;85727;15;0;0;0;0;.00nan;0;0
370;183844;29;100;43;2;41;.953;3600000;0
370;37818;29;0;0;0;0;.00nan;0;0
370;86192;21;68;37;4;33;.892;3544000;0
370;143156;21;0;0;0;0;.00nan;0;0
371;163695;9;0;0;0;0;.00nan;0;0
371;175092;9;52;30;4;26;.867;3600000;0
371;190465;33;60;7;0;7;1.000;570000;0
371;149452;33;48;37;6;31;.838;2944000;0
372;163565;19;0;0;0;0;.00nan;0;0
372;13714;8;0;0;0;0;.00nan;0;0
372;14305;19;86;28;2;26;.929;3703000;0
372;18213;8;81;27;1;26;.963;3703000;0
373;175084;22;37;17;3;14;.824;3563000;0
373;69536;10;0;0;0;0;.00nan;0;0
373;143473;22;0;0;0;0;.00nan;0;0
373;152717;10;99;53;2;51;.962;3600000;0
374;166646;16;0;0;0;0;.00nan;0;0
374;166751;5;55;37;4;33;.892;3600000;0
374;176995;5;0;0;0;0;.00nan;0;0
374;50065;16;71;21;1;20;.952;3600000;0
375;2059;23;53;34;5;29;.853;3515000;0
375;8424;28;0;0;0;0;.00nan;0;0
375;14266;23;0;0;0;0;.00nan;0;0
375;152835;28;75;35;3;32;.914;3600000;0
376;166591;20;0;0;0;0;.00nan;0;0
376;1669;32;0;0;0;0;.00nan;0;0
376;58830;32;86;47;3;44;.936;3939000;0
376;86697;20;90;38;2;36;.947;3921000;0
377;168712;14;49;33;5;28;.848;3600000;0
377;175912;14;0;0;0;0;.00nan;0;0
377;65762;35;89;36;2;34;.944;3600000;0
377;141998;35;0;0;0;0;.00nan;0;0
378;17043;30;84;28;2;26;.929;3600000;0
378;36755;30;0;0;0;0;.00nan;0;0
378;85798;12;0;0;0;0;.00nan;0;0
378;91178;12;77;21;1;20;.952;3600000;0
379;163695;9;0;0;0;0;.00nan;0;0
379;178413;17;0;0;0;0;.00nan;0;0
379;175092;9;70;32;3;29;.906;3600000;0
379;146862;17;38;36;6;30;.833;3600000;0
380;163565;19;43;4;1;3;.750;876000;0
380;14305;19;8;19;7;12;.632;2724000;0
380;86192;21;97;37;1;36;.973;3600000;0
380;143156;21;0;0;0;0;.00nan;0;0
381;13337;15;0;0;0;0;.00nan;0;0
381;46492;0;0;0;0;0;.00nan;0;0
381;85727;15;73;31;2;29;.935;3948000;0
381;149455;0;83;27;1;26;.963;3948000;0
382;165582;24;0;0;0;0;.00nan;0;0
382;168872;24;92;28;1;27;.964;3600000;0
382;173727;18;84;45;4;41;.911;3600000;0
382;43757;18;0;0;0;0;.00nan;0;0
383;170314;25;79;34;2;32;.941;3600000;0
383;190465;33;0;0;0;0;.00nan;0;0
383;148958;25;0;0;0;0;.00nan;0;0
383;149452;33;100;23;0;23;1.000;3600000;0
384;65;11;25;5;3;2;.400;579000;0
384;67;11;64;33;3;30;.909;3021000;0
384;163423;26;0;0;0;0;.00nan;0;0
384;179154;26;73;33;3;30;.909;3600000;0
385;13714;8;86;39;2;37;.949;3644000;0
385;18213;8;0;0;0;0;.00nan;0;0
385;169868;4182;0;0;0;0;.00nan;0;0
385;147945;4182;71;30;3;27;.900;3644000;0
386;676;34;74;38;4;34;.895;3655000;0
386;166381;27;0;0;0;0;.00nan;0;0
386;175660;27;67;28;3;25;.893;3655000;0
386;78806;34;0;0;0;0;.00nan;0;0
387;556;3;69;34;3;31;.912;3566000;0
387;166646;16;0;0;0;0;.00nan;0;0
387;179344;3;0;0;0;0;.00nan;0;0
387;50065;16;96;32;1;31;.969;3600000;0
388;166751;5;0;0;0;0;.00nan;0;0
388;176995;5;78;44;3;41;.932;3555000;0
388;69536;10;0;0;0;0;.00nan;0;0
388;152717;10;62;22;2;20;.909;3600000;0
389;17043;30;64;22;2;20;.909;4200000;0
389;36755;30;0;0;0;0;.00nan;0;0
389;85798;12;0;0;0;0;.00nan;0;0
389;91178;12;86;37;2;35;.946;4200000;0
390;166591;20;0;0;0;0;.00nan;0;0
390;9235;4838;0;0;0;0;.00nan;0;0
390;86697;20;63;24;2;22;.917;3600000;0
390;143749;4838;71;37;5;32;.865;3600000;0
391;163695;9;0;0;0;0;.00nan;0;0
391;183844;29;0;0;0;0;.00nan;0;0
391;175092;9;64;38;5;33;.868;3515000;0
391;37818;29;48;16;3;13;.813;3600000;0
392;178413;17;18;8;4;4;.500;1043000;0
392;173727;18;59;32;4;28;.875;3600000;0
392;43757;18;0;0;0;0;.00nan;0;0
392;146862;17;51;18;2;16;.889;2500000;0
393;163565;19;0;0;0;0;.00nan;0;0
393;8424;28;0;0;0;0;.00nan;0;0
393;14305;19;70;29;2;27;.931;3629000;0
393;152835;28;98;41;1;40;.976;3629000;0
394;171838;31;88;40;4;36;.900;3624000;0
394;46492;0;64;39;5;34;.872;3624000;0
394;86360;31;0;0;0;0;.00nan;0;0
394;149455;0;0;0;0;0;.00nan;0;0
395;166646;16;56;28;4;24;.857;4145000;0
395;168712;14;0;0;0;0;.00nan;0;0
395;175912;14;65;27;3;24;.889;4145000;0
395;50065;16;0;0;0;0;.00nan;0;0
396;165582;24;99;39;2;37;.949;3600000;0
396;168872;24;0;0;0;0;.00nan;0;0
396;86192;21;38;21;4;17;.810;3551000;0
396;143156;21;0;0;0;0;.00nan;0;0
397;166751;5;45;25;4;21;.840;3556000;0
397;176995;5;0;0;0;0;.00nan;0;0
397;190465;33;0;0;0;0;.00nan;0;0
397;149452;33;72;24;3;21;.875;3600000;0
398;169868;4182;0;0;0;0;.00nan;0;0
398;170314;25;87;30;2;28;.933;3600000;0
398;147945;4182;78;36;3;33;.917;3560000;0
398;148958;25;0;0;0;0;.00nan;0;0
399;175084;22;0;0;0;0;.00nan;0;0
399;65762;35;36;46;7;39;.848;3260000;0
399;141998;35;35;5;2;3;.600;340000;0
399;143473;22;91;23;0;23;1.000;3600000;0
400;65;11;63;26;3;23;.885;3570000;0
400;67;11;0;0;0;0;.00nan;0;0
400;166591;20;74;30;2;28;.933;3600000;0
400;86697;20;0;0;0;0;.00nan;0;0
401;1669;32;0;0;0;0;.00nan;0;0
401;13714;8;98;30;1;29;.967;3600000;0
401;18213;8;0;0;0;0;.00nan;0;0
401;58830;32;100;30;0;30;1.000;3600000;0
402;676;34;61;26;3;23;.885;3600000;0
402;2059;23;73;42;4;38;.905;3579000;0
402;14266;23;0;0;0;0;.00nan;0;0
402;78806;34;0;0;0;0;.00nan;0;0
403;163423;26;0;0;0;0;.00nan;0;0
403;166381;27;51;20;3;17;.850;3600000;0
403;179154;26;77;44;5;39;.886;3538000;0
403;175660;27;0;0;0;0;.00nan;0;0
404;85798;12;0;0;0;0;.00nan;0;0
404;86192;21;0;0;0;0;.00nan;0;0
404;91178;12;86;35;3;32;.914;4096000;0
404;143156;21;86;44;2;42;.955;4096000;0
405;556;3;53;30;4;26;.867;3574000;0
405;179344;3;0;0;0;0;.00nan;0;0
405;69536;10;0;0;0;0;.00nan;0;0
405;152717;10;86;30;2;28;.933;3600000;0
406;163423;26;0;0;0;0;.00nan;0;0
406;9235;4838;52;33;6;27;.818;3063000;0
406;179154;26;39;22;4;18;.818;3600000;0
406;143749;4838;63;9;0;9;1.000;491000;0
407;183844;29;0;0;0;0;.00nan;0;0
407;37818;29;91;17;0;17;1.000;3600000;0
407;65762;35;0;0;0;0;.00nan;0;0
407;141998;35;97;40;2;38;.950;3565000;0
408;65;11;79;23;1;22;.957;3600000;0
408;67;11;0;0;0;0;.00nan;0;0
408;676;34;69;26;2;24;.923;3521000;0
408;78806;34;0;0;0;0;.00nan;0;0
409;166646;16;0;0;0;0;.00nan;0;0
409;17043;30;90;32;1;31;.969;3600000;0
409;36755;30;0;0;0;0;.00nan;0;0
409;50065;16;88;37;3;34;.919;3538000;0
410;163695;9;38;27;5;22;.815;4114000;0
410;8424;28;0;0;0;0;.00nan;0;0
410;175092;9;0;0;0;0;.00nan;0;0
410;152835;28;40;31;6;25;.806;4114000;0
411;178413;17;0;0;0;0;.00nan;0;0
411;46492;0;75;29;2;27;.931;3600000;0
411;146862;17;73;20;1;19;.950;3600000;0
411;149455;0;0;0;0;0;.00nan;0;0
412;171838;31;47;36;6;30;.833;3600000;0
412;190465;33;0;0;0;0;.00nan;0;0
412;86360;31;0;0;0;0;.00nan;0;0
412;149452;33;61;19;2;17;.895;3600000;0
413;13337;15;47;34;5;29;.853;3578000;0
413;168712;14;0;0;0;0;.00nan;0;0
413;175912;14;45;23;4;19;.826;3600000;0
413;85727;15;0;0;0;0;.00nan;0;0
414;163565;19;49;14;2;12;.857;1169000;0
414;165582;24;63;23;2;21;.913;3600000;0
414;14305;19;11;19;6;13;.684;2431000;0
414;168872;24;0;0;0;0;.00nan;0;0
415;170314;25;90;29;1;28;.966;3600000;0
415;85798;12;74;39;4;35;.897;3600000;0
415;91178;12;0;0;0;0;.00nan;0;0
415;148958;25;0;0;0;0;.00nan;0;0
416;13714;8;47;7;1;6;.857;763000;0
416;18213;8;48;40;6;34;.850;2837000;0
416;175084;22;0;0;0;0;.00nan;0;0
416;143473;22;100;29;0;29;1.000;3600000;0
417;166751;5;65;28;3;25;.893;3581000;0
417;2059;23;0;0;0;0;.00nan;0;0
417;14266;23;58;17;2;15;.882;3600000;0
417;176995;5;0;0;0;0;.00nan;0;0
418;166591;20;0;0;0;0;.00nan;0;0
418;166381;27;0;0;0;0;.00nan;0;0
418;175660;27;45;29;4;25;.862;3600000;0
418;86697;20;56;44;5;39;.886;3549000;0
419;556;3;78;49;4;45;.918;3550000;0
419;179344;3;0;0;0;0;.00nan;0;0
419;86192;21;64;28;3;25;.893;3600000;0
419;143156;21;0;0;0;0;.00nan;0;0
420;676;34;0;0;0;0;.00nan;0;0
420;9235;4838;0;0;0;0;.00nan;0;0
420;78806;34;78;32;3;29;.906;3600000;0
420;143749;4838;61;32;4;28;.875;3578000;0
421;168712;14;71;43;5;38;.884;3600000;0
421;170314;25;94;23;0;23;1.000;3600000;0
421;175912;14;0;0;0;0;.00nan;0;0
421;148958;25;0;0;0;0;.00nan;0;0
422;8424;28;58;33;4;29;.879;3600000;0
422;190465;33;0;0;0;0;.00nan;0;0
422;149452;33;65;28;3;25;.893;3600000;0
422;152835;28;0;0;0;0;.00nan;0;0
423;163565;19;62;21;2;19;.905;3600000;0
423;13337;15;0;0;0;0;.00nan;0;0
423;14305;19;0;0;0;0;.00nan;0;0
423;85727;15;68;28;3;25;.893;3532000;0
424;1669;32;0;0;0;0;.00nan;0;0
424;169868;4182;36;18;4;14;.778;2196000;0
424;58830;32;81;34;3;31;.912;3600000;0
424;147945;4182;61;13;1;12;.923;1400000;0
425;2059;23;65;21;2;19;.905;3600000;0
425;163423;26;0;0;0;0;.00nan;0;0
425;14266;23;0;0;0;0;.00nan;0;0
425;179154;26;85;38;3;35;.921;3556000;0
426;17043;30;0;0;0;0;.00nan;0;0
426;173727;18;60;48;6;42;.875;3600000;0
426;36755;30;100;34;0;34;1.000;3600000;0
426;43757;18;0;0;0;0;.00nan;0;0
427;163695;9;0;0;0;0;.00nan;0;0
427;175092;9;99;36;1;35;.972;3600000;0
427;65762;35;53;3;0;3;1.000;678000;0
427;141998;35;32;29;6;23;.793;2922000;0
428;171838;31;0;0;0;0;.00nan;0;0
428;165582;24;52;24;3;21;.875;3577000;0
428;168872;24;0;0;0;0;.00nan;0;0
428;86360;31;92;31;1;30;.968;3600000;0
429;166646;16;0;0;0;0;.00nan;0;0
429;178413;17;0;0;0;0;.00nan;0;0
429;50065;16;84;47;3;44;.936;4200000;0
429;146862;17;83;36;3;33;.917;4200000;0
430;65;11;78;34;2;32;.941;3600000;0
430;67;11;0;0;0;0;.00nan;0;0
430;13714;8;0;0;0;0;.00nan;0;0
430;18213;8;70;30;3;27;.900;3550000;0
431;171838;31;55;32;4;28;.875;3879000;0
431;13337;15;67;26;3;23;.885;3879000;0
431;85727;15;0;0;0;0;.00nan;0;0
431;86360;31;0;0;0;0;.00nan;0;0
432;166591;20;0;0;0;0;.00nan;0;0
432;46492;0;96;20;0;20;1.000;3600000;0
432;86697;20;61;39;4;35;.897;3600000;0
432;149455;0;0;0;0;0;.00nan;0;0
433;65762;35;81;24;1;23;.958;3600000;0
433;69536;10;79;38;3;35;.921;3600000;0
433;141998;35;0;0;0;0;.00nan;0;0
433;152717;10;0;0;0;0;.00nan;0;0
434;175084;22;0;0;0;0;.00nan;0;0
434;190465;33;42;18;3;15;.833;1445000;0
434;143473;22;100;23;0;23;1.000;3600000;0
434;149452;33;56;41;6;35;.854;2155000;0
435;178413;17;97;34;1;33;.971;3600000;0
435;85798;12;0;0;0;0;.00nan;0;0
435;91178;12;94;34;2;32;.941;3567000;0
435;146862;17;0;0;0;0;.00nan;0;0
436;9235;4838;0;0;0;0;.00nan;0;0
436;170314;25;73;21;1;20;.952;3600000;0
436;143749;4838;51;30;5;25;.833;3600000;0
436;148958;25;0;0;0;0;.00nan;0;0
437;556;3;73;23;2;21;.913;4200000;0
437;2059;23;100;42;2;40;.952;4200000;0
437;14266;23;0;0;0;0;.00nan;0;0
437;179344;3;0;0;0;0;.00nan;0;0
438;166751;5;58;34;4;30;.882;3600000;0
438;166381;27;0;0;0;0;.00nan;0;0
438;175660;27;61;16;1;15;.938;3600000;0
438;176995;5;0;0;0;0;.00nan;0;0
439;65;11;93;49;3;46;.939;3600000;0
439;67;11;0;0;0;0;.00nan;0;0
439;17043;30;46;26;4;22;.846;3554000;0
439;36755;30;0;0;0;0;.00nan;0;0
440;1669;32;0;0;0;0;.00nan;0;0
440;173727;18;0;0;0;0;.00nan;0;0
440;43757;18;68;26;2;24;.923;3585000;0
440;58830;32;100;37;1;36;.973;3600000;0
441;8424;28;52;13;2;11;.846;643000;0
441;69536;10;0;0;0;0;.00nan;0;0
441;152717;10;52;24;3;21;.875;3600000;0
441;152835;28;48;43;6;37;.860;2957000;0
442;676;34;80;41;2;39;.951;4200000;0
442;183844;29;0;0;0;0;.00nan;0;0
442;37818;29;94;36;2;34;.944;4200000;0
442;78806;34;0;0;0;0;.00nan;0;0
443;165582;24;0;0;0;0;.00nan;0;0
443;168872;24;59;26;3;23;.885;3600000;0
443;169868;4182;65;23;2;21;.913;2458000;0
443;147945;4182;22;10;4;6;.600;1142000;0
444;163695;9;0;0;0;0;.00nan;0;0
444;13714;8;73;23;1;22;.957;3600000;0
444;18213;8;0;0;0;0;.00nan;0;0
444;175092;9;59;30;4;26;.867;3600000;0
445;1669;32;0;0;0;0;.00nan;0;0
445;163565;19;0;0;0;0;.00nan;0;0
445;14305;19;95;37;1;36;.973;3600000;0
445;58830;32;48;23;3;20;.870;3559000;0
446;166591;20;0;0;0;0;.00nan;0;0
446;178413;17;0;0;0;0;.00nan;0;0
446;86697;20;100;30;0;30;1.000;3600000;0
446;146862;17;61;19;2;17;.895;3600000;0
447;168712;14;45;32;5;27;.844;3600000;0
447;175084;22;0;0;0;0;.00nan;0;0
447;175912;14;0;0;0;0;.00nan;0;0
447;143473;22;77;9;0;9;1.000;3600000;0
448;171838;31;0;0;0;0;.00nan;0;0
448;86192;21;61;16;2;14;.875;3600000;0
448;86360;31;56;31;4;27;.871;3545000;0
448;143156;21;0;0;0;0;.00nan;0;0
449;65;11;67;39;4;35;.897;3548000;0
449;67;11;0;0;0;0;.00nan;0;0
449;163423;26;0;0;0;0;.00nan;0;0
449;179154;26;64;22;2;20;.909;3600000;0
450;46492;0;23;25;6;19;.760;3600000;0
450;85798;12;74;30;2;28;.933;3600000;0
450;91178;12;0;0;0;0;.00nan;0;0
450;149455;0;0;0;0;0;.00nan;0;0
451;166751;5;0;0;0;0;.00nan;0;0
451;9235;4838;64;40;5;35;.875;3600000;0
451;176995;5;68;20;2;18;.900;3600000;0
451;143749;4838;0;0;0;0;.00nan;0;0
452;2059;23;41;29;5;24;.828;3547000;0
452;14266;23;0;0;0;0;.00nan;0;0
452;170314;25;51;27;4;23;.852;3600000;0
452;148958;25;0;0;0;0;.00nan;0;0
453;556;3;65;35;4;31;.886;3600000;0
453;166381;27;0;0;0;0;.00nan;0;0
453;179344;3;0;0;0;0;.00nan;0;0
453;175660;27;69;23;2;21;.913;3600000;0
454;166591;20;0;0;0;0;.00nan;0;0
454;190465;33;0;0;0;0;.00nan;0;0
454;86697;20;100;51;2;49;.961;3600000;0
454;149452;33;56;19;3;16;.842;3545000;0
455;13337;15;0;0;0;0;.00nan;0;0
455;169868;4182;0;0;0;0;.00nan;0;0
455;85727;15;42;41;6;35;.854;3600000;0
455;147945;4182;83;37;2;35;.946;3600000;0
456;165582;24;66;21;1;20;.952;3600000;0
456;183844;29;0;0;0;0;.00nan;0;0
456;168872;24;0;0;0;0;.00nan;0;0
456;37818;29;84;40;3;37;.925;3546000;0
457;166646;16;0;0;0;0;.00nan;0;0
457;46492;0;49;25;4;21;.840;3066000;0
457;50065;16;56;32;4;28;.875;3600000;0
457;149455;0;37;10;3;7;.700;534000;0
458;173727;18;28;33;6;27;.818;3600000;0
458;43757;18;0;0;0;0;.00nan;0;0
458;65762;35;0;0;0;0;.00nan;0;0
458;141998;35;72;31;3;28;.903;3600000;0
459;163695;9;82;32;2;30;.938;3600000;0
459;17043;30;69;19;1;18;.947;3600000;0
459;175092;9;0;0;0;0;.00nan;0;0
459;36755;30;0;0;0;0;.00nan;0;0
460;163423;26;0;0;0;0;.00nan;0;0
460;166381;27;0;0;0;0;.00nan;0;0
460;179154;26;46;41;6;35;.854;3600000;0
460;175660;27;57;19;2;17;.895;3600000;0
461;13337;15;65;35;4;31;.886;3599000;0
461;183844;29;65;22;2;20;.909;3600000;0
461;37818;29;0;0;0;0;.00nan;0;0
461;85727;15;0;0;0;0;.00nan;0;0
462;676;34;52;2;0;2;1.000;599000;0
462;78806;34;4;27;8;19;.704;3001000;0
462;86192;21;86;32;2;30;.938;3600000;0
462;143156;21;0;0;0;0;.00nan;0;0
463;8424;28;0;0;0;0;.00nan;0;0
463;165582;24;0;0;0;0;.00nan;0;0
463;168872;24;56;21;3;18;.857;3587000;0
463;152835;28;76;26;2;24;.923;3600000;0
464;178413;17;0;0;0;0;.00nan;0;0
464;175084;22;65;19;2;17;.895;3600000;0
464;143473;22;0;0;0;0;.00nan;0;0
464;146862;17;68;53;6;47;.887;3600000;0
465;171838;31;66;23;2;21;.913;3600000;0
465;69536;10;0;0;0;0;.00nan;0;0
465;86360;31;0;0;0;0;.00nan;0;0
465;152717;10;70;42;4;38;.905;3600000;0
466;1669;32;55;41;5;36;.878;3600000;0
466;13714;8;79;25;1;24;.960;3600000;0
466;18213;8;0;0;0;0;.00nan;0;0
466;58830;32;0;0;0;0;.00nan;0;0
467;168712;14;100;27;0;27;1.000;3600000;0
467;175912;14;0;0;0;0;.00nan;0;0
467;190465;33;46;29;4;25;.862;3600000;0
467;149452;33;0;0;0;0;.00nan;0;0
468;166646;16;94;40;1;39;.975;3832000;0
468;50065;16;0;0;0;0;.00nan;0;0
468;85798;12;0;0;0;0;.00nan;0;0
468;91178;12;87;16;0;16;1.000;3832000;0
469;163695;9;0;0;0;0;.00nan;0;0
469;175092;9;81;48;4;44;.917;3585000;0
469;65762;35;65;28;3;25;.893;3600000;0
469;141998;35;0;0;0;0;.00nan;0;0
470;65;11;0;0;0;0;.00nan;0;0
470;67;11;68;46;5;41;.891;3600000;0
470;166751;5;35;31;6;25;.806;3567000;0
470;176995;5;0;0;0;0;.00nan;0;0
471;556;3;79;25;1;24;.960;3553000;0
471;9235;4838;0;0;0;0;.00nan;0;0
471;179344;3;0;0;0;0;.00nan;0;0
471;143749;4838;100;30;0;30;1.000;3600000;0
472;2059;23;63;34;4;30;.882;3680000;0
472;163565;19;0;0;0;0;.00nan;0;0
472;14266;23;0;0;0;0;.00nan;0;0
472;14305;19;66;28;3;25;.893;3680000;0
473;166381;27;88;17;0;17;1.000;3600000;0
473;170314;25;86;40;2;38;.950;3538000;0
473;175660;27;0;0;0;0;.00nan;0;0
473;148958;25;0;0;0;0;.00nan;0;0
474;166591;20;74;20;1;19;.950;3600000;0
474;168712;14;57;33;4;29;.879;3600000;0
474;175912;14;0;0;0;0;.00nan;0;0
474;86697;20;0;0;0;0;.00nan;0;0
475;676;34;27;23;5;18;.783;3507000;0
475;169868;4182;0;0;0;0;.00nan;0;0
475;78806;34;0;0;0;0;.00nan;0;0
475;147945;4182;78;36;3;33;.917;3600000;0
476;13714;8;0;0;0;0;.00nan;0;0
476;18213;8;100;26;0;26;1.000;3600000;0
476;173727;18;96;41;2;39;.951;3524000;0
476;43757;18;0;0;0;0;.00nan;0;0
477;17043;30;78;33;2;31;.939;3586000;0
477;36755;30;0;0;0;0;.00nan;0;0
477;46492;0;100;36;1;35;.972;3600000;0
477;149455;0;0;0;0;0;.00nan;0;0
478;178413;17;0;0;0;0;.00nan;0;0
478;169868;4182;70;38;4;34;.895;3600000;0
478;146862;17;83;29;1;28;.966;3600000;0
478;147945;4182;0;0;0;0;.00nan;0;0
479;163423;26;0;0;0;0;.00nan;0;0
479;179154;26;64;34;4;30;.882;3600000;0
479;69536;10;64;30;3;27;.900;3600000;0
479;152717;10;0;0;0;0;.00nan;0;0
480;1669;32;0;0;0;0;.00nan;0;0
480;8424;28;0;0;0;0;.00nan;0;0
480;58830;32;81;24;1;23;.958;3600000;0
480;152835;28;77;41;3;38;.927;3600000;0
481;166646;16;59;29;3;26;.897;3545000;0
481;2059;23;84;27;2;25;.926;3600000;0
481;14266;23;0;0;0;0;.00nan;0;0
481;50065;16;0;0;0;0;.00nan;0;0
482;65;11;69;35;3;32;.914;3569000;0
482;67;11;0;0;0;0;.00nan;0;0
482;556;3;68;24;1;23;.958;3600000;0
482;179344;3;0;0;0;0;.00nan;0;0
483;163423;26;28;28;6;22;.786;3600000;0
483;183844;29;0;0;0;0;.00nan;0;0
483;179154;26;0;0;0;0;.00nan;0;0
483;37818;29;77;14;0;14;1.000;3600000;0
484;163695;9;0;0;0;0;.00nan;0;0
484;175092;9;65;33;4;29;.879;4200000;0
484;86192;21;81;48;4;44;.917;4200000;0
484;143156;21;0;0;0;0;.00nan;0;0
485;166591;20;0;0;0;0;.00nan;0;0
485;17043;30;38;30;6;24;.800;3600000;0
485;36755;30;0;0;0;0;.00nan;0;0
485;86697;20;58;28;3;25;.893;3600000;0
486;676;34;0;0;0;0;.00nan;0;0
486;175084;22;0;0;0;0;.00nan;0;0
486;78806;34;71;37;4;33;.892;3600000;0
486;143473;22;75;10;0;10;1.000;3600000;0
487;166751;5;0;0;0;0;.00nan;0;0
487;176995;5;65;42;5;37;.881;3600000;0
487;85798;12;0;0;0;0;.00nan;0;0
487;91178;12;37;22;4;18;.818;3600000;0
488;171838;31;64;22;2;20;.909;3600000;0
488;13337;15;35;6;2;4;.667;533000;0
488;85727;15;43;33;6;27;.818;3067000;0
488;86360;31;0;0;0;0;.00nan;0;0
489;9235;4838;0;0;0;0;.00nan;0;0
489;165582;24;73;21;1;20;.952;3600000;0
489;168872;24;0;0;0;0;.00nan;0;0
489;143749;4838;82;31;2;29;.935;3544000;0
490;166381;27;65;25;2;23;.920;3600000;0
490;175660;27;0;0;0;0;.00nan;0;0
490;190465;33;0;0;0;0;.00nan;0;0
490;149452;33;52;22;3;19;.864;3568000;0
491;13714;8;0;0;0;0;.00nan;0;0
491;18213;8;68;28;3;25;.893;3600000;0
491;170314;25;100;32;0;32;1.000;3600000;0
491;148958;25;0;0;0;0;.00nan;0;0
492;46492;0;82;34;2;32;.941;3599000;0
492;65762;35;0;0;0;0;.00nan;0;0
492;141998;35;96;33;1;32;.970;3600000;0
492;149455;0;0;0;0;0;.00nan;0;0
493;163565;19;0;0;0;0;.00nan;0;0
493;14305;19;49;19;3;16;.842;3600000;0
493;173727;18;97;35;0;35;1.000;2902000;0
493;43757;18;23;12;4;8;.667;653000;0
494;1669;32;0;0;0;0;.00nan;0;0
494;178413;17;0;0;0;0;.00nan;0;0
494;58830;32;73;30;2;28;.933;3600000;0
494;146862;17;69;36;4;32;.889;3543000;0
495;165582;24;62;9;0;9;1.000;441000;0
495;168712;14;46;17;3;14;.824;3600000;0
495;168872;24;18;35;8;27;.771;3159000;0
495;175912;14;0;0;0;0;.00nan;0;0
496;2059;23;85;25;1;24;.960;3600000;0
496;163565;19;57;42;5;37;.881;3600000;0
496;14266;23;0;0;0;0;.00nan;0;0
496;14305;19;0;0;0;0;.00nan;0;0
497;171838;31;0;0;0;0;.00nan;0;0
497;163695;9;0;0;0;0;.00nan;0;0
497;175092;9;73;29;2;27;.931;3600000;0
497;86360;31;47;21;3;18;.857;3600000;0
498;168712;14;0;0;0;0;.00nan;0;0
498;175912;14;75;32;2;30;.938;3600000;0
498;86192;21;61;31;4;27;.871;3574000;0
498;143156;21;0;0;0;0;.00nan;0;0
499;556;3;0;0;0;0;.00nan;0;0
499;179344;3;89;34;3;31;.912;3600000;0
499;85798;12;0;0;0;0;.00nan;0;0
499;91178;12;72;40;4;36;.900;3577000;0
500;676;34;0;0;0;0;.00nan;0;0
500;9235;4838;0;0;0;0;.00nan;0;0
500;78806;34;61;16;1;15;.938;3600000;0
500;143749;4838;58;37;5;32;.865;3600000;0
501;175084;22;0;0;0;0;.00nan;0;0
501;190465;33;0;0;0;0;.00nan;0;0
501;143473;22;74;23;1;22;.957;3547000;0
501;149452;33;100;35;0;35;1.000;3600000;0
502;166591;20;0;0;0;0;.00nan;0;0
502;69536;10;0;0;0;0;.00nan;0;0
502;86697;20;62;34;4;30;.882;4077000;0
502;152717;10;52;38;5;33;.868;4061000;0
503;166751;5;6;27;8;19;.704;3600000;0
503;17043;30;65;27;3;24;.889;3600000;0
503;176995;5;0;0;0;0;.00nan;0;0
503;36755;30;0;0;0;0;.00nan;0;0
504;166646;16;0;0;0;0;.00nan;0;0
504;166381;27;0;0;0;0;.00nan;0;0
504;175660;27;48;21;4;17;.810;3600000;0
504;50065;16;73;46;5;41;.891;3572000;0
505;163423;26;0;0;0;0;.00nan;0;0
505;8424;28;0;0;0;0;.00nan;0;0
505;179154;26;69;38;4;34;.895;3592000;0
505;152835;28;76;35;3;32;.914;3600000;0
506;13714;8;0;0;0;0;.00nan;0;0
506;18213;8;54;35;5;30;.857;3600000;0
506;46492;0;47;27;4;23;.852;3600000;0
506;149455;0;0;0;0;0;.00nan;0;0
507;65;11;96;50;3;47;.940;3580000;0
507;67;11;0;0;0;0;.00nan;0;0
507;169868;4182;0;0;0;0;.00nan;0;0
507;147945;4182;76;23;2;21;.913;3600000;0
508;173727;18;92;42;2;40;.952;3600000;0
508;43757;18;0;0;0;0;.00nan;0;0
508;65762;35;0;0;0;0;.00nan;0;0
508;141998;35;78;23;1;22;.957;3600000;0
509;178413;17;33;20;4;16;.800;2166000;0
509;175084;22;93;19;1;18;.947;3600000;0
509;143473;22;0;0;0;0;.00nan;0;0
509;146862;17;47;22;3;19;.864;1434000;0
510;9235;4838;99;44;2;42;.955;4108000;0
510;13337;15;0;0;0;0;.00nan;0;0
510;85727;15;52;21;3;18;.857;4108000;0
510;143749;4838;0;0;0;0;.00nan;0;0
511;1669;32;0;0;0;0;.00nan;0;0
511;183844;29;0;0;0;0;.00nan;0;0
511;37818;29;50;27;4;23;.852;3571000;0
511;58830;32;75;35;3;32;.914;3600000;0
512;8424;28;64;33;4;29;.879;3566000;0
512;170314;25;68;21;2;19;.905;3600000;0
512;148958;25;0;0;0;0;.00nan;0;0
512;152835;28;0;0;0;0;.00nan;0;0
513;556;3;56;37;5;32;.865;3600000;0
513;17043;30;100;28;0;28;1.000;3600000;0
513;179344;3;0;0;0;0;.00nan;0;0
513;36755;30;0;0;0;0;.00nan;0;0
514;166646;16;0;0;0;0;.00nan;0;0
514;190465;33;0;0;0;0;.00nan;0;0
514;50065;16;62;36;5;31;.861;3600000;0
514;149452;33;79;26;2;24;.923;3600000;0
515;166591;20;0;0;0;0;.00nan;0;0
515;165582;24;39;28;5;23;.821;3600000;0
515;168872;24;0;0;0;0;.00nan;0;0
515;86697;20;100;49;2;47;.959;3600000;0
516;171838;31;56;46;6;40;.870;3600000;0
516;86192;21;68;25;2;23;.920;3600000;0
516;86360;31;0;0;0;0;.00nan;0;0
516;143156;21;0;0;0;0;.00nan;0;0
517;163423;26;0;0;0;0;.00nan;0;0
517;183844;29;50;15;2;13;.867;3600000;0
517;179154;26;74;48;4;44;.917;3518000;0
517;37818;29;0;0;0;0;.00nan;0;0
518;676;34;0;0;0;0;.00nan;0;0
518;178413;17;0;0;0;0;.00nan;0;0
518;78806;34;88;29;1;28;.966;4200000;0
518;146862;17;96;36;1;35;.972;4200000;0
519;46492;0;80;37;2;35;.946;3600000;0
519;69536;10;60;15;1;14;.933;1045000;0
519;149455;0;0;0;0;0;.00nan;0;0
519;152717;10;40;35;6;29;.829;2555000;0
520;166751;5;100;35;0;35;1.000;3600000;0
520;168712;14;59;20;2;18;.900;3559000;0
520;175912;14;0;0;0;0;.00nan;0;0
520;176995;5;0;0;0;0;.00nan;0;0
521;163695;9;0;0;0;0;.00nan;0;0
521;13337;15;100;38;1;37;.974;3600000;0
521;175092;9;59;28;4;24;.857;3600000;0
521;85727;15;0;0;0;0;.00nan;0;0
522;2059;23;55;38;5;33;.868;3600000;0
522;14266;23;0;0;0;0;.00nan;0;0
522;169868;4182;0;0;0;0;.00nan;0;0
522;147945;4182;91;36;2;34;.944;3600000;0
523;170314;25;82;32;1;31;.969;3600000;0
523;85798;12;0;0;0;0;.00nan;0;0
523;91178;12;83;28;2;26;.929;3595000;0
523;148958;25;0;0;0;0;.00nan;0;0
524;13714;8;0;0;0;0;.00nan;0;0
524;18213;8;65;27;3;24;.889;3600000;0
524;65762;35;67;38;5;33;.868;3590000;0
524;141998;35;0;0;0;0;.00nan;0;0
525;65;11;78;45;3;42;.933;4200000;0
525;67;11;0;0;0;0;.00nan;0;0
525;163565;19;0;0;0;0;.00nan;0;0
525;14305;19;93;45;3;42;.933;4200000;0
526;166381;27;0;0;0;0;.00nan;0;0
526;173727;18;0;0;0;0;.00nan;0;0
526;175660;27;78;25;2;23;.920;3600000;0
526;43757;18;83;43;3;40;.930;3600000;0
527;676;34;74;26;2;24;.923;3600000;0
527;78806;34;0;0;0;0;.00nan;0;0
527;86192;21;37;33;7;26;.788;3293000;0
527;143156;21;48;0;0;0;.00nan;307000;0
528;13337;15;0;0;0;0;.00nan;0;0
528;168712;14;69;31;3;28;.903;3561000;0
528;175912;14;0;0;0;0;.00nan;0;0
528;85727;15;85;29;1;28;.966;3600000;0
529;556;3;53;31;4;27;.871;3610000;0
529;166751;5;55;34;5;29;.853;3610000;0
529;179344;3;0;0;0;0;.00nan;0;0
529;176995;5;0;0;0;0;.00nan;0;0
530;171838;31;91;44;4;40;.909;3560000;0
530;46492;0;77;30;2;28;.933;3600000;0
530;86360;31;0;0;0;0;.00nan;0;0
530;149455;0;0;0;0;0;.00nan;0;0
531;163695;9;49;30;5;25;.833;3600000;0
531;183844;29;0;0;0;0;.00nan;0;0
531;175092;9;0;0;0;0;.00nan;0;0
531;37818;29;81;33;2;31;.939;3600000;0
532;165582;24;0;0;0;0;.00nan;0;0
532;168872;24;80;32;2;30;.938;3541000;0
532;69536;10;0;0;0;0;.00nan;0;0
532;152717;10;93;31;1;30;.968;3600000;0
533;163423;26;0;0;0;0;.00nan;0;0
533;178413;17;0;0;0;0;.00nan;0;0
533;179154;26;69;37;3;34;.919;3600000;0
533;146862;17;50;37;5;32;.865;3537000;0
534;166591;20;0;0;0;0;.00nan;0;0
534;190465;33;0;0;0;0;.00nan;0;0
534;86697;20;6;32;10;22;.688;3600000;0
534;149452;33;85;25;1;24;.960;3600000;0
535;166646;16;0;0;0;0;.00nan;0;0
535;50065;16;49;16;2;14;.875;3600000;0
535;85798;12;0;0;0;0;.00nan;0;0
535;91178;12;95;47;4;43;.915;3540000;0
536;13714;8;0;0;0;0;.00nan;0;0
536;18213;8;72;27;3;24;.889;3600000;0
536;65762;35;0;0;0;0;.00nan;0;0
536;141998;35;47;33;6;27;.818;3600000;0
537;1669;32;0;0;0;0;.00nan;0;0
537;170314;25;93;33;1;32;.970;3600000;0
537;58830;32;71;29;2;27;.931;3556000;0
537;148958;25;0;0;0;0;.00nan;0;0
538;65;11;98;53;2;51;.962;3600000;0
538;67;11;0;0;0;0;.00nan;0;0
538;2059;23;87;27;1;26;.963;3600000;0
538;14266;23;0;0;0;0;.00nan;0;0
539;17043;30;63;38;4;34;.895;3564000;0
539;169868;4182;0;0;0;0;.00nan;0;0
539;36755;30;0;0;0;0;.00nan;0;0
539;147945;4182;49;20;3;17;.850;3600000;0
540;163565;19;0;0;0;0;.00nan;0;0
540;14305;19;34;26;5;21;.808;3600000;0
540;173727;18;48;31;4;27;.871;3600000;0
540;43757;18;0;0;0;0;.00nan;0;0
541;166591;20;82;41;3;38;.927;3594000;0
541;8424;28;0;0;0;0;.00nan;0;0
541;86697;20;0;0;0;0;.00nan;0;0
541;152835;28;84;23;1;22;.957;3600000;0
542;166381;27;0;0;0;0;.00nan;0;0
542;175084;22;0;0;0;0;.00nan;0;0
542;175660;27;48;32;5;27;.844;3591000;0
542;143473;22;63;29;3;26;.897;3600000;0
543;163565;19;89;22;0;22;1.000;3600000;0
543;14305;19;0;0;0;0;.00nan;0;0
543;17043;30;0;0;0;0;.00nan;0;0
543;36755;30;63;29;3;26;.897;3600000;0
544;9235;4838;0;0;0;0;.00nan;0;0
544;173727;18;0;0;0;0;.00nan;0;0
544;43757;18;82;50;4;46;.920;3600000;0
544;143749;4838;97;22;0;22;1.000;3600000;0
545;171838;31;0;0;0;0;.00nan;0;0
545;86192;21;70;27;2;25;.926;3600000;0
545;86360;31;75;35;4;31;.886;3587000;0
545;143156;21;0;0;0;0;.00nan;0;0
546;178413;17;100;37;0;37;1.000;3600000;0
546;190465;33;0;0;0;0;.00nan;0;0
546;146862;17;0;0;0;0;.00nan;0;0
546;149452;33;49;18;2;16;.889;3515000;0
547;556;3;80;37;2;35;.946;3600000;0
547;13337;15;0;0;0;0;.00nan;0;0
547;179344;3;0;0;0;0;.00nan;0;0
547;85727;15;91;34;3;31;.912;3565000;0
548;676;34;0;0;0;0;.00nan;0;0
548;46492;0;92;22;0;22;1.000;3600000;0
548;78806;34;89;38;2;36;.947;3543000;0
548;149455;0;0;0;0;0;.00nan;0;0
549;165582;24;86;39;2;37;.949;3593000;0
549;168712;14;71;25;1;24;.960;3600000;0
549;168872;24;0;0;0;0;.00nan;0;0
549;175912;14;0;0;0;0;.00nan;0;0
550;166646;16;0;0;0;0;.00nan;0;0
550;170314;25;62;27;3;24;.889;3561000;0
550;50065;16;86;27;1;26;.963;3600000;0
550;148958;25;0;0;0;0;.00nan;0;0
551;13714;8;0;0;0;0;.00nan;0;0
551;18213;8;71;31;3;28;.903;4120000;0
551;85798;12;86;39;2;37;.949;4120000;0
551;91178;12;0;0;0;0;.00nan;0;0
552;169868;4182;0;0;0;0;.00nan;0;0
552;65762;35;0;0;0;0;.00nan;0;0
552;141998;35;98;37;1;36;.973;3600000;0
552;147945;4182;78;35;3;32;.914;3527000;0
553;2059;23;0;0;0;0;.00nan;0;0
553;14266;23;66;33;4;29;.879;3600000;0
553;175084;22;25;28;6;22;.786;3596000;0
553;143473;22;0;0;0;0;.00nan;0;0
554;1669;32;0;0;0;0;.00nan;0;0
554;163423;26;0;0;0;0;.00nan;0;0
554;179154;26;69;23;2;21;.913;3600000;0
554;58830;32;36;30;6;24;.800;3600000;0
555;163695;9;84;31;1;30;.968;3544000;0
555;175092;9;0;0;0;0;.00nan;0;0
555;86192;21;0;0;0;0;.00nan;0;0
555;143156;21;100;36;0;36;1.000;3600000;0
556;676;34;100;44;1;43;.977;4200000;0
556;183844;29;0;0;0;0;.00nan;0;0
556;37818;29;86;29;1;28;.966;4200000;0
556;78806;34;0;0;0;0;.00nan;0;0
557;556;3;0;0;0;0;.00nan;0;0
557;8424;28;0;0;0;0;.00nan;0;0
557;179344;3;71;32;3;29;.906;3600000;0
557;152835;28;52;39;5;34;.872;3514000;0
558;69536;10;98;41;2;39;.951;3552000;0
558;85798;12;0;0;0;0;.00nan;0;0
558;91178;12;80;20;1;19;.950;3600000;0
558;152717;10;0;0;0;0;.00nan;0;0
559;166751;5;0;0;0;0;.00nan;0;0
559;13337;15;17;21;6;15;.714;3600000;0
559;176995;5;75;33;3;30;.909;3600000;0
559;85727;15;0;0;0;0;.00nan;0;0
560;166591;20;0;0;0;0;.00nan;0;0
560;171838;31;67;36;4;32;.889;3600000;0
560;86360;31;0;0;0;0;.00nan;0;0
560;86697;20;83;35;2;33;.943;3600000;0
561;168712;14;0;0;0;0;.00nan;0;0
561;175912;14;74;22;1;21;.955;3600000;0
561;190465;33;0;0;0;0;.00nan;0;0
561;149452;33;100;30;0;30;1.000;3600000;0
562;163565;19;79;13;0;13;1.000;3600000;0
562;9235;4838;58;5;0;5;1.000;638000;0
562;14305;19;0;0;0;0;.00nan;0;0
562;143749;4838;46;38;6;32;.842;2962000;0
563;1669;32;0;0;0;0;.00nan;0;0
563;163423;26;0;0;0;0;.00nan;0;0
563;179154;26;57;23;3;20;.870;3600000;0
563;58830;32;63;42;5;37;.881;3583000;0
564;183844;29;83;27;2;25;.926;3600000;0
564;178413;17;0;0;0;0;.00nan;0;0
564;37818;29;0;0;0;0;.00nan;0;0
564;146862;17;74;38;4;34;.895;3548000;0
565;163695;9;0;0;0;0;.00nan;0;0
565;175092;9;76;50;5;45;.900;3600000;0
565;46492;0;41;21;4;17;.810;3600000;0
565;149455;0;0;0;0;0;.00nan;0;0
566;165582;24;75;24;1;23;.958;3600000;0
566;168872;24;0;0;0;0;.00nan;0;0
566;69536;10;66;35;4;31;.886;2611000;0
566;152717;10;37;17;4;13;.765;989000;0
567;166751;5;33;28;6;22;.786;3712000;0
567;8424;28;64;40;5;35;.875;3712000;0
567;176995;5;0;0;0;0;.00nan;0;0
567;152835;28;0;0;0;0;.00nan;0;0
568;9235;4838;41;39;6;33;.846;3600000;0
568;169868;4182;0;0;0;0;.00nan;0;0
568;143749;4838;0;0;0;0;.00nan;0;0
568;147945;4182;84;28;1;27;.964;3600000;0
569;65;11;98;48;3;45;.938;3563000;0
569;67;11;0;0;0;0;.00nan;0;0
569;175084;22;0;0;0;0;.00nan;0;0
569;143473;22;68;16;1;15;.938;3600000;0
570;13714;8;0;0;0;0;.00nan;0;0
570;18213;8;100;27;0;27;1.000;3600000;0
570;173727;18;74;42;4;38;.905;3600000;0
570;43757;18;0;0;0;0;.00nan;0;0
571;166646;16;0;0;0;0;.00nan;0;0
571;170314;25;28;16;4;12;.750;3560000;0
571;50065;16;78;35;3;32;.914;3600000;0
571;148958;25;0;0;0;0;.00nan;0;0
572;2059;23;22;19;5;14;.737;1884000;0
572;14266;23;77;15;0;15;1.000;1716000;0
572;17043;30;72;25;2;23;.920;3600000;0
572;36755;30;0;0;0;0;.00nan;0;0
573;183844;29;0;0;0;0;.00nan;0;0
573;37818;29;81;17;0;17;1.000;3600000;0
573;86192;21;0;0;0;0;.00nan;0;0
573;143156;21;77;33;2;31;.939;3553000;0
574;166591;20;0;0;0;0;.00nan;0;0
574;13337;15;0;0;0;0;.00nan;0;0
574;85727;15;80;25;1;24;.960;3600000;0
574;86697;20;43;29;4;25;.862;3600000;0
575;168712;14;54;20;3;17;.850;3600000;0
575;175912;14;0;0;0;0;.00nan;0;0
575;69536;10;0;0;0;0;.00nan;0;0
575;152717;10;56;33;4;29;.879;3548000;0
576;166646;16;77;25;2;23;.920;3600000;0
576;8424;28;0;0;0;0;.00nan;0;0
576;50065;16;0;0;0;0;.00nan;0;0
576;152835;28;67;35;3;32;.914;3600000;0
577;65;11;99;39;2;37;.949;3600000;0
577;67;11;0;0;0;0;.00nan;0;0
577;163423;26;0;0;0;0;.00nan;0;0
577;179154;26;51;29;4;25;.862;3565000;0
578;170314;25;59;29;4;25;.862;3600000;0
578;190465;33;0;0;0;0;.00nan;0;0
578;148958;25;0;0;0;0;.00nan;0;0
578;149452;33;100;36;0;36;1.000;3600000;0
579;1669;32;0;0;0;0;.00nan;0;0
579;166751;5;60;39;4;35;.897;3600000;0
579;176995;5;0;0;0;0;.00nan;0;0
579;58830;32;91;27;1;26;.963;3600000;0
580;556;3;46;29;4;25;.862;3573000;0
580;179344;3;0;0;0;0;.00nan;0;0
580;65762;35;75;29;2;27;.931;3600000;0
580;141998;35;0;0;0;0;.00nan;0;0
581;13714;8;0;0;0;0;.00nan;0;0
581;165582;24;73;23;1;22;.957;3579000;0
581;18213;8;100;25;0;25;1.000;3600000;0
581;168872;24;0;0;0;0;.00nan;0;0
582;9235;4838;0;0;0;0;.00nan;0;0
582;175084;22;0;0;0;0;.00nan;0;0
582;143473;22;51;25;4;21;.840;3581000;0
582;143749;4838;81;35;2;33;.943;3600000;0
583;166381;27;0;0;0;0;.00nan;0;0
583;175660;27;31;16;4;12;.750;3536000;0
583;46492;0;83;36;2;34;.944;3600000;0
583;149455;0;0;0;0;0;.00nan;0;0
584;171838;31;77;47;5;42;.894;3806000;0
584;163565;19;61;35;4;31;.886;3806000;0
584;14305;19;0;0;0;0;.00nan;0;0
584;86360;31;0;0;0;0;.00nan;0;0
585;178413;17;0;0;0;0;.00nan;0;0
585;173727;18;0;0;0;0;.00nan;0;0
585;43757;18;90;46;3;43;.935;3585000;0
585;146862;17;78;26;1;25;.962;3600000;0
586;676;34;0;0;0;0;.00nan;0;0
586;168712;14;0;0;0;0;.00nan;0;0
586;175912;14;86;39;2;37;.949;4200000;0
586;78806;34;100;55;2;53;.964;4200000;0
587;171838;31;0;0;0;0;.00nan;0;0
587;169868;4182;0;0;0;0;.00nan;0;0
587;86360;31;87;34;2;32;.941;3600000;0
587;147945;4182;90;42;3;39;.929;3546000;0
588;183844;29;57;3;0;3;1.000;244000;0
588;37818;29;30;25;6;19;.760;3311000;0
588;69536;10;0;0;0;0;.00nan;0;0
588;152717;10;59;35;5;30;.857;3600000;0
589;163695;9;0;0;0;0;.00nan;0;0
589;8424;28;100;27;0;27;1.000;3600000;0
589;175092;9;80;28;1;27;.964;3553000;0
589;152835;28;0;0;0;0;.00nan;0;0
590;13337;15;0;0;0;0;.00nan;0;0
590;170314;25;63;36;4;32;.889;3641000;0
590;85727;15;59;27;3;24;.889;3641000;0
590;148958;25;0;0;0;0;.00nan;0;0
591;175084;22;48;19;3;16;.842;3600000;0
591;86192;21;64;44;5;39;.886;3600000;0
591;143156;21;0;0;0;0;.00nan;0;0
591;143473;22;0;0;0;0;.00nan;0;0
592;166646;16;0;0;0;0;.00nan;0;0
592;13714;8;0;0;0;0;.00nan;0;0
592;18213;8;78;30;2;28;.933;3593000;0
592;50065;16;92;30;1;29;.967;3600000;0
593;166751;5;57;39;5;34;.872;3581000;0
593;163423;26;0;0;0;0;.00nan;0;0
593;179154;26;44;14;3;11;.786;3600000;0
593;176995;5;0;0;0;0;.00nan;0;0
594;65;11;86;36;2;34;.944;3600000;0
594;67;11;0;0;0;0;.00nan;0;0
594;190465;33;0;0;0;0;.00nan;0;0
594;149452;33;61;32;3;29;.906;3546000;0
595;166381;27;0;0;0;0;.00nan;0;0
595;175660;27;93;17;0;17;1.000;3600000;0
595;85798;12;0;0;0;0;.00nan;0;0
595;91178;12;67;36;4;32;.889;3600000;0
596;165582;24;68;27;3;24;.889;3600000;0
596;168872;24;0;0;0;0;.00nan;0;0
596;65762;35;53;2;0;2;1.000;572000;0
596;141998;35;54;44;6;38;.864;3028000;0
597;2059;23;83;46;4;42;.913;3625000;0
597;14266;23;0;0;0;0;.00nan;0;0
597;46492;0;67;30;3;27;.900;3605000;0
597;149455;0;0;0;0;0;.00nan;0;0
598;556;3;50;25;3;22;.880;3600000;0
598;17043;30;100;22;0;22;1.000;3600000;0
598;179344;3;0;0;0;0;.00nan;0;0
598;36755;30;0;0;0;0;.00nan;0;0
599;163565;19;0;0;0;0;.00nan;0;0
599;14305;19;36;31;5;26;.839;3600000;0
599;178413;17;0;0;0;0;.00nan;0;0
599;146862;17;77;31;2;29;.935;3600000;0
600;1669;32;0;0;0;0;.00nan;0;0
600;173727;18;0;0;0;0;.00nan;0;0
600;43757;18;84;34;1;33;.971;3600000;0
600;58830;32;87;39;2;37;.949;3585000;0
601;676;34;99;35;1;34;.971;3600000;0
601;170314;25;31;18;5;13;.722;3600000;0
601;78806;34;0;0;0;0;.00nan;0;0
601;148958;25;0;0;0;0;.00nan;0;0
602;166591;20;0;0;0;0;.00nan;0;0
602;168712;14;64;26;2;24;.923;3600000;0
602;175912;14;0;0;0;0;.00nan;0;0
602;86697;20;67;31;3;28;.903;3545000;0
603;1669;32;0;0;0;0;.00nan;0;0
603;169868;4182;0;0;0;0;.00nan;0;0
603;58830;32;79;39;3;36;.923;3569000;0
603;147945;4182;76;23;1;22;.957;3600000;0
604;65;11;56;35;6;29;.829;2057000;0
604;67;11;39;26;5;21;.808;1543000;0
604;175084;22;0;0;0;0;.00nan;0;0
604;143473;22;57;12;1;11;.917;3600000;0
605;556;3;50;35;5;30;.857;2321000;0
605;13714;8;0;0;0;0;.00nan;0;0
605;18213;8;89;29;1;28;.966;3600000;0
605;179344;3;65;9;0;9;1.000;1279000;0
606;166751;5;74;30;2;28;.933;3600000;0
606;183844;29;0;0;0;0;.00nan;0;0
606;176995;5;0;0;0;0;.00nan;0;0
606;37818;29;88;18;0;18;1.000;3600000;0
607;166591;20;58;38;5;33;.868;3587000;0
607;85798;12;0;0;0;0;.00nan;0;0
607;86697;20;0;0;0;0;.00nan;0;0
607;91178;12;100;41;3;38;.927;3600000;0
608;163423;26;0;0;0;0;.00nan;0;0
608;179154;26;48;40;6;34;.850;3600000;0
608;86192;21;82;30;2;28;.933;3600000;0
608;143156;21;0;0;0;0;.00nan;0;0
609;8424;28;97;26;0;26;1.000;3600000;0
609;13337;15;0;0;0;0;.00nan;0;0
609;85727;15;69;22;2;20;.909;3552000;0
609;152835;28;0;0;0;0;.00nan;0;0
610;676;34;0;0;0;0;.00nan;0;0
610;166381;27;0;0;0;0;.00nan;0;0
610;175660;27;93;24;0;24;1.000;3600000;0
610;78806;34;85;36;3;33;.917;3600000;0
611;163695;9;76;36;3;33;.917;4200000;0
611;175092;9;0;0;0;0;.00nan;0;0
611;69536;10;67;30;3;27;.900;4200000;0
611;152717;10;0;0;0;0;.00nan;0;0
612;171838;31;78;32;2;30;.938;3600000;0
612;173727;18;0;0;0;0;.00nan;0;0
612;43757;18;42;30;5;25;.833;3600000;0
612;86360;31;0;0;0;0;.00nan;0;0
613;166646;16;0;0;0;0;.00nan;0;0
613;190465;33;0;0;0;0;.00nan;0;0
613;50065;16;74;35;3;32;.914;3600000;0
613;149452;33;82;30;2;28;.933;3600000;0
614;9235;4838;0;0;0;0;.00nan;0;0
614;46492;0;86;29;1;28;.966;3600000;0
614;143749;4838;81;45;4;41;.911;3600000;0
614;149455;0;0;0;0;0;.00nan;0;0
615;165582;24;92;43;3;40;.930;3600000;0
615;17043;30;78;24;1;23;.958;3600000;0
615;168872;24;0;0;0;0;.00nan;0;0
615;36755;30;0;0;0;0;.00nan;0;0
616;65;11;82;38;3;35;.921;3586000;0
616;67;11;0;0;0;0;.00nan;0;0
616;170314;25;82;31;2;29;.935;3600000;0
616;148958;25;0;0;0;0;.00nan;0;0
617;163565;19;0;0;0;0;.00nan;0;0
617;14305;19;65;37;5;32;.865;3600000;0
617;168712;14;0;0;0;0;.00nan;0;0
617;175912;14;100;24;0;24;1.000;3600000;0
618;1669;32;0;0;0;0;.00nan;0;0
618;58830;32;66;29;3;26;.897;3566000;0
618;65762;35;0;0;0;0;.00nan;0;0
618;141998;35;82;23;1;22;.957;3600000;0
619;178413;17;0;0;0;0;.00nan;0;0
619;169868;4182;0;0;0;0;.00nan;0;0
619;146862;17;100;45;1;44;.978;3600000;0
619;147945;4182;44;29;4;25;.862;3600000;0
620;13337;15;0;0;0;0;.00nan;0;0
620;166381;27;0;0;0;0;.00nan;0;0
620;175660;27;59;18;2;16;.889;3555000;0
620;85727;15;99;48;1;47;.979;3600000;0
621;175084;22;0;0;0;0;.00nan;0;0
621;69536;10;0;0;0;0;.00nan;0;0
621;143473;22;88;17;0;17;1.000;3600000;0
621;152717;10;91;32;1;31;.969;3600000;0
622;166646;16;0;0;0;0;.00nan;0;0
622;163423;26;0;0;0;0;.00nan;0;0
622;179154;26;71;34;4;30;.882;3558000;0
622;50065;16;45;20;3;17;.850;3600000;0
623;13714;8;0;0;0;0;.00nan;0;0
623;183844;29;0;0;0;0;.00nan;0;0
623;18213;8;71;26;2;24;.923;3600000;0
623;37818;29;42;27;5;22;.815;3600000;0
624;2059;23;53;30;4;26;.867;3541000;0
624;163695;9;0;0;0;0;.00nan;0;0
624;14266;23;0;0;0;0;.00nan;0;0
624;175092;9;77;36;2;34;.944;3600000;0
625;166751;5;0;0;0;0;.00nan;0;0
625;163565;19;0;0;0;0;.00nan;0;0
625;14305;19;44;33;5;28;.848;3600000;0
625;176995;5;72;29;2;27;.931;3600000;0
626;171838;31;0;0;0;0;.00nan;0;0
626;173727;18;26;19;5;14;.737;1134000;0
626;43757;18;30;30;7;23;.767;2466000;0
626;86360;31;43;29;5;24;.828;3600000;0
627;165582;24;51;10;1;9;.900;1538000;0
627;166381;27;60;31;4;27;.871;3600000;0
627;168872;24;13;17;6;11;.647;2062000;0
627;175660;27;0;0;0;0;.00nan;0;0
628;169868;4182;0;0;0;0;.00nan;0;0
628;190465;33;0;0;0;0;.00nan;0;0
628;147945;4182;96;43;2;41;.953;3600000;0
628;149452;33;60;25;3;22;.880;3600000;0
629;556;3;76;29;2;27;.931;3600000;0
629;179344;3;0;0;0;0;.00nan;0;0
629;85798;12;0;0;0;0;.00nan;0;0
629;91178;12;75;34;3;31;.912;3592000;0
630;1669;32;0;0;0;0;.00nan;0;0
630;58830;32;79;34;2;32;.941;3600000;0
630;86192;21;79;22;1;21;.955;3600000;0
630;143156;21;0;0;0;0;.00nan;0;0
631;9235;4838;0;0;0;0;.00nan;0;0
631;170314;25;66;18;1;17;.944;3600000;0
631;143749;4838;98;48;2;46;.958;3569000;0
631;148958;25;0;0;0;0;.00nan;0;0
632;183844;29;25;31;7;24;.774;2084000;0
632;37818;29;23;11;4;7;.636;1516000;0
632;65762;35;0;0;0;0;.00nan;0;0
632;141998;35;87;37;4;33;.892;3600000;0
633;65;11;0;0;0;0;.00nan;0;0
633;67;11;79;51;4;47;.922;4159000;0
633;46492;0;42;27;5;22;.815;4159000;0
633;149455;0;0;0;0;0;.00nan;0;0
634;8424;28;97;42;1;41;.976;3562000;0
634;175084;22;83;13;0;13;1.000;3600000;0
634;143473;22;0;0;0;0;.00nan;0;0
634;152835;28;0;0;0;0;.00nan;0;0
635;166646;16;84;24;1;23;.958;3600000;0
635;163423;26;0;0;0;0;.00nan;0;0
635;179154;26;62;34;3;31;.912;3600000;0
635;50065;16;0;0;0;0;.00nan;0;0
636;13714;8;0;0;0;0;.00nan;0;0
636;17043;30;94;39;2;37;.949;3600000;0
636;18213;8;58;32;4;28;.875;3551000;0
636;36755;30;0;0;0;0;.00nan;0;0
637;163695;9;0;0;0;0;.00nan;0;0
637;175092;9;66;31;3;28;.903;3862000;0
637;46492;0;81;28;2;26;.929;3862000;0
637;149455;0;0;0;0;0;.00nan;0;0
638;166591;20;0;0;0;0;.00nan;0;0
638;169868;4182;0;0;0;0;.00nan;0;0
638;86697;20;80;29;1;28;.966;3600000;0
638;147945;4182;77;39;3;36;.923;3600000;0
639;9235;4838;0;0;0;0;.00nan;0;0
639;178413;17;63;25;2;23;.920;3600000;0
639;143749;4838;55;34;4;30;.882;3593000;0
639;146862;17;0;0;0;0;.00nan;0;0
640;556;3;99;43;2;41;.953;3600000;0
640;163565;19;0;0;0;0;.00nan;0;0
640;14305;19;55;26;3;23;.885;3545000;0
640;179344;3;0;0;0;0;.00nan;0;0
641;8424;28;0;0;0;0;.00nan;0;0
641;173727;18;0;0;0;0;.00nan;0;0
641;43757;18;61;32;5;27;.844;3600000;0
641;152835;28;100;34;0;34;1.000;3600000;0
642;166381;27;54;3;0;3;1.000;268000;0
642;175660;27;42;32;6;26;.813;3325000;0
642;69536;10;54;36;5;31;.861;3600000;0
642;152717;10;0;0;0;0;.00nan;0;0
643;676;34;80;25;1;24;.960;3600000;0
643;166751;5;80;32;2;30;.938;3600000;0
643;176995;5;0;0;0;0;.00nan;0;0
643;78806;34;0;0;0;0;.00nan;0;0
644;2059;23;83;36;1;35;.972;4200000;0
644;14266;23;0;0;0;0;.00nan;0;0
644;168712;14;0;0;0;0;.00nan;0;0
644;175912;14;89;29;1;28;.966;4200000;0
645;171838;31;79;38;3;35;.921;3600000;0
645;165582;24;39;18;4;14;.778;3546000;0
645;168872;24;0;0;0;0;.00nan;0;0
645;86360;31;0;0;0;0;.00nan;0;0
646;13337;15;0;0;0;0;.00nan;0;0
646;85727;15;56;23;3;20;.870;3749000;0
646;85798;12;52;28;4;24;.857;3748000;0
646;91178;12;0;0;0;0;.00nan;0;0
647;1669;32;0;0;0;0;.00nan;0;0
647;170314;25;53;29;5;24;.828;3798000;0
647;58830;32;84;48;4;44;.917;3798000;0
647;148958;25;0;0;0;0;.00nan;0;0
648;65;11;83;43;3;40;.930;3600000;0
648;67;11;0;0;0;0;.00nan;0;0
648;65762;35;0;0;0;0;.00nan;0;0
648;141998;35;36;27;5;22;.815;3581000;0
649;183844;29;0;0;0;0;.00nan;0;0
649;17043;30;67;16;1;15;.938;877000;0
649;36755;30;37;37;6;31;.838;2723000;0
649;37818;29;57;23;3;20;.870;3600000;0
650;166646;16;0;0;0;0;.00nan;0;0
650;190465;33;0;0;0;0;.00nan;0;0
650;50065;16;62;34;5;29;.853;3698000;0
650;149452;33;62;27;4;23;.852;3698000;0
651;163423;26;0;0;0;0;.00nan;0;0
651;179154;26;80;33;2;31;.939;3600000;0
651;175084;22;0;0;0;0;.00nan;0;0
651;143473;22;45;26;4;22;.846;3580000;0
652;13337;15;0;0;0;0;.00nan;0;0
652;168712;14;52;29;4;25;.862;3600000;0
652;175912;14;0;0;0;0;.00nan;0;0
652;85727;15;72;30;3;27;.900;3600000;0
653;163695;9;0;0;0;0;.00nan;0;0
653;166381;27;0;0;0;0;.00nan;0;0
653;175092;9;65;29;3;26;.897;3600000;0
653;175660;27;99;34;1;33;.971;3600000;0
654;173727;18;100;42;2;40;.952;4196000;0
654;43757;18;0;0;0;0;.00nan;0;0
654;46492;0;66;27;2;25;.926;4200000;0
654;149455;0;0;0;0;0;.00nan;0;0
655;556;3;100;47;1;46;.979;3600000;0
655;676;34;46;26;4;22;.846;3600000;0
655;179344;3;0;0;0;0;.00nan;0;0
655;78806;34;0;0;0;0;.00nan;0;0
656;166591;20;51;10;1;9;.900;980000;0
656;69536;10;0;0;0;0;.00nan;0;0
656;86697;20;28;26;6;20;.769;2620000;0
656;152717;10;67;30;3;27;.900;3600000;0
657;2059;23;65;44;5;39;.886;3554000;0
657;14266;23;0;0;0;0;.00nan;0;0
657;86192;21;51;24;3;21;.875;3600000;0
657;143156;21;0;0;0;0;.00nan;0;0
658;163565;19;0;0;0;0;.00nan;0;0
658;14305;19;84;26;1;25;.962;3600000;0
658;178413;17;0;0;0;0;.00nan;0;0
658;146862;17;74;30;2;28;.933;3587000;0
659;8424;28;0;0;0;0;.00nan;0;0
659;9235;4838;0;0;0;0;.00nan;0;0
659;143749;4838;51;41;6;35;.854;3600000;0
659;152835;28;80;24;1;23;.958;3600000;0
660;166751;5;64;29;3;26;.897;3616000;0
660;169868;4182;0;0;0;0;.00nan;0;0
660;176995;5;0;0;0;0;.00nan;0;0
660;147945;4182;91;36;2;34;.944;3616000;0
661;171838;31;0;0;0;0;.00nan;0;0
661;13714;8;0;0;0;0;.00nan;0;0
661;18213;8;74;31;3;28;.903;3600000;0
661;86360;31;49;39;5;34;.872;3578000;0
662;1669;32;0;0;0;0;.00nan;0;0
662;175084;22;58;24;3;21;.875;3600000;0
662;58830;32;38;32;5;27;.844;3598000;0
662;143473;22;0;0;0;0;.00nan;0;0
663;166646;16;28;15;4;11;.733;726000;0
663;170314;25;90;33;1;32;.970;3600000;0
663;50065;16;81;19;0;19;1.000;2874000;0
663;148958;25;0;0;0;0;.00nan;0;0
664;163423;26;26;25;6;19;.760;2833000;0
664;179154;26;54;11;1;10;.909;767000;0
664;65762;35;0;0;0;0;.00nan;0;0
664;141998;35;75;33;2;31;.939;3600000;0
665;165582;24;0;0;0;0;.00nan;0;0
665;168872;24;92;28;1;27;.964;3600000;0
665;190465;33;97;47;2;45;.957;3592000;0
665;149452;33;0;0;0;0;.00nan;0;0
666;183844;29;0;0;0;0;.00nan;0;0
666;37818;29;78;34;4;30;.882;3600000;0
666;85798;12;0;0;0;0;.00nan;0;0
666;91178;12;70;24;3;21;.875;3600000;0
667;65;11;83;37;2;35;.946;4200000;0
667;67;11;0;0;0;0;.00nan;0;0
667;17043;30;84;27;2;25;.926;4189000;0
667;36755;30;0;0;0;0;.00nan;0;0
668;13337;15;71;37;3;34;.919;3600000;0
668;168712;14;0;0;0;0;.00nan;0;0
668;175912;14;64;19;2;17;.895;3600000;0
668;85727;15;0;0;0;0;.00nan;0;0
669;171838;31;62;25;3;22;.880;3553000;0
669;178413;17;81;33;2;31;.939;3600000;0
669;86360;31;0;0;0;0;.00nan;0;0
669;146862;17;0;0;0;0;.00nan;0;0
670;676;34;0;0;0;0;.00nan;0;0
670;183844;29;0;0;0;0;.00nan;0;0
670;37818;29;76;22;2;20;.909;3587000;0
670;78806;34;81;25;1;24;.960;3600000;0
671;163695;9;0;0;0;0;.00nan;0;0
671;173727;18;54;31;4;27;.871;3592000;0
671;175092;9;67;24;2;22;.917;3600000;0
671;43757;18;0;0;0;0;.00nan;0;0
672;166381;27;0;0;0;0;.00nan;0;0
672;175660;27;70;36;4;32;.889;3866000;0
672;86192;21;65;41;5;36;.878;3866000;0
672;143156;21;0;0;0;0;.00nan;0;0
673;556;3;71;31;2;29;.935;3600000;0
673;169868;4182;0;0;0;0;.00nan;0;0
673;179344;3;0;0;0;0;.00nan;0;0
673;147945;4182;83;38;3;35;.921;3543000;0
674;166591;20;82;38;3;35;.921;4200000;0
674;163565;19;0;0;0;0;.00nan;0;0
674;14305;19;63;30;3;27;.900;4200000;0
674;86697;20;0;0;0;0;.00nan;0;0
675;163423;26;0;0;0;0;.00nan;0;0
675;165582;24;0;0;0;0;.00nan;0;0
675;168872;24;39;14;3;11;.786;3580000;0
675;179154;26;100;49;1;48;.980;3600000;0
676;2059;23;98;50;2;48;.960;4200000;0
676;14266;23;0;0;0;0;.00nan;0;0
676;69536;10;0;0;0;0;.00nan;0;0
676;152717;10;100;45;2;43;.956;4200000;0
677;8424;28;67;36;3;33;.917;3575000;0
677;13714;8;0;0;0;0;.00nan;0;0
677;18213;8;73;29;2;27;.931;3600000;0
677;152835;28;0;0;0;0;.00nan;0;0
678;175084;22;0;0;0;0;.00nan;0;0
678;85798;12;0;0;0;0;.00nan;0;0
678;91178;12;87;38;2;36;.947;4200000;0
678;143473;22;69;23;2;21;.913;4200000;0
679;17043;30;46;35;6;29;.829;3600000;0
679;190465;33;0;0;0;0;.00nan;0;0
679;36755;30;0;0;0;0;.00nan;0;0
679;149452;33;100;25;0;25;1.000;3600000;0
680;2059;23;0;0;0;0;.00nan;0;0
680;14266;23;48;25;4;21;.840;3817000;0
680;58830;15;59;29;3;26;.897;3817000;0
680;85727;15;0;0;0;0;.00nan;0;0
681;13714;8;68;32;3;29;.906;3661000;0
681;18213;8;0;0;0;0;.00nan;0;0
681;46492;0;89;34;2;32;.941;3661000;0
681;149455;0;0;0;0;0;.00nan;0;0
682;168712;14;64;36;5;31;.861;3600000;0
682;169868;4182;95;33;1;32;.970;3600000;0
682;175912;14;0;0;0;0;.00nan;0;0
682;147945;4182;0;0;0;0;.00nan;0;0
683;166646;16;0;0;0;0;.00nan;0;0
683;163565;19;95;49;4;45;.918;3600000;0
683;14305;19;0;0;0;0;.00nan;0;0
683;50065;16;78;22;1;21;.955;3600000;0
684;1669;32;44;30;5;25;.833;3600000;0
684;13337;32;0;0;0;0;.00nan;0;0
684;165582;24;64;23;2;21;.913;3600000;0
684;168872;24;0;0;0;0;.00nan;0;0
685;173727;18;0;0;0;0;.00nan;0;0
685;170314;25;42;21;4;17;.810;3692000;0
685;43757;18;100;55;3;52;.945;3692000;0
685;148958;25;0;0;0;0;.00nan;0;0
686;65;11;91;53;5;48;.906;4200000;0
686;67;11;0;0;0;0;.00nan;0;0
686;65762;35;0;0;0;0;.00nan;0;0
686;141998;35;58;32;5;27;.844;4200000;0
687;171838;31;66;24;2;22;.917;3600000;0
687;9235;4838;19;10;4;6;.600;784000;0
687;86360;31;0;0;0;0;.00nan;0;0
687;143749;4838;91;26;0;26;1.000;2753000;0
688;556;3;54;29;4;25;.862;3726000;0
688;178413;17;0;0;0;0;.00nan;0;0
688;179344;3;0;0;0;0;.00nan;0;0
688;146862;17;87;55;5;50;.909;3726000;0
689;676;34;0;0;0;0;.00nan;0;0
689;8424;28;51;40;6;34;.850;3292000;0
689;78806;34;79;40;3;37;.925;3600000;0
689;152835;28;57;4;0;4;1.000;308000;0
690;163695;9;0;0;0;0;.00nan;0;0
690;170314;25;56;27;3;24;.889;3600000;0
690;175092;9;58;37;4;33;.892;3590000;0
690;148958;25;0;0;0;0;.00nan;0;0
691;13714;8;0;0;0;0;.00nan;0;0
691;183844;29;0;0;0;0;.00nan;0;0
691;18213;8;86;22;0;22;1.000;3600000;0
691;37818;29;57;24;3;21;.875;3600000;0
692;8424;28;0;0;0;0;.00nan;0;0
692;46492;0;64;30;3;27;.900;3600000;0
692;149455;0;0;0;0;0;.00nan;0;0
692;152835;28;58;37;4;33;.892;3600000;0
693;166646;16;0;0;0;0;.00nan;0;0
693;175084;22;0;0;0;0;.00nan;0;0
693;50065;16;72;38;4;34;.895;3600000;0
693;143473;22;87;18;0;18;1.000;3600000;0
694;166751;5;0;0;0;0;.00nan;0;0
694;163423;26;0;0;0;0;.00nan;0;0
694;179154;26;39;25;5;20;.800;3516000;0
694;176995;5;86;47;3;44;.936;3600000;0
695;168712;14;71;29;2;27;.931;3556000;0
695;175912;14;0;0;0;0;.00nan;0;0
695;85798;12;0;0;0;0;.00nan;0;0
695;91178;12;88;29;1;28;.966;3600000;0
696;65;11;55;30;3;27;.900;3572000;0
696;67;11;0;0;0;0;.00nan;0;0
696;171838;31;0;0;0;0;.00nan;0;0
696;86360;31;70;29;2;27;.931;3600000;0
697;2059;23;79;28;2;26;.929;3579000;0
697;9235;4838;0;0;0;0;.00nan;0;0
697;14266;23;0;0;0;0;.00nan;0;0
697;143749;4838;87;25;1;24;.960;3600000;0
698;163565;19;0;0;0;0;.00nan;0;0
698;14305;19;80;27;1;26;.963;3600000;0
698;190465;33;0;0;0;0;.00nan;0;0
698;149452;33;45;25;4;21;.840;3600000;0
699;166381;27;0;0;0;0;.00nan;0;0
699;175660;27;64;22;2;20;.909;3600000;0
699;65762;35;48;27;4;23;.852;901000;0
699;141998;35;96;32;1;31;.969;2699000;0
700;17043;30;24;24;7;17;.708;3251000;0
700;36755;30;50;1;0;1;1.000;349000;0
700;58830;15;100;34;0;34;1.000;3600000;0
700;85727;15;0;0;0;0;.00nan;0;0
701;166591;20;0;0;0;0;.00nan;0;0
701;178413;17;0;0;0;0;.00nan;0;0
701;86697;20;83;15;0;15;1.000;3600000;0
701;146862;17;54;25;3;22;.880;3600000;0
702;676;34;0;0;0;0;.00nan;0;0
702;78806;34;79;36;3;33;.917;3600000;0
702;86192;21;85;23;1;22;.957;3600000;0
702;143156;21;0;0;0;0;.00nan;0;0
703;556;3;93;38;2;36;.947;3541000;0
703;163423;26;76;31;1;30;.968;3600000;0
703;179154;26;0;0;0;0;.00nan;0;0
703;179344;3;0;0;0;0;.00nan;0;0
704;165582;24;83;30;2;28;.933;3600000;0
704;168872;24;0;0;0;0;.00nan;0;0
704;170314;25;48;22;3;19;.864;3590000;0
704;148958;25;0;0;0;0;.00nan;0;0
705;166751;5;99;34;2;32;.941;3600000;0
705;163695;9;0;0;0;0;.00nan;0;0
705;175092;9;38;15;3;12;.800;3600000;0
705;176995;5;0;0;0;0;.00nan;0;0
706;13714;8;0;0;0;0;.00nan;0;0
706;18213;8;62;44;5;39;.886;3600000;0
706;175084;22;0;0;0;0;.00nan;0;0
706;143473;22;50;14;2;12;.857;3600000;0
707;190465;33;0;0;0;0;.00nan;0;0
707;65762;35;90;33;1;32;.970;3600000;0
707;141998;35;0;0;0;0;.00nan;0;0
707;149452;33;46;31;5;26;.839;3600000;0
708;1669;32;0;0;0;0;.00nan;0;0
708;13337;32;60;38;4;34;.895;3625000;0
708;46492;0;45;32;5;27;.844;3625000;0
708;149455;0;0;0;0;0;.00nan;0;0
709;8424;28;25;13;4;9;.692;644000;0
709;183844;29;0;0;0;0;.00nan;0;0
709;37818;29;77;24;2;22;.917;3600000;0
709;152835;28;70;28;2;26;.929;2956000;0
710;676;34;34;29;6;23;.793;3600000;0
710;166646;16;0;0;0;0;.00nan;0;0
710;50065;16;77;21;1;20;.952;3600000;0
710;78806;34;0;0;0;0;.00nan;0;0
711;171838;31;77;66;6;60;.909;3600000;0
711;166381;27;0;0;0;0;.00nan;0;0
711;175660;27;75;22;1;21;.955;3600000;0
711;86360;31;0;0;0;0;.00nan;0;0
712;168712;14;68;38;4;34;.895;3600000;0
712;175912;14;0;0;0;0;.00nan;0;0
712;85798;12;0;0;0;0;.00nan;0;0
712;91178;12;64;20;2;18;.900;3600000;0
713;65;11;82;34;3;31;.912;3587000;0
713;67;11;0;0;0;0;.00nan;0;0
713;9235;4838;0;0;0;0;.00nan;0;0
713;143749;4838;93;34;2;32;.941;3600000;0
714;173727;18;0;0;0;0;.00nan;0;0
714;169868;4182;0;0;0;0;.00nan;0;0
714;43757;18;82;30;1;29;.967;3600000;0
714;147945;4182;64;34;3;31;.912;3534000;0
715;17043;30;64;14;1;13;.929;3600000;0
715;36755;30;0;0;0;0;.00nan;0;0
715;69536;10;0;0;0;0;.00nan;0;0
715;152717;10;98;56;2;54;.964;3597000;0
716;163565;19;0;0;0;0;.00nan;0;0
716;14305;19;76;24;1;23;.958;3600000;0
716;58830;15;67;25;2;23;.920;3562000;0
716;85727;15;0;0;0;0;.00nan;0;0
717;175084;22;69;26;2;24;.923;3600000;0
717;46492;0;0;0;0;0;.00nan;0;0
717;143473;22;0;0;0;0;.00nan;0;0
717;149455;0;71;42;5;37;.881;3600000;0
718;166591;20;0;0;0;0;.00nan;0;0
718;163423;26;0;0;0;0;.00nan;0;0
718;179154;26;74;26;2;24;.923;3600000;0
718;86697;20;73;37;4;33;.892;3543000;0
719;166751;5;0;0;0;0;.00nan;0;0
719;178413;17;75;38;3;35;.921;3534000;0
719;176995;5;86;26;1;25;.962;3600000;0
719;146862;17;0;0;0;0;.00nan;0;0
720;166646;16;51;32;4;28;.875;4107000;0
720;165582;24;49;32;5;27;.844;4154000;0
720;168872;24;0;0;0;0;.00nan;0;0
720;50065;16;0;0;0;0;.00nan;0;0
721;169868;4182;59;27;3;24;.889;3543000;0
721;58830;15;68;24;2;22;.917;3600000;0
721;85727;15;0;0;0;0;.00nan;0;0
721;147945;4182;0;0;0;0;.00nan;0;0
722;171838;31;0;0;0;0;.00nan;0;0
722;2059;23;53;25;4;21;.840;3587000;0
722;14266;23;0;0;0;0;.00nan;0;0
722;86360;31;73;25;2;23;.920;3600000;0
723;1669;32;0;0;0;0;.00nan;0;0
723;13337;32;86;53;4;49;.925;3563000;0
723;183844;29;0;0;0;0;.00nan;0;0
723;37818;29;73;21;2;19;.905;3600000;0
724;676;34;0;0;0;0;.00nan;0;0
724;17043;30;65;31;3;28;.903;3600000;0
724;36755;30;0;0;0;0;.00nan;0;0
724;78806;34;54;30;4;26;.867;3519000;0
725;556;3;100;27;0;27;1.000;3600000;0
725;179344;3;0;0;0;0;.00nan;0;0
725;190465;33;0;0;0;0;.00nan;0;0
725;149452;33;38;29;5;24;.828;3600000;0
726;65762;35;0;0;0;0;.00nan;0;0
726;69536;10;0;0;0;0;.00nan;0;0
726;141998;35;84;35;2;33;.943;3600000;0
726;152717;10;62;36;4;32;.889;3600000;0
727;166381;27;0;0;0;0;.00nan;0;0
727;170314;25;76;35;3;32;.914;3582000;0
727;175660;27;78;30;2;28;.933;3600000;0
727;148958;25;0;0;0;0;.00nan;0;0
728;163565;19;65;27;2;25;.926;3572000;0
728;14305;19;0;0;0;0;.00nan;0;0
728;173727;18;0;0;0;0;.00nan;0;0
728;43757;18;98;37;1;36;.973;3600000;0
729;166646;16;0;0;0;0;.00nan;0;0
729;178413;17;0;0;0;0;.00nan;0;0
729;50065;16;48;23;4;19;.826;3600000;0
729;146862;17;86;32;1;31;.969;3600000;0
730;8424;28;0;0;0;0;.00nan;0;0
730;46492;0;89;31;1;30;.968;3600000;0
730;149455;0;0;0;0;0;.00nan;0;0
730;152835;28;73;29;2;27;.931;3561000;0
731;166751;5;43;23;4;19;.826;2194000;0
731;175084;22;0;0;0;0;.00nan;0;0
731;176995;5;25;26;5;21;.808;1406000;0
731;143473;22;76;8;0;8;1.000;3600000;0
732;165582;24;0;0;0;0;.00nan;0;0
732;17043;30;53;22;3;19;.864;3643000;0
732;168872;24;63;39;4;35;.897;3643000;0
732;36755;30;0;0;0;0;.00nan;0;0
733;163423;26;0;0;0;0;.00nan;0;0
733;168712;14;77;25;1;24;.960;4197000;0
733;179154;26;90;36;2;34;.944;4197000;0
733;175912;14;0;0;0;0;.00nan;0;0
734;65;11;83;37;2;35;.946;3524000;0
734;67;11;0;0;0;0;.00nan;0;0
734;85798;12;0;0;0;0;.00nan;0;0
734;91178;12;89;18;0;18;1.000;3600000;0
735;9235;4838;58;49;6;43;.878;3600000;0
735;86192;21;73;18;1;17;.944;3600000;0
735;143156;21;0;0;0;0;.00nan;0;0
735;143749;4838;0;0;0;0;.00nan;0;0
736;163695;9;0;0;0;0;.00nan;0;0
736;169868;4182;0;0;0;0;.00nan;0;0
736;175092;9;56;37;5;32;.865;3520000;0
736;147945;4182;61;28;3;25;.893;3600000;0
737;173727;18;100;46;2;44;.957;3700000;0
737;43757;18;0;0;0;0;.00nan;0;0
737;58830;15;63;31;3;28;.903;3700000;0
737;85727;15;0;0;0;0;.00nan;0;0
738;556;3;98;39;1;38;.974;3600000;0
738;179344;3;0;0;0;0;.00nan;0;0
738;65762;35;0;0;0;0;.00nan;0;0
738;141998;35;89;38;2;36;.947;3577000;0
739;171838;31;83;23;1;22;.957;3600000;0
739;1669;32;0;0;0;0;.00nan;0;0
739;13337;32;89;37;3;34;.919;3545000;0
739;86360;31;0;0;0;0;.00nan;0;0
740;166591;20;0;0;0;0;.00nan;0;0
740;183844;29;0;0;0;0;.00nan;0;0
740;37818;29;62;36;4;32;.889;3959000;0
740;86697;20;76;36;3;33;.917;3959000;0
741;13714;8;0;0;0;0;.00nan;0;0
741;18213;8;60;28;3;25;.893;3589000;0
741;168712;14;0;0;0;0;.00nan;0;0
741;175912;14;78;29;2;27;.931;3600000;0
742;2059;23;38;30;5;25;.833;3600000;0
742;14266;23;0;0;0;0;.00nan;0;0
742;170314;25;96;24;0;24;1.000;3600000;0
742;148958;25;0;0;0;0;.00nan;0;0
743;166381;27;0;0;0;0;.00nan;0;0
743;175660;27;79;13;0;13;1.000;3600000;0
743;85798;12;0;0;0;0;.00nan;0;0
743;91178;12;94;34;2;32;.941;3555000;0
744;163565;19;0;0;0;0;.00nan;0;0
744;163695;9;67;47;4;43;.915;4125000;0
744;14305;19;66;38;3;35;.921;4125000;0
744;175092;9;0;0;0;0;.00nan;0;0
745;676;34;0;0;0;0;.00nan;0;0
745;166591;20;84;38;3;35;.921;3600000;0
745;78806;34;31;22;5;17;.773;3498000;0
745;86697;20;0;0;0;0;.00nan;0;0
746;178413;17;0;0;0;0;.00nan;0;0
746;175084;22;0;0;0;0;.00nan;0;0
746;143473;22;67;18;1;17;.944;3600000;0
746;146862;17;86;41;3;38;.927;3547000;0
747;8424;28;0;0;0;0;.00nan;0;0
747;165582;24;77;26;1;25;.962;3600000;0
747;168872;24;0;0;0;0;.00nan;0;0
747;152835;28;68;27;2;25;.926;3600000;0
748;183844;29;46;32;5;27;.844;3570000;0
748;37818;29;0;0;0;0;.00nan;0;0
748;46492;0;84;27;2;25;.926;3600000;0
748;149455;0;0;0;0;0;.00nan;0;0
749;166751;5;66;42;5;37;.881;3600000;0
749;176995;5;0;0;0;0;.00nan;0;0
749;65762;35;94;31;1;30;.968;3600000;0
749;141998;35;0;0;0;0;.00nan;0;0
750;166646;16;0;0;0;0;.00nan;0;0
750;169868;4182;0;0;0;0;.00nan;0;0
750;50065;16;86;24;1;23;.958;3564000;0
750;147945;4182;100;28;0;28;1.000;3600000;0
751;163423;26;0;0;0;0;.00nan;0;0
751;179154;26;74;40;3;37;.925;3929000;0
751;190465;33;0;0;0;0;.00nan;0;0
751;149452;33;75;28;2;26;.929;3929000;0
752;65;11;46;23;4;19;.826;1161000;0
752;67;11;21;23;5;18;.783;2439000;0
752;86192;21;56;19;2;17;.895;3600000;0
752;143156;21;0;0;0;0;.00nan;0;0
753;9235;4838;76;31;2;29;.935;2442000;0
753;170314;25;28;13;4;9;.692;3600000;0
753;143749;4838;31;17;4;13;.765;1092000;0
753;148958;25;0;0;0;0;.00nan;0;0
754;17043;30;72;31;3;28;.903;4022000;0
754;36755;30;0;0;0;0;.00nan;0;0
754;58830;15;95;40;2;38;.950;4022000;0
754;85727;15;0;0;0;0;.00nan;0;0
755;556;3;77;30;2;28;.933;3600000;0
755;179344;3;0;0;0;0;.00nan;0;0
755;69536;10;71;44;5;39;.886;3600000;0
755;152717;10;0;0;0;0;.00nan;0;0
756;163565;19;54;11;1;10;.909;2494000;0
756;13714;8;0;0;0;0;.00nan;0;0
756;14305;19;23;11;4;7;.636;1106000;0
756;18213;8;59;26;4;22;.846;3600000;0
757;2059;23;85;33;2;31;.939;3582000;0
757;14266;23;0;0;0;0;.00nan;0;0
757;85798;12;0;0;0;0;.00nan;0;0
757;91178;12;100;26;0;26;1.000;3600000;0
758;183844;29;0;0;0;0;.00nan;0;0
758;175084;22;0;0;0;0;.00nan;0;0
758;37818;29;89;26;1;25;.962;4200000;0
758;143473;22;95;35;1;34;.971;4200000;0
759;166646;16;0;0;0;0;.00nan;0;0
759;168712;14;0;0;0;0;.00nan;0;0
759;175912;14;70;28;2;26;.929;3600000;0
759;50065;16;49;25;4;21;.840;3549000;0
760;9235;4838;0;0;0;0;.00nan;0;0
760;190465;33;0;0;0;0;.00nan;0;0
760;143749;4838;60;46;5;41;.891;3600000;0
760;149452;33;61;17;2;15;.882;3600000;0
761;163695;9;0;0;0;0;.00nan;0;0
761;173727;18;0;0;0;0;.00nan;0;0
761;175092;9;83;29;2;27;.931;3600000;0
761;43757;18;78;42;3;39;.929;3587000;0
762;166591;20;0;0;0;0;.00nan;0;0
762;65762;35;0;0;0;0;.00nan;0;0
762;86697;20;94;35;1;34;.971;3600000;0
762;141998;35;73;44;4;40;.909;3600000;0
763;178413;17;61;34;4;30;.882;3556000;0
763;17043;30;0;0;0;0;.00nan;0;0
763;36755;30;60;22;2;20;.909;3600000;0
763;146862;17;0;0;0;0;.00nan;0;0
764;46492;0;73;23;1;22;.957;3600000;0
764;58830;15;86;40;3;37;.925;3581000;0
764;85727;15;0;0;0;0;.00nan;0;0
764;149455;0;0;0;0;0;.00nan;0;0
765;8424;28;0;0;0;0;.00nan;0;0
765;69536;10;0;0;0;0;.00nan;0;0
765;152717;10;94;38;2;36;.947;3600000;0
765;152835;28;76;41;4;37;.902;3600000;0
766;676;34;0;0;0;0;.00nan;0;0
766;166751;5;0;0;0;0;.00nan;0;0
766;176995;5;81;39;3;36;.923;4200000;0
766;78806;34;70;33;3;30;.909;4200000;0
767;171838;31;92;32;1;31;.969;3600000;0
767;1669;32;0;0;0;0;.00nan;0;0
767;13337;32;51;24;3;21;.875;3553000;0
767;86360;31;0;0;0;0;.00nan;0;0
768;556;3;85;36;2;34;.944;3600000;0
768;165582;24;50;26;4;22;.846;3549000;0
768;168872;24;0;0;0;0;.00nan;0;0
768;179344;3;0;0;0;0;.00nan;0;0
769;163423;26;0;0;0;0;.00nan;0;0
769;169868;4182;0;0;0;0;.00nan;0;0
769;179154;26;72;27;2;25;.926;3600000;0
769;147945;4182;66;35;4;31;.886;3547000;0
770;65;11;78;42;3;39;.929;3600000;0
770;67;11;0;0;0;0;.00nan;0;0
770;170314;25;67;15;1;14;.933;3600000;0
770;148958;25;0;0;0;0;.00nan;0;0
771;166381;27;0;0;0;0;.00nan;0;0
771;175660;27;64;21;2;19;.905;4200000;0
771;86192;21;90;40;2;38;.950;4200000;0
771;143156;21;0;0;0;0;.00nan;0;0
772;163565;19;0;0;0;0;.00nan;0;0
772;14305;19;66;39;4;35;.897;3523000;0
772;85798;12;0;0;0;0;.00nan;0;0
772;91178;12;70;18;2;16;.889;3600000;0
773;2059;23;77;44;4;40;.909;3600000;0
773;14266;23;0;0;0;0;.00nan;0;0
773;86192;21;0;0;0;0;.00nan;0;0
773;143156;21;65;18;1;17;.944;3600000;0
774;190465;33;0;0;0;0;.00nan;0;0
774;46492;0;86;32;1;31;.969;4200000;0
774;149452;33;100;41;1;40;.976;4200000;0
774;149455;0;0;0;0;0;.00nan;0;0
775;85798;12;70;34;3;31;.912;4145000;0
775;86192;21;88;31;2;29;.935;4145000;0
775;91178;12;0;0;0;0;.00nan;0;0
775;143156;21;0;0;0;0;.00nan;0;0
776;2059;23;100;22;0;22;1.000;3600000;0
776;14266;23;0;0;0;0;.00nan;0;0
776;173727;18;76;32;2;30;.938;3594000;0
776;43757;18;0;0;0;0;.00nan;0;0
777;178413;17;0;0;0;0;.00nan;0;0
777;46492;0;78;33;3;30;.909;3600000;0
777;146862;17;56;42;7;35;.833;3600000;0
777;149455;0;0;0;0;0;.00nan;0;0
778;163565;19;71;38;3;35;.921;3600000;0
778;14305;19;0;0;0;0;.00nan;0;0
778;190465;33;0;0;0;0;.00nan;0;0
778;149452;33;52;26;4;22;.846;3562000;0
779;173727;18;97;37;1;36;.973;2924000;0
779;169868;4182;0;0;0;0;.00nan;0;0
779;43757;18;27;13;4;9;.692;676000;0
779;147945;4182;85;23;1;22;.957;3600000;0
780;13714;8;0;0;0;0;.00nan;0;0
780;18213;8;75;23;2;21;.913;3600000;0
780;58830;15;79;24;1;23;.958;3600000;0
780;85727;15;0;0;0;0;.00nan;0;0
781;171838;31;93;34;1;33;.971;3600000;0
781;165582;24;74;28;2;26;.929;3596000;0
781;168872;24;0;0;0;0;.00nan;0;0
781;86360;31;0;0;0;0;.00nan;0;0
782;65;11;91;45;3;42;.933;3600000;0
782;67;11;0;0;0;0;.00nan;0;0
782;183844;29;0;0;0;0;.00nan;0;0
782;37818;29;83;18;0;18;1.000;3600000;0
783;166646;16;0;0;0;0;.00nan;0;0
783;163695;9;0;0;0;0;.00nan;0;0
783;175092;9;77;28;2;26;.929;4200000;0
783;50065;16;68;28;2;26;.929;4200000;0
784;166591;20;0;0;0;0;.00nan;0;0
784;166381;27;0;0;0;0;.00nan;0;0
784;175660;27;73;25;1;24;.960;3600000;0
784;86697;20;73;33;2;31;.939;3550000;0
785;556;3;0;0;0;0;.00nan;0;0
785;179344;3;92;48;2;46;.958;3668000;0
785;175084;22;0;0;0;0;.00nan;0;0
785;143473;22;75;19;1;18;.947;3668000;0
786;676;34;71;32;3;29;.906;3623000;0
786;13714;8;63;30;4;26;.867;3623000;0
786;18213;8;0;0;0;0;.00nan;0;0
786;78806;34;0;0;0;0;.00nan;0;0
787;1669;32;0;0;0;0;.00nan;0;0
787;13337;32;82;36;3;33;.917;3833000;0
787;69536;10;70;35;4;31;.886;3833000;0
787;152717;10;0;0;0;0;.00nan;0;0
788;8424;28;0;0;0;0;.00nan;0;0
788;168712;14;0;0;0;0;.00nan;0;0
788;175912;14;61;23;3;20;.870;3600000;0
788;152835;28;49;28;4;24;.857;3543000;0
789;9235;4838;0;0;0;0;.00nan;0;0
789;17043;30;93;31;1;30;.968;3600000;0
789;36755;30;0;0;0;0;.00nan;0;0
789;143749;4838;90;40;2;38;.950;3579000;0
790;166751;5;95;29;1;28;.966;3563000;0
790;176995;5;0;0;0;0;.00nan;0;0
790;58830;15;100;37;0;37;1.000;3600000;0
790;85727;15;0;0;0;0;.00nan;0;0
791;171838;31;0;0;0;0;.00nan;0;0
791;166646;16;78;28;2;26;.929;3600000;0
791;50065;16;0;0;0;0;.00nan;0;0
791;86360;31;86;39;3;36;.923;3577000;0
792;163423;26;55;3;0;3;1.000;925000;0
792;170314;25;84;34;3;31;.912;3600000;0
792;179154;26;37;30;6;24;.800;2675000;0
792;148958;25;0;0;0;0;.00nan;0;0
793;166381;27;0;0;0;0;.00nan;0;0
793;183844;29;0;0;0;0;.00nan;0;0
793;175660;27;57;18;2;16;.889;3600000;0
793;37818;29;82;38;3;35;.921;3600000;0
794;556;3;94;28;1;27;.964;3600000;0
794;168712;14;0;0;0;0;.00nan;0;0
794;179344;3;0;0;0;0;.00nan;0;0
794;175912;14;45;31;5;26;.839;3600000;0
795;65;11;30;30;6;24;.800;3600000;0
795;67;11;0;0;0;0;.00nan;0;0
795;676;34;0;0;0;0;.00nan;0;0
795;78806;34;49;20;3;17;.850;3600000;0
796;1669;32;0;0;0;0;.00nan;0;0
796;13337;32;94;48;1;47;.979;3650000;0
796;175084;22;0;0;0;0;.00nan;0;0
796;143473;22;100;23;0;23;1.000;3650000;0
797;166751;5;0;0;0;0;.00nan;0;0
797;165582;24;0;0;0;0;.00nan;0;0
797;168872;24;57;24;2;22;.917;3600000;0
797;176995;5;75;37;3;34;.919;3552000;0
798;166591;20;0;0;0;0;.00nan;0;0
798;13714;8;0;0;0;0;.00nan;0;0
798;18213;8;38;22;4;18;.818;3600000;0
798;86697;20;92;33;1;32;.970;3600000;0
799;17043;30;75;33;3;30;.909;4055000;0
799;36755;30;0;0;0;0;.00nan;0;0
799;65762;35;0;0;0;0;.00nan;0;0
799;141998;35;83;30;2;28;.933;4055000;0
800;163423;26;0;0;0;0;.00nan;0;0
800;179154;26;52;31;4;27;.871;4002000;0
800;69536;10;0;0;0;0;.00nan;0;0
800;152717;10;52;37;5;32;.865;4002000;0
801;170314;25;82;31;2;29;.935;3570000;0
801;58830;15;75;23;1;22;.957;3600000;0
801;85727;15;0;0;0;0;.00nan;0;0
801;148958;25;0;0;0;0;.00nan;0;0
802;9235;4838;0;0;0;0;.00nan;0;0
802;169868;4182;0;0;0;0;.00nan;0;0
802;143749;4838;97;41;1;40;.976;4200000;0
802;147945;4182;100;27;1;26;.963;4200000;0
803;163695;9;79;37;4;33;.892;3600000;0
803;175092;9;0;0;0;0;.00nan;0;0
803;85798;12;0;0;0;0;.00nan;0;0
803;91178;12;63;19;2;17;.895;3600000;0
804;166381;27;0;0;0;0;.00nan;0;0
804;178413;17;0;0;0;0;.00nan;0;0
804;175660;27;61;24;3;21;.875;3600000;0
804;146862;17;74;42;4;38;.905;3566000;0
805;166646;16;0;0;0;0;.00nan;0;0
805;8424;28;65;40;4;36;.900;4200000;0
805;50065;16;57;25;4;21;.840;4185000;0
805;152835;28;0;0;0;0;.00nan;0;0
806;65;11;23;26;6;20;.769;3314000;0
806;67;11;59;6;0;6;1.000;286000;0
806;165582;24;73;32;3;29;.906;3600000;0
806;168872;24;0;0;0;0;.00nan;0;0
807;183844;29;0;0;0;0;.00nan;0;0
807;168712;14;72;34;4;30;.882;3600000;0
807;175912;14;0;0;0;0;.00nan;0;0
807;37818;29;96;20;0;20;1.000;3600000;0
808;556;3;95;22;0;22;1.000;3600000;0
808;13714;8;0;0;0;0;.00nan;0;0
808;18213;8;63;35;4;31;.886;3600000;0
808;179344;3;0;0;0;0;.00nan;0;0
809;676;34;0;0;0;0;.00nan;0;0
809;166591;20;0;0;0;0;.00nan;0;0
809;78806;34;83;39;3;36;.923;3559000;0
809;86697;20;73;27;2;25;.926;3600000;0
810;166751;5;70;35;3;32;.914;3715000;0
810;176995;5;0;0;0;0;.00nan;0;0
810;86192;21;87;28;2;26;.929;3715000;0
810;143156;21;0;0;0;0;.00nan;0;0
811;171838;31;51;43;6;37;.860;3600000;0
811;46492;0;100;36;0;36;1.000;3600000;0
811;86360;31;0;0;0;0;.00nan;0;0
811;149455;0;0;0;0;0;.00nan;0;0
812;2059;23;85;53;4;49;.925;3600000;0
812;14266;23;0;0;0;0;.00nan;0;0
812;175084;22;38;13;3;10;.769;3600000;0
812;143473;22;0;0;0;0;.00nan;0;0
813;1669;32;0;0;0;0;.00nan;0;0
813;13337;32;80;24;2;22;.917;3600000;0
813;69536;10;82;42;3;39;.929;3572000;0
813;152717;10;0;0;0;0;.00nan;0;0
814;190465;33;0;0;0;0;.00nan;0;0
814;65762;35;0;0;0;0;.00nan;0;0
814;141998;35;81;43;3;40;.930;3891000;0
814;149452;33;60;36;4;32;.889;3931000;0
815;163565;19;57;23;3;20;.870;3600000;0
815;9235;4838;21;23;6;17;.739;2215000;0
815;14305;19;0;0;0;0;.00nan;0;0
815;143749;4838;79;18;0;18;1.000;1385000;0
816;8424;28;0;0;0;0;.00nan;0;0
816;85798;12;0;0;0;0;.00nan;0;0
816;91178;12;84;15;0;15;1.000;3600000;0
816;152835;28;97;46;1;45;.978;3600000;0
817;166381;27;100;32;0;32;1.000;3600000;0
817;168712;14;0;0;0;0;.00nan;0;0
817;175660;27;0;0;0;0;.00nan;0;0
817;175912;14;83;34;1;33;.971;3551000;0
818;676;34;73;30;3;27;.900;3600000;0
818;2059;23;36;12;3;9;.750;525000;0
818;14266;23;29;26;6;20;.769;3075000;0
818;78806;34;0;0;0;0;.00nan;0;0
819;65;11;76;28;2;26;.929;3600000;0
819;67;11;0;0;0;0;.00nan;0;0
819;58830;15;71;30;3;27;.900;3590000;0
819;85727;15;0;0;0;0;.00nan;0;0
820;175084;22;0;0;0;0;.00nan;0;0
820;65762;35;0;0;0;0;.00nan;0;0
820;141998;35;90;46;3;43;.935;3600000;0
820;143473;22;87;16;1;15;.938;3600000;0
821;163423;26;49;9;1;8;.889;967000;0
821;17043;30;96;29;1;28;.966;3600000;0
821;179154;26;27;29;6;23;.793;2633000;0
821;36755;30;0;0;0;0;.00nan;0;0
822;166751;5;66;38;4;34;.895;3600000;0
822;183844;29;0;0;0;0;.00nan;0;0
822;176995;5;0;0;0;0;.00nan;0;0
822;37818;29;100;33;0;33;1.000;3600000;0
823;163565;19;62;40;5;35;.875;3807000;0
823;163695;9;71;42;4;38;.905;3807000;0
823;14305;19;0;0;0;0;.00nan;0;0
823;175092;9;0;0;0;0;.00nan;0;0
824;8424;28;0;0;0;0;.00nan;0;0
824;169868;4182;0;0;0;0;.00nan;0;0
824;147945;4182;78;29;3;26;.897;3600000;0
824;152835;28;56;35;4;31;.886;3600000;0
825;46492;0;89;19;0;19;1.000;3600000;0
825;86192;21;48;46;7;39;.848;3600000;0
825;143156;21;0;0;0;0;.00nan;0;0
825;149455;0;0;0;0;0;.00nan;0;0
826;171838;31;31;34;7;27;.794;3600000;0
826;85798;12;0;0;0;0;.00nan;0;0
826;86360;31;0;0;0;0;.00nan;0;0
826;91178;12;76;29;2;27;.931;3600000;0
827;13714;8;0;0;0;0;.00nan;0;0
827;18213;8;100;40;1;39;.975;4200000;0
827;168712;14;67;18;1;17;.944;4200000;0
827;175912;14;0;0;0;0;.00nan;0;0
828;2059;23;60;31;4;27;.871;3581000;0
828;165582;24;0;0;0;0;.00nan;0;0
828;14266;23;0;0;0;0;.00nan;0;0
828;168872;24;73;33;3;30;.909;3600000;0
829;166591;20;0;0;0;0;.00nan;0;0
829;166646;16;0;0;0;0;.00nan;0;0
829;50065;16;49;23;4;19;.826;3554000;0
829;86697;20;84;34;3;31;.912;3600000;0
830;676;34;0;0;0;0;.00nan;0;0
830;190465;33;0;0;0;0;.00nan;0;0
830;78806;34;73;40;4;36;.900;3600000;0
830;149452;33;52;23;3;20;.870;3600000;0
831;166381;27;79;21;1;20;.952;3600000;0
831;170314;25;34;29;6;23;.793;1963000;0
831;175660;27;0;0;0;0;.00nan;0;0
831;148958;25;62;15;1;14;.933;1637000;0
832;9235;4838;0;0;0;0;.00nan;0;0
832;178413;17;0;0;0;0;.00nan;0;0
832;143749;4838;47;31;5;26;.839;3550000;0
832;146862;17;62;33;4;29;.879;3600000;0
833;556;3;50;21;3;18;.857;3546000;0
833;179344;3;0;0;0;0;.00nan;0;0
833;69536;10;0;0;0;0;.00nan;0;0
833;152717;10;95;40;2;38;.950;3600000;0
834;1669;32;0;0;0;0;.00nan;0;0
834;13337;32;78;10;0;10;1.000;3600000;0
834;173727;18;98;46;2;44;.957;3535000;0
834;43757;18;0;0;0;0;.00nan;0;0
835;163423;26;0;0;0;0;.00nan;0;0
835;179154;26;88;40;2;38;.950;3600000;0
835;65762;35;0;0;0;0;.00nan;0;0
835;141998;35;92;34;1;33;.971;3600000;0
836;2059;23;96;53;3;50;.943;3545000;0
836;14266;23;0;0;0;0;.00nan;0;0
836;183844;29;0;0;0;0;.00nan;0;0
836;37818;29;71;22;2;20;.909;3600000;0
837;556;3;29;33;7;26;.788;2902000;0
837;163695;9;0;0;0;0;.00nan;0;0
837;179344;3;56;5;0;5;1.000;615000;0
837;175092;9;56;41;5;36;.878;3600000;0
838;676;34;0;0;0;0;.00nan;0;0
838;163565;19;52;28;4;24;.857;3600000;0
838;14305;19;0;0;0;0;.00nan;0;0
838;78806;34;98;19;0;19;1.000;3600000;0
839;8424;28;0;0;0;0;.00nan;0;0
839;58830;15;59;21;2;19;.905;3523000;0
839;85727;15;0;0;0;0;.00nan;0;0
839;152835;28;100;36;0;36;1.000;3600000;0
840;169868;4182;0;0;0;0;.00nan;0;0
840;46492;0;65;18;2;16;.889;3600000;0
840;147945;4182;62;37;4;33;.892;3573000;0
840;149455;0;0;0;0;0;.00nan;0;0
841;166751;5;0;0;0;0;.00nan;0;0
841;13714;8;0;0;0;0;.00nan;0;0
841;18213;8;79;13;0;13;1.000;3600000;0
841;176995;5;59;43;5;38;.884;3600000;0
842;171838;31;0;0;0;0;.00nan;0;0
842;175084;22;0;0;0;0;.00nan;0;0
842;86360;31;83;43;3;40;.930;3600000;0
842;143473;22;58;27;4;23;.852;3600000;0
843;9235;4838;0;0;0;0;.00nan;0;0
843;85798;12;0;0;0;0;.00nan;0;0
843;91178;12;55;29;4;25;.862;3600000;0
843;143749;4838;99;39;1;38;.974;3600000;0
844;170314;25;73;33;2;31;.939;3600000;0
844;69536;10;80;35;3;32;.914;3600000;0
844;148958;25;0;0;0;0;.00nan;0;0
844;152717;10;0;0;0;0;.00nan;0;0
845;65;11;0;0;0;0;.00nan;0;0
845;67;11;40;28;5;23;.821;3600000;0
845;173727;18;0;0;0;0;.00nan;0;0
845;43757;18;79;24;1;23;.958;3600000;0
846;166646;16;0;0;0;0;.00nan;0;0
846;190465;33;63;22;2;20;.909;2435000;0
846;50065;16;72;26;2;24;.923;3600000;0
846;149452;33;16;7;4;3;.429;1165000;0
847;166381;27;0;0;0;0;.00nan;0;0
847;178413;17;0;0;0;0;.00nan;0;0
847;175660;27;61;11;1;10;.909;3600000;0
847;146862;17;62;42;5;37;.881;3600000;0
848;166591;20;0;0;0;0;.00nan;0;0
848;65762;35;0;0;0;0;.00nan;0;0
848;86697;20;61;31;3;28;.903;3568000;0
848;141998;35;86;29;1;28;.966;3600000;0
849;166646;16;0;0;0;0;.00nan;0;0
849;9235;4838;0;0;0;0;.00nan;0;0
849;50065;16;74;24;2;22;.917;3600000;0
849;143749;4838;61;34;4;30;.882;3513000;0
850;170314;25;61;21;2;19;.905;3600000;0
850;46492;0;55;33;4;29;.879;3553000;0
850;148958;25;0;0;0;0;.00nan;0;0
850;149455;0;0;0;0;0;.00nan;0;0
851;65;11;100;23;0;23;1.000;3600000;0
851;67;11;0;0;0;0;.00nan;0;0
851;178413;17;0;0;0;0;.00nan;0;0
851;146862;17;89;36;1;35;.972;3555000;0
852;163565;19;0;0;0;0;.00nan;0;0
852;14305;19;98;49;2;47;.959;3600000;0
852;183844;29;0;0;0;0;.00nan;0;0
852;37818;29;71;21;1;20;.952;3600000;0
853;163423;26;0;0;0;0;.00nan;0;0
853;163695;9;99;55;1;54;.982;3600000;0
853;179154;26;39;22;4;18;.818;3600000;0
853;175092;9;0;0;0;0;.00nan;0;0
854;190465;33;0;0;0;0;.00nan;0;0
854;85798;12;0;0;0;0;.00nan;0;0
854;91178;12;78;26;1;25;.962;3600000;0
854;149452;33;90;30;2;28;.933;3565000;0
855;556;3;74;24;2;22;.917;3600000;0
855;166751;5;77;40;4;36;.900;3520000;0
855;179344;3;0;0;0;0;.00nan;0;0
855;176995;5;0;0;0;0;.00nan;0;0
856;8424;28;0;0;0;0;.00nan;0;0
856;168712;14;64;24;3;21;.875;3600000;0
856;175912;14;0;0;0;0;.00nan;0;0
856;152835;28;44;23;4;19;.826;3600000;0
857;171838;31;24;16;5;11;.688;3000000;0
857;169868;4182;0;0;0;0;.00nan;0;0
857;86360;31;42;4;1;3;.750;600000;0
857;147945;4182;74;30;3;27;.900;3600000;0
858;676;34;0;0;0;0;.00nan;0;0
858;175084;22;0;0;0;0;.00nan;0;0
858;78806;34;100;60;3;57;.950;4200000;0
858;143473;22;55;16;3;13;.813;4200000;0
859;1669;32;0;0;0;0;.00nan;0;0
859;13337;32;88;48;3;45;.938;4200000;0
859;166381;27;0;0;0;0;.00nan;0;0
859;175660;27;60;26;3;23;.885;4200000;0
860;173727;18;78;52;4;48;.923;3547000;0
860;43757;18;0;0;0;0;.00nan;0;0
860;86192;21;56;20;2;18;.900;3600000;0
860;143156;21;0;0;0;0;.00nan;0;0
861;166591;20;56;30;4;26;.867;3576000;0
861;17043;30;73;33;3;30;.909;3600000;0
861;36755;30;0;0;0;0;.00nan;0;0
861;86697;20;0;0;0;0;.00nan;0;0
862;165582;24;90;33;2;31;.939;3770000;0
862;168872;24;0;0;0;0;.00nan;0;0
862;58830;15;79;26;1;25;.962;3770000;0
862;85727;15;0;0;0;0;.00nan;0;0
863;13714;8;0;0;0;0;.00nan;0;0
863;18213;8;66;26;2;24;.923;3600000;0
863;65762;35;0;0;0;0;.00nan;0;0
863;141998;35;86;34;4;30;.882;3560000;0
864;163565;19;78;39;2;37;.949;3574000;0
864;14305;19;0;0;0;0;.00nan;0;0
864;69536;10;0;0;0;0;.00nan;0;0
864;152717;10;68;18;1;17;.944;3600000;0
865;163695;9;0;0;0;0;.00nan;0;0
865;169868;4182;0;0;0;0;.00nan;0;0
865;175092;9;79;34;2;32;.941;3600000;0
865;147945;4182;74;42;4;38;.905;3536000;0
866;166646;16;0;0;0;0;.00nan;0;0
866;183844;29;0;0;0;0;.00nan;0;0
866;37818;29;92;35;1;34;.971;3600000;0
866;50065;16;43;31;5;26;.839;3600000;0
867;171838;31;0;0;0;0;.00nan;0;0
867;85798;12;0;0;0;0;.00nan;0;0
867;86360;31;86;31;1;30;.968;3579000;0
867;91178;12;100;28;0;28;1.000;3600000;0
868;163423;26;0;0;0;0;.00nan;0;0
868;166381;27;0;0;0;0;.00nan;0;0
868;179154;26;58;39;5;34;.872;3572000;0
868;175660;27;73;31;3;28;.903;3600000;0
869;2059;23;0;0;0;0;.00nan;0;0
869;14266;23;58;25;3;22;.880;3551000;0
869;178413;17;0;0;0;0;.00nan;0;0
869;146862;17;92;40;2;38;.950;3600000;0
870;9235;4838;84;34;3;31;.912;3600000;0
870;65762;35;35;20;4;16;.800;3600000;0
870;141998;35;0;0;0;0;.00nan;0;0
870;143749;4838;0;0;0;0;.00nan;0;0
871;65;11;28;23;5;18;.783;3600000;0
871;67;11;0;0;0;0;.00nan;0;0
871;1669;32;0;0;0;0;.00nan;0;0
871;13337;32;77;19;1;18;.947;3600000;0
872;17043;30;98;35;1;34;.971;3600000;0
872;173727;18;61;23;2;21;.913;3556000;0
872;36755;30;0;0;0;0;.00nan;0;0
872;43757;18;0;0;0;0;.00nan;0;0
873;166591;20;0;0;0;0;.00nan;0;0
873;170314;25;67;24;2;22;.917;3600000;0
873;86697;20;53;36;5;31;.861;3600000;0
873;148958;25;0;0;0;0;.00nan;0;0
874;166751;5;60;45;5;40;.889;3595000;0
874;176995;5;0;0;0;0;.00nan;0;0
874;46492;0;81;31;3;28;.903;3600000;0
874;149455;0;0;0;0;0;.00nan;0;0
875;556;3;25;15;5;10;.667;1825000;0
875;179344;3;67;22;2;20;.909;1775000;0
875;46492;0;96;36;1;35;.972;3600000;0
875;149455;0;0;0;0;0;.00nan;0;0
876;166646;16;73;37;4;33;.892;3570000;0
876;50065;16;0;0;0;0;.00nan;0;0
876;58830;15;69;25;2;23;.920;3600000;0
876;85727;15;0;0;0;0;.00nan;0;0
877;165582;24;0;0;0;0;.00nan;0;0
877;168872;24;100;28;0;28;1.000;3600000;0
877;69536;10;87;28;1;27;.964;3569000;0
877;152717;10;0;0;0;0;.00nan;0;0
878;676;34;0;0;0;0;.00nan;0;0
878;168712;14;73;25;2;23;.920;3600000;0
878;175912;14;0;0;0;0;.00nan;0;0
878;78806;34;92;43;3;40;.930;3547000;0
879;1669;32;42;32;5;27;.844;3536000;0
879;163423;26;60;27;3;24;.889;3600000;0
879;13337;32;0;0;0;0;.00nan;0;0
879;179154;26;0;0;0;0;.00nan;0;0
880;13714;8;0;0;0;0;.00nan;0;0
880;166381;27;100;29;1;28;.966;3600000;0
880;18213;8;78;31;2;29;.935;3569000;0
880;175660;27;0;0;0;0;.00nan;0;0
881;17043;30;0;0;0;0;.00nan;0;0
881;190465;33;0;0;0;0;.00nan;0;0
881;36755;30;75;27;2;25;.926;3600000;0
881;149452;33;79;45;4;41;.911;3550000;0
882;163565;19;47;25;4;21;.840;3600000;0
882;14305;19;0;0;0;0;.00nan;0;0
882;86192;21;74;22;1;21;.955;3600000;0
882;143156;21;0;0;0;0;.00nan;0;0
883;163695;9;91;34;1;33;.971;3600000;0
883;8424;28;0;0;0;0;.00nan;0;0
883;175092;9;0;0;0;0;.00nan;0;0
883;152835;28;72;29;3;26;.897;3581000;0
884;170314;25;90;39;1;38;.974;3600000;0
884;175084;22;0;0;0;0;.00nan;0;0
884;143473;22;27;21;5;16;.762;3600000;0
884;148958;25;0;0;0;0;.00nan;0;0
885;169868;4182;0;0;0;0;.00nan;0;0
885;86192;21;0;0;0;0;.00nan;0;0
885;143156;21;63;38;3;35;.921;4200000;0
885;147945;4182;82;40;3;37;.925;4200000;0
886;171838;31;62;35;4;31;.886;3600000;0
886;65762;35;0;0;0;0;.00nan;0;0
886;86360;31;0;0;0;0;.00nan;0;0
886;141998;35;38;39;7;32;.821;3600000;0
887;9235;4838;0;0;0;0;.00nan;0;0
887;183844;29;0;0;0;0;.00nan;0;0
887;37818;29;69;19;1;18;.947;3637000;0
887;143749;4838;78;29;2;27;.931;3637000;0
888;556;3;89;33;1;32;.970;3600000;0
888;166591;20;0;0;0;0;.00nan;0;0
888;179344;3;0;0;0;0;.00nan;0;0
888;86697;20;54;30;4;26;.867;3600000;0
889;13714;8;0;0;0;0;.00nan;0;0
889;178413;17;76;28;2;26;.929;3600000;0
889;18213;8;93;26;1;25;.962;3600000;0
889;146862;17;0;0;0;0;.00nan;0;0
890;676;34;75;29;2;27;.931;3600000;0
890;58830;15;74;37;3;34;.919;3600000;0
890;78806;34;0;0;0;0;.00nan;0;0
890;85727;15;0;0;0;0;.00nan;0;0
891;166646;16;0;0;0;0;.00nan;0;0
891;46492;0;95;39;3;36;.923;4200000;0
891;50065;16;82;40;3;37;.925;4200000;0
891;149455;0;0;0;0;0;.00nan;0;0
892;8424;28;82;37;2;35;.946;3600000;0
892;69536;10;0;0;0;0;.00nan;0;0
892;152717;10;65;32;4;28;.875;3559000;0
892;152835;28;0;0;0;0;.00nan;0;0
893;166751;5;80;29;2;27;.931;3544000;0
893;168712;14;68;18;1;17;.944;3600000;0
893;175912;14;0;0;0;0;.00nan;0;0
893;176995;5;0;0;0;0;.00nan;0;0
894;165582;24;0;0;0;0;.00nan;0;0
894;168872;24;82;45;3;42;.933;3600000;0
894;85798;12;0;0;0;0;.00nan;0;0
894;91178;12;100;25;0;25;1.000;3600000;0
895;65;11;79;48;4;44;.917;3560000;0
895;67;11;0;0;0;0;.00nan;0;0
895;183844;29;56;17;2;15;.882;3600000;0
895;37818;29;0;0;0;0;.00nan;0;0
896;2059;23;65;44;5;39;.886;3530000;0
896;14266;23;0;0;0;0;.00nan;0;0
896;166381;27;0;0;0;0;.00nan;0;0
896;175660;27;74;32;3;29;.906;3600000;0
897;171838;31;0;0;0;0;.00nan;0;0
897;17043;30;65;36;4;32;.889;3570000;0
897;36755;30;0;0;0;0;.00nan;0;0
897;86360;31;91;42;2;40;.952;3600000;0
898;163565;19;98;32;0;32;1.000;3600000;0
898;14305;19;0;0;0;0;.00nan;0;0
898;190465;33;0;0;0;0;.00nan;0;0
898;149452;33;79;39;4;35;.897;3600000;0
899;163695;9;83;38;3;35;.921;4191000;0
899;175092;9;0;0;0;0;.00nan;0;0
899;86192;21;65;39;3;36;.923;4200000;0
899;143156;21;0;0;0;0;.00nan;0;0
900;1669;32;0;0;0;0;.00nan;0;0
900;13337;32;90;29;1;28;.966;3600000;0
900;170314;25;56;22;2;20;.909;3600000;0
900;148958;25;0;0;0;0;.00nan;0;0
901;163423;26;0;0;0;0;.00nan;0;0
901;9235;4838;0;0;0;0;.00nan;0;0
901;179154;26;82;24;1;23;.958;3600000;0
901;143749;4838;92;38;2;36;.947;3544000;0
902;676;34;0;0;0;0;.00nan;0;0
902;8424;28;61;15;1;14;.933;1241000;0
902;78806;34;68;20;1;19;.950;3600000;0
902;152835;28;45;25;4;21;.840;2359000;0
903;166751;5;48;32;5;27;.844;3600000;0
903;165582;24;0;0;0;0;.00nan;0;0
903;168872;24;92;35;1;34;.971;3600000;0
903;176995;5;0;0;0;0;.00nan;0;0
904;175084;22;85;25;1;24;.960;3600000;0
904;58830;15;88;47;3;44;.936;3564000;0
904;85727;15;0;0;0;0;.00nan;0;0
904;143473;22;0;0;0;0;.00nan;0;0
905;556;3;72;35;3;32;.914;3600000;0
905;168712;14;40;20;4;16;.800;2140000;0
905;179344;3;0;0;0;0;.00nan;0;0
905;175912;14;51;6;1;5;.833;1389000;0
906;166591;20;77;33;3;30;.909;3972000;0
906;166646;16;0;0;0;0;.00nan;0;0
906;50065;16;51;31;4;27;.871;3972000;0
906;86697;20;0;0;0;0;.00nan;0;0
907;171838;31;91;40;2;38;.950;3600000;0
907;13714;8;0;0;0;0;.00nan;0;0
907;18213;8;100;27;0;27;1.000;3600000;0
907;86360;31;0;0;0;0;.00nan;0;0
908;178413;17;0;0;0;0;.00nan;0;0
908;85798;12;0;0;0;0;.00nan;0;0
908;91178;12;77;32;3;29;.906;3600000;0
908;146862;17;54;38;5;33;.868;3561000;0
909;17043;30;62;27;3;24;.889;3569000;0
909;36755;30;0;0;0;0;.00nan;0;0
909;46492;0;87;35;2;33;.943;3600000;0
909;149455;0;0;0;0;0;.00nan;0;0
910;166381;27;0;0;0;0;.00nan;0;0
910;183844;29;0;0;0;0;.00nan;0;0
910;175660;27;60;34;3;31;.912;3554000;0
910;37818;29;91;28;1;27;.964;3600000;0
911;65;11;67;19;1;18;.947;3600000;0
911;67;11;0;0;0;0;.00nan;0;0
911;9235;4838;75;36;3;33;.917;3575000;0
911;143749;4838;0;0;0;0;.00nan;0;0
912;2059;23;70;31;3;28;.903;3600000;0
912;163423;26;41;28;5;23;.821;3548000;0
912;14266;23;0;0;0;0;.00nan;0;0
912;179154;26;0;0;0;0;.00nan;0;0
913;173727;18;0;0;0;0;.00nan;0;0
913;190465;33;0;0;0;0;.00nan;0;0
913;43757;18;83;34;2;32;.941;3675000;0
913;149452;33;56;24;3;21;.875;3665000;0
914;163565;19;60;35;4;31;.886;3550000;0
914;14305;19;0;0;0;0;.00nan;0;0
914;169868;4182;0;0;0;0;.00nan;0;0
914;147945;4182;84;31;3;28;.903;3600000;0
915;676;34;46;19;3;16;.842;3600000;0
915;166751;5;0;0;0;0;.00nan;0;0
915;176995;5;62;42;4;38;.905;3577000;0
915;78806;34;0;0;0;0;.00nan;0;0
916;175084;22;0;0;0;0;.00nan;0;0
916;69536;10;0;0;0;0;.00nan;0;0
916;143473;22;76;23;1;22;.957;3600000;0
916;152717;10;70;46;5;41;.891;3600000;0
917;166591;20;0;0;0;0;.00nan;0;0
917;163695;9;0;0;0;0;.00nan;0;0
917;175092;9;73;24;2;22;.917;3600000;0
917;86697;20;53;26;3;23;.885;3600000;0
918;58830;15;68;31;3;28;.903;3576000;0
918;85727;15;0;0;0;0;.00nan;0;0
918;86192;21;97;28;1;27;.964;3600000;0
918;143156;21;0;0;0;0;.00nan;0;0
919;178413;17;88;43;3;40;.930;3647000;0
919;170314;25;85;31;2;29;.935;3647000;0
919;146862;17;0;0;0;0;.00nan;0;0
919;148958;25;0;0;0;0;.00nan;0;0
920;1669;32;0;0;0;0;.00nan;0;0
920;13337;32;78;50;6;44;.880;3600000;0
920;65762;35;55;22;3;19;.864;3600000;0
920;141998;35;0;0;0;0;.00nan;0;0
921;169868;4182;42;35;6;29;.829;3600000;0
921;190465;33;0;0;0;0;.00nan;0;0
921;147945;4182;0;0;0;0;.00nan;0;0
921;149452;33;73;35;3;32;.914;3600000;0
922;168712;14;0;0;0;0;.00nan;0;0
922;175912;14;53;40;5;35;.875;3561000;0
922;46492;0;92;36;3;33;.917;3600000;0
922;149455;0;0;0;0;0;.00nan;0;0
923;166646;16;0;0;0;0;.00nan;0;0
923;165582;24;0;0;0;0;.00nan;0;0
923;168872;24;77;41;3;38;.927;3541000;0
923;50065;16;100;33;1;32;.970;3600000;0
924;163565;19;72;29;2;27;.931;4151000;0
924;9235;4838;0;0;0;0;.00nan;0;0
924;14305;19;0;0;0;0;.00nan;0;0
924;143749;4838;94;63;3;60;.952;4151000;0
925;2059;23;65;35;4;31;.886;3600000;0
925;14266;23;0;0;0;0;.00nan;0;0
925;183844;29;0;0;0;0;.00nan;0;0
925;37818;29;87;28;1;27;.964;3600000;0
926;178413;17;0;0;0;0;.00nan;0;0
926;168712;14;65;39;5;34;.872;3600000;0
926;175912;14;0;0;0;0;.00nan;0;0
926;146862;17;99;40;1;39;.975;3600000;0
927;556;3;50;8;1;7;.875;1298000;0
927;163695;9;0;0;0;0;.00nan;0;0
927;179344;3;41;27;5;22;.815;2302000;0
927;175092;9;100;37;1;36;.973;3600000;0
928;8424;28;0;0;0;0;.00nan;0;0
928;65762;35;0;0;0;0;.00nan;0;0
928;141998;35;49;28;4;24;.857;3566000;0
928;152835;28;70;25;2;23;.920;3600000;0
929;166751;5;28;25;6;19;.760;2163000;0
929;175084;22;0;0;0;0;.00nan;0;0
929;176995;5;63;18;2;16;.889;1437000;0
929;143473;22;88;15;0;15;1.000;3600000;0
930;171838;31;84;30;1;29;.967;3600000;0
930;17043;30;81;33;2;31;.939;3551000;0
930;36755;30;0;0;0;0;.00nan;0;0
930;86360;31;0;0;0;0;.00nan;0;0
931;166591;20;0;0;0;0;.00nan;0;0
931;163423;26;0;0;0;0;.00nan;0;0
931;179154;26;91;34;1;33;.971;4033000;0
931;86697;20;92;41;2;39;.951;4033000;0
932;190465;33;73;26;1;25;.962;3600000;0
932;46492;0;82;31;2;29;.935;3600000;0
932;149452;33;0;0;0;0;.00nan;0;0
932;149455;0;0;0;0;0;.00nan;0;0
933;1669;32;0;0;0;0;.00nan;0;0
933;13337;32;100;42;1;41;.976;4200000;0
933;85798;12;0;0;0;0;.00nan;0;0
933;91178;12;71;22;1;21;.955;4200000;0
934;65;11;65;23;2;21;.913;3600000;0
934;67;11;0;0;0;0;.00nan;0;0
934;163565;19;0;0;0;0;.00nan;0;0
934;14305;19;78;35;3;32;.914;3600000;0
935;166646;16;63;40;5;35;.875;3600000;0
935;13714;8;0;0;0;0;.00nan;0;0
935;18213;8;80;25;1;24;.960;3600000;0
935;50065;16;0;0;0;0;.00nan;0;0
936;166381;27;0;0;0;0;.00nan;0;0
936;175660;27;73;26;1;25;.962;3600000;0
936;69536;10;0;0;0;0;.00nan;0;0
936;152717;10;70;31;3;28;.903;3563000;0
937;676;34;0;0;0;0;.00nan;0;0
937;173727;18;78;32;2;30;.938;3600000;0
937;43757;18;0;0;0;0;.00nan;0;0
937;78806;34;69;28;3;25;.893;3546000;0
938;58830;15;73;47;5;42;.894;3600000;0
938;85727;15;0;0;0;0;.00nan;0;0
938;86192;21;93;29;2;27;.931;3600000;0
938;143156;21;0;0;0;0;.00nan;0;0
939;9235;4838;0;0;0;0;.00nan;0;0
939;85798;12;0;0;0;0;.00nan;0;0
939;91178;12;87;29;1;28;.966;4008000;0
939;143749;4838;100;29;0;29;1.000;4008000;0
940;183844;29;0;0;0;0;.00nan;0;0
940;17043;30;77;32;3;29;.906;3560000;0
940;36755;30;0;0;0;0;.00nan;0;0
940;37818;29;85;27;1;26;.963;3600000;0
941;166591;20;55;4;0;4;1.000;518000;0
941;86192;21;0;0;0;0;.00nan;0;0
941;86697;20;25;30;7;23;.767;3082000;0
941;143156;21;63;30;3;27;.900;3600000;0
942;165582;24;0;0;0;0;.00nan;0;0
942;178413;17;0;0;0;0;.00nan;0;0
942;168872;24;36;31;5;26;.839;3600000;0
942;146862;17;99;42;1;41;.976;3600000;0
943;556;3;78;30;3;27;.900;3595000;0
943;8424;28;0;0;0;0;.00nan;0;0
943;179344;3;0;0;0;0;.00nan;0;0
943;152835;28;87;31;2;29;.935;3600000;0
944;166751;5;66;35;4;31;.886;3733000;0
944;163695;9;0;0;0;0;.00nan;0;0
944;175092;9;37;27;5;22;.815;3733000;0
944;176995;5;0;0;0;0;.00nan;0;0
945;171838;31;0;0;0;0;.00nan;0;0
945;65762;35;0;0;0;0;.00nan;0;0
945;86360;31;100;39;1;38;.974;3600000;0
945;141998;35;52;32;4;28;.875;3600000;0
946;166646;16;0;0;0;0;.00nan;0;0
946;1669;32;0;0;0;0;.00nan;0;0
946;13337;32;99;49;2;47;.959;3600000;0
946;50065;16;67;34;4;30;.882;3539000;0
947;163423;26;0;0;0;0;.00nan;0;0
947;179154;26;86;35;2;33;.943;3679000;0
947;190465;33;0;0;0;0;.00nan;0;0
947;149452;33;63;32;3;29;.906;3679000;0
948;13714;8;0;0;0;0;.00nan;0;0
948;18213;8;90;34;1;33;.971;3600000;0
948;170314;25;82;34;2;32;.941;3557000;0
948;148958;25;0;0;0;0;.00nan;0;0
949;2059;23;0;0;0;0;.00nan;0;0
949;14266;23;57;34;4;30;.882;3600000;0
949;69536;10;0;0;0;0;.00nan;0;0
949;152717;10;100;35;1;34;.971;3600000;0
950;163565;19;47;30;4;26;.867;3600000;0
950;14305;19;0;0;0;0;.00nan;0;0
950;166381;27;0;0;0;0;.00nan;0;0
950;175660;27;61;25;3;22;.880;3600000;0
951;173727;18;0;0;0;0;.00nan;0;0
951;169868;4182;0;0;0;0;.00nan;0;0
951;43757;18;94;41;2;39;.951;3665000;0
951;147945;4182;70;32;3;29;.906;3665000;0
952;46492;0;0;0;0;0;.00nan;0;0
952;65762;35;52;39;5;34;.872;3600000;0
952;141998;35;0;0;0;0;.00nan;0;0
952;149455;0;73;27;2;25;.926;3600000;0
953;168712;14;71;58;6;52;.897;3600000;0
953;175084;22;0;0;0;0;.00nan;0;0
953;175912;14;0;0;0;0;.00nan;0;0
953;143473;22;68;22;2;20;.909;3600000;0
954;676;34;0;0;0;0;.00nan;0;0
954;169868;4182;51;33;5;28;.848;3582000;0
954;78806;34;80;39;4;35;.897;3600000;0
954;147945;4182;0;0;0;0;.00nan;0;0
955;166591;20;79;41;3;38;.927;4124000;0
955;1669;32;0;0;0;0;.00nan;0;0
955;13337;32;84;32;2;30;.938;4124000;0
955;86697;20;0;0;0;0;.00nan;0;0
956;165582;24;0;0;0;0;.00nan;0;0
956;183844;29;0;0;0;0;.00nan;0;0
956;168872;24;74;30;2;28;.933;3600000;0
956;37818;29;68;32;3;29;.906;3600000;0
957;2059;23;68;23;2;21;.913;3560000;0
957;9235;4838;0;0;0;0;.00nan;0;0
957;14266;23;0;0;0;0;.00nan;0;0
957;143749;4838;100;36;0;36;1.000;3600000;0
958;13714;8;0;0;0;0;.00nan;0;0
958;18213;8;64;28;3;25;.893;3600000;0
958;190465;33;0;0;0;0;.00nan;0;0
958;149452;33;100;38;0;38;1.000;3600000;0
959;163695;9;56;39;5;34;.872;4200000;0
959;17043;30;33;26;5;21;.808;4200000;0
959;175092;9;0;0;0;0;.00nan;0;0
959;36755;30;0;0;0;0;.00nan;0;0
960;556;3;73;19;1;18;.947;3600000;0
960;178413;17;76;38;3;35;.921;3569000;0
960;179344;3;0;0;0;0;.00nan;0;0
960;146862;17;0;0;0;0;.00nan;0;0
961;175084;22;99;19;0;19;1.000;3600000;0
961;46492;0;98;39;1;38;.974;3548000;0
961;143473;22;0;0;0;0;.00nan;0;0
961;149455;0;0;0;0;0;.00nan;0;0
962;166751;5;0;0;0;0;.00nan;0;0
962;8424;28;0;0;0;0;.00nan;0;0
962;176995;5;45;32;5;27;.844;3600000;0
962;152835;28;62;21;2;19;.905;3600000;0
963;171838;31;90;32;1;31;.969;3600000;0
963;58830;15;76;26;2;24;.923;3600000;0
963;85727;15;0;0;0;0;.00nan;0;0
963;86360;31;0;0;0;0;.00nan;0;0
964;170314;25;52;27;4;23;.852;3600000;0
964;86192;21;60;36;5;31;.861;3600000;0
964;143156;21;0;0;0;0;.00nan;0;0
964;148958;25;0;0;0;0;.00nan;0;0
965;166646;16;0;0;0;0;.00nan;0;0
965;173727;18;53;30;4;26;.867;3600000;0
965;43757;18;0;0;0;0;.00nan;0;0
965;50065;16;88;17;0;17;1.000;3600000;0
966;163423;26;0;0;0;0;.00nan;0;0
966;179154;26;73;34;3;31;.912;3647000;0
966;85798;12;0;0;0;0;.00nan;0;0
966;91178;12;87;31;2;29;.935;3647000;0
967;65;11;82;41;3;38;.927;4200000;0
967;67;11;0;0;0;0;.00nan;0;0
967;69536;10;0;0;0;0;.00nan;0;0
967;152717;10;58;31;3;28;.903;4200000;0
968;168712;14;61;31;4;27;.871;3600000;0
968;175912;14;0;0;0;0;.00nan;0;0
968;65762;35;33;4;2;2;.500;272000;0
968;141998;35;45;35;6;29;.829;3328000;0
969;676;34;50;1;0;1;1.000;504000;0
969;163565;19;66;35;4;31;.886;3600000;0
969;14305;19;0;0;0;0;.00nan;0;0
969;78806;34;28;27;6;21;.778;2985000;0
970;1669;32;37;27;5;22;.815;3600000;0
970;163695;9;0;0;0;0;.00nan;0;0
970;13337;32;0;0;0;0;.00nan;0;0
970;175092;9;93;39;2;37;.949;3600000;0
971;163423;26;76;23;1;22;.957;3600000;0
971;173727;18;0;0;0;0;.00nan;0;0
971;179154;26;0;0;0;0;.00nan;0;0
971;43757;18;76;40;3;37;.925;3595000;0
972;166381;27;0;0;0;0;.00nan;0;0
972;169868;4182;0;0;0;0;.00nan;0;0
972;175660;27;100;33;1;32;.970;3600000;0
972;147945;4182;56;33;5;28;.848;3600000;0
973;9235;4838;0;0;0;0;.00nan;0;0
973;69536;10;85;36;2;34;.944;4132000;0
973;143749;4838;84;38;3;35;.921;4132000;0
973;152717;10;0;0;0;0;.00nan;0;0
974;17043;30;63;28;3;25;.893;3569000;0
974;36755;30;0;0;0;0;.00nan;0;0
974;86192;21;82;32;2;30;.938;3600000;0
974;143156;21;0;0;0;0;.00nan;0;0
975;556;3;59;35;4;31;.886;3600000;0
975;179344;3;0;0;0;0;.00nan;0;0
975;58830;15;80;37;2;35;.946;3600000;0
975;85727;15;0;0;0;0;.00nan;0;0
976;175084;22;0;0;0;0;.00nan;0;0
976;85798;12;0;0;0;0;.00nan;0;0
976;91178;12;80;38;3;35;.921;4101000;0
976;143473;22;49;29;4;25;.862;4101000;0
977;171838;31;0;0;0;0;.00nan;0;0
977;183844;29;0;0;0;0;.00nan;0;0
977;37818;29;74;30;2;28;.933;3600000;0
977;86360;31;46;38;6;32;.842;3600000;0
978;13714;8;0;0;0;0;.00nan;0;0
978;18213;8;92;40;3;37;.925;3561000;0
978;170314;25;90;33;1;32;.970;3600000;0
978;148958;25;0;0;0;0;.00nan;0;0
979;65;11;39;26;5;21;.808;3591000;0
979;67;11;0;0;0;0;.00nan;0;0
979;2059;23;71;32;4;28;.875;3600000;0
979;14266;23;0;0;0;0;.00nan;0;0
980;9235;4838;90;30;1;29;.967;3600000;0
980;183844;29;49;25;3;22;.880;3553000;0
980;37818;29;0;0;0;0;.00nan;0;0
980;143749;4838;0;0;0;0;.00nan;0;0
981;556;3;98;43;1;42;.977;4200000;0
981;676;34;86;31;1;30;.968;4200000;0
981;179344;3;0;0;0;0;.00nan;0;0
981;78806;34;0;0;0;0;.00nan;0;0
982;69536;10;82;19;0;19;1.000;1241000;0
982;86192;21;0;0;0;0;.00nan;0;0
982;143156;21;48;23;4;19;.826;3600000;0
982;152717;10;55;36;5;31;.861;2309000;0
983;165582;24;0;0;0;0;.00nan;0;0
983;168872;24;60;21;2;19;.905;3643000;0
983;85798;12;0;0;0;0;.00nan;0;0
983;91178;12;85;28;1;27;.964;3643000;0
984;8424;28;0;0;0;0;.00nan;0;0
984;190465;33;0;0;0;0;.00nan;0;0
984;149452;33;61;29;4;25;.862;3600000;0
984;152835;28;74;25;1;24;.960;3600000;0
985;1669;32;0;0;0;0;.00nan;0;0
985;2059;23;0;0;0;0;.00nan;0;0
985;13337;32;90;43;3;40;.930;3556000;0
985;14266;23;68;21;2;19;.905;3600000;0
986;170314;25;90;32;1;31;.969;3600000;0
986;65762;35;79;32;2;30;.938;3551000;0
986;141998;35;0;0;0;0;.00nan;0;0
986;148958;25;0;0;0;0;.00nan;0;0
987;163565;19;32;28;6;22;.786;3600000;0
987;14305;19;0;0;0;0;.00nan;0;0
987;166381;27;0;0;0;0;.00nan;0;0
987;175660;27;78;21;1;20;.952;3600000;0
988;166646;16;0;0;0;0;.00nan;0;0
988;173727;18;36;33;6;27;.818;3067000;0
988;43757;18;45;5;1;4;.800;533000;0
988;50065;16;62;26;3;23;.885;3600000;0
989;171838;31;80;34;2;32;.941;3600000;0
989;163695;9;51;27;3;24;.889;3543000;0
989;175092;9;0;0;0;0;.00nan;0;0
989;86360;31;0;0;0;0;.00nan;0;0
990;13714;8;0;0;0;0;.00nan;0;0
990;178413;17;0;0;0;0;.00nan;0;0
990;18213;8;73;22;2;20;.909;4200000;0
990;146862;17;98;42;2;40;.952;4200000;0
991;169868;4182;0;0;0;0;.00nan;0;0
991;46492;0;93;31;1;30;.968;3600000;0
991;147945;4182;59;26;3;23;.885;3531000;0
991;149455;0;0;0;0;0;.00nan;0;0
992;171838;31;0;0;0;0;.00nan;0;0
992;183844;29;0;0;0;0;.00nan;0;0
992;37818;29;36;20;4;16;.800;3600000;0
992;86360;31;100;47;3;44;.936;3600000;0
993;166591;20;0;0;0;0;.00nan;0;0
993;8424;28;0;0;0;0;.00nan;0;0
993;86697;20;56;36;5;31;.861;3588000;0
993;152835;28;56;25;3;22;.880;3600000;0
994;9235;4838;0;0;0;0;.00nan;0;0
994;86192;21;63;35;4;31;.886;3600000;0
994;143156;21;0;0;0;0;.00nan;0;0
994;143749;4838;74;46;5;41;.891;3549000;0
995;556;3;80;28;2;26;.929;3600000;0
995;179344;3;0;0;0;0;.00nan;0;0
995;175084;22;0;0;0;0;.00nan;0;0
995;143473;22;68;31;3;28;.903;3568000;0
996;676;34;0;0;0;0;.00nan;0;0
996;78806;34;82;31;2;29;.935;3600000;0
996;85798;12;0;0;0;0;.00nan;0;0
996;91178;12;56;26;3;23;.885;3574000;0
997;168712;14;88;30;1;29;.967;3600000;0
997;175912;14;0;0;0;0;.00nan;0;0
997;69536;10;0;0;0;0;.00nan;0;0
997;152717;10;65;18;2;16;.889;3555000;0
998;65;11;40;33;5;28;.848;3600000;0
998;67;11;0;0;0;0;.00nan;0;0
998;166751;5;93;38;2;36;.947;3600000;0
998;176995;5;0;0;0;0;.00nan;0;0
999;163695;9;0;0;0;0;.00nan;0;0
999;175092;9;64;25;2;23;.920;3600000;0
999;190465;33;0;0;0;0;.00nan;0;0
999;149452;33;61;27;4;23;.852;3594000;0
1000;163423;26;0;0;0;0;.00nan;0;0
1000;179154;26;95;38;1;37;.974;3600000;0
1000;65762;35;0;0;0;0;.00nan;0;0
1000;141998;35;67;26;3;23;.885;3578000;0
1001;166381;27;0;0;0;0;.00nan;0;0
1001;17043;30;79;37;3;34;.919;3543000;0
1001;175660;27;83;33;2;31;.939;3600000;0
1001;36755;30;0;0;0;0;.00nan;0;0
1002;163565;19;39;35;6;29;.829;3600000;0
1002;14305;19;0;0;0;0;.00nan;0;0
1002;46492;0;81;32;2;30;.938;3600000;0
1002;149455;0;0;0;0;0;.00nan;0;0
1003;165582;24;0;0;0;0;.00nan;0;0
1003;168872;24;47;20;3;17;.850;3600000;0
1003;173727;18;42;45;7;38;.844;3600000;0
1003;43757;18;0;0;0;0;.00nan;0;0
1004;178413;17;0;0;0;0;.00nan;0;0
1004;65762;35;100;25;0;25;1.000;3600000;0
1004;141998;35;0;0;0;0;.00nan;0;0
1004;146862;17;41;38;6;32;.842;3600000;0
1005;163423;26;47;29;4;25;.862;3597000;0
1005;13714;8;0;0;0;0;.00nan;0;0
1005;18213;8;100;37;2;35;.946;3600000;0
1005;179154;26;0;0;0;0;.00nan;0;0
1006;166646;16;0;0;0;0;.00nan;0;0
1006;169868;4182;0;0;0;0;.00nan;0;0
1006;50065;16;78;42;3;39;.929;4200000;0
1006;147945;4182;60;32;3;29;.906;4200000;0
1007;1669;32;0;0;0;0;.00nan;0;0
1007;2059;23;0;0;0;0;.00nan;0;0
1007;13337;32;72;22;2;20;.909;3547000;0
1007;14266;23;100;33;1;32;.970;3600000;0
1008;163695;9;70;39;5;34;.872;3645000;0
1008;9235;4838;0;0;0;0;.00nan;0;0
1008;175092;9;0;0;0;0;.00nan;0;0
1008;143749;4838;39;36;6;30;.833;3645000;0
1009;190465;33;0;0;0;0;.00nan;0;0
1009;86192;21;93;35;2;33;.943;3600000;0
1009;143156;21;0;0;0;0;.00nan;0;0
1009;149452;33;57;35;5;30;.857;3600000;0
1010;676;34;0;0;0;0;.00nan;0;0
1010;166591;20;0;0;0;0;.00nan;0;0
1010;78806;34;83;39;3;36;.923;4200000;0
1010;86697;20;55;27;3;24;.889;4191000;0
1011;183844;29;0;0;0;0;.00nan;0;0
1011;37818;29;50;19;3;16;.842;3600000;0
1011;69536;10;0;0;0;0;.00nan;0;0
1011;152717;10;70;43;4;39;.907;3600000;0
1012;65;11;91;58;4;54;.931;3600000;0
1012;67;11;0;0;0;0;.00nan;0;0
1012;556;3;88;24;1;23;.958;3600000;0
1012;179344;3;0;0;0;0;.00nan;0;0
1013;171838;31;0;0;0;0;.00nan;0;0
1013;8424;28;67;35;3;32;.914;3600000;0
1013;86360;31;50;34;4;30;.882;3552000;0
1013;152835;28;0;0;0;0;.00nan;0;0
1014;173727;18;0;0;0;0;.00nan;0;0
1014;43757;18;100;51;3;48;.941;4200000;0
1014;46492;0;54;22;3;19;.864;4200000;0
1014;149455;0;0;0;0;0;.00nan;0;0
1015;166751;5;75;45;4;41;.911;3600000;0
1015;175084;22;0;0;0;0;.00nan;0;0
1015;176995;5;0;0;0;0;.00nan;0;0
1015;143473;22;64;14;2;12;.857;3600000;0
1016;168712;14;0;0;0;0;.00nan;0;0
1016;170314;25;99;31;1;30;.968;3600000;0
1016;175912;14;55;35;5;30;.857;3600000;0
1016;148958;25;0;0;0;0;.00nan;0;0
1017;58830;15;96;35;1;34;.971;3600000;0
1017;85727;15;0;0;0;0;.00nan;0;0
1017;85798;12;0;0;0;0;.00nan;0;0
1017;91178;12;70;23;2;21;.913;3545000;0
1018;1669;32;0;0;0;0;.00nan;0;0
1018;13337;32;71;33;2;31;.939;4200000;0
1018;166381;27;0;0;0;0;.00nan;0;0
1018;175660;27;73;28;2;26;.929;4200000;0
1019;178413;17;78;42;3;39;.929;3573000;0
1019;17043;30;0;0;0;0;.00nan;0;0
1019;36755;30;73;25;2;23;.920;3600000;0
1019;146862;17;0;0;0;0;.00nan;0;0
1020;166646;16;41;34;6;28;.824;3600000;0
1020;163565;19;81;26;1;25;.962;3600000;0
1020;14305;19;0;0;0;0;.00nan;0;0
1020;50065;16;0;0;0;0;.00nan;0;0
1021;9235;4838;65;33;4;29;.879;3600000;0
1021;69536;10;50;33;5;28;.848;3560000;0
1021;143749;4838;0;0;0;0;.00nan;0;0
1021;152717;10;0;0;0;0;.00nan;0;0
1022;163423;26;0;0;0;0;.00nan;0;0
1022;179154;26;56;34;5;29;.853;3593000;0
1022;190465;33;0;0;0;0;.00nan;0;0
1022;149452;33;80;37;4;33;.892;3600000;0
1023;65;11;40;24;4;20;.833;3559000;0
1023;67;11;0;0;0;0;.00nan;0;0
1023;166591;20;60;30;3;27;.900;3600000;0
1023;86697;20;0;0;0;0;.00nan;0;0
1024;170314;25;47;19;3;16;.842;3549000;0
1024;65762;35;99;41;1;40;.976;3600000;0
1024;141998;35;0;0;0;0;.00nan;0;0
1024;148958;25;0;0;0;0;.00nan;0;0
1025;165582;24;0;0;0;0;.00nan;0;0
1025;168872;24;74;38;4;34;.895;3901000;0
1025;169868;4182;0;0;0;0;.00nan;0;0
1025;147945;4182;85;34;3;31;.912;3901000;0
1026;183844;29;0;0;0;0;.00nan;0;0
1026;37818;29;100;25;0;25;1.000;3600000;0
1026;85798;12;0;0;0;0;.00nan;0;0
1026;91178;12;82;22;1;21;.955;3600000;0
1027;676;34;0;0;0;0;.00nan;0;0
1027;58830;15;81;41;3;38;.927;3549000;0
1027;78806;34;77;31;2;29;.935;3600000;0
1027;85727;15;0;0;0;0;.00nan;0;0
1028;1669;32;0;0;0;0;.00nan;0;0
1028;13337;32;93;50;2;48;.960;3586000;0
1028;168712;14;100;29;0;29;1.000;3600000;0
1028;175912;14;0;0;0;0;.00nan;0;0
1029;163565;19;76;37;3;34;.919;3558000;0
1029;165582;24;86;38;2;36;.947;3600000;0
1029;14305;19;0;0;0;0;.00nan;0;0
1029;168872;24;0;0;0;0;.00nan;0;0
1030;163695;9;0;0;0;0;.00nan;0;0
1030;178413;17;0;0;0;0;.00nan;0;0
1030;175092;9;86;27;1;26;.963;3600000;0
1030;146862;17;43;22;3;19;.864;3525000;0
1031;166591;20;0;0;0;0;.00nan;0;0
1031;58830;15;89;18;0;18;1.000;3600000;0
1031;85727;15;0;0;0;0;.00nan;0;0
1031;86697;20;94;39;2;37;.949;3557000;0
1032;8424;28;0;0;0;0;.00nan;0;0
1032;86192;21;60;19;2;17;.895;3600000;0
1032;143156;21;0;0;0;0;.00nan;0;0
1032;152835;28;100;34;0;34;1.000;3600000;0
1033;46492;0;61;24;3;21;.875;4014000;0
1033;69536;10;0;0;0;0;.00nan;0;0
1033;149455;0;0;0;0;0;.00nan;0;0
1033;152717;10;80;47;4;43;.915;4014000;0
1034;173727;18;99;41;1;40;.976;3600000;0
1034;175084;22;0;0;0;0;.00nan;0;0
1034;43757;18;0;0;0;0;.00nan;0;0
1034;143473;22;45;21;4;17;.810;3600000;0
1035;556;3;46;20;3;17;.850;3600000;0
1035;166646;16;0;0;0;0;.00nan;0;0
1035;179344;3;0;0;0;0;.00nan;0;0
1035;50065;16;100;31;0;31;1.000;3600000;0
1036;163423;26;55;23;3;20;.870;3462000;0
1036;179154;26;22;4;3;1;.250;138000;0
1036;65762;35;0;0;0;0;.00nan;0;0
1036;141998;35;84;31;1;30;.968;3600000;0
1037;169868;4182;0;0;0;0;.00nan;0;0
1037;170314;25;62;26;3;23;.885;3600000;0
1037;147945;4182;89;36;2;34;.944;3600000;0
1037;148958;25;0;0;0;0;.00nan;0;0
1038;65;11;0;0;0;0;.00nan;0;0
1038;67;11;90;38;2;36;.947;4200000;0
1038;13714;8;0;0;0;0;.00nan;0;0
1038;18213;8;100;32;2;30;.938;4200000;0
1039;2059;23;56;24;3;21;.875;3600000;0
1039;14266;23;0;0;0;0;.00nan;0;0
1039;17043;30;96;36;1;35;.972;3600000;0
1039;36755;30;0;0;0;0;.00nan;0;0
1040;163565;19;34;30;6;24;.800;3600000;0
1040;14305;19;0;0;0;0;.00nan;0;0
1040;85798;12;82;37;2;35;.946;3600000;0
1040;91178;12;0;0;0;0;.00nan;0;0
1041;1669;32;0;0;0;0;.00nan;0;0
1041;13337;32;83;37;3;34;.919;3579000;0
1041;190465;33;0;0;0;0;.00nan;0;0
1041;149452;33;84;34;2;32;.941;3600000;0
1042;9235;4838;40;7;2;5;.714;346000;0
1042;168712;14;68;21;2;19;.905;3600000;0
1042;175912;14;0;0;0;0;.00nan;0;0
1042;143749;4838;45;38;6;32;.842;3254000;0
1043;13714;8;0;0;0;0;.00nan;0;0
1043;166381;27;0;0;0;0;.00nan;0;0
1043;18213;8;96;35;1;34;.971;3600000;0
1043;175660;27;48;15;3;12;.800;3550000;0
1044;163695;9;0;0;0;0;.00nan;0;0
1044;165582;24;0;0;0;0;.00nan;0;0
1044;168872;24;76;32;2;30;.938;3600000;0
1044;175092;9;45;41;6;35;.854;3600000;0
1045;556;3;77;20;1;19;.950;3600000;0
1045;166591;20;0;0;0;0;.00nan;0;0
1045;179344;3;0;0;0;0;.00nan;0;0
1045;86697;20;71;36;3;33;.917;3600000;0
1046;46492;0;92;34;2;32;.941;3574000;0
1046;86192;21;95;21;0;21;1.000;3600000;0
1046;143156;21;0;0;0;0;.00nan;0;0
1046;149455;0;0;0;0;0;.00nan;0;0
1047;178413;17;0;0;0;0;.00nan;0;0
1047;65762;35;48;15;3;12;.800;3600000;0
1047;141998;35;0;0;0;0;.00nan;0;0
1047;146862;17;62;37;4;33;.892;3549000;0
1048;8424;28;0;0;0;0;.00nan;0;0
1048;183844;29;0;0;0;0;.00nan;0;0
1048;37818;29;66;30;3;27;.900;4200000;0
1048;152835;28;73;39;3;36;.923;4200000;0
1049;171838;31;0;0;0;0;.00nan;0;0
1049;175084;22;55;19;2;17;.895;3600000;0
1049;86360;31;88;51;3;48;.941;3566000;0
1049;143473;22;0;0;0;0;.00nan;0;0
1050;173727;18;87;42;2;40;.952;3600000;0
1050;43757;18;0;0;0;0;.00nan;0;0
1050;69536;10;0;0;0;0;.00nan;0;0
1050;152717;10;83;33;3;30;.909;3600000;0
1051;166751;5;0;0;0;0;.00nan;0;0
1051;176995;5;54;22;3;19;.864;3600000;0
1051;58830;15;90;17;0;17;1.000;3600000;0
1051;85727;15;0;0;0;0;.00nan;0;0
1052;676;34;0;0;0;0;.00nan;0;0
1052;166646;16;0;0;0;0;.00nan;0;0
1052;50065;16;100;24;0;24;1.000;3600000;0
1052;78806;34;71;30;2;28;.933;3550000;0
1053;163423;26;0;0;0;0;.00nan;0;0
1053;169868;4182;0;0;0;0;.00nan;0;0
1053;179154;26;100;31;1;30;.968;3600000;0
1053;147945;4182;74;31;2;29;.935;3600000;0
1054;65;11;66;25;2;23;.920;3545000;0
1054;67;11;0;0;0;0;.00nan;0;0
1054;17043;30;76;24;1;23;.958;3600000;0
1054;36755;30;0;0;0;0;.00nan;0;0
1055;2059;23;0;0;0;0;.00nan;0;0
1055;14266;23;51;30;5;25;.833;3550000;0
1055;168712;14;30;15;4;11;.733;3600000;0
1055;175912;14;0;0;0;0;.00nan;0;0
1056;1669;32;0;0;0;0;.00nan;0;0
1056;13337;32;71;24;2;22;.917;3600000;0
1056;169868;4182;49;22;3;19;.864;3584000;0
1056;147945;4182;0;0;0;0;.00nan;0;0
1057;163565;19;59;33;4;29;.879;3574000;0
1057;14305;19;0;0;0;0;.00nan;0;0
1057;170314;25;71;35;3;32;.914;3600000;0
1057;148958;25;0;0;0;0;.00nan;0;0
1058;163695;9;15;20;6;14;.700;2831000;0
1058;178413;17;73;29;2;27;.931;3600000;0
1058;175092;9;50;8;1;7;.875;769000;0
1058;146862;17;0;0;0;0;.00nan;0;0
1059;165582;24;0;0;0;0;.00nan;0;0
1059;168872;24;91;38;2;36;.947;3600000;0
1059;46492;0;64;29;3;26;.897;3544000;0
1059;149455;0;0;0;0;0;.00nan;0;0
1060;58830;15;76;42;5;37;.881;4200000;0
1060;69536;10;60;36;5;31;.861;4200000;0
1060;85727;15;0;0;0;0;.00nan;0;0
1060;152717;10;0;0;0;0;.00nan;0;0
1061;676;34;0;0;0;0;.00nan;0;0
1061;65762;35;72;36;3;33;.917;3600000;0
1061;78806;34;42;31;5;26;.839;3571000;0
1061;141998;35;0;0;0;0;.00nan;0;0
1062;556;3;62;20;2;18;.900;3600000;0
1062;166751;5;73;44;5;39;.886;3600000;0
1062;179344;3;0;0;0;0;.00nan;0;0
1062;176995;5;0;0;0;0;.00nan;0;0
1063;183844;29;52;9;1;8;.889;721000;0
1063;175084;22;0;0;0;0;.00nan;0;0
1063;37818;29;27;28;7;21;.750;2879000;0
1063;143473;22;62;23;2;21;.913;3600000;0
1064;173727;18;74;51;5;46;.902;3567000;0
1064;43757;18;0;0;0;0;.00nan;0;0
1064;86192;21;60;28;3;25;.893;3600000;0
1064;143156;21;0;0;0;0;.00nan;0;0
1065;65;11;75;31;3;28;.903;3586000;0
1065;67;11;0;0;0;0;.00nan;0;0
1065;8424;28;0;0;0;0;.00nan;0;0
1065;152835;28;80;29;2;27;.931;3600000;0
1066;166591;20;74;27;2;25;.926;3710000;0
1066;171838;31;0;0;0;0;.00nan;0;0
1066;86360;31;72;30;3;27;.900;3710000;0
1066;86697;20;0;0;0;0;.00nan;0;0
1067;166646;16;0;0;0;0;.00nan;0;0
1067;163565;19;0;0;0;0;.00nan;0;0
1067;14305;19;50;21;3;18;.857;3517000;0
1067;50065;16;76;28;1;27;.964;3600000;0
1068;163423;26;0;0;0;0;.00nan;0;0
1068;179154;26;90;45;3;42;.933;3556000;0
1068;85798;12;0;0;0;0;.00nan;0;0
1068;91178;12;95;36;2;34;.944;3600000;0
1069;9235;4838;0;0;0;0;.00nan;0;0
1069;13714;8;0;0;0;0;.00nan;0;0
1069;18213;8;90;33;2;31;.939;4200000;0
1069;143749;4838;96;45;2;43;.956;4200000;0
1070;2059;23;94;39;2;37;.949;3611000;0
1070;14266;23;0;0;0;0;.00nan;0;0
1070;190465;33;0;0;0;0;.00nan;0;0
1070;149452;33;64;13;1;12;.923;3611000;0
1071;166381;27;0;0;0;0;.00nan;0;0
1071;168712;14;83;39;3;36;.923;3600000;0
1071;175660;27;100;28;0;28;1.000;3600000;0
1071;175912;14;0;0;0;0;.00nan;0;0
1072;165582;24;35;30;6;24;.800;2826000;0
1072;168872;24;51;5;1;4;.800;774000;0
1072;58830;15;60;15;2;13;.867;3600000;0
1072;85727;15;0;0;0;0;.00nan;0;0
1073;676;34;66;35;3;32;.914;3492000;0
1073;17043;30;65;24;2;22;.917;3600000;0
1073;36755;30;0;0;0;0;.00nan;0;0
1073;78806;34;0;0;0;0;.00nan;0;0
1074;1669;32;0;0;0;0;.00nan;0;0
1074;13337;32;97;39;1;38;.974;4200000;0
1074;86192;21;0;0;0;0;.00nan;0;0
1074;143156;21;95;37;1;36;.973;4200000;0
1075;173727;18;0;0;0;0;.00nan;0;0
1075;170314;25;75;40;4;36;.900;3827000;0
1075;43757;18;81;37;3;34;.919;3827000;0
1075;148958;25;0;0;0;0;.00nan;0;0
1076;166591;20;0;0;0;0;.00nan;0;0
1076;46492;0;66;19;1;18;.947;3600000;0
1076;86697;20;63;39;4;35;.897;3600000;0
1076;149455;0;0;0;0;0;.00nan;0;0
1077;178413;17;0;0;0;0;.00nan;0;0
1077;69536;10;0;0;0;0;.00nan;0;0
1077;146862;17;81;40;3;37;.925;3600000;0
1077;152717;10;71;27;2;25;.926;3600000;0
1078;169868;4182;0;0;0;0;.00nan;0;0
1078;85798;12;0;0;0;0;.00nan;0;0
1078;91178;12;69;34;4;30;.882;3600000;0
1078;147945;4182;62;15;1;14;.933;3600000;0
1079;65;11;92;53;5;48;.906;4200000;0
1079;67;11;0;0;0;0;.00nan;0;0
1079;168712;14;57;35;5;30;.857;4200000;0
1079;175912;14;0;0;0;0;.00nan;0;0
1080;2059;23;57;34;5;29;.853;3583000;0
1080;163695;9;76;29;3;26;.897;3600000;0
1080;14266;23;0;0;0;0;.00nan;0;0
1080;175092;9;0;0;0;0;.00nan;0;0
1081;183844;29;0;0;0;0;.00nan;0;0
1081;37818;29;98;38;2;36;.947;3555000;0
1081;46492;0;100;23;0;23;1.000;3600000;0
1081;149455;0;0;0;0;0;.00nan;0;0
1082;178413;17;0;0;0;0;.00nan;0;0
1082;86192;21;64;22;2;20;.909;3600000;0
1082;143156;21;0;0;0;0;.00nan;0;0
1082;146862;17;56;37;5;32;.865;3600000;0
1083;676;34;100;28;0;28;1.000;3600000;0
1083;69536;10;52;18;3;15;.833;1284000;0
1083;78806;34;0;0;0;0;.00nan;0;0
1083;152717;10;53;34;5;29;.853;2316000;0
1084;1669;32;0;0;0;0;.00nan;0;0
1084;13337;32;79;33;4;29;.879;3581000;0
1084;58830;15;67;25;2;23;.920;3600000;0
1084;85727;15;0;0;0;0;.00nan;0;0
1085;171838;31;0;0;0;0;.00nan;0;0
1085;175084;22;0;0;0;0;.00nan;0;0
1085;86360;31;54;36;5;31;.861;3600000;0
1085;143473;22;87;17;0;17;1.000;3600000;0
1086;166591;20;69;55;6;49;.891;3600000;0
1086;165582;24;0;0;0;0;.00nan;0;0
1086;168872;24;79;26;2;24;.923;3600000;0
1086;86697;20;0;0;0;0;.00nan;0;0
1087;173727;18;100;39;1;38;.974;3600000;0
1087;190465;33;0;0;0;0;.00nan;0;0
1087;43757;18;0;0;0;0;.00nan;0;0
1087;149452;33;57;32;4;28;.875;3600000;0
1088;13714;8;0;0;0;0;.00nan;0;0
1088;18213;8;61;36;4;32;.889;3569000;0
1088;85798;12;0;0;0;0;.00nan;0;0
1088;91178;12;98;38;2;36;.947;3600000;0
1089;8424;28;0;0;0;0;.00nan;0;0
1089;9235;4838;0;0;0;0;.00nan;0;0
1089;143749;4838;51;29;4;25;.862;3600000;0
1089;152835;28;83;33;2;31;.939;3600000;0
1090;163423;26;0;0;0;0;.00nan;0;0
1090;169868;4182;0;0;0;0;.00nan;0;0
1090;179154;26;77;25;1;24;.960;3600000;0
1090;147945;4182;56;28;4;24;.857;3600000;0
1091;163565;19;90;36;3;33;.917;3600000;0
1091;14305;19;0;0;0;0;.00nan;0;0
1091;170314;25;76;38;4;34;.895;3546000;0
1091;148958;25;0;0;0;0;.00nan;0;0
1092;163695;9;0;0;0;0;.00nan;0;0
1092;166381;27;0;0;0;0;.00nan;0;0
1092;175092;9;77;53;5;48;.906;3600000;0
1092;175660;27;55;15;2;13;.867;3600000;0
1093;166751;5;34;31;6;25;.806;3600000;0
1093;17043;30;100;29;0;29;1.000;3600000;0
1093;176995;5;0;0;0;0;.00nan;0;0
1093;36755;30;0;0;0;0;.00nan;0;0
1094;171838;31;100;36;1;35;.972;3600000;0
1094;168712;14;64;27;3;24;.889;3538000;0
1094;175912;14;0;0;0;0;.00nan;0;0
1094;86360;31;0;0;0;0;.00nan;0;0
1095;166646;16;39;29;5;24;.828;3600000;0
1095;50065;16;0;0;0;0;.00nan;0;0
1095;65762;35;40;42;6;36;.857;3600000;0
1095;141998;35;0;0;0;0;.00nan;0;0
1096;163423;26;89;34;2;32;.941;3600000;0
1096;163565;19;0;0;0;0;.00nan;0;0
1096;14305;19;71;32;3;29;.906;3598000;0
1096;179154;26;0;0;0;0;.00nan;0;0
1097;183844;29;0;0;0;0;.00nan;0;0
1097;37818;29;100;29;0;29;1.000;3600000;0
1097;58830;15;72;24;2;22;.917;3563000;0
1097;85727;15;0;0;0;0;.00nan;0;0
1098;166591;20;0;0;0;0;.00nan;0;0
1098;175084;22;0;0;0;0;.00nan;0;0
1098;86697;20;50;36;5;31;.861;3569000;0
1098;143473;22;41;15;4;11;.733;3600000;0
1099;165582;24;0;0;0;0;.00nan;0;0
1099;178413;17;0;0;0;0;.00nan;0;0
1099;168872;24;79;33;2;31;.939;3544000;0
1099;146862;17;92;29;1;28;.966;3600000;0
1100;556;3;61;20;2;18;.900;3600000;0
1100;179344;3;0;0;0;0;.00nan;0;0
1100;190465;33;0;0;0;0;.00nan;0;0
1100;149452;33;88;50;3;47;.940;3543000;0
1101;676;34;83;29;1;28;.966;3600000;0
1101;1669;32;0;0;0;0;.00nan;0;0
1101;13337;32;58;34;4;30;.882;3600000;0
1101;78806;34;0;0;0;0;.00nan;0;0
1102;46492;0;79;44;3;41;.932;3819000;0
1102;85798;12;0;0;0;0;.00nan;0;0
1102;91178;12;74;28;2;26;.929;3819000;0
1102;149455;0;0;0;0;0;.00nan;0;0
1103;163695;9;0;0;0;0;.00nan;0;0
1103;9235;4838;0;0;0;0;.00nan;0;0
1103;175092;9;78;20;1;19;.950;3600000;0
1103;143749;4838;55;28;4;24;.857;3600000;0
1104;169868;4182;0;0;0;0;.00nan;0;0
1104;170314;25;78;34;2;32;.941;3548000;0
1104;147945;4182;74;23;1;22;.957;3600000;0
1104;148958;25;0;0;0;0;.00nan;0;0
1105;8424;28;0;0;0;0;.00nan;0;0
1105;166381;27;0;0;0;0;.00nan;0;0
1105;175660;27;82;12;0;12;1.000;3600000;0
1105;152835;28;92;41;3;38;.927;3600000;0
1106;2059;23;34;13;3;10;.769;1741000;0
1106;14266;23;53;30;4;26;.867;1859000;0
1106;17043;30;48;27;4;23;.852;3600000;0
1106;36755;30;0;0;0;0;.00nan;0;0
1107;166751;5;75;42;4;38;.905;3553000;0
1107;173727;18;72;36;3;33;.917;3600000;0
1107;176995;5;0;0;0;0;.00nan;0;0
1107;43757;18;0;0;0;0;.00nan;0;0
1108;166591;20;47;30;5;25;.833;3600000;0
1108;168712;14;0;0;0;0;.00nan;0;0
1108;175912;14;67;24;2;22;.917;3600000;0
1108;86697;20;0;0;0;0;.00nan;0;0
1109;166646;16;0;0;0;0;.00nan;0;0
1109;50065;16;75;37;4;33;.892;3600000;0
1109;69536;10;0;0;0;0;.00nan;0;0
1109;152717;10;54;43;6;37;.860;3600000;0
1110;13714;8;82;27;1;26;.963;3727000;0
1110;18213;8;0;0;0;0;.00nan;0;0
1110;86192;21;89;37;2;35;.946;3727000;0
1110;143156;21;0;0;0;0;.00nan;0;0
1111;2059;23;79;23;1;22;.957;3792000;0
1111;14266;23;0;0;0;0;.00nan;0;0
1111;65762;35;0;0;0;0;.00nan;0;0
1111;141998;35;100;35;0;35;1.000;3792000;0
1112;1669;32;0;0;0;0;.00nan;0;0
1112;13337;32;66;45;5;40;.889;3592000;0
1112;165582;24;0;0;0;0;.00nan;0;0
1112;168872;24;54;26;3;23;.885;3600000;0
1113;183844;29;0;0;0;0;.00nan;0;0
1113;175084;22;0;0;0;0;.00nan;0;0
1113;37818;29;96;37;2;35;.946;3600000;0
1113;143473;22;75;33;3;30;.909;3600000;0
1114;163423;26;0;0;0;0;.00nan;0;0
1114;179154;26;80;27;1;26;.963;3768000;0
1114;85798;12;0;0;0;0;.00nan;0;0
1114;91178;12;93;49;2;47;.959;3768000;0
1115;178413;17;0;0;0;0;.00nan;0;0
1115;190465;33;0;0;0;0;.00nan;0;0
1115;146862;17;91;43;2;41;.953;3600000;0
1115;149452;33;62;19;3;16;.842;3573000;0
1116;676;34;15;19;6;13;.684;3208000;0
1116;46492;0;39;35;6;29;.829;3734000;0
1116;78806;34;50;4;1;3;.750;499000;0
1116;149455;0;0;0;0;0;.00nan;0;0
1117;171838;31;0;0;0;0;.00nan;0;0
1117;9235;4838;58;6;0;6;1.000;558000;0
1117;86360;31;95;19;0;19;1.000;3600000;0
1117;143749;4838;22;38;8;30;.789;3042000;0
1118;556;3;39;31;6;25;.806;3663000;0
1118;179344;3;0;0;0;0;.00nan;0;0
1118;58830;15;47;32;5;27;.844;3663000;0
1118;85727;15;0;0;0;0;.00nan;0;0
1119;65;11;97;37;1;36;.973;3546000;0
1119;67;11;0;0;0;0;.00nan;0;0
1119;166381;27;0;0;0;0;.00nan;0;0
1119;175660;27;100;25;0;25;1.000;3600000;0
1120;166751;5;84;44;3;41;.932;4194000;0
1120;163565;19;74;31;3;28;.903;4200000;0
1120;14305;19;0;0;0;0;.00nan;0;0
1120;176995;5;0;0;0;0;.00nan;0;0
1121;173727;18;80;48;4;44;.917;3577000;0
1121;170314;25;47;19;3;16;.842;3600000;0
1121;43757;18;0;0;0;0;.00nan;0;0
1121;148958;25;0;0;0;0;.00nan;0;0
1122;17043;30;36;20;4;16;.800;1086000;0
1122;36755;30;60;20;2;18;.900;2514000;0
1122;86192;21;0;0;0;0;.00nan;0;0
1122;143156;21;72;28;2;26;.929;3600000;0
1123;1669;32;77;33;2;31;.939;3600000;0
1123;13337;32;0;0;0;0;.00nan;0;0
1123;168712;14;28;19;5;14;.737;3600000;0
1123;175912;14;0;0;0;0;.00nan;0;0
1124;13714;8;0;0;0;0;.00nan;0;0
1124;18213;8;55;23;3;20;.870;3600000;0
1124;69536;10;74;21;1;20;.952;1842000;0
1124;152717;10;60;39;5;34;.872;1758000;0
1125;676;34;0;0;0;0;.00nan;0;0
1125;165582;24;38;28;5;23;.821;3517000;0
1125;168872;24;0;0;0;0;.00nan;0;0
1125;78806;34;52;26;3;23;.885;3600000;0
1126;166591;20;0;0;0;0;.00nan;0;0
1126;171838;31;0;0;0;0;.00nan;0;0
1126;86360;31;67;46;5;41;.891;3600000;0
1126;86697;20;100;36;0;36;1.000;3600000;0
1127;9235;4838;20;9;4;5;.556;1066000;0
1127;46492;0;69;26;3;23;.885;3600000;0
1127;143749;4838;59;32;4;28;.875;2534000;0
1127;149455;0;0;0;0;0;.00nan;0;0
1128;556;3;69;35;3;32;.914;3643000;0
1128;179344;3;0;0;0;0;.00nan;0;0
1128;175084;22;63;26;4;22;.846;3643000;0
1128;143473;22;0;0;0;0;.00nan;0;0
1129;166646;16;0;0;0;0;.00nan;0;0
1129;50065;16;76;24;1;23;.958;3600000;0
1129;65762;35;0;0;0;0;.00nan;0;0
1129;141998;35;54;35;5;30;.857;3600000;0
1130;166751;5;0;0;0;0;.00nan;0;0
1130;169868;4182;0;0;0;0;.00nan;0;0
1130;176995;5;65;19;2;17;.895;3600000;0
1130;147945;4182;100;45;1;44;.978;3600000;0
1131;65;11;0;0;0;0;.00nan;0;0
1131;67;11;73;31;2;29;.935;3600000;0
1131;163695;9;48;33;5;28;.848;3600000;0
1131;175092;9;0;0;0;0;.00nan;0;0
1132;2059;23;76;31;3;28;.903;3600000;0
1132;8424;28;0;0;0;0;.00nan;0;0
1132;14266;23;0;0;0;0;.00nan;0;0
1132;152835;28;66;36;4;32;.889;3569000;0
1133;17043;30;86;36;1;35;.972;3600000;0
1133;36755;30;0;0;0;0;.00nan;0;0
1133;85798;12;26;18;5;13;.722;3600000;0
1133;91178;12;0;0;0;0;.00nan;0;0
1134;163565;19;32;27;6;21;.778;2461000;0
1134;14305;19;69;12;0;12;1.000;1139000;0
1134;166381;27;0;0;0;0;.00nan;0;0
1134;175660;27;63;26;3;23;.885;3600000;0
1135;556;3;73;30;4;26;.867;3779000;0
1135;183844;29;0;0;0;0;.00nan;0;0
1135;179344;3;0;0;0;0;.00nan;0;0
1135;37818;29;72;30;3;27;.900;3779000;0
1136;175084;22;0;0;0;0;.00nan;0;0
1136;58830;15;96;42;2;40;.952;3576000;0
1136;85727;15;0;0;0;0;.00nan;0;0
1136;143473;22;65;14;1;13;.929;3600000;0
1137;166591;20;0;0;0;0;.00nan;0;0
1137;69536;10;78;31;2;29;.935;3600000;0
1137;86697;20;67;32;3;29;.906;3567000;0
1137;152717;10;0;0;0;0;.00nan;0;0
1138;676;34;29;26;6;20;.769;2643000;0
1138;171838;31;86;41;3;38;.927;3600000;0
1138;78806;34;60;11;0;11;1.000;957000;0
1138;86360;31;0;0;0;0;.00nan;0;0
1139;178413;17;0;0;0;0;.00nan;0;0
1139;168712;14;65;27;3;24;.889;3533000;0
1139;175912;14;0;0;0;0;.00nan;0;0
1139;146862;17;99;35;1;34;.971;3600000;0
1140;17043;30;66;38;5;33;.868;3780000;0
1140;190465;33;0;0;0;0;.00nan;0;0
1140;36755;30;0;0;0;0;.00nan;0;0
1140;149452;33;59;34;4;30;.882;3780000;0
1141;1669;32;0;0;0;0;.00nan;0;0
1141;9235;4838;0;0;0;0;.00nan;0;0
1141;13337;32;71;18;1;17;.944;3600000;0
1141;143749;4838;85;34;2;32;.941;3583000;0
1142;65;11;81;36;2;34;.944;4137000;0
1142;67;11;0;0;0;0;.00nan;0;0
1142;170314;25;56;25;3;22;.880;4137000;0
1142;148958;25;0;0;0;0;.00nan;0;0
1143;8424;28;0;0;0;0;.00nan;0;0
1143;13714;8;0;0;0;0;.00nan;0;0
1143;18213;8;67;26;2;24;.923;3600000;0
1143;152835;28;79;38;3;35;.921;3546000;0
1144;65762;35;0;0;0;0;.00nan;0;0
1144;86192;21;49;27;4;23;.852;3566000;0
1144;141998;35;66;22;2;20;.909;3600000;0
1144;143156;21;0;0;0;0;.00nan;0;0
1145;2059;23;50;33;5;28;.848;3600000;0
1145;14266;23;0;0;0;0;.00nan;0;0
1145;169868;4182;0;0;0;0;.00nan;0;0
1145;147945;4182;100;27;0;27;1.000;3600000;0
1146;166646;16;69;24;2;22;.917;3267000;0
1146;173727;18;0;0;0;0;.00nan;0;0
1146;43757;18;39;34;6;28;.824;3578000;0
1146;50065;16;27;5;3;2;.400;333000;0
1147;163695;9;0;0;0;0;.00nan;0;0
1147;175092;9;72;33;3;30;.909;3562000;0
1147;46492;0;82;34;2;32;.941;3600000;0
1147;149455;0;0;0;0;0;.00nan;0;0
1148;166751;5;47;24;4;20;.833;3600000;0
1148;183844;29;40;26;5;21;.808;3589000;0
1148;176995;5;0;0;0;0;.00nan;0;0
1148;37818;29;0;0;0;0;.00nan;0;0
1149;166591;20;0;0;0;0;.00nan;0;0
1149;178413;17;0;0;0;0;.00nan;0;0
1149;86697;20;44;36;6;30;.833;3574000;0
1149;146862;17;59;18;3;15;.833;3600000;0
1150;556;3;75;35;3;32;.914;3562000;0
1150;165582;24;0;0;0;0;.00nan;0;0
1150;168872;24;88;38;2;36;.947;3600000;0
1150;179344;3;0;0;0;0;.00nan;0;0
1151;8424;28;0;0;0;0;.00nan;0;0
1151;175084;22;0;0;0;0;.00nan;0;0
1151;143473;22;67;18;1;17;.944;3600000;0
1151;152835;28;62;41;5;36;.878;3600000;0
1152;170314;25;28;19;5;14;.737;3794000;0
1152;46492;0;0;0;0;0;.00nan;0;0
1152;148958;25;0;0;0;0;.00nan;0;0
1152;149455;0;54;44;6;38;.864;3794000;0
1153;69536;10;0;0;0;0;.00nan;0;0
1153;86192;21;93;22;0;22;1.000;3600000;0
1153;143156;21;0;0;0;0;.00nan;0;0
1153;152717;10;90;31;1;30;.968;3553000;0
1154;171838;31;0;0;0;0;.00nan;0;0
1154;168712;14;80;39;3;36;.923;3600000;0
1154;175912;14;0;0;0;0;.00nan;0;0
1154;86360;31;66;34;4;30;.882;3583000;0
1155;163423;26;0;0;0;0;.00nan;0;0
1155;173727;18;52;27;4;23;.852;3600000;0
1155;179154;26;98;38;1;37;.974;3600000;0
1155;43757;18;0;0;0;0;.00nan;0;0
1156;65;11;72;41;4;37;.902;3588000;0
1156;67;11;0;0;0;0;.00nan;0;0
1156;85798;12;0;0;0;0;.00nan;0;0
1156;91178;12;59;19;2;17;.895;3600000;0
1157;1669;32;0;0;0;0;.00nan;0;0
1157;13337;32;60;41;5;36;.878;3600000;0
1157;17043;30;78;35;3;32;.914;3600000;0
1157;36755;30;0;0;0;0;.00nan;0;0
1158;13714;8;0;0;0;0;.00nan;0;0
1158;18213;8;51;20;3;17;.850;3715000;0
1158;58830;15;96;40;2;38;.950;3715000;0
1158;85727;15;0;0;0;0;.00nan;0;0
1159;163565;19;60;29;3;26;.897;3579000;0
1159;9235;4838;0;0;0;0;.00nan;0;0
1159;14305;19;0;0;0;0;.00nan;0;0
1159;143749;4838;67;17;1;16;.941;3600000;0
1160;190465;33;0;0;0;0;.00nan;0;0
1160;65762;35;0;0;0;0;.00nan;0;0
1160;141998;35;81;44;4;40;.909;3577000;0
1160;149452;33;87;35;2;33;.943;3600000;0
1161;2059;23;0;0;0;0;.00nan;0;0
1161;14266;23;45;43;7;36;.837;4020000;0
1161;169868;4182;0;0;0;0;.00nan;0;0
1161;147945;4182;58;47;6;41;.872;3992000;0
1162;166646;16;0;0;0;0;.00nan;0;0
1162;166381;27;0;0;0;0;.00nan;0;0
1162;175660;27;82;29;1;28;.966;3600000;0
1162;50065;16;86;45;4;41;.911;3600000;0
1163;676;34;0;0;0;0;.00nan;0;0
1163;163695;9;0;0;0;0;.00nan;0;0
1163;175092;9;91;36;1;35;.972;3600000;0
1163;78806;34;54;23;3;20;.870;3594000;0
1164;556;3;79;28;2;26;.929;3600000;0
1164;178413;17;0;0;0;0;.00nan;0;0
1164;179344;3;0;0;0;0;.00nan;0;0
1164;146862;17;85;45;4;41;.911;3536000;0
1165;163423;26;0;0;0;0;.00nan;0;0
1165;17043;30;81;29;1;28;.966;3600000;0
1165;179154;26;63;35;4;31;.886;3600000;0
1165;36755;30;0;0;0;0;.00nan;0;0
1166;9235;4838;68;41;4;37;.902;3600000;0
1166;169868;4182;0;0;0;0;.00nan;0;0
1166;143749;4838;0;0;0;0;.00nan;0;0
1166;147945;4182;71;31;3;28;.903;3600000;0
1167;58830;15;59;13;1;12;.923;3600000;0
1167;65762;35;26;32;7;25;.781;3337000;0
1167;85727;15;0;0;0;0;.00nan;0;0
1167;141998;35;51;2;0;2;1.000;263000;0
1168;13714;8;0;0;0;0;.00nan;0;0
1168;18213;8;76;32;3;29;.906;3576000;0
1168;190465;33;0;0;0;0;.00nan;0;0
1168;149452;33;91;47;2;45;.957;3600000;0
1169;171838;31;0;0;0;0;.00nan;0;0
1169;163695;9;68;38;4;34;.895;3545000;0
1169;175092;9;0;0;0;0;.00nan;0;0
1169;86360;31;80;44;3;41;.932;3600000;0
1170;69536;10;0;0;0;0;.00nan;0;0
1170;86192;21;40;41;7;34;.829;3600000;0
1170;143156;21;0;0;0;0;.00nan;0;0
1170;152717;10;86;42;3;39;.929;3600000;0
1171;166591;20;91;38;2;36;.947;3600000;0
1171;8424;28;54;4;0;4;1.000;1270000;0
1171;86697;20;0;0;0;0;.00nan;0;0
1171;152835;28;29;28;6;22;.786;2330000;0
1172;170314;25;81;27;2;25;.926;3577000;0
1172;175084;22;0;0;0;0;.00nan;0;0
1172;143473;22;66;19;1;18;.947;3600000;0
1172;148958;25;0;0;0;0;.00nan;0;0
1173;166751;5;62;36;4;32;.889;3600000;0
1173;165582;24;0;0;0;0;.00nan;0;0
1173;168872;24;87;19;0;19;1.000;3600000;0
1173;176995;5;0;0;0;0;.00nan;0;0
1174;1669;32;0;0;0;0;.00nan;0;0
1174;13337;32;80;36;2;34;.944;3522000;0
1174;46492;0;100;27;0;27;1.000;3600000;0
1174;149455;0;0;0;0;0;.00nan;0;0
1175;183844;29;0;0;0;0;.00nan;0;0
1175;168712;14;72;32;3;29;.906;4200000;0
1175;175912;14;0;0;0;0;.00nan;0;0
1175;37818;29;72;28;3;25;.893;4200000;0
1176;173727;18;25;6;3;3;.500;415000;0
1176;43757;18;68;29;2;27;.931;3185000;0
1176;85798;12;0;0;0;0;.00nan;0;0
1176;91178;12;61;21;2;19;.905;3600000;0
1177;65;11;68;36;4;32;.889;3583000;0
1177;67;11;0;0;0;0;.00nan;0;0
1177;163565;19;0;0;0;0;.00nan;0;0
1177;14305;19;44;19;3;16;.842;3600000;0
1178;166646;16;0;0;0;0;.00nan;0;0
1178;2059;23;86;36;2;34;.944;3600000;0
1178;14266;23;0;0;0;0;.00nan;0;0
1178;50065;16;73;23;1;22;.957;3600000;0
1179;166381;27;0;0;0;0;.00nan;0;0
1179;169868;4182;98;50;2;48;.960;3600000;0
1179;175660;27;62;14;1;13;.929;3600000;0
1179;147945;4182;0;0;0;0;.00nan;0;0
1180;13714;8;0;0;0;0;.00nan;0;0
1180;18213;8;82;27;2;25;.926;3600000;0
1180;86192;21;45;20;3;17;.850;3600000;0
1180;143156;21;0;0;0;0;.00nan;0;0
1181;58830;15;94;33;1;32;.970;3600000;0
1181;69536;10;0;0;0;0;.00nan;0;0
1181;85727;15;0;0;0;0;.00nan;0;0
1181;152717;10;81;37;2;35;.946;3554000;0
1182;165582;24;46;13;2;11;.846;627000;0
1182;168872;24;42;38;7;31;.816;2973000;0
1182;175084;22;66;17;1;16;.941;3600000;0
1182;143473;22;0;0;0;0;.00nan;0;0
1183;166751;5;0;0;0;0;.00nan;0;0
1183;178413;17;0;0;0;0;.00nan;0;0
1183;176995;5;89;33;1;32;.970;3600000;0
1183;146862;17;57;31;4;27;.871;3600000;0
1184;556;3;82;29;1;28;.966;3600000;0
1184;171838;31;0;0;0;0;.00nan;0;0
1184;179344;3;0;0;0;0;.00nan;0;0
1184;86360;31;69;39;4;35;.897;3600000;0
1185;9235;4838;0;0;0;0;.00nan;0;0
1185;85798;12;0;0;0;0;.00nan;0;0
1185;91178;12;58;31;4;27;.871;3552000;0
1185;143749;4838;100;40;2;38;.950;3600000;0
1186;1669;32;0;0;0;0;.00nan;0;0
1186;163565;19;0;0;0;0;.00nan;0;0
1186;13337;32;75;37;5;32;.865;3961000;0
1186;14305;19;74;40;4;36;.900;3961000;0
1187;2059;23;100;29;0;29;1.000;3600000;0
1187;14266;23;0;0;0;0;.00nan;0;0
1187;173727;18;79;26;1;25;.962;3600000;0
1187;43757;18;0;0;0;0;.00nan;0;0
1188;163695;9;0;0;0;0;.00nan;0;0
1188;168712;14;97;20;0;20;1.000;3600000;0
1188;175092;9;57;46;6;40;.870;3600000;0
1188;175912;14;0;0;0;0;.00nan;0;0
1189;556;3;78;30;2;28;.933;3600000;0
1189;8424;28;0;0;0;0;.00nan;0;0
1189;179344;3;0;0;0;0;.00nan;0;0
1189;152835;28;47;37;5;32;.865;3600000;0
1190;676;34;97;22;0;22;1.000;3600000;0
1190;69536;10;22;10;4;6;.600;946000;0
1190;78806;34;0;0;0;0;.00nan;0;0
1190;152717;10;64;14;1;13;.929;2654000;0
1191;165582;24;48;35;6;29;.829;3600000;0
1191;168872;24;0;0;0;0;.00nan;0;0
1191;170314;25;97;33;1;32;.970;3600000;0
1191;148958;25;0;0;0;0;.00nan;0;0
1192;163423;26;0;0;0;0;.00nan;0;0
1192;179154;26;93;33;1;32;.970;3600000;0
1192;46492;0;74;27;2;25;.926;3600000;0
1192;149455;0;0;0;0;0;.00nan;0;0
1193;183844;29;0;0;0;0;.00nan;0;0
1193;190465;33;0;0;0;0;.00nan;0;0
1193;37818;29;77;25;2;23;.920;3838000;0
1193;149452;33;71;30;3;27;.900;3834000;0
1194;65;11;56;43;6;37;.860;3600000;0
1194;67;11;0;0;0;0;.00nan;0;0
1194;169868;4182;0;0;0;0;.00nan;0;0
1194;147945;4182;74;21;1;20;.952;3600000;0
1195;166381;27;0;0;0;0;.00nan;0;0
1195;17043;30;0;0;0;0;.00nan;0;0
1195;175660;27;76;30;3;27;.900;3600000;0
1195;36755;30;78;46;4;42;.913;3558000;0
1196;171838;31;0;0;0;0;.00nan;0;0
1196;166751;5;74;28;2;26;.929;3600000;0
1196;176995;5;0;0;0;0;.00nan;0;0
1196;86360;31;38;19;4;15;.789;3515000;0
1197;676;34;0;0;0;0;.00nan;0;0
1197;58830;15;95;43;2;41;.953;3600000;0
1197;78806;34;84;21;1;20;.952;3600000;0
1197;85727;15;0;0;0;0;.00nan;0;0
1198;166646;16;89;17;0;17;1.000;3600000;0
1198;9235;4838;0;0;0;0;.00nan;0;0
1198;50065;16;0;0;0;0;.00nan;0;0
1198;143749;4838;77;41;4;37;.902;3600000;0
1199;166381;27;91;28;1;27;.964;3600000;0
1199;175660;27;0;0;0;0;.00nan;0;0
1199;65762;35;0;0;0;0;.00nan;0;0
1199;141998;35;50;40;6;34;.850;3600000;0
1200;2059;23;35;26;5;21;.808;3600000;0
1200;163565;19;58;24;4;20;.833;3600000;0
1200;14266;23;0;0;0;0;.00nan;0;0
1200;14305;19;0;0;0;0;.00nan;0;0
1201;166591;20;0;0;0;0;.00nan;0;0
1201;183844;29;0;0;0;0;.00nan;0;0
1201;37818;29;50;8;1;7;.875;3600000;0
1201;86697;20;80;40;3;37;.925;3536000;0
1202;165582;24;0;0;0;0;.00nan;0;0
1202;168872;24;44;43;6;37;.860;3600000;0
1202;86192;21;78;20;1;19;.950;3600000;0
1202;143156;21;0;0;0;0;.00nan;0;0
1203;166751;5;0;0;0;0;.00nan;0;0
1203;8424;28;0;0;0;0;.00nan;0;0
1203;176995;5;91;39;1;38;.974;3600000;0
1203;152835;28;65;30;3;27;.900;3514000;0
1204;556;3;58;30;5;25;.833;3600000;0
1204;179344;3;0;0;0;0;.00nan;0;0
1204;46492;0;48;23;4;19;.826;3600000;0
1204;149455;0;0;0;0;0;.00nan;0;0
1205;168712;14;0;0;0;0;.00nan;0;0
1205;175912;14;65;20;2;18;.900;3696000;0
1205;69536;10;0;0;0;0;.00nan;0;0
1205;152717;10;92;47;3;44;.936;3696000;0
1206;163423;26;0;0;0;0;.00nan;0;0
1206;13714;8;0;0;0;0;.00nan;0;0
1206;18213;8;85;28;2;26;.929;3600000;0
1206;179154;26;61;39;5;34;.872;3600000;0
1207;190465;33;0;0;0;0;.00nan;0;0
1207;85798;12;0;0;0;0;.00nan;0;0
1207;91178;12;65;22;2;20;.909;3600000;0
1207;149452;33;60;39;5;34;.872;3600000;0
1208;65;11;52;34;5;29;.853;3600000;0
1208;67;11;0;0;0;0;.00nan;0;0
1208;1669;32;0;0;0;0;.00nan;0;0
1208;13337;32;71;22;2;20;.909;3600000;0
1209;163565;19;0;0;0;0;.00nan;0;0
1209;14305;19;65;23;2;21;.913;3566000;0
1209;173727;18;94;29;1;28;.966;3600000;0
1209;43757;18;0;0;0;0;.00nan;0;0
1210;163695;9;0;0;0;0;.00nan;0;0
1210;175084;22;0;0;0;0;.00nan;0;0
1210;175092;9;98;49;2;47;.959;3527000;0
1210;143473;22;91;17;0;17;1.000;3600000;0
1211;166591;20;59;43;5;38;.884;3600000;0
1211;168712;14;78;26;2;24;.923;3600000;0
1211;175912;14;0;0;0;0;.00nan;0;0
1211;86697;20;0;0;0;0;.00nan;0;0
1212;178413;17;81;30;1;29;.967;3600000;0
1212;58830;15;76;37;4;33;.892;3600000;0
1212;85727;15;0;0;0;0;.00nan;0;0
1212;146862;17;0;0;0;0;.00nan;0;0
1213;9235;4838;0;0;0;0;.00nan;0;0
1213;13714;8;0;0;0;0;.00nan;0;0
1213;18213;8;82;14;0;14;1.000;3600000;0
1213;143749;4838;44;29;5;24;.828;3600000;0
1214;2059;23;0;0;0;0;.00nan;0;0
1214;14266;23;70;25;2;23;.920;3600000;0
1214;169868;4182;34;18;4;14;.778;2581000;0
1214;147945;4182;23;10;4;6;.600;1019000;0
1215;17043;30;55;25;3;22;.880;3600000;0
1215;36755;30;0;0;0;0;.00nan;0;0
1215;65762;35;61;45;5;40;.889;3550000;0
1215;141998;35;0;0;0;0;.00nan;0;0
1216;166751;5;93;44;2;42;.955;3792000;0
1216;176995;5;0;0;0;0;.00nan;0;0
1216;69536;10;80;38;3;35;.921;3792000;0
1216;152717;10;0;0;0;0;.00nan;0;0
1217;556;3;77;50;5;45;.900;3600000;0
1217;183844;29;0;0;0;0;.00nan;0;0
1217;179344;3;0;0;0;0;.00nan;0;0
1217;37818;29;74;11;0;11;1.000;3600000;0
1218;1669;32;0;0;0;0;.00nan;0;0
1218;163423;26;0;0;0;0;.00nan;0;0
1218;13337;32;78;36;3;33;.917;4200000;0
1218;179154;26;54;20;3;17;.850;4200000;0
1219;166646;16;84;29;1;28;.966;3600000;0
1219;170314;25;51;34;5;29;.853;3600000;0
1219;50065;16;0;0;0;0;.00nan;0;0
1219;148958;25;0;0;0;0;.00nan;0;0
1220;173727;18;49;20;3;17;.850;1521000;0
1220;43757;18;42;27;4;23;.852;2079000;0
1220;85798;12;0;0;0;0;.00nan;0;0
1220;91178;12;51;23;4;19;.826;3600000;0
1221;175084;22;76;22;1;21;.955;3550000;0
1221;86192;21;99;25;0;25;1.000;3600000;0
1221;143156;21;0;0;0;0;.00nan;0;0
1221;143473;22;0;0;0;0;.00nan;0;0
1222;171838;31;0;0;0;0;.00nan;0;0
1222;8424;28;0;0;0;0;.00nan;0;0
1222;86360;31;69;23;2;21;.913;4138000;0
1222;152835;28;99;38;1;37;.974;4138000;0
1223;676;34;52;26;3;23;.885;3545000;0
1223;46492;0;99;38;1;37;.974;3600000;0
1223;78806;34;0;0;0;0;.00nan;0;0
1223;149455;0;0;0;0;0;.00nan;0;0
1224;165582;24;0;0;0;0;.00nan;0;0
1224;168872;24;79;40;3;37;.925;3600000;0
1224;190465;33;0;0;0;0;.00nan;0;0
1224;149452;33;49;28;4;24;.857;3563000;0
1225;65;11;73;35;3;32;.914;3600000;0
1225;67;11;0;0;0;0;.00nan;0;0
1225;9235;4838;67;24;2;22;.917;3600000;0
1225;143749;4838;0;0;0;0;.00nan;0;0
1226;163565;19;83;43;3;40;.930;3520000;0
1226;14305;19;0;0;0;0;.00nan;0;0
1226;166381;27;0;0;0;0;.00nan;0;0
1226;175660;27;79;24;1;23;.958;3600000;0
1227;163695;9;0;0;0;0;.00nan;0;0
1227;178413;17;0;0;0;0;.00nan;0;0
1227;175092;9;66;33;3;30;.909;3600000;0
1227;146862;17;72;47;5;42;.894;3529000;0
1228;163423;26;45;30;5;25;.833;3562000;0
1228;170314;25;0;0;0;0;.00nan;0;0
1228;179154;26;0;0;0;0;.00nan;0;0
1228;148958;25;64;35;4;31;.886;3600000;0
1229;166591;20;59;34;4;30;.882;3600000;0
1229;86192;21;85;17;0;17;1.000;3600000;0
1229;86697;20;0;0;0;0;.00nan;0;0
1229;143156;21;0;0;0;0;.00nan;0;0
1230;173727;18;43;34;6;28;.824;3076000;0
1230;43757;18;46;4;1;3;.750;511000;0
1230;65762;35;57;10;1;9;.900;1776000;0
1230;141998;35;35;22;5;17;.773;1824000;0
1231;168712;14;81;42;3;39;.929;4030000;0
1231;175912;14;0;0;0;0;.00nan;0;0
1231;46492;0;76;45;4;41;.911;4030000;0
1231;149455;0;0;0;0;0;.00nan;0;0
1232;676;34;0;0;0;0;.00nan;0;0
1232;190465;33;0;0;0;0;.00nan;0;0
1232;78806;34;100;29;0;29;1.000;3600000;0
1232;149452;33;84;35;2;33;.943;3578000;0
1233;8424;28;0;0;0;0;.00nan;0;0
1233;58830;15;0;0;0;0;.00nan;0;0
1233;85727;15;56;22;3;19;.864;3562000;0
1233;152835;28;84;31;1;30;.968;3600000;0
1234;169868;4182;0;0;0;0;.00nan;0;0
1234;85798;12;0;0;0;0;.00nan;0;0
1234;91178;12;85;26;1;25;.962;3600000;0
1234;147945;4182;82;30;2;28;.933;3600000;0
1235;166646;16;0;0;0;0;.00nan;0;0
1235;13714;8;0;0;0;0;.00nan;0;0
1235;18213;8;93;18;0;18;1.000;3600000;0
1235;50065;16;88;40;2;38;.950;3578000;0
1236;171838;31;0;0;0;0;.00nan;0;0
1236;69536;10;0;0;0;0;.00nan;0;0
1236;86360;31;92;33;1;32;.970;3673000;0
1236;152717;10;57;17;2;15;.882;3673000;0
1237;166381;27;0;0;0;0;.00nan;0;0
1237;17043;30;57;40;5;35;.875;3600000;0
1237;175660;27;72;26;2;24;.923;3600000;0
1237;36755;30;0;0;0;0;.00nan;0;0
1238;166591;20;0;0;0;0;.00nan;0;0
1238;183844;29;0;0;0;0;.00nan;0;0
1238;37818;29;63;25;2;23;.920;3600000;0
1238;86697;20;83;38;3;35;.921;3591000;0
1239;178413;17;81;42;3;39;.929;3600000;0
1239;168712;14;88;17;0;17;1.000;3600000;0
1239;175912;14;0;0;0;0;.00nan;0;0
1239;146862;17;0;0;0;0;.00nan;0;0
1240;556;3;78;32;3;29;.906;3583000;0
1240;179344;3;0;0;0;0;.00nan;0;0
1240;46492;0;100;36;1;35;.972;3600000;0
1240;149455;0;0;0;0;0;.00nan;0;0
1241;8424;28;56;37;5;32;.865;3172000;0
1241;175084;22;0;0;0;0;.00nan;0;0
1241;143473;22;59;19;2;17;.895;3600000;0
1241;152835;28;53;3;0;3;1.000;428000;0
1242;676;34;0;0;0;0;.00nan;0;0
1242;171838;31;75;54;5;49;.907;3532000;0
1242;78806;34;64;30;3;27;.900;3600000;0
1242;86360;31;0;0;0;0;.00nan;0;0
1243;165582;24;0;0;0;0;.00nan;0;0
1243;168872;24;54;32;5;27;.844;3600000;0
1243;58830;15;50;13;2;11;.846;3600000;0
1243;85727;15;0;0;0;0;.00nan;0;0
1244;166751;5;0;0;0;0;.00nan;0;0
1244;176995;5;78;36;4;32;.889;3600000;0
1244;86192;21;61;13;1;12;.923;3600000;0
1244;143156;21;0;0;0;0;.00nan;0;0
1245;166646;16;0;0;0;0;.00nan;0;0
1245;163695;9;0;0;0;0;.00nan;0;0
1245;175092;9;59;33;4;29;.879;3600000;0
1245;50065;16;75;16;1;15;.938;3600000;0
1246;1669;32;0;0;0;0;.00nan;0;0
1246;13337;32;81;52;4;48;.923;3540000;0
1246;190465;33;0;0;0;0;.00nan;0;0
1246;149452;33;81;29;2;27;.931;3600000;0
1247;163423;26;0;0;0;0;.00nan;0;0
1247;13714;8;0;0;0;0;.00nan;0;0
1247;18213;8;22;30;7;23;.767;3600000;0
1247;179154;26;65;37;3;34;.919;3600000;0
1248;163565;19;0;0;0;0;.00nan;0;0
1248;14305;19;73;27;2;25;.926;3600000;0
1248;169868;4182;0;0;0;0;.00nan;0;0
1248;147945;4182;65;31;3;28;.903;3543000;0
1249;2059;23;0;0;0;0;.00nan;0;0
1249;14266;23;74;26;1;25;.962;3600000;0
1249;65762;35;0;0;0;0;.00nan;0;0
1249;141998;35;69;29;2;27;.931;3589000;0
1250;65;11;39;27;5;22;.815;3600000;0
1250;67;11;0;0;0;0;.00nan;0;0
1250;173727;18;99;37;1;36;.973;3600000;0
1250;43757;18;0;0;0;0;.00nan;0;0
1251;170314;25;98;47;1;46;.979;4200000;0
1251;85798;12;0;0;0;0;.00nan;0;0
1251;91178;12;80;21;1;20;.952;4200000;0
1251;148958;25;0;0;0;0;.00nan;0;0
1252;9235;4838;46;6;1;5;.833;370000;0
1252;17043;30;44;28;5;23;.821;3600000;0
1252;36755;30;0;0;0;0;.00nan;0;0
1252;143749;4838;50;37;6;31;.838;3230000;0
1253;166381;27;0;0;0;0;.00nan;0;0
1253;175660;27;100;41;2;39;.951;3600000;0
1253;65762;35;70;38;3;35;.921;3600000;0
1253;141998;35;0;0;0;0;.00nan;0;0
1254;163695;9;35;32;6;26;.813;2826000;0
1254;168712;14;53;22;3;19;.864;3600000;0
1254;175092;9;61;9;0;9;1.000;774000;0
1254;175912;14;0;0;0;0;.00nan;0;0
1255;556;3;47;21;4;17;.810;2026000;0
1255;179344;3;66;14;1;13;.929;1574000;0
1255;86192;21;95;34;1;33;.971;3600000;0
1255;143156;21;0;0;0;0;.00nan;0;0
1256;175084;22;0;0;0;0;.00nan;0;0
1256;58830;15;58;44;7;37;.841;3600000;0
1256;85727;15;0;0;0;0;.00nan;0;0
1256;143473;22;63;18;2;16;.889;3600000;0
1257;178413;17;0;0;0;0;.00nan;0;0
1257;69536;10;0;0;0;0;.00nan;0;0
1257;146862;17;91;19;0;19;1.000;3600000;0
1257;152717;10;81;29;1;28;.966;3600000;0
1258;166751;5;83;32;1;31;.969;3600000;0
1258;176995;5;0;0;0;0;.00nan;0;0
1258;46492;0;56;23;3;20;.870;3535000;0
1258;149455;0;0;0;0;0;.00nan;0;0
1259;676;34;0;0;0;0;.00nan;0;0
1259;171838;31;0;0;0;0;.00nan;0;0
1259;78806;34;38;31;6;25;.806;3988000;0
1259;86360;31;47;33;5;28;.848;3988000;0
1260;8424;28;0;0;0;0;.00nan;0;0
1260;165582;24;0;0;0;0;.00nan;0;0
1260;168872;24;30;27;5;22;.815;3600000;0
1260;152835;28;74;22;1;21;.955;3600000;0
1261;166646;16;0;0;0;0;.00nan;0;0
1261;1669;32;0;0;0;0;.00nan;0;0
1261;13337;32;77;33;3;30;.909;3600000;0
1261;50065;16;53;25;4;21;.840;3589000;0
1262;2059;23;0;0;0;0;.00nan;0;0
1262;14266;23;43;24;4;20;.833;3600000;0
1262;173727;18;49;42;7;35;.833;3600000;0
1262;43757;18;0;0;0;0;.00nan;0;0
1263;65;11;61;48;6;42;.875;3570000;0
1263;67;11;0;0;0;0;.00nan;0;0
1263;163565;19;0;0;0;0;.00nan;0;0
1263;14305;19;36;28;5;23;.821;3600000;0
1264;166591;20;100;43;1;42;.977;3600000;0
1264;85798;12;0;0;0;0;.00nan;0;0
1264;86697;20;0;0;0;0;.00nan;0;0
1264;91178;12;48;20;3;17;.850;3583000;0
1265;170314;25;42;25;4;21;.840;4160000;0
1265;190465;33;0;0;0;0;.00nan;0;0
1265;148958;25;0;0;0;0;.00nan;0;0
1265;149452;33;91;48;4;44;.917;4200000;0
1266;9235;4838;0;0;0;0;.00nan;0;0
1266;65762;35;0;0;0;0;.00nan;0;0
1266;141998;35;69;32;4;28;.875;3600000;0
1266;143749;4838;48;39;6;33;.846;3549000;0
1267;65;11;38;20;4;16;.800;919000;0
1267;67;11;44;23;4;19;.826;2634000;0
1267;169868;4182;0;0;0;0;.00nan;0;0
1267;147945;4182;43;29;5;24;.828;3600000;0
1268;163423;26;64;10;0;10;1.000;483000;0
1268;17043;30;97;22;0;22;1.000;3600000;0
1268;179154;26;39;40;7;33;.825;3117000;0
1268;36755;30;0;0;0;0;.00nan;0;0
1269;165582;24;0;0;0;0;.00nan;0;0
1269;168872;24;42;39;6;33;.846;3600000;0
1269;58830;15;100;34;0;34;1.000;3600000;0
1269;85727;15;0;0;0;0;.00nan;0;0
1270;166646;16;62;16;1;15;.938;3600000;0
1270;2059;23;68;35;3;32;.914;3517000;0
1270;14266;23;0;0;0;0;.00nan;0;0
1270;50065;16;0;0;0;0;.00nan;0;0
1271;1669;32;0;0;0;0;.00nan;0;0
1271;13337;32;66;38;5;33;.868;3566000;0
1271;13714;8;0;0;0;0;.00nan;0;0
1271;18213;8;49;20;3;17;.850;3600000;0
1272;556;3;0;0;0;0;.00nan;0;0
1272;163695;9;0;0;0;0;.00nan;0;0
1272;179344;3;57;31;3;28;.903;3600000;0
1272;175092;9;70;35;4;31;.886;3554000;0
1273;676;34;79;29;2;27;.931;3089000;0
1273;175084;22;0;0;0;0;.00nan;0;0
1273;78806;34;32;7;3;4;.571;511000;0
1273;143473;22;72;26;2;24;.923;3600000;0
1274;166751;5;92;44;2;42;.955;3678000;0
1274;168712;14;0;0;0;0;.00nan;0;0
1274;175912;14;73;20;1;19;.950;3678000;0
1274;176995;5;0;0;0;0;.00nan;0;0
1275;8424;28;0;0;0;0;.00nan;0;0
1275;46492;0;71;15;1;14;.933;3600000;0
1275;149455;0;0;0;0;0;.00nan;0;0
1275;152835;28;86;36;2;34;.944;3600000;0
1276;171838;31;0;0;0;0;.00nan;0;0
1276;178413;17;0;0;0;0;.00nan;0;0
1276;86360;31;48;38;6;32;.842;3600000;0
1276;146862;17;89;30;1;29;.967;3600000;0
1277;190465;33;71;36;3;33;.917;3600000;0
1277;86192;21;41;24;4;20;.833;3555000;0
1277;143156;21;0;0;0;0;.00nan;0;0
1277;149452;33;0;0;0;0;.00nan;0;0
1278;183844;29;0;0;0;0;.00nan;0;0
1278;37818;29;60;27;3;24;.889;4200000;0
1278;69536;10;100;55;3;52;.945;4200000;0
1278;152717;10;0;0;0;0;.00nan;0;0
1279;9235;4838;56;41;6;35;.854;1954000;0
1279;166381;27;0;0;0;0;.00nan;0;0
1279;175660;27;34;23;5;18;.783;3600000;0
1279;143749;4838;71;23;1;22;.957;1620000;0
1280;163565;19;99;36;1;35;.972;4200000;0
1280;14305;19;0;0;0;0;.00nan;0;0
1280;169868;4182;72;30;1;29;.967;4200000;0
1280;147945;4182;0;0;0;0;.00nan;0;0
1281;163423;26;37;30;5;25;.833;3555000;0
1281;173727;18;0;0;0;0;.00nan;0;0
1281;179154;26;0;0;0;0;.00nan;0;0
1281;43757;18;81;45;3;42;.933;3600000;0
1282;2059;23;0;0;0;0;.00nan;0;0
1282;14266;23;68;40;4;36;.900;4200000;0
1282;85798;12;68;32;4;28;.875;4200000;0
1282;91178;12;0;0;0;0;.00nan;0;0
1283;13714;8;65;23;2;21;.913;3600000;0
1283;17043;30;61;7;0;7;1.000;763000;0
1283;18213;8;0;0;0;0;.00nan;0;0
1283;36755;30;47;44;6;38;.864;2837000;0
1284;166591;20;0;0;0;0;.00nan;0;0
1284;170314;25;59;14;1;13;.929;3600000;0
1284;86697;20;77;49;4;45;.918;3600000;0
1284;148958;25;0;0;0;0;.00nan;0;0
1285;65;11;51;33;4;29;.879;3543000;0
1285;67;11;0;0;0;0;.00nan;0;0
1285;65762;35;66;26;3;23;.885;3600000;0
1285;141998;35;0;0;0;0;.00nan;0;0
1286;8424;28;0;0;0;0;.00nan;0;0
1286;178413;17;94;38;2;36;.947;3600000;0
1286;146862;17;0;0;0;0;.00nan;0;0
1286;152835;28;68;31;3;28;.903;3565000;0
1287;676;34;100;33;0;33;1.000;3600000;0
1287;165582;24;0;0;0;0;.00nan;0;0
1287;168872;24;74;32;2;30;.938;3562000;0
1287;78806;34;0;0;0;0;.00nan;0;0
1288;190465;33;0;0;0;0;.00nan;0;0
1288;69536;10;0;0;0;0;.00nan;0;0
1288;149452;33;100;26;0;26;1.000;3600000;0
1288;152717;10;47;26;4;22;.846;3600000;0
1289;166751;5;84;26;1;25;.962;3091000;0
1289;163695;9;0;0;0;0;.00nan;0;0
1289;175092;9;86;34;2;32;.941;3600000;0
1289;176995;5;30;7;3;4;.571;509000;0
1290;183844;29;0;0;0;0;.00nan;0;0
1290;168712;14;78;31;2;29;.935;3565000;0
1290;175912;14;0;0;0;0;.00nan;0;0
1290;37818;29;88;31;1;30;.968;3600000;0
1291;46492;0;61;27;3;24;.889;3559000;0
1291;58830;15;93;32;1;31;.969;3600000;0
1291;85727;15;0;0;0;0;.00nan;0;0
1291;149455;0;0;0;0;0;.00nan;0;0
1292;9235;4838;60;12;1;11;.917;1423000;0
1292;173727;18;90;34;2;32;.941;3600000;0
1292;43757;18;0;0;0;0;.00nan;0;0
1292;143749;4838;23;21;6;15;.714;2177000;0
1293;163423;26;0;0;0;0;.00nan;0;0
1293;163565;19;0;0;0;0;.00nan;0;0
1293;14305;19;50;26;4;22;.846;3600000;0
1293;179154;26;89;31;1;30;.968;3600000;0
1294;183844;29;72;40;4;36;.900;3993000;0
1294;37818;29;0;0;0;0;.00nan;0;0
1294;46492;0;90;38;3;35;.921;3993000;0
1294;149455;0;0;0;0;0;.00nan;0;0
1295;166591;20;63;36;4;32;.889;3600000;0
1295;86192;21;0;0;0;0;.00nan;0;0
1295;86697;20;0;0;0;0;.00nan;0;0
1295;143156;21;74;21;1;20;.952;3600000;0
1296;556;3;72;23;2;21;.913;3600000;0
1296;171838;31;0;0;0;0;.00nan;0;0
1296;179344;3;0;0;0;0;.00nan;0;0
1296;86360;31;91;39;3;36;.923;3540000;0
1297;8424;28;64;16;1;15;.938;3844000;0
1297;178413;17;0;0;0;0;.00nan;0;0
1297;146862;17;70;25;2;23;.920;3844000;0
1297;152835;28;0;0;0;0;.00nan;0;0
1298;168712;14;0;0;0;0;.00nan;0;0
1298;175084;22;69;28;2;26;.929;4075000;0
1298;175912;14;88;48;3;45;.938;4075000;0
1298;143473;22;0;0;0;0;.00nan;0;0
1299;1669;32;0;0;0;0;.00nan;0;0
1299;2059;23;84;33;2;31;.939;3600000;0
1299;13337;32;46;24;3;21;.875;3573000;0
1299;14266;23;0;0;0;0;.00nan;0;0
1300;17043;30;77;31;2;29;.935;3600000;0
1300;170314;25;50;35;5;30;.857;3571000;0
1300;36755;30;0;0;0;0;.00nan;0;0
1300;148958;25;0;0;0;0;.00nan;0;0
1301;65;11;81;55;5;50;.909;3600000;0
1301;67;11;0;0;0;0;.00nan;0;0
1301;166381;27;0;0;0;0;.00nan;0;0
1301;175660;27;93;21;0;21;1.000;3600000;0
1302;165582;24;0;0;0;0;.00nan;0;0
1302;168872;24;63;42;5;37;.881;3623000;0
1302;69536;10;0;0;0;0;.00nan;0;0
1302;152717;10;66;38;4;34;.895;3623000;0
1303;171838;31;75;37;4;33;.892;3600000;0
1303;166751;5;27;27;6;21;.778;2663000;0
1303;176995;5;64;11;0;11;1.000;885000;0
1303;86360;31;0;0;0;0;.00nan;0;0
1304;166646;16;0;0;0;0;.00nan;0;0
1304;50065;16;85;34;2;32;.941;3600000;0
1304;85798;12;57;13;1;12;.923;1361000;0
1304;91178;12;32;16;4;12;.750;2239000;0
1305;9235;4838;0;0;0;0;.00nan;0;0
1305;65762;35;0;0;0;0;.00nan;0;0
1305;141998;35;45;37;6;31;.838;3929000;0
1305;143749;4838;31;40;7;33;.825;3949000;0
1306;2059;23;77;31;2;29;.935;3600000;0
1306;163423;26;0;0;0;0;.00nan;0;0
1306;14266;23;0;0;0;0;.00nan;0;0
1306;179154;26;59;29;3;26;.897;3582000;0
1307;1669;32;0;0;0;0;.00nan;0;0
1307;13337;32;39;36;6;30;.833;3600000;0
1307;166381;27;0;0;0;0;.00nan;0;0
1307;175660;27;70;23;2;21;.913;3600000;0
1308;65;11;0;0;0;0;.00nan;0;0
1308;67;11;59;48;6;42;.875;3600000;0
1308;173727;18;71;20;2;18;.900;3600000;0
1308;43757;18;0;0;0;0;.00nan;0;0
1309;9235;4838;93;56;2;54;.964;3600000;0
1309;13714;8;0;0;0;0;.00nan;0;0
1309;18213;8;69;19;1;18;.947;3600000;0
1309;143749;4838;0;0;0;0;.00nan;0;0
1310;17043;30;73;37;3;34;.919;3829000;0
1310;169868;4182;0;0;0;0;.00nan;0;0
1310;36755;30;0;0;0;0;.00nan;0;0
1310;147945;4182;51;31;4;27;.871;3829000;0
1311;163565;19;0;0;0;0;.00nan;0;0
1311;14305;19;61;45;5;40;.889;3600000;0
1311;170314;25;44;9;2;7;.778;3600000;0
1311;148958;25;0;0;0;0;.00nan;0;0
1313;1669;32;0;0;0;0;.00nan;0;0
1313;167642;18;0;0;0;0;.00nan;0;0
1313;43757;18;98;41;3;38;.927;3537000;0
1313;58830;32;82;31;1;30;.968;3600000;0
1315;178413;17;59;14;1;13;.929;3600000;0
1315;169868;4182;0;0;0;0;.00nan;0;0
1315;146862;17;0;0;0;0;.00nan;0;0
1315;147945;4182;76;29;3;26;.897;3600000;0
1317;166751;5;0;0;0;0;.00nan;0;0
1317;36755;5;60;49;5;44;.898;3553000;0
1317;46492;0;63;26;3;23;.885;3600000;0
1317;149455;0;0;0;0;0;.00nan;0;0
1319;17043;30;86;42;2;40;.952;3600000;0
1319;176921;15;0;0;0;0;.00nan;0;0
1319;176995;30;0;0;0;0;.00nan;0;0
1319;85727;15;80;35;3;32;.914;3574000;0
1321;166646;16;0;0;0;0;.00nan;0;0
1321;163565;19;0;0;0;0;.00nan;0;0
1321;14305;19;75;40;4;36;.900;3600000;0
1321;50065;16;90;21;0;21;1.000;3600000;0
1323;166591;20;0;0;0;0;.00nan;0;0
1323;86697;20;36;24;5;19;.792;3518000;0
1323;141998;35;0;0;0;0;.00nan;0;0
1323;143473;35;74;36;3;33;.917;3600000;0
1325;9235;4838;0;0;0;0;.00nan;0;0
1325;175084;22;45;17;3;14;.824;3600000;0
1325;184770;22;0;0;0;0;.00nan;0;0
1325;143749;4838;53;33;5;28;.848;3579000;0
1327;183844;29;0;0;0;0;.00nan;0;0
1327;190465;33;0;0;0;0;.00nan;0;0
1327;37818;29;90;27;1;26;.963;3600000;0
1327;149452;33;89;47;3;44;.936;3542000;0
1329;187578;10;0;0;0;0;.00nan;0;0
1329;168712;14;66;27;2;25;.926;3553000;0
1329;175912;14;0;0;0;0;.00nan;0;0
1329;152717;10;99;31;1;30;.968;3600000;0
1331;174718;25;80;31;1;30;.968;4200000;0
1331;86192;21;90;31;1;30;.968;4200000;0
1331;143156;21;0;0;0;0;.00nan;0;0
1331;148958;25;0;0;0;0;.00nan;0;0
1333;163423;26;0;0;0;0;.00nan;0;0
1333;166381;27;76;22;1;21;.955;3878000;0
1333;179154;26;92;45;2;43;.956;3878000;0
1333;175660;27;0;0;0;0;.00nan;0;0
1335;676;34;60;35;4;31;.886;3561000;0
1335;78806;34;0;0;0;0;.00nan;0;0
1335;85798;12;78;36;3;33;.917;3600000;0
1335;91178;12;0;0;0;0;.00nan;0;0
1337;556;3;47;27;4;23;.852;3659000;0
1337;13714;8;87;33;3;30;.909;3659000;0
1337;18213;8;0;0;0;0;.00nan;0;0
1337;179344;3;0;0;0;0;.00nan;0;0
1339;171838;31;0;0;0;0;.00nan;0;0
1339;8424;28;0;0;0;0;.00nan;0;0
1339;86360;31;100;37;0;37;1.000;3600000;0
1339;152835;28;85;27;2;25;.926;3559000;0
1341;2059;23;82;33;2;31;.939;3600000;0
1341;165582;24;0;0;0;0;.00nan;0;0
1341;14266;23;0;0;0;0;.00nan;0;0
1341;168872;24;56;42;5;37;.881;3600000;0
1343;65;11;45;32;5;27;.844;3600000;0
1343;67;11;0;0;0;0;.00nan;0;0
1343;163695;9;80;29;2;27;.931;3600000;0
1343;175092;9;0;0;0;0;.00nan;0;0
1345;163565;19;0;0;0;0;.00nan;0;0
1345;14305;19;78;28;2;26;.929;3562000;0
1345;169868;4182;0;0;0;0;.00nan;0;0
1345;147945;4182;75;30;1;29;.967;3600000;0
1347;65;11;38;34;6;28;.824;3600000;0
1347;67;11;0;0;0;0;.00nan;0;0
1347;166381;27;0;0;0;0;.00nan;0;0
1347;175660;27;49;19;3;16;.842;3600000;0
1349;556;3;68;39;4;35;.897;3553000;0
1349;676;34;75;33;2;31;.939;3600000;0
1349;179344;3;0;0;0;0;.00nan;0;0
1349;78806;34;0;0;0;0;.00nan;0;0
1351;1669;32;0;0;0;0;.00nan;0;0
1351;9235;4838;0;0;0;0;.00nan;0;0
1351;58830;32;93;46;2;44;.957;4200000;0
1351;143749;4838;64;20;2;18;.900;4200000;0
1353;187578;10;0;0;0;0;.00nan;0;0
1353;190465;33;0;0;0;0;.00nan;0;0
1353;149452;33;68;27;2;25;.926;3600000;0
1353;152717;10;66;32;3;29;.906;3559000;0
1355;13714;8;0;0;0;0;.00nan;0;0
1355;183844;29;99;48;3;45;.938;3600000;0
1355;18213;8;46;25;4;21;.840;3588000;0
1355;37818;29;0;0;0;0;.00nan;0;0
1357;17043;30;84;38;2;36;.947;3600000;0
1357;176995;30;0;0;0;0;.00nan;0;0
1357;85798;12;44;27;4;23;.852;3573000;0
1357;91178;12;0;0;0;0;.00nan;0;0
1359;163423;26;57;5;0;5;1.000;763000;0
1359;179154;26;15;27;7;20;.741;2837000;0
1359;46492;0;73;26;2;24;.923;3600000;0
1359;149455;0;0;0;0;0;.00nan;0;0
1361;166591;20;0;0;0;0;.00nan;0;0
1361;163695;9;0;0;0;0;.00nan;0;0
1361;175092;9;65;49;5;44;.898;3600000;0
1361;86697;20;77;27;2;25;.926;3600000;0
1363;166751;5;0;0;0;0;.00nan;0;0
1363;8424;28;0;0;0;0;.00nan;0;0
1363;36755;5;92;43;3;40;.930;3544000;0
1363;152835;28;70;25;2;23;.920;3600000;0
1365;2059;23;0;0;0;0;.00nan;0;0
1365;14266;23;47;24;3;21;.875;3575000;0
1365;141998;35;0;0;0;0;.00nan;0;0
1365;143473;35;96;39;1;38;.974;3600000;0
1367;167642;18;58;6;0;6;1.000;631000;0
1367;174718;25;0;0;0;0;.00nan;0;0
1367;43757;18;43;32;6;26;.813;2954000;0
1367;148958;25;38;19;4;15;.789;3600000;0
1369;165582;24;84;29;1;28;.966;3600000;0
1369;168872;24;0;0;0;0;.00nan;0;0
1369;175084;22;54;28;3;25;.893;3574000;0
1369;184770;22;0;0;0;0;.00nan;0;0
1371;176921;15;0;0;0;0;.00nan;0;0
1371;85727;15;81;44;3;41;.932;3578000;0
1371;86192;21;0;0;0;0;.00nan;0;0
1371;143156;21;68;25;2;23;.920;3600000;0
1373;171838;31;0;0;0;0;.00nan;0;0
1373;166646;16;0;0;0;0;.00nan;0;0
1373;50065;16;88;19;0;19;1.000;3600000;0
1373;86360;31;89;47;3;44;.936;3600000;0
1375;178413;17;52;3;0;3;1.000;369000;0
1375;168712;14;72;27;2;25;.926;3600000;0
1375;175912;14;0;0;0;0;.00nan;0;0
1375;146862;17;48;38;6;32;.842;3231000;0
1377;556;3;0;0;0;0;.00nan;0;0
1377;179344;3;43;37;6;31;.838;3551000;0
1377;190465;33;72;38;4;34;.895;3600000;0
1377;149452;33;0;0;0;0;.00nan;0;0
1379;166646;16;89;20;0;20;1.000;3600000;0
1379;176921;15;69;50;5;45;.900;3600000;0
1379;50065;16;0;0;0;0;.00nan;0;0
1379;85727;15;0;0;0;0;.00nan;0;0
1381;1669;32;70;30;2;28;.933;3570000;0
1381;8424;28;88;33;1;32;.970;3600000;0
1381;58830;32;0;0;0;0;.00nan;0;0
1381;152835;28;0;0;0;0;.00nan;0;0
1383;9235;4838;94;40;2;38;.950;3589000;0
1383;174718;25;65;14;1;13;.929;3600000;0
1383;143749;4838;0;0;0;0;.00nan;0;0
1383;148958;25;0;0;0;0;.00nan;0;0
1385;2059;23;66;30;3;27;.900;3826000;0
1385;14266;23;0;0;0;0;.00nan;0;0
1385;183844;29;0;0;0;0;.00nan;0;0
1385;37818;29;88;35;2;33;.943;3826000;0
1387;166751;5;82;56;5;51;.911;3600000;0
1387;178413;17;53;20;2;18;.900;3600000;0
1387;36755;5;0;0;0;0;.00nan;0;0
1387;146862;17;0;0;0;0;.00nan;0;0
1389;163423;26;40;25;4;21;.840;3513000;0
1389;169868;4182;59;24;2;22;.917;3600000;0
1389;179154;26;0;0;0;0;.00nan;0;0
1389;147945;4182;0;0;0;0;.00nan;0;0
1391;163695;9;76;31;2;29;.935;3600000;0
1391;175092;9;0;0;0;0;.00nan;0;0
1391;86192;21;68;16;1;15;.938;3600000;0
1391;143156;21;0;0;0;0;.00nan;0;0
1393;187578;10;44;30;5;25;.833;2245000;0
1393;166381;27;100;35;0;35;1.000;3600000;0
1393;175660;27;0;0;0;0;.00nan;0;0
1393;152717;10;67;15;1;14;.933;1355000;0
1395;167642;18;100;36;0;36;1.000;3600000;0
1395;165582;24;0;0;0;0;.00nan;0;0
1395;168872;24;72;24;1;23;.958;3600000;0
1395;43757;18;0;0;0;0;.00nan;0;0
1397;166591;20;69;35;3;32;.914;3696000;0
1397;85798;12;0;0;0;0;.00nan;0;0
1397;86697;20;0;0;0;0;.00nan;0;0
1397;91178;12;53;29;4;25;.862;3696000;0
1399;163565;19;42;35;5;30;.857;3566000;0
1399;13714;8;68;29;3;26;.897;3600000;0
1399;14305;19;0;0;0;0;.00nan;0;0
1399;18213;8;0;0;0;0;.00nan;0;0
1401;168712;14;0;0;0;0;.00nan;0;0
1401;175084;22;0;0;0;0;.00nan;0;0
1401;184770;22;68;22;1;21;.955;3600000;0
1401;175912;14;85;42;3;39;.929;3598000;0
1403;17043;30;76;30;2;28;.933;3600000;0
1403;176995;30;0;0;0;0;.00nan;0;0
1403;46492;0;0;0;0;0;.00nan;0;0
1403;149455;0;91;20;0;20;1.000;3600000;0
1405;65;11;36;27;5;22;.815;2417000;0
1405;67;11;29;19;4;15;.789;1183000;0
1405;676;34;0;0;0;0;.00nan;0;0
1405;78806;34;55;21;2;19;.905;3600000;0
1407;171838;31;69;49;5;44;.898;3600000;0
1407;86360;31;0;0;0;0;.00nan;0;0
1407;141998;35;63;16;1;15;.938;3600000;0
1407;143473;35;0;0;0;0;.00nan;0;0
1409;167642;18;55;39;5;34;.872;3600000;0
1409;190465;33;0;0;0;0;.00nan;0;0
1409;43757;18;0;0;0;0;.00nan;0;0
1409;149452;33;94;18;0;18;1.000;3600000;0
1411;556;3;73;30;3;27;.900;3833000;0
1411;163423;26;0;0;0;0;.00nan;0;0
1411;179154;26;62;31;4;27;.871;3833000;0
1411;179344;3;0;0;0;0;.00nan;0;0
1413;163565;19;0;0;0;0;.00nan;0;0
1413;163695;9;0;0;0;0;.00nan;0;0
1413;14305;19;100;26;0;26;1.000;3600000;0
1413;175092;9;74;36;3;33;.917;3600000;0
1415;676;34;85;35;2;33;.943;3600000;0
1415;46492;0;0;0;0;0;.00nan;0;0
1415;78806;34;0;0;0;0;.00nan;0;0
1415;149455;0;56;25;3;22;.880;3545000;0
1417;9235;4838;0;0;0;0;.00nan;0;0
1417;176921;15;0;0;0;0;.00nan;0;0
1417;85727;15;52;15;2;13;.867;3600000;0
1417;143749;4838;28;27;6;21;.778;3600000;0
1419;171838;31;0;0;0;0;.00nan;0;0
1419;175084;22;79;24;1;23;.958;3600000;0
1419;184770;22;0;0;0;0;.00nan;0;0
1419;86360;31;71;43;4;39;.907;3600000;0
1421;86192;21;90;38;2;36;.947;3600000;0
1421;141998;35;67;38;5;33;.868;3600000;0
1421;143156;21;0;0;0;0;.00nan;0;0
1421;143473;35;0;0;0;0;.00nan;0;0
1423;178413;17;0;0;0;0;.00nan;0;0
1423;169868;4182;0;0;0;0;.00nan;0;0
1423;146862;17;97;49;3;46;.939;3600000;0
1423;147945;4182;48;32;5;27;.844;3569000;0
1425;166381;27;66;20;2;18;.900;4200000;0
1425;17043;30;95;43;2;41;.953;4200000;0
1425;175660;27;0;0;0;0;.00nan;0;0
1425;176995;30;0;0;0;0;.00nan;0;0
1427;1669;32;0;0;0;0;.00nan;0;0
1427;58830;32;56;36;5;31;.861;3600000;0
1427;85798;12;61;30;4;26;.867;3600000;0
1427;91178;12;0;0;0;0;.00nan;0;0
1429;166751;5;36;32;6;26;.813;3600000;0
1429;168712;14;0;0;0;0;.00nan;0;0
1429;175912;14;70;31;3;28;.903;3600000;0
1429;36755;5;0;0;0;0;.00nan;0;0
1431;187578;10;38;29;5;24;.828;3600000;0
1431;183844;29;68;29;3;26;.897;3600000;0
1431;37818;29;0;0;0;0;.00nan;0;0
1431;152717;10;0;0;0;0;.00nan;0;0
1433;166591;20;0;0;0;0;.00nan;0;0
1433;174718;25;79;23;1;22;.957;3600000;0
1433;86697;20;77;49;5;44;.898;3600000;0
1433;148958;25;0;0;0;0;.00nan;0;0
1435;8424;28;0;0;0;0;.00nan;0;0
1435;165582;24;0;0;0;0;.00nan;0;0
1435;168872;24;59;27;3;24;.889;3600000;0
1435;152835;28;55;35;5;30;.857;3514000;0
1437;166646;16;61;32;4;28;.875;3543000;0
1437;13714;8;0;0;0;0;.00nan;0;0
1437;18213;8;91;40;2;38;.950;3600000;0
1437;50065;16;0;0;0;0;.00nan;0;0
1439;65;11;0;0;0;0;.00nan;0;0
1439;67;11;79;28;2;26;.929;3600000;0
1439;2059;23;48;37;5;32;.865;3600000;0
1439;14266;23;0;0;0;0;.00nan;0;0
1441;9235;4838;100;43;3;40;.930;4200000;0
1441;141998;35;0;0;0;0;.00nan;0;0
1441;143473;35;72;35;3;32;.914;4200000;0
1441;143749;4838;0;0;0;0;.00nan;0;0
1443;166381;27;0;0;0;0;.00nan;0;0
1443;183844;29;50;10;1;9;.900;810000;0
1443;175660;27;98;21;0;21;1.000;3600000;0
1443;37818;29;54;40;6;34;.850;2790000;0
1445;166591;20;76;26;1;25;.962;3600000;0
1445;8424;28;75;28;2;26;.929;3545000;0
1445;86697;20;0;0;0;0;.00nan;0;0
1445;152835;28;0;0;0;0;.00nan;0;0
1447;175084;22;0;0;0;0;.00nan;0;0
1447;184770;22;83;26;1;25;.962;4200000;0
1447;46492;0;100;40;1;39;.975;4200000;0
1447;149455;0;0;0;0;0;.00nan;0;0
1449;165582;24;57;35;4;31;.886;3600000;0
1449;178413;17;10;18;6;12;.667;3279000;0
1449;168872;24;0;0;0;0;.00nan;0;0
1449;146862;17;61;5;0;5;1.000;303000;0
1451;174718;25;0;0;0;0;.00nan;0;0
1451;176921;15;83;34;2;32;.941;3600000;0
1451;85727;15;0;0;0;0;.00nan;0;0
1451;148958;25;52;21;3;18;.857;3600000;0
1453;163565;19;0;0;0;0;.00nan;0;0
1453;14305;19;99;30;0;30;1.000;3600000;0
1453;85798;12;0;0;0;0;.00nan;0;0
1453;91178;12;61;27;3;24;.889;3600000;0
1455;167642;18;0;0;0;0;.00nan;0;0
1455;169868;4182;89;41;2;39;.951;3600000;0
1455;43757;18;11;10;5;5;.500;3600000;0
1455;147945;4182;0;0;0;0;.00nan;0;0
1457;187578;10;0;0;0;0;.00nan;0;0
1457;166751;5;0;0;0;0;.00nan;0;0
1457;36755;5;99;43;1;42;.977;3600000;0
1457;152717;10;52;23;3;20;.870;3567000;0
1459;676;34;44;5;1;4;.800;1473000;0
1459;13714;8;84;45;4;41;.911;3600000;0
1459;18213;8;0;0;0;0;.00nan;0;0
1459;78806;34;31;21;5;16;.762;2127000;0
1461;171838;31;71;21;1;20;.952;3600000;0
1461;1669;32;0;0;0;0;.00nan;0;0
1461;58830;32;84;38;3;35;.921;3583000;0
1461;86360;31;0;0;0;0;.00nan;0;0
1463;166646;16;0;0;0;0;.00nan;0;0
1463;190465;33;0;0;0;0;.00nan;0;0
1463;50065;16;82;34;2;32;.941;4200000;0
1463;149452;33;63;22;2;20;.909;4200000;0
1465;556;3;0;0;0;0;.00nan;0;0
1465;2059;23;0;0;0;0;.00nan;0;0
1465;14266;23;48;29;4;25;.862;3600000;0
1465;179344;3;83;22;1;21;.955;3600000;0
1467;65;11;72;32;2;30;.938;3577000;0
1467;67;11;0;0;0;0;.00nan;0;0
1467;163695;9;82;24;1;23;.958;3600000;0
1467;175092;9;0;0;0;0;.00nan;0;0
1469;17043;30;45;47;7;40;.851;3328000;0
1469;168712;14;72;20;1;19;.950;3600000;0
1469;175912;14;0;0;0;0;.00nan;0;0
1469;176995;30;46;5;1;4;.800;272000;0
1471;163423;26;78;28;2;26;.929;3600000;0
1471;179154;26;0;0;0;0;.00nan;0;0
1471;86192;21;0;0;0;0;.00nan;0;0
1471;143156;21;55;29;4;25;.862;3600000;0
1473;171838;31;0;0;0;0;.00nan;0;0
1473;167642;18;0;0;0;0;.00nan;0;0
1473;43757;18;91;34;1;33;.971;3600000;0
1473;86360;31;79;29;2;27;.931;3600000;0
1475;2059;23;92;20;0;20;1.000;3600000;0
1475;14266;23;0;0;0;0;.00nan;0;0
1475;17043;30;89;41;2;39;.951;3562000;0
1475;176995;30;0;0;0;0;.00nan;0;0
1477;163423;26;0;0;0;0;.00nan;0;0
1477;179154;26;42;35;6;29;.829;4122000;0
1477;176921;15;36;32;5;27;.844;4122000;0
1477;85727;15;0;0;0;0;.00nan;0;0
1479;165582;24;0;0;0;0;.00nan;0;0
1479;168712;14;28;22;6;16;.727;2786000;0
1479;168872;24;72;28;2;26;.929;3600000;0
1479;175912;14;53;9;1;8;.889;814000;0
1481;163695;9;0;0;0;0;.00nan;0;0
1481;8424;28;0;0;0;0;.00nan;0;0
1481;175092;9;64;34;4;30;.882;3570000;0
1481;152835;28;54;28;3;25;.893;3600000;0
1483;556;3;93;44;2;42;.955;4200000;0
1483;179344;3;0;0;0;0;.00nan;0;0
1483;190465;33;0;0;0;0;.00nan;0;0
1483;149452;33;79;26;2;24;.923;4200000;0
1485;1669;32;0;0;0;0;.00nan;0;0
1485;166381;27;0;0;0;0;.00nan;0;0
1485;175660;27;72;20;2;18;.900;3600000;0
1485;58830;32;69;40;4;36;.900;3564000;0
1487;187578;10;45;40;6;34;.850;3600000;0
1487;13714;8;0;0;0;0;.00nan;0;0
1487;18213;8;90;42;3;39;.929;3600000;0
1487;152717;10;0;0;0;0;.00nan;0;0
1489;166646;16;0;0;0;0;.00nan;0;0
1489;174718;25;81;25;1;24;.960;3592000;0
1489;50065;16;100;27;0;27;1.000;3600000;0
1489;148958;25;0;0;0;0;.00nan;0;0
1491;166591;20;0;0;0;0;.00nan;0;0
1491;166751;5;39;1;1;0;.000;378000;0
1491;36755;5;54;38;6;32;.842;3222000;0
1491;86697;20;54;15;2;13;.867;3600000;0
1493;183844;29;0;0;0;0;.00nan;0;0
1493;37818;29;86;43;3;40;.930;3842000;0
1493;141998;35;0;0;0;0;.00nan;0;0
1493;143473;35;81;32;2;30;.938;3842000;0
1495;9235;4838;0;0;0;0;.00nan;0;0
1495;178413;17;0;0;0;0;.00nan;0;0
1495;143749;4838;100;29;1;28;.966;3600000;0
1495;146862;17;69;33;3;30;.909;3550000;0
1497;163565;19;0;0;0;0;.00nan;0;0
1497;14305;19;79;28;1;27;.964;3600000;0
1497;85798;12;69;30;3;27;.900;3535000;0
1497;91178;12;0;0;0;0;.00nan;0;0
1499;175084;22;65;26;2;24;.923;3548000;0
1499;184770;22;0;0;0;0;.00nan;0;0
1499;46492;0;100;40;0;40;1.000;3600000;0
1499;149455;0;0;0;0;0;.00nan;0;0
1501;676;34;0;0;0;0;.00nan;0;0
1501;78806;34;59;26;3;23;.885;3600000;0
1501;86192;21;85;46;4;42;.913;3560000;0
1501;143156;21;0;0;0;0;.00nan;0;0
1503;65;11;84;42;3;39;.929;3600000;0
1503;67;11;0;0;0;0;.00nan;0;0
1503;169868;4182;0;0;0;0;.00nan;0;0
1503;147945;4182;76;33;2;31;.939;3600000;0
1505;8424;28;90;31;1;30;.968;3600000;0
1505;46492;0;59;36;5;31;.861;3600000;0
1505;149455;0;0;0;0;0;.00nan;0;0
1505;152835;28;0;0;0;0;.00nan;0;0
1507;166591;20;78;20;1;19;.950;3600000;0
1507;166751;5;85;42;4;38;.905;3600000;0
1507;36755;5;0;0;0;0;.00nan;0;0
1507;86697;20;0;0;0;0;.00nan;0;0
1509;183844;29;65;31;3;28;.903;3600000;0
1509;169868;4182;63;40;5;35;.875;3540000;0
1509;37818;29;0;0;0;0;.00nan;0;0
1509;147945;4182;0;0;0;0;.00nan;0;0
1511;167642;18;16;24;6;18;.750;3289000;0
1511;190465;33;61;24;3;21;.875;3600000;0
1511;43757;18;57;7;0;7;1.000;311000;0
1511;149452;33;0;0;0;0;.00nan;0;0
1513;165582;24;38;15;4;11;.733;945000;0
1513;168872;24;61;23;2;21;.913;2655000;0
1513;174718;25;0;0;0;0;.00nan;0;0
1513;148958;25;63;21;2;19;.905;3600000;0
1515;171838;31;78;25;1;24;.960;3578000;0
1515;163695;9;100;31;0;31;1.000;3600000;0
1515;175092;9;0;0;0;0;.00nan;0;0
1515;86360;31;0;0;0;0;.00nan;0;0
1517;187578;10;0;0;0;0;.00nan;0;0
1517;85798;12;0;0;0;0;.00nan;0;0
1517;91178;12;69;35;3;32;.914;3600000;0
1517;152717;10;63;34;4;30;.882;3598000;0
1519;2059;23;50;26;4;22;.846;3596000;0
1519;14266;23;0;0;0;0;.00nan;0;0
1519;166381;27;90;34;2;32;.941;3600000;0
1519;175660;27;0;0;0;0;.00nan;0;0
1521;163423;26;93;30;1;29;.967;3600000;0
1521;178413;17;77;34;2;32;.941;3558000;0
1521;179154;26;0;0;0;0;.00nan;0;0
1521;146862;17;0;0;0;0;.00nan;0;0
1523;13714;8;91;37;2;35;.946;3600000;0
1523;18213;8;0;0;0;0;.00nan;0;0
1523;176921;15;0;0;0;0;.00nan;0;0
1523;85727;15;70;31;3;28;.903;3580000;0
1525;676;34;100;25;0;25;1.000;3600000;0
1525;163565;19;97;46;2;44;.957;3554000;0
1525;14305;19;0;0;0;0;.00nan;0;0
1525;78806;34;0;0;0;0;.00nan;0;0
1527;1669;32;48;21;3;18;.857;3571000;0
1527;17043;30;67;28;2;26;.929;3600000;0
1527;176995;30;0;0;0;0;.00nan;0;0
1527;58830;32;0;0;0;0;.00nan;0;0
1529;9235;4838;78;39;3;36;.923;3600000;0
1529;168712;14;0;0;0;0;.00nan;0;0
1529;175912;14;95;22;0;22;1.000;3600000;0
1529;143749;4838;0;0;0;0;.00nan;0;0
1531;166646;16;68;27;3;24;.889;3600000;0
1531;50065;16;0;0;0;0;.00nan;0;0
1531;86192;21;0;0;0;0;.00nan;0;0
1531;143156;21;68;37;4;33;.892;3572000;0
1533;65;11;0;0;0;0;.00nan;0;0
1533;67;11;97;38;1;37;.974;4200000;0
1533;141998;35;89;26;1;25;.962;4200000;0
1533;143473;35;0;0;0;0;.00nan;0;0
1535;556;3;0;0;0;0;.00nan;0;0
1535;179344;3;48;20;3;17;.850;3543000;0
1535;175084;22;0;0;0;0;.00nan;0;0
1535;184770;22;85;24;1;23;.958;3600000;0
1536;163462;58;81;37;2;35;.946;3579000;0
1536;37942;58;0;0;0;0;.00nan;0;0
1536;58037;53;71;20;1;19;.950;3600000;0
1536;78581;53;0;0;0;0;.00nan;0;0
1537;172340;48;90;67;3;64;.955;3560000;0
1537;164715;62;0;0;0;0;.00nan;0;0
1537;170598;48;0;0;0;0;.00nan;0;0
1537;152418;62;73;27;2;25;.926;3600000;0
1538;182780;60;74;33;3;30;.909;3603000;0
1538;170294;60;0;0;0;0;.00nan;0;0
1538;171673;64;67;31;4;27;.871;3646000;0
1538;176915;64;0;0;0;0;.00nan;0;0
1539;163471;37;96;22;0;22;1.000;3600000;0
1539;47112;4837;0;0;0;0;.00nan;0;0
1539;78775;4837;68;37;4;33;.892;3600000;0
1539;141850;37;0;0;0;0;.00nan;0;0
1540;176860;44;74;40;4;36;.900;3600000;0
1540;43928;39;71;19;1;18;.947;2461000;0
1540;57434;44;0;0;0;0;.00nan;0;0
1540;59025;39;36;15;4;11;.733;1095000;0
1541;172499;50;0;0;0;0;.00nan;0;0
1541;76574;50;66;19;2;17;.895;3600000;0
1541;79132;49;42;36;6;30;.833;3286000;0
1541;91225;49;51;2;0;2;1.000;314000;0
1542;178384;40;65;40;4;36;.900;3600000;0
1542;60773;47;42;14;3;11;.786;3037000;0
1542;79141;47;32;12;3;9;.750;519000;0
1542;85636;40;0;0;0;0;.00nan;0;0
1543;171608;59;0;0;0;0;.00nan;0;0
1543;180316;52;0;0;0;0;.00nan;0;0
1543;37857;52;90;51;3;48;.941;3900000;0
1543;58054;59;45;14;3;11;.786;3900000;0
1544;169154;38;0;0;0;0;.00nan;0;0
1544;170963;38;70;35;4;31;.886;3570000;0
1544;-1;51;0;0;0;0;.00nan;0;0
1544;141484;51;60;29;3;26;.897;3600000;0
1545;163989;45;94;48;3;45;.938;3600000;0
1545;170314;4619;96;20;0;20;1.000;3600000;0
1545;179350;45;0;0;0;0;.00nan;0;0
1545;64800;4619;0;0;0;0;.00nan;0;0
1546;5311;42;99;40;1;39;.975;3600000;0
1546;167642;61;0;0;0;0;.00nan;0;0
1546;179950;61;85;48;4;44;.917;3600000;0
1546;141496;42;0;0;0;0;.00nan;0;0
1547;183904;43;0;0;0;0;.00nan;0;0
1547;85336;56;0;0;0;0;.00nan;0;0
1547;85468;56;99;30;1;29;.967;3900000;0
1547;90164;43;96;32;1;31;.969;3900000;0
1548;163462;58;52;9;1;8;.889;1332000;0
1548;37942;58;46;33;6;27;.818;2268000;0
1548;58037;53;0;0;0;0;.00nan;0;0
1548;78581;53;86;30;2;28;.933;3600000;0
1549;68938;46;94;35;1;34;.971;3600000;0
1549;79280;46;0;0;0;0;.00nan;0;0
1549;94615;54;0;0;0;0;.00nan;0;0
1549;143301;54;50;28;4;24;.857;3600000;0
1550;182780;60;0;0;0;0;.00nan;0;0
1550;170294;60;71;36;3;33;.917;3600000;0
1550;171673;64;0;0;0;0;.00nan;0;0
1550;176915;64;59;38;4;34;.895;3586000;0
1551;176136;57;49;40;5;35;.875;3600000;0
1551;37077;55;0;0;0;0;.00nan;0;0
1551;57152;57;0;0;0;0;.00nan;0;0
1551;86862;55;63;14;1;13;.929;3600000;0
1552;163471;37;73;23;1;22;.957;3600000;0
1552;47112;4837;0;0;0;0;.00nan;0;0
1552;78775;4837;56;43;5;38;.884;3600000;0
1552;141850;37;0;0;0;0;.00nan;0;0
1553;176860;44;0;0;0;0;.00nan;0;0
1553;43928;39;0;0;0;0;.00nan;0;0
1553;57434;44;87;30;1;29;.967;3900000;0
1553;59025;39;96;43;1;42;.977;3900000;0
1554;173699;36;44;33;6;27;.818;3600000;0
1554;38276;65;0;0;0;0;.00nan;0;0
1554;86180;65;65;28;3;25;.893;3600000;0
1554;152710;36;0;0;0;0;.00nan;0;0
1555;163989;45;39;40;7;33;.825;3600000;0
1555;170314;4619;53;22;3;19;.864;3600000;0
1555;179350;45;0;0;0;0;.00nan;0;0
1555;64800;4619;0;0;0;0;.00nan;0;0
1556;170977;41;56;26;3;23;.885;3600000;0
1556;171608;59;0;0;0;0;.00nan;0;0
1556;58054;59;82;27;1;26;.963;3600000;0
1556;143507;41;0;0;0;0;.00nan;0;0
1557;183904;43;0;0;0;0;.00nan;0;0
1557;169154;38;0;0;0;0;.00nan;0;0
1557;170963;38;55;32;4;28;.875;3550000;0
1557;90164;43;56;25;3;22;.880;3600000;0
1558;5311;42;43;23;4;19;.826;3600000;0
1558;167642;61;0;0;0;0;.00nan;0;0
1558;179950;61;69;20;1;19;.950;3600000;0
1558;141496;42;0;0;0;0;.00nan;0;0
1559;-1;51;0;0;0;0;.00nan;0;0
1559;175757;63;35;16;3;13;.813;1676000;0
1559;181123;63;10;22;6;16;.727;1924000;0
1559;141484;51;80;39;3;36;.923;3600000;0
1560;173699;36;54;33;5;28;.848;3564000;0
1560;176136;57;0;0;0;0;.00nan;0;0
1560;57152;57;74;36;4;32;.889;3600000;0
1560;152710;36;0;0;0;0;.00nan;0;0
1561;37077;55;0;0;0;0;.00nan;0;0
1561;38276;65;0;0;0;0;.00nan;0;0
1561;86180;65;56;22;2;20;.909;3690000;0
1561;86862;55;68;28;3;25;.893;3690000;0
1562;172499;50;0;0;0;0;.00nan;0;0
1562;76574;50;31;10;3;7;.700;3600000;0
1562;79132;49;81;46;4;42;.913;3544000;0
1562;91225;49;0;0;0;0;.00nan;0;0
1563;178384;40;60;36;4;32;.889;3515000;0
1563;60773;47;0;0;0;0;.00nan;0;0
1563;79141;47;65;20;2;18;.900;3600000;0
1563;85636;40;0;0;0;0;.00nan;0;0
1564;170977;41;77;38;3;35;.921;3594000;0
1564;180316;52;0;0;0;0;.00nan;0;0
1564;37857;52;71;23;2;21;.913;3600000;0
1564;143507;41;0;0;0;0;.00nan;0;0
1565;175757;63;0;0;0;0;.00nan;0;0
1565;181123;63;55;37;4;33;.892;3600000;0
1565;85336;56;95;34;1;33;.971;3600000;0
1565;85468;56;0;0;0;0;.00nan;0;0
1566;5311;42;69;26;4;22;.846;3575000;0
1566;68938;46;0;0;0;0;.00nan;0;0
1566;79280;46;76;38;3;35;.921;3600000;0
1566;141496;42;0;0;0;0;.00nan;0;0
1567;-1;51;0;0;0;0;.00nan;0;0
1567;43928;39;0;0;0;0;.00nan;0;0
1567;59025;39;40;23;4;19;.826;3554000;0
1567;141484;51;56;27;3;24;.889;3600000;0
1568;169154;38;0;0;0;0;.00nan;0;0
1568;170963;38;60;38;5;33;.868;3600000;0
1568;180316;52;0;0;0;0;.00nan;0;0
1568;37857;52;72;25;3;22;.880;3600000;0
1569;176860;44;65;33;4;29;.879;3900000;0
1569;57434;44;0;0;0;0;.00nan;0;0
1569;79132;49;55;28;4;24;.857;3900000;0
1569;91225;49;0;0;0;0;.00nan;0;0
1570;183904;43;0;0;0;0;.00nan;0;0
1570;173699;36;73;34;3;31;.912;3577000;0
1570;90164;43;72;22;2;20;.909;3600000;0
1570;152710;36;0;0;0;0;.00nan;0;0
1571;182780;60;0;0;0;0;.00nan;0;0
1571;170294;60;48;24;3;21;.875;3900000;0
1571;171673;64;0;0;0;0;.00nan;0;0
1571;176915;64;100;48;3;45;.938;3900000;0
1572;171608;59;83;38;2;36;.947;3900000;0
1572;58037;53;0;0;0;0;.00nan;0;0
1572;58054;59;0;0;0;0;.00nan;0;0
1572;78581;53;84;34;2;32;.941;3900000;0
1573;170314;4619;72;31;2;29;.935;3600000;0
1573;47112;4837;79;37;3;34;.919;3588000;0
1573;64800;4619;0;0;0;0;.00nan;0;0
1573;78775;4837;0;0;0;0;.00nan;0;0
1574;-1;51;100;42;0;42;1.000;3600000;0
1574;43928;39;35;16;4;12;.750;2301000;0
1574;59025;39;42;7;2;5;.714;1299000;0
1574;141484;51;0;0;0;0;.00nan;0;0
1575;163471;37;92;28;1;27;.964;3600000;0
1575;172499;50;0;0;0;0;.00nan;0;0
1575;76574;50;85;35;3;32;.914;3551000;0
1575;141850;37;0;0;0;0;.00nan;0;0
1576;176136;57;0;0;0;0;.00nan;0;0
1576;180316;52;0;0;0;0;.00nan;0;0
1576;37857;52;65;28;3;25;.893;3900000;0
1576;57152;57;84;50;3;47;.940;3900000;0
1577;178384;40;82;42;4;38;.905;3600000;0
1577;60773;47;0;0;0;0;.00nan;0;0
1577;79141;47;84;25;1;24;.960;3600000;0
1577;85636;40;0;0;0;0;.00nan;0;0
1578;170977;41;81;47;4;43;.915;3544000;0
1578;38276;65;0;0;0;0;.00nan;0;0
1578;86180;65;69;27;3;24;.889;3600000;0
1578;143507;41;0;0;0;0;.00nan;0;0
1579;176860;44;0;0;0;0;.00nan;0;0
1579;57434;44;70;25;2;23;.920;3900000;0
1579;79132;49;0;0;0;0;.00nan;0;0
1579;91225;49;89;39;2;37;.949;3900000;0
1580;164715;62;78;37;3;34;.919;3600000;0
1580;178384;40;66;11;0;11;1.000;1686000;0
1580;85636;40;29;30;6;24;.800;1914000;0
1580;152418;62;0;0;0;0;.00nan;0;0
1581;37077;55;75;24;2;22;.917;3600000;0
1581;43928;39;0;0;0;0;.00nan;0;0
1581;59025;39;77;37;4;33;.892;3551000;0
1581;86862;55;0;0;0;0;.00nan;0;0
1582;169154;38;46;33;5;28;.848;3549000;0
1582;170963;38;0;0;0;0;.00nan;0;0
1582;85336;56;66;35;4;31;.886;3600000;0
1582;85468;56;0;0;0;0;.00nan;0;0
1583;183904;43;65;20;2;18;.900;3637000;0
1583;173699;36;0;0;0;0;.00nan;0;0
1583;90164;43;0;0;0;0;.00nan;0;0
1583;152710;36;92;48;3;45;.938;3637000;0
1584;182780;60;62;15;1;14;.933;3040000;0
1584;170294;60;30;10;3;7;.700;560000;0
1584;171673;64;0;0;0;0;.00nan;0;0
1584;176915;64;50;47;6;41;.872;3600000;0
1585;171608;59;0;0;0;0;.00nan;0;0
1585;38276;65;0;0;0;0;.00nan;0;0
1585;58054;59;95;29;2;27;.931;3600000;0
1585;86180;65;80;42;3;39;.929;3551000;0
1586;170314;4619;0;0;0;0;.00nan;0;0
1586;47112;4837;0;0;0;0;.00nan;0;0
1586;64800;4619;92;27;1;26;.963;3600000;0
1586;78775;4837;72;37;4;33;.892;3600000;0
1587;163471;37;91;35;2;33;.943;3749000;0
1587;172499;50;58;24;3;21;.875;3749000;0
1587;76574;50;0;0;0;0;.00nan;0;0
1587;141850;37;0;0;0;0;.00nan;0;0
1588;5311;42;56;40;5;35;.875;3600000;0
1588;94615;54;0;0;0;0;.00nan;0;0
1588;141496;42;0;0;0;0;.00nan;0;0
1588;143301;54;80;29;1;28;.966;3600000;0
1589;176136;57;97;50;2;48;.960;3900000;0
1589;180316;52;53;12;2;10;.833;3900000;0
1589;37857;52;0;0;0;0;.00nan;0;0
1589;57152;57;0;0;0;0;.00nan;0;0
1590;163989;45;72;35;3;32;.914;3600000;0
1590;179350;45;0;0;0;0;.00nan;0;0
1590;68938;46;0;0;0;0;.00nan;0;0
1590;79280;46;79;24;2;22;.917;3600000;0
1591;163462;58;0;0;0;0;.00nan;0;0
1591;175757;63;0;0;0;0;.00nan;0;0
1591;181123;63;70;20;1;19;.950;3600000;0
1591;37942;58;76;39;3;36;.923;3537000;0
1592;172340;48;70;56;5;51;.911;3600000;0
1592;167642;61;69;15;1;14;.933;3600000;0
1592;170598;48;0;0;0;0;.00nan;0;0
1592;179950;61;0;0;0;0;.00nan;0;0
1593;170977;41;58;8;0;8;1.000;664000;0
1593;58037;53;0;0;0;0;.00nan;0;0
1593;78581;53;47;12;2;10;.833;3600000;0
1593;143507;41;27;31;6;25;.806;2936000;0
1594;169154;38;0;0;0;0;.00nan;0;0
1594;170963;38;55;25;3;22;.880;3600000;0
1594;176136;57;0;0;0;0;.00nan;0;0
1594;57152;57;70;45;5;40;.889;3589000;0
1595;5311;42;0;0;0;0;.00nan;0;0
1595;68938;46;0;0;0;0;.00nan;0;0
1595;79280;46;70;33;3;30;.909;3600000;0
1595;141496;42;53;33;4;29;.879;3580000;0
1596;170977;41;80;52;5;47;.904;3600000;0
1596;38276;65;87;17;0;17;1.000;3600000;0
1596;86180;65;0;0;0;0;.00nan;0;0
1596;143507;41;0;0;0;0;.00nan;0;0
1597;163462;58;0;0;0;0;.00nan;0;0
1597;175757;63;67;21;2;19;.905;3600000;0
1597;181123;63;0;0;0;0;.00nan;0;0
1597;37942;58;51;37;5;32;.865;3600000;0
1598;182780;60;90;31;1;30;.968;3460000;0
1598;170294;60;24;6;3;3;.500;440000;0
1598;176860;44;85;41;4;37;.902;3900000;0
1598;57434;44;0;0;0;0;.00nan;0;0
1599;164715;62;65;24;2;22;.917;3600000;0
1599;47112;4837;86;41;3;38;.927;3588000;0
1599;78775;4837;0;0;0;0;.00nan;0;0
1599;152418;62;0;0;0;0;.00nan;0;0
1600;175757;63;0;0;0;0;.00nan;0;0
1600;181123;63;92;46;3;43;.935;3600000;0
1600;94615;54;0;0;0;0;.00nan;0;0
1600;143301;54;94;18;0;18;1.000;3600000;0
1601;167642;61;0;0;0;0;.00nan;0;0
1601;179950;61;79;32;2;30;.938;3600000;0
1601;60773;47;0;0;0;0;.00nan;0;0
1601;79141;47;65;30;3;27;.900;3597000;0
1602;182780;60;0;0;0;0;.00nan;0;0
1602;170294;60;73;16;1;15;.938;3600000;0
1602;176860;44;0;0;0;0;.00nan;0;0
1602;57434;44;65;40;4;36;.900;3600000;0
1603;37077;55;0;0;0;0;.00nan;0;0
1603;86862;55;86;30;2;28;.933;3600000;0
1603;94615;54;0;0;0;0;.00nan;0;0
1603;143301;54;61;27;3;24;.889;3600000;0
1604;172340;48;72;34;3;31;.912;3600000;0
1604;178384;40;64;20;2;18;.900;3600000;0
1604;170598;48;0;0;0;0;.00nan;0;0
1604;85636;40;0;0;0;0;.00nan;0;0
1605;163471;37;0;0;0;0;.00nan;0;0
1605;68938;46;0;0;0;0;.00nan;0;0
1605;79280;46;99;38;1;37;.974;3600000;0
1605;141850;37;55;20;2;18;.900;3566000;0
1606;163462;58;0;0;0;0;.00nan;0;0
1606;-1;51;66;26;2;24;.923;3577000;0
1606;37942;58;100;40;0;40;1.000;3600000;0
1606;141484;51;0;0;0;0;.00nan;0;0
1607;170314;4619;88;41;3;38;.927;3600000;0
1607;47112;4837;0;0;0;0;.00nan;0;0
1607;64800;4619;0;0;0;0;.00nan;0;0
1607;78775;4837;100;36;1;35;.972;3600000;0
1608;176136;57;0;0;0;0;.00nan;0;0
1608;57152;57;100;47;1;46;.979;3600000;0
1608;58037;53;51;14;2;12;.857;3600000;0
1608;78581;53;0;0;0;0;.00nan;0;0
1609;175757;63;0;0;0;0;.00nan;0;0
1609;181123;63;94;35;1;34;.971;3600000;0
1609;37077;55;0;0;0;0;.00nan;0;0
1609;86862;55;59;31;3;28;.903;3548000;0
1610;163462;58;51;15;2;13;.867;2655000;0
1610;169154;38;61;39;4;35;.897;3600000;0
1610;170963;38;0;0;0;0;.00nan;0;0
1610;37942;58;38;21;4;17;.810;923000;0
1611;173699;36;70;31;3;28;.903;3513000;0
1611;171673;64;95;33;1;32;.970;3600000;0
1611;176915;64;0;0;0;0;.00nan;0;0
1611;152710;36;0;0;0;0;.00nan;0;0
1612;170977;41;98;78;4;74;.949;3600000;0
1612;171608;59;0;0;0;0;.00nan;0;0
1612;58054;59;73;15;1;14;.933;3600000;0
1612;143507;41;0;0;0;0;.00nan;0;0
1613;178384;40;100;40;2;38;.950;3900000;0
1613;47112;4837;67;26;2;24;.923;3900000;0
1613;78775;4837;0;0;0;0;.00nan;0;0
1613;85636;40;0;0;0;0;.00nan;0;0
1614;-1;51;0;0;0;0;.00nan;0;0
1614;43928;39;0;0;0;0;.00nan;0;0
1614;59025;39;76;35;3;32;.914;3600000;0
1614;141484;51;42;28;5;23;.821;3529000;0
1615;163471;37;51;22;4;18;.818;3600000;0
1615;163989;45;0;0;0;0;.00nan;0;0
1615;179350;45;59;39;5;34;.872;3545000;0
1615;141850;37;0;0;0;0;.00nan;0;0
1616;176860;44;0;0;0;0;.00nan;0;0
1616;57434;44;69;35;3;32;.914;3721000;0
1616;60773;47;0;0;0;0;.00nan;0;0
1616;79141;47;60;29;4;25;.862;3721000;0
1617;183904;43;0;0;0;0;.00nan;0;0
1617;85336;56;64;41;5;36;.878;3600000;0
1617;85468;56;0;0;0;0;.00nan;0;0
1617;90164;43;82;25;1;24;.960;3600000;0
1618;5311;42;97;32;1;31;.969;3900000;0
1618;172499;50;0;0;0;0;.00nan;0;0
1618;76574;50;83;22;1;21;.955;3900000;0
1618;141496;42;0;0;0;0;.00nan;0;0
1619;167642;61;0;0;0;0;.00nan;0;0
1619;164715;62;59;31;4;27;.871;3515000;0
1619;179950;61;79;30;2;28;.933;3600000;0
1619;152418;62;0;0;0;0;.00nan;0;0
1620;175757;63;77;37;2;35;.946;3570000;0
1620;181123;63;0;0;0;0;.00nan;0;0
1620;37077;55;87;27;1;26;.963;3600000;0
1620;86862;55;0;0;0;0;.00nan;0;0
1621;182780;60;0;0;0;0;.00nan;0;0
1621;170294;60;56;26;3;23;.885;3552000;0
1621;79132;49;86;39;2;37;.949;3600000;0
1621;91225;49;0;0;0;0;.00nan;0;0
1622;163462;58;0;0;0;0;.00nan;0;0
1622;169154;38;0;0;0;0;.00nan;0;0
1622;170963;38;78;36;3;33;.917;3571000;0
1622;37942;58;91;30;1;29;.967;3600000;0
1623;173699;36;30;8;3;5;.625;514000;0
1623;68938;46;0;0;0;0;.00nan;0;0
1623;79280;46;38;19;4;15;.789;3600000;0
1623;152710;36;41;38;6;32;.842;3086000;0
1624;176136;57;91;41;3;38;.927;3900000;0
1624;38276;65;84;35;3;32;.914;3900000;0
1624;57152;57;0;0;0;0;.00nan;0;0
1624;86180;65;0;0;0;0;.00nan;0;0
1625;163471;37;0;0;0;0;.00nan;0;0
1625;94615;54;67;23;2;21;.913;3600000;0
1625;141850;37;62;25;3;22;.880;3585000;0
1625;143301;54;0;0;0;0;.00nan;0;0
1626;163989;45;86;35;2;33;.943;3900000;0
1626;171673;64;0;0;0;0;.00nan;0;0
1626;179350;45;0;0;0;0;.00nan;0;0
1626;176915;64;63;28;2;26;.929;3900000;0
1627;172340;48;66;48;5;43;.896;3600000;0
1627;170314;4619;53;18;2;16;.889;3600000;0
1627;170598;48;0;0;0;0;.00nan;0;0
1627;64800;4619;0;0;0;0;.00nan;0;0
1628;170977;41;0;0;0;0;.00nan;0;0
1628;180316;52;0;0;0;0;.00nan;0;0
1628;37857;52;87;20;0;20;1.000;3600000;0
1628;143507;41;98;48;1;47;.979;3551000;0
1629;183904;43;52;9;1;8;.889;3600000;0
1629;43928;39;48;31;5;26;.839;3600000;0
1629;59025;39;0;0;0;0;.00nan;0;0
1629;90164;43;0;0;0;0;.00nan;0;0
1630;5311;42;0;0;0;0;.00nan;0;0
1630;172499;50;64;29;3;26;.897;3564000;0
1630;76574;50;0;0;0;0;.00nan;0;0
1630;141496;42;81;25;1;24;.960;3600000;0
1631;167642;61;58;31;3;28;.903;3596000;0
1631;164715;62;0;0;0;0;.00nan;0;0
1631;179950;61;0;0;0;0;.00nan;0;0
1631;152418;62;89;38;2;36;.947;3600000;0
1632;-1;51;90;49;4;45;.918;3900000;0
1632;85336;56;0;0;0;0;.00nan;0;0
1632;85468;56;73;37;4;33;.892;3900000;0
1632;141484;51;0;0;0;0;.00nan;0;0
1633;171608;59;73;30;1;29;.967;3600000;0
1633;58037;53;0;0;0;0;.00nan;0;0
1633;58054;59;0;0;0;0;.00nan;0;0
1633;78581;53;91;37;2;35;.946;3572000;0
1634;182780;60;62;26;3;23;.885;3600000;0
1634;170294;60;0;0;0;0;.00nan;0;0
1634;79132;49;0;0;0;0;.00nan;0;0
1634;91225;49;47;41;6;35;.854;3600000;0
1635;47112;4837;0;0;0;0;.00nan;0;0
1635;60773;47;65;21;2;19;.905;3600000;0
1635;78775;4837;72;38;3;35;.921;3544000;0
1635;79141;47;0;0;0;0;.00nan;0;0
1636;176136;57;0;0;0;0;.00nan;0;0
1636;57152;57;72;46;4;42;.913;3600000;0
1636;58037;53;60;17;1;16;.941;3600000;0
1636;78581;53;0;0;0;0;.00nan;0;0
1637;171608;59;0;0;0;0;.00nan;0;0
1637;38276;65;0;0;0;0;.00nan;0;0
1637;58054;59;87;35;2;33;.943;3600000;0
1637;86180;65;100;36;1;35;.972;3600000;0
1638;178384;40;70;25;2;23;.920;3600000;0
1638;176860;44;0;0;0;0;.00nan;0;0
1638;57434;44;71;44;5;39;.886;3600000;0
1638;85636;40;0;0;0;0;.00nan;0;0
1639;170977;41;46;38;6;32;.842;2504000;0
1639;180316;52;0;0;0;0;.00nan;0;0
1639;37857;52;52;17;2;15;.882;3600000;0
1639;143507;41;54;21;2;19;.905;1096000;0
1640;172340;48;50;17;2;15;.882;1684000;0
1640;170314;4619;0;0;0;0;.00nan;0;0
1640;170598;48;54;41;6;35;.854;1916000;0
1640;64800;4619;60;21;2;19;.905;3600000;0
1641;172340;48;73;31;2;29;.935;3600000;0
1641;170598;48;0;0;0;0;.00nan;0;0
1641;176860;44;0;0;0;0;.00nan;0;0
1641;57434;44;41;19;4;15;.789;3542000;0
1642;173699;36;36;35;6;29;.829;3600000;0
1642;171673;64;0;0;0;0;.00nan;0;0
1642;176915;64;67;34;3;31;.912;3600000;0
1642;152710;36;0;0;0;0;.00nan;0;0
1643;43928;39;0;0;0;0;.00nan;0;0
1643;59025;39;59;28;3;25;.893;3600000;0
1643;85336;56;69;37;5;32;.865;3584000;0
1643;85468;56;0;0;0;0;.00nan;0;0
1644;183904;43;0;0;0;0;.00nan;0;0
1644;-1;51;86;18;0;18;1.000;999000;0
1644;90164;43;41;21;4;17;.810;3600000;0
1644;141484;51;27;30;6;24;.800;2556000;0
1645;180316;52;51;3;0;3;1.000;252000;0
1645;37857;52;40;30;6;24;.800;3289000;0
1645;58037;53;0;0;0;0;.00nan;0;0
1645;78581;53;62;32;4;28;.875;3600000;0
1646;163471;37;49;23;3;20;.870;3600000;0
1646;94615;54;0;0;0;0;.00nan;0;0
1646;141850;37;0;0;0;0;.00nan;0;0
1646;143301;54;64;34;4;30;.882;3574000;0
1647;176860;44;0;0;0;0;.00nan;0;0
1647;47112;4837;0;0;0;0;.00nan;0;0
1647;57434;44;76;28;2;26;.929;3600000;0
1647;78775;4837;85;40;3;37;.925;3600000;0
1648;170314;4619;53;31;4;27;.871;3600000;0
1648;64800;4619;0;0;0;0;.00nan;0;0
1648;79132;49;83;34;2;32;.941;3600000;0
1648;91225;49;0;0;0;0;.00nan;0;0
1649;163462;58;64;33;4;29;.879;3600000;0
1649;37942;58;0;0;0;0;.00nan;0;0
1649;60773;47;0;0;0;0;.00nan;0;0
1649;79141;47;89;17;0;17;1.000;3600000;0
1650;173699;36;99;49;1;48;.980;3600000;0
1650;180316;52;0;0;0;0;.00nan;0;0
1650;37857;52;52;14;2;12;.857;3562000;0
1650;152710;36;0;0;0;0;.00nan;0;0
1651;182780;60;44;4;1;3;.750;463000;0
1651;178384;40;66;39;5;34;.872;3600000;0
1651;170294;60;29;30;6;24;.800;3056000;0
1651;85636;40;0;0;0;0;.00nan;0;0
1652;175757;63;98;26;0;26;1.000;2435000;0
1652;181123;63;37;21;5;16;.762;1165000;0
1652;43928;39;0;0;0;0;.00nan;0;0
1652;59025;39;87;28;1;27;.964;3600000;0
1653;171608;59;0;0;0;0;.00nan;0;0
1653;38276;65;0;0;0;0;.00nan;0;0
1653;58054;59;56;44;6;38;.864;3523000;0
1653;86180;65;89;44;4;40;.909;3600000;0
1654;-1;51;86;41;3;38;.927;3600000;0
1654;85336;56;56;35;5;30;.857;3537000;0
1654;85468;56;0;0;0;0;.00nan;0;0
1654;141484;51;0;0;0;0;.00nan;0;0
1655;170977;41;79;41;4;37;.902;3600000;0
1655;37077;55;0;0;0;0;.00nan;0;0
1655;86862;55;99;23;0;23;1.000;3600000;0
1655;143507;41;0;0;0;0;.00nan;0;0
1656;167642;61;0;0;0;0;.00nan;0;0
1656;179950;61;76;28;1;27;.964;3600000;0
1656;68938;46;78;21;0;21;1.000;2561000;0
1656;79280;46;42;23;4;19;.826;1039000;0
1657;176136;57;0;0;0;0;.00nan;0;0
1657;57152;57;79;43;4;39;.907;3558000;0
1657;58037;53;0;0;0;0;.00nan;0;0
1657;78581;53;88;33;2;31;.939;3600000;0
1658;176860;44;58;27;4;23;.852;3900000;0
1658;47112;4837;69;36;4;32;.889;3900000;0
1658;57434;44;0;0;0;0;.00nan;0;0
1658;78775;4837;0;0;0;0;.00nan;0;0
1659;172340;48;45;41;6;35;.854;3600000;0
1659;164715;62;56;19;2;17;.895;3600000;0
1659;170598;48;0;0;0;0;.00nan;0;0
1659;152418;62;0;0;0;0;.00nan;0;0
1660;163462;58;0;0;0;0;.00nan;0;0
1660;37942;58;95;58;3;55;.948;3600000;0
1660;60773;47;0;0;0;0;.00nan;0;0
1660;79141;47;52;16;2;14;.875;3600000;0
1661;173699;36;0;0;0;0;.00nan;0;0
1661;180316;52;85;29;1;28;.966;3600000;0
1661;37857;52;0;0;0;0;.00nan;0;0
1661;152710;36;51;22;3;19;.864;3517000;0
1662;182780;60;100;24;0;24;1.000;3600000;0
1662;178384;40;79;29;2;27;.931;3566000;0
1662;170294;60;0;0;0;0;.00nan;0;0
1662;85636;40;0;0;0;0;.00nan;0;0
1663;169154;38;71;22;2;20;.909;3600000;0
1663;170963;38;0;0;0;0;.00nan;0;0
1663;176136;57;69;33;3;30;.909;3561000;0
1663;57152;57;0;0;0;0;.00nan;0;0
1664;5311;42;58;37;4;33;.892;3538000;0
1664;163471;37;78;30;2;28;.933;3600000;0
1664;141496;42;0;0;0;0;.00nan;0;0
1664;141850;37;0;0;0;0;.00nan;0;0
1665;175757;63;0;0;0;0;.00nan;0;0
1665;181123;63;84;27;1;26;.963;3600000;0
1665;43928;39;53;40;6;34;.850;3188000;0
1665;59025;39;50;2;0;2;1.000;412000;0
1666;172499;50;0;0;0;0;.00nan;0;0
1666;163989;45;70;34;3;31;.912;3544000;0
1666;179350;45;0;0;0;0;.00nan;0;0
1666;76574;50;58;12;1;11;.917;3600000;0
1667;171673;64;0;0;0;0;.00nan;0;0
1667;176915;64;71;52;5;47;.904;3600000;0
1667;94615;54;0;0;0;0;.00nan;0;0
1667;143301;54;88;15;0;15;1.000;3600000;0
1668;170977;41;0;0;0;0;.00nan;0;0
1668;38276;65;56;21;3;18;.857;3900000;0
1668;86180;65;0;0;0;0;.00nan;0;0
1668;143507;41;65;40;3;37;.925;3900000;0
1669;183904;43;67;20;1;19;.950;3600000;0
1669;-1;51;0;0;0;0;.00nan;0;0
1669;90164;43;0;0;0;0;.00nan;0;0
1669;141484;51;87;39;3;36;.923;3600000;0
1670;167642;61;55;26;3;23;.885;3563000;0
1670;179950;61;0;0;0;0;.00nan;0;0
1670;68938;46;0;0;0;0;.00nan;0;0
1670;79280;46;93;31;1;30;.968;3600000;0
1671;171608;59;61;28;3;25;.893;3589000;0
1671;58054;59;0;0;0;0;.00nan;0;0
1671;85336;56;0;0;0;0;.00nan;0;0
1671;85468;56;92;41;2;39;.951;3600000;0
1672;37077;55;0;0;0;0;.00nan;0;0
1672;58037;53;78;25;1;24;.960;3600000;0
1672;78581;53;0;0;0;0;.00nan;0;0
1672;86862;55;72;32;3;29;.906;3561000;0
1673;169154;38;0;0;0;0;.00nan;0;0
1673;170963;38;59;24;3;21;.875;3600000;0
1673;170977;41;40;36;6;30;.833;3600000;0
1673;143507;41;0;0;0;0;.00nan;0;0
1674;170314;4619;44;21;4;17;.810;3600000;0
1674;64800;4619;0;0;0;0;.00nan;0;0
1674;79132;49;49;34;5;29;.853;3566000;0
1674;91225;49;0;0;0;0;.00nan;0;0
1675;5311;42;0;0;0;0;.00nan;0;0
1675;163471;37;0;0;0;0;.00nan;0;0
1675;141496;42;64;44;4;40;.909;3600000;0
1675;141850;37;58;19;2;17;.895;3600000;0
1676;172499;50;0;0;0;0;.00nan;0;0
1676;163989;45;0;0;0;0;.00nan;0;0
1676;179350;45;82;48;4;44;.917;3600000;0
1676;76574;50;78;26;1;25;.962;3600000;0
1677;182780;60;74;22;2;20;.909;3847000;0
1677;170294;60;0;0;0;0;.00nan;0;0
1677;47112;4837;0;0;0;0;.00nan;0;0
1677;78775;4837;94;33;1;32;.970;3847000;0
1678;183904;43;0;0;0;0;.00nan;0;0
1678;37077;55;0;0;0;0;.00nan;0;0
1678;86862;55;100;28;0;28;1.000;3600000;0
1678;90164;43;75;30;2;28;.933;3590000;0
1679;172340;48;98;69;5;64;.928;3600000;0
1679;170598;48;0;0;0;0;.00nan;0;0
1679;60773;47;0;0;0;0;.00nan;0;0
1679;79141;47;60;17;2;15;.882;3600000;0
1680;182780;60;0;0;0;0;.00nan;0;0
1680;170294;60;62;27;3;24;.889;3633000;0
1680;47112;4837;64;34;4;30;.882;3633000;0
1680;78775;4837;0;0;0;0;.00nan;0;0
1681;175757;63;0;0;0;0;.00nan;0;0
1681;181123;63;51;55;9;46;.836;3600000;0
1681;94615;54;0;0;0;0;.00nan;0;0
1681;143301;54;67;19;1;18;.947;3600000;0
1682;167642;61;0;0;0;0;.00nan;0;0
1682;178384;40;63;35;4;31;.886;3590000;0
1682;179950;61;73;29;2;27;.931;3600000;0
1682;85636;40;0;0;0;0;.00nan;0;0
1683;5311;42;83;34;2;32;.941;3600000;0
1683;163989;45;0;0;0;0;.00nan;0;0
1683;179350;45;74;41;4;37;.902;3600000;0
1683;141496;42;0;0;0;0;.00nan;0;0
1684;170977;41;56;5;0;5;1.000;786000;0
1684;38276;65;0;0;0;0;.00nan;0;0
1684;86180;65;68;19;1;18;.947;3600000;0
1684;143507;41;31;36;7;29;.806;2814000;0
1685;164715;62;91;45;3;42;.933;3600000;0
1685;176860;44;0;0;0;0;.00nan;0;0
1685;57434;44;65;41;5;36;.878;3530000;0
1685;152418;62;0;0;0;0;.00nan;0;0
1686;173699;36;93;57;5;52;.912;3600000;0
1686;37077;55;0;0;0;0;.00nan;0;0
1686;86862;55;68;20;2;18;.900;3600000;0
1686;152710;36;0;0;0;0;.00nan;0;0
1687;169154;38;75;48;4;44;.917;3575000;0
1687;170963;38;0;0;0;0;.00nan;0;0
1687;171608;59;0;0;0;0;.00nan;0;0
1687;58054;59;63;18;2;16;.889;3600000;0
1688;171673;64;96;39;1;38;.974;3900000;0
1688;175757;63;0;0;0;0;.00nan;0;0
1688;176915;64;0;0;0;0;.00nan;0;0
1688;181123;63;99;44;1;43;.977;3900000;0
1689;167642;61;0;0;0;0;.00nan;0;0
1689;178384;40;44;36;6;30;.833;3087000;0
1689;179950;61;82;33;1;32;.970;3600000;0
1689;85636;40;57;6;0;6;1.000;513000;0
1690;170977;41;62;7;0;7;1.000;696000;0
1690;180316;52;0;0;0;0;.00nan;0;0
1690;37857;52;54;17;2;15;.882;3600000;0
1690;143507;41;40;47;7;40;.851;2904000;0
1691;-1;51;78;42;4;38;.905;3600000;0
1691;85336;56;0;0;0;0;.00nan;0;0
1691;85468;56;75;20;1;19;.950;3600000;0
1691;141484;51;0;0;0;0;.00nan;0;0
1692;163471;37;52;23;3;20;.870;3554000;0
1692;163989;45;94;46;2;44;.957;3600000;0
1692;179350;45;0;0;0;0;.00nan;0;0
1692;141850;37;0;0;0;0;.00nan;0;0
1693;60773;47;0;0;0;0;.00nan;0;0
1693;79132;49;60;57;8;49;.860;3600000;0
1693;79141;47;79;9;0;9;1.000;3600000;0
1693;91225;49;0;0;0;0;.00nan;0;0
1694;163462;58;0;0;0;0;.00nan;0;0
1694;170314;4619;80;24;1;23;.958;3900000;0
1694;37942;58;100;39;1;38;.974;3900000;0
1694;64800;4619;0;0;0;0;.00nan;0;0
1695;183904;43;0;0;0;0;.00nan;0;0
1695;58037;53;0;0;0;0;.00nan;0;0
1695;78581;53;99;37;1;36;.973;3600000;0
1695;90164;43;63;36;4;32;.889;3600000;0
1696;5311;42;67;34;4;30;.882;3600000;0
1696;94615;54;0;0;0;0;.00nan;0;0
1696;141496;42;0;0;0;0;.00nan;0;0
1696;143301;54;78;23;1;22;.957;3600000;0
1697;164715;62;84;37;2;35;.946;3592000;0
1697;176860;44;0;0;0;0;.00nan;0;0
1697;57434;44;93;34;1;33;.971;3600000;0
1697;152418;62;0;0;0;0;.00nan;0;0
1698;169154;38;0;0;0;0;.00nan;0;0
1698;170963;38;84;12;0;12;1.000;3900000;0
1698;170977;41;97;36;0;36;1.000;3900000;0
1698;143507;41;0;0;0;0;.00nan;0;0
1699;163471;37;0;0;0;0;.00nan;0;0
1699;68938;46;0;0;0;0;.00nan;0;0
1699;79280;46;94;33;1;32;.970;3600000;0
1699;141850;37;74;26;2;24;.923;3600000;0
1700;172340;48;54;3;0;3;1.000;417000;0
1700;170598;48;31;32;6;26;.813;3183000;0
1700;79132;49;70;18;1;17;.944;3600000;0
1700;91225;49;0;0;0;0;.00nan;0;0
1701;171673;64;0;0;0;0;.00nan;0;0
1701;175757;63;99;23;0;23;1.000;3600000;0
1701;176915;64;53;19;2;17;.895;3550000;0
1701;181123;63;0;0;0;0;.00nan;0;0
1702;171608;59;54;15;1;14;.933;3600000;0
1702;180316;52;55;35;5;30;.857;3600000;0
1702;37857;52;0;0;0;0;.00nan;0;0
1702;58054;59;0;0;0;0;.00nan;0;0
1703;176136;57;0;0;0;0;.00nan;0;0
1703;38276;65;0;0;0;0;.00nan;0;0
1703;57152;57;64;44;5;39;.886;3600000;0
1703;86180;65;60;13;2;11;.846;3600000;0
1704;182780;60;26;12;4;8;.667;1198000;0
1704;170294;60;44;16;3;13;.813;2402000;0
1704;60773;47;75;22;2;20;.909;3600000;0
1704;79141;47;0;0;0;0;.00nan;0;0
1705;5311;42;0;0;0;0;.00nan;0;0
1705;94615;54;97;56;3;53;.946;3600000;0
1705;141496;42;67;22;2;20;.909;3600000;0
1705;143301;54;0;0;0;0;.00nan;0;0
1706;-1;51;47;5;1;4;.800;240000;0
1706;85336;56;50;27;5;22;.815;3600000;0
1706;85468;56;0;0;0;0;.00nan;0;0
1706;141484;51;40;46;7;39;.848;3360000;0
1707;183904;43;25;26;6;20;.769;3600000;0
1707;58037;53;78;37;3;34;.919;3600000;0
1707;78581;53;0;0;0;0;.00nan;0;0
1707;90164;43;0;0;0;0;.00nan;0;0
1708;173699;36;89;33;2;31;.939;3600000;0
1708;37077;55;0;0;0;0;.00nan;0;0
1708;86862;55;32;27;6;21;.778;3600000;0
1708;152710;36;0;0;0;0;.00nan;0;0
1709;163989;45;75;40;3;37;.925;3900000;0
1709;179350;45;0;0;0;0;.00nan;0;0
1709;68938;46;70;29;3;26;.897;3900000;0
1709;79280;46;0;0;0;0;.00nan;0;0
1710;172340;48;92;53;4;49;.925;3560000;0
1710;167642;61;0;0;0;0;.00nan;0;0
1710;170598;48;0;0;0;0;.00nan;0;0
1710;179950;61;44;10;2;8;.800;3600000;0
1711;176136;57;61;50;6;44;.880;3600000;0
1711;38276;65;84;27;1;26;.963;3600000;0
1711;57152;57;0;0;0;0;.00nan;0;0
1711;86180;65;0;0;0;0;.00nan;0;0
1712;172499;50;0;0;0;0;.00nan;0;0
1712;43928;39;0;0;0;0;.00nan;0;0
1712;59025;39;60;39;5;34;.872;3579000;0
1712;76574;50;45;25;4;21;.840;3600000;0
1713;182780;60;59;22;2;20;.909;3568000;0
1713;178384;40;87;29;1;28;.966;3600000;0
1713;170294;60;0;0;0;0;.00nan;0;0
1713;85636;40;0;0;0;0;.00nan;0;0
1714;171608;59;0;0;0;0;.00nan;0;0
1714;180316;52;0;0;0;0;.00nan;0;0
1714;37857;52;96;40;1;39;.975;3600000;0
1714;58054;59;69;28;2;26;.929;3550000;0
1715;163462;58;0;0;0;0;.00nan;0;0
1715;170314;4619;93;33;1;32;.970;3600000;0
1715;37942;58;43;31;5;26;.839;3600000;0
1715;64800;4619;0;0;0;0;.00nan;0;0
1716;172499;50;0;0;0;0;.00nan;0;0
1716;43928;39;98;40;2;38;.950;3600000;0
1716;59025;39;0;0;0;0;.00nan;0;0
1716;76574;50;63;28;3;25;.893;3594000;0
1717;183904;43;0;0;0;0;.00nan;0;0
1717;169154;38;0;0;0;0;.00nan;0;0
1717;170963;38;90;53;3;50;.943;3600000;0
1717;90164;43;80;12;0;12;1.000;3600000;0
1718;164715;62;0;0;0;0;.00nan;0;0
1718;79132;49;51;32;5;27;.844;3562000;0
1718;91225;49;0;0;0;0;.00nan;0;0
1718;152418;62;79;36;4;32;.889;3600000;0
1719;164715;62;62;24;3;21;.875;3600000;0
1719;79132;49;72;13;0;13;1.000;828000;0
1719;91225;49;35;32;6;26;.813;2772000;0
1719;152418;62;0;0;0;0;.00nan;0;0
1720;171673;64;98;44;2;42;.955;3600000;0
1720;176915;64;0;0;0;0;.00nan;0;0
1720;68938;46;0;0;0;0;.00nan;0;0
1720;79280;46;89;20;0;20;1.000;3600000;0
1721;170977;41;27;27;6;21;.778;2140000;0
1721;171608;59;0;0;0;0;.00nan;0;0
1721;58054;59;79;27;1;26;.963;3600000;0
1721;143507;41;40;10;2;8;.800;1460000;0
1722;172340;48;67;34;3;31;.912;3598000;0
1722;170598;48;0;0;0;0;.00nan;0;0
1722;47112;4837;91;30;1;29;.967;3600000;0
1722;78775;4837;0;0;0;0;.00nan;0;0
1723;37077;55;0;0;0;0;.00nan;0;0
1723;43928;39;0;0;0;0;.00nan;0;0
1723;59025;39;75;33;2;31;.939;3600000;0
1723;86862;55;60;32;3;29;.906;3559000;0
1724;163462;58;0;0;0;0;.00nan;0;0
1724;37942;58;95;63;4;59;.937;3600000;0
1724;60773;47;0;0;0;0;.00nan;0;0
1724;79141;47;65;19;1;18;.947;3600000;0
1725;176136;57;0;0;0;0;.00nan;0;0
1725;57152;57;95;54;1;53;.981;3900000;0
1725;58037;53;77;18;1;17;.944;3900000;0
1725;78581;53;0;0;0;0;.00nan;0;0
1726;173699;36;96;38;2;36;.947;3600000;0
1726;-1;51;0;0;0;0;.00nan;0;0
1726;141484;51;87;13;0;13;1.000;3600000;0
1726;152710;36;0;0;0;0;.00nan;0;0
1727;172499;50;0;0;0;0;.00nan;0;0
1727;37077;55;0;0;0;0;.00nan;0;0
1727;76574;50;100;29;1;28;.966;3900000;0
1727;86862;55;92;38;1;37;.974;3900000;0
1728;176860;44;0;0;0;0;.00nan;0;0
1728;47112;4837;0;0;0;0;.00nan;0;0
1728;57434;44;77;27;2;25;.926;3600000;0
1728;78775;4837;55;30;4;26;.867;3522000;0
1729;169154;38;0;0;0;0;.00nan;0;0
1729;170963;38;92;20;0;20;1.000;3600000;0
1729;176136;57;0;0;0;0;.00nan;0;0
1729;57152;57;88;36;1;35;.972;3546000;0
1730;38276;65;0;0;0;0;.00nan;0;0
1730;43928;39;0;0;0;0;.00nan;0;0
1730;59025;39;100;31;0;31;1.000;3600000;0
1730;86180;65;97;40;1;39;.975;3600000;0
1731;178384;40;92;36;2;34;.944;3600000;0
1731;79132;49;72;34;3;31;.912;3544000;0
1731;85636;40;0;0;0;0;.00nan;0;0
1731;91225;49;0;0;0;0;.00nan;0;0
1732;180316;52;56;7;0;7;1.000;915000;0
1732;37857;52;19;19;6;13;.684;2685000;0
1732;58037;53;0;0;0;0;.00nan;0;0
1732;78581;53;76;31;3;28;.903;3600000;0
1733;163989;45;13;20;6;14;.700;1819000;0
1733;179350;45;62;17;3;14;.824;1781000;0
1733;94615;54;0;0;0;0;.00nan;0;0
1733;143301;54;80;28;1;27;.964;3600000;0
1734;163462;58;0;0;0;0;.00nan;0;0
1734;37942;58;69;41;4;37;.902;3600000;0
1734;60773;47;0;0;0;0;.00nan;0;0
1734;79141;47;34;23;5;18;.783;3578000;0
1735;182780;60;0;0;0;0;.00nan;0;0
1735;170294;60;75;50;5;45;.900;3551000;0
1735;170314;4619;53;22;4;18;.818;3600000;0
1735;64800;4619;0;0;0;0;.00nan;0;0
1736;170977;41;0;0;0;0;.00nan;0;0
1736;85336;56;0;0;0;0;.00nan;0;0
1736;85468;56;54;24;3;21;.875;3600000;0
1736;143507;41;83;37;2;35;.946;3600000;0
1737;183904;43;0;0;0;0;.00nan;0;0
1737;171608;59;0;0;0;0;.00nan;0;0
1737;58054;59;77;27;2;25;.926;3600000;0
1737;90164;43;41;36;6;30;.833;3600000;0
1738;5311;42;56;30;3;27;.900;3543000;0
1738;171673;64;0;0;0;0;.00nan;0;0
1738;176915;64;78;37;2;35;.946;3600000;0
1738;141496;42;0;0;0;0;.00nan;0;0
1739;172340;48;0;0;0;0;.00nan;0;0
1739;167642;61;0;0;0;0;.00nan;0;0
1739;170598;48;98;62;3;59;.952;3600000;0
1739;179950;61;97;23;0;23;1.000;3600000;0
1740;37077;55;72;41;4;37;.902;3600000;0
1740;38276;65;71;28;3;25;.893;3600000;0
1740;86180;65;0;0;0;0;.00nan;0;0
1740;86862;55;0;0;0;0;.00nan;0;0
1741;169154;38;0;0;0;0;.00nan;0;0
1741;170963;38;59;12;1;11;.917;3600000;0
1741;176136;57;46;34;5;29;.853;3600000;0
1741;57152;57;0;0;0;0;.00nan;0;0
1742;173699;36;77;34;3;31;.912;3900000;0
1742;-1;51;0;0;0;0;.00nan;0;0
1742;141484;51;72;38;3;35;.921;3900000;0
1742;152710;36;0;0;0;0;.00nan;0;0
1743;183904;43;82;32;2;30;.938;3600000;0
1743;171608;59;54;26;3;23;.885;3600000;0
1743;58054;59;0;0;0;0;.00nan;0;0
1743;90164;43;0;0;0;0;.00nan;0;0
1744;176860;44;25;21;5;16;.762;3600000;0
1744;47112;4837;87;33;2;31;.939;3600000;0
1744;57434;44;0;0;0;0;.00nan;0;0
1744;78775;4837;0;0;0;0;.00nan;0;0
1745;163471;37;62;17;2;15;.882;3600000;0
1745;163989;45;61;6;0;6;1.000;456000;0
1745;179350;45;46;39;6;33;.846;3144000;0
1745;141850;37;0;0;0;0;.00nan;0;0
1746;68938;46;0;0;0;0;.00nan;0;0
1746;79280;46;45;24;4;20;.833;3519000;0
1746;94615;54;75;28;2;26;.929;3600000;0
1746;143301;54;0;0;0;0;.00nan;0;0
1747;180316;52;98;36;1;35;.972;3900000;0
1747;37857;52;0;0;0;0;.00nan;0;0
1747;58037;53;97;48;1;47;.979;3900000;0
1747;78581;53;0;0;0;0;.00nan;0;0
1748;182780;60;23;13;4;9;.692;1159000;0
1748;170294;60;69;22;2;20;.909;2441000;0
1748;170314;4619;60;26;3;23;.885;3600000;0
1748;64800;4619;0;0;0;0;.00nan;0;0
1749;5311;42;0;0;0;0;.00nan;0;0
1749;171673;64;62;45;5;40;.889;3588000;0
1749;176915;64;0;0;0;0;.00nan;0;0
1749;141496;42;50;22;3;19;.864;3600000;0
1750;172499;50;0;0;0;0;.00nan;0;0
1750;175757;63;61;35;4;31;.886;3546000;0
1750;181123;63;0;0;0;0;.00nan;0;0
1750;76574;50;88;38;3;35;.921;3600000;0
1751;172340;48;48;50;7;43;.860;3600000;0
1751;167642;61;0;0;0;0;.00nan;0;0
1751;170598;48;0;0;0;0;.00nan;0;0
1751;179950;61;52;14;2;12;.857;3600000;0
1752;43928;39;0;0;0;0;.00nan;0;0
1752;59025;39;71;36;3;33;.917;3594000;0
1752;85336;56;66;23;2;21;.913;3600000;0
1752;85468;56;0;0;0;0;.00nan;0;0
1753;169154;38;74;34;3;31;.912;3600000;0
1753;170963;38;0;0;0;0;.00nan;0;0
1753;180316;52;0;0;0;0;.00nan;0;0
1753;37857;52;74;16;1;15;.938;3600000;0
1754;68938;46;23;11;4;7;.636;541000;0
1754;79280;46;96;38;1;37;.974;3059000;0
1754;94615;54;0;0;0;0;.00nan;0;0
1754;143301;54;45;11;2;9;.818;3600000;0
1755;163471;37;0;0;0;0;.00nan;0;0
1755;163989;45;100;42;1;41;.976;3900000;0
1755;179350;45;0;0;0;0;.00nan;0;0
1755;141850;37;77;20;1;19;.950;3900000;0
1756;178384;40;0;0;0;0;.00nan;0;0
1756;79132;49;95;36;2;34;.944;3600000;0
1756;85636;40;58;27;3;24;.889;3600000;0
1756;91225;49;0;0;0;0;.00nan;0;0
1757;172499;50;69;16;1;15;.938;3600000;0
1757;175757;63;0;0;0;0;.00nan;0;0
1757;181123;63;70;43;4;39;.907;3600000;0
1757;76574;50;0;0;0;0;.00nan;0;0
1758;163462;58;0;0;0;0;.00nan;0;0
1758;173699;36;54;35;4;31;.886;3776000;0
1758;37942;58;36;26;5;21;.808;3771000;0
1758;152710;36;0;0;0;0;.00nan;0;0
1759;164715;62;0;0;0;0;.00nan;0;0
1759;47112;4837;46;5;1;4;.800;331000;0
1759;78775;4837;52;36;6;30;.833;3269000;0
1759;152418;62;67;27;2;25;.926;3600000;0
1760;167642;61;0;0;0;0;.00nan;0;0
1760;179950;61;61;19;2;17;.895;3600000;0
1760;79132;49;86;47;3;44;.936;3589000;0
1760;91225;49;0;0;0;0;.00nan;0;0
1761;172340;48;45;39;6;33;.846;2438000;0
1761;178384;40;97;18;0;18;1.000;3600000;0
1761;170598;48;55;16;2;14;.875;1162000;0
1761;85636;40;0;0;0;0;.00nan;0;0
1762;170314;4619;93;47;3;44;.936;3574000;0
1762;60773;47;0;0;0;0;.00nan;0;0
1762;64800;4619;0;0;0;0;.00nan;0;0
1762;79141;47;64;24;2;22;.917;3600000;0
1763;175757;63;83;30;3;27;.900;3600000;0
1763;181123;63;0;0;0;0;.00nan;0;0
1763;38276;65;55;24;3;21;.875;2998000;0
1763;86180;65;33;12;3;9;.750;602000;0
1764;167642;61;66;15;1;14;.933;3600000;0
1764;179950;61;0;0;0;0;.00nan;0;0
1764;79132;49;0;0;0;0;.00nan;0;0
1764;91225;49;84;60;5;55;.917;3600000;0
1765;163462;58;85;35;2;33;.943;3900000;0
1765;173699;36;58;25;2;23;.920;3900000;0
1765;37942;58;0;0;0;0;.00nan;0;0
1765;152710;36;0;0;0;0;.00nan;0;0
1766;171608;59;0;0;0;0;.00nan;0;0
1766;180316;52;0;0;0;0;.00nan;0;0
1766;37857;52;59;28;3;25;.893;3597000;0
1766;58054;59;65;27;2;25;.926;3600000;0
1767;176136;57;0;0;0;0;.00nan;0;0
1767;57152;57;69;34;3;31;.912;3600000;0
1767;58037;53;0;0;0;0;.00nan;0;0
1767;78581;53;27;20;5;15;.750;3600000;0
1768;163471;37;60;30;3;27;.900;3545000;0
1768;94615;54;0;0;0;0;.00nan;0;0
1768;141850;37;0;0;0;0;.00nan;0;0
1768;143301;54;93;42;2;40;.952;3600000;0
1769;-1;51;96;40;1;39;.975;3597000;0
1769;43928;39;0;0;0;0;.00nan;0;0
1769;59025;39;93;18;0;18;1.000;3600000;0
1769;141484;51;0;0;0;0;.00nan;0;0
1770;172499;50;0;0;0;0;.00nan;0;0
1770;163989;45;40;32;6;26;.813;3234000;0
1770;179350;45;50;2;0;2;1.000;366000;0
1770;76574;50;62;19;2;17;.895;3600000;0
1771;169154;38;0;0;0;0;.00nan;0;0
1771;170963;38;80;31;3;28;.903;3600000;0
1771;170977;41;62;35;4;31;.886;3545000;0
1771;143507;41;0;0;0;0;.00nan;0;0
1772;183904;43;0;0;0;0;.00nan;0;0
1772;85336;56;0;0;0;0;.00nan;0;0
1772;85468;56;100;47;0;47;1.000;3600000;0
1772;90164;43;67;17;1;16;.941;3573000;0
1773;163462;58;0;0;0;0;.00nan;0;0
1773;37942;58;65;30;3;27;.900;3589000;0
1773;58037;53;63;21;2;19;.905;3600000;0
1773;78581;53;0;0;0;0;.00nan;0;0
1774;173699;36;66;30;3;27;.900;3600000;0
1774;175757;63;0;0;0;0;.00nan;0;0
1774;181123;63;74;20;1;19;.950;3600000;0
1774;152710;36;0;0;0;0;.00nan;0;0
1775;182780;60;0;0;0;0;.00nan;0;0
1775;5311;42;51;40;5;35;.875;3600000;0
1775;170294;60;77;33;3;30;.909;3600000;0
1775;141496;42;0;0;0;0;.00nan;0;0
1776;172499;50;0;0;0;0;.00nan;0;0
1776;171673;64;79;40;3;37;.925;3544000;0
1776;176915;64;0;0;0;0;.00nan;0;0
1776;76574;50;80;34;2;32;.941;3600000;0
1777;180316;52;0;0;0;0;.00nan;0;0
1777;37857;52;38;20;4;16;.800;3600000;0
1777;38276;65;0;0;0;0;.00nan;0;0
1777;86180;65;40;35;5;30;.857;3542000;0
1778;-1;51;52;40;6;34;.850;3007000;0
1778;43928;39;0;0;0;0;.00nan;0;0
1778;59025;39;54;28;4;24;.857;3600000;0
1778;141484;51;43;5;1;4;.800;593000;0
1779;163989;45;0;0;0;0;.00nan;0;0
1779;179350;45;82;36;3;33;.917;3600000;0
1779;94615;54;0;0;0;0;.00nan;0;0
1779;143301;54;60;29;4;25;.862;3583000;0
1780;60773;47;0;0;0;0;.00nan;0;0
1780;68938;46;0;0;0;0;.00nan;0;0
1780;79141;47;100;24;0;24;1.000;3600000;0
1780;79280;46;80;47;5;42;.894;3600000;0
1781;178384;40;54;35;4;31;.886;3567000;0
1781;170314;4619;71;32;3;29;.906;3600000;0
1781;64800;4619;0;0;0;0;.00nan;0;0
1781;85636;40;0;0;0;0;.00nan;0;0
1782;170977;41;63;26;2;24;.923;2508000;0
1782;171608;59;0;0;0;0;.00nan;0;0
1782;58054;59;41;20;4;16;.800;3600000;0
1782;143507;41;34;17;4;13;.765;1072000;0
1783;183904;43;0;0;0;0;.00nan;0;0
1783;85336;56;0;0;0;0;.00nan;0;0
1783;85468;56;88;33;1;32;.970;3600000;0
1783;90164;43;47;27;4;23;.852;3600000;0
1784;172340;48;98;59;3;56;.949;3600000;0
1784;164715;62;0;0;0;0;.00nan;0;0
1784;170598;48;0;0;0;0;.00nan;0;0
1784;152418;62;87;15;0;15;1.000;3600000;0
1785;169154;38;0;0;0;0;.00nan;0;0
1785;170963;38;75;27;2;25;.926;3600000;0
1785;180316;52;37;14;3;11;.786;3600000;0
1785;37857;52;0;0;0;0;.00nan;0;0
1786;176860;44;0;0;0;0;.00nan;0;0
1786;57434;44;99;32;1;31;.969;3600000;0
1786;79132;49;62;26;3;23;.885;3585000;0
1786;91225;49;0;0;0;0;.00nan;0;0
1787;163462;58;0;0;0;0;.00nan;0;0
1787;37942;58;79;30;1;29;.967;3600000;0
1787;58037;53;0;0;0;0;.00nan;0;0
1787;78581;53;42;16;3;13;.813;3524000;0
1788;182780;60;92;20;0;20;1.000;3600000;0
1788;5311;42;0;0;0;0;.00nan;0;0
1788;170294;60;0;0;0;0;.00nan;0;0
1788;141496;42;55;20;2;18;.900;3526000;0
1789;171608;59;61;32;4;28;.875;3900000;0
1789;37077;55;95;28;0;28;1.000;2986000;0
1789;58054;59;0;0;0;0;.00nan;0;0
1789;86862;55;23;12;4;8;.667;914000;0
1790;167642;61;0;0;0;0;.00nan;0;0
1790;179950;61;74;35;4;31;.886;3822000;0
1790;47112;4837;0;0;0;0;.00nan;0;0
1790;78775;4837;100;59;3;56;.949;3822000;0
1791;163471;37;39;20;4;16;.800;3600000;0
1791;176136;57;0;0;0;0;.00nan;0;0
1791;57152;57;66;50;6;44;.880;3540000;0
1791;141850;37;0;0;0;0;.00nan;0;0
1792;-1;51;76;32;3;29;.906;3587000;0
1792;38276;65;87;32;1;31;.969;3600000;0
1792;86180;65;0;0;0;0;.00nan;0;0
1792;141484;51;0;0;0;0;.00nan;0;0
1793;163989;45;97;49;2;47;.959;3600000;0
1793;179350;45;0;0;0;0;.00nan;0;0
1793;94615;54;63;14;1;13;.929;3600000;0
1793;143301;54;0;0;0;0;.00nan;0;0
1794;60773;47;79;29;2;27;.931;3600000;0
1794;68938;46;69;41;5;36;.878;3600000;0
1794;79141;47;0;0;0;0;.00nan;0;0
1794;79280;46;0;0;0;0;.00nan;0;0
1795;178384;40;72;38;4;34;.895;3589000;0
1795;170314;4619;66;20;2;18;.900;3600000;0
1795;64800;4619;0;0;0;0;.00nan;0;0
1795;85636;40;0;0;0;0;.00nan;0;0
1796;170977;41;0;0;0;0;.00nan;0;0
1796;85336;56;0;0;0;0;.00nan;0;0
1796;85468;56;60;17;2;15;.882;3600000;0
1796;143507;41;63;39;5;34;.872;3600000;0
1797;183904;43;65;16;1;15;.938;3600000;0
1797;43928;39;0;0;0;0;.00nan;0;0
1797;59025;39;89;47;3;44;.936;3540000;0
1797;90164;43;0;0;0;0;.00nan;0;0
1798;169154;38;61;23;3;20;.870;3530000;0
1798;170963;38;0;0;0;0;.00nan;0;0
1798;37077;55;0;0;0;0;.00nan;0;0
1798;86862;55;73;30;2;28;.933;3600000;0
1799;176860;44;59;19;2;17;.895;3760000;0
1799;57434;44;0;0;0;0;.00nan;0;0
1799;79132;49;0;0;0;0;.00nan;0;0
1799;91225;49;92;49;3;46;.939;3760000;0
1800;172499;50;0;0;0;0;.00nan;0;0
1800;171673;64;74;40;4;36;.900;3600000;0
1800;176915;64;0;0;0;0;.00nan;0;0
1800;76574;50;85;31;1;30;.968;3600000;0
1801;167642;61;85;30;1;29;.967;3641000;0
1801;179950;61;0;0;0;0;.00nan;0;0
1801;47112;4837;90;38;2;36;.947;3641000;0
1801;78775;4837;0;0;0;0;.00nan;0;0
1802;163471;37;0;0;0;0;.00nan;0;0
1802;176136;57;57;52;6;46;.885;3600000;0
1802;57152;57;0;0;0;0;.00nan;0;0
1802;141850;37;72;23;1;22;.957;3600000;0
1803;173699;36;39;19;4;15;.789;2340000;0
1803;175757;63;79;37;3;34;.919;3600000;0
1803;181123;63;0;0;0;0;.00nan;0;0
1803;152710;36;59;12;1;11;.917;1205000;0
1804;167642;61;0;0;0;0;.00nan;0;0
1804;178384;40;75;31;3;28;.903;3600000;0
1804;179950;61;49;18;2;16;.889;3600000;0
1804;85636;40;0;0;0;0;.00nan;0;0
1805;172340;48;80;50;5;45;.900;3600000;0
1805;170314;4619;100;27;0;27;1.000;3600000;0
1805;170598;48;0;0;0;0;.00nan;0;0
1805;64800;4619;0;0;0;0;.00nan;0;0
1806;171673;64;96;48;3;45;.938;3900000;0
1806;176915;64;0;0;0;0;.00nan;0;0
1806;68938;46;0;0;0;0;.00nan;0;0
1806;79280;46;69;32;3;29;.906;3900000;0
1807;164715;62;0;0;0;0;.00nan;0;0
1807;47112;4837;0;0;0;0;.00nan;0;0
1807;78775;4837;47;27;4;23;.852;3600000;0
1807;152418;62;75;25;1;24;.960;3600000;0
1808;5311;42;76;37;3;34;.919;3600000;0
1808;60773;47;0;0;0;0;.00nan;0;0
1808;79141;47;62;35;4;31;.886;3547000;0
1808;141496;42;0;0;0;0;.00nan;0;0
1809;37077;55;0;0;0;0;.00nan;0;0
1809;85336;56;0;0;0;0;.00nan;0;0
1809;85468;56;80;29;2;27;.931;3600000;0
1809;86862;55;39;27;5;22;.815;3600000;0
1810;176136;57;0;0;0;0;.00nan;0;0
1810;57152;57;78;38;3;35;.921;3600000;0
1810;58037;53;82;24;1;23;.958;3600000;0
1810;78581;53;0;0;0;0;.00nan;0;0
1811;176860;44;26;15;4;11;.733;665000;0
1811;43928;39;0;0;0;0;.00nan;0;0
1811;57434;44;41;33;6;27;.818;2935000;0
1811;59025;39;72;39;4;35;.897;3600000;0
1812;5311;42;63;28;3;25;.893;3600000;0
1812;164715;62;100;24;0;24;1.000;3600000;0
1812;141496;42;0;0;0;0;.00nan;0;0
1812;152418;62;0;0;0;0;.00nan;0;0
1813;-1;51;100;32;0;32;1.000;3600000;0
1813;37077;55;0;0;0;0;.00nan;0;0
1813;86862;55;65;18;1;17;.944;3600000;0
1813;141484;51;0;0;0;0;.00nan;0;0
1814;163462;58;0;0;0;0;.00nan;0;0
1814;176136;57;0;0;0;0;.00nan;0;0
1814;37942;58;67;23;2;21;.913;3600000;0
1814;57152;57;68;36;3;33;.917;3579000;0
1815;182780;60;72;36;3;33;.917;3900000;0
1815;163471;37;72;29;3;26;.897;3900000;0
1815;170294;60;0;0;0;0;.00nan;0;0
1815;141850;37;0;0;0;0;.00nan;0;0
1816;171673;64;77;34;3;31;.912;3600000;0
1816;176915;64;0;0;0;0;.00nan;0;0
1816;94615;54;0;0;0;0;.00nan;0;0
1816;143301;54;51;26;4;22;.846;3578000;0
1817;176921;59;0;0;0;0;.00nan;0;0
1817;38276;65;0;0;0;0;.00nan;0;0
1817;58054;59;31;17;4;13;.765;3600000;0
1817;86180;65;61;50;6;44;.880;3600000;0
1818;47112;4837;0;0;0;0;.00nan;0;0
1818;78775;4837;76;21;1;20;.952;3600000;0
1818;79132;49;67;27;3;24;.889;3573000;0
1818;91225;49;0;0;0;0;.00nan;0;0
1819;172499;50;0;0;0;0;.00nan;0;0
1819;163989;45;75;46;5;41;.891;3565000;0
1819;179350;45;0;0;0;0;.00nan;0;0
1819;76574;50;64;30;3;27;.900;3600000;0
1820;172340;48;100;58;1;57;.983;3600000;0
1820;178384;40;41;17;3;14;.824;3528000;0
1820;170598;48;0;0;0;0;.00nan;0;0
1820;85636;40;0;0;0;0;.00nan;0;0
1821;169154;38;0;0;0;0;.00nan;0;0
1821;170963;38;67;36;4;32;.889;3600000;0
1821;180316;52;0;0;0;0;.00nan;0;0
1821;37857;52;67;18;1;17;.944;3600000;0
1822;170977;41;0;0;0;0;.00nan;0;0
1822;58037;53;0;0;0;0;.00nan;0;0
1822;78581;53;64;14;1;13;.929;3600000;0
1822;143507;41;97;58;2;56;.966;3581000;0
1823;183904;43;0;0;0;0;.00nan;0;0
1823;175757;63;0;0;0;0;.00nan;0;0
1823;181123;63;99;58;2;56;.966;3600000;0
1823;90164;43;36;15;3;12;.800;3546000;0
1824;167642;61;0;0;0;0;.00nan;0;0
1824;174718;4619;58;40;5;35;.875;3600000;0
1824;179950;61;100;27;0;27;1.000;3600000;0
1824;64800;4619;0;0;0;0;.00nan;0;0
1825;176860;44;91;38;1;37;.974;3581000;0
1825;43928;39;0;0;0;0;.00nan;0;0
1825;57434;44;0;0;0;0;.00nan;0;0
1825;59025;39;97;30;0;30;1.000;3600000;0
1826;5311;42;0;0;0;0;.00nan;0;0
1826;164715;62;72;31;3;28;.903;3600000;0
1826;141496;42;59;32;4;28;.875;3564000;0
1826;152418;62;0;0;0;0;.00nan;0;0
1827;-1;51;78;29;2;27;.931;3566000;0
1827;37077;55;99;37;1;36;.973;3600000;0
1827;86862;55;0;0;0;0;.00nan;0;0
1827;141484;51;0;0;0;0;.00nan;0;0
1828;169154;38;81;54;5;49;.907;3530000;0
1828;170963;38;0;0;0;0;.00nan;0;0
1828;180316;52;48;21;3;18;.857;3600000;0
1828;37857;52;0;0;0;0;.00nan;0;0
1829;163462;58;54;16;2;14;.875;3600000;0
1829;176136;57;47;40;6;34;.850;3199000;0
1829;37942;58;0;0;0;0;.00nan;0;0
1829;57152;57;55;3;0;3;1.000;401000;0
1830;60773;47;0;0;0;0;.00nan;0;0
1830;68938;46;0;0;0;0;.00nan;0;0
1830;79141;47;55;22;3;19;.864;3600000;0
1830;79280;46;54;28;4;24;.857;3578000;0
1831;173699;36;90;45;2;43;.956;3600000;0
1831;85336;56;0;0;0;0;.00nan;0;0
1831;85468;56;75;28;3;25;.893;3561000;0
1831;152710;36;0;0;0;0;.00nan;0;0
1832;172340;48;0;0;0;0;.00nan;0;0
1832;178384;40;80;26;1;25;.962;3600000;0
1832;170598;48;74;35;3;32;.914;3600000;0
1832;85636;40;0;0;0;0;.00nan;0;0
1833;182780;60;0;0;0;0;.00nan;0;0
1833;163471;37;0;0;0;0;.00nan;0;0
1833;170294;60;46;38;6;32;.842;3600000;0
1833;141850;37;100;22;0;22;1.000;3600000;0
1834;176921;59;100;28;0;28;1.000;3600000;0
1834;38276;65;43;39;6;33;.846;3600000;0
1834;58054;59;0;0;0;0;.00nan;0;0
1834;86180;65;0;0;0;0;.00nan;0;0
1835;171673;64;78;40;3;37;.925;3600000;0
1835;176915;64;0;0;0;0;.00nan;0;0
1835;94615;54;21;32;7;25;.781;3253000;0
1835;143301;54;39;1;1;0;.000;347000;0
1836;183904;43;60;21;2;19;.905;3600000;0
1836;175757;63;62;44;5;39;.886;3600000;0
1836;181123;63;0;0;0;0;.00nan;0;0
1836;90164;43;0;0;0;0;.00nan;0;0
1837;167642;61;0;0;0;0;.00nan;0;0
1837;174718;4619;54;39;5;34;.872;3600000;0
1837;179950;61;71;22;2;20;.909;3600000;0
1837;64800;4619;0;0;0;0;.00nan;0;0
1838;170977;41;75;42;3;39;.929;3600000;0
1838;58037;53;0;0;0;0;.00nan;0;0
1838;78581;53;48;23;4;19;.826;3584000;0
1838;143507;41;0;0;0;0;.00nan;0;0
1839;60773;47;0;0;0;0;.00nan;0;0
1839;68938;46;91;45;3;42;.933;3544000;0
1839;79141;47;69;23;2;21;.913;3600000;0
1839;79280;46;0;0;0;0;.00nan;0;0
1840;173699;36;0;0;0;0;.00nan;0;0
1840;85336;56;80;35;3;32;.914;3647000;0
1840;85468;56;0;0;0;0;.00nan;0;0
1840;152710;36;65;37;4;33;.892;3647000;0
1841;47112;4837;69;26;2;24;.923;3555000;0
1841;78775;4837;0;0;0;0;.00nan;0;0
1841;79132;49;99;34;1;33;.971;3600000;0
1841;91225;49;0;0;0;0;.00nan;0;0
1842;172499;50;0;0;0;0;.00nan;0;0
1842;163989;45;76;30;2;28;.933;3600000;0
1842;179350;45;0;0;0;0;.00nan;0;0
1842;76574;50;40;14;3;11;.786;3588000;0
1843;180316;52;0;0;0;0;.00nan;0;0
1843;37857;52;76;23;1;22;.957;3600000;0
1843;38276;65;0;0;0;0;.00nan;0;0
1843;86180;65;53;46;6;40;.870;3600000;0
1844;163471;37;0;0;0;0;.00nan;0;0
1844;163989;45;94;41;1;40;.976;3900000;0
1844;179350;45;0;0;0;0;.00nan;0;0
1844;141850;37;70;15;1;14;.933;3900000;0
1845;171673;64;0;0;0;0;.00nan;0;0
1845;175757;63;0;0;0;0;.00nan;0;0
1845;176915;64;50;36;5;31;.861;3513000;0
1845;181123;63;82;43;3;40;.930;3600000;0
1846;173699;36;89;59;6;53;.898;3600000;0
1846;176921;59;56;19;2;17;.895;3600000;0
1846;58054;59;0;0;0;0;.00nan;0;0
1846;152710;36;0;0;0;0;.00nan;0;0
1847;37077;55;79;40;4;36;.900;3580000;0
1847;43928;39;0;0;0;0;.00nan;0;0
1847;59025;39;71;31;2;29;.935;3600000;0
1847;86862;55;0;0;0;0;.00nan;0;0
1848;60773;47;0;0;0;0;.00nan;0;0
1848;79141;47;65;20;2;18;.900;3600000;0
1848;94615;54;0;0;0;0;.00nan;0;0
1848;143301;54;69;33;3;30;.909;3600000;0
1849;178384;40;76;28;2;26;.929;3600000;0
1849;47112;4837;0;0;0;0;.00nan;0;0
1849;78775;4837;43;31;5;26;.839;3600000;0
1849;85636;40;0;0;0;0;.00nan;0;0
1850;172340;48;87;61;5;56;.918;3600000;0
1850;170598;48;0;0;0;0;.00nan;0;0
1850;176860;44;86;17;0;17;1.000;3600000;0
1850;57434;44;0;0;0;0;.00nan;0;0
1851;171673;64;70;43;5;38;.884;3600000;0
1851;176915;64;0;0;0;0;.00nan;0;0
1851;37077;55;0;0;0;0;.00nan;0;0
1851;86862;55;49;36;6;30;.833;3559000;0
1852;172499;50;0;0;0;0;.00nan;0;0
1852;76574;50;84;30;1;29;.967;3563000;0
1852;79132;49;0;0;0;0;.00nan;0;0
1852;91225;49;100;39;0;39;1.000;3600000;0
1853;182780;60;0;0;0;0;.00nan;0;0
1853;167642;61;0;0;0;0;.00nan;0;0
1853;170294;60;50;24;3;21;.875;3536000;0
1853;179950;61;90;32;1;31;.969;3600000;0
1854;163471;37;0;0;0;0;.00nan;0;0
1854;94615;54;0;0;0;0;.00nan;0;0
1854;141850;37;31;35;8;27;.771;3600000;0
1854;143301;54;65;31;3;28;.903;3600000;0
1855;176921;59;0;0;0;0;.00nan;0;0
1855;43928;39;0;0;0;0;.00nan;0;0
1855;58054;59;92;29;1;28;.966;3600000;0
1855;59025;39;49;40;6;34;.850;3600000;0
1856;180316;52;0;0;0;0;.00nan;0;0
1856;37857;52;73;23;1;22;.957;3600000;0
1856;38276;65;0;0;0;0;.00nan;0;0
1856;86180;65;63;43;5;38;.884;3600000;0
1857;164715;62;46;28;5;23;.821;3554000;0
1857;178384;40;72;36;4;32;.889;3600000;0
1857;85636;40;0;0;0;0;.00nan;0;0
1857;152418;62;0;0;0;0;.00nan;0;0
1858;163462;58;0;0;0;0;.00nan;0;0
1858;-1;51;99;42;1;41;.976;3600000;0
1858;37942;58;64;24;2;22;.917;3594000;0
1858;141484;51;0;0;0;0;.00nan;0;0
1859;163989;45;0;0;0;0;.00nan;0;0
1859;179350;45;94;47;3;44;.936;3731000;0
1859;60773;47;0;0;0;0;.00nan;0;0
1859;79141;47;63;23;2;21;.913;3731000;0
1860;174718;4619;78;27;2;25;.926;3600000;0
1860;47112;4837;0;0;0;0;.00nan;0;0
1860;64800;4619;0;0;0;0;.00nan;0;0
1860;78775;4837;59;37;5;32;.865;3600000;0
1861;183904;43;56;23;3;20;.870;3600000;0
1861;176136;57;0;0;0;0;.00nan;0;0
1861;57152;57;82;42;5;37;.881;3576000;0
1861;90164;43;0;0;0;0;.00nan;0;0
1862;5311;42;47;20;3;17;.850;3600000;0
1862;68938;46;41;2;1;1;.500;1059000;0
1862;79280;46;36;28;6;22;.786;2541000;0
1862;141496;42;0;0;0;0;.00nan;0;0
1863;169154;38;0;0;0;0;.00nan;0;0
1863;170963;38;78;35;2;33;.943;3600000;0
1863;85336;56;43;19;3;16;.842;3586000;0
1863;85468;56;0;0;0;0;.00nan;0;0
1864;173699;36;78;45;4;41;.911;3596000;0
1864;58037;53;0;0;0;0;.00nan;0;0
1864;78581;53;47;13;2;11;.846;3600000;0
1864;152710;36;0;0;0;0;.00nan;0;0
1865;172340;48;0;0;0;0;.00nan;0;0
1865;170598;48;94;43;3;40;.930;3583000;0
1865;176860;44;44;10;2;8;.800;3600000;0
1865;57434;44;0;0;0;0;.00nan;0;0
1866;164715;62;0;0;0;0;.00nan;0;0
1866;178384;40;36;29;6;23;.793;2734000;0
1866;85636;40;66;10;0;10;1.000;808000;0
1866;152418;62;45;32;5;27;.844;3600000;0
1867;171673;64;49;32;5;27;.844;3600000;0
1867;176915;64;0;0;0;0;.00nan;0;0
1867;37077;55;73;33;2;31;.939;3600000;0
1867;86862;55;0;0;0;0;.00nan;0;0
1868;182780;60;80;29;2;27;.931;3600000;0
1868;167642;61;39;29;5;24;.828;3600000;0
1868;170294;60;0;0;0;0;.00nan;0;0
1868;179950;61;0;0;0;0;.00nan;0;0
1869;173699;36;63;37;4;33;.892;3900000;0
1869;176136;57;81;44;4;40;.909;3900000;0
1869;57152;57;0;0;0;0;.00nan;0;0
1869;152710;36;0;0;0;0;.00nan;0;0
1870;163471;37;56;24;2;22;.917;3900000;0
1870;94615;54;0;0;0;0;.00nan;0;0
1870;141850;37;0;0;0;0;.00nan;0;0
1870;143301;54;84;26;2;24;.923;3900000;0
1871;176921;59;64;26;3;23;.885;3600000;0
1871;43928;39;0;0;0;0;.00nan;0;0
1871;58054;59;0;0;0;0;.00nan;0;0
1871;59025;39;59;47;5;42;.894;3560000;0
1872;163462;58;75;29;2;27;.931;3575000;0
1872;37942;58;0;0;0;0;.00nan;0;0
1872;38276;65;0;0;0;0;.00nan;0;0
1872;86180;65;91;27;1;26;.963;3600000;0
1873;163989;45;68;39;4;35;.897;3553000;0
1873;179350;45;0;0;0;0;.00nan;0;0
1873;60773;47;0;0;0;0;.00nan;0;0
1873;79141;47;58;26;3;23;.885;3600000;0
1874;174718;4619;50;24;3;21;.875;3587000;0
1874;47112;4837;74;30;2;28;.933;3600000;0
1874;64800;4619;0;0;0;0;.00nan;0;0
1874;78775;4837;0;0;0;0;.00nan;0;0
1875;169154;38;57;44;6;38;.864;3600000;0
1875;170963;38;0;0;0;0;.00nan;0;0
1875;170977;41;0;0;0;0;.00nan;0;0
1875;143507;41;76;25;1;24;.960;3600000;0
1876;183904;43;0;0;0;0;.00nan;0;0
1876;85336;56;46;16;3;13;.813;1621000;0
1876;85468;56;39;20;4;16;.800;1979000;0
1876;90164;43;79;25;1;24;.960;3600000;0
1877;5311;42;77;35;4;31;.886;3687000;0
1877;68938;46;0;0;0;0;.00nan;0;0
1877;79280;46;74;43;5;38;.884;3687000;0
1877;141496;42;0;0;0;0;.00nan;0;0
1878;180316;52;80;41;4;37;.902;3547000;0
1878;37857;52;0;0;0;0;.00nan;0;0
1878;58037;53;77;40;3;37;.925;3600000;0
1878;78581;53;0;0;0;0;.00nan;0;0
1879;172499;50;0;0;0;0;.00nan;0;0
1879;76574;50;83;28;1;27;.964;3600000;0
1879;79132;49;0;0;0;0;.00nan;0;0
1879;91225;49;72;36;3;33;.917;3570000;0
1880;163462;58;0;0;0;0;.00nan;0;0
1880;176136;57;52;2;0;2;1.000;444000;0
1880;37942;58;58;20;2;18;.900;3600000;0
1880;57152;57;37;42;7;35;.833;3156000;0
1881;171673;64;0;0;0;0;.00nan;0;0
1881;175757;63;0;0;0;0;.00nan;0;0
1881;176915;64;66;43;5;38;.884;3875000;0
1881;181123;63;57;39;5;34;.872;3900000;0
1882;183904;43;63;17;1;16;.941;3600000;0
1882;85336;56;0;0;0;0;.00nan;0;0
1882;85468;56;68;46;5;41;.891;3600000;0
1882;90164;43;0;0;0;0;.00nan;0;0
1883;182780;60;0;0;0;0;.00nan;0;0
1883;164715;62;0;0;0;0;.00nan;0;0
1883;170294;60;54;36;5;31;.861;3900000;0
1883;152418;62;44;27;5;22;.815;3900000;0
1884;163471;37;76;19;1;18;.947;3600000;0
1884;68938;46;0;0;0;0;.00nan;0;0
1884;79280;46;58;37;5;32;.865;3600000;0
1884;141850;37;0;0;0;0;.00nan;0;0
1885;172340;48;89;46;3;43;.935;3537000;0
1885;170598;48;0;0;0;0;.00nan;0;0
1885;176860;44;100;34;1;33;.971;3600000;0
1885;57434;44;0;0;0;0;.00nan;0;0
1886;5311;42;66;44;5;39;.886;3600000;0
1886;171673;64;65;49;6;43;.878;3600000;0
1886;176915;64;0;0;0;0;.00nan;0;0
1886;141496;42;0;0;0;0;.00nan;0;0
1887;176136;57;0;0;0;0;.00nan;0;0
1887;180316;52;0;0;0;0;.00nan;0;0
1887;37857;52;85;15;0;15;1.000;3600000;0
1887;57152;57;97;47;2;45;.957;3600000;0
1888;163462;58;0;0;0;0;.00nan;0;0
1888;37942;58;59;32;4;28;.875;3600000;0
1888;38276;65;0;0;0;0;.00nan;0;0
1888;86180;65;54;26;3;23;.885;3600000;0
1889;178384;40;0;0;0;0;.00nan;0;0
1889;47112;4837;0;0;0;0;.00nan;0;0
1889;78775;4837;85;33;2;31;.939;3600000;0
1889;85636;40;57;28;3;25;.893;3595000;0
1890;170977;41;49;25;4;21;.840;3600000;0
1890;-1;51;77;36;3;33;.917;3600000;0
1890;141484;51;0;0;0;0;.00nan;0;0
1890;143507;41;0;0;0;0;.00nan;0;0
1891;183904;43;0;0;0;0;.00nan;0;0
1891;58037;53;0;0;0;0;.00nan;0;0
1891;78581;53;72;40;4;36;.900;3600000;0
1891;90164;43;60;39;5;34;.872;3596000;0
1892;173699;36;64;32;4;28;.875;3600000;0
1892;37077;55;99;28;1;27;.964;3600000;0
1892;86862;55;0;0;0;0;.00nan;0;0
1892;152710;36;0;0;0;0;.00nan;0;0
1893;163462;58;36;26;5;21;.808;3600000;0
1893;169154;38;0;0;0;0;.00nan;0;0
1893;170963;38;54;42;6;36;.857;3578000;0
1893;37942;58;0;0;0;0;.00nan;0;0
1894;173699;36;0;0;0;0;.00nan;0;0
1894;37077;55;0;0;0;0;.00nan;0;0
1894;86862;55;71;22;2;20;.909;3900000;0
1894;152710;36;99;45;2;43;.956;3900000;0
1895;5311;42;99;39;1;38;.974;3600000;0
1895;171673;64;0;0;0;0;.00nan;0;0
1895;176915;64;87;34;2;32;.941;3584000;0
1895;141496;42;0;0;0;0;.00nan;0;0
1896;-1;51;45;33;6;27;.818;2125000;0
1896;176921;59;0;0;0;0;.00nan;0;0
1896;58054;59;100;23;0;23;1.000;3600000;0
1896;141484;51;45;18;3;15;.833;1475000;0
1897;38276;65;0;0;0;0;.00nan;0;0
1897;43928;39;0;0;0;0;.00nan;0;0
1897;59025;39;69;28;3;25;.893;3600000;0
1897;86180;65;46;39;5;34;.872;3590000;0
1898;172499;50;0;0;0;0;.00nan;0;0
1898;76574;50;79;25;2;23;.920;3600000;0
1898;94615;54;0;0;0;0;.00nan;0;0
1898;143301;54;82;42;3;39;.929;3584000;0
1899;175757;63;42;9;2;7;.778;967000;0
1899;180316;52;0;0;0;0;.00nan;0;0
1899;181123;63;44;35;6;29;.829;2633000;0
1899;37857;52;91;19;0;19;1.000;3600000;0
1900;163471;37;66;27;2;25;.926;3900000;0
1900;163989;45;97;43;2;41;.953;3900000;0
1900;179350;45;0;0;0;0;.00nan;0;0
1900;141850;37;0;0;0;0;.00nan;0;0
1901;174718;4619;0;0;0;0;.00nan;0;0
1901;64800;4619;100;31;0;31;1.000;3600000;0
1901;79132;49;45;28;5;23;.821;2595000;0
1901;91225;49;27;13;4;9;.692;1005000;0
1902;167642;61;0;0;0;0;.00nan;0;0
1902;176860;44;56;52;7;45;.865;3138000;0
1902;179950;61;67;24;2;22;.917;3600000;0
1902;57434;44;51;3;0;3;1.000;462000;0
1903;58037;53;0;0;0;0;.00nan;0;0
1903;78581;53;55;23;3;20;.870;3600000;0
1903;85336;56;100;32;0;32;1.000;3600000;0
1903;85468;56;0;0;0;0;.00nan;0;0
1904;163462;58;0;0;0;0;.00nan;0;0
1904;169154;38;68;23;2;21;.913;3833000;0
1904;170963;38;0;0;0;0;.00nan;0;0
1904;37942;58;77;40;3;37;.925;3833000;0
1905;5311;42;100;32;0;32;1.000;3600000;0
1905;68938;46;82;26;1;25;.962;3555000;0
1905;79280;46;0;0;0;0;.00nan;0;0
1905;141496;42;0;0;0;0;.00nan;0;0
1906;172340;48;64;35;4;31;.886;3600000;0
1906;164715;62;100;30;0;30;1.000;3600000;0
1906;170598;48;0;0;0;0;.00nan;0;0
1906;152418;62;0;0;0;0;.00nan;0;0
1907;176136;57;0;0;0;0;.00nan;0;0
1907;43928;39;0;0;0;0;.00nan;0;0
1907;57152;57;98;40;3;37;.925;3588000;0
1907;59025;39;84;23;1;22;.957;3600000;0
1908;170977;41;54;30;4;26;.867;3600000;0
1908;38276;65;0;0;0;0;.00nan;0;0
1908;86180;65;71;26;1;25;.962;3600000;0
1908;143507;41;0;0;0;0;.00nan;0;0
1909;182780;60;0;0;0;0;.00nan;0;0
1909;178384;40;87;14;0;14;1.000;3600000;0
1909;170294;60;59;27;3;24;.889;3600000;0
1909;85636;40;0;0;0;0;.00nan;0;0
1910;163471;37;0;0;0;0;.00nan;0;0
1910;163989;45;0;0;0;0;.00nan;0;0
1910;179350;45;74;29;2;27;.931;3600000;0
1910;141850;37;65;26;3;23;.885;3577000;0
1911;47112;4837;0;0;0;0;.00nan;0;0
1911;60773;47;100;28;0;28;1.000;3600000;0
1911;78775;4837;94;44;4;40;.909;3600000;0
1911;79141;47;0;0;0;0;.00nan;0;0
1912;174718;4619;53;16;2;14;.875;3600000;0
1912;64800;4619;0;0;0;0;.00nan;0;0
1912;79132;49;0;0;0;0;.00nan;0;0
1912;91225;49;53;38;6;32;.842;3600000;0
1913;167642;61;43;26;4;22;.846;3600000;0
1913;176860;44;0;0;0;0;.00nan;0;0
1913;179950;61;0;0;0;0;.00nan;0;0
1913;57434;44;56;38;5;33;.868;3600000;0
1914;183904;43;64;23;2;21;.913;3600000;0
1914;85336;56;0;0;0;0;.00nan;0;0
1914;85468;56;80;57;6;51;.895;3600000;0
1914;90164;43;0;0;0;0;.00nan;0;0
1915;-1;51;98;52;4;48;.923;3600000;0
1915;58037;53;53;10;1;9;.900;3600000;0
1915;78581;53;0;0;0;0;.00nan;0;0
1915;141484;51;0;0;0;0;.00nan;0;0
1916;163989;45;67;30;3;27;.900;3600000;0
1916;179350;45;0;0;0;0;.00nan;0;0
1916;68938;46;0;0;0;0;.00nan;0;0
1916;79280;46;67;22;2;20;.909;3600000;0
1917;182780;60;61;30;3;27;.900;3596000;0
1917;172340;48;0;0;0;0;.00nan;0;0
1917;170294;60;0;0;0;0;.00nan;0;0
1917;170598;48;96;51;2;49;.961;3600000;0
1918;175757;63;26;11;4;7;.636;1166000;0
1918;176921;59;0;0;0;0;.00nan;0;0
1918;181123;63;47;36;6;30;.833;2434000;0
1918;58054;59;72;21;1;20;.952;3600000;0
1919;170977;41;0;0;0;0;.00nan;0;0
1919;176136;57;77;24;1;23;.958;3600000;0
1919;57152;57;0;0;0;0;.00nan;0;0
1919;143507;41;39;32;6;26;.813;3600000;0
1920;172499;50;74;27;2;25;.926;3544000;0
1920;76574;50;0;0;0;0;.00nan;0;0
1920;94615;54;0;0;0;0;.00nan;0;0
1920;143301;54;84;32;1;31;.969;3600000;0
1921;183904;43;0;0;0;0;.00nan;0;0
1921;180316;52;0;0;0;0;.00nan;0;0
1921;37857;52;74;24;1;23;.958;3600000;0
1921;90164;43;93;40;2;38;.950;3600000;0
1922;172499;50;0;0;0;0;.00nan;0;0
1922;68938;46;50;1;0;1;1.000;365000;0
1922;76574;50;72;36;3;33;.917;3600000;0
1922;79280;46;25;24;6;18;.750;3235000;0
1923;5311;42;100;27;0;27;1.000;3600000;0
1923;171673;64;81;31;2;29;.935;3515000;0
1923;176915;64;0;0;0;0;.00nan;0;0
1923;141496;42;0;0;0;0;.00nan;0;0
1924;178384;40;100;39;1;38;.974;3600000;0
1924;176860;44;68;24;2;22;.917;3582000;0
1924;57434;44;0;0;0;0;.00nan;0;0
1924;85636;40;0;0;0;0;.00nan;0;0
1925;164715;62;54;30;4;26;.867;3600000;0
1925;79132;49;0;0;0;0;.00nan;0;0
1925;91225;49;65;41;5;36;.878;3598000;0
1925;152418;62;0;0;0;0;.00nan;0;0
1926;172340;48;62;52;7;45;.865;3355000;0
1926;170598;48;41;4;1;3;.750;245000;0
1926;47112;4837;0;0;0;0;.00nan;0;0
1926;78775;4837;61;13;1;12;.923;3600000;0
1927;163471;37;92;47;2;45;.957;3600000;0
1927;94615;54;0;0;0;0;.00nan;0;0
1927;141850;37;0;0;0;0;.00nan;0;0
1927;143301;54;57;32;4;28;.875;3536000;0
1928;173699;36;65;25;3;22;.880;3561000;0
1928;-1;51;83;34;2;32;.941;3600000;0
1928;141484;51;0;0;0;0;.00nan;0;0
1928;152710;36;0;0;0;0;.00nan;0;0
1929;163989;45;93;47;3;44;.936;3690000;0
1929;179350;45;0;0;0;0;.00nan;0;0
1929;60773;47;47;12;2;10;.833;3694000;0
1929;79141;47;0;0;0;0;.00nan;0;0
1930;167642;61;0;0;0;0;.00nan;0;0
1930;174718;4619;0;0;0;0;.00nan;0;0
1930;179950;61;79;33;2;31;.939;3600000;0
1930;64800;4619;70;30;3;27;.900;3570000;0
1931;183904;43;0;0;0;0;.00nan;0;0
1931;43928;39;57;13;1;12;.923;1039000;0
1931;59025;39;49;36;6;30;.833;2561000;0
1931;90164;43;51;25;4;21;.840;3600000;0
1932;5311;42;62;29;3;26;.897;3900000;0
1932;171673;64;0;0;0;0;.00nan;0;0
1932;176915;64;70;37;3;34;.919;3900000;0
1932;141496;42;0;0;0;0;.00nan;0;0
1933;175757;63;83;55;5;50;.909;3600000;0
1933;180316;52;0;0;0;0;.00nan;0;0
1933;181123;63;0;0;0;0;.00nan;0;0
1933;37857;52;61;18;2;16;.889;3600000;0
1934;178384;40;41;36;6;30;.833;3591000;0
1934;176860;44;0;0;0;0;.00nan;0;0
1934;57434;44;48;31;5;26;.839;3600000;0
1934;85636;40;0;0;0;0;.00nan;0;0
1935;37077;55;97;51;3;48;.941;3574000;0
1935;58037;53;67;17;1;16;.941;3600000;0
1935;78581;53;0;0;0;0;.00nan;0;0
1935;86862;55;0;0;0;0;.00nan;0;0
1936;163462;58;0;0;0;0;.00nan;0;0
1936;37942;58;33;22;5;17;.773;3600000;0
1936;38276;65;0;0;0;0;.00nan;0;0
1936;86180;65;86;29;1;28;.966;3600000;0
1937;167642;61;0;0;0;0;.00nan;0;0
1937;164715;62;0;0;0;0;.00nan;0;0
1937;179950;61;92;34;1;33;.971;3600000;0
1937;152418;62;81;45;4;41;.911;3600000;0
1938;175757;63;0;0;0;0;.00nan;0;0
1938;181123;63;58;31;4;27;.871;3600000;0
1938;37077;55;83;24;1;23;.958;3600000;0
1938;86862;55;0;0;0;0;.00nan;0;0
1939;163462;58;100;40;1;39;.975;3600000;0
1939;37942;58;0;0;0;0;.00nan;0;0
1939;38276;65;0;0;0;0;.00nan;0;0
1939;86180;65;48;28;5;23;.821;3600000;0
1940;182780;60;0;0;0;0;.00nan;0;0
1940;170294;60;55;10;1;9;.900;3600000;0
1940;79132;49;0;0;0;0;.00nan;0;0
1940;91225;49;90;52;4;48;.923;3600000;0
1941;169154;38;52;3;0;3;1.000;493000;0
1941;170963;38;49;39;6;33;.846;3107000;0
1941;176921;59;89;14;0;14;1.000;3600000;0
1941;58054;59;0;0;0;0;.00nan;0;0
1942;174718;4619;83;38;3;35;.921;3600000;0
1942;47112;4837;70;26;2;24;.923;3600000;0
1942;64800;4619;0;0;0;0;.00nan;0;0
1942;78775;4837;0;0;0;0;.00nan;0;0
1943;163471;37;72;18;1;17;.944;3600000;0
1943;172499;50;0;0;0;0;.00nan;0;0
1943;76574;50;73;32;3;29;.906;3525000;0
1943;141850;37;0;0;0;0;.00nan;0;0
1944;43928;39;56;45;6;39;.867;3600000;0
1944;58037;53;74;23;2;21;.913;3600000;0
1944;59025;39;0;0;0;0;.00nan;0;0
1944;78581;53;0;0;0;0;.00nan;0;0
1945;68938;46;0;0;0;0;.00nan;0;0
1945;79280;46;84;36;3;33;.917;3900000;0
1945;94615;54;0;0;0;0;.00nan;0;0
1945;143301;54;65;33;3;30;.909;3900000;0
1946;-1;51;93;36;1;35;.972;3720000;0
1946;180316;52;0;0;0;0;.00nan;0;0
1946;37857;52;90;20;0;20;1.000;3720000;0
1946;141484;51;0;0;0;0;.00nan;0;0
1947;163989;45;39;21;4;17;.810;1399000;0
1947;179350;45;39;38;6;32;.842;2201000;0
1947;60773;47;0;0;0;0;.00nan;0;0
1947;79141;47;56;26;5;21;.808;3600000;0
1948;170977;41;91;35;2;33;.943;3600000;0
1948;176136;57;0;0;0;0;.00nan;0;0
1948;57152;57;60;33;4;29;.879;3538000;0
1948;143507;41;0;0;0;0;.00nan;0;0
1949;183904;43;66;16;2;14;.875;3600000;0
1949;173699;36;80;40;4;36;.900;3591000;0
1949;90164;43;0;0;0;0;.00nan;0;0
1949;152710;36;0;0;0;0;.00nan;0;0
1950;68938;46;72;28;2;26;.929;3600000;0
1950;79280;46;0;0;0;0;.00nan;0;0
1950;94615;54;50;34;5;29;.853;3600000;0
1950;143301;54;0;0;0;0;.00nan;0;0
1951;172340;48;74;43;4;39;.907;3600000;0
1951;164715;62;66;19;1;18;.947;3600000;0
1951;170598;48;0;0;0;0;.00nan;0;0
1951;152418;62;0;0;0;0;.00nan;0;0
1952;182780;60;63;26;2;24;.923;3600000;0
1952;170294;60;0;0;0;0;.00nan;0;0
1952;79132;49;73;50;4;46;.920;3560000;0
1952;91225;49;0;0;0;0;.00nan;0;0
1953;174718;4619;0;0;0;0;.00nan;0;0
1953;47112;4837;0;0;0;0;.00nan;0;0
1953;64800;4619;64;25;2;23;.920;3600000;0
1953;78775;4837;91;51;5;46;.902;3600000;0
1954;176136;57;76;51;5;46;.902;3600000;0
1954;180316;52;72;20;2;18;.900;3600000;0
1954;37857;52;0;0;0;0;.00nan;0;0
1954;57152;57;0;0;0;0;.00nan;0;0
1955;163471;37;0;0;0;0;.00nan;0;0
1955;172499;50;0;0;0;0;.00nan;0;0
1955;76574;50;91;26;1;25;.962;3544000;0
1955;141850;37;100;28;0;28;1.000;3600000;0
1956;167642;61;54;41;6;35;.854;3286000;0
1956;179950;61;54;11;1;10;.909;314000;0
1956;60773;47;55;21;3;18;.857;3600000;0
1956;79141;47;0;0;0;0;.00nan;0;0
1957;169154;38;78;34;3;31;.912;3518000;0
1957;170963;38;0;0;0;0;.00nan;0;0
1957;170977;41;0;0;0;0;.00nan;0;0
1957;143507;41;87;28;1;27;.964;3600000;0
1958;183904;43;0;0;0;0;.00nan;0;0
1958;-1;51;90;66;5;61;.924;3600000;0
1958;90164;43;49;21;3;18;.857;3600000;0
1958;141484;51;0;0;0;0;.00nan;0;0
1959;173699;36;0;0;0;0;.00nan;0;0
1959;85336;56;55;29;4;25;.862;3600000;0
1959;85468;56;0;0;0;0;.00nan;0;0
1959;152710;36;81;16;0;16;1.000;3600000;0
1960;175757;63;0;0;0;0;.00nan;0;0
1960;181123;63;100;36;0;36;1.000;3600000;0
1960;37077;55;79;29;1;28;.966;3573000;0
1960;86862;55;0;0;0;0;.00nan;0;0
1961;164715;62;0;0;0;0;.00nan;0;0
1961;47112;4837;0;0;0;0;.00nan;0;0
1961;78775;4837;58;37;4;33;.892;3594000;0
1961;152418;62;81;34;3;31;.912;3600000;0
1962;169154;38;0;0;0;0;.00nan;0;0
1962;170963;38;92;45;2;43;.956;3600000;0
1962;180316;52;0;0;0;0;.00nan;0;0
1962;37857;52;76;17;1;16;.941;3600000;0
1963;173699;36;0;0;0;0;.00nan;0;0
1963;175757;63;0;0;0;0;.00nan;0;0
1963;181123;63;43;35;6;29;.829;3600000;0
1963;152710;36;72;23;2;21;.913;3600000;0
1964;172340;48;88;62;5;57;.919;3600000;0
1964;170598;48;0;0;0;0;.00nan;0;0
1964;60773;47;0;0;0;0;.00nan;0;0
1964;79141;47;44;9;2;7;.778;3600000;0
1965;176136;57;0;0;0;0;.00nan;0;0
1965;57152;57;78;46;4;42;.913;3600000;0
1965;58037;53;93;16;0;16;1.000;3600000;0
1965;78581;53;0;0;0;0;.00nan;0;0
1966;38276;65;0;0;0;0;.00nan;0;0
1966;85336;56;0;0;0;0;.00nan;0;0
1966;85468;56;67;35;4;31;.886;3572000;0
1966;86180;65;73;28;3;25;.893;3600000;0
1967;68938;46;0;0;0;0;.00nan;0;0
1967;79280;46;66;37;4;33;.892;3558000;0
1967;94615;54;0;0;0;0;.00nan;0;0
1967;143301;54;68;27;2;25;.926;3600000;0
1968;183904;43;0;0;0;0;.00nan;0;0
1968;-1;51;88;59;5;54;.915;3600000;0
1968;90164;43;68;18;1;17;.944;3600000;0
1968;141484;51;0;0;0;0;.00nan;0;0
1969;163989;45;0;0;0;0;.00nan;0;0
1969;171673;64;69;27;2;25;.926;3900000;0
1969;179350;45;78;34;2;32;.941;3900000;0
1969;176915;64;0;0;0;0;.00nan;0;0
1970;170977;41;42;40;6;34;.850;3244000;0
1970;176921;59;78;24;1;23;.958;3600000;0
1970;58054;59;0;0;0;0;.00nan;0;0
1970;143507;41;59;8;0;8;1.000;356000;0
1971;37077;55;44;38;6;32;.842;3600000;0
1971;43928;39;0;0;0;0;.00nan;0;0
1971;59025;39;68;35;3;32;.914;3600000;0
1971;86862;55;0;0;0;0;.00nan;0;0
1972;176860;44;0;0;0;0;.00nan;0;0
1972;57434;44;56;37;5;32;.865;3600000;0
1972;79132;49;0;0;0;0;.00nan;0;0
1972;91225;49;71;24;1;23;.958;3600000;0
1973;182780;60;0;0;0;0;.00nan;0;0
1973;163471;37;0;0;0;0;.00nan;0;0
1973;170294;60;52;34;5;29;.853;3600000;0
1973;141850;37;53;25;3;22;.880;3600000;0
1974;178384;40;64;41;5;36;.878;3600000;0
1974;60773;47;0;0;0;0;.00nan;0;0
1974;79141;47;61;19;2;17;.895;3600000;0
1974;85636;40;0;0;0;0;.00nan;0;0
1975;164715;62;0;0;0;0;.00nan;0;0
1975;174718;4619;85;45;3;42;.933;3600000;0
1975;64800;4619;0;0;0;0;.00nan;0;0
1975;152418;62;67;21;2;19;.905;3600000;0
1976;176860;44;65;23;2;21;.913;3600000;0
1976;57434;44;0;0;0;0;.00nan;0;0
1976;79132;49;83;37;3;34;.919;3600000;0
1976;91225;49;0;0;0;0;.00nan;0;0
1977;171673;64;39;31;7;24;.774;3334000;0
1977;176915;64;54;3;0;3;1.000;266000;0
1977;68938;46;80;25;1;24;.960;3600000;0
1977;79280;46;0;0;0;0;.00nan;0;0
1978;183904;43;46;32;6;26;.813;2518000;0
1978;43928;39;0;0;0;0;.00nan;0;0
1978;59025;39;57;12;1;11;.917;3600000;0
1978;90164;43;50;13;2;11;.846;1082000;0
1979;5311;42;71;34;3;31;.912;3538000;0
1979;172499;50;0;0;0;0;.00nan;0;0
1979;76574;50;91;32;1;31;.969;3600000;0
1979;141496;42;0;0;0;0;.00nan;0;0
1980;-1;51;93;23;1;22;.957;3900000;0
1980;176136;57;0;0;0;0;.00nan;0;0
1980;57152;57;95;33;1;32;.970;3900000;0
1980;141484;51;0;0;0;0;.00nan;0;0
1981;169154;38;0;0;0;0;.00nan;0;0
1981;170963;38;99;37;2;35;.946;3600000;0
1981;170977;41;0;0;0;0;.00nan;0;0
1981;143507;41;73;39;3;36;.923;3548000;0
1982;172340;48;60;41;6;35;.854;3600000;0
1982;167642;61;0;0;0;0;.00nan;0;0
1982;170598;48;0;0;0;0;.00nan;0;0
1982;179950;61;75;21;1;20;.952;3600000;0
1983;180316;52;0;0;0;0;.00nan;0;0
1983;37857;52;89;23;1;22;.957;3600000;0
1983;85336;56;0;0;0;0;.00nan;0;0
1983;85468;56;90;48;3;45;.938;3589000;0
1984;163462;58;0;0;0;0;.00nan;0;0
1984;37942;58;87;33;2;31;.939;3600000;0
1984;58037;53;25;13;4;9;.692;1148000;0
1984;78581;53;55;25;3;22;.880;2452000;0
1985;173699;36;73;34;4;30;.882;3600000;0
1985;68938;46;0;0;0;0;.00nan;0;0
1985;79280;46;89;25;1;24;.960;3600000;0
1985;152710;36;0;0;0;0;.00nan;0;0
1986;169154;38;67;49;6;43;.878;3600000;0
1986;170963;38;0;0;0;0;.00nan;0;0
1986;176921;59;77;16;1;15;.938;3600000;0
1986;58054;59;0;0;0;0;.00nan;0;0
1987;178384;40;68;30;3;27;.900;3600000;0
1987;47112;4837;0;0;0;0;.00nan;0;0
1987;78775;4837;77;41;4;37;.902;3600000;0
1987;85636;40;0;0;0;0;.00nan;0;0
1988;182780;60;0;0;0;0;.00nan;0;0
1988;163471;37;48;33;4;29;.879;3900000;0
1988;170294;60;89;43;4;39;.907;3900000;0
1988;141850;37;0;0;0;0;.00nan;0;0
1989;183904;43;0;0;0;0;.00nan;0;0
1989;43928;39;0;0;0;0;.00nan;0;0
1989;59025;39;76;37;3;34;.919;3600000;0
1989;90164;43;81;30;1;29;.967;3600000;0
1990;176136;57;31;22;5;17;.773;2217000;0
1990;38276;65;0;0;0;0;.00nan;0;0
1990;57152;57;45;12;2;10;.833;1383000;0
1990;86180;65;55;21;3;18;.857;3600000;0
1991;163989;45;33;35;6;29;.829;2251000;0
1991;179350;45;62;9;0;9;1.000;1349000;0
1991;94615;54;0;0;0;0;.00nan;0;0
1991;143301;54;85;31;2;29;.935;3600000;0
1992;164715;62;64;43;6;37;.860;2893000;0
1992;174718;4619;0;0;0;0;.00nan;0;0
1992;64800;4619;72;34;3;31;.912;3600000;0
1992;152418;62;58;5;0;5;1.000;707000;0
1993;170977;41;93;46;2;44;.957;3587000;0
1993;180316;52;76;25;1;24;.960;3600000;0
1993;37857;52;0;0;0;0;.00nan;0;0
1993;143507;41;0;0;0;0;.00nan;0;0
1994;175757;63;15;6;4;2;.333;382000;0
1994;181123;63;84;32;1;31;.969;3218000;0
1994;37077;55;30;15;4;11;.733;948000;0
1994;86862;55;58;28;3;25;.893;2628000;0
1995;167642;61;98;42;2;40;.952;3746000;0
1995;179950;61;0;0;0;0;.00nan;0;0
1995;60773;47;0;0;0;0;.00nan;0;0
1995;79141;47;67;31;3;28;.903;3746000;0
1996;-1;51;0;0;0;0;.00nan;0;0
1996;85336;56;61;15;1;14;.933;3600000;0
1996;85468;56;0;0;0;0;.00nan;0;0
1996;141484;51;59;43;5;38;.884;3600000;0
1997;163462;58;64;48;6;42;.875;3600000;0
1997;37942;58;0;0;0;0;.00nan;0;0
1997;58037;53;73;18;1;17;.944;3600000;0
1997;78581;53;0;0;0;0;.00nan;0;0
1998;173699;36;82;27;1;26;.963;2031000;0
1998;171673;64;0;0;0;0;.00nan;0;0
1998;176915;64;73;22;1;21;.955;3600000;0
1998;152710;36;23;25;6;19;.760;1569000;0
1999;163462;58;0;0;0;0;.00nan;0;0
1999;37942;58;91;41;3;38;.927;3900000;0
1999;38276;65;60;21;3;18;.857;3900000;0
1999;86180;65;0;0;0;0;.00nan;0;0
2000;5311;42;45;30;6;24;.800;2983000;0
2000;172499;50;0;0;0;0;.00nan;0;0
2000;76574;50;94;30;1;29;.967;3600000;0
2000;141496;42;57;6;0;6;1.000;617000;0
2001;178384;40;0;0;0;0;.00nan;0;0
2001;47112;4837;88;33;2;31;.939;3600000;0
2001;78775;4837;0;0;0;0;.00nan;0;0
2001;85636;40;41;32;5;27;.844;3600000;0
2002;163989;45;37;48;7;41;.854;3600000;0
2002;179350;45;0;0;0;0;.00nan;0;0
2002;94615;54;0;0;0;0;.00nan;0;0
2002;143301;54;75;26;2;24;.923;3600000;0
2003;172340;48;100;39;1;38;.974;3600000;0
2003;170598;48;0;0;0;0;.00nan;0;0
2003;79132;49;0;0;0;0;.00nan;0;0
2003;91225;49;57;20;2;18;.900;3548000;0
2004;172340;48;68;12;0;12;1.000;1290000;0
2004;170598;48;33;31;6;25;.806;2310000;0
2004;79132;49;75;22;1;21;.955;3600000;0
2004;91225;49;0;0;0;0;.00nan;0;0
2005;5311;42;86;33;3;30;.909;3600000;0
2005;68938;46;69;38;4;34;.895;3549000;0
2005;79280;46;0;0;0;0;.00nan;0;0
2005;141496;42;0;0;0;0;.00nan;0;0
2006;164715;62;0;0;0;0;.00nan;0;0
2006;176860;44;46;31;5;26;.839;3600000;0
2006;57434;44;0;0;0;0;.00nan;0;0
2006;152418;62;77;31;2;29;.935;3600000;0
2007;47112;4837;0;0;0;0;.00nan;0;0
2007;60773;47;0;0;0;0;.00nan;0;0
2007;78775;4837;67;28;2;26;.929;3600000;0
2007;79141;47;62;28;3;25;.893;3589000;0
2008;163462;58;0;0;0;0;.00nan;0;0
2008;176136;57;0;0;0;0;.00nan;0;0
2008;37942;58;72;34;3;31;.912;3651000;0
2008;57152;57;77;34;2;32;.941;3651000;0
2009;167642;61;0;0;0;0;.00nan;0;0
2009;174718;4619;58;30;4;26;.867;3600000;0
2009;179950;61;77;34;3;31;.912;3600000;0
2009;64800;4619;0;0;0;0;.00nan;0;0
2010;173699;36;66;35;5;30;.857;3600000;0
2010;175757;63;0;0;0;0;.00nan;0;0
2010;181123;63;95;31;1;30;.968;3600000;0
2010;152710;36;0;0;0;0;.00nan;0;0
2011;169154;38;0;0;0;0;.00nan;0;0
2011;170963;38;98;70;5;65;.929;3557000;0
2011;176921;59;56;26;3;23;.885;3600000;0
2011;58054;59;0;0;0;0;.00nan;0;0
2012;47112;4837;0;0;0;0;.00nan;0;0
2012;78775;4837;96;35;1;34;.971;3853000;0
2012;79132;49;78;29;2;27;.931;3853000;0
2012;91225;49;0;0;0;0;.00nan;0;0
2013;167642;61;67;29;2;27;.931;3252000;0
2013;179950;61;23;4;3;1;.250;348000;0
2013;68938;46;0;0;0;0;.00nan;0;0
2013;79280;46;89;36;2;34;.944;3600000;0
2014;163471;37;0;0;0;0;.00nan;0;0
2014;171673;64;91;31;2;29;.935;3541000;0
2014;176915;64;0;0;0;0;.00nan;0;0
2014;141850;37;75;25;1;24;.960;3600000;0
2015;182780;60;0;0;0;0;.00nan;0;0
2015;170294;60;65;36;3;33;.917;3900000;0
2015;94615;54;0;0;0;0;.00nan;0;0
2015;143301;54;73;28;3;25;.893;3900000;0
2016;178384;40;85;27;1;26;.963;3900000;0
2016;174718;4619;92;31;1;30;.968;3900000;0
2016;64800;4619;0;0;0;0;.00nan;0;0
2016;85636;40;0;0;0;0;.00nan;0;0
2017;173699;36;93;35;1;34;.971;3600000;0
2017;-1;51;79;31;2;29;.935;3574000;0
2017;141484;51;0;0;0;0;.00nan;0;0
2017;152710;36;0;0;0;0;.00nan;0;0
2018;164715;62;56;38;5;33;.868;3600000;0
2018;60773;47;78;22;2;20;.909;3600000;0
2018;79141;47;0;0;0;0;.00nan;0;0
2018;152418;62;0;0;0;0;.00nan;0;0
2019;170977;41;0;0;0;0;.00nan;0;0
2019;58037;53;60;26;4;22;.846;3549000;0
2019;78581;53;0;0;0;0;.00nan;0;0
2019;143507;41;80;36;2;34;.944;3600000;0
2020;5311;42;0;0;0;0;.00nan;0;0
2020;163989;45;90;48;2;46;.958;3600000;0
2020;179350;45;0;0;0;0;.00nan;0;0
2020;141496;42;54;26;4;22;.846;3599000;0
2021;43928;39;0;0;0;0;.00nan;0;0
2021;59025;39;67;37;4;33;.892;3535000;0
2021;85336;56;0;0;0;0;.00nan;0;0
2021;85468;56;66;24;2;22;.917;3600000;0
2022;163462;58;0;0;0;0;.00nan;0;0
2022;169154;38;0;0;0;0;.00nan;0;0
2022;170963;38;89;40;3;37;.925;3808000;0
2022;37942;58;60;23;2;21;.913;3808000;0
2023;47112;4837;71;18;1;17;.944;3600000;0
2023;78775;4837;0;0;0;0;.00nan;0;0
2023;79132;49;0;0;0;0;.00nan;0;0
2023;91225;49;85;52;4;48;.923;3600000;0
2024;167642;61;0;0;0;0;.00nan;0;0
2024;179950;61;70;30;3;27;.900;3600000;0
2024;68938;46;71;42;4;38;.905;3572000;0
2024;79280;46;0;0;0;0;.00nan;0;0
2025;173699;36;97;18;0;18;1.000;3600000;0
2025;-1;51;98;47;1;46;.979;3600000;0
2025;141484;51;0;0;0;0;.00nan;0;0
2025;152710;36;0;0;0;0;.00nan;0;0
2026;172340;48;94;50;4;46;.920;3600000;0
2026;170598;48;0;0;0;0;.00nan;0;0
2026;176860;44;67;16;1;15;.938;3600000;0
2026;57434;44;0;0;0;0;.00nan;0;0
2027;176136;57;70;23;1;22;.957;1227000;0
2027;176921;59;76;18;1;17;.944;3600000;0
2027;57152;57;42;41;6;35;.854;2373000;0
2027;58054;59;0;0;0;0;.00nan;0;0
2028;163471;37;74;21;1;20;.952;3600000;0
2028;171673;64;0;0;0;0;.00nan;0;0
2028;176915;64;96;47;3;44;.936;3600000;0
2028;141850;37;0;0;0;0;.00nan;0;0
2029;172499;50;0;0;0;0;.00nan;0;0
2029;37077;55;31;29;6;23;.793;2903000;0
2029;76574;50;36;23;5;18;.783;3600000;0
2029;86862;55;49;2;0;2;1.000;688000;0
2030;182780;60;47;19;3;16;.842;3900000;0
2030;170294;60;0;0;0;0;.00nan;0;0
2030;94615;54;85;38;3;35;.921;3900000;0
2030;143301;54;0;0;0;0;.00nan;0;0
2031;178384;40;0;0;0;0;.00nan;0;0
2031;174718;4619;0;0;0;0;.00nan;0;0
2031;64800;4619;54;21;3;18;.857;3600000;0
2031;85636;40;48;32;5;27;.844;3596000;0
2032;164715;62;0;0;0;0;.00nan;0;0
2032;60773;47;0;0;0;0;.00nan;0;0
2032;79141;47;74;20;1;19;.950;3600000;0
2032;152418;62;70;53;6;47;.887;3600000;0
2033;170977;41;47;45;8;37;.822;3600000;0
2033;180316;52;0;0;0;0;.00nan;0;0
2033;37857;52;51;25;5;20;.800;3600000;0
2033;143507;41;0;0;0;0;.00nan;0;0
2034;5311;42;91;28;1;27;.964;3600000;0
2034;163989;45;0;0;0;0;.00nan;0;0
2034;179350;45;73;28;2;26;.929;3547000;0
2034;141496;42;0;0;0;0;.00nan;0;0
2035;183904;43;0;0;0;0;.00nan;0;0
2035;175757;63;0;0;0;0;.00nan;0;0
2035;181123;63;99;44;1;43;.977;3600000;0
2035;90164;43;36;21;5;16;.762;3600000;0
2036;38276;65;0;0;0;0;.00nan;0;0
2036;58037;53;68;25;2;23;.920;3600000;0
2036;78581;53;0;0;0;0;.00nan;0;0
2036;86180;65;87;39;3;36;.923;3600000;0
2037;163462;58;80;24;1;23;.958;3702000;0
2037;169154;38;90;39;2;37;.949;3702000;0
2037;170963;38;0;0;0;0;.00nan;0;0
2037;37942;58;0;0;0;0;.00nan;0;0
2038;172340;48;62;10;0;10;1.000;618000;0
2038;170598;48;39;35;6;29;.829;2982000;0
2038;176860;44;100;26;0;26;1.000;3600000;0
2038;57434;44;0;0;0;0;.00nan;0;0
2039;176136;57;0;0;0;0;.00nan;0;0
2039;38276;65;0;0;0;0;.00nan;0;0
2039;57152;57;88;49;4;45;.918;3900000;0
2039;86180;65;66;32;4;28;.875;3900000;0
2040;172499;50;0;0;0;0;.00nan;0;0
2040;37077;55;63;34;3;31;.912;3537000;0
2040;76574;50;68;16;1;15;.938;3600000;0
2040;86862;55;0;0;0;0;.00nan;0;0
2041;170977;41;67;19;1;18;.947;1501000;0
2041;180316;52;47;11;2;9;.818;3600000;0
2041;37857;52;0;0;0;0;.00nan;0;0
2041;143507;41;30;27;6;21;.778;2099000;0
2042;183904;43;54;9;1;8;.889;3576000;0
2042;175757;63;100;48;0;48;1.000;3600000;0
2042;181123;63;0;0;0;0;.00nan;0;0
2042;90164;43;0;0;0;0;.00nan;0;0
2043;43928;39;0;0;0;0;.00nan;0;0
2043;59025;39;76;24;2;22;.917;3556000;0
2043;85336;56;0;0;0;0;.00nan;0;0
2043;85468;56;98;39;1;38;.974;3600000;0
2044;176921;59;0;0;0;0;.00nan;0;0
2044;58037;53;0;0;0;0;.00nan;0;0
2044;58054;59;63;28;3;25;.893;3600000;0
2044;78581;53;81;47;4;43;.915;3590000;0
2045;178384;40;85;41;3;38;.927;3600000;0
2045;174718;4619;44;40;7;33;.825;3600000;0
2045;64800;4619;0;0;0;0;.00nan;0;0
2045;85636;40;0;0;0;0;.00nan;0;0
2046;172499;50;0;0;0;0;.00nan;0;0
2046;37077;55;97;30;1;29;.967;3600000;0
2046;76574;50;82;24;2;22;.917;3564000;0
2046;86862;55;0;0;0;0;.00nan;0;0
2047;169154;38;0;0;0;0;.00nan;0;0
2047;170963;38;47;15;2;13;.867;3600000;0
2047;170977;41;69;44;5;39;.886;3600000;0
2047;143507;41;0;0;0;0;.00nan;0;0
2048;171673;64;65;30;3;27;.900;3600000;0
2048;176915;64;0;0;0;0;.00nan;0;0
2048;94615;54;0;0;0;0;.00nan;0;0
2048;143301;54;100;28;0;28;1.000;3600000;0
2049;43928;39;0;0;0;0;.00nan;0;0
2049;59025;39;74;32;3;29;.906;3702000;0
2049;85336;56;0;0;0;0;.00nan;0;0
2049;85468;56;52;25;4;21;.840;3711000;0
2050;172340;48;83;45;4;41;.911;3600000;0
2050;170598;48;0;0;0;0;.00nan;0;0
2050;60773;47;0;0;0;0;.00nan;0;0
2050;79141;47;62;13;1;12;.923;3600000;0
2051;178384;40;88;38;2;36;.947;3600000;0
2051;79132;49;69;35;4;31;.886;3520000;0
2051;85636;40;0;0;0;0;.00nan;0;0
2051;91225;49;0;0;0;0;.00nan;0;0
2052;167642;61;0;0;0;0;.00nan;0;0
2052;176860;44;70;37;4;33;.892;3587000;0
2052;179950;61;64;18;2;16;.889;3600000;0
2052;57434;44;0;0;0;0;.00nan;0;0
2053;178384;40;0;0;0;0;.00nan;0;0
2053;79132;49;0;0;0;0;.00nan;0;0
2053;85636;40;100;27;0;27;1.000;3600000;0
2053;91225;49;70;36;4;32;.889;3600000;0
2054;163462;58;0;0;0;0;.00nan;0;0
2054;-1;51;27;36;7;29;.806;3600000;0
2054;37942;58;44;16;3;13;.813;3600000;0
2054;141484;51;0;0;0;0;.00nan;0;0
2055;182780;60;0;0;0;0;.00nan;0;0
2055;172340;48;98;42;2;40;.952;3900000;0
2055;170294;60;66;20;2;18;.900;3900000;0
2055;170598;48;0;0;0;0;.00nan;0;0
2056;163989;45;92;42;3;39;.929;3600000;0
2056;171673;64;74;20;1;19;.950;3600000;0
2056;179350;45;0;0;0;0;.00nan;0;0
2056;176915;64;0;0;0;0;.00nan;0;0
2057;47112;4837;56;5;0;5;1.000;389000;0
2057;78775;4837;42;34;6;28;.824;3211000;0
2057;94615;54;0;0;0;0;.00nan;0;0
2057;143301;54;62;21;2;19;.905;3600000;0
2058;172499;50;0;0;0;0;.00nan;0;0
2058;43928;39;46;34;6;28;.824;3013000;0
2058;59025;39;37;9;3;6;.667;587000;0
2058;76574;50;81;23;1;22;.957;3600000;0
2059;176921;59;40;15;3;12;.800;3600000;0
2059;38276;65;0;0;0;0;.00nan;0;0
2059;58054;59;0;0;0;0;.00nan;0;0
2059;86180;65;67;50;6;44;.880;3600000;0
2060;180316;52;0;0;0;0;.00nan;0;0
2060;37857;52;85;28;1;27;.964;3600000;0
2060;58037;53;72;23;2;21;.913;3574000;0
2060;78581;53;0;0;0;0;.00nan;0;0
2061;163471;37;0;0;0;0;.00nan;0;0
2061;60773;47;0;0;0;0;.00nan;0;0
2061;79141;47;79;29;2;27;.931;3600000;0
2061;141850;37;65;37;5;32;.865;3600000;0
2062;164715;62;62;20;2;18;.900;3600000;0
2062;174718;4619;36;29;5;24;.828;3600000;0
2062;64800;4619;0;0;0;0;.00nan;0;0
2062;152418;62;0;0;0;0;.00nan;0;0
2063;183904;43;0;0;0;0;.00nan;0;0
2063;170977;41;66;44;5;39;.886;3163000;0
2063;90164;43;72;17;1;16;.941;3600000;0
2063;143507;41;64;11;0;11;1.000;437000;0
2064;175757;63;74;33;3;30;.909;3600000;0
2064;181123;63;0;0;0;0;.00nan;0;0
2064;37077;55;50;26;4;22;.846;3584000;0
2064;86862;55;0;0;0;0;.00nan;0;0
2065;173699;36;37;36;6;30;.833;2576000;0
2065;85336;56;59;15;1;14;.933;3600000;0
2065;85468;56;0;0;0;0;.00nan;0;0
2065;152710;36;60;26;3;23;.885;1024000;0
2066;167642;61;85;26;1;25;.962;3600000;0
2066;176860;44;73;33;3;30;.909;3521000;0
2066;179950;61;0;0;0;0;.00nan;0;0
2066;57434;44;0;0;0;0;.00nan;0;0
2067;164715;62;50;1;0;1;1.000;446000;0
2067;174718;4619;0;0;0;0;.00nan;0;0
2067;64800;4619;69;31;3;28;.903;3600000;0
2067;152418;62;60;37;5;32;.865;3099000;0
2068;169154;38;0;0;0;0;.00nan;0;0
2068;170963;38;68;50;6;44;.880;3600000;0
2068;58037;53;0;0;0;0;.00nan;0;0
2068;78581;53;56;23;2;21;.913;3600000;0
2069;163462;58;73;22;2;20;.909;3900000;0
2069;-1;51;0;0;0;0;.00nan;0;0
2069;37942;58;0;0;0;0;.00nan;0;0
2069;141484;51;86;34;2;32;.941;3900000;0
2070;182780;60;58;18;3;15;.833;3600000;0
2070;172340;48;0;0;0;0;.00nan;0;0
2070;170294;60;0;0;0;0;.00nan;0;0
2070;170598;48;71;49;5;44;.898;3567000;0
2071;163989;45;0;0;0;0;.00nan;0;0
2071;171673;64;0;0;0;0;.00nan;0;0
2071;179350;45;64;22;2;20;.909;3557000;0
2071;176915;64;99;45;1;44;.978;3600000;0
2072;176921;59;0;0;0;0;.00nan;0;0
2072;180316;52;38;36;6;30;.833;3671000;0
2072;37857;52;0;0;0;0;.00nan;0;0
2072;58054;59;31;18;5;13;.722;3671000;0
2073;47112;4837;29;14;4;10;.714;1058000;0
2073;78775;4837;48;27;4;23;.852;2542000;0
2073;94615;54;0;0;0;0;.00nan;0;0
2073;143301;54;85;20;1;19;.950;3600000;0
2074;172499;50;0;0;0;0;.00nan;0;0
2074;43928;39;0;0;0;0;.00nan;0;0
2074;59025;39;57;24;3;21;.875;3600000;0
2074;76574;50;59;32;4;28;.875;3600000;0
2075;176136;57;0;0;0;0;.00nan;0;0
2075;38276;65;68;30;3;27;.900;3600000;0
2075;57152;57;74;46;4;42;.913;3566000;0
2075;86180;65;0;0;0;0;.00nan;0;0
2076;163471;37;63;37;4;33;.892;3589000;0
2076;60773;47;68;23;2;21;.913;3600000;0
2076;79141;47;0;0;0;0;.00nan;0;0
2076;141850;37;0;0;0;0;.00nan;0;0
2077;183904;43;83;14;0;14;1.000;3600000;0
2077;173699;36;65;52;6;46;.885;2929000;0
2077;90164;43;0;0;0;0;.00nan;0;0
2077;152710;36;48;7;1;6;.857;671000;0
2078;5311;42;80;32;2;30;.938;3600000;0
2078;68938;46;0;0;0;0;.00nan;0;0
2078;79280;46;64;37;5;32;.865;3600000;0
2078;141496;42;0;0;0;0;.00nan;0;0
2079;170977;41;0;0;0;0;.00nan;0;0
2079;85336;56;0;0;0;0;.00nan;0;0
2079;85468;56;50;17;4;13;.765;3600000;0
2079;143507;41;54;45;6;39;.867;3600000;0
2080;175757;63;0;0;0;0;.00nan;0;0
2080;181123;63;66;24;2;22;.917;3600000;0
2080;37077;55;68;35;3;32;.914;3566000;0
2080;86862;55;0;0;0;0;.00nan;0;0
2081;169154;38;78;47;4;43;.915;3600000;0
2081;170963;38;0;0;0;0;.00nan;0;0
2081;180316;52;0;0;0;0;.00nan;0;0
2081;37857;52;76;15;1;14;.933;3600000;0
2082;5311;42;66;32;3;29;.906;3572000;0
2082;68938;46;0;0;0;0;.00nan;0;0
2082;79280;46;71;23;2;21;.913;3600000;0
2082;141496;42;0;0;0;0;.00nan;0;0
2083;169154;38;0;0;0;0;.00nan;0;0
2083;170963;38;91;39;2;37;.949;3600000;0
2083;176136;57;0;0;0;0;.00nan;0;0
2083;57152;57;54;21;3;18;.857;3545000;0
2084;172340;48;95;52;3;49;.942;3600000;0
2084;170598;48;0;0;0;0;.00nan;0;0
2084;47112;4837;0;0;0;0;.00nan;0;0
2084;78775;4837;62;13;1;12;.923;3600000;0
2085;170977;41;98;52;4;48;.923;3600000;0
2085;58037;53;83;23;1;22;.957;3600000;0
2085;78581;53;0;0;0;0;.00nan;0;0
2085;143507;41;0;0;0;0;.00nan;0;0
2086;183904;43;77;21;1;20;.952;3600000;0
2086;85336;56;0;0;0;0;.00nan;0;0
2086;85468;56;57;40;5;35;.875;3600000;0
2086;90164;43;0;0;0;0;.00nan;0;0
2087;163471;37;0;0;0;0;.00nan;0;0
2087;167642;61;0;0;0;0;.00nan;0;0
2087;179950;61;51;20;3;17;.850;3600000;0
2087;141850;37;81;37;2;35;.946;3600000;0
2088;178384;40;0;0;0;0;.00nan;0;0
2088;176860;44;0;0;0;0;.00nan;0;0
2088;57434;44;57;27;3;24;.889;3540000;0
2088;85636;40;72;25;2;23;.920;3600000;0
2089;163462;58;0;0;0;0;.00nan;0;0
2089;174718;4619;0;0;0;0;.00nan;0;0
2089;37942;58;40;22;4;18;.818;3600000;0
2089;64800;4619;26;32;7;25;.781;3600000;0
2090;182780;60;0;0;0;0;.00nan;0;0
2090;164715;62;35;24;5;19;.792;3544000;0
2090;170294;60;64;35;4;31;.886;3600000;0
2090;152418;62;0;0;0;0;.00nan;0;0
2091;178384;40;85;36;3;33;.917;3600000;0
2091;176860;44;49;28;4;24;.857;3600000;0
2091;57434;44;0;0;0;0;.00nan;0;0
2091;85636;40;0;0;0;0;.00nan;0;0
2092;163462;58;87;32;1;31;.969;3600000;0
2092;174718;4619;54;27;3;24;.889;3529000;0
2092;37942;58;0;0;0;0;.00nan;0;0
2092;64800;4619;0;0;0;0;.00nan;0;0
2093;172340;48;100;44;0;44;1.000;3600000;0
2093;170598;48;0;0;0;0;.00nan;0;0
2093;47112;4837;0;0;0;0;.00nan;0;0
2093;78775;4837;60;18;2;16;.889;3579000;0
2094;182780;60;42;24;4;20;.833;3550000;0
2094;164715;62;0;0;0;0;.00nan;0;0
2094;170294;60;0;0;0;0;.00nan;0;0
2094;152418;62;83;35;2;33;.943;3600000;0
2095;-1;51;69;41;5;36;.878;3600000;0
2095;38276;65;0;0;0;0;.00nan;0;0
2095;86180;65;76;15;0;15;1.000;3600000;0
2095;141484;51;0;0;0;0;.00nan;0;0
2096;163471;37;0;0;0;0;.00nan;0;0
2096;167642;61;0;0;0;0;.00nan;0;0
2096;179950;61;94;39;2;37;.949;3600000;0
2096;141850;37;61;39;4;35;.897;3545000;0
2097;37077;55;81;37;2;35;.946;3600000;0
2097;85336;56;59;28;3;25;.893;3600000;0
2097;85468;56;0;0;0;0;.00nan;0;0
2097;86862;55;0;0;0;0;.00nan;0;0
2098;180316;52;0;0;0;0;.00nan;0;0
2098;37857;52;98;36;2;34;.944;3900000;0
2098;58037;53;95;42;2;40;.952;3895000;0
2098;78581;53;0;0;0;0;.00nan;0;0
2099;173699;36;48;43;6;37;.860;2657000;0
2099;38276;65;0;0;0;0;.00nan;0;0
2099;86180;65;56;20;2;18;.900;3600000;0
2099;152710;36;69;11;0;11;1.000;943000;0
2100;172340;48;84;41;3;38;.927;3556000;0
2100;170598;48;0;0;0;0;.00nan;0;0
2100;79132;49;69;19;1;18;.947;3600000;0
2100;91225;49;0;0;0;0;.00nan;0;0
2101;176136;57;0;0;0;0;.00nan;0;0
2101;176921;59;73;19;2;17;.895;3900000;0
2101;57152;57;97;45;2;43;.956;3900000;0
2101;58054;59;0;0;0;0;.00nan;0;0
2102;37077;55;67;28;3;25;.893;3600000;0
2102;43928;39;58;30;4;26;.867;3555000;0
2102;59025;39;0;0;0;0;.00nan;0;0
2102;86862;55;0;0;0;0;.00nan;0;0
2103;172499;50;0;0;0;0;.00nan;0;0
2103;171673;64;93;54;4;50;.926;3600000;0
2103;176915;64;0;0;0;0;.00nan;0;0
2103;76574;50;99;25;0;25;1.000;3600000;0
2104;5311;42;88;38;3;35;.921;3551000;0
2104;94615;54;0;0;0;0;.00nan;0;0
2104;141496;42;0;0;0;0;.00nan;0;0
2104;143301;54;76;21;1;20;.952;3600000;0
2105;163989;45;83;35;2;33;.943;3600000;0
2105;179350;45;0;0;0;0;.00nan;0;0
2105;68938;46;0;0;0;0;.00nan;0;0
2105;79280;46;62;37;4;33;.892;3569000;0
2106;183904;43;0;0;0;0;.00nan;0;0
2106;180316;52;0;0;0;0;.00nan;0;0
2106;37857;52;53;24;3;21;.875;3600000;0
2106;90164;43;67;35;4;31;.886;3600000;0
2107;167642;61;0;0;0;0;.00nan;0;0
2107;179950;61;84;27;1;26;.963;3600000;0
2107;47112;4837;0;0;0;0;.00nan;0;0
2107;78775;4837;76;42;4;38;.905;3600000;0
2108;-1;51;26;36;7;29;.806;3600000;0
2108;85336;56;0;0;0;0;.00nan;0;0
2108;85468;56;72;27;2;25;.926;3600000;0
2108;141484;51;0;0;0;0;.00nan;0;0
2109;176860;44;91;32;1;31;.969;3600000;0
2109;57434;44;0;0;0;0;.00nan;0;0
2109;60773;47;0;0;0;0;.00nan;0;0
2109;79141;47;69;28;2;26;.929;3549000;0
2110;164715;62;55;21;3;18;.857;3600000;0
2110;79132;49;0;0;0;0;.00nan;0;0
2110;91225;49;64;50;6;44;.880;3600000;0
2110;152418;62;0;0;0;0;.00nan;0;0
2111;37077;55;70;31;3;28;.903;3600000;0
2111;43928;39;0;0;0;0;.00nan;0;0
2111;59025;39;88;35;2;33;.943;3600000;0
2111;86862;55;0;0;0;0;.00nan;0;0
2112;169154;38;0;0;0;0;.00nan;0;0
2112;170963;38;88;46;3;43;.935;3600000;0
2112;176921;59;0;0;0;0;.00nan;0;0
2112;58054;59;57;17;2;15;.882;3600000;0
2113;163462;58;0;0;0;0;.00nan;0;0
2113;175757;63;0;0;0;0;.00nan;0;0
2113;181123;63;68;34;3;31;.912;3600000;0
2113;37942;58;49;26;4;22;.846;3553000;0
2114;173699;36;24;12;4;8;.667;728000;0
2114;38276;65;0;0;0;0;.00nan;0;0
2114;86180;65;92;35;1;34;.971;3600000;0
2114;152710;36;46;29;5;24;.828;2872000;0
2115;182780;60;0;0;0;0;.00nan;0;0
2115;170294;60;53;18;3;15;.833;3600000;0
2115;174718;4619;63;36;4;32;.889;3571000;0
2115;64800;4619;0;0;0;0;.00nan;0;0
2116;176136;57;62;47;5;42;.894;3600000;0
2116;57152;57;0;0;0;0;.00nan;0;0
2116;58037;53;44;11;2;9;.818;3600000;0
2116;78581;53;0;0;0;0;.00nan;0;0
2117;172499;50;0;0;0;0;.00nan;0;0
2117;171673;64;0;0;0;0;.00nan;0;0
2117;176915;64;56;39;5;34;.872;3600000;0
2117;76574;50;70;24;2;22;.917;3600000;0
2118;5311;42;84;45;3;42;.933;3579000;0
2118;94615;54;0;0;0;0;.00nan;0;0
2118;141496;42;0;0;0;0;.00nan;0;0
2118;143301;54;87;30;1;29;.967;3600000;0
2119;172340;48;0;0;0;0;.00nan;0;0
2119;178384;40;100;22;0;22;1.000;3600000;0
2119;170598;48;75;45;4;41;.911;3600000;0
2119;85636;40;0;0;0;0;.00nan;0;0
2120;170977;41;100;37;1;36;.973;3600000;0
2120;-1;51;0;0;0;0;.00nan;0;0
2120;141484;51;46;23;4;19;.826;3600000;0
2120;143507;41;0;0;0;0;.00nan;0;0
2121;163471;37;0;0;0;0;.00nan;0;0
2121;163989;45;0;0;0;0;.00nan;0;0
2121;179350;45;82;41;2;39;.951;3600000;0
2121;141850;37;43;28;4;24;.857;3591000;0
2122;183904;43;78;25;1;24;.960;3600000;0
2122;85336;56;94;55;3;52;.945;3571000;0
2122;85468;56;0;0;0;0;.00nan;0;0
2122;90164;43;0;0;0;0;.00nan;0;0
2123;167642;61;46;15;3;12;.800;3600000;0
2123;179950;61;0;0;0;0;.00nan;0;0
2123;47112;4837;34;32;6;26;.813;2767000;0
2123;78775;4837;51;9;1;8;.889;833000;0
2124;176860;44;0;0;0;0;.00nan;0;0
2124;57434;44;92;33;2;31;.939;3900000;0
2124;60773;47;82;33;2;31;.939;3900000;0
2124;79141;47;0;0;0;0;.00nan;0;0
2125;163462;58;28;7;3;4;.571;440000;0
2125;175757;63;38;25;5;20;.800;3600000;0
2125;181123;63;0;0;0;0;.00nan;0;0
2125;37942;58;46;20;3;17;.850;3160000;0
2126;182780;60;0;0;0;0;.00nan;0;0
2126;170294;60;70;26;3;23;.885;3900000;0
2126;174718;4619;0;0;0;0;.00nan;0;0
2126;64800;4619;93;45;3;42;.933;3900000;0
2127;164715;62;0;0;0;0;.00nan;0;0
2127;178384;40;84;36;3;33;.917;3600000;0
2127;85636;40;0;0;0;0;.00nan;0;0
2127;152418;62;55;33;4;29;.879;3547000;0
2128;169154;38;62;46;6;40;.870;3600000;0
2128;170963;38;0;0;0;0;.00nan;0;0
2128;180316;52;60;15;1;14;.933;3600000;0
2128;37857;52;0;0;0;0;.00nan;0;0
2129;170977;41;0;0;0;0;.00nan;0;0
2129;58037;53;0;0;0;0;.00nan;0;0
2129;78581;53;51;14;2;12;.857;3600000;0
2129;143507;41;94;52;4;48;.923;3600000;0
2130;5311;42;79;29;2;27;.931;3600000;0
2130;163471;37;0;0;0;0;.00nan;0;0
2130;141496;42;0;0;0;0;.00nan;0;0
2130;141850;37;78;41;3;38;.927;3583000;0
2131;172499;50;0;0;0;0;.00nan;0;0
2131;68938;46;0;0;0;0;.00nan;0;0
2131;76574;50;62;24;3;21;.875;3574000;0
2131;79280;46;99;41;2;39;.951;3600000;0
2132;176860;44;87;53;5;48;.906;3600000;0
2132;57434;44;0;0;0;0;.00nan;0;0
2132;60773;47;0;0;0;0;.00nan;0;0
2132;79141;47;58;18;2;16;.889;3600000;0
2133;173699;36;77;34;2;32;.941;3600000;0
2133;175757;63;0;0;0;0;.00nan;0;0
2133;181123;63;65;26;3;23;.885;3600000;0
2133;152710;36;0;0;0;0;.00nan;0;0
2134;163989;45;73;41;3;38;.927;3569000;0
2134;171673;64;71;18;1;17;.944;3600000;0
2134;179350;45;0;0;0;0;.00nan;0;0
2134;176915;64;0;0;0;0;.00nan;0;0
2135;172340;48;47;42;6;36;.857;2871000;0
2135;170598;48;43;12;2;10;.833;729000;0
2135;47112;4837;0;0;0;0;.00nan;0;0
2135;78775;4837;60;19;2;17;.895;3600000;0
2136;170977;41;49;37;6;31;.838;2804000;0
2136;176136;57;0;0;0;0;.00nan;0;0
2136;57152;57;61;35;4;31;.886;3600000;0
2136;143507;41;50;1;0;1;1.000;747000;0
2137;5311;42;98;29;1;28;.966;3600000;0
2137;163471;37;60;39;4;35;.897;3600000;0
2137;141496;42;0;0;0;0;.00nan;0;0
2137;141850;37;0;0;0;0;.00nan;0;0
2138;43928;39;0;0;0;0;.00nan;0;0
2138;59025;39;66;39;4;35;.897;3600000;0
2138;85336;56;0;0;0;0;.00nan;0;0
2138;85468;56;32;25;5;20;.800;3600000;0
2139;172499;50;56;37;5;32;.865;3596000;0
2139;68938;46;0;0;0;0;.00nan;0;0
2139;76574;50;0;0;0;0;.00nan;0;0
2139;79280;46;83;32;3;29;.906;3600000;0
2140;37077;55;0;0;0;0;.00nan;0;0
2140;86862;55;31;36;7;29;.806;3600000;0
2140;94615;54;0;0;0;0;.00nan;0;0
2140;143301;54;49;19;3;16;.842;3600000;0
2141;164715;62;58;32;4;28;.875;3900000;0
2141;174718;4619;0;0;0;0;.00nan;0;0
2141;64800;4619;77;39;4;35;.897;3900000;0
2141;152418;62;0;0;0;0;.00nan;0;0
2142;176921;59;82;26;1;25;.962;3600000;0
2142;58037;53;56;22;2;20;.909;3584000;0
2142;58054;59;0;0;0;0;.00nan;0;0
2142;78581;53;0;0;0;0;.00nan;0;0
2143;164715;62;56;5;0;5;1.000;348000;0
2143;176860;44;78;45;5;40;.889;3600000;0
2143;57434;44;0;0;0;0;.00nan;0;0
2143;152418;62;21;24;6;18;.750;3237000;0
2144;173699;36;84;46;3;43;.935;3600000;0
2144;176921;59;86;22;1;21;.955;3600000;0
2144;58054;59;0;0;0;0;.00nan;0;0
2144;152710;36;0;0;0;0;.00nan;0;0
2145;171673;64;82;30;2;28;.933;3564000;0
2145;176915;64;0;0;0;0;.00nan;0;0
2145;37077;55;0;0;0;0;.00nan;0;0
2145;86862;55;95;37;1;36;.973;3600000;0
2146;182780;60;0;0;0;0;.00nan;0;0
2146;170294;60;35;20;4;16;.800;3600000;0
2146;47112;4837;0;0;0;0;.00nan;0;0
2146;78775;4837;99;46;1;45;.978;3600000;0
2147;163471;37;77;45;4;41;.911;3600000;0
2147;60773;47;0;0;0;0;.00nan;0;0
2147;79141;47;60;35;5;30;.857;3553000;0
2147;141850;37;0;0;0;0;.00nan;0;0
2148;38276;65;0;0;0;0;.00nan;0;0
2148;58037;53;58;20;2;18;.900;3600000;0
2148;78581;53;0;0;0;0;.00nan;0;0
2148;86180;65;53;37;5;32;.865;3600000;0
2149;163989;45;94;37;1;36;.973;3708000;0
2149;179350;45;0;0;0;0;.00nan;0;0
2149;94615;54;0;0;0;0;.00nan;0;0
2149;143301;54;86;16;0;16;1.000;3708000;0
2150;169154;38;0;0;0;0;.00nan;0;0
2150;170963;38;90;43;2;41;.953;3587000;0
2150;180316;52;0;0;0;0;.00nan;0;0
2150;37857;52;95;18;0;18;1.000;3600000;0
2151;-1;51;86;45;4;41;.911;3579000;0
2151;85336;56;0;0;0;0;.00nan;0;0
2151;85468;56;48;20;3;17;.850;3600000;0
2151;141484;51;0;0;0;0;.00nan;0;0
2152;174718;4619;53;24;4;20;.833;3693000;0
2152;64800;4619;0;0;0;0;.00nan;0;0
2152;79132;49;99;48;3;45;.938;3693000;0
2152;91225;49;0;0;0;0;.00nan;0;0
2153;163462;58;56;26;4;22;.846;3600000;0
2153;170977;41;57;35;5;30;.857;3600000;0
2153;37942;58;0;0;0;0;.00nan;0;0
2153;143507;41;0;0;0;0;.00nan;0;0
2154;183904;43;0;0;0;0;.00nan;0;0
2154;43928;39;0;0;0;0;.00nan;0;0
2154;59025;39;96;40;1;39;.975;3600000;0
2154;90164;43;60;26;3;23;.885;3537000;0
2155;5311;42;0;0;0;0;.00nan;0;0
2155;172340;48;52;42;6;36;.857;3600000;0
2155;170598;48;0;0;0;0;.00nan;0;0
2155;141496;42;77;22;1;21;.955;3600000;0
2156;167642;61;0;0;0;0;.00nan;0;0
2156;178384;40;70;46;5;41;.891;3560000;0
2156;179950;61;55;26;3;23;.885;3600000;0
2156;85636;40;0;0;0;0;.00nan;0;0
2157;164715;62;41;29;5;24;.828;3600000;0
2157;176860;44;0;0;0;0;.00nan;0;0
2157;57434;44;72;26;2;24;.923;3600000;0
2157;152418;62;0;0;0;0;.00nan;0;0
2158;169154;38;25;31;6;25;.806;3600000;0
2158;170963;38;0;0;0;0;.00nan;0;0
2158;180316;52;0;0;0;0;.00nan;0;0
2158;37857;52;76;27;3;24;.889;3600000;0
2159;68938;46;0;0;0;0;.00nan;0;0
2159;79280;46;67;25;2;23;.920;3677000;0
2159;94615;54;0;0;0;0;.00nan;0;0
2159;143301;54;82;44;3;41;.932;3705000;0
2160;173699;36;0;0;0;0;.00nan;0;0
2160;176921;59;0;0;0;0;.00nan;0;0
2160;58054;59;42;12;3;9;.750;3600000;0
2160;152710;36;92;53;4;49;.925;3600000;0
2161;171673;64;0;0;0;0;.00nan;0;0
2161;176915;64;52;31;4;27;.871;3515000;0
2161;37077;55;0;0;0;0;.00nan;0;0
2161;86862;55;85;35;2;33;.943;3600000;0
2162;182780;60;0;0;0;0;.00nan;0;0
2162;170294;60;80;26;1;25;.962;3600000;0
2162;47112;4837;57;31;4;27;.871;3600000;0
2162;78775;4837;0;0;0;0;.00nan;0;0
2163;163471;37;37;7;2;5;.714;564000;0
2163;60773;47;40;36;6;30;.833;2884000;0
2163;79141;47;50;0;0;0;.00nan;716000;0
2163;141850;37;31;30;6;24;.800;3019000;0
2164;175757;63;0;0;0;0;.00nan;0;0
2164;181123;63;96;42;2;40;.952;3600000;0
2164;38276;65;0;0;0;0;.00nan;0;0
2164;86180;65;93;32;1;31;.969;3600000;0
2165;-1;51;0;0;0;0;.00nan;0;0
2165;43928;39;0;0;0;0;.00nan;0;0
2165;59025;39;76;26;2;24;.923;3600000;0
2165;141484;51;62;30;4;26;.867;3567000;0
2166;172499;50;0;0;0;0;.00nan;0;0
2166;163989;45;84;37;3;34;.919;3600000;0
2166;179350;45;0;0;0;0;.00nan;0;0
2166;76574;50;96;18;0;18;1.000;3600000;0
2167;174718;4619;0;0;0;0;.00nan;0;0
2167;64800;4619;72;27;2;25;.926;3600000;0
2167;79132;49;49;12;2;10;.833;790000;0
2167;91225;49;46;35;6;29;.829;2810000;0
2168;163462;58;0;0;0;0;.00nan;0;0
2168;170977;41;59;6;0;6;1.000;1298000;0
2168;37942;58;55;24;3;21;.875;3600000;0
2168;143507;41;22;22;6;16;.727;2302000;0
2169;5311;42;34;10;3;7;.700;3600000;0
2169;172340;48;66;19;1;18;.947;1266000;0
2169;170598;48;25;36;7;29;.806;2334000;0
2169;141496;42;0;0;0;0;.00nan;0;0
2170;167642;61;51;14;2;12;.857;3600000;0
2170;178384;40;0;0;0;0;.00nan;0;0
2170;179950;61;0;0;0;0;.00nan;0;0
2170;85636;40;91;47;3;44;.936;3584000;0
2171;183904;43;57;18;2;16;.889;3600000;0
2171;85336;56;56;35;4;31;.886;3582000;0
2171;85468;56;0;0;0;0;.00nan;0;0
2171;90164;43;0;0;0;0;.00nan;0;0
2172;176136;57;0;0;0;0;.00nan;0;0
2172;57152;57;84;54;5;49;.907;3600000;0
2172;58037;53;0;0;0;0;.00nan;0;0
2172;78581;53;69;23;2;21;.913;3600000;0
2173;172499;50;0;0;0;0;.00nan;0;0
2173;68938;46;95;37;1;36;.973;3600000;0
2173;76574;50;67;22;2;20;.909;3556000;0
2173;79280;46;0;0;0;0;.00nan;0;0
2174;175757;63;43;31;5;26;.839;3568000;0
2174;176136;57;62;24;3;21;.875;3600000;0
2174;181123;63;0;0;0;0;.00nan;0;0
2174;57152;57;0;0;0;0;.00nan;0;0
2175;163462;58;64;35;3;32;.914;3600000;0
2175;180316;52;84;18;0;18;1.000;3600000;0
2175;37857;52;0;0;0;0;.00nan;0;0
2175;37942;58;0;0;0;0;.00nan;0;0
2176;60773;47;0;0;0;0;.00nan;0;0
2176;79141;47;91;30;2;28;.933;3600000;0
2176;94615;54;0;0;0;0;.00nan;0;0
2176;143301;54;62;28;3;25;.893;3561000;0
2177;182780;60;0;0;0;0;.00nan;0;0
2177;178384;40;84;31;3;28;.903;3600000;0
2177;170294;60;43;24;4;20;.833;3577000;0
2177;85636;40;0;0;0;0;.00nan;0;0
2178;172499;50;0;0;0;0;.00nan;0;0
2178;163989;45;16;22;6;16;.727;1938000;0
2178;179350;45;67;19;1;18;.947;1662000;0
2178;76574;50;100;18;0;18;1.000;3600000;0
2179;167642;61;0;0;0;0;.00nan;0;0
2179;164715;62;0;0;0;0;.00nan;0;0
2179;179950;61;63;24;3;21;.875;3778000;0
2179;152418;62;66;31;4;27;.871;3778000;0
2180;169154;38;0;0;0;0;.00nan;0;0
2180;170963;38;100;32;0;32;1.000;3600000;0
2180;170977;41;88;40;3;37;.925;3600000;0
2180;143507;41;0;0;0;0;.00nan;0;0
2181;172340;48;65;38;5;33;.868;3547000;0
2181;170598;48;0;0;0;0;.00nan;0;0
2181;79132;49;47;26;4;22;.846;3600000;0
2181;91225;49;0;0;0;0;.00nan;0;0
2182;163462;58;0;0;0;0;.00nan;0;0
2182;176921;59;55;17;2;15;.882;3900000;0
2182;37942;58;77;32;2;30;.938;3900000;0
2182;58054;59;0;0;0;0;.00nan;0;0
2183;43928;39;0;0;0;0;.00nan;0;0
2183;59025;39;90;36;2;34;.944;3600000;0
2183;85336;56;0;0;0;0;.00nan;0;0
2183;85468;56;71;27;3;24;.889;3532000;0
2184;176136;57;0;0;0;0;.00nan;0;0
2184;38276;65;0;0;0;0;.00nan;0;0
2184;57152;57;83;39;2;37;.949;3548000;0
2184;86180;65;64;16;1;15;.938;3600000;0
2185;183904;43;0;0;0;0;.00nan;0;0
2185;-1;51;98;55;4;51;.927;3560000;0
2185;90164;43;44;9;2;7;.778;3600000;0
2185;141484;51;0;0;0;0;.00nan;0;0
2186;175757;63;0;0;0;0;.00nan;0;0
2186;181123;63;75;41;4;37;.902;3600000;0
2186;58037;53;86;14;0;14;1.000;3600000;0
2186;78581;53;0;0;0;0;.00nan;0;0
2187;173699;36;92;47;4;43;.915;3599000;0
2187;68938;46;0;0;0;0;.00nan;0;0
2187;79280;46;62;23;2;21;.913;3600000;0
2187;152710;36;0;0;0;0;.00nan;0;0
2188;174718;4619;43;41;6;35;.854;3600000;0
2188;176860;44;84;36;3;33;.917;3600000;0
2188;57434;44;0;0;0;0;.00nan;0;0
2188;64800;4619;0;0;0;0;.00nan;0;0
2189;170963;38;71;21;1;20;.952;3900000;0
2189;170977;41;94;30;1;29;.967;3900000;0
2189;141496;38;0;0;0;0;.00nan;0;0
2189;143507;41;0;0;0;0;.00nan;0;0
2190;163462;58;67;43;4;39;.907;3542000;0
2190;180316;52;70;24;2;22;.917;3600000;0
2190;37857;52;0;0;0;0;.00nan;0;0
2190;37942;58;0;0;0;0;.00nan;0;0
2191;172340;48;0;0;0;0;.00nan;0;0
2191;170598;48;92;46;3;43;.935;3600000;0
2191;79132;49;90;12;0;12;1.000;3600000;0
2191;91225;49;0;0;0;0;.00nan;0;0
2192;176921;59;55;22;2;20;.909;3600000;0
2192;58037;53;37;32;5;27;.844;3600000;0
2192;58054;59;0;0;0;0;.00nan;0;0
2192;78581;53;0;0;0;0;.00nan;0;0
2193;163471;37;56;33;4;29;.879;3542000;0
2193;47112;4837;0;0;0;0;.00nan;0;0
2193;78775;4837;65;29;3;26;.897;3600000;0
2193;141850;37;0;0;0;0;.00nan;0;0
2194;-1;51;100;30;0;30;1.000;3600000;0
2194;43928;39;0;0;0;0;.00nan;0;0
2194;59025;39;55;16;2;14;.875;3577000;0
2194;141484;51;0;0;0;0;.00nan;0;0
2195;176136;57;0;0;0;0;.00nan;0;0
2195;38276;65;0;0;0;0;.00nan;0;0
2195;57152;57;93;46;1;45;.978;3600000;0
2195;86180;65;61;21;2;19;.905;3598000;0
2196;172499;50;0;0;0;0;.00nan;0;0
2196;76574;50;78;24;1;23;.958;3600000;0
2196;94615;54;0;0;0;0;.00nan;0;0
2196;143301;54;81;35;3;32;.914;3563000;0
2197;182780;60;0;0;0;0;.00nan;0;0
2197;178384;40;65;28;3;25;.893;3600000;0
2197;170294;60;89;41;2;39;.951;3600000;0
2197;85636;40;0;0;0;0;.00nan;0;0
2198;163989;45;0;0;0;0;.00nan;0;0
2198;171673;64;22;13;4;9;.692;757000;0
2198;179350;45;84;37;3;34;.919;3600000;0
2198;176915;64;43;29;5;24;.828;2843000;0
2199;167642;61;0;0;0;0;.00nan;0;0
2199;179950;61;97;48;2;46;.958;3528000;0
2199;60773;47;0;0;0;0;.00nan;0;0
2199;79141;47;93;19;0;19;1.000;3600000;0
2200;183904;43;48;32;5;27;.844;3600000;0
2200;37077;55;68;19;1;18;.947;1679000;0
2200;86862;55;21;23;6;17;.739;1921000;0
2200;90164;43;0;0;0;0;.00nan;0;0
2201;5311;42;80;42;4;38;.905;3543000;0
2201;164715;62;86;40;3;37;.925;3600000;0
2201;57695;42;0;0;0;0;.00nan;0;0
2201;152418;62;0;0;0;0;.00nan;0;0
2202;175757;63;46;4;1;3;.750;660000;0
2202;181123;63;25;24;6;18;.750;2940000;0
2202;85336;56;63;19;2;17;.895;3600000;0
2202;85468;56;0;0;0;0;.00nan;0;0
2203;174718;4619;0;0;0;0;.00nan;0;0
2203;176860;44;67;20;1;19;.950;2569000;0
2203;57434;44;19;9;4;5;.556;1031000;0
2203;64800;4619;83;29;1;28;.966;3600000;0
2204;163462;58;0;0;0;0;.00nan;0;0
2204;180316;52;0;0;0;0;.00nan;0;0
2204;37857;52;70;28;3;25;.893;3600000;0
2204;37942;58;98;30;0;30;1.000;3600000;0
2205;173699;36;73;44;4;40;.909;3600000;0
2205;68938;46;0;0;0;0;.00nan;0;0
2205;79280;46;67;28;3;25;.893;3600000;0
2205;152710;36;0;0;0;0;.00nan;0;0
2206;172340;48;45;44;7;37;.841;2523000;0
2206;167642;61;38;15;3;12;.800;3600000;0
2206;170598;48;66;10;0;10;1.000;1077000;0
2206;179950;61;0;0;0;0;.00nan;0;0
2207;170977;41;0;0;0;0;.00nan;0;0
2207;176921;59;0;0;0;0;.00nan;0;0
2207;58054;59;78;9;0;9;1.000;3600000;0
2207;143507;41;89;56;4;52;.929;3600000;0
2208;163471;37;0;0;0;0;.00nan;0;0
2208;47112;4837;78;25;2;23;.920;3600000;0
2208;78775;4837;0;0;0;0;.00nan;0;0
2208;141850;37;43;24;4;20;.833;3523000;0
2209;170963;38;0;0;0;0;.00nan;0;0
2209;176136;57;95;50;3;47;.940;3565000;0
2209;57152;57;0;0;0;0;.00nan;0;0
2209;141496;38;94;29;2;27;.931;3600000;0
2210;-1;51;93;50;4;46;.920;3600000;0
2210;43928;39;47;16;3;13;.813;3600000;0
2210;59025;39;0;0;0;0;.00nan;0;0
2210;141484;51;0;0;0;0;.00nan;0;0
2211;38276;65;87;48;4;44;.917;3600000;0
2211;58037;53;0;0;0;0;.00nan;0;0
2211;78581;53;86;30;1;29;.967;3600000;0
2211;86180;65;0;0;0;0;.00nan;0;0
2212;178384;40;49;21;3;18;.857;3724000;0
2212;79132;49;82;45;4;41;.911;3724000;0
2212;85636;40;0;0;0;0;.00nan;0;0
2212;91225;49;0;0;0;0;.00nan;0;0
2213;172499;50;59;23;3;20;.870;3600000;0
2213;163989;45;25;40;8;32;.800;3120000;0
2213;179350;45;62;9;0;9;1.000;480000;0
2213;76574;50;0;0;0;0;.00nan;0;0
2214;182780;60;80;40;3;37;.925;3577000;0
2214;170294;60;0;0;0;0;.00nan;0;0
2214;60773;47;0;0;0;0;.00nan;0;0
2214;79141;47;72;26;2;24;.923;3600000;0
2215;183904;43;0;0;0;0;.00nan;0;0
2215;37077;55;0;0;0;0;.00nan;0;0
2215;86862;55;89;40;3;37;.925;3545000;0
2215;90164;43;53;10;1;9;.900;3600000;0
2216;5311;42;0;0;0;0;.00nan;0;0
2216;164715;62;55;31;4;27;.871;3541000;0
2216;57695;42;93;41;2;39;.951;3600000;0
2216;152418;62;0;0;0;0;.00nan;0;0
2217;175757;63;59;39;5;34;.872;3600000;0
2217;181123;63;0;0;0;0;.00nan;0;0
2217;85336;56;0;0;0;0;.00nan;0;0
2217;85468;56;93;23;0;23;1.000;3600000;0
2218;164715;62;0;0;0;0;.00nan;0;0
2218;174718;4619;46;30;4;26;.867;3900000;0
2218;64800;4619;0;0;0;0;.00nan;0;0
2218;152418;62;57;29;4;25;.862;3900000;0
2219;37077;55;0;0;0;0;.00nan;0;0
2219;85336;56;0;0;0;0;.00nan;0;0
2219;85468;56;69;34;4;30;.882;3600000;0
2219;86862;55;97;40;1;39;.975;3600000;0
2220;60773;47;0;0;0;0;.00nan;0;0
2220;79132;49;26;37;7;30;.811;2955000;0
2220;79141;47;96;17;0;17;1.000;3600000;0
2220;91225;49;45;7;1;6;.857;645000;0
2221;163462;58;0;0;0;0;.00nan;0;0
2221;173699;36;70;27;3;24;.889;3593000;0
2221;37942;58;96;33;1;32;.970;3600000;0
2221;152710;36;0;0;0;0;.00nan;0;0
2222;182780;60;0;0;0;0;.00nan;0;0
2222;170294;60;62;32;4;28;.875;3600000;0
2222;176860;44;99;36;1;35;.972;3600000;0
2222;57434;44;0;0;0;0;.00nan;0;0
2223;172499;50;0;0;0;0;.00nan;0;0
2223;171673;64;95;70;6;64;.914;3600000;0
2223;176915;64;0;0;0;0;.00nan;0;0
2223;76574;50;48;19;3;16;.842;3600000;0
2224;170963;38;73;43;4;39;.907;3900000;0
2224;176921;59;0;0;0;0;.00nan;0;0
2224;58054;59;46;18;4;14;.778;3900000;0
2224;141496;38;0;0;0;0;.00nan;0;0
2225;163471;37;42;34;6;28;.824;3236000;0
2225;167642;61;0;0;0;0;.00nan;0;0
2225;179950;61;73;35;4;31;.886;3600000;0
2225;141850;37;53;3;0;3;1.000;354000;0
2226;38276;65;0;0;0;0;.00nan;0;0
2226;58037;53;78;25;1;24;.960;3600000;0
2226;78581;53;0;0;0;0;.00nan;0;0
2226;86180;65;86;50;4;46;.920;3600000;0
2227;178384;40;93;33;1;32;.970;3600000;0
2227;47112;4837;0;0;0;0;.00nan;0;0
2227;78775;4837;55;29;4;25;.862;3600000;0
2227;85636;40;0;0;0;0;.00nan;0;0
2228;176136;57;0;0;0;0;.00nan;0;0
2228;180316;52;0;0;0;0;.00nan;0;0
2228;37857;52;62;15;1;14;.933;3600000;0
2228;57152;57;78;39;3;36;.923;3537000;0
2229;183904;43;66;21;2;19;.905;3600000;0
2229;-1;51;88;55;5;50;.909;3600000;0
2229;90164;43;0;0;0;0;.00nan;0;0
2229;141484;51;0;0;0;0;.00nan;0;0
2230;5311;42;92;33;1;32;.970;3600000;0
2230;163989;45;75;36;3;33;.917;3518000;0
2230;179350;45;0;0;0;0;.00nan;0;0
2230;57695;42;0;0;0;0;.00nan;0;0
2231;175757;63;0;0;0;0;.00nan;0;0
2231;181123;63;59;35;4;31;.886;3548000;0
2231;43928;39;0;0;0;0;.00nan;0;0
2231;59025;39;74;25;2;23;.920;3600000;0
2232;37077;55;0;0;0;0;.00nan;0;0
2232;85336;56;37;26;5;21;.808;3530000;0
2232;85468;56;0;0;0;0;.00nan;0;0
2232;86862;55;60;40;4;36;.900;3600000;0
2233;170963;38;0;0;0;0;.00nan;0;0
2233;38276;65;85;28;1;27;.964;3600000;0
2233;86180;65;0;0;0;0;.00nan;0;0
2233;141496;38;80;45;2;43;.956;3573000;0
2234;60773;47;0;0;0;0;.00nan;0;0
2234;79132;49;91;46;3;43;.935;3600000;0
2234;79141;47;30;23;5;18;.783;3530000;0
2234;91225;49;0;0;0;0;.00nan;0;0
2235;172340;48;59;24;4;20;.833;1748000;0
2235;170598;48;46;17;3;14;.824;1852000;0
2235;47112;4837;61;25;3;22;.880;3600000;0
2235;78775;4837;0;0;0;0;.00nan;0;0
2236;182780;60;68;33;4;29;.879;3635000;0
2236;170294;60;0;0;0;0;.00nan;0;0
2236;176860;44;23;5;3;2;.400;595000;0
2236;57434;44;74;31;2;29;.935;3040000;0
2237;172499;50;42;26;5;21;.808;3548000;0
2237;171673;64;0;0;0;0;.00nan;0;0
2237;176915;64;70;32;3;29;.906;3600000;0
2237;76574;50;0;0;0;0;.00nan;0;0
2238;176921;59;39;21;4;17;.810;3600000;0
2238;180316;52;49;32;5;27;.844;3600000;0
2238;37857;52;0;0;0;0;.00nan;0;0
2238;58054;59;0;0;0;0;.00nan;0;0
2239;163471;37;0;0;0;0;.00nan;0;0
2239;167642;61;70;35;4;31;.886;3560000;0
2239;179950;61;0;0;0;0;.00nan;0;0
2239;141850;37;71;22;3;19;.864;3600000;0
2240;5311;42;68;38;5;33;.868;3600000;0
2240;57695;42;0;0;0;0;.00nan;0;0
2240;94615;54;0;0;0;0;.00nan;0;0
2240;143301;54;52;17;2;15;.882;3600000;0
2241;163989;45;0;0;0;0;.00nan;0;0
2241;179350;45;97;52;3;49;.942;3600000;0
2241;68938;46;0;0;0;0;.00nan;0;0
2241;79280;46;71;24;1;23;.958;3600000;0
2242;164715;62;60;39;5;34;.872;3600000;0
2242;174718;4619;0;0;0;0;.00nan;0;0
2242;64800;4619;83;37;3;34;.919;3600000;0
2242;152418;62;0;0;0;0;.00nan;0;0
2243;170977;41;87;32;2;30;.938;3600000;0
2243;176136;57;68;30;3;27;.900;3553000;0
2243;57152;57;0;0;0;0;.00nan;0;0
2243;143507;41;0;0;0;0;.00nan;0;0
2244;183904;43;0;0;0;0;.00nan;0;0
2244;-1;51;94;49;4;45;.918;3600000;0
2244;90164;43;84;19;0;19;1.000;3600000;0
2244;141484;51;0;0;0;0;.00nan;0;0
2245;175757;63;81;40;3;37;.925;3600000;0
2245;181123;63;0;0;0;0;.00nan;0;0
2245;43928;39;0;0;0;0;.00nan;0;0
2245;59025;39;55;30;4;26;.867;3600000;0
2246;163462;58;95;38;2;36;.947;3600000;0
2246;173699;36;49;30;5;25;.833;3600000;0
2246;37942;58;0;0;0;0;.00nan;0;0
2246;152710;36;0;0;0;0;.00nan;0;0
2247;172499;50;0;0;0;0;.00nan;0;0
2247;76574;50;65;31;4;27;.871;3600000;0
2247;79132;49;46;32;5;27;.844;2311000;0
2247;91225;49;60;11;1;10;.909;1269000;0
2248;173699;36;51;22;3;19;.864;3562000;0
2248;171673;64;76;25;2;23;.920;3600000;0
2248;176915;64;0;0;0;0;.00nan;0;0
2248;152710;36;0;0;0;0;.00nan;0;0
2249;182780;60;0;0;0;0;.00nan;0;0
2249;164715;62;43;33;6;27;.818;3122000;0
2249;170294;60;34;27;5;22;.815;3600000;0
2249;85336;62;50;1;0;1;1.000;478000;0
2250;68938;46;0;0;0;0;.00nan;0;0
2250;79280;46;70;29;2;27;.931;3600000;0
2250;94615;54;46;26;4;22;.846;3534000;0
2250;143301;54;0;0;0;0;.00nan;0;0
2251;5311;42;78;22;1;21;.955;3600000;0
2251;163989;45;49;38;6;32;.842;3331000;0
2251;179350;45;41;3;1;2;.667;269000;0
2251;57695;42;0;0;0;0;.00nan;0;0
2252;183904;43;0;0;0;0;.00nan;0;0
2252;37077;55;71;29;2;27;.931;3600000;0
2252;86862;55;0;0;0;0;.00nan;0;0
2252;90164;43;42;17;4;13;.765;3518000;0
2253;172499;50;62;14;1;13;.929;3600000;0
2253;76574;50;0;0;0;0;.00nan;0;0
2253;79132;49;77;44;5;39;.886;3600000;0
2253;91225;49;0;0;0;0;.00nan;0;0
2254;182780;60;67;32;4;28;.875;3600000;0
2254;164715;62;0;0;0;0;.00nan;0;0
2254;170294;60;0;0;0;0;.00nan;0;0
2254;85336;62;48;30;5;25;.833;3600000;0
2255;176136;57;51;13;1;12;.923;747000;0
2255;38276;65;0;0;0;0;.00nan;0;0
2255;57152;57;22;29;7;22;.759;2853000;0
2255;86180;65;60;18;2;16;.889;3600000;0
2256;174718;4619;74;45;4;41;.911;3600000;0
2256;60773;47;0;0;0;0;.00nan;0;0
2256;64800;4619;0;0;0;0;.00nan;0;0
2256;79141;47;64;30;3;27;.900;3600000;0
2257;175757;63;0;0;0;0;.00nan;0;0
2257;181123;63;57;31;4;27;.871;3528000;0
2257;58037;53;79;27;2;25;.926;3600000;0
2257;78581;53;0;0;0;0;.00nan;0;0
2258;-1;51;41;47;8;39;.830;3205000;0
2258;58100;56;0;0;0;0;.00nan;0;0
2258;85468;56;48;25;4;21;.840;3600000;0
2258;141484;51;51;2;0;2;1.000;395000;0
2259;172340;48;93;37;2;35;.946;3900000;0
2259;170598;48;0;0;0;0;.00nan;0;0
2259;174718;4619;0;0;0;0;.00nan;0;0
2259;64800;4619;69;21;2;19;.905;3900000;0
2260;175757;63;0;0;0;0;.00nan;0;0
2260;181123;63;41;25;5;20;.800;3600000;0
2260;37077;55;0;0;0;0;.00nan;0;0
2260;86862;55;87;37;2;35;.946;3600000;0
2261;173699;36;98;44;1;43;.977;3563000;0
2261;171673;64;0;0;0;0;.00nan;0;0
2261;176915;64;99;25;0;25;1.000;3600000;0
2261;152710;36;0;0;0;0;.00nan;0;0
2262;176921;59;96;33;1;32;.970;3600000;0
2262;43928;39;0;0;0;0;.00nan;0;0
2262;58054;59;0;0;0;0;.00nan;0;0
2262;59025;39;61;35;4;31;.886;3600000;0
2263;170963;38;0;0;0;0;.00nan;0;0
2263;180316;52;0;0;0;0;.00nan;0;0
2263;37857;52;62;16;2;14;.875;3600000;0
2263;141496;38;85;46;4;42;.913;3513000;0
2264;-1;51;52;41;6;35;.854;2025000;0
2264;58037;53;65;16;1;15;.938;3600000;0
2264;78581;53;0;0;0;0;.00nan;0;0
2264;141484;51;14;24;6;18;.750;1575000;0
2265;163989;45;0;0;0;0;.00nan;0;0
2265;179350;45;83;44;4;40;.909;3900000;0
2265;68938;46;0;0;0;0;.00nan;0;0
2265;79280;46;56;24;4;20;.833;3900000;0
2266;5311;42;76;34;2;32;.941;3600000;0
2266;163471;37;72;31;3;28;.903;3582000;0
2266;57695;42;0;0;0;0;.00nan;0;0
2266;141850;37;0;0;0;0;.00nan;0;0
2267;167642;61;0;0;0;0;.00nan;0;0
2267;178384;40;72;29;3;26;.897;3900000;0
2267;179950;61;57;26;3;23;.885;3900000;0
2267;85636;40;0;0;0;0;.00nan;0;0
2268;176860;44;70;36;3;33;.917;3600000;0
2268;57434;44;0;0;0;0;.00nan;0;0
2268;79132;49;16;14;5;9;.643;1556000;0
2268;91225;49;39;16;3;13;.813;2044000;0
2269;164715;62;77;35;3;32;.914;3551000;0
2269;174718;4619;86;32;2;30;.938;3600000;0
2269;64800;4619;0;0;0;0;.00nan;0;0
2269;85336;62;0;0;0;0;.00nan;0;0
2270;170963;38;64;48;5;43;.896;3600000;0
2270;176921;59;0;0;0;0;.00nan;0;0
2270;58054;59;47;17;3;14;.824;3600000;0
2270;141496;38;0;0;0;0;.00nan;0;0
2271;163462;58;87;32;1;31;.969;3900000;0
2271;170977;41;100;47;1;46;.979;3900000;0
2271;37942;58;0;0;0;0;.00nan;0;0
2271;143507;41;0;0;0;0;.00nan;0;0
2272;173699;36;90;41;2;39;.951;3514000;0
2272;68938;46;89;18;0;18;1.000;3600000;0
2272;79280;46;0;0;0;0;.00nan;0;0
2272;152710;36;0;0;0;0;.00nan;0;0
2273;182780;60;0;0;0;0;.00nan;0;0
2273;172340;48;0;0;0;0;.00nan;0;0
2273;170294;60;87;30;2;28;.933;3896000;0
2273;170598;48;76;35;2;33;.943;3900000;0
2274;183904;43;76;27;1;26;.963;3600000;0
2274;38276;65;0;0;0;0;.00nan;0;0
2274;86180;65;97;46;2;44;.957;3546000;0
2274;90164;43;0;0;0;0;.00nan;0;0
2275;172499;50;0;0;0;0;.00nan;0;0
2275;76574;50;62;28;3;25;.893;3600000;0
2275;94615;54;0;0;0;0;.00nan;0;0
2275;143301;54;35;37;7;30;.811;3600000;0
2276;163989;45;48;32;4;28;.875;3600000;0
2276;171673;64;0;0;0;0;.00nan;0;0
2276;179350;45;0;0;0;0;.00nan;0;0
2276;176915;64;99;44;2;42;.955;3600000;0
2277;47112;4837;0;0;0;0;.00nan;0;0
2277;60773;47;0;0;0;0;.00nan;0;0
2277;78775;4837;69;56;6;50;.893;3600000;0
2277;79141;47;87;18;0;18;1.000;3600000;0
2278;5311;42;0;0;0;0;.00nan;0;0
2278;163471;37;0;0;0;0;.00nan;0;0
2278;57695;42;100;30;0;30;1.000;3600000;0
2278;141850;37;89;37;2;35;.946;3566000;0
2279;175757;63;51;21;3;18;.857;3600000;0
2279;176136;57;0;0;0;0;.00nan;0;0
2279;181123;63;0;0;0;0;.00nan;0;0
2279;57152;57;43;43;7;36;.837;3600000;0
2280;167642;61;70;27;2;25;.926;3600000;0
2280;178384;40;54;36;5;31;.861;3600000;0
2280;179950;61;0;0;0;0;.00nan;0;0
2280;85636;40;0;0;0;0;.00nan;0;0
2281;37077;55;83;36;2;34;.944;3600000;0
2281;58100;56;0;0;0;0;.00nan;0;0
2281;85468;56;94;52;4;48;.923;3599000;0
2281;86862;55;0;0;0;0;.00nan;0;0
2282;43928;39;0;0;0;0;.00nan;0;0
2282;58037;53;0;0;0;0;.00nan;0;0
2282;59025;39;77;41;3;38;.927;3534000;0
2282;78581;53;81;27;1;26;.963;3600000;0
2283;182780;60;82;33;2;31;.939;3600000;0
2283;164715;62;0;0;0;0;.00nan;0;0
2283;170294;60;0;0;0;0;.00nan;0;0
2283;85336;62;88;25;1;24;.960;3600000;0
2284;170963;38;0;0;0;0;.00nan;0;0
2284;43928;39;50;21;3;18;.857;3900000;0
2284;59025;39;0;0;0;0;.00nan;0;0
2284;141496;38;90;40;3;37;.925;3900000;0
2285;163462;58;0;0;0;0;.00nan;0;0
2285;170977;41;0;0;0;0;.00nan;0;0
2285;37942;58;87;20;0;20;1.000;3600000;0
2285;143507;41;49;44;6;38;.864;3600000;0
2286;173699;36;60;46;6;40;.870;3162000;0
2286;68938;46;93;20;0;20;1.000;3600000;0
2286;79280;46;0;0;0;0;.00nan;0;0
2286;152710;36;43;4;1;3;.750;438000;0
2287;172340;48;43;42;7;35;.833;3874000;0
2287;170598;48;0;0;0;0;.00nan;0;0
2287;47112;4837;33;23;5;18;.783;2374000;0
2287;78775;4837;55;11;2;9;.818;1526000;0
2288;176921;59;97;24;0;24;1.000;3600000;0
2288;180316;52;0;0;0;0;.00nan;0;0
2288;37857;52;83;32;2;30;.938;3533000;0
2288;58054;59;0;0;0;0;.00nan;0;0
2289;-1;51;70;34;3;31;.912;3600000;0
2289;58100;56;64;23;2;21;.913;3600000;0
2289;85468;56;0;0;0;0;.00nan;0;0
2289;141484;51;0;0;0;0;.00nan;0;0
2290;176860;44;84;24;1;23;.958;3600000;0
2290;57434;44;0;0;0;0;.00nan;0;0
2290;79132;49;46;39;6;33;.846;3600000;0
2290;91225;49;0;0;0;0;.00nan;0;0
2291;176136;57;0;0;0;0;.00nan;0;0
2291;37077;55;0;0;0;0;.00nan;0;0
2291;57152;57;58;29;3;26;.897;3900000;0
2291;86862;55;62;29;3;26;.897;3900000;0
2292;163471;37;53;23;3;20;.870;3600000;0
2292;163989;45;44;40;6;34;.850;2869000;0
2292;179350;45;71;16;0;16;1.000;731000;0
2292;141850;37;0;0;0;0;.00nan;0;0
2293;172499;50;0;0;0;0;.00nan;0;0
2293;76574;50;78;38;3;35;.921;3600000;0
2293;94615;54;0;0;0;0;.00nan;0;0
2293;143301;54;83;18;0;18;1.000;3600000;0
2294;-1;51;68;36;4;32;.889;3600000;0
2294;175757;63;0;0;0;0;.00nan;0;0
2294;181123;63;84;27;1;26;.963;3600000;0
2294;141484;51;0;0;0;0;.00nan;0;0
2295;164715;62;88;34;2;32;.941;3600000;0
2295;60773;47;0;0;0;0;.00nan;0;0
2295;79141;47;76;33;3;30;.909;3548000;0
2295;85336;62;0;0;0;0;.00nan;0;0
2296;5311;42;66;27;2;25;.926;3523000;0
2296;171673;64;0;0;0;0;.00nan;0;0
2296;176915;64;99;31;0;31;1.000;3600000;0
2296;57695;42;0;0;0;0;.00nan;0;0
2297;170963;38;83;48;5;43;.896;3567000;0
2297;176921;59;47;18;3;15;.833;3600000;0
2297;58054;59;0;0;0;0;.00nan;0;0
2297;141496;38;0;0;0;0;.00nan;0;0
2298;163471;37;0;0;0;0;.00nan;0;0
2298;163989;45;70;39;4;35;.897;3523000;0
2298;179350;45;0;0;0;0;.00nan;0;0
2298;141850;37;52;15;2;13;.867;3600000;0
2299;176136;57;0;0;0;0;.00nan;0;0
2299;43928;39;0;0;0;0;.00nan;0;0
2299;57152;57;77;39;4;35;.897;3600000;0
2299;59025;39;66;19;1;18;.947;3600000;0
2300;178384;40;71;32;4;28;.875;3592000;0
2300;176860;44;87;39;2;37;.949;3600000;0
2300;57434;44;0;0;0;0;.00nan;0;0
2300;85636;40;0;0;0;0;.00nan;0;0
2301;-1;51;73;45;5;40;.889;3559000;0
2301;37077;55;0;0;0;0;.00nan;0;0
2301;86862;55;45;24;4;20;.833;3600000;0
2301;141484;51;0;0;0;0;.00nan;0;0
2302;172340;48;97;53;3;50;.943;3595000;0
2302;170598;48;0;0;0;0;.00nan;0;0
2302;174718;4619;0;0;0;0;.00nan;0;0
2302;64800;4619;82;25;1;24;.960;3600000;0
2303;38276;65;0;0;0;0;.00nan;0;0
2303;58037;53;46;30;4;26;.867;3600000;0
2303;78581;53;0;0;0;0;.00nan;0;0
2303;86180;65;45;33;5;28;.848;3569000;0
2304;68938;46;86;42;3;39;.929;3600000;0
2304;79280;46;0;0;0;0;.00nan;0;0
2304;94615;54;0;0;0;0;.00nan;0;0
2304;143301;54;46;24;4;20;.833;3558000;0
2305;182780;60;0;0;0;0;.00nan;0;0
2305;170294;60;100;22;0;22;1.000;3600000;0
2305;47112;4837;0;0;0;0;.00nan;0;0
2305;78775;4837;92;47;3;44;.936;3600000;0
2306;176136;57;0;0;0;0;.00nan;0;0
2306;57152;57;50;43;6;37;.860;3600000;0
2306;58037;53;99;24;0;24;1.000;3600000;0
2306;78581;53;0;0;0;0;.00nan;0;0
2307;175757;63;0;0;0;0;.00nan;0;0
2307;181123;63;95;40;2;38;.950;3600000;0
2307;43928;39;0;0;0;0;.00nan;0;0
2307;59025;39;57;31;5;26;.839;3600000;0
2308;172499;50;0;0;0;0;.00nan;0;0
2308;76574;50;79;14;0;14;1.000;3600000;0
2308;79132;49;96;43;2;41;.953;3600000;0
2308;91225;49;0;0;0;0;.00nan;0;0
2309;172340;48;62;29;4;25;.862;2149000;0
2309;178384;40;51;20;3;17;.850;3600000;0
2309;170598;48;57;20;2;18;.900;1451000;0
2309;85636;40;0;0;0;0;.00nan;0;0
2310;173699;36;89;34;2;32;.941;3593000;0
2310;180316;52;0;0;0;0;.00nan;0;0
2310;37857;52;70;21;1;20;.952;3600000;0
2310;152710;36;0;0;0;0;.00nan;0;0
2311;-1;51;98;48;2;46;.958;3548000;0
2311;37077;55;73;21;1;20;.952;3600000;0
2311;86862;55;0;0;0;0;.00nan;0;0
2311;141484;51;0;0;0;0;.00nan;0;0
2312;5311;42;71;30;3;27;.900;3600000;0
2312;163989;45;0;0;0;0;.00nan;0;0
2312;179350;45;74;43;4;39;.907;3600000;0
2312;57695;42;0;0;0;0;.00nan;0;0
2313;174718;4619;75;32;4;28;.875;3900000;0
2313;176860;44;84;38;4;34;.895;3900000;0
2313;57434;44;0;0;0;0;.00nan;0;0
2313;64800;4619;0;0;0;0;.00nan;0;0
2314;170977;41;45;46;7;39;.848;3600000;0
2314;176921;59;56;13;2;11;.846;3600000;0
2314;58054;59;0;0;0;0;.00nan;0;0
2314;143507;41;0;0;0;0;.00nan;0;0
2315;167642;61;0;0;0;0;.00nan;0;0
2315;164715;62;0;0;0;0;.00nan;0;0
2315;179950;61;75;31;3;28;.903;3600000;0
2315;85336;62;50;33;5;28;.848;3556000;0
2316;183904;43;69;25;3;22;.880;3900000;0
2316;58100;56;66;33;3;30;.909;3900000;0
2316;85468;56;0;0;0;0;.00nan;0;0
2316;90164;43;0;0;0;0;.00nan;0;0
2317;163462;58;38;32;6;26;.813;3600000;0
2317;37942;58;0;0;0;0;.00nan;0;0
2317;38276;65;0;0;0;0;.00nan;0;0
2317;86180;65;69;29;2;27;.931;3600000;0
2318;182780;60;0;0;0;0;.00nan;0;0
2318;170294;60;71;32;3;29;.906;3600000;0
2318;47112;4837;66;38;5;33;.868;3573000;0
2318;78775;4837;0;0;0;0;.00nan;0;0
2319;5311;42;0;0;0;0;.00nan;0;0
2319;171673;64;0;0;0;0;.00nan;0;0
2319;176915;64;54;38;5;33;.868;3580000;0
2319;57695;42;76;31;3;28;.903;3600000;0
2320;173699;36;80;42;3;39;.929;3600000;0
2320;176921;59;62;20;1;19;.950;3600000;0
2320;58054;59;0;0;0;0;.00nan;0;0
2320;152710;36;0;0;0;0;.00nan;0;0
2321;-1;51;71;51;6;45;.882;3600000;0
2321;176136;57;73;25;2;23;.920;3600000;0
2321;57152;57;0;0;0;0;.00nan;0;0
2321;141484;51;0;0;0;0;.00nan;0;0
2322;175757;63;90;36;2;34;.944;3900000;0
2322;181123;63;0;0;0;0;.00nan;0;0
2322;43928;39;66;27;2;25;.926;3900000;0
2322;59025;39;0;0;0;0;.00nan;0;0
2323;172499;50;0;0;0;0;.00nan;0;0
2323;76574;50;59;19;2;17;.895;3559000;0
2323;79132;49;99;42;1;41;.976;3600000;0
2323;91225;49;0;0;0;0;.00nan;0;0
2324;68938;46;0;0;0;0;.00nan;0;0
2324;79280;46;59;32;4;28;.875;3900000;0
2324;94615;54;0;0;0;0;.00nan;0;0
2324;143301;54;81;43;4;39;.907;3900000;0
2325;163471;37;73;29;2;27;.931;3600000;0
2325;163989;45;58;44;5;39;.886;3600000;0
2325;179350;45;0;0;0;0;.00nan;0;0
2325;141850;37;0;0;0;0;.00nan;0;0
2326;178384;40;83;43;2;41;.953;3600000;0
2326;60773;47;0;0;0;0;.00nan;0;0
2326;79141;47;44;25;4;21;.840;3557000;0
2326;85636;40;0;0;0;0;.00nan;0;0
2327;174718;4619;0;0;0;0;.00nan;0;0
2327;176860;44;62;36;4;32;.889;3600000;0
2327;57434;44;0;0;0;0;.00nan;0;0
2327;64800;4619;100;27;0;27;1.000;3600000;0
2328;170977;41;0;0;0;0;.00nan;0;0
2328;180316;52;59;19;2;17;.895;3600000;0
2328;37857;52;0;0;0;0;.00nan;0;0
2328;143507;41;89;47;3;44;.936;3600000;0
2329;183904;43;0;0;0;0;.00nan;0;0
2329;37077;55;0;0;0;0;.00nan;0;0
2329;86862;55;62;46;6;40;.870;3600000;0
2329;90164;43;88;26;1;25;.962;3600000;0
2330;167642;61;46;16;3;13;.813;3544000;0
2330;164715;62;94;42;2;40;.952;3600000;0
2330;179950;61;0;0;0;0;.00nan;0;0
2330;85336;62;0;0;0;0;.00nan;0;0
2331;170963;38;80;54;5;49;.907;3552000;0
2331;58037;53;57;20;3;17;.850;3600000;0
2331;78581;53;0;0;0;0;.00nan;0;0
2331;141496;38;0;0;0;0;.00nan;0;0
2332;170963;38;0;0;0;0;.00nan;0;0
2332;170977;41;84;30;2;28;.933;3900000;0
2332;141496;38;61;16;2;14;.875;3900000;0
2332;143507;41;0;0;0;0;.00nan;0;0
2333;163462;58;0;0;0;0;.00nan;0;0
2333;37942;58;84;40;3;37;.925;3882000;0
2333;38276;65;87;33;3;30;.909;3900000;0
2333;86180;65;0;0;0;0;.00nan;0;0
2334;163471;37;0;0;0;0;.00nan;0;0
2334;68938;46;39;23;4;19;.826;3600000;0
2334;79280;46;0;0;0;0;.00nan;0;0
2334;141850;37;90;39;2;37;.949;3600000;0
2335;171673;64;86;43;3;40;.930;3587000;0
2335;176915;64;0;0;0;0;.00nan;0;0
2335;94615;54;0;0;0;0;.00nan;0;0
2335;143301;54;87;36;2;34;.944;3600000;0
2336;173699;36;28;15;4;11;.733;1138000;0
2336;180316;52;0;0;0;0;.00nan;0;0
2336;37857;52;84;26;1;25;.962;3600000;0
2336;152710;36;57;22;3;19;.864;2462000;0
2337;183904;43;98;19;0;19;1.000;3600000;0
2337;58100;56;53;36;5;31;.861;3600000;0
2337;85468;56;0;0;0;0;.00nan;0;0
2337;90164;43;0;0;0;0;.00nan;0;0
2338;182780;60;0;0;0;0;.00nan;0;0
2338;170294;60;65;34;5;29;.853;3900000;0
2338;176860;44;0;0;0;0;.00nan;0;0
2338;57434;44;65;39;5;34;.872;3894000;0
2339;178384;40;0;0;0;0;.00nan;0;0
2339;174718;4619;75;25;1;24;.960;3900000;0
2339;64800;4619;0;0;0;0;.00nan;0;0
2339;85636;40;75;22;1;21;.955;3900000;0
2340;5311;42;87;39;2;37;.949;3600000;0
2340;57695;42;0;0;0;0;.00nan;0;0
2340;60773;47;0;0;0;0;.00nan;0;0
2340;79141;47;58;28;3;25;.893;3543000;0
2341;182780;60;68;35;4;31;.886;3554000;0
2341;170294;60;0;0;0;0;.00nan;0;0
2341;176860;44;99;37;2;35;.946;3600000;0
2341;57434;44;0;0;0;0;.00nan;0;0
2342;167642;61;0;0;0;0;.00nan;0;0
2342;164715;62;53;23;3;20;.870;3558000;0
2342;179950;61;92;38;2;36;.947;3600000;0
2342;85336;62;0;0;0;0;.00nan;0;0
2343;37077;55;63;41;6;35;.854;3600000;0
2343;58100;56;68;21;2;19;.905;3600000;0
2343;85468;56;0;0;0;0;.00nan;0;0
2343;86862;55;0;0;0;0;.00nan;0;0
2344;170963;38;79;36;4;32;.889;3552000;0
2344;43928;39;0;0;0;0;.00nan;0;0
2344;59025;39;82;32;3;29;.906;3600000;0
2344;141496;38;0;0;0;0;.00nan;0;0
2345;173699;36;97;32;1;31;.969;3600000;0
2345;175757;63;0;0;0;0;.00nan;0;0
2345;181123;63;68;40;4;36;.900;3600000;0
2345;152710;36;0;0;0;0;.00nan;0;0
2346;172340;48;0;0;0;0;.00nan;0;0
2346;170598;48;89;40;2;38;.950;3600000;0
2346;174718;4619;0;0;0;0;.00nan;0;0
2346;64800;4619;37;25;5;20;.800;3600000;0
2347;163471;37;82;40;3;37;.925;3600000;0
2347;171673;64;0;0;0;0;.00nan;0;0
2347;176915;64;52;33;5;28;.848;3572000;0
2347;141850;37;0;0;0;0;.00nan;0;0
2348;163462;58;0;0;0;0;.00nan;0;0
2348;176921;59;80;35;2;33;.943;3600000;0
2348;37942;58;61;30;3;27;.900;3549000;0
2348;58054;59;0;0;0;0;.00nan;0;0
2349;183904;43;49;11;2;9;.818;3600000;0
2349;-1;51;36;32;6;26;.813;1808000;0
2349;90164;43;0;0;0;0;.00nan;0;0
2349;141484;51;60;26;3;23;.885;1792000;0
2350;5311;42;0;0;0;0;.00nan;0;0
2350;57695;42;67;29;3;26;.897;3543000;0
2350;60773;47;87;33;2;31;.939;3600000;0
2350;79141;47;0;0;0;0;.00nan;0;0
2351;172340;48;78;54;6;48;.889;3600000;0
2351;164715;62;0;0;0;0;.00nan;0;0
2351;170598;48;0;0;0;0;.00nan;0;0
2351;85336;62;53;9;1;8;.889;3600000;0
2352;-1;51;100;45;2;43;.956;3600000;0
2352;37077;55;0;0;0;0;.00nan;0;0
2352;86862;55;39;15;3;12;.800;3600000;0
2352;141484;51;0;0;0;0;.00nan;0;0
2353;182780;60;0;0;0;0;.00nan;0;0
2353;170294;60;73;28;2;26;.929;3900000;0
2353;79132;49;71;22;2;20;.909;3900000;0
2353;91225;49;0;0;0;0;.00nan;0;0
2354;173699;36;89;46;2;44;.957;3581000;0
2354;68938;46;85;13;0;13;1.000;3600000;0
2354;79280;46;0;0;0;0;.00nan;0;0
2354;152710;36;0;0;0;0;.00nan;0;0
2355;163471;37;80;16;0;16;1.000;3600000;0
2355;171673;64;82;35;2;33;.943;3552000;0
2355;176915;64;0;0;0;0;.00nan;0;0
2355;141850;37;0;0;0;0;.00nan;0;0
2356;176921;59;56;20;2;18;.900;3600000;0
2356;43928;39;0;0;0;0;.00nan;0;0
2356;58054;59;0;0;0;0;.00nan;0;0
2356;59025;39;75;32;3;29;.906;3596000;0
2357;167642;61;0;0;0;0;.00nan;0;0
2357;179950;61;73;19;1;18;.947;3759000;0
2357;47112;4837;0;0;0;0;.00nan;0;0
2357;78775;4837;92;43;2;41;.953;3759000;0
2358;163989;45;0;0;0;0;.00nan;0;0
2358;179350;45;42;43;7;36;.837;3600000;0
2358;94615;54;0;0;0;0;.00nan;0;0
2358;143301;54;56;17;2;15;.882;3600000;0
2359;178384;40;71;42;4;38;.905;3600000;0
2359;60773;47;51;2;0;2;1.000;874000;0
2359;79141;47;31;22;6;16;.727;2718000;0
2359;85636;40;0;0;0;0;.00nan;0;0
2360;170977;41;0;0;0;0;.00nan;0;0
2360;180316;52;0;0;0;0;.00nan;0;0
2360;37857;52;57;19;2;17;.895;3600000;0
2360;143507;41;48;44;6;38;.864;3600000;0
2361;183904;43;85;25;1;24;.960;3600000;0
2361;175757;63;0;0;0;0;.00nan;0;0
2361;181123;63;85;37;3;34;.919;3514000;0
2361;90164;43;0;0;0;0;.00nan;0;0
2362;38276;65;0;0;0;0;.00nan;0;0
2362;58100;56;100;48;2;46;.958;3600000;0
2362;85468;56;0;0;0;0;.00nan;0;0
2362;86180;65;57;26;3;23;.885;3600000;0
2363;163462;58;0;0;0;0;.00nan;0;0
2363;37942;58;87;45;3;42;.933;3600000;0
2363;58037;53;79;12;0;12;1.000;3600000;0
2363;78581;53;0;0;0;0;.00nan;0;0
2364;164715;62;64;42;6;36;.857;3897000;0
2364;176860;44;44;27;5;22;.815;3897000;0
2364;57434;44;0;0;0;0;.00nan;0;0
2364;85336;62;0;0;0;0;.00nan;0;0
2365;-1;51;0;0;0;0;.00nan;0;0
2365;37077;55;51;18;3;15;.833;3900000;0
2365;86862;55;0;0;0;0;.00nan;0;0
2365;141484;51;69;35;3;32;.914;3900000;0
2366;173699;36;0;0;0;0;.00nan;0;0
2366;68938;46;0;0;0;0;.00nan;0;0
2366;79280;46;41;18;3;15;.833;3568000;0
2366;152710;36;100;46;1;45;.978;3600000;0
2367;163989;45;88;29;1;28;.966;3600000;0
2367;171673;64;0;0;0;0;.00nan;0;0
2367;179350;45;0;0;0;0;.00nan;0;0
2367;176915;64;51;33;5;28;.848;3600000;0
2368;167642;61;79;27;1;26;.963;3600000;0
2368;179950;61;0;0;0;0;.00nan;0;0
2368;47112;4837;62;41;5;36;.878;3600000;0
2368;78775;4837;0;0;0;0;.00nan;0;0
2369;176136;57;0;0;0;0;.00nan;0;0
2369;57152;57;92;50;3;47;.940;3869000;0
2369;58100;56;65;27;2;25;.926;3869000;0
2369;85468;56;0;0;0;0;.00nan;0;0
2370;170963;38;63;33;4;29;.879;3600000;0
2370;38276;65;100;28;0;28;1.000;3600000;0
2370;86180;65;0;0;0;0;.00nan;0;0
2370;141496;38;0;0;0;0;.00nan;0;0
2371;5311;42;91;37;2;35;.946;3600000;0
2371;172499;50;0;0;0;0;.00nan;0;0
2371;57695;42;0;0;0;0;.00nan;0;0
2371;76574;50;68;33;4;29;.879;3575000;0
2372;172340;48;0;0;0;0;.00nan;0;0
2372;170598;48;88;58;6;52;.897;3600000;0
2372;174718;4619;83;15;0;15;1.000;3600000;0
2372;64800;4619;0;0;0;0;.00nan;0;0
2373;170977;41;58;36;4;32;.889;3589000;0
2373;43928;39;61;20;2;18;.900;3600000;0
2373;59025;39;0;0;0;0;.00nan;0;0
2373;143507;41;0;0;0;0;.00nan;0;0
2374;183904;43;0;0;0;0;.00nan;0;0
2374;175757;63;0;0;0;0;.00nan;0;0
2374;181123;63;100;35;1;34;.971;3600000;0
2374;90164;43;60;30;4;26;.867;3600000;0
2375;163462;58;95;55;4;51;.927;3600000;0
2375;37942;58;0;0;0;0;.00nan;0;0
2375;58037;53;90;20;0;20;1.000;3600000;0
2375;78581;53;0;0;0;0;.00nan;0;0
2376;182780;60;0;0;0;0;.00nan;0;0
2376;170294;60;64;27;2;25;.926;3544000;0
2376;79132;49;99;40;1;39;.975;3600000;0
2376;91225;49;0;0;0;0;.00nan;0;0
2377;176136;57;54;43;6;37;.860;3651000;0
2377;38276;65;57;31;5;26;.839;3651000;0
2377;57152;57;0;0;0;0;.00nan;0;0
2377;86180;65;0;0;0;0;.00nan;0;0
2378;5311;42;0;0;0;0;.00nan;0;0
2378;172499;50;0;0;0;0;.00nan;0;0
2378;57695;42;76;37;4;33;.892;3545000;0
2378;76574;50;87;45;3;42;.933;3600000;0
2379;163471;37;100;32;0;32;1.000;3600000;0
2379;94615;54;0;0;0;0;.00nan;0;0
2379;141850;37;0;0;0;0;.00nan;0;0
2379;143301;54;50;37;6;31;.838;3600000;0
2380;178384;40;60;21;3;18;.857;3900000;0
2380;176860;44;94;57;3;54;.947;3900000;0
2380;57434;44;0;0;0;0;.00nan;0;0
2380;85636;40;0;0;0;0;.00nan;0;0
2381;176921;59;67;20;2;18;.900;3600000;0
2381;180316;52;50;3;0;3;1.000;290000;0
2381;37857;52;40;28;5;23;.821;3310000;0
2381;58054;59;0;0;0;0;.00nan;0;0
2382;170963;38;0;0;0;0;.00nan;0;0
2382;170977;41;0;0;0;0;.00nan;0;0
2382;141496;38;38;24;5;19;.792;3793000;0
2382;143507;41;49;33;6;27;.818;3847000;0
2383;173699;36;65;34;4;30;.882;3600000;0
2383;171673;64;75;26;1;25;.962;3600000;0
2383;176915;64;0;0;0;0;.00nan;0;0
2383;152710;36;0;0;0;0;.00nan;0;0
2384;167642;61;0;0;0;0;.00nan;0;0
2384;179950;61;75;23;1;22;.957;3600000;0
2384;79132;49;35;17;4;13;.765;1056000;0
2384;91225;49;79;37;3;34;.919;2544000;0
2385;164715;62;82;29;1;28;.966;3900000;0
2385;47112;4837;0;0;0;0;.00nan;0;0
2385;78775;4837;97;34;1;33;.971;3900000;0
2385;85336;62;0;0;0;0;.00nan;0;0
2386;183904;43;67;29;3;26;.897;3600000;0
2386;43928;39;0;0;0;0;.00nan;0;0
2386;59025;39;74;45;4;41;.911;3600000;0
2386;90164;43;0;0;0;0;.00nan;0;0
2387;172499;50;0;0;0;0;.00nan;0;0
2387;76574;50;87;23;1;22;.957;3600000;0
2387;94615;54;0;0;0;0;.00nan;0;0
2387;143301;54;62;30;3;27;.900;3547000;0
2388;178384;40;46;31;5;26;.839;2052000;0
2388;176860;44;67;23;2;21;.913;3600000;0
2388;57434;44;0;0;0;0;.00nan;0;0
2388;85636;40;31;12;4;8;.667;1548000;0
2389;172340;48;31;16;4;12;.750;806000;0
2389;60773;47;0;0;0;0;.00nan;0;0
2389;79141;47;44;17;3;14;.824;3600000;0
2389;142492;48;57;32;4;28;.875;2794000;0
2390;175757;63;0;0;0;0;.00nan;0;0
2390;181123;63;53;35;4;31;.886;3564000;0
2390;37077;55;0;0;0;0;.00nan;0;0
2390;86862;55;58;29;3;26;.897;3600000;0
2391;167642;61;54;12;1;11;.917;3600000;0
2391;179950;61;0;0;0;0;.00nan;0;0
2391;79132;49;90;64;4;60;.938;3600000;0
2391;91225;49;0;0;0;0;.00nan;0;0
2392;182780;60;0;0;0;0;.00nan;0;0
2392;164715;62;0;0;0;0;.00nan;0;0
2392;170294;60;63;24;2;22;.917;3553000;0
2392;85336;62;93;31;1;30;.968;3600000;0
2393;163462;58;0;0;0;0;.00nan;0;0
2393;176136;57;0;0;0;0;.00nan;0;0
2393;37942;58;56;22;3;19;.864;3599000;0
2393;57152;57;77;32;2;30;.938;3600000;0
2394;171673;64;0;0;0;0;.00nan;0;0
2394;176915;64;82;52;5;47;.904;3600000;0
2394;68938;46;0;0;0;0;.00nan;0;0
2394;79280;46;41;10;2;8;.800;3600000;0
2395;176921;59;90;25;1;24;.960;3600000;0
2395;180316;52;0;0;0;0;.00nan;0;0
2395;37857;52;75;35;2;33;.943;3547000;0
2395;58054;59;0;0;0;0;.00nan;0;0
2396;176860;44;71;40;4;36;.900;3554000;0
2396;47112;4837;0;0;0;0;.00nan;0;0
2396;57434;44;0;0;0;0;.00nan;0;0
2396;78775;4837;86;37;2;35;.946;3600000;0
2397;173699;36;90;58;6;52;.897;3600000;0
2397;43928;39;0;0;0;0;.00nan;0;0
2397;59025;39;38;15;3;12;.800;3600000;0
2397;152710;36;0;0;0;0;.00nan;0;0
2398;38276;65;0;0;0;0;.00nan;0;0
2398;58037;53;80;23;1;22;.957;3600000;0
2398;78581;53;0;0;0;0;.00nan;0;0
2398;86180;65;79;54;5;49;.907;3600000;0
2399;183904;43;100;26;0;26;1.000;3600000;0
2399;-1;51;63;42;5;37;.881;3600000;0
2399;90164;43;0;0;0;0;.00nan;0;0
2399;141484;51;0;0;0;0;.00nan;0;0
2400;172340;48;100;61;4;57;.934;3900000;0
2400;60773;47;56;31;4;27;.871;3900000;0
2400;79141;47;0;0;0;0;.00nan;0;0
2400;142492;48;0;0;0;0;.00nan;0;0
2401;170963;38;66;24;2;22;.917;3600000;0
2401;170977;41;70;30;3;27;.900;3600000;0
2401;141496;38;0;0;0;0;.00nan;0;0
2401;143507;41;0;0;0;0;.00nan;0;0
2402;5311;42;72;33;3;30;.909;3705000;0
2402;174718;4619;85;32;2;30;.938;3705000;0
2402;57695;42;0;0;0;0;.00nan;0;0
2402;64800;4619;0;0;0;0;.00nan;0;0
2403;175757;63;0;0;0;0;.00nan;0;0
2403;181123;63;95;54;4;50;.926;3600000;0
2403;58100;56;81;27;1;26;.963;3600000;0
2403;85468;56;0;0;0;0;.00nan;0;0
2404;182780;60;0;0;0;0;.00nan;0;0
2404;164715;62;85;27;1;26;.963;3600000;0
2404;170294;60;38;29;5;24;.828;3600000;0
2404;85336;62;0;0;0;0;.00nan;0;0
2405;170963;38;0;0;0;0;.00nan;0;0
2405;176921;59;81;14;0;14;1.000;3600000;0
2405;58054;59;0;0;0;0;.00nan;0;0
2405;141496;38;87;54;4;50;.926;3600000;0
2406;178384;40;59;21;2;19;.905;3545000;0
2406;79132;49;0;0;0;0;.00nan;0;0
2406;85636;40;0;0;0;0;.00nan;0;0
2406;91225;49;99;45;1;44;.978;3600000;0
2407;163462;58;75;21;1;20;.952;3600000;0
2407;176136;57;56;33;4;29;.879;3600000;0
2407;37942;58;0;0;0;0;.00nan;0;0
2407;57152;57;0;0;0;0;.00nan;0;0
2408;163989;45;31;30;6;24;.800;1873000;0
2408;179350;45;61;14;1;13;.929;1727000;0
2408;68938;46;86;21;0;21;1.000;3600000;0
2408;79280;46;0;0;0;0;.00nan;0;0
2409;172340;48;0;0;0;0;.00nan;0;0
2409;167642;61;0;0;0;0;.00nan;0;0
2409;179950;61;48;19;3;16;.842;3544000;0
2409;142492;48;99;57;2;55;.965;3600000;0
2410;176860;44;53;25;3;22;.880;3600000;0
2410;47112;4837;66;34;4;30;.882;3588000;0
2410;57434;44;0;0;0;0;.00nan;0;0
2410;78775;4837;0;0;0;0;.00nan;0;0
2411;163471;37;60;26;3;23;.885;3547000;0
2411;76574;50;83;33;2;31;.939;3600000;0
2411;85661;50;0;0;0;0;.00nan;0;0
2411;141850;37;0;0;0;0;.00nan;0;0
2412;173699;36;0;0;0;0;.00nan;0;0
2412;43928;39;70;16;1;15;.938;3600000;0
2412;59025;39;0;0;0;0;.00nan;0;0
2412;152710;36;71;51;5;46;.902;3600000;0
2413;171673;64;71;37;3;34;.919;3600000;0
2413;176915;64;0;0;0;0;.00nan;0;0
2413;94615;54;0;0;0;0;.00nan;0;0
2413;143301;54;99;20;0;20;1.000;3600000;0
2414;170977;41;49;1;0;1;1.000;351000;0
2414;175757;63;0;0;0;0;.00nan;0;0
2414;181123;63;67;24;2;22;.917;3600000;0
2414;143507;41;57;31;5;26;.839;3249000;0
2415;183904;43;0;0;0;0;.00nan;0;0
2415;-1;51;0;0;0;0;.00nan;0;0
2415;90164;43;63;20;2;18;.900;3600000;0
2415;141484;51;60;42;5;37;.881;3600000;0
2416;5311;42;0;0;0;0;.00nan;0;0
2416;174718;4619;0;0;0;0;.00nan;0;0
2416;57695;42;95;28;1;27;.964;3600000;0
2416;64800;4619;97;42;2;40;.952;3549000;0
2417;37077;55;0;0;0;0;.00nan;0;0
2417;58100;56;89;22;1;21;.955;3900000;0
2417;85468;56;0;0;0;0;.00nan;0;0
2417;86862;55;97;39;1;38;.974;3900000;0
2418;38276;65;51;43;7;36;.837;3600000;0
2418;58037;53;0;0;0;0;.00nan;0;0
2418;78581;53;89;43;3;40;.930;3600000;0
2418;86180;65;0;0;0;0;.00nan;0;0
2419;170963;38;59;36;5;31;.861;3600000;0
2419;184770;65;80;23;1;22;.957;3600000;0
2419;38276;65;0;0;0;0;.00nan;0;0
2419;141496;38;0;0;0;0;.00nan;0;0
2420;178384;40;62;22;2;20;.909;3872000;0
2420;58037;40;0;0;0;0;.00nan;0;0
2420;79132;49;94;45;3;42;.933;3872000;0
2420;91225;49;0;0;0;0;.00nan;0;0
2421;68938;46;0;0;0;0;.00nan;0;0
2421;79280;46;92;19;0;19;1.000;3600000;0
2421;94615;54;0;0;0;0;.00nan;0;0
2421;143301;54;72;41;4;37;.902;3600000;0
2422;43731;37;77;41;4;37;.902;3810000;0
2422;57424;37;0;0;0;0;.00nan;0;0
2422;76574;50;71;42;5;37;.881;3810000;0
2422;85661;50;0;0;0;0;.00nan;0;0
2423;170977;41;49;43;7;36;.837;2438000;0
2423;180316;52;57;19;2;17;.895;3600000;0
2423;37077;52;0;0;0;0;.00nan;0;0
2423;143507;41;59;17;3;14;.824;1162000;0
2424;-1;51;88;36;2;34;.944;3600000;0
2424;58100;56;62;29;3;26;.897;3575000;0
2424;85468;56;0;0;0;0;.00nan;0;0
2424;141484;51;0;0;0;0;.00nan;0;0
2425;164715;62;84;38;3;35;.921;3900000;0
2425;176860;44;74;32;3;29;.906;3900000;0
2425;85336;62;0;0;0;0;.00nan;0;0
2425;86180;44;0;0;0;0;.00nan;0;0
2426;176921;59;30;28;6;22;.786;3551000;0
2426;37942;58;67;46;5;41;.891;3600000;0
2426;58054;59;0;0;0;0;.00nan;0;0
2426;141850;58;0;0;0;0;.00nan;0;0
2427;5311;42;78;30;2;28;.933;3600000;0
2427;163989;45;69;29;3;26;.897;3584000;0
2427;179350;45;0;0;0;0;.00nan;0;0
2427;57695;42;0;0;0;0;.00nan;0;0
2428;167642;61;0;0;0;0;.00nan;0;0
2428;179950;61;81;29;1;28;.966;3600000;0
2428;47112;4837;0;0;0;0;.00nan;0;0
2428;78775;4837;82;34;2;32;.941;3552000;0
2429;164715;62;0;0;0;0;.00nan;0;0
2429;176860;44;0;0;0;0;.00nan;0;0
2429;85336;62;77;26;1;25;.962;3600000;0
2429;86180;44;75;29;2;27;.931;3543000;0
2430;8505;55;39;39;6;33;.846;3600000;0
2430;58100;56;90;29;1;28;.966;3600000;0
2430;85468;56;0;0;0;0;.00nan;0;0
2430;86862;55;0;0;0;0;.00nan;0;0
2431;176921;59;37;24;5;19;.792;3575000;0
2431;37942;58;0;0;0;0;.00nan;0;0
2431;58054;59;0;0;0;0;.00nan;0;0
2431;141850;58;65;40;4;36;.900;3600000;0
2432;173699;36;94;35;1;34;.971;3561000;0
2432;171673;64;0;0;0;0;.00nan;0;0
2432;176915;64;100;27;0;27;1.000;3600000;0
2432;152710;36;0;0;0;0;.00nan;0;0
2433;170963;38;71;31;3;28;.903;3543000;0
2433;43928;39;0;0;0;0;.00nan;0;0
2433;59025;39;64;16;1;15;.938;3600000;0
2433;141496;38;0;0;0;0;.00nan;0;0
2434;76574;50;87;30;1;29;.967;3600000;0
2434;85661;50;0;0;0;0;.00nan;0;0
2434;94615;54;0;0;0;0;.00nan;0;0
2434;143301;54;81;35;2;33;.943;3563000;0
2435;178384;40;100;36;0;36;1.000;3600000;0
2435;58037;40;0;0;0;0;.00nan;0;0
2435;60773;47;77;20;1;19;.950;3561000;0
2435;79141;47;0;0;0;0;.00nan;0;0
2436;183904;43;39;15;3;12;.800;3556000;0
2436;-1;51;99;44;1;43;.977;3600000;0
2436;90164;43;0;0;0;0;.00nan;0;0
2436;141484;51;0;0;0;0;.00nan;0;0
2437;5311;42;0;0;0;0;.00nan;0;0
2437;163989;45;73;17;0;17;1.000;1223000;0
2437;179350;45;30;41;8;33;.805;2377000;0
2437;57695;42;35;24;5;19;.792;3600000;0
2438;167642;61;61;26;3;23;.885;3600000;0
2438;179950;61;0;0;0;0;.00nan;0;0
2438;47112;4837;14;20;6;14;.700;2078000;0
2438;78775;4837;63;17;1;16;.941;1522000;0
2439;184770;65;0;0;0;0;.00nan;0;0
2439;38276;65;63;27;3;24;.889;3600000;0
2439;60863;53;0;0;0;0;.00nan;0;0
2439;78581;53;74;39;4;35;.897;3565000;0
2440;68938;46;88;27;3;24;.889;3900000;0
2440;76574;50;60;25;3;22;.880;3900000;0
2440;79280;46;0;0;0;0;.00nan;0;0
2440;85661;50;0;0;0;0;.00nan;0;0
2441;173699;36;62;34;4;30;.882;3600000;0
2441;60863;53;0;0;0;0;.00nan;0;0
2441;78581;53;84;28;1;27;.964;3600000;0
2441;152710;36;0;0;0;0;.00nan;0;0
2442;182780;60;0;0;0;0;.00nan;0;0
2442;170294;60;69;27;2;25;.926;3600000;0
2442;79132;49;94;52;3;49;.942;3598000;0
2442;91225;49;0;0;0;0;.00nan;0;0
2443;171673;64;100;44;1;43;.977;3600000;0
2443;176915;64;0;0;0;0;.00nan;0;0
2443;43731;37;60;28;3;25;.893;3567000;0
2443;57424;37;0;0;0;0;.00nan;0;0
2444;170963;38;98;48;3;45;.938;3513000;0
2444;43928;39;0;0;0;0;.00nan;0;0
2444;59025;39;76;25;1;24;.960;3600000;0
2444;141496;38;0;0;0;0;.00nan;0;0
2445;172340;48;58;28;3;25;.893;3544000;0
2445;178384;40;88;28;1;27;.964;3600000;0
2445;58037;40;0;0;0;0;.00nan;0;0
2445;142492;48;0;0;0;0;.00nan;0;0
2446;184770;65;0;0;0;0;.00nan;0;0
2446;180316;52;0;0;0;0;.00nan;0;0
2446;37077;52;76;43;4;39;.907;3547000;0
2446;38276;65;95;50;3;47;.940;3600000;0
2447;163471;63;71;33;2;31;.939;3600000;0
2447;-1;51;53;30;4;26;.867;3527000;0
2447;175757;63;0;0;0;0;.00nan;0;0
2447;141484;51;0;0;0;0;.00nan;0;0
2448;60773;47;0;0;0;0;.00nan;0;0
2448;79141;47;78;26;1;25;.962;3600000;0
2448;94615;54;0;0;0;0;.00nan;0;0
2448;143301;54;71;34;3;31;.912;3563000;0
2449;8505;55;70;52;6;46;.885;3294000;0
2449;183904;43;0;0;0;0;.00nan;0;0
2449;86862;55;53;4;0;4;1.000;306000;0
2449;90164;43;53;22;3;19;.864;3600000;0
2450;176136;57;0;0;0;0;.00nan;0;0
2450;57152;57;56;31;4;27;.871;3600000;0
2450;58100;56;79;12;0;12;1.000;3600000;0
2450;85468;56;0;0;0;0;.00nan;0;0
2451;176860;44;0;0;0;0;.00nan;0;0
2451;47112;4837;0;0;0;0;.00nan;0;0
2451;78775;4837;32;30;6;24;.800;3600000;0
2451;86180;44;62;28;2;26;.929;3600000;0
2452;164715;62;0;0;0;0;.00nan;0;0
2452;178384;40;36;7;2;5;.714;642000;0
2452;58037;40;29;25;6;19;.760;2958000;0
2452;85336;62;66;28;2;26;.929;3600000;0
2453;8505;55;0;0;0;0;.00nan;0;0
2453;170963;38;0;0;0;0;.00nan;0;0
2453;86862;55;82;35;2;33;.943;3526000;0
2453;141496;38;100;26;0;26;1.000;3600000;0
2454;170977;41;72;36;3;33;.917;3600000;0
2454;37942;58;0;0;0;0;.00nan;0;0
2454;141850;58;58;30;4;26;.867;3562000;0
2454;143507;41;0;0;0;0;.00nan;0;0
2455;68938;46;0;0;0;0;.00nan;0;0
2455;76574;50;0;0;0;0;.00nan;0;0
2455;79280;46;78;24;2;22;.917;3600000;0
2455;85661;50;78;37;3;34;.919;3600000;0
2456;173699;36;0;0;0;0;.00nan;0;0
2456;60863;53;51;6;1;5;.833;3600000;0
2456;78581;53;0;0;0;0;.00nan;0;0
2456;152710;36;93;49;3;46;.939;3531000;0
2457;182780;60;0;0;0;0;.00nan;0;0
2457;170294;60;57;19;2;17;.895;3600000;0
2457;79132;49;0;0;0;0;.00nan;0;0
2457;91225;49;68;32;3;29;.906;3600000;0
2458;171673;64;0;0;0;0;.00nan;0;0
2458;176915;64;94;47;3;44;.936;3600000;0
2458;43731;37;0;0;0;0;.00nan;0;0
2458;57424;37;59;31;4;27;.871;3563000;0
2459;176921;59;0;0;0;0;.00nan;0;0
2459;58054;59;77;32;2;30;.938;3900000;0
2459;58100;56;100;47;2;45;.957;3900000;0
2459;85468;56;0;0;0;0;.00nan;0;0
2460;183904;43;0;0;0;0;.00nan;0;0
2460;176136;57;99;42;2;40;.952;3900000;0
2460;57152;57;0;0;0;0;.00nan;0;0
2460;90164;43;62;20;2;18;.900;3900000;0
2461;184770;65;44;55;7;48;.873;3600000;0
2461;180316;52;0;0;0;0;.00nan;0;0
2461;37077;52;52;17;3;14;.824;3600000;0
2461;38276;65;0;0;0;0;.00nan;0;0
2462;163989;45;88;38;3;35;.921;3600000;0
2462;174718;4619;22;5;3;2;.400;518000;0
2462;179350;45;0;0;0;0;.00nan;0;0
2462;64800;4619;47;12;2;10;.833;3066000;0
2463;60773;47;28;26;5;21;.808;3600000;0
2463;79141;47;0;0;0;0;.00nan;0;0
2463;94615;54;0;0;0;0;.00nan;0;0
2463;143301;54;50;29;4;25;.862;3600000;0
2464;163471;63;94;36;1;35;.972;3900000;0
2464;-1;51;0;0;0;0;.00nan;0;0
2464;175757;63;0;0;0;0;.00nan;0;0
2464;141484;51;90;27;1;26;.963;3900000;0
2465;5311;42;90;33;1;32;.970;3600000;0
2465;167642;61;0;0;0;0;.00nan;0;0
2465;179950;61;57;21;3;18;.857;3568000;0
2465;57695;42;0;0;0;0;.00nan;0;0
2466;176860;44;0;0;0;0;.00nan;0;0
2466;47112;4837;9;9;5;4;.444;1016000;0
2466;78775;4837;55;25;3;22;.880;2584000;0
2466;86180;44;39;22;5;17;.773;3600000;0
2467;170977;41;0;0;0;0;.00nan;0;0
2467;37942;58;0;0;0;0;.00nan;0;0
2467;141850;58;74;31;2;29;.935;3600000;0
2467;143507;41;58;28;3;25;.893;3580000;0
2468;43731;37;100;37;0;37;1.000;3600000;0
2468;57424;37;0;0;0;0;.00nan;0;0
2468;68938;46;64;28;4;24;.857;3600000;0
2468;79280;46;0;0;0;0;.00nan;0;0
2469;176136;57;60;15;1;14;.933;642000;0
2469;176921;59;65;14;1;13;.929;3600000;0
2469;57152;57;40;40;7;33;.825;2958000;0
2469;58054;59;0;0;0;0;.00nan;0;0
2470;163989;45;45;5;1;4;.800;246000;0
2470;174718;4619;42;18;4;14;.778;2039000;0
2470;179350;45;44;42;6;36;.857;3354000;0
2470;64800;4619;58;8;1;7;.875;1561000;0
2471;163471;63;99;42;1;41;.976;3600000;0
2471;175757;63;0;0;0;0;.00nan;0;0
2471;43928;39;0;0;0;0;.00nan;0;0
2471;59025;39;51;20;3;17;.850;3532000;0
2472;5311;42;0;0;0;0;.00nan;0;0
2472;167642;61;65;18;1;17;.944;3600000;0
2472;179950;61;0;0;0;0;.00nan;0;0
2472;57695;42;52;35;4;31;.886;3600000;0
2473;164715;62;0;0;0;0;.00nan;0;0
2473;79132;49;100;41;1;40;.976;3900000;0
2473;85336;62;75;17;1;16;.941;3900000;0
2473;91225;49;0;0;0;0;.00nan;0;0
2474;182780;60;0;0;0;0;.00nan;0;0
2474;170294;60;83;38;2;36;.947;3600000;0
2474;94615;54;0;0;0;0;.00nan;0;0
2474;143301;54;57;30;4;26;.867;3561000;0
2475;172499;50;0;0;0;0;.00nan;0;0
2475;171673;64;59;41;5;36;.878;3591000;0
2475;176915;64;0;0;0;0;.00nan;0;0
2475;76574;50;53;25;4;21;.840;3600000;0
2476;164715;62;0;0;0;0;.00nan;0;0
2476;79132;49;0;0;0;0;.00nan;0;0
2476;85336;62;61;23;3;20;.870;3600000;0
2476;91225;49;50;43;6;37;.860;3600000;0
2477;5311;42;86;36;3;33;.917;3600000;0
2477;172340;48;0;0;0;0;.00nan;0;0
2477;57695;42;0;0;0;0;.00nan;0;0
2477;142492;48;47;41;6;35;.854;3600000;0
2478;182780;60;71;43;4;39;.907;3520000;0
2478;170294;60;0;0;0;0;.00nan;0;0
2478;94615;54;0;0;0;0;.00nan;0;0
2478;143301;54;71;26;2;24;.923;3600000;0
2479;170977;41;59;44;6;38;.864;3600000;0
2479;184770;65;0;0;0;0;.00nan;0;0
2479;38276;65;77;35;3;32;.914;3600000;0
2479;143507;41;0;0;0;0;.00nan;0;0
2480;172499;50;0;0;0;0;.00nan;0;0
2480;171673;64;90;45;3;42;.933;3900000;0
2480;176915;64;0;0;0;0;.00nan;0;0
2480;76574;50;52;23;3;20;.870;3900000;0
2481;167642;61;0;0;0;0;.00nan;0;0
2481;178384;40;59;26;3;23;.885;3551000;0
2481;179950;61;80;24;2;22;.917;3600000;0
2481;58037;40;0;0;0;0;.00nan;0;0
2482;-1;51;75;59;6;53;.898;3344000;0
2482;176921;59;75;10;0;10;1.000;3600000;0
2482;58054;59;0;0;0;0;.00nan;0;0
2482;141484;51;45;5;1;4;.800;256000;0
2483;163989;45;49;34;5;29;.853;1950000;0
2483;179350;45;71;26;2;24;.923;1650000;0
2483;68938;46;42;11;2;9;.818;3600000;0
2483;79280;46;0;0;0;0;.00nan;0;0
2484;174718;4619;0;0;0;0;.00nan;0;0
2484;60773;47;0;0;0;0;.00nan;0;0
2484;64800;4619;69;45;5;40;.889;3900000;0
2484;79141;47;39;23;5;18;.783;3900000;0
2485;173699;36;42;30;6;24;.800;3877000;0
2485;176136;57;55;39;6;33;.846;3900000;0
2485;57152;57;0;0;0;0;.00nan;0;0
2485;152710;36;0;0;0;0;.00nan;0;0
2486;172340;48;0;0;0;0;.00nan;0;0
2486;164715;62;0;0;0;0;.00nan;0;0
2486;85336;62;89;27;1;26;.963;3600000;0
2486;142492;48;92;38;2;36;.947;3583000;0
2487;8505;55;53;26;4;22;.846;2292000;0
2487;43928;39;0;0;0;0;.00nan;0;0
2487;59025;39;77;33;3;30;.909;3600000;0
2487;86862;55;71;13;0;13;1.000;1292000;0
2488;43731;37;40;20;4;16;.800;3552000;0
2488;57424;37;0;0;0;0;.00nan;0;0
2488;68938;46;68;36;3;33;.917;3600000;0
2488;79280;46;0;0;0;0;.00nan;0;0
2489;178384;40;75;40;3;37;.925;3553000;0
2489;58037;40;0;0;0;0;.00nan;0;0
2489;79132;49;76;35;2;33;.943;3600000;0
2489;91225;49;0;0;0;0;.00nan;0;0
2490;163471;63;93;31;1;30;.968;3600000;0
2490;-1;51;75;32;3;29;.906;3600000;0
2490;175757;63;0;0;0;0;.00nan;0;0
2490;141484;51;0;0;0;0;.00nan;0;0
2491;5311;42;72;55;6;49;.891;3600000;0
2491;57695;42;0;0;0;0;.00nan;0;0
2491;60773;47;0;0;0;0;.00nan;0;0
2491;79141;47;77;24;1;23;.958;3600000;0
2492;170977;41;0;0;0;0;.00nan;0;0
2492;37942;58;0;0;0;0;.00nan;0;0
2492;141850;58;64;26;3;23;.885;3572000;0
2492;143507;41;93;50;2;48;.960;3600000;0
2493;183904;43;65;30;3;27;.900;3522000;0
2493;60863;53;0;0;0;0;.00nan;0;0
2493;78581;53;87;30;1;29;.967;3600000;0
2493;90164;43;0;0;0;0;.00nan;0;0
2494;170963;38;0;0;0;0;.00nan;0;0
2494;58100;56;45;30;5;25;.833;3600000;0
2494;85468;56;0;0;0;0;.00nan;0;0
2494;141496;38;91;36;2;34;.944;3600000;0
2495;8505;55;49;39;6;33;.846;2954000;0
2495;43928;39;81;28;2;26;.929;3600000;0
2495;59025;39;0;0;0;0;.00nan;0;0
2495;86862;55;47;6;1;5;.833;646000;0
2496;173699;36;70;31;3;28;.903;3589000;0
2496;176136;57;0;0;0;0;.00nan;0;0
2496;57152;57;82;31;1;30;.968;3600000;0
2496;152710;36;0;0;0;0;.00nan;0;0
2497;5311;42;0;0;0;0;.00nan;0;0
2497;172340;48;77;30;2;28;.933;3600000;0
2497;57695;42;47;5;1;4;.800;3600000;0
2497;142492;48;0;0;0;0;.00nan;0;0
2498;43731;37;0;0;0;0;.00nan;0;0
2498;57424;37;68;27;2;25;.926;3600000;0
2498;68938;46;0;0;0;0;.00nan;0;0
2498;79280;46;36;23;4;19;.826;3547000;0
2499;170963;38;83;26;2;24;.923;3900000;0
2499;184770;65;0;0;0;0;.00nan;0;0
2499;38276;65;83;26;2;24;.923;3900000;0
2499;141496;38;0;0;0;0;.00nan;0;0
2500;172499;50;0;0;0;0;.00nan;0;0
2500;176860;44;0;0;0;0;.00nan;0;0
2500;76574;50;58;24;3;21;.875;3798000;0
2500;86180;44;51;29;4;25;.862;3798000;0
2501;47112;4837;0;0;0;0;.00nan;0;0
2501;78775;4837;30;33;6;27;.818;3600000;0
2501;94615;54;0;0;0;0;.00nan;0;0
2501;143301;54;77;23;1;22;.957;3600000;0
2502;180316;52;0;0;0;0;.00nan;0;0
2502;37077;52;85;32;1;31;.969;3600000;0
2502;37942;58;0;0;0;0;.00nan;0;0
2502;141850;58;44;29;5;24;.828;3600000;0
2503;163989;45;63;39;4;35;.897;3600000;0
2503;171673;64;18;22;6;16;.727;2161000;0
2503;179350;45;0;0;0;0;.00nan;0;0
2503;176915;64;60;12;1;11;.917;1439000;0
2504;167642;61;0;0;0;0;.00nan;0;0
2504;174718;4619;0;0;0;0;.00nan;0;0
2504;179950;61;60;35;4;31;.886;3900000;0
2504;64800;4619;73;41;4;37;.902;3900000;0
2505;183904;43;0;0;0;0;.00nan;0;0
2505;170977;41;48;53;7;46;.868;3294000;0
2505;90164;43;50;10;1;9;.900;3600000;0
2505;143507;41;54;4;0;4;1.000;306000;0
2506;163471;63;77;60;6;54;.900;3600000;0
2506;175757;63;0;0;0;0;.00nan;0;0
2506;176921;59;68;17;1;16;.941;3600000;0
2506;58054;59;0;0;0;0;.00nan;0;0
2507;58100;56;63;36;4;32;.889;3600000;0
2507;60863;53;19;22;6;16;.727;2382000;0
2507;78581;53;51;9;1;8;.889;1218000;0
2507;85468;56;0;0;0;0;.00nan;0;0
2508;8505;55;0;0;0;0;.00nan;0;0
2508;176921;59;0;0;0;0;.00nan;0;0
2508;58054;59;75;23;1;22;.957;3600000;0
2508;86862;55;85;49;4;45;.918;3600000;0
2509;184770;65;78;35;3;32;.914;3572000;0
2509;38276;65;0;0;0;0;.00nan;0;0
2509;60863;53;0;0;0;0;.00nan;0;0
2509;78581;53;87;39;2;37;.949;3600000;0
2510;172499;50;0;0;0;0;.00nan;0;0
2510;176860;44;47;5;1;4;.800;268000;0
2510;76574;50;61;29;4;25;.862;3600000;0
2510;86180;44;36;33;6;27;.818;3332000;0
2511;47112;4837;63;23;3;20;.870;3600000;0
2511;78775;4837;0;0;0;0;.00nan;0;0
2511;94615;54;18;9;4;5;.556;937000;0
2511;143301;54;72;25;2;23;.920;2663000;0
2512;164715;62;0;0;0;0;.00nan;0;0
2512;178384;40;89;29;1;28;.966;3900000;0
2512;58037;40;0;0;0;0;.00nan;0;0
2512;85336;62;100;36;1;35;.972;3900000;0
2513;183904;43;73;29;2;27;.931;3600000;0
2513;180316;52;0;0;0;0;.00nan;0;0
2513;37077;52;53;27;3;24;.889;3584000;0
2513;90164;43;0;0;0;0;.00nan;0;0
2514;-1;51;86;55;5;50;.909;3600000;0
2514;58100;56;74;26;2;24;.923;3600000;0
2514;85468;56;0;0;0;0;.00nan;0;0
2514;141484;51;0;0;0;0;.00nan;0;0
2515;60773;47;100;23;0;23;1.000;3600000;0
2515;79132;49;47;23;4;19;.826;1005000;0
2515;79141;47;0;0;0;0;.00nan;0;0
2515;91225;49;65;34;4;30;.882;2595000;0
2516;167642;61;82;24;2;22;.917;3600000;0
2516;174718;4619;97;57;3;54;.947;3547000;0
2516;179950;61;0;0;0;0;.00nan;0;0
2516;64800;4619;0;0;0;0;.00nan;0;0
2517;163471;63;56;44;5;39;.886;3540000;0
2517;175757;63;0;0;0;0;.00nan;0;0
2517;43928;39;0;0;0;0;.00nan;0;0
2517;59025;39;60;22;3;19;.864;3600000;0
2518;172340;48;0;0;0;0;.00nan;0;0
2518;79132;49;72;35;4;31;.886;3600000;0
2518;91225;49;0;0;0;0;.00nan;0;0
2518;142492;48;42;28;5;23;.821;3541000;0
2519;176136;57;81;48;4;44;.917;3600000;0
2519;180316;52;0;0;0;0;.00nan;0;0
2519;37077;52;52;20;2;18;.900;3600000;0
2519;57152;57;0;0;0;0;.00nan;0;0
2520;43731;37;100;32;1;31;.969;3900000;0
2520;57424;37;0;0;0;0;.00nan;0;0
2520;94615;54;0;0;0;0;.00nan;0;0
2520;143301;54;95;37;1;36;.973;3900000;0
2521;172340;48;74;27;2;25;.926;3600000;0
2521;79132;49;0;0;0;0;.00nan;0;0
2521;91225;49;20;28;6;22;.786;3600000;0
2521;142492;48;0;0;0;0;.00nan;0;0
2522;163989;45;71;50;5;45;.900;3600000;0
2522;179350;45;0;0;0;0;.00nan;0;0
2522;68938;46;58;12;1;11;.917;3600000;0
2522;79280;46;0;0;0;0;.00nan;0;0
2523;173699;36;89;30;2;28;.933;3600000;0
2523;171673;64;0;0;0;0;.00nan;0;0
2523;176915;64;82;30;1;29;.967;3600000;0
2523;152710;36;0;0;0;0;.00nan;0;0
2524;176921;59;68;15;1;14;.933;3600000;0
2524;37942;58;61;8;0;8;1.000;836000;0
2524;58054;59;0;0;0;0;.00nan;0;0
2524;141850;58;18;37;8;29;.784;2764000;0
2525;163471;63;100;32;0;32;1.000;3600000;0
2525;172499;50;0;0;0;0;.00nan;0;0
2525;175757;63;0;0;0;0;.00nan;0;0
2525;76574;50;62;17;1;16;.941;3543000;0
2526;178384;40;98;46;3;43;.935;3600000;0
2526;174718;4619;0;0;0;0;.00nan;0;0
2526;58037;40;0;0;0;0;.00nan;0;0
2526;64800;4619;77;16;1;15;.938;3600000;0
2527;183904;43;0;0;0;0;.00nan;0;0
2527;-1;51;34;10;3;7;.700;503000;0
2527;90164;43;64;16;1;15;.938;3600000;0
2527;141484;51;97;33;1;32;.970;3097000;0
2528;43928;39;0;0;0;0;.00nan;0;0
2528;58100;56;88;39;2;37;.949;3900000;0
2528;59025;39;78;34;2;32;.941;3900000;0
2528;85468;56;0;0;0;0;.00nan;0;0
2529;170963;38;94;20;0;20;1.000;3600000;0
2529;37942;58;0;0;0;0;.00nan;0;0
2529;141496;38;0;0;0;0;.00nan;0;0
2529;141850;58;65;25;3;22;.880;3600000;0
2530;174718;4619;27;11;4;7;.636;877000;0
2530;64800;4619;44;17;3;14;.824;2723000;0
2530;79132;49;88;30;1;29;.967;3600000;0
2530;91225;49;0;0;0;0;.00nan;0;0
2531;171673;64;88;37;1;36;.973;3600000;0
2531;176915;64;0;0;0;0;.00nan;0;0
2531;68938;46;59;17;2;15;.882;3546000;0
2531;79280;46;0;0;0;0;.00nan;0;0
2532;182780;60;0;0;0;0;.00nan;0;0
2532;170294;60;66;22;2;20;.909;3600000;0
2532;176860;44;0;0;0;0;.00nan;0;0
2532;86180;44;64;38;4;34;.895;3600000;0
2533;170977;41;0;0;0;0;.00nan;0;0
2533;176921;59;65;17;1;16;.941;3600000;0
2533;58054;59;0;0;0;0;.00nan;0;0
2533;143507;41;69;42;4;38;.905;3600000;0
2534;164715;62;0;0;0;0;.00nan;0;0
2534;47112;4837;0;0;0;0;.00nan;0;0
2534;78775;4837;92;36;1;35;.972;3600000;0
2534;85336;62;70;30;2;28;.933;3600000;0
2535;8505;55;66;37;4;33;.892;3600000;0
2535;43928;39;0;0;0;0;.00nan;0;0
2535;59025;39;71;15;1;14;.933;3600000;0
2535;86862;55;0;0;0;0;.00nan;0;0
2536;163471;63;76;45;4;41;.911;3600000;0
2536;172499;50;0;0;0;0;.00nan;0;0
2536;175757;63;0;0;0;0;.00nan;0;0
2536;76574;50;75;23;1;22;.957;3600000;0
2537;163989;45;96;42;2;40;.952;3557000;0
2537;179350;45;0;0;0;0;.00nan;0;0
2537;94615;54;0;0;0;0;.00nan;0;0
2537;143301;54;88;16;0;16;1.000;3600000;0
2538;183904;43;46;31;5;26;.839;3600000;0
2538;184770;65;52;8;1;7;.875;955000;0
2538;38276;65;27;34;7;27;.794;2645000;0
2538;90164;43;0;0;0;0;.00nan;0;0
2539;5311;42;70;22;2;20;.909;3600000;0
2539;43731;37;66;35;3;32;.914;3568000;0
2539;57424;37;0;0;0;0;.00nan;0;0
2539;57695;42;0;0;0;0;.00nan;0;0
2540;167642;61;0;0;0;0;.00nan;0;0
2540;179950;61;99;23;0;23;1.000;3600000;0
2540;60773;47;87;38;3;35;.921;3600000;0
2540;79141;47;0;0;0;0;.00nan;0;0
2541;180316;52;0;0;0;0;.00nan;0;0
2541;37077;52;64;27;3;24;.889;3600000;0
2541;58100;56;76;43;4;39;.907;3600000;0
2541;85468;56;0;0;0;0;.00nan;0;0
2542;170963;38;39;23;5;18;.783;3600000;0
2542;37942;58;0;0;0;0;.00nan;0;0
2542;141496;38;0;0;0;0;.00nan;0;0
2542;141850;58;63;37;4;33;.892;3600000;0
2543;163989;45;0;0;0;0;.00nan;0;0
2543;179350;45;72;44;4;40;.909;3554000;0
2543;68938;46;0;0;0;0;.00nan;0;0
2543;79280;46;74;28;2;26;.929;3600000;0
2544;173699;36;31;26;6;20;.769;3600000;0
2544;-1;51;58;23;3;20;.870;3600000;0
2544;141484;51;0;0;0;0;.00nan;0;0
2544;152710;36;0;0;0;0;.00nan;0;0
2545;182780;60;0;0;0;0;.00nan;0;0
2545;170294;60;50;35;5;30;.857;3600000;0
2545;176860;44;0;0;0;0;.00nan;0;0
2545;86180;44;72;21;1;20;.952;3600000;0
2546;176136;57;54;42;6;36;.857;2994000;0
2546;176921;59;0;0;0;0;.00nan;0;0
2546;57152;57;62;17;2;15;.882;606000;0
2546;58054;59;94;15;0;15;1.000;3600000;0
2547;172340;48;0;0;0;0;.00nan;0;0
2547;47112;4837;71;29;2;27;.931;3600000;0
2547;78775;4837;0;0;0;0;.00nan;0;0
2547;142492;48;51;23;3;20;.870;3572000;0
2548;8505;55;0;0;0;0;.00nan;0;0
2548;43928;39;75;25;1;24;.960;3600000;0
2548;59025;39;0;0;0;0;.00nan;0;0
2548;86862;55;72;40;4;36;.900;3600000;0
2549;171673;64;0;0;0;0;.00nan;0;0
2549;176915;64;65;31;3;28;.903;3547000;0
2549;94615;54;0;0;0;0;.00nan;0;0
2549;143301;54;68;26;2;24;.923;3600000;0
2550;164715;62;0;0;0;0;.00nan;0;0
2550;178384;40;78;42;4;38;.905;3538000;0
2550;58037;40;0;0;0;0;.00nan;0;0
2550;85336;62;81;27;2;25;.926;3600000;0
2551;183904;43;0;0;0;0;.00nan;0;0
2551;180316;52;0;0;0;0;.00nan;0;0
2551;37077;52;87;42;3;39;.929;3600000;0
2551;90164;43;51;27;4;23;.852;3577000;0
2552;5311;42;0;0;0;0;.00nan;0;0
2552;43731;37;0;0;0;0;.00nan;0;0
2552;57424;37;58;36;4;32;.889;3559000;0
2552;57695;42;62;29;2;27;.931;3600000;0
2553;167642;61;0;0;0;0;.00nan;0;0
2553;179950;61;72;36;3;33;.917;3600000;0
2553;60773;47;0;0;0;0;.00nan;0;0
2553;79141;47;54;26;4;22;.846;3555000;0
2554;170977;41;37;39;7;32;.821;3600000;0
2554;58100;56;59;13;1;12;.923;3600000;0
2554;85468;56;0;0;0;0;.00nan;0;0
2554;143507;41;0;0;0;0;.00nan;0;0
2555;184770;65;75;43;3;40;.930;3600000;0
2555;38276;65;0;0;0;0;.00nan;0;0
2555;60863;53;82;24;1;23;.958;3600000;0
2555;78581;53;0;0;0;0;.00nan;0;0
2556;174718;4619;0;0;0;0;.00nan;0;0
2556;64800;4619;88;26;1;25;.962;3600000;0
2556;79132;49;74;40;3;37;.925;3552000;0
2556;91225;49;0;0;0;0;.00nan;0;0
2557;172499;50;0;0;0;0;.00nan;0;0
2557;176860;44;0;0;0;0;.00nan;0;0
2557;76574;50;66;24;2;22;.917;3695000;0
2557;86180;44;79;33;3;30;.909;3695000;0
2558;170963;38;91;29;1;28;.966;3600000;0
2558;58100;56;49;27;4;23;.852;3600000;0
2558;85468;56;0;0;0;0;.00nan;0;0
2558;141496;38;0;0;0;0;.00nan;0;0
2559;184770;65;0;0;0;0;.00nan;0;0
2559;176136;57;0;0;0;0;.00nan;0;0
2559;38276;65;73;24;2;22;.917;3600000;0
2559;57152;57;78;39;3;36;.923;3564000;0
2560;163989;45;72;39;3;36;.923;3600000;0
2560;179350;45;0;0;0;0;.00nan;0;0
2560;94615;54;0;0;0;0;.00nan;0;0
2560;143301;54;88;24;1;23;.958;3600000;0
2561;182780;60;0;0;0;0;.00nan;0;0
2561;5311;42;82;38;3;35;.921;3600000;0
2561;170294;60;74;24;2;22;.917;3600000;0
2561;57695;42;0;0;0;0;.00nan;0;0
2562;172499;50;0;0;0;0;.00nan;0;0
2562;176860;44;0;0;0;0;.00nan;0;0
2562;76574;50;79;36;2;34;.944;3900000;0
2562;86180;44;91;35;2;33;.943;3900000;0
2563;167642;61;0;0;0;0;.00nan;0;0
2563;164715;62;0;0;0;0;.00nan;0;0
2563;179950;61;92;34;1;33;.971;3600000;0
2563;85336;62;87;37;2;35;.946;3555000;0
2564;171673;64;77;55;5;50;.909;3600000;0
2564;176915;64;0;0;0;0;.00nan;0;0
2564;68938;46;72;17;1;16;.941;3600000;0
2564;79280;46;0;0;0;0;.00nan;0;0
2565;170963;38;54;11;1;10;.909;772000;0
2565;176921;59;0;0;0;0;.00nan;0;0
2565;58054;59;82;22;1;21;.955;3600000;0
2565;141496;38;60;42;6;36;.857;2828000;0
2566;178384;40;100;42;2;40;.952;3600000;0
2566;47112;4837;0;0;0;0;.00nan;0;0
2566;58037;40;0;0;0;0;.00nan;0;0
2566;78775;4837;57;32;4;28;.875;3591000;0
2567;173699;36;90;38;3;35;.921;3600000;0
2567;-1;51;0;0;0;0;.00nan;0;0
2567;141484;51;34;26;5;21;.808;3572000;0
2567;152710;36;0;0;0;0;.00nan;0;0
2568;174718;4619;99;47;3;44;.936;3900000;0
2568;60773;47;0;0;0;0;.00nan;0;0
2568;64800;4619;0;0;0;0;.00nan;0;0
2568;79141;47;65;29;3;26;.897;3900000;0
2569;182780;60;47;25;4;21;.840;3581000;0
2569;5311;42;0;0;0;0;.00nan;0;0
2569;170294;60;0;0;0;0;.00nan;0;0
2569;57695;42;67;30;3;27;.900;3600000;0
2570;163471;63;56;17;3;14;.824;3600000;0
2570;170977;41;64;46;6;40;.870;3135000;0
2570;175757;63;0;0;0;0;.00nan;0;0
2570;143507;41;57;6;0;6;1.000;465000;0
2571;172340;48;58;28;4;24;.857;3111000;0
2571;174718;4619;0;0;0;0;.00nan;0;0
2571;64800;4619;100;42;0;42;1.000;3600000;0
2571;142492;48;30;9;3;6;.667;489000;0
2572;164715;62;0;0;0;0;.00nan;0;0
2572;79132;49;83;31;2;29;.935;3600000;0
2572;85336;62;58;26;3;23;.885;3558000;0
2572;91225;49;0;0;0;0;.00nan;0;0
2573;8505;55;99;21;0;21;1.000;3600000;0
2573;170977;41;74;39;3;36;.923;3600000;0
2573;86862;55;0;0;0;0;.00nan;0;0
2573;143507;41;0;0;0;0;.00nan;0;0
2574;163989;45;0;0;0;0;.00nan;0;0
2574;171673;64;0;0;0;0;.00nan;0;0
2574;179350;45;71;25;1;24;.960;3600000;0
2574;176915;64;98;44;2;42;.955;3600000;0
2575;176136;57;84;44;4;40;.909;3600000;0
2575;43731;37;87;18;0;18;1.000;3600000;0
2575;57152;57;0;0;0;0;.00nan;0;0
2575;57424;37;0;0;0;0;.00nan;0;0
2576;183904;43;72;30;3;27;.900;3600000;0
2576;43928;39;76;23;1;22;.957;2538000;0
2576;59025;39;23;13;4;9;.692;1062000;0
2576;90164;43;0;0;0;0;.00nan;0;0
2577;184770;65;0;0;0;0;.00nan;0;0
2577;180316;52;0;0;0;0;.00nan;0;0
2577;37077;52;67;18;1;17;.944;3600000;0
2577;38276;65;75;38;4;34;.895;3600000;0
2578;173699;36;21;3;3;0;.000;175000;0
2578;60863;53;0;0;0;0;.00nan;0;0
2578;78581;53;63;15;1;14;.933;3600000;0
2578;152710;36;60;35;5;30;.857;3425000;0
2579;172340;48;69;27;3;24;.889;3554000;0
2579;176860;44;0;0;0;0;.00nan;0;0
2579;86180;44;68;23;2;21;.913;3600000;0
2579;142492;48;0;0;0;0;.00nan;0;0
2580;164715;62;0;0;0;0;.00nan;0;0
2580;79132;49;96;33;1;32;.970;3600000;0
2580;85336;62;84;32;2;30;.938;3600000;0
2580;91225;49;0;0;0;0;.00nan;0;0
2581;8505;55;52;43;6;37;.860;3600000;0
2581;183904;43;62;23;2;21;.913;3600000;0
2581;86862;55;0;0;0;0;.00nan;0;0
2581;90164;43;0;0;0;0;.00nan;0;0
2582;170963;38;57;26;3;23;.885;3588000;0
2582;60863;53;75;18;1;17;.944;3600000;0
2582;78581;53;0;0;0;0;.00nan;0;0
2582;141496;38;0;0;0;0;.00nan;0;0
2583;176921;59;100;25;0;25;1.000;3600000;0
2583;37942;58;0;0;0;0;.00nan;0;0
2583;58054;59;0;0;0;0;.00nan;0;0
2583;141850;58;84;44;3;41;.932;3600000;0
2584;182780;60;0;0;0;0;.00nan;0;0
2584;170294;60;98;44;2;42;.955;3900000;0
2584;47112;4837;0;0;0;0;.00nan;0;0
2584;78775;4837;81;34;2;32;.941;3900000;0
2585;176136;57;0;0;0;0;.00nan;0;0
2585;43731;37;53;21;3;18;.857;3600000;0
2585;57152;57;89;53;5;48;.906;3580000;0
2585;57424;37;0;0;0;0;.00nan;0;0
2586;170977;41;0;0;0;0;.00nan;0;0
2586;43928;39;0;0;0;0;.00nan;0;0
2586;59025;39;88;25;1;24;.960;3600000;0
2586;143507;41;67;41;4;37;.902;3600000;0
2587;173699;36;68;38;5;33;.868;3600000;0
2587;184770;65;78;26;1;25;.962;3600000;0
2587;38276;65;0;0;0;0;.00nan;0;0
2587;152710;36;0;0;0;0;.00nan;0;0
2588;172499;50;0;0;0;0;.00nan;0;0
2588;68938;46;68;24;2;22;.917;3600000;0
2588;76574;50;71;47;5;42;.894;3600000;0
2588;79280;46;0;0;0;0;.00nan;0;0
2589;178384;40;48;28;4;24;.857;3600000;0
2589;174718;4619;92;31;1;30;.968;3600000;0
2589;58037;40;0;0;0;0;.00nan;0;0
2589;64800;4619;0;0;0;0;.00nan;0;0
2590;-1;51;98;55;3;52;.945;3583000;0
2590;180316;52;0;0;0;0;.00nan;0;0
2590;37077;52;77;12;1;11;.917;3600000;0
2590;141484;51;0;0;0;0;.00nan;0;0
2591;163989;45;30;49;8;41;.837;3600000;0
2591;171673;64;69;34;4;30;.882;3600000;0
2591;179350;45;0;0;0;0;.00nan;0;0
2591;176915;64;0;0;0;0;.00nan;0;0
2592;167642;61;0;0;0;0;.00nan;0;0
2592;179950;61;93;38;2;36;.947;3600000;0
2592;60773;47;40;26;5;21;.808;3600000;0
2592;79141;47;0;0;0;0;.00nan;0;0
2593;5311;42;100;26;0;26;1.000;3600000;0
2593;57695;42;0;0;0;0;.00nan;0;0
2593;94615;54;0;0;0;0;.00nan;0;0
2593;143301;54;47;30;5;25;.833;3600000;0
2594;163471;63;88;47;4;43;.915;3600000;0
2594;175757;63;0;0;0;0;.00nan;0;0
2594;58100;56;79;27;2;25;.926;3600000;0
2594;85468;56;0;0;0;0;.00nan;0;0
2595;172340;48;0;0;0;0;.00nan;0;0
2595;176860;44;0;0;0;0;.00nan;0;0
2595;86180;44;66;36;4;32;.889;3600000;0
2595;142492;48;78;23;1;22;.957;3600000;0
2596;170963;38;0;0;0;0;.00nan;0;0
2596;-1;51;74;29;3;26;.897;3600000;0
2596;141484;51;0;0;0;0;.00nan;0;0
2596;141496;38;48;32;5;27;.844;3568000;0
2597;176921;59;78;26;1;25;.962;3900000;0
2597;37942;58;0;0;0;0;.00nan;0;0
2597;58054;59;0;0;0;0;.00nan;0;0
2597;141850;58;78;28;1;27;.964;3900000;0
2598;182780;60;85;26;1;25;.962;3600000;0
2598;170294;60;0;0;0;0;.00nan;0;0
2598;47112;4837;73;28;2;26;.929;3580000;0
2598;78775;4837;0;0;0;0;.00nan;0;0
2599;172499;50;100;40;1;39;.975;3600000;0
2599;68938;46;0;0;0;0;.00nan;0;0
2599;76574;50;0;0;0;0;.00nan;0;0
2599;79280;46;62;24;2;22;.917;3560000;0
2600;167642;61;0;0;0;0;.00nan;0;0
2600;179950;61;74;41;4;37;.902;3600000;0
2600;60773;47;0;0;0;0;.00nan;0;0
2600;79141;47;66;26;3;23;.885;3600000;0
2601;5311;42;0;0;0;0;.00nan;0;0
2601;57695;42;72;34;4;30;.882;3900000;0
2601;94615;54;0;0;0;0;.00nan;0;0
2601;143301;54;75;42;4;38;.905;3900000;0
2602;163471;63;68;38;3;35;.921;3900000;0
2602;175757;63;0;0;0;0;.00nan;0;0
2602;58100;56;58;29;3;26;.897;3900000;0
2602;85468;56;0;0;0;0;.00nan;0;0
2603;184770;65;0;0;0;0;.00nan;0;0
2603;38276;65;98;39;1;38;.974;3558000;0
2603;60863;53;0;0;0;0;.00nan;0;0
2603;78581;53;89;20;0;20;1.000;3600000;0
2604;163989;45;74;50;6;44;.880;3600000;0
2604;179350;45;0;0;0;0;.00nan;0;0
2604;43731;37;50;14;2;12;.857;3600000;0
2604;57424;37;0;0;0;0;.00nan;0;0
2605;164715;62;0;0;0;0;.00nan;0;0
2605;60773;47;58;29;4;25;.862;3900000;0
2605;79141;47;0;0;0;0;.00nan;0;0
2605;85336;62;67;44;4;40;.909;3900000;0
2606;172340;48;31;30;6;24;.800;3332000;0
2606;178384;40;86;23;1;22;.957;3600000;0
2606;58037;40;0;0;0;0;.00nan;0;0
2606;142492;48;57;4;0;4;1.000;268000;0
2607;174718;4619;0;0;0;0;.00nan;0;0
2607;47112;4837;66;38;4;34;.895;3600000;0
2607;64800;4619;100;40;1;39;.975;3600000;0
2607;78775;4837;0;0;0;0;.00nan;0;0
2608;163471;63;77;36;4;32;.889;3559000;0
2608;8505;55;0;0;0;0;.00nan;0;0
2608;175757;63;0;0;0;0;.00nan;0;0
2608;86862;55;65;33;3;30;.909;3600000;0
2609;176860;44;0;0;0;0;.00nan;0;0
2609;79132;49;77;43;5;38;.884;3600000;0
2609;86180;44;93;21;0;21;1.000;3600000;0
2609;91225;49;0;0;0;0;.00nan;0;0
2610;173699;36;45;28;5;23;.821;3600000;0
2610;43928;39;0;0;0;0;.00nan;0;0
2610;59025;39;86;27;1;26;.963;3600000;0
2610;152710;36;0;0;0;0;.00nan;0;0
2611;176860;44;0;0;0;0;.00nan;0;0
2611;79132;49;0;0;0;0;.00nan;0;0
2611;86180;44;95;36;1;35;.972;3600000;0
2611;91225;49;40;41;7;34;.829;3600000;0
2612;172340;48;0;0;0;0;.00nan;0;0
2612;164715;62;0;0;0;0;.00nan;0;0
2612;85336;62;94;37;2;35;.946;3900000;0
2612;142492;48;84;39;2;37;.949;3900000;0
2613;163989;45;0;0;0;0;.00nan;0;0
2613;171673;64;98;50;2;48;.960;3525000;0
2613;179350;45;100;29;0;29;1.000;3600000;0
2613;176915;64;0;0;0;0;.00nan;0;0
2614;170977;41;91;52;3;49;.942;3600000;0
2614;176921;59;36;21;4;17;.810;3558000;0
2614;58054;59;0;0;0;0;.00nan;0;0
2614;143507;41;0;0;0;0;.00nan;0;0
2615;184770;65;0;0;0;0;.00nan;0;0
2615;176136;57;82;33;2;31;.939;3900000;0
2615;38276;65;61;16;2;14;.875;3900000;0
2615;57152;57;0;0;0;0;.00nan;0;0
2616;68938;46;0;0;0;0;.00nan;0;0
2616;79280;46;64;25;2;23;.920;3515000;0
2616;94615;54;0;0;0;0;.00nan;0;0
2616;143301;54;91;20;0;20;1.000;3600000;0
2617;178384;40;52;39;6;33;.846;3229000;0
2617;58037;40;50;1;0;1;1.000;371000;0
2617;60773;47;0;0;0;0;.00nan;0;0
2617;79141;47;83;25;1;24;.960;3600000;0
2618;180316;52;0;0;0;0;.00nan;0;0
2618;37077;52;47;28;4;24;.857;3541000;0
2618;58100;56;100;45;2;43;.956;3600000;0
2618;85468;56;0;0;0;0;.00nan;0;0
2619;8505;55;0;0;0;0;.00nan;0;0
2619;-1;51;64;39;5;34;.872;3530000;0
2619;86862;55;58;22;3;19;.864;3600000;0
2619;141484;51;0;0;0;0;.00nan;0;0
2620;5311;42;48;40;6;34;.850;3600000;0
2620;174718;4619;95;43;2;41;.953;3600000;0
2620;57695;42;0;0;0;0;.00nan;0;0
2620;64800;4619;0;0;0;0;.00nan;0;0
2621;163471;63;97;35;1;34;.971;3600000;0
2621;183904;43;55;32;4;28;.875;3600000;0
2621;175757;63;0;0;0;0;.00nan;0;0
2621;90164;43;0;0;0;0;.00nan;0;0
2622;182780;60;0;0;0;0;.00nan;0;0
2622;167642;61;0;0;0;0;.00nan;0;0
2622;170294;60;74;30;3;27;.900;3600000;0
2622;179950;61;54;30;4;26;.867;3571000;0
2623;170963;38;70;41;4;37;.902;3537000;0
2623;60863;53;0;0;0;0;.00nan;0;0
2623;78581;53;66;23;2;21;.913;3600000;0
2623;141496;38;0;0;0;0;.00nan;0;0
2624;171673;64;0;0;0;0;.00nan;0;0
2624;176915;64;53;54;7;47;.870;3600000;0
2624;68938;46;71;21;2;19;.905;3600000;0
2624;79280;46;0;0;0;0;.00nan;0;0
2625;173699;36;0;0;0;0;.00nan;0;0
2625;43928;39;0;0;0;0;.00nan;0;0
2625;59025;39;73;18;1;17;.944;3600000;0
2625;152710;36;74;31;2;29;.935;3591000;0
2626;178384;40;0;0;0;0;.00nan;0;0
2626;47112;4837;0;0;0;0;.00nan;0;0
2626;58037;40;86;38;2;36;.947;3600000;0
2626;78775;4837;83;18;1;17;.944;3600000;0
2627;170963;38;0;0;0;0;.00nan;0;0
2627;184770;65;44;17;3;14;.824;3723000;0
2627;38276;65;0;0;0;0;.00nan;0;0
2627;141496;38;62;32;4;28;.875;3723000;0
2628;172499;50;0;0;0;0;.00nan;0;0
2628;43731;37;96;39;2;37;.949;3900000;0
2628;57424;37;0;0;0;0;.00nan;0;0
2628;76574;50;66;20;2;18;.900;3900000;0
2629;180316;52;0;0;0;0;.00nan;0;0
2629;37077;52;76;28;3;25;.893;3900000;0
2629;58100;56;88;42;3;39;.929;3900000;0
2629;85468;56;0;0;0;0;.00nan;0;0
2630;8505;55;73;39;3;36;.923;3600000;0
2630;-1;51;0;0;0;0;.00nan;0;0
2630;86862;55;0;0;0;0;.00nan;0;0
2630;141484;51;74;34;2;32;.941;3600000;0
2631;163989;45;94;56;5;51;.911;3585000;0
2631;179350;45;0;0;0;0;.00nan;0;0
2631;94615;54;0;0;0;0;.00nan;0;0
2631;143301;54;40;18;4;14;.778;3600000;0
2632;5311;42;0;0;0;0;.00nan;0;0
2632;174718;4619;33;4;2;2;.500;416000;0
2632;57695;42;79;23;1;22;.957;3600000;0
2632;64800;4619;42;40;6;34;.850;3184000;0
2633;170977;41;0;0;0;0;.00nan;0;0
2633;37942;58;0;0;0;0;.00nan;0;0
2633;141850;58;75;35;3;32;.914;3802000;0
2633;143507;41;77;34;2;32;.941;3802000;0
2634;163471;63;42;36;7;29;.806;2350000;0
2634;183904;43;0;0;0;0;.00nan;0;0
2634;175757;63;77;18;0;18;1.000;1250000;0
2634;90164;43;56;30;4;26;.867;3600000;0
2635;182780;60;54;39;6;33;.846;3750000;0
2635;167642;61;33;28;5;23;.821;3750000;0
2635;170294;60;0;0;0;0;.00nan;0;0
2635;179950;61;0;0;0;0;.00nan;0;0
2636;176136;57;0;0;0;0;.00nan;0;0
2636;57152;57;87;49;4;45;.918;3600000;0
2636;60863;53;49;21;3;18;.857;3600000;0
2636;78581;53;0;0;0;0;.00nan;0;0
2637;171673;64;98;51;2;49;.961;3587000;0
2637;176915;64;0;0;0;0;.00nan;0;0
2637;68938;46;0;0;0;0;.00nan;0;0
2637;79280;46;74;21;1;20;.952;3600000;0
2638;172340;48;72;31;3;28;.903;3580000;0
2638;60773;47;0;0;0;0;.00nan;0;0
2638;79141;47;69;24;2;22;.917;3600000;0
2638;142492;48;0;0;0;0;.00nan;0;0
2639;176921;59;76;19;1;18;.947;3600000;0
2639;37942;58;0;0;0;0;.00nan;0;0
2639;58054;59;0;0;0;0;.00nan;0;0
2639;141850;58;48;38;5;33;.868;3600000;0
2640;176136;57;38;31;6;25;.806;2134000;0
2640;57152;57;50;29;4;25;.862;1466000;0
2640;60863;53;0;0;0;0;.00nan;0;0
2640;78581;53;33;15;4;11;.733;3600000;0
2641;172499;50;0;0;0;0;.00nan;0;0
2641;43731;37;0;0;0;0;.00nan;0;0
2641;57424;37;70;34;3;31;.912;3542000;0
2641;76574;50;93;30;1;29;.967;3600000;0
2642;163989;45;0;0;0;0;.00nan;0;0
2642;179350;45;83;29;1;28;.966;3600000;0
2642;94615;54;0;0;0;0;.00nan;0;0
2642;143301;54;47;15;3;12;.800;3545000;0
2643;170977;41;91;43;4;39;.907;3600000;0
2643;180316;52;0;0;0;0;.00nan;0;0
2643;37077;52;26;17;5;12;.706;3546000;0
2643;143507;41;0;0;0;0;.00nan;0;0
2644;182780;60;0;0;0;0;.00nan;0;0
2644;170294;60;60;36;5;31;.861;3600000;0
2644;60773;47;0;0;0;0;.00nan;0;0
2644;79141;47;70;24;2;22;.917;3600000;0
2645;164715;62;0;0;0;0;.00nan;0;0
2645;178384;40;93;43;2;41;.953;3600000;0
2645;58037;40;0;0;0;0;.00nan;0;0
2645;85336;62;63;15;1;14;.933;3600000;0
2646;8505;55;0;0;0;0;.00nan;0;0
2646;183904;43;62;26;3;23;.885;3600000;0
2646;86862;55;73;36;4;32;.889;3588000;0
2646;90164;43;0;0;0;0;.00nan;0;0
2647;172340;48;66;35;4;31;.886;3600000;0
2647;167642;61;0;0;0;0;.00nan;0;0
2647;179950;61;62;14;1;13;.929;3600000;0
2647;142492;48;0;0;0;0;.00nan;0;0
2648;182780;60;96;39;1;38;.974;3600000;0
2648;170294;60;0;0;0;0;.00nan;0;0
2648;60773;47;38;18;4;14;.778;3600000;0
2648;79141;47;0;0;0;0;.00nan;0;0
2649;176136;57;84;29;2;27;.931;3600000;0
2649;37942;58;0;0;0;0;.00nan;0;0
2649;57152;57;0;0;0;0;.00nan;0;0
2649;141850;58;49;21;3;18;.857;3543000;0
2650;171673;64;78;36;3;33;.917;3838000;0
2650;176915;64;0;0;0;0;.00nan;0;0
2650;43731;37;63;34;4;30;.882;3838000;0
2650;57424;37;0;0;0;0;.00nan;0;0
2651;172499;50;0;0;0;0;.00nan;0;0
2651;76574;50;100;34;0;34;1.000;3600000;0
2651;94615;54;0;0;0;0;.00nan;0;0
2651;143301;54;69;32;3;29;.906;3600000;0
2652;163471;63;63;16;1;15;.938;3600000;0
2652;-1;51;88;44;3;41;.932;3587000;0
2652;175757;63;0;0;0;0;.00nan;0;0
2652;141484;51;0;0;0;0;.00nan;0;0
2653;176860;44;0;0;0;0;.00nan;0;0
2653;79132;49;73;34;3;31;.912;3531000;0
2653;86180;44;71;20;1;19;.950;3600000;0
2653;91225;49;0;0;0;0;.00nan;0;0
2654;8505;55;0;0;0;0;.00nan;0;0
2654;43928;39;0;0;0;0;.00nan;0;0
2654;59025;39;76;34;3;31;.912;3600000;0
2654;86862;55;69;40;4;36;.900;3592000;0
2655;170963;38;95;45;1;44;.978;3900000;0
2655;184770;65;0;0;0;0;.00nan;0;0
2655;38276;65;60;16;1;15;.938;3900000;0
2655;141496;38;0;0;0;0;.00nan;0;0
2656;176921;59;77;26;1;25;.962;3600000;0
2656;58054;59;0;0;0;0;.00nan;0;0
2656;60863;53;0;0;0;0;.00nan;0;0
2656;78581;53;76;34;3;31;.912;3582000;0
2657;164715;62;0;0;0;0;.00nan;0;0
2657;47112;4837;0;0;0;0;.00nan;0;0
2657;78775;4837;81;43;3;40;.930;3600000;0
2657;85336;62;49;34;5;29;.853;3513000;0
2658;171673;64;0;0;0;0;.00nan;0;0
2658;176915;64;57;42;5;37;.881;3600000;0
2658;43731;37;68;22;2;20;.909;3600000;0
2658;57424;37;0;0;0;0;.00nan;0;0
2659;170977;41;96;58;4;54;.931;3600000;0
2659;180316;52;0;0;0;0;.00nan;0;0
2659;37077;52;65;15;1;14;.933;3600000;0
2659;143507;41;0;0;0;0;.00nan;0;0
2660;173699;36;97;42;1;41;.976;3900000;0
2660;-1;51;0;0;0;0;.00nan;0;0
2660;141484;51;76;17;1;16;.941;3900000;0
2660;152710;36;0;0;0;0;.00nan;0;0
2661;163989;45;11;20;6;14;.700;1986000;0
2661;179350;45;74;20;1;19;.950;1614000;0
2661;68938;46;94;32;2;30;.938;3600000;0
2661;79280;46;0;0;0;0;.00nan;0;0
2662;5311;42;81;31;2;29;.935;3600000;0
2662;172499;50;0;0;0;0;.00nan;0;0
2662;57695;42;0;0;0;0;.00nan;0;0
2662;76574;50;72;32;3;29;.906;3570000;0
2663;167642;61;0;0;0;0;.00nan;0;0
2663;174718;4619;66;40;5;35;.875;3600000;0
2663;179950;61;50;28;4;24;.857;3600000;0
2663;64800;4619;0;0;0;0;.00nan;0;0
2664;183904;43;33;26;5;21;.808;3513000;0
2664;58100;56;73;33;3;30;.909;3600000;0
2664;85468;56;0;0;0;0;.00nan;0;0
2664;90164;43;0;0;0;0;.00nan;0;0
2665;176860;44;0;0;0;0;.00nan;0;0
2665;79132;49;71;51;5;46;.902;3600000;0
2665;86180;44;69;18;1;17;.944;3600000;0
2665;91225;49;0;0;0;0;.00nan;0;0
2666;164715;62;0;0;0;0;.00nan;0;0
2666;47112;4837;81;29;2;27;.931;3900000;0
2666;78775;4837;0;0;0;0;.00nan;0;0
2666;85336;62;84;33;2;31;.939;3900000;0
2667;170963;38;0;0;0;0;.00nan;0;0
2667;180316;52;0;0;0;0;.00nan;0;0
2667;37077;52;68;23;2;21;.913;3600000;0
2667;141496;38;65;43;5;38;.884;3600000;0
2668;43731;37;0;0;0;0;.00nan;0;0
2668;57424;37;62;34;4;30;.882;3535000;0
2668;68938;46;0;0;0;0;.00nan;0;0
2668;79280;46;83;31;2;29;.935;3600000;0
2669;182780;60;0;0;0;0;.00nan;0;0
2669;178384;40;0;0;0;0;.00nan;0;0
2669;170294;60;60;30;4;26;.867;3529000;0
2669;58037;40;79;31;2;29;.935;3600000;0
2670;176136;57;52;3;0;3;1.000;902000;0
2670;37942;58;0;0;0;0;.00nan;0;0
2670;57152;57;10;27;7;20;.741;2698000;0
2670;141850;58;73;29;2;27;.931;3600000;0
2671;8505;55;79;58;5;53;.914;3600000;0
2671;43928;39;82;24;1;23;.958;3600000;0
2671;59025;39;0;0;0;0;.00nan;0;0
2671;86862;55;0;0;0;0;.00nan;0;0
2672;184770;65;67;42;4;38;.905;3600000;0
2672;38276;65;0;0;0;0;.00nan;0;0
2672;60863;53;68;21;1;20;.952;3600000;0
2672;78581;53;0;0;0;0;.00nan;0;0
2673;163989;45;0;0;0;0;.00nan;0;0
2673;179350;45;77;52;5;47;.904;3537000;0
2673;94615;54;45;16;3;13;.813;3600000;0
2673;143301;54;0;0;0;0;.00nan;0;0
2674;172340;48;98;46;2;44;.957;3600000;0
2674;60773;47;0;0;0;0;.00nan;0;0
2674;79141;47;89;31;1;30;.968;3600000;0
2674;142492;48;0;0;0;0;.00nan;0;0
2675;170977;41;0;0;0;0;.00nan;0;0
2675;176921;59;84;16;0;16;1.000;3600000;0
2675;58054;59;0;0;0;0;.00nan;0;0
2675;143507;41;97;41;2;39;.951;3549000;0
2676;183904;43;83;17;1;16;.941;3600000;0
2676;58100;56;94;50;3;47;.940;3542000;0
2676;85468;56;0;0;0;0;.00nan;0;0
2676;90164;43;0;0;0;0;.00nan;0;0
2677;5311;42;0;0;0;0;.00nan;0;0
2677;172499;50;0;0;0;0;.00nan;0;0
2677;57695;42;61;41;5;36;.878;3600000;0
2677;76574;50;83;25;1;24;.960;3600000;0
2678;163471;63;41;27;5;22;.815;3596000;0
2678;173699;36;70;39;4;35;.897;3600000;0
2678;175757;63;0;0;0;0;.00nan;0;0
2678;152710;36;0;0;0;0;.00nan;0;0
2679;167642;61;71;19;1;18;.947;3600000;0
2679;174718;4619;0;0;0;0;.00nan;0;0
2679;179950;61;0;0;0;0;.00nan;0;0
2679;64800;4619;92;45;3;42;.933;3550000;0
2680;163989;45;78;39;4;35;.897;3764000;0
2680;179350;45;0;0;0;0;.00nan;0;0
2680;68938;46;46;17;3;14;.824;3764000;0
2680;79280;46;0;0;0;0;.00nan;0;0
2681;172340;48;0;0;0;0;.00nan;0;0
2681;60773;47;26;11;4;7;.636;898000;0
2681;79141;47;60;15;1;14;.933;2702000;0
2681;142492;48;57;37;4;33;.892;3600000;0
2682;182780;60;20;23;5;18;.783;3900000;0
2682;178384;40;52;34;5;29;.853;3900000;0
2682;170294;60;0;0;0;0;.00nan;0;0
2682;58037;40;0;0;0;0;.00nan;0;0
2683;171673;64;52;38;5;33;.868;3568000;0
2683;176915;64;0;0;0;0;.00nan;0;0
2683;94615;54;0;0;0;0;.00nan;0;0
2683;143301;54;60;26;3;23;.885;3600000;0
2684;184770;65;51;3;0;3;1.000;326000;0
2684;37942;58;0;0;0;0;.00nan;0;0
2684;38276;65;26;31;7;24;.774;3274000;0
2684;141850;58;91;38;2;36;.947;3600000;0
2685;176921;59;93;38;2;36;.947;3600000;0
2685;180316;52;0;0;0;0;.00nan;0;0
2685;37077;52;42;35;6;29;.829;3600000;0
2685;58054;59;0;0;0;0;.00nan;0;0
2686;163471;63;80;32;2;30;.938;3600000;0
2686;173699;36;0;0;0;0;.00nan;0;0
2686;175757;63;0;0;0;0;.00nan;0;0
2686;152710;36;55;39;5;34;.872;3600000;0
2687;-1;51;85;25;1;24;.960;3600000;0
2687;58100;56;64;25;2;23;.920;3544000;0
2687;85468;56;0;0;0;0;.00nan;0;0
2687;141484;51;0;0;0;0;.00nan;0;0
2689;171608;59;0;0;0;0;.00nan;0;0
2689;47112;4837;0;0;0;0;.00nan;0;0
2689;58054;59;75;26;2;24;.923;3600000;0
2689;78775;4837;81;46;4;42;.913;3550000;0
2691;5311;42;70;34;4;30;.882;3859000;0
2691;175757;63;0;0;0;0;.00nan;0;0
2691;181123;63;84;54;5;49;.907;3859000;0
2691;141496;42;0;0;0;0;.00nan;0;0
2693;164715;62;0;0;0;0;.00nan;0;0
2693;60773;47;0;0;0;0;.00nan;0;0
2693;79141;47;69;32;3;29;.906;3600000;0
2693;152418;62;90;34;1;33;.971;3600000;0
2695;79132;49;60;25;3;22;.880;3600000;0
2695;85336;56;0;0;0;0;.00nan;0;0
2695;85468;56;56;31;4;27;.871;3600000;0
2695;91225;49;0;0;0;0;.00nan;0;0
2697;167642;61;0;0;0;0;.00nan;0;0
2697;179950;61;94;32;2;30;.938;3787000;0
2697;68938;46;0;0;0;0;.00nan;0;0
2697;79280;46;99;47;1;46;.979;3787000;0
2699;183904;43;0;0;0;0;.00nan;0;0
2699;43928;39;0;0;0;0;.00nan;0;0
2699;59025;39;48;43;6;37;.860;3600000;0
2699;90164;43;55;22;3;19;.864;3600000;0
2701;163462;58;99;41;1;40;.976;3600000;0
2701;37942;58;0;0;0;0;.00nan;0;0
2701;58037;53;0;0;0;0;.00nan;0;0
2701;78581;53;46;20;3;17;.850;3513000;0
2703;178384;40;79;42;3;39;.929;3600000;0
2703;76574;50;0;0;0;0;.00nan;0;0
2703;85636;40;0;0;0;0;.00nan;0;0
2703;85661;50;43;9;2;7;.778;3600000;0
2705;182780;60;0;0;0;0;.00nan;0;0
2705;173699;36;82;46;4;42;.913;3573000;0
2705;170294;60;48;12;2;10;.833;3600000;0
2705;152710;36;0;0;0;0;.00nan;0;0
2707;163989;45;94;45;2;43;.956;3600000;0
2707;179350;45;0;0;0;0;.00nan;0;0
2707;94615;54;0;0;0;0;.00nan;0;0
2707;143301;54;88;17;0;17;1.000;3600000;0
2709;163471;37;100;41;2;39;.951;3600000;0
2709;180316;52;0;0;0;0;.00nan;0;0
2709;37857;52;37;19;4;15;.789;3540000;0
2709;141850;37;0;0;0;0;.00nan;0;0
2711;-1;51;53;3;0;3;1.000;446000;0
2711;176136;57;57;32;5;27;.844;3600000;0
2711;57152;57;0;0;0;0;.00nan;0;0
2711;141484;51;42;41;6;35;.854;3105000;0
2713;169154;38;0;0;0;0;.00nan;0;0
2713;170963;38;80;28;1;27;.964;3600000;0
2713;171673;64;51;26;4;22;.846;3600000;0
2713;176915;64;0;0;0;0;.00nan;0;0
2715;172340;48;29;27;6;21;.778;1674000;0
2715;170598;48;54;22;2;20;.909;1926000;0
2715;176860;44;63;23;2;21;.913;3600000;0
2715;57434;44;0;0;0;0;.00nan;0;0
2717;170977;41;0;0;0;0;.00nan;0;0
2717;38276;65;0;0;0;0;.00nan;0;0
2717;86180;65;48;28;4;24;.857;3600000;0
2717;143507;41;79;49;5;44;.898;3600000;0
2719;170314;4619;49;18;3;15;.833;3900000;0
2719;37077;55;0;0;0;0;.00nan;0;0
2719;86862;55;97;42;3;39;.929;3900000;0
2719;147492;4619;0;0;0;0;.00nan;0;0
2720;83;737;72;31;3;28;.903;3600000;0
2720;190570;737;0;0;0;0;.00nan;0;0
2720;-1;744;0;0;0;0;.00nan;0;0
2720;49900;744;48;28;5;23;.821;3545000;0
2721;186235;751;0;0;0;0;.00nan;0;0
2721;-1;751;52;34;5;29;.853;3600000;0
2721;61272;748;0;0;0;0;.00nan;0;0
2721;88646;748;40;45;7;38;.844;3529000;0
2722;3756;747;77;24;1;23;.958;3600000;0
2722;195867;2168;0;0;0;0;.00nan;0;0
2722;196698;747;0;0;0;0;.00nan;0;0
2722;85670;2168;87;39;2;37;.949;3553000;0
2723;201075;736;0;0;0;0;.00nan;0;0
2723;186219;736;76;40;3;37;.925;3556000;0
2723;-1;3789;0;0;0;0;.00nan;0;0
2723;149280;3789;100;36;1;35;.972;3600000;0
2724;1957;733;25;5;3;2;.400;598000;0
2724;6079;733;87;47;4;43;.915;3002000;0
2724;178098;738;0;0;0;0;.00nan;0;0
2724;185442;738;95;19;0;19;1.000;3600000;0
2725;33044;741;0;0;0;0;.00nan;0;0
2725;180188;743;0;0;0;0;.00nan;0;0
2725;190589;743;87;37;2;35;.946;3900000;0
2725;56565;741;100;43;2;41;.953;3900000;0
2726;2643;742;90;35;2;33;.943;3900000;0
2726;43971;742;0;0;0;0;.00nan;0;0
2726;44526;734;96;41;2;39;.951;3900000;0
2726;-1;734;0;0;0;0;.00nan;0;0
2727;188561;739;0;0;0;0;.00nan;0;0
2727;186234;739;88;42;2;40;.952;3584000;0
2727;76405;732;82;27;1;26;.963;3600000;0
2727;148788;732;0;0;0;0;.00nan;0;0
2728;178114;752;0;0;0;0;.00nan;0;0
2728;190607;1880;0;0;0;0;.00nan;0;0
2728;43731;752;91;41;3;38;.927;3900000;0
2728;49935;1880;59;34;3;31;.912;3900000;0
2729;3508;745;25;7;3;4;.571;324000;0
2729;8505;764;0;0;0;0;.00nan;0;0
2729;192386;745;61;30;3;27;.900;3276000;0
2729;67362;764;88;33;1;32;.970;3600000;0
2730;83;737;65;29;3;26;.897;3512000;0
2730;198736;749;0;0;0;0;.00nan;0;0
2730;190570;737;0;0;0;0;.00nan;0;0
2730;149305;749;75;27;1;26;.963;3600000;0
2731;185413;740;57;30;3;27;.900;3562000;0
2731;196715;740;0;0;0;0;.00nan;0;0
2731;46792;729;65;22;2;20;.909;3600000;0
2731;52204;729;0;0;0;0;.00nan;0;0
2732;33044;741;0;0;0;0;.00nan;0;0
2732;-1;744;0;0;0;0;.00nan;0;0
2732;49900;744;54;19;2;17;.895;3565000;0
2732;56565;741;87;36;1;35;.972;3600000;0
2733;195867;2168;0;0;0;0;.00nan;0;0
2733;61272;748;0;0;0;0;.00nan;0;0
2733;85670;2168;74;23;1;22;.957;3600000;0
2733;88646;748;68;35;3;32;.914;3596000;0
2734;178098;738;63;31;4;27;.871;3551000;0
2734;178114;752;0;0;0;0;.00nan;0;0
2734;185442;738;0;0;0;0;.00nan;0;0
2734;43731;752;71;28;2;26;.929;3600000;0
2735;188561;739;0;0;0;0;.00nan;0;0
2735;201075;736;0;0;0;0;.00nan;0;0
2735;186219;736;46;34;5;29;.853;3900000;0
2735;186234;739;49;32;5;27;.844;3884000;0
2736;1957;733;100;64;5;59;.922;3900000;0
2736;6079;733;0;0;0;0;.00nan;0;0
2736;180188;743;47;31;5;26;.839;3900000;0
2736;190589;743;0;0;0;0;.00nan;0;0
2737;-1;3789;0;0;0;0;.00nan;0;0
2737;76405;732;49;21;3;18;.857;3600000;0
2737;148788;732;0;0;0;0;.00nan;0;0
2737;149280;3789;74;28;2;26;.929;3600000;0
2738;190607;1880;0;0;0;0;.00nan;0;0
2738;44526;734;76;26;2;24;.923;3600000;0
2738;-1;734;0;0;0;0;.00nan;0;0
2738;49935;1880;47;33;6;27;.818;3600000;0
2739;3508;745;93;43;2;41;.953;3600000;0
2739;3756;747;44;33;5;28;.848;3600000;0
2739;196698;747;0;0;0;0;.00nan;0;0
2739;192386;745;0;0;0;0;.00nan;0;0
2740;83;737;77;32;3;29;.906;3900000;0
2740;8505;764;0;0;0;0;.00nan;0;0
2740;190570;737;0;0;0;0;.00nan;0;0
2740;67362;764;76;28;3;25;.893;3900000;0
2741;201075;736;32;17;4;13;.765;1180000;0
2741;-1;744;0;0;0;0;.00nan;0;0
2741;186219;736;55;20;2;18;.900;2360000;0
2741;49900;744;62;32;4;28;.875;3600000;0
2742;188561;739;69;31;2;29;.935;3564000;0
2742;186234;739;0;0;0;0;.00nan;0;0
2742;44526;734;97;27;1;26;.963;3600000;0
2742;-1;734;0;0;0;0;.00nan;0;0
2743;3756;747;51;25;4;21;.840;3600000;0
2743;180188;743;0;0;0;0;.00nan;0;0
2743;190589;743;80;65;6;59;.908;3589000;0
2743;196698;747;0;0;0;0;.00nan;0;0
2744;33044;741;0;0;0;0;.00nan;0;0
2744;46792;729;53;25;3;22;.880;3514000;0
2744;52204;729;0;0;0;0;.00nan;0;0
2744;56565;741;85;28;1;27;.964;3600000;0
2745;1957;733;59;24;3;21;.875;3600000;0
2745;6079;733;0;0;0;0;.00nan;0;0
2745;185413;740;27;7;3;4;.571;402000;0
2745;196715;740;49;23;3;20;.870;3198000;0
2746;2643;742;81;26;1;25;.962;3600000;0
2746;43971;742;0;0;0;0;.00nan;0;0
2746;-1;3789;0;0;0;0;.00nan;0;0
2746;149280;3789;66;27;2;25;.926;3574000;0
2747;178114;752;0;0;0;0;.00nan;0;0
2747;43731;752;91;27;1;26;.963;3563000;0
2747;76405;732;0;0;0;0;.00nan;0;0
2747;148788;732;100;30;0;30;1.000;3600000;0
2748;198736;749;0;0;0;0;.00nan;0;0
2748;190607;1880;0;0;0;0;.00nan;0;0
2748;49935;1880;97;48;1;47;.979;3900000;0
2748;149305;749;92;29;1;28;.966;3900000;0
2749;3508;745;83;36;3;33;.917;3600000;0
2749;186235;751;0;0;0;0;.00nan;0;0
2749;-1;751;51;27;4;23;.852;3572000;0
2749;192386;745;0;0;0;0;.00nan;0;0
2750;8505;764;0;0;0;0;.00nan;0;0
2750;178098;738;98;24;0;24;1.000;3600000;0
2750;185442;738;0;0;0;0;.00nan;0;0
2750;67362;764;41;23;4;19;.826;3600000;0
2751;195867;2168;0;0;0;0;.00nan;0;0
2751;61272;748;0;0;0;0;.00nan;0;0
2751;85670;2168;92;34;1;33;.971;3600000;0
2751;88646;748;53;30;4;26;.867;3600000;0
2752;188561;739;0;0;0;0;.00nan;0;0
2752;-1;744;0;0;0;0;.00nan;0;0
2752;186234;739;50;22;3;19;.864;3600000;0
2752;49900;744;58;32;4;28;.875;3545000;0
2753;1957;733;58;40;5;35;.875;3600000;0
2753;6079;733;0;0;0;0;.00nan;0;0
2753;46792;729;52;28;4;24;.857;3600000;0
2753;52204;729;0;0;0;0;.00nan;0;0
2754;185413;740;26;7;3;4;.571;594000;0
2754;196715;740;63;22;2;20;.909;2932000;0
2754;44526;734;75;37;3;34;.919;3600000;0
2754;-1;734;0;0;0;0;.00nan;0;0
2755;83;737;63;45;5;40;.889;3600000;0
2755;2643;742;46;22;4;18;.818;3600000;0
2755;190570;737;0;0;0;0;.00nan;0;0
2755;43971;742;0;0;0;0;.00nan;0;0
2756;198736;749;0;0;0;0;.00nan;0;0
2756;76405;732;100;31;1;30;.968;3600000;0
2756;148788;732;0;0;0;0;.00nan;0;0
2756;149305;749;94;37;2;35;.946;3600000;0
2757;33044;741;0;0;0;0;.00nan;0;0
2757;190607;1880;0;0;0;0;.00nan;0;0
2757;49935;1880;55;22;3;19;.864;3600000;0
2757;56565;741;60;35;4;31;.886;3600000;0
2758;195867;2168;0;0;0;0;.00nan;0;0
2758;186235;751;80;28;2;26;.929;3900000;0
2758;-1;751;0;0;0;0;.00nan;0;0
2758;85670;2168;100;41;2;39;.951;3900000;0
2759;178098;738;87;24;0;24;1.000;3600000;0
2759;201075;736;81;43;3;40;.930;3600000;0
2759;185442;738;0;0;0;0;.00nan;0;0
2759;186219;736;0;0;0;0;.00nan;0;0
2760;178114;752;0;0;0;0;.00nan;0;0
2760;180188;743;27;13;4;9;.692;1119000;0
2760;190589;743;42;25;4;21;.840;2481000;0
2760;43731;752;100;30;0;30;1.000;3600000;0
2761;192386;745;56;4;0;4;1.000;1144000;0
2761;61272;748;0;0;0;0;.00nan;0;0
2761;75268;745;28;26;6;20;.769;2456000;0
2761;88646;748;79;25;1;24;.960;3600000;0
2762;8505;764;74;29;2;27;.931;3600000;0
2762;190607;1880;0;0;0;0;.00nan;0;0
2762;49935;1880;63;30;3;27;.900;3563000;0
2762;67362;764;0;0;0;0;.00nan;0;0
2763;83;737;62;29;3;26;.897;3600000;0
2763;188561;739;0;0;0;0;.00nan;0;0
2763;190570;737;0;0;0;0;.00nan;0;0
2763;186234;739;98;26;0;26;1.000;3600000;0
2764;178114;752;0;0;0;0;.00nan;0;0
2764;186235;751;0;0;0;0;.00nan;0;0
2764;-1;751;63;31;3;28;.903;3557000;0
2764;43731;752;70;24;2;22;.917;3600000;0
2765;178098;738;63;41;4;37;.902;3562000;0
2765;195867;2168;0;0;0;0;.00nan;0;0
2765;185442;738;0;0;0;0;.00nan;0;0
2765;85670;2168;64;19;2;17;.895;3600000;0
2766;201075;736;0;0;0;0;.00nan;0;0
2766;186219;736;52;18;3;15;.833;3600000;0
2766;46792;729;20;31;7;24;.774;2995000;0
2766;52204;729;47;13;2;11;.846;605000;0
2767;2643;742;61;27;3;24;.889;3600000;0
2767;43971;742;0;0;0;0;.00nan;0;0
2767;192386;745;0;0;0;0;.00nan;0;0
2767;75268;745;87;32;1;31;.969;3600000;0
2768;8505;764;0;0;0;0;.00nan;0;0
2768;196698;747;0;0;0;0;.00nan;0;0
2768;57107;747;54;27;4;23;.852;3773000;0
2768;67362;764;85;37;3;34;.919;3773000;0
2769;-1;744;0;0;0;0;.00nan;0;0
2769;44526;734;95;38;1;37;.974;3563000;0
2769;-1;734;0;0;0;0;.00nan;0;0
2769;49900;744;78;14;0;14;1.000;3600000;0
2770;188561;739;0;0;0;0;.00nan;0;0
2770;186234;739;93;41;2;39;.951;3900000;0
2770;46792;729;0;0;0;0;.00nan;0;0
2770;52204;729;89;32;2;30;.938;3900000;0
2771;198736;749;0;0;0;0;.00nan;0;0
2771;185413;740;0;0;0;0;.00nan;0;0
2771;196715;740;100;40;0;40;1.000;3600000;0
2771;149305;749;44;27;5;22;.815;3600000;0
2772;1957;733;0;0;0;0;.00nan;0;0
2772;6079;733;54;45;6;39;.867;3600000;0
2772;76405;732;61;23;2;21;.913;3600000;0
2772;148788;732;0;0;0;0;.00nan;0;0
2773;33044;741;0;0;0;0;.00nan;0;0
2773;180188;743;0;0;0;0;.00nan;0;0
2773;190589;743;40;25;4;21;.840;3600000;0
2773;56565;741;85;33;1;32;.970;3600000;0
2774;201075;736;77;48;4;44;.917;3600000;0
2774;186219;736;0;0;0;0;.00nan;0;0
2774;-1;3789;0;0;0;0;.00nan;0;0
2774;149280;3789;81;33;2;31;.939;3600000;0
2775;83;737;49;31;4;27;.871;3590000;0
2775;178098;738;95;31;0;31;1.000;3071000;0
2775;190570;737;0;0;0;0;.00nan;0;0
2775;185442;738;41;12;3;9;.750;529000;0
2776;178114;752;0;0;0;0;.00nan;0;0
2776;43731;752;75;22;1;21;.955;3600000;0
2776;61272;748;0;0;0;0;.00nan;0;0
2776;88646;748;87;40;3;37;.925;3525000;0
2777;198736;749;0;0;0;0;.00nan;0;0
2777;186235;751;26;6;3;3;.500;438000;0
2777;-1;751;92;33;1;32;.970;3094000;0
2777;149305;749;80;26;2;24;.923;3600000;0
2778;8505;764;78;39;3;36;.923;3600000;0
2778;180188;743;93;41;2;39;.951;3600000;0
2778;190589;743;0;0;0;0;.00nan;0;0
2778;67362;764;0;0;0;0;.00nan;0;0
2779;188561;739;0;0;0;0;.00nan;0;0
2779;185413;740;0;0;0;0;.00nan;0;0
2779;196715;740;97;41;0;41;1.000;3900000;0
2779;186234;739;100;34;0;34;1.000;3900000;0
2780;-1;744;0;0;0;0;.00nan;0;0
2780;196698;747;0;0;0;0;.00nan;0;0
2780;49900;744;96;38;2;36;.947;3600000;0
2780;57107;747;52;21;3;18;.857;3545000;0
2781;33044;741;0;0;0;0;.00nan;0;0
2781;44526;734;50;31;4;27;.871;3600000;0
2781;-1;734;0;0;0;0;.00nan;0;0
2781;56565;741;95;36;1;35;.972;3600000;0
2782;190607;1880;0;0;0;0;.00nan;0;0
2782;49935;1880;84;26;1;25;.962;3600000;0
2782;76405;732;62;25;2;23;.920;3552000;0
2782;148788;732;0;0;0;0;.00nan;0;0
2783;2643;742;41;35;6;29;.829;3600000;0
2783;43971;742;0;0;0;0;.00nan;0;0
2783;192386;745;0;0;0;0;.00nan;0;0
2783;75268;745;75;35;2;33;.943;3600000;0
2784;1957;733;69;41;4;37;.902;3889000;0
2784;6079;733;0;0;0;0;.00nan;0;0
2784;178098;738;0;0;0;0;.00nan;0;0
2784;185442;738;78;40;3;37;.925;3889000;0
2785;201075;736;0;0;0;0;.00nan;0;0
2785;186219;736;68;34;3;31;.912;3600000;0
2785;61272;748;0;0;0;0;.00nan;0;0
2785;88646;748;68;35;4;31;.886;3544000;0
2786;2643;742;0;0;0;0;.00nan;0;0
2786;3508;751;87;33;2;31;.939;3600000;0
2786;-1;751;0;0;0;0;.00nan;0;0
2786;43971;742;74;38;3;35;.921;3564000;0
2787;185413;740;53;46;6;40;.870;3088000;0
2787;-1;744;0;0;0;0;.00nan;0;0
2787;196715;740;43;5;1;4;.800;512000;0
2787;49900;744;91;17;0;17;1.000;3600000;0
2788;195867;2168;0;0;0;0;.00nan;0;0
2788;85281;749;80;31;2;29;.935;3600000;0
2788;85670;2168;72;40;3;37;.925;3600000;0
2788;149305;749;0;0;0;0;.00nan;0;0
2789;83;737;91;21;0;21;1.000;3600000;0
2789;190570;737;0;0;0;0;.00nan;0;0
2789;76405;732;47;40;6;34;.850;3600000;0
2789;148788;732;0;0;0;0;.00nan;0;0
2790;188561;739;84;36;2;34;.944;3600000;0
2790;186234;739;0;0;0;0;.00nan;0;0
2790;46792;729;52;42;6;36;.857;3600000;0
2790;52204;729;0;0;0;0;.00nan;0;0
2791;848;743;76;37;3;34;.919;3536000;0
2791;8505;764;0;0;0;0;.00nan;0;0
2791;190589;743;0;0;0;0;.00nan;0;0
2791;67362;764;71;21;1;20;.952;3600000;0
2792;33044;741;0;0;0;0;.00nan;0;0
2792;192386;745;0;0;0;0;.00nan;0;0
2792;56565;741;88;43;3;40;.930;3584000;0
2792;75268;745;72;26;2;24;.923;3600000;0
2793;190607;1880;0;0;0;0;.00nan;0;0
2793;-1;3789;0;0;0;0;.00nan;0;0
2793;49935;1880;100;36;0;36;1.000;3600000;0
2793;149280;3789;59;21;2;19;.905;3513000;0
2794;1957;733;75;36;3;33;.917;3529000;0
2794;6079;733;0;0;0;0;.00nan;0;0
2794;61272;748;0;0;0;0;.00nan;0;0
2794;88646;748;77;15;1;14;.933;3600000;0
2795;190607;1880;0;0;0;0;.00nan;0;0
2795;-1;744;0;0;0;0;.00nan;0;0
2795;49900;744;71;18;1;17;.944;3600000;0
2795;49935;1880;72;25;2;23;.920;3600000;0
2796;2643;742;38;26;5;21;.808;3600000;0
2796;195867;2168;0;0;0;0;.00nan;0;0
2796;43971;742;0;0;0;0;.00nan;0;0
2796;85670;2168;97;41;2;39;.951;3600000;0
2797;83;737;32;25;6;19;.760;3600000;0
2797;190570;737;0;0;0;0;.00nan;0;0
2797;46792;729;52;26;3;23;.885;3600000;0
2797;52204;729;0;0;0;0;.00nan;0;0
2798;178098;738;88;44;2;42;.955;3574000;0
2798;185442;738;0;0;0;0;.00nan;0;0
2798;76405;732;69;18;1;17;.944;3600000;0
2798;148788;732;0;0;0;0;.00nan;0;0
2799;8505;764;0;0;0;0;.00nan;0;0
2799;192386;745;0;0;0;0;.00nan;0;0
2799;67362;764;90;20;0;20;1.000;3600000;0
2799;75268;745;55;38;5;33;.868;3600000;0
2800;185413;740;0;0;0;0;.00nan;0;0
2800;196698;747;0;0;0;0;.00nan;0;0
2800;196715;740;72;47;5;42;.894;3600000;0
2800;57107;747;69;30;2;28;.933;3600000;0
2801;201075;736;86;40;2;38;.950;3575000;0
2801;186219;736;0;0;0;0;.00nan;0;0
2801;-1;3789;0;0;0;0;.00nan;0;0
2801;149280;3789;97;31;1;30;.968;3600000;0
2802;848;743;66;32;3;29;.906;3900000;0
2802;33044;741;0;0;0;0;.00nan;0;0
2802;190589;743;0;0;0;0;.00nan;0;0
2802;56565;741;88;45;3;42;.933;3900000;0
2803;3756;752;34;11;3;8;.727;523000;0
2803;188561;739;0;0;0;0;.00nan;0;0
2803;186234;739;34;30;5;25;.833;3600000;0
2803;43731;752;42;17;3;14;.824;3020000;0
2804;44526;734;79;44;4;40;.909;3600000;0
2804;46792;729;89;24;1;23;.958;3600000;0
2804;-1;734;0;0;0;0;.00nan;0;0
2804;52204;729;0;0;0;0;.00nan;0;0
2805;8505;764;0;0;0;0;.00nan;0;0
2805;192386;745;0;0;0;0;.00nan;0;0
2805;67362;764;45;36;6;30;.833;3581000;0
2805;75268;745;59;38;5;33;.868;3600000;0
2806;190607;1880;0;0;0;0;.00nan;0;0
2806;185413;740;93;39;2;37;.949;3600000;0
2806;196715;740;0;0;0;0;.00nan;0;0
2806;49935;1880;38;22;4;18;.818;3525000;0
2807;2643;742;93;44;1;43;.977;3900000;0
2807;196698;747;0;0;0;0;.00nan;0;0
2807;43971;742;0;0;0;0;.00nan;0;0
2807;57107;747;91;24;1;23;.958;3900000;0
2808;1957;733;100;54;1;53;.981;3600000;0
2808;6079;733;0;0;0;0;.00nan;0;0
2808;-1;3789;0;0;0;0;.00nan;0;0
2808;149280;3789;49;16;2;14;.875;3578000;0
2809;3756;752;72;22;1;21;.955;3720000;0
2809;178098;738;0;0;0;0;.00nan;0;0
2809;185442;738;94;39;2;37;.949;3720000;0
2809;43731;752;0;0;0;0;.00nan;0;0
2810;83;737;80;33;2;31;.939;3600000;0
2810;848;743;62;42;5;37;.881;3600000;0
2810;190570;737;0;0;0;0;.00nan;0;0
2810;190589;743;0;0;0;0;.00nan;0;0
2811;3508;751;73;35;3;32;.914;3600000;0
2811;-1;751;0;0;0;0;.00nan;0;0
2811;61272;748;40;20;4;16;.800;2376000;0
2811;88646;748;60;10;0;10;1.000;1224000;0
2812;201075;736;0;0;0;0;.00nan;0;0
2812;33044;741;0;0;0;0;.00nan;0;0
2812;186219;736;56;27;3;24;.889;3557000;0
2812;56565;741;86;35;2;33;.943;3600000;0
2813;195867;2168;0;0;0;0;.00nan;0;0
2813;76405;732;0;0;0;0;.00nan;0;0
2813;85670;2168;81;47;5;42;.894;3900000;0
2813;148788;732;49;32;5;27;.844;3900000;0
2814;188561;739;0;0;0;0;.00nan;0;0
2814;186234;739;51;37;6;31;.838;3600000;0
2814;85281;749;71;29;2;27;.931;3600000;0
2814;149305;749;0;0;0;0;.00nan;0;0
2815;190607;1880;0;0;0;0;.00nan;0;0
2815;44526;734;77;32;2;30;.938;3695000;0
2815;-1;734;0;0;0;0;.00nan;0;0
2815;49935;1880;82;35;3;32;.914;3695000;0
2816;196698;747;0;0;0;0;.00nan;0;0
2816;192386;745;0;0;0;0;.00nan;0;0
2816;57107;747;89;28;1;27;.964;3600000;0
2816;75268;745;84;37;2;35;.946;3600000;0
2817;8505;764;0;0;0;0;.00nan;0;0
2817;-1;3789;78;14;0;14;1.000;3600000;0
2817;67362;764;61;43;5;38;.884;3600000;0
2817;149280;3789;0;0;0;0;.00nan;0;0
2818;1957;733;39;36;6;30;.833;2158000;0
2818;3756;752;99;41;2;39;.951;3600000;0
2818;6079;733;75;24;1;23;.958;1442000;0
2818;43731;752;0;0;0;0;.00nan;0;0
2819;848;743;100;36;1;35;.972;3900000;0
2819;188561;739;0;0;0;0;.00nan;0;0
2819;190589;743;0;0;0;0;.00nan;0;0
2819;186234;739;87;30;1;29;.967;3900000;0
2820;83;737;43;39;6;33;.846;3600000;0
2820;190570;737;0;0;0;0;.00nan;0;0
2820;46792;729;14;23;6;17;.739;2663000;0
2820;52204;729;46;12;2;10;.833;903000;0
2821;2643;742;0;0;0;0;.00nan;0;0
2821;3508;751;91;43;3;40;.930;3578000;0
2821;-1;751;0;0;0;0;.00nan;0;0
2821;43971;742;74;33;2;31;.939;3600000;0
2822;195867;2168;0;0;0;0;.00nan;0;0
2822;61272;748;0;0;0;0;.00nan;0;0
2822;85670;2168;82;49;4;45;.918;3600000;0
2822;88646;748;82;28;1;27;.964;3600000;0
2823;33044;741;0;0;0;0;.00nan;0;0
2823;56565;741;58;42;5;37;.881;3600000;0
2823;76405;732;82;25;1;24;.960;3600000;0
2823;148788;732;0;0;0;0;.00nan;0;0
2824;178098;738;65;39;4;35;.897;3516000;0
2824;185442;738;0;0;0;0;.00nan;0;0
2824;85281;749;78;29;2;27;.931;3600000;0
2824;149305;749;0;0;0;0;.00nan;0;0
2825;-1;744;0;0;0;0;.00nan;0;0
2825;196698;747;0;0;0;0;.00nan;0;0
2825;49900;744;50;30;4;26;.867;3600000;0
2825;57107;747;96;28;1;27;.964;3600000;0
2826;185413;740;81;34;2;32;.941;3600000;0
2826;196715;740;0;0;0;0;.00nan;0;0
2826;44526;734;75;41;4;37;.902;3528000;0
2826;-1;734;0;0;0;0;.00nan;0;0
2827;848;743;42;9;2;7;.778;3549000;0
2827;33044;741;0;0;0;0;.00nan;0;0
2827;190589;743;0;0;0;0;.00nan;0;0
2827;56565;741;100;39;1;38;.974;3600000;0
2828;8505;764;0;0;0;0;.00nan;0;0
2828;46792;729;96;34;2;32;.941;3600000;0
2828;52204;729;0;0;0;0;.00nan;0;0
2828;67362;764;33;31;6;25;.806;3600000;0
2829;2643;742;63;33;4;29;.879;3568000;0
2829;195867;2168;0;0;0;0;.00nan;0;0
2829;43971;742;0;0;0;0;.00nan;0;0
2829;85670;2168;82;38;3;35;.921;3600000;0
2830;178098;738;0;0;0;0;.00nan;0;0
2830;185442;738;66;36;4;32;.889;3600000;0
2830;61272;748;0;0;0;0;.00nan;0;0
2830;88646;748;69;26;3;23;.885;3600000;0
2831;1957;733;82;51;3;48;.941;3674000;0
2831;6079;733;0;0;0;0;.00nan;0;0
2831;85281;749;67;27;2;25;.926;3674000;0
2831;149305;749;0;0;0;0;.00nan;0;0
2832;3508;751;85;37;2;35;.946;3600000;0
2832;-1;751;0;0;0;0;.00nan;0;0
2832;192386;745;0;0;0;0;.00nan;0;0
2832;75268;745;58;33;4;29;.879;3570000;0
2833;83;737;65;48;5;43;.896;3782000;0
2833;190570;737;0;0;0;0;.00nan;0;0
2833;-1;3789;37;26;6;20;.769;3782000;0
2833;149280;3789;0;0;0;0;.00nan;0;0
2834;-1;744;0;0;0;0;.00nan;0;0
2834;44526;734;100;37;1;36;.973;3600000;0
2834;-1;734;0;0;0;0;.00nan;0;0
2834;49900;744;66;29;2;27;.931;3572000;0
2835;201075;736;65;25;2;23;.920;3542000;0
2835;186219;736;0;0;0;0;.00nan;0;0
2835;76405;732;83;19;1;18;.947;3600000;0
2835;148788;732;0;0;0;0;.00nan;0;0
2836;190607;1880;0;0;0;0;.00nan;0;0
2836;185413;740;0;0;0;0;.00nan;0;0
2836;196715;740;63;30;3;27;.900;3746000;0
2836;49935;1880;51;25;4;21;.840;3746000;0
2837;8505;764;0;0;0;0;.00nan;0;0
2837;188561;739;0;0;0;0;.00nan;0;0
2837;186234;739;85;29;1;28;.966;3600000;0
2837;67362;764;63;42;5;37;.881;3600000;0
2838;175764;729;0;0;0;0;.00nan;0;0
2838;192386;745;0;0;0;0;.00nan;0;0
2838;46792;729;82;35;2;33;.943;3900000;0
2838;75268;745;82;29;2;27;.931;3900000;0
2839;2643;742;100;24;0;24;1.000;3600000;0
2839;3756;752;98;47;2;45;.957;3573000;0
2839;43731;752;0;0;0;0;.00nan;0;0
2839;43971;742;0;0;0;0;.00nan;0;0
2840;1957;733;73;46;5;41;.891;3600000;0
2840;6079;733;0;0;0;0;.00nan;0;0
2840;61272;748;0;0;0;0;.00nan;0;0
2840;88646;748;64;22;2;20;.909;3600000;0
2841;33044;741;0;0;0;0;.00nan;0;0
2841;196698;747;0;0;0;0;.00nan;0;0
2841;56565;741;64;31;3;28;.903;3600000;0
2841;57107;747;100;21;0;21;1.000;3600000;0
2842;195867;2168;0;0;0;0;.00nan;0;0
2842;85281;749;88;39;3;36;.923;3560000;0
2842;85670;2168;68;23;2;21;.913;3600000;0
2842;149305;749;0;0;0;0;.00nan;0;0
2843;-1;3789;0;0;0;0;.00nan;0;0
2843;76405;732;100;43;2;41;.953;3900000;0
2843;148788;732;0;0;0;0;.00nan;0;0
2843;149280;3789;72;24;2;22;.917;3900000;0
2844;83;737;66;22;2;20;.909;3600000;0
2844;201075;736;0;0;0;0;.00nan;0;0
2844;190570;737;0;0;0;0;.00nan;0;0
2844;186219;736;62;48;4;44;.917;3533000;0
2845;185413;740;58;38;5;33;.868;3552000;0
2845;-1;744;0;0;0;0;.00nan;0;0
2845;196715;740;0;0;0;0;.00nan;0;0
2845;49900;744;62;30;3;27;.900;3600000;0
2846;848;743;45;28;4;24;.857;3585000;0
2846;190589;743;0;0;0;0;.00nan;0;0
2846;190607;1880;0;0;0;0;.00nan;0;0
2846;49935;1880;57;20;2;18;.900;3600000;0
2847;3508;751;96;41;2;39;.951;3600000;0
2847;178098;738;71;33;3;30;.909;3600000;0
2847;185442;738;0;0;0;0;.00nan;0;0
2847;-1;751;0;0;0;0;.00nan;0;0
2848;3756;752;70;20;1;19;.950;3600000;0
2848;188561;739;41;2;1;1;.500;426000;0
2848;186234;739;17;27;7;20;.741;3174000;0
2848;43731;752;0;0;0;0;.00nan;0;0
2849;8505;764;48;54;8;46;.852;3600000;0
2849;196698;747;0;0;0;0;.00nan;0;0
2849;57107;747;50;21;3;18;.857;3600000;0
2849;67362;764;0;0;0;0;.00nan;0;0
2850;195867;2168;0;0;0;0;.00nan;0;0
2850;61272;748;0;0;0;0;.00nan;0;0
2850;85670;2168;85;33;1;32;.970;3600000;0
2850;88646;748;92;43;2;41;.953;3600000;0
2851;175764;729;0;0;0;0;.00nan;0;0
2851;-1;3789;0;0;0;0;.00nan;0;0
2851;46792;729;70;38;4;34;.895;3600000;0
2851;149280;3789;96;23;0;23;1.000;3600000;0
2852;848;743;69;37;4;33;.892;3600000;0
2852;190589;743;0;0;0;0;.00nan;0;0
2852;44526;734;84;26;1;25;.962;3600000;0
2852;-1;734;0;0;0;0;.00nan;0;0
2853;201075;736;94;33;0;33;1.000;3900000;0
2853;185413;740;0;0;0;0;.00nan;0;0
2853;196715;740;100;40;0;40;1.000;3900000;0
2853;186219;736;0;0;0;0;.00nan;0;0
2854;2643;742;100;32;1;31;.969;3600000;0
2854;33044;741;0;0;0;0;.00nan;0;0
2854;43971;742;0;0;0;0;.00nan;0;0
2854;56565;741;90;41;2;39;.951;3568000;0
2855;192386;745;0;0;0;0;.00nan;0;0
2855;75268;745;89;36;2;34;.944;3600000;0
2855;85281;749;19;24;6;18;.750;2642000;0
2855;149305;749;61;7;0;7;1.000;958000;0
2856;3756;752;62;36;4;32;.889;3600000;0
2856;-1;744;0;0;0;0;.00nan;0;0
2856;43731;752;0;0;0;0;.00nan;0;0
2856;49900;744;92;33;1;32;.970;3600000;0
2857;3508;751;78;38;3;35;.921;3900000;0
2857;188561;739;0;0;0;0;.00nan;0;0
2857;186234;739;81;40;3;37;.925;3900000;0
2857;-1;751;0;0;0;0;.00nan;0;0
2858;83;737;75;22;2;20;.909;3900000;0
2858;190570;737;0;0;0;0;.00nan;0;0
2858;190607;1880;0;0;0;0;.00nan;0;0
2858;49935;1880;92;35;2;33;.943;3900000;0
2859;195867;2168;0;0;0;0;.00nan;0;0
2859;44526;734;21;23;6;17;.739;2665000;0
2859;-1;734;59;6;0;6;1.000;935000;0
2859;85670;2168;92;43;2;41;.953;3600000;0
2860;188561;739;86;25;1;24;.960;3600000;0
2860;178098;738;0;0;0;0;.00nan;0;0
2860;185442;738;76;34;2;32;.941;3581000;0
2860;186234;739;0;0;0;0;.00nan;0;0
2861;848;743;85;26;1;25;.962;3600000;0
2861;190589;743;0;0;0;0;.00nan;0;0
2861;196698;747;0;0;0;0;.00nan;0;0
2861;57107;747;61;26;3;23;.885;3545000;0
2862;2643;742;69;38;4;34;.895;3565000;0
2862;8505;764;65;23;2;21;.913;3600000;0
2862;43971;742;0;0;0;0;.00nan;0;0
2862;67362;764;0;0;0;0;.00nan;0;0
2863;1957;733;56;37;5;32;.865;3561000;0
2863;6079;733;0;0;0;0;.00nan;0;0
2863;201075;736;62;36;4;32;.889;3600000;0
2863;186219;736;0;0;0;0;.00nan;0;0
2864;175764;729;0;0;0;0;.00nan;0;0
2864;46792;729;55;36;4;32;.889;3526000;0
2864;76405;732;0;0;0;0;.00nan;0;0
2864;148788;732;68;28;2;26;.929;3600000;0
2865;33044;741;69;36;3;33;.917;3600000;0
2865;56565;741;0;0;0;0;.00nan;0;0
2865;61272;748;0;0;0;0;.00nan;0;0
2865;88646;748;69;33;2;31;.939;3600000;0
2866;-1;744;0;0;0;0;.00nan;0;0
2866;-1;3789;0;0;0;0;.00nan;0;0
2866;49900;744;83;28;1;27;.964;3900000;0
2866;149280;3789;98;28;1;27;.964;3900000;0
2867;3508;751;55;38;5;33;.868;3600000;0
2867;185413;740;0;0;0;0;.00nan;0;0
2867;196715;740;42;39;6;33;.846;3585000;0
2867;-1;751;0;0;0;0;.00nan;0;0
2868;3756;752;95;31;0;31;1.000;3900000;0
2868;43731;752;0;0;0;0;.00nan;0;0
2868;192386;745;0;0;0;0;.00nan;0;0
2868;75268;745;100;39;0;39;1.000;3900000;0
2869;83;737;88;26;1;25;.962;3563000;0
2869;195867;2168;0;0;0;0;.00nan;0;0
2869;190570;737;0;0;0;0;.00nan;0;0
2869;85670;2168;100;37;0;37;1.000;3600000;0
2870;1957;733;85;50;4;46;.920;3600000;0
2870;6079;733;0;0;0;0;.00nan;0;0
2870;44526;734;100;28;0;28;1.000;3600000;0
2870;-1;734;0;0;0;0;.00nan;0;0
2871;178098;738;74;28;2;26;.929;3541000;0
2871;175764;729;0;0;0;0;.00nan;0;0
2871;185442;738;0;0;0;0;.00nan;0;0
2871;46792;729;100;31;0;31;1.000;3600000;0
2872;2643;742;84;39;2;37;.949;3600000;0
2872;8505;764;0;0;0;0;.00nan;0;0
2872;43971;742;0;0;0;0;.00nan;0;0
2872;67362;764;84;42;3;39;.929;3561000;0
2873;61272;748;0;0;0;0;.00nan;0;0
2873;76405;732;0;0;0;0;.00nan;0;0
2873;88646;748;59;29;3;26;.897;3600000;0
2873;148788;732;100;38;0;38;1.000;3600000;0
2874;33044;741;0;0;0;0;.00nan;0;0
2874;196698;747;0;0;0;0;.00nan;0;0
2874;56565;741;94;49;3;46;.939;3900000;0
2874;57107;747;92;35;3;32;.914;3899000;0
2875;188561;739;0;0;0;0;.00nan;0;0
2875;190607;1880;0;0;0;0;.00nan;0;0
2875;186234;739;89;42;3;39;.929;3590000;0
2875;49935;1880;77;27;1;26;.963;3600000;0
2876;3508;751;80;41;3;38;.927;3900000;0
2876;-1;744;0;0;0;0;.00nan;0;0
2876;-1;751;0;0;0;0;.00nan;0;0
2876;49900;744;77;33;3;30;.909;3900000;0
2877;188561;739;83;23;1;22;.957;3600000;0
2877;185413;740;69;45;4;41;.911;3600000;0
2877;196715;740;0;0;0;0;.00nan;0;0
2877;186234;739;0;0;0;0;.00nan;0;0
2878;201075;736;0;0;0;0;.00nan;0;0
2878;186219;736;39;35;6;29;.829;3600000;0
2878;-1;3789;0;0;0;0;.00nan;0;0
2878;149280;3789;70;17;1;16;.941;3600000;0
2879;848;743;97;57;3;54;.947;3543000;0
2879;190589;743;0;0;0;0;.00nan;0;0
2879;85281;749;97;33;1;32;.970;3600000;0
2879;149305;749;0;0;0;0;.00nan;0;0
2880;83;737;74;34;3;31;.912;3600000;0
2880;1957;733;51;40;5;35;.875;3600000;0
2880;6079;733;0;0;0;0;.00nan;0;0
2880;190570;737;0;0;0;0;.00nan;0;0
2881;175764;729;0;0;0;0;.00nan;0;0
2881;44526;734;96;39;1;38;.974;3600000;0
2881;46792;729;50;39;6;33;.846;3600000;0
2881;-1;734;0;0;0;0;.00nan;0;0
2882;8505;764;51;4;0;4;1.000;333000;0
2882;196698;747;0;0;0;0;.00nan;0;0
2882;57107;747;87;35;2;33;.943;3600000;0
2882;67362;764;41;36;6;30;.833;3267000;0
2883;192386;745;0;0;0;0;.00nan;0;0
2883;61272;748;0;0;0;0;.00nan;0;0
2883;75268;745;83;25;1;24;.960;3600000;0
2883;88646;748;98;43;2;41;.953;3553000;0
2884;195867;2168;0;0;0;0;.00nan;0;0
2884;190607;1880;0;0;0;0;.00nan;0;0
2884;49935;1880;93;46;3;43;.935;3541000;0
2884;85670;2168;95;34;1;33;.971;3600000;0
2885;848;743;0;0;0;0;.00nan;0;0
2885;190589;743;65;44;4;40;.909;3600000;0
2885;85281;749;0;0;0;0;.00nan;0;0
2885;149305;749;89;29;1;28;.966;3600000;0
2886;3508;751;78;26;1;25;.962;3600000;0
2886;33044;741;0;0;0;0;.00nan;0;0
2886;-1;751;0;0;0;0;.00nan;0;0
2886;56565;741;96;58;5;53;.914;3600000;0
2887;178098;738;0;0;0;0;.00nan;0;0
2887;185413;740;0;0;0;0;.00nan;0;0
2887;185442;738;44;34;5;29;.853;3730000;0
2887;196715;740;71;38;4;34;.895;3730000;0
2888;188561;739;0;0;0;0;.00nan;0;0
2888;186234;739;65;26;2;24;.923;3600000;0
2888;76405;732;0;0;0;0;.00nan;0;0
2888;148788;732;95;35;1;34;.971;3600000;0
2889;201075;736;45;36;6;30;.833;3600000;0
2889;186219;736;0;0;0;0;.00nan;0;0
2889;-1;3789;0;0;0;0;.00nan;0;0
2889;149280;3789;100;25;0;25;1.000;3600000;0
2890;848;743;81;39;3;36;.923;3600000;0
2890;3756;752;54;33;4;29;.879;3551000;0
2890;190589;743;0;0;0;0;.00nan;0;0
2890;43731;752;0;0;0;0;.00nan;0;0
2891;8505;764;0;0;0;0;.00nan;0;0
2891;196698;747;0;0;0;0;.00nan;0;0
2891;57107;747;77;32;2;30;.938;3900000;0
2891;67362;764;84;31;2;29;.935;3900000;0
2892;2643;742;0;0;0;0;.00nan;0;0
2892;43971;742;52;23;3;20;.870;3539000;0
2892;192386;745;0;0;0;0;.00nan;0;0
2892;75268;745;82;27;1;26;.963;3600000;0
2893;-1;744;0;0;0;0;.00nan;0;0
2893;49900;744;74;25;2;23;.920;3600000;0
2893;85281;749;65;32;3;29;.906;3543000;0
2893;149305;749;0;0;0;0;.00nan;0;0
2894;195867;2168;88;36;1;35;.972;3600000;0
2894;33044;741;0;0;0;0;.00nan;0;0
2894;56565;741;35;35;6;29;.829;3600000;0
2894;85670;2168;0;0;0;0;.00nan;0;0
2895;178098;738;38;24;4;20;.833;1045000;0
2895;185442;738;48;29;4;25;.862;2555000;0
2895;-1;3789;0;0;0;0;.00nan;0;0
2895;149280;3789;100;20;0;20;1.000;3600000;0
2896;175764;729;0;0;0;0;.00nan;0;0
2896;185413;740;24;13;4;9;.692;1011000;0
2896;196715;740;76;27;1;26;.963;2589000;0
2896;46792;729;99;29;1;28;.966;3600000;0
2897;1957;733;0;0;0;0;.00nan;0;0
2897;6079;733;70;50;5;45;.900;3600000;0
2897;188561;739;0;0;0;0;.00nan;0;0
2897;186234;739;63;24;3;21;.875;3600000;0
2898;83;737;100;30;0;30;1.000;3600000;0
2898;201075;736;0;0;0;0;.00nan;0;0
2898;190570;737;0;0;0;0;.00nan;0;0
2898;186219;736;79;27;2;25;.926;3570000;0
2899;190607;1880;0;0;0;0;.00nan;0;0
2899;49935;1880;69;34;4;30;.882;3600000;0
2899;76405;732;0;0;0;0;.00nan;0;0
2899;148788;732;35;27;5;22;.815;3556000;0
2900;848;743;76;38;3;35;.921;3577000;0
2900;3756;752;0;0;0;0;.00nan;0;0
2900;190589;743;0;0;0;0;.00nan;0;0
2900;43731;752;100;37;1;36;.973;3600000;0
2901;196698;747;0;0;0;0;.00nan;0;0
2901;192386;745;0;0;0;0;.00nan;0;0
2901;57107;747;69;29;2;27;.931;3600000;0
2901;75268;745;83;43;3;40;.930;3580000;0
2902;-1;744;0;0;0;0;.00nan;0;0
2902;49900;744;71;18;1;17;.944;3600000;0
2902;85281;749;65;34;3;31;.912;3600000;0
2902;149305;749;0;0;0;0;.00nan;0;0
2903;3508;751;93;43;2;41;.953;3600000;0
2903;8505;764;0;0;0;0;.00nan;0;0
2903;-1;751;0;0;0;0;.00nan;0;0
2903;67362;764;80;46;4;42;.913;3564000;0
2904;178098;738;48;26;4;22;.846;3600000;0
2904;195867;2168;0;0;0;0;.00nan;0;0
2904;185442;738;0;0;0;0;.00nan;0;0
2904;85670;2168;86;46;5;41;.891;3551000;0
2905;185413;740;74;42;4;38;.905;3577000;0
2905;196715;740;0;0;0;0;.00nan;0;0
2905;-1;3789;0;0;0;0;.00nan;0;0
2905;149280;3789;74;32;3;29;.906;3600000;0
2906;188561;739;67;30;2;28;.933;3600000;0
2906;186234;739;0;0;0;0;.00nan;0;0
2906;44526;734;60;27;3;24;.889;3546000;0
2906;-1;734;0;0;0;0;.00nan;0;0
2907;2643;742;54;23;3;20;.870;3600000;0
2907;190607;1880;0;0;0;0;.00nan;0;0
2907;43971;742;0;0;0;0;.00nan;0;0
2907;49935;1880;95;34;1;33;.971;3600000;0
2908;33044;741;0;0;0;0;.00nan;0;0
2908;56565;741;74;37;3;34;.919;3521000;0
2908;61272;748;0;0;0;0;.00nan;0;0
2908;88646;748;83;22;1;21;.955;3600000;0
2909;1957;733;89;54;4;50;.926;3600000;0
2909;6079;733;0;0;0;0;.00nan;0;0
2909;175764;729;0;0;0;0;.00nan;0;0
2909;46792;729;74;24;1;23;.958;3600000;0
2910;83;737;57;39;5;34;.872;3600000;0
2910;190570;737;0;0;0;0;.00nan;0;0
2910;76405;732;0;0;0;0;.00nan;0;0
2910;148788;732;100;39;1;38;.974;3600000;0
2911;3756;752;61;37;4;33;.892;3544000;0
2911;-1;744;0;0;0;0;.00nan;0;0
2911;43731;752;0;0;0;0;.00nan;0;0
2911;49900;744;48;26;3;23;.885;3600000;0
2912;2643;742;0;0;0;0;.00nan;0;0
2912;201075;736;67;19;1;18;.947;3600000;0
2912;186219;736;0;0;0;0;.00nan;0;0
2912;43971;742;85;30;2;28;.933;3544000;0
2913;3508;751;79;25;2;23;.920;3600000;0
2913;178098;738;0;0;0;0;.00nan;0;0
2913;185442;738;56;36;5;31;.861;3600000;0
2913;-1;751;0;0;0;0;.00nan;0;0
2914;175764;729;0;0;0;0;.00nan;0;0
2914;195867;2168;0;0;0;0;.00nan;0;0
2914;46792;729;92;31;1;30;.968;3600000;0
2914;85670;2168;79;35;4;31;.886;3600000;0
2915;8505;764;0;0;0;0;.00nan;0;0
2915;61272;748;0;0;0;0;.00nan;0;0
2915;67362;764;90;39;2;37;.949;3600000;0
2915;88646;748;81;26;1;25;.962;3600000;0
2916;190607;1880;0;0;0;0;.00nan;0;0
2916;196698;747;0;0;0;0;.00nan;0;0
2916;49935;1880;95;42;3;39;.929;3900000;0
2916;57107;747;74;31;3;28;.903;3900000;0
2917;1957;733;87;35;2;33;.943;3600000;0
2917;6079;733;0;0;0;0;.00nan;0;0
2917;44526;734;90;20;0;20;1.000;3600000;0
2917;-1;734;0;0;0;0;.00nan;0;0
2918;33044;741;0;0;0;0;.00nan;0;0
2918;192386;745;0;0;0;0;.00nan;0;0
2918;56565;741;52;43;6;37;.860;3900000;0
2918;75268;745;21;21;6;15;.714;3900000;0
2919;83;737;97;34;2;32;.941;3900000;0
2919;201075;736;0;0;0;0;.00nan;0;0
2919;190570;737;0;0;0;0;.00nan;0;0
2919;186219;736;68;34;2;32;.941;3900000;0
2920;3756;752;70;37;4;33;.892;3515000;0
2920;-1;744;0;0;0;0;.00nan;0;0
2920;43731;752;0;0;0;0;.00nan;0;0
2920;49900;744;95;41;2;39;.951;3600000;0
2921;2643;742;0;0;0;0;.00nan;0;0
2921;188561;739;0;0;0;0;.00nan;0;0
2921;186234;739;75;33;2;31;.939;3753000;0
2921;43971;742;69;19;1;18;.947;3753000;0
2922;848;743;71;45;5;40;.889;3600000;0
2922;190589;743;0;0;0;0;.00nan;0;0
2922;85281;749;67;18;2;16;.889;3600000;0
2922;149305;749;0;0;0;0;.00nan;0;0
2923;185413;740;0;0;0;0;.00nan;0;0
2923;196715;740;68;43;4;39;.907;3552000;0
2923;76405;732;0;0;0;0;.00nan;0;0
2923;148788;732;86;38;2;36;.947;3600000;0
2924;3508;751;42;37;6;31;.838;3600000;0
2924;175764;729;0;0;0;0;.00nan;0;0
2924;-1;751;0;0;0;0;.00nan;0;0
2924;46792;729;100;29;0;29;1.000;3600000;0
2925;8505;764;0;0;0;0;.00nan;0;0
2925;195867;2168;0;0;0;0;.00nan;0;0
2925;67362;764;96;27;0;27;1.000;3600000;0
2925;85670;2168;68;35;3;32;.914;3600000;0
2926;196698;747;0;0;0;0;.00nan;0;0
2926;44526;734;76;42;4;38;.905;3570000;0
2926;-1;734;0;0;0;0;.00nan;0;0
2926;57107;747;61;28;3;25;.893;3600000;0
2927;190607;1880;0;0;0;0;.00nan;0;0
2927;192386;745;0;0;0;0;.00nan;0;0
2927;49935;1880;59;27;3;24;.889;3583000;0
2927;75268;745;98;33;1;32;.970;3600000;0
2928;83;737;77;22;1;21;.955;3600000;0
2928;188561;739;0;0;0;0;.00nan;0;0
2928;190570;737;0;0;0;0;.00nan;0;0
2928;186234;739;49;43;6;37;.860;3600000;0
2929;178098;738;0;0;0;0;.00nan;0;0
2929;185442;738;74;33;2;31;.939;3759000;0
2929;61272;748;0;0;0;0;.00nan;0;0
2929;88646;748;81;25;1;24;.960;3759000;0
2930;848;743;70;31;4;27;.871;3566000;0
2930;2643;742;83;32;2;30;.938;3600000;0
2930;190589;743;0;0;0;0;.00nan;0;0
2930;43971;742;0;0;0;0;.00nan;0;0
2931;185413;740;78;51;5;46;.902;3600000;0
2931;196715;740;0;0;0;0;.00nan;0;0
2931;-1;3789;0;0;0;0;.00nan;0;0
2931;149280;3789;75;22;1;21;.955;3600000;0
2932;1957;733;80;49;4;45;.918;3591000;0
2932;6079;733;0;0;0;0;.00nan;0;0
2932;85281;749;79;26;2;24;.923;3600000;0
2932;139409;749;0;0;0;0;.00nan;0;0
2933;201075;736;85;41;3;38;.927;3600000;0
2933;186219;736;0;0;0;0;.00nan;0;0
2933;76405;732;52;4;0;4;1.000;808000;0
2933;148788;732;36;30;6;24;.800;2792000;0
2934;3756;752;56;34;4;30;.882;3514000;0
2934;33044;741;0;0;0;0;.00nan;0;0
2934;43731;752;0;0;0;0;.00nan;0;0
2934;56565;741;100;51;2;49;.961;3600000;0
2935;8505;764;43;4;1;3;.750;392000;0
2935;192386;745;0;0;0;0;.00nan;0;0
2935;67362;764;33;34;6;28;.824;3208000;0
2935;75268;745;79;31;2;29;.935;3600000;0
2936;178098;738;100;31;0;31;1.000;3600000;0
2936;185442;738;0;0;0;0;.00nan;0;0
2936;-1;3789;0;0;0;0;.00nan;0;0
2936;149280;3789;54;27;3;24;.889;3600000;0
2937;848;743;70;22;1;21;.955;3600000;0
2937;195867;2168;0;0;0;0;.00nan;0;0
2937;190589;743;0;0;0;0;.00nan;0;0
2937;85670;2168;94;40;2;38;.950;3586000;0
2938;185413;740;74;38;3;35;.921;3600000;0
2938;196715;740;0;0;0;0;.00nan;0;0
2938;61272;748;0;0;0;0;.00nan;0;0
2938;88646;748;67;23;2;21;.913;3600000;0
2939;2643;742;0;0;0;0;.00nan;0;0
2939;43971;742;65;44;4;40;.909;3597000;0
2939;85281;749;0;0;0;0;.00nan;0;0
2939;139409;749;84;33;2;31;.939;3600000;0
2940;201075;736;41;4;1;3;.750;586000;0
2940;186219;736;36;34;6;28;.824;3014000;0
2940;76405;732;60;27;3;24;.889;3600000;0
2940;148788;732;0;0;0;0;.00nan;0;0
2941;3508;751;48;24;4;20;.833;3600000;0
2941;190607;1880;58;7;0;7;1.000;918000;0
2941;-1;751;0;0;0;0;.00nan;0;0
2941;49935;1880;34;31;6;25;.806;2682000;0
2942;83;737;68;23;2;21;.913;3900000;0
2942;175764;729;0;0;0;0;.00nan;0;0
2942;190570;737;0;0;0;0;.00nan;0;0
2942;46792;729;93;42;2;40;.952;3900000;0
2943;188561;739;50;3;0;3;1.000;238000;0
2943;186234;739;36;36;6;30;.833;3362000;0
2943;44526;734;78;30;2;28;.933;3600000;0
2943;-1;734;0;0;0;0;.00nan;0;0
2944;8505;764;0;0;0;0;.00nan;0;0
2944;33044;741;0;0;0;0;.00nan;0;0
2944;56565;741;70;27;2;25;.926;3600000;0
2944;67362;764;72;44;4;40;.909;3535000;0
2945;3756;752;100;36;1;35;.972;3600000;0
2945;43731;752;0;0;0;0;.00nan;0;0
2945;192386;745;0;0;0;0;.00nan;0;0
2945;75268;745;92;37;2;35;.946;3575000;0
2946;-1;744;0;0;0;0;.00nan;0;0
2946;49900;744;92;35;2;33;.943;3600000;0
2946;61272;748;0;0;0;0;.00nan;0;0
2946;88646;748;74;40;3;37;.925;3600000;0
2947;196698;747;0;0;0;0;.00nan;0;0
2947;-1;3789;0;0;0;0;.00nan;0;0
2947;57107;747;67;30;3;27;.900;3600000;0
2947;149280;3789;67;21;2;19;.905;3600000;0
2948;848;743;63;41;5;36;.878;3600000;0
2948;3508;751;59;30;4;26;.867;3600000;0
2948;190589;743;0;0;0;0;.00nan;0;0
2948;-1;751;0;0;0;0;.00nan;0;0
2949;201075;736;0;0;0;0;.00nan;0;0
2949;195867;2168;0;0;0;0;.00nan;0;0
2949;186219;736;94;42;2;40;.952;3600000;0
2949;85670;2168;85;35;3;32;.914;3570000;0
2950;3756;752;68;30;2;28;.933;3566000;0
2950;185413;740;0;0;0;0;.00nan;0;0
2950;196715;740;92;36;1;35;.972;3600000;0
2950;43731;752;0;0;0;0;.00nan;0;0
2951;1957;733;89;38;2;36;.947;3600000;0
2951;2643;742;74;23;1;22;.957;3600000;0
2951;6079;733;0;0;0;0;.00nan;0;0
2951;43971;742;0;0;0;0;.00nan;0;0
2952;175764;729;0;0;0;0;.00nan;0;0
2952;190607;1880;0;0;0;0;.00nan;0;0
2952;46792;729;83;40;4;36;.900;3600000;0
2952;49935;1880;82;28;1;27;.964;3600000;0
2953;83;737;67;32;3;29;.906;3600000;0
2953;190570;737;0;0;0;0;.00nan;0;0
2953;-1;744;0;0;0;0;.00nan;0;0
2953;49900;744;73;22;1;21;.955;3600000;0
2954;196698;747;0;0;0;0;.00nan;0;0
2954;44526;734;82;29;1;28;.966;3732000;0
2954;-1;734;0;0;0;0;.00nan;0;0
2954;57107;747;73;31;2;29;.935;3732000;0
2955;848;743;100;34;0;34;1.000;3600000;0
2955;178098;738;70;22;1;21;.955;3592000;0
2955;190589;743;0;0;0;0;.00nan;0;0
2955;185442;738;0;0;0;0;.00nan;0;0
2956;188561;739;24;19;5;14;.737;2157000;0
2956;195867;2168;0;0;0;0;.00nan;0;0
2956;186234;739;54;9;1;8;.889;1376000;0
2956;85670;2168;57;29;4;25;.862;3600000;0
2957;3508;751;70;35;3;32;.914;3600000;0
2957;8505;764;42;36;6;30;.833;2746000;0
2957;-1;751;0;0;0;0;.00nan;0;0
2957;67362;764;27;15;4;11;.733;854000;0
2958;76405;732;93;50;3;47;.940;3600000;0
2958;85281;749;56;34;4;30;.882;3568000;0
2958;139409;749;0;0;0;0;.00nan;0;0
2958;148788;732;0;0;0;0;.00nan;0;0
2959;192386;745;0;0;0;0;.00nan;0;0
2959;61272;748;0;0;0;0;.00nan;0;0
2959;75268;745;97;48;2;46;.958;3900000;0
2959;88646;748;96;37;2;35;.946;3900000;0
2960;1957;733;59;29;3;26;.897;3600000;0
2960;6079;733;0;0;0;0;.00nan;0;0
2960;175764;729;55;19;2;17;.895;3600000;0
2960;46792;729;0;0;0;0;.00nan;0;0
2961;2643;742;0;0;0;0;.00nan;0;0
2961;33044;741;0;0;0;0;.00nan;0;0
2961;43971;742;77;22;1;21;.955;3600000;0
2961;56565;741;57;35;4;31;.886;3600000;0
2962;3508;751;88;40;3;37;.925;3621000;0
2962;-1;744;0;0;0;0;.00nan;0;0
2962;-1;751;0;0;0;0;.00nan;0;0
2962;49900;744;68;24;2;22;.917;3621000;0
2963;848;743;72;23;2;21;.913;3600000;0
2963;190589;743;0;0;0;0;.00nan;0;0
2963;-1;3789;0;0;0;0;.00nan;0;0
2963;149280;3789;68;29;3;26;.897;3565000;0
2964;3756;752;0;0;0;0;.00nan;0;0
2964;43731;752;79;38;2;36;.947;3900000;0
2964;76405;732;0;0;0;0;.00nan;0;0
2964;148788;732;88;34;2;32;.941;3900000;0
2965;185413;740;87;34;2;32;.941;3600000;0
2965;196698;747;0;0;0;0;.00nan;0;0
2965;196715;740;0;0;0;0;.00nan;0;0
2965;57107;747;69;36;3;33;.917;3583000;0
2966;178098;738;0;0;0;0;.00nan;0;0
2966;190607;1880;0;0;0;0;.00nan;0;0
2966;185442;738;88;38;2;36;.947;3600000;0
2966;49935;1880;62;29;3;26;.897;3543000;0
2967;83;737;83;36;3;33;.917;3600000;0
2967;190570;737;0;0;0;0;.00nan;0;0
2967;85281;749;100;28;0;28;1.000;3600000;0
2967;139409;749;0;0;0;0;.00nan;0;0
2968;195867;2168;0;0;0;0;.00nan;0;0
2968;192386;745;0;0;0;0;.00nan;0;0
2968;75268;745;53;34;5;29;.853;3600000;0
2968;85670;2168;75;28;2;26;.929;3600000;0
2969;1957;733;52;40;5;35;.875;3600000;0
2969;6079;733;0;0;0;0;.00nan;0;0
2969;188561;739;0;0;0;0;.00nan;0;0
2969;186234;739;95;25;0;25;1.000;3600000;0
2970;8505;764;0;0;0;0;.00nan;0;0
2970;33044;741;0;0;0;0;.00nan;0;0
2970;56565;741;49;34;5;29;.853;3562000;0
2970;67362;764;55;24;4;20;.833;3600000;0
2971;3508;751;67;19;1;18;.947;3600000;0
2971;196698;747;0;0;0;0;.00nan;0;0
2971;-1;751;0;0;0;0;.00nan;0;0
2971;57107;747;73;40;3;37;.925;3579000;0
2972;83;737;91;40;2;38;.950;3600000;0
2972;3756;752;63;30;4;26;.867;3560000;0
2972;190570;737;0;0;0;0;.00nan;0;0
2972;43731;752;0;0;0;0;.00nan;0;0
2973;61272;748;56;28;3;25;.893;3600000;0
2973;76405;732;69;34;4;30;.882;3600000;0
2973;88646;748;0;0;0;0;.00nan;0;0
2973;148788;732;0;0;0;0;.00nan;0;0
2974;190607;1880;0;0;0;0;.00nan;0;0
2974;49935;1880;98;40;1;39;.975;3570000;0
2974;85281;749;100;32;0;32;1.000;3600000;0
2974;139409;749;0;0;0;0;.00nan;0;0
2975;195867;2168;0;0;0;0;.00nan;0;0
2975;44526;734;86;34;2;32;.941;3600000;0
2975;-1;734;0;0;0;0;.00nan;0;0
2975;85670;2168;85;35;3;32;.914;3600000;0
2976;848;743;64;44;5;39;.886;3600000;0
2976;190589;743;0;0;0;0;.00nan;0;0
2976;-1;744;0;0;0;0;.00nan;0;0
2976;49900;744;74;22;1;21;.955;3600000;0
2977;175764;729;0;0;0;0;.00nan;0;0
2977;-1;3789;0;0;0;0;.00nan;0;0
2977;46792;729;76;28;2;26;.929;3625000;0
2977;149280;3789;60;27;3;24;.889;3625000;0
2978;185413;740;0;0;0;0;.00nan;0;0
2978;196715;740;92;41;2;39;.951;3600000;0
2978;192386;745;0;0;0;0;.00nan;0;0
2978;75268;745;72;36;4;32;.889;3515000;0
2979;2643;742;91;33;2;31;.939;3549000;0
2979;188561;739;0;0;0;0;.00nan;0;0
2979;186234;739;88;26;1;25;.962;3600000;0
2979;43971;742;0;0;0;0;.00nan;0;0
2980;1957;733;98;52;2;50;.962;3543000;0
2980;6079;733;0;0;0;0;.00nan;0;0
2980;201075;736;100;24;0;24;1.000;3600000;0
2980;186219;736;0;0;0;0;.00nan;0;0
2981;8505;764;0;0;0;0;.00nan;0;0
2981;33044;741;0;0;0;0;.00nan;0;0
2981;56565;741;48;29;4;25;.862;3600000;0
2981;67362;764;75;16;1;15;.938;3600000;0
2982;3756;752;91;43;3;40;.930;3600000;0
2982;190607;1880;0;0;0;0;.00nan;0;0
2982;43731;752;0;0;0;0;.00nan;0;0
2982;49935;1880;51;26;4;22;.846;3600000;0
2983;83;737;71;44;5;39;.886;3600000;0
2983;190570;737;0;0;0;0;.00nan;0;0
2983;61272;748;0;0;0;0;.00nan;0;0
2983;88646;748;86;38;2;36;.947;3600000;0
2984;178098;738;82;41;3;38;.927;3900000;0
2984;185442;738;0;0;0;0;.00nan;0;0
2984;196698;747;51;25;3;22;.880;3900000;0
2984;57107;747;0;0;0;0;.00nan;0;0
2985;3508;751;73;31;3;28;.903;3600000;0
2985;-1;751;0;0;0;0;.00nan;0;0
2985;44526;734;78;23;1;22;.957;3600000;0
2985;-1;734;0;0;0;0;.00nan;0;0
2986;195867;2168;0;0;0;0;.00nan;0;0
2986;185413;740;0;0;0;0;.00nan;0;0
2986;196715;740;97;51;3;48;.941;3600000;0
2986;85670;2168;58;28;4;24;.857;3600000;0
2987;192386;745;0;0;0;0;.00nan;0;0
2987;-1;3789;0;0;0;0;.00nan;0;0
2987;75268;745;83;39;3;36;.923;3710000;0
2987;149280;3789;83;37;2;35;.946;3710000;0
2988;848;743;95;40;1;39;.975;3567000;0
2988;8505;764;0;0;0;0;.00nan;0;0
2988;190589;743;0;0;0;0;.00nan;0;0
2988;67362;764;100;35;0;35;1.000;3600000;0
2989;2643;742;0;0;0;0;.00nan;0;0
2989;-1;744;0;0;0;0;.00nan;0;0
2989;43971;742;81;32;2;30;.938;3600000;0
2989;49900;744;85;39;3;36;.923;3600000;0
2990;188561;739;0;0;0;0;.00nan;0;0
2990;33044;741;73;37;3;34;.919;3708000;0
2990;186234;739;59;19;2;17;.895;3708000;0
2990;56565;741;0;0;0;0;.00nan;0;0
2991;848;743;0;0;0;0;.00nan;0;0
2991;190589;743;91;46;2;44;.957;3600000;0
2991;85281;749;66;36;4;32;.889;3600000;0
2991;139409;749;0;0;0;0;.00nan;0;0
2992;190607;1880;0;0;0;0;.00nan;0;0
2992;49935;1880;97;32;1;31;.969;3542000;0
2992;61272;748;0;0;0;0;.00nan;0;0
2992;88646;748;100;26;0;26;1.000;3600000;0
2993;178098;738;0;0;0;0;.00nan;0;0
2993;201075;736;61;35;4;31;.886;3577000;0
2993;185442;738;81;32;2;30;.938;3600000;0
2993;186219;736;0;0;0;0;.00nan;0;0
2994;3508;751;77;23;1;22;.957;3600000;0
2994;185413;740;49;42;6;36;.857;3208000;0
2994;196715;740;53;2;0;2;1.000;392000;0
2994;-1;751;0;0;0;0;.00nan;0;0
2995;44526;734;82;36;3;33;.917;3900000;0
2995;-1;3789;0;0;0;0;.00nan;0;0
2995;-1;734;0;0;0;0;.00nan;0;0
2995;149280;3789;63;26;3;23;.885;3900000;0
2996;8505;764;0;0;0;0;.00nan;0;0
2996;195867;2168;0;0;0;0;.00nan;0;0
2996;67362;764;88;33;2;31;.939;3900000;0
2996;85670;2168;83;33;2;31;.939;3900000;0
2997;3756;752;28;23;6;17;.739;1720000;0
2997;196698;747;0;0;0;0;.00nan;0;0
2997;43731;752;48;14;2;12;.857;1880000;0
2997;57107;747;100;39;1;38;.974;3600000;0
2998;1957;733;0;0;0;0;.00nan;0;0
2998;6079;733;100;40;1;39;.975;3600000;0
2998;-1;744;0;0;0;0;.00nan;0;0
2998;49900;744;24;14;4;10;.714;3600000;0
2999;178098;738;77;29;2;27;.931;3600000;0
2999;201075;736;0;0;0;0;.00nan;0;0
2999;185442;738;0;0;0;0;.00nan;0;0
2999;186219;736;79;39;3;36;.923;3600000;0
3000;2643;742;0;0;0;0;.00nan;0;0
3000;43971;742;33;26;6;20;.769;3531000;0
3000;76405;732;0;0;0;0;.00nan;0;0
3000;148788;732;48;27;4;23;.852;3600000;0
3001;188561;739;0;0;0;0;.00nan;0;0
3001;186234;739;66;27;3;24;.889;3536000;0
3001;192386;745;0;0;0;0;.00nan;0;0
3001;75268;745;76;22;1;21;.955;3600000;0
3002;33044;741;0;0;0;0;.00nan;0;0
3002;56565;741;78;37;3;34;.919;3600000;0
3002;85281;749;44;24;4;20;.833;3600000;0
3002;139409;749;0;0;0;0;.00nan;0;0
3003;188561;739;55;23;3;20;.870;3600000;0
3003;185413;740;0;0;0;0;.00nan;0;0
3003;196715;740;61;35;4;31;.886;3547000;0
3003;186234;739;0;0;0;0;.00nan;0;0
3004;848;743;56;36;4;32;.889;3600000;0
3004;190589;743;0;0;0;0;.00nan;0;0
3004;-1;3789;0;0;0;0;.00nan;0;0
3004;149280;3789;100;27;0;27;1.000;3600000;0
3005;175764;729;0;0;0;0;.00nan;0;0
3005;44526;734;77;45;4;41;.911;3600000;0
3005;46792;729;77;26;1;25;.962;3600000;0
3005;-1;734;0;0;0;0;.00nan;0;0
3006;2643;742;0;0;0;0;.00nan;0;0
3006;43971;742;96;34;1;33;.971;3600000;0
3006;61272;748;0;0;0;0;.00nan;0;0
3006;88646;748;100;37;0;37;1.000;3600000;0
3007;-1;744;0;0;0;0;.00nan;0;0
3007;196698;747;0;0;0;0;.00nan;0;0
3007;49900;744;89;40;3;37;.925;3900000;0
3007;57107;747;82;43;3;40;.930;3900000;0
3008;1957;733;96;45;2;43;.956;3600000;0
3008;3508;751;50;34;5;29;.853;3600000;0
3008;6079;733;0;0;0;0;.00nan;0;0
3008;-1;751;0;0;0;0;.00nan;0;0
3009;3756;752;87;34;2;32;.941;3600000;0
3009;201075;736;70;52;5;47;.904;3600000;0
3009;186219;736;0;0;0;0;.00nan;0;0
3009;43731;752;0;0;0;0;.00nan;0;0
3010;83;737;43;22;3;19;.864;3600000;0
3010;190570;737;0;0;0;0;.00nan;0;0
3010;76405;732;100;37;0;37;1.000;3600000;0
3010;148788;732;0;0;0;0;.00nan;0;0
3011;195867;2168;0;0;0;0;.00nan;0;0
3011;192386;745;0;0;0;0;.00nan;0;0
3011;75268;745;71;29;3;26;.897;3547000;0
3011;85670;2168;93;42;2;40;.952;3600000;0
3012;33044;741;0;0;0;0;.00nan;0;0
3012;56565;741;58;34;4;30;.882;3600000;0
3012;85281;749;70;23;2;21;.913;3600000;0
3012;139409;749;0;0;0;0;.00nan;0;0
3013;195867;2168;0;0;0;0;.00nan;0;0
3013;-1;744;0;0;0;0;.00nan;0;0
3013;49900;744;77;26;2;24;.923;3600000;0
3013;85670;2168;75;36;3;33;.917;3571000;0
3014;178098;738;86;35;2;33;.943;3600000;0
3014;175764;729;0;0;0;0;.00nan;0;0
3014;185442;738;0;0;0;0;.00nan;0;0
3014;46792;729;89;26;1;25;.962;3600000;0
3015;8505;764;0;0;0;0;.00nan;0;0
3015;44526;734;73;29;2;27;.931;3600000;0
3015;-1;734;0;0;0;0;.00nan;0;0
3015;67362;764;54;26;3;23;.885;3545000;0
3016;196698;747;0;0;0;0;.00nan;0;0
3016;57107;747;99;18;0;18;1.000;3600000;0
3016;61272;748;0;0;0;0;.00nan;0;0
3016;88646;748;92;36;1;35;.972;3580000;0
3017;3508;751;58;24;3;21;.875;3640000;0
3017;201075;736;88;46;4;42;.913;3640000;0
3017;186219;736;0;0;0;0;.00nan;0;0
3017;-1;751;0;0;0;0;.00nan;0;0
3018;185413;740;78;37;2;35;.946;3600000;0
3018;196715;740;0;0;0;0;.00nan;0;0
3018;76405;732;81;38;4;34;.895;3514000;0
3018;148788;732;0;0;0;0;.00nan;0;0
3019;1957;733;81;51;5;46;.902;3600000;0
3019;6079;733;0;0;0;0;.00nan;0;0
3019;190607;1880;79;24;1;23;.958;3600000;0
3019;49935;1880;0;0;0;0;.00nan;0;0
3020;2643;742;0;0;0;0;.00nan;0;0
3020;43971;742;42;41;8;33;.805;3600000;0
3020;192386;745;0;0;0;0;.00nan;0;0
3020;75268;745;78;23;1;22;.957;3600000;0
3021;83;737;0;0;0;0;.00nan;0;0
3021;848;743;97;36;1;35;.972;3900000;0
3021;190570;737;84;37;1;36;.973;3900000;0
3021;190589;743;0;0;0;0;.00nan;0;0
3022;188561;739;0;0;0;0;.00nan;0;0
3022;186234;739;68;32;3;29;.906;3600000;0
3022;-1;3789;0;0;0;0;.00nan;0;0
3022;149280;3789;100;27;0;27;1.000;3600000;0
3023;3508;751;66;18;1;17;.944;3600000;0
3023;-1;751;0;0;0;0;.00nan;0;0
3023;44526;734;0;0;0;0;.00nan;0;0
3023;-1;734;98;57;4;53;.930;3600000;0
3024;3756;752;85;28;1;27;.964;3600000;0
3024;175764;729;0;0;0;0;.00nan;0;0
3024;43731;752;0;0;0;0;.00nan;0;0
3024;46792;729;97;38;2;36;.947;3551000;0
3025;188561;739;68;27;2;25;.926;3900000;0
3025;186234;739;0;0;0;0;.00nan;0;0
3025;-1;3789;0;0;0;0;.00nan;0;0
3025;149280;3789;70;24;2;22;.917;3900000;0
3026;2643;742;100;43;1;42;.977;3600000;0
3026;196698;747;0;0;0;0;.00nan;0;0
3026;43971;742;0;0;0;0;.00nan;0;0
3026;57107;747;79;28;2;26;.929;3574000;0
3027;1957;733;100;52;3;49;.942;3600000;0
3027;6079;733;0;0;0;0;.00nan;0;0
3027;76405;732;48;23;4;19;.826;3547000;0
3027;148788;732;0;0;0;0;.00nan;0;0
3028;178098;738;0;0;0;0;.00nan;0;0
3028;190607;1880;0;0;0;0;.00nan;0;0
3028;185442;738;93;49;3;46;.939;3895000;0
3028;49935;1880;81;28;2;26;.929;3895000;0
3029;192386;745;70;23;2;21;.913;3600000;0
3029;61272;748;0;0;0;0;.00nan;0;0
3029;75268;745;0;0;0;0;.00nan;0;0
3029;88646;748;65;31;3;28;.903;3551000;0
3030;195867;2168;0;0;0;0;.00nan;0;0
3030;-1;744;0;0;0;0;.00nan;0;0
3030;49900;744;86;31;1;30;.968;3600000;0
3030;85670;2168;66;36;4;32;.889;3600000;0
3031;83;737;85;28;2;26;.929;3600000;0
3031;33044;741;71;16;1;15;.938;1521000;0
3031;190570;737;0;0;0;0;.00nan;0;0
3031;56565;741;24;26;6;20;.769;2079000;0
3032;201075;736;28;27;6;21;.778;1728000;0
3032;196698;747;0;0;0;0;.00nan;0;0
3032;186219;736;43;25;4;21;.840;1872000;0
3032;57107;747;28;26;6;20;.769;3600000;0
3033;188561;739;0;0;0;0;.00nan;0;0
3033;178098;738;57;42;5;37;.881;3600000;0
3033;185442;738;0;0;0;0;.00nan;0;0
3033;186234;739;71;24;2;22;.917;3600000;0
3034;8505;764;0;0;0;0;.00nan;0;0
3034;61272;748;0;0;0;0;.00nan;0;0
3034;67362;764;98;40;1;39;.975;3600000;0
3034;88646;748;60;25;3;22;.880;3558000;0
3035;190607;1880;0;0;0;0;.00nan;0;0
3035;185413;740;95;54;2;52;.963;3900000;0
3035;196715;740;0;0;0;0;.00nan;0;0
3035;49935;1880;77;27;2;25;.926;3900000;0
3036;175764;729;0;0;0;0;.00nan;0;0
3036;46792;729;42;33;7;26;.788;3600000;0
3036;85281;749;79;35;2;33;.943;3600000;0
3036;139409;749;0;0;0;0;.00nan;0;0
3037;83;737;84;23;1;22;.957;3600000;0
3037;3508;751;81;38;2;36;.947;3549000;0
3037;190570;737;0;0;0;0;.00nan;0;0
3037;-1;751;0;0;0;0;.00nan;0;0
3038;201075;736;0;0;0;0;.00nan;0;0
3038;186219;736;100;42;1;41;.976;3900000;0
3038;44526;734;75;28;1;27;.964;3900000;0
3038;-1;734;0;0;0;0;.00nan;0;0
3039;3756;752;77;42;3;39;.929;3549000;0
3039;43731;752;0;0;0;0;.00nan;0;0
3039;192386;745;0;0;0;0;.00nan;0;0
3039;75268;745;89;33;1;32;.970;3600000;0
3040;848;743;65;45;5;40;.889;3600000;0
3040;190589;743;0;0;0;0;.00nan;0;0
3040;-1;744;39;21;4;17;.810;2955000;0
3040;49900;744;27;9;3;6;.667;575000;0
3041;2643;742;62;31;4;27;.871;3589000;0
3041;43971;742;0;0;0;0;.00nan;0;0
3041;76405;732;79;41;3;38;.927;3600000;0
3041;148788;732;0;0;0;0;.00nan;0;0
3042;1957;733;77;42;4;38;.905;3676000;0
3042;6079;733;0;0;0;0;.00nan;0;0
3042;33044;741;0;0;0;0;.00nan;0;0
3042;56565;741;85;44;3;41;.932;3676000;0
3043;188561;739;50;3;0;3;1.000;694000;0
3043;195867;2168;0;0;0;0;.00nan;0;0
3043;186234;739;45;36;6;30;.833;2906000;0
3043;85670;2168;100;32;0;32;1.000;3600000;0
3044;201075;736;64;48;5;43;.896;3600000;0
3044;186219;736;0;0;0;0;.00nan;0;0
3044;44526;734;75;23;1;22;.957;3600000;0
3044;-1;734;0;0;0;0;.00nan;0;0
3045;3756;752;0;0;0;0;.00nan;0;0
3045;43731;752;59;32;4;28;.875;3600000;0
3045;192386;745;0;0;0;0;.00nan;0;0
3045;75268;745;87;18;0;18;1.000;3600000;0
3046;175764;729;0;0;0;0;.00nan;0;0
3046;46792;729;70;22;1;21;.955;3581000;0
3046;61272;748;0;0;0;0;.00nan;0;0
3046;88646;748;100;31;0;31;1.000;3600000;0
3047;190607;1880;0;0;0;0;.00nan;0;0
3047;-1;3789;0;0;0;0;.00nan;0;0
3047;49935;1880;50;34;5;29;.853;3600000;0
3047;149280;3789;66;27;3;24;.889;3600000;0
3048;185413;740;0;0;0;0;.00nan;0;0
3048;196715;740;71;30;2;28;.933;3600000;0
3048;85281;749;96;33;1;32;.970;3600000;0
3048;139409;749;0;0;0;0;.00nan;0;0
3049;848;743;86;38;3;35;.921;3600000;0
3049;190589;743;0;0;0;0;.00nan;0;0
3049;76405;732;59;17;2;15;.882;3600000;0
3049;148788;732;0;0;0;0;.00nan;0;0
3050;8505;764;84;30;1;29;.967;3600000;0
3050;-1;744;0;0;0;0;.00nan;0;0
3050;49900;744;54;26;3;23;.885;3558000;0
3050;67362;764;0;0;0;0;.00nan;0;0
3051;1957;733;44;31;5;26;.839;3231000;0
3051;2643;742;59;15;2;13;.867;3600000;0
3051;6079;733;19;10;4;6;.600;369000;0
3051;43971;742;0;0;0;0;.00nan;0;0
3052;3508;751;86;27;2;25;.926;3544000;0
3052;188561;739;0;0;0;0;.00nan;0;0
3052;186234;739;98;30;1;29;.967;3600000;0
3052;-1;751;0;0;0;0;.00nan;0;0
3053;195867;2168;0;0;0;0;.00nan;0;0
3053;-1;3789;51;7;1;6;.857;1731000;0
3053;85670;2168;79;45;4;41;.911;3600000;0
3053;149280;3789;1;16;7;9;.563;1869000;0
3054;178098;738;49;29;5;24;.828;2251000;0
3054;185442;738;66;17;1;16;.941;1349000;0
3054;44526;734;80;31;2;29;.935;3600000;0
3054;-1;734;0;0;0;0;.00nan;0;0
3055;3756;752;67;31;4;27;.871;3591000;0
3055;185413;740;88;36;2;34;.944;3600000;0
3055;196715;740;0;0;0;0;.00nan;0;0
3055;43731;752;0;0;0;0;.00nan;0;0
3056;175764;729;0;0;0;0;.00nan;0;0
3056;196698;747;57;1;0;1;1.000;613000;0
3056;46792;729;84;37;3;34;.919;3900000;0
3056;57107;747;67;27;3;24;.889;3287000;0
3057;192386;745;0;0;0;0;.00nan;0;0
3057;75268;745;100;39;0;39;1.000;3600000;0
3057;85281;749;76;29;2;27;.931;3549000;0
3057;139409;749;0;0;0;0;.00nan;0;0
3058;83;737;65;36;4;32;.889;3600000;0
3058;2643;742;36;33;6;27;.818;3594000;0
3058;190570;737;0;0;0;0;.00nan;0;0
3058;43971;742;0;0;0;0;.00nan;0;0
3059;201075;736;91;20;0;20;1.000;1599000;0
3059;190607;1880;0;0;0;0;.00nan;0;0
3059;186219;736;18;22;6;16;.727;2001000;0
3059;49935;1880;60;18;2;16;.889;3600000;0
3060;3508;751;100;34;1;33;.971;3600000;0
3060;-1;751;0;0;0;0;.00nan;0;0
3060;-1;3789;0;0;0;0;.00nan;0;0
3060;149280;3789;60;21;2;19;.905;3558000;0
3061;1957;733;100;36;0;36;1.000;3600000;0
3061;6079;733;0;0;0;0;.00nan;0;0
3061;-1;744;0;0;0;0;.00nan;0;0
3061;49900;744;69;18;1;17;.944;3586000;0
3062;8505;764;0;0;0;0;.00nan;0;0
3062;44526;734;84;48;3;45;.938;3600000;0
3062;-1;734;0;0;0;0;.00nan;0;0
3062;67362;764;87;29;1;28;.966;3600000;0
3063;185413;740;72;32;3;29;.906;3591000;0
3063;196715;740;0;0;0;0;.00nan;0;0
3063;61272;748;0;0;0;0;.00nan;0;0
3063;88646;748;88;34;2;32;.941;3600000;0
3064;201075;736;82;39;3;36;.923;3514000;0
3064;190607;1880;0;0;0;0;.00nan;0;0
3064;186219;736;0;0;0;0;.00nan;0;0
3064;49935;1880;76;24;1;23;.958;3600000;0
3065;178098;738;61;30;4;26;.867;2205000;0
3065;185442;738;42;9;2;7;.778;1395000;0
3065;76405;732;0;0;0;0;.00nan;0;0
3065;148788;732;75;29;2;27;.931;3600000;0
3066;33044;741;0;0;0;0;.00nan;0;0
3066;196698;747;0;0;0;0;.00nan;0;0
3066;56565;741;93;47;4;43;.915;3900000;0
3066;57107;747;82;42;4;38;.905;3900000;0
3067;192386;745;0;0;0;0;.00nan;0;0
3067;75268;745;91;36;2;34;.944;3600000;0
3067;85281;749;47;23;3;20;.870;3559000;0
3067;139409;749;0;0;0;0;.00nan;0;0
3068;83;737;99;36;1;35;.972;3600000;0
3068;3756;752;76;33;3;30;.909;3587000;0
3068;190570;737;0;0;0;0;.00nan;0;0
3068;43731;752;0;0;0;0;.00nan;0;0
3069;178098;738;0;0;0;0;.00nan;0;0
3069;185442;738;65;35;4;31;.886;3526000;0
3069;-1;744;76;24;2;22;.917;3600000;0
3069;49900;744;0;0;0;0;.00nan;0;0
3070;1957;733;66;39;4;35;.897;3547000;0
3070;6079;733;0;0;0;0;.00nan;0;0
3070;-1;3789;0;0;0;0;.00nan;0;0
3070;149280;3789;92;38;3;35;.921;3600000;0
3071;190607;1880;0;0;0;0;.00nan;0;0
3071;44526;734;62;25;3;22;.880;3567000;0
3071;-1;734;0;0;0;0;.00nan;0;0
3071;49935;1880;92;49;2;47;.959;3600000;0
3072;188561;739;0;0;0;0;.00nan;0;0
3072;175764;729;0;0;0;0;.00nan;0;0
3072;186234;739;96;32;1;31;.969;3600000;0
3072;46792;729;100;38;0;38;1.000;3600000;0
3073;8505;764;0;0;0;0;.00nan;0;0
3073;61272;748;0;0;0;0;.00nan;0;0
3073;67362;764;71;29;3;26;.897;3900000;0
3073;88646;748;67;30;3;27;.900;3900000;0
3074;848;743;77;33;3;30;.909;3900000;0
3074;201075;736;0;0;0;0;.00nan;0;0
3074;190589;743;0;0;0;0;.00nan;0;0
3074;186219;736;85;47;3;44;.936;3900000;0
3075;196698;747;0;0;0;0;.00nan;0;0
3075;57107;747;64;27;3;24;.889;3600000;0
3075;76405;732;67;35;4;31;.886;3561000;0
3075;148788;732;0;0;0;0;.00nan;0;0
3076;195867;2168;0;0;0;0;.00nan;0;0
3076;33044;741;95;35;1;34;.971;3600000;0
3076;56565;741;0;0;0;0;.00nan;0;0
3076;85670;2168;58;27;3;24;.889;3518000;0
3077;3508;751;36;37;6;31;.838;3600000;0
3077;-1;751;0;0;0;0;.00nan;0;0
3077;85281;749;86;36;3;33;.917;3600000;0
3077;139409;749;0;0;0;0;.00nan;0;0
3078;2643;742;0;0;0;0;.00nan;0;0
3078;3756;752;95;32;1;31;.969;3600000;0
3078;43731;752;0;0;0;0;.00nan;0;0
3078;43971;742;64;26;3;23;.885;3591000;0
3079;-1;744;0;0;0;0;.00nan;0;0
3079;196698;747;0;0;0;0;.00nan;0;0
3079;49900;744;53;25;3;22;.880;3570000;0
3079;57107;747;99;45;2;43;.956;3600000;0
3080;190607;1880;0;0;0;0;.00nan;0;0
3080;-1;3789;0;0;0;0;.00nan;0;0
3080;49935;1880;99;41;1;40;.976;3600000;0
3080;149280;3789;50;33;4;29;.879;3600000;0
3081;188561;739;68;37;3;34;.919;3570000;0
3081;186234;739;0;0;0;0;.00nan;0;0
3081;61272;748;0;0;0;0;.00nan;0;0
3081;88646;748;64;20;2;18;.900;3600000;0
3082;1957;733;81;36;3;33;.917;3600000;0
3082;6079;733;0;0;0;0;.00nan;0;0
3082;175764;729;0;0;0;0;.00nan;0;0
3082;46792;729;100;26;0;26;1.000;3600000;0
3083;8505;764;0;0;0;0;.00nan;0;0
3083;195867;2168;0;0;0;0;.00nan;0;0
3083;67362;764;83;30;2;28;.933;3568000;0
3083;85670;2168;100;36;1;35;.972;3600000;0
3084;178098;738;70;33;4;29;.879;3600000;0
3084;185413;740;0;0;0;0;.00nan;0;0
3084;185442;738;0;0;0;0;.00nan;0;0
3084;196715;740;87;33;1;32;.970;3600000;0
3085;83;737;61;24;2;22;.917;3600000;0
3085;201075;736;66;34;3;31;.912;3600000;0
3085;190570;737;0;0;0;0;.00nan;0;0
3085;186219;736;0;0;0;0;.00nan;0;0
3086;848;743;70;30;3;27;.900;3555000;0
3086;190589;743;0;0;0;0;.00nan;0;0
3086;76405;732;74;24;1;23;.958;3600000;0
3086;148788;732;0;0;0;0;.00nan;0;0
3087;33044;741;0;0;0;0;.00nan;0;0
3087;192386;745;0;0;0;0;.00nan;0;0
3087;56565;741;98;40;2;38;.950;3900000;0
3087;75268;745;79;31;2;29;.935;3900000;0
3088;190607;1880;0;0;0;0;.00nan;0;0
3088;-1;3789;71;23;1;22;.957;3556000;0
3088;49935;1880;100;37;0;37;1.000;3600000;0
3088;149280;3789;0;0;0;0;.00nan;0;0
3089;3756;752;0;0;0;0;.00nan;0;0
3089;43731;752;82;34;3;31;.912;3600000;0
3089;85281;749;39;23;5;18;.783;3560000;0
3089;139409;749;0;0;0;0;.00nan;0;0
3090;2643;742;0;0;0;0;.00nan;0;0
3090;3508;751;97;48;2;46;.958;3563000;0
3090;-1;751;0;0;0;0;.00nan;0;0
3090;43971;742;91;30;1;29;.967;3600000;0
3091;848;743;99;33;1;32;.970;3600000;0
3091;190589;743;0;0;0;0;.00nan;0;0
3091;44526;734;45;16;3;13;.813;3600000;0
3091;-1;734;0;0;0;0;.00nan;0;0
3092;8505;764;0;0;0;0;.00nan;0;0
3092;61272;748;0;0;0;0;.00nan;0;0
3092;67362;764;90;37;2;35;.946;3600000;0
3092;88646;748;60;39;4;35;.897;3584000;0
3093;195867;2168;0;0;0;0;.00nan;0;0
3093;185413;740;76;29;2;27;.931;3600000;0
3093;196715;740;0;0;0;0;.00nan;0;0
3093;85670;2168;99;33;1;32;.970;3600000;0
3094;83;737;66;26;2;24;.923;3600000;0
3094;1957;733;97;57;3;54;.947;3571000;0
3094;6079;733;0;0;0;0;.00nan;0;0
3094;190570;737;0;0;0;0;.00nan;0;0
3095;178098;738;0;0;0;0;.00nan;0;0
3095;185442;738;65;40;4;36;.900;3600000;0
3095;-1;744;0;0;0;0;.00nan;0;0
3095;49900;744;93;19;0;19;1.000;3600000;0
3096;3756;752;86;42;3;39;.929;3600000;0
3096;43731;752;0;0;0;0;.00nan;0;0
3096;85281;749;78;21;1;20;.952;3600000;0
3096;139409;749;0;0;0;0;.00nan;0;0
3097;175764;729;0;0;0;0;.00nan;0;0
3097;46792;729;91;31;1;30;.968;3600000;0
3097;76405;732;86;34;2;32;.941;3571000;0
3097;148788;732;0;0;0;0;.00nan;0;0
3098;2643;742;94;34;1;33;.971;3600000;0
3098;196698;747;0;0;0;0;.00nan;0;0
3098;43971;742;0;0;0;0;.00nan;0;0
3098;57107;747;63;29;3;26;.897;3600000;0
3099;3508;751;45;30;5;25;.833;3600000;0
3099;33044;741;45;5;1;4;.800;579000;0
3099;-1;751;0;0;0;0;.00nan;0;0
3099;56565;741;34;34;6;28;.824;2989000;0
3100;83;737;49;25;4;21;.840;3576000;0
3100;190570;737;0;0;0;0;.00nan;0;0
3100;-1;3789;0;0;0;0;.00nan;0;0
3100;149280;3789;64;30;3;27;.900;3600000;0
3101;201075;736;0;0;0;0;.00nan;0;0
3101;186219;736;80;34;1;33;.971;3555000;0
3101;61272;748;0;0;0;0;.00nan;0;0
3101;88646;748;100;36;0;36;1.000;3600000;0
3102;44526;734;64;44;4;40;.909;3600000;0
3102;192386;745;0;0;0;0;.00nan;0;0
3102;-1;734;0;0;0;0;.00nan;0;0
3102;75268;745;65;22;2;20;.909;3600000;0
3103;2643;742;45;21;3;18;.857;3600000;0
3103;195867;2168;0;0;0;0;.00nan;0;0
3103;43971;742;0;0;0;0;.00nan;0;0
3103;85670;2168;71;32;2;30;.938;3600000;0
3104;178098;738;59;29;4;25;.862;3659000;0
3104;185413;740;79;40;3;37;.925;3659000;0
3104;185442;738;0;0;0;0;.00nan;0;0
3104;196715;740;0;0;0;0;.00nan;0;0
3105;188561;739;0;0;0;0;.00nan;0;0
3105;-1;744;0;0;0;0;.00nan;0;0
3105;186234;739;68;32;3;29;.906;3600000;0
3105;49900;744;100;23;0;23;1.000;3600000;0
3106;848;743;67;43;5;38;.884;3600000;0
3106;175764;729;0;0;0;0;.00nan;0;0
3106;190589;743;0;0;0;0;.00nan;0;0
3106;46792;729;93;31;1;30;.968;3600000;0
3107;8505;764;0;0;0;0;.00nan;0;0
3107;33044;741;0;0;0;0;.00nan;0;0
3107;56565;741;64;27;3;24;.889;3600000;0
3107;67362;764;84;31;1;30;.968;3600000;0
3108;3508;751;93;29;1;28;.966;3600000;0
3108;196698;747;0;0;0;0;.00nan;0;0
3108;-1;751;0;0;0;0;.00nan;0;0
3108;57107;747;94;37;2;35;.946;3545000;0
3109;1957;733;97;44;1;43;.977;3600000;0
3109;6079;733;0;0;0;0;.00nan;0;0
3109;76405;732;100;26;0;26;1.000;3600000;0
3109;148788;732;0;0;0;0;.00nan;0;0
3110;83;737;59;31;3;28;.903;3600000;0
3110;190570;737;0;0;0;0;.00nan;0;0
3110;44526;734;100;31;0;31;1.000;3600000;0
3110;-1;734;0;0;0;0;.00nan;0;0
3111;3756;752;100;36;0;36;1.000;3600000;0
3111;43731;752;0;0;0;0;.00nan;0;0
3111;-1;3789;0;0;0;0;.00nan;0;0
3111;149280;3789;65;28;3;25;.893;3600000;0
3112;201075;736;59;47;7;40;.851;3600000;0
3112;186219;736;0;0;0;0;.00nan;0;0
3112;85281;749;64;23;2;21;.913;3600000;0
3112;139409;749;0;0;0;0;.00nan;0;0
3113;8505;764;0;0;0;0;.00nan;0;0
3113;67362;764;85;27;1;26;.963;3600000;0
3113;76405;732;61;22;2;20;.909;3600000;0
3113;148788;732;0;0;0;0;.00nan;0;0
3114;2643;742;52;32;5;27;.844;3533000;0
3114;43971;742;0;0;0;0;.00nan;0;0
3114;61272;748;0;0;0;0;.00nan;0;0
3114;88646;748;57;25;3;22;.880;3600000;0
3115;33044;741;0;0;0;0;.00nan;0;0
3115;196698;747;0;0;0;0;.00nan;0;0
3115;56565;741;66;34;3;31;.912;3565000;0
3115;57107;747;73;31;2;29;.935;3600000;0
3116;1957;733;0;0;0;0;.00nan;0;0
3116;6079;733;60;33;3;30;.909;3600000;0
3116;185413;740;0;0;0;0;.00nan;0;0
3116;196715;740;72;34;4;30;.882;3574000;0
3117;190607;1880;0;0;0;0;.00nan;0;0
3117;-1;744;0;0;0;0;.00nan;0;0
3117;49900;744;76;39;3;36;.923;3561000;0
3117;49935;1880;66;21;2;19;.905;3600000;0
3118;848;743;97;42;2;40;.952;3550000;0
3118;190589;743;0;0;0;0;.00nan;0;0
3118;192386;745;0;0;0;0;.00nan;0;0
3118;75268;745;100;37;1;36;.973;3600000;0
3119;178098;738;0;0;0;0;.00nan;0;0
3119;185442;738;77;42;4;38;.905;3600000;0
3119;44526;734;92;24;0;24;1.000;3600000;0
3119;-1;734;0;0;0;0;.00nan;0;0
3120;3756;752;100;41;1;40;.976;3600000;0
3120;201075;736;0;0;0;0;.00nan;0;0
3120;186219;736;22;34;7;27;.794;3600000;0
3120;43731;752;0;0;0;0;.00nan;0;0
3121;-1;3789;0;0;0;0;.00nan;0;0
3121;85281;749;59;23;2;21;.913;3520000;0
3121;139409;749;0;0;0;0;.00nan;0;0
3121;149280;3789;100;34;0;34;1.000;3600000;0
3122;195867;2168;0;0;0;0;.00nan;0;0
3122;190607;1880;0;0;0;0;.00nan;0;0
3122;49935;1880;85;32;2;30;.938;3600000;0
3122;85670;2168;48;37;5;32;.865;3600000;0
3123;83;737;85;42;4;38;.905;3573000;0
3123;175764;729;0;0;0;0;.00nan;0;0
3123;190570;737;0;0;0;0;.00nan;0;0
3123;46792;729;64;30;3;27;.900;3600000;0
3124;188561;739;0;0;0;0;.00nan;0;0
3124;186234;739;78;28;2;26;.929;3600000;0
3124;61272;748;0;0;0;0;.00nan;0;0
3124;88646;748;63;32;3;29;.906;3595000;0
3125;33044;741;77;36;3;33;.917;3525000;0
3125;185413;740;70;20;1;19;.950;3600000;0
3125;196715;740;0;0;0;0;.00nan;0;0
3125;56565;741;0;0;0;0;.00nan;0;0
3126;192386;745;0;0;0;0;.00nan;0;0
3126;75268;745;95;34;1;33;.971;3600000;0
3126;76405;732;69;42;4;38;.905;3600000;0
3126;148788;732;0;0;0;0;.00nan;0;0
3127;848;743;71;42;4;38;.905;3600000;0
3127;190589;743;0;0;0;0;.00nan;0;0
3127;-1;744;0;0;0;0;.00nan;0;0
3127;49900;744;85;17;0;17;1.000;3600000;0
3128;3756;752;44;32;6;26;.813;3158000;0
3128;43731;752;53;5;0;5;1.000;367000;0
3128;85281;749;64;35;4;31;.886;3600000;0
3128;139409;749;0;0;0;0;.00nan;0;0
3129;2643;742;75;34;3;31;.912;3600000;0
3129;8505;764;0;0;0;0;.00nan;0;0
3129;43971;742;0;0;0;0;.00nan;0;0
3129;67362;764;79;31;2;29;.935;3600000;0
3130;-1;3789;0;0;0;0;.00nan;0;0
3130;61272;748;51;23;3;20;.870;3600000;0
3130;88646;748;0;0;0;0;.00nan;0;0
3130;149280;3789;84;21;0;21;1.000;3600000;0
3131;1957;733;77;43;5;38;.884;3600000;0
3131;6079;733;0;0;0;0;.00nan;0;0
3131;178098;738;0;0;0;0;.00nan;0;0
3131;185442;738;71;23;2;21;.913;3600000;0
3132;3508;751;100;25;0;25;1.000;3600000;0
3132;190607;1880;0;0;0;0;.00nan;0;0
3132;-1;751;0;0;0;0;.00nan;0;0
3132;49935;1880;73;31;2;29;.935;3576000;0
3133;83;737;75;33;2;31;.939;3900000;0
3133;190570;737;0;0;0;0;.00nan;0;0
3133;44526;734;95;53;2;51;.962;3900000;0
3133;-1;734;0;0;0;0;.00nan;0;0
3134;175764;729;0;0;0;0;.00nan;0;0
3134;185413;740;0;0;0;0;.00nan;0;0
3134;196715;740;91;39;2;37;.949;3600000;0
3134;46792;729;55;31;4;27;.871;3536000;0
3135;-1;744;0;0;0;0;.00nan;0;0
3135;192386;745;0;0;0;0;.00nan;0;0
3135;49900;744;100;44;4;40;.909;3900000;0
3135;75268;745;49;28;4;24;.857;3900000;0
3136;8505;764;0;0;0;0;.00nan;0;0
3136;195867;2168;67;13;0;13;1.000;1265000;0
3136;67362;764;60;16;2;14;.875;3600000;0
3136;85670;2168;25;27;6;21;.778;2335000;0
3137;188561;739;0;0;0;0;.00nan;0;0
3137;186234;739;93;36;1;35;.972;3900000;0
3137;76405;732;88;20;1;19;.950;3900000;0
3137;148788;732;0;0;0;0;.00nan;0;0
3138;61272;748;0;0;0;0;.00nan;0;0
3138;85281;749;66;28;3;25;.893;3900000;0
3138;88646;748;70;31;3;28;.903;3900000;0
3138;139409;749;0;0;0;0;.00nan;0;0
3139;848;743;90;37;1;36;.973;3600000;0
3139;190589;743;0;0;0;0;.00nan;0;0
3139;196698;747;0;0;0;0;.00nan;0;0
3139;57107;747;74;33;2;31;.939;3593000;0
3140;2643;742;70;29;3;26;.897;3759000;0
3140;3508;751;86;47;4;43;.915;3759000;0
3140;-1;751;0;0;0;0;.00nan;0;0
3140;43971;742;0;0;0;0;.00nan;0;0
3141;3756;752;99;49;1;48;.980;3600000;0
3141;43731;752;0;0;0;0;.00nan;0;0
3141;44526;734;64;28;2;26;.929;3544000;0
3141;-1;734;0;0;0;0;.00nan;0;0
3142;1957;733;100;30;0;30;1.000;3600000;0
3142;6079;733;0;0;0;0;.00nan;0;0
3142;190607;1880;0;0;0;0;.00nan;0;0
3142;49935;1880;71;21;2;19;.905;3588000;0
3143;201075;736;90;44;3;41;.932;3600000;0
3143;175764;729;73;22;1;21;.955;3173000;0
3143;186219;736;0;0;0;0;.00nan;0;0
3143;46792;729;28;7;3;4;.571;396000;0
3144;178098;738;66;28;3;25;.893;3699000;0
3144;33044;741;0;0;0;0;.00nan;0;0
3144;185442;738;0;0;0;0;.00nan;0;0
3144;56565;741;86;38;2;36;.947;3699000;0
3145;188561;739;81;42;4;38;.905;3561000;0
3145;186234;739;0;0;0;0;.00nan;0;0
3145;192386;745;0;0;0;0;.00nan;0;0
3145;75268;745;81;31;2;29;.935;3600000;0
3146;848;743;98;49;2;47;.959;3583000;0
3146;190589;743;0;0;0;0;.00nan;0;0
3146;61272;748;0;0;0;0;.00nan;0;0
3146;88646;748;100;33;0;33;1.000;3600000;0
3147;196698;747;52;25;2;23;.920;3521000;0
3147;57107;747;0;0;0;0;.00nan;0;0
3147;76405;732;0;0;0;0;.00nan;0;0
3147;148788;732;100;40;0;40;1.000;3600000;0
3148;2643;742;42;33;6;27;.818;3600000;0
3148;-1;744;0;0;0;0;.00nan;0;0
3148;43971;742;0;0;0;0;.00nan;0;0
3148;49900;744;85;22;1;21;.955;3600000;0
3149;195867;2168;0;0;0;0;.00nan;0;0
3149;-1;3789;0;0;0;0;.00nan;0;0
3149;85670;2168;78;42;4;38;.905;3600000;0
3149;149280;3789;87;28;1;27;.964;3600000;0
3150;1957;733;98;48;2;46;.958;3573000;0
3150;6079;733;0;0;0;0;.00nan;0;0
3150;8505;764;77;26;1;25;.962;3600000;0
3150;67362;764;0;0;0;0;.00nan;0;0
3151;178098;738;79;32;2;30;.938;3600000;0
3151;185413;740;48;29;4;25;.862;3593000;0
3151;185442;738;0;0;0;0;.00nan;0;0
3151;196715;740;0;0;0;0;.00nan;0;0
3152;201075;736;0;0;0;0;.00nan;0;0
3152;175764;729;0;0;0;0;.00nan;0;0
3152;186219;736;82;39;2;37;.949;3576000;0
3152;46792;729;75;16;1;15;.938;3600000;0
3153;83;737;48;20;3;17;.850;3544000;0
3153;33044;741;0;0;0;0;.00nan;0;0
3153;190570;737;0;0;0;0;.00nan;0;0
3153;56565;741;80;32;2;30;.938;3600000;0
3154;44526;734;78;40;3;37;.925;3529000;0
3154;-1;734;0;0;0;0;.00nan;0;0
3154;85281;749;0;0;0;0;.00nan;0;0
3154;139409;749;77;22;1;21;.955;3600000;0
3155;3508;751;0;0;0;0;.00nan;0;0
3155;3756;752;46;34;6;28;.824;3082000;0
3155;-1;751;94;30;1;29;.967;3600000;0
3155;43731;752;44;4;1;3;.750;518000;0
3156;3508;751;100;32;0;32;1.000;3600000;0
3156;195867;2168;0;0;0;0;.00nan;0;0
3156;-1;751;0;0;0;0;.00nan;0;0
3156;85670;2168;77;43;5;38;.884;3600000;0
3157;-1;744;0;0;0;0;.00nan;0;0
3157;-1;3789;0;0;0;0;.00nan;0;0
3157;49900;744;57;29;4;25;.862;3583000;0
3157;149280;3789;42;18;3;15;.833;3600000;0
3158;188561;739;0;0;0;0;.00nan;0;0
3158;201075;736;49;45;6;39;.867;2849000;0
3158;186219;736;41;2;1;1;.500;751000;0
3158;186234;739;68;31;3;28;.903;3600000;0
3159;848;743;93;41;2;39;.951;3661000;0
3159;190589;743;0;0;0;0;.00nan;0;0
3159;185413;740;0;0;0;0;.00nan;0;0
3159;196715;740;98;29;1;28;.966;3661000;0
3160;83;737;53;35;5;30;.857;3600000;0
3160;8505;764;0;0;0;0;.00nan;0;0
3160;190570;737;0;0;0;0;.00nan;0;0
3160;67362;764;43;22;4;18;.818;3600000;0
3161;44526;734;68;24;3;21;.875;3600000;0
3161;-1;734;0;0;0;0;.00nan;0;0
3161;61272;748;0;0;0;0;.00nan;0;0
3161;88646;748;47;14;2;12;.857;3600000;0
3162;178098;738;0;0;0;0;.00nan;0;0
3162;185442;738;43;39;6;33;.846;3600000;0
3162;76405;732;0;0;0;0;.00nan;0;0
3162;148788;732;99;41;2;39;.951;3600000;0
3163;190607;1880;0;0;0;0;.00nan;0;0
3163;196698;747;0;0;0;0;.00nan;0;0
3163;49935;1880;92;36;2;34;.944;3900000;0
3163;57107;747;80;26;2;24;.923;3900000;0
3164;1957;733;28;9;3;6;.667;230000;0
3164;6079;733;70;48;5;43;.896;3370000;0
3164;192386;745;0;0;0;0;.00nan;0;0
3164;75268;745;68;23;2;21;.913;3600000;0
3165;3756;752;47;44;7;37;.841;3138000;0
3165;43731;752;59;6;0;6;1.000;462000;0
3165;85281;749;78;25;1;24;.960;3600000;0
3165;139409;749;0;0;0;0;.00nan;0;0
3166;178098;738;61;26;2;24;.923;3564000;0
3166;185442;738;0;0;0;0;.00nan;0;0
3166;-1;3789;0;0;0;0;.00nan;0;0
3166;149280;3789;79;23;1;22;.957;3600000;0
3167;848;743;90;36;2;34;.944;3551000;0
3167;2643;742;100;41;1;40;.976;3600000;0
3167;190589;743;0;0;0;0;.00nan;0;0
3167;43971;742;0;0;0;0;.00nan;0;0
3168;175764;729;79;23;1;22;.957;3600000;0
3168;-1;744;0;0;0;0;.00nan;0;0
3168;46792;729;0;0;0;0;.00nan;0;0
3168;49900;744;63;31;3;28;.903;3600000;0
3169;8505;764;0;0;0;0;.00nan;0;0
3169;185413;740;56;34;4;30;.882;3687000;0
3169;196715;740;0;0;0;0;.00nan;0;0
3169;67362;764;61;26;3;23;.885;3687000;0
3170;195867;2168;0;0;0;0;.00nan;0;0
3170;61272;748;0;0;0;0;.00nan;0;0
3170;85670;2168;81;31;2;29;.935;3600000;0
3170;88646;748;53;34;5;29;.853;3600000;0
3171;201075;736;30;31;6;25;.806;3213000;0
3171;186219;736;45;4;1;3;.750;387000;0
3171;76405;732;78;37;3;34;.919;3600000;0
3171;148788;732;0;0;0;0;.00nan;0;0
3172;1957;733;98;45;2;43;.956;3600000;0
3172;6079;733;0;0;0;0;.00nan;0;0
3172;33044;741;0;0;0;0;.00nan;0;0
3172;56565;741;66;15;1;14;.933;3600000;0
3173;83;737;74;32;3;29;.906;3535000;0
3173;190570;737;0;0;0;0;.00nan;0;0
3173;190607;1880;0;0;0;0;.00nan;0;0
3173;49935;1880;80;27;1;26;.963;3600000;0
3174;3756;752;0;0;0;0;.00nan;0;0
3174;43731;752;32;38;7;31;.816;3600000;0
3174;85281;749;0;0;0;0;.00nan;0;0
3174;139409;749;96;37;1;36;.973;3600000;0
3175;196698;747;0;0;0;0;.00nan;0;0
3175;192386;745;0;0;0;0;.00nan;0;0
3175;57107;747;56;27;3;24;.889;3600000;0
3175;75268;745;81;52;4;48;.923;3544000;0
3176;3508;751;94;43;3;40;.930;3900000;0
3176;-1;744;0;0;0;0;.00nan;0;0
3176;192065;751;0;0;0;0;.00nan;0;0
3176;49900;744;66;24;3;21;.875;3900000;0
3177;190607;1880;0;0;0;0;.00nan;0;0
3177;44526;734;67;28;3;25;.893;3600000;0
3177;-1;734;0;0;0;0;.00nan;0;0
3177;49935;1880;58;33;4;29;.879;3552000;0
3178;83;737;52;15;1;14;.933;3900000;0
3178;178098;738;100;51;1;50;.980;3900000;0
3178;190570;737;0;0;0;0;.00nan;0;0
3178;185442;738;0;0;0;0;.00nan;0;0
3179;848;743;84;36;3;33;.917;3600000;0
3179;190589;743;0;0;0;0;.00nan;0;0
3179;61272;748;0;0;0;0;.00nan;0;0
3179;88646;748;64;37;5;32;.865;3569000;0
3180;187925;3789;0;0;0;0;.00nan;0;0
3180;175764;729;0;0;0;0;.00nan;0;0
3180;46792;729;69;32;3;29;.906;3567000;0
3180;149280;3789;95;32;1;31;.969;3600000;0
3181;185413;740;79;49;4;45;.918;3783000;0
3181;196715;740;0;0;0;0;.00nan;0;0
3181;76405;732;80;32;3;29;.906;3783000;0
3181;148788;732;0;0;0;0;.00nan;0;0
3182;195867;2168;0;0;0;0;.00nan;0;0
3182;196698;747;0;0;0;0;.00nan;0;0
3182;57107;747;83;20;1;19;.950;3600000;0
3182;85670;2168;90;59;6;53;.898;3600000;0
3183;1957;733;79;37;3;34;.919;3600000;0
3183;6079;733;0;0;0;0;.00nan;0;0
3183;201075;736;30;10;3;7;.700;432000;0
3183;186219;736;79;27;1;26;.963;3168000;0
3184;33044;741;0;0;0;0;.00nan;0;0
3184;192386;745;0;0;0;0;.00nan;0;0
3184;56565;741;76;29;2;27;.931;3585000;0
3184;75268;745;81;27;1;26;.963;3600000;0
3185;3756;752;50;38;5;33;.868;3600000;0
3185;43731;752;0;0;0;0;.00nan;0;0
3185;85281;749;77;28;2;26;.929;3600000;0
3185;139409;749;0;0;0;0;.00nan;0;0
3186;3508;751;75;32;2;30;.938;3600000;0
3186;201075;736;63;32;3;29;.906;3551000;0
3186;186219;736;0;0;0;0;.00nan;0;0
3186;-1;751;0;0;0;0;.00nan;0;0
3187;187925;3789;0;0;0;0;.00nan;0;0
3187;185413;740;0;0;0;0;.00nan;0;0
3187;52204;740;81;37;4;33;.892;3600000;0
3187;149280;3789;66;21;2;19;.905;3600000;0
3188;178098;738;79;24;1;23;.958;3600000;0
3188;33044;741;0;0;0;0;.00nan;0;0
3188;185442;738;0;0;0;0;.00nan;0;0
3188;56565;741;89;38;2;36;.947;3600000;0
3189;848;743;91;37;2;35;.946;3600000;0
3189;190589;743;0;0;0;0;.00nan;0;0
3189;61272;748;0;0;0;0;.00nan;0;0
3189;88646;748;76;30;3;27;.900;3541000;0
3190;175764;729;0;0;0;0;.00nan;0;0
3190;190607;1880;0;0;0;0;.00nan;0;0
3190;46792;729;92;42;3;39;.929;3577000;0
3190;49935;1880;86;31;2;29;.935;3600000;0
3191;2643;742;0;0;0;0;.00nan;0;0
3191;195867;2168;0;0;0;0;.00nan;0;0
3191;43971;742;63;21;2;19;.905;3600000;0
3191;85670;2168;83;36;3;33;.917;3600000;0
3192;83;737;100;33;0;33;1.000;3600000;0
3192;1957;733;66;48;5;43;.896;3600000;0
3192;6079;733;0;0;0;0;.00nan;0;0
3192;190570;737;0;0;0;0;.00nan;0;0
3193;-1;744;0;0;0;0;.00nan;0;0
3193;192386;745;0;0;0;0;.00nan;0;0
3193;49900;744;83;35;3;32;.914;3600000;0
3193;75268;745;52;37;5;32;.865;3570000;0
3194;188561;739;0;0;0;0;.00nan;0;0
3194;33044;741;0;0;0;0;.00nan;0;0
3194;186234;739;50;22;3;19;.864;3600000;0
3194;56565;741;61;39;5;34;.872;3569000;0
3195;3756;752;100;40;0;40;1.000;3600000;0
3195;8505;764;0;0;0;0;.00nan;0;0
3195;43731;752;0;0;0;0;.00nan;0;0
3195;67362;764;79;33;2;31;.939;3551000;0
3196;196698;747;0;0;0;0;.00nan;0;0
3196;57107;747;45;43;7;36;.837;3600000;0
3196;85281;749;28;14;4;10;.714;3600000;0
3196;139409;749;0;0;0;0;.00nan;0;0
3197;44526;734;85;26;1;25;.962;3600000;0
3197;-1;734;0;0;0;0;.00nan;0;0
3197;76405;732;0;0;0;0;.00nan;0;0
3197;148788;732;98;46;3;43;.935;3521000;0
3198;201075;736;0;0;0;0;.00nan;0;0
3198;195867;2168;0;0;0;0;.00nan;0;0
3198;186219;736;59;25;3;22;.880;3600000;0
3198;85670;2168;51;26;4;22;.846;3592000;0
3199;83;737;64;32;3;29;.906;3600000;0
3199;175764;729;60;35;4;31;.886;3570000;0
3199;190570;737;0;0;0;0;.00nan;0;0
3199;46792;729;0;0;0;0;.00nan;0;0
3200;1957;733;72;47;5;42;.894;3600000;0
3200;6079;733;0;0;0;0;.00nan;0;0
3200;185413;740;0;0;0;0;.00nan;0;0
3200;52204;740;52;13;2;11;.846;3600000;0
3201;2643;742;92;29;1;28;.966;3600000;0
3201;178098;738;76;33;2;31;.939;3581000;0
3201;185442;738;0;0;0;0;.00nan;0;0
3201;43971;742;0;0;0;0;.00nan;0;0
3202;-1;744;0;0;0;0;.00nan;0;0
3202;49900;744;73;34;3;31;.912;3900000;0
3202;61272;748;0;0;0;0;.00nan;0;0
3202;88646;748;79;44;3;41;.932;3900000;0
3203;3508;751;73;29;2;27;.931;3600000;0
3203;8505;764;0;0;0;0;.00nan;0;0
3203;-1;751;0;0;0;0;.00nan;0;0
3203;67362;764;65;33;4;29;.879;3513000;0
3204;187925;3789;0;0;0;0;.00nan;0;0
3204;85281;749;100;38;0;38;1.000;3600000;0
3204;139409;749;0;0;0;0;.00nan;0;0
3204;149280;3789;76;35;3;32;.914;3600000;0
3205;848;743;77;41;4;37;.902;3600000;0
3205;190589;743;0;0;0;0;.00nan;0;0
3205;192386;745;0;0;0;0;.00nan;0;0
3205;75268;745;96;22;0;22;1.000;3600000;0
3206;188561;739;0;0;0;0;.00nan;0;0
3206;186234;739;82;46;3;43;.935;3515000;0
3206;76405;732;65;22;1;21;.955;3600000;0
3206;148788;732;0;0;0;0;.00nan;0;0
3207;190607;1880;0;0;0;0;.00nan;0;0
3207;44526;734;60;31;3;28;.903;3600000;0
3207;-1;734;0;0;0;0;.00nan;0;0
3207;49935;1880;100;43;0;43;1.000;3600000;0
3208;83;737;87;29;1;28;.966;3600000;0
3208;190570;737;0;0;0;0;.00nan;0;0
3208;196698;747;0;0;0;0;.00nan;0;0
3208;57107;747;80;34;2;32;.941;3600000;0
3209;1957;733;51;30;4;26;.867;3585000;0
3209;6079;733;0;0;0;0;.00nan;0;0
3209;178098;738;77;29;2;27;.931;3600000;0
3209;185442;738;0;0;0;0;.00nan;0;0
3210;2643;742;59;33;4;29;.879;3632000;0
3210;3756;752;56;23;3;20;.870;3632000;0
3210;43731;752;0;0;0;0;.00nan;0;0
3210;43971;742;0;0;0;0;.00nan;0;0
3211;187925;3789;0;0;0;0;.00nan;0;0
3211;33044;741;0;0;0;0;.00nan;0;0
3211;56565;741;98;46;2;44;.957;3547000;0
3211;149280;3789;100;34;1;33;.971;3600000;0
3212;44526;734;61;31;3;28;.903;3589000;0
3212;192386;745;0;0;0;0;.00nan;0;0
3212;-1;734;0;0;0;0;.00nan;0;0
3212;75268;745;99;36;1;35;.972;3600000;0
3213;188561;739;68;36;3;33;.917;3600000;0
3213;175764;729;0;0;0;0;.00nan;0;0
3213;186234;739;0;0;0;0;.00nan;0;0
3213;46792;729;67;16;1;15;.938;3600000;0
3214;848;743;89;33;1;32;.970;3600000;0
3214;8505;764;0;0;0;0;.00nan;0;0
3214;190589;743;0;0;0;0;.00nan;0;0
3214;67362;764;48;31;5;26;.839;3600000;0
3215;185413;740;0;0;0;0;.00nan;0;0
3215;52204;740;100;32;0;32;1.000;3600000;0
3215;76405;732;81;26;1;25;.962;3586000;0
3215;148788;732;0;0;0;0;.00nan;0;0
3216;3508;751;71;30;3;27;.900;3650000;0
3216;-1;751;0;0;0;0;.00nan;0;0
3216;61272;748;0;0;0;0;.00nan;0;0
3216;88646;748;77;23;2;21;.913;3650000;0
3217;201075;736;17;28;7;21;.750;2611000;0
3217;186219;736;60;8;1;7;.875;989000;0
3217;85281;749;73;28;2;26;.929;3600000;0
3217;139409;749;0;0;0;0;.00nan;0;0
3218;83;737;23;17;5;12;.706;3550000;0
3218;1957;733;74;30;3;27;.900;3600000;0
3218;6079;733;0;0;0;0;.00nan;0;0
3218;-1;737;0;0;0;0;.00nan;0;0
3219;2643;742;71;36;3;33;.917;3572000;0
3219;3756;752;85;30;2;28;.933;3600000;0
3219;43731;752;0;0;0;0;.00nan;0;0
3219;43971;742;0;0;0;0;.00nan;0;0
3220;8505;764;0;0;0;0;.00nan;0;0
3220;49900;744;65;31;4;27;.871;3600000;0
3220;67362;764;100;35;1;34;.971;3600000;0
3220;94018;744;0;0;0;0;.00nan;0;0
3221;195867;2168;0;0;0;0;.00nan;0;0
3221;-1;751;0;0;0;0;.00nan;0;0
3221;85670;2168;58;28;3;25;.893;3600000;0
3221;148788;751;66;38;4;34;.895;3563000;0
3222;3508;739;7;27;8;19;.704;3600000;0
3222;187925;3789;0;0;0;0;.00nan;0;0
3222;188561;739;0;0;0;0;.00nan;0;0
3222;149280;3789;100;30;1;29;.967;3600000;0
3223;44526;734;45;12;3;9;.750;3600000;0
3223;192386;734;0;0;0;0;.00nan;0;0
3223;76405;732;68;55;6;49;.891;3340000;0
3223;81733;732;52;3;0;3;1.000;260000;0
3224;848;743;74;31;2;29;.935;3558000;0
3224;178098;738;0;0;0;0;.00nan;0;0
3224;190589;743;0;0;0;0;.00nan;0;0
3224;185442;738;95;31;1;30;.968;3600000;0
3225;175764;729;0;0;0;0;.00nan;0;0
3225;46792;729;72;27;3;24;.889;3900000;0
3225;52204;740;72;43;3;40;.930;3900000;0
3225;93324;740;0;0;0;0;.00nan;0;0
3226;33044;741;0;0;0;0;.00nan;0;0
3226;56565;741;77;42;3;39;.929;3598000;0
3226;61272;748;0;0;0;0;.00nan;0;0
3226;88646;748;74;22;2;20;.909;3600000;0
3227;201075;736;76;43;4;39;.907;3651000;0
3227;196698;747;0;0;0;0;.00nan;0;0
3227;186219;736;0;0;0;0;.00nan;0;0
3227;57107;747;74;41;5;36;.878;3651000;0
3228;279;745;0;0;0;0;.00nan;0;0
3228;190607;1880;0;0;0;0;.00nan;0;0
3228;49935;1880;97;39;2;37;.949;3600000;0
3228;75268;745;42;25;5;20;.800;3600000;0
3229;2643;742;96;36;1;35;.972;3600000;0
3229;43971;742;0;0;0;0;.00nan;0;0
3229;85281;749;0;0;0;0;.00nan;0;0
3229;139409;749;57;34;4;30;.882;3600000;0
3230;196698;747;0;0;0;0;.00nan;0;0
3230;49900;744;74;27;2;25;.926;3600000;0
3230;57107;747;76;35;3;32;.914;3558000;0
3230;94018;744;0;0;0;0;.00nan;0;0
3231;195867;2168;0;0;0;0;.00nan;0;0
3231;33044;741;0;0;0;0;.00nan;0;0
3231;56565;741;65;35;3;32;.914;3600000;0
3231;85670;2168;74;27;2;25;.926;3600000;0
3232;83;737;69;31;2;29;.935;3900000;0
3232;187925;3789;0;0;0;0;.00nan;0;0
3232;-1;737;0;0;0;0;.00nan;0;0
3232;149280;3789;77;29;2;27;.931;3900000;0
3233;848;743;87;33;1;32;.970;3600000;0
3233;190589;743;0;0;0;0;.00nan;0;0
3233;-1;751;0;0;0;0;.00nan;0;0
3233;148788;751;44;23;4;19;.826;3600000;0
3234;178098;738;70;44;5;39;.886;3600000;0
3234;175764;729;0;0;0;0;.00nan;0;0
3234;185442;738;0;0;0;0;.00nan;0;0
3234;46792;729;72;21;1;20;.952;3600000;0
3235;3508;739;97;37;1;36;.973;3600000;0
3235;8505;764;100;32;0;32;1.000;3600000;0
3235;188561;739;0;0;0;0;.00nan;0;0
3235;67362;764;0;0;0;0;.00nan;0;0
3236;279;745;0;0;0;0;.00nan;0;0
3236;1957;733;0;0;0;0;.00nan;0;0
3236;6079;733;100;51;0;51;1.000;3600000;0
3236;75268;745;68;18;1;17;.944;3577000;0
3237;201075;736;0;0;0;0;.00nan;0;0
3237;186219;736;92;41;2;39;.951;3548000;0
3237;44526;734;97;33;1;32;.970;3600000;0
3237;192386;734;0;0;0;0;.00nan;0;0
3238;190607;1880;0;0;0;0;.00nan;0;0
3238;49935;1880;43;11;2;9;.818;3600000;0
3238;76405;732;52;39;6;33;.846;2276000;0
3238;81733;732;40;20;4;16;.800;1324000;0
3239;2643;742;0;0;0;0;.00nan;0;0
3239;43971;742;89;46;3;43;.935;3561000;0
3239;85281;749;90;33;1;32;.970;3600000;0
3239;139409;749;0;0;0;0;.00nan;0;0
3240;196698;747;0;0;0;0;.00nan;0;0
3240;-1;751;0;0;0;0;.00nan;0;0
3240;57107;747;100;43;1;42;.977;3600000;0
3240;148788;751;56;22;3;19;.864;3550000;0
3241;3756;752;84;37;2;35;.946;3600000;0
3241;187925;3789;0;0;0;0;.00nan;0;0
3241;43731;752;0;0;0;0;.00nan;0;0
3241;149280;3789;75;17;1;16;.941;3600000;0
3242;175764;729;0;0;0;0;.00nan;0;0
3242;195867;2168;0;0;0;0;.00nan;0;0
3242;46792;729;56;40;5;35;.875;3600000;0
3242;85670;2168;83;36;2;34;.944;3600000;0
3243;61272;748;0;0;0;0;.00nan;0;0
3243;85281;749;71;24;3;21;.875;3556000;0
3243;88646;748;92;52;2;50;.962;3600000;0
3243;139409;749;0;0;0;0;.00nan;0;0
3244;1957;733;0;0;0;0;.00nan;0;0
3244;6079;733;82;36;2;34;.944;3600000;0
3244;190607;1880;0;0;0;0;.00nan;0;0
3244;49935;1880;43;23;5;18;.783;3600000;0
3245;8505;764;53;31;5;26;.839;3559000;0
3245;201075;736;0;0;0;0;.00nan;0;0
3245;186219;736;89;50;4;46;.920;3600000;0
3245;67362;764;0;0;0;0;.00nan;0;0
3246;279;745;0;0;0;0;.00nan;0;0
3246;33044;741;0;0;0;0;.00nan;0;0
3246;56565;741;91;45;2;43;.956;3600000;0
3246;75268;745;76;25;1;24;.960;3600000;0
3247;3508;739;83;35;2;33;.943;3900000;0
3247;188561;739;0;0;0;0;.00nan;0;0
3247;52204;740;0;0;0;0;.00nan;0;0
3247;93324;740;79;24;2;22;.917;3900000;0
3248;848;743;97;45;2;43;.956;3900000;0
3248;2643;742;67;18;2;16;.889;3900000;0
3248;190589;743;0;0;0;0;.00nan;0;0
3248;43971;742;0;0;0;0;.00nan;0;0
3249;49900;744;63;37;4;33;.892;3600000;0
3249;85281;749;88;25;1;24;.960;3600000;0
3249;94018;744;0;0;0;0;.00nan;0;0
3249;139409;749;0;0;0;0;.00nan;0;0
3250;187925;3789;0;0;0;0;.00nan;0;0
3250;190607;1880;0;0;0;0;.00nan;0;0
3250;49935;1880;62;22;3;19;.864;3600000;0
3250;149280;3789;42;34;5;29;.853;3600000;0
3251;83;737;84;17;0;17;1.000;3600000;0
3251;-1;737;0;0;0;0;.00nan;0;0
3251;76405;732;80;50;4;46;.920;3600000;0
3251;81733;732;0;0;0;0;.00nan;0;0
3252;3756;752;62;36;4;32;.889;3560000;0
3252;43731;752;0;0;0;0;.00nan;0;0
3252;44526;734;0;0;0;0;.00nan;0;0
3252;192386;734;68;33;3;30;.909;3600000;0
3253;2643;742;0;0;0;0;.00nan;0;0
3253;8505;764;0;0;0;0;.00nan;0;0
3253;43971;742;69;32;3;29;.906;3537000;0
3253;67362;764;89;37;2;35;.946;3600000;0
3254;196698;747;0;0;0;0;.00nan;0;0
3254;57107;747;70;28;3;25;.893;3809000;0
3254;61272;748;0;0;0;0;.00nan;0;0
3254;88646;748;59;30;4;26;.867;3809000;0
3255;1957;733;72;37;4;33;.892;3600000;0
3255;6079;733;0;0;0;0;.00nan;0;0
3255;175764;729;0;0;0;0;.00nan;0;0
3255;46792;729;78;18;1;17;.944;3600000;0
3256;279;745;0;0;0;0;.00nan;0;0
3256;201075;736;0;0;0;0;.00nan;0;0
3256;186219;736;51;39;5;34;.872;3600000;0
3256;75268;745;76;11;0;11;1.000;3600000;0
3257;195867;2168;0;0;0;0;.00nan;0;0
3257;33044;741;87;39;2;37;.949;3900000;0
3257;56565;741;0;0;0;0;.00nan;0;0
3257;85670;2168;69;23;2;21;.913;3900000;0
3258;848;743;94;45;3;42;.933;3571000;0
3258;190589;743;0;0;0;0;.00nan;0;0
3258;-1;751;0;0;0;0;.00nan;0;0
3258;148788;751;60;19;2;17;.895;3600000;0
3259;3508;739;59;37;5;32;.865;3600000;0
3259;188561;739;0;0;0;0;.00nan;0;0
3259;178098;738;73;31;2;29;.935;3600000;0
3259;185442;738;0;0;0;0;.00nan;0;0
3260;279;745;0;0;0;0;.00nan;0;0
3260;49900;744;59;28;3;25;.893;3530000;0
3260;75268;745;100;34;1;33;.971;3600000;0
3260;94018;744;0;0;0;0;.00nan;0;0
3261;187925;3789;0;0;0;0;.00nan;0;0
3261;201075;736;0;0;0;0;.00nan;0;0
3261;186219;736;93;48;3;45;.938;3600000;0
3261;149280;3789;100;22;0;22;1.000;3600000;0
3262;83;737;75;35;2;33;.943;3600000;0
3262;3508;739;50;28;5;23;.821;3600000;0
3262;188561;739;0;0;0;0;.00nan;0;0
3262;190570;737;0;0;0;0;.00nan;0;0
3263;178098;738;0;0;0;0;.00nan;0;0
3263;185442;738;79;13;0;13;1.000;3600000;0
3263;76405;732;89;60;5;55;.917;3600000;0
3263;81733;732;0;0;0;0;.00nan;0;0
3264;44526;734;83;28;1;27;.964;3600000;0
3264;192386;734;0;0;0;0;.00nan;0;0
3264;52204;740;93;46;2;44;.957;3550000;0
3264;93324;740;0;0;0;0;.00nan;0;0
3265;195867;2168;0;0;0;0;.00nan;0;0
3265;196698;747;0;0;0;0;.00nan;0;0
3265;57107;747;94;37;2;35;.946;3900000;0
3265;85670;2168;88;39;2;37;.949;3900000;0
3266;1957;733;94;55;1;54;.982;3900000;0
3266;6079;733;0;0;0;0;.00nan;0;0
3266;8505;764;74;18;1;17;.944;3900000;0
3266;67362;764;0;0;0;0;.00nan;0;0
3267;175764;729;0;0;0;0;.00nan;0;0
3267;33044;741;0;0;0;0;.00nan;0;0
3267;46792;729;57;26;3;23;.885;3600000;0
3267;56565;741;97;61;5;56;.918;3536000;0
3268;2643;742;54;41;5;36;.878;3600000;0
3268;190607;1880;0;0;0;0;.00nan;0;0
3268;43971;742;0;0;0;0;.00nan;0;0
3268;49935;1880;90;36;2;34;.944;3600000;0
3269;3756;752;0;0;0;0;.00nan;0;0
3269;43731;752;65;37;4;33;.892;3600000;0
3269;61272;748;0;0;0;0;.00nan;0;0
3269;88646;748;86;23;1;22;.957;3600000;0
3270;-1;751;0;0;0;0;.00nan;0;0
3270;85281;749;79;24;1;23;.958;3547000;0
3270;139409;749;0;0;0;0;.00nan;0;0
3270;148788;751;100;38;0;38;1.000;3600000;0
3271;195867;2168;61;10;0;10;1.000;554000;0
3271;49900;744;0;0;0;0;.00nan;0;0
3271;85670;2168;36;33;6;27;.818;3046000;0
3271;94018;744;58;25;3;22;.880;3600000;0
3272;83;737;65;21;2;19;.905;3600000;0
3272;190570;737;0;0;0;0;.00nan;0;0
3272;52204;740;53;35;4;31;.886;3557000;0
3272;93324;740;0;0;0;0;.00nan;0;0
3273;44526;734;66;16;1;15;.938;3600000;0
3273;192386;734;0;0;0;0;.00nan;0;0
3273;76405;732;74;47;4;43;.915;3600000;0
3273;81733;732;0;0;0;0;.00nan;0;0
3274;178098;738;0;0;0;0;.00nan;0;0
3274;201075;736;54;32;4;28;.875;3600000;0
3274;185442;738;100;19;0;19;1.000;3600000;0
3274;186219;736;0;0;0;0;.00nan;0;0
3275;279;745;0;0;0;0;.00nan;0;0
3275;848;743;81;32;2;30;.938;3731000;0
3275;190589;743;0;0;0;0;.00nan;0;0
3275;75268;745;92;47;3;44;.936;3731000;0
3276;8505;764;0;0;0;0;.00nan;0;0
3276;175764;729;0;0;0;0;.00nan;0;0
3276;46792;729;44;25;4;21;.840;3600000;0
3276;67362;764;89;22;0;22;1.000;3600000;0
3277;3508;739;84;34;2;32;.941;3547000;0
3277;188561;739;0;0;0;0;.00nan;0;0
3277;196698;747;0;0;0;0;.00nan;0;0
3277;57107;747;97;32;1;31;.969;3600000;0
3278;2643;742;55;30;4;26;.867;3562000;0
3278;33044;741;0;0;0;0;.00nan;0;0
3278;43971;742;0;0;0;0;.00nan;0;0
3278;56565;741;69;28;2;26;.929;3600000;0
3279;3756;752;68;29;3;26;.897;3574000;0
3279;43731;752;0;0;0;0;.00nan;0;0
3279;61272;748;0;0;0;0;.00nan;0;0
3279;88646;748;95;40;1;39;.975;3600000;0
3280;1957;733;35;16;4;12;.750;2007000;0
3280;6079;733;62;18;2;16;.889;1593000;0
3280;190607;1880;0;0;0;0;.00nan;0;0
3280;49935;1880;80;18;1;17;.944;3600000;0
3281;-1;751;0;0;0;0;.00nan;0;0
3281;85281;749;0;0;0;0;.00nan;0;0
3281;139409;749;57;20;2;18;.900;3600000;0
3281;148788;751;76;46;4;42;.913;3582000;0
3282;83;737;89;13;0;13;1.000;3600000;0
3282;178098;738;0;0;0;0;.00nan;0;0
3282;190570;737;0;0;0;0;.00nan;0;0
3282;185442;738;36;28;5;23;.821;3600000;0
3283;44526;734;12;27;7;20;.741;3600000;0
3283;192386;734;0;0;0;0;.00nan;0;0
3283;52204;740;96;49;2;47;.959;3600000;0
3283;93324;740;0;0;0;0;.00nan;0;0
3284;848;743;94;44;2;42;.955;3615000;0
3284;175764;729;0;0;0;0;.00nan;0;0
3284;190589;743;0;0;0;0;.00nan;0;0
3284;46792;729;85;29;1;28;.966;3615000;0
3285;8505;764;97;35;1;34;.971;3600000;0
3285;201075;736;0;0;0;0;.00nan;0;0
3285;186219;736;45;36;5;31;.861;3600000;0
3285;67362;764;0;0;0;0;.00nan;0;0
3286;3508;739;72;43;4;39;.907;3600000;0
3286;187925;3789;0;0;0;0;.00nan;0;0
3286;188561;739;0;0;0;0;.00nan;0;0
3286;149280;3789;93;23;0;23;1.000;3600000;0
3287;3756;752;48;42;7;35;.833;3600000;0
3287;-1;751;0;0;0;0;.00nan;0;0
3287;43731;752;0;0;0;0;.00nan;0;0
3287;148788;751;76;25;1;24;.960;3600000;0
3288;2643;742;0;0;0;0;.00nan;0;0
3288;196698;747;0;0;0;0;.00nan;0;0
3288;43971;742;57;33;4;29;.879;3561000;0
3288;57107;747;69;25;3;22;.880;3600000;0
3289;1957;733;56;27;3;24;.889;3600000;0
3289;6079;733;0;0;0;0;.00nan;0;0
3289;76405;732;81;32;2;30;.938;3600000;0
3289;81733;732;0;0;0;0;.00nan;0;0
3290;33044;741;42;4;1;3;.750;297000;0
3290;49900;744;49;26;4;22;.846;3600000;0
3290;56565;741;56;36;4;32;.889;3303000;0
3290;94018;744;0;0;0;0;.00nan;0;0
3291;61272;748;0;0;0;0;.00nan;0;0
3291;85281;749;34;32;6;26;.813;3789000;0
3291;88646;748;65;38;5;33;.868;3789000;0
3291;139409;749;0;0;0;0;.00nan;0;0
3292;178098;738;100;30;0;30;1.000;3600000;0
3292;185442;738;0;0;0;0;.00nan;0;0
3292;52204;740;86;31;1;30;.968;3600000;0
3292;93324;740;0;0;0;0;.00nan;0;0
3293;3756;752;0;0;0;0;.00nan;0;0
3293;-1;751;0;0;0;0;.00nan;0;0
3293;43731;752;84;49;4;45;.918;3600000;0
3293;148788;751;76;19;1;18;.947;3600000;0
3294;279;745;0;0;0;0;.00nan;0;0
3294;848;743;87;31;2;29;.935;3600000;0
3294;190589;743;0;0;0;0;.00nan;0;0
3294;75268;745;54;26;3;23;.885;3582000;0
3295;1957;733;79;51;4;47;.922;3600000;0
3295;187925;3789;0;0;0;0;.00nan;0;0
3295;6079;733;0;0;0;0;.00nan;0;0
3295;149280;3789;88;15;0;15;1.000;3600000;0
3296;33044;741;0;0;0;0;.00nan;0;0
3296;44526;734;48;36;5;31;.861;3900000;0
3296;192386;734;0;0;0;0;.00nan;0;0
3296;56565;741;52;26;5;21;.808;3900000;0
3297;3508;739;54;37;5;32;.865;3600000;0
3297;188561;739;0;0;0;0;.00nan;0;0
3297;196698;747;0;0;0;0;.00nan;0;0
3297;57107;747;82;28;1;27;.964;3600000;0
3298;175764;729;0;0;0;0;.00nan;0;0
3298;190607;1880;0;0;0;0;.00nan;0;0
3298;46792;729;75;29;2;27;.931;3600000;0
3298;49935;1880;74;32;3;29;.906;3541000;0
3299;2643;742;87;29;1;28;.966;3600000;0
3299;43971;742;0;0;0;0;.00nan;0;0
3299;49900;744;74;22;2;20;.909;3544000;0
3299;94018;744;0;0;0;0;.00nan;0;0
3300;8505;764;93;19;0;19;1.000;3600000;0
3300;67362;764;0;0;0;0;.00nan;0;0
3300;76405;732;97;50;2;48;.960;3524000;0
3300;81733;732;0;0;0;0;.00nan;0;0
3301;61272;748;0;0;0;0;.00nan;0;0
3301;85281;749;64;23;2;21;.913;3600000;0
3301;88646;748;34;32;5;27;.844;3600000;0
3301;139409;749;0;0;0;0;.00nan;0;0
3302;848;743;68;34;4;30;.882;3592000;0
3302;195867;2168;57;28;3;25;.893;3600000;0
3302;190589;743;0;0;0;0;.00nan;0;0
3302;85670;2168;0;0;0;0;.00nan;0;0
3303;83;737;88;37;2;35;.946;3546000;0
3303;279;745;0;0;0;0;.00nan;0;0
3303;190570;737;0;0;0;0;.00nan;0;0
3303;75268;745;95;32;1;31;.969;3600000;0
3304;195867;2168;0;0;0;0;.00nan;0;0
3304;196698;747;0;0;0;0;.00nan;0;0
3304;57107;747;62;27;3;24;.889;3600000;0
3304;85670;2168;67;24;2;22;.917;3600000;0
3305;3508;739;98;44;1;43;.977;3570000;0
3305;188561;739;0;0;0;0;.00nan;0;0
3305;44526;734;100;37;0;37;1.000;3600000;0
3305;192386;734;0;0;0;0;.00nan;0;0
3306;2643;742;88;41;3;38;.927;3899000;0
3306;175764;729;0;0;0;0;.00nan;0;0
3306;43971;742;0;0;0;0;.00nan;0;0
3306;46792;729;56;27;3;24;.889;3900000;0
3307;8505;764;0;0;0;0;.00nan;0;0
3307;52204;740;0;0;0;0;.00nan;0;0
3307;67362;764;88;37;2;35;.946;3900000;0
3307;93324;740;73;33;2;31;.939;3900000;0
3308;201075;736;74;41;3;38;.927;3882000;0
3308;186219;736;0;0;0;0;.00nan;0;0
3308;49900;744;69;28;2;26;.929;3882000;0
3308;94018;744;0;0;0;0;.00nan;0;0
3309;190607;1880;0;0;0;0;.00nan;0;0
3309;49935;1880;83;17;0;17;1.000;3600000;0
3309;76405;732;87;44;3;41;.932;3600000;0
3309;81733;732;0;0;0;0;.00nan;0;0
3310;83;737;62;28;3;25;.893;3707000;0
3310;190570;737;0;0;0;0;.00nan;0;0
3310;-1;751;0;0;0;0;.00nan;0;0
3310;148788;751;63;23;2;21;.913;3707000;0
3311;3508;739;61;21;2;19;.905;3786000;0
3311;188561;739;0;0;0;0;.00nan;0;0
3311;44526;734;70;38;3;35;.921;3786000;0
3311;192386;734;0;0;0;0;.00nan;0;0
3312;1957;733;56;37;5;32;.865;3566000;0
3312;3756;752;54;22;3;19;.864;3600000;0
3312;6079;733;0;0;0;0;.00nan;0;0
3312;85633;752;0;0;0;0;.00nan;0;0
3313;187925;3789;0;0;0;0;.00nan;0;0
3313;33044;741;0;0;0;0;.00nan;0;0
3313;56565;741;76;56;5;51;.911;3560000;0
3313;149280;3789;48;21;4;17;.810;3600000;0
3314;279;745;0;0;0;0;.00nan;0;0
3314;75268;745;80;27;1;26;.963;3600000;0
3314;85281;749;64;22;2;20;.909;3548000;0
3314;139409;749;0;0;0;0;.00nan;0;0
3315;848;743;97;50;3;47;.940;3574000;0
3315;190589;743;0;0;0;0;.00nan;0;0
3315;49900;744;58;12;1;11;.917;3600000;0
3315;94018;744;0;0;0;0;.00nan;0;0
3316;2643;742;91;27;1;26;.963;3600000;0
3316;178098;738;84;46;4;42;.913;3600000;0
3316;185442;738;0;0;0;0;.00nan;0;0
3316;43971;742;0;0;0;0;.00nan;0;0
3317;190607;1880;0;0;0;0;.00nan;0;0
3317;49935;1880;80;23;1;22;.957;3600000;0
3317;52204;740;77;41;3;38;.927;3592000;0
3317;93324;740;0;0;0;0;.00nan;0;0
3318;196698;747;0;0;0;0;.00nan;0;0
3318;57107;747;83;31;2;29;.935;3600000;0
3318;61272;748;79;43;4;39;.907;3600000;0
3318;88646;748;0;0;0;0;.00nan;0;0
3319;83;737;57;31;4;27;.871;3512000;0
3319;195867;2168;0;0;0;0;.00nan;0;0
3319;190570;737;0;0;0;0;.00nan;0;0
3319;85670;2168;79;29;2;27;.931;3600000;0
3320;3756;752;71;47;5;42;.894;3600000;0
3320;175764;729;0;0;0;0;.00nan;0;0
3320;46792;729;66;15;1;14;.933;3600000;0
3320;85633;752;0;0;0;0;.00nan;0;0
3321;8505;764;0;0;0;0;.00nan;0;0
3321;67362;764;82;41;3;38;.927;3597000;0
3321;85281;749;63;23;2;21;.913;3600000;0
3321;139409;749;0;0;0;0;.00nan;0;0
3322;1957;733;100;36;1;35;.972;3600000;0
3322;3508;739;62;20;2;18;.900;3600000;0
3322;6079;733;0;0;0;0;.00nan;0;0
3322;188561;739;0;0;0;0;.00nan;0;0
3323;33044;741;0;0;0;0;.00nan;0;0
3323;56565;741;70;14;1;13;.929;3600000;0
3323;76405;732;88;42;3;39;.929;3592000;0
3323;81733;732;0;0;0;0;.00nan;0;0
3324;279;745;0;0;0;0;.00nan;0;0
3324;187925;3789;0;0;0;0;.00nan;0;0
3324;75268;745;73;50;5;45;.900;3600000;0
3324;149280;3789;67;37;4;33;.892;3600000;0
3325;178098;738;0;0;0;0;.00nan;0;0
3325;185442;738;91;36;2;34;.944;3764000;0
3325;44526;734;63;32;3;29;.906;3764000;0
3325;192386;734;0;0;0;0;.00nan;0;0
3326;848;743;93;51;4;47;.922;3600000;0
3326;190589;743;0;0;0;0;.00nan;0;0
3326;190607;1880;0;0;0;0;.00nan;0;0
3326;49935;1880;86;14;0;14;1.000;3600000;0
3327;49900;744;85;14;0;14;1.000;3600000;0
3327;76405;732;98;56;3;53;.946;3600000;0
3327;81733;732;0;0;0;0;.00nan;0;0
3327;94018;744;0;0;0;0;.00nan;0;0
3328;175764;729;94;32;2;30;.938;3900000;0
3328;-1;751;0;0;0;0;.00nan;0;0
3328;46792;729;0;0;0;0;.00nan;0;0
3328;148788;751;97;47;2;45;.957;3900000;0
3329;187925;3789;0;0;0;0;.00nan;0;0
3329;8505;764;0;0;0;0;.00nan;0;0
3329;67362;764;74;40;4;36;.900;3600000;0
3329;149280;3789;70;28;2;26;.929;3600000;0
3330;83;737;82;39;3;36;.923;3600000;0
3330;190570;737;0;0;0;0;.00nan;0;0
3330;52204;740;58;29;4;25;.862;3572000;0
3330;93324;740;0;0;0;0;.00nan;0;0
3331;2643;742;0;0;0;0;.00nan;0;0
3331;43971;742;73;36;3;33;.917;3600000;0
3331;85281;749;0;0;0;0;.00nan;0;0
3331;139409;749;59;35;5;30;.857;3600000;0
3332;3756;752;78;32;2;30;.938;3600000;0
3332;196698;747;0;0;0;0;.00nan;0;0
3332;57107;747;87;44;3;41;.932;3600000;0
3332;85633;752;0;0;0;0;.00nan;0;0
3333;279;745;0;0;0;0;.00nan;0;0
3333;195867;2168;0;0;0;0;.00nan;0;0
3333;75268;745;64;22;2;20;.909;3600000;0
3333;85670;2168;88;41;3;38;.927;3600000;0
3334;848;743;100;38;0;38;1.000;3600000;0
3334;201075;736;0;0;0;0;.00nan;0;0
3334;190589;743;0;0;0;0;.00nan;0;0
3334;186219;736;45;29;4;25;.862;3600000;0
3335;1957;733;66;49;5;44;.898;3572000;0
3335;6079;733;0;0;0;0;.00nan;0;0
3335;44526;734;62;34;4;30;.882;3600000;0
3335;192386;734;0;0;0;0;.00nan;0;0
3336;33044;741;49;31;4;27;.871;3600000;0
3336;56565;741;0;0;0;0;.00nan;0;0
3336;61272;748;0;0;0;0;.00nan;0;0
3336;88646;748;100;17;0;17;1.000;3600000;0
3337;187925;3789;52;26;3;23;.885;3525000;0
3337;-1;751;0;0;0;0;.00nan;0;0
3337;148788;751;71;21;1;20;.952;3600000;0
3337;149280;3789;0;0;0;0;.00nan;0;0
3338;178098;738;70;22;2;20;.909;3600000;0
3338;185442;738;0;0;0;0;.00nan;0;0
3338;76405;732;24;5;3;2;.400;555000;0
3338;81733;732;98;34;1;33;.971;3014000;0
3339;83;737;76;32;2;30;.938;3600000;0
3339;190570;737;0;0;0;0;.00nan;0;0
3339;44526;734;67;47;5;42;.894;3600000;0
3339;192386;734;0;0;0;0;.00nan;0;0
3340;3756;752;0;0;0;0;.00nan;0;0
3340;196698;747;0;0;0;0;.00nan;0;0
3340;57107;747;37;25;5;20;.800;3600000;0
3340;85633;752;61;33;4;29;.879;3600000;0
3341;201075;736;28;27;6;21;.778;3600000;0
3341;175764;729;0;0;0;0;.00nan;0;0
3341;186219;736;0;0;0;0;.00nan;0;0
3341;46792;729;58;24;3;21;.875;3600000;0
3342;2643;742;0;0;0;0;.00nan;0;0
3342;43971;742;71;24;2;22;.917;3600000;0
3342;52204;740;47;35;6;29;.829;3343000;0
3342;93324;740;57;4;0;4;1.000;257000;0
3343;1957;733;94;57;5;52;.912;3571000;0
3343;6079;733;0;0;0;0;.00nan;0;0
3343;195867;2168;0;0;0;0;.00nan;0;0
3343;85670;2168;62;25;3;22;.880;3600000;0
3344;190607;1880;0;0;0;0;.00nan;0;0
3344;49935;1880;70;44;5;39;.886;3608000;0
3344;61272;748;0;0;0;0;.00nan;0;0
3344;88646;748;37;31;6;25;.806;3608000;0
3345;8505;764;97;48;3;45;.938;3600000;0
3345;67362;764;0;0;0;0;.00nan;0;0
3345;85281;749;100;28;0;28;1.000;3600000;0
3345;139409;749;0;0;0;0;.00nan;0;0
3346;279;745;0;0;0;0;.00nan;0;0
3346;49900;744;100;28;0;28;1.000;3900000;0
3346;75268;745;98;45;0;45;1.000;3900000;0
3346;94018;744;0;0;0;0;.00nan;0;0
3347;3508;739;81;27;2;25;.926;3600000;0
3347;188561;739;0;0;0;0;.00nan;0;0
3347;178098;738;0;0;0;0;.00nan;0;0
3347;185442;738;50;31;5;26;.839;3600000;0
3348;-1;751;0;0;0;0;.00nan;0;0
3348;49900;744;51;31;4;27;.871;3553000;0
3348;94018;744;0;0;0;0;.00nan;0;0
3348;148788;751;64;24;3;21;.875;3600000;0
3349;187925;3789;0;0;0;0;.00nan;0;0
3349;61272;748;0;0;0;0;.00nan;0;0
3349;88646;748;79;54;5;49;.907;3565000;0
3349;149280;3789;64;20;2;18;.900;3600000;0
3350;3756;752;72;40;3;37;.925;3513000;0
3350;196698;747;0;0;0;0;.00nan;0;0
3350;57107;747;100;41;1;40;.976;3600000;0
3350;85633;752;0;0;0;0;.00nan;0;0
3351;848;743;99;46;1;45;.978;3600000;0
3351;195867;2168;0;0;0;0;.00nan;0;0
3351;190589;743;0;0;0;0;.00nan;0;0
3351;85670;2168;53;34;5;29;.853;3600000;0
3352;175764;729;0;0;0;0;.00nan;0;0
3352;44526;734;66;38;4;34;.895;3550000;0
3352;192386;734;0;0;0;0;.00nan;0;0
3352;46792;729;57;17;2;15;.882;3600000;0
3353;2643;742;0;0;0;0;.00nan;0;0
3353;33044;741;0;0;0;0;.00nan;0;0
3353;43971;742;83;26;1;25;.962;3600000;0
3353;56565;741;85;44;3;41;.932;3549000;0
3354;83;737;89;18;0;18;1.000;3600000;0
3354;1957;733;87;35;1;34;.971;3600000;0
3354;6079;733;0;0;0;0;.00nan;0;0
3354;190570;737;0;0;0;0;.00nan;0;0
3355;201075;736;0;0;0;0;.00nan;0;0
3355;190607;1880;0;0;0;0;.00nan;0;0
3355;186219;736;49;50;7;43;.860;3600000;0
3355;49935;1880;93;41;3;38;.927;3600000;0
3356;8505;764;81;39;2;37;.949;3600000;0
3356;67362;764;0;0;0;0;.00nan;0;0
3356;85281;749;78;36;4;32;.889;3549000;0
3356;139409;749;0;0;0;0;.00nan;0;0
3357;279;745;0;0;0;0;.00nan;0;0
3357;52204;740;94;39;2;37;.949;3900000;0
3357;75268;745;78;32;2;30;.938;3900000;0
3357;93324;740;0;0;0;0;.00nan;0;0
3358;178098;738;100;28;1;27;.964;3600000;0
3358;185442;738;0;0;0;0;.00nan;0;0
3358;76405;732;0;0;0;0;.00nan;0;0
3358;81733;732;89;39;3;36;.923;3548000;0
3359;33044;741;0;0;0;0;.00nan;0;0
3359;-1;751;0;0;0;0;.00nan;0;0
3359;56565;741;85;37;2;35;.946;3600000;0
3359;148788;751;100;35;1;34;.971;3600000;0
3360;195867;2168;48;13;2;11;.846;1304000;0
3360;49900;744;58;35;4;31;.886;3600000;0
3360;85670;2168;23;26;5;21;.808;2296000;0
3360;94018;744;0;0;0;0;.00nan;0;0
3361;83;737;97;54;3;51;.944;3544000;0
3361;187925;3789;0;0;0;0;.00nan;0;0
3361;190570;737;0;0;0;0;.00nan;0;0
3361;149280;3789;76;30;2;28;.933;3600000;0
3362;44526;734;0;0;0;0;.00nan;0;0
3362;192386;734;66;34;3;31;.912;3756000;0
3362;61272;748;0;0;0;0;.00nan;0;0
3362;88646;748;41;18;4;14;.778;3756000;0
3363;3756;752;59;49;6;43;.878;3600000;0
3363;8505;764;0;0;0;0;.00nan;0;0
3363;67362;764;81;36;3;33;.917;3600000;0
3363;85633;752;0;0;0;0;.00nan;0;0
3364;848;743;57;39;6;33;.846;2874000;0
3364;2643;742;0;0;0;0;.00nan;0;0
3364;190589;743;59;8;0;8;1.000;726000;0
3364;43971;742;66;19;1;18;.947;3600000;0
3365;3508;739;50;23;3;20;.870;3600000;0
3365;188561;739;0;0;0;0;.00nan;0;0
3365;201075;736;83;36;2;34;.944;3600000;0
3365;186219;736;0;0;0;0;.00nan;0;0
3366;196698;747;0;0;0;0;.00nan;0;0
3366;57107;747;53;35;5;30;.857;3600000;0
3366;85281;749;81;31;2;29;.935;3600000;0
3366;139409;749;0;0;0;0;.00nan;0;0
3367;178098;738;0;0;0;0;.00nan;0;0
3367;190607;1880;0;0;0;0;.00nan;0;0
3367;185442;738;67;34;3;31;.912;3600000;0
3367;49935;1880;28;28;6;22;.786;3600000;0
3368;3756;752;0;0;0;0;.00nan;0;0
3368;8505;764;75;24;2;22;.917;3600000;0
3368;67362;764;0;0;0;0;.00nan;0;0
3368;85633;752;54;38;5;33;.868;3600000;0
3369;1957;733;0;0;0;0;.00nan;0;0
3369;6079;733;89;43;2;41;.953;3550000;0
3369;175764;729;0;0;0;0;.00nan;0;0
3369;46792;729;68;17;1;16;.941;3600000;0
3370;3508;739;87;15;0;15;1.000;3600000;0
3370;188561;739;0;0;0;0;.00nan;0;0
3370;201075;736;0;0;0;0;.00nan;0;0
3370;186219;736;85;38;2;36;.947;3567000;0
3371;52204;740;52;20;3;17;.850;3600000;0
3371;76405;732;70;37;4;33;.892;3571000;0
3371;81733;732;0;0;0;0;.00nan;0;0
3371;93324;740;0;0;0;0;.00nan;0;0
3372;196698;747;0;0;0;0;.00nan;0;0
3372;57107;747;71;44;5;39;.886;3600000;0
3372;85281;749;0;0;0;0;.00nan;0;0
3372;139409;749;79;28;2;26;.929;3600000;0
3373;848;743;90;45;2;43;.956;3575000;0
3373;2643;742;82;26;1;25;.962;3600000;0
3373;190589;743;0;0;0;0;.00nan;0;0
3373;43971;742;0;0;0;0;.00nan;0;0
3374;49900;744;94;21;0;21;1.000;3600000;0
3374;61272;748;0;0;0;0;.00nan;0;0
3374;88646;748;67;33;3;30;.909;3600000;0
3374;94018;744;0;0;0;0;.00nan;0;0
3375;195867;2168;0;0;0;0;.00nan;0;0
3375;-1;751;0;0;0;0;.00nan;0;0
3375;85670;2168;73;33;2;31;.939;3575000;0
3375;148788;751;75;22;1;21;.955;3600000;0
3376;83;737;0;0;0;0;.00nan;0;0
3376;190570;737;100;24;0;24;1.000;3600000;0
3376;52204;740;74;27;2;25;.926;3530000;0
3376;93324;740;0;0;0;0;.00nan;0;0
3377;3508;739;100;36;0;36;1.000;3600000;0
3377;188561;739;0;0;0;0;.00nan;0;0
3377;190607;1880;0;0;0;0;.00nan;0;0
3377;49935;1880;78;28;3;25;.893;3600000;0
3378;201075;736;79;38;3;35;.921;3600000;0
3378;186219;736;0;0;0;0;.00nan;0;0
3378;44526;734;84;37;2;35;.946;3600000;0
3378;192386;734;0;0;0;0;.00nan;0;0
3379;175764;729;0;0;0;0;.00nan;0;0
3379;46792;729;100;22;0;22;1.000;3600000;0
3379;76405;732;76;36;2;34;.944;3555000;0
3379;81733;732;0;0;0;0;.00nan;0;0
3380;279;745;0;0;0;0;.00nan;0;0
3380;33044;741;0;0;0;0;.00nan;0;0
3380;56565;741;100;55;1;54;.982;3600000;0
3380;75268;745;61;16;2;14;.875;3557000;0
3381;848;743;61;28;4;24;.857;3600000;0
3381;190589;743;0;0;0;0;.00nan;0;0
3381;196698;747;49;33;5;28;.848;3542000;0
3381;57107;747;0;0;0;0;.00nan;0;0
3382;187925;3789;0;0;0;0;.00nan;0;0
3382;44526;734;100;36;0;36;1.000;3600000;0
3382;192386;734;0;0;0;0;.00nan;0;0
3382;149280;3789;66;25;2;23;.920;3549000;0
3383;83;737;0;0;0;0;.00nan;0;0
3383;1957;733;64;41;4;37;.902;3600000;0
3383;6079;733;0;0;0;0;.00nan;0;0
3383;190570;737;66;22;2;20;.909;3600000;0
3384;3508;739;38;42;7;35;.833;3040000;0
3384;188561;739;51;3;0;3;1.000;560000;0
3384;85281;749;76;30;2;28;.933;3600000;0
3384;139409;749;0;0;0;0;.00nan;0;0
3385;8505;764;58;13;1;12;.923;1140000;0
3385;-1;751;0;0;0;0;.00nan;0;0
3385;67362;764;21;26;6;20;.769;2460000;0
3385;148788;751;68;35;3;32;.914;3600000;0
3386;178098;738;69;29;2;27;.931;3900000;0
3386;185442;738;0;0;0;0;.00nan;0;0
3386;52204;740;0;0;0;0;.00nan;0;0
3386;93324;740;93;35;2;33;.943;3900000;0
3387;3756;752;57;25;3;22;.880;3600000;0
3387;61272;748;0;0;0;0;.00nan;0;0
3387;85633;752;0;0;0;0;.00nan;0;0
3387;88646;748;53;31;4;27;.871;3600000;0
3388;279;745;0;0;0;0;.00nan;0;0
3388;75268;745;73;24;2;22;.917;3600000;0
3388;76405;732;74;52;6;46;.885;3600000;0
3388;81733;732;0;0;0;0;.00nan;0;0
3389;175764;729;0;0;0;0;.00nan;0;0
3389;190607;1880;0;0;0;0;.00nan;0;0
3389;46792;729;72;26;2;24;.923;3566000;0
3389;49935;1880;76;27;1;26;.963;3600000;0
3390;33044;741;0;0;0;0;.00nan;0;0
3390;49900;744;100;29;1;28;.966;3900000;0
3390;56565;741;90;35;1;34;.971;3900000;0
3390;94018;744;0;0;0;0;.00nan;0;0
3391;3756;752;54;23;3;20;.870;3600000;0
3391;195867;2168;0;0;0;0;.00nan;0;0
3391;85633;752;0;0;0;0;.00nan;0;0
3391;85670;2168;100;42;0;42;1.000;3600000;0
3392;83;737;97;46;2;44;.957;3547000;0
3392;279;745;0;0;0;0;.00nan;0;0
3392;190570;737;0;0;0;0;.00nan;0;0
3392;75268;745;69;20;1;19;.950;3600000;0
3393;44526;734;100;43;1;42;.977;3600000;0
3393;192386;734;0;0;0;0;.00nan;0;0
3393;85281;749;59;27;3;24;.889;3516000;0
3393;139409;749;0;0;0;0;.00nan;0;0
3394;178098;738;0;0;0;0;.00nan;0;0
3394;175764;729;0;0;0;0;.00nan;0;0
3394;185442;738;54;30;4;26;.867;3545000;0
3394;46792;729;74;27;2;25;.926;3600000;0
3395;187925;3789;0;0;0;0;.00nan;0;0
3395;52204;740;56;19;2;17;.895;3600000;0
3395;93324;740;0;0;0;0;.00nan;0;0
3395;149280;3789;95;37;1;36;.973;3600000;0
3396;1957;733;87;50;4;46;.920;3600000;0
3396;6079;733;0;0;0;0;.00nan;0;0
3396;196698;747;0;0;0;0;.00nan;0;0
3396;57107;747;77;30;2;28;.933;3600000;0
3397;-1;751;0;0;0;0;.00nan;0;0
3397;76405;732;74;62;7;55;.887;3600000;0
3397;81733;732;0;0;0;0;.00nan;0;0
3397;148788;751;31;15;4;11;.733;3600000;0
3398;3508;739;70;36;4;32;.889;3612000;0
3398;188561;739;0;0;0;0;.00nan;0;0
3398;190607;1880;0;0;0;0;.00nan;0;0
3398;49935;1880;43;18;3;15;.833;3612000;0
3399;49900;744;44;22;4;18;.818;3600000;0
3399;61272;748;0;0;0;0;.00nan;0;0
3399;88646;748;64;29;3;26;.897;3600000;0
3399;94018;744;0;0;0;0;.00nan;0;0
3400;848;743;100;46;1;45;.978;3600000;0
3400;2643;742;21;26;6;20;.769;3215000;0
3400;190589;743;0;0;0;0;.00nan;0;0
3400;43971;742;59;4;0;4;1.000;385000;0
3401;33044;741;0;0;0;0;.00nan;0;0
3401;52204;740;0;0;0;0;.00nan;0;0
3401;56565;741;88;38;3;35;.921;3600000;0
3401;93324;740;91;19;0;19;1.000;3600000;0
3402;201075;736;43;35;5;30;.857;3554000;0
3402;190607;1880;0;0;0;0;.00nan;0;0
3402;186219;736;0;0;0;0;.00nan;0;0
3402;49935;1880;45;28;4;24;.857;3600000;0
3403;1957;733;63;37;4;33;.892;3600000;0
3403;6079;733;0;0;0;0;.00nan;0;0
3403;-1;751;0;0;0;0;.00nan;0;0
3403;148788;751;63;20;2;18;.900;3600000;0
3404;3756;752;34;31;6;25;.806;3600000;0
3404;195867;2168;0;0;0;0;.00nan;0;0
3404;85633;752;0;0;0;0;.00nan;0;0
3404;85670;2168;48;19;3;16;.842;3600000;0
3405;187925;3789;0;0;0;0;.00nan;0;0
3405;44526;734;95;49;2;47;.959;3900000;0
3405;192386;734;0;0;0;0;.00nan;0;0
3405;149280;3789;67;21;2;19;.905;3900000;0
3406;279;745;0;0;0;0;.00nan;0;0
3406;178098;738;91;41;2;39;.951;3600000;0
3406;185442;738;0;0;0;0;.00nan;0;0
3406;75268;745;83;28;1;27;.964;3600000;0
3407;8505;764;70;26;2;24;.923;3900000;0
3407;67362;764;0;0;0;0;.00nan;0;0
3407;85281;749;83;26;2;24;.923;3900000;0
3407;139409;749;0;0;0;0;.00nan;0;0
3408;83;737;67;39;4;35;.897;3600000;0
3408;190570;737;0;0;0;0;.00nan;0;0
3408;196698;747;0;0;0;0;.00nan;0;0
3408;57107;747;76;25;2;23;.920;3600000;0
3409;175764;729;0;0;0;0;.00nan;0;0
3409;46792;729;78;20;1;19;.950;3600000;0
3409;61272;748;0;0;0;0;.00nan;0;0
3409;88646;748;92;40;2;38;.950;3593000;0
3410;201075;736;0;0;0;0;.00nan;0;0
3410;33044;741;0;0;0;0;.00nan;0;0
3410;186219;736;85;49;4;45;.918;3581000;0
3410;56565;741;71;21;2;19;.905;3600000;0
3411;-1;751;58;15;1;14;.933;3600000;0
3411;76405;732;83;50;5;45;.900;3600000;0
3411;81733;732;0;0;0;0;.00nan;0;0
3411;148788;751;0;0;0;0;.00nan;0;0
3412;1957;733;66;47;4;43;.915;3600000;0
3412;6079;733;0;0;0;0;.00nan;0;0
3412;195867;2168;0;0;0;0;.00nan;0;0
3412;85670;2168;69;18;1;17;.944;3600000;0
3413;83;737;60;28;3;25;.893;3600000;0
3413;190570;737;0;0;0;0;.00nan;0;0
3413;44526;734;68;36;4;32;.889;3600000;0
3413;192386;734;0;0;0;0;.00nan;0;0
3414;848;743;49;34;5;29;.853;3565000;0
3414;3756;752;71;37;3;34;.919;3600000;0
3414;190589;743;0;0;0;0;.00nan;0;0
3414;85633;752;0;0;0;0;.00nan;0;0
3415;175764;729;83;39;2;37;.949;3900000;0
3415;46792;729;0;0;0;0;.00nan;0;0
3415;85281;749;78;32;2;30;.938;3900000;0
3415;139409;749;0;0;0;0;.00nan;0;0
3416;33044;741;0;0;0;0;.00nan;0;0
3416;49900;744;76;24;2;22;.917;3895000;0
3416;56565;741;100;55;1;54;.982;3895000;0
3416;94018;744;0;0;0;0;.00nan;0;0
3417;187925;3789;0;0;0;0;.00nan;0;0
3417;190607;1880;0;0;0;0;.00nan;0;0
3417;49935;1880;59;32;3;29;.906;3600000;0
3417;149280;3789;98;38;2;36;.947;3600000;0
3418;201075;736;65;38;4;34;.895;3900000;0
3418;186219;736;0;0;0;0;.00nan;0;0
3418;52204;740;0;0;0;0;.00nan;0;0
3418;93324;740;52;31;4;27;.871;3900000;0
3419;2643;742;0;0;0;0;.00nan;0;0
3419;43971;742;52;21;2;19;.905;3531000;0
3419;61272;748;0;0;0;0;.00nan;0;0
3419;88646;748;100;29;0;29;1.000;3600000;0
3420;195867;2168;0;0;0;0;.00nan;0;0
3420;76405;732;97;49;2;47;.959;3600000;0
3420;81733;732;0;0;0;0;.00nan;0;0
3420;85670;2168;68;17;1;16;.941;3600000;0
3421;187925;3789;0;0;0;0;.00nan;0;0
3421;175764;729;0;0;0;0;.00nan;0;0
3421;46792;729;79;28;2;26;.929;3600000;0
3421;149280;3789;47;39;6;33;.846;3600000;0
3422;196698;747;0;0;0;0;.00nan;0;0
3422;49900;744;64;32;4;28;.875;3576000;0
3422;57107;747;76;36;3;33;.917;3600000;0
3422;94018;744;0;0;0;0;.00nan;0;0
3423;-1;751;55;2;0;2;1.000;571000;0
3423;61272;748;0;0;0;0;.00nan;0;0
3423;88646;748;60;31;4;27;.871;3900000;0
3423;148788;751;53;30;4;26;.867;3329000;0
3424;187925;3789;90;33;1;32;.970;3600000;0
3424;44526;734;98;43;2;41;.953;3556000;0
3424;192386;734;0;0;0;0;.00nan;0;0
3424;149280;3789;0;0;0;0;.00nan;0;0
3425;8505;764;0;0;0;0;.00nan;0;0
3425;178098;738;59;27;3;24;.889;3547000;0
3425;185442;738;0;0;0;0;.00nan;0;0
3425;67362;764;67;18;1;17;.944;3600000;0
3426;2643;742;67;26;2;24;.923;3560000;0
3426;43971;742;0;0;0;0;.00nan;0;0
3426;52204;740;82;25;1;24;.960;3600000;0
3426;93324;740;0;0;0;0;.00nan;0;0
3427;1957;733;65;47;5;42;.894;3600000;0
3427;6079;733;0;0;0;0;.00nan;0;0
3427;201075;736;0;0;0;0;.00nan;0;0
3427;186219;736;85;25;1;24;.960;3600000;0
3428;83;737;100;46;2;44;.957;3600000;0
3428;190570;737;0;0;0;0;.00nan;0;0
3428;190607;1880;0;0;0;0;.00nan;0;0
3428;49935;1880;67;32;3;29;.906;3600000;0
3429;175764;729;0;0;0;0;.00nan;0;0
3429;46792;729;69;19;2;17;.895;3900000;0
3429;76405;732;83;35;2;33;.943;3900000;0
3429;81733;732;0;0;0;0;.00nan;0;0
3430;2643;742;49;28;4;24;.857;3553000;0
3430;43971;742;0;0;0;0;.00nan;0;0
3430;49900;744;72;28;3;25;.893;3600000;0
3430;94018;744;0;0;0;0;.00nan;0;0
3431;3756;752;0;0;0;0;.00nan;0;0
3431;33044;741;0;0;0;0;.00nan;0;0
3431;56565;741;78;26;1;25;.962;3600000;0
3431;85633;752;49;28;4;24;.857;3600000;0
3432;83;737;64;20;2;18;.900;3900000;0
3432;3508;739;76;35;2;33;.943;3900000;0
3432;188561;739;0;0;0;0;.00nan;0;0
3432;190570;737;0;0;0;0;.00nan;0;0
3433;196698;747;0;0;0;0;.00nan;0;0
3433;-1;751;0;0;0;0;.00nan;0;0
3433;57107;747;80;34;3;31;.912;3560000;0
3433;148788;751;99;47;2;45;.957;3600000;0
3434;848;743;71;37;4;33;.892;3546000;0
3434;1957;733;88;42;3;39;.929;3600000;0
3434;6079;733;0;0;0;0;.00nan;0;0
3434;190589;743;0;0;0;0;.00nan;0;0
3435;190607;1880;0;0;0;0;.00nan;0;0
3435;44526;734;92;33;1;32;.970;3600000;0
3435;192386;734;0;0;0;0;.00nan;0;0
3435;49935;1880;74;34;3;31;.912;3600000;0
3436;195867;2168;0;0;0;0;.00nan;0;0
3436;85281;749;76;18;1;17;.944;3600000;0
3436;85670;2168;92;39;3;36;.923;3542000;0
3436;139409;749;0;0;0;0;.00nan;0;0
3437;279;745;0;0;0;0;.00nan;0;0
3437;178098;738;0;0;0;0;.00nan;0;0
3437;185442;738;48;35;6;29;.829;3600000;0
3437;75268;745;90;27;1;26;.963;3600000;0
3438;187925;3789;0;0;0;0;.00nan;0;0
3438;76405;732;95;71;3;68;.958;3900000;0
3438;81733;732;0;0;0;0;.00nan;0;0
3438;149280;3789;52;13;3;10;.769;3900000;0
3439;3756;752;100;26;0;26;1.000;3600000;0
3439;33044;741;0;0;0;0;.00nan;0;0
3439;56565;741;61;33;4;29;.879;3600000;0
3439;85633;752;0;0;0;0;.00nan;0;0
3440;201075;736;37;31;5;26;.839;3600000;0
3440;186219;736;0;0;0;0;.00nan;0;0
3440;52204;740;83;27;1;26;.963;3600000;0
3440;93324;740;0;0;0;0;.00nan;0;0
3441;195867;2168;0;0;0;0;.00nan;0;0
3441;85281;749;0;0;0;0;.00nan;0;0
3441;85670;2168;96;44;2;42;.955;3566000;0
3441;139409;749;92;30;1;29;.967;3600000;0
3442;8505;764;0;0;0;0;.00nan;0;0
3442;49900;744;100;22;0;22;1.000;3600000;0
3442;67362;764;97;40;2;38;.950;3588000;0
3442;94018;744;0;0;0;0;.00nan;0;0
3443;178098;738;76;23;2;21;.913;3600000;0
3443;185442;738;0;0;0;0;.00nan;0;0
3443;44526;734;60;34;4;30;.882;3559000;0
3443;192386;734;0;0;0;0;.00nan;0;0
3444;848;743;99;39;1;38;.974;3600000;0
3444;3508;739;45;16;2;14;.875;3547000;0
3444;188561;739;0;0;0;0;.00nan;0;0
3444;190589;743;0;0;0;0;.00nan;0;0
3445;83;737;73;38;3;35;.921;3600000;0
3445;175764;729;0;0;0;0;.00nan;0;0
3445;190570;737;0;0;0;0;.00nan;0;0
3445;46792;729;99;22;0;22;1.000;3600000;0
3446;2643;742;57;20;2;18;.900;3547000;0
3446;43971;742;0;0;0;0;.00nan;0;0
3446;61272;748;0;0;0;0;.00nan;0;0
3446;88646;748;99;42;1;41;.976;3600000;0
3447;1957;733;92;47;2;45;.957;3600000;0
3447;6079;733;0;0;0;0;.00nan;0;0
3447;196698;747;0;0;0;0;.00nan;0;0
3447;57107;747;42;24;4;20;.833;3513000;0
3448;279;745;0;0;0;0;.00nan;0;0
3448;-1;751;0;0;0;0;.00nan;0;0
3448;75268;745;70;31;3;28;.903;3600000;0
3448;148788;751;31;20;5;15;.750;3530000;0
3449;3756;752;30;33;7;26;.788;3723000;0
3449;195867;2168;0;0;0;0;.00nan;0;0
3449;85633;752;0;0;0;0;.00nan;0;0
3449;85670;2168;32;30;6;24;.800;3723000;0
3450;201075;736;64;9;0;9;1.000;922000;0
3450;186219;736;36;36;6;30;.833;2678000;0
3450;52204;740;89;34;1;33;.971;3600000;0
3450;93324;740;0;0;0;0;.00nan;0;0
3451;33044;741;0;0;0;0;.00nan;0;0
3451;56565;741;69;47;5;42;.894;3600000;0
3451;85281;749;65;19;2;17;.895;3600000;0
3451;139409;749;0;0;0;0;.00nan;0;0
3452;8505;764;99;42;1;41;.976;3600000;0
3452;-1;751;0;0;0;0;.00nan;0;0
3452;67362;764;0;0;0;0;.00nan;0;0
3452;148788;751;37;35;6;29;.829;3600000;0
3453;178098;738;64;26;3;23;.885;3600000;0
3453;190607;1880;23;16;5;11;.688;2493000;0
3453;185442;738;0;0;0;0;.00nan;0;0
3453;49935;1880;27;17;4;13;.765;1107000;0
3454;3508;739;58;20;2;18;.900;3854000;0
3454;188561;739;0;0;0;0;.00nan;0;0
3454;44526;734;89;33;2;31;.939;3900000;0
3454;192386;734;0;0;0;0;.00nan;0;0
3455;175764;729;0;0;0;0;.00nan;0;0
3455;196698;747;0;0;0;0;.00nan;0;0
3455;46792;729;85;30;1;29;.967;3600000;0
3455;57107;747;47;23;3;20;.870;3513000;0
3456;49900;744;99;20;0;20;1.000;3600000;0
3456;76405;732;65;36;4;32;.889;3600000;0
3456;81733;732;0;0;0;0;.00nan;0;0
3456;94018;744;0;0;0;0;.00nan;0;0
3457;2643;742;69;23;2;21;.913;3600000;0
3457;187925;3789;0;0;0;0;.00nan;0;0
3457;43971;742;0;0;0;0;.00nan;0;0
3457;149280;3789;33;33;6;27;.818;3600000;0
3458;3756;752;44;30;5;25;.833;3600000;0
3458;195867;2168;0;0;0;0;.00nan;0;0
3458;85633;752;0;0;0;0;.00nan;0;0
3458;85670;2168;84;37;2;35;.946;3600000;0
3459;1957;733;92;39;3;36;.923;3600000;0
3459;6079;733;0;0;0;0;.00nan;0;0
3459;52204;740;31;29;6;23;.793;3600000;0
3459;93324;740;0;0;0;0;.00nan;0;0
3460;33044;741;0;0;0;0;.00nan;0;0
3460;56565;741;65;47;5;42;.894;3600000;0
3460;85281;749;65;26;2;24;.923;3600000;0
3460;139409;749;0;0;0;0;.00nan;0;0
3461;279;745;0;0;0;0;.00nan;0;0
3461;201075;736;71;47;4;43;.915;3590000;0
3461;186219;736;0;0;0;0;.00nan;0;0
3461;75268;745;45;17;3;14;.824;3600000;0
3462;83;737;67;31;3;28;.903;3580000;0
3462;190570;737;0;0;0;0;.00nan;0;0
3462;190607;1880;0;0;0;0;.00nan;0;0
3462;49935;1880;92;35;1;34;.971;3600000;0
3463;178098;738;0;0;0;0;.00nan;0;0
3463;185442;738;87;35;2;33;.943;3679000;0
3463;196698;747;0;0;0;0;.00nan;0;0
3463;57107;747;99;38;1;37;.974;3679000;0
3464;8505;764;82;47;3;44;.936;3589000;0
3464;49900;744;74;26;2;24;.923;3600000;0
3464;67362;764;0;0;0;0;.00nan;0;0
3464;94018;744;0;0;0;0;.00nan;0;0
3465;279;745;0;0;0;0;.00nan;0;0
3465;-1;751;0;0;0;0;.00nan;0;0
3465;75268;745;90;37;2;35;.946;3600000;0
3465;148788;751;51;21;3;18;.857;3543000;0
3466;2643;742;88;28;1;27;.964;3732000;0
3466;43971;742;0;0;0;0;.00nan;0;0
3466;44526;734;75;30;2;28;.933;3732000;0
3466;192386;734;0;0;0;0;.00nan;0;0
3467;3508;739;58;21;3;18;.857;3600000;0
3467;188561;739;0;0;0;0;.00nan;0;0
3467;201075;736;0;0;0;0;.00nan;0;0
3467;186219;736;47;35;5;30;.857;3546000;0
3468;848;743;90;43;2;41;.953;3600000;0
3468;190589;743;0;0;0;0;.00nan;0;0
3468;61272;748;0;0;0;0;.00nan;0;0
3468;88646;748;45;33;6;27;.818;3600000;0
3469;1957;733;82;43;3;40;.930;3578000;0
3469;187925;3789;0;0;0;0;.00nan;0;0
3469;6079;733;0;0;0;0;.00nan;0;0
3469;149280;3789;86;24;1;23;.958;3600000;0
3470;52204;740;79;18;1;17;.944;3600000;0
3470;76405;732;67;41;4;37;.902;3600000;0
3470;81733;732;0;0;0;0;.00nan;0;0
3470;93324;740;0;0;0;0;.00nan;0;0
3471;175764;729;0;0;0;0;.00nan;0;0
3471;46792;729;75;30;2;28;.933;3600000;0
3471;49900;744;0;0;0;0;.00nan;0;0
3471;94018;744;48;26;4;22;.846;3546000;0
3472;196698;747;0;0;0;0;.00nan;0;0
3472;57107;747;73;37;3;34;.919;3517000;0
3472;85281;749;84;26;1;25;.962;3600000;0
3472;139409;749;0;0;0;0;.00nan;0;0
3473;848;743;100;44;2;42;.955;3600000;0
3473;190589;743;0;0;0;0;.00nan;0;0
3473;-1;751;0;0;0;0;.00nan;0;0
3473;148788;751;53;29;4;25;.862;3546000;0
3474;279;745;0;0;0;0;.00nan;0;0
3474;195867;2168;0;0;0;0;.00nan;0;0
3474;75268;745;61;22;2;20;.909;3600000;0
3474;85670;2168;52;30;4;26;.867;3551000;0
3475;83;737;70;22;2;20;.909;3900000;0
3475;190570;737;0;0;0;0;.00nan;0;0
3475;61272;748;0;0;0;0;.00nan;0;0
3475;88646;748;93;35;2;33;.943;3900000;0
3476;187925;3789;0;0;0;0;.00nan;0;0
3476;178098;738;54;42;6;36;.857;3600000;0
3476;185442;738;0;0;0;0;.00nan;0;0
3476;149280;3789;94;18;0;18;1.000;3600000;0
3477;3756;752;97;26;0;26;1.000;3600000;0
3477;8505;764;65;35;4;31;.886;3600000;0
3477;67362;764;0;0;0;0;.00nan;0;0
3477;85633;752;0;0;0;0;.00nan;0;0
3478;33044;741;0;0;0;0;.00nan;0;0
3478;190607;1880;0;0;0;0;.00nan;0;0
3478;49935;1880;65;45;6;39;.867;3600000;0
3478;56565;741;90;31;1;30;.968;3600000;0
3479;1957;733;100;45;1;44;.978;3600000;0
3479;6079;733;0;0;0;0;.00nan;0;0
3479;44526;734;57;26;3;23;.885;3513000;0
3479;192386;734;0;0;0;0;.00nan;0;0
3480;2643;742;0;0;0;0;.00nan;0;0
3480;175764;729;0;0;0;0;.00nan;0;0
3480;43971;742;75;46;4;42;.913;3900000;0
3480;46792;729;65;35;4;31;.886;3900000;0
3481;3508;739;62;45;5;40;.889;3600000;0
3481;188561;739;0;0;0;0;.00nan;0;0
3481;201075;736;98;42;2;40;.952;3600000;0
3481;186219;736;0;0;0;0;.00nan;0;0
3482;3756;752;51;35;5;30;.857;3585000;0
3482;49900;744;42;17;3;14;.824;3600000;0
3482;85633;752;0;0;0;0;.00nan;0;0
3482;94018;744;0;0;0;0;.00nan;0;0
3483;848;743;77;43;5;38;.884;3600000;0
3483;195867;2168;0;0;0;0;.00nan;0;0
3483;190589;743;0;0;0;0;.00nan;0;0
3483;85670;2168;96;19;0;19;1.000;3600000;0
3484;178098;738;0;0;0;0;.00nan;0;0
3484;185442;738;60;39;5;34;.872;3600000;0
3484;85281;749;99;31;1;30;.968;3600000;0
3484;139409;749;0;0;0;0;.00nan;0;0
3485;8505;764;0;0;0;0;.00nan;0;0
3485;190607;1880;0;0;0;0;.00nan;0;0
3485;49935;1880;71;29;2;27;.931;3900000;0
3485;67362;764;80;28;2;26;.929;3900000;0
3486;83;737;57;29;4;25;.862;3599000;0
3486;190570;737;0;0;0;0;.00nan;0;0
3486;52204;740;0;0;0;0;.00nan;0;0
3486;93324;740;70;36;3;33;.917;3600000;0
3487;196698;747;0;0;0;0;.00nan;0;0
3487;57107;747;100;26;0;26;1.000;3600000;0
3487;61272;748;0;0;0;0;.00nan;0;0
3487;88646;748;70;51;5;46;.902;3600000;0
3488;187925;3789;0;0;0;0;.00nan;0;0
3488;76405;732;69;36;3;33;.917;3600000;0
3488;81733;732;0;0;0;0;.00nan;0;0
3488;149280;3789;100;28;0;28;1.000;3600000;0
3489;33044;741;0;0;0;0;.00nan;0;0
3489;-1;751;0;0;0;0;.00nan;0;0
3489;56565;741;91;43;3;40;.930;3600000;0
3489;148788;751;41;31;5;26;.839;3527000;0
3490;1957;733;99;43;3;40;.930;3881000;0
3490;3508;739;65;28;3;25;.893;3900000;0
3490;6079;733;0;0;0;0;.00nan;0;0
3490;188561;739;0;0;0;0;.00nan;0;0
3491;2643;742;0;0;0;0;.00nan;0;0
3491;201075;736;0;0;0;0;.00nan;0;0
3491;186219;736;69;47;4;43;.915;3588000;0
3491;43971;742;67;28;2;26;.929;3600000;0
3492;279;745;0;0;0;0;.00nan;0;0
3492;175764;729;0;0;0;0;.00nan;0;0
3492;46792;729;90;31;2;29;.935;3876000;0
3492;75268;745;75;41;3;38;.927;3876000;0
3493;49900;744;74;33;2;31;.939;3731000;0
3493;85281;749;41;15;3;12;.800;3731000;0
3493;94018;744;0;0;0;0;.00nan;0;0
3493;139409;749;0;0;0;0;.00nan;0;0
3494;195867;2168;0;0;0;0;.00nan;0;0
3494;61272;748;0;0;0;0;.00nan;0;0
3494;85670;2168;77;28;3;25;.893;3900000;0
3494;88646;748;84;30;3;27;.900;3900000;0
3495;83;737;90;37;2;35;.946;3600000;0
3495;178098;738;74;32;3;29;.906;3581000;0
3495;190570;737;0;0;0;0;.00nan;0;0
3495;185442;738;0;0;0;0;.00nan;0;0
3496;3508;739;0;0;0;0;.00nan;0;0
3496;188561;739;43;45;7;38;.844;3600000;0
3496;190607;1880;0;0;0;0;.00nan;0;0
3496;49935;1880;68;28;2;26;.929;3600000;0
3497;8505;764;64;34;4;30;.882;3554000;0
3497;-1;751;0;0;0;0;.00nan;0;0
3497;67362;764;0;0;0;0;.00nan;0;0
3497;148788;751;92;36;2;34;.944;3600000;0
3498;848;743;77;27;2;25;.926;3600000;0
3498;190589;743;0;0;0;0;.00nan;0;0
3498;52204;740;73;32;4;28;.875;3542000;0
3498;93324;740;0;0;0;0;.00nan;0;0
3499;187925;3789;0;0;0;0;.00nan;0;0
3499;196698;747;0;0;0;0;.00nan;0;0
3499;57107;747;100;30;0;30;1.000;3600000;0
3499;149280;3789;53;25;4;21;.840;3600000;0
3500;44526;734;68;24;2;22;.917;3600000;0
3500;192386;734;0;0;0;0;.00nan;0;0
3500;76405;732;90;47;3;44;.936;3545000;0
3500;81733;732;0;0;0;0;.00nan;0;0
3501;3756;752;82;34;2;32;.941;3900000;0
3501;33044;741;55;22;2;20;.909;3900000;0
3501;56565;741;0;0;0;0;.00nan;0;0
3501;85633;752;0;0;0;0;.00nan;0;0
3503;44526;734;70;21;2;19;.905;3600000;0
3503;-1;3789;0;0;0;0;.00nan;0;0
3503;-1;734;0;0;0;0;.00nan;0;0
3503;149280;3789;52;23;3;20;.870;3544000;0
3505;178114;752;61;9;0;9;1.000;924000;0
3505;186235;751;78;22;1;21;.955;3600000;0
3505;-1;751;0;0;0;0;.00nan;0;0
3505;43731;752;42;34;6;28;.824;2676000;0
3507;178098;738;55;32;4;28;.875;3583000;0
3507;185442;738;0;0;0;0;.00nan;0;0
3507;76405;732;80;34;3;31;.912;3600000;0
3507;148788;732;0;0;0;0;.00nan;0;0
3509;83;737;100;19;0;19;1.000;3600000;0
3509;1957;733;69;44;4;40;.909;3600000;0
3509;6079;733;0;0;0;0;.00nan;0;0
3509;190570;737;0;0;0;0;.00nan;0;0
3511;188561;739;0;0;0;0;.00nan;0;0
3511;180188;743;67;32;4;28;.875;3600000;0
3511;190589;743;0;0;0;0;.00nan;0;0
3511;186234;739;82;29;1;28;.966;3600000;0
3513;3756;747;100;32;0;32;1.000;3600000;0
3513;198736;749;46;38;5;33;.868;3600000;0
3513;195867;749;0;0;0;0;.00nan;0;0
3513;196698;747;0;0;0;0;.00nan;0;0
3515;190607;2168;0;0;0;0;.00nan;0;0
3515;61272;748;0;0;0;0;.00nan;0;0
3515;85670;2168;54;38;5;33;.868;3600000;0
3515;88646;748;90;30;1;29;.967;3600000;0
3517;192065;1880;0;0;0;0;.00nan;0;0
3517;46792;729;74;38;3;35;.921;3558000;0
3517;49935;1880;78;26;2;24;.923;3600000;0
3517;52204;729;0;0;0;0;.00nan;0;0
3519;3508;745;60;19;2;17;.895;3561000;0
3519;201075;736;94;38;1;37;.974;3600000;0
3519;186219;736;0;0;0;0;.00nan;0;0
3519;192386;745;0;0;0;0;.00nan;0;0
3521;8505;764;0;0;0;0;.00nan;0;0
3521;185413;740;0;0;0;0;.00nan;0;0
3521;196715;740;46;29;5;24;.828;3600000;0
3521;67362;764;84;32;1;31;.969;3600000;0
3523;2643;742;0;0;0;0;.00nan;0;0
3523;-1;744;0;0;0;0;.00nan;0;0
3523;43971;742;76;19;1;18;.947;3600000;0
3523;49900;744;48;18;3;15;.833;3541000;0
3525;201075;736;63;38;5;33;.868;3548000;0
3525;186219;736;0;0;0;0;.00nan;0;0
3525;186235;751;67;28;3;25;.893;3600000;0
3525;-1;751;0;0;0;0;.00nan;0;0
3527;180188;743;0;0;0;0;.00nan;0;0
3527;190589;743;71;39;3;36;.923;3900000;0
3527;185413;740;62;32;3;29;.906;3900000;0
3527;196715;740;0;0;0;0;.00nan;0;0
3529;46792;729;51;23;3;20;.870;3562000;0
3529;52204;729;0;0;0;0;.00nan;0;0
3529;76405;732;85;28;1;27;.964;3600000;0
3529;148788;732;0;0;0;0;.00nan;0;0
3531;3756;747;59;17;2;15;.882;3600000;0
3531;188561;739;75;43;4;39;.907;3531000;0
3531;196698;747;0;0;0;0;.00nan;0;0
3531;186234;739;0;0;0;0;.00nan;0;0
3533;192065;1880;0;0;0;0;.00nan;0;0
3533;49935;1880;66;20;2;18;.900;3583000;0
3533;61272;748;0;0;0;0;.00nan;0;0
3533;88646;748;100;36;0;36;1.000;3600000;0
3535;178098;738;0;0;0;0;.00nan;0;0
3535;185442;738;58;33;3;30;.909;3582000;0
3535;-1;3789;0;0;0;0;.00nan;0;0
3535;149280;3789;78;24;1;23;.958;3600000;0
3537;3508;745;87;18;0;18;1.000;3600000;0
3537;44526;734;56;45;6;39;.867;3600000;0
3537;192386;745;0;0;0;0;.00nan;0;0
3537;-1;734;0;0;0;0;.00nan;0;0
3539;33044;741;0;0;0;0;.00nan;0;0
3539;-1;744;0;0;0;0;.00nan;0;0
3539;49900;744;96;20;0;20;1.000;3600000;0
3539;56565;741;52;37;6;31;.838;3600000;0
3541;198736;749;94;38;1;37;.974;3600000;0
3541;195867;749;0;0;0;0;.00nan;0;0
3541;190607;2168;49;1;0;1;1.000;247000;0
3541;85670;2168;50;43;6;37;.860;3353000;0
3543;2643;742;67;37;4;33;.892;3574000;0
3543;8505;764;0;0;0;0;.00nan;0;0
3543;43971;742;0;0;0;0;.00nan;0;0
3543;67362;764;64;31;3;28;.903;3600000;0
3545;1957;733;58;8;0;8;1.000;1206000;0
3545;6079;733;36;21;4;17;.810;2353000;0
3545;178114;752;0;0;0;0;.00nan;0;0
3545;43731;752;53;17;2;15;.882;3600000;0
3547;3756;747;0;0;0;0;.00nan;0;0
3547;178098;738;89;19;0;19;1.000;3600000;0
3547;185442;738;0;0;0;0;.00nan;0;0
3547;196698;747;61;24;2;22;.917;3536000;0
3549;178114;752;98;47;3;44;.936;3514000;0
3549;186235;751;0;0;0;0;.00nan;0;0
3549;-1;751;92;34;1;33;.971;3600000;0
3549;43731;752;0;0;0;0;.00nan;0;0
3551;201075;736;0;0;0;0;.00nan;0;0
3551;186219;736;62;29;2;27;.931;3600000;0
3551;61272;748;0;0;0;0;.00nan;0;0
3551;88646;748;82;25;1;24;.960;3600000;0
3553;8505;764;95;21;0;21;1.000;3600000;0
3553;188561;739;0;0;0;0;.00nan;0;0
3553;186234;739;98;45;2;43;.956;3550000;0
3553;67362;764;0;0;0;0;.00nan;0;0
3555;33044;741;88;40;2;38;.950;3900000;0
3555;44526;734;0;0;0;0;.00nan;0;0
3555;-1;734;94;34;2;32;.941;3900000;0
3555;56565;741;0;0;0;0;.00nan;0;0
3557;2643;742;63;8;0;8;1.000;545000;0
3557;3508;745;84;25;1;24;.960;3600000;0
3557;43971;742;37;31;6;25;.806;3055000;0
3557;192386;745;0;0;0;0;.00nan;0;0
3559;1957;733;78;42;3;39;.929;3538000;0
3559;6079;733;0;0;0;0;.00nan;0;0
3559;180188;743;88;27;1;26;.963;3600000;0
3559;190589;743;0;0;0;0;.00nan;0;0
3561;185413;740;0;0;0;0;.00nan;0;0
3561;-1;744;45;20;3;17;.850;3555000;0
3561;196715;740;96;57;1;56;.982;3600000;0
3561;49900;744;0;0;0;0;.00nan;0;0
3563;198736;749;0;0;0;0;.00nan;0;0
3563;195867;749;82;37;2;35;.946;3600000;0
3563;-1;3789;43;28;5;23;.821;3600000;0
3563;149280;3789;0;0;0;0;.00nan;0;0
3565;190607;2168;0;0;0;0;.00nan;0;0
3565;46792;729;0;0;0;0;.00nan;0;0
3565;52204;729;69;34;3;31;.912;3590000;0
3565;85670;2168;83;36;2;34;.944;3600000;0
3567;83;737;91;41;1;40;.976;3600000;0
3567;190570;737;0;0;0;0;.00nan;0;0
3567;192065;1880;68;28;3;25;.893;3600000;0
3567;49935;1880;0;0;0;0;.00nan;0;0
3569;3508;745;19;9;4;5;.556;1128000;0
3569;178114;752;0;0;0;0;.00nan;0;0
3569;43731;752;73;26;2;24;.923;3600000;0
3569;192386;745;84;19;0;19;1.000;2387000;0
3571;1957;733;66;40;5;35;.875;3600000;0
3571;6079;733;0;0;0;0;.00nan;0;0
3571;201075;736;90;30;1;29;.967;3600000;0
3571;186219;736;0;0;0;0;.00nan;0;0
3573;8505;764;75;22;1;21;.955;3900000;0
3573;186235;751;0;0;0;0;.00nan;0;0
3573;-1;751;100;46;1;45;.978;3900000;0
3573;67362;764;0;0;0;0;.00nan;0;0
3575;2643;742;97;32;1;31;.969;3600000;0
3575;178098;738;57;21;2;19;.905;3560000;0
3575;185442;738;0;0;0;0;.00nan;0;0
3575;43971;742;0;0;0;0;.00nan;0;0
3577;180188;743;0;0;0;0;.00nan;0;0
3577;190589;743;54;40;6;34;.850;3600000;0
3577;190607;2168;0;0;0;0;.00nan;0;0
3577;85670;2168;75;33;3;30;.909;3600000;0
3579;3756;747;81;47;4;43;.915;3600000;0
3579;196698;747;0;0;0;0;.00nan;0;0
3579;61272;748;0;0;0;0;.00nan;0;0
3579;88646;748;79;23;1;22;.957;3600000;0
3581;83;737;86;31;2;29;.935;3600000;0
3581;190570;737;0;0;0;0;.00nan;0;0
3581;-1;3789;0;0;0;0;.00nan;0;0
3581;149280;3789;57;25;3;22;.880;3545000;0
3583;188561;739;0;0;0;0;.00nan;0;0
3583;186234;739;96;35;1;34;.971;3708000;0
3583;46792;729;74;31;2;29;.935;3708000;0
3583;52204;729;0;0;0;0;.00nan;0;0
3585;33044;741;0;0;0;0;.00nan;0;0
3585;192065;1880;0;0;0;0;.00nan;0;0
3585;49935;1880;41;23;4;19;.826;3547000;0
3585;56565;741;71;34;3;31;.912;3600000;0
3587;-1;744;0;0;0;0;.00nan;0;0
3587;49900;744;83;18;0;18;1.000;3600000;0
3587;76405;732;85;32;2;30;.938;3569000;0
3587;148788;732;0;0;0;0;.00nan;0;0
3589;185413;740;69;32;3;29;.906;3551000;0
3589;196715;740;0;0;0;0;.00nan;0;0
3589;44526;734;95;41;2;39;.951;3600000;0
3589;-1;734;0;0;0;0;.00nan;0;0
3591;178098;738;0;0;0;0;.00nan;0;0
3591;185413;740;0;0;0;0;.00nan;0;0
3591;185442;738;61;27;3;24;.889;3584000;0
3591;196715;740;100;44;2;42;.955;3600000;0
3593;178114;752;57;18;2;16;.889;3579000;0
3593;201075;736;0;0;0;0;.00nan;0;0
3593;186219;736;100;42;1;41;.976;3600000;0
3593;43731;752;0;0;0;0;.00nan;0;0
3595;83;737;0;0;0;0;.00nan;0;0
3595;3756;747;53;18;2;16;.889;3600000;0
3595;190570;737;35;32;6;26;.813;3600000;0
3595;196698;747;0;0;0;0;.00nan;0;0
3597;1957;733;54;4;0;4;1.000;793000;0
3597;6079;733;36;35;6;29;.829;2807000;0
3597;-1;744;0;0;0;0;.00nan;0;0
3597;49900;744;62;15;2;13;.867;3600000;0
3599;3508;745;89;42;2;40;.952;3600000;0
3599;192065;1880;89;29;1;28;.966;3600000;0
3599;192386;745;0;0;0;0;.00nan;0;0
3599;49935;1880;0;0;0;0;.00nan;0;0
3601;46792;729;0;0;0;0;.00nan;0;0
3601;52204;729;91;28;1;27;.964;3600000;0
3601;76405;732;0;0;0;0;.00nan;0;0
3601;148788;732;82;36;2;34;.944;3575000;0
3603;180188;743;100;38;1;37;.974;3600000;0
3603;190589;743;0;0;0;0;.00nan;0;0
3603;61272;748;93;38;2;36;.947;3600000;0
3603;88646;748;0;0;0;0;.00nan;0;0
3605;33044;741;85;49;4;45;.918;3600000;0
3605;44526;734;77;25;1;24;.960;3600000;0
3605;-1;734;0;0;0;0;.00nan;0;0
3605;56565;741;0;0;0;0;.00nan;0;0
3607;8505;764;0;0;0;0;.00nan;0;0
3607;190607;2168;0;0;0;0;.00nan;0;0
3607;67362;764;68;25;2;23;.920;3600000;0
3607;85670;2168;53;31;4;27;.871;3563000;0
3609;198736;749;62;40;4;36;.900;3600000;0
3609;195867;749;0;0;0;0;.00nan;0;0
3609;-1;3789;68;17;1;16;.941;3600000;0
3609;149280;3789;0;0;0;0;.00nan;0;0
3611;2643;742;0;0;0;0;.00nan;0;0
3611;186235;751;94;33;1;32;.970;3600000;0
3611;-1;751;0;0;0;0;.00nan;0;0
3611;43971;742;69;34;3;31;.912;3600000;0
3613;180188;743;0;0;0;0;.00nan;0;0
3613;190589;743;83;44;3;41;.932;3600000;0
3613;192065;1880;0;0;0;0;.00nan;0;0
3613;49935;1880;88;23;0;23;1.000;3600000;0
3615;188561;739;0;0;0;0;.00nan;0;0
3615;190607;2168;0;0;0;0;.00nan;0;0
3615;186234;739;68;25;2;23;.920;3821000;0
3615;85670;2168;65;32;3;29;.906;3821000;0
3617;201075;736;98;42;2;40;.952;3600000;0
3617;186219;736;0;0;0;0;.00nan;0;0
3617;46792;729;94;41;3;38;.927;3600000;0
3617;52204;729;0;0;0;0;.00nan;0;0
3619;8505;764;0;0;0;0;.00nan;0;0
3619;61272;748;0;0;0;0;.00nan;0;0
3619;67362;764;61;23;2;21;.913;3528000;0
3619;88646;748;100;25;0;25;1.000;3600000;0
3621;-1;744;0;0;0;0;.00nan;0;0
3621;44526;734;54;38;5;33;.868;3600000;0
3621;-1;734;0;0;0;0;.00nan;0;0
3621;49900;744;72;22;2;20;.909;3600000;0
3623;198736;749;93;37;2;35;.946;3600000;0
3623;195867;749;0;0;0;0;.00nan;0;0
3623;185413;740;59;23;3;20;.870;2509000;0
3623;196715;740;29;19;4;15;.789;1091000;0
3625;3756;747;26;40;8;32;.800;3275000;0
3625;178098;738;81;26;1;25;.962;3600000;0
3625;185442;738;0;0;0;0;.00nan;0;0
3625;196698;747;55;4;0;4;1.000;325000;0
3627;1957;733;38;17;4;13;.765;3600000;0
3627;6079;733;0;0;0;0;.00nan;0;0
3627;33044;741;0;0;0;0;.00nan;0;0
3627;56565;741;48;42;6;36;.857;3549000;0
3629;2643;742;89;35;2;33;.943;3571000;0
3629;3508;745;84;31;1;30;.968;3600000;0
3629;43971;742;0;0;0;0;.00nan;0;0
3629;192386;745;0;0;0;0;.00nan;0;0
3631;186235;751;0;0;0;0;.00nan;0;0
3631;-1;751;51;36;5;31;.861;3761000;0
3631;-1;3789;0;0;0;0;.00nan;0;0
3631;149280;3789;60;37;4;33;.892;3765000;0
3633;83;737;80;29;1;28;.966;3600000;0
3633;190570;737;0;0;0;0;.00nan;0;0
3633;76405;732;97;40;2;38;.950;3556000;0
3633;148788;732;0;0;0;0;.00nan;0;0
3635;1957;733;0;0;0;0;.00nan;0;0
3635;6079;733;65;38;4;34;.895;3561000;0
3635;201075;736;0;0;0;0;.00nan;0;0
3635;186219;736;53;26;3;23;.885;3600000;0
3637;33044;741;45;33;5;28;.848;3600000;0
3637;44526;734;0;0;0;0;.00nan;0;0
3637;-1;734;69;20;1;19;.950;3600000;0
3637;56565;741;0;0;0;0;.00nan;0;0
3639;178114;752;0;0;0;0;.00nan;0;0
3639;190607;2168;0;0;0;0;.00nan;0;0
3639;43731;752;62;21;2;19;.905;3600000;0
3639;85670;2168;74;37;3;34;.919;3553000;0
3641;180188;743;83;44;4;40;.909;3600000;0
3641;190589;743;0;0;0;0;.00nan;0;0
3641;-1;3789;65;17;1;16;.941;3600000;0
3641;149280;3789;0;0;0;0;.00nan;0;0
3643;188561;739;80;24;1;23;.958;3600000;0
3643;178098;738;0;0;0;0;.00nan;0;0
3643;185442;738;70;36;4;32;.889;3600000;0
3643;186234;739;0;0;0;0;.00nan;0;0
3645;8505;764;84;36;3;33;.917;3600000;0
3645;192065;1880;0;0;0;0;.00nan;0;0
3645;49935;1880;100;28;0;28;1.000;3600000;0
3645;67362;764;0;0;0;0;.00nan;0;0
3647;83;737;0;0;0;0;.00nan;0;0
3647;2643;742;0;0;0;0;.00nan;0;0
3647;190570;737;78;22;2;20;.909;3900000;0
3647;43971;742;96;40;2;38;.950;3900000;0
3649;185413;740;51;2;0;2;1.000;327000;0
3649;196715;740;54;38;6;32;.842;3273000;0
3649;46792;729;0;0;0;0;.00nan;0;0
3649;52204;729;78;24;1;23;.958;3600000;0
3651;3508;745;0;0;0;0;.00nan;0;0
3651;186235;751;80;35;2;33;.943;3562000;0
3651;-1;751;0;0;0;0;.00nan;0;0
3651;192386;745;100;39;1;38;.974;3600000;0
3653;-1;744;67;26;2;24;.923;3900000;0
3653;49900;744;0;0;0;0;.00nan;0;0
3653;61272;748;0;0;0;0;.00nan;0;0
3653;88646;748;86;37;2;35;.946;3900000;0
3655;3756;747;74;35;3;32;.914;3600000;0
3655;196698;747;0;0;0;0;.00nan;0;0
3655;76405;732;0;0;0;0;.00nan;0;0
3655;148788;732;72;38;4;34;.895;3556000;0
20077;187925;3789;0;0;0;0;.00nan;0;0
20077;178098;738;93;34;1;33;.971;3600000;0
20077;185442;738;0;0;0;0;.00nan;0;0
20077;149280;3789;56;37;5;32;.865;3600000;0
20078;190607;1880;0;0;0;0;.00nan;0;0
20078;49935;1880;80;39;2;37;.949;4774000;0
20078;76405;732;90;36;1;35;.972;4774000;0
20078;81733;732;0;0;0;0;.00nan;0;0
20079;175764;729;0;0;0;0;.00nan;0;0
20079;46792;729;80;28;2;26;.929;3600000;0
20079;52204;740;64;25;3;22;.880;3574000;0
20079;93324;740;0;0;0;0;.00nan;0;0
20080;83;737;72;43;3;40;.930;7112000;0
20080;190570;737;0;0;0;0;.00nan;0;0
20080;44526;734;78;49;2;47;.959;7112000;0
20080;192386;734;0;0;0;0;.00nan;0;0
20081;279;745;0;0;0;0;.00nan;0;0
20081;61272;748;0;0;0;0;.00nan;0;0
20081;75268;745;56;40;5;35;.875;3554000;0
20081;88646;748;62;25;3;22;.880;3600000;0
20082;195867;2168;62;10;0;10;1.000;803000;0
20082;85281;749;28;31;7;24;.774;3916000;0
20082;85670;2168;53;43;6;37;.860;3113000;0
20082;139409;749;0;0;0;0;.00nan;0;0
20083;-1;751;0;0;0;0;.00nan;0;0
20083;-1;764;0;0;0;0;.00nan;0;0
20083;67362;764;61;31;4;27;.871;3600000;0
20083;148788;751;40;30;5;25;.833;3550000;0
20084;196698;747;0;0;0;0;.00nan;0;0
20084;49900;744;100;29;0;29;1.000;3600000;0
20084;57107;747;85;23;1;22;.957;3554000;0
20084;94018;744;0;0;0;0;.00nan;0;0
20085;187925;3789;0;0;0;0;.00nan;0;0
20085;178098;738;29;34;7;27;.794;2726000;0
20085;185442;738;42;4;1;3;.750;874000;0
20085;149280;3789;83;29;1;28;.966;3600000;0
20086;190607;1880;0;0;0;0;.00nan;0;0
20086;49935;1880;57;12;1;11;.917;3600000;0
20086;76405;732;97;42;2;40;.952;3559000;0
20086;81733;732;0;0;0;0;.00nan;0;0
20087;175764;729;0;0;0;0;.00nan;0;0
20087;46792;729;63;27;4;23;.852;3625000;0
20087;52204;740;49;30;5;25;.833;3625000;0
20087;93324;740;0;0;0;0;.00nan;0;0
20088;83;737;79;32;2;30;.938;3987000;0
20088;190570;737;0;0;0;0;.00nan;0;0
20088;44526;734;60;14;1;13;.929;3987000;0
20088;192386;734;0;0;0;0;.00nan;0;0
20089;279;745;0;0;0;0;.00nan;0;0
20089;61272;748;0;0;0;0;.00nan;0;0
20089;75268;745;96;34;1;33;.971;3600000;0
20089;88646;748;38;28;5;23;.821;3600000;0
20090;195867;2168;50;1;0;1;1.000;392000;0
20090;85281;749;72;23;2;21;.913;3600000;0
20090;85670;2168;48;36;6;30;.833;3208000;0
20090;139409;749;0;0;0;0;.00nan;0;0
20091;-1;751;0;0;0;0;.00nan;0;0
20091;-1;764;0;0;0;0;.00nan;0;0
20091;67362;764;69;38;4;34;.895;3573000;0
20091;148788;751;65;30;3;27;.900;3600000;0
20092;196698;747;0;0;0;0;.00nan;0;0
20092;49900;744;72;21;1;20;.952;3600000;0
20092;57107;747;100;27;0;27;1.000;3600000;0
20092;94018;744;0;0;0;0;.00nan;0;0
20093;187925;3789;0;0;0;0;.00nan;0;0
20093;178098;738;91;34;1;33;.971;3592000;0
20093;185442;738;0;0;0;0;.00nan;0;0
20093;149280;3789;97;16;0;16;1.000;3600000;0
20094;190607;1880;0;0;0;0;.00nan;0;0
20094;49935;1880;42;19;4;15;.789;4775000;0
20094;76405;732;88;57;5;52;.912;4775000;0
20094;81733;732;0;0;0;0;.00nan;0;0
20095;175764;729;0;0;0;0;.00nan;0;0
20095;46792;729;96;53;3;50;.943;5378000;0
20095;52204;740;82;50;4;46;.920;5378000;0
20095;93324;740;0;0;0;0;.00nan;0;0
20096;83;737;87;36;2;34;.944;3720000;0
20096;190570;737;0;0;0;0;.00nan;0;0
20096;44526;734;70;21;1;20;.952;3720000;0
20096;192386;734;0;0;0;0;.00nan;0;0
20097;279;745;0;0;0;0;.00nan;0;0
20097;61272;748;0;0;0;0;.00nan;0;0
20097;75268;745;84;27;1;26;.963;3763000;0
20097;88646;748;65;24;2;22;.917;3763000;0
20098;195867;2168;0;0;0;0;.00nan;0;0
20098;85281;749;81;33;2;31;.939;4200000;0
20098;85670;2168;70;34;3;31;.912;4200000;0
20098;139409;749;0;0;0;0;.00nan;0;0
20099;-1;751;0;0;0;0;.00nan;0;0
20099;-1;764;0;0;0;0;.00nan;0;0
20099;67362;764;33;34;6;28;.824;3600000;0
20099;148788;751;100;26;0;26;1.000;3600000;0
20100;196698;747;0;0;0;0;.00nan;0;0
20100;49900;744;59;28;3;25;.893;3546000;0
20100;57107;747;74;23;1;22;.957;3600000;0
20100;94018;744;0;0;0;0;.00nan;0;0
20101;187925;3789;0;0;0;0;.00nan;0;0
20101;178098;738;73;34;4;30;.882;3600000;0
20101;185442;738;0;0;0;0;.00nan;0;0
20101;149280;3789;70;24;1;23;.958;3600000;0
20102;190607;1880;0;0;0;0;.00nan;0;0
20102;49935;1880;82;15;0;15;1.000;3600000;0
20102;76405;732;87;50;4;46;.920;3600000;0
20102;81733;732;0;0;0;0;.00nan;0;0
20103;175764;729;0;0;0;0;.00nan;0;0
20103;46792;729;63;39;4;35;.897;3543000;0
20103;52204;740;85;31;2;29;.935;3600000;0
20103;93324;740;0;0;0;0;.00nan;0;0
20104;83;737;76;25;1;24;.960;3600000;0
20104;190570;737;0;0;0;0;.00nan;0;0
20104;44526;734;56;32;4;28;.875;3600000;0
20104;192386;734;0;0;0;0;.00nan;0;0
20105;279;745;0;0;0;0;.00nan;0;0
20105;61272;748;0;0;0;0;.00nan;0;0
20105;75268;745;72;42;4;38;.905;3566000;0
20105;88646;748;55;22;3;19;.864;3600000;0
20106;195867;2168;0;0;0;0;.00nan;0;0
20106;85281;749;66;31;3;28;.903;3569000;0
20106;85670;2168;99;34;1;33;.971;3600000;0
20106;139409;749;0;0;0;0;.00nan;0;0
20107;-1;751;0;0;0;0;.00nan;0;0
20107;-1;764;0;0;0;0;.00nan;0;0
20107;67362;764;100;41;0;41;1.000;3600000;0
20107;148788;751;70;20;1;19;.950;3552000;0
20108;196698;747;28;8;3;5;.625;1288000;0
20108;49900;744;87;20;0;20;1.000;3600000;0
20108;57107;747;54;30;4;26;.867;2312000;0
20108;94018;744;0;0;0;0;.00nan;0;0
190;187925;3789;0;0;0;0;.00nan;0;0
190;178098;738;61;35;4;31;.886;3600000;0
190;185442;738;0;0;0;0;.00nan;0;0
190;149280;3789;95;23;0;23;1.000;3600000;0
191;190607;1880;0;0;0;0;.00nan;0;0
191;49935;1880;84;17;0;17;1.000;3600000;0
191;76405;732;82;42;4;38;.905;3600000;0
191;81733;732;0;0;0;0;.00nan;0;0
192;175764;729;0;0;0;0;.00nan;0;0
192;46792;729;71;19;1;18;.947;4132000;0
192;52204;740;90;51;2;49;.961;4132000;0
192;93324;740;0;0;0;0;.00nan;0;0
193;83;737;76;24;1;23;.958;3600000;0
193;190570;737;0;0;0;0;.00nan;0;0
193;44526;734;51;26;4;22;.846;3600000;0
193;192386;734;0;0;0;0;.00nan;0;0
194;279;745;0;0;0;0;.00nan;0;0
194;61272;748;0;0;0;0;.00nan;0;0
194;75268;745;100;33;1;32;.970;4514000;0
194;88646;748;81;34;2;32;.941;4514000;0
195;195867;2168;0;0;0;0;.00nan;0;0
195;85281;749;98;25;0;25;1.000;3600000;0
195;85670;2168;50;38;5;33;.868;3600000;0
195;139409;749;0;0;0;0;.00nan;0;0
196;-1;751;0;0;0;0;.00nan;0;0
196;-1;764;0;0;0;0;.00nan;0;0
196;67362;764;88;40;3;37;.925;3600000;0
196;148788;751;94;30;1;29;.967;3600000;0
197;196698;747;0;0;0;0;.00nan;0;0
197;49900;744;71;19;1;18;.947;3600000;0
197;57107;747;78;37;4;33;.892;3600000;0
197;94018;744;0;0;0;0;.00nan;0;0
230;83;737;58;26;3;23;.885;3600000;0
230;190570;737;0;0;0;0;.00nan;0;0
230;44526;734;100;28;0;28;1.000;3600000;0
230;192386;734;0;0;0;0;.00nan;0;0
231;279;745;0;0;0;0;.00nan;0;0
231;61272;748;0;0;0;0;.00nan;0;0
231;75268;745;67;32;3;29;.906;3528000;0
231;88646;748;82;29;2;27;.931;3600000;0
232;195867;2168;0;0;0;0;.00nan;0;0
232;85281;749;97;26;1;25;.962;3600000;0
232;85670;2168;67;32;3;29;.906;3544000;0
232;139409;749;0;0;0;0;.00nan;0;0
233;-1;751;0;0;0;0;.00nan;0;0
233;-1;764;0;0;0;0;.00nan;0;0
233;67362;764;36;32;6;26;.813;3600000;0
233;148788;751;81;33;3;30;.909;3600000;0
234;196698;747;0;0;0;0;.00nan;0;0
234;49900;744;86;30;2;28;.933;3600000;0
234;57107;747;56;23;3;20;.870;3574000;0
234;94018;744;0;0;0;0;.00nan;0;0
374;279;745;0;0;0;0;.00nan;0;0
374;61272;748;0;0;0;0;.00nan;0;0
374;75268;745;87;24;1;23;.958;3600000;0
374;88646;748;67;41;5;36;.878;3600000;0
438;187925;3789;0;0;0;0;.00nan;0;0
438;44526;734;72;37;4;33;.892;3600000;0
438;192386;734;0;0;0;0;.00nan;0;0
438;149280;3789;62;23;2;21;.913;3600000;0
439;175764;729;0;0;0;0;.00nan;0;0
439;190607;1880;0;0;0;0;.00nan;0;0
439;46792;729;58;25;3;22;.880;3600000;0
439;49935;1880;38;32;5;27;.844;3541000;0
440;279;745;0;0;0;0;.00nan;0;0
440;49900;744;100;22;0;22;1.000;3600000;0
440;75268;745;35;24;5;19;.792;3600000;0
440;94018;744;0;0;0;0;.00nan;0;0
441;-1;751;0;0;0;0;.00nan;0;0
441;85281;749;63;28;3;25;.893;3564000;0
441;139409;749;0;0;0;0;.00nan;0;0
441;148788;751;93;41;2;39;.951;3600000;0
442;187925;3789;0;0;0;0;.00nan;0;0
442;44526;734;88;40;2;38;.950;3580000;0
442;192386;734;0;0;0;0;.00nan;0;0
442;149280;3789;81;22;1;21;.955;3600000;0
443;175764;729;0;0;0;0;.00nan;0;0
443;190607;1880;0;0;0;0;.00nan;0;0
443;46792;729;77;26;2;24;.923;3600000;0
443;49935;1880;49;24;4;20;.833;3549000;0
444;279;745;0;0;0;0;.00nan;0;0
444;49900;744;59;24;3;21;.875;4180000;0
444;75268;745;68;36;4;32;.889;4180000;0
444;94018;744;0;0;0;0;.00nan;0;0
445;-1;751;0;0;0;0;.00nan;0;0
445;85281;749;75;23;1;22;.957;3600000;0
445;139409;749;0;0;0;0;.00nan;0;0
445;148788;751;67;48;6;42;.875;3600000;0
446;187925;3789;0;0;0;0;.00nan;0;0
446;44526;734;72;45;5;40;.889;3600000;0
446;192386;734;0;0;0;0;.00nan;0;0
446;149280;3789;59;24;3;21;.875;3600000;0
447;175764;729;0;0;0;0;.00nan;0;0
447;190607;1880;0;0;0;0;.00nan;0;0
447;46792;729;92;37;2;35;.946;3555000;0
447;49935;1880;98;41;1;40;.976;3600000;0
448;279;745;0;0;0;0;.00nan;0;0
448;49900;744;51;27;4;23;.852;4257000;0
448;75268;745;74;43;3;40;.930;4257000;0
448;94018;744;0;0;0;0;.00nan;0;0
449;-1;751;0;0;0;0;.00nan;0;0
449;85281;749;85;26;1;25;.962;3553000;0
449;139409;749;0;0;0;0;.00nan;0;0
449;148788;751;100;37;0;37;1.000;3600000;0
450;187925;3789;0;0;0;0;.00nan;0;0
450;44526;734;40;34;6;28;.824;2537000;0
450;192386;734;82;23;0;23;1.000;1063000;0
450;149280;3789;64;14;1;13;.929;3600000;0
451;175764;729;0;0;0;0;.00nan;0;0
451;190607;1880;0;0;0;0;.00nan;0;0
451;46792;729;93;28;1;27;.964;3600000;0
451;49935;1880;51;25;3;22;.880;3525000;0
452;279;745;0;0;0;0;.00nan;0;0
452;49900;744;72;39;4;35;.897;3600000;0
452;75268;745;65;13;1;12;.923;3600000;0
452;94018;744;0;0;0;0;.00nan;0;0
453;-1;751;0;0;0;0;.00nan;0;0
453;85281;749;81;36;2;34;.944;3540000;0
453;139409;749;0;0;0;0;.00nan;0;0
453;148788;751;94;24;0;24;1.000;3600000;0
667;175764;729;0;0;0;0;.00nan;0;0
667;190607;1880;0;0;0;0;.00nan;0;0
667;46792;729;68;32;3;29;.906;3600000;0
667;49935;1880;99;23;0;23;1.000;3600000;0
668;279;745;0;0;0;0;.00nan;0;0
668;49900;744;74;30;2;28;.933;3600000;0
668;75268;745;65;30;3;27;.900;3600000;0
668;94018;744;0;0;0;0;.00nan;0;0
669;-1;751;0;0;0;0;.00nan;0;0
669;85281;749;58;18;2;16;.889;3600000;0
669;139409;749;0;0;0;0;.00nan;0;0
669;148788;751;89;48;3;45;.938;3592000;0
692;175764;729;0;0;0;0;.00nan;0;0
692;190607;1880;0;0;0;0;.00nan;0;0
692;46792;729;48;35;5;30;.857;3543000;0
692;49935;1880;67;39;4;35;.897;3600000;0
693;279;745;0;0;0;0;.00nan;0;0
693;49900;744;69;25;2;23;.920;3530000;0
693;75268;745;100;38;0;38;1.000;3600000;0
693;94018;744;0;0;0;0;.00nan;0;0
694;-1;751;0;0;0;0;.00nan;0;0
694;85281;749;61;23;2;21;.913;3600000;0
694;139409;749;0;0;0;0;.00nan;0;0
694;148788;751;59;27;3;24;.889;3544000;0
785;175764;729;0;0;0;0;.00nan;0;0
785;190607;1880;0;0;0;0;.00nan;0;0
785;46792;729;54;25;3;22;.880;3600000;0
785;49935;1880;100;25;0;25;1.000;3600000;0
786;279;745;0;0;0;0;.00nan;0;0
786;49900;744;74;14;1;13;.929;3600000;0
786;75268;745;98;46;2;44;.957;3600000;0
786;94018;744;0;0;0;0;.00nan;0;0
787;-1;751;0;0;0;0;.00nan;0;0
787;85281;749;53;32;5;27;.844;3513000;0
787;139409;749;0;0;0;0;.00nan;0;0
787;148788;751;84;35;3;32;.914;3600000;0
897;187925;3789;0;0;0;0;.00nan;0;0
897;190607;1880;52;4;0;4;1.000;464000;0
897;49935;1880;45;41;6;35;.854;3136000;0
897;149280;3789;56;19;2;17;.895;3600000;0
898;-1;751;0;0;0;0;.00nan;0;0
898;49900;744;41;37;6;31;.838;3600000;0
898;94018;744;0;0;0;0;.00nan;0;0
898;148788;751;60;26;3;23;.885;3600000;0
899;187925;3789;0;0;0;0;.00nan;0;0
899;190607;1880;55;5;0;5;1.000;317000;0
899;49935;1880;23;32;7;25;.781;3283000;0
899;149280;3789;100;31;0;31;1.000;3600000;0
900;-1;751;0;0;0;0;.00nan;0;0
900;49900;744;60;25;3;22;.880;3933000;0
900;94018;744;0;0;0;0;.00nan;0;0
900;148788;751;84;36;2;34;.944;3933000;0
901;187925;3789;0;0;0;0;.00nan;0;0
901;190607;1880;0;0;0;0;.00nan;0;0
901;49935;1880;80;41;3;38;.927;3600000;0
901;149280;3789;94;18;0;18;1.000;3600000;0
902;-1;751;0;0;0;0;.00nan;0;0
902;49900;744;94;29;1;28;.966;3600000;0
902;94018;744;0;0;0;0;.00nan;0;0
902;148788;751;64;23;2;21;.913;3568000;0
903;187925;3789;0;0;0;0;.00nan;0;0
903;190607;1880;0;0;0;0;.00nan;0;0
903;49935;1880;90;47;2;45;.957;4190000;0
903;149280;3789;73;17;1;16;.941;4190000;0
904;-1;751;0;0;0;0;.00nan;0;0
904;49900;744;90;29;1;28;.966;4102000;0
904;94018;744;0;0;0;0;.00nan;0;0
904;148788;751;100;37;0;37;1.000;4102000;0
1029;-1;751;0;0;0;0;.00nan;0;0
1029;49900;744;100;30;0;30;1.000;3600000;0
1029;94018;744;0;0;0;0;.00nan;0;0
1029;148788;751;70;21;2;19;.905;3528000;0
1076;-1;751;0;0;0;0;.00nan;0;0
1076;49900;744;56;24;3;21;.875;3600000;0
1076;94018;744;0;0;0;0;.00nan;0;0
1076;148788;751;46;35;5;30;.857;3536000;0
1109;-1;751;0;0;0;0;.00nan;0;0
1109;49900;744;75;23;1;22;.957;3600000;0
1109;94018;744;0;0;0;0;.00nan;0;0
1109;148788;751;57;42;5;37;.881;3600000;0
1183;187925;3789;0;0;0;0;.00nan;0;0
1183;49900;744;49;20;3;17;.850;3597000;0
1183;94018;744;0;0;0;0;.00nan;0;0
1183;149280;3789;78;19;1;18;.947;3600000;0
1184;187925;3789;0;0;0;0;.00nan;0;0
1184;49900;744;72;21;2;19;.905;3600000;0
1184;94018;744;0;0;0;0;.00nan;0;0
1184;149280;3789;96;36;1;35;.972;3600000;0
1185;187925;3789;0;0;0;0;.00nan;0;0
1185;49900;744;80;27;1;26;.963;3600000;0
1185;94018;744;0;0;0;0;.00nan;0;0
1185;149280;3789;39;20;4;16;.800;3600000;0
1186;187925;3789;0;0;0;0;.00nan;0;0
1186;49900;744;67;27;3;24;.889;3796000;0
1186;94018;744;0;0;0;0;.00nan;0;0
1186;149280;3789;78;31;2;29;.935;3796000;0
3656;169493;562;0;0;0;0;.00nan;0;0
3656;73939;572;51;35;5;30;.857;3600000;0
3656;78815;562;79;27;1;26;.963;3600000;0
3656;84430;572;0;0;0;0;.00nan;0;0
3657;12859;569;0;0;0;0;.00nan;0;0
3657;174407;571;0;0;0;0;.00nan;0;0
3657;36571;569;90;33;1;32;.970;3600000;0
3657;53861;571;49;20;3;17;.850;3515000;0
3658;4484;574;0;0;0;0;.00nan;0;0
3658;190423;570;0;0;0;0;.00nan;0;0
3658;67626;570;60;34;3;31;.912;3600000;0
3658;68167;574;70;21;1;20;.952;3600000;0
3659;4504;577;62;34;4;30;.882;3576000;0
3659;78251;564;90;47;3;44;.936;3600000;0
3659;90734;564;0;0;0;0;.00nan;0;0
3659;143829;577;0;0;0;0;.00nan;0;0
3660;6127;565;100;48;2;46;.958;3600000;0
3660;170042;565;0;0;0;0;.00nan;0;0
3660;22684;566;59;27;3;24;.889;3547000;0
3660;64721;566;0;0;0;0;.00nan;0;0
3661;14047;578;96;42;2;40;.952;3600000;0
3661;14459;576;33;21;4;17;.810;3515000;0
3661;174736;576;0;0;0;0;.00nan;0;0
3661;35520;578;0;0;0;0;.00nan;0;0
3662;1601;573;0;0;0;0;.00nan;0;0
3662;56126;575;0;0;0;0;.00nan;0;0
3662;66245;575;54;30;4;26;.867;3900000;0
3662;84945;573;54;31;4;27;.871;3900000;0
3663;12859;569;0;0;0;0;.00nan;0;0
3663;169493;562;0;0;0;0;.00nan;0;0
3663;36571;569;73;36;3;33;.917;3558000;0
3663;78815;562;84;28;1;27;.964;3600000;0
3664;4504;577;0;0;0;0;.00nan;0;0
3664;73939;572;94;47;2;45;.957;3580000;0
3664;84430;572;0;0;0;0;.00nan;0;0
3664;143829;577;88;23;1;22;.957;3600000;0
3665;6127;565;100;44;2;42;.955;3600000;0
3665;170042;565;0;0;0;0;.00nan;0;0
3665;190423;570;0;0;0;0;.00nan;0;0
3665;67626;570;75;29;3;26;.897;3562000;0
3666;38228;568;97;31;1;30;.968;3600000;0
3666;56126;575;0;0;0;0;.00nan;0;0
3666;64923;568;0;0;0;0;.00nan;0;0
3666;66245;575;61;32;4;28;.875;3600000;0
3667;14047;578;22;18;5;13;.722;1128000;0
3667;174407;571;60;16;1;15;.938;3600000;0
3667;35520;578;62;20;3;17;.850;2472000;0
3667;53861;571;0;0;0;0;.00nan;0;0
3668;22684;566;60;26;3;23;.885;3749000;0
3668;174407;571;84;29;2;27;.931;3749000;0
3668;53861;571;0;0;0;0;.00nan;0;0
3668;64721;566;0;0;0;0;.00nan;0;0
3669;12859;569;71;21;1;20;.952;3600000;0
3669;36571;569;0;0;0;0;.00nan;0;0
3669;73939;572;0;0;0;0;.00nan;0;0
3669;84430;572;57;29;3;26;.897;3580000;0
3670;4484;574;0;0;0;0;.00nan;0;0
3670;68167;574;53;35;4;31;.886;3513000;0
3670;78251;564;0;0;0;0;.00nan;0;0
3670;90734;564;70;27;2;25;.926;3600000;0
3671;6127;565;0;0;0;0;.00nan;0;0
3671;170042;565;63;24;2;22;.917;3600000;0
3671;65014;570;68;34;4;30;.882;3600000;0
3671;67626;570;0;0;0;0;.00nan;0;0
3672;169493;562;62;8;0;8;1.000;542000;0
3672;38228;568;0;0;0;0;.00nan;0;0
3672;64923;568;77;23;1;22;.957;3600000;0
3672;78815;562;45;38;6;32;.842;3058000;0
3673;1601;573;0;0;0;0;.00nan;0;0
3673;14459;576;0;0;0;0;.00nan;0;0
3673;84945;573;92;40;3;37;.925;3900000;0
3673;91202;576;48;29;3;26;.897;3900000;0
3674;4504;577;0;0;0;0;.00nan;0;0
3674;14047;578;71;35;3;32;.914;3570000;0
3674;35520;578;0;0;0;0;.00nan;0;0
3674;143829;577;63;22;2;20;.909;3600000;0
3675;4484;574;0;0;0;0;.00nan;0;0
3675;68167;574;67;27;2;25;.926;3600000;0
3675;73939;572;89;51;4;47;.922;3535000;0
3675;84430;572;0;0;0;0;.00nan;0;0
3676;38228;568;0;0;0;0;.00nan;0;0
3676;64923;568;83;33;2;31;.939;3900000;0
3676;65014;570;70;29;2;27;.931;3900000;0
3676;67626;570;0;0;0;0;.00nan;0;0
3677;56126;575;0;0;0;0;.00nan;0;0
3677;66245;575;89;50;3;47;.940;3600000;0
3677;78251;564;0;0;0;0;.00nan;0;0
3677;90734;564;53;29;4;25;.862;3600000;0
3678;1601;573;0;0;0;0;.00nan;0;0
3678;22684;566;0;0;0;0;.00nan;0;0
3678;64721;566;88;30;1;29;.967;3600000;0
3678;84945;573;74;36;3;33;.917;3529000;0
3679;4504;577;0;0;0;0;.00nan;0;0
3679;14459;576;0;0;0;0;.00nan;0;0
3679;91202;576;93;33;1;32;.970;3600000;0
3679;143829;577;89;45;2;43;.956;3549000;0
3680;12859;569;0;0;0;0;.00nan;0;0
3680;169493;562;0;0;0;0;.00nan;0;0
3680;36571;569;34;30;5;25;.833;3578000;0
3680;78815;562;68;28;3;25;.893;3600000;0
3681;6127;565;53;30;4;26;.867;3556000;0
3681;170042;565;0;0;0;0;.00nan;0;0
3681;174407;571;60;31;3;28;.903;3600000;0
3681;53861;571;0;0;0;0;.00nan;0;0
3682;4484;574;78;33;3;30;.909;3567000;0
3682;174407;571;0;0;0;0;.00nan;0;0
3682;53861;571;60;17;1;16;.941;3600000;0
3682;68167;574;0;0;0;0;.00nan;0;0
3683;38228;568;0;0;0;0;.00nan;0;0
3683;64923;568;66;25;2;23;.920;3600000;0
3683;73939;572;41;33;5;28;.848;3600000;0
3683;84430;572;0;0;0;0;.00nan;0;0
3684;1601;573;0;0;0;0;.00nan;0;0
3684;12859;569;63;26;3;23;.885;3600000;0
3684;36571;569;0;0;0;0;.00nan;0;0
3684;84945;573;73;43;4;39;.907;3554000;0
3685;169493;562;0;0;0;0;.00nan;0;0
3685;22684;566;51;26;4;22;.846;3900000;0
3685;64721;566;0;0;0;0;.00nan;0;0
3685;78815;562;93;52;4;48;.923;3900000;0
3686;14047;578;98;43;1;42;.977;3567000;0
3686;35520;578;0;0;0;0;.00nan;0;0
3686;65014;570;90;18;0;18;1.000;3600000;0
3686;67626;570;0;0;0;0;.00nan;0;0
3687;174407;571;81;31;2;29;.935;3600000;0
3687;53861;571;0;0;0;0;.00nan;0;0
3687;73939;572;0;0;0;0;.00nan;0;0
3687;84430;572;82;37;3;34;.919;3582000;0
3688;65014;570;69;37;4;33;.892;3600000;0
3688;67626;570;0;0;0;0;.00nan;0;0
3688;78251;564;0;0;0;0;.00nan;0;0
3688;90734;564;36;29;5;24;.828;3550000;0
3689;14459;576;0;0;0;0;.00nan;0;0
3689;169493;562;55;39;5;34;.872;3600000;0
3689;78815;562;0;0;0;0;.00nan;0;0
3689;91202;576;72;24;2;22;.917;3600000;0
3690;1601;573;34;23;5;18;.783;1574000;0
3690;4484;574;0;0;0;0;.00nan;0;0
3690;68167;574;89;19;0;19;1.000;3600000;0
3690;84945;573;66;24;2;22;.917;2026000;0
3691;6127;565;55;26;3;23;.885;3600000;0
3691;14047;578;0;0;0;0;.00nan;0;0
3691;170042;565;0;0;0;0;.00nan;0;0
3691;35520;578;23;35;8;27;.771;3600000;0
3692;22684;566;0;0;0;0;.00nan;0;0
3692;56126;575;92;39;2;37;.949;3578000;0
3692;64721;566;87;30;1;29;.967;3600000;0
3692;66245;575;0;0;0;0;.00nan;0;0
3693;4504;577;70;41;4;37;.902;3564000;0
3693;12859;569;0;0;0;0;.00nan;0;0
3693;36571;569;98;42;2;40;.952;3600000;0
3693;143829;577;0;0;0;0;.00nan;0;0
3694;12859;569;0;0;0;0;.00nan;0;0
3694;22684;566;100;27;0;27;1.000;3600000;0
3694;36571;569;90;38;1;37;.974;3552000;0
3694;64721;566;0;0;0;0;.00nan;0;0
3695;73939;572;65;48;5;43;.896;3600000;0
3695;78251;564;71;22;2;20;.909;3600000;0
3695;84430;572;0;0;0;0;.00nan;0;0
3695;90734;564;0;0;0;0;.00nan;0;0
3696;4484;574;0;0;0;0;.00nan;0;0
3696;38228;568;49;38;5;33;.868;3568000;0
3696;64923;568;0;0;0;0;.00nan;0;0
3696;68167;574;72;33;4;29;.879;3600000;0
3697;56126;575;0;0;0;0;.00nan;0;0
3697;65014;570;89;18;0;18;1.000;3600000;0
3697;66245;575;97;44;2;42;.955;3575000;0
3697;67626;570;0;0;0;0;.00nan;0;0
3698;1601;573;0;0;0;0;.00nan;0;0
3698;169493;562;0;0;0;0;.00nan;0;0
3698;78815;562;71;35;4;31;.886;3656000;0
3698;84945;573;51;37;5;32;.865;3656000;0
3699;14047;578;65;22;2;20;.909;3600000;0
3699;14459;576;0;0;0;0;.00nan;0;0
3699;35520;578;0;0;0;0;.00nan;0;0
3699;91202;576;61;29;3;26;.897;3600000;0
3700;12859;569;0;0;0;0;.00nan;0;0
3700;36571;569;94;44;2;42;.955;3588000;0
3700;56126;575;100;35;1;34;.971;3600000;0
3700;66245;575;0;0;0;0;.00nan;0;0
3701;12859;569;56;25;3;22;.880;3581000;0
3701;36571;569;0;0;0;0;.00nan;0;0
3701;38228;568;0;0;0;0;.00nan;0;0
3701;64923;568;68;23;2;21;.913;3600000;0
3702;22684;566;51;19;2;17;.895;3600000;0
3702;64721;566;0;0;0;0;.00nan;0;0
3702;78251;564;0;0;0;0;.00nan;0;0
3702;90734;564;43;30;5;25;.833;3600000;0
3703;6127;565;93;46;4;42;.913;3900000;0
3703;14459;576;0;0;0;0;.00nan;0;0
3703;170042;565;0;0;0;0;.00nan;0;0
3703;91202;576;66;33;4;29;.879;3900000;0
3704;169493;562;0;0;0;0;.00nan;0;0
3704;65014;570;76;30;2;28;.933;3600000;0
3704;67626;570;0;0;0;0;.00nan;0;0
3704;78815;562;71;37;3;34;.919;3556000;0
3705;1601;573;73;24;1;23;.958;3600000;0
3705;14047;578;79;39;3;36;.923;3600000;0
3705;35520;578;0;0;0;0;.00nan;0;0
3705;84945;573;0;0;0;0;.00nan;0;0
3706;4504;577;0;0;0;0;.00nan;0;0
3706;174407;571;64;31;3;28;.903;3600000;0
3706;53861;571;0;0;0;0;.00nan;0;0
3706;143829;577;76;30;2;28;.933;3600000;0
3707;4504;577;100;22;0;22;1.000;3600000;0
3707;174407;571;74;14;0;14;1.000;1353000;0
3707;53861;571;13;16;6;10;.625;2247000;0
3707;143829;577;0;0;0;0;.00nan;0;0
3708;1601;573;0;0;0;0;.00nan;0;0
3708;38228;568;70;16;1;15;.938;3600000;0
3708;64923;568;0;0;0;0;.00nan;0;0
3708;84945;573;63;56;7;49;.875;3600000;0
3709;6127;565;0;0;0;0;.00nan;0;0
3709;170042;565;52;34;5;29;.853;3600000;0
3709;78251;564;92;28;1;27;.964;3600000;0
3709;90734;564;0;0;0;0;.00nan;0;0
3710;56126;575;0;0;0;0;.00nan;0;0
3710;66245;575;76;34;3;31;.912;3900000;0
3710;73939;572;87;44;3;41;.932;3900000;0
3710;84430;572;0;0;0;0;.00nan;0;0
3711;4484;574;0;0;0;0;.00nan;0;0
3711;14047;578;0;0;0;0;.00nan;0;0
3711;35520;578;74;35;3;32;.914;3900000;0
3711;68167;574;54;22;3;19;.864;3900000;0
3712;169493;562;77;41;3;38;.927;3566000;0
3712;22684;566;0;0;0;0;.00nan;0;0
3712;64721;566;66;26;2;24;.923;3600000;0
3712;78815;562;0;0;0;0;.00nan;0;0
3713;169493;562;0;0;0;0;.00nan;0;0
3713;56126;575;0;0;0;0;.00nan;0;0
3713;66245;575;78;35;2;33;.943;3600000;0
3713;78815;562;85;28;1;27;.964;3600000;0
3714;174407;571;71;39;4;35;.897;3600000;0
3714;53861;571;0;0;0;0;.00nan;0;0
3714;78251;564;0;0;0;0;.00nan;0;0
3714;90734;564;66;26;2;24;.923;3600000;0
3715;1601;573;0;0;0;0;.00nan;0;0
3715;65014;570;71;27;1;26;.963;3900000;0
3715;67626;570;0;0;0;0;.00nan;0;0
3715;84945;573;85;31;1;30;.968;3900000;0
3716;4504;577;0;0;0;0;.00nan;0;0
3716;73939;572;98;48;4;44;.917;3600000;0
3716;84430;572;0;0;0;0;.00nan;0;0
3716;143829;577;78;21;1;20;.952;3600000;0
3717;14047;578;79;39;3;36;.923;3900000;0
3717;35520;578;0;0;0;0;.00nan;0;0
3717;38228;568;0;0;0;0;.00nan;0;0
3717;64923;568;70;28;3;25;.893;3900000;0
3718;12859;569;0;0;0;0;.00nan;0;0
3718;14459;576;0;0;0;0;.00nan;0;0
3718;36571;569;100;36;1;35;.972;3600000;0
3718;91202;576;71;29;2;27;.931;3600000;0
3719;6127;565;0;0;0;0;.00nan;0;0
3719;169493;562;0;0;0;0;.00nan;0;0
3719;170042;565;72;45;5;40;.889;3561000;0
3719;78815;562;71;22;3;19;.864;3600000;0
3720;14047;578;75;37;3;34;.919;3577000;0
3720;22684;566;70;24;1;23;.958;3600000;0
3720;35520;578;0;0;0;0;.00nan;0;0
3720;64721;566;0;0;0;0;.00nan;0;0
3721;65014;570;88;17;0;17;1.000;3600000;0
3721;67626;570;0;0;0;0;.00nan;0;0
3721;73939;572;50;28;4;24;.857;3600000;0
3721;84430;572;0;0;0;0;.00nan;0;0
3722;4484;574;0;0;0;0;.00nan;0;0
3722;56126;575;0;0;0;0;.00nan;0;0
3722;66245;575;60;34;4;30;.882;3563000;0
3722;68167;574;97;42;2;40;.952;3600000;0
3723;1601;573;0;0;0;0;.00nan;0;0
3723;4504;577;46;25;4;21;.840;3600000;0
3723;84945;573;63;45;5;40;.889;3550000;0
3723;143829;577;0;0;0;0;.00nan;0;0
3724;174407;571;100;28;0;28;1.000;3600000;0
3724;38228;568;0;0;0;0;.00nan;0;0
3724;53861;571;0;0;0;0;.00nan;0;0
3724;64923;568;57;34;4;30;.882;3600000;0
3725;6127;565;90;30;1;29;.967;3600000;0
3725;170042;565;0;0;0;0;.00nan;0;0
3725;73939;572;0;0;0;0;.00nan;0;0
3725;84430;572;70;33;3;30;.909;3528000;0
3726;12859;569;85;38;2;36;.947;3600000;0
3726;36571;569;0;0;0;0;.00nan;0;0
3726;65014;570;65;28;3;25;.893;3600000;0
3726;67626;570;0;0;0;0;.00nan;0;0
3727;4484;574;71;22;1;21;.955;3600000;0
3727;14047;578;0;0;0;0;.00nan;0;0
3727;35520;578;43;33;6;27;.818;3600000;0
3727;68167;574;0;0;0;0;.00nan;0;0
3728;14459;576;0;0;0;0;.00nan;0;0
3728;78251;564;66;30;4;26;.867;3560000;0
3728;90734;564;0;0;0;0;.00nan;0;0
3728;91202;576;91;42;2;40;.952;3600000;0
3729;4504;577;0;0;0;0;.00nan;0;0
3729;169493;562;0;0;0;0;.00nan;0;0
3729;78815;562;72;36;3;33;.917;3579000;0
3729;143829;577;87;28;1;27;.964;3600000;0
3730;1601;573;44;24;4;20;.833;3556000;0
3730;56126;575;78;38;3;35;.921;3600000;0
3730;66245;575;0;0;0;0;.00nan;0;0
3730;84945;573;0;0;0;0;.00nan;0;0
3731;174407;571;67;35;3;32;.914;3553000;0
3731;53861;571;0;0;0;0;.00nan;0;0
3731;65014;570;75;31;2;29;.935;3600000;0
3731;67626;570;0;0;0;0;.00nan;0;0
3732;38228;568;0;0;0;0;.00nan;0;0
3732;64923;568;54;24;3;21;.875;3600000;0
3732;73939;572;100;45;1;44;.978;3600000;0
3732;84430;572;0;0;0;0;.00nan;0;0
3733;6127;565;97;24;0;24;1.000;3600000;0
3733;14459;576;0;0;0;0;.00nan;0;0
3733;170042;565;0;0;0;0;.00nan;0;0
3733;91202;576;54;22;3;19;.864;3600000;0
3734;4504;577;0;0;0;0;.00nan;0;0
3734;22684;566;71;25;1;24;.960;3900000;0
3734;64721;566;0;0;0;0;.00nan;0;0
3734;143829;577;100;45;1;44;.978;3900000;0
3735;14459;576;85;38;2;36;.947;3900000;0
3735;38228;568;89;31;2;29;.935;3900000;0
3735;64923;568;0;0;0;0;.00nan;0;0
3735;91202;576;0;0;0;0;.00nan;0;0
3736;12859;569;65;34;4;30;.882;3900000;0
3736;174407;571;53;33;4;29;.879;3900000;0
3736;36571;569;0;0;0;0;.00nan;0;0
3736;53861;571;0;0;0;0;.00nan;0;0
3737;4484;574;0;0;0;0;.00nan;0;0
3737;68167;574;84;14;0;14;1.000;3600000;0
3737;73939;572;34;15;4;11;.733;922000;0
3737;84430;572;43;37;6;31;.838;2678000;0
3738;4504;577;70;28;2;26;.929;3900000;0
3738;65014;570;86;34;2;32;.941;3900000;0
3738;67626;570;0;0;0;0;.00nan;0;0
3738;143829;577;0;0;0;0;.00nan;0;0
3739;169493;562;0;0;0;0;.00nan;0;0
3739;78251;564;0;0;0;0;.00nan;0;0
3739;78815;562;82;39;3;36;.923;3600000;0
3739;90734;564;98;23;0;23;1.000;3600000;0
3740;14047;578;75;35;2;33;.943;3900000;0
3740;35520;578;0;0;0;0;.00nan;0;0
3740;56126;575;0;0;0;0;.00nan;0;0
3740;66245;575;71;25;2;23;.920;3900000;0
3741;174407;571;0;0;0;0;.00nan;0;0
3741;53861;571;78;20;0;20;1.000;3900000;0
3741;73939;572;100;36;0;36;1.000;3900000;0
3741;84430;572;0;0;0;0;.00nan;0;0
3742;22684;566;71;21;1;20;.952;3600000;0
3742;38228;568;0;0;0;0;.00nan;0;0
3742;64721;566;0;0;0;0;.00nan;0;0
3742;64923;568;88;39;2;37;.949;3590000;0
3743;1601;573;0;0;0;0;.00nan;0;0
3743;14459;576;0;0;0;0;.00nan;0;0
3743;84945;573;79;34;2;32;.941;3600000;0
3743;91202;576;91;19;0;19;1.000;3600000;0
3744;6127;565;54;40;5;35;.875;3900000;0
3744;12859;569;0;0;0;0;.00nan;0;0
3744;170042;565;0;0;0;0;.00nan;0;0
3744;36571;569;55;34;5;29;.853;3900000;0
3745;56126;575;0;0;0;0;.00nan;0;0
3745;65014;570;65;28;2;26;.929;3567000;0
3745;66245;575;88;34;1;33;.971;3600000;0
3745;67626;570;0;0;0;0;.00nan;0;0
3746;4504;577;0;0;0;0;.00nan;0;0
3746;169493;562;0;0;0;0;.00nan;0;0
3746;78815;562;60;32;4;28;.875;3568000;0
3746;143829;577;93;36;2;34;.944;3600000;0
3747;4484;574;0;0;0;0;.00nan;0;0
3747;68167;574;57;39;5;34;.872;3600000;0
3747;78251;564;0;0;0;0;.00nan;0;0
3747;90734;564;100;28;0;28;1.000;3600000;0
3748;22684;566;91;18;0;18;1.000;3600000;0
3748;64721;566;0;0;0;0;.00nan;0;0
3748;65014;570;70;46;5;41;.891;3600000;0
3748;67626;570;0;0;0;0;.00nan;0;0
3749;174407;571;0;0;0;0;.00nan;0;0
3749;38228;568;0;0;0;0;.00nan;0;0
3749;53861;571;82;39;3;36;.923;3573000;0
3749;64923;568;99;30;1;29;.967;3600000;0
3750;4484;574;0;0;0;0;.00nan;0;0
3750;5559;576;0;0;0;0;.00nan;0;0
3750;68167;574;90;27;1;26;.963;3600000;0
3750;91202;576;67;34;3;31;.912;3570000;0
3751;22684;566;0;0;0;0;.00nan;0;0
3751;64721;566;32;16;4;12;.750;3547000;0
3751;73939;572;95;45;2;43;.956;3600000;0
3751;84430;572;0;0;0;0;.00nan;0;0
3752;65014;570;81;34;2;32;.941;3900000;0
3752;67626;570;0;0;0;0;.00nan;0;0
3752;78251;564;0;0;0;0;.00nan;0;0
3752;90734;564;56;19;2;17;.895;3900000;0
3753;1601;573;0;0;0;0;.00nan;0;0
3753;169493;562;0;0;0;0;.00nan;0;0
3753;78815;562;100;41;2;39;.951;3900000;0
3753;84945;573;75;30;2;28;.933;3900000;0
3754;6127;565;70;31;3;28;.903;3521000;0
3754;170042;565;0;0;0;0;.00nan;0;0
3754;56126;575;0;0;0;0;.00nan;0;0
3754;66245;575;100;35;1;34;.971;3600000;0
3755;4504;577;0;0;0;0;.00nan;0;0
3755;38228;568;89;32;1;31;.969;3600000;0
3755;64923;568;0;0;0;0;.00nan;0;0
3755;143829;577;73;32;3;29;.906;3600000;0
3756;1601;573;85;45;3;42;.933;3900000;0
3756;73939;572;0;0;0;0;.00nan;0;0
3756;84430;572;76;34;3;31;.912;3900000;0
3756;84945;573;0;0;0;0;.00nan;0;0
3757;12859;569;66;36;4;32;.889;3570000;0
3757;36571;569;0;0;0;0;.00nan;0;0
3757;78251;564;82;31;2;29;.935;3600000;0
3757;90734;564;0;0;0;0;.00nan;0;0
3758;5559;576;0;0;0;0;.00nan;0;0
3758;56126;575;100;29;0;29;1.000;3600000;0
3758;66245;575;0;0;0;0;.00nan;0;0
3758;91202;576;51;26;4;22;.846;3600000;0
3759;4484;574;0;0;0;0;.00nan;0;0
3759;169493;562;0;0;0;0;.00nan;0;0
3759;68167;574;63;26;3;23;.885;3632000;0
3759;78815;562;58;31;4;27;.871;3632000;0
3760;4504;577;63;27;3;24;.889;3549000;0
3760;6127;565;0;0;0;0;.00nan;0;0
3760;170042;565;99;42;2;40;.952;3600000;0
3760;143829;577;0;0;0;0;.00nan;0;0
3761;14047;578;74;44;4;40;.909;3584000;0
3761;22684;566;71;28;2;26;.929;3600000;0
3761;35520;578;0;0;0;0;.00nan;0;0
3761;64721;566;0;0;0;0;.00nan;0;0
3762;12859;569;0;0;0;0;.00nan;0;0
3762;14047;578;0;0;0;0;.00nan;0;0
3762;35520;578;75;38;3;35;.921;3600000;0
3762;36571;569;64;16;2;14;.875;3600000;0
3763;1601;573;0;0;0;0;.00nan;0;0
3763;4484;574;0;0;0;0;.00nan;0;0
3763;68167;574;63;30;3;27;.900;3600000;0
3763;84945;573;40;28;5;23;.821;3529000;0
3764;6127;565;93;39;1;38;.974;3756000;0
3764;170042;565;0;0;0;0;.00nan;0;0
3764;38228;568;0;0;0;0;.00nan;0;0
3764;64923;568;55;17;2;15;.882;3756000;0
3765;12859;569;58;27;3;24;.889;3600000;0
3765;36571;569;0;0;0;0;.00nan;0;0
3765;65014;570;80;28;2;26;.929;3600000;0
3765;67626;570;0;0;0;0;.00nan;0;0
3766;174407;571;82;36;2;34;.944;3547000;0
3766;53861;571;0;0;0;0;.00nan;0;0
3766;56126;575;100;23;0;23;1.000;3600000;0
3766;66245;575;0;0;0;0;.00nan;0;0
3767;4504;577;0;0;0;0;.00nan;0;0
3767;5559;576;71;31;3;28;.903;3600000;0
3767;91202;576;0;0;0;0;.00nan;0;0
3767;143829;577;68;44;5;39;.886;3521000;0
3768;14047;578;81;40;4;36;.900;3528000;0
3768;169493;562;0;0;0;0;.00nan;0;0
3768;35520;578;0;0;0;0;.00nan;0;0
3768;78815;562;100;37;2;35;.946;3600000;0
3769;1601;573;84;45;3;42;.933;3600000;0
3769;4504;577;100;22;0;22;1.000;3600000;0
3769;84945;573;0;0;0;0;.00nan;0;0
3769;143829;577;0;0;0;0;.00nan;0;0
3770;169493;562;0;0;0;0;.00nan;0;0
3770;174407;571;95;25;0;25;1.000;3600000;0
3770;53861;571;0;0;0;0;.00nan;0;0
3770;78815;562;54;30;4;26;.867;3600000;0
3771;12859;569;79;22;1;21;.955;3600000;0
3771;36571;569;0;0;0;0;.00nan;0;0
3771;56126;575;66;43;6;37;.860;3600000;0
3771;66245;575;0;0;0;0;.00nan;0;0
3772;4484;574;0;0;0;0;.00nan;0;0
3772;22684;566;77;31;2;29;.935;3600000;0
3772;64721;566;0;0;0;0;.00nan;0;0
3772;68167;574;55;35;4;31;.886;3600000;0
3773;38228;568;0;0;0;0;.00nan;0;0
3773;64923;568;45;37;6;31;.838;3600000;0
3773;78251;564;0;0;0;0;.00nan;0;0
3773;90734;564;83;25;1;24;.960;3600000;0
3774;5559;576;53;27;4;23;.852;3567000;0
3774;73939;572;66;28;3;25;.893;3600000;0
3774;84430;572;0;0;0;0;.00nan;0;0
3774;91202;576;0;0;0;0;.00nan;0;0
3775;12859;569;53;5;0;5;1.000;482000;0
3775;36571;569;44;37;6;31;.838;3118000;0
3775;38228;568;87;28;1;27;.964;3600000;0
3775;64923;568;0;0;0;0;.00nan;0;0
3776;5559;576;0;0;0;0;.00nan;0;0
3776;73939;572;98;44;2;42;.955;3560000;0
3776;84430;572;0;0;0;0;.00nan;0;0
3776;91202;576;83;23;1;22;.957;3600000;0
3777;169493;562;0;0;0;0;.00nan;0;0
3777;174407;571;82;32;2;30;.938;3600000;0
3777;53861;571;0;0;0;0;.00nan;0;0
3777;78815;562;87;26;1;25;.962;3600000;0
3778;6127;565;97;41;3;38;.927;3593000;0
3778;170042;565;0;0;0;0;.00nan;0;0
3778;65014;570;76;23;1;22;.957;3600000;0
3778;67626;570;0;0;0;0;.00nan;0;0
3779;56126;575;0;0;0;0;.00nan;0;0
3779;66245;575;72;41;4;37;.902;3600000;0
3779;78251;564;64;30;3;27;.900;3600000;0
3779;90734;564;0;0;0;0;.00nan;0;0
3780;1601;573;58;24;3;21;.875;3541000;0
3780;14047;578;78;20;1;19;.950;3600000;0
3780;35520;578;0;0;0;0;.00nan;0;0
3780;84945;573;0;0;0;0;.00nan;0;0
3781;4484;574;0;0;0;0;.00nan;0;0
3781;22684;566;0;0;0;0;.00nan;0;0
3781;64721;566;71;30;2;28;.933;3576000;0
3781;68167;574;77;22;1;21;.955;3600000;0
3782;1601;573;74;47;5;42;.894;3600000;0
3782;22684;566;94;29;1;28;.966;3600000;0
3782;64721;566;0;0;0;0;.00nan;0;0
3782;84945;573;0;0;0;0;.00nan;0;0
3783;6127;565;0;0;0;0;.00nan;0;0
3783;170042;565;92;65;4;61;.938;3600000;0
3783;78251;564;0;0;0;0;.00nan;0;0
3783;90734;564;75;25;1;24;.960;3600000;0
3784;5559;576;52;21;3;18;.857;3900000;0
3784;73939;572;72;35;3;32;.914;3900000;0
3784;84430;572;0;0;0;0;.00nan;0;0
3784;91202;576;0;0;0;0;.00nan;0;0
3785;4484;574;0;0;0;0;.00nan;0;0
3785;4504;577;65;22;2;20;.909;3751000;0
3785;68167;574;61;26;3;23;.885;3751000;0
3785;143829;577;0;0;0;0;.00nan;0;0
3786;12859;569;57;27;3;24;.889;3560000;0
3786;22684;566;0;0;0;0;.00nan;0;0
3786;36571;569;0;0;0;0;.00nan;0;0
3786;64721;566;73;20;1;19;.950;3600000;0
3787;169493;562;0;0;0;0;.00nan;0;0
3787;56126;575;0;0;0;0;.00nan;0;0
3787;66245;575;60;32;3;29;.906;3900000;0
3787;78815;562;79;29;3;26;.897;3900000;0
3788;174407;571;0;0;0;0;.00nan;0;0
3788;53861;571;61;24;2;22;.917;3600000;0
3788;65014;570;63;28;3;25;.893;3580000;0
3788;67626;570;0;0;0;0;.00nan;0;0
3789;38228;568;0;0;0;0;.00nan;0;0
3789;64923;568;57;19;2;17;.895;3568000;0
3789;73939;572;0;0;0;0;.00nan;0;0
3789;84430;572;100;27;0;27;1.000;3600000;0
3790;5559;576;0;0;0;0;.00nan;0;0
3790;12859;569;0;0;0;0;.00nan;0;0
3790;36571;569;84;26;1;25;.962;3600000;0
3790;91202;576;65;31;2;29;.935;3566000;0
3791;14047;578;100;57;2;55;.965;3900000;0
3791;35520;578;0;0;0;0;.00nan;0;0
3791;78251;564;0;0;0;0;.00nan;0;0
3791;90734;564;65;20;2;18;.900;3900000;0
3792;169493;562;44;32;5;27;.844;3600000;0
3792;65014;570;66;24;2;22;.917;3600000;0
3792;67626;570;0;0;0;0;.00nan;0;0
3792;78815;562;0;0;0;0;.00nan;0;0
3793;1601;573;100;37;0;37;1.000;3600000;0
3793;6127;565;89;33;2;31;.939;3525000;0
3793;170042;565;0;0;0;0;.00nan;0;0
3793;84945;573;0;0;0;0;.00nan;0;0
3794;4504;577;0;0;0;0;.00nan;0;0
3794;56126;575;39;36;6;30;.833;3600000;0
3794;66245;575;0;0;0;0;.00nan;0;0
3794;143829;577;72;29;2;27;.931;3600000;0
3795;169493;562;0;0;0;0;.00nan;0;0
3795;73939;572;0;0;0;0;.00nan;0;0
3795;78815;562;65;27;3;24;.889;3518000;0
3795;84430;572;72;23;1;22;.957;3600000;0
3796;4484;574;0;0;0;0;.00nan;0;0
3796;5559;576;0;0;0;0;.00nan;0;0
3796;68167;574;73;32;3;29;.906;3900000;0
3796;91202;576;73;33;3;30;.909;3900000;0
3797;1601;573;0;0;0;0;.00nan;0;0
3797;78251;564;0;0;0;0;.00nan;0;0
3797;84945;573;81;60;6;54;.900;3600000;0
3797;90734;564;42;13;3;10;.769;3600000;0
3798;22684;566;0;0;0;0;.00nan;0;0
3798;174407;571;100;32;0;32;1.000;3600000;0
3798;53861;571;0;0;0;0;.00nan;0;0
3798;64721;566;69;24;2;22;.917;3581000;0
3799;38228;568;0;0;0;0;.00nan;0;0
3799;64923;568;35;22;5;17;.773;3600000;0
3799;65014;570;0;0;0;0;.00nan;0;0
3799;67626;570;77;22;1;21;.955;3600000;0
3800;6127;565;0;0;0;0;.00nan;0;0
3800;170042;565;64;26;3;23;.885;3600000;0
3800;56126;575;0;0;0;0;.00nan;0;0
3800;66245;575;82;41;2;39;.951;3600000;0
3801;12859;569;0;0;0;0;.00nan;0;0
3801;14047;578;83;34;2;32;.941;3600000;0
3801;35520;578;0;0;0;0;.00nan;0;0
3801;36571;569;50;23;3;20;.870;3582000;0
3802;14047;578;65;25;3;22;.880;3600000;0
3802;174407;571;91;23;0;23;1.000;3600000;0
3802;35520;578;0;0;0;0;.00nan;0;0
3802;53861;571;0;0;0;0;.00nan;0;0
3803;22684;566;46;12;2;10;.833;3567000;0
3803;64721;566;0;0;0;0;.00nan;0;0
3803;73939;572;99;35;1;34;.971;3600000;0
3803;84430;572;0;0;0;0;.00nan;0;0
3804;38228;568;83;27;1;26;.963;3600000;0
3804;64923;568;0;0;0;0;.00nan;0;0
3804;78251;564;0;0;0;0;.00nan;0;0
3804;90734;564;45;25;4;21;.840;3600000;0
3805;5559;576;0;0;0;0;.00nan;0;0
3805;65014;570;57;21;2;19;.905;3600000;0
3805;67626;570;0;0;0;0;.00nan;0;0
3805;91202;576;50;26;4;22;.846;3591000;0
3806;4504;577;0;0;0;0;.00nan;0;0
3806;6127;565;42;41;7;34;.829;3195000;0
3806;170042;565;57;8;0;8;1.000;405000;0
3806;143829;577;60;21;2;19;.905;3600000;0
3807;4484;574;0;0;0;0;.00nan;0;0
3807;68167;574;67;39;4;35;.897;3600000;0
3807;78251;564;87;28;1;27;.964;3600000;0
3807;90734;564;0;0;0;0;.00nan;0;0
3808;5559;576;0;0;0;0;.00nan;0;0
3808;22684;566;0;0;0;0;.00nan;0;0
3808;64721;566;59;28;3;25;.893;3900000;0
3808;91202;576;82;34;3;31;.912;3900000;0
3809;1601;573;54;35;5;30;.857;3691000;0
3809;174407;571;44;23;4;19;.826;3691000;0
3809;53861;571;0;0;0;0;.00nan;0;0
3809;84945;573;0;0;0;0;.00nan;0;0
3810;6127;565;71;34;2;32;.941;3900000;0
3810;170042;565;0;0;0;0;.00nan;0;0
3810;38228;568;0;0;0;0;.00nan;0;0
3810;64923;568;89;38;2;36;.947;3900000;0
3811;12859;569;0;0;0;0;.00nan;0;0
3811;36571;569;68;32;2;30;.938;3600000;0
3811;56126;575;97;26;0;26;1.000;3600000;0
3811;66245;575;0;0;0;0;.00nan;0;0
3812;4504;577;0;0;0;0;.00nan;0;0
3812;14047;578;30;32;6;26;.813;3600000;0
3812;35520;578;0;0;0;0;.00nan;0;0
3812;143829;577;92;33;1;32;.970;3600000;0
3813;4504;577;62;23;2;21;.913;3900000;0
3813;174407;571;0;0;0;0;.00nan;0;0
3813;53861;571;92;41;2;39;.951;3900000;0
3813;143829;577;0;0;0;0;.00nan;0;0
3814;14047;578;41;34;6;28;.824;3585000;0
3814;35520;578;0;0;0;0;.00nan;0;0
3814;73939;572;57;39;4;35;.897;3600000;0
3814;84430;572;0;0;0;0;.00nan;0;0
3815;38228;568;67;23;2;21;.913;3900000;0
3815;56126;575;83;37;2;35;.946;3900000;0
3815;64923;568;0;0;0;0;.00nan;0;0
3815;66245;575;0;0;0;0;.00nan;0;0
3816;6127;565;0;0;0;0;.00nan;0;0
3816;12859;569;76;29;2;27;.931;3576000;0
3816;170042;565;100;26;0;26;1.000;3600000;0
3816;36571;569;0;0;0;0;.00nan;0;0
3817;4484;574;0;0;0;0;.00nan;0;0
3817;169493;562;0;0;0;0;.00nan;0;0
3817;68167;574;61;32;4;28;.875;3577000;0
3817;78815;562;59;23;3;20;.870;3600000;0
3818;5559;576;85;36;2;34;.944;3600000;0
3818;22684;566;49;23;3;20;.870;3591000;0
3818;64721;566;0;0;0;0;.00nan;0;0
3818;91202;576;0;0;0;0;.00nan;0;0
3819;1601;573;0;0;0;0;.00nan;0;0
3819;65014;570;90;33;1;32;.970;3900000;0
3819;67626;570;0;0;0;0;.00nan;0;0
3819;84945;573;94;38;1;37;.974;3900000;0
3820;4484;574;0;0;0;0;.00nan;0;0
3820;4504;577;0;0;0;0;.00nan;0;0
3820;68167;574;69;36;3;33;.917;3600000;0
3820;143829;577;77;33;2;31;.939;3600000;0
3821;14047;578;65;38;4;34;.895;3651000;0
3821;35520;578;0;0;0;0;.00nan;0;0
3821;65014;570;77;33;3;30;.909;3651000;0
3821;67626;570;0;0;0;0;.00nan;0;0
3822;4484;574;0;0;0;0;.00nan;0;0
3822;12859;569;0;0;0;0;.00nan;0;0
3822;36571;569;55;29;3;26;.897;3591000;0
3822;68167;574;95;32;1;31;.969;3600000;0
3823;22684;566;88;35;2;33;.943;3900000;0
3823;64721;566;0;0;0;0;.00nan;0;0
3823;78251;564;0;0;0;0;.00nan;0;0
3823;90734;564;65;25;2;23;.920;3900000;0
3824;5559;576;0;0;0;0;.00nan;0;0
3824;174407;571;69;29;2;27;.931;3900000;0
3824;53861;571;0;0;0;0;.00nan;0;0
3824;91202;576;80;37;2;35;.946;3900000;0
3825;1601;573;67;36;3;33;.917;3600000;0
3825;73939;572;100;31;0;31;1.000;3600000;0
3825;84430;572;0;0;0;0;.00nan;0;0
3825;84945;573;0;0;0;0;.00nan;0;0
3826;4504;577;0;0;0;0;.00nan;0;0
3826;38228;568;0;0;0;0;.00nan;0;0
3826;64923;568;60;31;3;28;.903;3545000;0
3826;143829;577;66;26;2;24;.923;3600000;0
3827;22684;566;0;0;0;0;.00nan;0;0
3827;64721;566;63;36;4;32;.889;3900000;0
3827;78251;564;67;33;4;29;.879;3900000;0
3827;90734;564;0;0;0;0;.00nan;0;0
3828;6127;565;0;0;0;0;.00nan;0;0
3828;169493;562;0;0;0;0;.00nan;0;0
3828;170042;565;80;43;4;39;.907;3518000;0
3828;78815;562;94;33;2;31;.939;3600000;0
3829;14047;578;69;25;3;22;.880;3600000;0
3829;35520;578;0;0;0;0;.00nan;0;0
3829;56126;575;44;22;4;18;.818;2050000;0
3829;66245;575;72;15;0;15;1.000;1550000;0
3830;1601;573;74;38;4;34;.895;3676000;0
3830;38228;568;74;39;3;36;.923;3676000;0
3830;64923;568;0;0;0;0;.00nan;0;0
3830;84945;573;0;0;0;0;.00nan;0;0
3831;65014;570;71;24;2;22;.917;3600000;0
3831;67626;570;0;0;0;0;.00nan;0;0
3831;73939;572;74;49;5;44;.898;3600000;0
3831;84430;572;0;0;0;0;.00nan;0;0
3832;4484;574;0;0;0;0;.00nan;0;0
3832;12859;569;0;0;0;0;.00nan;0;0
3832;36571;569;49;27;4;23;.852;3600000;0
3832;68167;574;52;36;5;31;.861;3593000;0
3833;5559;576;61;34;4;30;.882;3528000;0
3833;14047;578;61;23;2;21;.913;3600000;0
3833;35520;578;0;0;0;0;.00nan;0;0
3833;91202;576;0;0;0;0;.00nan;0;0
3834;4504;577;65;23;2;21;.913;3600000;0
3834;56126;575;87;50;3;47;.940;3553000;0
3834;66245;575;0;0;0;0;.00nan;0;0
3834;143829;577;0;0;0;0;.00nan;0;0
3835;12859;569;0;0;0;0;.00nan;0;0
3835;36571;569;37;42;7;35;.833;3600000;0
3835;78251;564;0;0;0;0;.00nan;0;0
3835;90734;564;76;24;3;21;.875;3600000;0
3836;1601;573;0;0;0;0;.00nan;0;0
3836;6127;565;82;35;2;33;.943;3600000;0
3836;170042;565;0;0;0;0;.00nan;0;0
3836;84945;573;57;41;5;36;.878;3600000;0
3837;4504;577;0;0;0;0;.00nan;0;0
3837;73939;572;88;41;2;39;.951;3600000;0
3837;84430;572;0;0;0;0;.00nan;0;0
3837;143829;577;74;24;1;23;.958;3600000;0
3838;4484;574;48;32;4;28;.875;3600000;0
3838;38228;568;0;0;0;0;.00nan;0;0
3838;64923;568;100;32;1;31;.969;3600000;0
3838;68167;574;0;0;0;0;.00nan;0;0
3839;1601;573;70;33;4;29;.879;3579000;0
3839;22684;566;61;25;3;22;.880;3600000;0
3839;64721;566;0;0;0;0;.00nan;0;0
3839;84945;573;0;0;0;0;.00nan;0;0
3840;174407;571;84;37;3;34;.919;3600000;0
3840;53861;571;0;0;0;0;.00nan;0;0
3840;65014;570;57;25;4;21;.840;3560000;0
3840;67626;570;0;0;0;0;.00nan;0;0
3841;14047;578;83;37;3;34;.919;3600000;0
3841;169493;562;0;0;0;0;.00nan;0;0
3841;35520;578;0;0;0;0;.00nan;0;0
3841;78815;562;86;34;2;32;.941;3600000;0
3842;5559;576;0;0;0;0;.00nan;0;0
3842;56126;575;0;0;0;0;.00nan;0;0
3842;66245;575;41;14;3;11;.786;3570000;0
3842;91202;576;75;22;2;20;.909;3600000;0
3843;12859;569;0;0;0;0;.00nan;0;0
3843;36571;569;73;21;1;20;.952;3600000;0
3843;73939;572;88;48;3;45;.938;3584000;0
3843;84430;572;0;0;0;0;.00nan;0;0
3844;169493;562;0;0;0;0;.00nan;0;0
3844;174407;571;68;30;3;27;.900;3900000;0
3844;53861;571;0;0;0;0;.00nan;0;0
3844;78815;562;83;38;3;35;.921;3900000;0
3845;5559;576;0;0;0;0;.00nan;0;0
3845;38228;568;88;29;1;28;.966;3600000;0
3845;64923;568;0;0;0;0;.00nan;0;0
3845;91202;576;85;35;3;32;.914;3525000;0
3846;4504;577;0;0;0;0;.00nan;0;0
3846;12859;569;25;7;3;4;.571;586000;0
3846;36571;569;75;29;2;27;.931;2934000;0
3846;143829;577;69;32;3;29;.906;3600000;0
3847;22684;566;0;0;0;0;.00nan;0;0
3847;56126;575;30;9;3;6;.667;456000;0
3847;64721;566;56;22;3;19;.864;3600000;0
3847;66245;575;91;43;2;41;.953;3097000;0
3848;4484;574;0;0;0;0;.00nan;0;0
3848;65014;570;75;26;2;24;.923;3570000;0
3848;67626;570;0;0;0;0;.00nan;0;0
3848;68167;574;77;19;1;18;.947;3600000;0
3849;6127;565;50;46;6;40;.870;3101000;0
3849;14047;578;0;0;0;0;.00nan;0;0
3849;170042;565;51;8;1;7;.875;469000;0
3849;35520;578;43;30;5;25;.833;3600000;0
3850;6127;565;54;5;0;5;1.000;599000;0
3850;170042;565;49;35;6;29;.829;3001000;0
3850;174407;571;76;23;1;22;.957;3600000;0
3850;53861;571;0;0;0;0;.00nan;0;0
3851;4484;574;0;0;0;0;.00nan;0;0
3851;22684;566;58;21;2;19;.905;3600000;0
3851;64721;566;0;0;0;0;.00nan;0;0
3851;68167;574;58;46;6;40;.870;3600000;0
3852;5559;576;80;41;3;38;.927;3749000;0
3852;38228;568;0;0;0;0;.00nan;0;0
3852;64923;568;56;17;2;15;.882;3749000;0
3852;91202;576;0;0;0;0;.00nan;0;0
3853;4504;577;0;0;0;0;.00nan;0;0
3853;169493;562;85;28;1;27;.964;3600000;0
3853;78815;562;0;0;0;0;.00nan;0;0
3853;143829;577;76;30;2;28;.933;3545000;0
3854;1601;573;0;0;0;0;.00nan;0;0
3854;78251;564;0;0;0;0;.00nan;0;0
3854;84945;573;82;51;5;46;.902;3600000;0
3854;90734;564;59;25;2;23;.920;3600000;0
3855;14047;578;81;27;2;25;.926;3544000;0
3855;35520;578;0;0;0;0;.00nan;0;0
3855;56126;575;0;0;0;0;.00nan;0;0
3855;66245;575;73;26;1;25;.962;3600000;0
3856;5559;576;0;0;0;0;.00nan;0;0
3856;174407;571;90;12;0;12;1.000;3600000;0
3856;53861;571;0;0;0;0;.00nan;0;0
3856;91202;576;76;29;2;27;.931;3567000;0
3857;22684;566;0;0;0;0;.00nan;0;0
3857;38228;568;0;0;0;0;.00nan;0;0
3857;64721;566;84;30;2;28;.933;3600000;0
3857;64923;568;60;30;3;27;.900;3557000;0
3858;12859;569;0;0;0;0;.00nan;0;0
3858;36571;569;47;31;5;26;.839;3733000;0
3858;56126;575;0;0;0;0;.00nan;0;0
3858;66245;575;62;31;4;27;.871;3733000;0
3859;4484;574;0;0;0;0;.00nan;0;0
3859;6127;565;95;42;2;40;.952;3900000;0
3859;170042;565;0;0;0;0;.00nan;0;0
3859;68167;574;75;23;2;21;.913;3900000;0
3860;73939;572;46;37;6;31;.838;2058000;0
3860;78251;564;0;0;0;0;.00nan;0;0
3860;84430;572;84;30;1;29;.967;1542000;0
3860;90734;564;54;21;3;18;.857;3600000;0
3861;1601;573;0;0;0;0;.00nan;0;0
3861;65014;570;80;27;1;26;.963;3600000;0
3861;67626;570;0;0;0;0;.00nan;0;0
3861;84945;573;57;36;4;32;.889;3600000;0
3862;4504;577;0;0;0;0;.00nan;0;0
3862;169493;562;0;0;0;0;.00nan;0;0
3862;78815;562;55;37;5;32;.865;3600000;0
3862;143829;577;68;21;1;20;.952;3600000;0
3863;56126;575;54;19;2;17;.895;3600000;0
3863;66245;575;0;0;0;0;.00nan;0;0
3863;73939;572;60;35;4;31;.886;3600000;0
3863;84430;572;0;0;0;0;.00nan;0;0
3864;5559;576;90;21;0;21;1.000;3600000;0
3864;169493;562;0;0;0;0;.00nan;0;0
3864;78815;562;77;24;1;23;.958;3600000;0
3864;91202;576;0;0;0;0;.00nan;0;0
3865;1601;573;93;50;3;47;.940;3600000;0
3865;12859;569;100;25;0;25;1.000;3600000;0
3865;36571;569;0;0;0;0;.00nan;0;0
3865;84945;573;0;0;0;0;.00nan;0;0
3866;4484;574;71;22;2;20;.909;3900000;0
3866;6127;565;0;0;0;0;.00nan;0;0
3866;170042;565;70;26;2;24;.923;3900000;0
3866;68167;574;0;0;0;0;.00nan;0;0
3867;4504;577;0;0;0;0;.00nan;0;0
3867;174407;571;97;35;2;33;.943;3600000;0
3867;53861;571;0;0;0;0;.00nan;0;0
3867;143829;577;61;33;3;30;.909;3600000;0
3868;14047;578;93;39;2;37;.949;3551000;0
3868;35520;578;0;0;0;0;.00nan;0;0
3868;78251;564;0;0;0;0;.00nan;0;0
3868;90734;564;76;21;1;20;.952;3600000;0
3869;22684;566;53;32;4;28;.875;3600000;0
3869;64721;566;0;0;0;0;.00nan;0;0
3869;65014;570;96;32;1;31;.969;3600000;0
3869;67626;570;0;0;0;0;.00nan;0;0
3870;174407;571;98;58;3;55;.948;3600000;0
3870;53861;571;0;0;0;0;.00nan;0;0
3870;78251;564;0;0;0;0;.00nan;0;0
3870;90734;564;54;15;2;13;.867;3600000;0
3871;14047;578;80;43;4;39;.907;3627000;0
3871;35520;578;0;0;0;0;.00nan;0;0
3871;38228;568;0;0;0;0;.00nan;0;0
3871;64923;568;45;17;3;14;.824;3627000;0
3872;1601;573;0;0;0;0;.00nan;0;0
3872;174407;571;70;20;1;19;.950;3600000;0
3872;53861;571;0;0;0;0;.00nan;0;0
3872;84945;573;98;50;2;48;.960;3600000;0
3873;12859;569;66;34;3;31;.912;3600000;0
3873;14047;578;46;32;5;27;.844;3555000;0
3873;35520;578;0;0;0;0;.00nan;0;0
3873;36571;569;0;0;0;0;.00nan;0;0
3874;4484;574;0;0;0;0;.00nan;0;0
3874;56126;575;66;19;1;18;.947;3600000;0
3874;66245;575;0;0;0;0;.00nan;0;0
3874;68167;574;65;24;2;22;.917;3546000;0
3875;4504;577;0;0;0;0;.00nan;0;0
3875;22684;566;0;0;0;0;.00nan;0;0
3875;64721;566;48;26;4;22;.846;3568000;0
3875;143829;577;68;36;3;33;.917;3600000;0
3876;5559;576;100;24;0;24;1.000;3600000;0
3876;65014;570;82;27;1;26;.963;3553000;0
3876;67626;570;0;0;0;0;.00nan;0;0
3876;91202;576;0;0;0;0;.00nan;0;0
3877;169493;562;0;0;0;0;.00nan;0;0
3877;78251;564;0;0;0;0;.00nan;0;0
3877;78815;562;99;46;2;44;.957;3600000;0
3877;90734;564;52;23;3;20;.870;3548000;0
3878;6127;565;68;31;3;28;.903;3600000;0
3878;170042;565;0;0;0;0;.00nan;0;0
3878;73939;572;67;45;6;39;.867;3600000;0
3878;84430;572;0;0;0;0;.00nan;0;0
3879;4484;574;0;0;0;0;.00nan;0;0
3879;68167;574;100;26;0;26;1.000;3600000;0
3879;73939;572;68;40;4;36;.900;3600000;0
3879;84430;572;0;0;0;0;.00nan;0;0
3880;174407;571;100;37;1;36;.973;3600000;0
3880;53861;571;0;0;0;0;.00nan;0;0
3880;78251;564;0;0;0;0;.00nan;0;0
3880;90734;564;38;24;5;19;.792;3600000;0
3881;12859;569;91;39;2;37;.949;3600000;0
3881;169493;562;0;0;0;0;.00nan;0;0
3881;36571;569;0;0;0;0;.00nan;0;0
3881;78815;562;41;30;5;25;.833;3600000;0
3882;1601;573;0;0;0;0;.00nan;0;0
3882;38228;568;38;17;4;13;.765;3600000;0
3882;64923;568;0;0;0;0;.00nan;0;0
3882;84945;573;52;45;6;39;.867;3567000;0
3883;56126;575;0;0;0;0;.00nan;0;0
3883;65014;570;99;45;3;42;.933;3900000;0
3883;66245;575;76;36;3;33;.917;3900000;0
3883;67626;570;0;0;0;0;.00nan;0;0
3884;4504;577;0;0;0;0;.00nan;0;0
3884;22684;566;65;37;4;33;.892;3565000;0
3884;64721;566;0;0;0;0;.00nan;0;0
3884;143829;577;73;29;3;26;.897;3600000;0
3885;5559;576;60;25;3;22;.880;3600000;0
3885;14047;578;59;31;4;27;.871;3562000;0
3885;35520;578;0;0;0;0;.00nan;0;0
3885;91202;576;0;0;0;0;.00nan;0;0
3886;169493;562;0;0;0;0;.00nan;0;0
3886;38228;568;0;0;0;0;.00nan;0;0
3886;64923;568;62;21;2;19;.905;3545000;0
3886;78815;562;100;35;1;34;.971;3600000;0
3887;12859;569;0;0;0;0;.00nan;0;0
3887;174407;571;64;21;2;19;.905;3634000;0
3887;36571;569;80;34;3;31;.912;3634000;0
3887;53861;571;0;0;0;0;.00nan;0;0
3888;4484;574;0;0;0;0;.00nan;0;0
3888;68167;574;88;51;4;47;.922;3600000;0
3888;78251;564;0;0;0;0;.00nan;0;0
3888;90734;564;76;19;1;18;.947;3600000;0
3889;1601;573;87;54;4;50;.926;3900000;0
3889;5559;576;46;21;4;17;.810;3900000;0
3889;84945;573;0;0;0;0;.00nan;0;0
3889;91202;576;0;0;0;0;.00nan;0;0
3890;6127;565;100;46;1;45;.978;3856000;0
3890;170042;565;0;0;0;0;.00nan;0;0
3890;22684;566;60;19;2;17;.895;3856000;0
3890;64721;566;0;0;0;0;.00nan;0;0
3891;4504;577;0;0;0;0;.00nan;0;0
3891;65014;570;63;24;3;21;.875;3600000;0
3891;67626;570;0;0;0;0;.00nan;0;0
3891;143829;577;51;31;5;26;.839;3557000;0
3892;14047;578;74;24;1;23;.958;3600000;0
3892;35520;578;0;0;0;0;.00nan;0;0
3892;73939;572;62;34;3;31;.912;3600000;0
3892;84430;572;0;0;0;0;.00nan;0;0
3893;174407;571;100;44;2;42;.955;3600000;0
3893;53861;571;0;0;0;0;.00nan;0;0
3893;56126;575;0;0;0;0;.00nan;0;0
3893;66245;575;42;25;5;20;.800;3600000;0
3894;38228;568;0;0;0;0;.00nan;0;0
3894;64923;568;56;18;2;16;.889;3546000;0
3894;73939;572;99;49;1;48;.980;3600000;0
3894;84430;572;0;0;0;0;.00nan;0;0
3895;4504;577;0;0;0;0;.00nan;0;0
3895;12859;569;100;29;0;29;1.000;3600000;0
3895;36571;569;0;0;0;0;.00nan;0;0
3895;143829;577;58;23;3;20;.870;3600000;0
3896;1601;573;0;0;0;0;.00nan;0;0
3896;4484;574;0;0;0;0;.00nan;0;0
3896;68167;574;64;25;2;23;.920;3600000;0
3896;84945;573;87;42;3;39;.929;3589000;0
3897;5559;576;94;39;2;37;.949;3584000;0
3897;78251;564;0;0;0;0;.00nan;0;0
3897;90734;564;73;21;1;20;.952;3600000;0
3897;91202;576;0;0;0;0;.00nan;0;0
3898;6127;565;48;34;5;29;.853;3600000;0
3898;170042;565;0;0;0;0;.00nan;0;0
3898;65014;570;0;0;0;0;.00nan;0;0
3898;67626;570;100;24;0;24;1.000;3600000;0
3899;14047;578;92;25;1;24;.960;3600000;0
3899;169493;562;0;0;0;0;.00nan;0;0
3899;35520;578;0;0;0;0;.00nan;0;0
3899;78815;562;75;33;2;31;.939;3600000;0
3900;4484;574;0;0;0;0;.00nan;0;0
3900;65014;570;0;0;0;0;.00nan;0;0
3900;67626;570;61;40;5;35;.875;3600000;0
3900;68167;574;71;32;2;30;.938;3600000;0
3901;73939;572;70;45;5;40;.889;3600000;0
3901;78251;564;0;0;0;0;.00nan;0;0
3901;84430;572;0;0;0;0;.00nan;0;0
3901;90734;564;79;10;0;10;1.000;3600000;0
3902;169493;562;0;0;0;0;.00nan;0;0
3902;38228;568;0;0;0;0;.00nan;0;0
3902;64923;568;67;24;2;22;.917;3900000;0
3902;78815;562;99;37;2;35;.946;3900000;0
3903;1601;573;0;0;0;0;.00nan;0;0
3903;174407;571;98;35;1;34;.971;3600000;0
3903;53861;571;0;0;0;0;.00nan;0;0
3903;84945;573;67;34;4;30;.882;3600000;0
3904;6127;565;98;37;2;35;.946;3900000;0
3904;12859;569;60;27;2;25;.926;3900000;0
3904;170042;565;0;0;0;0;.00nan;0;0
3904;36571;569;0;0;0;0;.00nan;0;0
3905;14047;578;96;37;2;35;.946;3600000;0
3905;35520;578;0;0;0;0;.00nan;0;0
3905;56126;575;0;0;0;0;.00nan;0;0
3905;66245;575;73;41;3;38;.927;3547000;0
3906;4504;577;0;0;0;0;.00nan;0;0
3906;5559;576;81;32;2;30;.938;3600000;0
3906;91202;576;0;0;0;0;.00nan;0;0
3906;143829;577;78;32;3;29;.906;3531000;0
3907;5559;576;58;17;2;15;.882;3682000;0
3907;56126;575;0;0;0;0;.00nan;0;0
3907;66245;575;69;33;3;30;.909;3682000;0
3907;91202;576;0;0;0;0;.00nan;0;0
3908;4484;574;0;0;0;0;.00nan;0;0
3908;14047;571;0;0;0;0;.00nan;0;0
3908;174407;571;67;24;2;22;.917;3600000;0
3908;68167;574;31;23;5;18;.783;3600000;0
3909;6127;565;81;36;3;33;.917;3600000;0
3909;170042;565;0;0;0;0;.00nan;0;0
3909;73939;572;46;38;6;32;.842;3600000;0
3909;84430;572;0;0;0;0;.00nan;0;0
3910;14047;578;75;55;5;50;.909;3600000;0
3910;35520;578;0;0;0;0;.00nan;0;0
3910;38228;568;78;14;0;14;1.000;3600000;0
3910;64923;568;0;0;0;0;.00nan;0;0
3911;12859;569;78;26;2;24;.923;3600000;0
3911;36571;569;0;0;0;0;.00nan;0;0
3911;65014;570;83;40;3;37;.925;3580000;0
3911;67626;570;0;0;0;0;.00nan;0;0
3912;1601;573;60;31;3;28;.903;3572000;0
3912;169493;562;0;0;0;0;.00nan;0;0
3912;78815;562;74;21;2;19;.905;3600000;0
3912;84945;573;0;0;0;0;.00nan;0;0
3913;4504;577;0;0;0;0;.00nan;0;0
3913;78251;564;0;0;0;0;.00nan;0;0
3913;90734;564;70;22;1;21;.955;3600000;0
3913;143829;577;81;50;4;46;.920;3600000;0
3914;12859;569;0;0;0;0;.00nan;0;0
3914;36571;569;92;22;0;22;1.000;3600000;0
3914;73939;572;64;23;2;21;.913;3543000;0
3914;84430;572;0;0;0;0;.00nan;0;0
3915;4484;574;0;0;0;0;.00nan;0;0
3915;4504;577;0;0;0;0;.00nan;0;0
3915;68167;574;69;36;3;33;.917;3600000;0
3915;143829;577;65;36;4;32;.889;3600000;0
3916;5559;576;37;29;5;24;.828;2175000;0
3916;78251;564;0;0;0;0;.00nan;0;0
3916;90734;564;58;24;3;21;.875;3600000;0
3916;91202;576;72;17;1;16;.941;1425000;0
3917;169493;562;0;0;0;0;.00nan;0;0
3917;65014;570;69;28;2;26;.929;3600000;0
3917;67626;570;0;0;0;0;.00nan;0;0
3917;78815;562;76;24;1;23;.958;3600000;0
3918;6127;565;34;34;6;28;.824;3176000;0
3918;170042;565;54;6;0;6;1.000;424000;0
3918;38228;568;92;34;1;33;.971;3600000;0
3918;64923;568;0;0;0;0;.00nan;0;0
3919;174407;571;75;20;1;19;.950;3600000;0
3919;53861;571;0;0;0;0;.00nan;0;0
3919;73939;572;49;23;3;20;.870;1608000;0
3919;84430;572;81;37;4;33;.892;1992000;0
3920;5559;576;64;26;3;23;.885;3600000;0
3920;174407;571;0;0;0;0;.00nan;0;0
3920;53861;571;48;30;5;25;.833;3561000;0
3920;91202;576;0;0;0;0;.00nan;0;0
3921;4484;574;0;0;0;0;.00nan;0;0
3921;12859;569;0;0;0;0;.00nan;0;0
3921;36571;569;81;42;3;39;.929;3526000;0
3921;68167;574;100;38;1;37;.974;3600000;0
3922;22684;566;75;29;2;27;.931;3891000;0
3922;64721;566;0;0;0;0;.00nan;0;0
3922;78251;564;0;0;0;0;.00nan;0;0
3922;90734;564;76;37;3;34;.919;3891000;0
3923;38228;568;63;24;2;22;.917;3600000;0
3923;64923;568;0;0;0;0;.00nan;0;0
3923;65014;570;95;23;0;23;1.000;3600000;0
3923;67626;570;0;0;0;0;.00nan;0;0
3924;14047;578;75;39;4;35;.897;3652000;0
3924;35520;578;0;0;0;0;.00nan;0;0
3924;56126;575;0;0;0;0;.00nan;0;0
3924;66245;575;43;14;3;11;.786;3652000;0
3925;4504;577;84;27;1;26;.963;3600000;0
3925;6127;565;81;58;6;52;.897;3600000;0
3925;170042;565;0;0;0;0;.00nan;0;0
3925;143829;577;0;0;0;0;.00nan;0;0
3926;4484;574;0;0;0;0;.00nan;0;0
3926;38228;568;0;0;0;0;.00nan;0;0
3926;64923;568;67;34;4;30;.882;3586000;0
3926;68167;574;74;33;3;30;.909;3600000;0
3927;12859;569;44;32;5;27;.844;2935000;0
3927;36571;569;44;4;1;3;.750;665000;0
3927;78251;564;0;0;0;0;.00nan;0;0
3927;90734;564;92;30;1;29;.967;3600000;0
3928;22684;566;0;0;0;0;.00nan;0;0
3928;64721;566;40;12;3;9;.750;3900000;0
3928;73939;572;100;66;3;63;.955;3900000;0
3928;84430;572;0;0;0;0;.00nan;0;0
3929;5559;576;0;0;0;0;.00nan;0;0
3929;169493;562;0;0;0;0;.00nan;0;0
3929;78815;562;45;23;4;19;.826;3600000;0
3929;91202;576;93;23;0;23;1.000;3600000;0
3930;1601;573;75;39;4;35;.897;3600000;0
3930;65014;570;30;26;6;20;.769;3568000;0
3930;67626;570;0;0;0;0;.00nan;0;0
3930;84945;573;0;0;0;0;.00nan;0;0
3931;4504;577;0;0;0;0;.00nan;0;0
3931;14047;578;32;30;5;25;.833;1607000;0
3931;35520;578;17;29;7;22;.759;1993000;0
3931;143829;577;65;20;2;18;.900;3600000;0
3932;174407;571;61;16;1;15;.938;3600000;0
3932;38228;568;0;0;0;0;.00nan;0;0
3932;53861;571;0;0;0;0;.00nan;0;0
3932;64923;568;66;22;2;20;.909;3546000;0
3933;12859;569;0;0;0;0;.00nan;0;0
3933;169493;562;0;0;0;0;.00nan;0;0
3933;36571;569;79;26;1;25;.962;3741000;0
3933;78815;562;94;44;2;42;.955;3741000;0
3934;4484;574;0;0;0;0;.00nan;0;0
3934;5559;576;0;0;0;0;.00nan;0;0
3934;68167;574;60;21;2;19;.905;3600000;0
3934;91202;576;56;37;5;32;.865;3600000;0
3935;1601;573;44;24;4;20;.833;3600000;0
3935;6127;565;23;9;4;5;.556;1038000;0
3935;170042;565;40;21;4;17;.810;2562000;0
3935;84945;573;0;0;0;0;.00nan;0;0
3936;14047;578;96;50;3;47;.940;3600000;0
3936;22684;566;88;16;0;16;1.000;3600000;0
3936;35520;578;0;0;0;0;.00nan;0;0
3936;64721;566;0;0;0;0;.00nan;0;0
3937;4504;577;0;0;0;0;.00nan;0;0
3937;65014;570;25;27;6;21;.778;1974000;0
3937;67626;570;73;22;1;21;.955;1626000;0
3937;143829;577;48;27;4;23;.852;3600000;0
3938;14047;578;58;33;4;29;.879;3600000;0
3938;35520;578;0;0;0;0;.00nan;0;0
3938;73939;572;65;12;0;12;1.000;1077000;0
3938;84430;572;19;24;6;18;.750;2458000;0
3939;1601;573;0;0;0;0;.00nan;0;0
3939;12859;569;0;0;0;0;.00nan;0;0
3939;36571;569;73;23;2;21;.913;3569000;0
3939;84945;573;81;25;1;24;.960;3600000;0
3940;38228;568;85;26;0;26;1.000;2538000;0
3940;64923;568;16;15;5;10;.667;1062000;0
3940;78251;564;0;0;0;0;.00nan;0;0
3940;90734;564;55;19;2;17;.895;3600000;0
3941;6127;565;74;54;6;48;.889;3600000;0
3941;170042;565;0;0;0;0;.00nan;0;0
3941;22684;566;100;40;1;39;.975;3600000;0
3941;64721;566;0;0;0;0;.00nan;0;0
3942;169493;562;0;0;0;0;.00nan;0;0
3942;56126;575;0;0;0;0;.00nan;0;0
3942;66245;575;74;35;3;32;.914;3600000;0
3942;78815;562;54;33;4;29;.879;3583000;0
3943;4484;574;0;0;0;0;.00nan;0;0
3943;68167;574;81;37;3;34;.919;3546000;0
3943;78251;564;0;0;0;0;.00nan;0;0
3943;90734;564;66;14;1;13;.929;3600000;0
3944;5559;576;91;36;1;35;.972;3600000;0
3944;38228;568;0;0;0;0;.00nan;0;0
3944;64923;568;56;43;5;38;.884;3600000;0
3944;91202;576;0;0;0;0;.00nan;0;0
3945;65014;570;85;21;1;20;.952;3600000;0
3945;67626;570;0;0;0;0;.00nan;0;0
3945;73939;572;93;44;4;40;.909;3600000;0
3945;84430;572;0;0;0;0;.00nan;0;0
3946;1601;573;100;45;1;44;.978;3600000;0
3946;6127;565;0;0;0;0;.00nan;0;0
3946;170042;565;62;26;3;23;.885;3555000;0
3946;84945;573;0;0;0;0;.00nan;0;0
3947;22684;566;0;0;0;0;.00nan;0;0
3947;56126;575;100;52;2;50;.962;3600000;0
3947;64721;566;44;14;3;11;.786;3545000;0
3947;66245;575;0;0;0;0;.00nan;0;0
3948;12859;569;78;19;1;18;.947;3600000;0
3948;14047;578;64;32;4;28;.875;3600000;0
3948;35520;578;0;0;0;0;.00nan;0;0
3948;36571;569;0;0;0;0;.00nan;0;0
3949;4504;577;0;0;0;0;.00nan;0;0
3949;174407;571;43;27;4;23;.852;3553000;0
3949;53861;571;0;0;0;0;.00nan;0;0
3949;143829;577;67;22;2;20;.909;3600000;0
3950;14047;578;57;43;5;38;.884;3515000;0
3950;174407;571;79;34;3;31;.912;3600000;0
3950;35520;578;0;0;0;0;.00nan;0;0
3950;53861;571;0;0;0;0;.00nan;0;0
3951;169493;562;0;0;0;0;.00nan;0;0
3951;73939;572;0;0;0;0;.00nan;0;0
3951;78815;562;69;33;3;30;.909;3563000;0
3951;84430;572;78;34;2;32;.941;3600000;0
3952;6127;565;81;35;3;32;.914;3600000;0
3952;170042;565;0;0;0;0;.00nan;0;0
3952;38228;568;53;38;5;33;.868;3550000;0
3952;64923;568;0;0;0;0;.00nan;0;0
3953;1601;573;0;0;0;0;.00nan;0;0
3953;4504;577;0;0;0;0;.00nan;0;0
3953;84945;573;70;31;3;28;.903;3543000;0
3953;143829;577;81;26;2;24;.923;3600000;0
3954;56126;575;0;0;0;0;.00nan;0;0
3954;66245;575;58;36;5;31;.861;3600000;0
3954;78251;564;0;0;0;0;.00nan;0;0
3954;90734;564;100;28;0;28;1.000;3600000;0
3955;65014;570;88;35;2;33;.943;3900000;0
3955;67626;570;0;0;0;0;.00nan;0;0
3955;78251;564;0;0;0;0;.00nan;0;0
3955;90734;564;74;26;2;24;.923;3900000;0
3956;4484;574;0;0;0;0;.00nan;0;0
3956;169493;562;37;25;5;20;.800;3600000;0
3956;68167;574;77;32;2;30;.938;3600000;0
3956;78815;562;0;0;0;0;.00nan;0;0
3957;5559;576;27;24;6;18;.750;1873000;0
3957;73939;572;28;15;4;11;.733;1137000;0
3957;84430;572;43;30;5;25;.833;2463000;0
3957;91202;576;60;6;0;6;1.000;1727000;0
3958;174407;571;40;32;5;27;.844;3600000;0
3958;38228;568;0;0;0;0;.00nan;0;0
3958;53861;571;0;0;0;0;.00nan;0;0
3958;64923;568;70;17;1;16;.941;3600000;0
3959;22684;566;97;19;0;19;1.000;3600000;0
3959;56126;575;0;0;0;0;.00nan;0;0
3959;64721;566;0;0;0;0;.00nan;0;0
3959;66245;575;73;34;3;31;.912;3600000;0
3960;6127;565;99;38;1;37;.974;3600000;0
3960;14047;578;52;16;2;14;.875;3596000;0
3960;170042;565;0;0;0;0;.00nan;0;0
3960;35520;578;0;0;0;0;.00nan;0;0
3961;4504;577;0;0;0;0;.00nan;0;0
3961;169493;562;0;0;0;0;.00nan;0;0
3961;78815;562;77;48;5;43;.896;3600000;0
3961;143829;577;47;24;4;20;.833;3600000;0
3962;5559;576;55;22;3;19;.864;3900000;0
3962;73939;572;70;41;3;38;.927;3900000;0
3962;84430;572;0;0;0;0;.00nan;0;0
3962;91202;576;0;0;0;0;.00nan;0;0
3963;12859;569;0;0;0;0;.00nan;0;0
3963;36571;569;82;37;3;34;.919;3600000;0
3963;38228;568;54;33;5;28;.848;3531000;0
3963;64923;568;0;0;0;0;.00nan;0;0
3964;4484;574;0;0;0;0;.00nan;0;0
3964;14047;578;94;55;4;51;.927;3600000;0
3964;35520;578;0;0;0;0;.00nan;0;0
3964;68167;574;75;23;1;22;.957;3600000;0
3965;22684;566;28;10;4;6;.600;1768000;0
3965;64721;566;61;15;1;14;.933;1832000;0
3965;65014;570;67;30;2;28;.933;3600000;0
3965;67626;570;0;0;0;0;.00nan;0;0
3966;1601;573;68;32;4;28;.875;3600000;0
3966;56126;575;33;31;6;25;.806;3538000;0
3966;66245;575;0;0;0;0;.00nan;0;0
3966;84945;573;0;0;0;0;.00nan;0;0
3967;6127;565;24;29;6;23;.793;2268000;0
3967;170042;565;75;15;0;15;1.000;1332000;0
3967;78251;564;0;0;0;0;.00nan;0;0
3967;90734;564;54;16;2;14;.875;3600000;0
3968;4484;574;0;0;0;0;.00nan;0;0
3968;56126;575;0;0;0;0;.00nan;0;0
3968;66245;575;67;25;2;23;.920;3576000;0
3968;68167;574;79;21;1;20;.952;3600000;0
3969;1601;573;0;0;0;0;.00nan;0;0
3969;174407;571;49;21;3;18;.857;3600000;0
3969;53861;571;0;0;0;0;.00nan;0;0
3969;84945;573;76;42;4;38;.905;3586000;0
3970;169493;562;0;0;0;0;.00nan;0;0
3970;38228;568;0;0;0;0;.00nan;0;0
3970;64923;568;48;18;3;15;.833;3576000;0
3970;78815;562;99;41;2;39;.951;3600000;0
3971;65014;570;53;29;4;25;.862;3544000;0
3971;67626;570;0;0;0;0;.00nan;0;0
3971;78251;564;0;0;0;0;.00nan;0;0
3971;90734;564;78;27;3;24;.889;3600000;0
3972;12859;569;49;2;0;2;1.000;458000;0
3972;22684;566;63;30;3;27;.900;3600000;0
3972;36571;569;47;37;6;31;.838;3142000;0
3972;64721;566;0;0;0;0;.00nan;0;0
3973;5559;576;52;9;1;8;.889;3600000;0
3973;6127;565;98;46;2;44;.957;3600000;0
3973;170042;565;0;0;0;0;.00nan;0;0
3973;91202;576;0;0;0;0;.00nan;0;0
3974;4504;577;0;0;0;0;.00nan;0;0
3974;38228;568;87;27;1;26;.963;3600000;0
3974;64923;568;0;0;0;0;.00nan;0;0
3974;143829;577;77;38;3;35;.921;3514000;0
3975;4484;574;0;0;0;0;.00nan;0;0
3975;22684;566;93;20;0;20;1.000;3600000;0
3975;64721;566;0;0;0;0;.00nan;0;0
3975;68167;574;41;27;5;22;.815;3600000;0
3976;6127;565;41;37;6;31;.838;3172000;0
3976;170042;565;59;7;0;7;1.000;428000;0
3976;65014;570;64;20;2;18;.900;3600000;0
3976;67626;570;0;0;0;0;.00nan;0;0
3977;169493;562;0;0;0;0;.00nan;0;0
3977;174407;571;84;22;1;21;.955;3600000;0
3977;53861;571;0;0;0;0;.00nan;0;0
3977;78815;562;72;39;4;35;.897;3600000;0
3978;1601;573;99;31;1;30;.968;3600000;0
3978;73939;572;96;39;2;37;.949;3546000;0
3978;84430;572;0;0;0;0;.00nan;0;0
3978;84945;573;0;0;0;0;.00nan;0;0
3979;12859;569;0;0;0;0;.00nan;0;0
3979;36571;569;79;25;1;24;.960;3600000;0
3979;56126;575;0;0;0;0;.00nan;0;0
3979;66245;575;41;36;6;30;.833;3600000;0
3980;14047;578;0;0;0;0;.00nan;0;0
3980;35520;578;88;47;4;43;.915;3600000;0
3980;78251;564;0;0;0;0;.00nan;0;0
3980;90734;564;87;18;0;18;1.000;3600000;0
3981;38228;568;48;28;5;23;.821;3900000;0
3981;56126;575;58;39;5;34;.872;3900000;0
3981;64923;568;0;0;0;0;.00nan;0;0
3981;66245;575;0;0;0;0;.00nan;0;0
3982;169493;562;29;50;8;42;.840;3600000;0
3982;174407;571;0;0;0;0;.00nan;0;0
3982;53861;571;84;27;1;26;.963;3600000;0
3982;78815;562;0;0;0;0;.00nan;0;0
3983;12859;569;57;19;2;17;.895;3600000;0
3983;14047;578;75;37;3;34;.919;3570000;0
3983;35520;578;0;0;0;0;.00nan;0;0
3983;36571;569;0;0;0;0;.00nan;0;0
3984;4484;574;17;29;7;22;.759;2890000;0
3984;22684;566;78;23;1;22;.957;3600000;0
3984;64721;566;0;0;0;0;.00nan;0;0
3984;68167;574;54;5;0;5;1.000;710000;0
3985;4504;577;0;0;0;0;.00nan;0;0
3985;5559;576;0;0;0;0;.00nan;0;0
3985;91202;576;43;34;5;29;.853;3600000;0
3985;143829;577;71;28;2;26;.929;3600000;0
3986;6127;565;0;0;0;0;.00nan;0;0
3986;170042;565;77;37;3;34;.919;3664000;0
3986;65014;570;52;20;4;16;.800;3664000;0
3986;67626;570;0;0;0;0;.00nan;0;0
3987;1601;573;0;0;0;0;.00nan;0;0
3987;78251;564;0;0;0;0;.00nan;0;0
3987;84945;573;97;44;2;42;.955;3543000;0
3987;90734;564;62;16;1;15;.938;3600000;0
3988;4484;574;0;0;0;0;.00nan;0;0
3988;174407;571;100;44;2;42;.955;3600000;0
3988;53861;571;0;0;0;0;.00nan;0;0
3988;68167;574;53;42;6;36;.857;3600000;0
3989;12859;569;0;0;0;0;.00nan;0;0
3989;36571;569;82;26;2;24;.923;3600000;0
3989;73939;572;56;39;4;35;.897;3600000;0
3989;84430;572;0;0;0;0;.00nan;0;0
3990;5559;576;54;18;2;16;.889;3600000;0
3990;169493;562;0;0;0;0;.00nan;0;0
3990;78815;562;80;36;3;33;.917;3544000;0
3990;91202;576;0;0;0;0;.00nan;0;0
3991;1601;573;66;21;3;18;.857;3715000;0
3991;6127;565;79;32;2;30;.938;3715000;0
3991;170042;565;0;0;0;0;.00nan;0;0
3991;84945;573;0;0;0;0;.00nan;0;0
3992;22684;566;65;25;3;22;.880;3549000;0
3992;64721;566;0;0;0;0;.00nan;0;0
3992;78251;564;0;0;0;0;.00nan;0;0
3992;90734;564;65;25;2;23;.920;3600000;0
3993;12859;569;98;38;1;37;.974;3600000;0
3993;36571;569;0;0;0;0;.00nan;0;0
3993;65014;570;57;42;5;37;.881;3600000;0
3993;67626;570;0;0;0;0;.00nan;0;0
3994;4504;577;0;0;0;0;.00nan;0;0
3994;56126;575;0;0;0;0;.00nan;0;0
3994;66245;575;80;27;1;26;.963;3600000;0
3994;143829;577;45;20;3;17;.850;3585000;0
3995;4484;574;0;0;0;0;.00nan;0;0
3995;68167;574;74;18;1;17;.944;3600000;0
3995;73939;572;97;45;2;43;.956;3600000;0
3995;84430;572;0;0;0;0;.00nan;0;0
3996;1601;573;0;0;0;0;.00nan;0;0
3996;65014;570;0;0;0;0;.00nan;0;0
3996;67626;570;100;25;0;25;1.000;3600000;0
3996;84945;573;89;38;2;36;.947;3600000;0
3997;4504;577;60;25;3;22;.880;3600000;0
3997;14047;578;98;42;2;40;.952;3600000;0
3997;35520;578;0;0;0;0;.00nan;0;0
3997;143829;577;0;0;0;0;.00nan;0;0
3998;14047;571;0;0;0;0;.00nan;0;0
3998;174407;571;80;34;2;32;.941;3900000;0
3998;56126;575;0;0;0;0;.00nan;0;0
3998;66245;575;67;35;2;33;.943;3900000;0
3999;5559;576;0;0;0;0;.00nan;0;0
3999;12859;569;98;24;0;24;1.000;3600000;0
3999;36571;569;0;0;0;0;.00nan;0;0
3999;91202;576;58;27;3;24;.889;3600000;0
4000;6127;565;99;48;1;47;.979;3600000;0
4000;170042;565;0;0;0;0;.00nan;0;0
4000;22684;566;65;26;3;23;.885;3532000;0
4000;64721;566;0;0;0;0;.00nan;0;0
4001;56126;575;90;18;0;18;1.000;3600000;0
4001;66245;575;0;0;0;0;.00nan;0;0
4001;73939;572;97;40;1;39;.975;3549000;0
4001;84430;572;0;0;0;0;.00nan;0;0
4002;4504;577;0;0;0;0;.00nan;0;0
4002;78251;564;84;26;1;25;.962;3600000;0
4002;90734;564;0;0;0;0;.00nan;0;0
4002;143829;577;82;36;2;34;.944;3571000;0
4003;22684;566;0;0;0;0;.00nan;0;0
4003;38228;568;0;0;0;0;.00nan;0;0
4003;64721;566;99;26;0;26;1.000;3600000;0
4003;64923;568;81;35;2;33;.943;3555000;0
4004;5559;576;88;29;1;28;.966;3900000;0
4004;12859;569;89;34;1;33;.971;3900000;0
4004;36571;569;0;0;0;0;.00nan;0;0
4004;91202;576;0;0;0;0;.00nan;0;0
4005;4484;574;63;29;3;26;.897;2760000;0
4005;65014;570;0;0;0;0;.00nan;0;0
4005;67626;570;100;27;0;27;1.000;3600000;0
4005;68167;574;28;15;4;11;.733;840000;0
4006;6127;565;66;32;3;29;.906;3900000;0
4006;169493;562;0;0;0;0;.00nan;0;0
4006;170042;565;0;0;0;0;.00nan;0;0
4006;78815;562;76;36;3;33;.917;3900000;0
4007;1601;573;100;41;1;40;.976;3600000;0
4007;35520;578;58;29;3;26;.897;3525000;0
4007;53861;578;0;0;0;0;.00nan;0;0
4007;84945;573;0;0;0;0;.00nan;0;0
4008;4504;577;0;0;0;0;.00nan;0;0
4008;73939;572;95;45;3;42;.933;3564000;0
4008;84430;572;0;0;0;0;.00nan;0;0
4008;143829;577;78;26;1;25;.962;3600000;0
4009;38228;568;0;0;0;0;.00nan;0;0
4009;64923;568;68;35;4;31;.886;3893000;0
4009;78251;564;0;0;0;0;.00nan;0;0
4009;90734;564;63;28;4;24;.857;3900000;0
4010;4484;574;0;0;0;0;.00nan;0;0
4010;56126;575;100;44;0;44;1.000;3600000;0
4010;66245;575;0;0;0;0;.00nan;0;0
4010;68167;574;41;23;4;19;.826;3600000;0
4011;5559;576;0;0;0;0;.00nan;0;0
4011;14047;571;79;24;1;23;.958;3600000;0
4011;174407;571;0;0;0;0;.00nan;0;0
4011;91202;576;70;25;2;23;.920;3564000;0
4012;169493;562;0;0;0;0;.00nan;0;0
4012;65014;570;0;0;0;0;.00nan;0;0
4012;67626;570;73;29;2;27;.931;3517000;0
4012;78815;562;100;34;0;34;1.000;3600000;0
4013;1601;573;0;0;0;0;.00nan;0;0
4013;22684;566;0;0;0;0;.00nan;0;0
4013;64721;566;67;15;2;13;.867;3600000;0
4013;84945;573;63;44;5;39;.886;3600000;0
4014;6127;565;88;38;3;35;.921;3600000;0
4014;170042;565;0;0;0;0;.00nan;0;0
4014;35520;578;0;0;0;0;.00nan;0;0
4014;53861;578;100;29;0;29;1.000;3600000;0
4015;4484;572;0;0;0;0;.00nan;0;0
4015;38228;568;0;0;0;0;.00nan;0;0
4015;64923;568;100;21;0;21;1.000;3600000;0
4015;84430;572;74;34;3;31;.912;3600000;0
4016;5559;576;39;32;6;26;.813;3179000;0
4016;78251;564;0;0;0;0;.00nan;0;0
4016;90734;564;74;19;1;18;.947;3600000;0
4016;91202;576;43;4;1;3;.750;421000;0
4017;14047;571;0;0;0;0;.00nan;0;0
4017;22684;566;77;26;2;24;.923;3600000;0
4017;174407;571;78;47;4;43;.915;3575000;0
4017;64721;566;0;0;0;0;.00nan;0;0
4018;35520;578;0;0;0;0;.00nan;0;0
4018;53861;578;51;27;4;23;.852;3554000;0
4018;65014;570;75;38;3;35;.921;3600000;0
4018;67626;570;0;0;0;0;.00nan;0;0
4019;1601;573;59;46;5;41;.891;3600000;0
4019;12859;569;0;0;0;0;.00nan;0;0
4019;36571;569;79;22;1;21;.955;3600000;0
4019;84945;573;0;0;0;0;.00nan;0;0
4020;6127;565;50;41;6;35;.854;3600000;0
4020;170042;565;0;0;0;0;.00nan;0;0
4020;56126;575;92;30;1;29;.967;3600000;0
4020;66245;575;0;0;0;0;.00nan;0;0
4021;4504;577;0;0;0;0;.00nan;0;0
4021;68167;574;0;0;0;0;.00nan;0;0
4021;73939;574;91;21;0;21;1.000;3600000;0
4021;143829;577;70;42;4;38;.905;3600000;0
4022;6127;565;93;35;1;34;.971;3600000;0
4022;14047;571;84;33;2;31;.939;3600000;0
4022;170042;565;0;0;0;0;.00nan;0;0
4022;174407;571;0;0;0;0;.00nan;0;0
4023;12859;569;0;0;0;0;.00nan;0;0
4023;36571;569;99;37;1;36;.973;3670000;0
4023;68167;574;0;0;0;0;.00nan;0;0
4023;73939;574;78;23;2;21;.913;3670000;0
4024;169493;562;40;36;6;30;.833;2501000;0
4024;78251;564;0;0;0;0;.00nan;0;0
4024;78815;562;22;13;4;9;.692;1099000;0
4024;90734;564;71;28;2;26;.929;3600000;0
4025;12859;569;50;35;5;30;.857;3600000;0
4025;36571;569;0;0;0;0;.00nan;0;0
4025;38228;568;0;0;0;0;.00nan;0;0
4025;64923;568;68;17;1;16;.941;3600000;0
4026;169493;562;0;0;0;0;.00nan;0;0
4026;22684;566;69;20;2;18;.900;3900000;0
4026;64721;566;0;0;0;0;.00nan;0;0
4026;78815;562;98;52;2;50;.962;3900000;0
4027;6127;565;69;23;2;21;.913;3900000;0
4027;170042;565;0;0;0;0;.00nan;0;0
4027;56126;575;0;0;0;0;.00nan;0;0
4027;66245;575;95;41;2;39;.951;3900000;0
4028;35520;578;0;0;0;0;.00nan;0;0
4028;53861;578;85;45;3;42;.933;3540000;0
4028;68167;574;84;26;1;25;.962;3600000;0
4028;73939;574;0;0;0;0;.00nan;0;0
4029;4484;572;0;0;0;0;.00nan;0;0
4029;14047;571;0;0;0;0;.00nan;0;0
4029;174407;571;53;20;3;17;.850;3764000;0
4029;84430;572;89;36;2;34;.944;3764000;0
4030;4504;577;0;0;0;0;.00nan;0;0
4030;65014;570;71;30;2;28;.933;3600000;0
4030;67626;570;0;0;0;0;.00nan;0;0
4030;143829;577;61;27;3;24;.889;3547000;0
4031;38228;568;0;0;0;0;.00nan;0;0
4031;64923;568;77;24;2;22;.917;3600000;0
4031;68167;574;0;0;0;0;.00nan;0;0
4031;73939;574;68;31;3;28;.903;3553000;0
4032;56126;575;0;0;0;0;.00nan;0;0
4032;66245;575;95;61;4;57;.934;3600000;0
4032;78251;564;0;0;0;0;.00nan;0;0
4032;90734;564;32;23;5;18;.783;3545000;0
4033;5559;576;0;0;0;0;.00nan;0;0
4033;22684;566;100;26;0;26;1.000;3600000;0
4033;64721;566;0;0;0;0;.00nan;0;0
4033;91202;576;60;21;2;19;.905;3546000;0
4034;1601;573;0;0;0;0;.00nan;0;0
4034;35520;578;0;0;0;0;.00nan;0;0
4034;53861;578;72;31;3;28;.903;3600000;0
4034;84945;573;65;40;5;35;.875;3584000;0
4035;4484;572;52;31;4;27;.871;3600000;0
4035;65014;570;66;21;1;20;.952;3600000;0
4035;67626;570;0;0;0;0;.00nan;0;0
4035;84430;572;0;0;0;0;.00nan;0;0
4036;5559;576;68;28;2;26;.929;3600000;0
4036;22684;566;51;31;5;26;.839;3600000;0
4036;64721;566;0;0;0;0;.00nan;0;0
4036;91202;576;0;0;0;0;.00nan;0;0
4037;14047;571;0;0;0;0;.00nan;0;0
4037;169493;562;0;0;0;0;.00nan;0;0
4037;174407;571;58;26;4;22;.846;3614000;0
4037;78815;562;61;39;5;34;.872;3614000;0
4038;6127;565;0;0;0;0;.00nan;0;0
4038;170042;565;74;43;4;39;.907;3600000;0
4038;78251;564;94;21;0;21;1.000;3600000;0
4038;90734;564;0;0;0;0;.00nan;0;0
4039;38228;568;80;24;1;23;.958;3600000;0
4039;56126;575;59;19;2;17;.895;3570000;0
4039;64923;568;0;0;0;0;.00nan;0;0
4039;66245;575;0;0;0;0;.00nan;0;0
4040;1601;573;69;39;4;35;.897;3573000;0
4040;4504;577;55;25;3;22;.880;3600000;0
4040;84945;573;0;0;0;0;.00nan;0;0
4040;143829;577;0;0;0;0;.00nan;0;0
4041;12859;569;0;0;0;0;.00nan;0;0
4041;35520;578;0;0;0;0;.00nan;0;0
4041;36571;569;81;17;0;17;1.000;3600000;0
4041;53861;578;81;39;3;36;.923;3600000;0
4042;22684;566;96;45;2;43;.956;3900000;0
4042;64721;566;0;0;0;0;.00nan;0;0
4042;78251;564;83;34;2;32;.941;3900000;0
4042;90734;564;0;0;0;0;.00nan;0;0
4043;4484;572;0;0;0;0;.00nan;0;0
4043;5559;576;0;0;0;0;.00nan;0;0
4043;84430;572;68;38;3;35;.921;3600000;0
4043;91202;576;31;28;6;22;.786;3600000;0
4044;1601;573;0;0;0;0;.00nan;0;0
4044;68167;574;0;0;0;0;.00nan;0;0
4044;73939;574;98;38;1;37;.974;3900000;0
4044;84945;573;89;40;1;39;.975;3900000;0
4045;4504;577;0;0;0;0;.00nan;0;0
4045;6127;565;97;41;2;39;.951;3900000;0
4045;170042;565;0;0;0;0;.00nan;0;0
4045;143829;577;81;28;2;26;.929;3900000;0
4046;35520;578;0;0;0;0;.00nan;0;0
4046;53861;578;83;31;1;30;.968;3591000;0
4046;65014;570;100;31;0;31;1.000;3600000;0
4046;67626;570;0;0;0;0;.00nan;0;0
4047;14047;571;0;0;0;0;.00nan;0;0
4047;22684;566;0;0;0;0;.00nan;0;0
4047;174407;571;96;44;2;42;.955;3900000;0
4047;64721;566;90;35;2;33;.943;3900000;0
4048;38228;568;0;0;0;0;.00nan;0;0
4048;64923;568;64;23;2;21;.913;3552000;0
4048;65014;570;80;23;1;22;.957;3600000;0
4048;67626;570;0;0;0;0;.00nan;0;0
4049;6127;565;91;51;3;48;.941;3671000;0
4049;12859;569;0;0;0;0;.00nan;0;0
4049;170042;565;0;0;0;0;.00nan;0;0
4049;36571;569;54;27;4;23;.852;3653000;0
4050;169493;562;0;0;0;0;.00nan;0;0
4050;68167;574;0;0;0;0;.00nan;0;0
4050;73939;574;86;32;2;30;.938;3900000;0
4050;78815;562;72;29;2;27;.931;3900000;0
4051;1601;573;53;36;5;31;.861;3579000;0
4051;5559;576;64;34;4;30;.882;3600000;0
4051;84945;573;0;0;0;0;.00nan;0;0
4051;91202;576;0;0;0;0;.00nan;0;0
4052;4504;577;0;0;0;0;.00nan;0;0
4052;78251;564;0;0;0;0;.00nan;0;0
4052;90734;564;63;22;2;20;.909;3537000;0
4052;143829;577;100;34;0;34;1.000;3600000;0
4053;35520;578;0;0;0;0;.00nan;0;0
4053;53861;578;59;32;4;28;.875;3600000;0
4053;56126;575;0;0;0;0;.00nan;0;0
4053;66245;575;38;34;6;28;.824;3531000;0
4054;1601;573;0;0;0;0;.00nan;0;0
4054;4484;572;0;0;0;0;.00nan;0;0
4054;84430;572;44;25;4;21;.840;3900000;0
4054;84945;573;56;32;4;28;.875;3867000;0
4055;22684;566;64;27;3;24;.889;3600000;0
4055;35520;578;51;2;0;2;1.000;434000;0
4055;53861;578;45;37;6;31;.838;3166000;0
4055;64721;566;0;0;0;0;.00nan;0;0
4056;5559;576;0;0;0;0;.00nan;0;0
4056;65014;570;60;8;0;8;1.000;757000;0
4056;67626;570;21;22;6;16;.727;2843000;0
4056;91202;576;95;40;1;39;.975;3600000;0
4057;6127;565;0;0;0;0;.00nan;0;0
4057;169493;562;0;0;0;0;.00nan;0;0
4057;170042;565;79;35;3;32;.914;3592000;0
4057;78815;562;75;28;2;26;.929;3600000;0
4058;14047;571;0;0;0;0;.00nan;0;0
4058;174407;571;60;22;2;20;.909;3600000;0
4058;56126;575;70;36;3;33;.917;3579000;0
4058;66245;575;0;0;0;0;.00nan;0;0
4059;68167;574;54;30;4;26;.867;3600000;0
4059;73939;574;0;0;0;0;.00nan;0;0
4059;78251;564;83;27;1;26;.963;3600000;0
4059;90734;564;0;0;0;0;.00nan;0;0
4060;4504;577;0;0;0;0;.00nan;0;0
4060;14047;571;50;32;5;27;.844;3600000;0
4060;174407;571;0;0;0;0;.00nan;0;0
4060;143829;577;100;34;0;34;1.000;3600000;0
4061;12859;569;0;0;0;0;.00nan;0;0
4061;14047;571;0;0;0;0;.00nan;0;0
4061;174407;571;100;23;0;23;1.000;3600000;0
4061;36571;569;77;28;2;26;.929;3569000;0
4062;1601;573;73;41;4;37;.902;3600000;0
4062;38228;568;0;0;0;0;.00nan;0;0
4062;64923;568;95;22;0;22;1.000;3600000;0
4062;84945;573;0;0;0;0;.00nan;0;0
4063;4504;577;0;0;0;0;.00nan;0;0
4063;22684;566;73;30;3;27;.900;3600000;0
4063;64721;566;0;0;0;0;.00nan;0;0
4063;143829;577;60;40;5;35;.875;3570000;0
4064;5559;576;89;25;1;24;.960;3600000;0
4064;6127;565;89;41;2;39;.951;3562000;0
4064;170042;565;0;0;0;0;.00nan;0;0
4064;91202;576;0;0;0;0;.00nan;0;0
4065;56126;575;0;0;0;0;.00nan;0;0
4065;65014;570;78;36;4;32;.889;3890000;0
4065;66245;575;97;44;3;41;.932;3890000;0
4065;67626;570;0;0;0;0;.00nan;0;0
4066;4484;572;0;0;0;0;.00nan;0;0
4066;169493;562;0;0;0;0;.00nan;0;0
4066;78815;562;33;31;6;25;.806;3600000;0
4066;84430;572;74;34;3;31;.912;3600000;0
4067;1601;573;0;0;0;0;.00nan;0;0
4067;56126;575;57;17;2;15;.882;3600000;0
4067;66245;575;0;0;0;0;.00nan;0;0
4067;84945;573;74;58;6;52;.897;3600000;0
4068;5559;576;0;0;0;0;.00nan;0;0
4068;38228;568;0;0;0;0;.00nan;0;0
4068;64923;568;99;25;0;25;1.000;3600000;0
4068;91202;576;80;34;2;32;.941;3569000;0
4069;12859;569;0;0;0;0;.00nan;0;0
4069;36571;569;70;37;4;33;.892;3600000;0
4069;78251;564;0;0;0;0;.00nan;0;0
4069;90734;564;97;20;0;20;1.000;3600000;0
4070;169493;562;0;0;0;0;.00nan;0;0
4070;22684;566;56;17;2;15;.882;3900000;0
4070;64721;566;0;0;0;0;.00nan;0;0
4070;78815;562;92;52;2;50;.962;3900000;0
4071;6127;565;0;0;0;0;.00nan;0;0
4071;170042;565;86;45;4;41;.911;3566000;0
4071;68167;574;0;0;0;0;.00nan;0;0
4071;73939;574;79;26;2;24;.923;3600000;0
4072;4484;572;0;0;0;0;.00nan;0;0
4072;35520;578;0;0;0;0;.00nan;0;0
4072;53861;578;100;33;0;33;1.000;3600000;0
4072;84430;572;97;45;2;43;.956;3600000;0
4073;4504;577;0;0;0;0;.00nan;0;0
4073;56126;575;0;0;0;0;.00nan;0;0
4073;66245;575;93;42;2;40;.952;3564000;0
4073;143829;577;100;21;0;21;1.000;3600000;0
4074;4484;572;77;41;4;37;.902;3524000;0
4074;78251;564;0;0;0;0;.00nan;0;0
4074;84430;572;0;0;0;0;.00nan;0;0
4074;90734;564;61;18;2;16;.889;3600000;0
4075;12859;569;89;38;3;35;.921;3600000;0
4075;22684;566;0;0;0;0;.00nan;0;0
4075;36571;569;0;0;0;0;.00nan;0;0
4075;64721;566;99;19;0;19;1.000;3600000;0
4076;6127;565;99;52;2;50;.962;3600000;0
4076;170042;565;0;0;0;0;.00nan;0;0
4076;68167;574;54;27;4;23;.852;3517000;0
4076;73939;574;0;0;0;0;.00nan;0;0
4077;5559;576;56;28;4;24;.857;3900000;0
4077;38228;568;0;0;0;0;.00nan;0;0
4077;64923;568;64;35;4;31;.886;3900000;0
4077;91202;576;0;0;0;0;.00nan;0;0
4078;14047;571;0;0;0;0;.00nan;0;0
4078;174407;571;32;21;5;16;.762;3567000;0
4078;65014;570;0;0;0;0;.00nan;0;0
4078;67626;570;47;27;4;23;.852;3600000;0
4079;1601;573;28;14;4;10;.714;1011000;0
4079;169493;562;55;5;0;5;1.000;732000;0
4079;78815;562;32;26;6;20;.769;2830000;0
4079;84945;573;88;29;1;28;.966;2589000;0
4080;35520;578;0;0;0;0;.00nan;0;0
4080;53861;578;97;50;3;47;.940;3571000;0
4080;78251;564;0;0;0;0;.00nan;0;0
4080;90734;564;68;19;1;18;.947;3600000;0
4081;6127;565;0;0;0;0;.00nan;0;0
4081;14047;571;0;0;0;0;.00nan;0;0
4081;170042;565;95;50;4;46;.920;3560000;0
4081;174407;571;62;18;2;16;.889;3600000;0
4082;169493;562;0;0;0;0;.00nan;0;0
4082;56126;575;73;34;3;31;.912;3900000;0
4082;66245;575;0;0;0;0;.00nan;0;0
4082;78815;562;73;32;3;29;.906;3900000;0
4083;4484;572;0;0;0;0;.00nan;0;0
4083;38228;568;0;0;0;0;.00nan;0;0
4083;64923;568;76;27;2;25;.926;3600000;0
4083;84430;572;58;52;7;45;.865;3600000;0
4084;14047;571;87;51;3;48;.941;3600000;0
4084;174407;571;0;0;0;0;.00nan;0;0
4084;68167;574;0;0;0;0;.00nan;0;0
4084;73939;574;91;17;0;17;1.000;3600000;0
4085;22684;566;0;0;0;0;.00nan;0;0
4085;64721;566;69;28;2;26;.929;3543000;0
4085;65014;570;95;34;1;33;.971;3600000;0
4085;67626;570;0;0;0;0;.00nan;0;0
4086;5559;576;0;0;0;0;.00nan;0;0
4086;65014;570;0;0;0;0;.00nan;0;0
4086;67626;570;85;29;1;28;.966;3600000;0
4086;91202;576;55;28;3;25;.893;3510000;0
4087;169493;562;48;19;3;16;.842;3600000;0
4087;35520;578;0;0;0;0;.00nan;0;0
4087;53861;578;61;39;5;34;.872;3540000;0
4087;78815;562;0;0;0;0;.00nan;0;0
4088;4484;572;0;0;0;0;.00nan;0;0
4088;22684;566;57;17;3;14;.824;3900000;0
4088;64721;566;0;0;0;0;.00nan;0;0
4088;84430;572;98;45;3;42;.933;3900000;0
4089;4504;577;0;0;0;0;.00nan;0;0
4089;38228;568;0;0;0;0;.00nan;0;0
4089;64923;568;54;39;5;34;.872;3600000;0
4089;143829;577;77;29;2;27;.931;3600000;0
4090;12859;569;0;0;0;0;.00nan;0;0
4090;36571;569;54;31;4;27;.871;3600000;0
4090;56126;575;99;20;0;20;1.000;3600000;0
4090;66245;575;0;0;0;0;.00nan;0;0
4091;1601;573;44;3;1;2;.667;288000;0
4091;78251;564;0;0;0;0;.00nan;0;0
4091;84945;573;41;38;6;32;.842;3312000;0
4091;90734;564;99;31;1;30;.968;3600000;0
4092;5559;576;64;24;2;22;.917;3546000;0
4092;56126;575;90;33;1;32;.970;3600000;0
4092;66245;575;0;0;0;0;.00nan;0;0
4092;91202;576;0;0;0;0;.00nan;0;0
4093;14047;571;0;0;0;0;.00nan;0;0
4093;174407;571;84;38;4;34;.895;3900000;0
4093;78251;564;0;0;0;0;.00nan;0;0
4093;90734;564;39;23;4;19;.826;3900000;0
4094;22684;566;0;0;0;0;.00nan;0;0
4094;64721;566;60;32;4;28;.875;3576000;0
4094;68167;574;0;0;0;0;.00nan;0;0
4094;73939;574;68;37;3;34;.919;3600000;0
4095;1601;573;0;0;0;0;.00nan;0;0
4095;65014;570;70;25;2;23;.920;3900000;0
4095;67626;570;0;0;0;0;.00nan;0;0
4095;84945;573;100;46;2;44;.957;3900000;0
4096;4504;577;0;0;0;0;.00nan;0;0
4096;169493;562;0;0;0;0;.00nan;0;0
4096;78815;562;82;36;2;34;.944;3544000;0
4096;143829;577;91;25;1;24;.960;3600000;0
4097;4484;572;0;0;0;0;.00nan;0;0
4097;6127;565;0;0;0;0;.00nan;0;0
4097;170042;565;100;35;1;34;.971;3600000;0
4097;84430;572;66;32;3;29;.906;3587000;0
4098;35520;578;36;25;4;21;.840;3542000;0
4098;38228;568;0;0;0;0;.00nan;0;0
4098;53861;578;0;0;0;0;.00nan;0;0
4098;64923;568;61;32;3;29;.906;3600000;0
4099;22684;566;89;24;1;23;.958;3600000;0
4099;38228;568;0;0;0;0;.00nan;0;0
4099;64721;566;0;0;0;0;.00nan;0;0
4099;64923;568;66;39;5;34;.872;3600000;0
4100;5559;576;0;0;0;0;.00nan;0;0
4100;68167;574;0;0;0;0;.00nan;0;0
4100;73939;574;42;39;6;33;.846;3600000;0
4100;91202;576;75;39;3;36;.923;3600000;0
4101;169493;562;59;7;0;7;1.000;1069000;0
4101;78251;564;0;0;0;0;.00nan;0;0
4101;78815;562;31;39;7;32;.821;2531000;0
4101;90734;564;90;16;0;16;1.000;3600000;0
4102;1601;573;45;30;5;25;.833;3850000;0
4102;6127;565;0;0;0;0;.00nan;0;0
4102;170042;565;68;40;5;35;.875;3900000;0
4102;84945;573;0;0;0;0;.00nan;0;0
4103;4484;572;0;0;0;0;.00nan;0;0
4103;56126;575;0;0;0;0;.00nan;0;0
4103;66245;575;97;28;1;27;.964;3577000;0
4103;84430;572;100;26;0;26;1.000;3600000;0
4104;4504;577;0;0;0;0;.00nan;0;0
4104;12859;569;0;0;0;0;.00nan;0;0
4104;36571;569;99;39;2;37;.949;3600000;0
4104;143829;577;51;30;4;26;.867;3546000;0
4105;14047;571;0;0;0;0;.00nan;0;0
4105;174407;571;83;26;1;25;.962;3600000;0
4105;35520;578;0;0;0;0;.00nan;0;0
4105;53861;578;55;33;4;29;.879;3600000;0
4107;1601;573;0;0;0;0;.00nan;0;0
4107;73939;572;100;30;0;30;1.000;3600000;0
4107;84430;572;0;0;0;0;.00nan;0;0
4107;84945;573;67;37;4;33;.892;3600000;0
4109;6127;565;70;22;1;21;.955;2646000;0
4109;170042;565;32;15;4;11;.733;954000;0
4109;174407;571;63;19;2;17;.895;3600000;0
4109;53861;571;0;0;0;0;.00nan;0;0
4111;38228;568;0;0;0;0;.00nan;0;0
4111;56126;575;0;0;0;0;.00nan;0;0
4111;64923;568;85;31;1;30;.968;3900000;0
4111;66245;575;94;36;1;35;.972;3900000;0
4113;12859;569;0;0;0;0;.00nan;0;0
4113;190423;570;0;0;0;0;.00nan;0;0
4113;36571;569;52;33;5;28;.848;3700000;0
4113;67626;570;65;43;4;39;.907;3679000;0
4115;4504;577;0;0;0;0;.00nan;0;0
4115;169493;562;38;38;6;32;.842;3782000;0
4115;78815;562;0;0;0;0;.00nan;0;0
4115;143829;577;36;28;5;23;.821;3782000;0
4117;4484;574;0;0;0;0;.00nan;0;0
4117;68167;574;89;35;1;34;.971;3555000;0
4117;78251;564;100;26;0;26;1.000;3600000;0
4117;90734;564;0;0;0;0;.00nan;0;0
4119;14047;578;58;29;3;26;.897;3582000;0
4119;14459;576;0;0;0;0;.00nan;0;0
4119;174736;576;74;28;2;26;.929;3600000;0
4119;35520;578;0;0;0;0;.00nan;0;0
4125;14047;578;74;27;2;25;.926;3642000;0
4125;35520;578;0;0;0;0;.00nan;0;0
4125;73939;572;71;36;3;33;.917;3642000;0
4125;84430;572;0;0;0;0;.00nan;0;0
4127;22684;566;0;0;0;0;.00nan;0;0
4127;56126;575;0;0;0;0;.00nan;0;0
4127;64721;566;41;41;7;34;.829;3600000;0
4127;66245;575;99;42;1;41;.976;3600000;0
4129;169493;562;0;0;0;0;.00nan;0;0
4129;78251;564;45;30;5;25;.833;3718000;0
4129;78815;562;60;33;4;29;.879;3718000;0
4129;90734;564;0;0;0;0;.00nan;0;0
4131;1601;573;76;36;3;33;.917;3600000;0
4131;12859;569;54;30;4;26;.867;3575000;0
4131;36571;569;0;0;0;0;.00nan;0;0
4131;84945;573;0;0;0;0;.00nan;0;0
4135;1601;573;0;0;0;0;.00nan;0;0
4135;22684;566;56;23;3;20;.870;3600000;0
4135;64721;566;0;0;0;0;.00nan;0;0
4135;84945;573;71;46;4;42;.913;3600000;0
4139;6127;565;76;34;2;32;.941;3600000;0
4139;14047;578;0;0;0;0;.00nan;0;0
4139;170042;565;0;0;0;0;.00nan;0;0
4139;35520;578;53;36;5;31;.861;3600000;0
4141;14459;576;0;0;0;0;.00nan;0;0
4141;174736;576;53;33;4;29;.879;3529000;0
4141;38228;568;0;0;0;0;.00nan;0;0
4141;64923;568;72;25;2;23;.920;3600000;0
4143;4484;574;0;0;0;0;.00nan;0;0
4143;68167;574;66;16;1;15;.938;3600000;0
4143;73939;572;0;0;0;0;.00nan;0;0
4143;84430;572;90;44;2;42;.955;3600000;0
4149;12859;569;0;0;0;0;.00nan;0;0
4149;169493;562;0;0;0;0;.00nan;0;0
4149;36571;569;84;31;1;30;.968;3600000;0
4149;78815;562;60;23;2;21;.913;3577000;0
4155;56126;575;0;0;0;0;.00nan;0;0
4155;66245;575;45;25;4;21;.840;3600000;0
4155;73939;572;0;0;0;0;.00nan;0;0
4155;84430;572;66;15;1;14;.933;3600000;0
4157;6127;565;0;0;0;0;.00nan;0;0
4157;170042;565;100;49;1;48;.980;3600000;0
4157;22684;566;0;0;0;0;.00nan;0;0
4157;64721;566;71;25;2;23;.920;3600000;0
4161;38228;568;0;0;0;0;.00nan;0;0
4161;64923;568;59;24;3;21;.875;3543000;0
4161;78251;564;67;25;2;23;.920;3600000;0
4161;90734;564;0;0;0;0;.00nan;0;0
4165;169493;562;84;53;4;49;.925;3600000;0
4165;78251;564;0;0;0;0;.00nan;0;0
4165;78815;562;0;0;0;0;.00nan;0;0
4165;90734;564;58;13;1;12;.923;3600000;0
4169;1601;573;78;23;1;22;.957;3600000;0
4169;73939;572;71;35;2;33;.943;3547000;0
4169;84430;572;0;0;0;0;.00nan;0;0
4169;84945;573;0;0;0;0;.00nan;0;0
4171;38228;568;87;27;1;26;.963;3600000;0
4171;56126;575;87;46;4;42;.913;3600000;0
4171;64923;568;0;0;0;0;.00nan;0;0
4171;66245;575;0;0;0;0;.00nan;0;0
4175;6127;565;72;32;3;29;.906;3552000;0
4175;12859;569;78;32;2;30;.938;3600000;0
4175;170042;565;0;0;0;0;.00nan;0;0
4175;36571;569;0;0;0;0;.00nan;0;0
4179;1601;573;79;34;2;32;.941;3600000;0
4179;14047;578;99;35;1;34;.971;3600000;0
4179;35520;578;0;0;0;0;.00nan;0;0
4179;84945;573;0;0;0;0;.00nan;0;0
4181;38228;568;0;0;0;0;.00nan;0;0
4181;56126;575;0;0;0;0;.00nan;0;0
4181;64923;568;65;15;1;14;.933;3600000;0
4181;66245;575;93;46;3;43;.935;3537000;0
4185;6127;565;0;0;0;0;.00nan;0;0
4185;12859;569;71;38;4;34;.895;3600000;0
4185;170042;565;73;28;2;26;.929;3600000;0
4185;36571;569;0;0;0;0;.00nan;0;0
4189;4484;574;0;0;0;0;.00nan;0;0
4189;68167;574;76;25;2;23;.920;3600000;0
4189;78251;564;88;41;3;38;.927;3551000;0
4189;90734;564;0;0;0;0;.00nan;0;0
4195;1601;573;0;0;0;0;.00nan;0;0
4195;169493;562;0;0;0;0;.00nan;0;0
4195;78815;562;53;21;3;18;.857;3574000;0
4195;84945;573;90;49;2;47;.959;3600000;0
4197;4484;574;63;41;4;37;.902;3600000;0
4197;22684;566;71;22;1;21;.955;3600000;0
4197;64721;566;0;0;0;0;.00nan;0;0
4197;68167;574;0;0;0;0;.00nan;0;0
4199;14459;576;89;28;1;27;.964;3556000;0
4199;174736;576;0;0;0;0;.00nan;0;0
4199;38228;568;80;16;0;16;1.000;3600000;0
4199;64923;568;0;0;0;0;.00nan;0;0
4201;12859;569;0;0;0;0;.00nan;0;0
4201;14047;578;0;0;0;0;.00nan;0;0
4201;35520;578;36;22;4;18;.818;3583000;0
4201;36571;569;58;30;3;27;.900;3600000;0
4203;73939;572;82;46;4;42;.913;3600000;0
4203;78251;564;0;0;0;0;.00nan;0;0
4203;84430;572;0;0;0;0;.00nan;0;0
4203;90734;564;83;18;0;18;1.000;3600000;0
454;12859;569;0;0;0;0;.00nan;0;0
454;36571;569;64;39;4;35;.897;3572000;0
454;56126;575;0;0;0;0;.00nan;0;0
454;66245;575;52;19;3;16;.842;3600000;0
455;5559;576;73;22;2;20;.909;3600000;0
455;38228;568;0;0;0;0;.00nan;0;0
455;64923;568;61;37;4;33;.892;3526000;0
455;91202;576;0;0;0;0;.00nan;0;0
456;12859;569;0;0;0;0;.00nan;0;0
456;36571;569;64;23;2;21;.913;3600000;0
456;56126;575;0;0;0;0;.00nan;0;0
456;66245;575;65;34;3;31;.912;3555000;0
457;5559;576;0;0;0;0;.00nan;0;0
457;38228;568;0;0;0;0;.00nan;0;0
457;64923;568;94;39;1;38;.974;5258000;0
457;91202;576;99;24;0;24;1.000;5258000;0
592;12859;569;0;0;0;0;.00nan;0;0
592;36571;569;47;32;5;27;.844;3600000;0
592;56126;575;0;0;0;0;.00nan;0;0
592;66245;575;59;18;2;16;.889;3600000;0
614;56126;575;0;0;0;0;.00nan;0;0
614;66245;575;98;39;1;38;.974;3600000;0
614;78251;564;0;0;0;0;.00nan;0;0
614;90734;564;65;25;2;23;.920;3600000;0
615;5559;576;0;0;0;0;.00nan;0;0
615;14047;571;0;0;0;0;.00nan;0;0
615;174407;571;78;27;1;26;.963;3600000;0
615;91202;576;68;34;4;30;.882;3600000;0
616;4504;577;0;0;0;0;.00nan;0;0
616;68167;574;0;0;0;0;.00nan;0;0
616;73939;574;89;32;2;30;.938;3600000;0
616;143829;577;49;28;5;23;.821;3600000;0
617;22684;566;98;33;1;32;.970;3600000;0
617;64721;566;0;0;0;0;.00nan;0;0
617;65014;570;90;34;3;31;.912;3563000;0
617;67626;570;0;0;0;0;.00nan;0;0
618;56126;575;0;0;0;0;.00nan;0;0
618;66245;575;63;48;4;44;.917;4309000;0
618;78251;564;0;0;0;0;.00nan;0;0
618;90734;564;55;27;3;24;.889;4309000;0
619;5559;576;0;0;0;0;.00nan;0;0
619;14047;571;0;0;0;0;.00nan;0;0
619;174407;571;58;28;3;25;.893;3544000;0
619;91202;576;71;26;2;24;.923;3600000;0
620;4504;577;0;0;0;0;.00nan;0;0
620;68167;574;79;35;2;33;.943;3874000;0
620;73939;574;0;0;0;0;.00nan;0;0
620;143829;577;52;18;3;15;.833;3874000;0
621;22684;566;92;47;4;43;.915;3587000;0
621;64721;566;0;0;0;0;.00nan;0;0
621;65014;570;58;20;2;18;.900;3600000;0
621;67626;570;0;0;0;0;.00nan;0;0
622;56126;575;0;0;0;0;.00nan;0;0
622;66245;575;61;36;5;31;.861;3600000;0
622;78251;564;0;0;0;0;.00nan;0;0
622;90734;564;61;23;2;21;.913;3600000;0
623;5559;576;0;0;0;0;.00nan;0;0
623;14047;571;0;0;0;0;.00nan;0;0
623;174407;571;71;34;3;31;.912;3563000;0
623;91202;576;69;22;1;21;.955;3600000;0
624;4504;577;0;0;0;0;.00nan;0;0
624;68167;574;79;32;2;30;.938;3564000;0
624;73939;574;0;0;0;0;.00nan;0;0
624;143829;577;78;20;1;19;.950;3600000;0
625;22684;566;60;23;3;20;.870;3600000;0
625;64721;566;0;0;0;0;.00nan;0;0
625;65014;570;60;38;4;34;.895;3582000;0
625;67626;570;0;0;0;0;.00nan;0;0
626;56126;575;0;0;0;0;.00nan;0;0
626;66245;575;63;38;4;34;.895;3544000;0
626;78251;564;0;0;0;0;.00nan;0;0
626;90734;564;44;18;3;15;.833;3600000;0
627;5559;576;0;0;0;0;.00nan;0;0
627;14047;571;0;0;0;0;.00nan;0;0
627;174407;571;84;29;1;28;.966;3600000;0
627;91202;576;79;28;2;26;.929;3588000;0
628;4504;577;0;0;0;0;.00nan;0;0
628;68167;574;98;45;2;43;.956;3600000;0
628;73939;574;0;0;0;0;.00nan;0;0
628;143829;577;54;34;5;29;.853;3600000;0
629;22684;566;54;29;4;25;.862;3600000;0
629;64721;566;0;0;0;0;.00nan;0;0
629;65014;570;100;38;1;37;.974;3600000;0
629;67626;570;0;0;0;0;.00nan;0;0
935;56126;575;0;0;0;0;.00nan;0;0
935;66245;575;70;51;5;46;.902;3600000;0
935;78251;564;0;0;0;0;.00nan;0;0
935;90734;564;82;26;2;24;.923;3600000;0
936;5559;576;0;0;0;0;.00nan;0;0
936;14047;571;0;0;0;0;.00nan;0;0
936;174407;571;100;33;0;33;1.000;3600000;0
936;91202;576;70;27;2;25;.926;3536000;0
937;4504;577;0;0;0;0;.00nan;0;0
937;68167;574;61;43;5;38;.884;3600000;0
937;73939;574;0;0;0;0;.00nan;0;0
937;143829;577;47;21;4;17;.810;3600000;0
938;22684;566;62;24;3;21;.875;3940000;0
938;64721;566;0;0;0;0;.00nan;0;0
938;65014;570;67;38;4;34;.895;3940000;0
938;67626;570;0;0;0;0;.00nan;0;0
972;5559;576;0;0;0;0;.00nan;0;0
972;14047;571;0;0;0;0;.00nan;0;0
972;174407;571;48;24;4;20;.833;3600000;0
972;91202;576;100;25;0;25;1.000;3600000;0
973;4504;577;0;0;0;0;.00nan;0;0
973;68167;574;43;26;5;21;.808;3837000;0
973;73939;574;0;0;0;0;.00nan;0;0
973;143829;577;83;43;4;39;.907;3837000;0
974;22684;566;59;25;3;22;.880;3849000;0
974;64721;566;0;0;0;0;.00nan;0;0
974;65014;570;92;34;2;32;.941;3849000;0
974;67626;570;0;0;0;0;.00nan;0;0
989;5559;576;0;0;0;0;.00nan;0;0
989;14047;571;0;0;0;0;.00nan;0;0
989;174407;571;79;25;1;24;.960;3600000;0
989;91202;576;67;26;3;23;.885;3559000;0
990;4504;577;0;0;0;0;.00nan;0;0
990;68167;574;57;27;3;24;.889;3975000;0
990;73939;574;0;0;0;0;.00nan;0;0
990;143829;577;93;34;2;32;.941;3975000;0
991;22684;566;73;29;2;27;.931;3600000;0
991;64721;566;0;0;0;0;.00nan;0;0
991;65014;570;25;23;6;17;.739;2439000;0
991;67626;570;52;20;3;17;.850;1161000;0
1030;22684;566;94;88;4;84;.955;6804000;0
1030;64721;566;0;0;0;0;.00nan;0;0
1030;78251;564;0;0;0;0;.00nan;0;0
1030;90734;564;100;54;3;51;.944;6800000;0
1031;4504;577;0;0;0;0;.00nan;0;0
1031;14047;571;0;0;0;0;.00nan;0;0
1031;174407;571;73;20;1;19;.950;3600000;0
1031;143829;577;51;32;4;28;.875;3600000;0
1032;22684;566;56;34;4;30;.882;3600000;0
1032;64721;566;0;0;0;0;.00nan;0;0
1032;78251;564;0;0;0;0;.00nan;0;0
1032;90734;564;90;17;0;17;1.000;3600000;0
1033;4504;577;0;0;0;0;.00nan;0;0
1033;14047;571;0;0;0;0;.00nan;0;0
1033;174407;571;89;38;2;36;.947;3600000;0
1033;143829;577;66;38;4;34;.895;3520000;0
1034;22684;566;71;32;3;29;.906;3600000;0
1034;64721;566;0;0;0;0;.00nan;0;0
1034;78251;564;0;0;0;0;.00nan;0;0
1034;90734;564;60;34;4;30;.882;3555000;0
1035;4504;577;0;0;0;0;.00nan;0;0
1035;14047;571;0;0;0;0;.00nan;0;0
1035;174407;571;79;34;2;32;.941;4160000;0
1035;143829;577;88;27;1;26;.963;4160000;0
1036;22684;566;93;42;2;40;.952;3548000;0
1036;64721;566;0;0;0;0;.00nan;0;0
1036;78251;564;0;0;0;0;.00nan;0;0
1036;90734;564;77;23;1;22;.957;3600000;0
1037;4504;577;0;0;0;0;.00nan;0;0
1037;14047;571;0;0;0;0;.00nan;0;0
1037;174407;571;52;36;5;31;.861;3600000;0
1037;143829;577;67;34;4;30;.882;3600000;0
1264;22684;566;82;49;3;46;.939;5034000;0
1264;64721;566;0;0;0;0;.00nan;0;0
1264;78251;564;0;0;0;0;.00nan;0;0
1264;90734;564;70;38;4;34;.895;5068000;0
1265;4504;577;0;0;0;0;.00nan;0;0
1265;14047;571;0;0;0;0;.00nan;0;0
1265;174407;571;79;28;2;26;.929;3554000;0
1265;143829;577;100;38;1;37;.974;3600000;0
1323;22684;566;84;38;3;35;.921;3550000;0
1323;64721;566;0;0;0;0;.00nan;0;0
1323;78251;564;0;0;0;0;.00nan;0;0
1323;90734;564;70;23;2;21;.913;3600000;0
1324;4504;577;0;0;0;0;.00nan;0;0
1324;14047;571;0;0;0;0;.00nan;0;0
1324;174407;571;95;43;3;40;.930;3571000;0
1324;143829;577;65;19;1;18;.947;3600000;0
4204;7037;877;73;36;3;33;.917;3600000;0
4204;20645;877;0;0;0;0;.00nan;0;0
4204;28701;875;0;0;0;0;.00nan;0;0
4204;63551;875;50;30;4;26;.867;3600000;0
4205;85453;883;0;0;0;0;.00nan;0;0
4205;86394;876;0;0;0;0;.00nan;0;0
4205;142911;883;72;35;3;32;.914;3900000;0
4205;159705;876;69;34;3;31;.912;3900000;0
4206;779;882;70;41;4;37;.902;3683000;0
4206;196005;882;0;0;0;0;.00nan;0;0
4206;34708;892;59;30;3;27;.900;3683000;0
4206;46910;892;0;0;0;0;.00nan;0;0
4207;8101;897;0;0;0;0;.00nan;0;0
4207;46904;887;0;0;0;0;.00nan;0;0
4207;71075;887;86;38;3;35;.921;3553000;0
4207;78348;897;77;23;1;22;.957;3600000;0
4208;3359;878;0;0;0;0;.00nan;0;0
4208;5559;893;90;51;5;46;.902;3600000;0
4208;11716;893;0;0;0;0;.00nan;0;0
4208;176963;878;46;19;3;16;.842;3600000;0
4209;3077;881;56;37;5;32;.865;3587000;0
4209;196090;881;0;0;0;0;.00nan;0;0
4209;78596;873;72;33;3;30;.909;3600000;0
4209;80834;873;0;0;0;0;.00nan;0;0
4210;164715;886;0;0;0;0;.00nan;0;0
4210;28833;886;60;29;4;25;.862;3600000;0
4210;67287;872;65;26;2;24;.923;3600000;0
4210;154414;872;0;0;0;0;.00nan;0;0
4211;3077;881;0;0;0;0;.00nan;0;0
4211;28701;875;0;0;0;0;.00nan;0;0
4211;63551;875;77;34;4;30;.882;3893000;0
4211;85787;881;81;42;4;38;.905;3900000;0
4212;164715;886;0;0;0;0;.00nan;0;0
4212;28833;886;40;29;5;24;.828;3557000;0
4212;34708;892;0;0;0;0;.00nan;0;0
4212;46910;892;64;23;3;20;.870;3600000;0
4213;8101;897;0;0;0;0;.00nan;0;0
4213;78348;897;100;48;2;46;.958;3600000;0
4213;85453;883;0;0;0;0;.00nan;0;0
4213;142911;883;59;28;4;24;.857;3559000;0
4214;67287;872;66;15;1;14;.933;3600000;0
4214;71075;887;0;0;0;0;.00nan;0;0
4214;74734;887;100;31;0;31;1.000;3600000;0
4214;154414;872;0;0;0;0;.00nan;0;0
4215;779;882;0;0;0;0;.00nan;0;0
4215;3359;878;0;0;0;0;.00nan;0;0
4215;176963;878;35;30;6;24;.800;3600000;0
4215;91742;882;98;36;2;34;.944;3600000;0
4216;5559;893;0;0;0;0;.00nan;0;0
4216;7037;877;76;22;1;21;.955;3600000;0
4216;11716;893;58;59;7;52;.881;3600000;0
4216;149858;877;0;0;0;0;.00nan;0;0
4217;28701;875;68;26;2;24;.923;3747000;0
4217;63551;875;0;0;0;0;.00nan;0;0
4217;86394;876;67;33;3;30;.909;3747000;0
4217;159705;876;0;0;0;0;.00nan;0;0
4218;3359;878;0;0;0;0;.00nan;0;0
4218;176963;878;100;37;0;37;1.000;3600000;0
4218;34708;892;0;0;0;0;.00nan;0;0
4218;46910;892;69;24;1;23;.958;3600000;0
4219;779;882;0;0;0;0;.00nan;0;0
4219;71075;887;0;0;0;0;.00nan;0;0
4219;74734;887;100;29;0;29;1.000;3600000;0
4219;91742;882;77;53;5;48;.906;3600000;0
4220;5559;893;0;0;0;0;.00nan;0;0
4220;164715;886;0;0;0;0;.00nan;0;0
4220;11716;893;55;37;4;33;.892;3600000;0
4220;28833;886;69;19;1;18;.947;3600000;0
4221;78596;873;52;29;4;25;.862;3600000;0
4221;80834;873;0;0;0;0;.00nan;0;0
4221;85453;883;0;0;0;0;.00nan;0;0
4221;142911;883;94;32;1;31;.969;3600000;0
4222;7037;877;0;0;0;0;.00nan;0;0
4222;8101;897;0;0;0;0;.00nan;0;0
4222;78348;897;69;41;4;37;.902;3600000;0
4222;149858;877;63;19;1;18;.947;3600000;0
4223;3077;881;0;0;0;0;.00nan;0;0
4223;67287;872;68;33;5;28;.848;3600000;0
4223;85787;881;71;20;1;19;.950;3600000;0
4223;154414;872;0;0;0;0;.00nan;0;0
4224;164715;886;53;39;5;34;.872;3556000;0
4224;28833;886;0;0;0;0;.00nan;0;0
4224;71075;887;0;0;0;0;.00nan;0;0
4224;74734;887;77;28;2;26;.929;3600000;0
4225;8101;897;0;0;0;0;.00nan;0;0
4225;78348;897;47;31;5;26;.839;3566000;0
4225;86394;876;56;31;4;27;.871;3600000;0
4225;159705;876;0;0;0;0;.00nan;0;0
4226;34708;892;0;0;0;0;.00nan;0;0
4226;46910;892;59;32;3;29;.906;3573000;0
4226;85453;883;73;22;1;21;.955;3600000;0
4226;142911;883;0;0;0;0;.00nan;0;0
4227;5559;893;0;0;0;0;.00nan;0;0
4227;11716;893;73;31;2;29;.935;3600000;0
4227;28701;875;0;0;0;0;.00nan;0;0
4227;63551;875;63;27;3;24;.889;3555000;0
4228;3359;878;0;0;0;0;.00nan;0;0
4228;7037;877;0;0;0;0;.00nan;0;0
4228;176963;878;57;31;4;27;.871;3662000;0
4228;149858;877;56;25;3;22;.880;3662000;0
4229;779;882;0;0;0;0;.00nan;0;0
4229;3077;881;0;0;0;0;.00nan;0;0
4229;85787;881;60;25;3;22;.880;3825000;0
4229;91742;882;99;41;2;39;.951;3825000;0
4230;67287;872;0;0;0;0;.00nan;0;0
4230;78596;873;61;32;3;29;.906;3600000;0
4230;80834;873;0;0;0;0;.00nan;0;0
4230;154414;872;44;27;4;23;.852;3573000;0
4231;164715;886;0;0;0;0;.00nan;0;0
4231;28833;886;66;19;1;18;.947;3600000;0
4231;85453;883;0;0;0;0;.00nan;0;0
4231;142911;883;58;29;3;26;.897;3533000;0
4232;78596;873;0;0;0;0;.00nan;0;0
4232;80834;873;73;25;2;23;.920;3600000;0
4232;86394;876;30;31;6;25;.806;3099000;0
4232;159705;876;56;5;0;5;1.000;501000;0
4233;28701;875;46;20;3;17;.850;3600000;0
4233;63551;875;0;0;0;0;.00nan;0;0
4233;85453;883;0;0;0;0;.00nan;0;0
4233;142911;883;62;34;4;30;.882;3570000;0
4234;3077;881;0;0;0;0;.00nan;0;0
4234;34708;892;40;16;3;13;.813;3565000;0
4234;46910;892;0;0;0;0;.00nan;0;0
4234;85787;881;95;46;1;45;.978;3600000;0
4235;71075;887;0;0;0;0;.00nan;0;0
4235;74734;887;99;38;1;37;.974;3600000;0
4235;86394;876;69;26;2;24;.923;3005000;0
4235;159705;876;25;7;3;4;.571;595000;0
4236;3359;878;0;0;0;0;.00nan;0;0
4236;176963;878;37;34;6;28;.824;3600000;0
4236;78596;873;100;32;0;32;1.000;3600000;0
4236;80834;873;0;0;0;0;.00nan;0;0
4237;779;882;0;0;0;0;.00nan;0;0
4237;5559;893;0;0;0;0;.00nan;0;0
4237;11716;893;93;53;5;48;.906;3600000;0
4237;91742;882;66;14;1;13;.929;3600000;0
4238;8101;897;0;0;0;0;.00nan;0;0
4238;67287;872;81;20;1;19;.950;3600000;0
4238;78348;897;75;31;2;29;.935;3598000;0
4238;154414;872;0;0;0;0;.00nan;0;0
4239;7037;877;0;0;0;0;.00nan;0;0
4239;164715;886;0;0;0;0;.00nan;0;0
4239;28833;886;94;49;3;46;.939;3515000;0
4239;149858;877;74;17;1;16;.941;3600000;0
4240;28701;875;0;0;0;0;.00nan;0;0
4240;34708;892;0;0;0;0;.00nan;0;0
4240;46910;892;74;35;3;32;.914;3515000;0
4240;63551;875;86;26;1;25;.962;3600000;0
4241;3359;878;0;0;0;0;.00nan;0;0
4241;164715;886;0;0;0;0;.00nan;0;0
4241;28833;886;62;31;3;28;.903;3900000;0
4241;176963;878;55;23;3;20;.870;3900000;0
4242;71075;887;0;0;0;0;.00nan;0;0
4242;74734;887;76;38;3;35;.921;3553000;0
4242;85453;883;0;0;0;0;.00nan;0;0
4242;142911;883;80;26;1;25;.962;3600000;0
4243;5559;893;78;36;2;34;.944;3600000;0
4243;11716;893;0;0;0;0;.00nan;0;0
4243;78596;873;84;30;1;29;.967;3600000;0
4243;80834;873;0;0;0;0;.00nan;0;0
4244;779;882;0;0;0;0;.00nan;0;0
4244;8101;897;0;0;0;0;.00nan;0;0
4244;78348;897;86;41;3;38;.927;3575000;0
4244;91742;882;60;13;1;12;.923;3600000;0
4245;3077;881;0;0;0;0;.00nan;0;0
4245;85787;881;81;27;2;25;.926;3600000;0
4245;86394;876;97;52;3;49;.942;3549000;0
4245;159705;876;0;0;0;0;.00nan;0;0
4246;7037;877;0;0;0;0;.00nan;0;0
4246;67287;872;50;31;4;27;.871;3556000;0
4246;149858;877;86;28;2;26;.929;3600000;0
4246;154414;872;0;0;0;0;.00nan;0;0
4247;34708;892;0;0;0;0;.00nan;0;0
4247;46910;892;71;29;3;26;.897;3900000;0
4247;78596;873;90;41;3;38;.927;3900000;0
4247;80834;873;0;0;0;0;.00nan;0;0
4248;779;882;0;0;0;0;.00nan;0;0
4248;987;886;0;0;0;0;.00nan;0;0
4248;28833;886;85;36;2;34;.944;3543000;0
4248;91742;882;77;21;1;20;.952;3600000;0
4249;7037;877;24;17;5;12;.706;3531000;0
4249;86394;876;91;49;3;46;.939;3600000;0
4249;149858;877;0;0;0;0;.00nan;0;0
4249;159705;876;0;0;0;0;.00nan;0;0
4250;5559;893;0;0;0;0;.00nan;0;0
4250;11716;893;67;35;4;31;.886;3600000;0
4250;85453;883;100;36;0;36;1.000;3600000;0
4250;142911;883;0;0;0;0;.00nan;0;0
4251;3077;881;0;0;0;0;.00nan;0;0
4251;8101;897;0;0;0;0;.00nan;0;0
4251;78348;897;50;29;5;24;.828;3600000;0
4251;85787;881;61;24;2;22;.917;3600000;0
4252;3359;878;39;30;6;24;.800;3660000;0
4252;176963;878;0;0;0;0;.00nan;0;0
4252;71075;887;0;0;0;0;.00nan;0;0
4252;74734;887;35;28;5;23;.821;3674000;0
4253;28701;875;36;31;6;25;.806;2743000;0
4253;63551;875;37;8;2;6;.750;857000;0
4253;67287;872;67;24;2;22;.917;3600000;0
4253;154414;872;0;0;0;0;.00nan;0;0
4254;34708;892;0;0;0;0;.00nan;0;0
4254;46910;892;79;29;2;27;.931;3600000;0
4254;86394;876;45;20;3;17;.850;3546000;0
4254;159705;876;0;0;0;0;.00nan;0;0
4255;5559;893;0;0;0;0;.00nan;0;0
4255;11716;893;71;26;2;24;.923;3561000;0
4255;71075;887;0;0;0;0;.00nan;0;0
4255;74734;887;83;27;1;26;.963;3600000;0
4256;987;886;94;60;2;58;.967;3787000;0
4256;28833;886;0;0;0;0;.00nan;0;0
4256;78596;873;72;20;1;19;.950;3787000;0
4256;80834;873;0;0;0;0;.00nan;0;0
4257;779;882;45;38;6;32;.842;3600000;0
4257;28701;875;0;0;0;0;.00nan;0;0
4257;63551;875;85;34;2;32;.941;3600000;0
4257;91742;882;0;0;0;0;.00nan;0;0
4258;3359;878;0;0;0;0;.00nan;0;0
4258;8101;897;37;8;2;6;.750;322000;0
4258;176963;878;97;21;0;21;1.000;3600000;0
4258;78348;897;64;37;4;33;.892;3278000;0
4259;67287;872;61;31;3;28;.903;3600000;0
4259;85453;883;75;27;2;25;.926;3600000;0
4259;142911;883;0;0;0;0;.00nan;0;0
4259;154414;872;0;0;0;0;.00nan;0;0
4260;3077;881;0;0;0;0;.00nan;0;0
4260;7037;877;0;0;0;0;.00nan;0;0
4260;85787;881;98;34;1;33;.971;3600000;0
4260;149858;877;60;37;5;32;.865;3600000;0
4261;8101;897;0;0;0;0;.00nan;0;0
4261;28701;875;96;34;1;33;.971;3558000;0
4261;63551;875;0;0;0;0;.00nan;0;0
4261;78348;897;100;34;0;34;1.000;3600000;0
4262;3359;878;0;0;0;0;.00nan;0;0
4262;176963;878;79;38;3;35;.921;3600000;0
4262;86394;876;0;0;0;0;.00nan;0;0
4262;159705;876;83;33;1;32;.970;3600000;0
4263;7037;877;83;31;2;29;.935;3600000;0
4263;85453;883;0;0;0;0;.00nan;0;0
4263;142911;883;74;35;3;32;.914;3586000;0
4263;149858;877;0;0;0;0;.00nan;0;0
4264;71075;887;0;0;0;0;.00nan;0;0
4264;74734;887;100;29;0;29;1.000;3600000;0
4264;78596;873;75;23;1;22;.957;3600000;0
4264;80834;873;0;0;0;0;.00nan;0;0
4265;11716;893;69;32;3;29;.906;3600000;0
4265;34708;892;0;0;0;0;.00nan;0;0
4265;46910;892;97;16;0;16;1.000;3600000;0
4265;70879;893;0;0;0;0;.00nan;0;0
4266;779;882;0;0;0;0;.00nan;0;0
4266;67287;872;67;40;5;35;.875;3600000;0
4266;91742;882;66;18;1;17;.944;3600000;0
4266;154414;872;0;0;0;0;.00nan;0;0
4267;987;886;71;49;5;44;.898;3600000;0
4267;3077;881;0;0;0;0;.00nan;0;0
4267;28833;886;0;0;0;0;.00nan;0;0
4267;85787;881;89;36;2;34;.944;3600000;0
4268;3359;878;0;0;0;0;.00nan;0;0
4268;28701;875;0;0;0;0;.00nan;0;0
4268;176963;878;100;37;0;37;1.000;3900000;0
4268;63551;875;96;32;0;32;1.000;3900000;0
4269;987;886;98;48;3;45;.938;3600000;0
4269;28833;886;0;0;0;0;.00nan;0;0
4269;86394;876;64;23;2;21;.913;3600000;0
4269;159705;876;0;0;0;0;.00nan;0;0
4270;779;882;0;0;0;0;.00nan;0;0
4270;78596;873;0;0;0;0;.00nan;0;0
4270;80834;873;70;25;2;23;.920;3600000;0
4270;91742;882;68;31;3;28;.903;3592000;0
4271;8101;897;0;0;0;0;.00nan;0;0
4271;11716;893;0;0;0;0;.00nan;0;0
4271;70879;893;58;27;3;24;.889;3600000;0
4271;78348;897;55;31;4;27;.871;3559000;0
4272;3077;881;0;0;0;0;.00nan;0;0
4272;85453;883;0;0;0;0;.00nan;0;0
4272;85787;881;99;37;1;36;.973;3900000;0
4272;142911;883;72;25;1;24;.960;3900000;0
4273;34708;892;0;0;0;0;.00nan;0;0
4273;46910;892;64;23;2;21;.913;3600000;0
4273;67287;872;100;27;0;27;1.000;3600000;0
4273;154414;872;0;0;0;0;.00nan;0;0
4274;7037;877;0;0;0;0;.00nan;0;0
4274;71075;887;0;0;0;0;.00nan;0;0
4274;74734;887;99;41;1;40;.976;3600000;0
4274;149858;877;68;39;3;36;.923;3531000;0
4275;8101;897;0;0;0;0;.00nan;0;0
4275;34708;892;0;0;0;0;.00nan;0;0
4275;46910;892;81;28;2;26;.929;3600000;0
4275;78348;897;49;31;4;27;.871;3513000;0
4276;987;886;62;33;4;29;.879;3588000;0
4276;28833;886;0;0;0;0;.00nan;0;0
4276;85453;883;0;0;0;0;.00nan;0;0
4276;142911;883;77;29;2;27;.931;3600000;0
4277;28701;875;0;0;0;0;.00nan;0;0
4277;63551;875;29;19;4;15;.789;3600000;0
4277;74734;887;100;40;1;39;.975;3600000;0
4277;87798;887;0;0;0;0;.00nan;0;0
4278;11716;893;0;0;0;0;.00nan;0;0
4278;67287;872;82;44;4;40;.909;3737000;0
4278;70879;893;61;26;3;23;.885;3737000;0
4278;154414;872;0;0;0;0;.00nan;0;0
4279;779;882;0;0;0;0;.00nan;0;0
4279;86394;876;0;0;0;0;.00nan;0;0
4279;91742;882;75;33;3;30;.909;3562000;0
4279;159705;876;62;25;2;23;.920;3600000;0
4280;3359;878;0;0;0;0;.00nan;0;0
4280;176963;878;53;31;5;26;.839;3900000;0
4280;75313;881;0;0;0;0;.00nan;0;0
4280;85787;881;51;33;5;28;.848;3900000;0
4281;78596;873;76;39;3;36;.923;3593000;0
4281;80834;873;0;0;0;0;.00nan;0;0
4281;139467;877;78;23;1;22;.957;3600000;0
4281;149858;877;0;0;0;0;.00nan;0;0
4282;987;886;100;25;0;25;1.000;3600000;0
4282;28701;875;75;31;2;29;.935;3537000;0
4282;28833;886;0;0;0;0;.00nan;0;0
4282;63551;875;0;0;0;0;.00nan;0;0
4283;11716;893;0;0;0;0;.00nan;0;0
4283;70879;893;80;31;2;29;.935;3600000;0
4283;86394;876;78;42;4;38;.905;3526000;0
4283;159705;876;0;0;0;0;.00nan;0;0
4284;34708;892;76;23;1;22;.957;3147000;0
4284;46910;892;28;7;3;4;.571;547000;0
4284;139467;877;53;31;5;26;.839;3694000;0
4284;149858;877;0;0;0;0;.00nan;0;0
4285;779;882;0;0;0;0;.00nan;0;0
4285;85453;883;38;8;2;6;.750;577000;0
4285;91742;882;82;35;2;33;.943;3600000;0
4285;142911;883;42;38;6;32;.842;3023000;0
4286;8101;897;95;49;3;46;.939;3600000;0
4286;78348;897;0;0;0;0;.00nan;0;0
4286;78596;873;43;28;5;23;.821;3547000;0
4286;80834;873;0;0;0;0;.00nan;0;0
4287;3359;878;0;0;0;0;.00nan;0;0
4287;176963;878;87;29;1;28;.966;3600000;0
4287;67287;872;86;22;0;22;1.000;3600000;0
4287;154414;872;0;0;0;0;.00nan;0;0
4288;74734;887;57;27;3;24;.889;3900000;0
4288;75313;881;0;0;0;0;.00nan;0;0
4288;85787;881;76;31;3;28;.903;3900000;0
4288;87798;887;0;0;0;0;.00nan;0;0
4289;3359;878;0;0;0;0;.00nan;0;0
4289;176963;878;72;30;2;28;.933;3600000;0
4289;85453;883;70;36;4;32;.889;3572000;0
4289;142911;883;0;0;0;0;.00nan;0;0
4290;987;886;41;35;6;29;.829;3600000;0
4290;28833;886;0;0;0;0;.00nan;0;0
4290;139467;877;100;22;0;22;1.000;3600000;0
4290;149858;877;0;0;0;0;.00nan;0;0
4291;987;886;66;30;3;27;.900;3600000;0
4291;8101;897;52;29;4;25;.862;3600000;0
4291;28833;886;0;0;0;0;.00nan;0;0
4291;78348;897;0;0;0;0;.00nan;0;0
4292;34708;892;0;0;0;0;.00nan;0;0
4292;46910;892;91;29;1;28;.966;3600000;0
4292;74734;887;98;51;2;49;.961;3600000;0
4292;87798;887;0;0;0;0;.00nan;0;0
4293;11716;893;0;0;0;0;.00nan;0;0
4293;70879;893;50;28;4;24;.857;3600000;0
4293;75313;881;0;0;0;0;.00nan;0;0
4293;85787;881;81;21;1;20;.952;3600000;0
4294;28701;875;54;39;4;35;.897;3900000;0
4294;63551;875;0;0;0;0;.00nan;0;0
4294;78596;873;57;30;4;26;.867;3900000;0
4294;80834;873;0;0;0;0;.00nan;0;0
4295;67287;872;83;35;2;33;.943;3600000;0
4295;86394;876;49;7;1;6;.857;280000;0
4295;154414;872;0;0;0;0;.00nan;0;0
4295;159705;876;30;27;6;21;.778;3320000;0
4296;779;882;0;0;0;0;.00nan;0;0
4296;91742;882;79;36;2;34;.944;3563000;0
4296;139467;877;100;30;0;30;1.000;3600000;0
4296;149858;877;0;0;0;0;.00nan;0;0
4297;67287;872;93;33;1;32;.970;3900000;0
4297;85453;883;0;0;0;0;.00nan;0;0
4297;142911;883;86;35;1;34;.971;3900000;0
4297;154414;872;0;0;0;0;.00nan;0;0
4298;11716;893;0;0;0;0;.00nan;0;0
4298;70879;893;85;37;2;35;.946;3600000;0
4298;139467;877;56;25;3;22;.880;3548000;0
4298;149858;877;0;0;0;0;.00nan;0;0
4299;74734;887;93;31;1;30;.968;3600000;0
4299;78596;873;43;25;5;20;.800;3600000;0
4299;80834;873;0;0;0;0;.00nan;0;0
4299;87798;887;0;0;0;0;.00nan;0;0
4300;779;882;0;0;0;0;.00nan;0;0
4300;987;886;87;44;3;41;.932;3600000;0
4300;28833;886;0;0;0;0;.00nan;0;0
4300;91742;882;100;28;0;28;1.000;3600000;0
4301;8101;897;86;37;2;35;.946;3600000;0
4301;78348;897;0;0;0;0;.00nan;0;0
4301;86394;876;51;30;4;26;.867;3547000;0
4301;159705;876;0;0;0;0;.00nan;0;0
4302;3359;878;86;40;3;37;.925;3900000;0
4302;28701;875;0;0;0;0;.00nan;0;0
4302;176963;878;0;0;0;0;.00nan;0;0
4302;63551;875;56;24;3;21;.875;3900000;0
4303;34708;892;0;0;0;0;.00nan;0;0
4303;46910;892;100;42;1;41;.976;3600000;0
4303;75313;881;0;0;0;0;.00nan;0;0
4303;85787;881;68;27;2;25;.926;3549000;0
4304;34708;892;74;23;1;22;.957;3600000;0
4304;46910;892;0;0;0;0;.00nan;0;0
4304;67287;872;45;33;6;27;.818;3600000;0
4304;154414;872;0;0;0;0;.00nan;0;0
4305;28701;875;0;0;0;0;.00nan;0;0
4305;63551;875;57;33;4;29;.879;3514000;0
4305;74734;887;81;31;2;29;.935;3600000;0
4305;87798;887;0;0;0;0;.00nan;0;0
4306;987;886;74;35;3;32;.914;3600000;0
4306;28833;886;0;0;0;0;.00nan;0;0
4306;78596;873;32;30;6;24;.800;3600000;0
4306;80834;873;0;0;0;0;.00nan;0;0
4307;75313;881;0;0;0;0;.00nan;0;0
4307;85787;881;79;37;3;34;.919;3571000;0
4307;86394;876;0;0;0;0;.00nan;0;0
4307;159705;876;74;21;1;20;.952;3600000;0
4308;11716;893;0;0;0;0;.00nan;0;0
4308;34708;892;0;0;0;0;.00nan;0;0
4308;46910;892;49;23;3;20;.870;3573000;0
4308;70879;893;93;33;1;32;.970;3600000;0
4309;8101;897;86;41;3;38;.927;3515000;0
4309;78348;897;0;0;0;0;.00nan;0;0
4309;85453;883;0;0;0;0;.00nan;0;0
4309;142911;883;95;39;1;38;.974;3600000;0
4310;779;882;0;0;0;0;.00nan;0;0
4310;3359;878;0;0;0;0;.00nan;0;0
4310;176963;878;56;25;3;22;.880;3600000;0
4310;91742;882;86;34;2;32;.941;3600000;0
4311;67287;872;0;0;0;0;.00nan;0;0
4311;139467;877;59;34;4;30;.882;3891000;0
4311;149858;877;0;0;0;0;.00nan;0;0
4311;154414;872;75;35;3;32;.914;3879000;0
4312;987;886;76;24;1;23;.958;3600000;0
4312;28701;875;0;0;0;0;.00nan;0;0
4312;28833;886;0;0;0;0;.00nan;0;0
4312;63551;875;69;37;4;33;.892;3600000;0
4313;78596;873;42;23;4;19;.826;3520000;0
4313;80834;873;0;0;0;0;.00nan;0;0
4313;86394;876;75;30;2;28;.933;3600000;0
4313;159705;876;0;0;0;0;.00nan;0;0
4314;75313;881;0;0;0;0;.00nan;0;0
4314;85453;883;57;11;1;10;.909;1299000;0
4314;85787;881;66;31;3;28;.903;3600000;0
4314;142911;883;30;24;5;19;.792;2301000;0
4315;3359;878;0;0;0;0;.00nan;0;0
4315;176963;878;90;35;1;34;.971;3600000;0
4315;74734;887;0;0;0;0;.00nan;0;0
4315;87798;887;77;35;3;32;.914;3589000;0
4316;779;882;0;0;0;0;.00nan;0;0
4316;11716;893;0;0;0;0;.00nan;0;0
4316;70879;893;100;37;1;36;.973;3600000;0
4316;91742;882;74;31;3;28;.903;3562000;0
4317;8101;897;86;42;3;39;.929;3554000;0
4317;78348;897;0;0;0;0;.00nan;0;0
4317;139467;877;73;18;1;17;.944;3600000;0
4317;149858;877;0;0;0;0;.00nan;0;0
4318;987;886;0;0;0;0;.00nan;0;0
4318;11716;893;0;0;0;0;.00nan;0;0
4318;28833;886;91;38;2;36;.947;3900000;0
4318;70879;893;81;30;2;28;.933;3900000;0
4319;28701;875;100;34;1;33;.971;3900000;0
4319;63551;875;0;0;0;0;.00nan;0;0
4319;85453;883;0;0;0;0;.00nan;0;0
4319;142911;883;90;23;1;22;.957;3900000;0
4320;8101;897;59;25;3;22;.880;3600000;0
4320;78348;897;0;0;0;0;.00nan;0;0
4320;78596;873;0;0;0;0;.00nan;0;0
4320;80834;873;83;34;2;32;.941;3600000;0
4321;779;882;0;0;0;0;.00nan;0;0
4321;34708;892;0;0;0;0;.00nan;0;0
4321;46910;892;61;23;2;21;.913;3732000;0
4321;91742;882;70;29;3;26;.897;3732000;0
4322;3359;878;0;0;0;0;.00nan;0;0
4322;176963;878;45;26;4;22;.846;3900000;0
4322;86394;876;62;38;4;34;.895;3900000;0
4322;159705;876;0;0;0;0;.00nan;0;0
4323;75313;881;49;2;0;2;1.000;482000;0
4323;85787;881;58;43;6;37;.860;3118000;0
4323;139467;877;62;22;2;20;.909;3600000;0
4323;149858;877;0;0;0;0;.00nan;0;0
4324;2195;887;0;0;0;0;.00nan;0;0
4324;67287;872;61;34;4;30;.882;3600000;0
4324;74734;887;100;26;1;25;.962;3600000;0
4324;154414;872;0;0;0;0;.00nan;0;0
4325;779;882;0;0;0;0;.00nan;0;0
4325;28701;875;0;0;0;0;.00nan;0;0
4325;63551;875;62;29;3;26;.897;3545000;0
4325;91742;882;69;33;2;31;.939;3600000;0
4326;34708;892;0;0;0;0;.00nan;0;0
4326;46910;892;65;29;3;26;.897;3900000;0
4326;86394;876;0;0;0;0;.00nan;0;0
4326;159705;876;72;32;3;29;.906;3900000;0
4327;987;886;69;30;3;27;.900;3593000;0
4327;2195;887;0;0;0;0;.00nan;0;0
4327;28833;886;0;0;0;0;.00nan;0;0
4327;74734;887;60;21;2;19;.905;3600000;0
4328;11716;893;0;0;0;0;.00nan;0;0
4328;70879;893;73;32;2;30;.938;3600000;0
4328;78596;873;34;27;5;22;.815;3600000;0
4328;80834;873;0;0;0;0;.00nan;0;0
4329;3359;878;0;0;0;0;.00nan;0;0
4329;8101;897;90;28;1;27;.964;3600000;0
4329;176963;878;54;19;2;17;.895;3600000;0
4329;78348;897;0;0;0;0;.00nan;0;0
4330;67287;872;70;27;2;25;.926;3900000;0
4330;75313;881;0;0;0;0;.00nan;0;0
4330;85787;881;84;32;2;30;.938;3900000;0
4330;154414;872;0;0;0;0;.00nan;0;0
4331;85453;883;49;9;1;8;.889;432000;0
4331;139467;877;0;0;0;0;.00nan;0;0
4331;142911;883;27;28;6;22;.786;3168000;0
4331;149858;877;69;25;2;23;.920;3600000;0
4332;11716;893;0;0;0;0;.00nan;0;0
4332;28701;875;99;38;2;36;.947;3600000;0
4332;63551;875;0;0;0;0;.00nan;0;0
4332;70879;893;79;41;4;37;.902;3600000;0
4333;987;886;25;24;6;18;.750;2811000;0
4333;28833;886;50;10;1;9;.900;789000;0
4333;139467;877;80;31;1;30;.968;3600000;0
4333;149858;877;0;0;0;0;.00nan;0;0
4334;67287;872;79;34;2;32;.941;3545000;0
4334;86394;876;85;30;1;29;.967;3600000;0
4334;154414;872;0;0;0;0;.00nan;0;0
4334;159705;876;0;0;0;0;.00nan;0;0
4335;2195;887;0;0;0;0;.00nan;0;0
4335;34708;892;77;23;1;22;.957;3600000;0
4335;46910;892;0;0;0;0;.00nan;0;0
4335;74734;887;77;29;2;27;.931;3561000;0
4336;779;882;65;37;4;33;.892;3600000;0
4336;78596;873;55;31;5;26;.839;3535000;0
4336;80834;873;0;0;0;0;.00nan;0;0
4336;91742;882;0;0;0;0;.00nan;0;0
4337;3359;878;0;0;0;0;.00nan;0;0
4337;176963;878;69;27;2;25;.926;3600000;0
4337;85453;883;0;0;0;0;.00nan;0;0
4337;142911;883;40;21;4;17;.810;3560000;0
4338;8101;897;77;47;5;42;.894;3600000;0
4338;75313;881;78;27;1;26;.963;3600000;0
4338;78348;897;0;0;0;0;.00nan;0;0
4338;85787;881;0;0;0;0;.00nan;0;0
4339;987;886;100;48;1;47;.979;3600000;0
4339;28833;886;0;0;0;0;.00nan;0;0
4339;67287;872;46;26;4;22;.846;3600000;0
4339;154414;872;0;0;0;0;.00nan;0;0
4340;28701;875;0;0;0;0;.00nan;0;0
4340;34708;892;0;0;0;0;.00nan;0;0
4340;46910;892;53;17;2;15;.882;3600000;0
4340;63551;875;83;44;3;41;.932;3566000;0
4341;779;882;0;0;0;0;.00nan;0;0
4341;85453;883;97;46;3;43;.935;3874000;0
4341;91742;882;64;30;4;26;.867;3874000;0
4341;142911;883;0;0;0;0;.00nan;0;0
4342;2195;887;0;0;0;0;.00nan;0;0
4342;8101;897;94;37;1;36;.973;3600000;0
4342;74734;887;69;26;2;24;.923;3600000;0
4342;78348;897;0;0;0;0;.00nan;0;0
4343;75313;881;0;0;0;0;.00nan;0;0
4343;78596;873;0;0;0;0;.00nan;0;0
4343;80834;873;75;30;2;28;.933;3600000;0
4343;85787;881;63;26;3;23;.885;3552000;0
4344;86394;876;100;31;0;31;1.000;3600000;0
4344;139467;877;88;40;3;37;.925;3600000;0
4344;149858;877;0;0;0;0;.00nan;0;0
4344;159705;876;0;0;0;0;.00nan;0;0
4345;3359;878;0;0;0;0;.00nan;0;0
4345;11716;893;97;49;2;47;.959;3900000;0
4345;176963;878;72;21;2;19;.905;3900000;0
4345;70879;893;0;0;0;0;.00nan;0;0
4346;987;886;38;17;4;13;.765;1184000;0
4346;28833;886;74;24;2;22;.917;2416000;0
4346;85453;883;0;0;0;0;.00nan;0;0
4346;142911;883;100;29;0;29;1.000;3600000;0
4347;78596;873;55;39;6;33;.846;3600000;0
4347;80834;873;0;0;0;0;.00nan;0;0
4347;139467;877;51;26;3;23;.885;3600000;0
4347;149858;877;0;0;0;0;.00nan;0;0
4348;779;882;0;0;0;0;.00nan;0;0
4348;2195;887;0;0;0;0;.00nan;0;0
4348;74734;887;69;40;4;36;.900;3600000;0
4348;91742;882;64;40;5;35;.875;3543000;0
4349;8101;897;81;34;3;31;.912;3600000;0
4349;34708;892;0;0;0;0;.00nan;0;0
4349;46910;892;67;21;2;19;.905;3600000;0
4349;78348;897;0;0;0;0;.00nan;0;0
4350;28701;875;0;0;0;0;.00nan;0;0
4350;63551;875;88;33;2;31;.939;3600000;0
4350;75313;881;0;0;0;0;.00nan;0;0
4350;85787;881;57;27;3;24;.889;3567000;0
4351;3359;878;0;0;0;0;.00nan;0;0
4351;176963;878;56;39;5;34;.872;3600000;0
4351;67287;872;0;0;0;0;.00nan;0;0
4351;154414;872;82;29;2;27;.931;3600000;0
4352;28701;875;81;37;3;34;.919;3600000;0
4352;63551;875;0;0;0;0;.00nan;0;0
4352;67287;872;60;30;4;26;.867;3575000;0
4352;154414;872;0;0;0;0;.00nan;0;0
4353;779;882;0;0;0;0;.00nan;0;0
4353;86394;876;88;33;2;31;.939;3900000;0
4353;91742;882;96;45;2;43;.956;3900000;0
4353;159705;876;0;0;0;0;.00nan;0;0
4354;78596;873;71;51;5;46;.902;3845000;0
4354;80834;873;0;0;0;0;.00nan;0;0
4354;85453;883;0;0;0;0;.00nan;0;0
4354;142911;883;52;28;4;24;.857;3861000;0
4355;2195;887;61;38;5;33;.868;3600000;0
4355;74734;887;0;0;0;0;.00nan;0;0
4355;75313;881;0;0;0;0;.00nan;0;0
4355;85787;881;81;20;1;19;.950;3600000;0
4356;8101;897;83;35;2;33;.943;3570000;0
4356;11716;893;82;29;1;28;.966;3600000;0
4356;70879;893;0;0;0;0;.00nan;0;0
4356;78348;897;0;0;0;0;.00nan;0;0
4357;987;886;80;37;2;35;.946;3600000;0
4357;3359;878;0;0;0;0;.00nan;0;0
4357;28833;886;0;0;0;0;.00nan;0;0
4357;176963;878;74;21;1;20;.952;3600000;0
4358;34708;892;0;0;0;0;.00nan;0;0
4358;46910;892;78;27;1;26;.963;3600000;0
4358;139467;877;68;38;3;35;.921;3559000;0
4358;149858;877;0;0;0;0;.00nan;0;0
4359;28701;875;0;0;0;0;.00nan;0;0
4359;63551;875;45;43;6;37;.860;3574000;0
4359;86394;876;33;27;5;22;.815;3600000;0
4359;159705;876;0;0;0;0;.00nan;0;0
4360;34708;892;56;19;2;17;.895;3600000;0
4360;46910;892;0;0;0;0;.00nan;0;0
4360;85453;883;0;0;0;0;.00nan;0;0
4360;142911;883;72;36;3;33;.917;3589000;0
4361;2195;887;0;0;0;0;.00nan;0;0
4361;74734;887;65;29;2;27;.931;3551000;0
4361;139467;877;90;28;1;27;.964;3600000;0
4361;149858;877;0;0;0;0;.00nan;0;0
4362;779;882;0;0;0;0;.00nan;0;0
4362;75313;881;0;0;0;0;.00nan;0;0
4362;85787;881;84;36;3;33;.917;3550000;0
4362;91742;882;65;24;2;22;.917;3600000;0
4363;987;886;58;25;3;22;.880;3555000;0
4363;8101;897;97;34;1;33;.971;3600000;0
4363;28833;886;0;0;0;0;.00nan;0;0
4363;78348;897;0;0;0;0;.00nan;0;0
4364;3359;878;60;42;5;37;.881;3600000;0
4364;176963;878;0;0;0;0;.00nan;0;0
4364;78596;873;59;18;2;16;.889;3600000;0
4364;80834;873;0;0;0;0;.00nan;0;0
4365;11716;893;0;0;0;0;.00nan;0;0
4365;67287;872;75;30;2;28;.933;3600000;0
4365;70879;893;59;44;6;38;.864;3600000;0
4365;154414;872;0;0;0;0;.00nan;0;0
4366;2195;887;0;0;0;0;.00nan;0;0
4366;74734;887;82;44;4;40;.909;3583000;0
4366;86394;876;0;0;0;0;.00nan;0;0
4366;159705;876;60;29;3;26;.897;3600000;0
4367;987;886;87;30;1;29;.967;3555000;0
4367;28833;886;0;0;0;0;.00nan;0;0
4367;34708;892;0;0;0;0;.00nan;0;0
4367;46910;892;99;26;0;26;1.000;3600000;0
4368;11716;893;0;0;0;0;.00nan;0;0
4368;70879;893;99;35;1;34;.971;3600000;0
4368;85453;883;0;0;0;0;.00nan;0;0
4368;142911;883;89;36;2;34;.944;3547000;0
4369;67287;872;82;30;2;28;.933;3600000;0
4369;78596;873;54;5;0;5;1.000;446000;0
4369;80834;873;32;29;6;23;.793;3154000;0
4369;154414;872;0;0;0;0;.00nan;0;0
4370;779;882;0;0;0;0;.00nan;0;0
4370;8101;897;92;34;1;33;.971;3900000;0
4370;78348;897;0;0;0;0;.00nan;0;0
4370;91742;882;97;34;1;33;.971;3900000;0
4371;3359;878;98;20;0;20;1.000;3600000;0
4371;176963;878;0;0;0;0;.00nan;0;0
4371;75313;881;0;0;0;0;.00nan;0;0
4371;85787;881;81;36;2;34;.944;3577000;0
4372;28701;875;88;46;3;43;.935;3600000;0
4372;63551;875;0;0;0;0;.00nan;0;0
4372;139467;877;100;30;0;30;1.000;3600000;0
4372;149858;877;0;0;0;0;.00nan;0;0
4373;28701;875;46;41;6;35;.854;3742000;0
4373;63551;875;0;0;0;0;.00nan;0;0
4373;78596;873;58;38;5;33;.868;3742000;0
4373;80834;873;0;0;0;0;.00nan;0;0
4374;987;886;61;37;4;33;.892;3515000;0
4374;28833;886;0;0;0;0;.00nan;0;0
4374;86394;876;64;23;2;21;.913;3600000;0
4374;159705;876;0;0;0;0;.00nan;0;0
4375;2195;887;0;0;0;0;.00nan;0;0
4375;74734;887;60;42;6;36;.857;3834000;0
4375;85453;883;0;0;0;0;.00nan;0;0
4375;142911;883;39;25;5;20;.800;3870000;0
4376;779;882;0;0;0;0;.00nan;0;0
4376;91742;882;73;37;3;34;.919;3568000;0
4376;139467;877;83;33;2;31;.939;3600000;0
4376;149858;877;0;0;0;0;.00nan;0;0
4377;3359;878;33;9;3;6;.667;586000;0
4377;176963;878;56;14;1;13;.929;2958000;0
4377;34708;892;0;0;0;0;.00nan;0;0
4377;46910;892;54;25;3;22;.880;3600000;0
4378;11716;893;0;0;0;0;.00nan;0;0
4378;70879;893;99;37;1;36;.973;3600000;0
4378;75313;881;0;0;0;0;.00nan;0;0
4378;85787;881;91;53;4;49;.925;3600000;0
4379;8101;897;98;29;2;27;.931;3594000;0
4379;67287;872;57;15;1;14;.933;3600000;0
4379;78348;897;0;0;0;0;.00nan;0;0
4379;154414;872;0;0;0;0;.00nan;0;0
4380;28701;875;62;30;3;27;.900;3575000;0
4380;63551;875;0;0;0;0;.00nan;0;0
4380;78596;873;42;19;3;16;.842;3600000;0
4380;80834;873;0;0;0;0;.00nan;0;0
4381;987;886;75;51;4;47;.922;3600000;0
4381;28833;886;0;0;0;0;.00nan;0;0
4381;75313;881;0;0;0;0;.00nan;0;0
4381;85787;881;100;41;1;40;.976;3600000;0
4382;34708;892;68;21;2;19;.905;3600000;0
4382;46910;892;0;0;0;0;.00nan;0;0
4382;85453;883;0;0;0;0;.00nan;0;0
4382;142911;883;43;31;5;26;.839;3600000;0
4383;8101;897;0;0;0;0;.00nan;0;0
4383;78348;897;98;52;2;50;.962;3590000;0
4383;86394;876;63;16;1;15;.938;3600000;0
4383;159705;876;0;0;0;0;.00nan;0;0
4384;3359;878;92;34;1;33;.971;3600000;0
4384;176963;878;0;0;0;0;.00nan;0;0
4384;139467;877;70;30;2;28;.933;3551000;0
4384;149858;877;0;0;0;0;.00nan;0;0
4385;34708;892;0;0;0;0;.00nan;0;0
4385;46910;892;40;35;6;29;.829;3531000;0
4385;78596;873;0;0;0;0;.00nan;0;0
4385;80834;873;74;43;4;39;.907;3600000;0
4386;85453;883;65;30;3;27;.900;3558000;0
4386;86394;876;62;21;2;19;.905;3600000;0
4386;142911;883;0;0;0;0;.00nan;0;0
4386;159705;876;0;0;0;0;.00nan;0;0
4387;2195;887;0;0;0;0;.00nan;0;0
4387;11716;893;0;0;0;0;.00nan;0;0
4387;70879;893;88;30;1;29;.967;3600000;0
4387;74734;887;73;33;3;30;.909;3566000;0
4388;8101;897;71;36;4;32;.889;3900000;0
4388;28701;875;0;0;0;0;.00nan;0;0
4388;63551;875;56;35;4;31;.886;3900000;0
4388;78348;897;0;0;0;0;.00nan;0;0
4389;779;882;0;0;0;0;.00nan;0;0
4389;67287;872;62;22;2;20;.909;3600000;0
4389;91742;882;62;40;5;35;.875;3600000;0
4389;154414;872;0;0;0;0;.00nan;0;0
4390;3359;878;82;30;1;29;.967;3600000;0
4390;176963;878;0;0;0;0;.00nan;0;0
4390;139467;877;70;43;5;38;.884;3600000;0
4390;149858;877;0;0;0;0;.00nan;0;0
4391;2195;887;0;0;0;0;.00nan;0;0
4391;28701;875;49;13;2;11;.846;3600000;0
4391;63551;875;0;0;0;0;.00nan;0;0
4391;74734;887;68;34;3;31;.912;3558000;0
4392;11716;893;0;0;0;0;.00nan;0;0
4392;34708;892;0;0;0;0;.00nan;0;0
4392;46910;892;95;22;0;22;1.000;3600000;0
4392;70879;893;72;29;2;27;.931;3559000;0
4393;78596;873;52;42;6;36;.857;3600000;0
4393;80834;873;0;0;0;0;.00nan;0;0
4393;86394;876;56;21;3;18;.857;3600000;0
4393;159705;876;0;0;0;0;.00nan;0;0
4394;779;882;0;0;0;0;.00nan;0;0
4394;85453;883;0;0;0;0;.00nan;0;0
4394;91742;882;71;33;3;30;.909;3900000;0
4394;142911;883;62;27;3;24;.889;3900000;0
4395;3359;878;100;35;0;35;1.000;3600000;0
4395;8101;897;91;31;1;30;.968;3600000;0
4395;176963;878;0;0;0;0;.00nan;0;0
4395;78348;897;0;0;0;0;.00nan;0;0
4396;67287;872;78;35;2;33;.943;3900000;0
4396;75313;881;0;0;0;0;.00nan;0;0
4396;85787;881;79;38;2;36;.947;3900000;0
4396;154414;872;0;0;0;0;.00nan;0;0
4397;8101;897;83;34;3;31;.912;3561000;0
4397;28701;875;0;0;0;0;.00nan;0;0
4397;63551;875;97;37;1;36;.973;3600000;0
4397;78348;897;0;0;0;0;.00nan;0;0
4398;86394;876;0;0;0;0;.00nan;0;0
4398;139467;877;98;36;1;35;.972;3600000;0
4398;149858;877;0;0;0;0;.00nan;0;0
4398;159705;876;93;45;2;43;.956;3550000;0
4399;64911;882;0;0;0;0;.00nan;0;0
4399;78596;873;79;48;4;44;.917;3534000;0
4399;80834;873;0;0;0;0;.00nan;0;0
4399;91742;882;80;22;2;20;.909;3600000;0
4400;3359;878;68;23;2;21;.913;3600000;0
4400;11716;893;0;0;0;0;.00nan;0;0
4400;176963;878;0;0;0;0;.00nan;0;0
4400;70879;893;77;44;4;40;.909;3520000;0
4401;2195;887;0;0;0;0;.00nan;0;0
4401;74734;887;74;44;5;39;.886;3556000;0
4401;75313;881;0;0;0;0;.00nan;0;0
4401;85787;881;65;36;4;32;.889;3600000;0
4402;34708;892;0;0;0;0;.00nan;0;0
4402;46910;892;76;28;2;26;.929;3900000;0
4402;67287;872;68;27;2;25;.926;3900000;0
4402;154414;872;0;0;0;0;.00nan;0;0
4403;11716;893;0;0;0;0;.00nan;0;0
4403;70879;893;91;44;2;42;.955;3600000;0
4403;75313;881;62;32;4;28;.875;3514000;0
4403;85787;881;0;0;0;0;.00nan;0;0
4404;987;886;94;30;1;29;.967;3600000;0
4404;28701;875;68;28;2;26;.929;3569000;0
4404;28833;886;0;0;0;0;.00nan;0;0
4404;63551;875;0;0;0;0;.00nan;0;0
4405;3359;878;68;33;3;30;.909;3572000;0
4405;176963;878;0;0;0;0;.00nan;0;0
4405;34708;892;0;0;0;0;.00nan;0;0
4405;46910;892;65;26;2;24;.923;3600000;0
4406;2195;887;37;40;7;33;.825;3600000;0
4406;74734;887;0;0;0;0;.00nan;0;0
4406;78596;873;77;30;2;28;.933;3600000;0
4406;80834;873;0;0;0;0;.00nan;0;0
4407;779;882;0;0;0;0;.00nan;0;0
4407;86394;876;76;37;3;34;.919;3532000;0
4407;91742;882;88;29;1;28;.966;3600000;0
4407;159705;876;0;0;0;0;.00nan;0;0
4408;8101;897;0;0;0;0;.00nan;0;0
4408;75313;881;0;0;0;0;.00nan;0;0
4408;78348;897;59;35;4;31;.886;3581000;0
4408;85787;881;63;20;2;18;.900;3600000;0
4409;67287;872;0;0;0;0;.00nan;0;0
4409;85453;883;0;0;0;0;.00nan;0;0
4409;142911;883;79;36;3;33;.917;3600000;0
4409;154414;872;59;34;4;30;.882;3577000;0
4410;11716;893;58;3;0;3;1.000;491000;0
4410;70879;893;60;46;6;40;.870;3109000;0
4410;139467;877;0;0;0;0;.00nan;0;0
4410;149858;877;93;19;0;19;1.000;3600000;0
4411;85453;883;0;0;0;0;.00nan;0;0
4411;86394;876;61;20;2;18;.900;3544000;0
4411;142911;883;89;35;1;34;.971;3600000;0
4411;159705;876;0;0;0;0;.00nan;0;0
4412;8101;897;100;31;1;30;.968;3600000;0
4412;34708;892;0;0;0;0;.00nan;0;0
4412;46910;892;50;28;4;24;.857;3600000;0
4412;78348;897;0;0;0;0;.00nan;0;0
4413;2195;887;0;0;0;0;.00nan;0;0
4413;67287;872;65;20;2;18;.900;3600000;0
4413;74734;887;88;46;4;42;.913;3600000;0
4413;154414;872;0;0;0;0;.00nan;0;0
4414;987;886;61;33;4;29;.879;3544000;0
4414;11716;893;0;0;0;0;.00nan;0;0
4414;28833;886;0;0;0;0;.00nan;0;0
4414;70879;893;84;37;3;34;.919;3600000;0
4415;3359;878;56;22;3;19;.864;3544000;0
4415;176963;878;0;0;0;0;.00nan;0;0
4415;78596;873;0;0;0;0;.00nan;0;0
4415;80834;873;85;26;1;25;.962;3600000;0
4416;779;882;23;11;4;7;.636;1437000;0
4416;28701;875;0;0;0;0;.00nan;0;0
4416;63551;875;61;38;4;34;.895;3600000;0
4416;91742;882;36;29;6;23;.793;2163000;0
4417;75313;881;0;0;0;0;.00nan;0;0
4417;85787;881;84;30;1;29;.967;3600000;0
4417;139467;877;0;0;0;0;.00nan;0;0
4417;149858;877;83;31;2;29;.935;3600000;0
4418;3359;878;97;34;1;33;.971;3567000;0
4418;176963;878;0;0;0;0;.00nan;0;0
4418;67287;872;90;17;0;17;1.000;3600000;0
4418;154414;872;0;0;0;0;.00nan;0;0
4419;28701;875;67;43;4;39;.907;3600000;0
4419;63551;875;0;0;0;0;.00nan;0;0
4419;139467;877;87;17;0;17;1.000;3600000;0
4419;149858;877;0;0;0;0;.00nan;0;0
4420;779;882;0;0;0;0;.00nan;0;0
4420;987;886;58;36;5;31;.861;3587000;0
4420;28833;886;0;0;0;0;.00nan;0;0
4420;91742;882;41;26;4;22;.846;3600000;0
4421;11716;893;0;0;0;0;.00nan;0;0
4421;70879;893;83;30;2;28;.933;3548000;0
4421;85453;883;0;0;0;0;.00nan;0;0
4421;142911;883;88;31;1;30;.968;3600000;0
4422;34708;892;0;0;0;0;.00nan;0;0
4422;46910;892;42;22;3;19;.864;3899000;0
4422;78596;873;61;23;3;20;.870;3900000;0
4422;80834;873;0;0;0;0;.00nan;0;0
4423;2195;887;0;0;0;0;.00nan;0;0
4423;8101;897;58;30;4;26;.867;3562000;0
4423;74734;887;70;31;3;28;.903;3600000;0
4423;78348;897;0;0;0;0;.00nan;0;0
4424;3359;878;70;34;2;32;.941;3900000;0
4424;176963;878;0;0;0;0;.00nan;0;0
4424;67287;872;94;38;2;36;.947;3900000;0
4424;154414;872;0;0;0;0;.00nan;0;0
4425;75313;881;0;0;0;0;.00nan;0;0
4425;85787;881;84;34;2;32;.941;3648000;0
4425;86394;876;87;39;3;36;.923;3648000;0
4425;159705;876;0;0;0;0;.00nan;0;0
4426;987;886;68;36;4;32;.889;3807000;0
4426;3359;878;63;23;3;20;.870;3851000;0
4426;28833;886;0;0;0;0;.00nan;0;0
4426;176963;878;0;0;0;0;.00nan;0;0
4427;2195;887;0;0;0;0;.00nan;0;0
4427;74734;887;57;33;4;29;.879;3566000;0
4427;86394;876;72;36;3;33;.917;3600000;0
4427;159705;876;0;0;0;0;.00nan;0;0
4428;779;882;68;20;1;19;.950;3456000;0
4428;11716;893;0;0;0;0;.00nan;0;0
4428;70879;893;61;39;5;34;.872;3863000;0
4428;91742;882;26;5;3;2;.400;407000;0
4429;8101;897;0;0;0;0;.00nan;0;0
4429;78348;897;81;43;4;39;.907;3616000;0
4429;78596;873;82;32;3;29;.906;3616000;0
4429;80834;873;0;0;0;0;.00nan;0;0
4430;75313;881;0;0;0;0;.00nan;0;0
4430;85453;883;0;0;0;0;.00nan;0;0
4430;85787;881;61;22;2;20;.909;3900000;0
4430;142911;883;75;30;2;28;.933;3900000;0
4431;28701;875;53;12;1;11;.917;1499000;0
4431;63551;875;33;23;5;18;.783;2264000;0
4431;67287;872;45;45;7;38;.844;3763000;0
4431;154414;872;0;0;0;0;.00nan;0;0
4432;34708;892;0;0;0;0;.00nan;0;0
4432;46910;892;84;33;2;31;.939;3690000;0
4432;139467;877;71;27;3;24;.889;3690000;0
4432;149858;877;0;0;0;0;.00nan;0;0
4433;11716;893;0;0;0;0;.00nan;0;0
4433;70879;893;99;20;0;20;1.000;3600000;0
4433;86394;876;63;47;5;42;.894;3600000;0
4433;159705;876;0;0;0;0;.00nan;0;0
4434;28701;875;58;41;5;36;.878;3900000;0
4434;63551;875;0;0;0;0;.00nan;0;0
4434;75313;881;0;0;0;0;.00nan;0;0
4434;85787;881;55;36;5;31;.861;3900000;0
4435;11716;893;0;0;0;0;.00nan;0;0
4435;70879;893;45;28;4;24;.857;3600000;0
4435;86394;876;85;40;3;37;.925;3600000;0
4435;159705;876;0;0;0;0;.00nan;0;0
4436;34708;892;0;0;0;0;.00nan;0;0
4436;46910;892;70;28;3;25;.893;3547000;0
4436;85453;883;99;39;2;37;.949;3600000;0
4436;142911;883;0;0;0;0;.00nan;0;0
4437;8101;897;0;0;0;0;.00nan;0;0
4437;64911;882;0;0;0;0;.00nan;0;0
4437;78348;897;57;24;3;21;.875;3536000;0
4437;91742;882;85;37;2;35;.946;3600000;0
4438;2195;887;0;0;0;0;.00nan;0;0
4438;3359;878;100;26;0;26;1.000;3600000;0
4438;176963;878;0;0;0;0;.00nan;0;0
4438;74734;887;84;29;2;27;.931;3568000;0
4439;987;886;84;36;3;33;.917;3537000;0
4439;28833;886;0;0;0;0;.00nan;0;0
4439;67287;872;67;18;1;17;.944;3600000;0
4439;154414;872;0;0;0;0;.00nan;0;0
4440;78596;873;98;55;3;52;.945;3584000;0
4440;80834;873;0;0;0;0;.00nan;0;0
4440;139467;877;68;12;1;11;.917;3600000;0
4440;149858;877;0;0;0;0;.00nan;0;0
4441;3359;878;68;27;2;25;.926;3600000;0
4441;28701;875;0;0;0;0;.00nan;0;0
4441;176963;878;0;0;0;0;.00nan;0;0
4441;63551;875;97;30;1;29;.967;3600000;0
4442;34708;892;49;35;5;30;.857;3600000;0
4442;46910;892;0;0;0;0;.00nan;0;0
4442;86394;876;77;32;2;30;.938;3600000;0
4442;159705;876;0;0;0;0;.00nan;0;0
4443;2195;887;58;6;0;6;1.000;312000;0
4443;11716;893;0;0;0;0;.00nan;0;0
4443;70879;893;87;25;1;24;.960;3600000;0
4443;74734;887;49;36;6;30;.833;3288000;0
4444;78596;873;62;40;5;35;.875;3600000;0
4444;80834;873;0;0;0;0;.00nan;0;0
4444;85453;883;0;0;0;0;.00nan;0;0
4444;142911;883;69;17;1;16;.941;3600000;0
4445;8101;897;0;0;0;0;.00nan;0;0
4445;67287;872;94;49;2;47;.959;3600000;0
4445;78348;897;66;42;5;37;.881;3600000;0
4445;154414;872;0;0;0;0;.00nan;0;0
4446;987;886;89;42;3;39;.929;3870000;0
4446;28833;886;0;0;0;0;.00nan;0;0
4446;75313;881;0;0;0;0;.00nan;0;0
4446;85787;881;61;21;2;19;.905;3870000;0
4447;64911;882;0;0;0;0;.00nan;0;0
4447;91742;882;64;46;5;41;.891;3600000;0
4447;139467;877;64;22;2;20;.909;3600000;0
4447;149858;877;0;0;0;0;.00nan;0;0
4448;28701;875;77;25;1;24;.960;3600000;0
4448;63551;875;0;0;0;0;.00nan;0;0
4448;67287;872;100;27;0;27;1.000;3600000;0
4448;154414;872;0;0;0;0;.00nan;0;0
4449;2195;887;88;52;4;48;.923;3543000;0
4449;74734;887;0;0;0;0;.00nan;0;0
4449;139467;877;77;34;3;31;.912;3600000;0
4449;149858;877;0;0;0;0;.00nan;0;0
4450;987;886;67;34;4;30;.882;3600000;0
4450;28833;886;0;0;0;0;.00nan;0;0
4450;64911;882;0;0;0;0;.00nan;0;0
4450;91742;882;98;27;0;27;1.000;3600000;0
4451;987;886;71;26;2;24;.923;3651000;0
4451;8101;897;0;0;0;0;.00nan;0;0
4451;28833;886;0;0;0;0;.00nan;0;0
4451;78348;897;55;22;3;19;.864;3651000;0
4452;3359;878;91;51;2;49;.961;3600000;0
4452;176963;878;0;0;0;0;.00nan;0;0
4452;86394;876;42;19;4;15;.789;3571000;0
4452;159705;876;0;0;0;0;.00nan;0;0
4453;85453;883;0;0;0;0;.00nan;0;0
4453;139467;877;67;16;1;15;.938;3600000;0
4453;142911;883;96;51;3;48;.941;3579000;0
4453;149858;877;0;0;0;0;.00nan;0;0
4454;2195;887;0;0;0;0;.00nan;0;0
4454;34708;892;0;0;0;0;.00nan;0;0
4454;46910;892;75;29;2;27;.931;3900000;0
4454;74734;887;71;25;2;23;.920;3880000;0
4455;11716;893;0;0;0;0;.00nan;0;0
4455;28701;875;0;0;0;0;.00nan;0;0
4455;63551;875;79;45;3;42;.933;3600000;0
4455;70879;893;68;42;4;38;.905;3558000;0
4456;64911;882;0;0;0;0;.00nan;0;0
4456;75313;881;77;27;2;25;.926;3600000;0
4456;85787;881;0;0;0;0;.00nan;0;0
4456;91742;882;63;38;4;34;.895;3543000;0
4457;67287;872;100;38;1;37;.974;3600000;0
4457;78596;873;68;24;2;22;.917;3600000;0
4457;80834;873;0;0;0;0;.00nan;0;0
4457;154414;872;0;0;0;0;.00nan;0;0
4458;28701;875;0;0;0;0;.00nan;0;0
4458;34708;892;0;0;0;0;.00nan;0;0
4458;46910;892;67;22;2;20;.909;3600000;0
4458;63551;875;56;33;4;29;.879;3522000;0
4459;987;886;93;33;1;32;.970;3600000;0
4459;28833;886;0;0;0;0;.00nan;0;0
4459;86394;876;54;16;2;14;.875;3551000;0
4459;159705;876;0;0;0;0;.00nan;0;0
4460;2195;887;0;0;0;0;.00nan;0;0
4460;74734;887;72;44;5;39;.886;3573000;0
4460;85453;883;0;0;0;0;.00nan;0;0
4460;142911;883;69;34;3;31;.912;3600000;0
4461;11716;893;0;0;0;0;.00nan;0;0
4461;70879;893;38;22;4;18;.818;3553000;0
4461;78596;873;91;42;3;39;.929;3600000;0
4461;80834;873;0;0;0;0;.00nan;0;0
4462;64911;882;64;8;0;8;1.000;752000;0
4462;67287;872;36;12;3;9;.750;543000;0
4462;91742;882;15;17;6;11;.647;2848000;0
4462;154414;872;38;31;5;26;.839;3008000;0
4463;8101;897;48;27;4;23;.852;3511000;0
4463;78348;897;0;0;0;0;.00nan;0;0
4463;139467;877;88;33;2;31;.939;3600000;0
4463;149858;877;0;0;0;0;.00nan;0;0
4464;3359;878;67;35;4;31;.886;3568000;0
4464;176963;878;0;0;0;0;.00nan;0;0
4464;75313;881;0;0;0;0;.00nan;0;0
4464;85787;881;80;26;1;25;.962;3600000;0
4465;28701;875;0;0;0;0;.00nan;0;0
4465;63551;875;100;56;1;55;.982;3600000;0
4465;86394;876;49;20;3;17;.850;3554000;0
4465;159705;876;0;0;0;0;.00nan;0;0
4466;34708;892;54;22;3;19;.864;2907000;0
4466;46910;892;30;14;4;10;.714;693000;0
4466;75313;881;0;0;0;0;.00nan;0;0
4466;85787;881;80;25;1;24;.960;3600000;0
4467;8101;897;0;0;0;0;.00nan;0;0
4467;78348;897;85;25;1;24;.960;3600000;0
4467;85453;883;0;0;0;0;.00nan;0;0
4467;142911;883;60;30;3;27;.900;3600000;0
4468;11716;893;99;46;1;45;.978;3600000;0
4468;67287;872;47;19;3;16;.842;3522000;0
4468;70879;893;0;0;0;0;.00nan;0;0
4468;154414;872;0;0;0;0;.00nan;0;0
4469;987;886;93;35;1;34;.971;3600000;0
4469;28833;886;0;0;0;0;.00nan;0;0
4469;78596;873;92;39;2;37;.949;3578000;0
4469;80834;873;0;0;0;0;.00nan;0;0
4470;3359;878;75;49;5;44;.898;3544000;0
4470;176963;878;0;0;0;0;.00nan;0;0
4470;64911;882;0;0;0;0;.00nan;0;0
4470;91742;882;100;42;3;39;.929;3600000;0
4471;2195;887;0;0;0;0;.00nan;0;0
4471;74734;887;81;41;4;37;.902;3680000;0
4471;139467;877;0;0;0;0;.00nan;0;0
4471;149858;877;46;31;5;26;.839;3680000;0
4472;28701;875;59;27;3;24;.889;3600000;0
4472;63551;875;0;0;0;0;.00nan;0;0
4472;85453;883;0;0;0;0;.00nan;0;0
4472;142911;883;53;35;5;30;.857;3550000;0
4473;987;886;0;0;0;0;.00nan;0;0
4473;28833;886;87;40;4;36;.900;3586000;0
4473;34708;892;0;0;0;0;.00nan;0;0
4473;46910;892;64;21;2;19;.905;3600000;0
4474;2195;887;0;0;0;0;.00nan;0;0
4474;64911;882;0;0;0;0;.00nan;0;0
4474;74734;887;77;34;3;31;.912;3703000;0
4474;91742;882;75;28;2;26;.929;3703000;0
4475;8101;897;70;24;2;22;.917;3549000;0
4475;11716;893;0;0;0;0;.00nan;0;0
4475;70879;893;78;24;1;23;.958;3600000;0
4475;78348;897;0;0;0;0;.00nan;0;0
4476;3359;878;87;42;2;40;.952;3568000;0
4476;176963;878;0;0;0;0;.00nan;0;0
4476;139467;877;100;27;0;27;1.000;3600000;0
4476;149858;877;0;0;0;0;.00nan;0;0
4477;75313;881;0;0;0;0;.00nan;0;0
4477;78596;873;100;33;1;32;.970;3900000;0
4477;80834;873;0;0;0;0;.00nan;0;0
4477;85787;881;91;36;1;35;.972;3900000;0
4478;67287;872;0;0;0;0;.00nan;0;0
4478;86394;876;55;37;5;32;.865;3900000;0
4478;154414;872;63;44;5;39;.886;3900000;0
4478;159705;876;0;0;0;0;.00nan;0;0
4479;987;886;88;25;0;25;1.000;3600000;0
4479;2195;887;0;0;0;0;.00nan;0;0
4479;28833;886;0;0;0;0;.00nan;0;0
4479;74734;887;83;40;3;37;.925;3600000;0
4480;8101;897;74;41;4;37;.902;3600000;0
4480;78348;897;0;0;0;0;.00nan;0;0
4480;86394;876;0;0;0;0;.00nan;0;0
4480;159705;876;59;30;3;27;.900;3600000;0
4481;34708;892;0;0;0;0;.00nan;0;0
4481;46910;892;69;32;3;29;.906;3626000;0
4481;64911;882;0;0;0;0;.00nan;0;0
4481;91742;882;71;35;4;31;.886;3626000;0
4482;3359;878;81;22;1;21;.955;3600000;0
4482;176963;878;0;0;0;0;.00nan;0;0
4482;85453;883;53;23;3;20;.870;3600000;0
4482;142911;883;0;0;0;0;.00nan;0;0
4483;11716;893;0;0;0;0;.00nan;0;0
4483;70879;893;66;24;2;22;.917;3654000;0
4483;75313;881;0;0;0;0;.00nan;0;0
4483;85787;881;86;38;3;35;.921;3654000;0
4484;28701;875;49;28;4;24;.857;3594000;0
4484;63551;875;0;0;0;0;.00nan;0;0
4484;78596;873;0;0;0;0;.00nan;0;0
4484;80834;873;66;29;2;27;.931;3600000;0
4485;67287;872;74;29;2;27;.931;3600000;0
4485;139467;877;64;31;3;28;.903;3599000;0
4485;149858;877;0;0;0;0;.00nan;0;0
4485;154414;872;0;0;0;0;.00nan;0;0
4486;28701;875;0;0;0;0;.00nan;0;0
4486;63551;875;82;39;3;36;.923;3600000;0
4486;86394;876;42;22;4;18;.818;3552000;0
4486;159705;876;0;0;0;0;.00nan;0;0
4487;987;886;55;24;3;21;.875;3600000;0
4487;28833;886;0;0;0;0;.00nan;0;0
4487;67287;872;98;21;0;21;1.000;3600000;0
4487;154414;872;0;0;0;0;.00nan;0;0
4488;2195;887;0;0;0;0;.00nan;0;0
4488;3077;893;0;0;0;0;.00nan;0;0
4488;70879;893;72;26;2;24;.923;3900000;0
4488;74734;887;76;25;2;23;.920;3900000;0
4489;64911;882;58;27;3;24;.889;3600000;0
4489;78596;873;24;27;6;21;.778;3100000;0
4489;80834;873;53;4;0;4;1.000;500000;0
4489;91742;882;0;0;0;0;.00nan;0;0
4490;8101;897;0;0;0;0;.00nan;0;0
4490;78348;897;52;26;4;22;.846;3516000;0
4490;85453;883;0;0;0;0;.00nan;0;0
4490;142911;883;80;34;2;32;.941;3600000;0
4491;11716;892;37;23;5;18;.783;3600000;0
4491;46910;892;0;0;0;0;.00nan;0;0
4491;75313;881;0;0;0;0;.00nan;0;0
4491;85787;881;71;21;1;20;.952;3600000;0
4492;987;886;70;56;6;50;.893;3600000;0
4492;28833;886;0;0;0;0;.00nan;0;0
4492;139467;877;79;20;1;19;.950;3600000;0
4492;149858;877;0;0;0;0;.00nan;0;0
4493;2195;887;0;0;0;0;.00nan;0;0
4493;74734;887;61;33;4;29;.879;3664000;0
4493;86394;876;71;26;3;23;.885;3664000;0
4493;159705;876;0;0;0;0;.00nan;0;0
4494;11716;892;73;28;2;26;.929;3600000;0
4494;28701;875;45;10;2;8;.800;1399000;0
4494;46910;892;0;0;0;0;.00nan;0;0
4494;63551;875;24;16;5;11;.688;2201000;0
4495;75313;881;0;0;0;0;.00nan;0;0
4495;85453;883;0;0;0;0;.00nan;0;0
4495;85787;881;65;28;3;25;.893;3552000;0
4495;142911;883;99;41;1;40;.976;3600000;0
4496;8101;897;100;26;0;26;1.000;3600000;0
4496;78348;897;0;0;0;0;.00nan;0;0
4496;78596;873;0;0;0;0;.00nan;0;0
4496;80834;873;87;39;2;37;.949;3524000;0
4497;3359;878;73;32;2;30;.938;3600000;0
4497;176963;878;0;0;0;0;.00nan;0;0
4497;64911;882;63;28;3;25;.893;3552000;0
4497;91742;882;0;0;0;0;.00nan;0;0
4498;3077;893;58;14;1;13;.929;1607000;0
4498;67287;872;59;30;4;26;.867;3600000;0
4498;70879;893;18;16;5;11;.688;1925000;0
4498;154414;872;0;0;0;0;.00nan;0;0
4499;75313;881;72;14;0;14;1.000;1262000;0
4499;85787;881;37;27;5;22;.815;2338000;0
4499;86394;876;76;29;2;27;.931;3600000;0
4499;159705;876;0;0;0;0;.00nan;0;0
4500;11716;892;13;31;8;23;.742;2928000;0
4500;46910;892;54;2;0;2;1.000;672000;0
4500;139467;877;77;32;2;30;.938;3600000;0
4500;149858;877;0;0;0;0;.00nan;0;0
4501;2195;887;0;0;0;0;.00nan;0;0
4501;74734;887;68;22;2;20;.909;3600000;0
4501;85453;883;55;22;3;19;.864;3554000;0
4501;142911;883;0;0;0;0;.00nan;0;0
4502;20432;893;0;0;0;0;.00nan;0;0
4502;64911;882;0;0;0;0;.00nan;0;0
4502;70879;893;85;39;3;36;.923;3572000;0
4502;91742;882;77;26;1;25;.962;3600000;0
4503;67287;872;98;36;2;34;.944;3600000;0
4503;78596;873;23;12;4;8;.667;894000;0
4503;80834;873;36;14;3;11;.786;2706000;0
4503;154414;872;0;0;0;0;.00nan;0;0
4504;987;886;68;42;5;37;.881;3564000;0
4504;8101;897;55;24;3;21;.875;3600000;0
4504;28833;886;0;0;0;0;.00nan;0;0
4504;78348;897;0;0;0;0;.00nan;0;0
4505;3359;878;75;32;3;29;.906;3600000;0
4505;28701;875;0;0;0;0;.00nan;0;0
4505;176963;878;0;0;0;0;.00nan;0;0
4505;63551;875;52;35;5;30;.857;3516000;0
4506;67287;872;75;36;3;33;.917;3582000;0
4506;86394;876;72;21;1;20;.952;3600000;0
4506;154414;872;0;0;0;0;.00nan;0;0
4506;159705;876;0;0;0;0;.00nan;0;0
4507;2195;887;0;0;0;0;.00nan;0;0
4507;8101;897;68;31;4;27;.871;3582000;0
4507;74734;887;83;33;2;31;.939;3600000;0
4507;78348;897;0;0;0;0;.00nan;0;0
4508;20432;893;73;39;4;35;.897;3600000;0
4508;70879;893;0;0;0;0;.00nan;0;0
4508;85453;883;0;0;0;0;.00nan;0;0
4508;142911;883;84;28;1;27;.964;3600000;0
4509;75313;881;0;0;0;0;.00nan;0;0
4509;78596;873;0;0;0;0;.00nan;0;0
4509;80834;873;51;23;3;20;.870;3600000;0
4509;85787;881;58;41;5;36;.878;3551000;0
4510;11716;892;61;23;2;21;.913;3600000;0
4510;46910;892;0;0;0;0;.00nan;0;0
4510;64911;882;0;0;0;0;.00nan;0;0
4510;91742;882;55;30;4;26;.867;3529000;0
4511;987;886;92;36;2;34;.944;3600000;0
4511;3359;878;49;26;5;21;.808;3600000;0
4511;28833;886;0;0;0;0;.00nan;0;0
4511;176963;878;0;0;0;0;.00nan;0;0
4512;28701;875;74;39;4;35;.897;3572000;0
4512;63551;875;0;0;0;0;.00nan;0;0
4512;139467;877;36;11;3;8;.727;3600000;0
4512;149858;877;0;0;0;0;.00nan;0;0
4513;28701;875;88;34;1;33;.971;3600000;0
4513;63551;875;0;0;0;0;.00nan;0;0
4513;64911;882;0;0;0;0;.00nan;0;0
4513;91742;882;52;37;5;32;.865;3600000;0
4514;987;886;63;39;5;34;.872;3600000;0
4514;28833;886;0;0;0;0;.00nan;0;0
4514;86394;876;94;29;2;27;.931;3600000;0
4514;159705;876;0;0;0;0;.00nan;0;0
4515;2195;887;44;12;2;10;.833;1636000;0
4515;11716;892;75;21;1;20;.952;3600000;0
4515;46910;892;0;0;0;0;.00nan;0;0
4515;74734;887;20;16;5;11;.688;1964000;0
4516;78596;873;0;0;0;0;.00nan;0;0
4516;80834;873;55;20;3;17;.850;3632000;0
4516;85453;883;0;0;0;0;.00nan;0;0
4516;142911;883;66;37;4;33;.892;3632000;0
4517;3359;878;88;24;1;23;.958;3600000;0
4517;20432;893;77;35;3;32;.914;3542000;0
4517;176963;878;0;0;0;0;.00nan;0;0
4517;70879;893;0;0;0;0;.00nan;0;0
4518;8101;897;71;32;2;30;.938;3600000;0
4518;75313;881;0;0;0;0;.00nan;0;0
4518;78348;897;0;0;0;0;.00nan;0;0
4518;85787;881;51;26;4;22;.846;3554000;0
4519;67287;872;88;41;2;39;.951;3600000;0
4519;139467;877;42;22;4;18;.818;3547000;0
4519;149858;877;0;0;0;0;.00nan;0;0
4519;154414;872;0;0;0;0;.00nan;0;0
4520;987;886;78;30;2;28;.933;3899000;0
4520;20432;893;84;22;1;21;.955;3899000;0
4520;28833;886;0;0;0;0;.00nan;0;0
4520;70879;893;0;0;0;0;.00nan;0;0
4521;28701;875;0;0;0;0;.00nan;0;0
4521;63551;875;85;17;0;17;1.000;3600000;0
4521;85453;883;91;34;1;33;.971;3547000;0
4521;142911;883;0;0;0;0;.00nan;0;0
4522;2195;887;65;36;4;32;.889;3600000;0
4522;74734;887;0;0;0;0;.00nan;0;0
4522;75313;881;0;0;0;0;.00nan;0;0
4522;85787;881;64;16;1;15;.938;3600000;0
4523;78596;873;0;0;0;0;.00nan;0;0
4523;80834;873;63;36;4;32;.889;3585000;0
4523;139467;877;69;36;3;33;.917;3600000;0
4523;149858;877;0;0;0;0;.00nan;0;0
4524;8101;897;0;0;0;0;.00nan;0;0
4524;11716;892;69;22;2;20;.909;3600000;0
4524;46910;892;0;0;0;0;.00nan;0;0
4524;78348;897;57;41;5;36;.878;3600000;0
4525;3359;878;0;0;0;0;.00nan;0;0
4525;176963;878;77;42;4;38;.905;3589000;0
4525;86394;876;67;24;3;21;.875;3600000;0
4525;159705;876;0;0;0;0;.00nan;0;0
4526;64911;882;0;0;0;0;.00nan;0;0
4526;67287;872;75;29;2;27;.931;3600000;0
4526;91742;882;31;29;6;23;.793;3600000;0
4526;154414;872;0;0;0;0;.00nan;0;0
4527;78596;873;0;0;0;0;.00nan;0;0
4527;80834;873;70;39;3;36;.923;3549000;0
4527;86394;876;0;0;0;0;.00nan;0;0
4527;159705;876;74;18;1;17;.944;3600000;0
4528;987;886;92;39;2;37;.949;3600000;0
4528;11716;892;78;26;1;25;.962;3600000;0
4528;28833;886;0;0;0;0;.00nan;0;0
4528;46910;892;0;0;0;0;.00nan;0;0
4529;8101;897;70;38;3;35;.921;3600000;0
4529;20432;893;91;19;0;19;1.000;3600000;0
4529;70879;893;0;0;0;0;.00nan;0;0
4529;78348;897;0;0;0;0;.00nan;0;0
4530;2195;887;0;0;0;0;.00nan;0;0
4530;64911;882;89;34;1;33;.971;3600000;0
4530;74734;887;52;34;5;29;.853;3600000;0
4530;91742;882;0;0;0;0;.00nan;0;0
4531;3359;878;77;32;2;30;.938;3600000;0
4531;176963;878;0;0;0;0;.00nan;0;0
4531;75313;881;0;0;0;0;.00nan;0;0
4531;85787;881;69;32;3;29;.906;3595000;0
4532;85453;883;0;0;0;0;.00nan;0;0
4532;139467;877;0;0;0;0;.00nan;0;0
4532;142911;883;71;35;4;31;.886;3600000;0
4532;149858;877;67;36;3;33;.917;3600000;0
4533;987;886;100;38;1;37;.974;3600000;0
4533;28833;886;0;0;0;0;.00nan;0;0
4533;78596;873;0;0;0;0;.00nan;0;0
4533;80834;873;58;22;2;20;.909;3547000;0
4534;11716;892;72;20;1;19;.950;3600000;0
4534;20432;893;67;44;4;40;.909;3600000;0
4534;46910;892;0;0;0;0;.00nan;0;0
4534;70879;893;0;0;0;0;.00nan;0;0
4535;85453;883;0;0;0;0;.00nan;0;0
4535;86394;876;79;30;2;28;.933;3600000;0
4535;142911;883;92;55;6;49;.891;3600000;0
4535;159705;876;0;0;0;0;.00nan;0;0
4536;2195;887;0;0;0;0;.00nan;0;0
4536;3359;878;61;34;4;30;.882;3600000;0
4536;176963;878;0;0;0;0;.00nan;0;0
4536;74734;887;82;29;1;28;.966;3600000;0
4537;64911;882;0;0;0;0;.00nan;0;0
4537;91742;882;95;43;3;40;.930;3900000;0
4537;139467;877;86;38;3;35;.921;3900000;0
4537;149858;877;0;0;0;0;.00nan;0;0
4538;8101;897;0;0;0;0;.00nan;0;0
4538;28701;875;0;0;0;0;.00nan;0;0
4538;63551;875;51;23;3;20;.870;3600000;0
4538;78348;897;46;37;6;31;.838;3600000;0
4539;67287;872;71;30;3;27;.900;3562000;0
4539;75313;881;0;0;0;0;.00nan;0;0
4539;85787;881;59;18;2;16;.889;3600000;0
4539;154414;872;0;0;0;0;.00nan;0;0
4540;987;886;75;24;2;22;.917;3600000;0
4540;28833;886;0;0;0;0;.00nan;0;0
4540;85453;883;0;0;0;0;.00nan;0;0
4540;142911;883;76;39;3;36;.923;3529000;0
4541;64911;882;0;0;0;0;.00nan;0;0
4541;86394;876;69;27;2;25;.926;3600000;0
4541;91742;882;61;36;5;31;.861;3600000;0
4541;159705;876;0;0;0;0;.00nan;0;0
4542;20432;893;98;45;2;43;.956;3582000;0
4542;70879;893;0;0;0;0;.00nan;0;0
4542;139467;877;100;24;0;24;1.000;3600000;0
4542;149858;877;0;0;0;0;.00nan;0;0
4543;2195;887;0;0;0;0;.00nan;0;0
4543;74734;887;60;40;5;35;.875;3900000;0
4543;78596;873;0;0;0;0;.00nan;0;0
4543;80834;873;59;44;5;39;.886;3900000;0
4544;3359;878;61;27;3;24;.889;3600000;0
4544;11716;892;73;23;2;21;.913;3600000;0
4544;176963;878;0;0;0;0;.00nan;0;0
4544;46910;892;0;0;0;0;.00nan;0;0
4545;28701;875;53;11;1;10;.909;3600000;0
4545;63551;875;0;0;0;0;.00nan;0;0
4545;75313;881;54;19;2;17;.895;3573000;0
4545;85787;881;0;0;0;0;.00nan;0;0
4546;8101;897;0;0;0;0;.00nan;0;0
4546;67287;872;44;20;3;17;.850;3568000;0
4546;78348;897;100;39;1;38;.974;3600000;0
4546;154414;872;0;0;0;0;.00nan;0;0
4547;20432;893;98;62;4;58;.935;3558000;0
4547;28701;875;86;34;2;32;.941;3600000;0
4547;63551;875;0;0;0;0;.00nan;0;0
4547;70879;893;0;0;0;0;.00nan;0;0
4548;11716;892;52;28;4;24;.857;3600000;0
4548;46910;892;0;0;0;0;.00nan;0;0
4548;78596;873;48;0;0;0;.00nan;190000;0
4548;80834;873;25;26;6;20;.769;3333000;0
4549;67287;872;51;44;6;38;.864;3600000;0
4549;85453;883;0;0;0;0;.00nan;0;0
4549;142911;883;74;33;3;30;.909;3600000;0
4549;154414;872;0;0;0;0;.00nan;0;0
4550;987;886;25;26;6;20;.769;3044000;0
4550;2195;887;0;0;0;0;.00nan;0;0
4550;28833;886;41;4;1;3;.750;556000;0
4550;74734;887;73;19;1;18;.947;3600000;0
4551;64911;882;0;0;0;0;.00nan;0;0
4551;75313;881;0;0;0;0;.00nan;0;0
4551;85787;881;69;30;3;27;.900;3600000;0
4551;91742;882;48;36;5;31;.861;3571000;0
4552;3359;878;61;23;2;21;.913;3600000;0
4552;8101;897;0;0;0;0;.00nan;0;0
4552;176963;878;0;0;0;0;.00nan;0;0
4552;78348;897;58;41;6;35;.854;3600000;0
4553;86394;876;82;44;4;40;.909;3600000;0
4553;139467;877;84;29;1;28;.966;3600000;0
4553;149858;877;0;0;0;0;.00nan;0;0
4553;159705;876;0;0;0;0;.00nan;0;0
4554;987;886;75;39;4;35;.897;3600000;0
4554;28701;875;0;0;0;0;.00nan;0;0
4554;28833;886;0;0;0;0;.00nan;0;0
4554;63551;875;56;19;2;17;.895;3600000;0
4555;11716;892;75;30;3;27;.900;3900000;0
4555;46910;892;0;0;0;0;.00nan;0;0
4555;86394;876;56;32;3;29;.906;3895000;0
4555;159705;876;0;0;0;0;.00nan;0;0
4556;20432;893;81;47;4;43;.915;3600000;0
4556;70879;893;0;0;0;0;.00nan;0;0
4556;78596;873;0;0;0;0;.00nan;0;0
4556;80834;873;68;29;3;26;.897;3600000;0
4557;8101;897;0;0;0;0;.00nan;0;0
4557;64911;882;0;0;0;0;.00nan;0;0
4557;78348;897;99;50;2;48;.960;3600000;0
4557;91742;882;54;32;4;28;.875;3546000;0
4558;3359;878;0;0;0;0;.00nan;0;0
4558;176963;878;78;27;1;26;.963;3600000;0
4558;85453;883;0;0;0;0;.00nan;0;0
4558;142911;883;77;31;2;29;.935;3547000;0
4559;75313;881;0;0;0;0;.00nan;0;0
4559;85787;881;68;36;5;31;.861;3600000;0
4559;139467;877;94;45;2;43;.956;3600000;0
4559;149858;877;0;0;0;0;.00nan;0;0
4560;2195;887;0;0;0;0;.00nan;0;0
4560;67287;872;0;0;0;0;.00nan;0;0
4560;74734;887;65;33;3;30;.909;3600000;0
4560;154414;872;91;18;0;18;1.000;3600000;0
4561;2195;887;0;0;0;0;.00nan;0;0
4561;28701;875;79;39;3;36;.923;3581000;0
4561;63551;875;0;0;0;0;.00nan;0;0
4561;74734;887;80;28;1;27;.964;3600000;0
4562;987;886;79;34;4;30;.882;3900000;0
4562;28833;886;0;0;0;0;.00nan;0;0
4562;75313;881;0;0;0;0;.00nan;0;0
4562;85787;881;43;19;4;15;.789;3900000;0
4563;11716;892;53;20;3;17;.850;3900000;0
4563;46910;892;0;0;0;0;.00nan;0;0
4563;67287;872;0;0;0;0;.00nan;0;0
4563;154414;872;78;30;3;27;.900;3900000;0
4564;64911;882;0;0;0;0;.00nan;0;0
4564;85453;883;0;0;0;0;.00nan;0;0
4564;91742;882;51;24;3;21;.875;3600000;0
4564;142911;883;72;39;4;35;.897;3596000;0
4565;20432;893;89;41;3;38;.927;3600000;0
4565;70879;893;0;0;0;0;.00nan;0;0
4565;86394;876;74;29;2;27;.931;3600000;0
4565;159705;876;0;0;0;0;.00nan;0;0
4566;3359;878;100;35;0;35;1.000;3600000;0
4566;176963;878;0;0;0;0;.00nan;0;0
4566;78596;873;0;0;0;0;.00nan;0;0
4566;80834;873;61;27;3;24;.889;3600000;0
4567;8101;897;71;27;2;25;.926;3900000;0
4567;78348;897;0;0;0;0;.00nan;0;0
4567;139467;877;92;37;2;35;.946;3900000;0
4567;149858;877;0;0;0;0;.00nan;0;0
4573;5559;893;0;0;0;0;.00nan;0;0
4573;11716;893;75;35;3;32;.914;3600000;0
4573;28701;875;0;0;0;0;.00nan;0;0
4573;63551;875;48;21;4;17;.810;3552000;0
4575;164715;886;0;0;0;0;.00nan;0;0
4575;28833;886;78;30;2;28;.933;3564000;0
4575;67287;872;73;25;1;24;.960;3600000;0
4575;154414;872;0;0;0;0;.00nan;0;0
4577;78348;897;87;40;2;38;.950;3600000;0
4577;86394;876;69;29;3;26;.897;3591000;0
4577;146386;897;0;0;0;0;.00nan;0;0
4577;159705;876;0;0;0;0;.00nan;0;0
4581;3077;881;43;5;1;4;.800;1201000;0
4581;3359;878;0;0;0;0;.00nan;0;0
4581;176963;878;64;40;4;36;.900;3600000;0
4581;196090;881;16;21;6;15;.714;2399000;0
4587;5559;893;92;28;1;27;.964;3900000;0
4587;11716;893;0;0;0;0;.00nan;0;0
4587;78596;873;89;37;1;36;.973;3900000;0
4587;80834;873;0;0;0;0;.00nan;0;0
4589;3077;881;79;23;1;22;.957;3600000;0
4589;196090;881;0;0;0;0;.00nan;0;0
4589;78348;897;0;0;0;0;.00nan;0;0
4589;146386;897;70;29;2;27;.931;3582000;0
4593;3359;878;52;26;4;22;.846;3600000;0
4593;176963;878;0;0;0;0;.00nan;0;0
4593;86394;876;0;0;0;0;.00nan;0;0
4593;159705;876;80;34;2;32;.941;3600000;0
4595;164715;886;74;43;4;39;.907;3556000;0
4595;28701;875;68;30;3;27;.900;3600000;0
4595;28833;886;0;0;0;0;.00nan;0;0
4595;63551;875;0;0;0;0;.00nan;0;0
4597;8101;897;0;0;0;0;.00nan;0;0
4597;78348;897;91;42;2;40;.952;3600000;0
4597;78596;873;0;0;0;0;.00nan;0;0
4597;80834;873;39;19;4;15;.789;3584000;0
4605;779;882;78;22;1;21;.955;3600000;0
4605;196005;882;0;0;0;0;.00nan;0;0
4605;86394;876;52;22;3;19;.864;3553000;0
4605;159705;876;0;0;0;0;.00nan;0;0
4607;3077;881;0;0;0;0;.00nan;0;0
4607;5559;893;0;0;0;0;.00nan;0;0
4607;11716;893;51;24;3;21;.875;3667000;0
4607;196090;881;66;37;4;33;.892;3667000;0
4609;164715;886;0;0;0;0;.00nan;0;0
4609;28833;886;81;29;2;27;.931;3600000;0
4609;67287;872;85;43;3;40;.930;3581000;0
4609;154414;872;0;0;0;0;.00nan;0;0
4611;67287;872;57;35;5;30;.857;3600000;0
4611;78596;873;69;32;4;28;.875;3600000;0
4611;80834;873;0;0;0;0;.00nan;0;0
4611;154414;872;0;0;0;0;.00nan;0;0
4615;164715;886;66;37;4;33;.892;3600000;0
4615;28701;875;0;0;0;0;.00nan;0;0
4615;28833;886;0;0;0;0;.00nan;0;0
4615;63551;875;27;24;5;19;.792;3577000;0
4617;779;882;0;0;0;0;.00nan;0;0
4617;8101;897;92;32;1;31;.969;3600000;0
4617;196005;882;100;31;0;31;1.000;3600000;0
4617;78348;897;0;0;0;0;.00nan;0;0
4623;3077;881;77;20;1;19;.950;3600000;0
4623;5559;893;82;30;2;28;.933;3585000;0
4623;11716;893;0;0;0;0;.00nan;0;0
4623;196090;881;0;0;0;0;.00nan;0;0
4631;8101;897;0;0;0;0;.00nan;0;0
4631;67287;872;74;21;1;20;.952;3600000;0
4631;78348;897;27;28;6;22;.786;3600000;0
4631;154414;872;0;0;0;0;.00nan;0;0
4633;779;882;0;0;0;0;.00nan;0;0
4633;196005;882;55;35;4;31;.886;3600000;0
4633;78596;873;0;0;0;0;.00nan;0;0
4633;80834;873;61;25;3;22;.880;3600000;0
4635;5559;893;0;0;0;0;.00nan;0;0
4635;11716;893;88;38;2;36;.947;3600000;0
4635;28701;875;57;26;3;23;.885;3576000;0
4635;63551;875;0;0;0;0;.00nan;0;0
4641;779;882;46;19;4;15;.789;3527000;0
4641;8101;897;71;26;2;24;.923;3600000;0
4641;196005;882;0;0;0;0;.00nan;0;0
4641;78348;897;0;0;0;0;.00nan;0;0
4645;3359;878;0;0;0;0;.00nan;0;0
4645;176963;878;49;21;3;18;.857;3600000;0
4645;86394;876;75;41;4;37;.902;3551000;0
4645;159705;876;0;0;0;0;.00nan;0;0
4649;3077;881;100;30;0;30;1.000;3600000;0
4649;164715;886;0;0;0;0;.00nan;0;0
4649;28833;886;48;24;4;20;.833;3600000;0
4649;196090;881;0;0;0;0;.00nan;0;0
4651;5559;893;95;46;3;43;.935;3583000;0
4651;11716;893;0;0;0;0;.00nan;0;0
4651;67287;872;0;0;0;0;.00nan;0;0
4651;154414;872;62;23;2;21;.913;3600000;0
4653;5559;893;0;0;0;0;.00nan;0;0
4653;8101;897;0;0;0;0;.00nan;0;0
4653;11716;893;55;38;5;33;.868;3542000;0
4653;78348;897;75;38;3;35;.921;3600000;0
4661;779;882;0;0;0;0;.00nan;0;0
4661;196005;882;77;33;2;31;.939;3600000;0
4661;78596;873;56;34;5;29;.853;3600000;0
4661;80834;873;0;0;0;0;.00nan;0;0
4663;67287;872;81;22;1;21;.955;3867000;0
4663;86394;876;90;31;2;29;.935;3867000;0
4663;154414;872;0;0;0;0;.00nan;0;0
4663;159705;876;0;0;0;0;.00nan;0;0
4665;3077;881;80;35;2;33;.943;3900000;0
4665;164715;886;0;0;0;0;.00nan;0;0
4665;28833;886;72;30;2;28;.933;3900000;0
4665;196090;881;0;0;0;0;.00nan;0;0
458;64911;882;0;0;0;0;.00nan;0;0
458;85453;883;0;0;0;0;.00nan;0;0
458;91742;882;73;32;2;30;.938;3600000;0
458;142911;883;66;35;4;31;.886;3585000;0
459;2195;887;55;20;2;18;.900;2430000;0
459;28701;875;0;0;0;0;.00nan;0;0
459;63551;875;71;21;1;20;.952;3600000;0
459;74734;887;18;8;4;4;.500;1170000;0
460;64911;882;61;9;0;9;1.000;745000;0
460;85453;883;0;0;0;0;.00nan;0;0
460;91742;882;25;28;6;22;.786;2855000;0
460;142911;883;16;26;7;19;.731;3549000;0
461;2195;887;0;0;0;0;.00nan;0;0
461;28701;875;0;0;0;0;.00nan;0;0
461;63551;875;64;44;6;38;.864;3600000;0
461;74734;887;14;33;8;25;.758;3600000;0
564;28701;875;0;0;0;0;.00nan;0;0
564;63551;875;95;32;1;31;.969;3600000;0
564;139467;877;59;33;3;30;.909;3577000;0
564;149858;877;0;0;0;0;.00nan;0;0
565;11716;892;67;33;3;30;.909;3600000;0
565;46910;892;0;0;0;0;.00nan;0;0
565;64911;882;0;0;0;0;.00nan;0;0
565;91742;882;84;31;1;30;.968;3600000;0
566;3359;878;100;33;0;33;1.000;3600000;0
566;176963;878;0;0;0;0;.00nan;0;0
566;86394;876;75;30;2;28;.933;3529000;0
566;159705;876;0;0;0;0;.00nan;0;0
567;67287;872;99;34;1;33;.971;3600000;0
567;75313;881;0;0;0;0;.00nan;0;0
567;85787;881;83;32;2;30;.938;3554000;0
567;154414;872;0;0;0;0;.00nan;0;0
568;28701;875;0;0;0;0;.00nan;0;0
568;63551;875;79;37;4;33;.892;3600000;0
568;139467;877;98;25;0;25;1.000;3600000;0
568;149858;877;0;0;0;0;.00nan;0;0
569;11716;892;76;39;4;35;.897;3600000;0
569;46910;892;0;0;0;0;.00nan;0;0
569;64911;882;0;0;0;0;.00nan;0;0
569;91742;882;69;26;2;24;.923;3600000;0
570;3359;878;81;31;2;29;.935;3600000;0
570;176963;878;0;0;0;0;.00nan;0;0
570;86394;876;39;29;5;24;.828;3600000;0
570;159705;876;0;0;0;0;.00nan;0;0
571;67287;872;88;47;4;43;.915;3600000;0
571;75313;881;0;0;0;0;.00nan;0;0
571;85787;881;50;14;2;12;.857;3600000;0
571;154414;872;0;0;0;0;.00nan;0;0
572;28701;875;0;0;0;0;.00nan;0;0
572;63551;875;100;36;0;36;1.000;3600000;0
572;139467;877;61;30;3;27;.900;3600000;0
572;149858;877;0;0;0;0;.00nan;0;0
573;11716;892;18;22;6;16;.727;3567000;0
573;46910;892;0;0;0;0;.00nan;0;0
573;64911;882;0;0;0;0;.00nan;0;0
573;91742;882;49;26;4;22;.846;3600000;0
574;3359;878;64;32;4;28;.875;3600000;0
574;176963;878;0;0;0;0;.00nan;0;0
574;86394;876;89;33;1;32;.970;3600000;0
574;159705;876;0;0;0;0;.00nan;0;0
575;67287;872;55;35;4;31;.886;3571000;0
575;75313;881;0;0;0;0;.00nan;0;0
575;85787;881;74;27;2;25;.926;3600000;0
575;154414;872;0;0;0;0;.00nan;0;0
576;28701;875;0;0;0;0;.00nan;0;0
576;63551;875;73;38;4;34;.895;3540000;0
576;139467;877;92;41;2;39;.951;3600000;0
576;149858;877;0;0;0;0;.00nan;0;0
577;11716;892;76;30;3;27;.900;3600000;0
577;46910;892;0;0;0;0;.00nan;0;0
577;64911;882;97;35;1;34;.971;3137000;0
577;91742;882;28;7;3;4;.571;418000;0
578;3359;878;63;45;5;40;.889;3600000;0
578;176963;878;0;0;0;0;.00nan;0;0
578;86394;876;77;28;2;26;.929;3600000;0
578;159705;876;0;0;0;0;.00nan;0;0
579;67287;872;61;30;4;26;.867;3568000;0
579;75313;881;0;0;0;0;.00nan;0;0
579;85787;881;69;19;2;17;.895;3600000;0
579;154414;872;0;0;0;0;.00nan;0;0
788;28701;875;0;0;0;0;.00nan;0;0
788;63551;875;73;39;4;35;.897;3592000;0
788;139467;877;67;25;3;22;.880;3600000;0
788;149858;877;0;0;0;0;.00nan;0;0
789;11716;892;70;32;3;29;.906;3581000;0
789;46910;892;0;0;0;0;.00nan;0;0
789;64911;882;0;0;0;0;.00nan;0;0
789;91742;882;89;39;2;37;.949;3600000;0
790;3359;878;66;47;6;41;.872;3600000;0
790;176963;878;0;0;0;0;.00nan;0;0
790;86394;876;100;39;0;39;1.000;3600000;0
790;159705;876;0;0;0;0;.00nan;0;0
791;67287;872;94;36;2;34;.944;3752000;0
791;75313;881;0;0;0;0;.00nan;0;0
791;85787;881;86;34;3;31;.912;3752000;0
791;154414;872;0;0;0;0;.00nan;0;0
905;28701;875;0;0;0;0;.00nan;0;0
905;63551;875;89;31;1;30;.968;3600000;0
905;139467;877;73;33;2;31;.939;3565000;0
905;149858;877;0;0;0;0;.00nan;0;0
906;3359;878;42;28;6;22;.786;3600000;0
906;176963;878;0;0;0;0;.00nan;0;0
906;86394;876;100;34;0;34;1.000;3600000;0
906;159705;876;0;0;0;0;.00nan;0;0
907;67287;872;63;32;3;29;.906;3517000;0
907;75313;881;0;0;0;0;.00nan;0;0
907;85787;881;81;25;1;24;.960;3600000;0
907;154414;872;0;0;0;0;.00nan;0;0
939;28701;875;0;0;0;0;.00nan;0;0
939;63551;875;48;27;3;24;.889;4742000;0
939;139467;877;66;37;4;33;.892;4712000;0
939;149858;877;0;0;0;0;.00nan;0;0
945;28701;875;0;0;0;0;.00nan;0;0
945;63551;875;37;34;6;28;.824;3600000;0
945;86394;876;79;27;1;26;.963;3600000;0
945;159705;876;0;0;0;0;.00nan;0;0
946;64911;882;0;0;0;0;.00nan;0;0
946;75313;881;0;0;0;0;.00nan;0;0
946;85787;881;76;24;2;22;.917;3589000;0
946;91742;882;100;30;0;30;1.000;3600000;0
947;28701;875;0;0;0;0;.00nan;0;0
947;63551;875;97;35;1;34;.971;3600000;0
947;86394;876;63;24;3;21;.875;3600000;0
947;159705;876;0;0;0;0;.00nan;0;0
948;64911;882;0;0;0;0;.00nan;0;0
948;75313;881;0;0;0;0;.00nan;0;0
948;85787;881;56;34;4;30;.882;3600000;0
948;91742;882;90;33;1;32;.970;3600000;0
949;28701;875;0;0;0;0;.00nan;0;0
949;63551;875;79;35;2;33;.943;3886000;0
949;86394;876;84;44;3;41;.932;3931000;0
949;159705;876;0;0;0;0;.00nan;0;0
950;64911;882;0;0;0;0;.00nan;0;0
950;75313;881;0;0;0;0;.00nan;0;0
950;85787;881;81;42;4;38;.905;3600000;0
950;91742;882;85;16;0;16;1.000;3600000;0
951;28701;875;0;0;0;0;.00nan;0;0
951;63551;875;100;33;0;33;1.000;3600000;0
951;86394;876;73;35;3;32;.914;3600000;0
951;159705;876;0;0;0;0;.00nan;0;0
952;64911;882;0;0;0;0;.00nan;0;0
952;75313;881;0;0;0;0;.00nan;0;0
952;85787;881;88;47;3;44;.936;4385000;0
952;91742;882;67;40;4;36;.900;4385000;0
1110;28701;875;0;0;0;0;.00nan;0;0
1110;63551;875;43;36;6;30;.833;3576000;0
1110;86394;876;76;38;4;34;.895;3600000;0
1110;159705;876;0;0;0;0;.00nan;0;0
1111;64911;882;0;0;0;0;.00nan;0;0
1111;75313;881;0;0;0;0;.00nan;0;0
1111;85787;881;65;26;2;24;.923;3813000;0
1111;91742;882;60;25;3;22;.880;3813000;0
1187;28701;875;0;0;0;0;.00nan;0;0
1187;63551;875;71;35;3;32;.914;3967000;0
1187;86394;876;87;32;2;30;.938;3967000;0
1187;159705;876;0;0;0;0;.00nan;0;0
1188;64911;882;0;0;0;0;.00nan;0;0
1188;75313;881;0;0;0;0;.00nan;0;0
1188;85787;881;49;27;4;23;.852;3600000;0
1188;91742;882;100;31;0;31;1.000;3600000;0
1239;28701;875;76;32;2;30;.938;3189000;0
1239;63551;875;33;11;3;8;.727;411000;0
1239;86394;876;61;21;2;19;.905;3600000;0
1239;159705;876;0;0;0;0;.00nan;0;0
1243;64911;882;0;0;0;0;.00nan;0;0
1243;86394;876;60;26;3;23;.885;3543000;0
1243;91742;882;73;26;2;24;.923;3600000;0
1243;159705;876;0;0;0;0;.00nan;0;0
1244;64911;882;0;0;0;0;.00nan;0;0
1244;86394;876;93;34;2;32;.941;3600000;0
1244;91742;882;62;30;3;27;.900;3576000;0
1244;159705;876;0;0;0;0;.00nan;0;0
1245;64911;882;0;0;0;0;.00nan;0;0
1245;86394;876;61;23;2;21;.913;3588000;0
1245;91742;882;91;32;1;31;.969;3600000;0
1245;159705;876;0;0;0;0;.00nan;0;0
4666;6948;524;0;0;0;0;.00nan;0;0
4666;143063;524;82;32;2;30;.938;3600000;0
4666;143330;519;76;48;5;43;.896;3600000;0
4666;143421;519;0;0;0;0;.00nan;0;0
4667;167036;515;92;36;1;35;.972;3600000;0
4667;7332;1472;0;0;0;0;.00nan;0;0
4667;68565;515;0;0;0;0;.00nan;0;0
4667;86228;1472;68;27;2;25;.926;3550000;0
4668;6944;520;33;32;6;26;.813;2922000;0
4668;143083;512;80;26;1;25;.962;3600000;0
4668;152202;512;0;0;0;0;.00nan;0;0
4668;155474;520;56;6;0;6;1.000;678000;0
4669;7487;513;0;0;0;0;.00nan;0;0
4669;16587;513;90;31;1;30;.968;3600000;0
4669;55495;516;0;0;0;0;.00nan;0;0
4669;143036;516;54;37;4;33;.892;3600000;0
4670;7534;1481;77;40;4;36;.900;3798000;0
4670;67764;1481;0;0;0;0;.00nan;0;0
4670;68425;1876;0;0;0;0;.00nan;0;0
4670;152478;1876;53;20;3;17;.850;3798000;0
4671;6947;1872;0;0;0;0;.00nan;0;0
4671;174581;518;100;39;1;38;.974;3600000;0
4671;64271;518;0;0;0;0;.00nan;0;0
4671;76951;1872;62;29;3;26;.897;3513000;0
4672;63107;514;69;40;5;35;.875;3600000;0
4672;64230;511;0;0;0;0;.00nan;0;0
4672;80859;511;76;27;2;25;.926;3600000;0
4672;159851;514;0;0;0;0;.00nan;0;0
4673;174581;518;0;0;0;0;.00nan;0;0
4673;38124;512;64;36;4;32;.889;3900000;0
4673;64271;518;67;32;4;28;.875;3900000;0
4673;143083;512;0;0;0;0;.00nan;0;0
4674;44200;519;0;0;0;0;.00nan;0;0
4674;64230;511;0;0;0;0;.00nan;0;0
4674;80859;511;96;25;0;25;1.000;3600000;0
4674;143330;519;54;34;4;30;.882;3600000;0
4675;6944;520;23;27;6;21;.778;3291000;0
4675;55495;516;0;0;0;0;.00nan;0;0
4675;143036;516;63;25;3;22;.880;3600000;0
4675;155474;520;50;2;0;2;1.000;309000;0
4676;2410;513;86;34;2;32;.941;3697000;0
4676;7534;1481;82;41;3;38;.927;3697000;0
4676;16587;513;0;0;0;0;.00nan;0;0
4676;67764;1481;0;0;0;0;.00nan;0;0
4677;167036;515;84;48;3;45;.938;3892000;0
4677;63107;514;0;0;0;0;.00nan;0;0
4677;68565;515;0;0;0;0;.00nan;0;0
4677;75362;514;88;31;2;29;.935;3892000;0
4678;6948;524;0;0;0;0;.00nan;0;0
4678;7332;1472;0;0;0;0;.00nan;0;0
4678;86228;1472;72;21;1;20;.952;3600000;0
4678;91403;524;89;39;2;37;.949;3564000;0
4679;6947;1872;72;38;3;35;.921;3600000;0
4679;68425;1876;59;6;0;6;1.000;869000;0
4679;76951;1872;0;0;0;0;.00nan;0;0
4679;152478;1876;44;33;6;27;.818;2731000;0
4680;6947;1872;82;41;2;39;.951;3900000;0
4680;55495;516;0;0;0;0;.00nan;0;0
4680;76951;1872;0;0;0;0;.00nan;0;0
4680;143036;516;81;31;2;29;.935;3900000;0
4681;2410;513;79;29;2;27;.931;3600000;0
4681;16587;513;0;0;0;0;.00nan;0;0
4681;44200;519;0;0;0;0;.00nan;0;0
4681;143330;519;62;25;3;22;.880;3600000;0
4682;7332;1472;0;0;0;0;.00nan;0;0
4682;68425;1876;0;0;0;0;.00nan;0;0
4682;86228;1472;64;41;4;37;.902;3590000;0
4682;152478;1876;44;17;3;14;.824;3600000;0
4683;167036;515;69;35;4;31;.886;3600000;0
4683;6948;524;0;0;0;0;.00nan;0;0
4683;68565;515;0;0;0;0;.00nan;0;0
4683;91403;524;100;51;0;51;1.000;3600000;0
4684;38124;512;100;30;0;30;1.000;3600000;0
4684;64230;511;0;0;0;0;.00nan;0;0
4684;80859;511;58;38;5;33;.868;3600000;0
4684;143083;512;0;0;0;0;.00nan;0;0
4685;7534;1481;65;46;5;41;.891;3600000;0
4685;174581;518;83;26;1;25;.962;3600000;0
4685;64271;518;0;0;0;0;.00nan;0;0
4685;67764;1481;0;0;0;0;.00nan;0;0
4686;6944;520;52;37;5;32;.865;3600000;0
4686;63107;514;0;0;0;0;.00nan;0;0
4686;75362;514;73;16;1;15;.938;3600000;0
4686;155474;520;0;0;0;0;.00nan;0;0
4687;6948;524;0;0;0;0;.00nan;0;0
4687;174581;518;68;36;3;33;.917;3600000;0
4687;64271;518;0;0;0;0;.00nan;0;0
4687;91403;524;51;33;4;29;.879;3565000;0
4688;7534;1481;80;53;5;48;.906;3600000;0
4688;64230;511;0;0;0;0;.00nan;0;0
4688;67764;1481;0;0;0;0;.00nan;0;0
4688;80859;511;59;17;2;15;.882;3600000;0
4689;6944;520;0;0;0;0;.00nan;0;0
4689;6947;1872;100;25;0;25;1.000;3600000;0
4689;76951;1872;0;0;0;0;.00nan;0;0
4689;155474;520;78;28;1;27;.964;3579000;0
4690;2410;513;56;14;2;12;.857;3600000;0
4690;7332;1472;0;0;0;0;.00nan;0;0
4690;16587;513;0;0;0;0;.00nan;0;0
4690;86228;1472;80;46;3;43;.935;3600000;0
4691;167036;515;0;0;0;0;.00nan;0;0
4691;44200;519;0;0;0;0;.00nan;0;0
4691;68565;515;90;40;2;38;.950;3626000;0
4691;143330;519;79;35;3;32;.914;3626000;0
4692;38124;512;93;43;2;41;.953;3900000;0
4692;55495;516;0;0;0;0;.00nan;0;0
4692;143036;516;61;20;2;18;.900;3900000;0
4692;143083;512;0;0;0;0;.00nan;0;0
4693;63107;514;0;0;0;0;.00nan;0;0
4693;68425;1876;0;0;0;0;.00nan;0;0
4693;75362;514;74;17;1;16;.941;3900000;0
4693;152478;1876;96;37;1;36;.973;3900000;0
4694;174581;518;67;40;5;35;.875;3600000;0
4694;44200;519;76;26;2;24;.923;3600000;0
4694;64271;518;0;0;0;0;.00nan;0;0
4694;143330;519;0;0;0;0;.00nan;0;0
4695;6944;520;0;0;0;0;.00nan;0;0
4695;7332;1472;0;0;0;0;.00nan;0;0
4695;86228;1472;73;31;3;28;.903;3600000;0
4695;155474;520;60;30;4;26;.867;3588000;0
4696;167036;515;94;49;3;46;.939;3790000;0
4696;64230;511;0;0;0;0;.00nan;0;0
4696;68565;515;0;0;0;0;.00nan;0;0
4696;80859;511;71;25;2;23;.920;3790000;0
4697;2410;513;74;38;3;35;.921;3515000;0
4697;6948;524;0;0;0;0;.00nan;0;0
4697;16587;513;0;0;0;0;.00nan;0;0
4697;91403;524;92;27;1;26;.963;3600000;0
4698;38124;512;66;23;2;21;.913;3600000;0
4698;68425;1876;0;0;0;0;.00nan;0;0
4698;143083;512;0;0;0;0;.00nan;0;0
4698;152478;1876;51;28;4;24;.857;3560000;0
4699;6947;1872;74;31;3;28;.903;3849000;0
4699;7534;1481;86;39;4;35;.897;3849000;0
4699;67764;1481;0;0;0;0;.00nan;0;0
4699;76951;1872;0;0;0;0;.00nan;0;0
4700;55495;516;67;25;2;23;.920;2641000;0
4700;63107;514;80;35;3;32;.914;3600000;0
4700;75362;514;0;0;0;0;.00nan;0;0
4700;143036;516;28;14;4;10;.714;959000;0
4701;174581;518;99;45;2;43;.956;3600000;0
4701;63107;514;0;0;0;0;.00nan;0;0
4701;64271;518;0;0;0;0;.00nan;0;0
4701;75362;514;64;28;3;25;.893;3573000;0
4702;7332;1472;0;0;0;0;.00nan;0;0
4702;64230;511;0;0;0;0;.00nan;0;0
4702;80859;511;76;22;1;21;.955;3600000;0
4702;86228;1472;79;49;5;44;.898;3600000;0
4703;6944;520;13;21;6;15;.714;1978000;0
4703;44200;519;0;0;0;0;.00nan;0;0
4703;143330;519;40;18;4;14;.778;3600000;0
4703;155474;520;44;12;2;10;.833;1622000;0
4704;2410;513;0;0;0;0;.00nan;0;0
4704;167036;515;71;25;1;24;.960;3600000;0
4704;16587;513;78;34;3;31;.912;3561000;0
4704;68565;515;0;0;0;0;.00nan;0;0
4705;7534;1481;60;40;5;35;.875;3600000;0
4705;55495;516;57;13;1;12;.923;3600000;0
4705;67764;1481;0;0;0;0;.00nan;0;0
4705;143036;516;0;0;0;0;.00nan;0;0
4706;6947;1872;65;39;4;35;.897;3585000;0
4706;38124;512;74;27;2;25;.926;3600000;0
4706;76951;1872;0;0;0;0;.00nan;0;0
4706;143083;512;0;0;0;0;.00nan;0;0
4707;6948;524;0;0;0;0;.00nan;0;0
4707;68425;1876;0;0;0;0;.00nan;0;0
4707;91403;524;87;37;1;36;.973;3900000;0
4707;152478;1876;100;42;1;41;.976;3900000;0
4708;7332;1472;0;0;0;0;.00nan;0;0
4708;55495;516;0;0;0;0;.00nan;0;0
4708;86228;1472;83;44;5;39;.886;3600000;0
4708;143036;516;97;19;0;19;1.000;3600000;0
4709;2410;513;94;25;0;25;1.000;3600000;0
4709;16587;513;0;0;0;0;.00nan;0;0
4709;68425;1876;0;0;0;0;.00nan;0;0
4709;152478;1876;97;42;1;41;.976;3600000;0
4710;167036;515;81;39;4;35;.897;3600000;0
4710;174581;518;32;23;5;18;.783;2329000;0
4710;64271;518;72;12;0;12;1.000;1216000;0
4710;68565;515;0;0;0;0;.00nan;0;0
4711;6948;524;0;0;0;0;.00nan;0;0
4711;64230;511;0;0;0;0;.00nan;0;0
4711;80859;511;60;27;3;24;.889;3600000;0
4711;91403;524;81;39;2;37;.949;3600000;0
4712;6944;520;89;27;1;26;.963;3600000;0
4712;7534;1481;86;39;3;36;.923;3578000;0
4712;67764;1481;0;0;0;0;.00nan;0;0
4712;155474;520;0;0;0;0;.00nan;0;0
4713;6947;1872;63;20;2;18;.900;3600000;0
4713;44200;519;0;0;0;0;.00nan;0;0
4713;76951;1872;0;0;0;0;.00nan;0;0
4713;143330;519;66;34;3;31;.912;3556000;0
4714;38124;512;85;26;1;25;.962;3612000;0
4714;63107;514;0;0;0;0;.00nan;0;0
4714;75362;514;100;38;0;38;1.000;3612000;0
4714;143083;512;0;0;0;0;.00nan;0;0
4715;7332;1472;0;0;0;0;.00nan;0;0
4715;174581;518;78;27;2;25;.926;3900000;0
4715;64271;518;0;0;0;0;.00nan;0;0
4715;86228;1472;70;27;2;25;.926;3900000;0
4716;2410;513;52;36;5;31;.861;3600000;0
4716;16587;513;0;0;0;0;.00nan;0;0
4716;64230;511;54;22;3;19;.864;3600000;0
4716;80859;511;0;0;0;0;.00nan;0;0
4717;6944;520;0;0;0;0;.00nan;0;0
4717;6948;524;0;0;0;0;.00nan;0;0
4717;91403;524;95;23;0;23;1.000;3600000;0
4717;155474;520;47;26;4;22;.846;3600000;0
4718;7534;1481;81;39;3;36;.923;3600000;0
4718;38124;512;81;14;0;14;1.000;3600000;0
4718;67764;1481;0;0;0;0;.00nan;0;0
4718;143083;512;0;0;0;0;.00nan;0;0
4719;44200;519;0;0;0;0;.00nan;0;0
4719;55495;516;0;0;0;0;.00nan;0;0
4719;143036;516;86;42;2;40;.952;3699000;0
4719;143330;519;91;29;1;28;.966;3699000;0
4720;6947;1872;0;0;0;0;.00nan;0;0
4720;63107;514;0;0;0;0;.00nan;0;0
4720;75362;514;78;37;3;34;.919;3550000;0
4720;76951;1872;76;27;2;25;.926;3600000;0
4721;167036;515;0;0;0;0;.00nan;0;0
4721;68425;1876;0;0;0;0;.00nan;0;0
4721;68565;515;68;25;2;23;.920;3900000;0
4721;152478;1876;93;39;2;37;.949;3900000;0
4722;38124;512;36;26;5;21;.808;3564000;0
4722;44200;519;0;0;0;0;.00nan;0;0
4722;143083;512;0;0;0;0;.00nan;0;0
4722;143330;519;64;35;3;32;.914;3600000;0
4723;6947;1872;26;22;5;17;.773;3600000;0
4723;7332;1472;81;36;2;34;.944;3600000;0
4723;76951;1872;0;0;0;0;.00nan;0;0
4723;86228;1472;0;0;0;0;.00nan;0;0
4724;2410;513;100;33;0;33;1.000;3600000;0
4724;16587;513;0;0;0;0;.00nan;0;0
4724;174581;518;74;33;3;30;.909;3600000;0
4724;64271;518;0;0;0;0;.00nan;0;0
4725;167036;515;79;24;1;23;.958;3600000;0
4725;6944;520;41;42;6;36;.857;3600000;0
4725;68565;515;0;0;0;0;.00nan;0;0
4725;155474;520;0;0;0;0;.00nan;0;0
4726;6948;524;0;0;0;0;.00nan;0;0
4726;55495;516;0;0;0;0;.00nan;0;0
4726;91403;524;71;34;4;30;.882;3566000;0
4726;143036;516;64;21;2;19;.905;3600000;0
4727;7534;1481;71;24;1;23;.958;3600000;0
4727;67764;1481;0;0;0;0;.00nan;0;0
4727;75362;514;100;27;0;27;1.000;3600000;0
4727;159851;514;0;0;0;0;.00nan;0;0
4728;64230;511;0;0;0;0;.00nan;0;0
4728;68425;1876;0;0;0;0;.00nan;0;0
4728;80859;511;60;14;1;13;.929;3600000;0
4728;152478;1876;65;42;5;37;.881;3600000;0
4729;174581;518;28;7;3;4;.571;357000;0
4729;64230;511;0;0;0;0;.00nan;0;0
4729;64271;518;94;44;4;40;.909;3243000;0
4729;80859;511;100;19;0;19;1.000;3600000;0
4730;6944;520;59;20;2;18;.900;3600000;0
4730;68425;1876;0;0;0;0;.00nan;0;0
4730;152478;1876;81;41;3;38;.927;3600000;0
4730;155474;520;0;0;0;0;.00nan;0;0
4731;2410;513;67;20;2;18;.900;3600000;0
4731;6947;1872;69;39;5;34;.872;3600000;0
4731;16587;513;0;0;0;0;.00nan;0;0
4731;76951;1872;0;0;0;0;.00nan;0;0
4732;6948;524;0;0;0;0;.00nan;0;0
4732;38124;512;77;27;2;25;.926;3600000;0
4732;91403;524;74;39;3;36;.923;3554000;0
4732;143083;512;0;0;0;0;.00nan;0;0
4733;167036;515;74;45;4;41;.911;3900000;0
4733;55495;516;0;0;0;0;.00nan;0;0
4733;68565;515;0;0;0;0;.00nan;0;0
4733;143036;516;56;28;4;24;.857;3900000;0
4734;7534;1481;96;43;1;42;.977;3600000;0
4734;44200;519;0;0;0;0;.00nan;0;0
4734;67764;1481;0;0;0;0;.00nan;0;0
4734;143330;519;38;20;3;17;.850;3513000;0
4735;7332;1472;0;0;0;0;.00nan;0;0
4735;75362;514;73;22;1;21;.955;3600000;0
4735;86228;1472;84;49;4;45;.918;3600000;0
4735;159851;514;0;0;0;0;.00nan;0;0
4736;55495;516;0;0;0;0;.00nan;0;0
4736;64230;511;0;0;0;0;.00nan;0;0
4736;80859;511;69;21;2;19;.905;3600000;0
4736;143036;516;73;49;5;44;.898;3600000;0
4737;44200;519;0;0;0;0;.00nan;0;0
4737;75362;514;95;20;0;20;1.000;3600000;0
4737;143330;519;91;38;1;37;.974;3554000;0
4737;159851;514;0;0;0;0;.00nan;0;0
4738;7332;1472;0;0;0;0;.00nan;0;0
4738;38124;512;49;27;4;23;.852;3543000;0
4738;86228;1472;75;36;3;33;.917;3600000;0
4738;143083;512;0;0;0;0;.00nan;0;0
4739;2410;513;91;43;2;41;.953;3600000;0
4739;6944;520;77;39;4;35;.897;3600000;0
4739;16587;513;0;0;0;0;.00nan;0;0
4739;155474;520;0;0;0;0;.00nan;0;0
4740;167036;515;86;25;1;24;.960;3600000;0
4740;7534;1481;55;37;5;32;.865;3600000;0
4740;67764;1481;0;0;0;0;.00nan;0;0
4740;68565;515;0;0;0;0;.00nan;0;0
4741;6947;1872;52;26;3;23;.885;3534000;0
4741;6948;524;0;0;0;0;.00nan;0;0
4741;76951;1872;0;0;0;0;.00nan;0;0
4741;91403;524;99;36;1;35;.972;3600000;0
4742;174581;518;91;26;1;25;.962;3600000;0
4742;64271;518;0;0;0;0;.00nan;0;0
4742;68425;1876;0;0;0;0;.00nan;0;0
4742;152478;1876;72;36;3;33;.917;3600000;0
4743;6944;520;87;44;4;40;.909;3600000;0
4743;174581;518;49;40;6;34;.850;3566000;0
4743;64271;518;0;0;0;0;.00nan;0;0
4743;155474;520;0;0;0;0;.00nan;0;0
4744;7332;1472;0;0;0;0;.00nan;0;0
4744;44200;519;0;0;0;0;.00nan;0;0
4744;86228;1472;61;25;2;23;.920;3572000;0
4744;143330;519;92;25;1;24;.960;3600000;0
4745;167036;515;0;0;0;0;.00nan;0;0
4745;38124;512;82;24;1;23;.958;3600000;0
4745;43896;515;96;49;3;46;.939;3540000;0
4745;143083;512;0;0;0;0;.00nan;0;0
4746;68425;1876;0;0;0;0;.00nan;0;0
4746;84990;516;0;0;0;0;.00nan;0;0
4746;143036;516;67;21;2;19;.905;3900000;0
4746;152478;1876;96;46;2;44;.957;3900000;0
4747;7534;1481;51;28;4;24;.857;3543000;0
4747;67764;1481;0;0;0;0;.00nan;0;0
4747;86347;524;0;0;0;0;.00nan;0;0
4747;91403;524;51;23;3;20;.870;3600000;0
4748;6947;1872;71;41;4;37;.902;3898000;0
4748;64230;511;76;27;2;25;.926;3492000;0
4748;76951;1872;0;0;0;0;.00nan;0;0
4748;80859;511;31;8;3;5;.625;406000;0
4749;2410;513;89;50;4;46;.920;3558000;0
4749;59614;513;0;0;0;0;.00nan;0;0
4749;75362;514;79;23;2;21;.913;3600000;0
4749;159851;514;0;0;0;0;.00nan;0;0
4750;174581;518;61;45;5;40;.889;3600000;0
4750;64271;518;0;0;0;0;.00nan;0;0
4750;84990;516;0;0;0;0;.00nan;0;0
4750;143036;516;92;26;1;25;.962;3600000;0
4751;6944;520;87;65;5;60;.923;3900000;0
4751;64230;511;0;0;0;0;.00nan;0;0
4751;80859;511;48;23;4;19;.826;3900000;0
4751;155474;520;0;0;0;0;.00nan;0;0
4752;7332;1472;81;41;2;39;.951;3600000;0
4752;7534;1481;42;36;6;30;.833;2805000;0
4752;67764;1481;56;8;1;7;.875;795000;0
4752;86228;1472;0;0;0;0;.00nan;0;0
4753;2410;513;57;25;3;22;.880;3594000;0
4753;38124;512;93;32;1;31;.969;3600000;0
4753;59614;513;0;0;0;0;.00nan;0;0
4753;143083;512;0;0;0;0;.00nan;0;0
4754;75362;514;64;20;2;18;.900;3590000;0
4754;86347;524;0;0;0;0;.00nan;0;0
4754;91403;524;83;33;1;32;.970;3600000;0
4754;159851;514;0;0;0;0;.00nan;0;0
4755;167036;515;0;0;0;0;.00nan;0;0
4755;6947;1872;0;0;0;0;.00nan;0;0
4755;43896;515;83;35;3;32;.914;3567000;0
4755;76951;1872;100;47;1;46;.979;3600000;0
4756;44200;519;0;0;0;0;.00nan;0;0
4756;68425;1876;0;0;0;0;.00nan;0;0
4756;143330;519;84;21;1;20;.952;3600000;0
4756;152478;1876;69;37;4;33;.892;3600000;0
4757;6947;1872;0;0;0;0;.00nan;0;0
4757;174581;518;35;37;7;30;.811;3332000;0
4757;64271;518;48;0;0;0;.00nan;268000;0
4757;76951;1872;81;36;2;34;.944;3600000;0
4758;64230;511;56;26;3;23;.885;3867000;0
4758;75362;514;83;43;4;39;.907;3867000;0
4758;80859;511;0;0;0;0;.00nan;0;0
4758;159851;514;0;0;0;0;.00nan;0;0
4759;6944;520;0;0;0;0;.00nan;0;0
4759;38124;512;68;40;3;37;.925;3852000;0
4759;143083;512;0;0;0;0;.00nan;0;0
4759;155474;520;72;35;2;33;.943;3852000;0
4760;2410;513;73;25;1;24;.960;3600000;0
4760;59614;513;0;0;0;0;.00nan;0;0
4760;84990;516;0;0;0;0;.00nan;0;0
4760;143036;516;64;21;2;19;.905;3600000;0
4761;167036;515;0;0;0;0;.00nan;0;0
4761;7332;1472;0;0;0;0;.00nan;0;0
4761;43896;515;67;21;2;19;.905;3600000;0
4761;86228;1472;69;31;3;28;.903;3580000;0
4762;44200;519;0;0;0;0;.00nan;0;0
4762;86347;524;0;0;0;0;.00nan;0;0
4762;91403;524;86;37;2;35;.946;3900000;0
4762;143330;519;88;35;2;33;.943;3900000;0
4763;7534;1481;81;25;1;24;.960;3600000;0
4763;67764;1481;0;0;0;0;.00nan;0;0
4763;68425;1876;0;0;0;0;.00nan;0;0
4763;152478;1876;49;25;3;22;.880;3537000;0
4764;44200;519;0;0;0;0;.00nan;0;0
4764;64230;511;0;0;0;0;.00nan;0;0
4764;80859;511;100;19;0;19;1.000;3600000;0
4764;143330;519;89;46;1;45;.978;3546000;0
4765;7332;1472;0;0;0;0;.00nan;0;0
4765;86228;1472;55;31;4;27;.871;3521000;0
4765;86347;524;0;0;0;0;.00nan;0;0
4765;91403;524;81;28;2;26;.929;3600000;0
4766;174581;518;71;38;4;34;.895;3545000;0
4766;38124;512;71;33;3;30;.909;3600000;0
4766;64271;518;0;0;0;0;.00nan;0;0
4766;143083;512;0;0;0;0;.00nan;0;0
4767;6944;520;78;44;4;40;.909;3578000;0
4767;84990;516;0;0;0;0;.00nan;0;0
4767;143036;516;76;30;2;28;.933;3600000;0
4767;155474;520;0;0;0;0;.00nan;0;0
4768;2410;513;57;19;2;17;.895;3622000;0
4768;7534;1481;92;28;1;27;.964;3622000;0
4768;59614;513;0;0;0;0;.00nan;0;0
4768;67764;1481;0;0;0;0;.00nan;0;0
4769;6947;1872;0;0;0;0;.00nan;0;0
4769;68425;1876;0;0;0;0;.00nan;0;0
4769;76951;1872;83;40;4;36;.900;3600000;0
4769;152478;1876;54;33;5;28;.848;3543000;0
4770;167036;515;0;0;0;0;.00nan;0;0
4770;43896;515;97;37;1;36;.973;3900000;0
4770;75362;514;0;0;0;0;.00nan;0;0
4770;159851;514;81;26;1;25;.962;3900000;0
4771;7534;1481;84;34;2;32;.941;3600000;0
4771;174581;518;96;36;1;35;.972;3600000;0
4771;64271;518;0;0;0;0;.00nan;0;0
4771;67764;1481;0;0;0;0;.00nan;0;0
4772;6944;520;75;39;5;34;.872;3600000;0
4772;75362;514;87;35;2;33;.943;3600000;0
4772;155474;520;0;0;0;0;.00nan;0;0
4772;159851;514;0;0;0;0;.00nan;0;0
4773;2410;513;0;0;0;0;.00nan;0;0
4773;44200;519;0;0;0;0;.00nan;0;0
4773;59614;513;27;26;6;20;.769;3600000;0
4773;143330;519;92;28;1;27;.964;3600000;0
4774;167036;515;0;0;0;0;.00nan;0;0
4774;43896;515;84;32;1;31;.969;3600000;0
4774;86347;524;0;0;0;0;.00nan;0;0
4774;91403;524;86;42;4;38;.905;3600000;0
4775;6947;1872;0;0;0;0;.00nan;0;0
4775;76951;1872;100;40;0;40;1.000;3600000;0
4775;84990;516;0;0;0;0;.00nan;0;0
4775;143036;516;49;19;3;16;.842;3600000;0
4776;7332;1472;0;0;0;0;.00nan;0;0
4776;68425;1876;0;0;0;0;.00nan;0;0
4776;86228;1472;100;30;0;30;1.000;3600000;0
4776;152478;1876;94;45;2;43;.956;3571000;0
4777;38124;512;89;47;3;44;.936;3589000;0
4777;64230;511;0;0;0;0;.00nan;0;0
4777;80859;511;93;26;1;25;.962;3600000;0
4777;143083;512;0;0;0;0;.00nan;0;0
4778;167036;515;0;0;0;0;.00nan;0;0
4778;43896;515;96;36;1;35;.972;3600000;0
4778;44200;519;66;25;2;23;.920;3544000;0
4778;143330;519;0;0;0;0;.00nan;0;0
4779;2410;513;63;39;4;35;.897;3600000;0
4779;7332;1472;0;0;0;0;.00nan;0;0
4779;59614;513;0;0;0;0;.00nan;0;0
4779;86228;1472;48;20;3;17;.850;3600000;0
4780;174581;518;56;33;4;29;.879;3600000;0
4780;64271;518;0;0;0;0;.00nan;0;0
4780;86347;524;0;0;0;0;.00nan;0;0
4780;91403;524;100;43;0;43;1.000;3600000;0
4781;38124;512;0;0;0;0;.00nan;0;0
4781;84990;516;0;0;0;0;.00nan;0;0
4781;143036;516;86;43;3;40;.930;3600000;0
4781;143083;512;61;34;4;30;.882;3593000;0
4782;7534;1481;0;0;0;0;.00nan;0;0
4782;64230;511;0;0;0;0;.00nan;0;0
4782;67764;1481;76;50;4;46;.920;3600000;0
4782;80859;511;76;19;1;18;.947;3600000;0
4783;6944;520;78;31;2;29;.935;3900000;0
4783;6947;1872;0;0;0;0;.00nan;0;0
4783;76951;1872;91;35;2;33;.943;3900000;0
4783;155474;520;0;0;0;0;.00nan;0;0
4784;68425;1876;0;0;0;0;.00nan;0;0
4784;75362;514;68;23;2;21;.913;3571000;0
4784;152478;1876;87;28;1;27;.964;3600000;0
4784;159851;514;0;0;0;0;.00nan;0;0
4785;174581;518;83;36;3;33;.917;3600000;0
4785;44200;519;0;0;0;0;.00nan;0;0
4785;64271;518;0;0;0;0;.00nan;0;0
4785;143330;519;39;26;5;21;.808;3537000;0
4786;167036;515;0;0;0;0;.00nan;0;0
4786;43896;515;42;31;6;25;.806;3600000;0
4786;64230;511;0;0;0;0;.00nan;0;0
4786;80859;511;56;26;3;23;.885;3600000;0
4787;6944;520;0;0;0;0;.00nan;0;0
4787;7332;1472;0;0;0;0;.00nan;0;0
4787;86228;1472;66;17;1;16;.941;3600000;0
4787;155474;520;82;40;3;37;.925;3583000;0
4788;2410;513;82;27;2;25;.926;3600000;0
4788;59614;513;0;0;0;0;.00nan;0;0
4788;86347;524;0;0;0;0;.00nan;0;0
4788;91403;524;60;33;4;29;.879;3586000;0
4789;75362;514;74;32;3;29;.906;3572000;0
4789;84990;516;0;0;0;0;.00nan;0;0
4789;143036;516;72;26;2;24;.923;3600000;0
4789;159851;514;0;0;0;0;.00nan;0;0
4790;6947;1872;0;0;0;0;.00nan;0;0
4790;7534;1481;57;40;6;34;.850;3600000;0
4790;67764;1481;0;0;0;0;.00nan;0;0
4790;76951;1872;100;23;0;23;1.000;3600000;0
4791;38124;512;67;25;2;23;.920;3600000;0
4791;68425;1876;32;23;4;19;.826;3595000;0
4791;143083;512;0;0;0;0;.00nan;0;0
4791;152478;1876;0;0;0;0;.00nan;0;0
4792;6944;520;63;35;4;31;.886;3600000;0
4792;44200;519;0;0;0;0;.00nan;0;0
4792;143330;519;100;28;0;28;1.000;3600000;0
4792;155474;520;0;0;0;0;.00nan;0;0
4793;7332;1472;0;0;0;0;.00nan;0;0
4793;64230;511;0;0;0;0;.00nan;0;0
4793;80859;511;42;18;3;15;.833;3600000;0
4793;86228;1472;97;34;1;33;.971;3600000;0
4794;2410;513;100;30;0;30;1.000;3600000;0
4794;167036;515;0;0;0;0;.00nan;0;0
4794;43896;515;88;34;1;33;.971;3583000;0
4794;59614;513;0;0;0;0;.00nan;0;0
4795;68425;1876;0;0;0;0;.00nan;0;0
4795;86347;524;0;0;0;0;.00nan;0;0
4795;91403;524;76;32;2;30;.938;3600000;0
4795;152478;1876;76;35;3;32;.914;3553000;0
4796;6947;1872;0;0;0;0;.00nan;0;0
4796;38124;512;71;28;3;25;.893;3600000;0
4796;76951;1872;45;33;5;28;.848;3600000;0
4796;143083;512;0;0;0;0;.00nan;0;0
4797;7534;1481;81;35;2;33;.943;3572000;0
4797;67764;1481;0;0;0;0;.00nan;0;0
4797;84990;516;0;0;0;0;.00nan;0;0
4797;143036;516;83;21;1;20;.952;3600000;0
4798;174581;518;73;40;3;37;.925;3900000;0
4798;64271;518;0;0;0;0;.00nan;0;0
4798;75362;514;69;28;3;25;.893;3900000;0
4798;159851;514;0;0;0;0;.00nan;0;0
4799;167036;515;0;0;0;0;.00nan;0;0
4799;43896;515;100;44;1;43;.977;3600000;0
4799;64271;518;60;29;3;26;.897;3542000;0
4799;143330;518;0;0;0;0;.00nan;0;0
4800;64230;511;0;0;0;0;.00nan;0;0
4800;80859;511;67;33;3;30;.909;3550000;0
4800;86347;524;0;0;0;0;.00nan;0;0
4800;91403;524;73;28;2;26;.929;3600000;0
4801;6944;520;0;0;0;0;.00nan;0;0
4801;7534;1481;97;51;2;49;.961;3600000;0
4801;67764;1481;0;0;0;0;.00nan;0;0
4801;155474;520;90;18;0;18;1.000;3600000;0
4802;6947;1872;31;9;3;6;.667;1212000;0
4802;169323;519;0;0;0;0;.00nan;0;0
4802;44200;519;79;21;1;20;.952;3600000;0
4802;76951;1872;45;24;4;20;.833;2388000;0
4803;38124;512;78;31;2;29;.935;3900000;0
4803;75362;514;90;38;2;36;.947;3900000;0
4803;143083;512;0;0;0;0;.00nan;0;0
4803;159851;514;0;0;0;0;.00nan;0;0
4804;7332;1472;0;0;0;0;.00nan;0;0
4804;84990;516;0;0;0;0;.00nan;0;0
4804;86228;1472;35;28;6;22;.786;3600000;0
4804;143036;516;66;21;2;19;.905;3600000;0
4805;2410;513;89;38;2;36;.947;3600000;0
4805;59614;513;0;0;0;0;.00nan;0;0
4805;68425;1876;0;0;0;0;.00nan;0;0
4805;152478;1876;55;27;4;23;.852;3518000;0
4806;169323;519;81;27;1;26;.963;3600000;0
4806;44200;519;0;0;0;0;.00nan;0;0
4806;84990;516;0;0;0;0;.00nan;0;0
4806;143036;516;82;33;2;31;.939;3568000;0
4807;7332;1472;0;0;0;0;.00nan;0;0
4807;64271;518;38;9;2;7;.778;915000;0
4807;86228;1472;72;24;1;23;.958;3600000;0
4807;143330;518;34;30;6;24;.800;2685000;0
4808;2410;513;72;38;3;35;.921;3578000;0
4808;59614;513;0;0;0;0;.00nan;0;0
4808;64230;511;0;0;0;0;.00nan;0;0
4808;80859;511;72;18;1;17;.944;3600000;0
4809;167036;515;0;0;0;0;.00nan;0;0
4809;43896;515;76;20;1;19;.950;3600000;0
4809;68425;1876;0;0;0;0;.00nan;0;0
4809;152478;1876;57;38;5;33;.868;3600000;0
4810;6944;520;0;0;0;0;.00nan;0;0
4810;86347;524;0;0;0;0;.00nan;0;0
4810;91403;524;86;15;0;15;1.000;3600000;0
4810;155474;520;58;38;4;34;.895;3600000;0
4811;7534;1481;80;46;4;42;.913;3600000;0
4811;38124;512;52;11;1;10;.909;3600000;0
4811;67764;1481;0;0;0;0;.00nan;0;0
4811;143083;512;0;0;0;0;.00nan;0;0
4812;6947;1872;0;0;0;0;.00nan;0;0
4812;75362;514;84;37;2;35;.946;3600000;0
4812;76951;1872;64;42;4;38;.905;3548000;0
4812;159851;514;0;0;0;0;.00nan;0;0
4813;2410;513;65;22;2;20;.909;3600000;0
4813;59614;513;0;0;0;0;.00nan;0;0
4813;64271;518;0;0;0;0;.00nan;0;0
4813;143330;518;43;38;6;32;.842;3600000;0
4814;64230;511;0;0;0;0;.00nan;0;0
4814;68425;1876;0;0;0;0;.00nan;0;0
4814;80859;511;71;15;1;14;.933;3600000;0
4814;152478;1876;57;40;5;35;.875;3600000;0
4815;167036;515;0;0;0;0;.00nan;0;0
4815;6944;520;76;32;3;29;.906;3326000;0
4815;43896;515;88;32;2;30;.938;3600000;0
4815;155474;520;28;6;3;3;.500;274000;0
4816;169323;519;0;0;0;0;.00nan;0;0
4816;38124;512;63;36;4;32;.889;3600000;0
4816;44200;519;63;41;5;36;.878;3600000;0
4816;143083;512;0;0;0;0;.00nan;0;0
4817;84990;516;0;0;0;0;.00nan;0;0
4817;86347;524;0;0;0;0;.00nan;0;0
4817;91403;524;88;48;4;44;.917;3560000;0
4817;143036;516;64;31;3;28;.903;3600000;0
4818;6947;1872;0;0;0;0;.00nan;0;0
4818;7332;1472;0;0;0;0;.00nan;0;0
4818;76951;1872;94;40;2;38;.950;3900000;0
4818;86228;1472;64;28;2;26;.929;3900000;0
4819;7534;1481;50;39;6;33;.846;2610000;0
4819;67764;1481;55;6;0;6;1.000;950000;0
4819;75362;514;30;19;5;14;.737;3600000;0
4819;159851;514;0;0;0;0;.00nan;0;0
4820;64230;511;0;0;0;0;.00nan;0;0
4820;64271;518;0;0;0;0;.00nan;0;0
4820;80859;511;58;24;3;21;.875;3600000;0
4820;143330;518;64;52;6;46;.885;3600000;0
4821;7534;1481;94;46;3;43;.935;3900000;0
4821;169323;519;0;0;0;0;.00nan;0;0
4821;44200;519;51;22;3;19;.864;3900000;0
4821;67764;1481;0;0;0;0;.00nan;0;0
4822;7332;1472;0;0;0;0;.00nan;0;0
4822;75362;514;58;24;3;21;.875;3548000;0
4822;86228;1472;78;29;2;27;.931;3600000;0
4822;159851;514;0;0;0;0;.00nan;0;0
4823;167036;515;0;0;0;0;.00nan;0;0
4823;43896;515;54;23;3;20;.870;3574000;0
4823;84990;516;0;0;0;0;.00nan;0;0
4823;143036;516;91;39;2;37;.949;3600000;0
4824;38124;512;98;28;0;28;1.000;3600000;0
4824;86347;524;0;0;0;0;.00nan;0;0
4824;91403;524;77;26;1;25;.962;3574000;0
4824;143083;512;0;0;0;0;.00nan;0;0
4825;2410;513;24;30;7;23;.767;3600000;0
4825;6947;1872;0;0;0;0;.00nan;0;0
4825;59614;513;0;0;0;0;.00nan;0;0
4825;76951;1872;100;29;0;29;1.000;3600000;0
4826;6944;520;0;0;0;0;.00nan;0;0
4826;68425;1876;0;0;0;0;.00nan;0;0
4826;152478;1876;90;50;3;47;.940;3600000;0
4826;155474;520;84;25;1;24;.960;3600000;0
4827;64271;518;0;0;0;0;.00nan;0;0
4827;68425;1876;0;0;0;0;.00nan;0;0
4827;143330;518;66;30;2;28;.933;3600000;0
4827;152478;1876;41;28;5;23;.821;3600000;0
4828;2410;513;75;31;2;29;.935;3600000;0
4828;6944;520;63;33;3;30;.909;3556000;0
4828;59614;513;0;0;0;0;.00nan;0;0
4828;155474;520;0;0;0;0;.00nan;0;0
4829;7332;1472;0;0;0;0;.00nan;0;0
4829;38124;512;60;34;4;30;.882;3550000;0
4829;86228;1472;89;33;2;31;.939;3600000;0
4829;143083;512;0;0;0;0;.00nan;0;0
4830;64230;511;0;0;0;0;.00nan;0;0
4830;80859;511;51;19;3;16;.842;3600000;0
4830;84990;516;0;0;0;0;.00nan;0;0
4830;143036;516;73;41;4;37;.902;3600000;0
4831;167036;515;0;0;0;0;.00nan;0;0
4831;7534;1481;43;34;6;28;.824;2817000;0
4831;43896;515;58;17;2;15;.882;3600000;0
4831;67764;1481;70;11;0;11;1.000;783000;0
4832;6947;1872;82;25;1;24;.960;3600000;0
4832;76951;1872;0;0;0;0;.00nan;0;0
4832;86347;524;0;0;0;0;.00nan;0;0
4832;91403;524;59;24;2;22;.917;3559000;0
4833;169323;519;0;0;0;0;.00nan;0;0
4833;44200;519;61;25;2;23;.920;3572000;0
4833;75362;514;82;28;1;27;.964;3600000;0
4833;159851;514;0;0;0;0;.00nan;0;0
4834;6944;520;0;0;0;0;.00nan;0;0
4834;64271;518;0;0;0;0;.00nan;0;0
4834;143330;518;82;36;2;34;.944;3600000;0
4834;155474;520;49;39;5;34;.872;3600000;0
4835;6947;1872;0;0;0;0;.00nan;0;0
4835;64230;511;0;0;0;0;.00nan;0;0
4835;76951;1872;100;48;3;45;.938;3900000;0
4835;80859;511;76;36;3;33;.917;3900000;0
4836;7332;1472;86;32;1;31;.969;3600000;0
4836;169323;519;0;0;0;0;.00nan;0;0
4836;44200;519;88;44;3;41;.932;3531000;0
4836;86228;1472;0;0;0;0;.00nan;0;0
4837;2410;513;0;0;0;0;.00nan;0;0
4837;59614;513;37;17;4;13;.765;3770000;0
4837;75362;514;63;31;3;28;.903;3770000;0
4837;159851;514;0;0;0;0;.00nan;0;0
4838;167036;515;89;36;2;34;.944;3600000;0
4838;38124;512;51;29;5;24;.828;3600000;0
4838;43896;515;0;0;0;0;.00nan;0;0
4838;143083;512;0;0;0;0;.00nan;0;0
4839;7534;1481;100;33;0;33;1.000;3898000;0
4839;67764;1481;0;0;0;0;.00nan;0;0
4839;86347;524;0;0;0;0;.00nan;0;0
4839;91403;524;92;30;1;29;.967;3898000;0
4840;68425;1876;0;0;0;0;.00nan;0;0
4840;84990;516;0;0;0;0;.00nan;0;0
4840;143036;516;42;23;4;19;.826;3600000;0
4840;152478;1876;44;27;5;22;.815;3544000;0
4841;6944;520;99;42;2;40;.952;3600000;0
4841;64230;511;0;0;0;0;.00nan;0;0
4841;80859;511;45;23;3;20;.870;3566000;0
4841;155474;520;0;0;0;0;.00nan;0;0
4842;169323;519;93;21;0;21;1.000;3600000;0
4842;44200;519;0;0;0;0;.00nan;0;0
4842;68425;1876;62;8;0;8;1.000;1050000;0
4842;152478;1876;38;34;6;28;.824;2550000;0
4843;167036;515;0;0;0;0;.00nan;0;0
4843;6947;1872;0;0;0;0;.00nan;0;0
4843;43896;515;100;37;0;37;1.000;3600000;0
4843;76951;1872;78;36;3;33;.917;3600000;0
4844;2410;513;53;33;4;29;.879;3600000;0
4844;38124;512;79;22;1;21;.955;3600000;0
4844;59614;513;0;0;0;0;.00nan;0;0
4844;143083;512;0;0;0;0;.00nan;0;0
4845;64271;518;0;0;0;0;.00nan;0;0
4845;84990;516;0;0;0;0;.00nan;0;0
4845;143036;516;87;39;3;36;.923;3900000;0
4845;143330;518;75;39;3;36;.923;3900000;0
4846;7332;1472;0;0;0;0;.00nan;0;0
4846;7534;1481;90;36;3;33;.917;3600000;0
4846;67764;1481;0;0;0;0;.00nan;0;0
4846;86228;1472;48;29;4;25;.862;3598000;0
4847;75362;514;0;0;0;0;.00nan;0;0
4847;86347;524;0;0;0;0;.00nan;0;0
4847;91403;524;61;33;4;29;.879;3900000;0
4847;159851;514;44;26;4;22;.846;3900000;0
4848;169323;519;80;33;3;30;.909;3806000;0
4848;44200;519;0;0;0;0;.00nan;0;0
4848;86347;524;0;0;0;0;.00nan;0;0
4848;91403;524;88;45;2;43;.956;3806000;0
4849;167036;515;0;0;0;0;.00nan;0;0
4849;7332;1472;0;0;0;0;.00nan;0;0
4849;43896;515;83;35;2;33;.943;3600000;0
4849;86228;1472;34;10;3;7;.700;3547000;0
4850;6944;520;0;0;0;0;.00nan;0;0
4850;38124;512;76;37;3;34;.919;3600000;0
4850;143083;512;0;0;0;0;.00nan;0;0
4850;155474;520;55;42;5;37;.881;3600000;0
4851;2410;513;38;22;4;18;.818;3600000;0
4851;59614;513;0;0;0;0;.00nan;0;0
4851;84990;516;0;0;0;0;.00nan;0;0
4851;143036;516;93;34;1;33;.971;3600000;0
4852;7534;1481;83;29;1;28;.966;3600000;0
4852;67764;1481;0;0;0;0;.00nan;0;0
4852;68425;1876;0;0;0;0;.00nan;0;0
4852;152478;1876;79;17;0;17;1.000;3600000;0
4853;6947;1872;0;0;0;0;.00nan;0;0
4853;64271;518;0;0;0;0;.00nan;0;0
4853;76951;1872;98;35;1;34;.971;3600000;0
4853;143330;518;69;31;3;28;.903;3543000;0
4854;64230;511;0;0;0;0;.00nan;0;0
4854;75362;514;79;41;4;37;.902;3600000;0
4854;80859;511;98;25;0;25;1.000;3600000;0
4854;159851;514;0;0;0;0;.00nan;0;0
4855;38124;512;56;25;3;22;.880;3564000;0
4855;84990;516;0;0;0;0;.00nan;0;0
4855;143036;516;71;26;2;24;.923;3600000;0
4855;143083;512;0;0;0;0;.00nan;0;0
4856;38124;512;64;35;5;30;.857;3577000;0
4856;64271;518;0;0;0;0;.00nan;0;0
4856;143083;512;0;0;0;0;.00nan;0;0
4856;143330;518;56;25;3;22;.880;3600000;0
4857;169323;519;53;15;2;13;.867;1781000;0
4857;44200;519;27;25;5;20;.800;1819000;0
4857;64230;511;0;0;0;0;.00nan;0;0
4857;80859;511;66;25;2;23;.920;3600000;0
4858;6944;520;84;33;2;31;.939;3600000;0
4858;84990;516;0;0;0;0;.00nan;0;0
4858;143036;516;54;31;4;27;.871;3565000;0
4858;155474;520;0;0;0;0;.00nan;0;0
4859;2410;513;66;15;1;14;.933;3600000;0
4859;7534;1481;89;43;3;40;.930;3561000;0
4859;59614;513;0;0;0;0;.00nan;0;0
4859;67764;1481;0;0;0;0;.00nan;0;0
4860;167036;515;32;28;5;23;.821;3900000;0
4860;43896;515;0;0;0;0;.00nan;0;0
4860;75362;514;75;38;5;33;.868;3900000;0
4860;159851;514;0;0;0;0;.00nan;0;0
4861;7332;1472;0;0;0;0;.00nan;0;0
4861;86228;1472;99;32;1;31;.969;3900000;0
4861;86347;524;0;0;0;0;.00nan;0;0
4861;91403;524;97;35;1;34;.971;3900000;0
4862;6947;1872;0;0;0;0;.00nan;0;0
4862;68425;1876;0;0;0;0;.00nan;0;0
4862;76951;1872;53;18;2;16;.889;3886000;0
4862;152478;1876;94;48;3;45;.938;3886000;0
4863;2410;513;0;0;0;0;.00nan;0;0
4863;169323;519;34;29;5;24;.828;3600000;0
4863;44200;519;0;0;0;0;.00nan;0;0
4863;59614;513;84;31;1;30;.968;3600000;0
4864;7332;1472;0;0;0;0;.00nan;0;0
4864;68425;1876;0;0;0;0;.00nan;0;0
4864;86228;1472;66;19;1;18;.947;3600000;0
4864;152478;1876;93;50;3;47;.940;3536000;0
4865;167036;515;0;0;0;0;.00nan;0;0
4865;43896;515;57;29;3;26;.897;3567000;0
4865;86347;524;0;0;0;0;.00nan;0;0
4865;91403;524;95;33;2;31;.939;3600000;0
4866;38124;512;100;34;0;34;1.000;3600000;0
4866;64230;511;0;0;0;0;.00nan;0;0
4866;80859;511;81;30;2;28;.933;3542000;0
4866;143083;512;0;0;0;0;.00nan;0;0
4867;7534;1481;0;0;0;0;.00nan;0;0
4867;64271;518;0;0;0;0;.00nan;0;0
4867;67764;1481;85;32;2;30;.938;3521000;0
4867;143330;518;98;23;0;23;1.000;3600000;0
4868;6947;1872;0;0;0;0;.00nan;0;0
4868;76951;1872;76;24;1;23;.958;3600000;0
4868;84990;516;0;0;0;0;.00nan;0;0
4868;143036;516;88;41;3;38;.927;3564000;0
4869;6944;520;0;0;0;0;.00nan;0;0
4869;75362;514;82;31;3;28;.903;3678000;0
4869;155474;520;94;37;2;35;.946;3678000;0
4869;159851;514;0;0;0;0;.00nan;0;0
4870;64271;518;0;0;0;0;.00nan;0;0
4870;86347;524;0;0;0;0;.00nan;0;0
4870;91403;524;51;39;5;34;.872;3600000;0
4870;143330;518;47;23;4;19;.826;3600000;0
4871;7534;1481;48;36;5;31;.861;3600000;0
4871;64230;511;0;0;0;0;.00nan;0;0
4871;67764;1481;0;0;0;0;.00nan;0;0
4871;80859;511;63;13;1;12;.923;3600000;0
4872;6944;520;78;39;3;36;.923;3900000;0
4872;6947;1872;0;0;0;0;.00nan;0;0
4872;76951;1872;62;33;3;30;.909;3900000;0
4872;155474;520;0;0;0;0;.00nan;0;0
4873;2410;513;47;38;6;32;.842;3600000;0
4873;7332;1472;0;0;0;0;.00nan;0;0
4873;59614;513;0;0;0;0;.00nan;0;0
4873;86228;1472;60;23;3;20;.870;3600000;0
4874;167036;515;0;0;0;0;.00nan;0;0
4874;43896;515;94;36;2;34;.944;3600000;0
4874;44200;519;0;0;0;0;.00nan;0;0
4874;143036;519;91;48;4;44;.917;3514000;0
4875;68425;1876;0;0;0;0;.00nan;0;0
4875;75362;514;77;42;4;38;.905;3600000;0
4875;152478;1876;100;29;0;29;1.000;3600000;0
4875;159851;514;0;0;0;0;.00nan;0;0
4876;169323;519;54;25;3;22;.880;3635000;0
4876;44200;519;0;0;0;0;.00nan;0;0
4876;64271;518;0;0;0;0;.00nan;0;0
4876;143330;518;60;31;4;27;.871;3635000;0
4877;6944;520;44;15;3;12;.800;833000;0
4877;7332;1472;71;25;2;23;.920;3600000;0
4877;86228;1472;0;0;0;0;.00nan;0;0
4877;155474;520;31;32;6;26;.813;2767000;0
4878;2410;511;0;0;0;0;.00nan;0;0
4878;167036;515;0;0;0;0;.00nan;0;0
4878;43896;515;85;36;2;34;.944;3600000;0
4878;80859;511;56;33;4;29;.879;3572000;0
4879;2410;513;74;35;3;32;.914;3600000;0
4879;59614;513;0;0;0;0;.00nan;0;0
4879;86347;524;100;23;0;23;1.000;3600000;0
4879;91403;524;0;0;0;0;.00nan;0;0
4880;38124;512;78;22;1;21;.955;3600000;0
4880;68425;1876;0;0;0;0;.00nan;0;0
4880;143083;512;0;0;0;0;.00nan;0;0
4880;152478;1876;80;38;3;35;.921;3590000;0
4881;6947;1872;0;0;0;0;.00nan;0;0
4881;7534;1481;96;59;5;54;.915;3600000;0
4881;67764;1481;0;0;0;0;.00nan;0;0
4881;76951;1872;85;15;0;15;1.000;3600000;0
4882;75362;514;76;32;2;30;.938;3600000;0
4882;84990;516;0;0;0;0;.00nan;0;0
4882;143036;516;60;28;3;25;.893;3551000;0
4882;159851;514;0;0;0;0;.00nan;0;0
4883;64271;518;0;0;0;0;.00nan;0;0
4883;75362;514;58;32;4;28;.875;3621000;0
4883;143330;518;92;46;3;43;.935;3621000;0
4883;159851;514;0;0;0;0;.00nan;0;0
4884;7332;1472;0;0;0;0;.00nan;0;0
4884;64230;511;62;28;3;25;.893;3600000;0
4884;80859;511;0;0;0;0;.00nan;0;0
4884;86228;1472;70;27;2;25;.926;3600000;0
4885;6944;520;75;28;2;26;.929;3600000;0
4885;169323;519;0;0;0;0;.00nan;0;0
4885;44200;519;98;25;0;25;1.000;3600000;0
4885;155474;520;0;0;0;0;.00nan;0;0
4886;167036;515;0;0;0;0;.00nan;0;0
4886;16587;513;77;39;4;35;.897;3900000;0
4886;43896;515;46;21;4;17;.810;3900000;0
4886;59614;513;0;0;0;0;.00nan;0;0
4887;7534;1481;79;44;4;40;.909;3600000;0
4887;55495;516;0;0;0;0;.00nan;0;0
4887;67764;1481;0;0;0;0;.00nan;0;0
4887;84990;516;64;15;1;14;.933;3600000;0
4888;6947;1872;0;0;0;0;.00nan;0;0
4888;38124;512;91;36;2;34;.944;3600000;0
4888;76951;1872;55;22;3;19;.864;3548000;0
4888;143083;512;0;0;0;0;.00nan;0;0
4889;68425;1876;0;0;0;0;.00nan;0;0
4889;86347;524;73;27;2;25;.926;3600000;0
4889;91403;524;0;0;0;0;.00nan;0;0
4889;152478;1876;72;37;3;34;.919;3580000;0
4890;44200;519;64;30;3;27;.900;3554000;0
4890;55495;516;0;0;0;0;.00nan;0;0
4890;84990;516;90;38;2;36;.947;3600000;0
4890;143036;519;0;0;0;0;.00nan;0;0
4891;7332;1472;0;0;0;0;.00nan;0;0
4891;64271;518;0;0;0;0;.00nan;0;0
4891;86228;1472;85;13;0;13;1.000;3600000;0
4891;143330;518;69;38;4;34;.895;3600000;0
4892;2410;513;62;22;2;20;.909;3588000;0
4892;59614;513;0;0;0;0;.00nan;0;0
4892;64230;511;0;0;0;0;.00nan;0;0
4892;80859;511;88;37;1;36;.973;3600000;0
4893;167036;515;23;6;3;3;.500;586000;0
4893;43896;515;70;17;1;16;.941;3314000;0
4893;68425;1876;0;0;0;0;.00nan;0;0
4893;152478;1876;79;45;4;41;.911;3900000;0
4894;6944;520;0;0;0;0;.00nan;0;0
4894;86347;524;0;0;0;0;.00nan;0;0
4894;91403;524;90;37;2;35;.946;3600000;0
4894;155474;520;39;36;7;29;.806;3600000;0
4895;7534;1481;87;42;2;40;.952;3600000;0
4895;38124;512;70;34;3;31;.912;3576000;0
4895;67764;1481;0;0;0;0;.00nan;0;0
4895;143083;512;0;0;0;0;.00nan;0;0
4896;6947;1872;41;30;5;25;.833;3600000;0
4896;75362;514;100;30;0;30;1.000;3600000;0
4896;76951;1872;0;0;0;0;.00nan;0;0
4896;159851;514;0;0;0;0;.00nan;0;0
4897;6947;1872;0;0;0;0;.00nan;0;0
4897;44200;519;51;40;5;35;.875;3526000;0
4897;76951;1872;75;32;3;29;.906;3600000;0
4897;143036;519;0;0;0;0;.00nan;0;0
4898;7332;1472;0;0;0;0;.00nan;0;0
4898;55495;516;0;0;0;0;.00nan;0;0
4898;84990;516;80;28;1;27;.964;3600000;0
4898;86228;1472;54;29;4;25;.862;3600000;0
4899;2410;513;0;0;0;0;.00nan;0;0
4899;59614;513;57;17;2;15;.882;3600000;0
4899;68425;1876;0;0;0;0;.00nan;0;0
4899;152478;1876;76;38;3;35;.921;3600000;0
4900;167036;515;0;0;0;0;.00nan;0;0
4900;43896;515;65;34;4;30;.882;3900000;0
4900;64271;518;0;0;0;0;.00nan;0;0
4900;143330;518;67;33;4;29;.879;3900000;0
4901;64230;511;0;0;0;0;.00nan;0;0
4901;80859;511;40;19;3;16;.842;3511000;0
4901;86347;524;0;0;0;0;.00nan;0;0
4901;91403;524;100;37;1;36;.973;3600000;0
4902;6944;520;100;30;1;29;.967;3600000;0
4902;7534;1481;93;50;3;47;.940;3564000;0
4902;67764;1481;0;0;0;0;.00nan;0;0
4902;155474;520;0;0;0;0;.00nan;0;0
4903;38124;512;73;25;2;23;.920;3600000;0
4903;75362;514;60;39;5;34;.872;3600000;0
4903;143083;512;0;0;0;0;.00nan;0;0
4903;159851;514;0;0;0;0;.00nan;0;0
4904;7332;1472;0;0;0;0;.00nan;0;0
4904;64271;518;0;0;0;0;.00nan;0;0
4904;86228;1472;74;32;2;30;.938;3600000;0
4904;143330;518;78;43;4;39;.907;3600000;0
4905;2410;513;68;46;6;40;.870;3600000;0
4905;59614;513;0;0;0;0;.00nan;0;0
4905;64230;511;0;0;0;0;.00nan;0;0
4905;80859;511;54;19;3;16;.842;3600000;0
4906;6944;520;0;0;0;0;.00nan;0;0
4906;86347;524;0;0;0;0;.00nan;0;0
4906;91403;524;52;30;4;26;.867;3762000;0
4906;155474;520;73;49;5;44;.898;3762000;0
4907;7534;1481;91;47;2;45;.957;3689000;0
4907;38124;512;0;0;0;0;.00nan;0;0
4907;67764;1481;0;0;0;0;.00nan;0;0
4907;143083;512;59;27;3;24;.889;3675000;0
4908;44200;519;0;0;0;0;.00nan;0;0
4908;55495;516;0;0;0;0;.00nan;0;0
4908;84990;516;100;35;0;35;1.000;3600000;0
4908;143036;519;70;28;2;26;.929;3552000;0
4909;167036;515;0;0;0;0;.00nan;0;0
4909;43896;515;46;27;4;23;.852;3580000;0
4909;68425;1876;0;0;0;0;.00nan;0;0
4909;152478;1876;95;39;2;37;.949;3600000;0
4910;6947;1872;0;0;0;0;.00nan;0;0
4910;75362;514;77;30;2;28;.933;3600000;0
4910;76951;1872;72;30;3;27;.900;3550000;0
4910;159851;514;0;0;0;0;.00nan;0;0
4911;38124;512;80;41;3;38;.927;3516000;0
4911;44200;519;0;0;0;0;.00nan;0;0
4911;143036;519;70;23;1;22;.957;3600000;0
4911;143083;512;0;0;0;0;.00nan;0;0
4912;6947;1872;0;0;0;0;.00nan;0;0
4912;7332;1472;0;0;0;0;.00nan;0;0
4912;76951;1872;71;43;4;39;.907;3553000;0
4912;86228;1472;77;26;2;24;.923;3600000;0
4913;2410;513;40;15;3;12;.800;3600000;0
4913;59614;513;0;0;0;0;.00nan;0;0
4913;64271;518;0;0;0;0;.00nan;0;0
4913;143330;518;57;34;5;29;.853;3551000;0
4914;167036;515;0;0;0;0;.00nan;0;0
4914;6944;520;75;31;3;28;.903;3595000;0
4914;43896;515;80;24;1;23;.958;3600000;0
4914;155474;520;0;0;0;0;.00nan;0;0
4915;55495;516;0;0;0;0;.00nan;0;0
4915;84990;516;97;21;0;21;1.000;3600000;0
4915;86347;524;0;0;0;0;.00nan;0;0
4915;91403;524;74;45;5;40;.889;3600000;0
4916;7534;1481;87;43;2;41;.953;3600000;0
4916;67764;1481;0;0;0;0;.00nan;0;0
4916;75362;514;69;17;1;16;.941;3600000;0
4916;159851;514;0;0;0;0;.00nan;0;0
4917;64230;511;0;0;0;0;.00nan;0;0
4917;68425;1876;0;0;0;0;.00nan;0;0
4917;80859;511;34;20;4;16;.800;3540000;0
4917;152478;1876;92;58;3;55;.948;3600000;0
4918;64230;511;0;0;0;0;.00nan;0;0
4918;64271;518;0;0;0;0;.00nan;0;0
4918;80859;511;73;17;1;16;.941;3600000;0
4918;143330;518;67;45;5;40;.889;3600000;0
4919;6944;520;0;0;0;0;.00nan;0;0
4919;68425;1876;0;0;0;0;.00nan;0;0
4919;152478;1876;81;26;1;25;.962;3600000;0
4919;155474;520;80;31;2;29;.935;3582000;0
4920;38124;512;54;31;4;27;.871;3536000;0
4920;86347;524;0;0;0;0;.00nan;0;0
4920;91403;524;99;46;2;44;.957;3600000;0
4920;143083;512;0;0;0;0;.00nan;0;0
4921;167036;515;0;0;0;0;.00nan;0;0
4921;43896;515;70;21;1;20;.952;3600000;0
4921;55495;516;0;0;0;0;.00nan;0;0
4921;84990;516;76;34;2;32;.941;3600000;0
4922;7534;1481;98;53;3;50;.943;3599000;0
4922;44200;519;0;0;0;0;.00nan;0;0
4922;67764;1481;0;0;0;0;.00nan;0;0
4922;143036;519;71;20;1;19;.950;3600000;0
4923;2410;513;59;39;5;34;.872;3600000;0
4923;6947;1872;0;0;0;0;.00nan;0;0
4923;59614;513;0;0;0;0;.00nan;0;0
4923;76951;1872;86;24;1;23;.958;3600000;0
4924;7332;1472;0;0;0;0;.00nan;0;0
4924;75362;514;0;0;0;0;.00nan;0;0
4924;86228;1472;82;26;1;25;.962;3600000;0
4924;159851;514;42;29;5;24;.828;3600000;0
4925;2410;511;46;28;4;24;.857;3600000;0
4925;55495;516;0;0;0;0;.00nan;0;0
4925;80859;511;0;0;0;0;.00nan;0;0
4925;84990;516;75;36;3;33;.917;3600000;0
4926;44200;519;0;0;0;0;.00nan;0;0
4926;75362;514;76;35;3;32;.914;3900000;0
4926;143036;519;76;38;3;35;.921;3900000;0
4926;159851;514;0;0;0;0;.00nan;0;0
4927;7332;1472;0;0;0;0;.00nan;0;0
4927;38124;512;81;45;3;42;.933;3600000;0
4927;86228;1472;52;29;4;25;.862;3600000;0
4927;143083;512;0;0;0;0;.00nan;0;0
4928;6944;520;0;0;0;0;.00nan;0;0
4928;16587;513;68;18;1;17;.944;3600000;0
4928;59614;513;0;0;0;0;.00nan;0;0
4928;155474;520;88;36;2;34;.944;3600000;0
4929;167036;515;0;0;0;0;.00nan;0;0
4929;7534;1481;77;45;4;41;.911;3600000;0
4929;43896;515;92;22;0;22;1.000;3600000;0
4929;67764;1481;0;0;0;0;.00nan;0;0
4930;6947;1872;0;0;0;0;.00nan;0;0
4930;76951;1872;44;35;5;30;.857;3830000;0
4930;86347;524;0;0;0;0;.00nan;0;0
4930;91403;524;60;51;6;45;.882;3830000;0
4931;64271;518;0;0;0;0;.00nan;0;0
4931;68425;1876;0;0;0;0;.00nan;0;0
4931;143330;518;69;27;3;24;.889;3650000;0
4931;152478;1876;85;37;2;35;.946;3650000;0
4932;6944;520;0;0;0;0;.00nan;0;0
4932;64271;518;61;18;2;16;.889;2405000;0
4932;143330;518;21;20;5;15;.750;1195000;0
4932;155474;520;93;61;4;57;.934;3600000;0
4933;7332;1472;0;0;0;0;.00nan;0;0
4933;44200;519;0;0;0;0;.00nan;0;0
4933;86228;1472;66;19;2;17;.895;3900000;0
4933;143036;519;83;36;2;34;.944;3900000;0
4934;167036;515;0;0;0;0;.00nan;0;0
4934;38124;512;34;30;6;24;.800;3600000;0
4934;43896;515;90;32;1;31;.969;3600000;0
4934;143083;512;0;0;0;0;.00nan;0;0
4935;55495;516;75;25;2;23;.920;3549000;0
4935;68425;1876;0;0;0;0;.00nan;0;0
4935;84990;516;0;0;0;0;.00nan;0;0
4935;152478;1876;98;36;1;35;.972;3600000;0
4936;7534;1481;85;50;4;46;.920;3600000;0
4936;67764;1481;0;0;0;0;.00nan;0;0
4936;86347;524;0;0;0;0;.00nan;0;0
4936;91403;524;73;22;1;21;.955;3600000;0
4937;2410;511;48;36;5;31;.861;3579000;0
4937;6947;1872;70;36;3;33;.917;3600000;0
4937;76951;1872;0;0;0;0;.00nan;0;0
4937;80859;511;0;0;0;0;.00nan;0;0
4938;16587;513;55;5;0;5;1.000;1301000;0
4938;59614;513;31;32;6;26;.813;2299000;0
4938;75362;514;74;21;1;20;.952;3600000;0
4938;159851;514;0;0;0;0;.00nan;0;0
4939;55495;516;0;0;0;0;.00nan;0;0
4939;64271;518;84;30;1;29;.967;3600000;0
4939;84990;516;48;41;7;34;.829;3600000;0
4939;143330;518;0;0;0;0;.00nan;0;0
4940;2410;511;51;25;4;21;.840;3594000;0
4940;6944;520;83;42;3;39;.929;3600000;0
4940;80859;511;0;0;0;0;.00nan;0;0
4940;155474;520;0;0;0;0;.00nan;0;0
4941;7332;1472;0;0;0;0;.00nan;0;0
4941;7534;1481;92;57;4;53;.930;3570000;0
4941;67764;1481;0;0;0;0;.00nan;0;0
4941;86228;1472;74;26;2;24;.923;3600000;0
4942;16587;513;0;0;0;0;.00nan;0;0
4942;38124;512;80;25;1;24;.960;3600000;0
4942;59614;513;53;34;5;29;.853;3600000;0
4942;143083;512;0;0;0;0;.00nan;0;0
4943;167036;515;0;0;0;0;.00nan;0;0
4943;6947;1872;0;0;0;0;.00nan;0;0
4943;43896;515;81;27;2;25;.926;3900000;0
4943;76951;1872;79;35;2;33;.943;3900000;0
4944;75362;514;80;29;2;27;.931;3600000;0
4944;86347;524;0;0;0;0;.00nan;0;0
4944;91403;524;59;30;3;27;.900;3573000;0
4944;159851;514;0;0;0;0;.00nan;0;0
4945;44200;519;0;0;0;0;.00nan;0;0
4945;68425;1876;0;0;0;0;.00nan;0;0
4945;143036;519;53;29;4;25;.862;3569000;0
4945;152478;1876;98;38;2;36;.947;3600000;0
4946;6947;1872;0;0;0;0;.00nan;0;0
4946;64271;518;0;0;0;0;.00nan;0;0
4946;76951;1872;92;40;2;38;.950;3733000;0
4946;143330;518;100;36;1;35;.972;3733000;0
4947;2410;511;56;19;2;17;.895;3513000;0
4947;75362;514;100;30;0;30;1.000;3600000;0
4947;80859;511;0;0;0;0;.00nan;0;0
4947;159851;514;0;0;0;0;.00nan;0;0
4948;6944;520;0;0;0;0;.00nan;0;0
4948;38124;512;82;31;1;30;.968;3600000;0
4948;143083;512;0;0;0;0;.00nan;0;0
4948;155474;520;83;46;3;43;.935;3600000;0
4949;16587;513;0;0;0;0;.00nan;0;0
4949;55495;516;0;0;0;0;.00nan;0;0
4949;59614;513;74;28;2;26;.929;3567000;0
4949;84990;516;100;32;0;32;1.000;3600000;0
4950;167036;515;50;36;5;31;.861;3600000;0
4950;7332;1472;0;0;0;0;.00nan;0;0
4950;43896;515;0;0;0;0;.00nan;0;0
4950;86228;1472;64;28;2;26;.929;3600000;0
4951;44200;519;0;0;0;0;.00nan;0;0
4951;86347;524;0;0;0;0;.00nan;0;0
4951;91403;524;82;38;2;36;.947;3511000;0
4951;143036;519;78;13;0;13;1.000;3600000;0
4952;7534;1481;94;43;3;40;.930;3900000;0
4952;67764;1481;0;0;0;0;.00nan;0;0
4952;68425;1876;0;0;0;0;.00nan;0;0
4952;152478;1876;74;31;3;28;.903;3900000;0
4953;2410;511;55;25;3;22;.880;3577000;0
4953;44200;519;0;0;0;0;.00nan;0;0
4953;80859;511;0;0;0;0;.00nan;0;0
4953;143036;519;90;37;2;35;.946;3600000;0
4954;7332;1472;0;0;0;0;.00nan;0;0
4954;86228;1472;68;15;1;14;.933;3600000;0
4954;86347;524;0;0;0;0;.00nan;0;0
4954;91403;524;81;35;2;33;.943;3600000;0
4955;38124;512;0;0;0;0;.00nan;0;0
4955;64271;518;0;0;0;0;.00nan;0;0
4955;143083;512;76;30;3;27;.900;3600000;0
4955;143330;518;37;31;5;26;.839;3561000;0
4956;6944;520;66;36;4;32;.889;3600000;0
4956;55495;516;0;0;0;0;.00nan;0;0
4956;84990;516;78;19;1;18;.947;3600000;0
4956;155474;520;0;0;0;0;.00nan;0;0
4957;7534;1481;63;37;4;33;.892;3580000;0
4957;16587;513;0;0;0;0;.00nan;0;0
4957;59614;513;49;17;2;15;.882;3600000;0
4957;67764;1481;0;0;0;0;.00nan;0;0
4958;6947;1872;25;14;4;10;.714;1142000;0
4958;68425;1876;0;0;0;0;.00nan;0;0
4958;76951;1872;90;21;1;20;.952;2458000;0
4958;152478;1876;100;37;0;37;1.000;3600000;0
4959;167036;515;0;0;0;0;.00nan;0;0
4959;43896;515;99;40;2;38;.950;3900000;0
4959;75362;514;93;33;2;31;.939;3900000;0
4959;159851;514;0;0;0;0;.00nan;0;0
4960;7534;1481;84;62;6;56;.903;3600000;0
4960;64271;518;0;0;0;0;.00nan;0;0
4960;67764;1481;0;0;0;0;.00nan;0;0
4960;143330;518;65;21;2;19;.905;3600000;0
4961;2410;511;52;23;3;20;.870;3564000;0
4961;38124;512;100;39;1;38;.974;3600000;0
4961;80859;511;0;0;0;0;.00nan;0;0
4961;143083;512;0;0;0;0;.00nan;0;0
4962;6944;520;57;6;0;6;1.000;1242000;0
4962;75362;514;100;21;0;21;1.000;3600000;0
4962;155474;520;31;31;6;25;.806;2358000;0
4962;159851;514;0;0;0;0;.00nan;0;0
4963;16587;513;0;0;0;0;.00nan;0;0
4963;44200;519;0;0;0;0;.00nan;0;0
4963;59614;513;41;32;5;27;.844;3600000;0
4963;143036;519;81;22;1;21;.955;3600000;0
4964;167036;515;71;20;1;19;.950;3600000;0
4964;43896;515;0;0;0;0;.00nan;0;0
4964;86347;524;0;0;0;0;.00nan;0;0
4964;91403;524;76;37;3;34;.919;3583000;0
4965;6947;1872;0;0;0;0;.00nan;0;0
4965;55495;516;0;0;0;0;.00nan;0;0
4965;76951;1872;99;33;1;32;.970;3600000;0
4965;84990;516;65;29;3;26;.897;3580000;0
4966;7332;1472;0;0;0;0;.00nan;0;0
4966;68425;1876;0;0;0;0;.00nan;0;0
4966;86228;1472;58;29;3;26;.897;3566000;0
4966;152478;1876;100;45;2;43;.956;3600000;0
4967;167036;515;0;0;0;0;.00nan;0;0
4967;43896;515;96;31;1;30;.968;3600000;0
4967;44200;519;0;0;0;0;.00nan;0;0
4967;143036;519;81;33;2;31;.939;3561000;0
4968;7332;1472;57;19;3;16;.842;3574000;0
4968;16587;513;0;0;0;0;.00nan;0;0
4968;59614;513;93;37;1;36;.973;3600000;0
4968;86228;1472;0;0;0;0;.00nan;0;0
4969;64271;518;0;0;0;0;.00nan;0;0
4969;86347;524;0;0;0;0;.00nan;0;0
4969;91403;524;83;42;3;39;.929;3600000;0
4969;143330;518;100;26;0;26;1.000;3600000;0
4970;38124;512;49;22;3;19;.864;3600000;0
4970;55495;516;67;10;0;10;1.000;939000;0
4970;84990;516;16;21;6;15;.714;2661000;0
4970;143083;512;0;0;0;0;.00nan;0;0
4971;2410;511;85;17;0;17;1.000;3600000;0
4971;7534;1481;0;0;0;0;.00nan;0;0
4971;67764;1481;91;57;3;54;.947;3600000;0
4971;80859;511;0;0;0;0;.00nan;0;0
4972;6944;520;64;39;4;35;.897;3558000;0
4972;6947;1872;67;24;2;22;.917;3600000;0
4972;76951;1872;0;0;0;0;.00nan;0;0
4972;155474;520;0;0;0;0;.00nan;0;0
4973;68425;1876;0;0;0;0;.00nan;0;0
4973;75362;514;51;21;3;18;.857;3600000;0
4973;152478;1876;72;47;5;42;.894;3571000;0
4973;159851;514;0;0;0;0;.00nan;0;0
4974;44200;519;0;0;0;0;.00nan;0;0
4974;64271;518;0;0;0;0;.00nan;0;0
4974;143036;519;56;31;4;27;.871;3586000;0
4974;143330;518;61;24;3;21;.875;3600000;0
4975;2410;511;80;40;2;38;.950;3900000;0
4975;167036;515;0;0;0;0;.00nan;0;0
4975;43896;515;92;40;2;38;.950;3900000;0
4975;80859;511;0;0;0;0;.00nan;0;0
4976;6944;520;0;0;0;0;.00nan;0;0
4976;7332;1472;0;0;0;0;.00nan;0;0
4976;86228;1472;51;38;6;32;.842;3544000;0
4976;155474;520;55;31;5;26;.839;3600000;0
4977;16587;513;0;0;0;0;.00nan;0;0
4977;59614;513;49;22;3;19;.864;3600000;0
4977;86347;524;0;0;0;0;.00nan;0;0
4977;91403;524;37;28;5;23;.821;3543000;0
4978;55495;516;0;0;0;0;.00nan;0;0
4978;75362;514;70;20;1;19;.950;3600000;0
4978;84990;516;47;37;5;32;.865;3600000;0
4978;159851;514;0;0;0;0;.00nan;0;0
4979;6947;1872;0;0;0;0;.00nan;0;0
4979;7534;1481;91;55;4;51;.927;3600000;0
4979;67764;1481;0;0;0;0;.00nan;0;0
4979;76951;1872;62;14;1;13;.929;3600000;0
4980;38124;512;64;27;3;24;.889;3600000;0
4980;68425;1876;58;35;4;31;.886;3552000;0
4980;143083;512;0;0;0;0;.00nan;0;0
4980;152478;1876;0;0;0;0;.00nan;0;0
4981;6944;520;52;33;6;27;.818;2961000;0
4981;44200;519;0;0;0;0;.00nan;0;0
4981;143036;519;97;21;0;21;1.000;3600000;0
4981;155474;520;47;6;1;5;.833;639000;0
4982;2410;511;93;32;2;30;.938;3771000;0
4982;7332;1472;0;0;0;0;.00nan;0;0
4982;80859;511;0;0;0;0;.00nan;0;0
4982;86228;1472;92;40;1;39;.975;3771000;0
4983;167036;515;57;32;4;28;.875;3600000;0
4983;16587;513;0;0;0;0;.00nan;0;0
4983;43896;515;0;0;0;0;.00nan;0;0
4983;59614;513;99;38;1;37;.974;3600000;0
4984;68425;1876;0;0;0;0;.00nan;0;0
4984;86347;524;0;0;0;0;.00nan;0;0
4984;91403;524;75;27;3;24;.889;3561000;0
4984;152478;1876;76;32;2;30;.938;3600000;0
4985;6947;1872;100;37;1;36;.973;3900000;0
4985;38124;512;94;33;1;32;.970;3900000;0
4985;76951;1872;0;0;0;0;.00nan;0;0
4985;143083;512;0;0;0;0;.00nan;0;0
4986;7534;1481;64;37;4;33;.892;3520000;0
4986;13325;516;0;0;0;0;.00nan;0;0
4986;67764;1481;0;0;0;0;.00nan;0;0
4986;84990;516;57;21;2;19;.905;3600000;0
4987;64271;518;0;0;0;0;.00nan;0;0
4987;75362;514;55;22;3;19;.864;3600000;0
4987;143330;518;26;37;8;29;.784;3600000;0
4987;159851;514;0;0;0;0;.00nan;0;0
4988;167036;515;0;0;0;0;.00nan;0;0
4988;43896;515;56;28;4;24;.857;3600000;0
4988;64271;518;0;0;0;0;.00nan;0;0
4988;143330;518;95;31;1;30;.968;3600000;0
4989;2410;511;70;28;3;25;.893;3600000;0
4989;80859;511;0;0;0;0;.00nan;0;0
4989;86347;524;82;46;3;43;.935;3074000;0
4989;91403;524;34;10;3;7;.700;526000;0
4990;6944;520;0;0;0;0;.00nan;0;0
4990;7534;1481;100;41;1;40;.976;3600000;0
4990;67764;1481;0;0;0;0;.00nan;0;0
4990;155474;520;67;26;2;24;.923;3545000;0
4991;38124;512;96;35;1;34;.971;3600000;0
4991;75362;514;65;23;2;21;.913;3547000;0
4991;143083;512;0;0;0;0;.00nan;0;0
4991;159851;514;0;0;0;0;.00nan;0;0
4992;7332;1472;0;0;0;0;.00nan;0;0
4992;13325;516;0;0;0;0;.00nan;0;0
4992;84990;516;40;31;5;26;.839;3600000;0
4992;86228;1472;65;23;2;21;.913;3600000;0
4993;6947;1872;0;0;0;0;.00nan;0;0
4993;44200;519;0;0;0;0;.00nan;0;0
4993;76951;1872;64;25;3;22;.880;3600000;0
4993;143036;519;52;32;5;27;.844;3523000;0
4994;16587;513;0;0;0;0;.00nan;0;0
4994;59614;513;80;27;2;25;.926;3600000;0
4994;68425;1876;0;0;0;0;.00nan;0;0
4994;152478;1876;72;32;3;29;.906;3566000;0
4995;16587;513;0;0;0;0;.00nan;0;0
4995;59614;513;74;30;2;28;.933;3600000;0
4995;64271;518;0;0;0;0;.00nan;0;0
4995;143330;518;58;26;3;23;.885;3563000;0
4996;2410;511;83;31;2;29;.935;3600000;0
4996;68425;1876;0;0;0;0;.00nan;0;0
4996;80859;511;0;0;0;0;.00nan;0;0
4996;152478;1876;98;58;3;55;.948;3570000;0
4997;167036;515;0;0;0;0;.00nan;0;0
4997;6944;520;70;33;3;30;.909;3600000;0
4997;43896;515;80;46;4;42;.913;3550000;0
4997;155474;520;0;0;0;0;.00nan;0;0
4998;38124;512;59;23;3;20;.870;3600000;0
4998;44200;519;0;0;0;0;.00nan;0;0
4998;143036;519;36;36;6;30;.833;3600000;0
4998;143083;512;0;0;0;0;.00nan;0;0
4999;13325;516;0;0;0;0;.00nan;0;0
4999;84990;516;49;20;3;17;.850;3600000;0
4999;86347;524;0;0;0;0;.00nan;0;0
4999;91403;524;100;40;0;40;1.000;3600000;0
5000;6947;1872;0;0;0;0;.00nan;0;0
5000;7332;1472;0;0;0;0;.00nan;0;0
5000;76951;1872;63;37;5;32;.865;3526000;0
5000;86228;1472;84;39;3;36;.923;3600000;0
5001;7534;1481;28;27;6;21;.778;2692000;0
5001;67764;1481;29;9;3;6;.667;908000;0
5001;75362;514;85;18;0;18;1.000;3600000;0
5001;159851;514;0;0;0;0;.00nan;0;0
5002;2410;511;63;19;2;17;.895;3600000;0
5002;64271;518;0;0;0;0;.00nan;0;0
5002;80859;511;0;0;0;0;.00nan;0;0
5002;143330;518;74;44;4;40;.909;3600000;0
5003;7534;1481;73;49;5;44;.898;3600000;0
5003;44200;519;0;0;0;0;.00nan;0;0
5003;67764;1481;0;0;0;0;.00nan;0;0
5003;143036;519;67;22;2;20;.909;3600000;0
5004;7332;1472;0;0;0;0;.00nan;0;0
5004;75362;514;100;24;0;24;1.000;3600000;0
5004;86228;1472;69;36;3;33;.917;3600000;0
5004;159851;514;0;0;0;0;.00nan;0;0
5005;6947;1872;0;0;0;0;.00nan;0;0
5005;16587;513;97;52;4;48;.923;3600000;0
5005;59614;513;0;0;0;0;.00nan;0;0
5005;76951;1872;89;30;1;29;.967;3600000;0
5006;167036;515;0;0;0;0;.00nan;0;0
5006;13325;516;0;0;0;0;.00nan;0;0
5006;43896;515;47;26;4;22;.846;3600000;0
5006;84990;516;76;27;1;26;.963;3600000;0
5007;38124;512;85;28;1;27;.964;3900000;0
5007;86347;524;0;0;0;0;.00nan;0;0
5007;91403;524;95;31;1;30;.968;3900000;0
5007;143083;512;0;0;0;0;.00nan;0;0
5008;6944;520;0;0;0;0;.00nan;0;0
5008;68425;1876;0;0;0;0;.00nan;0;0
5008;152478;1876;46;33;5;28;.848;3555000;0
5008;155474;520;67;29;3;26;.897;3600000;0
5009;64271;518;61;16;1;15;.938;3600000;0
5009;68425;1876;0;0;0;0;.00nan;0;0
5009;143330;518;0;0;0;0;.00nan;0;0
5009;152478;1876;88;38;2;36;.947;3592000;0
5010;6944;520;60;33;4;29;.879;3600000;0
5010;16587;513;0;0;0;0;.00nan;0;0
5010;59614;513;100;37;0;37;1.000;3600000;0
5010;155474;520;0;0;0;0;.00nan;0;0
5011;7332;1472;0;0;0;0;.00nan;0;0
5011;38124;512;0;0;0;0;.00nan;0;0
5011;86228;1472;64;19;1;18;.947;3600000;0
5011;143083;512;85;31;2;29;.935;3562000;0
5012;2410;511;66;21;3;18;.857;3600000;0
5012;13325;516;0;0;0;0;.00nan;0;0
5012;80859;511;0;0;0;0;.00nan;0;0
5012;84990;516;38;30;5;25;.833;3569000;0
5013;167036;515;0;0;0;0;.00nan;0;0
5013;7534;1481;91;32;1;31;.969;3600000;0
5013;43896;515;90;17;0;17;1.000;3600000;0
5013;67764;1481;0;0;0;0;.00nan;0;0
5014;6947;1872;69;22;1;21;.955;3600000;0
5014;76951;1872;0;0;0;0;.00nan;0;0
5014;86347;524;0;0;0;0;.00nan;0;0
5014;91403;524;66;37;4;33;.892;3600000;0
5015;44200;519;0;0;0;0;.00nan;0;0
5015;75362;514;100;37;1;36;.973;3600000;0
5015;143036;519;74;32;3;29;.906;3556000;0
5015;159851;514;0;0;0;0;.00nan;0;0
5016;6944;520;0;0;0;0;.00nan;0;0
5016;64271;518;0;0;0;0;.00nan;0;0
5016;143330;518;68;40;4;36;.900;3900000;0
5016;155474;520;67;38;4;34;.895;3900000;0
5017;2410;511;61;19;2;17;.895;3600000;0
5017;6947;1872;0;0;0;0;.00nan;0;0
5017;76951;1872;86;46;4;42;.913;3542000;0
5017;80859;511;0;0;0;0;.00nan;0;0
5018;7332;1472;0;0;0;0;.00nan;0;0
5018;44200;519;63;24;2;22;.917;3600000;0
5018;86228;1472;64;28;3;25;.893;3583000;0
5018;143036;519;0;0;0;0;.00nan;0;0
5019;16587;513;0;0;0;0;.00nan;0;0
5019;59614;513;74;36;4;32;.889;3605000;0
5019;75362;514;62;38;5;33;.868;3605000;0
5019;159851;514;0;0;0;0;.00nan;0;0
5020;167036;515;0;0;0;0;.00nan;0;0
5020;38124;512;80;27;2;25;.926;3600000;0
5020;43896;515;88;37;3;34;.919;3600000;0
5020;143083;512;0;0;0;0;.00nan;0;0
5021;7534;1481;71;29;3;26;.897;3591000;0
5021;67764;1481;0;0;0;0;.00nan;0;0
5021;86347;524;0;0;0;0;.00nan;0;0
5021;91403;524;76;25;1;24;.960;3600000;0
5022;13325;516;0;0;0;0;.00nan;0;0
5022;68425;1876;0;0;0;0;.00nan;0;0
5022;84990;516;74;27;2;25;.926;3900000;0
5022;152478;1876;100;42;2;40;.952;3900000;0
5023;2410;511;68;28;3;25;.893;3600000;0
5023;6944;520;62;35;4;31;.886;3591000;0
5023;80859;511;0;0;0;0;.00nan;0;0
5023;155474;520;0;0;0;0;.00nan;0;0
5024;44200;519;64;18;2;16;.889;3900000;0
5024;68425;1876;0;0;0;0;.00nan;0;0
5024;143036;519;0;0;0;0;.00nan;0;0
5024;152478;1876;84;31;2;29;.935;3900000;0
5025;16587;513;0;0;0;0;.00nan;0;0
5025;38124;512;77;35;3;32;.914;3600000;0
5025;59614;513;91;39;2;37;.949;3600000;0
5025;143083;512;0;0;0;0;.00nan;0;0
5026;13325;516;84;46;4;42;.913;3659000;0
5026;64271;518;0;0;0;0;.00nan;0;0
5026;84990;516;0;0;0;0;.00nan;0;0
5026;143330;518;50;28;5;23;.821;3659000;0
5027;7332;1472;0;0;0;0;.00nan;0;0
5027;7534;1481;98;46;2;44;.957;3600000;0
5027;67764;1481;0;0;0;0;.00nan;0;0
5027;86228;1472;87;20;0;20;1.000;3600000;0
5028;167036;515;0;0;0;0;.00nan;0;0
5028;6947;1872;0;0;0;0;.00nan;0;0
5028;43896;515;73;38;4;34;.895;3600000;0
5028;76951;1872;100;26;0;26;1.000;3600000;0
5029;75362;514;0;0;0;0;.00nan;0;0
5029;86347;524;0;0;0;0;.00nan;0;0
5029;91403;524;98;40;1;39;.975;3600000;0
5029;159851;514;60;18;2;16;.889;3587000;0
5033;55495;516;0;0;0;0;.00nan;0;0
5033;143036;516;61;19;3;16;.842;3600000;0
5033;143083;512;0;0;0;0;.00nan;0;0
5033;152202;512;70;41;4;37;.902;3546000;0
5037;6944;520;42;20;4;16;.800;3600000;0
5037;6948;524;0;0;0;0;.00nan;0;0
5037;143063;524;75;47;5;42;.894;3573000;0
5037;155474;520;0;0;0;0;.00nan;0;0
5041;7487;513;0;0;0;0;.00nan;0;0
5041;16587;513;80;27;1;26;.963;3600000;0
5041;143330;519;66;25;2;23;.920;3550000;0
5041;143421;519;0;0;0;0;.00nan;0;0
5043;167036;515;85;16;0;16;1.000;3815000;0
5043;7534;1481;92;52;1;51;.981;3815000;0
5043;67764;1481;0;0;0;0;.00nan;0;0
5043;68565;515;0;0;0;0;.00nan;0;0
5047;6948;524;0;0;0;0;.00nan;0;0
5047;143063;524;93;40;2;38;.950;3900000;0
5047;143330;519;71;31;2;29;.935;3900000;0
5047;143421;519;0;0;0;0;.00nan;0;0
5049;7534;1481;100;33;0;33;1.000;3600000;0
5049;67764;1481;0;0;0;0;.00nan;0;0
5049;143083;512;59;16;1;15;.938;3544000;0
5049;152202;512;0;0;0;0;.00nan;0;0
5051;167036;515;92;37;1;36;.973;3900000;0
5051;63107;514;82;25;1;24;.960;3900000;0
5051;68565;515;0;0;0;0;.00nan;0;0
5051;159851;514;0;0;0;0;.00nan;0;0
5053;6944;520;0;0;0;0;.00nan;0;0
5053;7487;513;0;0;0;0;.00nan;0;0
5053;16587;513;81;47;4;43;.915;3600000;0
5053;155474;520;81;30;2;28;.933;3600000;0
5059;6947;1872;79;28;2;26;.929;3900000;0
5059;55495;516;0;0;0;0;.00nan;0;0
5059;76951;1872;0;0;0;0;.00nan;0;0
5059;143036;516;71;27;2;25;.926;3900000;0
5061;68425;1876;0;0;0;0;.00nan;0;0
5061;143083;512;0;0;0;0;.00nan;0;0
5061;152202;512;61;13;1;12;.923;3600000;0
5061;152478;1876;55;33;4;29;.879;3600000;0
5069;7534;1481;80;40;3;37;.925;3600000;0
5069;63107;514;0;0;0;0;.00nan;0;0
5069;67764;1481;0;0;0;0;.00nan;0;0
5069;159851;514;69;15;1;14;.933;3600000;0
5071;167036;515;0;0;0;0;.00nan;0;0
5071;6948;524;63;39;5;34;.872;3600000;0
5071;68565;515;56;17;2;15;.882;3600000;0
5071;143063;524;0;0;0;0;.00nan;0;0
5075;55495;516;0;0;0;0;.00nan;0;0
5075;143036;516;62;22;3;19;.864;3600000;0
5075;143083;512;34;28;5;23;.821;3600000;0
5075;152202;512;0;0;0;0;.00nan;0;0
5077;7487;513;0;0;0;0;.00nan;0;0
5077;16587;513;67;39;4;35;.897;3600000;0
5077;63107;514;78;29;1;28;.966;3600000;0
5077;159851;514;0;0;0;0;.00nan;0;0
5079;6948;524;0;0;0;0;.00nan;0;0
5079;7534;1481;68;22;1;21;.955;3600000;0
5079;67764;1481;0;0;0;0;.00nan;0;0
5079;143063;524;66;28;3;25;.893;3547000;0
5085;6944;520;83;29;1;28;.966;3600000;0
5085;68425;1876;0;0;0;0;.00nan;0;0
5085;152478;1876;56;30;4;26;.867;3600000;0
5085;155474;520;0;0;0;0;.00nan;0;0
5087;6947;1872;0;0;0;0;.00nan;0;0
5087;6948;524;100;27;0;27;1.000;3837000;0
5087;76951;1872;90;36;1;35;.972;3837000;0
5087;143063;524;0;0;0;0;.00nan;0;0
5089;6944;520;0;0;0;0;.00nan;0;0
5089;55495;516;0;0;0;0;.00nan;0;0
5089;143036;516;72;29;2;27;.931;3600000;0
5089;155474;520;55;34;4;30;.882;3584000;0
5095;7487;513;68;22;2;20;.909;3600000;0
5095;7534;1481;0;0;0;0;.00nan;0;0
5095;16587;513;0;0;0;0;.00nan;0;0
5095;67764;1481;62;36;4;32;.889;3532000;0
5097;63107;514;0;0;0;0;.00nan;0;0
5097;143083;512;0;0;0;0;.00nan;0;0
5097;152202;512;62;31;3;28;.903;3600000;0
5097;159851;514;95;18;0;18;1.000;3600000;0
5099;68425;1876;82;33;2;31;.939;3900000;0
5099;143330;519;60;21;2;19;.905;3900000;0
5099;143421;519;0;0;0;0;.00nan;0;0
5099;152478;1876;0;0;0;0;.00nan;0;0
5101;7534;1481;87;37;2;35;.946;3600000;0
5101;67764;1481;0;0;0;0;.00nan;0;0
5101;143083;512;37;23;5;18;.783;3600000;0
5101;152202;512;0;0;0;0;.00nan;0;0
5103;167036;515;72;26;1;25;.962;3600000;0
5103;6947;1872;0;0;0;0;.00nan;0;0
5103;68565;515;0;0;0;0;.00nan;0;0
5103;76951;1872;87;44;3;41;.932;3519000;0
5105;6948;524;55;37;5;32;.865;3600000;0
5105;68425;1876;0;0;0;0;.00nan;0;0
5105;143063;524;0;0;0;0;.00nan;0;0
5105;152478;1876;76;27;1;26;.963;3600000;0
5107;6944;520;45;22;3;19;.864;3561000;0
5107;55495;516;0;0;0;0;.00nan;0;0
5107;143036;516;84;29;1;28;.966;3600000;0
5107;155474;520;0;0;0;0;.00nan;0;0
5115;6948;524;0;0;0;0;.00nan;0;0
5115;63107;514;0;0;0;0;.00nan;0;0
5115;143063;524;78;38;3;35;.921;3600000;0
5115;159851;514;53;16;2;14;.875;3600000;0
5117;6947;1872;70;29;3;26;.897;3572000;0
5117;7487;513;0;0;0;0;.00nan;0;0
5117;16587;513;64;22;2;20;.909;3600000;0
5117;76951;1872;0;0;0;0;.00nan;0;0
5123;7534;1481;0;0;0;0;.00nan;0;0
5123;67764;1481;68;44;5;39;.886;3600000;0
5123;143083;512;0;0;0;0;.00nan;0;0
5123;152202;512;60;8;1;7;.875;3600000;0
5125;167036;515;0;0;0;0;.00nan;0;0
5125;6944;520;0;0;0;0;.00nan;0;0
5125;68565;515;87;31;1;30;.968;3900000;0
5125;155474;520;67;19;1;18;.947;3900000;0
5127;55495;516;45;21;3;18;.857;3600000;0
5127;143036;516;0;0;0;0;.00nan;0;0
5127;143330;519;39;21;4;17;.810;3550000;0
5127;143421;519;0;0;0;0;.00nan;0;0
96;7332;1472;0;0;0;0;.00nan;0;0
96;68425;1876;0;0;0;0;.00nan;0;0
96;80859;1876;85;58;5;53;.914;3600000;0
96;86228;1472;74;20;1;19;.950;3600000;0
97;167036;515;0;0;0;0;.00nan;0;0
97;43896;515;86;40;3;37;.925;4993000;0
97;44200;519;0;0;0;0;.00nan;0;0
97;143036;519;76;43;4;39;.907;4993000;0
98;16587;513;0;0;0;0;.00nan;0;0
98;59614;513;75;28;2;26;.929;3600000;0
98;64271;518;43;10;2;8;.800;1281000;0
98;143330;518;65;31;4;27;.871;2319000;0
99;13325;516;0;0;0;0;.00nan;0;0
99;84990;516;93;43;2;41;.953;3600000;0
99;86347;524;0;0;0;0;.00nan;0;0
99;91403;524;59;37;3;34;.919;3585000;0
100;7332;1472;0;0;0;0;.00nan;0;0
100;68425;1876;0;0;0;0;.00nan;0;0
100;80859;1876;70;34;3;31;.912;3600000;0
100;86228;1472;94;20;0;20;1.000;3600000;0
101;167036;515;0;0;0;0;.00nan;0;0
101;169323;519;0;0;0;0;.00nan;0;0
101;43896;515;80;37;3;34;.919;3524000;0
101;143036;519;88;31;1;30;.968;3600000;0
102;16587;513;0;0;0;0;.00nan;0;0
102;59614;513;99;54;2;52;.963;4179000;0
102;64271;518;0;0;0;0;.00nan;0;0
102;143330;518;84;41;3;38;.927;4179000;0
103;13325;516;0;0;0;0;.00nan;0;0
103;84990;516;65;35;4;31;.886;3600000;0
103;86347;524;0;0;0;0;.00nan;0;0
103;91403;524;80;24;1;23;.958;3600000;0
104;7332;1472;0;0;0;0;.00nan;0;0
104;68425;1876;0;0;0;0;.00nan;0;0
104;80859;1876;100;30;0;30;1.000;3600000;0
104;86228;1472;73;32;3;29;.906;3600000;0
105;167036;515;0;0;0;0;.00nan;0;0
105;169323;519;0;0;0;0;.00nan;0;0
105;43896;515;76;28;2;26;.929;3600000;0
105;143036;519;65;30;3;27;.900;3600000;0
106;16587;513;0;0;0;0;.00nan;0;0
106;59614;513;100;32;0;32;1.000;3600000;0
106;64271;518;0;0;0;0;.00nan;0;0
106;143330;518;88;38;3;35;.921;3600000;0
107;13325;516;0;0;0;0;.00nan;0;0
107;84990;516;92;51;2;49;.961;4265000;0
107;86347;524;0;0;0;0;.00nan;0;0
107;91403;524;59;23;3;20;.870;4227000;0
235;7332;1472;0;0;0;0;.00nan;0;0
235;68425;1876;0;0;0;0;.00nan;0;0
235;80859;1876;92;47;1;46;.979;5069000;0
235;86228;1472;80;19;0;19;1.000;5069000;0
236;167036;515;0;0;0;0;.00nan;0;0
236;169323;519;0;0;0;0;.00nan;0;0
236;43896;515;68;38;4;34;.895;3600000;0
236;143036;519;45;31;5;26;.839;3600000;0
237;13325;516;0;0;0;0;.00nan;0;0
237;84990;516;43;24;4;20;.833;3600000;0
237;86347;524;0;0;0;0;.00nan;0;0
237;91403;524;100;34;0;34;1.000;3600000;0
375;13325;516;0;0;0;0;.00nan;0;0
375;84990;516;61;31;3;28;.903;3532000;0
375;86347;524;0;0;0;0;.00nan;0;0
375;91403;524;75;21;1;20;.952;3600000;0
462;38124;512;67;28;3;25;.893;4272000;0
462;86347;524;0;0;0;0;.00nan;0;0
462;91403;524;99;45;2;43;.956;4272000;0
462;143083;512;0;0;0;0;.00nan;0;0
463;167036;515;68;20;1;19;.950;3323000;0
463;43896;515;23;4;3;1;.250;277000;0
463;75362;514;54;16;2;14;.875;3600000;0
463;159851;514;0;0;0;0;.00nan;0;0
464;6947;1872;0;0;0;0;.00nan;0;0
464;7332;1472;0;0;0;0;.00nan;0;0
464;76951;1872;100;32;0;32;1.000;3600000;0
464;86228;1472;72;39;4;35;.897;3600000;0
465;2410;511;0;0;0;0;.00nan;0;0
465;16587;513;0;0;0;0;.00nan;0;0
465;59614;513;98;40;1;39;.975;3600000;0
465;152478;511;59;23;2;21;.913;3554000;0
466;38124;512;42;20;4;16;.800;3600000;0
466;86347;524;0;0;0;0;.00nan;0;0
466;91403;524;72;45;5;40;.889;3600000;0
466;143083;512;0;0;0;0;.00nan;0;0
467;167036;515;0;0;0;0;.00nan;0;0
467;43896;515;57;35;4;31;.886;3600000;0
467;75362;514;85;27;1;26;.963;3600000;0
467;159851;514;0;0;0;0;.00nan;0;0
468;6947;1872;0;0;0;0;.00nan;0;0
468;7332;1472;0;0;0;0;.00nan;0;0
468;76951;1872;95;43;2;41;.953;4142000;0
468;86228;1472;64;33;3;30;.909;4142000;0
469;2410;511;0;0;0;0;.00nan;0;0
469;16587;513;0;0;0;0;.00nan;0;0
469;59614;513;76;32;2;30;.938;3591000;0
469;152478;511;80;28;1;27;.964;3600000;0
470;38124;512;69;22;2;20;.909;3600000;0
470;86347;524;0;0;0;0;.00nan;0;0
470;91403;524;100;30;0;30;1.000;3600000;0
470;143083;512;0;0;0;0;.00nan;0;0
471;167036;515;0;0;0;0;.00nan;0;0
471;43896;515;72;31;2;29;.935;3567000;0
471;75362;514;99;40;1;39;.975;3600000;0
471;159851;514;0;0;0;0;.00nan;0;0
472;6947;1872;0;0;0;0;.00nan;0;0
472;7332;1472;0;0;0;0;.00nan;0;0
472;76951;1872;66;32;3;29;.906;3528000;0
472;86228;1472;77;21;1;20;.952;3600000;0
473;2410;511;0;0;0;0;.00nan;0;0
473;16587;513;0;0;0;0;.00nan;0;0
473;59614;513;64;23;2;21;.913;3600000;0
473;152478;511;42;28;5;23;.821;3600000;0
474;38124;512;100;29;0;29;1.000;3600000;0
474;86347;524;0;0;0;0;.00nan;0;0
474;91403;524;68;33;3;30;.909;3600000;0
474;143083;512;0;0;0;0;.00nan;0;0
475;167036;515;0;0;0;0;.00nan;0;0
475;43896;515;73;32;3;29;.906;5040000;0
475;75362;514;89;38;2;36;.947;5040000;0
475;159851;514;0;0;0;0;.00nan;0;0
476;6947;1872;47;8;1;7;.875;413000;0
476;7332;1472;0;0;0;0;.00nan;0;0
476;76951;1872;46;35;6;29;.829;3187000;0
476;86228;1472;88;30;2;28;.933;3600000;0
477;2410;511;0;0;0;0;.00nan;0;0
477;16587;513;0;0;0;0;.00nan;0;0
477;59614;513;76;40;4;36;.900;3557000;0
477;152478;511;71;29;2;27;.931;3600000;0
695;38124;512;89;16;0;16;1.000;3600000;0
695;86347;524;0;0;0;0;.00nan;0;0
695;91403;524;67;30;3;27;.900;3600000;0
695;143083;512;0;0;0;0;.00nan;0;0
696;6947;1872;0;0;0;0;.00nan;0;0
696;7332;1472;0;0;0;0;.00nan;0;0
696;76951;1872;86;51;4;47;.922;3600000;0
696;86228;1472;80;27;1;26;.963;3600000;0
697;2410;511;50;1;0;1;1.000;313000;0
697;16587;513;0;0;0;0;.00nan;0;0
697;59614;513;81;29;2;27;.931;3600000;0
697;152478;511;17;22;6;16;.727;3287000;0
792;38124;512;69;32;2;30;.938;3600000;0
792;86347;524;0;0;0;0;.00nan;0;0
792;91403;524;56;31;4;27;.871;3600000;0
792;143083;512;0;0;0;0;.00nan;0;0
793;6947;1872;0;0;0;0;.00nan;0;0
793;7332;1472;0;0;0;0;.00nan;0;0
793;76951;1872;92;48;3;45;.938;3929000;0
793;86228;1472;72;24;2;22;.917;3940000;0
794;2410;511;0;0;0;0;.00nan;0;0
794;16587;513;0;0;0;0;.00nan;0;0
794;59614;513;72;24;1;23;.958;3600000;0
794;152478;511;40;23;4;19;.826;3600000;0
908;16587;513;0;0;0;0;.00nan;0;0
908;38124;512;77;28;2;26;.929;3600000;0
908;59614;513;70;37;3;34;.919;3597000;0
908;143083;512;0;0;0;0;.00nan;0;0
909;7332;1472;0;0;0;0;.00nan;0;0
909;75362;514;62;23;3;20;.870;3600000;0
909;86228;1472;50;39;6;33;.846;3600000;0
909;159851;514;0;0;0;0;.00nan;0;0
910;16587;513;0;0;0;0;.00nan;0;0
910;38124;512;93;19;0;19;1.000;3600000;0
910;59614;513;69;39;3;36;.923;3600000;0
910;143083;512;0;0;0;0;.00nan;0;0
911;7332;1472;0;0;0;0;.00nan;0;0
911;75362;514;90;15;0;15;1.000;3600000;0
911;86228;1472;84;25;1;24;.960;3585000;0
911;159851;514;0;0;0;0;.00nan;0;0
912;16587;513;0;0;0;0;.00nan;0;0
912;38124;512;39;14;3;11;.786;3600000;0
912;59614;513;65;35;4;31;.886;3573000;0
912;143083;512;0;0;0;0;.00nan;0;0
913;7332;1472;0;0;0;0;.00nan;0;0
913;75362;514;77;36;3;33;.917;3548000;0
913;86228;1472;87;26;1;25;.962;3600000;0
913;159851;514;0;0;0;0;.00nan;0;0
914;16587;513;0;0;0;0;.00nan;0;0
914;38124;512;81;26;2;24;.923;3600000;0
914;59614;513;64;32;4;28;.875;3549000;0
914;143083;512;0;0;0;0;.00nan;0;0
915;7332;1472;0;0;0;0;.00nan;0;0
915;75362;514;95;41;2;39;.951;3547000;0
915;86228;1472;75;13;0;13;1.000;3600000;0
915;159851;514;0;0;0;0;.00nan;0;0
1077;7332;1472;0;0;0;0;.00nan;0;0
1077;75362;514;94;39;2;37;.949;4257000;0
1077;86228;1472;68;29;3;26;.897;4257000;0
1077;159851;514;0;0;0;0;.00nan;0;0
1112;7332;1472;53;8;1;7;.875;865000;0
1112;75362;514;44;38;6;32;.842;3600000;0
1112;86228;1472;5;13;6;7;.538;2692000;0
1112;159851;514;0;0;0;0;.00nan;0;0
1189;38124;512;72;25;2;23;.920;3600000;0
1189;75362;514;65;28;3;25;.893;3586000;0
1189;143083;512;0;0;0;0;.00nan;0;0
1189;159851;514;0;0;0;0;.00nan;0;0
1190;38124;512;96;23;0;23;1.000;3600000;0
1190;75362;514;79;29;2;27;.931;3600000;0
1190;143083;512;0;0;0;0;.00nan;0;0
1190;159851;514;0;0;0;0;.00nan;0;0
1191;38124;512;95;29;1;28;.966;3600000;0
1191;75362;514;73;29;2;27;.931;3542000;0
1191;143083;512;0;0;0;0;.00nan;0;0
1191;159851;514;0;0;0;0;.00nan;0;0
1192;38124;512;49;25;4;21;.840;3600000;0
1192;75362;514;87;26;1;25;.962;3600000;0
1192;143083;512;0;0;0;0;.00nan;0;0
1192;159851;514;0;0;0;0;.00nan;0;0
5128;11107;637;0;0;0;0;.00nan;0;0
5128;170144;637;59;31;4;27;.871;3610000;0
5128;-1;628;0;0;0;0;.00nan;0;0
5128;-1;628;47;28;5;23;.821;3610000;0
5129;169552;642;0;0;0;0;.00nan;0;0
5129;24593;642;85;42;3;39;.929;3522000;0
5129;85546;631;0;0;0;0;.00nan;0;0
5129;87603;631;71;21;1;20;.952;3600000;0
5130;177631;1813;0;0;0;0;.00nan;0;0
5130;8426;629;44;28;5;23;.821;3079000;0
5130;174334;1813;67;36;3;33;.917;3600000;0
5130;85644;629;41;3;1;2;.667;521000;0
5131;11068;641;64;27;2;25;.926;3304000;0
5131;165867;627;20;19;6;13;.684;3169000;0
5131;43064;627;55;1;0;1;1.000;731000;0
5131;160577;641;23;11;4;7;.636;596000;0
5132;3821;636;72;32;3;29;.906;3881000;0
5132;73274;647;0;0;0;0;.00nan;0;0
5132;80222;647;79;34;2;32;.941;3881000;0
5132;151728;636;0;0;0;0;.00nan;0;0
5133;8942;639;0;0;0;0;.00nan;0;0
5133;17625;651;67;24;2;22;.917;2454000;0
5133;58112;651;20;11;4;7;.636;1146000;0
5133;86485;639;86;34;1;33;.971;3600000;0
5134;-1;625;70;27;3;24;.889;3600000;0
5134;-1;625;0;0;0;0;.00nan;0;0
5134;59239;1814;53;40;5;35;.875;3586000;0
5134;72747;1814;0;0;0;0;.00nan;0;0
5135;8942;639;46;9;2;7;.778;1528000;0
5135;11107;637;0;0;0;0;.00nan;0;0
5135;170144;637;85;39;3;36;.923;3600000;0
5135;86485;639;68;37;4;33;.892;2072000;0
5136;177631;1813;0;0;0;0;.00nan;0;0
5136;165867;627;82;33;2;31;.939;3600000;0
5136;174334;1813;51;41;6;35;.854;3600000;0
5136;43064;627;0;0;0;0;.00nan;0;0
5137;11068;641;0;0;0;0;.00nan;0;0
5137;57859;1814;99;21;0;21;1.000;3600000;0
5137;59239;1814;0;0;0;0;.00nan;0;0
5137;160577;641;39;20;3;17;.850;3600000;0
5138;-1;628;0;0;0;0;.00nan;0;0
5138;-1;628;92;28;1;27;.964;3600000;0
5138;85546;631;56;32;4;28;.875;3600000;0
5138;87603;631;0;0;0;0;.00nan;0;0
5139;8426;629;87;29;1;28;.966;3600000;0
5139;17625;651;0;0;0;0;.00nan;0;0
5139;85644;629;0;0;0;0;.00nan;0;0
5139;149584;651;44;32;5;27;.844;3600000;0
5140;3821;636;0;0;0;0;.00nan;0;0
5140;169552;642;0;0;0;0;.00nan;0;0
5140;24593;642;56;21;2;19;.905;3720000;0
5140;151728;636;81;35;3;32;.914;3720000;0
5141;-1;625;48;33;5;28;.848;3600000;0
5141;-1;625;0;0;0;0;.00nan;0;0
5141;73274;647;0;0;0;0;.00nan;0;0
5141;80222;647;80;22;1;21;.955;3600000;0
5142;177631;1813;0;0;0;0;.00nan;0;0
5142;174334;1813;59;18;2;16;.889;3600000;0
5142;57859;1814;68;33;3;30;.909;3574000;0
5142;59239;1814;0;0;0;0;.00nan;0;0
5143;8426;629;57;38;4;34;.895;3578000;0
5143;8942;639;0;0;0;0;.00nan;0;0
5143;85644;629;0;0;0;0;.00nan;0;0
5143;86485;639;78;32;3;29;.906;3600000;0
5144;165867;627;0;0;0;0;.00nan;0;0
5144;43064;627;56;33;4;29;.879;3583000;0
5144;85546;631;72;34;3;31;.912;3600000;0
5144;87603;631;0;0;0;0;.00nan;0;0
5145;17625;651;0;0;0;0;.00nan;0;0
5145;169552;642;0;0;0;0;.00nan;0;0
5145;24593;642;70;19;2;17;.895;3600000;0
5145;149584;651;58;34;5;29;.853;3600000;0
5146;11068;641;0;0;0;0;.00nan;0;0
5146;-1;625;0;0;0;0;.00nan;0;0
5146;-1;625;74;26;1;25;.962;3600000;0
5146;160577;641;92;48;2;46;.958;3600000;0
5147;3821;636;68;20;1;19;.950;3030000;0
5147;11107;637;0;0;0;0;.00nan;0;0
5147;170144;637;39;29;5;24;.828;3585000;0
5147;151728;636;34;7;3;4;.571;570000;0
5148;-1;628;0;0;0;0;.00nan;0;0
5148;-1;628;72;24;2;22;.917;3600000;0
5148;73274;647;31;18;5;13;.722;1662000;0
5148;80222;647;87;29;1;28;.966;1938000;0
5149;8942;639;0;0;0;0;.00nan;0;0
5149;85546;631;45;16;2;14;.875;3600000;0
5149;86485;639;63;49;5;44;.898;3600000;0
5149;87603;631;0;0;0;0;.00nan;0;0
5150;165867;627;65;28;3;25;.893;3538000;0
5150;43064;627;0;0;0;0;.00nan;0;0
5150;73274;647;0;0;0;0;.00nan;0;0
5150;80222;647;62;24;2;22;.917;3600000;0
5151;11107;637;0;0;0;0;.00nan;0;0
5151;170144;637;41;21;4;17;.810;3588000;0
5151;57859;1814;73;33;3;30;.909;3600000;0
5151;59239;1814;0;0;0;0;.00nan;0;0
5152;8426;629;0;0;0;0;.00nan;0;0
5152;169552;642;0;0;0;0;.00nan;0;0
5152;24593;642;100;33;0;33;1.000;3600000;0
5152;85644;629;96;39;1;38;.974;3570000;0
5153;3821;636;0;0;0;0;.00nan;0;0
5153;-1;628;0;0;0;0;.00nan;0;0
5153;-1;628;61;20;2;18;.900;3900000;0
5153;151728;636;95;42;2;40;.952;3900000;0
5154;11068;641;0;0;0;0;.00nan;0;0
5154;17625;651;87;26;2;24;.923;3900000;0
5154;149584;651;0;0;0;0;.00nan;0;0
5154;160577;641;54;20;2;18;.900;3900000;0
5155;177631;1813;0;0;0;0;.00nan;0;0
5155;-1;625;47;26;4;22;.846;3600000;0
5155;174334;1813;48;33;5;28;.848;3600000;0
5155;-1;625;0;0;0;0;.00nan;0;0
5156;177631;1813;0;0;0;0;.00nan;0;0
5156;8942;639;0;0;0;0;.00nan;0;0
5156;174334;1813;57;21;2;19;.905;3837000;0
5156;86485;639;89;40;3;37;.925;3837000;0
5157;3821;636;70;22;1;21;.955;3600000;0
5157;8426;629;70;32;3;29;.906;3548000;0
5157;85644;629;0;0;0;0;.00nan;0;0
5157;151728;636;0;0;0;0;.00nan;0;0
5158;165867;627;0;0;0;0;.00nan;0;0
5158;-1;628;17;29;7;22;.759;2297000;0
5158;-1;628;41;8;2;6;.750;1303000;0
5158;43064;627;82;34;2;32;.941;3600000;0
5159;11068;641;0;0;0;0;.00nan;0;0
5159;169552;642;0;0;0;0;.00nan;0;0
5159;24593;642;73;30;2;28;.933;3600000;0
5159;160577;641;43;33;5;28;.848;3600000;0
5160;57859;1814;81;30;2;28;.933;3600000;0
5160;59239;1814;0;0;0;0;.00nan;0;0
5160;73274;647;0;0;0;0;.00nan;0;0
5160;80222;647;64;42;5;37;.881;3600000;0
5161;17625;651;53;6;0;6;1.000;411000;0
5161;85546;631;61;29;3;26;.897;3600000;0
5161;87603;631;0;0;0;0;.00nan;0;0
5161;149584;651;18;26;7;19;.731;3189000;0
5162;11107;637;0;0;0;0;.00nan;0;0
5162;170144;637;68;28;2;26;.929;3900000;0
5162;-1;625;78;30;2;28;.933;3900000;0
5162;-1;625;0;0;0;0;.00nan;0;0
5163;3821;636;0;0;0;0;.00nan;0;0
5163;8942;639;0;0;0;0;.00nan;0;0
5163;86485;639;52;14;2;12;.857;3600000;0
5163;151728;636;46;27;4;23;.852;3600000;0
5164;165867;627;67;18;1;17;.944;3600000;0
5164;-1;625;32;17;4;13;.765;1976000;0
5164;-1;625;35;20;4;16;.800;1624000;0
5164;43064;627;0;0;0;0;.00nan;0;0
5165;17625;651;0;0;0;0;.00nan;0;0
5165;57859;1814;31;17;4;13;.765;3543000;0
5165;59239;1814;0;0;0;0;.00nan;0;0
5165;149584;651;82;37;3;34;.919;3600000;0
5166;73274;647;63;34;4;30;.882;3600000;0
5166;80222;647;0;0;0;0;.00nan;0;0
5166;85546;631;0;0;0;0;.00nan;0;0
5166;87603;631;76;23;1;22;.957;3600000;0
5167;169552;642;0;0;0;0;.00nan;0;0
5167;24593;642;88;33;2;31;.939;3600000;0
5167;-1;628;0;0;0;0;.00nan;0;0
5167;-1;628;72;36;3;33;.917;3600000;0
5168;8426;629;84;24;1;23;.958;3600000;0
5168;11068;641;42;22;4;18;.818;3600000;0
5168;85644;629;0;0;0;0;.00nan;0;0
5168;160577;641;0;0;0;0;.00nan;0;0
5169;177631;1813;0;0;0;0;.00nan;0;0
5169;11107;637;69;23;2;21;.913;3900000;0
5169;170144;637;0;0;0;0;.00nan;0;0
5169;174334;1813;78;30;2;28;.933;3900000;0
5170;8942;639;0;0;0;0;.00nan;0;0
5170;-1;625;0;0;0;0;.00nan;0;0
5170;-1;625;47;18;3;15;.833;3600000;0
5170;86485;639;54;30;4;26;.867;3600000;0
5171;169552;642;0;0;0;0;.00nan;0;0
5171;24593;642;82;25;1;24;.960;3600000;0
5171;57859;1814;51;30;4;26;.867;3600000;0
5171;59239;1814;0;0;0;0;.00nan;0;0
5172;11068;641;83;43;3;40;.930;3553000;0
5172;-1;628;79;21;1;20;.952;3600000;0
5172;-1;628;0;0;0;0;.00nan;0;0
5172;160577;641;0;0;0;0;.00nan;0;0
5173;177631;1813;54;27;4;23;.852;3600000;0
5173;17625;651;0;0;0;0;.00nan;0;0
5173;174334;1813;0;0;0;0;.00nan;0;0
5173;149584;651;47;36;5;31;.861;3600000;0
5174;8426;629;24;6;3;3;.500;260000;0
5174;85546;631;0;0;0;0;.00nan;0;0
5174;85644;629;81;35;2;33;.943;3340000;0
5174;87603;631;60;22;2;20;.909;3600000;0
5175;3821;636;84;32;2;30;.938;3600000;0
5175;165867;627;69;34;3;31;.912;3548000;0
5175;43064;627;0;0;0;0;.00nan;0;0
5175;151728;636;0;0;0;0;.00nan;0;0
5176;11107;637;0;0;0;0;.00nan;0;0
5176;170144;637;65;16;1;15;.938;3900000;0
5176;73274;647;0;0;0;0;.00nan;0;0
5176;80222;647;83;28;1;27;.964;3900000;0
5177;8426;629;86;45;4;41;.911;3600000;0
5177;11107;637;0;0;0;0;.00nan;0;0
5177;170144;637;41;32;6;26;.813;3514000;0
5177;85644;629;0;0;0;0;.00nan;0;0
5178;165867;627;0;0;0;0;.00nan;0;0
5178;43064;627;71;25;2;23;.920;3900000;0
5178;57859;1814;96;43;2;41;.953;3900000;0
5178;59239;1814;0;0;0;0;.00nan;0;0
5179;177631;1813;0;0;0;0;.00nan;0;0
5179;174334;1813;96;46;1;45;.978;3900000;0
5179;-1;628;0;0;0;0;.00nan;0;0
5179;-1;628;74;22;1;21;.955;3900000;0
5180;8942;639;0;0;0;0;.00nan;0;0
5180;11068;641;0;0;0;0;.00nan;0;0
5180;86485;639;64;26;2;24;.923;3559000;0
5180;160577;641;72;23;1;22;.957;3600000;0
5181;3821;636;0;0;0;0;.00nan;0;0
5181;85546;631;84;29;1;28;.966;3600000;0
5181;87603;631;0;0;0;0;.00nan;0;0
5181;151728;636;98;50;2;48;.960;3571000;0
5182;17625;651;0;0;0;0;.00nan;0;0
5182;73274;647;75;16;1;15;.938;3600000;0
5182;80222;647;0;0;0;0;.00nan;0;0
5182;149584;651;69;28;2;26;.929;3582000;0
5183;169552;642;0;0;0;0;.00nan;0;0
5183;24593;642;84;27;1;26;.963;3600000;0
5183;-1;625;0;0;0;0;.00nan;0;0
5183;-1;625;79;36;3;33;.917;3513000;0
5184;8942;639;0;0;0;0;.00nan;0;0
5184;165867;627;100;28;0;28;1.000;3600000;0
5184;43064;627;0;0;0;0;.00nan;0;0
5184;86485;639;88;46;3;43;.935;3600000;0
5185;3821;636;0;0;0;0;.00nan;0;0
5185;57859;1814;0;0;0;0;.00nan;0;0
5185;59239;1814;73;28;2;26;.929;3600000;0
5185;151728;636;54;33;4;29;.879;3573000;0
5186;11107;637;0;0;0;0;.00nan;0;0
5186;169552;642;52;4;0;4;1.000;247000;0
5186;170144;637;57;34;4;30;.882;3600000;0
5186;24593;642;37;34;6;28;.824;3339000;0
5187;177631;1813;0;0;0;0;.00nan;0;0
5187;174334;1813;66;28;3;25;.893;3729000;0
5187;73274;647;0;0;0;0;.00nan;0;0
5187;80222;647;68;39;4;35;.897;3729000;0
5188;11068;641;59;31;4;27;.871;3600000;0
5188;85546;631;0;0;0;0;.00nan;0;0
5188;87603;631;75;21;1;20;.952;3600000;0
5188;160577;641;0;0;0;0;.00nan;0;0
5189;8426;629;0;0;0;0;.00nan;0;0
5189;-1;628;91;31;1;30;.968;3600000;0
5189;-1;628;0;0;0;0;.00nan;0;0
5189;85644;629;46;26;4;22;.846;3600000;0
5190;17625;651;0;0;0;0;.00nan;0;0
5190;-1;625;31;34;6;28;.824;3292000;0
5190;-1;625;53;2;0;2;1.000;308000;0
5190;149584;651;98;37;1;36;.973;3600000;0
5191;8942;639;0;0;0;0;.00nan;0;0
5191;57859;1814;80;25;2;23;.920;3600000;0
5191;59239;1814;0;0;0;0;.00nan;0;0
5191;86485;639;74;41;4;37;.902;3600000;0
5192;-1;625;72;13;0;13;1.000;1444000;0
5192;-1;625;43;25;4;21;.840;2156000;0
5192;85546;631;100;26;0;26;1.000;3600000;0
5192;87603;631;0;0;0;0;.00nan;0;0
5193;169552;642;0;0;0;0;.00nan;0;0
5193;24593;642;85;31;2;29;.935;3596000;0
5193;73274;647;0;0;0;0;.00nan;0;0
5193;80222;647;76;23;1;22;.957;3600000;0
5194;3821;636;0;0;0;0;.00nan;0;0
5194;177631;1813;0;0;0;0;.00nan;0;0
5194;174334;1813;86;34;1;33;.971;3900000;0
5194;151728;636;84;28;1;27;.964;3900000;0
5195;8426;629;72;34;3;31;.912;3586000;0
5195;165867;627;78;27;2;25;.926;3600000;0
5195;43064;627;0;0;0;0;.00nan;0;0
5195;85644;629;0;0;0;0;.00nan;0;0
5196;11068;641;67;30;3;27;.900;3900000;0
5196;11107;637;0;0;0;0;.00nan;0;0
5196;170144;637;43;18;3;15;.833;3900000;0
5196;160577;641;0;0;0;0;.00nan;0;0
5197;17625;651;0;0;0;0;.00nan;0;0
5197;-1;628;0;0;0;0;.00nan;0;0
5197;-1;628;64;26;2;24;.923;3600000;0
5197;149584;651;56;36;4;32;.889;3529000;0
5198;8942;639;0;0;0;0;.00nan;0;0
5198;169552;642;0;0;0;0;.00nan;0;0
5198;24593;642;74;27;2;25;.926;3599000;0
5198;86485;639;77;33;3;30;.909;3624000;0
5199;165867;627;0;0;0;0;.00nan;0;0
5199;17625;651;0;0;0;0;.00nan;0;0
5199;43064;627;75;38;3;35;.921;3600000;0
5199;149584;651;55;25;4;21;.840;3557000;0
5200;-1;628;67;14;1;13;.929;3900000;0
5200;-1;628;0;0;0;0;.00nan;0;0
5200;57859;1814;97;39;1;38;.974;3900000;0
5200;59239;1814;0;0;0;0;.00nan;0;0
5201;11107;637;0;0;0;0;.00nan;0;0
5201;170144;637;68;24;3;21;.875;3900000;0
5201;85546;631;64;32;3;29;.906;3900000;0
5201;87603;631;0;0;0;0;.00nan;0;0
5202;177631;1813;0;0;0;0;.00nan;0;0
5202;11068;641;0;0;0;0;.00nan;0;0
5202;174334;1813;73;29;2;27;.931;3600000;0
5202;160577;641;91;41;3;38;.927;3576000;0
5203;8426;629;57;34;4;30;.882;3580000;0
5203;73274;647;73;21;2;19;.905;3600000;0
5203;80222;647;0;0;0;0;.00nan;0;0
5203;85644;629;0;0;0;0;.00nan;0;0
5204;3821;636;0;0;0;0;.00nan;0;0
5204;-1;625;83;30;1;29;.967;3900000;0
5204;-1;625;0;0;0;0;.00nan;0;0
5204;151728;636;82;26;1;25;.962;3900000;0
5205;8426;629;71;33;3;30;.909;3566000;0
5205;57859;1814;88;29;2;27;.931;3600000;0
5205;59239;1814;0;0;0;0;.00nan;0;0
5205;85644;629;0;0;0;0;.00nan;0;0
5206;8942;639;0;0;0;0;.00nan;0;0
5206;73274;647;75;31;3;28;.903;3600000;0
5206;80222;647;0;0;0;0;.00nan;0;0
5206;86485;639;67;39;4;35;.897;3600000;0
5207;165867;627;18;32;7;25;.781;2896000;0
5207;169552;642;0;0;0;0;.00nan;0;0
5207;24593;642;71;37;5;32;.865;3600000;0
5207;43064;627;42;5;1;4;.800;704000;0
5208;177631;1813;0;0;0;0;.00nan;0;0
5208;174334;1813;74;32;2;30;.938;3600000;0
5208;85546;631;78;25;1;24;.960;3600000;0
5208;87603;631;0;0;0;0;.00nan;0;0
5209;3928;636;65;29;3;26;.897;3600000;0
5209;11068;641;64;45;5;40;.889;3561000;0
5209;151728;636;0;0;0;0;.00nan;0;0
5209;160577;641;0;0;0;0;.00nan;0;0
5210;11107;637;100;28;0;28;1.000;3600000;0
5210;17625;651;0;0;0;0;.00nan;0;0
5210;170144;637;0;0;0;0;.00nan;0;0
5210;149584;651;62;43;5;38;.884;3600000;0
5211;-1;625;85;31;1;30;.968;3600000;0
5211;-1;628;36;8;2;6;.750;1047000;0
5211;-1;628;19;27;6;21;.778;2553000;0
5211;-1;625;0;0;0;0;.00nan;0;0
5212;8942;639;61;8;0;8;1.000;839000;0
5212;-1;628;64;31;3;28;.903;3600000;0
5212;-1;628;0;0;0;0;.00nan;0;0
5212;86485;639;33;34;6;28;.824;2761000;0
5213;57859;1814;52;33;5;28;.848;3600000;0
5213;59239;1814;0;0;0;0;.00nan;0;0
5213;85546;631;82;30;2;28;.933;3600000;0
5213;87603;631;0;0;0;0;.00nan;0;0
5214;177631;1813;0;0;0;0;.00nan;0;0
5214;169552;642;0;0;0;0;.00nan;0;0
5214;24593;642;80;35;2;33;.943;3600000;0
5214;174334;1813;52;22;3;19;.864;3549000;0
5215;8426;629;86;28;1;27;.964;3600000;0
5215;-1;625;0;0;0;0;.00nan;0;0
5215;-1;625;43;20;3;17;.850;3530000;0
5215;85644;629;0;0;0;0;.00nan;0;0
5216;11107;637;77;20;1;19;.950;3600000;0
5216;165867;627;0;0;0;0;.00nan;0;0
5216;170144;637;0;0;0;0;.00nan;0;0
5216;43064;627;45;34;5;29;.853;3600000;0
5217;11068;641;98;45;2;43;.956;3900000;0
5217;73274;647;0;0;0;0;.00nan;0;0
5217;80222;647;76;28;2;26;.929;3900000;0
5217;160577;641;0;0;0;0;.00nan;0;0
5218;3928;636;52;30;4;26;.867;3527000;0
5218;17625;651;0;0;0;0;.00nan;0;0
5218;149584;651;73;25;2;23;.920;3600000;0
5218;151728;636;0;0;0;0;.00nan;0;0
5219;177631;1813;0;0;0;0;.00nan;0;0
5219;165867;627;0;0;0;0;.00nan;0;0
5219;174334;1813;100;42;0;42;1.000;3600000;0
5219;43064;627;65;31;3;28;.903;3600000;0
5220;8426;629;0;0;0;0;.00nan;0;0
5220;8942;639;0;0;0;0;.00nan;0;0
5220;85644;629;79;39;3;36;.923;3543000;0
5220;86485;639;81;24;1;23;.958;3600000;0
5221;11068;641;52;2;0;2;1.000;421000;0
5221;-1;628;0;0;0;0;.00nan;0;0
5221;-1;628;69;22;2;20;.909;3600000;0
5221;160577;641;29;43;8;35;.814;3179000;0
5222;17625;651;0;0;0;0;.00nan;0;0
5222;85546;631;59;20;2;18;.900;3600000;0
5222;87603;631;0;0;0;0;.00nan;0;0
5222;149584;651;70;19;1;18;.947;3600000;0
5223;169552;642;0;0;0;0;.00nan;0;0
5223;24593;642;73;31;3;28;.903;3600000;0
5223;57859;1814;33;27;6;21;.778;2059000;0
5223;59239;1814;49;19;3;16;.842;1541000;0
5224;3928;636;68;32;3;29;.906;3600000;0
5224;11107;637;36;6;2;4;.667;440000;0
5224;170144;637;8;33;8;25;.758;3160000;0
5224;151728;636;0;0;0;0;.00nan;0;0
5225;-1;625;80;42;4;38;.905;3782000;0
5225;-1;625;0;0;0;0;.00nan;0;0
5225;73274;647;0;0;0;0;.00nan;0;0
5225;80222;647;66;30;3;27;.900;3782000;0
5226;8942;639;0;0;0;0;.00nan;0;0
5226;165867;627;0;0;0;0;.00nan;0;0
5226;43064;627;100;29;0;29;1.000;3600000;0
5226;86485;639;89;32;1;31;.969;3559000;0
5227;-1;628;0;0;0;0;.00nan;0;0
5227;-1;628;96;44;2;42;.955;3600000;0
5227;57859;1814;0;0;0;0;.00nan;0;0
5227;59239;1814;31;30;6;24;.800;3600000;0
5228;-1;625;0;0;0;0;.00nan;0;0
5228;-1;625;62;33;4;29;.879;3556000;0
5228;85546;631;0;0;0;0;.00nan;0;0
5228;87603;631;89;37;2;35;.946;3600000;0
5229;3928;636;69;23;2;21;.913;3600000;0
5229;177631;1813;0;0;0;0;.00nan;0;0
5229;174334;1813;80;39;3;36;.923;3543000;0
5229;151728;636;0;0;0;0;.00nan;0;0
5230;8426;629;95;27;0;27;1.000;3822000;0
5230;11068;641;94;38;1;37;.974;3822000;0
5230;85644;629;0;0;0;0;.00nan;0;0
5230;160577;641;0;0;0;0;.00nan;0;0
5231;11107;637;0;0;0;0;.00nan;0;0
5231;170144;637;46;21;3;18;.857;3600000;0
5231;73274;647;0;0;0;0;.00nan;0;0
5231;80222;647;45;27;5;22;.815;3565000;0
5232;17625;651;83;19;1;18;.947;3600000;0
5232;169552;642;0;0;0;0;.00nan;0;0
5232;24593;642;77;39;3;36;.923;3572000;0
5232;149584;651;0;0;0;0;.00nan;0;0
5233;177631;1813;0;0;0;0;.00nan;0;0
5233;8942;639;0;0;0;0;.00nan;0;0
5233;174334;1813;67;29;3;26;.897;3569000;0
5233;86485;639;80;36;2;34;.944;3600000;0
5234;165867;627;0;0;0;0;.00nan;0;0
5234;-1;628;0;0;0;0;.00nan;0;0
5234;-1;628;82;40;3;37;.925;3589000;0
5234;43064;627;61;20;2;18;.900;3600000;0
5235;8426;629;39;41;6;35;.854;3553000;0
5235;11107;637;0;0;0;0;.00nan;0;0
5235;170144;637;58;29;4;25;.862;3600000;0
5235;85644;629;0;0;0;0;.00nan;0;0
5236;73274;647;56;41;6;35;.854;3768000;0
5236;80222;647;0;0;0;0;.00nan;0;0
5236;85546;631;40;29;5;24;.828;3768000;0
5236;87603;631;0;0;0;0;.00nan;0;0
5237;17625;651;0;0;0;0;.00nan;0;0
5237;-1;625;65;41;5;36;.878;3600000;0
5237;-1;625;0;0;0;0;.00nan;0;0
5237;149584;651;58;16;2;14;.875;3600000;0
5238;11068;641;0;0;0;0;.00nan;0;0
5238;169552;642;0;0;0;0;.00nan;0;0
5238;24593;642;73;30;2;28;.933;3600000;0
5238;160577;641;58;29;3;26;.897;3554000;0
5239;3928;636;64;21;2;19;.905;3600000;0
5239;57859;1814;76;36;3;33;.917;3554000;0
5239;59239;1814;0;0;0;0;.00nan;0;0
5239;151728;636;0;0;0;0;.00nan;0;0
5240;165867;627;0;0;0;0;.00nan;0;0
5240;43064;627;81;39;3;36;.923;3598000;0
5240;57859;1814;0;0;0;0;.00nan;0;0
5240;59239;1814;85;37;2;35;.946;3600000;0
5241;8942;639;0;0;0;0;.00nan;0;0
5241;-1;628;0;0;0;0;.00nan;0;0
5241;-1;628;56;19;2;17;.895;3600000;0
5241;86485;639;82;35;3;32;.914;3600000;0
5242;3928;636;89;36;2;34;.944;3900000;0
5242;85546;631;70;30;2;28;.933;3900000;0
5242;87603;631;0;0;0;0;.00nan;0;0
5242;151728;636;0;0;0;0;.00nan;0;0
5243;177631;1813;0;0;0;0;.00nan;0;0
5243;169552;642;0;0;0;0;.00nan;0;0
5243;24593;642;81;34;3;31;.912;3600000;0
5243;174334;1813;39;26;5;21;.808;3514000;0
5244;11068;641;72;29;2;27;.931;3600000;0
5244;73274;647;0;0;0;0;.00nan;0;0
5244;80222;647;29;25;6;19;.760;3600000;0
5244;160577;641;0;0;0;0;.00nan;0;0
5245;8426;629;67;30;3;27;.900;3600000;0
5245;17625;651;0;0;0;0;.00nan;0;0
5245;85644;629;0;0;0;0;.00nan;0;0
5245;149584;651;44;25;4;21;.840;3587000;0
5246;11107;637;0;0;0;0;.00nan;0;0
5246;170144;637;66;32;3;29;.906;3600000;0
5246;-1;625;59;38;5;33;.868;3561000;0
5246;-1;625;0;0;0;0;.00nan;0;0
5247;8942;639;70;25;2;23;.920;3600000;0
5247;-1;625;71;45;3;42;.933;3577000;0
5247;-1;625;0;0;0;0;.00nan;0;0
5247;86485;639;0;0;0;0;.00nan;0;0
5248;165867;627;0;0;0;0;.00nan;0;0
5248;43064;627;71;54;4;50;.926;3900000;0
5248;73274;647;0;0;0;0;.00nan;0;0
5248;80222;647;58;26;4;22;.846;3900000;0
5249;169552;642;0;0;0;0;.00nan;0;0
5249;24593;642;59;40;4;36;.900;3600000;0
5249;85546;631;74;19;1;18;.947;3600000;0
5249;87603;631;0;0;0;0;.00nan;0;0
5250;177631;1813;0;0;0;0;.00nan;0;0
5250;11068;641;0;0;0;0;.00nan;0;0
5250;174334;1813;89;38;2;36;.947;3600000;0
5250;160577;641;88;31;1;30;.968;3600000;0
5251;8426;629;89;33;1;32;.970;3558000;0
5251;57859;1814;100;24;0;24;1.000;3600000;0
5251;59239;1814;0;0;0;0;.00nan;0;0
5251;85644;629;0;0;0;0;.00nan;0;0
5252;11107;637;50;38;6;32;.842;3600000;0
5252;170144;637;0;0;0;0;.00nan;0;0
5252;-1;628;0;0;0;0;.00nan;0;0
5252;-1;628;79;37;2;35;.946;3600000;0
5253;3928;636;86;39;2;37;.949;3900000;0
5253;17625;651;0;0;0;0;.00nan;0;0
5253;149584;651;69;30;2;28;.933;3900000;0
5253;151728;636;0;0;0;0;.00nan;0;0
5254;165867;627;58;33;4;29;.879;3548000;0
5254;43064;627;0;0;0;0;.00nan;0;0
5254;85546;631;76;35;2;33;.943;3600000;0
5254;87603;631;0;0;0;0;.00nan;0;0
5255;11068;641;93;34;3;31;.912;3900000;0
5255;17625;651;0;0;0;0;.00nan;0;0
5255;149584;651;60;30;3;27;.900;3900000;0
5255;160577;641;0;0;0;0;.00nan;0;0
5256;8942;639;0;0;0;0;.00nan;0;0
5256;57859;1814;100;21;0;21;1.000;3600000;0
5256;59239;1814;0;0;0;0;.00nan;0;0
5256;86485;639;25;34;7;27;.794;3600000;0
5257;8426;629;70;47;5;42;.894;3600000;0
5257;-1;628;67;17;1;16;.941;3600000;0
5257;-1;628;0;0;0;0;.00nan;0;0
5257;85644;629;0;0;0;0;.00nan;0;0
5258;177631;1813;0;0;0;0;.00nan;0;0
5258;-1;625;86;33;3;30;.909;3900000;0
5258;174334;1813;54;23;3;20;.870;3900000;0
5258;-1;625;0;0;0;0;.00nan;0;0
5259;11107;637;0;0;0;0;.00nan;0;0
5259;169552;642;0;0;0;0;.00nan;0;0
5259;170144;637;80;26;1;25;.962;3600000;0
5259;24593;642;60;30;3;27;.900;3546000;0
5260;3928;636;85;31;2;29;.935;3600000;0
5260;73274;647;57;36;4;32;.889;3572000;0
5260;80222;647;0;0;0;0;.00nan;0;0
5260;151728;636;0;0;0;0;.00nan;0;0
5261;11068;641;0;0;0;0;.00nan;0;0
5261;85546;631;0;0;0;0;.00nan;0;0
5261;87603;631;61;22;3;19;.864;3618000;0
5261;160577;641;86;50;4;46;.920;3618000;0
5262;177631;1813;0;0;0;0;.00nan;0;0
5262;174334;1813;85;41;3;38;.927;3570000;0
5262;57859;1814;98;30;1;29;.967;3600000;0
5262;59239;1814;0;0;0;0;.00nan;0;0
5263;8942;639;0;0;0;0;.00nan;0;0
5263;169552;642;69;27;2;25;.926;3600000;0
5263;24593;642;0;0;0;0;.00nan;0;0
5263;86485;639;63;30;3;27;.900;3600000;0
5264;8426;629;0;0;0;0;.00nan;0;0
5264;73274;647;0;0;0;0;.00nan;0;0
5264;80222;647;55;33;4;29;.879;3594000;0
5264;85644;629;96;38;2;36;.947;3600000;0
5265;3928;636;72;26;2;24;.923;3900000;0
5265;165867;627;0;0;0;0;.00nan;0;0
5265;43064;627;92;40;2;38;.950;3900000;0
5265;151728;636;0;0;0;0;.00nan;0;0
5266;11107;637;0;0;0;0;.00nan;0;0
5266;17625;651;0;0;0;0;.00nan;0;0
5266;170144;637;29;28;6;22;.786;3600000;0
5266;149584;651;74;29;1;28;.966;3600000;0
5267;-1;625;79;43;3;40;.930;3900000;0
5267;-1;628;0;0;0;0;.00nan;0;0
5267;-1;628;79;36;3;33;.917;3900000;0
5267;-1;625;0;0;0;0;.00nan;0;0
5268;8426;629;57;43;5;38;.884;3600000;0
5268;169552;642;0;0;0;0;.00nan;0;0
5268;24593;642;60;17;2;15;.882;3600000;0
5268;85644;629;0;0;0;0;.00nan;0;0
5269;8942;639;0;0;0;0;.00nan;0;0
5269;11068;641;0;0;0;0;.00nan;0;0
5269;86485;639;77;25;1;24;.960;3544000;0
5269;160577;641;100;32;0;32;1.000;3600000;0
5270;11107;637;0;0;0;0;.00nan;0;0
5270;165867;627;0;0;0;0;.00nan;0;0
5270;170144;637;68;27;2;25;.926;3600000;0
5270;43064;627;83;25;1;24;.960;3600000;0
5271;57859;1814;100;38;0;38;1.000;3600000;0
5271;59239;1814;0;0;0;0;.00nan;0;0
5271;73274;647;51;34;4;30;.882;3600000;0
5271;80222;647;0;0;0;0;.00nan;0;0
5272;-1;628;0;0;0;0;.00nan;0;0
5272;-1;628;52;37;6;31;.838;3600000;0
5272;85546;631;95;35;1;34;.971;3600000;0
5272;87603;631;0;0;0;0;.00nan;0;0
5273;177631;1813;0;0;0;0;.00nan;0;0
5273;17625;651;0;0;0;0;.00nan;0;0
5273;174334;1813;63;31;3;28;.903;3600000;0
5273;149584;651;94;24;0;24;1.000;3600000;0
5274;3928;636;59;40;5;35;.875;3595000;0
5274;-1;625;56;25;3;22;.880;3600000;0
5274;-1;625;0;0;0;0;.00nan;0;0
5274;151728;636;0;0;0;0;.00nan;0;0
5275;169552;642;0;0;0;0;.00nan;0;0
5275;24593;642;50;38;6;32;.842;3600000;0
5275;-1;628;53;16;2;14;.875;3600000;0
5275;-1;628;0;0;0;0;.00nan;0;0
5276;8426;629;65;36;4;32;.889;3588000;0
5276;85546;631;60;17;2;15;.882;3600000;0
5276;85644;629;0;0;0;0;.00nan;0;0
5276;87603;631;0;0;0;0;.00nan;0;0
5277;8942;639;0;0;0;0;.00nan;0;0
5277;11107;637;56;30;4;26;.867;3763000;0
5277;170144;637;0;0;0;0;.00nan;0;0
5277;86485;639;72;45;5;40;.889;3742000;0
5278;177631;1813;0;0;0;0;.00nan;0;0
5278;174334;1813;49;33;5;28;.848;3600000;0
5278;73274;647;20;9;4;5;.556;964000;0
5278;80222;647;50;23;3;20;.870;2569000;0
5279;165867;627;0;0;0;0;.00nan;0;0
5279;17625;651;0;0;0;0;.00nan;0;0
5279;43064;627;100;31;0;31;1.000;3600000;0
5279;149584;651;76;36;3;33;.917;3600000;0
5280;-1;625;47;23;3;20;.870;3599000;0
5280;-1;625;0;0;0;0;.00nan;0;0
5280;57859;1814;75;30;2;28;.933;3600000;0
5280;59239;1814;0;0;0;0;.00nan;0;0
5281;3928;636;55;18;2;16;.889;3600000;0
5281;11068;641;61;41;5;36;.878;3600000;0
5281;151728;636;0;0;0;0;.00nan;0;0
5281;160577;641;0;0;0;0;.00nan;0;0
5282;8942;639;0;0;0;0;.00nan;0;0
5282;17625;651;0;0;0;0;.00nan;0;0
5282;86485;639;47;22;3;19;.864;3573000;0
5282;149584;651;81;24;1;23;.958;3600000;0
5283;-1;628;0;0;0;0;.00nan;0;0
5283;-1;628;96;35;2;33;.943;3600000;0
5283;73274;647;0;0;0;0;.00nan;0;0
5283;80222;647;51;39;5;34;.872;3600000;0
5284;177631;1813;0;0;0;0;.00nan;0;0
5284;174334;1813;39;22;4;18;.818;3549000;0
5284;85546;631;76;32;2;30;.938;3600000;0
5284;87603;631;0;0;0;0;.00nan;0;0
5285;169552;642;0;0;0;0;.00nan;0;0
5285;24593;642;28;19;5;14;.737;3600000;0
5285;-1;625;97;51;4;47;.922;3600000;0
5285;-1;625;0;0;0;0;.00nan;0;0
5286;11068;641;59;13;1;12;.923;1232000;0
5286;165867;627;0;0;0;0;.00nan;0;0
5286;43064;627;51;30;4;26;.867;3600000;0
5286;160577;641;50;30;4;26;.867;2313000;0
5287;3928;636;58;20;2;18;.900;3591000;0
5287;8426;629;100;42;1;41;.976;3600000;0
5287;85644;629;0;0;0;0;.00nan;0;0
5287;151728;636;0;0;0;0;.00nan;0;0
5288;11107;637;0;0;0;0;.00nan;0;0
5288;170144;637;84;28;1;27;.964;3600000;0
5288;57859;1814;42;31;5;26;.839;3600000;0
5288;59239;1814;0;0;0;0;.00nan;0;0
5289;8942;639;0;0;0;0;.00nan;0;0
5289;85546;631;53;20;3;17;.850;3566000;0
5289;86485;639;75;30;2;28;.933;3600000;0
5289;87603;631;0;0;0;0;.00nan;0;0
5290;8426;629;92;47;2;45;.957;3696000;0
5290;165867;627;0;0;0;0;.00nan;0;0
5290;43064;627;62;25;3;22;.880;3682000;0
5290;85644;629;0;0;0;0;.00nan;0;0
5291;17625;651;0;0;0;0;.00nan;0;0
5291;57859;1814;0;0;0;0;.00nan;0;0
5291;59239;1814;48;27;4;23;.852;3600000;0
5291;149584;651;34;26;5;21;.808;3557000;0
5292;3928;636;98;29;0;29;1.000;3900000;0
5292;-1;628;0;0;0;0;.00nan;0;0
5292;-1;628;100;35;0;35;1.000;3900000;0
5292;151728;636;0;0;0;0;.00nan;0;0
5293;177631;1813;41;27;5;22;.815;3560000;0
5293;11107;637;0;0;0;0;.00nan;0;0
5293;170144;637;60;33;4;29;.879;3600000;0
5293;174334;1813;0;0;0;0;.00nan;0;0
5294;169552;642;0;0;0;0;.00nan;0;0
5294;24593;642;100;29;0;29;1.000;3600000;0
5294;73274;647;0;0;0;0;.00nan;0;0
5294;80222;647;83;27;1;26;.963;3568000;0
5295;11068;641;100;39;0;39;1.000;3600000;0
5295;-1;625;60;15;1;14;.933;3549000;0
5295;-1;625;0;0;0;0;.00nan;0;0
5295;160577;641;0;0;0;0;.00nan;0;0
5296;3928;636;62;21;2;19;.905;3900000;0
5296;169552;642;0;0;0;0;.00nan;0;0
5296;24593;642;88;39;2;37;.949;3900000;0
5296;151728;636;0;0;0;0;.00nan;0;0
5297;165867;627;0;0;0;0;.00nan;0;0
5297;-1;625;47;30;4;26;.867;3521000;0
5297;-1;625;0;0;0;0;.00nan;0;0
5297;43064;627;82;31;2;29;.935;3600000;0
5298;57859;1814;49;29;5;24;.828;3600000;0
5298;59239;1814;0;0;0;0;.00nan;0;0
5298;85546;631;73;34;3;31;.912;3600000;0
5298;87603;631;0;0;0;0;.00nan;0;0
5299;17625;651;0;0;0;0;.00nan;0;0
5299;-1;628;0;0;0;0;.00nan;0;0
5299;-1;628;97;28;1;27;.964;3600000;0
5299;149584;651;67;41;4;37;.902;3600000;0
5300;177631;1813;62;7;0;7;1.000;1343000;0
5300;8426;629;25;34;7;27;.794;3515000;0
5300;174334;1813;28;21;5;16;.762;2257000;0
5300;85644;629;0;0;0;0;.00nan;0;0
5301;11068;641;0;0;0;0;.00nan;0;0
5301;11107;637;0;0;0;0;.00nan;0;0
5301;170144;637;71;26;2;24;.923;3831000;0
5301;160577;641;87;27;1;26;.963;3831000;0
5302;8942;639;0;0;0;0;.00nan;0;0
5302;73274;647;94;37;2;35;.946;3600000;0
5302;80222;647;0;0;0;0;.00nan;0;0
5302;86485;639;80;46;4;42;.913;3600000;0
5303;3928;636;88;17;0;17;1.000;3600000;0
5303;8942;639;66;15;0;15;1.000;1602000;0
5303;86485;639;32;32;6;26;.813;1998000;0
5303;151728;636;0;0;0;0;.00nan;0;0
5304;11107;637;0;0;0;0;.00nan;0;0
5304;170144;637;95;54;3;51;.944;3543000;0
5304;85546;631;0;0;0;0;.00nan;0;0
5304;87603;631;61;21;2;19;.905;3600000;0
5305;165867;627;0;0;0;0;.00nan;0;0
5305;169552;642;0;0;0;0;.00nan;0;0
5305;24593;642;47;40;5;35;.875;3600000;0
5305;43064;627;79;28;2;26;.929;3600000;0
5306;177631;1813;0;0;0;0;.00nan;0;0
5306;174334;1813;43;25;4;21;.840;3600000;0
5306;-1;628;0;0;0;0;.00nan;0;0
5306;-1;628;53;35;5;30;.857;3600000;0
5307;11068;641;42;31;5;26;.839;3600000;0
5307;57859;1814;77;31;2;29;.935;3600000;0
5307;59239;1814;0;0;0;0;.00nan;0;0
5307;160577;641;0;0;0;0;.00nan;0;0
5308;17625;651;0;0;0;0;.00nan;0;0
5308;73274;647;99;41;1;40;.976;3900000;0
5308;80222;647;0;0;0;0;.00nan;0;0
5308;149584;651;96;31;1;30;.968;3900000;0
5309;8426;629;100;36;1;35;.972;3600000;0
5309;-1;625;52;28;3;25;.893;3551000;0
5309;-1;625;0;0;0;0;.00nan;0;0
5309;85644;629;0;0;0;0;.00nan;0;0
5310;11107;637;0;0;0;0;.00nan;0;0
5310;169552;642;0;0;0;0;.00nan;0;0
5310;170144;637;73;30;2;28;.933;3900000;0
5310;24593;642;62;22;2;20;.909;3900000;0
5311;8942;639;48;38;5;33;.868;3600000;0
5311;-1;628;0;0;0;0;.00nan;0;0
5311;-1;628;65;17;1;16;.941;3600000;0
5311;86485;639;0;0;0;0;.00nan;0;0
5312;165867;627;0;0;0;0;.00nan;0;0
5312;43064;627;95;48;3;45;.938;3553000;0
5312;57859;1814;86;42;2;40;.952;3600000;0
5312;59239;1814;0;0;0;0;.00nan;0;0
5313;11068;641;0;0;0;0;.00nan;0;0
5313;73274;647;0;0;0;0;.00nan;0;0
5313;80222;647;100;29;0;29;1.000;3600000;0
5313;160577;641;68;35;2;33;.943;3513000;0
5314;8426;629;82;34;1;33;.971;3883000;0
5314;85546;631;62;20;2;18;.900;3883000;0
5314;85644;629;0;0;0;0;.00nan;0;0
5314;87603;631;0;0;0;0;.00nan;0;0
5315;3928;636;49;21;3;18;.857;3600000;0
5315;-1;625;39;31;6;25;.806;2096000;0
5315;-1;625;44;16;3;13;.813;1504000;0
5315;151728;636;0;0;0;0;.00nan;0;0
5316;177631;1813;0;0;0;0;.00nan;0;0
5316;17625;651;0;0;0;0;.00nan;0;0
5316;174334;1813;63;20;2;18;.900;3600000;0
5316;149584;651;54;27;4;23;.852;3541000;0
5317;-1;625;49;41;6;35;.854;3541000;0
5317;-1;625;0;0;0;0;.00nan;0;0
5317;57859;1814;66;37;4;33;.892;3600000;0
5317;59239;1814;0;0;0;0;.00nan;0;0
5318;8426;629;71;45;5;40;.889;3600000;0
5318;-1;628;0;0;0;0;.00nan;0;0
5318;-1;628;81;23;2;21;.913;3600000;0
5318;85644;629;0;0;0;0;.00nan;0;0
5319;8942;639;74;42;4;38;.905;3102000;0
5319;85546;631;42;16;3;13;.813;3600000;0
5319;86485;639;31;10;3;7;.700;498000;0
5319;87603;631;0;0;0;0;.00nan;0;0
5320;177631;1813;0;0;0;0;.00nan;0;0
5320;165867;627;0;0;0;0;.00nan;0;0
5320;174334;1813;67;26;3;23;.885;3900000;0
5320;43064;627;75;33;3;30;.909;3867000;0
5321;11068;641;77;24;1;23;.958;3600000;0
5321;169552;642;0;0;0;0;.00nan;0;0
5321;24593;642;65;22;2;20;.909;3551000;0
5321;160577;641;0;0;0;0;.00nan;0;0
5322;3928;636;0;0;0;0;.00nan;0;0
5322;73274;647;0;0;0;0;.00nan;0;0
5322;80222;647;69;35;3;32;.914;3564000;0
5322;151728;636;71;23;1;22;.957;3600000;0
5323;11107;637;0;0;0;0;.00nan;0;0
5323;17625;651;0;0;0;0;.00nan;0;0
5323;170144;637;60;17;1;16;.941;3600000;0
5323;149584;651;76;36;3;33;.917;3574000;0
5324;177631;1813;0;0;0;0;.00nan;0;0
5324;8942;639;0;0;0;0;.00nan;0;0
5324;174334;1813;74;29;1;28;.966;3600000;0
5324;86485;639;45;32;5;27;.844;3600000;0
5325;11107;637;0;0;0;0;.00nan;0;0
5325;170144;637;79;23;1;22;.957;3600000;0
5325;57859;1814;89;34;2;32;.941;3542000;0
5325;59239;1814;0;0;0;0;.00nan;0;0
5326;169552;642;0;0;0;0;.00nan;0;0
5326;24593;642;63;29;3;26;.897;3600000;0
5326;-1;628;0;0;0;0;.00nan;0;0
5326;-1;628;52;33;4;29;.879;3542000;0
5327;165867;627;0;0;0;0;.00nan;0;0
5327;43064;627;96;19;0;19;1.000;3600000;0
5327;85546;631;84;35;2;33;.943;3586000;0
5327;87603;631;0;0;0;0;.00nan;0;0
5328;3928;636;97;22;0;22;1.000;3600000;0
5328;11068;641;0;0;0;0;.00nan;0;0
5328;151728;636;0;0;0;0;.00nan;0;0
5328;160577;641;66;39;4;35;.897;3600000;0
5329;8426;629;52;40;5;35;.875;3600000;0
5329;73274;647;0;0;0;0;.00nan;0;0
5329;80222;647;72;21;1;20;.952;3600000;0
5329;85644;629;0;0;0;0;.00nan;0;0
5330;17625;651;0;0;0;0;.00nan;0;0
5330;-1;625;70;33;2;31;.939;3544000;0
5330;-1;625;0;0;0;0;.00nan;0;0
5330;149584;651;98;22;0;22;1.000;3600000;0
5331;3928;636;38;29;5;24;.828;3600000;0
5331;165867;627;0;0;0;0;.00nan;0;0
5331;43064;627;80;23;1;22;.957;3600000;0
5331;151728;636;0;0;0;0;.00nan;0;0
5332;73274;647;0;0;0;0;.00nan;0;0
5332;80222;647;82;35;3;32;.914;3572000;0
5332;85546;631;64;19;2;17;.895;3600000;0
5332;87603;631;0;0;0;0;.00nan;0;0
5333;169552;642;0;0;0;0;.00nan;0;0
5333;24593;642;78;30;2;28;.933;3600000;0
5333;-1;625;0;0;0;0;.00nan;0;0
5333;-1;625;38;27;5;22;.815;3600000;0
5334;177631;1813;0;0;0;0;.00nan;0;0
5334;174334;1813;69;29;3;26;.897;3544000;0
5334;-1;628;0;0;0;0;.00nan;0;0
5334;-1;628;81;28;2;26;.929;3600000;0
5335;8942;639;0;0;0;0;.00nan;0;0
5335;11068;641;95;41;2;39;.951;3900000;0
5335;86485;639;78;24;2;22;.917;3900000;0
5335;160577;641;0;0;0;0;.00nan;0;0
5336;8426;629;50;36;5;31;.861;3553000;0
5336;11107;637;0;0;0;0;.00nan;0;0
5336;170144;637;56;19;3;16;.842;3600000;0
5336;85644;629;0;0;0;0;.00nan;0;0
5337;17625;651;0;0;0;0;.00nan;0;0
5337;57859;1814;97;41;3;38;.927;3900000;0
5337;59239;1814;0;0;0;0;.00nan;0;0
5337;149584;651;68;33;3;30;.909;3900000;0
5338;8942;639;64;47;6;41;.872;3691000;0
5338;17625;651;0;0;0;0;.00nan;0;0
5338;86485;639;0;0;0;0;.00nan;0;0
5338;149584;651;44;35;5;30;.857;3691000;0
5339;165867;627;0;0;0;0;.00nan;0;0
5339;-1;628;70;25;2;23;.920;3600000;0
5339;-1;628;0;0;0;0;.00nan;0;0
5339;43064;627;84;41;4;37;.902;3600000;0
5340;11068;641;0;0;0;0;.00nan;0;0
5340;85546;631;62;28;3;25;.893;3600000;0
5340;87603;631;0;0;0;0;.00nan;0;0
5340;160577;641;48;28;4;24;.857;3546000;0
5341;8426;629;0;0;0;0;.00nan;0;0
5341;57859;1814;69;30;3;27;.900;3600000;0
5341;59239;1814;0;0;0;0;.00nan;0;0
5341;85644;629;85;36;2;34;.944;3600000;0
5342;3928;636;83;25;1;24;.960;3600000;0
5342;177631;1813;0;0;0;0;.00nan;0;0
5342;174334;1813;65;31;3;28;.903;3521000;0
5342;151728;636;0;0;0;0;.00nan;0;0
5343;11107;637;0;0;0;0;.00nan;0;0
5343;170144;637;52;27;4;23;.852;3600000;0
5343;-1;625;76;22;1;21;.955;1436000;0
5343;-1;625;52;27;4;23;.852;2157000;0
5344;169552;642;0;0;0;0;.00nan;0;0
5344;24593;642;77;42;4;38;.905;3733000;0
5344;73274;647;82;37;3;34;.919;3761000;0
5344;80222;647;0;0;0;0;.00nan;0;0
5345;169552;642;0;0;0;0;.00nan;0;0
5345;24593;642;82;20;1;19;.950;3600000;0
5345;57859;1814;0;0;0;0;.00nan;0;0
5345;59239;1814;66;39;5;34;.872;3600000;0
5346;177631;1813;76;34;3;31;.912;3600000;0
5346;174334;1813;0;0;0;0;.00nan;0;0
5346;85546;631;40;22;4;18;.818;3567000;0
5346;87603;631;0;0;0;0;.00nan;0;0
5347;11068;641;44;41;6;35;.854;3600000;0
5347;11107;637;0;0;0;0;.00nan;0;0
5347;170144;637;70;30;3;27;.900;3600000;0
5347;160577;641;0;0;0;0;.00nan;0;0
5348;3928;636;60;22;2;20;.909;3600000;0
5348;-1;628;0;0;0;0;.00nan;0;0
5348;-1;628;50;33;5;28;.848;3600000;0
5348;151728;636;0;0;0;0;.00nan;0;0
5349;165867;627;0;0;0;0;.00nan;0;0
5349;43064;627;62;23;2;21;.913;3600000;0
5349;73274;647;0;0;0;0;.00nan;0;0
5349;80222;647;100;37;1;36;.973;3600000;0
5350;8426;629;57;43;6;37;.860;3600000;0
5350;17625;651;0;0;0;0;.00nan;0;0
5350;85644;629;0;0;0;0;.00nan;0;0
5350;149584;651;87;27;1;26;.963;3600000;0
5351;8942;639;0;0;0;0;.00nan;0;0
5351;-1;625;50;17;3;14;.824;3573000;0
5351;-1;625;0;0;0;0;.00nan;0;0
5351;86485;639;100;45;1;44;.978;3600000;0
5352;3928;636;57;22;3;19;.864;3600000;0
5352;8942;639;0;0;0;0;.00nan;0;0
5352;86485;639;44;35;5;30;.857;3513000;0
5352;151728;636;0;0;0;0;.00nan;0;0
5353;165867;627;0;0;0;0;.00nan;0;0
5353;17625;651;0;0;0;0;.00nan;0;0
5353;43064;627;84;36;3;33;.917;3600000;0
5353;149584;651;63;19;2;17;.895;3600000;0
5354;11068;641;0;0;0;0;.00nan;0;0
5354;57859;1814;37;28;5;23;.821;3600000;0
5354;59239;1814;0;0;0;0;.00nan;0;0
5354;160577;641;92;20;0;20;1.000;3600000;0
5355;11107;637;0;0;0;0;.00nan;0;0
5355;170144;637;85;35;1;34;.971;3600000;0
5355;-1;628;0;0;0;0;.00nan;0;0
5355;-1;628;77;34;3;31;.912;3514000;0
5356;169552;642;0;0;0;0;.00nan;0;0
5356;24593;642;66;29;3;26;.897;3600000;0
5356;85546;631;45;27;5;22;.815;3514000;0
5356;87603;631;0;0;0;0;.00nan;0;0
5357;177631;1813;0;0;0;0;.00nan;0;0
5357;8426;629;65;40;4;36;.900;3600000;0
5357;174334;1813;67;27;2;25;.926;3600000;0
5357;85644;629;0;0;0;0;.00nan;0;0
5358;-1;625;0;0;0;0;.00nan;0;0
5358;-1;625;51;25;4;21;.840;3551000;0
5358;73274;647;0;0;0;0;.00nan;0;0
5358;80222;647;80;33;3;30;.909;3600000;0
5359;-1;628;0;0;0;0;.00nan;0;0
5359;-1;628;100;34;0;34;1.000;3600000;0
5359;85546;631;65;37;3;34;.919;3600000;0
5359;87603;631;0;0;0;0;.00nan;0;0
5360;3928;636;78;28;1;27;.964;3600000;0
5360;8426;629;69;33;3;30;.909;3586000;0
5360;85644;629;0;0;0;0;.00nan;0;0
5360;151728;636;0;0;0;0;.00nan;0;0
5361;8942;639;55;20;2;18;.900;2557000;0
5361;11107;637;57;30;4;26;.867;3600000;0
5361;170144;637;0;0;0;0;.00nan;0;0
5361;86485;639;34;15;4;11;.733;961000;0
5362;57859;1814;98;39;2;37;.949;3600000;0
5362;59239;1814;0;0;0;0;.00nan;0;0
5362;73274;647;0;0;0;0;.00nan;0;0
5362;80222;647;31;32;6;26;.813;3600000;0
5363;17625;651;100;36;1;35;.972;3900000;0
5363;169552;642;0;0;0;0;.00nan;0;0
5363;24593;642;71;23;1;22;.957;3900000;0
5363;149584;651;0;0;0;0;.00nan;0;0
5364;177631;1813;0;0;0;0;.00nan;0;0
5364;11068;641;0;0;0;0;.00nan;0;0
5364;174334;1813;64;17;1;16;.941;3600000;0
5364;160577;641;68;31;4;27;.871;3600000;0
5365;165867;627;0;0;0;0;.00nan;0;0
5365;-1;625;99;48;2;46;.958;3600000;0
5365;-1;625;0;0;0;0;.00nan;0;0
5365;43064;627;63;41;4;37;.902;3515000;0
5366;17625;651;0;0;0;0;.00nan;0;0
5366;85546;631;44;23;4;19;.826;3563000;0
5366;87603;631;0;0;0;0;.00nan;0;0
5366;149584;651;99;45;3;42;.933;3600000;0
5367;-1;625;0;0;0;0;.00nan;0;0
5367;-1;628;0;0;0;0;.00nan;0;0
5367;-1;628;76;26;2;24;.923;3636000;0
5367;-1;625;83;30;1;29;.967;3636000;0
5368;165867;627;0;0;0;0;.00nan;0;0
5368;169552;642;0;0;0;0;.00nan;0;0
5368;24593;642;74;40;4;36;.900;3845000;0
5368;43064;627;93;42;3;39;.929;3872000;0
5369;177631;1813;0;0;0;0;.00nan;0;0
5369;174334;1813;61;26;3;23;.885;3600000;0
5369;57859;1814;64;34;5;29;.853;3513000;0
5369;59239;1814;0;0;0;0;.00nan;0;0
5370;8426;629;22;26;6;20;.769;3005000;0
5370;11068;641;50;21;3;18;.857;3600000;0
5370;85644;629;53;3;0;3;1.000;595000;0
5370;160577;641;0;0;0;0;.00nan;0;0
5371;3928;636;43;31;6;25;.806;3754000;0
5371;11107;637;51;9;1;8;.889;1410000;0
5371;170144;637;44;23;4;19;.826;2344000;0
5371;151728;636;0;0;0;0;.00nan;0;0
5372;8942;639;0;0;0;0;.00nan;0;0
5372;73274;647;0;0;0;0;.00nan;0;0
5372;80222;647;64;32;5;27;.844;3600000;0
5372;86485;639;86;31;1;30;.968;3600000;0
5373;8942;639;0;0;0;0;.00nan;0;0
5373;165867;627;0;0;0;0;.00nan;0;0
5373;43064;627;71;23;1;22;.957;3600000;0
5373;86485;639;83;49;5;44;.898;3600000;0
5374;57859;1814;96;47;2;45;.957;3600000;0
5374;59239;1814;0;0;0;0;.00nan;0;0
5374;85546;631;78;42;3;39;.929;3576000;0
5374;87603;631;0;0;0;0;.00nan;0;0
5375;3928;636;73;32;2;30;.938;3600000;0
5375;169552;642;0;0;0;0;.00nan;0;0
5375;24593;642;71;34;3;31;.912;3554000;0
5375;151728;636;0;0;0;0;.00nan;0;0
5376;11068;641;72;31;3;28;.903;3600000;0
5376;-1;628;0;0;0;0;.00nan;0;0
5376;-1;628;44;23;4;19;.826;3600000;0
5376;160577;641;0;0;0;0;.00nan;0;0
5377;177631;1813;0;0;0;0;.00nan;0;0
5377;11107;637;0;0;0;0;.00nan;0;0
5377;170144;637;81;38;3;35;.921;3900000;0
5377;174334;1813;56;28;3;25;.893;3900000;0
5378;17625;651;0;0;0;0;.00nan;0;0
5378;73274;647;0;0;0;0;.00nan;0;0
5378;80222;647;81;40;3;37;.925;3546000;0
5378;149584;651;89;25;1;24;.960;3600000;0
5379;8426;629;99;44;1;43;.977;3600000;0
5379;-1;625;46;33;5;28;.848;3600000;0
5379;-1;625;0;0;0;0;.00nan;0;0
5379;85644;629;0;0;0;0;.00nan;0;0
5380;177631;1813;0;0;0;0;.00nan;0;0
5380;169552;642;0;0;0;0;.00nan;0;0
5380;24593;642;52;25;4;21;.840;3566000;0
5380;174334;1813;71;34;3;31;.912;3600000;0
5381;11068;641;0;0;0;0;.00nan;0;0
5381;165867;627;0;0;0;0;.00nan;0;0
5381;43064;627;81;23;1;22;.957;3600000;0
5381;160577;641;61;32;3;29;.906;3565000;0
5382;3928;636;31;31;6;25;.806;3600000;0
5382;57859;1814;77;31;2;29;.935;3600000;0
5382;59239;1814;0;0;0;0;.00nan;0;0
5382;151728;636;0;0;0;0;.00nan;0;0
5383;8426;629;84;36;2;34;.944;3600000;0
5383;8942;639;0;0;0;0;.00nan;0;0
5383;85644;629;0;0;0;0;.00nan;0;0
5383;86485;639;74;31;3;28;.903;3555000;0
5384;11107;637;0;0;0;0;.00nan;0;0
5384;170144;637;47;29;4;25;.862;3859000;0
5384;73274;647;0;0;0;0;.00nan;0;0
5384;80222;647;78;42;4;38;.905;3900000;0
5385;17625;651;0;0;0;0;.00nan;0;0
5385;-1;628;55;26;3;23;.885;3600000;0
5385;-1;628;0;0;0;0;.00nan;0;0
5385;149584;651;85;33;2;31;.939;3600000;0
5386;-1;625;0;0;0;0;.00nan;0;0
5386;-1;625;92;37;2;35;.946;3600000;0
5386;85546;631;46;19;3;16;.842;3555000;0
5386;87603;631;0;0;0;0;.00nan;0;0
5387;-1;628;0;0;0;0;.00nan;0;0
5387;-1;628;65;36;4;32;.889;3600000;0
5387;57859;1814;78;35;3;32;.914;3600000;0
5387;59239;1814;0;0;0;0;.00nan;0;0
5388;8942;639;0;0;0;0;.00nan;0;0
5388;169552;642;0;0;0;0;.00nan;0;0
5388;24593;642;33;20;4;16;.800;3546000;0
5388;86485;639;99;49;3;46;.939;3600000;0
5389;11068;641;75;28;3;25;.893;3900000;0
5389;-1;625;65;30;3;27;.900;3900000;0
5389;-1;625;0;0;0;0;.00nan;0;0
5389;160577;641;0;0;0;0;.00nan;0;0
5390;8426;629;71;46;4;42;.913;3600000;0
5390;165867;627;0;0;0;0;.00nan;0;0
5390;43064;627;47;16;3;13;.813;3600000;0
5390;85644;629;0;0;0;0;.00nan;0;0
5391;3928;636;0;0;0;0;.00nan;0;0
5391;17625;651;0;0;0;0;.00nan;0;0
5391;149584;651;99;43;2;41;.953;3600000;0
5391;151728;636;86;43;3;40;.930;3549000;0
5392;11107;637;0;0;0;0;.00nan;0;0
5392;170144;637;72;35;3;32;.914;3600000;0
5392;85546;631;100;26;0;26;1.000;3600000;0
5392;87603;631;0;0;0;0;.00nan;0;0
5393;177631;1813;0;0;0;0;.00nan;0;0
5393;174334;1813;24;19;5;14;.737;3600000;0
5393;73274;647;0;0;0;0;.00nan;0;0
5393;80222;647;67;15;1;14;.933;3600000;0
5394;11107;637;0;0;0;0;.00nan;0;0
5394;165867;627;68;34;4;30;.882;3900000;0
5394;170144;637;52;26;4;22;.846;3900000;0
5394;43064;627;0;0;0;0;.00nan;0;0
5395;8942;639;0;0;0;0;.00nan;0;0
5395;57859;1814;60;19;2;17;.895;3600000;0
5395;59239;1814;0;0;0;0;.00nan;0;0
5395;86485;639;67;37;5;32;.865;3600000;0
5396;-1;628;0;0;0;0;.00nan;0;0
5396;-1;628;100;46;0;46;1.000;3600000;0
5396;73274;647;0;0;0;0;.00nan;0;0
5396;80222;647;64;22;2;20;.909;3576000;0
5397;3928;636;43;48;8;40;.833;3600000;0
5397;85546;631;80;26;1;25;.962;3600000;0
5397;87603;631;0;0;0;0;.00nan;0;0
5397;151728;636;0;0;0;0;.00nan;0;0
5398;8426;629;97;47;3;44;.936;3600000;0
5398;169552;642;0;0;0;0;.00nan;0;0
5398;24593;642;78;28;1;27;.964;3600000;0
5398;85644;629;0;0;0;0;.00nan;0;0
5399;177631;1813;0;0;0;0;.00nan;0;0
5399;-1;625;40;30;6;24;.800;3152000;0
5399;174334;1813;96;31;1;30;.968;3600000;0
5399;-1;625;43;4;1;3;.750;448000;0
5400;11068;641;50;13;2;11;.846;1433000;0
5400;17625;651;0;0;0;0;.00nan;0;0
5400;149584;651;79;26;1;25;.962;3600000;0
5400;160577;641;47;31;5;26;.839;2167000;0
5401;8942;639;0;0;0;0;.00nan;0;0
5401;-1;628;0;0;0;0;.00nan;0;0
5401;-1;628;84;34;3;31;.912;3660000;0
5401;86485;639;71;42;4;38;.905;3660000;0
5402;177631;1813;0;0;0;0;.00nan;0;0
5402;174334;1813;44;31;5;26;.839;3600000;0
5402;85546;631;61;32;3;29;.906;3600000;0
5402;87603;631;0;0;0;0;.00nan;0;0
5403;17625;651;0;0;0;0;.00nan;0;0
5403;169552;642;34;6;2;4;.667;348000;0
5403;24593;642;45;26;5;21;.808;3252000;0
5403;149584;651;78;29;2;27;.931;3600000;0
5404;8426;629;63;29;3;26;.897;3577000;0
5404;11068;641;0;0;0;0;.00nan;0;0
5404;85644;629;0;0;0;0;.00nan;0;0
5404;160577;641;79;34;2;32;.941;3600000;0
5405;11107;637;61;30;3;27;.900;3600000;0
5405;170144;637;0;0;0;0;.00nan;0;0
5405;57859;1814;54;30;4;26;.867;3600000;0
5405;59239;1814;0;0;0;0;.00nan;0;0
5406;3928;636;78;32;2;30;.938;3600000;0
5406;73274;647;0;0;0;0;.00nan;0;0
5406;80222;647;61;28;3;25;.893;3574000;0
5406;151728;636;0;0;0;0;.00nan;0;0
5407;165867;627;0;0;0;0;.00nan;0;0
5407;-1;625;0;0;0;0;.00nan;0;0
5407;-1;625;100;38;1;37;.974;3600000;0
5407;43064;627;95;39;2;37;.949;3558000;0
5408;-1;625;54;33;5;28;.848;3549000;0
5408;-1;628;63;33;4;29;.879;3600000;0
5408;-1;628;0;0;0;0;.00nan;0;0
5408;-1;625;0;0;0;0;.00nan;0;0
5409;8426;629;68;28;2;26;.929;3559000;0
5409;8942;639;0;0;0;0;.00nan;0;0
5409;85644;629;0;0;0;0;.00nan;0;0
5409;86485;639;64;22;1;21;.955;3600000;0
5410;165867;627;0;0;0;0;.00nan;0;0
5410;169552;642;0;0;0;0;.00nan;0;0
5410;24593;642;78;24;1;23;.958;3600000;0
5410;43064;627;93;38;2;36;.947;3549000;0
5411;57859;1814;65;34;5;29;.853;3596000;0
5411;59239;1814;0;0;0;0;.00nan;0;0
5411;73274;647;0;0;0;0;.00nan;0;0
5411;80222;647;50;27;4;23;.852;3600000;0
5412;11068;641;64;34;3;31;.912;3584000;0
5412;85546;631;71;23;1;22;.957;3600000;0
5412;87603;631;0;0;0;0;.00nan;0;0
5412;160577;641;0;0;0;0;.00nan;0;0
5413;3928;636;75;38;3;35;.921;3573000;0
5413;11107;637;0;0;0;0;.00nan;0;0
5413;170144;637;81;28;1;27;.964;3600000;0
5413;151728;636;0;0;0;0;.00nan;0;0
5414;177631;1813;0;0;0;0;.00nan;0;0
5414;17625;651;0;0;0;0;.00nan;0;0
5414;174334;1813;67;34;4;30;.882;3517000;0
5414;149584;651;90;41;2;39;.951;3600000;0
5415;8942;639;0;0;0;0;.00nan;0;0
5415;11107;637;0;0;0;0;.00nan;0;0
5415;170144;637;77;43;3;40;.930;3600000;0
5415;86485;639;66;38;4;34;.895;3600000;0
5416;177631;1813;0;0;0;0;.00nan;0;0
5416;11068;641;0;0;0;0;.00nan;0;0
5416;174334;1813;72;21;2;19;.905;3600000;0
5416;160577;641;43;35;6;29;.829;3600000;0
5417;8426;629;78;32;3;29;.906;3558000;0
5417;-1;628;0;0;0;0;.00nan;0;0
5417;-1;628;84;25;1;24;.960;3600000;0
5417;85644;629;0;0;0;0;.00nan;0;0
5418;73274;647;0;0;0;0;.00nan;0;0
5418;80222;647;94;39;2;37;.949;3600000;0
5418;85546;631;43;16;3;13;.813;3545000;0
5418;87603;631;0;0;0;0;.00nan;0;0
5419;165867;627;0;0;0;0;.00nan;0;0
5419;17625;651;0;0;0;0;.00nan;0;0
5419;43064;627;88;44;3;41;.932;3600000;0
5419;149584;651;74;29;4;25;.862;3554000;0
5420;169552;642;0;0;0;0;.00nan;0;0
5420;24593;642;90;23;0;23;1.000;3600000;0
5420;-1;625;0;0;0;0;.00nan;0;0
5420;-1;625;58;40;5;35;.875;3600000;0
5421;-1;628;92;32;1;31;.969;3600000;0
5421;-1;628;0;0;0;0;.00nan;0;0
5421;85546;631;79;33;3;30;.909;3512000;0
5421;87603;631;0;0;0;0;.00nan;0;0
5422;3928;636;77;25;2;23;.920;3854000;0
5422;57859;1814;76;39;3;36;.923;3854000;0
5422;59239;1814;0;0;0;0;.00nan;0;0
5422;151728;636;0;0;0;0;.00nan;0;0
5423;11107;637;0;0;0;0;.00nan;0;0
5423;170144;637;93;30;1;29;.967;3600000;0
5423;-1;625;87;40;2;38;.950;3600000;0
5423;-1;625;0;0;0;0;.00nan;0;0
5424;3928;636;94;36;2;34;.944;3600000;0
5424;165867;627;0;0;0;0;.00nan;0;0
5424;43064;627;61;26;3;23;.885;3568000;0
5424;151728;636;0;0;0;0;.00nan;0;0
5425;8426;629;33;14;4;10;.714;792000;0
5425;57859;1814;61;14;1;13;.929;3600000;0
5425;59239;1814;0;0;0;0;.00nan;0;0
5425;85644;629;58;32;4;28;.875;2808000;0
5426;17625;651;0;0;0;0;.00nan;0;0
5426;-1;628;0;0;0;0;.00nan;0;0
5426;-1;628;81;29;2;27;.931;3600000;0
5426;149584;651;78;35;3;32;.914;3544000;0
5427;8942;639;0;0;0;0;.00nan;0;0
5427;85546;631;0;0;0;0;.00nan;0;0
5427;86485;639;80;40;3;37;.925;3600000;0
5427;87603;631;57;30;5;25;.833;3567000;0
5428;177631;1813;64;30;3;27;.900;3600000;0
5428;174334;1813;0;0;0;0;.00nan;0;0
5428;73274;647;0;0;0;0;.00nan;0;0
5428;80222;647;98;23;0;23;1.000;3600000;0
5429;11068;641;100;22;0;22;1.000;3600000;0
5429;169552;642;0;0;0;0;.00nan;0;0
5429;24593;642;62;20;2;18;.900;3515000;0
5429;160577;641;0;0;0;0;.00nan;0;0
5430;177631;1813;0;0;0;0;.00nan;0;0
5430;174334;1813;58;22;3;19;.864;3600000;0
5430;57859;1814;67;26;2;24;.923;3600000;0
5430;59239;1814;0;0;0;0;.00nan;0;0
5431;11068;641;0;0;0;0;.00nan;0;0
5431;11107;637;0;0;0;0;.00nan;0;0
5431;170144;637;59;11;1;10;.909;3600000;0
5431;160577;641;87;40;2;38;.950;3560000;0
5432;8426;629;67;29;3;26;.897;3600000;0
5432;169552;642;0;0;0;0;.00nan;0;0
5432;24593;642;28;28;6;22;.786;3600000;0
5432;85644;629;0;0;0;0;.00nan;0;0
5433;165867;627;0;0;0;0;.00nan;0;0
5433;43064;627;71;26;2;24;.923;3600000;0
5433;73274;647;0;0;0;0;.00nan;0;0
5433;80222;647;57;40;5;35;.875;3600000;0
5434;3928;636;95;36;2;34;.944;3600000;0
5434;17625;651;0;0;0;0;.00nan;0;0
5434;149584;651;52;36;5;31;.861;3600000;0
5434;151728;636;0;0;0;0;.00nan;0;0
5435;8942;639;0;0;0;0;.00nan;0;0
5435;-1;625;46;25;4;21;.840;3565000;0
5435;-1;625;0;0;0;0;.00nan;0;0
5435;86485;639;63;21;2;19;.905;3600000;0
5436;3928;636;43;16;3;13;.813;3600000;0
5436;8426;629;32;15;4;11;.733;1021000;0
5436;85644;629;73;27;2;25;.926;2579000;0
5436;151728;636;0;0;0;0;.00nan;0;0
5437;-1;625;0;0;0;0;.00nan;0;0
5437;-1;625;100;36;2;34;.944;3600000;0
5437;73274;647;70;31;3;28;.903;3572000;0
5437;80222;647;0;0;0;0;.00nan;0;0
5438;17625;651;0;0;0;0;.00nan;0;0
5438;85546;631;30;31;6;25;.806;3600000;0
5438;87603;631;0;0;0;0;.00nan;0;0
5438;149584;651;66;19;2;17;.895;3600000;0
5439;8942;639;66;34;3;31;.912;3560000;0
5439;11068;641;79;31;2;29;.935;3600000;0
5439;86485;639;0;0;0;0;.00nan;0;0
5439;160577;641;0;0;0;0;.00nan;0;0
5440;169552;642;0;0;0;0;.00nan;0;0
5440;24593;642;54;37;4;33;.892;3600000;0
5440;-1;628;0;0;0;0;.00nan;0;0
5440;-1;628;53;22;3;19;.864;3600000;0
5441;11107;637;0;0;0;0;.00nan;0;0
5441;17625;651;0;0;0;0;.00nan;0;0
5441;170144;637;67;36;3;33;.917;3847000;0
5441;149584;651;48;25;4;21;.840;3847000;0
5442;-1;625;61;42;5;37;.881;3600000;0
5442;-1;625;0;0;0;0;.00nan;0;0
5442;57859;1814;0;0;0;0;.00nan;0;0
5442;59239;1814;88;36;1;35;.972;3600000;0
5443;165867;627;69;23;2;21;.913;3600000;0
5443;43064;627;0;0;0;0;.00nan;0;0
5443;85546;631;87;42;3;39;.929;3579000;0
5443;87603;631;0;0;0;0;.00nan;0;0
5444;8426;629;0;0;0;0;.00nan;0;0
5444;73274;647;0;0;0;0;.00nan;0;0
5444;80222;647;55;24;3;21;.875;3570000;0
5444;85644;629;97;33;1;32;.970;3600000;0
5445;3928;636;41;25;4;21;.840;3900000;0
5445;177631;1813;0;0;0;0;.00nan;0;0
5445;174334;1813;70;48;4;44;.917;3900000;0
5445;151728;636;0;0;0;0;.00nan;0;0
5446;11107;637;0;0;0;0;.00nan;0;0
5446;170144;637;40;34;5;29;.853;3600000;0
5446;-1;628;65;24;2;22;.917;3600000;0
5446;-1;628;0;0;0;0;.00nan;0;0
5447;8426;629;63;29;3;26;.897;3563000;0
5447;165867;627;0;0;0;0;.00nan;0;0
5447;43064;627;61;22;2;20;.909;3600000;0
5447;85644;629;0;0;0;0;.00nan;0;0
5448;169552;642;0;0;0;0;.00nan;0;0
5448;24593;642;92;33;1;32;.970;3600000;0
5448;85546;631;45;24;3;21;.875;3583000;0
5448;87603;631;0;0;0;0;.00nan;0;0
5449;177631;1813;0;0;0;0;.00nan;0;0
5449;8942;639;0;0;0;0;.00nan;0;0
5449;174334;1813;40;37;7;30;.811;3600000;0
5449;86485;639;67;34;4;30;.882;3600000;0
5450;11068;641;0;0;0;0;.00nan;0;0
5450;57859;1814;71;32;4;28;.875;3570000;0
5450;59239;1814;0;0;0;0;.00nan;0;0
5450;160577;641;89;34;2;32;.941;3600000;0
5451;17625;651;0;0;0;0;.00nan;0;0
5451;73274;647;0;0;0;0;.00nan;0;0
5451;80222;647;94;37;2;35;.946;3900000;0
5451;149584;651;77;26;2;24;.923;3900000;0
5452;3928;636;41;19;3;16;.842;3600000;0
5452;-1;625;0;0;0;0;.00nan;0;0
5452;-1;625;62;45;5;40;.889;3523000;0
5452;151728;636;0;0;0;0;.00nan;0;0
5453;11068;641;86;37;2;35;.946;3900000;0
5453;-1;628;0;0;0;0;.00nan;0;0
5453;-1;628;70;28;2;26;.929;3900000;0
5453;160577;641;0;0;0;0;.00nan;0;0
5454;3928;636;96;25;0;25;1.000;3600000;0
5454;85546;631;77;31;2;29;.935;3574000;0
5454;87603;631;0;0;0;0;.00nan;0;0
5454;151728;636;0;0;0;0;.00nan;0;0
5455;8426;629;63;32;3;29;.906;3574000;0
5455;-1;625;78;33;2;31;.939;3600000;0
5455;-1;625;0;0;0;0;.00nan;0;0
5455;85644;629;0;0;0;0;.00nan;0;0
5456;8942;639;0;0;0;0;.00nan;0;0
5456;73274;647;0;0;0;0;.00nan;0;0
5456;80222;647;55;35;5;30;.857;3600000;0
5456;86485;639;91;33;1;32;.970;3600000;0
5457;-1;628;0;0;0;0;.00nan;0;0
5457;-1;628;78;29;2;27;.931;3600000;0
5457;57859;1814;76;38;3;35;.921;3594000;0
5457;59239;1814;0;0;0;0;.00nan;0;0
5458;177631;1813;0;0;0;0;.00nan;0;0
5458;165867;627;46;6;1;5;.833;884000;0
5458;174334;1813;77;22;1;21;.955;3600000;0
5458;43064;627;22;24;6;18;.750;2716000;0
5459;11107;637;0;0;0;0;.00nan;0;0
5459;169552;642;0;0;0;0;.00nan;0;0
5459;170144;637;77;50;4;46;.920;3574000;0
5459;24593;642;54;17;2;15;.882;3600000;0
5460;11068;641;0;0;0;0;.00nan;0;0
5460;17625;651;83;23;1;22;.957;3600000;0
5460;149584;651;0;0;0;0;.00nan;0;0
5460;160577;641;47;29;4;25;.862;3600000;0
5461;8942;639;0;0;0;0;.00nan;0;0
5461;169552;642;0;0;0;0;.00nan;0;0
5461;24593;642;91;30;1;29;.967;3600000;0
5461;86485;639;65;40;4;36;.900;3600000;0
5462;11068;641;0;0;0;0;.00nan;0;0
5462;165867;627;0;0;0;0;.00nan;0;0
5462;43064;627;68;31;3;28;.903;3553000;0
5462;160577;641;97;33;1;32;.970;3600000;0
5463;3928;636;82;29;2;27;.931;3600000;0
5463;-1;628;67;37;3;34;.919;3568000;0
5463;-1;628;0;0;0;0;.00nan;0;0
5463;151728;636;0;0;0;0;.00nan;0;0
5464;8426;629;72;37;4;33;.892;3600000;0
5464;85546;631;0;0;0;0;.00nan;0;0
5464;85644;629;0;0;0;0;.00nan;0;0
5464;87603;631;85;15;0;15;1.000;3600000;0
5465;11107;637;0;0;0;0;.00nan;0;0
5465;170144;637;78;33;3;30;.909;3579000;0
5465;73274;647;0;0;0;0;.00nan;0;0
5465;80222;647;100;39;0;39;1.000;3600000;0
5466;17625;651;0;0;0;0;.00nan;0;0
5466;57859;1814;64;24;2;22;.917;3600000;0
5466;59239;1814;0;0;0;0;.00nan;0;0
5466;149584;651;97;48;3;45;.938;3600000;0
5467;177631;1813;0;0;0;0;.00nan;0;0
5467;-1;625;0;0;0;0;.00nan;0;0
5467;174334;1813;29;17;4;13;.765;3853000;0
5467;-1;625;61;41;4;37;.902;3900000;0
5468;169552;642;0;0;0;0;.00nan;0;0
5468;24593;642;74;46;4;42;.913;3600000;0
5468;57859;1814;83;27;1;26;.963;3600000;0
5468;59239;1814;0;0;0;0;.00nan;0;0
5469;177631;1813;0;0;0;0;.00nan;0;0
5469;11107;637;0;0;0;0;.00nan;0;0
5469;170144;637;57;40;5;35;.875;3543000;0
5469;174334;1813;44;31;4;27;.871;3600000;0
5470;8942;639;0;0;0;0;.00nan;0;0
5470;165867;627;51;22;3;19;.864;3546000;0
5470;43064;627;0;0;0;0;.00nan;0;0
5470;86485;639;85;32;1;31;.969;3600000;0
5471;8942;639;0;0;0;0;.00nan;0;0
5471;17625;651;0;0;0;0;.00nan;0;0
5471;86485;639;74;44;4;40;.909;3600000;0
5471;149584;651;74;22;1;21;.955;3600000;0
5472;165867;627;0;0;0;0;.00nan;0;0
5472;43064;627;67;24;2;22;.917;3516000;0
5472;57859;1814;0;0;0;0;.00nan;0;0
5472;59239;1814;100;38;0;38;1.000;3600000;0
5473;177631;1813;0;0;0;0;.00nan;0;0
5473;169552;642;81;25;1;24;.960;3600000;0
5473;24593;642;0;0;0;0;.00nan;0;0
5473;174334;1813;60;43;5;38;.884;3600000;0
5474;3928;636;100;31;0;31;1.000;3600000;0
5474;11068;641;71;35;3;32;.914;3600000;0
5474;151728;636;0;0;0;0;.00nan;0;0
5474;160577;641;0;0;0;0;.00nan;0;0
5475;8426;629;69;36;4;32;.889;3600000;0
5475;11107;637;0;0;0;0;.00nan;0;0
5475;170144;637;100;34;0;34;1.000;3600000;0
5475;85644;629;0;0;0;0;.00nan;0;0
5476;-1;628;0;0;0;0;.00nan;0;0
5476;-1;628;67;22;2;20;.909;3600000;0
5476;73274;647;0;0;0;0;.00nan;0;0
5476;80222;647;66;27;3;24;.889;3543000;0
5477;-1;625;100;33;0;33;1.000;3600000;0
5477;-1;625;0;0;0;0;.00nan;0;0
5477;85546;631;0;0;0;0;.00nan;0;0
5477;87603;631;33;24;5;19;.792;3600000;0
5478;165867;627;0;0;0;0;.00nan;0;0
5478;-1;628;0;0;0;0;.00nan;0;0
5478;-1;628;89;39;3;36;.923;3571000;0
5478;43064;627;89;28;1;27;.964;3600000;0
5479;8942;639;0;0;0;0;.00nan;0;0
5479;57859;1814;0;0;0;0;.00nan;0;0
5479;59239;1814;63;24;2;22;.917;3749000;0
5479;86485;639;73;38;3;35;.921;3749000;0
5480;3928;636;100;30;0;30;1.000;3600000;0
5480;169552;642;0;0;0;0;.00nan;0;0
5480;24593;642;86;37;1;36;.973;3573000;0
5480;151728;636;0;0;0;0;.00nan;0;0
5481;177631;1813;0;0;0;0;.00nan;0;0
5481;8426;629;100;31;0;31;1.000;3600000;0
5481;174334;1813;87;33;2;31;.939;3545000;0
5481;85644;629;0;0;0;0;.00nan;0;0
5482;11068;641;46;28;4;24;.857;3578000;0
5482;73274;647;0;0;0;0;.00nan;0;0
5482;80222;647;57;25;3;22;.880;3600000;0
5482;160577;641;0;0;0;0;.00nan;0;0
5483;11107;637;65;22;2;20;.909;3600000;0
5483;170144;637;0;0;0;0;.00nan;0;0
5483;85546;631;70;43;5;38;.884;3576000;0
5483;87603;631;0;0;0;0;.00nan;0;0
5484;17625;651;0;0;0;0;.00nan;0;0
5484;-1;625;40;27;5;22;.815;3533000;0
5484;-1;625;0;0;0;0;.00nan;0;0
5484;149584;651;67;34;4;30;.882;3600000;0
5485;177631;1813;0;0;0;0;.00nan;0;0
5485;174334;1813;69;25;3;22;.880;3610000;0
5485;-1;628;0;0;0;0;.00nan;0;0
5485;-1;628;79;32;2;30;.938;3610000;0
5486;57859;1814;100;39;1;38;.974;3600000;0
5486;59239;1814;0;0;0;0;.00nan;0;0
5486;85546;631;84;32;2;30;.938;3600000;0
5486;87603;631;0;0;0;0;.00nan;0;0
5487;169552;642;0;0;0;0;.00nan;0;0
5487;24593;642;64;36;4;32;.889;3534000;0
5487;73274;647;0;0;0;0;.00nan;0;0
5487;80222;647;85;32;2;30;.938;3600000;0
5488;8426;629;96;31;1;30;.968;3600000;0
5488;17625;651;0;0;0;0;.00nan;0;0
5488;85644;629;0;0;0;0;.00nan;0;0
5488;149584;651;76;31;2;29;.935;3574000;0
5489;3928;636;60;25;3;22;.880;3600000;0
5489;8942;639;65;10;0;10;1.000;975000;0
5489;86485;639;48;37;6;31;.838;2625000;0
5489;151728;636;0;0;0;0;.00nan;0;0
5490;11107;637;0;0;0;0;.00nan;0;0
5490;165867;627;0;0;0;0;.00nan;0;0
5490;170144;637;73;31;2;29;.935;3577000;0
5490;43064;627;80;25;1;24;.960;3600000;0
5491;11068;641;0;0;0;0;.00nan;0;0
5491;-1;625;64;24;2;22;.917;3600000;0
5491;-1;625;0;0;0;0;.00nan;0;0
5491;160577;641;52;37;5;32;.865;3600000;0
5495;177631;1813;0;0;0;0;.00nan;0;0
5495;17625;651;59;26;3;23;.885;3790000;0
5495;174334;1813;70;27;2;25;.926;3790000;0
5495;58112;651;0;0;0;0;.00nan;0;0
5499;-1;625;65;24;3;21;.875;3600000;0
5499;-1;625;0;0;0;0;.00nan;0;0
5499;73274;647;62;14;1;13;.929;2473000;0
5499;80222;647;23;17;5;12;.706;1127000;0
5501;169552;642;49;1;0;1;1.000;249000;0
5501;24593;642;54;49;7;42;.857;3351000;0
5501;85546;631;74;18;1;17;.944;3600000;0
5501;87603;631;0;0;0;0;.00nan;0;0
5503;8942;639;0;0;0;0;.00nan;0;0
5503;59239;1814;56;30;5;25;.833;3548000;0
5503;86485;639;65;26;3;23;.885;3600000;0
5503;159912;1814;0;0;0;0;.00nan;0;0
5505;3821;636;50;3;0;3;1.000;858000;0
5505;8426;629;67;33;3;30;.909;3600000;0
5505;85644;629;0;0;0;0;.00nan;0;0
5505;151728;636;43;36;6;30;.833;2742000;0
5509;8426;629;0;0;0;0;.00nan;0;0
5509;-1;625;0;0;0;0;.00nan;0;0
5509;-1;625;67;21;2;19;.905;3618000;0
5509;85644;629;99;42;1;41;.976;3618000;0
5511;17625;651;0;0;0;0;.00nan;0;0
5511;58112;651;76;32;2;30;.938;3600000;0
5511;59239;1814;49;26;4;22;.846;3591000;0
5511;72747;1814;0;0;0;0;.00nan;0;0
5515;11068;641;0;0;0;0;.00nan;0;0
5515;73274;647;0;0;0;0;.00nan;0;0
5515;80222;647;63;21;2;19;.905;3667000;0
5515;160577;641;88;38;3;35;.921;3667000;0
5517;3821;636;66;40;4;36;.900;3600000;0
5517;177631;1813;32;28;5;23;.821;3594000;0
5517;174334;1813;0;0;0;0;.00nan;0;0
5517;151728;636;0;0;0;0;.00nan;0;0
5519;169552;642;67;35;4;31;.886;3577000;0
5519;24593;642;0;0;0;0;.00nan;0;0
5519;85546;631;0;0;0;0;.00nan;0;0
5519;87603;631;80;32;3;29;.906;3600000;0
5521;11068;641;65;32;3;29;.906;3564000;0
5521;59239;1814;72;24;2;22;.917;3600000;0
5521;72747;1814;0;0;0;0;.00nan;0;0
5521;160577;641;0;0;0;0;.00nan;0;0
5523;3821;636;0;0;0;0;.00nan;0;0
5523;17625;651;41;24;4;20;.833;3566000;0
5523;58112;651;0;0;0;0;.00nan;0;0
5523;151728;636;55;28;3;25;.893;3600000;0
5529;8426;629;84;31;1;30;.968;3900000;0
5529;-1;625;82;30;1;29;.967;3900000;0
5529;-1;625;0;0;0;0;.00nan;0;0
5529;85644;629;0;0;0;0;.00nan;0;0
5533;8942;639;0;0;0;0;.00nan;0;0
5533;85546;631;40;27;5;22;.815;3600000;0
5533;86485;639;87;38;2;36;.947;3600000;0
5533;87603;631;0;0;0;0;.00nan;0;0
5535;8426;629;0;0;0;0;.00nan;0;0
5535;73274;647;0;0;0;0;.00nan;0;0
5535;80222;647;60;15;2;13;.867;3600000;0
5535;85644;629;50;42;6;36;.857;3600000;0
5537;11068;641;49;1;0;1;1.000;443000;0
5537;59239;1814;0;0;0;0;.00nan;0;0
5537;72747;1814;37;23;5;18;.783;3600000;0
5537;160577;641;50;38;6;32;.842;3123000;0
5541;3821;636;51;21;3;18;.857;3563000;0
5541;169552;642;0;0;0;0;.00nan;0;0
5541;24593;642;90;35;2;33;.943;3600000;0
5541;151728;636;0;0;0;0;.00nan;0;0
5545;17625;651;0;0;0;0;.00nan;0;0
5545;-1;625;0;0;0;0;.00nan;0;0
5545;-1;625;100;28;0;28;1.000;3600000;0
5545;58112;651;58;28;3;25;.893;3600000;0
5547;177631;1813;0;0;0;0;.00nan;0;0
5547;8942;639;66;39;4;35;.897;3600000;0
5547;174334;1813;64;17;1;16;.941;3600000;0
5547;86485;639;0;0;0;0;.00nan;0;0
5549;17625;651;65;33;4;29;.879;3900000;0
5549;58112;651;0;0;0;0;.00nan;0;0
5549;59239;1814;40;19;4;15;.789;3900000;0
5549;72747;1814;0;0;0;0;.00nan;0;0
5557;177631;1813;0;0;0;0;.00nan;0;0
5557;174334;1813;69;30;2;28;.933;3900000;0
5557;85546;631;0;0;0;0;.00nan;0;0
5557;87603;631;70;27;2;25;.926;3900000;0
5559;3821;636;0;0;0;0;.00nan;0;0
5559;-1;625;0;0;0;0;.00nan;0;0
5559;-1;625;80;28;2;26;.929;3600000;0
5559;151728;636;34;26;5;21;.808;3600000;0
5561;8942;639;44;11;2;9;.818;994000;0
5561;169552;642;0;0;0;0;.00nan;0;0
5561;24593;642;31;24;5;19;.792;3600000;0
5561;86485;639;30;29;6;23;.793;2606000;0
5563;8426;629;44;18;3;15;.833;3644000;0
5563;8942;639;67;37;4;33;.892;3644000;0
5563;85644;629;0;0;0;0;.00nan;0;0
5563;86485;639;0;0;0;0;.00nan;0;0
5565;169552;642;0;0;0;0;.00nan;0;0
5565;24593;642;79;52;3;49;.942;3600000;0
5565;85546;631;54;15;2;13;.867;3600000;0
5565;87603;631;0;0;0;0;.00nan;0;0
5571;17625;651;0;0;0;0;.00nan;0;0
5571;58112;651;49;28;4;24;.857;3586000;0
5571;59239;1814;0;0;0;0;.00nan;0;0
5571;72747;1814;68;35;3;32;.914;3600000;0
5575;177631;1813;79;29;2;27;.931;3600000;0
5575;11068;641;0;0;0;0;.00nan;0;0
5575;174334;1813;0;0;0;0;.00nan;0;0
5575;160577;641;72;34;3;31;.912;3599000;0
5579;177631;1813;0;0;0;0;.00nan;0;0
5579;8426;629;60;36;4;32;.889;3513000;0
5579;174334;1813;81;25;2;23;.920;3600000;0
5579;85644;629;0;0;0;0;.00nan;0;0
5581;8942;639;40;42;7;35;.833;2799000;0
5581;11068;641;62;26;3;23;.885;3600000;0
5581;86485;639;57;7;0;7;1.000;801000;0
5581;160577;641;0;0;0;0;.00nan;0;0
5585;-1;625;0;0;0;0;.00nan;0;0
5585;-1;625;47;22;3;19;.864;3575000;0
5585;85546;631;83;35;2;33;.943;3600000;0
5585;87603;631;0;0;0;0;.00nan;0;0
5587;3821;636;0;0;0;0;.00nan;0;0
5587;73274;647;14;16;6;10;.625;2790000;0
5587;80222;647;40;3;1;2;.667;797000;0
5587;151728;636;42;38;6;32;.842;3600000;0
238;165867;627;0;0;0;0;.00nan;0;0
238;43064;627;44;23;4;19;.826;3636000;0
238;73274;647;0;0;0;0;.00nan;0;0
238;80222;647;80;47;5;42;.894;3636000;0
239;177631;1813;72;21;1;20;.952;1396000;0
239;17625;651;0;0;0;0;.00nan;0;0
239;174334;1813;23;19;5;14;.737;2178000;0
239;149584;651;46;26;5;21;.808;3600000;0
240;165867;627;0;0;0;0;.00nan;0;0
240;43064;627;54;26;4;22;.846;3613000;0
240;73274;647;0;0;0;0;.00nan;0;0
240;80222;647;71;35;3;32;.914;3613000;0
241;177631;1813;70;15;0;15;1.000;1201000;0
241;17625;651;0;0;0;0;.00nan;0;0
241;174334;1813;52;34;5;29;.853;2352000;0
241;149584;651;71;29;3;26;.897;3600000;0
431;165867;627;0;0;0;0;.00nan;0;0
431;43064;627;38;19;4;15;.789;3600000;0
431;73274;647;0;0;0;0;.00nan;0;0
431;80222;647;55;35;5;30;.857;3579000;0
502;3928;636;63;39;5;34;.872;3600000;0
502;17625;651;0;0;0;0;.00nan;0;0
502;149584;651;100;38;0;38;1.000;3600000;0
502;151728;636;0;0;0;0;.00nan;0;0
503;11107;637;0;0;0;0;.00nan;0;0
503;169552;642;0;0;0;0;.00nan;0;0
503;170144;637;97;47;1;46;.979;3600000;0
503;24593;642;64;22;2;20;.909;3600000;0
504;57859;1814;71;38;4;34;.895;3600000;0
504;59239;1814;0;0;0;0;.00nan;0;0
504;85546;631;58;10;1;9;.900;3600000;0
504;87603;631;0;0;0;0;.00nan;0;0
505;165867;627;0;0;0;0;.00nan;0;0
505;-1;628;0;0;0;0;.00nan;0;0
505;-1;628;100;49;2;47;.959;3600000;0
505;43064;627;49;26;4;22;.846;3544000;0
506;3928;636;60;35;5;30;.857;4356000;0
506;17625;651;0;0;0;0;.00nan;0;0
506;149584;651;41;36;6;30;.833;4356000;0
506;151728;636;0;0;0;0;.00nan;0;0
507;11107;637;0;0;0;0;.00nan;0;0
507;169552;642;0;0;0;0;.00nan;0;0
507;170144;637;68;35;3;32;.914;3571000;0
507;24593;642;89;24;1;23;.958;3600000;0
508;57859;1814;34;31;6;25;.806;3600000;0
508;59239;1814;0;0;0;0;.00nan;0;0
508;85546;631;75;22;1;21;.955;3600000;0
508;87603;631;0;0;0;0;.00nan;0;0
509;165867;627;0;0;0;0;.00nan;0;0
509;-1;628;0;0;0;0;.00nan;0;0
509;-1;628;82;30;2;28;.933;3600000;0
509;43064;627;57;32;4;28;.875;3570000;0
510;3928;636;66;31;3;28;.903;3600000;0
510;17625;651;0;0;0;0;.00nan;0;0
510;149584;651;49;28;4;24;.857;3600000;0
510;151728;636;0;0;0;0;.00nan;0;0
511;11107;637;0;0;0;0;.00nan;0;0
511;169552;642;0;0;0;0;.00nan;0;0
511;170144;637;44;26;5;21;.808;3600000;0
511;24593;642;62;23;3;20;.870;3600000;0
512;57859;1814;100;44;1;43;.977;3600000;0
512;59239;1814;0;0;0;0;.00nan;0;0
512;85546;631;70;33;3;30;.909;3519000;0
512;87603;631;0;0;0;0;.00nan;0;0
513;165867;627;0;0;0;0;.00nan;0;0
513;-1;628;0;0;0;0;.00nan;0;0
513;-1;628;86;33;1;32;.970;3827000;0
513;43064;627;64;20;2;18;.900;3827000;0
514;3928;636;56;25;3;22;.880;3600000;0
514;17625;651;0;0;0;0;.00nan;0;0
514;149584;651;53;33;4;29;.879;3570000;0
514;151728;636;0;0;0;0;.00nan;0;0
515;11107;637;0;0;0;0;.00nan;0;0
515;169552;642;0;0;0;0;.00nan;0;0
515;170144;637;84;42;3;39;.929;3678000;0
515;24593;642;59;20;2;18;.900;3678000;0
516;57859;1814;57;29;4;25;.862;3583000;0
516;59239;1814;0;0;0;0;.00nan;0;0
516;85546;631;68;29;3;26;.897;3600000;0
516;87603;631;0;0;0;0;.00nan;0;0
517;165867;627;0;0;0;0;.00nan;0;0
517;-1;628;0;0;0;0;.00nan;0;0
517;-1;628;67;28;2;26;.929;3600000;0
517;43064;627;48;30;5;25;.833;3600000;0
738;3928;636;98;37;2;35;.946;3600000;0
738;17625;651;0;0;0;0;.00nan;0;0
738;149584;651;53;31;5;26;.839;3600000;0
738;151728;636;0;0;0;0;.00nan;0;0
739;11107;637;0;0;0;0;.00nan;0;0
739;169552;642;0;0;0;0;.00nan;0;0
739;170144;637;62;28;3;25;.893;3789000;0
739;24593;642;69;29;4;25;.862;3789000;0
740;57859;1814;80;38;3;35;.921;3600000;0
740;59239;1814;0;0;0;0;.00nan;0;0
740;85546;631;21;24;6;18;.750;2208000;0
740;87603;631;40;8;2;6;.750;1392000;0
892;11107;637;0;0;0;0;.00nan;0;0
892;169552;642;66;22;2;20;.909;2493000;0
892;170144;637;62;19;2;17;.895;3600000;0
892;24593;642;35;13;4;9;.692;1107000;0
893;57859;1814;26;15;4;11;.733;673000;0
893;59239;1814;52;35;5;30;.857;2927000;0
893;85546;631;82;16;0;16;1.000;3600000;0
893;87603;631;0;0;0;0;.00nan;0;0
928;11107;637;0;0;0;0;.00nan;0;0
928;169552;642;0;0;0;0;.00nan;0;0
928;170144;637;82;42;4;38;.905;3600000;0
928;24593;642;100;26;0;26;1.000;3600000;0
953;3928;636;50;25;4;21;.840;3600000;0
953;169552;642;0;0;0;0;.00nan;0;0
953;24593;642;64;45;6;39;.867;3600000;0
953;151728;636;0;0;0;0;.00nan;0;0
954;-1;628;0;0;0;0;.00nan;0;0
954;-1;628;58;25;3;22;.880;3600000;0
954;85546;631;45;30;5;25;.833;3598000;0
954;87603;631;0;0;0;0;.00nan;0;0
955;3928;636;90;36;2;34;.944;3600000;0
955;169552;642;0;0;0;0;.00nan;0;0
955;24593;642;79;36;3;33;.917;3551000;0
955;151728;636;0;0;0;0;.00nan;0;0
956;-1;628;0;0;0;0;.00nan;0;0
956;-1;628;51;38;5;33;.868;3600000;0
956;85546;631;76;30;2;28;.933;3600000;0
956;87603;631;0;0;0;0;.00nan;0;0
957;3928;636;99;23;0;23;1.000;3600000;0
957;169552;642;0;0;0;0;.00nan;0;0
957;24593;642;74;31;2;29;.935;3570000;0
957;151728;636;0;0;0;0;.00nan;0;0
958;-1;628;0;0;0;0;.00nan;0;0
958;-1;628;55;22;3;19;.864;3600000;0
958;85546;631;57;30;4;26;.867;3556000;0
958;87603;631;0;0;0;0;.00nan;0;0
959;3928;636;46;20;3;17;.850;3547000;0
959;169552;642;0;0;0;0;.00nan;0;0
959;24593;642;92;35;1;34;.971;3600000;0
959;151728;636;0;0;0;0;.00nan;0;0
960;-1;628;0;0;0;0;.00nan;0;0
960;-1;628;97;42;2;40;.952;3600000;0
960;85546;631;38;14;3;11;.786;3544000;0
960;87603;631;0;0;0;0;.00nan;0;0
1137;3928;636;90;31;1;30;.968;3600000;0
1137;169552;642;0;0;0;0;.00nan;0;0
1137;24593;642;56;38;5;33;.868;3600000;0
1137;151728;636;0;0;0;0;.00nan;0;0
1138;-1;628;0;0;0;0;.00nan;0;0
1138;-1;628;83;37;2;35;.946;3571000;0
1138;85546;631;83;27;1;26;.963;3600000;0
1138;87603;631;0;0;0;0;.00nan;0;0
1210;-1;628;58;19;2;17;.895;2496000;0
1210;-1;628;31;15;4;11;.733;1104000;0
1210;85546;631;60;24;2;22;.917;3600000;0
1210;87603;631;0;0;0;0;.00nan;0;0
1247;-1;628;83;27;1;26;.963;3600000;0
1247;-1;628;0;0;0;0;.00nan;0;0
1247;85546;631;70;24;2;22;.917;3566000;0
1247;87603;631;0;0;0;0;.00nan;0;0
1281;3928;636;54;22;3;19;.864;3542000;0
1281;-1;628;99;47;2;45;.957;3600000;0
1281;-1;628;0;0;0;0;.00nan;0;0
1281;151728;636;0;0;0;0;.00nan;0;0
5590;5663;848;0;0;0;0;.00nan;0;0
5590;19322;848;68;30;2;28;.933;3900000;0
5590;32404;833;0;0;0;0;.00nan;0;0
5590;53867;833;71;24;2;22;.917;3900000;0
5591;10322;838;0;0;0;0;.00nan;0;0
5591;13373;834;95;35;2;33;.943;3600000;0
5591;94240;838;83;44;3;41;.932;3600000;0
5591;147901;834;0;0;0;0;.00nan;0;0
5592;16838;830;80;35;3;32;.914;3531000;0
5592;32404;833;0;0;0;0;.00nan;0;0
5592;47791;830;0;0;0;0;.00nan;0;0
5592;53867;833;100;32;1;31;.969;3600000;0
5593;5663;848;79;29;2;27;.931;3600000;0
5593;8501;836;0;0;0;0;.00nan;0;0
5593;19322;848;0;0;0;0;.00nan;0;0
5593;68390;836;76;41;3;38;.927;3559000;0
5594;30431;839;76;43;4;39;.907;3600000;0
5594;180287;847;0;0;0;0;.00nan;0;0
5594;54017;847;80;26;2;24;.923;3600000;0
5594;78223;839;0;0;0;0;.00nan;0;0
5595;6084;829;0;0;0;0;.00nan;0;0
5595;26336;829;69;33;3;30;.909;3600000;0
5595;48141;831;0;0;0;0;.00nan;0;0
5595;78094;831;82;29;1;28;.966;3600000;0
5596;805;832;0;0;0;0;.00nan;0;0
5596;167824;828;0;0;0;0;.00nan;0;0
5596;15538;832;91;35;1;34;.971;3600000;0
5596;148041;828;92;25;0;25;1.000;3600000;0
5597;183545;842;0;0;0;0;.00nan;0;0
5597;165723;837;87;38;2;36;.947;3600000;0
5597;23433;842;25;25;6;19;.760;3600000;0
5597;89190;837;0;0;0;0;.00nan;0;0
5598;8501;836;0;0;0;0;.00nan;0;0
5598;183545;842;0;0;0;0;.00nan;0;0
5598;23433;842;74;28;2;26;.929;3600000;0
5598;68390;836;65;50;6;44;.880;3600000;0
5599;6084;829;0;0;0;0;.00nan;0;0
5599;167824;828;86;17;0;17;1.000;3600000;0
5599;26336;829;97;48;2;46;.958;3545000;0
5599;148041;828;0;0;0;0;.00nan;0;0
5600;805;832;0;0;0;0;.00nan;0;0
5600;13373;834;87;25;1;24;.960;3600000;0
5600;15538;832;67;38;3;35;.921;3547000;0
5600;147901;834;0;0;0;0;.00nan;0;0
5601;5663;848;68;28;2;26;.929;3600000;0
5601;19322;848;0;0;0;0;.00nan;0;0
5601;48141;831;0;0;0;0;.00nan;0;0
5601;78094;831;72;30;3;27;.900;3567000;0
5602;32404;833;0;0;0;0;.00nan;0;0
5602;180287;847;72;38;3;35;.921;3600000;0
5602;53867;833;49;37;5;32;.865;3559000;0
5602;54017;847;0;0;0;0;.00nan;0;0
5603;165723;837;69;30;2;28;.933;3600000;0
5603;30431;839;100;23;0;23;1.000;3600000;0
5603;78223;839;0;0;0;0;.00nan;0;0
5603;89190;837;0;0;0;0;.00nan;0;0
5604;16838;830;55;34;5;29;.853;3600000;0
5604;57413;830;0;0;0;0;.00nan;0;0
5604;57657;838;86;29;1;28;.966;3600000;0
5604;94240;838;0;0;0;0;.00nan;0;0
5605;5663;848;67;39;4;35;.897;3600000;0
5605;13373;834;100;31;0;31;1.000;3600000;0
5605;19322;848;0;0;0;0;.00nan;0;0
5605;147901;834;0;0;0;0;.00nan;0;0
5606;805;832;0;0;0;0;.00nan;0;0
5606;15538;832;75;42;4;38;.905;3900000;0
5606;16838;830;88;39;4;35;.897;3900000;0
5606;57413;830;0;0;0;0;.00nan;0;0
5607;8501;836;57;22;2;20;.909;1201000;0
5607;180287;847;56;16;2;14;.875;3600000;0
5607;54017;847;0;0;0;0;.00nan;0;0
5607;68390;836;67;33;4;29;.879;2399000;0
5608;30431;839;83;26;1;25;.962;3600000;0
5608;32404;833;0;0;0;0;.00nan;0;0
5608;53867;833;74;33;2;31;.939;3550000;0
5608;78223;839;0;0;0;0;.00nan;0;0
5609;183545;842;0;0;0;0;.00nan;0;0
5609;23433;842;88;36;2;34;.944;3900000;0
5609;48141;831;68;20;2;18;.900;3900000;0
5609;78094;831;0;0;0;0;.00nan;0;0
5610;167824;828;83;32;2;30;.938;3600000;0
5610;57657;838;65;34;4;30;.882;3595000;0
5610;94240;838;0;0;0;0;.00nan;0;0
5610;148041;828;0;0;0;0;.00nan;0;0
5611;6084;829;0;0;0;0;.00nan;0;0
5611;165723;837;81;30;2;28;.933;3600000;0
5611;26336;829;64;37;4;33;.892;3534000;0
5611;89190;837;0;0;0;0;.00nan;0;0
5612;6084;829;65;28;3;25;.893;3595000;0
5612;183545;842;0;0;0;0;.00nan;0;0
5612;23433;842;86;25;2;23;.920;3600000;0
5612;26336;829;0;0;0;0;.00nan;0;0
5613;167824;828;70;37;3;34;.919;3564000;0
5613;13373;834;68;22;2;20;.909;3600000;0
5613;147901;834;0;0;0;0;.00nan;0;0
5613;148041;828;0;0;0;0;.00nan;0;0
5614;16838;830;50;17;3;14;.824;3600000;0
5614;180287;847;54;37;5;32;.865;3566000;0
5614;54017;847;0;0;0;0;.00nan;0;0
5614;57413;830;0;0;0;0;.00nan;0;0
5615;8501;836;50;37;5;32;.865;3600000;0
5615;57657;838;72;19;1;18;.947;3600000;0
5615;68390;836;0;0;0;0;.00nan;0;0
5615;94240;838;0;0;0;0;.00nan;0;0
5616;805;832;100;48;2;46;.958;3600000;0
5616;15538;832;0;0;0;0;.00nan;0;0
5616;32404;833;0;0;0;0;.00nan;0;0
5616;53867;833;61;35;4;31;.886;3568000;0
5617;5663;848;93;39;3;36;.923;3600000;0
5617;19322;848;0;0;0;0;.00nan;0;0
5617;30431;839;45;26;4;22;.846;3550000;0
5617;78223;839;0;0;0;0;.00nan;0;0
5618;6084;829;0;0;0;0;.00nan;0;0
5618;8501;836;0;0;0;0;.00nan;0;0
5618;26336;829;73;21;1;20;.952;3600000;0
5618;68390;836;80;47;5;42;.894;3600000;0
5619;13373;834;65;17;1;16;.941;3600000;0
5619;180287;847;48;0;0;0;.00nan;312000;0
5619;54017;847;30;24;6;18;.750;3288000;0
5619;147901;834;0;0;0;0;.00nan;0;0
5620;32404;833;58;29;3;26;.897;3900000;0
5620;48141;831;0;0;0;0;.00nan;0;0
5620;53867;833;0;0;0;0;.00nan;0;0
5620;78094;831;58;23;3;20;.870;3900000;0
5621;805;832;0;0;0;0;.00nan;0;0
5621;15538;832;74;41;4;37;.902;3600000;0
5621;57657;838;64;29;3;26;.897;3600000;0
5621;94240;838;0;0;0;0;.00nan;0;0
5622;183545;842;72;37;3;34;.919;3596000;0
5622;23433;842;0;0;0;0;.00nan;0;0
5622;30431;839;0;0;0;0;.00nan;0;0
5622;78223;839;65;23;2;21;.913;3600000;0
5623;167824;828;0;0;0;0;.00nan;0;0
5623;16838;830;0;0;0;0;.00nan;0;0
5623;57413;830;86;23;1;22;.957;3600000;0
5623;148041;828;52;30;4;26;.867;3600000;0
5624;5663;848;0;0;0;0;.00nan;0;0
5624;165723;837;0;0;0;0;.00nan;0;0
5624;19322;848;73;50;5;45;.900;3600000;0
5624;89190;837;77;33;2;31;.939;3600000;0
5625;165723;837;100;25;0;25;1.000;3600000;0
5625;48141;831;81;36;4;32;.889;3600000;0
5625;78094;831;0;0;0;0;.00nan;0;0
5625;89190;837;0;0;0;0;.00nan;0;0
5626;13373;834;65;24;3;21;.875;3600000;0
5626;32404;833;64;22;2;20;.909;2696000;0
5626;53867;833;15;13;5;8;.615;904000;0
5626;147901;834;0;0;0;0;.00nan;0;0
5627;165723;837;55;32;4;28;.875;3600000;0
5627;16838;830;64;26;3;23;.885;3600000;0
5627;57413;830;0;0;0;0;.00nan;0;0
5627;89190;837;0;0;0;0;.00nan;0;0
5628;8501;836;0;0;0;0;.00nan;0;0
5628;30431;839;75;35;3;32;.914;3600000;0
5628;68390;836;65;39;4;35;.897;3545000;0
5628;78223;839;0;0;0;0;.00nan;0;0
5629;805;832;0;0;0;0;.00nan;0;0
5629;183545;842;0;0;0;0;.00nan;0;0
5629;15538;832;46;27;4;23;.852;3600000;0
5629;23433;842;73;31;2;29;.935;3600000;0
5630;5663;848;42;34;5;29;.853;3600000;0
5630;6084;829;51;26;4;22;.846;3600000;0
5630;19322;848;0;0;0;0;.00nan;0;0
5630;26336;829;0;0;0;0;.00nan;0;0
5631;180287;847;75;24;2;22;.917;3600000;0
5631;54017;847;0;0;0;0;.00nan;0;0
5631;57657;838;50;36;5;31;.861;3600000;0
5631;94240;838;0;0;0;0;.00nan;0;0
5632;167824;828;64;20;2;18;.900;3600000;0
5632;48141;831;0;0;0;0;.00nan;0;0
5632;78094;831;82;50;4;46;.920;3587000;0
5632;148041;828;0;0;0;0;.00nan;0;0
5633;165723;837;72;21;2;19;.905;3600000;0
5633;32404;833;0;0;0;0;.00nan;0;0
5633;53867;833;79;45;3;42;.933;3573000;0
5633;89190;837;0;0;0;0;.00nan;0;0
5634;183545;842;0;0;0;0;.00nan;0;0
5634;16838;830;59;31;4;27;.871;3600000;0
5634;23433;842;48;41;5;36;.878;3574000;0
5634;57413;830;0;0;0;0;.00nan;0;0
5635;6084;829;0;0;0;0;.00nan;0;0
5635;26336;829;73;22;1;21;.955;3600000;0
5635;180287;847;62;28;3;25;.893;3512000;0
5635;54017;847;0;0;0;0;.00nan;0;0
5636;5663;848;0;0;0;0;.00nan;0;0
5636;167824;828;0;0;0;0;.00nan;0;0
5636;19322;848;43;32;5;27;.844;3561000;0
5636;148041;828;50;22;4;18;.818;3600000;0
5637;13373;834;72;21;1;20;.952;3600000;0
5637;48141;831;76;33;2;31;.939;3600000;0
5637;78094;831;0;0;0;0;.00nan;0;0
5637;147901;834;0;0;0;0;.00nan;0;0
5638;30431;839;62;25;3;22;.880;3900000;0
5638;57657;838;75;40;3;37;.925;3900000;0
5638;78223;839;0;0;0;0;.00nan;0;0
5638;94240;838;0;0;0;0;.00nan;0;0
5639;805;832;0;0;0;0;.00nan;0;0
5639;165723;837;88;30;1;29;.967;3600000;0
5639;15538;832;43;26;4;22;.846;3600000;0
5639;89190;837;0;0;0;0;.00nan;0;0
5640;8501;836;98;41;3;38;.927;3900000;0
5640;13373;834;0;0;0;0;.00nan;0;0
5640;68390;836;0;0;0;0;.00nan;0;0
5640;147901;834;63;23;3;20;.870;3900000;0
5641;6084;829;56;34;4;30;.882;3569000;0
5641;16838;830;0;0;0;0;.00nan;0;0
5641;26336;829;0;0;0;0;.00nan;0;0
5641;57413;830;61;26;3;23;.885;3600000;0
5642;805;832;59;27;3;24;.889;3544000;0
5642;15538;832;0;0;0;0;.00nan;0;0
5642;48141;831;0;0;0;0;.00nan;0;0
5642;78094;831;90;46;2;44;.957;3600000;0
5643;5663;848;100;56;2;54;.964;3774000;0
5643;19322;848;0;0;0;0;.00nan;0;0
5643;180287;847;0;0;0;0;.00nan;0;0
5643;54017;847;57;27;3;24;.889;3774000;0
5644;183545;842;100;40;2;38;.950;3896000;0
5644;23433;842;0;0;0;0;.00nan;0;0
5644;57657;838;0;0;0;0;.00nan;0;0
5644;94240;838;71;29;2;27;.931;3900000;0
5645;8501;836;46;7;1;6;.857;547000;0
5645;32404;833;0;0;0;0;.00nan;0;0
5645;53867;833;75;23;1;22;.957;3600000;0
5645;68390;836;35;32;6;26;.813;3053000;0
5646;167824;828;0;0;0;0;.00nan;0;0
5646;30431;839;79;32;2;30;.938;3600000;0
5646;78223;839;0;0;0;0;.00nan;0;0
5646;148041;828;31;21;4;17;.810;3597000;0
5647;183545;842;41;2;1;1;.500;257000;0
5647;23433;842;25;36;7;29;.806;3343000;0
5647;180287;847;91;34;2;32;.941;3600000;0
5647;54017;847;0;0;0;0;.00nan;0;0
5648;6084;829;0;0;0;0;.00nan;0;0
5648;13373;834;85;31;1;30;.968;3600000;0
5648;26336;829;69;24;2;22;.917;3550000;0
5648;147901;834;0;0;0;0;.00nan;0;0
5649;8501;836;71;38;3;35;.921;3600000;0
5649;16838;830;69;22;2;20;.909;3600000;0
5649;57413;830;0;0;0;0;.00nan;0;0
5649;68390;836;0;0;0;0;.00nan;0;0
5650;5663;848;86;26;1;25;.962;3600000;0
5650;19322;848;0;0;0;0;.00nan;0;0
5650;32404;833;0;0;0;0;.00nan;0;0
5650;53867;833;44;23;4;19;.826;3600000;0
5651;48141;831;96;43;1;42;.977;3900000;0
5651;57657;838;90;27;1;26;.963;3900000;0
5651;78094;831;0;0;0;0;.00nan;0;0
5651;94240;838;0;0;0;0;.00nan;0;0
5652;805;832;0;0;0;0;.00nan;0;0
5652;15538;832;93;46;3;43;.935;3600000;0
5652;30431;839;25;7;3;4;.571;450000;0
5652;78223;839;63;17;1;16;.941;3094000;0
5653;167824;828;0;0;0;0;.00nan;0;0
5653;165723;837;89;34;2;32;.941;3900000;0
5653;89190;837;0;0;0;0;.00nan;0;0
5653;148041;828;63;30;2;28;.933;3900000;0
5654;5663;848;82;38;3;35;.921;3568000;0
5654;183545;842;0;0;0;0;.00nan;0;0
5654;19322;848;0;0;0;0;.00nan;0;0
5654;23433;842;85;31;1;30;.968;3600000;0
5655;13373;834;75;26;1;25;.962;3600000;0
5655;16838;830;80;41;3;38;.927;3583000;0
5655;57413;830;0;0;0;0;.00nan;0;0
5655;147901;834;0;0;0;0;.00nan;0;0
5656;805;832;0;0;0;0;.00nan;0;0
5656;6084;829;0;0;0;0;.00nan;0;0
5656;15538;832;90;36;2;34;.944;3600000;0
5656;26336;829;58;43;5;38;.884;3600000;0
5657;167824;828;0;0;0;0;.00nan;0;0
5657;180287;847;0;0;0;0;.00nan;0;0
5657;54017;847;70;23;1;22;.957;3600000;0
5657;148041;828;66;42;4;38;.905;3600000;0
5658;32404;833;0;0;0;0;.00nan;0;0
5658;53867;833;86;42;3;39;.929;3580000;0
5658;57657;838;72;23;2;21;.913;3600000;0
5658;94240;838;0;0;0;0;.00nan;0;0
5659;30431;839;22;8;4;4;.500;1088000;0
5659;48141;831;0;0;0;0;.00nan;0;0
5659;78094;831;59;33;4;29;.879;3600000;0
5659;78223;839;68;24;2;22;.917;2498000;0
5660;8501;836;62;48;6;42;.875;3204000;0
5660;48141;831;85;29;1;28;.966;3600000;0
5660;68390;836;57;8;0;8;1.000;396000;0
5660;78094;831;0;0;0;0;.00nan;0;0
5661;805;832;100;35;1;34;.971;3600000;0
5661;15538;832;0;0;0;0;.00nan;0;0
5661;180287;847;83;34;2;32;.941;3554000;0
5661;54017;847;0;0;0;0;.00nan;0;0
5662;5663;848;0;0;0;0;.00nan;0;0
5662;16838;830;85;35;2;33;.943;3600000;0
5662;19322;848;81;43;3;40;.930;3583000;0
5662;57413;830;0;0;0;0;.00nan;0;0
5663;165723;837;63;34;4;30;.882;3600000;0
5663;57657;838;37;32;6;26;.813;3047000;0
5663;89190;837;0;0;0;0;.00nan;0;0
5663;94240;838;55;5;0;5;1.000;510000;0
5664;6084;829;75;42;3;39;.929;3600000;0
5664;26336;829;0;0;0;0;.00nan;0;0
5664;30431;839;76;27;2;25;.926;3600000;0
5664;78223;839;0;0;0;0;.00nan;0;0
5665;167824;828;65;30;2;28;.933;3900000;0
5665;32404;833;81;31;2;29;.935;3900000;0
5665;53867;833;0;0;0;0;.00nan;0;0
5665;148041;828;0;0;0;0;.00nan;0;0
5666;8501;836;64;43;5;38;.884;3006000;0
5666;165723;837;96;22;0;22;1.000;3600000;0
5666;68390;836;28;8;3;5;.625;594000;0
5666;89190;837;0;0;0;0;.00nan;0;0
5667;183545;842;100;29;0;29;1.000;3600000;0
5667;23433;842;0;0;0;0;.00nan;0;0
5667;-1;833;0;0;0;0;.00nan;0;0
5667;53867;833;81;27;1;26;.963;3541000;0
5668;6084;829;0;0;0;0;.00nan;0;0
5668;26336;829;79;21;1;20;.952;3600000;0
5668;57657;838;67;35;3;32;.914;3564000;0
5668;94240;838;0;0;0;0;.00nan;0;0
5669;805;832;52;9;1;8;.889;439000;0
5669;5663;848;66;29;3;26;.897;3600000;0
5669;15538;832;34;30;6;24;.800;3161000;0
5669;19322;848;0;0;0;0;.00nan;0;0
5670;16838;830;56;17;2;15;.882;3600000;0
5670;48141;831;0;0;0;0;.00nan;0;0
5670;57413;830;0;0;0;0;.00nan;0;0
5670;78094;831;46;39;6;33;.846;3600000;0
5671;165723;837;68;24;2;22;.917;3600000;0
5671;180287;847;51;10;1;9;.900;1509000;0
5671;54017;847;21;18;6;12;.667;2091000;0
5671;89190;837;0;0;0;0;.00nan;0;0
5672;13373;834;72;24;1;23;.958;3600000;0
5672;165723;837;82;42;2;40;.952;3579000;0
5672;89190;837;0;0;0;0;.00nan;0;0
5672;147901;834;0;0;0;0;.00nan;0;0
5673;16838;830;57;35;5;30;.857;3600000;0
5673;30431;839;63;30;4;26;.867;3600000;0
5673;57413;830;0;0;0;0;.00nan;0;0
5673;78223;839;0;0;0;0;.00nan;0;0
5674;805;832;88;34;2;32;.941;3600000;0
5674;8501;836;55;26;3;23;.885;3593000;0
5674;15538;832;0;0;0;0;.00nan;0;0
5674;68390;836;0;0;0;0;.00nan;0;0
5675;180287;847;70;36;3;33;.917;3547000;0
5675;48141;831;63;27;2;25;.926;3600000;0
5675;54017;847;0;0;0;0;.00nan;0;0
5675;78094;831;0;0;0;0;.00nan;0;0
5676;5663;848;0;0;0;0;.00nan;0;0
5676;19322;848;73;23;1;22;.957;3600000;0
5676;57657;838;0;0;0;0;.00nan;0;0
5676;94240;838;59;24;2;22;.917;3592000;0
5677;167824;828;0;0;0;0;.00nan;0;0
5677;183545;842;0;0;0;0;.00nan;0;0
5677;23433;842;93;38;2;36;.947;3600000;0
5677;148041;828;58;24;3;21;.875;3600000;0
5678;8501;836;0;0;0;0;.00nan;0;0
5678;167824;828;68;19;1;18;.947;3600000;0
5678;68390;836;97;49;3;46;.939;3600000;0
5678;148041;828;0;0;0;0;.00nan;0;0
5679;13373;834;71;21;1;20;.952;3600000;0
5679;30431;839;0;0;0;0;.00nan;0;0
5679;78223;839;58;29;3;26;.897;3584000;0
5679;147901;834;0;0;0;0;.00nan;0;0
5680;16838;830;60;43;6;37;.860;3600000;0
5680;180287;847;0;0;0;0;.00nan;0;0
5680;54017;847;65;29;3;26;.897;3600000;0
5680;57413;830;0;0;0;0;.00nan;0;0
5681;183545;842;0;0;0;0;.00nan;0;0
5681;165723;837;48;24;4;20;.833;3900000;0
5681;23433;842;57;26;4;22;.846;3900000;0
5681;89190;837;0;0;0;0;.00nan;0;0
5682;6084;829;0;0;0;0;.00nan;0;0
5682;26336;829;50;28;4;24;.857;3900000;0
5682;48141;831;0;0;0;0;.00nan;0;0
5682;78094;831;59;32;4;28;.875;3900000;0
5683;805;832;52;3;0;3;1.000;293000;0
5683;167824;828;0;0;0;0;.00nan;0;0
5683;15538;832;36;34;7;27;.794;3307000;0
5683;148041;828;69;34;3;31;.912;3600000;0
5684;5663;848;70;16;1;15;.938;3600000;0
5684;8501;836;67;49;6;43;.878;3600000;0
5684;19322;848;0;0;0;0;.00nan;0;0
5684;68390;836;0;0;0;0;.00nan;0;0
5685;13373;834;97;34;1;33;.971;3600000;0
5685;57657;838;59;18;2;16;.889;3544000;0
5685;77084;838;0;0;0;0;.00nan;0;0
5685;147901;834;0;0;0;0;.00nan;0;0
5686;30431;839;0;0;0;0;.00nan;0;0
5686;180287;847;30;28;6;22;.786;2109000;0
5686;54017;847;68;10;0;10;1.000;1412000;0
5686;78223;839;60;28;4;24;.857;3600000;0
5687;805;832;100;52;1;51;.981;3600000;0
5687;13373;834;49;35;5;30;.857;3600000;0
5687;15538;832;0;0;0;0;.00nan;0;0
5687;147901;834;0;0;0;0;.00nan;0;0
5688;16838;830;76;27;3;24;.889;3600000;0
5688;57413;830;0;0;0;0;.00nan;0;0
5688;57657;838;0;0;0;0;.00nan;0;0
5688;77084;838;71;44;5;39;.886;3600000;0
5689;8501;836;0;0;0;0;.00nan;0;0
5689;183545;842;83;26;1;25;.962;3600000;0
5689;23433;842;0;0;0;0;.00nan;0;0
5689;68390;836;97;40;2;38;.950;3566000;0
5690;-1;833;0;0;0;0;.00nan;0;0
5690;180287;847;67;23;2;21;.913;3843000;0
5690;53867;833;96;38;2;36;.947;3900000;0
5690;54017;847;0;0;0;0;.00nan;0;0
5691;6084;829;48;29;5;24;.828;3600000;0
5691;167824;828;63;23;2;21;.913;3600000;0
5691;26336;829;0;0;0;0;.00nan;0;0
5691;148041;828;0;0;0;0;.00nan;0;0
5692;16838;830;40;24;5;19;.792;3600000;0
5692;-1;833;56;42;6;36;.857;3569000;0
5692;53867;833;0;0;0;0;.00nan;0;0
5692;57413;830;0;0;0;0;.00nan;0;0
5693;5663;848;48;37;6;31;.838;3600000;0
5693;19322;848;0;0;0;0;.00nan;0;0
5693;48141;831;100;44;1;43;.977;3600000;0
5693;78094;831;0;0;0;0;.00nan;0;0
5694;165723;837;85;25;2;23;.920;3600000;0
5694;30431;839;76;50;4;46;.920;3546000;0
5694;78223;839;0;0;0;0;.00nan;0;0
5694;89190;837;0;0;0;0;.00nan;0;0
5695;183545;842;0;0;0;0;.00nan;0;0
5695;23433;842;67;45;5;40;.889;3600000;0
5695;48141;831;77;31;2;29;.935;3600000;0
5695;78094;831;0;0;0;0;.00nan;0;0
5696;6084;829;0;0;0;0;.00nan;0;0
5696;165723;837;46;35;6;29;.829;3698000;0
5696;26336;829;39;38;7;31;.816;3698000;0
5696;89190;837;0;0;0;0;.00nan;0;0
5697;8501;836;99;51;2;49;.961;3600000;0
5697;180287;847;0;0;0;0;.00nan;0;0
5697;54017;847;49;18;3;15;.833;3600000;0
5697;68390;836;0;0;0;0;.00nan;0;0
5698;805;832;0;0;0;0;.00nan;0;0
5698;15538;832;83;39;3;36;.923;3600000;0
5698;16838;830;37;27;5;22;.815;3555000;0
5698;57413;830;0;0;0;0;.00nan;0;0
5699;5663;848;67;31;3;28;.903;3900000;0
5699;13373;834;64;30;3;27;.900;3900000;0
5699;19322;848;0;0;0;0;.00nan;0;0
5699;147901;834;0;0;0;0;.00nan;0;0
5700;167824;828;81;34;2;32;.941;3900000;0
5700;57657;838;0;0;0;0;.00nan;0;0
5700;77084;838;63;25;2;23;.920;3900000;0
5700;148041;828;0;0;0;0;.00nan;0;0
5701;30431;839;90;42;2;40;.952;3600000;0
5701;-1;833;0;0;0;0;.00nan;0;0
5701;53867;833;77;36;3;33;.917;3548000;0
5701;78223;839;0;0;0;0;.00nan;0;0
5702;6084;829;0;0;0;0;.00nan;0;0
5702;183545;842;0;0;0;0;.00nan;0;0
5702;23433;842;84;39;2;37;.949;3543000;0
5702;26336;829;84;31;1;30;.968;3600000;0
5703;805;832;0;0;0;0;.00nan;0;0
5703;15538;832;69;30;2;28;.933;3900000;0
5703;-1;833;0;0;0;0;.00nan;0;0
5703;53867;833;80;31;2;29;.935;3900000;0
5704;8501;836;31;31;6;25;.806;3600000;0
5704;57657;838;0;0;0;0;.00nan;0;0
5704;68390;836;0;0;0;0;.00nan;0;0
5704;77084;838;56;18;2;16;.889;3600000;0
5705;5663;848;32;35;7;28;.800;3600000;0
5705;19322;848;0;0;0;0;.00nan;0;0
5705;30431;839;78;29;3;26;.897;3600000;0
5705;78223;839;0;0;0;0;.00nan;0;0
5706;167824;828;54;29;4;25;.862;3600000;0
5706;13373;834;74;23;1;22;.957;3600000;0
5706;147901;834;0;0;0;0;.00nan;0;0
5706;148041;828;0;0;0;0;.00nan;0;0
5707;165723;837;0;0;0;0;.00nan;0;0
5707;48141;831;41;37;6;31;.838;3331000;0
5707;78094;831;41;2;1;1;.500;269000;0
5707;89190;837;46;21;3;18;.857;3600000;0
5708;13373;834;0;0;0;0;.00nan;0;0
5708;180287;847;0;0;0;0;.00nan;0;0
5708;54017;847;85;26;1;25;.962;3600000;0
5708;147901;834;76;42;3;39;.929;3583000;0
5709;167824;828;76;34;3;31;.912;3600000;0
5709;16838;830;0;0;0;0;.00nan;0;0
5709;57413;830;45;26;4;22;.846;3550000;0
5709;148041;828;0;0;0;0;.00nan;0;0
5710;6084;829;100;31;0;31;1.000;3600000;0
5710;8501;836;0;0;0;0;.00nan;0;0
5710;26336;829;0;0;0;0;.00nan;0;0
5710;68390;836;68;48;5;43;.896;3600000;0
5711;805;832;89;34;2;32;.941;3600000;0
5711;15538;832;0;0;0;0;.00nan;0;0
5711;57657;838;0;0;0;0;.00nan;0;0
5711;77084;838;50;23;3;20;.870;3545000;0
5712;5663;848;0;0;0;0;.00nan;0;0
5712;165723;837;70;21;1;20;.952;3600000;0
5712;19322;848;81;33;2;31;.939;3544000;0
5712;89190;837;0;0;0;0;.00nan;0;0
5713;-1;833;87;30;1;29;.967;3600000;0
5713;48141;831;80;29;2;27;.931;3578000;0
5713;53867;833;0;0;0;0;.00nan;0;0
5713;78094;831;0;0;0;0;.00nan;0;0
5714;805;832;0;0;0;0;.00nan;0;0
5714;183545;842;0;0;0;0;.00nan;0;0
5714;15538;832;63;27;2;25;.926;3553000;0
5714;23433;842;84;33;1;32;.970;3600000;0
5715;5663;848;68;19;1;18;.947;3600000;0
5715;6084;829;76;29;2;27;.931;3545000;0
5715;19322;848;0;0;0;0;.00nan;0;0
5715;26336;829;0;0;0;0;.00nan;0;0
5716;180287;847;95;28;1;27;.964;3600000;0
5716;54017;847;0;0;0;0;.00nan;0;0
5716;57657;838;0;0;0;0;.00nan;0;0
5716;77084;838;66;32;4;28;.875;3600000;0
5717;13373;834;27;21;5;16;.762;3575000;0
5717;-1;833;0;0;0;0;.00nan;0;0
5717;53867;833;35;21;4;17;.810;3600000;0
5717;147901;834;0;0;0;0;.00nan;0;0
5718;167824;828;0;0;0;0;.00nan;0;0
5718;48141;831;0;0;0;0;.00nan;0;0
5718;78094;831;93;53;4;49;.925;3586000;0
5718;148041;828;57;26;3;23;.885;3600000;0
5719;165723;837;86;48;4;44;.917;3600000;0
5719;16838;830;81;27;1;26;.963;3600000;0
5719;57413;830;0;0;0;0;.00nan;0;0
5719;89190;837;0;0;0;0;.00nan;0;0
5720;8501;836;96;46;2;44;.957;3900000;0
5720;30431;839;0;0;0;0;.00nan;0;0
5720;68390;836;0;0;0;0;.00nan;0;0
5720;78223;839;63;24;2;22;.917;3900000;0
5721;8501;836;52;4;0;4;1.000;388000;0
5721;-1;833;0;0;0;0;.00nan;0;0
5721;53867;833;100;27;0;27;1.000;3600000;0
5721;68390;836;23;28;7;21;.750;3212000;0
5722;13373;834;84;30;1;29;.967;3600000;0
5722;48141;831;84;41;2;39;.951;3600000;0
5722;78094;831;0;0;0;0;.00nan;0;0
5722;147901;834;0;0;0;0;.00nan;0;0
5723;183545;842;0;0;0;0;.00nan;0;0
5723;16838;830;73;40;4;36;.900;3600000;0
5723;23433;842;100;29;0;29;1.000;3600000;0
5723;57413;830;0;0;0;0;.00nan;0;0
5724;805;832;0;0;0;0;.00nan;0;0
5724;165723;837;76;26;2;24;.923;3900000;0
5724;15538;832;71;38;2;36;.947;3900000;0
5724;89190;837;0;0;0;0;.00nan;0;0
5725;6084;829;0;0;0;0;.00nan;0;0
5725;26336;829;73;32;3;29;.906;3519000;0
5725;180287;847;80;25;1;24;.960;3600000;0
5725;54017;847;0;0;0;0;.00nan;0;0
5726;30431;839;82;31;2;29;.935;3600000;0
5726;57657;838;0;0;0;0;.00nan;0;0
5726;77084;838;100;33;0;33;1.000;3600000;0
5726;78223;839;0;0;0;0;.00nan;0;0
5727;183545;842;0;0;0;0;.00nan;0;0
5727;23433;842;45;24;4;20;.833;3882000;0
5727;57657;838;0;0;0;0;.00nan;0;0
5727;77084;838;47;32;5;27;.844;3882000;0
5728;6084;829;69;29;3;26;.897;3900000;0
5728;16838;830;70;25;3;22;.880;3900000;0
5728;26336;829;0;0;0;0;.00nan;0;0
5728;57413;830;0;0;0;0;.00nan;0;0
5729;8501;836;0;0;0;0;.00nan;0;0
5729;13373;834;82;22;1;21;.955;3600000;0
5729;68390;836;52;46;6;40;.870;3600000;0
5729;147901;834;0;0;0;0;.00nan;0;0
5730;5663;848;66;29;4;25;.862;3900000;0
5730;19322;848;0;0;0;0;.00nan;0;0
5730;180287;847;0;0;0;0;.00nan;0;0
5730;54017;847;50;30;4;26;.867;3900000;0
5731;805;832;0;0;0;0;.00nan;0;0
5731;15538;832;72;32;3;29;.906;3600000;0
5731;48141;831;52;28;4;24;.857;2324000;0
5731;78094;831;61;7;0;7;1.000;1221000;0
5732;167824;828;81;30;2;28;.933;3900000;0
5732;30431;839;0;0;0;0;.00nan;0;0
5732;78223;839;82;33;2;31;.939;3900000;0
5732;148041;828;0;0;0;0;.00nan;0;0
5733;165723;837;57;29;3;26;.897;3597000;0
5733;-1;833;0;0;0;0;.00nan;0;0
5733;53867;833;78;28;2;26;.929;3600000;0
5733;89190;837;0;0;0;0;.00nan;0;0
5734;5663;848;77;37;3;34;.919;3600000;0
5734;167824;828;97;26;0;26;1.000;3600000;0
5734;19322;848;0;0;0;0;.00nan;0;0
5734;148041;828;0;0;0;0;.00nan;0;0
5735;13373;834;100;44;2;42;.955;3900000;0
5735;16838;830;77;32;2;30;.938;3900000;0
5735;57413;830;0;0;0;0;.00nan;0;0
5735;147901;834;0;0;0;0;.00nan;0;0
5736;805;832;71;21;1;20;.952;3545000;0
5736;6084;829;0;0;0;0;.00nan;0;0
5736;15538;832;0;0;0;0;.00nan;0;0
5736;26336;829;100;34;0;34;1.000;3600000;0
5737;5663;848;0;0;0;0;.00nan;0;0
5737;183545;842;0;0;0;0;.00nan;0;0
5737;19322;848;100;27;0;27;1.000;3600000;0
5737;23433;842;16;36;8;28;.778;3600000;0
5738;-1;833;0;0;0;0;.00nan;0;0
5738;53867;833;60;20;2;18;.900;3580000;0
5738;57657;838;0;0;0;0;.00nan;0;0
5738;77084;838;94;34;1;33;.971;3600000;0
5739;30431;839;77;38;4;34;.895;3600000;0
5739;48141;831;43;16;3;13;.813;3600000;0
5739;78094;831;0;0;0;0;.00nan;0;0
5739;78223;839;0;0;0;0;.00nan;0;0
5740;167824;828;76;32;2;30;.938;3900000;0
5740;180287;847;0;0;0;0;.00nan;0;0
5740;54017;847;59;20;2;18;.900;3900000;0
5740;148041;828;0;0;0;0;.00nan;0;0
5741;183545;842;86;47;4;43;.915;3600000;0
5741;13373;834;90;25;1;24;.960;3600000;0
5741;23433;842;0;0;0;0;.00nan;0;0
5741;147901;834;0;0;0;0;.00nan;0;0
5742;6084;829;0;0;0;0;.00nan;0;0
5742;26336;829;100;29;0;29;1.000;3600000;0
5742;30431;839;0;0;0;0;.00nan;0;0
5742;78223;839;74;35;2;33;.943;3545000;0
5743;805;832;0;0;0;0;.00nan;0;0
5743;15538;832;72;44;5;39;.886;3900000;0
5743;180287;847;64;43;5;38;.884;3900000;0
5743;54017;847;0;0;0;0;.00nan;0;0
5744;167824;828;56;14;1;13;.929;1539000;0
5744;-1;833;0;0;0;0;.00nan;0;0
5744;53867;833;94;21;0;21;1.000;3600000;0
5744;148041;828;39;28;5;23;.821;2061000;0
5745;8501;836;76;36;3;33;.917;3600000;0
5745;48141;831;0;0;0;0;.00nan;0;0
5745;68390;836;0;0;0;0;.00nan;0;0
5745;78094;831;94;26;0;26;1.000;3600000;0
5746;165723;837;54;21;3;18;.857;3801000;0
5746;57657;838;0;0;0;0;.00nan;0;0
5746;77084;838;68;44;4;40;.909;3801000;0
5746;89190;837;0;0;0;0;.00nan;0;0
5747;5663;848;0;0;0;0;.00nan;0;0
5747;16838;830;68;28;3;25;.893;3708000;0
5747;19322;848;91;38;2;36;.947;3755000;0
5747;57413;830;0;0;0;0;.00nan;0;0
5748;8501;836;97;41;1;40;.976;2714000;0
5748;165723;837;84;14;0;14;1.000;3600000;0
5748;68390;836;25;13;4;9;.692;886000;0
5748;89190;837;0;0;0;0;.00nan;0;0
5749;5663;848;74;23;1;22;.957;3600000;0
5749;19322;848;0;0;0;0;.00nan;0;0
5749;-1;833;0;0;0;0;.00nan;0;0
5749;53867;833;83;42;3;39;.929;3574000;0
5750;180287;847;0;0;0;0;.00nan;0;0
5750;48141;831;0;0;0;0;.00nan;0;0
5750;54017;847;53;24;3;21;.875;3551000;0
5750;78094;831;85;40;2;38;.950;3600000;0
5751;13373;834;53;24;3;21;.875;3600000;0
5751;30431;839;61;42;5;37;.881;3514000;0
5751;78223;839;0;0;0;0;.00nan;0;0
5751;147901;834;0;0;0;0;.00nan;0;0
5752;16838;830;49;20;3;17;.850;3600000;0
5752;48141;831;0;0;0;0;.00nan;0;0
5752;57413;830;0;0;0;0;.00nan;0;0
5752;78094;831;58;44;5;39;.886;3581000;0
5753;805;832;0;0;0;0;.00nan;0;0
5753;5663;848;82;35;2;33;.943;3900000;0
5753;15538;832;97;39;2;37;.949;3900000;0
5753;19322;848;0;0;0;0;.00nan;0;0
5754;165723;837;64;19;1;18;.947;3567000;0
5754;180287;847;100;31;0;31;1.000;3600000;0
5754;54017;847;0;0;0;0;.00nan;0;0
5754;89190;837;0;0;0;0;.00nan;0;0
5755;6084;829;0;0;0;0;.00nan;0;0
5755;26336;829;57;33;4;29;.879;3568000;0
5755;57657;838;0;0;0;0;.00nan;0;0
5755;77084;838;60;24;3;21;.875;3600000;0
5756;8501;836;51;39;5;34;.872;3600000;0
5756;167824;828;0;0;0;0;.00nan;0;0
5756;68390;836;0;0;0;0;.00nan;0;0
5756;148041;828;58;14;1;13;.929;3600000;0
5757;167824;828;0;0;0;0;.00nan;0;0
5757;183545;842;0;0;0;0;.00nan;0;0
5757;23433;842;72;36;3;33;.917;3900000;0
5757;148041;828;80;38;3;35;.921;3900000;0
5758;6084;829;53;28;4;24;.857;3526000;0
5758;26336;829;0;0;0;0;.00nan;0;0
5758;-1;833;0;0;0;0;.00nan;0;0
5758;53867;833;84;32;2;30;.938;3600000;0
5759;805;832;0;0;0;0;.00nan;0;0
5759;8501;836;0;0;0;0;.00nan;0;0
5759;15538;832;74;25;1;24;.960;3600000;0
5759;68390;836;87;52;4;48;.923;3600000;0
5760;5663;848;0;0;0;0;.00nan;0;0
5760;19322;848;76;37;3;34;.919;3558000;0
5760;57657;838;0;0;0;0;.00nan;0;0
5760;77084;838;80;23;1;22;.957;3600000;0
5761;16838;830;57;23;3;20;.870;3766000;0
5761;30431;839;0;0;0;0;.00nan;0;0
5761;57413;830;0;0;0;0;.00nan;0;0
5761;78223;839;76;29;2;27;.931;3766000;0
5762;13373;834;47;26;4;22;.846;3539000;0
5762;165723;837;79;31;2;29;.935;3600000;0
5762;89190;837;0;0;0;0;.00nan;0;0
5762;147901;834;0;0;0;0;.00nan;0;0
5763;183545;842;100;20;0;20;1.000;3600000;0
5763;23433;842;0;0;0;0;.00nan;0;0
5763;-1;833;0;0;0;0;.00nan;0;0
5763;53867;833;64;34;4;30;.882;3600000;0
5764;6084;829;0;0;0;0;.00nan;0;0
5764;13373;834;68;32;3;29;.906;3556000;0
5764;26336;829;92;42;2;40;.952;3600000;0
5764;147901;834;0;0;0;0;.00nan;0;0
5765;8501;836;98;67;4;63;.940;3600000;0
5765;16838;830;85;18;0;18;1.000;3600000;0
5765;57413;830;0;0;0;0;.00nan;0;0
5765;68390;836;0;0;0;0;.00nan;0;0
5766;805;832;0;0;0;0;.00nan;0;0
5766;15538;832;74;29;3;26;.897;3600000;0
5766;30431;839;35;29;6;23;.793;3600000;0
5766;78223;839;0;0;0;0;.00nan;0;0
5767;-1;833;0;0;0;0;.00nan;0;0
5767;180287;847;41;15;3;12;.800;3585000;0
5767;53867;833;95;41;2;39;.951;3600000;0
5767;54017;847;0;0;0;0;.00nan;0;0
5768;48141;831;0;0;0;0;.00nan;0;0
5768;57657;838;0;0;0;0;.00nan;0;0
5768;77084;838;79;39;3;36;.923;3900000;0
5768;78094;831;55;22;3;19;.864;3900000;0
5769;167824;828;0;0;0;0;.00nan;0;0
5769;165723;837;28;6;3;3;.500;525000;0
5769;89190;837;81;35;2;33;.943;3075000;0
5769;148041;828;61;18;2;16;.889;3600000;0
5770;183545;842;76;46;4;42;.913;3650000;0
5770;23433;842;0;0;0;0;.00nan;0;0
5770;-1;833;0;0;0;0;.00nan;0;0
5770;53867;833;54;25;3;22;.880;3650000;0
5771;6084;829;98;49;2;47;.959;3600000;0
5771;165723;837;46;31;5;26;.839;3600000;0
5771;26336;829;0;0;0;0;.00nan;0;0
5771;89190;837;0;0;0;0;.00nan;0;0
5772;8501;836;0;0;0;0;.00nan;0;0
5772;16838;830;51;6;1;5;.833;3600000;0
5772;57413;830;0;0;0;0;.00nan;0;0
5772;68390;836;76;59;6;53;.898;3600000;0
5773;13373;834;71;40;4;36;.900;3600000;0
5773;48141;831;0;0;0;0;.00nan;0;0
5773;78094;831;91;36;2;34;.944;3600000;0
5773;147901;834;0;0;0;0;.00nan;0;0
5774;5663;848;87;32;2;30;.938;3600000;0
5774;19322;848;0;0;0;0;.00nan;0;0
5774;57657;838;0;0;0;0;.00nan;0;0
5774;77084;838;88;28;1;27;.964;3600000;0
5775;30431;839;0;0;0;0;.00nan;0;0
5775;180287;847;100;35;1;34;.971;3600000;0
5775;54017;847;0;0;0;0;.00nan;0;0
5775;78223;839;46;26;4;22;.846;3600000;0
5776;805;832;0;0;0;0;.00nan;0;0
5776;167824;828;71;35;3;32;.914;3600000;0
5776;15538;832;41;26;5;21;.808;3539000;0
5776;148041;828;0;0;0;0;.00nan;0;0
5777;167824;828;68;31;3;28;.903;3542000;0
5777;13373;834;0;0;0;0;.00nan;0;0
5777;147901;834;71;22;1;21;.955;3600000;0
5777;148041;828;0;0;0;0;.00nan;0;0
5778;16838;830;0;0;0;0;.00nan;0;0
5778;57413;830;86;34;1;33;.971;3600000;0
5778;57657;838;0;0;0;0;.00nan;0;0
5778;77084;838;98;24;0;24;1.000;3600000;0
5779;805;832;89;28;1;27;.964;3600000;0
5779;183545;842;0;0;0;0;.00nan;0;0
5779;15538;832;0;0;0;0;.00nan;0;0
5779;23433;842;51;29;4;25;.862;3600000;0
5780;6084;829;0;0;0;0;.00nan;0;0
5780;26336;829;70;31;3;28;.903;3600000;0
5780;180287;847;0;0;0;0;.00nan;0;0
5780;54017;847;50;32;5;27;.844;3530000;0
5781;-1;833;77;26;1;25;.962;3600000;0
5781;48141;831;0;0;0;0;.00nan;0;0
5781;53867;833;0;0;0;0;.00nan;0;0
5781;78094;831;85;35;2;33;.943;3566000;0
5782;165723;837;99;37;1;36;.973;3600000;0
5782;30431;839;65;36;4;32;.889;3600000;0
5782;78223;839;0;0;0;0;.00nan;0;0
5782;89190;837;0;0;0;0;.00nan;0;0
5783;5663;848;79;23;1;22;.957;3600000;0
5783;8501;836;68;44;4;40;.909;3600000;0
5783;19322;848;0;0;0;0;.00nan;0;0
5783;68390;836;0;0;0;0;.00nan;0;0
5784;183545;842;0;0;0;0;.00nan;0;0
5784;13373;834;56;27;3;24;.889;3593000;0
5784;23433;842;80;31;2;29;.935;3600000;0
5784;147901;834;0;0;0;0;.00nan;0;0
5785;6084;829;0;0;0;0;.00nan;0;0
5785;16838;830;100;21;0;21;1.000;3600000;0
5785;26336;829;97;49;4;45;.918;3600000;0
5785;57413;830;0;0;0;0;.00nan;0;0
5786;-1;833;0;0;0;0;.00nan;0;0
5786;53867;833;90;36;3;33;.917;3600000;0
5786;57657;838;0;0;0;0;.00nan;0;0
5786;77084;838;45;26;4;22;.846;3598000;0
5787;165723;837;62;26;3;23;.885;3600000;0
5787;48141;831;0;0;0;0;.00nan;0;0
5787;78094;831;49;30;4;26;.867;3554000;0
5787;89190;837;0;0;0;0;.00nan;0;0
5788;805;832;0;0;0;0;.00nan;0;0
5788;15538;832;77;41;3;38;.927;3762000;0
5788;30431;839;0;0;0;0;.00nan;0;0
5788;78223;839;69;32;2;30;.938;3762000;0
5789;13373;834;0;0;0;0;.00nan;0;0
5789;-1;833;0;0;0;0;.00nan;0;0
5789;53867;833;79;34;2;32;.941;3598000;0
5789;147901;834;68;18;1;17;.944;3600000;0
5790;167824;828;67;39;4;35;.897;3548000;0
5790;16838;830;56;28;3;25;.893;3600000;0
5790;57413;830;0;0;0;0;.00nan;0;0
5790;148041;828;0;0;0;0;.00nan;0;0
5791;805;832;47;19;3;16;.842;3600000;0
5791;8501;836;49;14;2;12;.857;1327000;0
5791;15538;832;0;0;0;0;.00nan;0;0
5791;68390;836;39;36;7;29;.806;2273000;0
5792;5663;848;54;23;3;20;.870;3781000;0
5792;6084;829;67;38;4;34;.895;3781000;0
5792;19322;848;0;0;0;0;.00nan;0;0
5792;26336;829;0;0;0;0;.00nan;0;0
5793;180287;847;86;36;1;35;.972;3600000;0
5793;48141;831;57;45;6;39;.867;3600000;0
5793;54017;847;0;0;0;0;.00nan;0;0
5793;78094;831;0;0;0;0;.00nan;0;0
5794;30431;839;79;42;4;38;.905;3600000;0
5794;57657;838;81;29;1;28;.966;3600000;0
5794;77084;838;0;0;0;0;.00nan;0;0
5794;78223;839;0;0;0;0;.00nan;0;0
5795;183545;842;0;0;0;0;.00nan;0;0
5795;165723;837;39;22;4;18;.818;3600000;0
5795;23433;842;98;38;1;37;.974;3600000;0
5795;89190;837;0;0;0;0;.00nan;0;0
5796;8501;836;100;53;2;51;.962;3600000;0
5796;180287;847;0;0;0;0;.00nan;0;0
5796;54017;847;68;24;3;21;.875;3544000;0
5796;68390;836;0;0;0;0;.00nan;0;0
5797;5663;848;77;20;1;19;.950;3600000;0
5797;183545;842;0;0;0;0;.00nan;0;0
5797;19322;848;0;0;0;0;.00nan;0;0
5797;23433;842;100;27;0;27;1.000;3600000;0
5798;6084;829;0;0;0;0;.00nan;0;0
5798;26336;829;73;40;3;37;.925;3600000;0
5798;57657;838;0;0;0;0;.00nan;0;0
5798;77084;838;100;26;0;26;1.000;3600000;0
5799;8501;836;0;0;0;0;.00nan;0;0
5799;13373;834;79;13;0;13;1.000;3600000;0
5799;68390;836;98;50;2;48;.960;3529000;0
5799;147901;834;0;0;0;0;.00nan;0;0
5800;165723;837;74;29;3;26;.897;3550000;0
5800;-1;833;0;0;0;0;.00nan;0;0
5800;53867;833;68;22;2;20;.909;3600000;0
5800;89190;837;0;0;0;0;.00nan;0;0
5801;805;832;0;0;0;0;.00nan;0;0
5801;15538;832;87;44;3;41;.932;3600000;0
5801;48141;831;0;0;0;0;.00nan;0;0
5801;78094;831;96;18;0;18;1.000;3600000;0
5802;16838;830;80;22;2;20;.909;3600000;0
5802;30431;839;36;35;6;29;.829;2674000;0
5802;57413;830;0;0;0;0;.00nan;0;0
5802;78223;839;51;17;2;15;.882;926000;0
5803;167824;828;76;19;1;18;.947;3600000;0
5803;180287;847;66;29;2;27;.931;3579000;0
5803;54017;847;0;0;0;0;.00nan;0;0
5803;148041;828;0;0;0;0;.00nan;0;0
5804;13373;834;95;21;0;21;1.000;3600000;0
5804;30431;839;78;33;2;31;.939;3587000;0
5804;78223;839;0;0;0;0;.00nan;0;0
5804;147901;834;0;0;0;0;.00nan;0;0
5805;183545;842;0;0;0;0;.00nan;0;0
5805;16838;830;47;29;4;25;.862;3550000;0
5805;23433;842;79;36;3;33;.917;3600000;0
5805;57413;830;0;0;0;0;.00nan;0;0
5806;6084;829;0;0;0;0;.00nan;0;0
5806;8501;836;62;32;4;28;.875;3600000;0
5806;26336;829;68;31;3;28;.903;3600000;0
5806;68390;836;0;0;0;0;.00nan;0;0
5807;5663;848;62;16;2;14;.875;3600000;0
5807;19322;848;0;0;0;0;.00nan;0;0
5807;48141;831;0;0;0;0;.00nan;0;0
5807;78094;831;61;40;5;35;.875;3600000;0
5808;-1;833;0;0;0;0;.00nan;0;0
5808;180287;847;0;0;0;0;.00nan;0;0
5808;53867;833;76;35;3;32;.914;3600000;0
5808;54017;847;71;35;4;31;.886;3556000;0
5809;805;832;0;0;0;0;.00nan;0;0
5809;15538;832;64;35;4;31;.886;3564000;0
5809;57657;838;0;0;0;0;.00nan;0;0
5809;77084;838;86;30;2;28;.933;3600000;0
5810;167824;828;51;21;3;18;.857;3557000;0
5810;165723;837;82;26;1;25;.962;3600000;0
5810;89190;837;0;0;0;0;.00nan;0;0
5810;148041;828;0;0;0;0;.00nan;0;0
5811;6084;829;0;0;0;0;.00nan;0;0
5811;167824;828;83;25;1;24;.960;3600000;0
5811;26336;829;97;50;2;48;.960;3547000;0
5811;148041;828;0;0;0;0;.00nan;0;0
5812;805;832;67;35;3;32;.914;3521000;0
5812;15538;832;0;0;0;0;.00nan;0;0
5812;16838;830;90;27;1;26;.963;3600000;0
5812;57413;830;0;0;0;0;.00nan;0;0
5813;13373;834;57;41;5;36;.878;3600000;0
5813;180287;847;70;26;2;24;.923;3600000;0
5813;54017;847;0;0;0;0;.00nan;0;0
5813;147901;834;0;0;0;0;.00nan;0;0
5814;183545;842;0;0;0;0;.00nan;0;0
5814;23433;842;72;41;4;37;.902;3600000;0
5814;48141;831;0;0;0;0;.00nan;0;0
5814;78094;831;66;16;1;15;.938;3600000;0
5815;8501;836;0;0;0;0;.00nan;0;0
5815;57657;838;0;0;0;0;.00nan;0;0
5815;68390;836;92;54;4;50;.926;3578000;0
5815;77084;838;59;20;2;18;.900;3600000;0
5816;30431;839;0;0;0;0;.00nan;0;0
5816;-1;833;0;0;0;0;.00nan;0;0
5816;53867;833;62;36;4;32;.889;3536000;0
5816;78223;839;84;31;2;29;.935;3600000;0
5817;5663;848;38;30;6;24;.800;2096000;0
5817;165723;837;79;41;4;37;.902;3600000;0
5817;19322;848;72;17;1;16;.941;1504000;0
5817;89190;837;0;0;0;0;.00nan;0;0
5818;183545;842;0;0;0;0;.00nan;0;0
5818;23433;842;90;37;2;35;.946;3543000;0
5818;30431;839;62;14;1;13;.929;3600000;0
5818;78223;839;0;0;0;0;.00nan;0;0
5819;13373;834;68;37;4;33;.892;3571000;0
5819;165723;837;72;32;3;29;.906;3600000;0
5819;89190;837;0;0;0;0;.00nan;0;0
5819;147901;834;0;0;0;0;.00nan;0;0
5820;16838;830;83;31;2;29;.935;3900000;0
5820;180287;847;79;32;2;30;.938;3900000;0
5820;54017;847;0;0;0;0;.00nan;0;0
5820;57413;830;0;0;0;0;.00nan;0;0
5821;8501;836;71;44;5;39;.886;3600000;0
5821;48141;831;0;0;0;0;.00nan;0;0
5821;68390;836;0;0;0;0;.00nan;0;0
5821;78094;831;59;29;4;25;.862;3600000;0
5822;805;832;0;0;0;0;.00nan;0;0
5822;5663;848;0;0;0;0;.00nan;0;0
5822;15538;832;56;29;3;26;.897;3600000;0
5822;19322;848;100;32;0;32;1.000;3600000;0
5823;6084;829;0;0;0;0;.00nan;0;0
5823;26336;829;65;43;5;38;.884;3600000;0
5823;-1;833;0;0;0;0;.00nan;0;0
5823;53867;833;63;27;3;24;.889;3600000;0
5824;167824;828;0;0;0;0;.00nan;0;0
5824;57657;838;0;0;0;0;.00nan;0;0
5824;77084;838;36;26;5;21;.808;3600000;0
5824;148041;828;43;34;6;28;.824;3600000;0
5825;30431;839;0;0;0;0;.00nan;0;0
5825;48141;831;0;0;0;0;.00nan;0;0
5825;78094;831;91;34;2;32;.941;3600000;0
5825;78223;839;60;25;3;22;.880;3560000;0
5826;8501;836;0;0;0;0;.00nan;0;0
5826;167824;828;56;23;3;20;.870;3600000;0
5826;68390;836;56;38;5;33;.868;3549000;0
5826;148041;828;0;0;0;0;.00nan;0;0
5827;183545;842;0;0;0;0;.00nan;0;0
5827;23433;842;95;52;4;48;.923;3600000;0
5827;180287;847;85;18;0;18;1.000;3600000;0
5827;54017;847;0;0;0;0;.00nan;0;0
5828;165723;837;57;38;5;33;.868;3600000;0
5828;16838;830;93;20;0;20;1.000;3600000;0
5828;57413;830;0;0;0;0;.00nan;0;0
5828;89190;837;0;0;0;0;.00nan;0;0
5829;805;832;0;0;0;0;.00nan;0;0
5829;6084;829;0;0;0;0;.00nan;0;0
5829;15538;832;63;41;4;37;.902;3549000;0
5829;26336;829;88;38;3;35;.921;3600000;0
5830;5663;848;0;0;0;0;.00nan;0;0
5830;19322;848;91;30;2;28;.933;3666000;0
5830;-1;833;0;0;0;0;.00nan;0;0
5830;53867;833;74;30;3;27;.900;3666000;0
5831;13373;834;74;26;2;24;.923;3600000;0
5831;57657;838;0;0;0;0;.00nan;0;0
5831;77084;838;55;32;4;28;.875;3600000;0
5831;147901;834;0;0;0;0;.00nan;0;0
5832;6084;829;71;26;2;24;.923;3600000;0
5832;183545;842;51;23;3;20;.870;3551000;0
5832;23433;842;0;0;0;0;.00nan;0;0
5832;26336;829;0;0;0;0;.00nan;0;0
5833;8501;836;97;50;3;47;.940;3599000;0
5833;30431;839;87;36;2;34;.944;3600000;0
5833;68390;836;0;0;0;0;.00nan;0;0
5833;78223;839;0;0;0;0;.00nan;0;0
5834;5663;848;87;39;2;37;.949;3600000;0
5834;19322;848;0;0;0;0;.00nan;0;0
5834;180287;847;75;35;3;32;.914;3549000;0
5834;54017;847;0;0;0;0;.00nan;0;0
5835;13373;834;83;41;2;39;.951;3600000;0
5835;16838;830;56;25;3;22;.880;3570000;0
5835;57413;830;0;0;0;0;.00nan;0;0
5835;147901;834;0;0;0;0;.00nan;0;0
5836;805;832;58;6;0;6;1.000;849000;0
5836;15538;832;35;30;6;24;.800;2691000;0
5836;-1;833;0;0;0;0;.00nan;0;0
5836;53867;833;46;25;4;21;.840;3600000;0
5837;167824;828;68;35;4;31;.886;3600000;0
5837;48141;831;70;27;2;25;.926;3600000;0
5837;78094;831;0;0;0;0;.00nan;0;0
5837;148041;828;0;0;0;0;.00nan;0;0
5838;165723;837;0;0;0;0;.00nan;0;0
5838;57657;838;0;0;0;0;.00nan;0;0
5838;77084;838;48;35;5;30;.857;3600000;0
5838;89190;837;100;37;0;37;1.000;3600000;0
5839;183545;842;0;0;0;0;.00nan;0;0
5839;23433;842;72;33;3;30;.909;3600000;0
5839;57657;838;0;0;0;0;.00nan;0;0
5839;77084;838;46;36;6;30;.833;3600000;0
5840;805;832;66;37;4;33;.892;3580000;0
5840;15538;832;0;0;0;0;.00nan;0;0
5840;180287;847;86;45;3;42;.933;3600000;0
5840;54017;847;0;0;0;0;.00nan;0;0
5841;5663;848;0;0;0;0;.00nan;0;0
5841;13373;834;66;23;2;21;.913;3600000;0
5841;19322;848;48;42;6;36;.857;3600000;0
5841;147901;834;0;0;0;0;.00nan;0;0
5842;16838;830;62;18;2;16;.889;3600000;0
5842;-1;833;0;0;0;0;.00nan;0;0
5842;53867;833;59;34;5;29;.853;3600000;0
5842;57413;830;0;0;0;0;.00nan;0;0
5843;6084;829;0;0;0;0;.00nan;0;0
5843;26336;829;84;32;2;30;.938;3600000;0
5843;48141;831;0;0;0;0;.00nan;0;0
5843;78094;831;52;24;3;21;.875;3549000;0
5844;167824;828;90;27;1;26;.963;3900000;0
5844;30431;839;93;29;1;28;.966;3900000;0
5844;78223;839;0;0;0;0;.00nan;0;0
5844;148041;828;0;0;0;0;.00nan;0;0
5845;8501;836;0;0;0;0;.00nan;0;0
5845;165723;837;0;0;0;0;.00nan;0;0
5845;68390;836;98;54;3;51;.944;3600000;0
5845;89190;837;60;14;1;13;.929;3600000;0
5846;805;832;0;0;0;0;.00nan;0;0
5846;13373;834;42;17;3;14;.824;3600000;0
5846;15538;832;62;43;5;38;.884;3541000;0
5846;147901;834;0;0;0;0;.00nan;0;0
5847;5663;848;99;39;2;37;.949;3600000;0
5847;16838;830;0;0;0;0;.00nan;0;0
5847;19322;848;0;0;0;0;.00nan;0;0
5847;57413;830;92;39;3;36;.923;3552000;0
5848;6084;829;94;35;1;34;.971;3600000;0
5848;26336;829;0;0;0;0;.00nan;0;0
5848;30431;839;0;0;0;0;.00nan;0;0
5848;78223;839;57;20;2;18;.900;3572000;0
5849;165723;837;81;41;4;37;.902;3592000;0
5849;180287;847;0;0;0;0;.00nan;0;0
5849;54017;847;75;29;2;27;.931;3600000;0
5849;89190;837;0;0;0;0;.00nan;0;0
5850;48141;831;0;0;0;0;.00nan;0;0
5850;57657;838;62;27;3;24;.889;3619000;0
5850;77084;838;0;0;0;0;.00nan;0;0
5850;78094;831;85;43;2;41;.953;3564000;0
5851;167824;828;0;0;0;0;.00nan;0;0
5851;-1;833;0;0;0;0;.00nan;0;0
5851;53867;833;68;26;2;24;.923;3600000;0
5851;148041;828;67;35;3;32;.914;3598000;0
5852;6084;829;0;0;0;0;.00nan;0;0
5852;13373;834;93;24;0;24;1.000;3600000;0
5852;26336;829;54;42;5;37;.881;3600000;0
5852;147901;834;0;0;0;0;.00nan;0;0
5853;16838;830;85;32;2;30;.938;3600000;0
5853;48141;831;0;0;0;0;.00nan;0;0
5853;57413;830;0;0;0;0;.00nan;0;0
5853;78094;831;82;33;3;30;.909;3569000;0
5854;5663;848;87;27;1;26;.963;3895000;0
5854;19322;848;0;0;0;0;.00nan;0;0
5854;30431;839;84;32;2;30;.938;3895000;0
5854;78223;839;0;0;0;0;.00nan;0;0
5855;180287;847;81;37;2;35;.946;3900000;0
5855;54017;847;0;0;0;0;.00nan;0;0
5855;57657;838;0;0;0;0;.00nan;0;0
5855;77084;838;73;32;2;30;.938;3900000;0
5856;167824;828;88;27;1;26;.963;3600000;0
5856;183545;842;0;0;0;0;.00nan;0;0
5856;23433;842;93;44;2;42;.955;3600000;0
5856;148041;828;0;0;0;0;.00nan;0;0
5857;167824;828;0;0;0;0;.00nan;0;0
5857;183545;842;70;33;3;30;.909;3529000;0
5857;23433;842;0;0;0;0;.00nan;0;0
5857;148041;828;73;23;1;22;.957;3600000;0
5858;6084;829;79;26;2;24;.923;3600000;0
5858;13373;834;57;32;4;28;.875;3600000;0
5858;26336;829;0;0;0;0;.00nan;0;0
5858;147901;834;0;0;0;0;.00nan;0;0
5859;16838;830;0;0;0;0;.00nan;0;0
5859;48141;831;45;39;6;33;.846;3136000;0
5859;57413;830;49;26;4;22;.846;3600000;0
5859;78094;831;54;4;0;4;1.000;411000;0
5860;5663;848;0;0;0;0;.00nan;0;0
5860;19322;848;74;31;2;29;.935;3815000;0
5860;30431;839;0;0;0;0;.00nan;0;0
5860;78223;839;86;29;1;28;.966;3815000;0
5861;805;832;0;0;0;0;.00nan;0;0
5861;165723;837;60;36;4;32;.889;3900000;0
5861;15538;832;80;46;4;42;.913;3900000;0
5861;89190;837;0;0;0;0;.00nan;0;0
5862;805;832;59;33;4;29;.879;3659000;0
5862;165723;837;0;0;0;0;.00nan;0;0
5862;15538;832;0;0;0;0;.00nan;0;0
5862;89190;837;68;31;3;28;.903;3659000;0
5863;180287;847;97;35;1;34;.971;3900000;0
5863;54017;847;0;0;0;0;.00nan;0;0
5863;57657;838;0;0;0;0;.00nan;0;0
5863;77084;838;78;19;1;18;.947;3900000;0
5864;183545;842;0;0;0;0;.00nan;0;0
5864;23433;842;61;34;4;30;.882;3600000;0
5864;180287;847;69;19;1;18;.947;3600000;0
5864;54017;847;0;0;0;0;.00nan;0;0
5865;8501;836;96;51;2;49;.961;3600000;0
5865;-1;833;0;0;0;0;.00nan;0;0
5865;53867;833;50;20;3;17;.850;3542000;0
5865;68390;836;0;0;0;0;.00nan;0;0
5866;30431;839;34;31;6;25;.806;3150000;0
5866;48141;831;0;0;0;0;.00nan;0;0
5866;78094;831;86;31;2;29;.935;3600000;0
5866;78223;839;51;3;0;3;1.000;450000;0
5867;13373;834;66;33;3;30;.909;3872000;0
5867;48141;831;0;0;0;0;.00nan;0;0
5867;78094;831;65;36;4;32;.889;3872000;0
5867;147901;834;0;0;0;0;.00nan;0;0
5868;8501;836;46;12;2;10;.833;513000;0
5868;16838;830;59;13;2;11;.846;3600000;0
5868;57413;830;0;0;0;0;.00nan;0;0
5868;68390;836;27;40;8;32;.800;3087000;0
5869;805;832;0;0;0;0;.00nan;0;0
5869;167824;828;45;5;1;4;.800;718000;0
5869;15538;832;69;33;3;30;.909;3600000;0
5869;148041;828;37;24;5;19;.792;2882000;0
5870;5663;848;67;34;3;31;.912;3600000;0
5870;19322;848;0;0;0;0;.00nan;0;0
5870;57657;838;0;0;0;0;.00nan;0;0
5870;77084;838;68;37;4;33;.892;3581000;0
5871;30431;839;61;28;3;25;.893;3543000;0
5871;180287;847;77;32;2;30;.938;3600000;0
5871;54017;847;0;0;0;0;.00nan;0;0
5871;78223;839;0;0;0;0;.00nan;0;0
5872;183545;842;0;0;0;0;.00nan;0;0
5872;23433;842;57;25;3;22;.880;3900000;0
5872;-1;833;0;0;0;0;.00nan;0;0
5872;53867;833;50;17;3;14;.824;3900000;0
5873;6084;829;0;0;0;0;.00nan;0;0
5873;165723;837;44;19;3;16;.842;3585000;0
5873;26336;829;78;36;2;34;.944;3600000;0
5873;89190;837;0;0;0;0;.00nan;0;0
5874;805;832;0;0;0;0;.00nan;0;0
5874;183545;842;48;29;5;24;.828;3893000;0
5874;15538;832;51;38;6;32;.842;3893000;0
5874;23433;842;0;0;0;0;.00nan;0;0
5875;5663;848;38;24;4;20;.833;3537000;0
5875;8501;836;0;0;0;0;.00nan;0;0
5875;19322;848;0;0;0;0;.00nan;0;0
5875;68390;836;91;37;2;35;.946;3600000;0
5876;-1;833;0;0;0;0;.00nan;0;0
5876;48141;831;0;0;0;0;.00nan;0;0
5876;53867;833;55;25;3;22;.880;3600000;0
5876;78094;831;100;34;0;34;1.000;3600000;0
5877;16838;830;0;0;0;0;.00nan;0;0
5877;57413;830;81;46;4;42;.913;3600000;0
5877;57657;838;62;27;3;24;.889;3600000;0
5877;77084;838;0;0;0;0;.00nan;0;0
5878;165723;837;0;0;0;0;.00nan;0;0
5878;30431;839;0;0;0;0;.00nan;0;0
5878;78223;839;83;32;2;30;.938;3600000;0
5878;89190;837;74;33;3;30;.909;3582000;0
5879;167824;828;0;0;0;0;.00nan;0;0
5879;13373;834;71;41;4;37;.902;3600000;0
5879;147901;834;0;0;0;0;.00nan;0;0
5879;148041;828;100;31;0;31;1.000;3600000;0
5880;6084;829;0;0;0;0;.00nan;0;0
5880;26336;829;67;42;5;37;.881;3600000;0
5880;180287;847;61;16;2;14;.875;3600000;0
5880;54017;847;0;0;0;0;.00nan;0;0
5881;183545;842;0;0;0;0;.00nan;0;0
5881;13373;834;58;13;1;12;.923;3600000;0
5881;23433;842;65;39;4;35;.897;3600000;0
5881;147901;834;0;0;0;0;.00nan;0;0
5882;6084;829;0;0;0;0;.00nan;0;0
5882;16838;830;48;24;3;21;.875;3900000;0
5882;26336;829;90;36;3;33;.917;3900000;0
5882;57413;830;0;0;0;0;.00nan;0;0
5883;805;832;0;0;0;0;.00nan;0;0
5883;15538;832;62;40;4;36;.900;3596000;0
5883;30431;839;0;0;0;0;.00nan;0;0
5883;78223;839;71;28;2;26;.929;3600000;0
5884;5663;848;92;42;3;39;.929;3576000;0
5884;167824;828;0;0;0;0;.00nan;0;0
5884;19322;848;0;0;0;0;.00nan;0;0
5884;148041;828;68;20;1;19;.950;3600000;0
5885;8501;836;41;36;6;30;.833;2769000;0
5885;180287;847;66;12;1;11;.917;3600000;0
5885;54017;847;0;0;0;0;.00nan;0;0
5885;68390;836;48;14;2;12;.857;831000;0
5886;-1;833;0;0;0;0;.00nan;0;0
5886;53867;833;70;33;3;30;.909;3900000;0
5886;57657;838;0;0;0;0;.00nan;0;0
5886;77084;838;57;25;3;22;.880;3900000;0
5887;165723;837;94;32;1;31;.969;3600000;0
5887;48141;831;0;0;0;0;.00nan;0;0
5887;78094;831;53;30;4;26;.867;3600000;0
5887;89190;837;0;0;0;0;.00nan;0;0
5888;13373;834;0;0;0;0;.00nan;0;0
5888;180287;847;0;0;0;0;.00nan;0;0
5888;54017;847;53;34;5;29;.853;3600000;0
5888;147901;834;64;20;2;18;.900;3600000;0
5889;8501;832;96;48;3;45;.938;3900000;0
5889;15538;832;0;0;0;0;.00nan;0;0
5889;16838;830;70;24;3;21;.875;3900000;0
5889;57413;830;0;0;0;0;.00nan;0;0
5890;5663;848;51;31;3;28;.903;3900000;0
5890;165723;837;99;43;3;40;.930;3900000;0
5890;19322;848;0;0;0;0;.00nan;0;0
5890;89190;837;0;0;0;0;.00nan;0;0
5891;6084;829;0;0;0;0;.00nan;0;0
5891;167824;828;0;0;0;0;.00nan;0;0
5891;26336;829;93;21;0;21;1.000;3600000;0
5891;148041;828;66;19;1;18;.947;3600000;0
5892;6084;829;82;37;2;35;.946;3600000;0
5892;26336;829;0;0;0;0;.00nan;0;0
5892;-1;833;0;0;0;0;.00nan;0;0
5892;53867;833;73;32;3;29;.906;3600000;0
5893;5663;848;0;0;0;0;.00nan;0;0
5893;8501;832;100;27;0;27;1.000;3600000;0
5893;15538;832;0;0;0;0;.00nan;0;0
5893;19322;848;51;24;3;21;.875;3600000;0
5894;16838;830;0;0;0;0;.00nan;0;0
5894;180287;847;99;25;0;25;1.000;3600000;0
5894;54017;847;0;0;0;0;.00nan;0;0
5894;57413;830;41;30;5;25;.833;3600000;0
5895;32404;836;0;0;0;0;.00nan;0;0
5895;48141;831;0;0;0;0;.00nan;0;0
5895;68390;836;94;57;4;53;.930;3600000;0
5895;78094;831;80;14;0;14;1.000;3600000;0
5896;167824;828;0;0;0;0;.00nan;0;0
5896;57657;838;0;0;0;0;.00nan;0;0
5896;77084;838;79;34;2;32;.941;3600000;0
5896;148041;828;67;37;3;34;.919;3600000;0
5897;183545;842;0;0;0;0;.00nan;0;0
5897;23433;842;100;45;2;43;.956;3900000;0
5897;30431;839;75;35;2;33;.943;3900000;0
5897;78223;839;0;0;0;0;.00nan;0;0
5898;183545;842;0;0;0;0;.00nan;0;0
5898;23433;842;66;42;4;38;.905;3600000;0
5898;48141;831;0;0;0;0;.00nan;0;0
5898;78094;831;73;24;1;23;.958;3600000;0
5899;32404;836;84;42;3;39;.929;3561000;0
5899;57657;838;51;15;2;13;.867;3600000;0
5899;68390;836;0;0;0;0;.00nan;0;0
5899;77084;838;0;0;0;0;.00nan;0;0
5900;13373;834;71;35;3;32;.914;3679000;0
5900;165723;837;78;25;2;23;.920;3679000;0
5900;89190;837;0;0;0;0;.00nan;0;0
5900;147901;834;0;0;0;0;.00nan;0;0
5901;183545;842;0;0;0;0;.00nan;0;0
5901;23433;842;89;38;2;36;.947;3900000;0
5901;30431;839;69;28;2;26;.929;3900000;0
5901;78223;839;0;0;0;0;.00nan;0;0
5902;167824;828;0;0;0;0;.00nan;0;0
5902;32404;836;0;0;0;0;.00nan;0;0
5902;68390;836;69;43;5;38;.884;3556000;0
5902;148041;828;56;22;3;19;.864;3600000;0
5903;6084;829;0;0;0;0;.00nan;0;0
5903;26336;829;87;43;3;40;.930;3596000;0
5903;-1;833;70;25;2;23;.920;3600000;0
5903;53867;833;0;0;0;0;.00nan;0;0
5904;30431;839;0;0;0;0;.00nan;0;0
5904;32404;836;0;0;0;0;.00nan;0;0
5904;68390;836;84;51;4;47;.922;3600000;0
5904;78223;839;60;15;1;14;.933;3600000;0
5905;5663;848;87;18;0;18;1.000;3600000;0
5905;167824;828;0;0;0;0;.00nan;0;0
5905;19322;848;0;0;0;0;.00nan;0;0
5905;148041;828;68;32;4;28;.875;3600000;0
5906;13373;834;60;32;4;28;.875;3900000;0
5906;57657;838;0;0;0;0;.00nan;0;0
5906;77084;838;63;33;4;29;.879;3900000;0
5906;147901;834;0;0;0;0;.00nan;0;0
5907;6084;829;0;0;0;0;.00nan;0;0
5907;8501;832;67;21;1;20;.952;3600000;0
5907;15538;832;0;0;0;0;.00nan;0;0
5907;26336;829;97;52;2;50;.962;3548000;0
5908;183545;842;0;0;0;0;.00nan;0;0
5908;23433;842;84;41;3;38;.927;3546000;0
5908;180287;847;85;30;2;28;.933;3600000;0
5908;54017;847;0;0;0;0;.00nan;0;0
5909;165723;837;93;31;1;30;.968;3600000;0
5909;16838;830;69;30;3;27;.900;3563000;0
5909;57413;830;0;0;0;0;.00nan;0;0
5909;89190;837;0;0;0;0;.00nan;0;0
5910;6084;829;37;25;5;20;.800;3600000;0
5910;183545;842;82;33;2;31;.939;3600000;0
5910;23433;842;0;0;0;0;.00nan;0;0
5910;26336;829;0;0;0;0;.00nan;0;0
5911;13373;834;80;32;2;30;.938;3600000;0
5911;16838;830;0;0;0;0;.00nan;0;0
5911;57413;830;61;42;5;37;.881;3600000;0
5911;147901;834;0;0;0;0;.00nan;0;0
5912;8501;832;93;49;3;46;.939;3900000;0
5912;15538;832;0;0;0;0;.00nan;0;0
5912;-1;833;0;0;0;0;.00nan;0;0
5912;53867;833;71;29;3;26;.897;3900000;0
5913;5663;848;68;17;1;16;.941;3900000;0
5913;19322;848;0;0;0;0;.00nan;0;0
5913;180287;847;0;0;0;0;.00nan;0;0
5913;54017;847;100;42;1;41;.976;3900000;0
5914;165723;837;62;16;2;14;.875;3600000;0
5914;57657;838;98;47;3;44;.936;3600000;0
5914;77084;838;0;0;0;0;.00nan;0;0
5914;89190;837;0;0;0;0;.00nan;0;0
5915;167824;828;0;0;0;0;.00nan;0;0
5915;48141;831;0;0;0;0;.00nan;0;0
5915;78094;831;52;35;5;30;.857;3600000;0
5915;148041;828;84;38;2;36;.947;3600000;0
5916;32404;836;91;45;4;41;.911;3679000;0
5916;-1;833;35;23;5;18;.783;3679000;0
5916;53867;833;0;0;0;0;.00nan;0;0
5916;68390;836;0;0;0;0;.00nan;0;0
5917;183545;842;0;0;0;0;.00nan;0;0
5917;13373;834;47;27;4;23;.852;3563000;0
5917;23433;842;72;29;2;27;.931;3600000;0
5917;147901;834;0;0;0;0;.00nan;0;0
5918;183545;842;0;0;0;0;.00nan;0;0
5918;165723;837;71;23;1;22;.957;3600000;0
5918;23433;842;57;36;4;32;.889;3600000;0
5918;89190;837;0;0;0;0;.00nan;0;0
5919;5663;848;76;32;3;29;.906;3600000;0
5919;6084;829;0;0;0;0;.00nan;0;0
5919;19322;848;0;0;0;0;.00nan;0;0
5919;26336;829;93;37;2;35;.946;3600000;0
5920;8501;832;87;19;0;19;1.000;3600000;0
5920;15538;832;0;0;0;0;.00nan;0;0
5920;32404;836;34;40;7;33;.825;2971000;0
5920;68390;836;52;6;1;5;.833;629000;0
5921;13373;834;84;33;2;31;.939;3600000;0
5921;-1;833;0;0;0;0;.00nan;0;0
5921;53867;833;72;34;3;31;.912;3600000;0
5921;147901;834;0;0;0;0;.00nan;0;0
5922;180287;847;82;32;2;30;.938;3600000;0
5922;48141;831;0;0;0;0;.00nan;0;0
5922;54017;847;0;0;0;0;.00nan;0;0
5922;78094;831;90;27;1;26;.963;3600000;0
5923;167824;828;0;0;0;0;.00nan;0;0
5923;16838;830;90;36;2;34;.944;3600000;0
5923;57413;830;0;0;0;0;.00nan;0;0
5923;148041;828;68;43;4;39;.907;3561000;0
5924;13373;834;0;0;0;0;.00nan;0;0
5924;32404;836;0;0;0;0;.00nan;0;0
5924;68390;836;74;44;3;41;.932;3900000;0
5924;147901;834;65;26;3;23;.885;3900000;0
5925;16838;830;0;0;0;0;.00nan;0;0
5925;30431;839;91;31;1;30;.968;3600000;0
5925;57413;830;86;35;2;33;.943;3587000;0
5925;78223;839;0;0;0;0;.00nan;0;0
5926;8501;832;71;34;4;30;.882;3600000;0
5926;15538;832;0;0;0;0;.00nan;0;0
5926;48141;831;44;36;6;30;.833;3110000;0
5926;78094;831;52;4;0;4;1.000;452000;0
5927;5663;848;0;0;0;0;.00nan;0;0
5927;183545;842;0;0;0;0;.00nan;0;0
5927;19322;848;56;22;2;20;.909;3600000;0
5927;23433;842;92;46;3;43;.935;3600000;0
5928;6084;829;67;36;4;32;.889;3652000;0
5928;26336;829;0;0;0;0;.00nan;0;0
5928;57657;838;60;25;3;22;.880;3652000;0
5928;77084;838;0;0;0;0;.00nan;0;0
5929;165723;837;74;35;3;32;.914;3900000;0
5929;-1;833;89;42;3;39;.929;3900000;0
5929;53867;833;0;0;0;0;.00nan;0;0
5929;89190;837;0;0;0;0;.00nan;0;0
5930;167824;828;0;0;0;0;.00nan;0;0
5930;180287;847;0;0;0;0;.00nan;0;0
5930;54017;847;53;29;3;26;.897;3585000;0
5930;148041;828;71;23;2;21;.913;3600000;0
5931;30431;839;0;0;0;0;.00nan;0;0
5931;57657;838;0;0;0;0;.00nan;0;0
5931;77084;838;69;32;3;29;.906;3600000;0
5931;78223;839;65;38;4;34;.895;3600000;0
5932;183545;842;0;0;0;0;.00nan;0;0
5932;23433;842;76;25;1;24;.960;3600000;0
5932;32404;836;0;0;0;0;.00nan;0;0
5932;68390;836;81;45;4;41;.911;3600000;0
5933;30431;839;67;31;3;28;.903;3534000;0
5933;-1;833;0;0;0;0;.00nan;0;0
5933;53867;833;92;35;1;34;.971;3600000;0
5933;78223;839;0;0;0;0;.00nan;0;0
5934;183545;842;0;0;0;0;.00nan;0;0
5934;16838;830;90;30;1;29;.967;3600000;0
5934;23433;842;57;35;5;30;.857;3600000;0
5934;57413;830;0;0;0;0;.00nan;0;0
5935;6084;829;0;0;0;0;.00nan;0;0
5935;26336;829;100;38;0;38;1.000;3600000;0
5935;32404;836;0;0;0;0;.00nan;0;0
5935;68390;836;98;36;1;35;.972;3600000;0
5936;8501;832;87;43;3;40;.930;3900000;0
5936;15538;832;0;0;0;0;.00nan;0;0
5936;57657;838;80;34;3;31;.912;3900000;0
5936;77084;838;0;0;0;0;.00nan;0;0
5937;5663;848;42;31;5;26;.839;3600000;0
5937;19322;848;0;0;0;0;.00nan;0;0
5937;48141;831;0;0;0;0;.00nan;0;0
5937;78094;831;64;34;4;30;.882;3600000;0
5938;13373;834;80;25;1;24;.960;3600000;0
5938;30431;839;0;0;0;0;.00nan;0;0
5938;78223;839;37;26;5;21;.808;3600000;0
5938;147901;834;0;0;0;0;.00nan;0;0
5939;167824;828;0;0;0;0;.00nan;0;0
5939;165723;837;84;35;2;33;.943;3600000;0
5939;89190;837;0;0;0;0;.00nan;0;0
5939;148041;828;84;15;0;15;1.000;3600000;0
5940;5663;848;51;33;4;29;.879;3600000;0
5940;13373;834;72;22;1;21;.955;3600000;0
5940;19322;848;0;0;0;0;.00nan;0;0
5940;147901;834;0;0;0;0;.00nan;0;0
5941;16838;830;32;16;4;12;.750;3600000;0
5941;-1;833;0;0;0;0;.00nan;0;0
5941;53867;833;100;31;0;31;1.000;3600000;0
5941;57413;830;0;0;0;0;.00nan;0;0
5942;6084;829;0;0;0;0;.00nan;0;0
5942;26336;829;69;34;3;31;.912;3552000;0
5942;48141;831;0;0;0;0;.00nan;0;0
5942;78094;831;55;19;2;17;.895;3600000;0
5943;165723;837;39;21;4;17;.810;3600000;0
5943;32404;836;0;0;0;0;.00nan;0;0
5943;68390;836;92;33;1;32;.970;3600000;0
5943;89190;837;0;0;0;0;.00nan;0;0
5944;8501;832;52;30;4;26;.867;3561000;0
5944;15538;832;0;0;0;0;.00nan;0;0
5944;180287;847;67;34;3;31;.912;3600000;0
5944;54017;847;0;0;0;0;.00nan;0;0
5945;183545;842;0;0;0;0;.00nan;0;0
5945;23433;842;21;35;7;28;.800;3600000;0
5945;57657;838;0;0;0;0;.00nan;0;0
5945;77084;838;57;29;4;25;.862;3600000;0
5946;167824;828;0;0;0;0;.00nan;0;0
5946;30431;839;77;34;3;31;.912;3618000;0
5946;78223;839;0;0;0;0;.00nan;0;0
5946;148041;828;57;32;4;28;.875;3618000;0
5947;183545;842;75;24;1;23;.958;3600000;0
5947;23433;842;0;0;0;0;.00nan;0;0
5947;32404;836;0;0;0;0;.00nan;0;0
5947;68390;836;61;47;7;40;.851;3600000;0
5948;8501;832;64;28;3;25;.893;3600000;0
5948;13373;834;73;29;2;27;.931;3600000;0
5948;15538;832;0;0;0;0;.00nan;0;0
5948;147901;834;0;0;0;0;.00nan;0;0
5949;5663;848;83;44;2;42;.955;3577000;0
5949;16838;830;99;23;0;23;1.000;3600000;0
5949;19322;848;0;0;0;0;.00nan;0;0
5949;57413;830;0;0;0;0;.00nan;0;0
5950;167824;828;54;36;5;31;.861;3612000;0
5950;-1;833;0;0;0;0;.00nan;0;0
5950;53867;833;54;27;4;23;.852;3612000;0
5950;148041;828;0;0;0;0;.00nan;0;0
5951;48141;831;0;0;0;0;.00nan;0;0
5951;57657;838;83;31;2;29;.935;3523000;0
5951;77084;838;0;0;0;0;.00nan;0;0
5951;78094;831;89;21;0;21;1.000;3600000;0
5952;6084;829;0;0;0;0;.00nan;0;0
5952;26336;829;60;25;3;22;.880;3600000;0
5952;30431;839;0;0;0;0;.00nan;0;0
5952;78223;839;65;33;4;29;.879;3573000;0
5953;165723;837;66;36;4;32;.889;3600000;0
5953;180287;847;0;0;0;0;.00nan;0;0
5953;54017;847;64;31;3;28;.903;3600000;0
5953;89190;837;0;0;0;0;.00nan;0;0
5955;8501;836;0;0;0;0;.00nan;0;0
5955;180287;847;64;16;1;15;.938;3600000;0
5955;54017;847;0;0;0;0;.00nan;0;0
5955;68390;836;91;55;4;51;.927;3600000;0
5959;165723;837;99;45;3;42;.933;3600000;0
5959;30431;839;46;33;5;28;.848;3544000;0
5959;78223;839;0;0;0;0;.00nan;0;0
5959;89190;837;0;0;0;0;.00nan;0;0
5961;805;832;0;0;0;0;.00nan;0;0
5961;15538;832;53;37;5;32;.865;3600000;0
5961;48141;831;0;0;0;0;.00nan;0;0
5961;78094;831;85;30;1;29;.967;3600000;0
5967;6084;829;0;0;0;0;.00nan;0;0
5967;10322;838;64;26;3;23;.885;3900000;0
5967;26336;829;86;38;3;35;.921;3900000;0
5967;94240;838;0;0;0;0;.00nan;0;0
5969;805;832;76;34;3;31;.912;3600000;0
5969;10322;838;0;0;0;0;.00nan;0;0
5969;15538;832;0;0;0;0;.00nan;0;0
5969;94240;838;82;20;2;18;.900;3600000;0
5971;8501;836;71;44;5;39;.886;3600000;0
5971;30431;839;0;0;0;0;.00nan;0;0
5971;68390;836;0;0;0;0;.00nan;0;0
5971;78223;839;100;22;0;22;1.000;3600000;0
5977;183545;842;0;0;0;0;.00nan;0;0
5977;23433;842;81;35;3;32;.914;3537000;0
5977;32404;833;0;0;0;0;.00nan;0;0
5977;53867;833;99;30;1;29;.967;3600000;0
5979;165723;837;0;0;0;0;.00nan;0;0
5979;180287;847;0;0;0;0;.00nan;0;0
5979;54017;847;57;14;2;12;.857;3626000;0
5979;89190;837;95;37;1;36;.973;3626000;0
5981;167824;828;55;20;2;18;.900;3600000;0
5981;48141;831;63;34;4;30;.882;3518000;0
5981;78094;831;0;0;0;0;.00nan;0;0
5981;148041;828;0;0;0;0;.00nan;0;0
5983;10322;838;0;0;0;0;.00nan;0;0
5983;165723;837;65;20;2;18;.900;3600000;0
5983;89190;837;0;0;0;0;.00nan;0;0
5983;94240;838;60;47;5;42;.894;3600000;0
5989;805;832;0;0;0;0;.00nan;0;0
5989;183545;842;0;0;0;0;.00nan;0;0
5989;15538;832;78;29;2;27;.931;3600000;0
5989;23433;842;70;43;4;39;.907;3517000;0
5991;167824;828;0;0;0;0;.00nan;0;0
5991;32404;833;0;0;0;0;.00nan;0;0
5991;53867;833;82;27;2;25;.926;3670000;0
5991;148041;828;78;22;1;21;.955;3670000;0
5995;30431;839;0;0;0;0;.00nan;0;0
5995;180287;847;88;28;1;27;.964;3600000;0
5995;54017;847;0;0;0;0;.00nan;0;0
5995;78223;839;69;43;4;39;.907;3600000;0
5999;167824;828;60;20;2;18;.900;3600000;0
5999;183545;842;89;52;4;48;.923;3600000;0
5999;23433;842;0;0;0;0;.00nan;0;0
5999;148041;828;0;0;0;0;.00nan;0;0
6001;6084;829;0;0;0;0;.00nan;0;0
6001;26336;829;43;24;4;20;.833;3600000;0
6001;180287;847;0;0;0;0;.00nan;0;0
6001;54017;847;69;29;3;26;.897;3600000;0
6003;8501;836;0;0;0;0;.00nan;0;0
6003;32404;833;66;15;1;14;.933;3600000;0
6003;53867;833;0;0;0;0;.00nan;0;0
6003;68390;836;53;40;5;35;.875;3600000;0
6005;10322;838;59;32;4;28;.875;3523000;0
6005;165723;837;74;26;2;24;.923;3600000;0
6005;89190;837;0;0;0;0;.00nan;0;0
6005;94240;838;0;0;0;0;.00nan;0;0
6011;10322;838;0;0;0;0;.00nan;0;0
6011;183545;842;0;0;0;0;.00nan;0;0
6011;23433;842;97;25;0;25;1.000;3600000;0
6011;94240;838;90;35;1;34;.971;3581000;0
6013;8501;836;71;36;4;32;.889;3034000;0
6013;16838;830;69;19;1;18;.947;3600000;0
6013;47791;830;0;0;0;0;.00nan;0;0
6013;68390;836;62;11;0;11;1.000;566000;0
6015;6084;829;69;25;2;23;.920;2565000;0
6015;165723;837;71;33;3;30;.909;3600000;0
6015;26336;829;32;16;4;12;.750;1035000;0
6015;89190;837;0;0;0;0;.00nan;0;0
6017;5663;848;83;34;2;32;.941;3600000;0
6017;19322;848;0;0;0;0;.00nan;0;0
6017;180287;847;57;23;3;20;.870;3574000;0
6017;54017;847;0;0;0;0;.00nan;0;0
6019;805;832;0;0;0;0;.00nan;0;0
6019;167824;828;90;31;1;30;.968;3600000;0
6019;15538;832;75;34;2;32;.941;3546000;0
6019;148041;828;0;0;0;0;.00nan;0;0
6021;30431;839;0;0;0;0;.00nan;0;0
6021;48141;831;0;0;0;0;.00nan;0;0
6021;78094;831;46;42;6;36;.857;3514000;0
6021;78223;839;61;38;4;34;.895;3600000;0
6023;13373;834;53;37;5;32;.865;3600000;0
6023;32404;833;0;0;0;0;.00nan;0;0
6023;53867;833;57;21;3;18;.857;3600000;0
6023;147901;834;0;0;0;0;.00nan;0;0
6025;30431;839;62;24;3;21;.875;3580000;0
6025;32404;833;0;0;0;0;.00nan;0;0
6025;53867;833;74;26;1;25;.962;3600000;0
6025;78223;839;0;0;0;0;.00nan;0;0
6027;180287;847;69;23;1;22;.957;3600000;0
6027;48141;831;57;4;0;4;1.000;591000;0
6027;54017;847;0;0;0;0;.00nan;0;0
6027;78094;831;38;30;6;24;.800;3009000;0
6035;167824;828;0;0;0;0;.00nan;0;0
6035;183545;842;0;0;0;0;.00nan;0;0
6035;23433;842;57;36;5;31;.861;3600000;0
6035;148041;828;50;16;2;14;.875;3600000;0
6037;6084;829;53;30;4;26;.867;3600000;0
6037;165723;837;100;25;0;25;1.000;3600000;0
6037;26336;829;0;0;0;0;.00nan;0;0
6037;89190;837;0;0;0;0;.00nan;0;0
6041;167824;828;73;21;1;20;.952;3600000;0
6041;48141;831;66;21;2;19;.905;3600000;0
6041;78094;831;0;0;0;0;.00nan;0;0
6041;148041;828;0;0;0;0;.00nan;0;0
6043;32404;833;80;35;2;33;.943;3537000;0
6043;180287;847;0;0;0;0;.00nan;0;0
6043;53867;833;0;0;0;0;.00nan;0;0
6043;54017;847;100;34;0;34;1.000;3600000;0
6045;805;832;68;8;0;8;1.000;1071000;0
6045;10322;838;0;0;0;0;.00nan;0;0
6045;15538;832;35;34;6;28;.824;2529000;0
6045;94240;838;74;28;2;26;.929;3600000;0
6047;6084;829;0;0;0;0;.00nan;0;0
6047;183545;842;60;23;2;21;.913;3600000;0
6047;23433;842;0;0;0;0;.00nan;0;0
6047;26336;829;70;31;3;28;.903;3591000;0
135;-1;833;0;0;0;0;.00nan;0;0
135;53867;833;65;40;4;36;.900;3586000;0
135;57657;838;0;0;0;0;.00nan;0;0
135;77084;838;98;35;2;33;.943;3600000;0
136;5663;848;91;33;1;32;.970;3591000;0
136;6084;829;0;0;0;0;.00nan;0;0
136;19322;848;0;0;0;0;.00nan;0;0
136;26336;829;95;22;0;22;1.000;3600000;0
137;-1;833;0;0;0;0;.00nan;0;0
137;53867;833;66;31;3;28;.903;3596000;0
137;57657;838;0;0;0;0;.00nan;0;0
137;77084;838;90;33;1;32;.970;3600000;0
138;5663;848;45;17;3;14;.824;3565000;0
138;6084;829;0;0;0;0;.00nan;0;0
138;19322;848;0;0;0;0;.00nan;0;0
138;26336;829;84;30;2;28;.933;3600000;0
202;6084;829;0;0;0;0;.00nan;0;0
202;26336;829;63;22;2;20;.909;3600000;0
202;-1;833;0;0;0;0;.00nan;0;0
202;53867;833;58;30;3;27;.900;3544000;0
203;6084;829;0;0;0;0;.00nan;0;0
203;26336;829;53;34;5;29;.853;3600000;0
203;-1;833;0;0;0;0;.00nan;0;0
203;53867;833;49;40;6;34;.850;3555000;0
376;6084;829;0;0;0;0;.00nan;0;0
376;13373;834;29;31;7;24;.774;2530000;0
376;26336;829;99;41;2;39;.951;3600000;0
376;147901;834;49;14;2;12;.857;1070000;0
377;16838;830;74;20;1;19;.950;3600000;0
377;48141;831;0;0;0;0;.00nan;0;0
377;57413;830;0;0;0;0;.00nan;0;0
377;78094;831;63;35;4;31;.886;3600000;0
378;167824;828;0;0;0;0;.00nan;0;0
378;180287;847;74;29;2;27;.931;3600000;0
378;54017;847;0;0;0;0;.00nan;0;0
378;148041;828;75;34;3;31;.912;3600000;0
379;165723;837;73;22;1;21;.955;3600000;0
379;57657;838;0;0;0;0;.00nan;0;0
379;77084;838;76;31;2;29;.935;3600000;0
379;89190;837;0;0;0;0;.00nan;0;0
380;6084;829;0;0;0;0;.00nan;0;0
380;13373;834;62;29;3;26;.897;3543000;0
380;26336;829;85;30;2;28;.933;3600000;0
380;147901;834;0;0;0;0;.00nan;0;0
381;16838;830;64;16;1;15;.938;3600000;0
381;48141;831;0;0;0;0;.00nan;0;0
381;57413;830;0;0;0;0;.00nan;0;0
381;78094;831;100;37;0;37;1.000;3600000;0
382;167824;828;0;0;0;0;.00nan;0;0
382;180287;847;64;26;3;23;.885;3561000;0
382;54017;847;0;0;0;0;.00nan;0;0
382;148041;828;74;28;2;26;.929;3600000;0
383;165723;837;93;40;3;37;.925;3580000;0
383;57657;838;0;0;0;0;.00nan;0;0
383;77084;838;67;23;2;21;.913;3600000;0
383;89190;837;0;0;0;0;.00nan;0;0
384;6084;829;0;0;0;0;.00nan;0;0
384;13373;834;87;28;1;27;.964;3600000;0
384;26336;829;62;33;4;29;.879;3600000;0
384;147901;834;0;0;0;0;.00nan;0;0
385;16838;830;85;33;1;32;.970;3600000;0
385;48141;831;0;0;0;0;.00nan;0;0
385;57413;830;0;0;0;0;.00nan;0;0
385;78094;831;68;32;3;29;.906;3600000;0
386;167824;828;0;0;0;0;.00nan;0;0
386;180287;847;75;28;2;26;.929;3600000;0
386;54017;847;0;0;0;0;.00nan;0;0
386;148041;828;81;38;3;35;.921;3543000;0
387;165723;837;28;34;7;27;.794;3522000;0
387;57657;838;0;0;0;0;.00nan;0;0
387;77084;838;46;35;5;30;.857;3600000;0
387;89190;837;0;0;0;0;.00nan;0;0
388;6084;829;0;0;0;0;.00nan;0;0
388;13373;834;51;28;4;24;.857;3514000;0
388;26336;829;95;40;2;38;.950;3600000;0
388;147901;834;0;0;0;0;.00nan;0;0
389;16838;830;80;43;4;39;.907;3559000;0
389;48141;831;0;0;0;0;.00nan;0;0
389;57413;830;0;0;0;0;.00nan;0;0
389;78094;831;78;37;3;34;.919;3600000;0
390;167824;828;53;3;0;3;1.000;476000;0
390;180287;847;89;32;2;30;.938;3600000;0
390;54017;847;0;0;0;0;.00nan;0;0
390;148041;828;47;38;6;32;.842;3124000;0
391;165723;837;73;26;2;24;.923;3600000;0
391;57657;838;41;2;1;1;.500;528000;0
391;77084;838;69;41;4;37;.902;3072000;0
391;89190;837;0;0;0;0;.00nan;0;0
670;6084;829;0;0;0;0;.00nan;0;0
670;13373;834;76;23;1;22;.957;3600000;0
670;26336;829;51;35;5;30;.857;3600000;0
670;147901;834;0;0;0;0;.00nan;0;0
671;16838;830;94;27;1;26;.963;3600000;0
671;48141;831;0;0;0;0;.00nan;0;0
671;57413;830;0;0;0;0;.00nan;0;0
671;78094;831;62;28;3;25;.893;3514000;0
672;167824;828;85;33;2;31;.939;3600000;0
672;180287;847;53;23;3;20;.870;3568000;0
672;54017;847;0;0;0;0;.00nan;0;0
672;148041;828;0;0;0;0;.00nan;0;0
673;165723;837;65;41;6;35;.854;3600000;0
673;57657;838;0;0;0;0;.00nan;0;0
673;77084;838;75;30;2;28;.933;3600000;0
673;89190;837;0;0;0;0;.00nan;0;0
698;6084;829;0;0;0;0;.00nan;0;0
698;13373;834;33;29;5;24;.828;3513000;0
698;26336;829;69;30;3;27;.900;3600000;0
698;147901;834;0;0;0;0;.00nan;0;0
699;16838;830;96;41;2;39;.951;4303000;0
699;48141;831;0;0;0;0;.00nan;0;0
699;57413;830;0;0;0;0;.00nan;0;0
699;78094;831;87;43;3;40;.930;4303000;0
700;167824;828;49;30;4;26;.867;4171000;0
700;180287;847;94;46;3;43;.935;4171000;0
700;54017;847;0;0;0;0;.00nan;0;0
700;148041;828;0;0;0;0;.00nan;0;0
701;165723;837;47;32;5;27;.844;3600000;0
701;57657;838;0;0;0;0;.00nan;0;0
701;77084;838;68;32;3;29;.906;3600000;0
701;89190;837;0;0;0;0;.00nan;0;0
795;6084;829;0;0;0;0;.00nan;0;0
795;16838;830;87;13;0;13;1.000;3600000;0
795;26336;829;86;37;2;35;.946;3577000;0
795;57413;830;0;0;0;0;.00nan;0;0
796;180287;847;79;27;3;24;.889;3545000;0
796;54017;847;0;0;0;0;.00nan;0;0
796;57657;838;0;0;0;0;.00nan;0;0
796;77084;838;76;28;2;26;.929;3600000;0
797;6084;829;0;0;0;0;.00nan;0;0
797;16838;830;100;23;0;23;1.000;3600000;0
797;26336;829;82;36;2;34;.944;3513000;0
797;57413;830;0;0;0;0;.00nan;0;0
798;180287;847;75;22;1;21;.955;3600000;0
798;54017;847;0;0;0;0;.00nan;0;0
798;57657;838;0;0;0;0;.00nan;0;0
798;77084;838;73;40;4;36;.900;3600000;0
799;6084;829;0;0;0;0;.00nan;0;0
799;16838;830;62;22;2;20;.909;3574000;0
799;26336;829;100;46;1;45;.978;3600000;0
799;57413;830;0;0;0;0;.00nan;0;0
800;180287;847;61;27;4;23;.852;3596000;0
800;54017;847;0;0;0;0;.00nan;0;0
800;57657;838;0;0;0;0;.00nan;0;0
800;77084;838;91;46;2;44;.957;3600000;0
801;6084;829;0;0;0;0;.00nan;0;0
801;16838;830;80;23;1;22;.957;3600000;0
801;26336;829;100;29;0;29;1.000;3600000;0
801;57413;830;0;0;0;0;.00nan;0;0
802;180287;847;81;25;1;24;.960;3600000;0
802;54017;847;0;0;0;0;.00nan;0;0
802;57657;838;0;0;0;0;.00nan;0;0
802;77084;838;61;31;4;27;.871;3600000;0
1038;6084;829;0;0;0;0;.00nan;0;0
1038;16838;830;64;21;2;19;.905;3600000;0
1038;26336;829;98;56;4;52;.929;3586000;0
1038;57413;830;0;0;0;0;.00nan;0;0
1039;180287;847;45;38;5;33;.868;4474000;0
1039;54017;847;0;0;0;0;.00nan;0;0
1039;57657;838;71;30;2;28;.933;3444000;0
1039;77084;838;40;20;4;16;.800;1030000;0
1078;6084;829;0;0;0;0;.00nan;0;0
1078;16838;830;73;27;2;25;.926;3600000;0
1078;26336;829;94;43;3;40;.930;3600000;0
1078;57413;830;0;0;0;0;.00nan;0;0
1079;180287;847;72;21;1;20;.952;3600000;0
1079;54017;847;0;0;0;0;.00nan;0;0
1079;57657;838;50;37;6;31;.838;2988000;0
1079;77084;838;44;3;1;2;.667;612000;0
1113;16838;830;54;14;2;12;.857;3600000;0
1113;180287;847;85;41;3;38;.927;3600000;0
1113;54017;847;0;0;0;0;.00nan;0;0
1113;57413;830;0;0;0;0;.00nan;0;0
1114;16838;830;93;20;0;20;1.000;3600000;0
1114;180287;847;75;34;3;31;.912;3600000;0
1114;54017;847;0;0;0;0;.00nan;0;0
1114;57413;830;0;0;0;0;.00nan;0;0
1115;16838;830;100;24;0;24;1.000;3600000;0
1115;180287;847;72;26;2;24;.923;3524000;0
1115;54017;847;0;0;0;0;.00nan;0;0
1115;57413;830;0;0;0;0;.00nan;0;0
1116;16838;830;40;37;6;31;.838;3265000;0
1116;180287;847;93;42;2;40;.952;3600000;0
1116;54017;847;0;0;0;0;.00nan;0;0
1116;57413;830;53;3;0;3;1.000;335000;0
1341;16838;830;46;23;4;19;.826;3600000;0
1341;180287;847;62;43;5;38;.884;3566000;0
1341;54017;847;0;0;0;0;.00nan;0;0
1341;57413;830;0;0;0;0;.00nan;0;0
6052;195942;783;0;0;0;0;.00nan;0;0
6052;-1;778;0;0;0;0;.00nan;0;0
6052;54272;778;100;31;0;31;1.000;3600000;0
6052;146184;783;68;23;1;22;.957;3581000;0
6053;-1;784;0;0;0;0;.00nan;0;0
6053;44203;794;84;40;3;37;.925;3600000;0
6053;46334;794;0;0;0;0;.00nan;0;0
6053;-1;784;35;21;4;17;.810;3561000;0
6054;192036;796;0;0;0;0;.00nan;0;0
6054;64066;2182;0;0;0;0;.00nan;0;0
6054;82273;2182;75;36;3;33;.917;3600000;0
6054;149847;796;44;29;5;24;.828;3590000;0
6055;8487;776;100;38;1;37;.974;3900000;0
6055;36245;777;76;23;1;22;.957;3900000;0
6055;66924;777;0;0;0;0;.00nan;0;0
6055;95405;776;0;0;0;0;.00nan;0;0
6056;8107;780;88;30;1;29;.967;3600000;0
6056;190702;3737;97;46;2;44;.957;3564000;0
6056;192030;3737;0;0;0;0;.00nan;0;0
6056;-1;780;0;0;0;0;.00nan;0;0
6057;193854;798;61;22;2;20;.909;3600000;0
6057;183377;904;36;22;4;18;.818;1682000;0
6057;201174;798;0;0;0;0;.00nan;0;0
6057;-1;904;35;23;5;18;.783;1918000;0
6058;8487;776;73;35;3;32;.914;3600000;0
6058;-1;784;100;35;1;34;.971;3600000;0
6058;-1;784;0;0;0;0;.00nan;0;0
6058;95405;776;0;0;0;0;.00nan;0;0
6059;190702;3737;81;40;3;37;.925;3900000;0
6059;192030;3737;0;0;0;0;.00nan;0;0
6059;192036;796;0;0;0;0;.00nan;0;0
6059;149847;796;43;18;3;15;.833;3900000;0
6060;193854;798;66;23;2;21;.913;3600000;0
6060;201174;798;0;0;0;0;.00nan;0;0
6060;195942;783;0;0;0;0;.00nan;0;0
6060;146184;783;41;31;5;26;.839;3600000;0
6061;-1;778;0;0;0;0;.00nan;0;0
6061;44203;794;100;41;1;40;.976;3600000;0
6061;46334;794;0;0;0;0;.00nan;0;0
6061;54272;778;71;30;3;27;.900;3557000;0
6062;8107;780;78;22;1;21;.955;3600000;0
6062;183377;904;84;27;1;26;.963;2676000;0
6062;-1;904;31;17;4;13;.765;924000;0
6062;-1;780;0;0;0;0;.00nan;0;0
6063;4622;777;48;29;4;25;.862;3900000;0
6063;36245;777;0;0;0;0;.00nan;0;0
6063;64066;2182;0;0;0;0;.00nan;0;0
6063;82273;2182;84;52;4;48;.923;3900000;0
6064;8107;780;84;34;2;32;.941;3900000;0
6064;193854;798;79;34;2;32;.941;3900000;0
6064;201174;798;0;0;0;0;.00nan;0;0
6064;-1;780;0;0;0;0;.00nan;0;0
6065;8487;776;32;29;6;23;.793;3571000;0
6065;-1;778;0;0;0;0;.00nan;0;0
6065;54272;778;56;41;5;36;.878;3600000;0
6065;95405;776;0;0;0;0;.00nan;0;0
6066;195942;783;66;31;3;28;.903;3600000;0
6066;44203;794;90;49;4;45;.918;3595000;0
6066;46334;794;0;0;0;0;.00nan;0;0
6066;146184;783;0;0;0;0;.00nan;0;0
6067;-1;784;0;0;0;0;.00nan;0;0
6067;-1;784;72;42;4;38;.905;3600000;0
6067;64066;2182;0;0;0;0;.00nan;0;0
6067;82273;2182;65;39;5;34;.872;3600000;0
6068;4622;777;57;14;1;13;.929;3600000;0
6068;36245;777;0;0;0;0;.00nan;0;0
6068;190702;3737;51;39;6;33;.846;3600000;0
6068;192030;3737;0;0;0;0;.00nan;0;0
6069;183377;904;99;47;2;45;.957;3721000;0
6069;192036;796;0;0;0;0;.00nan;0;0
6069;-1;904;0;0;0;0;.00nan;0;0
6069;149847;796;54;25;3;22;.880;3721000;0
6070;190702;3737;83;45;4;41;.911;3555000;0
6070;-1;784;64;21;2;19;.905;3600000;0
6070;192030;3737;0;0;0;0;.00nan;0;0
6070;-1;784;0;0;0;0;.00nan;0;0
6071;193854;798;0;0;0;0;.00nan;0;0
6071;201174;798;80;32;2;30;.938;3600000;0
6071;192036;796;89;27;1;26;.963;3600000;0
6071;149847;796;0;0;0;0;.00nan;0;0
6072;8107;780;57;24;3;21;.875;3600000;0
6072;195942;783;0;0;0;0;.00nan;0;0
6072;-1;780;0;0;0;0;.00nan;0;0
6072;146184;783;75;41;4;37;.902;3542000;0
6073;-1;778;0;0;0;0;.00nan;0;0
6073;54272;778;80;27;2;25;.926;3548000;0
6073;64066;2182;0;0;0;0;.00nan;0;0
6073;82273;2182;86;15;0;15;1.000;3600000;0
6074;4622;777;71;21;1;20;.952;3600000;0
6074;183377;904;32;32;6;26;.813;2580000;0
6074;36245;777;0;0;0;0;.00nan;0;0
6074;-1;904;53;24;3;21;.875;1020000;0
6075;8487;776;50;22;3;19;.864;3600000;0
6075;44203;794;81;44;4;40;.909;3549000;0
6075;46334;794;0;0;0;0;.00nan;0;0
6075;95405;776;0;0;0;0;.00nan;0;0
6076;8107;780;0;0;0;0;.00nan;0;0
6076;192036;796;0;0;0;0;.00nan;0;0
6076;-1;780;73;30;3;27;.900;3600000;0
6076;149847;796;36;30;5;25;.833;3546000;0
6077;44203;794;48;26;4;22;.846;3600000;0
6077;46334;794;0;0;0;0;.00nan;0;0
6077;64066;2182;0;0;0;0;.00nan;0;0
6077;82273;2182;100;39;1;38;.974;3600000;0
6078;4622;777;77;36;3;33;.917;3600000;0
6078;193854;798;47;26;4;22;.846;3550000;0
6078;201174;798;0;0;0;0;.00nan;0;0
6078;36245;777;0;0;0;0;.00nan;0;0
6079;190702;3737;58;30;3;27;.900;3557000;0
6079;-1;778;0;0;0;0;.00nan;0;0
6079;192030;3737;0;0;0;0;.00nan;0;0
6079;54272;778;67;18;1;17;.944;3600000;0
6080;8487;776;0;0;0;0;.00nan;0;0
6080;195942;783;55;6;0;6;1.000;463000;0
6080;95405;776;64;22;2;20;.909;3600000;0
6080;146184;783;58;49;6;43;.878;3137000;0
6081;183377;904;63;29;3;26;.897;3513000;0
6081;-1;784;0;0;0;0;.00nan;0;0
6081;-1;904;0;0;0;0;.00nan;0;0
6081;-1;784;84;27;1;26;.963;3600000;0
6082;193854;798;42;27;5;22;.815;3577000;0
6082;201174;798;0;0;0;0;.00nan;0;0
6082;-1;784;0;0;0;0;.00nan;0;0
6082;-1;784;78;35;3;32;.914;3600000;0
6083;190702;3737;46;13;2;11;.846;1030000;0
6083;44203;794;100;29;0;29;1.000;3600000;0
6083;192030;3737;39;29;6;23;.793;2570000;0
6083;46334;794;0;0;0;0;.00nan;0;0
6084;195942;783;81;39;3;36;.923;3600000;0
6084;192036;796;0;0;0;0;.00nan;0;0
6084;146184;783;0;0;0;0;.00nan;0;0
6084;149847;796;47;37;6;31;.838;3600000;0
6085;183377;904;0;0;0;0;.00nan;0;0
6085;-1;778;0;0;0;0;.00nan;0;0
6085;-1;904;51;22;3;19;.864;3600000;0
6085;54272;778;76;39;4;35;.897;3600000;0
6086;4622;777;66;33;4;29;.879;3600000;0
6086;8107;780;61;45;5;40;.889;3596000;0
6086;36245;777;0;0;0;0;.00nan;0;0
6086;-1;780;0;0;0;0;.00nan;0;0
6087;8487;776;67;21;3;18;.857;3570000;0
6087;64066;2182;0;0;0;0;.00nan;0;0
6087;82273;2182;87;37;2;35;.946;3600000;0
6087;95405;776;0;0;0;0;.00nan;0;0
6088;8107;780;60;25;2;23;.920;3900000;0
6088;-1;784;0;0;0;0;.00nan;0;0
6088;-1;780;0;0;0;0;.00nan;0;0
6088;-1;784;84;34;2;32;.941;3900000;0
6089;193854;798;62;18;2;16;.889;3600000;0
6089;201174;798;0;0;0;0;.00nan;0;0
6089;-1;778;0;0;0;0;.00nan;0;0
6089;54272;778;64;42;5;37;.881;3600000;0
6090;183377;904;67;42;4;38;.905;3599000;0
6090;44203;794;45;18;3;15;.833;3600000;0
6090;-1;904;0;0;0;0;.00nan;0;0
6090;46334;794;0;0;0;0;.00nan;0;0
6091;195942;783;0;0;0;0;.00nan;0;0
6091;64066;2182;0;0;0;0;.00nan;0;0
6091;82273;2182;71;41;4;37;.902;3545000;0
6091;146184;783;41;15;3;12;.800;3600000;0
6092;4622;777;77;33;3;30;.909;3824000;0
6092;36245;777;0;0;0;0;.00nan;0;0
6092;192036;796;0;0;0;0;.00nan;0;0
6092;149847;796;91;46;2;44;.957;3824000;0
6093;8487;776;89;31;1;30;.968;3600000;0
6093;190702;3737;65;39;4;35;.897;3600000;0
6093;192030;3737;0;0;0;0;.00nan;0;0
6093;95405;776;0;0;0;0;.00nan;0;0
6094;193854;798;87;21;0;21;1.000;3600000;0
6094;201174;798;0;0;0;0;.00nan;0;0
6094;44203;794;98;44;3;41;.932;3600000;0
6094;46334;794;0;0;0;0;.00nan;0;0
6095;190702;3737;79;31;2;29;.935;3600000;0
6095;192030;3737;0;0;0;0;.00nan;0;0
6095;64066;2182;0;0;0;0;.00nan;0;0
6095;82273;2182;64;33;4;29;.879;3579000;0
6096;-1;784;61;29;3;26;.897;3600000;0
6096;192036;796;0;0;0;0;.00nan;0;0
6096;-1;784;0;0;0;0;.00nan;0;0
6096;149847;796;48;30;4;26;.867;3549000;0
6097;4622;777;16;19;6;13;.684;2149000;0
6097;195942;783;0;0;0;0;.00nan;0;0
6097;36245;777;48;9;2;7;.778;1451000;0
6097;146184;783;68;35;4;31;.886;3600000;0
6098;8107;780;76;36;3;33;.917;3900000;0
6098;-1;778;0;0;0;0;.00nan;0;0
6098;-1;780;0;0;0;0;.00nan;0;0
6098;54272;778;72;34;3;31;.912;3900000;0
6099;8487;776;0;0;0;0;.00nan;0;0
6099;183377;904;0;0;0;0;.00nan;0;0
6099;-1;904;87;40;2;38;.950;3900000;0
6099;95405;776;72;27;2;25;.926;3900000;0
6100;8107;780;66;24;2;22;.917;3584000;0
6100;44203;794;99;46;1;45;.978;3600000;0
6100;-1;780;0;0;0;0;.00nan;0;0
6100;46334;794;0;0;0;0;.00nan;0;0
6101;4622;777;100;21;0;21;1.000;3600000;0
6101;36245;777;0;0;0;0;.00nan;0;0
6101;-1;784;0;0;0;0;.00nan;0;0
6101;-1;784;73;47;5;42;.894;3600000;0
6102;-1;778;0;0;0;0;.00nan;0;0
6102;192036;796;49;32;4;28;.875;3900000;0
6102;54272;778;65;37;4;33;.892;3900000;0
6102;149847;796;0;0;0;0;.00nan;0;0
6103;195942;783;0;0;0;0;.00nan;0;0
6103;190702;3737;78;37;3;34;.919;3574000;0
6103;192030;3737;0;0;0;0;.00nan;0;0
6103;146184;783;64;25;2;23;.920;3600000;0
6104;8487;776;76;27;1;26;.963;3600000;0
6104;193854;798;38;21;4;17;.810;3600000;0
6104;201174;798;0;0;0;0;.00nan;0;0
6104;95405;776;0;0;0;0;.00nan;0;0
6105;183377;904;67;27;3;24;.889;3600000;0
6105;-1;904;0;0;0;0;.00nan;0;0
6105;64066;2182;0;0;0;0;.00nan;0;0
6105;82273;2182;64;32;4;28;.875;3600000;0
6106;44203;794;78;35;2;33;.943;3568000;0
6106;192036;796;0;0;0;0;.00nan;0;0
6106;46334;794;0;0;0;0;.00nan;0;0
6106;149847;796;57;13;1;12;.923;3600000;0
6107;193854;798;91;35;1;34;.971;3900000;0
6107;201174;798;0;0;0;0;.00nan;0;0
6107;64066;2182;0;0;0;0;.00nan;0;0
6107;82273;2182;97;35;1;34;.971;3900000;0
6108;195942;783;98;28;0;28;1.000;3600000;0
6108;-1;784;57;19;2;17;.895;3537000;0
6108;-1;784;0;0;0;0;.00nan;0;0
6108;146184;783;0;0;0;0;.00nan;0;0
6109;4622;777;73;21;1;20;.952;3600000;0
6109;36245;777;0;0;0;0;.00nan;0;0
6109;-1;778;0;0;0;0;.00nan;0;0
6109;54272;778;80;31;2;29;.935;3553000;0
6110;183377;904;0;0;0;0;.00nan;0;0
6110;190702;3737;0;0;0;0;.00nan;0;0
6110;192030;3737;54;23;3;20;.870;3600000;0
6110;-1;904;26;32;6;26;.813;3600000;0
6111;8107;780;58;23;3;20;.870;3600000;0
6111;8487;776;62;42;5;37;.881;3593000;0
6111;-1;780;0;0;0;0;.00nan;0;0
6111;95405;776;0;0;0;0;.00nan;0;0
6112;-1;778;0;0;0;0;.00nan;0;0
6112;-1;784;0;0;0;0;.00nan;0;0
6112;-1;784;88;39;2;37;.949;3817000;0
6112;54272;778;74;24;1;23;.958;3817000;0
6113;8107;780;0;0;0;0;.00nan;0;0
6113;-1;780;72;23;2;21;.913;3900000;0
6113;64066;2182;0;0;0;0;.00nan;0;0
6113;82273;2182;97;53;2;51;.962;3900000;0
6114;183377;904;76;38;3;35;.921;3546000;0
6114;195942;783;68;31;2;29;.935;3600000;0
6114;-1;904;0;0;0;0;.00nan;0;0
6114;146184;783;0;0;0;0;.00nan;0;0
6115;8487;776;77;26;2;24;.923;3600000;0
6115;192036;796;0;0;0;0;.00nan;0;0
6115;95405;776;0;0;0;0;.00nan;0;0
6115;149847;796;45;28;5;23;.821;3600000;0
6116;4622;777;100;34;0;34;1.000;3600000;0
6116;36245;777;0;0;0;0;.00nan;0;0
6116;44203;794;72;34;3;31;.912;3600000;0
6116;46334;794;0;0;0;0;.00nan;0;0
6117;193854;798;64;26;2;24;.923;3900000;0
6117;201174;798;0;0;0;0;.00nan;0;0
6117;190702;3737;74;23;2;21;.913;3900000;0
6117;192030;3737;0;0;0;0;.00nan;0;0
6118;-1;784;60;26;3;23;.885;3721000;0
6118;44203;794;77;37;4;33;.892;3721000;0
6118;46334;794;0;0;0;0;.00nan;0;0
6118;-1;784;0;0;0;0;.00nan;0;0
6119;192036;796;100;28;0;28;1.000;3600000;0
6119;64066;2182;0;0;0;0;.00nan;0;0
6119;82273;2182;71;34;3;31;.912;3600000;0
6119;149847;796;0;0;0;0;.00nan;0;0
6120;195942;783;0;0;0;0;.00nan;0;0
6120;-1;778;59;22;3;19;.864;3052000;0
6120;54272;778;27;8;3;5;.625;548000;0
6120;146184;783;63;22;2;20;.909;3600000;0
6121;8107;780;59;21;3;18;.857;3600000;0
6121;190702;3737;63;36;5;31;.861;3585000;0
6121;192030;3737;0;0;0;0;.00nan;0;0
6121;-1;780;0;0;0;0;.00nan;0;0
6122;4622;777;81;39;3;36;.923;3600000;0
6122;8487;776;0;0;0;0;.00nan;0;0
6122;36245;777;0;0;0;0;.00nan;0;0
6122;95405;776;46;31;5;26;.839;3516000;0
6123;193854;798;49;27;4;23;.852;3900000;0
6123;183377;904;0;0;0;0;.00nan;0;0
6123;201174;798;0;0;0;0;.00nan;0;0
6123;-1;904;66;42;4;38;.905;3900000;0
6124;8487;776;96;34;1;33;.971;3600000;0
6124;-1;784;62;42;5;37;.881;3600000;0
6124;-1;784;0;0;0;0;.00nan;0;0
6124;95405;776;0;0;0;0;.00nan;0;0
6125;-1;778;0;0;0;0;.00nan;0;0
6125;44203;794;82;33;3;30;.909;3600000;0
6125;46334;794;0;0;0;0;.00nan;0;0
6125;54272;778;51;30;4;26;.867;3542000;0
6126;193854;798;72;31;4;27;.871;3600000;0
6126;201174;798;0;0;0;0;.00nan;0;0
6126;195942;783;23;47;9;38;.809;3600000;0
6126;146184;783;0;0;0;0;.00nan;0;0
6127;4622;777;73;18;1;17;.944;3600000;0
6127;36245;777;0;0;0;0;.00nan;0;0
6127;64066;2182;0;0;0;0;.00nan;0;0
6127;82273;2182;98;51;4;47;.922;3600000;0
6128;190702;3737;30;9;3;6;.667;308000;0
6128;192030;3737;97;45;1;44;.978;3292000;0
6128;192036;796;55;14;2;12;.857;3600000;0
6128;149847;796;0;0;0;0;.00nan;0;0
6129;8107;780;83;15;0;15;1.000;3600000;0
6129;183377;904;0;0;0;0;.00nan;0;0
6129;-1;904;33;35;6;29;.829;3600000;0
6129;-1;780;0;0;0;0;.00nan;0;0
6130;-1;784;0;0;0;0;.00nan;0;0
6130;-1;784;50;16;2;14;.875;3600000;0
6130;64066;2182;0;0;0;0;.00nan;0;0
6130;82273;2182;68;48;5;43;.896;3600000;0
6131;183377;904;0;0;0;0;.00nan;0;0
6131;192036;796;0;0;0;0;.00nan;0;0
6131;-1;904;63;51;6;45;.882;3600000;0
6131;149847;796;34;10;3;7;.700;3600000;0
6132;195942;783;0;0;0;0;.00nan;0;0
6132;44203;794;69;35;3;32;.914;3543000;0
6132;46334;794;0;0;0;0;.00nan;0;0
6132;146184;783;56;20;2;18;.900;3600000;0
6133;8487;776;88;28;1;27;.964;3600000;0
6133;-1;778;0;0;0;0;.00nan;0;0
6133;54272;778;42;26;5;21;.808;3600000;0
6133;95405;776;0;0;0;0;.00nan;0;0
6134;8107;780;61;42;5;37;.881;3600000;0
6134;193854;798;60;33;4;29;.879;3600000;0
6134;201174;798;0;0;0;0;.00nan;0;0
6134;-1;780;0;0;0;0;.00nan;0;0
6135;4622;777;68;22;1;21;.955;3600000;0
6135;36245;777;0;0;0;0;.00nan;0;0
6135;190702;3737;67;32;3;29;.906;3529000;0
6135;192030;3737;0;0;0;0;.00nan;0;0
6136;8107;780;76;12;0;12;1.000;3600000;0
6136;195942;783;0;0;0;0;.00nan;0;0
6136;-1;780;0;0;0;0;.00nan;0;0
6136;146184;783;82;42;3;39;.929;3600000;0
6137;8487;776;67;23;2;21;.913;3600000;0
6137;44203;794;0;0;0;0;.00nan;0;0
6137;46334;794;66;44;5;39;.886;3600000;0
6137;95405;776;0;0;0;0;.00nan;0;0
6138;-1;778;0;0;0;0;.00nan;0;0
6138;54272;778;56;22;2;20;.909;3600000;0
6138;64066;2182;0;0;0;0;.00nan;0;0
6138;82273;2182;59;34;4;30;.882;3546000;0
6139;193854;798;51;35;5;30;.857;3600000;0
6139;201174;798;0;0;0;0;.00nan;0;0
6139;192036;796;0;0;0;0;.00nan;0;0
6139;149847;796;63;19;2;17;.895;3600000;0
6140;190702;3737;57;38;5;33;.868;3600000;0
6140;-1;784;77;33;2;31;.939;3600000;0
6140;192030;3737;0;0;0;0;.00nan;0;0
6140;-1;784;0;0;0;0;.00nan;0;0
6141;4622;777;56;24;3;21;.875;3600000;0
6141;183377;904;23;14;4;10;.714;625000;0
6141;36245;777;0;0;0;0;.00nan;0;0
6141;-1;904;97;45;2;43;.956;2975000;0
6142;183377;904;51;14;2;12;.857;1562000;0
6142;-1;784;0;0;0;0;.00nan;0;0
6142;-1;904;46;30;4;26;.867;2038000;0
6142;-1;784;76;38;3;35;.921;3600000;0
6143;44203;794;57;17;2;15;.882;3600000;0
6143;46334;794;0;0;0;0;.00nan;0;0
6143;64066;2182;0;0;0;0;.00nan;0;0
6143;82273;2182;91;43;3;40;.930;3553000;0
6144;8107;780;89;29;1;28;.966;3600000;0
6144;192036;796;52;24;3;21;.875;3600000;0
6144;-1;780;0;0;0;0;.00nan;0;0
6144;149847;796;0;0;0;0;.00nan;0;0
6145;8487;776;44;17;3;14;.824;3600000;0
6145;195942;783;62;33;4;29;.879;3600000;0
6145;95405;776;0;0;0;0;.00nan;0;0
6145;146184;783;0;0;0;0;.00nan;0;0
6146;4622;777;100;30;0;30;1.000;3600000;0
6146;193854;798;49;27;4;23;.852;3600000;0
6146;201174;798;0;0;0;0;.00nan;0;0
6146;36245;777;0;0;0;0;.00nan;0;0
6147;190702;3737;0;0;0;0;.00nan;0;0
6147;-1;778;0;0;0;0;.00nan;0;0
6147;192030;3737;40;33;6;27;.818;3600000;0
6147;54272;778;88;42;2;40;.952;3600000;0
6148;4622;777;99;41;2;39;.951;3600000;0
6148;8107;780;0;0;0;0;.00nan;0;0
6148;36245;777;0;0;0;0;.00nan;0;0
6148;-1;780;67;35;3;32;.914;3592000;0
6149;193854;798;63;27;3;24;.889;3531000;0
6149;201174;798;0;0;0;0;.00nan;0;0
6149;-1;784;87;32;1;31;.969;3600000;0
6149;-1;784;0;0;0;0;.00nan;0;0
6150;8487;776;80;14;0;14;1.000;3600000;0
6150;64066;2182;0;0;0;0;.00nan;0;0
6150;82273;2182;71;49;5;44;.898;3600000;0
6150;95405;776;0;0;0;0;.00nan;0;0
6151;195942;783;0;0;0;0;.00nan;0;0
6151;192036;796;0;0;0;0;.00nan;0;0
6151;146184;783;100;51;1;50;.980;3600000;0
6151;149847;796;52;10;2;8;.800;3544000;0
6152;190702;3737;84;30;1;29;.967;3600000;0
6152;44203;794;56;30;4;26;.867;3600000;0
6152;192030;3737;0;0;0;0;.00nan;0;0
6152;46334;794;0;0;0;0;.00nan;0;0
6153;183377;904;64;24;2;22;.917;2855000;0
6153;-1;778;0;0;0;0;.00nan;0;0
6153;-1;904;19;8;4;4;.500;745000;0
6153;54272;778;100;27;0;27;1.000;3600000;0
6154;8107;780;49;29;5;24;.828;3546000;0
6154;-1;784;0;0;0;0;.00nan;0;0
6154;-1;780;0;0;0;0;.00nan;0;0
6154;-1;784;61;36;4;32;.889;3600000;0
6155;183377;904;0;0;0;0;.00nan;0;0
6155;44203;794;68;19;1;18;.947;3600000;0
6155;-1;904;49;32;5;27;.844;3600000;0
6155;46334;794;0;0;0;0;.00nan;0;0
6156;193854;798;87;31;1;30;.968;3814000;0
6156;201174;798;0;0;0;0;.00nan;0;0
6156;-1;778;0;0;0;0;.00nan;0;0
6156;54272;778;94;40;2;38;.950;3814000;0
6157;4622;777;67;24;2;22;.917;3600000;0
6157;36245;777;0;0;0;0;.00nan;0;0
6157;192036;796;0;0;0;0;.00nan;0;0
6157;149847;796;60;34;4;30;.882;3600000;0
6158;8487;776;78;23;1;22;.957;3600000;0
6158;190702;3737;54;19;2;17;.895;980000;0
6158;192030;3737;13;19;6;13;.684;2620000;0
6158;95405;776;0;0;0;0;.00nan;0;0
6159;195942;783;73;24;2;22;.917;3557000;0
6159;64066;2182;0;0;0;0;.00nan;0;0
6159;82273;2182;72;22;1;21;.955;3600000;0
6159;146184;783;0;0;0;0;.00nan;0;0
6160;193854;798;59;20;1;19;.950;3575000;0
6160;201174;798;0;0;0;0;.00nan;0;0
6160;44203;794;100;33;0;33;1.000;3600000;0
6160;46334;794;0;0;0;0;.00nan;0;0
6161;-1;784;77;37;3;34;.919;3562000;0
6161;192036;796;0;0;0;0;.00nan;0;0
6161;-1;784;0;0;0;0;.00nan;0;0
6161;149847;796;73;29;2;27;.931;3600000;0
6162;8107;780;18;8;4;4;.500;721000;0
6162;-1;778;0;0;0;0;.00nan;0;0
6162;-1;780;59;14;1;13;.929;2845000;0
6162;54272;778;80;35;3;32;.914;3600000;0
6163;4622;777;97;26;1;25;.962;3600000;0
6163;195942;783;0;0;0;0;.00nan;0;0
6163;36245;777;0;0;0;0;.00nan;0;0
6163;146184;783;54;35;4;31;.886;3600000;0
6164;190702;3737;59;40;5;35;.875;3600000;0
6164;192030;3737;0;0;0;0;.00nan;0;0
6164;64066;2182;0;0;0;0;.00nan;0;0
6164;82273;2182;51;38;6;32;.842;3567000;0
6165;8487;776;36;20;4;16;.800;3600000;0
6165;183377;904;47;52;6;46;.885;3600000;0
6165;-1;904;0;0;0;0;.00nan;0;0
6165;95405;776;0;0;0;0;.00nan;0;0
6166;8107;780;70;23;2;21;.913;3600000;0
6166;44203;794;71;34;4;30;.882;3567000;0
6166;-1;780;0;0;0;0;.00nan;0;0
6166;46334;794;0;0;0;0;.00nan;0;0
6167;-1;778;100;31;0;31;1.000;3600000;0
6167;192036;796;0;0;0;0;.00nan;0;0
6167;54272;778;0;0;0;0;.00nan;0;0
6167;149847;796;49;25;3;22;.880;3600000;0
6168;4622;777;39;32;6;26;.813;3600000;0
6168;36245;777;0;0;0;0;.00nan;0;0
6168;-1;784;0;0;0;0;.00nan;0;0
6168;-1;784;68;35;3;32;.914;3600000;0
6169;195942;783;58;18;2;16;.889;3600000;0
6169;190702;3737;55;38;5;33;.868;3600000;0
6169;192030;3737;0;0;0;0;.00nan;0;0
6169;146184;783;0;0;0;0;.00nan;0;0
6170;183377;904;0;0;0;0;.00nan;0;0
6170;-1;904;67;42;4;38;.905;3600000;0
6170;64066;2182;0;0;0;0;.00nan;0;0
6170;82273;2182;70;20;1;19;.950;3600000;0
6171;8487;776;75;25;2;23;.920;3600000;0
6171;193854;798;66;30;3;27;.900;3590000;0
6171;201174;798;0;0;0;0;.00nan;0;0
6171;95405;776;0;0;0;0;.00nan;0;0
6172;195942;783;0;0;0;0;.00nan;0;0
6172;-1;784;0;0;0;0;.00nan;0;0
6172;-1;784;83;34;2;32;.941;3900000;0
6172;146184;783;83;32;2;30;.938;3900000;0
6173;193854;798;0;0;0;0;.00nan;0;0
6173;201174;798;36;20;4;16;.800;3600000;0
6173;64066;2182;0;0;0;0;.00nan;0;0
6173;82273;2182;93;39;1;38;.974;3600000;0
6174;44203;794;76;35;3;32;.914;3600000;0
6174;192036;796;65;23;2;21;.913;3600000;0
6174;46334;794;0;0;0;0;.00nan;0;0
6174;149847;796;0;0;0;0;.00nan;0;0
6175;8107;780;65;30;3;27;.900;3600000;0
6175;8487;776;52;31;4;27;.871;3590000;0
6175;-1;780;0;0;0;0;.00nan;0;0
6175;95405;776;0;0;0;0;.00nan;0;0
6176;4622;777;59;14;1;13;.929;3600000;0
6176;36245;777;0;0;0;0;.00nan;0;0
6176;-1;778;59;31;4;27;.871;3600000;0
6176;54272;778;0;0;0;0;.00nan;0;0
6177;183377;904;55;43;5;38;.884;3576000;0
6177;190702;3737;61;28;3;25;.893;3600000;0
6177;192030;3737;0;0;0;0;.00nan;0;0
6177;-1;904;0;0;0;0;.00nan;0;0
6178;-1;778;0;0;0;0;.00nan;0;0
6178;-1;784;60;32;4;28;.875;3572000;0
6178;-1;784;0;0;0;0;.00nan;0;0
6178;54272;778;65;26;3;23;.885;3600000;0
6179;4622;777;68;19;1;18;.947;3600000;0
6179;36245;777;0;0;0;0;.00nan;0;0
6179;44203;794;95;44;2;42;.955;3545000;0
6179;46334;794;0;0;0;0;.00nan;0;0
6180;8107;780;90;19;0;19;1.000;3600000;0
6180;-1;780;0;0;0;0;.00nan;0;0
6180;64066;2182;77;41;4;37;.902;3600000;0
6180;82273;2182;0;0;0;0;.00nan;0;0
6181;193854;798;52;24;4;20;.833;3656000;0
6181;201174;798;0;0;0;0;.00nan;0;0
6181;190702;3737;82;40;3;37;.925;3656000;0
6181;192030;3737;0;0;0;0;.00nan;0;0
6182;8487;776;53;30;4;26;.867;3600000;0
6182;192036;796;0;0;0;0;.00nan;0;0
6182;95405;776;0;0;0;0;.00nan;0;0
6182;149847;796;89;34;1;33;.971;3600000;0
6183;183377;904;0;0;0;0;.00nan;0;0
6183;195942;783;0;0;0;0;.00nan;0;0
6183;-1;904;98;48;2;46;.958;3600000;0
6183;146184;783;89;29;1;28;.966;3600000;0
6184;-1;784;0;0;0;0;.00nan;0;0
6184;44203;794;85;42;4;38;.905;3600000;0
6184;46334;794;0;0;0;0;.00nan;0;0
6184;-1;784;67;20;1;19;.950;3600000;0
6185;192036;796;0;0;0;0;.00nan;0;0
6185;64066;2182;0;0;0;0;.00nan;0;0
6185;82273;2182;85;31;2;29;.935;3600000;0
6185;149847;796;60;13;1;12;.923;3600000;0
6186;195942;783;0;0;0;0;.00nan;0;0
6186;-1;778;0;0;0;0;.00nan;0;0
6186;54272;778;98;40;3;37;.925;3854000;0
6186;146184;783;76;40;3;37;.925;3900000;0
6187;193854;798;0;0;0;0;.00nan;0;0
6187;183377;904;0;0;0;0;.00nan;0;0
6187;201174;798;56;24;3;21;.875;3600000;0
6187;-1;904;38;29;6;23;.793;3600000;0
6188;4622;777;0;0;0;0;.00nan;0;0
6188;8487;776;44;17;3;14;.824;3600000;0
6188;36245;777;58;38;4;34;.895;3554000;0
6188;95405;776;0;0;0;0;.00nan;0;0
6189;8107;780;43;17;3;14;.824;3600000;0
6189;190702;3737;0;0;0;0;.00nan;0;0
6189;192030;3737;48;43;6;37;.860;3600000;0
6189;-1;780;0;0;0;0;.00nan;0;0
6190;8107;780;62;40;4;36;.900;3712000;0
6190;183377;904;0;0;0;0;.00nan;0;0
6190;-1;904;81;43;3;40;.930;3712000;0
6190;-1;780;0;0;0;0;.00nan;0;0
6191;-1;778;0;0;0;0;.00nan;0;0
6191;44203;794;70;34;3;31;.912;3600000;0
6191;46334;794;0;0;0;0;.00nan;0;0
6191;54272;778;67;23;2;21;.913;3600000;0
6192;193854;798;86;29;1;28;.966;3600000;0
6192;201174;798;0;0;0;0;.00nan;0;0
6192;195942;783;0;0;0;0;.00nan;0;0
6192;146184;783;80;40;3;37;.925;3600000;0
6193;190702;3737;72;33;3;30;.909;3544000;0
6193;192030;3737;0;0;0;0;.00nan;0;0
6193;192036;796;0;0;0;0;.00nan;0;0
6193;149847;796;57;18;2;16;.889;3600000;0
6194;4622;777;77;26;2;24;.923;3600000;0
6194;36245;777;0;0;0;0;.00nan;0;0
6194;64066;2182;0;0;0;0;.00nan;0;0
6194;82273;2182;40;35;6;29;.829;3600000;0
6195;8487;776;0;0;0;0;.00nan;0;0
6195;-1;784;79;48;4;44;.917;3546000;0
6195;-1;784;0;0;0;0;.00nan;0;0
6195;95405;776;60;29;3;26;.897;3600000;0
6196;195942;783;0;0;0;0;.00nan;0;0
6196;44203;794;0;0;0;0;.00nan;0;0
6196;46334;794;89;48;4;44;.917;3564000;0
6196;146184;783;63;25;3;22;.880;3600000;0
6197;-1;784;0;0;0;0;.00nan;0;0
6197;-1;784;59;24;3;21;.875;3600000;0
6197;64066;2182;0;0;0;0;.00nan;0;0
6197;82273;2182;57;34;4;30;.882;3567000;0
6198;8107;780;67;24;2;22;.917;3529000;0
6198;193854;798;100;31;0;31;1.000;3600000;0
6198;201174;798;0;0;0;0;.00nan;0;0
6198;-1;780;0;0;0;0;.00nan;0;0
6199;4622;777;57;18;2;16;.889;3600000;0
6199;36245;777;0;0;0;0;.00nan;0;0
6199;190702;3737;0;0;0;0;.00nan;0;0
6199;192030;3737;70;34;3;31;.912;3569000;0
6200;8487;776;73;27;2;25;.926;3600000;0
6200;-1;778;0;0;0;0;.00nan;0;0
6200;54272;778;77;42;4;38;.905;3590000;0
6200;95405;776;0;0;0;0;.00nan;0;0
6201;183377;904;94;40;1;39;.975;3561000;0
6201;192036;796;0;0;0;0;.00nan;0;0
6201;-1;904;0;0;0;0;.00nan;0;0
6201;149847;796;78;14;0;14;1.000;3600000;0
6202;190702;3737;64;29;3;26;.897;3600000;0
6202;44203;794;95;19;0;19;1.000;3600000;0
6202;192030;3737;0;0;0;0;.00nan;0;0
6202;46334;794;0;0;0;0;.00nan;0;0
6203;195942;783;40;29;4;25;.862;3600000;0
6203;-1;784;53;31;5;26;.839;3561000;0
6203;-1;784;0;0;0;0;.00nan;0;0
6203;146184;783;0;0;0;0;.00nan;0;0
6204;193854;798;88;30;1;29;.967;3600000;0
6204;201174;798;0;0;0;0;.00nan;0;0
6204;64066;2182;0;0;0;0;.00nan;0;0
6204;82273;2182;82;34;2;32;.941;3580000;0
6205;4622;777;92;32;1;31;.969;3900000;0
6205;36245;777;0;0;0;0;.00nan;0;0
6205;-1;778;0;0;0;0;.00nan;0;0
6205;54272;778;74;21;1;20;.952;3900000;0
6206;8487;776;36;31;6;25;.806;3552000;0
6206;192036;796;0;0;0;0;.00nan;0;0
6206;95405;776;0;0;0;0;.00nan;0;0
6206;149847;796;51;26;4;22;.846;3600000;0
6207;8107;780;100;30;0;30;1.000;3600000;0
6207;183377;904;0;0;0;0;.00nan;0;0
6207;-1;904;91;45;3;42;.933;3600000;0
6207;-1;780;0;0;0;0;.00nan;0;0
6208;8107;780;74;30;3;27;.900;3579000;0
6208;-1;778;0;0;0;0;.00nan;0;0
6208;-1;780;0;0;0;0;.00nan;0;0
6208;54272;778;76;30;2;28;.933;3600000;0
6209;190702;3737;66;44;4;40;.909;3600000;0
6209;-1;784;0;0;0;0;.00nan;0;0
6209;192030;3737;0;0;0;0;.00nan;0;0
6209;-1;784;66;32;3;29;.906;3600000;0
6210;195942;783;0;0;0;0;.00nan;0;0
6210;44203;794;100;51;2;49;.961;3600000;0
6210;46334;794;0;0;0;0;.00nan;0;0
6210;146184;783;62;27;3;24;.889;3555000;0
6211;193854;798;62;35;4;31;.886;3570000;0
6211;201174;798;0;0;0;0;.00nan;0;0
6211;192036;796;0;0;0;0;.00nan;0;0
6211;149847;796;65;30;3;27;.900;3600000;0
6212;4622;777;51;7;1;6;.857;3600000;0
6212;183377;904;56;13;1;12;.923;1507000;0
6212;36245;777;0;0;0;0;.00nan;0;0
6212;-1;904;37;36;7;29;.806;2093000;0
6213;8487;776;56;17;2;15;.882;3600000;0
6213;64066;2182;0;0;0;0;.00nan;0;0
6213;82273;2182;89;50;3;47;.940;3600000;0
6213;95405;776;0;0;0;0;.00nan;0;0
6214;-1;784;28;23;6;17;.739;3541000;0
6214;44203;794;69;39;4;35;.897;3600000;0
6214;46334;794;0;0;0;0;.00nan;0;0
6214;-1;784;0;0;0;0;.00nan;0;0
6215;192036;796;0;0;0;0;.00nan;0;0
6215;64066;2182;0;0;0;0;.00nan;0;0
6215;82273;2182;49;44;6;38;.864;3600000;0
6215;149847;796;62;16;1;15;.938;3600000;0
6216;8487;776;75;32;3;29;.906;3588000;0
6216;193854;798;0;0;0;0;.00nan;0;0
6216;201174;798;70;28;2;26;.929;3600000;0
6216;95405;776;0;0;0;0;.00nan;0;0
6217;4622;777;75;40;4;36;.900;3600000;0
6217;8107;780;90;37;1;36;.973;3600000;0
6217;36245;777;0;0;0;0;.00nan;0;0
6217;-1;780;0;0;0;0;.00nan;0;0
6218;195942;783;0;0;0;0;.00nan;0;0
6218;190702;3737;69;47;4;43;.915;3600000;0
6218;192030;3737;0;0;0;0;.00nan;0;0
6218;146184;783;57;19;2;17;.895;3600000;0
6219;183377;904;81;35;3;32;.914;3536000;0
6219;-1;778;0;0;0;0;.00nan;0;0
6219;-1;904;0;0;0;0;.00nan;0;0
6219;54272;778;81;27;1;26;.963;3600000;0
6220;8107;780;50;23;3;20;.870;3600000;0
6220;183377;904;0;0;0;0;.00nan;0;0
6220;-1;904;71;49;4;45;.918;3588000;0
6220;-1;780;0;0;0;0;.00nan;0;0
6221;4622;777;77;23;2;21;.913;3600000;0
6221;36245;777;0;0;0;0;.00nan;0;0
6221;202497;778;0;0;0;0;.00nan;0;0
6221;54272;778;71;33;3;30;.909;3567000;0
6222;195942;783;0;0;0;0;.00nan;0;0
6222;-1;784;0;0;0;0;.00nan;0;0
6222;-1;784;96;47;3;44;.936;3600000;0
6222;146184;783;38;32;6;26;.813;3600000;0
6223;201174;798;76;24;1;23;.958;3600000;0
6223;-1;798;0;0;0;0;.00nan;0;0
6223;64066;2182;0;0;0;0;.00nan;0;0
6223;82273;2182;61;47;5;42;.894;3600000;0
6224;8487;776;28;22;5;17;.773;3600000;0
6224;193859;796;0;0;0;0;.00nan;0;0
6224;95405;776;0;0;0;0;.00nan;0;0
6224;149847;796;72;23;2;21;.913;3600000;0
6225;190702;3737;64;30;3;27;.900;3589000;0
6225;44203;794;52;14;2;12;.857;3600000;0
6225;192030;3737;0;0;0;0;.00nan;0;0
6225;46334;794;0;0;0;0;.00nan;0;0
6226;8107;780;68;23;2;21;.913;3600000;0
6226;202497;778;0;0;0;0;.00nan;0;0
6226;-1;780;0;0;0;0;.00nan;0;0
6226;54272;778;32;26;6;20;.769;3600000;0
6227;195942;783;0;0;0;0;.00nan;0;0
6227;44203;794;80;39;2;37;.949;3600000;0
6227;46334;794;0;0;0;0;.00nan;0;0
6227;146184;783;59;16;1;15;.938;3600000;0
6228;193859;796;0;0;0;0;.00nan;0;0
6228;201174;798;59;30;4;26;.867;3600000;0
6228;-1;798;0;0;0;0;.00nan;0;0
6228;149847;796;23;24;6;18;.750;3541000;0
6229;8487;776;70;21;1;20;.952;3600000;0
6229;64066;2182;0;0;0;0;.00nan;0;0
6229;82273;2182;53;30;4;26;.867;3600000;0
6229;95405;776;0;0;0;0;.00nan;0;0
6230;190702;3737;0;0;0;0;.00nan;0;0
6230;-1;784;64;29;2;27;.931;3748000;0
6230;192030;3737;92;53;3;50;.943;3748000;0
6230;-1;784;0;0;0;0;.00nan;0;0
6231;4622;777;52;17;2;15;.882;3600000;0
6231;183377;904;66;41;5;36;.878;3600000;0
6231;36245;777;0;0;0;0;.00nan;0;0
6231;-1;904;0;0;0;0;.00nan;0;0
6232;183377;904;0;0;0;0;.00nan;0;0
6232;202497;778;0;0;0;0;.00nan;0;0
6232;-1;904;47;34;5;29;.853;3600000;0
6232;54272;778;100;24;0;24;1.000;3600000;0
6233;-1;784;0;0;0;0;.00nan;0;0
6233;44203;794;54;27;4;23;.852;3600000;0
6233;46334;794;0;0;0;0;.00nan;0;0
6233;-1;784;73;21;1;20;.952;3600000;0
6234;195942;783;33;21;4;17;.810;3522000;0
6234;190702;3737;88;41;2;39;.951;3600000;0
6234;192030;3737;0;0;0;0;.00nan;0;0
6234;146184;783;0;0;0;0;.00nan;0;0
6235;193859;796;0;0;0;0;.00nan;0;0
6235;64066;2182;52;2;0;2;1.000;400000;0
6235;82273;2182;52;37;6;31;.838;3200000;0
6235;149847;796;70;25;2;23;.920;3600000;0
6236;4622;777;76;39;3;36;.923;3549000;0
6236;8107;780;66;22;2;20;.909;3600000;0
6236;36245;777;0;0;0;0;.00nan;0;0
6236;-1;780;0;0;0;0;.00nan;0;0
6237;8487;776;55;31;4;27;.871;3600000;0
6237;201174;798;70;30;3;27;.900;3600000;0
6237;-1;798;0;0;0;0;.00nan;0;0
6237;95405;776;0;0;0;0;.00nan;0;0
6238;190702;3737;41;31;5;26;.839;3600000;0
6238;-1;784;67;22;2;20;.909;3600000;0
6238;192030;3737;0;0;0;0;.00nan;0;0
6238;-1;784;0;0;0;0;.00nan;0;0
6239;8487;776;65;29;4;25;.862;3900000;0
6239;44203;794;97;54;4;50;.926;3900000;0
6239;46334;794;0;0;0;0;.00nan;0;0
6239;95405;776;0;0;0;0;.00nan;0;0
6240;202497;778;0;0;0;0;.00nan;0;0
6240;54272;778;57;17;3;14;.824;3900000;0
6240;64066;2182;0;0;0;0;.00nan;0;0
6240;82273;2182;100;55;3;52;.945;3900000;0
6241;193859;796;0;0;0;0;.00nan;0;0
6241;201174;798;77;21;1;20;.952;3600000;0
6241;-1;798;0;0;0;0;.00nan;0;0
6241;149847;796;74;35;2;33;.943;3557000;0
6242;4622;777;40;20;4;16;.800;3600000;0
6242;183377;904;0;0;0;0;.00nan;0;0
6242;36245;777;0;0;0;0;.00nan;0;0
6242;-1;904;48;52;7;45;.865;3600000;0
6243;8107;780;55;32;4;28;.875;3600000;0
6243;195942;783;0;0;0;0;.00nan;0;0
6243;-1;780;0;0;0;0;.00nan;0;0
6243;146184;783;81;26;1;25;.962;3600000;0
6244;44203;794;62;29;3;26;.897;3600000;0
6244;46334;794;0;0;0;0;.00nan;0;0
6244;64066;2182;0;0;0;0;.00nan;0;0
6244;82273;2182;93;21;0;21;1.000;3600000;0
6245;190702;3737;68;38;4;34;.895;3600000;0
6245;-1;778;0;0;0;0;.00nan;0;0
6245;192030;3737;0;0;0;0;.00nan;0;0
6245;54272;778;91;26;1;25;.962;3600000;0
6246;4622;777;76;23;1;22;.957;3600000;0
6246;193854;798;75;37;3;34;.919;3513000;0
6246;201174;798;0;0;0;0;.00nan;0;0
6246;36245;777;0;0;0;0;.00nan;0;0
6247;8107;780;92;30;1;29;.967;3600000;0
6247;192036;796;0;0;0;0;.00nan;0;0
6247;-1;780;0;0;0;0;.00nan;0;0
6247;149847;796;58;31;4;27;.871;3600000;0
6248;8487;776;0;0;0;0;.00nan;0;0
6248;195942;783;44;6;1;5;.833;742000;0
6248;95405;776;75;31;3;28;.903;3600000;0
6248;146184;783;31;36;8;28;.778;2858000;0
6249;183377;904;86;39;2;37;.949;3900000;0
6249;-1;784;0;0;0;0;.00nan;0;0
6249;-1;904;0;0;0;0;.00nan;0;0
6249;-1;784;57;21;2;19;.905;3900000;0
6250;183377;904;76;40;3;37;.925;3600000;0
6250;-1;778;0;0;0;0;.00nan;0;0
6250;-1;904;0;0;0;0;.00nan;0;0
6250;54272;778;50;26;5;21;.808;3579000;0
6251;190702;3737;87;38;3;35;.921;3600000;0
6251;44203;794;96;25;1;24;.960;3600000;0
6251;192030;3737;0;0;0;0;.00nan;0;0
6251;46334;794;0;0;0;0;.00nan;0;0
6252;195942;783;0;0;0;0;.00nan;0;0
6252;192036;796;0;0;0;0;.00nan;0;0
6252;146184;783;80;42;3;39;.929;3761000;0
6252;149847;796;46;25;4;21;.840;3761000;0
6253;193854;798;93;47;3;44;.936;3600000;0
6253;201174;798;0;0;0;0;.00nan;0;0
6253;-1;784;74;28;1;27;.964;3600000;0
6253;-1;784;0;0;0;0;.00nan;0;0
6254;4622;777;76;29;3;26;.897;3600000;0
6254;8107;780;35;28;5;23;.821;3588000;0
6254;36245;777;0;0;0;0;.00nan;0;0
6254;-1;780;0;0;0;0;.00nan;0;0
6255;8487;776;64;19;2;17;.895;3900000;0
6255;64066;2182;0;0;0;0;.00nan;0;0
6255;82273;2182;87;41;2;39;.951;3900000;0
6255;95405;776;0;0;0;0;.00nan;0;0
6256;195942;783;0;0;0;0;.00nan;0;0
6256;64066;2182;0;0;0;0;.00nan;0;0
6256;82273;2182;63;35;5;30;.857;3600000;0
6256;146184;783;99;20;0;20;1.000;3600000;0
6257;4622;777;33;33;6;27;.818;2798000;0
6257;36245;777;35;6;2;4;.667;802000;0
6257;192036;796;0;0;0;0;.00nan;0;0
6257;149847;796;55;27;3;24;.889;3600000;0
6258;193854;798;73;27;2;25;.926;3600000;0
6258;201174;798;0;0;0;0;.00nan;0;0
6258;-1;778;0;0;0;0;.00nan;0;0
6258;54272;778;46;30;5;25;.833;3600000;0
6259;8107;780;77;29;2;27;.931;3543000;0
6259;-1;784;0;0;0;0;.00nan;0;0
6259;-1;780;0;0;0;0;.00nan;0;0
6259;-1;784;99;43;1;42;.977;3600000;0
6260;8487;776;37;35;6;29;.829;3600000;0
6260;190702;3737;0;0;0;0;.00nan;0;0
6260;192030;3737;100;50;1;49;.980;3600000;0
6260;95405;776;0;0;0;0;.00nan;0;0
6261;183377;904;45;27;4;23;.852;3600000;0
6261;44203;794;51;32;5;27;.844;3549000;0
6261;-1;904;0;0;0;0;.00nan;0;0
6261;46334;794;0;0;0;0;.00nan;0;0
6262;8107;780;68;34;3;31;.912;3851000;0
6262;-1;778;0;0;0;0;.00nan;0;0
6262;-1;780;0;0;0;0;.00nan;0;0
6262;54272;778;71;22;2;20;.909;3851000;0
6263;-1;784;43;35;5;30;.857;3600000;0
6263;192036;796;42;3;1;2;.667;525000;0
6263;-1;784;0;0;0;0;.00nan;0;0
6263;149847;796;41;33;6;27;.818;3005000;0
6264;4622;777;68;17;1;16;.941;3600000;0
6264;195942;783;0;0;0;0;.00nan;0;0
6264;36245;777;0;0;0;0;.00nan;0;0
6264;146184;783;91;41;3;38;.927;3600000;0
6265;193854;798;63;22;2;20;.909;3600000;0
6265;201174;798;0;0;0;0;.00nan;0;0
6265;44203;794;45;45;7;38;.844;3600000;0
6265;46334;794;0;0;0;0;.00nan;0;0
6266;190702;3737;68;31;3;28;.903;3600000;0
6266;192030;3737;0;0;0;0;.00nan;0;0
6266;64066;2182;0;0;0;0;.00nan;0;0
6266;82273;2182;100;30;0;30;1.000;3600000;0
6267;8487;776;64;22;2;20;.909;3600000;0
6267;183377;904;52;17;2;15;.882;1554000;0
6267;-1;904;19;25;6;19;.760;2046000;0
6267;95405;776;0;0;0;0;.00nan;0;0
6268;8107;780;54;19;2;17;.895;3600000;0
6268;44203;794;84;33;3;30;.909;3582000;0
6268;-1;780;0;0;0;0;.00nan;0;0
6268;46334;794;0;0;0;0;.00nan;0;0
6269;8487;776;60;43;5;38;.884;3600000;0
6269;193854;798;0;0;0;0;.00nan;0;0
6269;201174;798;63;26;2;24;.923;3600000;0
6269;95405;776;0;0;0;0;.00nan;0;0
6270;-1;778;0;0;0;0;.00nan;0;0
6270;192036;796;0;0;0;0;.00nan;0;0
6270;54272;778;68;46;4;42;.913;3583000;0
6270;149847;796;63;20;2;18;.900;3600000;0
6271;4622;777;50;21;3;18;.857;3584000;0
6271;36245;777;0;0;0;0;.00nan;0;0
6271;-1;784;0;0;0;0;.00nan;0;0
6271;-1;784;100;41;1;40;.976;3600000;0
6272;195942;783;0;0;0;0;.00nan;0;0
6272;190702;3737;61;48;5;43;.896;3600000;0
6272;192030;3737;0;0;0;0;.00nan;0;0
6272;146184;783;61;26;3;23;.885;3600000;0
6273;183377;904;85;30;1;29;.967;3600000;0
6273;-1;904;0;0;0;0;.00nan;0;0
6273;64066;2182;0;0;0;0;.00nan;0;0
6273;82273;2182;91;41;2;39;.951;3563000;0
6274;44203;794;0;0;0;0;.00nan;0;0
6274;192036;796;0;0;0;0;.00nan;0;0
6274;46334;794;93;33;1;32;.970;3600000;0
6274;149847;796;53;21;2;19;.905;3562000;0
6275;195942;783;62;6;0;6;1.000;1534000;0
6275;-1;784;57;36;4;32;.889;3600000;0
6275;-1;784;0;0;0;0;.00nan;0;0
6275;146184;783;27;22;6;16;.727;2031000;0
6276;4622;777;85;27;1;26;.963;3600000;0
6276;36245;777;0;0;0;0;.00nan;0;0
6276;-1;778;62;39;5;34;.872;3600000;0
6276;54272;778;0;0;0;0;.00nan;0;0
6277;193854;798;80;26;1;25;.962;3600000;0
6277;201174;798;0;0;0;0;.00nan;0;0
6277;64066;2182;0;0;0;0;.00nan;0;0
6277;82273;2182;69;34;5;29;.853;3600000;0
6278;183377;904;0;0;0;0;.00nan;0;0
6278;190702;3737;0;0;0;0;.00nan;0;0
6278;192030;3737;56;42;5;37;.881;3569000;0
6278;-1;904;53;27;4;23;.852;3600000;0
6279;8107;780;58;22;3;19;.864;3600000;0
6279;8487;776;34;16;4;12;.750;1412000;0
6279;-1;780;0;0;0;0;.00nan;0;0
6279;95405;776;24;27;6;21;.778;2188000;0
6280;8107;780;70;21;1;20;.952;3600000;0
6280;-1;780;0;0;0;0;.00nan;0;0
6280;64066;2182;38;7;2;5;.714;380000;0
6280;82273;2182;38;31;6;25;.806;3220000;0
6281;-1;778;0;0;0;0;.00nan;0;0
6281;-1;784;0;0;0;0;.00nan;0;0
6281;-1;784;59;34;4;30;.882;3600000;0
6281;54272;778;78;25;1;24;.960;3600000;0
6282;193854;798;38;25;6;19;.760;3600000;0
6282;201174;798;0;0;0;0;.00nan;0;0
6282;190702;3737;91;54;3;51;.944;3600000;0
6282;192030;3737;0;0;0;0;.00nan;0;0
6283;8487;776;73;35;3;32;.914;3540000;0
6283;192036;796;92;29;1;28;.966;3600000;0
6283;95405;776;0;0;0;0;.00nan;0;0
6283;149847;796;0;0;0;0;.00nan;0;0
6284;4622;777;72;19;1;18;.947;3600000;0
6284;36245;777;0;0;0;0;.00nan;0;0
6284;44203;794;92;55;3;52;.945;3576000;0
6284;46334;794;0;0;0;0;.00nan;0;0
6285;183377;904;71;43;4;39;.907;3561000;0
6285;195942;783;0;0;0;0;.00nan;0;0
6285;-1;904;0;0;0;0;.00nan;0;0
6285;146184;783;59;20;2;18;.900;3600000;0
6286;-1;784;0;0;0;0;.00nan;0;0
6286;44203;794;94;44;2;42;.955;3600000;0
6286;46334;794;0;0;0;0;.00nan;0;0
6286;-1;784;93;30;1;29;.967;3600000;0
6287;192036;796;0;0;0;0;.00nan;0;0
6287;64066;2182;0;0;0;0;.00nan;0;0
6287;82273;2182;97;48;2;46;.958;3511000;0
6287;149847;796;91;14;0;14;1.000;3600000;0
6288;195942;783;56;21;2;19;.905;3600000;0
6288;-1;778;0;0;0;0;.00nan;0;0
6288;54272;778;69;31;3;28;.903;3550000;0
6288;146184;783;0;0;0;0;.00nan;0;0
6289;193854;798;55;42;5;37;.881;3600000;0
6289;183377;904;86;33;1;32;.970;3600000;0
6289;201174;798;0;0;0;0;.00nan;0;0
6289;-1;904;0;0;0;0;.00nan;0;0
6290;8107;780;0;0;0;0;.00nan;0;0
6290;190702;3737;88;60;4;56;.933;3554000;0
6290;192030;3737;0;0;0;0;.00nan;0;0
6290;-1;780;44;20;3;17;.850;3600000;0
6291;4622;777;82;28;2;26;.929;3600000;0
6291;8487;776;53;27;4;23;.852;3511000;0
6291;36245;777;0;0;0;0;.00nan;0;0
6291;95405;776;0;0;0;0;.00nan;0;0
6292;-1;778;0;0;0;0;.00nan;0;0
6292;44203;794;55;32;4;28;.875;3575000;0
6292;46334;794;0;0;0;0;.00nan;0;0
6292;54272;778;82;33;2;31;.939;3600000;0
6293;193854;798;61;25;3;22;.880;3600000;0
6293;201174;798;0;0;0;0;.00nan;0;0
6293;195942;783;0;0;0;0;.00nan;0;0
6293;146184;783;42;31;5;26;.839;3553000;0
6294;4622;777;85;30;3;27;.900;3900000;0
6294;36245;777;0;0;0;0;.00nan;0;0
6294;64066;2182;0;0;0;0;.00nan;0;0
6294;82273;2182;91;42;3;39;.929;3900000;0
6295;190702;3737;53;48;6;42;.875;3545000;0
6295;192030;3737;0;0;0;0;.00nan;0;0
6295;192036;796;0;0;0;0;.00nan;0;0
6295;149847;796;35;26;5;21;.808;3600000;0
6296;8487;776;80;11;0;11;1.000;3600000;0
6296;-1;784;0;0;0;0;.00nan;0;0
6296;-1;784;82;47;4;43;.915;3600000;0
6296;95405;776;0;0;0;0;.00nan;0;0
6297;8107;780;82;23;1;22;.957;3600000;0
6297;183377;904;0;0;0;0;.00nan;0;0
6297;-1;904;51;25;4;21;.840;3600000;0
6297;-1;780;0;0;0;0;.00nan;0;0
6298;-1;784;40;33;5;28;.848;3600000;0
6298;-1;784;0;0;0;0;.00nan;0;0
6298;64066;2182;43;4;1;3;.750;700000;0
6298;82273;2182;44;35;6;29;.829;2848000;0
6299;183377;904;55;29;4;25;.862;3559000;0
6299;192036;796;0;0;0;0;.00nan;0;0
6299;-1;904;0;0;0;0;.00nan;0;0
6299;149847;796;72;20;2;18;.900;3600000;0
6300;195942;783;97;21;0;21;1.000;3600000;0
6300;44203;794;20;29;7;22;.759;3600000;0
6300;46334;794;0;0;0;0;.00nan;0;0
6300;146184;783;0;0;0;0;.00nan;0;0
6301;8107;780;71;30;3;27;.900;3863000;0
6301;193854;798;0;0;0;0;.00nan;0;0
6301;201174;798;74;34;3;31;.912;3900000;0
6301;-1;780;0;0;0;0;.00nan;0;0
6302;4622;777;0;0;0;0;.00nan;0;0
6302;36245;777;94;20;0;20;1.000;3600000;0
6302;190702;3737;62;36;4;32;.889;3600000;0
6302;192030;3737;0;0;0;0;.00nan;0;0
6303;8487;776;50;19;2;17;.895;3518000;0
6303;-1;778;0;0;0;0;.00nan;0;0
6303;54272;778;100;31;0;31;1.000;3600000;0
6303;95405;776;0;0;0;0;.00nan;0;0
6304;8107;780;81;27;1;26;.963;3600000;0
6304;195942;783;68;45;4;41;.911;3600000;0
6304;-1;780;0;0;0;0;.00nan;0;0
6304;146184;783;0;0;0;0;.00nan;0;0
6305;193854;798;38;34;5;29;.853;3900000;0
6305;201174;798;0;0;0;0;.00nan;0;0
6305;192036;796;0;0;0;0;.00nan;0;0
6305;149847;796;53;35;5;30;.857;3900000;0
6306;-1;778;0;0;0;0;.00nan;0;0
6306;54272;778;77;31;2;29;.935;3600000;0
6306;64066;2182;47;33;5;28;.848;3600000;0
6306;82273;2182;0;0;0;0;.00nan;0;0
6307;190702;3737;90;32;2;30;.938;3900000;0
6307;-1;784;86;43;2;41;.953;3900000;0
6307;192030;3737;0;0;0;0;.00nan;0;0
6307;-1;784;0;0;0;0;.00nan;0;0
6308;8487;776;96;21;0;21;1.000;3600000;0
6308;44203;794;98;51;3;48;.941;3600000;0
6308;46334;794;0;0;0;0;.00nan;0;0
6308;95405;776;0;0;0;0;.00nan;0;0
6309;4622;777;0;0;0;0;.00nan;0;0
6309;183377;904;64;11;0;11;1.000;679000;0
6309;36245;777;67;14;1;13;.929;3600000;0
6309;-1;904;30;33;6;27;.818;2921000;0
6310;190702;3737;91;37;1;36;.973;3600000;0
6310;-1;778;0;0;0;0;.00nan;0;0
6310;192030;3737;0;0;0;0;.00nan;0;0
6310;54272;778;76;31;2;29;.935;3548000;0
6311;183377;904;91;52;3;49;.942;3889000;0
6311;-1;784;0;0;0;0;.00nan;0;0
6311;-1;904;0;0;0;0;.00nan;0;0
6311;-1;784;54;24;3;21;.875;3900000;0
6312;44203;794;0;0;0;0;.00nan;0;0
6312;46334;794;50;36;5;31;.861;3594000;0
6312;64066;2182;0;0;0;0;.00nan;0;0
6312;82273;2182;57;31;4;27;.871;3600000;0
6313;8487;776;62;23;3;20;.870;3600000;0
6313;195942;783;57;6;0;6;1.000;253000;0
6313;95405;776;0;0;0;0;.00nan;0;0
6313;146184;783;39;40;6;34;.850;3347000;0
6314;4622;777;70;28;3;25;.893;3778000;0
6314;193854;798;59;23;2;21;.913;3782000;0
6314;201174;798;0;0;0;0;.00nan;0;0
6314;36245;777;0;0;0;0;.00nan;0;0
6315;8107;780;93;42;2;40;.952;3816000;0
6315;192036;796;0;0;0;0;.00nan;0;0
6315;-1;780;0;0;0;0;.00nan;0;0
6315;149847;796;64;33;3;30;.909;3816000;0
6316;8487;776;72;25;2;23;.920;3700000;0
6316;64066;2182;0;0;0;0;.00nan;0;0
6316;82273;2182;92;47;3;44;.936;3700000;0
6316;95405;776;0;0;0;0;.00nan;0;0
6317;195942;783;66;29;3;26;.897;3600000;0
6317;192036;796;8;33;8;25;.758;3600000;0
6317;146184;783;0;0;0;0;.00nan;0;0
6317;149847;796;0;0;0;0;.00nan;0;0
6318;193854;798;77;30;2;28;.933;3600000;0
6318;201174;798;0;0;0;0;.00nan;0;0
6318;-1;784;49;32;4;28;.875;3516000;0
6318;-1;784;0;0;0;0;.00nan;0;0
6319;4622;777;60;29;4;25;.862;3717000;0
6319;8107;780;71;37;3;34;.919;3717000;0
6319;36245;777;0;0;0;0;.00nan;0;0
6319;-1;780;0;0;0;0;.00nan;0;0
6320;190702;3737;0;0;0;0;.00nan;0;0
6320;44203;794;67;25;3;22;.880;3600000;0
6320;192030;3737;39;39;6;33;.846;3600000;0
6320;46334;794;0;0;0;0;.00nan;0;0
6321;183377;904;94;37;1;36;.973;3900000;0
6321;-1;778;0;0;0;0;.00nan;0;0
6321;-1;904;0;0;0;0;.00nan;0;0
6321;54272;778;85;27;1;26;.963;3900000;0
6322;8107;780;93;33;1;32;.970;3600000;0
6322;-1;784;0;0;0;0;.00nan;0;0
6322;-1;780;0;0;0;0;.00nan;0;0
6322;-1;784;65;32;3;29;.906;3579000;0
6323;195942;783;39;21;4;17;.810;3600000;0
6323;64066;2182;0;0;0;0;.00nan;0;0
6323;82273;2182;96;26;0;26;1.000;3600000;0
6323;146184;783;0;0;0;0;.00nan;0;0
6324;193854;798;0;0;0;0;.00nan;0;0
6324;201174;798;60;31;4;27;.871;3600000;0
6324;-1;778;0;0;0;0;.00nan;0;0
6324;54272;778;90;33;1;32;.970;3600000;0
6325;4622;777;85;29;2;27;.931;3600000;0
6325;36245;777;0;0;0;0;.00nan;0;0
6325;192036;796;0;0;0;0;.00nan;0;0
6325;149847;796;59;33;4;29;.879;3600000;0
6326;8487;776;98;26;0;26;1.000;3600000;0
6326;190702;3737;67;46;6;40;.870;3600000;0
6326;192030;3737;0;0;0;0;.00nan;0;0
6326;95405;776;0;0;0;0;.00nan;0;0
6327;183377;904;22;24;6;18;.750;2536000;0
6327;44203;794;63;34;4;30;.882;3600000;0
6327;-1;904;58;5;0;5;1.000;1038000;0
6327;46334;794;0;0;0;0;.00nan;0;0
6328;8107;780;51;29;4;25;.862;3543000;0
6328;-1;778;0;0;0;0;.00nan;0;0
6328;-1;780;0;0;0;0;.00nan;0;0
6328;54272;778;59;28;3;25;.893;3600000;0
6329;-1;784;88;35;2;33;.943;3600000;0
6329;192036;796;0;0;0;0;.00nan;0;0
6329;-1;784;0;0;0;0;.00nan;0;0
6329;149847;796;40;29;5;24;.828;3600000;0
6330;193854;798;100;30;0;30;1.000;3600000;0
6330;201174;798;0;0;0;0;.00nan;0;0
6330;44203;794;45;46;7;39;.848;3600000;0
6330;46334;794;0;0;0;0;.00nan;0;0
6331;4622;777;83;28;1;27;.964;3600000;0
6331;195942;783;0;0;0;0;.00nan;0;0
6331;36245;777;0;0;0;0;.00nan;0;0
6331;146184;783;76;44;3;41;.932;3600000;0
6332;190702;3737;50;28;4;24;.857;3511000;0
6332;192030;3737;0;0;0;0;.00nan;0;0
6332;64066;2182;0;0;0;0;.00nan;0;0
6332;82273;2182;92;39;2;37;.949;3600000;0
6333;8487;776;58;15;2;13;.867;3600000;0
6333;183377;904;54;38;5;33;.868;3600000;0
6333;-1;904;0;0;0;0;.00nan;0;0
6333;95405;776;0;0;0;0;.00nan;0;0
6334;8107;780;65;23;2;21;.913;3600000;0
6334;44203;794;40;34;6;28;.824;2796000;0
6334;-1;780;0;0;0;0;.00nan;0;0
6334;46334;794;49;10;1;9;.900;804000;0
6335;183377;904;0;0;0;0;.00nan;0;0
6335;-1;904;100;30;0;30;1.000;3600000;0
6335;64066;2182;0;0;0;0;.00nan;0;0
6335;82273;2182;47;26;4;22;.846;3600000;0
6336;195942;783;0;0;0;0;.00nan;0;0
6336;190702;3737;68;46;5;41;.891;3600000;0
6336;192030;3737;0;0;0;0;.00nan;0;0
6336;146184;783;69;16;1;15;.938;3600000;0
6337;-1;778;0;0;0;0;.00nan;0;0
6337;192036;796;0;0;0;0;.00nan;0;0
6337;54272;778;55;41;5;36;.878;3512000;0
6337;149847;796;72;35;3;32;.914;3600000;0
6338;8487;776;64;27;2;25;.926;3600000;0
6338;193854;798;77;35;3;32;.914;3585000;0
6338;201174;798;0;0;0;0;.00nan;0;0
6338;95405;776;0;0;0;0;.00nan;0;0
6339;4622;777;44;23;4;19;.826;3536000;0
6339;36245;777;0;0;0;0;.00nan;0;0
6339;-1;784;0;0;0;0;.00nan;0;0
6339;-1;784;85;38;2;36;.947;3600000;0
6340;193854;798;100;20;0;20;1.000;3600000;0
6340;201174;798;0;0;0;0;.00nan;0;0
6340;64066;2182;0;0;0;0;.00nan;0;0
6340;82273;2182;84;50;4;46;.920;3600000;0
6341;195942;783;70;26;1;25;.962;3600000;0
6341;-1;784;66;36;3;33;.917;3530000;0
6341;-1;784;0;0;0;0;.00nan;0;0
6341;146184;783;0;0;0;0;.00nan;0;0
6342;8107;780;67;32;3;29;.906;3600000;0
6342;8487;776;65;33;4;29;.879;3600000;0
6342;-1;780;0;0;0;0;.00nan;0;0
6342;95405;776;0;0;0;0;.00nan;0;0
6343;44203;794;36;11;3;8;.727;583000;0
6343;192036;796;52;18;3;15;.833;3900000;0
6343;46334;794;100;34;0;34;1.000;3317000;0
6343;149847;796;0;0;0;0;.00nan;0;0
6344;4622;777;84;25;1;24;.960;3900000;0
6344;36245;777;0;0;0;0;.00nan;0;0
6344;-1;778;0;0;0;0;.00nan;0;0
6344;54272;778;98;41;1;40;.976;3900000;0
6345;183377;904;0;0;0;0;.00nan;0;0
6345;190702;3737;69;39;4;35;.897;3573000;0
6345;192030;3737;0;0;0;0;.00nan;0;0
6345;-1;904;69;32;3;29;.906;3600000;0
6346;-1;778;0;0;0;0;.00nan;0;0
6346;-1;784;0;0;0;0;.00nan;0;0
6346;-1;784;63;34;4;30;.882;3900000;0
6346;54272;778;76;41;4;37;.902;3900000;0
6347;193854;798;44;20;4;16;.800;3600000;0
6347;201174;798;0;0;0;0;.00nan;0;0
6347;190702;3737;43;34;5;29;.853;3600000;0
6347;192030;3737;0;0;0;0;.00nan;0;0
6348;4622;777;66;27;3;24;.889;3600000;0
6348;36245;777;0;0;0;0;.00nan;0;0
6348;44203;794;50;48;7;41;.854;3600000;0
6348;46334;794;0;0;0;0;.00nan;0;0
6349;8107;780;71;18;1;17;.944;3600000;0
6349;-1;780;0;0;0;0;.00nan;0;0
6349;64066;2182;0;0;0;0;.00nan;0;0
6349;82273;2182;70;33;3;30;.909;3555000;0
6350;8487;776;58;29;3;26;.897;3572000;0
6350;192036;796;0;0;0;0;.00nan;0;0
6350;95405;776;0;0;0;0;.00nan;0;0
6350;149847;796;88;36;2;34;.944;3600000;0
6351;183377;904;29;7;3;4;.571;440000;0
6351;195942;783;0;0;0;0;.00nan;0;0
6351;-1;904;100;30;0;30;1.000;3160000;0
6351;146184;783;46;23;4;19;.826;3577000;0
6355;193854;798;0;0;0;0;.00nan;0;0
6355;201174;798;58;41;6;35;.854;3593000;0
6355;64066;2182;0;0;0;0;.00nan;0;0
6355;82273;2182;38;29;5;24;.828;3600000;0
6357;8107;780;46;27;4;23;.852;3600000;0
6357;195942;783;50;1;0;1;1.000;313000;0
6357;-1;780;0;0;0;0;.00nan;0;0
6357;146184;783;27;26;6;20;.769;3245000;0
6359;190702;3737;57;44;6;38;.864;3600000;0
6359;-1;784;57;20;2;18;.900;3600000;0
6359;192030;3737;0;0;0;0;.00nan;0;0
6359;-1;784;0;0;0;0;.00nan;0;0
6361;8487;776;60;25;2;23;.920;3600000;0
6361;-1;778;0;0;0;0;.00nan;0;0
6361;54272;778;48;36;5;31;.861;3600000;0
6361;95405;776;0;0;0;0;.00nan;0;0
6363;36245;777;72;23;1;22;.957;3600000;0
6363;44203;794;67;44;5;39;.886;3600000;0
6363;46334;794;0;0;0;0;.00nan;0;0
6363;66924;777;0;0;0;0;.00nan;0;0
6365;195942;783;0;0;0;0;.00nan;0;0
6365;64066;2182;0;0;0;0;.00nan;0;0
6365;82273;2182;97;49;2;47;.959;3900000;0
6365;146184;783;63;21;2;19;.905;3900000;0
6367;193854;798;76;23;1;22;.957;3600000;0
6367;201174;798;0;0;0;0;.00nan;0;0
6367;44203;794;77;43;4;39;.907;3600000;0
6367;46334;794;0;0;0;0;.00nan;0;0
6371;8107;780;98;46;2;44;.957;3573000;0
6371;8487;776;100;28;0;28;1.000;3600000;0
6371;-1;780;0;0;0;0;.00nan;0;0
6371;95405;776;0;0;0;0;.00nan;0;0
6373;-1;778;0;0;0;0;.00nan;0;0
6373;-1;784;0;0;0;0;.00nan;0;0
6373;-1;784;75;27;2;25;.926;3600000;0
6373;54272;778;31;33;6;27;.818;3600000;0
6375;183377;904;0;0;0;0;.00nan;0;0
6375;36245;777;54;20;3;17;.850;3600000;0
6375;-1;904;65;42;4;38;.905;3572000;0
6375;66924;777;0;0;0;0;.00nan;0;0
6377;8487;776;35;31;6;25;.806;3600000;0
6377;195942;783;66;25;2;23;.920;3600000;0
6377;95405;776;0;0;0;0;.00nan;0;0
6377;146184;783;0;0;0;0;.00nan;0;0
6379;8107;780;0;0;0;0;.00nan;0;0
6379;-1;778;73;43;5;38;.884;3600000;0
6379;-1;780;76;19;1;18;.947;3600000;0
6379;54272;778;0;0;0;0;.00nan;0;0
6381;183377;904;63;23;2;21;.913;3869000;0
6381;44203;794;0;0;0;0;.00nan;0;0
6381;-1;904;0;0;0;0;.00nan;0;0
6381;46334;794;70;33;3;30;.909;3869000;0
6385;193854;798;0;0;0;0;.00nan;0;0
6385;201174;798;51;22;3;19;.864;3600000;0
6385;64066;2182;82;16;0;16;1.000;3600000;0
6385;82273;2182;0;0;0;0;.00nan;0;0
6387;190702;3737;0;0;0;0;.00nan;0;0
6387;-1;784;79;38;3;35;.921;3659000;0
6387;192030;3737;43;24;4;20;.833;3659000;0
6387;-1;784;0;0;0;0;.00nan;0;0
6389;-1;778;0;0;0;0;.00nan;0;0
6389;44203;794;90;32;1;31;.969;3600000;0
6389;46334;794;0;0;0;0;.00nan;0;0
6389;54272;778;74;35;3;32;.914;3579000;0
6391;8107;780;68;15;1;14;.933;3600000;0
6391;-1;784;78;33;2;31;.939;3600000;0
6391;-1;780;0;0;0;0;.00nan;0;0
6391;-1;784;0;0;0;0;.00nan;0;0
6395;36245;777;65;33;3;30;.909;3535000;0
6395;190702;3737;94;37;1;36;.973;3600000;0
6395;192030;3737;0;0;0;0;.00nan;0;0
6395;66924;777;0;0;0;0;.00nan;0;0
6397;8487;776;53;2;0;2;1.000;411000;0
6397;195942;783;0;0;0;0;.00nan;0;0
6397;95405;776;47;41;6;35;.854;3189000;0
6397;146184;783;65;29;3;26;.897;3600000;0
6399;183377;904;48;22;3;19;.864;3549000;0
6399;-1;904;0;0;0;0;.00nan;0;0
6399;64066;2182;87;32;2;30;.938;3600000;0
6399;82273;2182;0;0;0;0;.00nan;0;0
6401;-1;778;60;17;2;15;.882;3600000;0
6401;44203;794;0;0;0;0;.00nan;0;0
6401;46334;794;93;52;4;48;.923;3568000;0
6401;54272;778;0;0;0;0;.00nan;0;0
6403;8487;776;86;33;2;31;.939;3551000;0
6403;-1;784;0;0;0;0;.00nan;0;0
6403;-1;784;95;36;1;35;.972;3600000;0
6403;95405;776;0;0;0;0;.00nan;0;0
6405;190702;3737;0;0;0;0;.00nan;0;0
6405;192030;3737;23;18;5;13;.722;3516000;0
6405;64066;2182;0;0;0;0;.00nan;0;0
6405;82273;2182;60;31;3;28;.903;3600000;0
6407;183377;904;0;0;0;0;.00nan;0;0
6407;36245;777;0;0;0;0;.00nan;0;0
6407;-1;904;97;52;3;49;.942;3600000;0
6407;66924;777;79;16;0;16;1.000;3600000;0
6411;8107;780;0;0;0;0;.00nan;0;0
6411;193854;798;92;39;3;36;.923;3600000;0
6411;201174;798;0;0;0;0;.00nan;0;0
6411;-1;780;82;34;2;32;.941;3600000;0
6413;44203;794;59;26;3;23;.885;3900000;0
6413;46334;794;0;0;0;0;.00nan;0;0
6413;64066;2182;0;0;0;0;.00nan;0;0
6413;82273;2182;84;39;3;36;.923;3900000;0
6415;183377;904;0;0;0;0;.00nan;0;0
6415;-1;778;0;0;0;0;.00nan;0;0
6415;-1;904;100;35;1;34;.971;3660000;0
6415;54272;778;75;28;2;26;.929;3660000;0
6419;8487;776;63;42;5;37;.881;3600000;0
6419;36245;777;0;0;0;0;.00nan;0;0
6419;66924;777;76;25;2;23;.920;3600000;0
6419;95405;776;0;0;0;0;.00nan;0;0
6421;8107;780;81;32;2;30;.938;3555000;0
6421;193854;798;0;0;0;0;.00nan;0;0
6421;201174;798;87;29;1;28;.966;3600000;0
6421;-1;780;0;0;0;0;.00nan;0;0
6423;195942;783;62;23;3;20;.870;3729000;0
6423;190702;3737;82;42;4;38;.905;3729000;0
6423;192030;3737;0;0;0;0;.00nan;0;0
6423;146184;783;0;0;0;0;.00nan;0;0
6425;8107;780;0;0;0;0;.00nan;0;0
6425;193854;798;54;22;3;19;.864;3562000;0
6425;201174;798;0;0;0;0;.00nan;0;0
6425;-1;780;53;17;2;15;.882;3600000;0
6427;195942;783;0;0;0;0;.00nan;0;0
6427;36245;777;70;21;1;20;.952;3600000;0
6427;66924;777;0;0;0;0;.00nan;0;0
6427;146184;783;87;32;2;30;.938;3574000;0
6429;8487;776;0;0;0;0;.00nan;0;0
6429;-1;784;0;0;0;0;.00nan;0;0
6429;-1;784;100;33;0;33;1.000;3600000;0
6429;95405;776;41;30;5;25;.833;3600000;0
6431;-1;778;69;25;2;23;.920;3600000;0
6431;44203;794;0;0;0;0;.00nan;0;0
6431;46334;794;75;40;3;37;.925;3582000;0
6431;54272;778;0;0;0;0;.00nan;0;0
6433;190702;3737;0;0;0;0;.00nan;0;0
6433;192030;3737;48;24;3;21;.875;3600000;0
6433;64066;2182;34;28;5;23;.821;3600000;0
6433;82273;2182;0;0;0;0;.00nan;0;0
108;195942;783;0;0;0;0;.00nan;0;0
108;64066;2182;0;0;0;0;.00nan;0;0
108;82273;2182;58;33;4;29;.879;3545000;0
108;146184;783;68;25;3;22;.880;3600000;0
109;-1;778;0;0;0;0;.00nan;0;0
109;44203;794;47;30;5;25;.833;3600000;0
109;46334;794;0;0;0;0;.00nan;0;0
109;54272;778;94;28;1;27;.964;3600000;0
110;195942;783;0;0;0;0;.00nan;0;0
110;64066;2182;0;0;0;0;.00nan;0;0
110;82273;2182;74;25;2;23;.920;3600000;0
110;146184;783;63;28;4;24;.857;3529000;0
111;-1;778;0;0;0;0;.00nan;0;0
111;44203;794;92;41;1;40;.976;3600000;0
111;46334;794;0;0;0;0;.00nan;0;0
111;54272;778;65;29;3;26;.897;3514000;0
204;195942;783;0;0;0;0;.00nan;0;0
204;64066;2182;0;0;0;0;.00nan;0;0
204;82273;2182;73;32;2;30;.938;3513000;0
204;146184;783;100;21;0;21;1.000;3600000;0
205;-1;778;0;0;0;0;.00nan;0;0
205;44203;794;60;46;6;40;.870;3600000;0
205;46334;794;0;0;0;0;.00nan;0;0
205;54272;778;69;26;2;24;.923;3600000;0
294;4622;777;72;29;3;26;.897;3946000;0
294;36245;777;0;0;0;0;.00nan;0;0
294;-1;778;0;0;0;0;.00nan;0;0
294;54272;778;83;27;2;25;.926;3946000;0
295;193854;798;55;19;2;17;.895;3600000;0
295;201174;798;0;0;0;0;.00nan;0;0
295;-1;784;21;25;6;19;.760;1796000;0
295;-1;784;44;16;2;14;.875;1804000;0
296;8487;776;68;32;3;29;.906;3600000;0
296;192036;796;0;0;0;0;.00nan;0;0
296;95405;776;0;0;0;0;.00nan;0;0
296;149847;796;28;22;5;17;.773;3563000;0
297;8107;780;45;17;3;14;.824;3785000;0
297;195942;783;0;0;0;0;.00nan;0;0
297;-1;780;0;0;0;0;.00nan;0;0
297;146184;783;92;45;2;43;.956;3785000;0
298;4622;777;72;18;1;17;.944;3600000;0
298;36245;777;0;0;0;0;.00nan;0;0
298;-1;778;0;0;0;0;.00nan;0;0
298;54272;778;60;37;4;33;.892;3600000;0
299;193854;798;73;34;3;31;.912;3600000;0
299;201174;798;0;0;0;0;.00nan;0;0
299;-1;784;0;0;0;0;.00nan;0;0
299;-1;784;75;30;2;28;.933;3600000;0
300;8487;776;94;40;2;38;.950;3725000;0
300;192036;796;0;0;0;0;.00nan;0;0
300;95405;776;0;0;0;0;.00nan;0;0
300;149847;796;86;28;1;27;.964;3725000;0
301;8107;780;51;26;4;22;.846;3804000;0
301;195942;783;0;0;0;0;.00nan;0;0
301;-1;780;0;0;0;0;.00nan;0;0
301;146184;783;72;36;3;33;.917;3804000;0
302;4622;777;68;37;4;33;.892;3552000;0
302;36245;777;0;0;0;0;.00nan;0;0
302;-1;778;0;0;0;0;.00nan;0;0
302;54272;778;95;35;2;33;.943;3600000;0
303;193854;798;77;30;2;28;.933;3600000;0
303;201174;798;0;0;0;0;.00nan;0;0
303;-1;784;0;0;0;0;.00nan;0;0
303;-1;784;71;34;3;31;.912;3566000;0
304;8487;776;57;42;5;37;.881;3600000;0
304;192036;796;0;0;0;0;.00nan;0;0
304;95405;776;0;0;0;0;.00nan;0;0
304;149847;796;82;25;2;23;.920;3600000;0
305;8107;780;57;25;3;22;.880;3551000;0
305;195942;783;0;0;0;0;.00nan;0;0
305;-1;780;0;0;0;0;.00nan;0;0
305;146184;783;99;39;1;38;.974;3600000;0
306;4622;777;81;34;3;31;.912;3544000;0
306;36245;777;0;0;0;0;.00nan;0;0
306;-1;778;0;0;0;0;.00nan;0;0
306;54272;778;64;21;2;19;.905;3600000;0
307;193854;798;45;28;4;24;.857;3600000;0
307;201174;798;0;0;0;0;.00nan;0;0
307;-1;784;0;0;0;0;.00nan;0;0
307;-1;784;100;29;0;29;1.000;3600000;0
308;8487;776;59;32;4;28;.875;3576000;0
308;192036;796;0;0;0;0;.00nan;0;0
308;95405;776;0;0;0;0;.00nan;0;0
308;149847;796;64;32;2;30;.938;3600000;0
309;8107;780;94;41;3;38;.927;3600000;0
309;195942;783;0;0;0;0;.00nan;0;0
309;-1;780;0;0;0;0;.00nan;0;0
309;146184;783;40;32;5;27;.844;3564000;0
630;4622;777;47;30;5;25;.833;3818000;0
630;36245;777;0;0;0;0;.00nan;0;0
630;-1;778;0;0;0;0;.00nan;0;0
630;54272;778;42;32;6;26;.813;3818000;0
631;193854;798;91;28;1;27;.964;3600000;0
631;201174;798;0;0;0;0;.00nan;0;0
631;-1;784;0;0;0;0;.00nan;0;0
631;-1;784;53;20;2;18;.900;3561000;0
632;8487;776;84;29;1;28;.966;3600000;0
632;192036;796;0;0;0;0;.00nan;0;0
632;95405;776;0;0;0;0;.00nan;0;0
632;149847;796;60;33;4;29;.879;3600000;0
633;8107;780;71;22;1;21;.955;3600000;0
633;195942;783;0;0;0;0;.00nan;0;0
633;-1;780;0;0;0;0;.00nan;0;0
633;146184;783;69;39;4;35;.897;3600000;0
674;4622;777;56;22;2;20;.909;3515000;0
674;36245;777;0;0;0;0;.00nan;0;0
674;-1;778;0;0;0;0;.00nan;0;0
674;54272;778;100;34;0;34;1.000;3600000;0
675;193854;798;86;16;0;16;1.000;3600000;0
675;201174;798;0;0;0;0;.00nan;0;0
675;-1;784;0;0;0;0;.00nan;0;0
675;-1;784;73;52;5;47;.904;3600000;0
676;8487;776;70;29;2;27;.931;4200000;0
676;192036;796;0;0;0;0;.00nan;0;0
676;95405;776;0;0;0;0;.00nan;0;0
676;149847;796;76;35;2;33;.943;4200000;0
677;8107;780;35;21;5;16;.762;3600000;0
677;195942;783;0;0;0;0;.00nan;0;0
677;-1;780;0;0;0;0;.00nan;0;0
677;146184;783;67;21;1;20;.952;3600000;0
702;8487;776;77;30;2;28;.933;3600000;0
702;192036;796;0;0;0;0;.00nan;0;0
702;95405;776;0;0;0;0;.00nan;0;0
702;149847;796;71;33;3;30;.909;3600000;0
741;8487;776;75;31;3;28;.903;3530000;0
741;-1;778;0;0;0;0;.00nan;0;0
741;54272;778;96;37;1;36;.973;3600000;0
741;95405;776;0;0;0;0;.00nan;0;0
742;193854;798;83;25;1;24;.960;3600000;0
742;201174;798;0;0;0;0;.00nan;0;0
742;195942;783;0;0;0;0;.00nan;0;0
742;146184;783;68;37;3;34;.919;3535000;0
743;8487;776;76;25;1;24;.960;3600000;0
743;-1;778;0;0;0;0;.00nan;0;0
743;54272;778;84;47;4;43;.915;3600000;0
743;95405;776;0;0;0;0;.00nan;0;0
744;193854;798;84;15;0;15;1.000;3600000;0
744;201174;798;0;0;0;0;.00nan;0;0
744;195942;783;36;19;4;15;.789;1414000;0
744;146184;783;34;27;6;21;.778;2186000;0
745;8487;776;93;34;2;32;.941;4200000;0
745;-1;778;0;0;0;0;.00nan;0;0
745;54272;778;91;35;2;33;.943;4200000;0
745;95405;776;0;0;0;0;.00nan;0;0
746;193854;798;66;38;4;34;.895;3600000;0
746;201174;798;0;0;0;0;.00nan;0;0
746;195942;783;74;24;1;23;.958;3600000;0
746;146184;783;0;0;0;0;.00nan;0;0
747;8487;776;51;36;4;32;.889;3600000;0
747;-1;778;0;0;0;0;.00nan;0;0
747;54272;778;85;27;1;26;.963;3600000;0
747;95405;776;0;0;0;0;.00nan;0;0
748;193854;798;69;27;2;25;.926;3600000;0
748;201174;798;0;0;0;0;.00nan;0;0
748;195942;783;75;38;3;35;.921;3583000;0
748;146184;783;0;0;0;0;.00nan;0;0
992;8487;776;100;30;0;30;1.000;3600000;0
992;-1;778;0;0;0;0;.00nan;0;0
992;54272;778;66;27;2;25;.926;3600000;0
992;95405;776;0;0;0;0;.00nan;0;0
993;193854;798;97;19;0;19;1.000;3600000;0
993;201174;798;0;0;0;0;.00nan;0;0
993;195942;783;37;34;5;29;.853;3600000;0
993;146184;783;0;0;0;0;.00nan;0;0
1040;8487;776;64;24;3;21;.875;3600000;0
1040;-1;778;0;0;0;0;.00nan;0;0
1040;54272;778;100;35;0;35;1.000;3600000;0
1040;95405;776;0;0;0;0;.00nan;0;0
1054;8487;776;100;26;0;26;1.000;3600000;0
1054;-1;778;0;0;0;0;.00nan;0;0
1054;54272;778;51;30;5;25;.833;3600000;0
1054;95405;776;0;0;0;0;.00nan;0;0
1085;8487;776;67;32;3;29;.906;3592000;0
1085;193854;798;76;25;1;24;.960;3600000;0
1085;201174;798;0;0;0;0;.00nan;0;0
1085;95405;776;0;0;0;0;.00nan;0;0
1086;8487;776;93;37;1;36;.973;3600000;0
1086;193854;798;59;32;5;27;.844;3600000;0
1086;201174;798;0;0;0;0;.00nan;0;0
1086;95405;776;0;0;0;0;.00nan;0;0
1087;8487;776;100;30;0;30;1.000;3600000;0
1087;193854;798;54;18;2;16;.889;3513000;0
1087;201174;798;0;0;0;0;.00nan;0;0
1087;95405;776;0;0;0;0;.00nan;0;0
1088;8487;776;100;40;1;39;.975;3600000;0
1088;193854;798;59;26;3;23;.885;3532000;0
1088;201174;798;0;0;0;0;.00nan;0;0
1088;95405;776;0;0;0;0;.00nan;0;0
1285;8487;776;45;18;3;15;.833;3554000;0
1285;193854;798;69;23;2;21;.913;3600000;0
1285;201174;798;0;0;0;0;.00nan;0;0
1285;95405;776;0;0;0;0;.00nan;0;0
1342;8487;776;76;44;4;40;.909;4011000;0
1342;193854;798;50;28;3;25;.893;4011000;0
1342;201174;798;0;0;0;0;.00nan;0;0
1342;95405;776;0;0;0;0;.00nan;0;0
6436;10112;1423;74;57;6;51;.895;3600000;0
6436;27517;1423;0;0;0;0;.00nan;0;0
6436;86422;552;0;0;0;0;.00nan;0;0
6436;88692;552;100;22;0;22;1.000;3600000;0
6437;180738;555;0;0;0;0;.00nan;0;0
6437;36115;555;100;68;3;65;.956;3600000;0
6437;86422;552;22;14;5;9;.643;3562000;0
6437;88692;552;0;0;0;0;.00nan;0;0
6438;178789;554;78;25;1;24;.960;3600000;0
6438;-1;554;0;0;0;0;.00nan;0;0
6438;28989;2626;68;38;3;35;.921;3520000;0
6438;45584;2626;0;0;0;0;.00nan;0;0
6439;2691;560;0;0;0;0;.00nan;0;0
6439;54860;560;75;34;3;31;.912;3600000;0
6439;80596;556;0;0;0;0;.00nan;0;0
6439;85349;556;77;16;0;16;1.000;3600000;0
6440;28989;2626;84;35;2;33;.943;3600000;0
6440;45584;2626;0;0;0;0;.00nan;0;0
6440;70573;553;0;0;0;0;.00nan;0;0
6440;144705;553;41;26;4;22;.846;3600000;0
6441;10112;1423;60;48;7;41;.854;3600000;0
6441;169325;558;0;0;0;0;.00nan;0;0
6441;27517;1423;0;0;0;0;.00nan;0;0
6441;86686;558;57;16;1;15;.938;3600000;0
6442;28989;2626;67;46;5;41;.891;3599000;0
6442;45584;2626;0;0;0;0;.00nan;0;0
6442;70573;553;0;0;0;0;.00nan;0;0
6442;144705;553;37;21;4;17;.810;3600000;0
6443;178789;554;35;13;3;10;.769;3545000;0
6443;-1;554;0;0;0;0;.00nan;0;0
6443;180738;555;91;46;2;44;.957;3600000;0
6443;36115;555;0;0;0;0;.00nan;0;0
6444;2691;560;0;0;0;0;.00nan;0;0
6444;54860;560;80;62;5;57;.919;3600000;0
6444;86422;552;72;6;0;6;1.000;3600000;0
6444;88692;552;0;0;0;0;.00nan;0;0
6445;28989;2626;71;25;2;23;.920;3600000;0
6445;180738;555;86;45;3;42;.933;3578000;0
6445;36115;555;0;0;0;0;.00nan;0;0
6445;45584;2626;0;0;0;0;.00nan;0;0
6446;10112;1423;97;47;2;45;.957;3600000;0
6446;27517;1423;0;0;0;0;.00nan;0;0
6446;80596;556;0;0;0;0;.00nan;0;0
6446;85349;556;68;17;1;16;.941;3600000;0
6447;180738;555;44;39;6;33;.846;3600000;0
6447;36115;555;0;0;0;0;.00nan;0;0
6447;46468;561;57;24;3;21;.875;3600000;0
6447;65324;561;0;0;0;0;.00nan;0;0
6448;2691;560;0;0;0;0;.00nan;0;0
6448;178789;554;58;28;3;25;.893;3557000;0
6448;-1;554;0;0;0;0;.00nan;0;0
6448;54860;560;99;39;2;37;.949;3600000;0
6449;181071;560;39;1;1;0;.000;419000;0
6449;46468;561;61;27;3;24;.889;3600000;0
6449;54860;560;51;34;4;30;.882;3157000;0
6449;65324;561;0;0;0;0;.00nan;0;0
6450;10112;1423;0;0;0;0;.00nan;0;0
6450;27517;1423;95;69;4;65;.942;3900000;0
6450;86422;552;35;19;4;15;.789;3900000;0
6450;88692;552;0;0;0;0;.00nan;0;0
6451;169325;558;67;28;3;25;.893;3900000;0
6451;46468;561;0;0;0;0;.00nan;0;0
6451;65324;561;66;30;3;27;.900;3852000;0
6451;86686;558;0;0;0;0;.00nan;0;0
6452;178789;554;100;26;0;26;1.000;3600000;0
6452;-1;554;0;0;0;0;.00nan;0;0
6452;70573;553;0;0;0;0;.00nan;0;0
6452;144705;553;56;38;5;33;.868;3600000;0
6453;178789;554;0;0;0;0;.00nan;0;0
6453;-1;554;72;11;0;11;1.000;3600000;0
6453;80596;556;83;57;5;52;.912;3600000;0
6453;85349;556;0;0;0;0;.00nan;0;0
6454;70573;553;90;43;3;40;.930;3600000;0
6454;86422;552;0;0;0;0;.00nan;0;0
6454;88692;552;34;21;4;17;.810;3563000;0
6454;144705;553;0;0;0;0;.00nan;0;0
6455;181071;560;0;0;0;0;.00nan;0;0
6455;54860;560;62;45;5;40;.889;3600000;0
6455;70573;553;51;14;2;12;.857;3600000;0
6455;144705;553;0;0;0;0;.00nan;0;0
6456;80596;556;74;36;3;33;.917;3120000;0
6456;85349;556;22;12;4;8;.667;480000;0
6456;86422;552;46;17;3;14;.824;3600000;0
6456;88692;552;0;0;0;0;.00nan;0;0
6457;28989;2626;57;23;2;21;.913;3600000;0
6457;181071;560;53;5;0;5;1.000;727000;0
6457;45584;2626;0;0;0;0;.00nan;0;0
6457;54860;560;58;48;6;42;.875;2873000;0
6458;10112;1423;0;0;0;0;.00nan;0;0
6458;27517;1423;60;44;5;39;.886;3600000;0
6458;46468;561;95;22;0;22;1.000;3600000;0
6458;65324;561;0;0;0;0;.00nan;0;0
6459;169325;558;0;0;0;0;.00nan;0;0
6459;180738;555;75;34;3;31;.912;3600000;0
6459;36115;555;0;0;0;0;.00nan;0;0
6459;86686;558;97;18;0;18;1.000;3600000;0
6460;178789;554;65;18;1;17;.944;3600000;0
6460;-1;554;0;0;0;0;.00nan;0;0
6460;70573;553;53;3;0;3;1.000;969000;0
6460;144705;553;42;47;8;39;.830;2631000;0
6461;28989;2626;77;30;2;28;.933;3600000;0
6461;181071;560;0;0;0;0;.00nan;0;0
6461;45584;2626;0;0;0;0;.00nan;0;0
6461;54860;560;71;40;4;36;.900;3534000;0
6462;169325;558;64;19;2;17;.895;1646000;0
6462;86422;552;76;26;2;24;.923;3600000;0
6462;86686;558;41;28;5;23;.821;1954000;0
6462;88692;552;0;0;0;0;.00nan;0;0
6463;169325;558;0;0;0;0;.00nan;0;0
6463;178789;554;56;14;1;13;.929;3600000;0
6463;-1;554;0;0;0;0;.00nan;0;0
6463;86686;558;64;45;5;40;.889;3600000;0
6464;169325;558;0;0;0;0;.00nan;0;0
6464;28989;2626;0;0;0;0;.00nan;0;0
6464;45584;2626;53;27;3;24;.889;3600000;0
6464;86686;558;100;34;0;34;1.000;3600000;0
6465;46468;561;0;0;0;0;.00nan;0;0
6465;65324;561;70;29;2;27;.931;3568000;0
6465;70573;553;81;29;1;28;.966;3600000;0
6465;144705;553;0;0;0;0;.00nan;0;0
6466;180738;555;79;32;3;29;.906;3877000;0
6466;36115;555;0;0;0;0;.00nan;0;0
6466;80596;556;67;25;2;23;.920;3877000;0
6466;85349;556;0;0;0;0;.00nan;0;0
6467;46468;561;52;27;4;23;.852;3900000;0
6467;65324;561;0;0;0;0;.00nan;0;0
6467;70573;553;46;27;4;23;.852;3900000;0
6467;144705;553;0;0;0;0;.00nan;0;0
6468;169325;558;0;0;0;0;.00nan;0;0
6468;86422;552;75;24;1;23;.958;3600000;0
6468;86686;558;91;49;4;45;.918;3600000;0
6468;88692;552;0;0;0;0;.00nan;0;0
6469;180738;555;0;0;0;0;.00nan;0;0
6469;36115;555;64;46;5;41;.891;3581000;0
6469;80596;556;0;0;0;0;.00nan;0;0
6469;85349;556;57;19;3;16;.842;3600000;0
6470;178789;554;49;15;2;13;.867;3600000;0
6470;-1;554;0;0;0;0;.00nan;0;0
6470;80596;556;62;39;5;34;.872;3600000;0
6470;85349;556;0;0;0;0;.00nan;0;0
6471;181071;560;95;44;2;42;.955;3600000;0
6471;54860;560;0;0;0;0;.00nan;0;0
6471;70573;553;57;29;4;25;.862;3527000;0
6471;144705;553;0;0;0;0;.00nan;0;0
6472;10112;1423;0;0;0;0;.00nan;0;0
6472;27517;1423;82;38;2;36;.947;3574000;0
6472;28989;2626;67;16;1;15;.938;3600000;0
6472;45584;2626;0;0;0;0;.00nan;0;0
6473;180738;555;70;47;5;42;.894;3600000;0
6473;36115;555;0;0;0;0;.00nan;0;0
6473;46468;561;0;0;0;0;.00nan;0;0
6473;65324;561;83;24;1;23;.958;3600000;0
6474;10112;1423;0;0;0;0;.00nan;0;0
6474;27517;1423;85;56;4;52;.929;3600000;0
6474;70573;553;62;15;1;14;.933;3600000;0
6474;144705;553;0;0;0;0;.00nan;0;0
6475;169325;558;0;0;0;0;.00nan;0;0
6475;80596;556;0;0;0;0;.00nan;0;0
6475;85349;556;69;35;3;32;.914;3545000;0
6475;86686;558;82;29;1;28;.966;3600000;0
6476;178789;554;69;6;0;6;1.000;3600000;0
6476;-1;554;0;0;0;0;.00nan;0;0
6476;181071;560;0;0;0;0;.00nan;0;0
6476;54860;560;86;61;5;56;.918;3600000;0
6477;181071;560;0;0;0;0;.00nan;0;0
6477;54860;560;69;56;6;50;.893;3600000;0
6477;86422;552;68;13;1;12;.923;3600000;0
6477;88692;552;0;0;0;0;.00nan;0;0
6478;10112;1423;68;30;3;27;.900;1731000;0
6478;27517;1423;32;33;6;27;.818;1869000;0
6478;70573;553;73;18;1;17;.944;3600000;0
6478;83252;553;0;0;0;0;.00nan;0;0
6479;178789;554;45;21;4;17;.810;3900000;0
6479;-1;554;0;0;0;0;.00nan;0;0
6479;80596;556;73;37;4;33;.892;3900000;0
6479;85349;556;0;0;0;0;.00nan;0;0
6480;169325;558;78;23;1;22;.957;3600000;0
6480;180738;555;0;0;0;0;.00nan;0;0
6480;36115;555;83;43;4;39;.907;3600000;0
6480;86686;558;0;0;0;0;.00nan;0;0
6481;28989;2626;58;24;3;21;.875;3600000;0
6481;45584;2626;0;0;0;0;.00nan;0;0
6481;46468;561;100;41;1;40;.976;3600000;0
6481;65324;561;0;0;0;0;.00nan;0;0
6482;28989;2626;68;27;2;25;.926;3600000;0
6482;181071;560;0;0;0;0;.00nan;0;0
6482;45584;2626;0;0;0;0;.00nan;0;0
6482;54860;560;50;22;3;19;.864;3561000;0
6483;181071;560;100;56;1;55;.982;3600000;0
6483;46468;561;0;0;0;0;.00nan;0;0
6483;54860;560;0;0;0;0;.00nan;0;0
6483;65324;561;66;25;2;23;.920;3543000;0
6484;178789;554;56;26;3;23;.885;3600000;0
6484;-1;554;0;0;0;0;.00nan;0;0
6484;70573;553;63;39;4;35;.897;3597000;0
6484;83252;553;0;0;0;0;.00nan;0;0
6485;169325;558;0;0;0;0;.00nan;0;0
6485;80596;556;0;0;0;0;.00nan;0;0
6485;85349;556;41;22;4;18;.818;3541000;0
6485;86686;558;100;42;2;40;.952;3600000;0
6486;169325;558;77;39;2;37;.949;3900000;0
6486;178789;554;0;0;0;0;.00nan;0;0
6486;-1;554;59;16;2;14;.875;3900000;0
6486;86686;558;0;0;0;0;.00nan;0;0
6487;180738;555;79;34;2;32;.941;3600000;0
6487;36115;555;0;0;0;0;.00nan;0;0
6487;46468;561;65;31;3;28;.903;3600000;0
6487;65324;561;0;0;0;0;.00nan;0;0
6488;10112;1423;26;29;6;23;.793;2220000;0
6488;27517;1423;43;32;5;27;.844;1380000;0
6488;86422;552;0;0;0;0;.00nan;0;0
6488;88692;552;42;9;2;7;.778;3600000;0
6489;180738;555;48;36;6;30;.833;2802000;0
6489;36115;555;44;10;2;8;.800;798000;0
6489;80596;556;85;24;1;23;.958;3600000;0
6489;85349;556;0;0;0;0;.00nan;0;0
6490;10112;1423;0;0;0;0;.00nan;0;0
6490;169325;558;0;0;0;0;.00nan;0;0
6490;27517;1423;68;47;4;43;.915;3600000;0
6490;86686;558;62;27;3;24;.889;3600000;0
6491;180738;555;85;41;4;37;.902;3600000;0
6491;36115;555;0;0;0;0;.00nan;0;0
6491;70573;553;77;23;1;22;.957;3600000;0
6491;144705;553;0;0;0;0;.00nan;0;0
6492;46468;561;0;0;0;0;.00nan;0;0
6492;65324;561;46;32;5;27;.844;3600000;0
6492;86422;552;75;21;1;20;.952;3600000;0
6492;88692;552;0;0;0;0;.00nan;0;0
6493;10112;1423;64;63;7;56;.889;3600000;0
6493;169325;558;0;0;0;0;.00nan;0;0
6493;27517;1423;0;0;0;0;.00nan;0;0
6493;86686;558;59;18;2;16;.889;3600000;0
6494;180738;555;0;0;0;0;.00nan;0;0
6494;36115;555;62;38;4;34;.895;3600000;0
6494;70573;553;0;0;0;0;.00nan;0;0
6494;144705;553;67;21;2;19;.905;3600000;0
6495;28989;2626;0;0;0;0;.00nan;0;0
6495;45584;2626;100;43;0;43;1.000;3600000;0
6495;46468;561;28;22;5;17;.773;3600000;0
6495;65324;561;0;0;0;0;.00nan;0;0
6496;80596;556;0;0;0;0;.00nan;0;0
6496;85349;556;99;42;1;41;.976;3600000;0
6496;86422;552;0;0;0;0;.00nan;0;0
6496;88692;552;50;20;3;17;.850;3541000;0
6497;10112;1423;73;27;2;25;.926;3900000;0
6497;27517;1423;0;0;0;0;.00nan;0;0
6497;180738;555;80;41;2;39;.951;3900000;0
6497;36115;555;0;0;0;0;.00nan;0;0
6498;28989;2626;0;0;0;0;.00nan;0;0
6498;45584;2626;92;44;2;42;.955;3600000;0
6498;70573;553;35;25;5;20;.800;3600000;0
6498;144705;553;0;0;0;0;.00nan;0;0
6499;46468;561;58;6;0;6;1.000;1271000;0
6499;65324;561;24;33;6;27;.818;2290000;0
6499;80596;556;37;26;5;21;.808;3600000;0
6499;85349;556;0;0;0;0;.00nan;0;0
6500;10112;1423;91;52;3;49;.942;3600000;0
6500;27517;1423;0;0;0;0;.00nan;0;0
6500;70573;553;0;0;0;0;.00nan;0;0
6500;144705;553;67;14;1;13;.929;3600000;0
6501;169325;558;0;0;0;0;.00nan;0;0
6501;28989;2626;71;51;6;45;.882;3600000;0
6501;45584;2626;0;0;0;0;.00nan;0;0
6501;86686;558;100;25;0;25;1.000;3600000;0
6502;169325;558;0;0;0;0;.00nan;0;0
6502;181071;560;79;34;2;32;.941;3546000;0
6502;54860;560;0;0;0;0;.00nan;0;0
6502;86686;558;75;19;1;18;.947;3600000;0
6503;28989;2626;0;0;0;0;.00nan;0;0
6503;45584;2626;61;31;3;28;.903;3900000;0
6503;80596;556;0;0;0;0;.00nan;0;0
6503;85349;556;72;29;3;26;.897;3900000;0
6504;180738;555;72;40;3;37;.925;3548000;0
6504;36115;555;0;0;0;0;.00nan;0;0
6504;86422;552;47;15;2;13;.867;3600000;0
6504;88692;552;0;0;0;0;.00nan;0;0
6505;178789;554;0;0;0;0;.00nan;0;0
6505;-1;554;90;21;0;21;1.000;3600000;0
6505;46468;561;27;29;6;23;.793;2461000;0
6505;65324;561;62;15;1;14;.933;1139000;0
6506;46468;561;0;0;0;0;.00nan;0;0
6506;65324;561;66;36;4;32;.889;3600000;0
6506;80596;556;28;28;6;22;.786;2853000;0
6506;85349;556;59;7;0;7;1.000;702000;0
6507;178789;554;0;0;0;0;.00nan;0;0
6507;-1;554;66;30;3;27;.900;3600000;0
6507;181071;560;70;48;5;43;.896;3558000;0
6507;54860;560;0;0;0;0;.00nan;0;0
6508;70573;553;0;0;0;0;.00nan;0;0
6508;86422;552;96;26;0;26;1.000;3600000;0
6508;88692;552;0;0;0;0;.00nan;0;0
6508;144705;553;82;36;3;33;.917;3600000;0
6509;10112;1423;68;47;5;42;.894;3600000;0
6509;169325;558;88;17;0;17;1.000;3600000;0
6509;27517;1423;0;0;0;0;.00nan;0;0
6509;86686;558;0;0;0;0;.00nan;0;0
6510;28989;2626;61;39;5;34;.872;3600000;0
6510;45584;2626;0;0;0;0;.00nan;0;0
6510;80596;556;0;0;0;0;.00nan;0;0
6510;85349;556;84;33;1;32;.970;3600000;0
6511;46468;561;66;34;3;31;.912;3563000;0
6511;65324;561;0;0;0;0;.00nan;0;0
6511;86422;552;0;0;0;0;.00nan;0;0
6511;88692;552;83;28;1;27;.964;3600000;0
6512;10112;1423;0;0;0;0;.00nan;0;0
6512;27517;1423;66;44;5;39;.886;3600000;0
6512;181071;560;71;24;1;23;.958;3600000;0
6512;54860;560;0;0;0;0;.00nan;0;0
6513;169325;558;0;0;0;0;.00nan;0;0
6513;180738;555;95;33;1;32;.970;3600000;0
6513;36115;555;0;0;0;0;.00nan;0;0
6513;86686;558;58;21;2;19;.905;3570000;0
6514;178789;554;66;24;2;22;.917;3600000;0
6514;-1;554;0;0;0;0;.00nan;0;0
6514;70573;553;60;41;5;36;.878;3600000;0
6514;144705;553;0;0;0;0;.00nan;0;0
6515;178789;554;0;0;0;0;.00nan;0;0
6515;-1;554;82;30;3;27;.900;3600000;0
6515;46468;561;0;0;0;0;.00nan;0;0
6515;65324;561;80;47;4;43;.915;3569000;0
6516;10112;1423;80;36;3;33;.917;3543000;0
6516;27517;1423;0;0;0;0;.00nan;0;0
6516;46468;561;73;27;2;25;.926;3600000;0
6516;65324;561;0;0;0;0;.00nan;0;0
6517;181071;560;54;45;6;39;.867;3600000;0
6517;54860;560;0;0;0;0;.00nan;0;0
6517;70573;553;0;0;0;0;.00nan;0;0
6517;144705;553;77;24;1;23;.958;3600000;0
6518;169325;558;57;4;0;4;1.000;870000;0
6518;28989;2626;78;38;4;34;.895;3900000;0
6518;45584;2626;0;0;0;0;.00nan;0;0
6518;86686;558;42;24;4;20;.833;3030000;0
6519;180738;555;70;56;6;50;.893;2580000;0
6519;36115;555;42;16;3;13;.813;1020000;0
6519;86422;552;83;11;0;11;1.000;3600000;0
6519;88692;552;0;0;0;0;.00nan;0;0
6520;10112;1423;68;43;5;38;.884;3600000;0
6520;178789;554;0;0;0;0;.00nan;0;0
6520;-1;554;52;10;2;8;.800;3600000;0
6520;27517;1423;0;0;0;0;.00nan;0;0
6521;169325;558;42;26;4;22;.846;1957000;0
6521;86422;552;75;18;1;17;.944;3600000;0
6521;86686;558;60;14;1;13;.929;1643000;0
6521;88692;552;0;0;0;0;.00nan;0;0
6522;181071;560;87;36;2;34;.944;3600000;0
6522;54860;560;0;0;0;0;.00nan;0;0
6522;80596;556;77;33;3;30;.909;3574000;0
6522;85349;556;0;0;0;0;.00nan;0;0
6523;28989;2626;48;23;4;19;.826;3561000;0
6523;45584;2626;0;0;0;0;.00nan;0;0
6523;46468;561;0;0;0;0;.00nan;0;0
6523;65324;561;50;22;3;19;.864;3600000;0
6524;28989;2626;0;0;0;0;.00nan;0;0
6524;45584;2626;67;30;3;27;.900;3600000;0
6524;46468;561;43;28;4;24;.857;3600000;0
6524;65324;561;0;0;0;0;.00nan;0;0
6525;181071;560;77;42;3;39;.929;3585000;0
6525;54860;560;0;0;0;0;.00nan;0;0
6525;70573;553;74;30;2;28;.933;3600000;0
6525;144705;553;0;0;0;0;.00nan;0;0
6526;10112;1423;0;0;0;0;.00nan;0;0
6526;27517;1423;62;49;6;43;.878;3600000;0
6526;80596;556;0;0;0;0;.00nan;0;0
6526;85349;556;77;23;1;22;.957;3600000;0
6527;178789;554;0;0;0;0;.00nan;0;0
6527;-1;554;57;11;1;10;.909;3600000;0
6527;180738;555;45;38;6;32;.842;3600000;0
6527;36115;555;0;0;0;0;.00nan;0;0
6528;169325;558;62;14;0;14;1.000;573000;0
6528;86422;552;63;28;3;25;.893;3600000;0
6528;86686;558;26;36;7;29;.806;3027000;0
6528;88692;552;0;0;0;0;.00nan;0;0
6529;10112;1423;45;40;5;35;.875;3600000;0
6529;27517;1423;0;0;0;0;.00nan;0;0
6529;80596;556;60;17;1;16;.941;3600000;0
6529;85349;556;0;0;0;0;.00nan;0;0
6530;70573;553;0;0;0;0;.00nan;0;0
6530;86422;552;0;0;0;0;.00nan;0;0
6530;88692;552;74;24;1;23;.958;3600000;0
6530;144705;553;63;47;5;42;.894;3600000;0
6531;169325;558;38;24;4;20;.833;3564000;0
6531;181071;560;66;35;3;32;.914;3600000;0
6531;54860;560;0;0;0;0;.00nan;0;0
6531;86686;558;0;0;0;0;.00nan;0;0
6532;178789;554;70;5;0;5;1.000;3600000;0
6532;-1;554;0;0;0;0;.00nan;0;0
6532;180738;555;0;0;0;0;.00nan;0;0
6532;36115;555;96;68;1;67;.985;3600000;0
6533;169325;558;0;0;0;0;.00nan;0;0
6533;46468;561;63;42;5;37;.881;3544000;0
6533;65324;561;0;0;0;0;.00nan;0;0
6533;86686;558;40;22;4;18;.818;3600000;0
6534;181071;560;57;35;5;30;.857;3549000;0
6534;54860;560;0;0;0;0;.00nan;0;0
6534;80596;556;0;0;0;0;.00nan;0;0
6534;85349;556;59;31;4;27;.871;3600000;0
6535;10112;1423;86;54;5;49;.907;3900000;0
6535;27517;1423;0;0;0;0;.00nan;0;0
6535;180738;555;51;33;5;28;.848;3900000;0
6535;36115;555;0;0;0;0;.00nan;0;0
6536;178789;554;76;21;1;20;.952;3600000;0
6536;-1;554;0;0;0;0;.00nan;0;0
6536;28989;2626;47;32;5;27;.844;2338000;0
6536;45584;2626;45;20;3;17;.850;1262000;0
6537;169325;558;77;43;3;40;.930;3600000;0
6537;46468;561;0;0;0;0;.00nan;0;0
6537;65324;561;79;14;0;14;1.000;3600000;0
6537;86686;558;0;0;0;0;.00nan;0;0
6538;70573;553;0;0;0;0;.00nan;0;0
6538;80596;556;0;0;0;0;.00nan;0;0
6538;85349;556;90;32;1;31;.969;3600000;0
6538;144705;553;91;37;2;35;.946;3600000;0
6539;10112;1423;50;1;0;1;1.000;365000;0
6539;27517;1423;28;38;7;31;.816;3235000;0
6539;180738;555;0;0;0;0;.00nan;0;0
6539;36115;555;48;22;4;18;.818;3600000;0
6540;178789;554;0;0;0;0;.00nan;0;0
6540;-1;554;74;9;0;9;1.000;3600000;0
6540;28989;2626;94;40;2;38;.950;3600000;0
6540;45584;2626;0;0;0;0;.00nan;0;0
6541;181071;560;66;40;4;36;.900;3600000;0
6541;54860;560;0;0;0;0;.00nan;0;0
6541;86422;552;100;25;0;25;1.000;3600000;0
6541;88692;552;0;0;0;0;.00nan;0;0
6542;10112;1423;90;38;2;36;.947;3562000;0
6542;27517;1423;0;0;0;0;.00nan;0;0
6542;181071;560;79;22;1;21;.955;3600000;0
6542;54860;560;0;0;0;0;.00nan;0;0
6543;169325;558;0;0;0;0;.00nan;0;0
6543;70573;553;83;40;3;37;.925;3555000;0
6543;86686;558;73;27;2;25;.926;3600000;0
6543;144705;553;0;0;0;0;.00nan;0;0
6544;46468;561;65;23;2;21;.913;3600000;0
6544;65324;561;0;0;0;0;.00nan;0;0
6544;80596;556;86;43;3;40;.930;3600000;0
6544;85349;556;0;0;0;0;.00nan;0;0
6545;28989;2626;0;0;0;0;.00nan;0;0
6545;180738;555;46;34;5;29;.853;3600000;0
6545;36115;555;0;0;0;0;.00nan;0;0
6545;45584;2626;86;22;1;21;.955;3600000;0
6546;178789;554;68;23;2;21;.913;2836000;0
6546;-1;554;22;10;4;6;.600;764000;0
6546;86422;552;72;20;1;19;.950;3600000;0
6546;88692;552;0;0;0;0;.00nan;0;0
6547;10112;1423;0;0;0;0;.00nan;0;0
6547;27517;1423;61;47;6;41;.872;3600000;0
6547;181071;560;82;14;0;14;1.000;3600000;0
6547;54860;560;0;0;0;0;.00nan;0;0
6548;169325;558;62;40;5;35;.875;3600000;0
6548;70573;553;0;0;0;0;.00nan;0;0
6548;86686;558;0;0;0;0;.00nan;0;0
6548;144705;553;79;35;2;33;.943;3600000;0
6549;28989;2626;45;26;4;22;.846;3600000;0
6549;180738;555;0;0;0;0;.00nan;0;0
6549;36115;555;54;49;7;42;.857;3600000;0
6549;45584;2626;0;0;0;0;.00nan;0;0
6550;178789;554;0;0;0;0;.00nan;0;0
6550;-1;554;100;26;0;26;1.000;3600000;0
6550;86422;552;56;34;5;29;.853;3600000;0
6550;88692;552;0;0;0;0;.00nan;0;0
6551;46468;561;0;0;0;0;.00nan;0;0
6551;65324;561;50;25;4;21;.840;3896000;0
6551;80596;556;0;0;0;0;.00nan;0;0
6551;85349;556;62;40;4;36;.900;3900000;0
6552;46468;561;76;32;3;29;.906;3600000;0
6552;65324;561;0;0;0;0;.00nan;0;0
6552;70573;553;64;33;4;29;.879;3600000;0
6552;144705;553;0;0;0;0;.00nan;0;0
6553;10112;1423;54;44;6;38;.864;3193000;0
6553;178789;554;0;0;0;0;.00nan;0;0
6553;-1;554;63;9;1;8;.889;3600000;0
6553;27517;1423;60;9;0;9;1.000;407000;0
6554;169325;558;0;0;0;0;.00nan;0;0
6554;80596;556;72;29;3;26;.897;3900000;0
6554;85349;556;0;0;0;0;.00nan;0;0
6554;86686;558;75;41;3;38;.927;3900000;0
6555;180738;555;94;36;1;35;.972;3600000;0
6555;181071;560;27;23;5;18;.783;3600000;0
6555;36115;555;0;0;0;0;.00nan;0;0
6555;54860;560;0;0;0;0;.00nan;0;0
6556;28989;2626;56;60;8;52;.867;3600000;0
6556;45584;2626;0;0;0;0;.00nan;0;0
6556;86422;552;46;19;3;16;.842;3600000;0
6556;88692;552;0;0;0;0;.00nan;0;0
6557;180738;555;64;33;4;29;.879;3537000;0
6557;181071;560;0;0;0;0;.00nan;0;0
6557;36115;555;0;0;0;0;.00nan;0;0
6557;54860;560;87;29;2;27;.931;3600000;0
6558;46468;561;0;0;0;0;.00nan;0;0
6558;65324;561;67;27;3;24;.889;3600000;0
6558;70573;553;0;0;0;0;.00nan;0;0
6558;144705;553;74;41;4;37;.902;3577000;0
6559;169325;558;53;46;6;40;.870;3600000;0
6559;80596;556;0;0;0;0;.00nan;0;0
6559;85349;556;80;29;1;28;.966;3600000;0
6559;86686;558;0;0;0;0;.00nan;0;0
6560;10112;1423;0;0;0;0;.00nan;0;0
6560;178789;554;47;13;2;11;.846;3600000;0
6560;-1;554;0;0;0;0;.00nan;0;0
6560;27517;1423;47;55;8;47;.855;3600000;0
6561;28989;2626;0;0;0;0;.00nan;0;0
6561;45584;2626;98;46;2;44;.957;3548000;0
6561;86422;552;62;15;1;14;.933;3600000;0
6561;88692;552;0;0;0;0;.00nan;0;0
6562;70573;553;0;0;0;0;.00nan;0;0
6562;80596;556;0;0;0;0;.00nan;0;0
6562;85349;556;74;45;4;41;.911;3600000;0
6562;144705;553;82;22;1;21;.955;3600000;0
6563;80596;556;0;0;0;0;.00nan;0;0
6563;85349;556;84;39;3;36;.923;3600000;0
6563;86422;552;63;33;4;29;.879;3599000;0
6563;88692;552;0;0;0;0;.00nan;0;0
6564;169325;558;0;0;0;0;.00nan;0;0
6564;46468;561;61;15;1;14;.933;3600000;0
6564;65324;561;0;0;0;0;.00nan;0;0
6564;86686;558;62;32;4;28;.875;3600000;0
6565;10112;1423;70;62;7;55;.887;3241000;0
6565;27517;1423;39;1;1;0;.000;359000;0
6565;70573;553;0;0;0;0;.00nan;0;0
6565;144705;553;58;11;1;10;.909;3600000;0
6566;28989;2626;100;30;0;30;1.000;3600000;0
6566;181071;560;63;40;4;36;.900;3600000;0
6566;45584;2626;0;0;0;0;.00nan;0;0
6566;54860;560;0;0;0;0;.00nan;0;0
6567;178789;554;0;0;0;0;.00nan;0;0
6567;-1;554;60;15;1;14;.933;3600000;0
6567;180738;555;81;46;4;42;.913;3600000;0
6567;36115;555;0;0;0;0;.00nan;0;0
6568;80596;556;90;39;2;37;.949;3600000;0
6568;85349;556;0;0;0;0;.00nan;0;0
6568;86422;552;0;0;0;0;.00nan;0;0
6568;88692;552;82;25;1;24;.960;3600000;0
6569;181071;560;80;24;2;22;.917;3900000;0
6569;46468;561;0;0;0;0;.00nan;0;0
6569;54860;560;0;0;0;0;.00nan;0;0
6569;65324;561;81;33;2;31;.939;3900000;0
6570;10112;1423;0;0;0;0;.00nan;0;0
6570;27517;1423;100;39;0;39;1.000;3600000;0
6570;28989;2626;57;20;2;18;.900;3525000;0
6570;45584;2626;0;0;0;0;.00nan;0;0
6571;169325;558;61;33;4;29;.879;3556000;0
6571;178789;554;68;24;2;22;.917;3600000;0
6571;-1;554;0;0;0;0;.00nan;0;0
6571;86686;558;0;0;0;0;.00nan;0;0
6572;180738;555;0;0;0;0;.00nan;0;0
6572;36115;555;75;37;2;35;.946;3594000;0
6572;70573;553;85;29;1;28;.966;3600000;0
6572;144705;553;0;0;0;0;.00nan;0;0
6573;178789;554;0;0;0;0;.00nan;0;0
6573;-1;554;35;12;3;9;.750;3600000;0
6573;46468;561;95;55;4;51;.927;3552000;0
6573;65324;561;0;0;0;0;.00nan;0;0
6574;178789;554;69;20;1;19;.950;3600000;0
6574;-1;554;0;0;0;0;.00nan;0;0
6574;46468;561;0;0;0;0;.00nan;0;0
6574;65324;561;71;40;3;37;.925;3546000;0
6575;70573;553;0;0;0;0;.00nan;0;0
6575;80596;556;0;0;0;0;.00nan;0;0
6575;85349;556;77;38;3;35;.921;3900000;0
6575;144705;553;74;37;3;34;.919;3900000;0
6576;169325;558;0;0;0;0;.00nan;0;0
6576;180738;555;33;26;5;21;.808;1949000;0
6576;36115;555;58;30;4;26;.867;1651000;0
6576;86686;558;87;14;0;14;1.000;3600000;0
6577;28989;2626;0;0;0;0;.00nan;0;0
6577;45584;2626;57;47;6;41;.872;3597000;0
6577;86422;552;26;15;4;11;.733;3600000;0
6577;88692;552;0;0;0;0;.00nan;0;0
6578;10112;1423;0;0;0;0;.00nan;0;0
6578;169325;558;0;0;0;0;.00nan;0;0
6578;27517;1423;54;48;6;42;.875;3600000;0
6578;86686;558;73;38;3;35;.921;3600000;0
6579;28989;2626;59;20;2;18;.900;3600000;0
6579;180738;555;65;38;4;34;.895;3515000;0
6579;36115;555;0;0;0;0;.00nan;0;0
6579;45584;2626;0;0;0;0;.00nan;0;0
6580;70573;553;84;49;6;43;.878;3600000;0
6580;86422;552;73;24;2;22;.917;3600000;0
6580;88692;552;0;0;0;0;.00nan;0;0
6580;144705;553;0;0;0;0;.00nan;0;0
6581;181071;560;74;41;3;38;.927;3900000;0
6581;54860;560;0;0;0;0;.00nan;0;0
6581;70573;553;0;0;0;0;.00nan;0;0
6581;144705;553;58;22;3;19;.864;3900000;0
6582;169325;558;0;0;0;0;.00nan;0;0
6582;86422;552;49;11;2;9;.818;3600000;0
6582;86686;558;88;40;3;37;.925;3600000;0
6582;88692;552;0;0;0;0;.00nan;0;0
6583;180738;555;82;40;4;36;.900;3600000;0
6583;36115;555;0;0;0;0;.00nan;0;0
6583;80596;556;0;0;0;0;.00nan;0;0
6583;85349;556;90;21;0;21;1.000;3600000;0
6584;10112;1423;100;39;1;38;.974;3600000;0
6584;27517;1423;0;0;0;0;.00nan;0;0
6584;28989;2626;45;25;4;21;.840;3600000;0
6584;45584;2626;0;0;0;0;.00nan;0;0
6585;178789;554;0;0;0;0;.00nan;0;0
6585;-1;554;46;27;4;23;.852;3579000;0
6585;46468;561;73;27;2;25;.926;3600000;0
6585;65324;561;0;0;0;0;.00nan;0;0
6586;10112;1423;0;0;0;0;.00nan;0;0
6586;27517;1423;71;46;4;42;.913;3600000;0
6586;46468;561;0;0;0;0;.00nan;0;0
6586;65324;561;60;12;1;11;.917;3600000;0
6587;178789;554;73;29;2;27;.931;3600000;0
6587;-1;554;0;0;0;0;.00nan;0;0
6587;70573;553;80;45;3;42;.933;3588000;0
6587;144705;553;0;0;0;0;.00nan;0;0
6588;180738;555;0;0;0;0;.00nan;0;0
6588;181071;560;100;31;0;31;1.000;3600000;0
6588;36115;555;86;38;1;37;.974;3545000;0
6588;54860;560;0;0;0;0;.00nan;0;0
6589;28989;2626;0;0;0;0;.00nan;0;0
6589;45584;2626;58;40;4;36;.900;3600000;0
6589;80596;556;0;0;0;0;.00nan;0;0
6589;85349;556;84;26;1;25;.962;3600000;0
6590;169325;558;86;40;3;37;.925;3600000;0
6590;86422;552;87;14;0;14;1.000;3600000;0
6590;86686;558;0;0;0;0;.00nan;0;0
6590;88692;552;0;0;0;0;.00nan;0;0
6591;10112;1423;100;46;0;46;1.000;3900000;0
6591;27517;1423;0;0;0;0;.00nan;0;0
6591;46468;561;75;18;0;18;1.000;3900000;0
6591;65324;561;0;0;0;0;.00nan;0;0
6592;180738;555;57;39;5;34;.872;3600000;0
6592;181071;560;34;17;4;13;.765;3600000;0
6592;36115;555;0;0;0;0;.00nan;0;0
6592;54860;560;0;0;0;0;.00nan;0;0
6593;169325;558;0;0;0;0;.00nan;0;0
6593;70573;553;0;0;0;0;.00nan;0;0
6593;86686;558;85;42;3;39;.929;3600000;0
6593;144705;553;100;28;0;28;1.000;3600000;0
6594;28989;2626;73;24;2;22;.917;3600000;0
6594;45584;2626;0;0;0;0;.00nan;0;0
6594;80596;556;53;23;3;20;.870;3600000;0
6594;85349;556;0;0;0;0;.00nan;0;0
6595;178789;554;69;41;4;37;.902;3600000;0
6595;-1;554;0;0;0;0;.00nan;0;0
6595;86422;552;20;27;6;21;.778;3549000;0
6595;88692;552;0;0;0;0;.00nan;0;0
6596;10112;1423;100;35;1;34;.971;3600000;0
6596;27517;1423;0;0;0;0;.00nan;0;0
6596;80596;556;0;0;0;0;.00nan;0;0
6596;85349;556;81;30;2;28;.933;3552000;0
6597;169325;558;51;34;5;29;.853;3600000;0
6597;181071;560;77;24;1;23;.958;3600000;0
6597;54860;560;0;0;0;0;.00nan;0;0
6597;86686;558;0;0;0;0;.00nan;0;0
6598;180738;555;0;0;0;0;.00nan;0;0
6598;36115;555;64;40;3;37;.925;3900000;0
6598;46468;561;71;24;3;21;.875;3900000;0
6598;65324;561;0;0;0;0;.00nan;0;0
6599;178789;554;0;0;0;0;.00nan;0;0
6599;-1;554;52;12;2;10;.833;3600000;0
6599;28989;2626;89;51;4;47;.922;3583000;0
6599;45584;2626;0;0;0;0;.00nan;0;0
6600;70573;553;0;0;0;0;.00nan;0;0
6600;86422;552;0;0;0;0;.00nan;0;0
6600;88692;552;72;25;2;23;.920;3900000;0
6600;144705;553;99;49;2;47;.959;3900000;0
6601;80596;556;36;23;5;18;.783;2080000;0
6601;85349;556;70;21;1;20;.952;1520000;0
6601;86422;552;66;21;2;19;.905;3600000;0
6601;88692;552;0;0;0;0;.00nan;0;0
6602;181071;560;43;30;5;25;.833;3600000;0
6602;46468;561;0;0;0;0;.00nan;0;0
6602;54860;560;0;0;0;0;.00nan;0;0
6602;65324;561;80;27;1;26;.963;3600000;0
6603;180738;555;45;41;6;35;.854;3255000;0
6603;36115;555;46;5;1;4;.800;345000;0
6603;70573;553;0;0;0;0;.00nan;0;0
6603;144705;553;57;19;2;17;.895;3600000;0
6604;169325;558;0;0;0;0;.00nan;0;0
6604;28989;2626;0;0;0;0;.00nan;0;0
6604;45584;2626;77;37;2;35;.946;3900000;0
6604;86686;558;95;39;2;37;.949;3900000;0
6605;10112;1423;46;12;2;10;.833;578000;0
6605;178789;554;49;11;2;9;.818;3600000;0
6605;-1;554;0;0;0;0;.00nan;0;0
6605;27517;1423;46;41;6;35;.854;3022000;0
6606;80596;556;0;0;0;0;.00nan;0;0
6606;85349;556;82;41;2;39;.951;3900000;0
6606;86422;552;0;0;0;0;.00nan;0;0
6606;88692;552;66;20;2;18;.900;3900000;0
6607;181071;560;83;34;3;31;.912;3600000;0
6607;46468;561;36;28;5;23;.821;3576000;0
6607;54860;560;0;0;0;0;.00nan;0;0
6607;65324;561;0;0;0;0;.00nan;0;0
6608;10112;1423;93;52;4;48;.923;3600000;0
6608;178789;554;0;0;0;0;.00nan;0;0
6608;-1;554;71;9;0;9;1.000;3600000;0
6608;27517;1423;0;0;0;0;.00nan;0;0
6609;169325;558;0;0;0;0;.00nan;0;0
6609;28989;2626;58;35;4;31;.886;3600000;0
6609;45584;2626;0;0;0;0;.00nan;0;0
6609;86686;558;84;24;1;23;.958;3600000;0
6610;10112;1423;64;47;5;42;.894;3600000;0
6610;27517;1423;0;0;0;0;.00nan;0;0
6610;181071;560;0;0;0;0;.00nan;0;0
6610;54860;560;79;29;1;28;.966;3600000;0
6611;169325;558;0;0;0;0;.00nan;0;0
6611;178789;554;0;0;0;0;.00nan;0;0
6611;-1;554;63;15;1;14;.933;3600000;0
6611;86686;558;70;27;2;25;.926;3581000;0
6612;46468;561;0;0;0;0;.00nan;0;0
6612;65324;561;79;31;2;29;.935;3600000;0
6612;80596;556;0;0;0;0;.00nan;0;0
6612;85349;556;45;34;6;28;.824;3600000;0
6613;180738;555;52;37;5;32;.865;3600000;0
6613;36115;555;0;0;0;0;.00nan;0;0
6613;70573;553;0;0;0;0;.00nan;0;0
6613;144705;553;57;11;1;10;.909;3600000;0
6614;28989;2626;56;40;5;35;.875;3600000;0
6614;45584;2626;0;0;0;0;.00nan;0;0
6614;86422;552;67;12;1;11;.917;3600000;0
6614;88692;552;0;0;0;0;.00nan;0;0
6615;10112;1423;0;0;0;0;.00nan;0;0
6615;27517;1423;85;76;5;71;.934;3600000;0
6615;86422;552;0;0;0;0;.00nan;0;0
6615;88692;552;68;8;0;8;1.000;3600000;0
6616;46468;561;56;26;3;23;.885;3600000;0
6616;65324;561;0;0;0;0;.00nan;0;0
6616;70573;553;93;20;0;20;1.000;3600000;0
6616;144705;553;0;0;0;0;.00nan;0;0
6617;169325;558;0;0;0;0;.00nan;0;0
6617;180738;555;0;0;0;0;.00nan;0;0
6617;36115;555;68;34;4;30;.882;3600000;0
6617;86686;558;90;21;0;21;1.000;3600000;0
6618;28989;2626;0;0;0;0;.00nan;0;0
6618;181071;560;97;34;1;33;.971;3900000;0
6618;45584;2626;73;21;1;20;.952;3900000;0
6618;54860;560;0;0;0;0;.00nan;0;0
6619;178789;554;61;30;3;27;.900;3783000;0
6619;-1;554;0;0;0;0;.00nan;0;0
6619;80596;556;86;48;4;44;.917;3783000;0
6619;85349;556;0;0;0;0;.00nan;0;0
6620;169325;558;0;0;0;0;.00nan;0;0
6620;181071;560;85;36;2;34;.944;3900000;0
6620;54860;560;0;0;0;0;.00nan;0;0
6620;86686;558;60;18;2;16;.889;3900000;0
6621;10112;1423;0;0;0;0;.00nan;0;0
6621;27517;1423;92;47;3;44;.936;3681000;0
6621;80596;556;71;21;2;19;.905;3681000;0
6621;85349;556;0;0;0;0;.00nan;0;0
6622;178789;554;0;0;0;0;.00nan;0;0
6622;-1;554;85;19;0;19;1.000;3600000;0
6622;70573;553;63;43;5;38;.884;3600000;0
6622;144705;553;0;0;0;0;.00nan;0;0
6623;180738;555;88;46;3;43;.935;3524000;0
6623;36115;555;0;0;0;0;.00nan;0;0
6623;86422;552;0;0;0;0;.00nan;0;0
6623;88692;552;73;19;1;18;.947;3600000;0
6624;10112;1423;89;67;6;61;.910;3600000;0
6624;27517;1423;0;0;0;0;.00nan;0;0
6624;80596;556;77;17;1;16;.941;3600000;0
6624;85349;556;0;0;0;0;.00nan;0;0
6625;10112;1423;0;0;0;0;.00nan;0;0
6625;27517;1423;60;37;4;33;.892;3900000;0
6625;180738;555;72;35;4;31;.886;3900000;0
6625;36115;555;0;0;0;0;.00nan;0;0
6626;169325;558;0;0;0;0;.00nan;0;0
6626;181071;560;41;30;5;25;.833;3558000;0
6626;54860;560;0;0;0;0;.00nan;0;0
6626;86686;558;68;29;3;26;.897;3600000;0
6627;28989;2626;97;58;3;55;.948;3555000;0
6627;45584;2626;0;0;0;0;.00nan;0;0
6627;70573;553;0;0;0;0;.00nan;0;0
6627;144705;553;70;20;1;19;.950;3600000;0
6628;178789;554;45;5;1;4;.800;541000;0
6628;-1;554;23;27;6;21;.778;3059000;0
6628;86422;552;75;25;2;23;.920;3600000;0
6628;88692;552;0;0;0;0;.00nan;0;0
6629;28989;2626;0;0;0;0;.00nan;0;0
6629;45584;2626;90;34;1;33;.971;3900000;0
6629;46468;561;0;0;0;0;.00nan;0;0
6629;65324;561;81;28;1;27;.964;3900000;0
6630;181071;560;24;13;4;9;.692;942000;0
6630;54860;560;37;37;7;30;.811;2658000;0
6630;70573;553;99;35;1;34;.971;3600000;0
6630;144705;553;0;0;0;0;.00nan;0;0
6631;180738;555;0;0;0;0;.00nan;0;0
6631;36115;555;92;56;3;53;.946;3600000;0
6631;86422;552;0;0;0;0;.00nan;0;0
6631;88692;552;20;9;4;5;.556;3544000;0
6632;169325;558;0;0;0;0;.00nan;0;0
6632;178789;554;50;27;5;22;.815;3600000;0
6632;-1;554;0;0;0;0;.00nan;0;0
6632;86686;558;94;33;1;32;.970;3600000;0
6633;169325;558;0;0;0;0;.00nan;0;0
6633;28989;2626;59;34;4;30;.882;3547000;0
6633;45584;2626;0;0;0;0;.00nan;0;0
6633;86686;558;65;30;3;27;.900;3600000;0
6634;169325;558;0;0;0;0;.00nan;0;0
6634;46468;561;100;24;0;24;1.000;3600000;0
6634;65324;561;0;0;0;0;.00nan;0;0
6634;86686;558;74;25;2;23;.920;3544000;0
6635;181071;560;52;43;6;37;.860;3038000;0
6635;54860;560;54;4;0;4;1.000;562000;0
6635;86422;552;65;21;2;19;.905;3600000;0
6635;88692;552;0;0;0;0;.00nan;0;0
6636;10112;1423;41;39;7;32;.821;3600000;0
6636;27517;1423;0;0;0;0;.00nan;0;0
6636;70573;553;93;20;0;20;1.000;3600000;0
6636;144705;553;0;0;0;0;.00nan;0;0
6637;178789;554;0;0;0;0;.00nan;0;0
6637;-1;554;67;15;1;14;.933;3600000;0
6637;80596;556;96;51;3;48;.941;3580000;0
6637;85349;556;0;0;0;0;.00nan;0;0
6638;28989;2626;0;0;0;0;.00nan;0;0
6638;180738;555;73;51;5;46;.902;3600000;0
6638;36115;555;0;0;0;0;.00nan;0;0
6638;45584;2626;61;13;1;12;.923;3600000;0
6639;70573;553;51;24;4;20;.833;3797000;0
6639;80596;556;0;0;0;0;.00nan;0;0
6639;85349;556;74;39;3;36;.923;3797000;0
6639;144705;553;0;0;0;0;.00nan;0;0
6640;180738;555;0;0;0;0;.00nan;0;0
6640;181071;560;67;25;2;23;.920;3900000;0
6640;36115;555;96;37;2;35;.946;3900000;0
6640;54860;560;0;0;0;0;.00nan;0;0
6641;178789;554;74;22;1;21;.955;3600000;0
6641;-1;554;0;0;0;0;.00nan;0;0
6641;46468;561;78;46;4;42;.913;3600000;0
6641;65324;561;0;0;0;0;.00nan;0;0
6642;10112;1423;0;0;0;0;.00nan;0;0
6642;27517;1423;92;57;4;53;.930;3600000;0
6642;86422;552;0;0;0;0;.00nan;0;0
6642;88692;552;74;16;1;15;.938;3600000;0
6643;10112;1423;73;42;4;38;.905;3600000;0
6643;27517;1423;0;0;0;0;.00nan;0;0
6643;46468;561;0;0;0;0;.00nan;0;0
6643;65324;561;67;19;1;18;.947;3600000;0
6644;180738;555;31;32;6;26;.813;3600000;0
6644;181071;560;0;0;0;0;.00nan;0;0
6644;36115;555;0;0;0;0;.00nan;0;0
6644;54860;560;47;20;3;17;.850;3600000;0
6645;169325;558;0;0;0;0;.00nan;0;0
6645;80596;556;85;36;2;34;.944;3600000;0
6645;85349;556;0;0;0;0;.00nan;0;0
6645;86686;558;80;33;3;30;.909;3569000;0
6646;28989;2626;93;40;2;38;.950;3600000;0
6646;45584;2626;0;0;0;0;.00nan;0;0
6646;70573;553;38;30;6;24;.800;3027000;0
6646;144705;553;48;7;1;6;.857;573000;0
6647;10112;1423;62;23;2;21;.913;1488000;0
6647;27517;1423;32;29;6;23;.793;2112000;0
6647;46468;561;72;17;1;16;.941;3600000;0
6647;65324;561;0;0;0;0;.00nan;0;0
6648;169325;558;72;27;2;25;.926;3600000;0
6648;80596;556;0;0;0;0;.00nan;0;0
6648;85349;556;65;38;3;35;.921;3545000;0
6648;86686;558;0;0;0;0;.00nan;0;0
6649;178789;554;0;0;0;0;.00nan;0;0
6649;-1;554;80;14;0;14;1.000;3600000;0
6649;181071;560;59;46;5;41;.891;3600000;0
6649;54860;560;0;0;0;0;.00nan;0;0
6650;28989;2626;84;36;2;34;.944;2501000;0
6650;45584;2626;36;20;4;16;.800;1099000;0
6650;86422;552;54;12;1;11;.917;3600000;0
6650;88692;552;0;0;0;0;.00nan;0;0
6651;70573;553;46;15;2;13;.867;1264000;0
6651;86422;552;0;0;0;0;.00nan;0;0
6651;88692;552;61;17;1;16;.941;3600000;0
6651;144705;553;35;35;6;29;.829;2336000;0
6652;178789;554;0;0;0;0;.00nan;0;0
6652;-1;554;59;11;1;10;.909;3600000;0
6652;180738;555;97;57;2;55;.965;3567000;0
6652;36115;555;0;0;0;0;.00nan;0;0
6653;10112;1423;64;34;4;30;.882;3272000;0
6653;27517;1423;55;5;0;5;1.000;628000;0
6653;181071;560;35;20;4;16;.800;3900000;0
6653;54860;560;0;0;0;0;.00nan;0;0
6654;178789;554;71;4;0;4;1.000;3600000;0
6654;-1;554;0;0;0;0;.00nan;0;0
6654;180738;555;77;58;6;52;.897;3600000;0
6654;36115;555;0;0;0;0;.00nan;0;0
6655;178789;554;41;30;5;25;.833;3900000;0
6655;-1;554;0;0;0;0;.00nan;0;0
6655;181071;560;78;46;5;41;.891;3900000;0
6655;54860;560;0;0;0;0;.00nan;0;0
6656;10112;1423;23;6;3;3;.500;687000;0
6656;169325;558;0;0;0;0;.00nan;0;0
6656;27517;1423;47;36;6;30;.833;2913000;0
6656;86686;558;56;17;2;15;.882;3600000;0
6657;28989;2626;73;51;5;46;.902;3600000;0
6657;45584;2626;0;0;0;0;.00nan;0;0
6657;80596;556;67;22;2;20;.909;3600000;0
6657;85349;556;0;0;0;0;.00nan;0;0
6658;46468;561;39;28;5;23;.821;3600000;0
6658;65324;561;0;0;0;0;.00nan;0;0
6658;86422;552;96;22;0;22;1.000;3600000;0
6658;88692;552;0;0;0;0;.00nan;0;0
6659;10112;1423;59;59;8;51;.864;3600000;0
6659;27517;1423;0;0;0;0;.00nan;0;0
6659;70573;553;45;18;3;15;.833;3600000;0
6659;144705;553;0;0;0;0;.00nan;0;0
6660;181071;560;82;43;4;39;.907;3600000;0
6660;54860;560;0;0;0;0;.00nan;0;0
6660;80596;556;0;0;0;0;.00nan;0;0
6660;85349;556;33;24;5;19;.792;3600000;0
6661;28989;2626;0;0;0;0;.00nan;0;0
6661;180738;555;67;37;3;34;.919;3589000;0
6661;36115;555;0;0;0;0;.00nan;0;0
6661;45584;2626;60;20;2;18;.900;3600000;0
6662;46468;561;0;0;0;0;.00nan;0;0
6662;65324;561;67;47;5;42;.894;3600000;0
6662;86422;552;66;27;3;24;.889;3600000;0
6662;88692;552;0;0;0;0;.00nan;0;0
6663;169325;558;0;0;0;0;.00nan;0;0
6663;178789;554;0;0;0;0;.00nan;0;0
6663;-1;554;95;17;0;17;1.000;3600000;0
6663;86686;558;85;38;2;36;.947;3561000;0
6664;180738;555;71;45;4;41;.911;3888000;0
6664;36115;555;0;0;0;0;.00nan;0;0
6664;46468;561;48;21;3;18;.857;3888000;0
6664;65324;561;0;0;0;0;.00nan;0;0
6665;169325;558;0;0;0;0;.00nan;0;0
6665;70573;553;0;0;0;0;.00nan;0;0
6665;86686;558;74;37;4;33;.892;3600000;0
6665;144705;553;70;36;3;33;.917;3600000;0
6666;10112;1423;28;20;5;15;.750;2070000;0
6666;27517;1423;68;14;0;14;1.000;1530000;0
6666;28989;2626;62;17;1;16;.941;3600000;0
6666;45584;2626;0;0;0;0;.00nan;0;0
6667;180738;555;98;40;2;38;.950;3571000;0
6667;36115;555;0;0;0;0;.00nan;0;0
6667;46468;561;0;0;0;0;.00nan;0;0
6667;65324;561;100;23;0;23;1.000;3600000;0
6668;169325;558;71;36;3;33;.917;3568000;0
6668;181071;560;77;29;2;27;.931;3600000;0
6668;54860;560;0;0;0;0;.00nan;0;0
6668;86686;558;0;0;0;0;.00nan;0;0
6669;28989;2626;0;0;0;0;.00nan;0;0
6669;45584;2626;89;43;3;40;.930;3600000;0
6669;80596;556;73;23;2;21;.913;3600000;0
6669;85349;556;0;0;0;0;.00nan;0;0
6670;178789;554;0;0;0;0;.00nan;0;0
6670;-1;554;83;31;1;30;.968;3600000;0
6670;86422;552;39;29;5;24;.828;3600000;0
6670;88692;552;0;0;0;0;.00nan;0;0
6671;181071;560;0;0;0;0;.00nan;0;0
6671;54860;560;56;43;6;37;.860;3600000;0
6671;80596;556;0;0;0;0;.00nan;0;0
6671;85349;556;67;19;1;18;.947;3600000;0
6672;10112;1423;0;0;0;0;.00nan;0;0
6672;27517;1423;98;68;4;64;.941;3600000;0
6672;86422;552;0;0;0;0;.00nan;0;0
6672;88692;552;84;15;0;15;1.000;3600000;0
6673;181071;560;64;41;5;36;.878;3600000;0
6673;54860;560;0;0;0;0;.00nan;0;0
6673;86422;552;0;0;0;0;.00nan;0;0
6673;88692;552;61;18;1;17;.944;3600000;0
6674;180738;555;63;55;6;49;.891;3538000;0
6674;36115;555;0;0;0;0;.00nan;0;0
6674;70573;553;0;0;0;0;.00nan;0;0
6674;144705;553;33;18;4;14;.778;3600000;0
6675;70573;553;52;27;4;23;.852;3600000;0
6675;80596;556;50;36;5;31;.861;3535000;0
6675;85349;556;0;0;0;0;.00nan;0;0
6675;144705;553;0;0;0;0;.00nan;0;0
6676;46468;561;0;0;0;0;.00nan;0;0
6676;65324;561;71;43;4;39;.907;3600000;0
6676;70573;553;0;0;0;0;.00nan;0;0
6676;144705;553;74;23;2;21;.913;3600000;0
6677;180738;555;97;40;2;38;.950;3900000;0
6677;36115;555;0;0;0;0;.00nan;0;0
6677;80596;556;0;0;0;0;.00nan;0;0
6677;85349;556;58;19;2;17;.895;3900000;0
6678;10112;1423;0;0;0;0;.00nan;0;0
6678;27517;1423;92;43;3;40;.930;3600000;0
6678;28989;2626;78;12;0;12;1.000;3600000;0
6678;45584;2626;0;0;0;0;.00nan;0;0
6679;178789;554;0;0;0;0;.00nan;0;0
6679;-1;554;61;25;3;22;.880;3600000;0
6679;86422;552;70;39;4;35;.897;3574000;0
6679;88692;552;0;0;0;0;.00nan;0;0
6680;178789;554;57;33;4;29;.879;3538000;0
6680;-1;554;0;0;0;0;.00nan;0;0
6680;181071;560;85;39;3;36;.923;3600000;0
6680;54860;560;0;0;0;0;.00nan;0;0
6681;10112;1423;90;40;3;37;.925;3823000;0
6681;27517;1423;0;0;0;0;.00nan;0;0
6681;28989;2626;44;20;4;16;.800;3823000;0
6681;45584;2626;0;0;0;0;.00nan;0;0
6682;169325;558;0;0;0;0;.00nan;0;0
6682;46468;561;72;20;1;19;.950;3600000;0
6682;65324;561;0;0;0;0;.00nan;0;0
6682;86686;558;57;28;3;25;.893;3515000;0
6683;180738;555;39;38;7;31;.816;3002000;0
6683;36115;555;39;7;2;5;.714;598000;0
6683;86422;552;0;0;0;0;.00nan;0;0
6683;88692;552;100;23;0;23;1.000;3600000;0
6684;70573;553;43;24;4;20;.833;3546000;0
6684;80596;556;0;0;0;0;.00nan;0;0
6684;85349;556;81;43;3;40;.930;3600000;0
6684;144705;553;0;0;0;0;.00nan;0;0
6685;46468;561;53;29;4;25;.862;3600000;0
6685;65324;561;0;0;0;0;.00nan;0;0
6685;80596;556;100;31;1;30;.968;3600000;0
6685;85349;556;0;0;0;0;.00nan;0;0
6686;28989;2626;74;41;4;37;.902;3556000;0
6686;45584;2626;0;0;0;0;.00nan;0;0
6686;70573;553;0;0;0;0;.00nan;0;0
6686;144705;553;66;18;2;16;.889;3600000;0
6687;169325;558;0;0;0;0;.00nan;0;0
6687;180738;555;91;52;4;48;.923;3600000;0
6687;36115;555;0;0;0;0;.00nan;0;0
6687;86686;558;70;19;1;18;.947;3600000;0
6688;10112;1423;63;53;6;47;.887;3156000;0
6688;178789;554;0;0;0;0;.00nan;0;0
6688;-1;554;40;9;2;7;.778;3600000;0
6688;27517;1423;56;5;0;5;1.000;444000;0
6689;181071;560;32;10;3;7;.700;588000;0
6689;54860;560;65;52;7;45;.865;3012000;0
6689;86422;552;0;0;0;0;.00nan;0;0
6689;88692;552;81;13;0;13;1.000;3600000;0
6690;181071;560;41;26;5;21;.808;3600000;0
6690;46468;561;0;0;0;0;.00nan;0;0
6690;54860;560;0;0;0;0;.00nan;0;0
6690;65324;561;88;17;0;17;1.000;3600000;0
6691;10112;1423;0;0;0;0;.00nan;0;0
6691;27517;1423;89;31;1;30;.968;3600000;0
6691;180738;555;41;21;4;17;.810;3600000;0
6691;36115;555;0;0;0;0;.00nan;0;0
6692;28989;2626;0;0;0;0;.00nan;0;0
6692;45584;2626;90;40;2;38;.950;3600000;0
6692;86422;552;75;14;0;14;1.000;3030000;0
6692;88692;552;25;6;3;3;.500;521000;0
6693;178789;554;79;30;2;28;.933;3600000;0
6693;-1;554;0;0;0;0;.00nan;0;0
6693;80596;556;0;0;0;0;.00nan;0;0
6693;85349;556;93;49;3;46;.939;3600000;0
6694;28989;2626;54;40;5;35;.875;3600000;0
6694;181071;560;86;30;1;29;.967;3600000;0
6694;45584;2626;0;0;0;0;.00nan;0;0
6694;54860;560;0;0;0;0;.00nan;0;0
6695;46468;561;0;0;0;0;.00nan;0;0
6695;65324;561;89;48;4;44;.917;3547000;0
6695;86422;552;0;0;0;0;.00nan;0;0
6695;88692;552;40;13;3;10;.769;3600000;0
6696;46468;561;75;43;4;39;.907;3600000;0
6696;65324;561;0;0;0;0;.00nan;0;0
6696;86422;552;94;28;1;27;.964;3600000;0
6696;88692;552;0;0;0;0;.00nan;0;0
6697;10112;1423;37;36;6;30;.833;3315000;0
6697;27517;1423;50;1;0;1;1.000;285000;0
6697;181071;560;0;0;0;0;.00nan;0;0
6697;54860;560;61;16;1;15;.938;3600000;0
6698;169325;558;0;0;0;0;.00nan;0;0
6698;70573;553;53;37;5;32;.865;3600000;0
6698;86686;558;75;26;2;24;.923;3600000;0
6698;144705;553;0;0;0;0;.00nan;0;0
6699;180738;555;60;38;4;34;.895;3556000;0
6699;36115;555;0;0;0;0;.00nan;0;0
6699;80596;556;0;0;0;0;.00nan;0;0
6699;85349;556;69;23;2;21;.913;3600000;0
6700;178789;554;0;0;0;0;.00nan;0;0
6700;-1;554;83;27;1;26;.963;3562000;0
6700;28989;2626;100;37;0;37;1.000;3600000;0
6700;45584;2626;0;0;0;0;.00nan;0;0
6701;10112;1423;0;0;0;0;.00nan;0;0
6701;27517;1423;47;28;4;24;.857;3554000;0
6701;180738;555;77;37;2;35;.946;3600000;0
6701;36115;555;0;0;0;0;.00nan;0;0
6702;169325;558;79;32;2;30;.938;3600000;0
6702;70573;553;0;0;0;0;.00nan;0;0
6702;86686;558;0;0;0;0;.00nan;0;0
6702;144705;553;47;18;3;15;.833;3544000;0
6703;181071;560;96;44;1;43;.977;3900000;0
6703;54860;560;0;0;0;0;.00nan;0;0
6703;80596;556;73;23;1;22;.957;3900000;0
6703;85349;556;0;0;0;0;.00nan;0;0
6704;178789;554;31;21;5;16;.762;3576000;0
6704;-1;554;0;0;0;0;.00nan;0;0
6704;28989;2626;57;30;4;26;.867;3600000;0
6704;45584;2626;0;0;0;0;.00nan;0;0
6705;28989;2626;0;0;0;0;.00nan;0;0
6705;45584;2626;92;43;2;41;.953;3560000;0
6705;46468;561;0;0;0;0;.00nan;0;0
6705;65324;561;94;38;1;37;.974;3600000;0
6707;10112;1423;72;55;6;49;.891;2916000;0
6707;178789;554;76;10;0;10;1.000;3600000;0
6707;-1;554;0;0;0;0;.00nan;0;0
6707;27517;1423;51;12;1;11;.917;684000;0
6709;180738;555;62;48;6;42;.875;3600000;0
6709;36115;555;0;0;0;0;.00nan;0;0
6709;80596;556;78;26;1;25;.962;3600000;0
6709;85349;556;0;0;0;0;.00nan;0;0
6711;2691;560;50;11;1;10;.909;1363000;0
6711;28989;2626;57;37;4;33;.892;3600000;0
6711;45584;2626;0;0;0;0;.00nan;0;0
6711;54860;560;32;28;6;22;.786;2237000;0
6713;46468;561;67;38;3;35;.921;3600000;0
6713;65324;561;0;0;0;0;.00nan;0;0
6713;70573;553;75;27;2;25;.926;3600000;0
6713;144705;553;0;0;0;0;.00nan;0;0
6715;169325;558;0;0;0;0;.00nan;0;0
6715;86422;552;50;20;3;17;.850;3600000;0
6715;86686;558;100;30;0;30;1.000;3600000;0
6715;88692;552;0;0;0;0;.00nan;0;0
6737;28989;2626;0;0;0;0;.00nan;0;0
6737;45584;2626;81;42;3;39;.929;3565000;0
6737;70573;553;0;0;0;0;.00nan;0;0
6737;144705;553;73;24;1;23;.958;3600000;0
6739;178789;554;72;6;0;6;1.000;3600000;0
6739;-1;554;0;0;0;0;.00nan;0;0
6739;46468;561;0;0;0;0;.00nan;0;0
6739;65324;561;90;55;4;51;.927;3600000;0
6741;2691;560;0;0;0;0;.00nan;0;0
6741;54860;560;100;43;1;42;.977;3600000;0
6741;80596;556;0;0;0;0;.00nan;0;0
6741;85349;556;60;27;3;24;.889;3564000;0
6743;10112;1423;49;38;6;32;.842;1977000;0
6743;169325;558;64;15;1;14;.933;3600000;0
6743;27517;1423;77;25;1;24;.960;1623000;0
6743;86686;558;0;0;0;0;.00nan;0;0
6745;180738;555;0;0;0;0;.00nan;0;0
6745;36115;555;93;59;2;57;.966;3600000;0
6745;86422;552;0;0;0;0;.00nan;0;0
6745;88692;552;48;15;3;12;.800;3544000;0
6747;178789;554;98;20;0;20;1.000;3600000;0
6747;-1;554;0;0;0;0;.00nan;0;0
6747;46468;561;26;21;5;16;.762;1054000;0
6747;65324;561;45;30;4;26;.867;2546000;0
6749;169325;558;0;0;0;0;.00nan;0;0
6749;86422;552;55;29;4;25;.862;3870000;0
6749;86686;558;97;42;3;39;.929;3870000;0
6749;88692;552;0;0;0;0;.00nan;0;0
6751;2691;560;51;39;6;33;.846;3600000;0
6751;28989;2626;43;18;3;15;.833;3600000;0
6751;45584;2626;0;0;0;0;.00nan;0;0
6751;54860;560;0;0;0;0;.00nan;0;0
6753;180738;555;90;50;2;48;.960;3600000;0
6753;36115;555;0;0;0;0;.00nan;0;0
6753;80596;556;78;27;1;26;.963;3600000;0
6753;85349;556;0;0;0;0;.00nan;0;0
6755;10112;1423;0;0;0;0;.00nan;0;0
6755;27517;1423;79;43;3;40;.930;3600000;0
6755;70573;553;99;22;0;22;1.000;3600000;0
6755;144705;553;0;0;0;0;.00nan;0;0
1139;178789;554;0;0;0;0;.00nan;0;0
1139;-1;554;59;20;2;18;.900;3600000;0
1139;181071;560;38;40;6;34;.850;2842000;0
1139;54860;560;42;9;2;7;.778;758000;0
1140;28989;2626;34;23;5;18;.783;1112000;0
1140;45584;2626;76;35;3;32;.914;2488000;0
1140;86422;552;50;12;2;10;.833;3600000;0
1140;88692;552;0;0;0;0;.00nan;0;0
1141;169325;558;0;0;0;0;.00nan;0;0
1141;80596;556;0;0;0;0;.00nan;0;0
1141;85349;556;89;31;1;30;.968;3600000;0
1141;86686;558;72;36;3;33;.917;3600000;0
1142;46468;561;62;20;2;18;.900;3600000;0
1142;65324;561;0;0;0;0;.00nan;0;0
1142;70573;553;0;0;0;0;.00nan;0;0
1142;144705;553;71;33;3;30;.909;3566000;0
1143;178789;554;0;0;0;0;.00nan;0;0
1143;-1;554;61;19;2;17;.895;3600000;0
1143;181071;560;81;45;3;42;.933;3562000;0
1143;54860;560;0;0;0;0;.00nan;0;0
1144;28989;2626;17;37;8;29;.784;3600000;0
1144;45584;2626;0;0;0;0;.00nan;0;0
1144;86422;552;85;13;0;13;1.000;3600000;0
1144;88692;552;0;0;0;0;.00nan;0;0
1145;169325;558;0;0;0;0;.00nan;0;0
1145;80596;556;0;0;0;0;.00nan;0;0
1145;85349;556;63;30;3;27;.900;3600000;0
1145;86686;558;64;34;4;30;.882;3544000;0
1146;46468;561;47;25;5;20;.800;3571000;0
1146;65324;561;0;0;0;0;.00nan;0;0
1146;70573;553;0;0;0;0;.00nan;0;0
1146;144705;553;59;27;3;24;.889;3600000;0
1266;178789;554;0;0;0;0;.00nan;0;0
1266;-1;554;73;31;3;28;.903;3600000;0
1266;70573;553;74;21;1;20;.952;2854000;0
1266;144705;553;14;13;5;8;.615;746000;0
1267;80596;556;0;0;0;0;.00nan;0;0
1267;85349;556;86;34;2;32;.941;3600000;0
1267;86422;552;51;26;4;22;.846;3521000;0
1267;88692;552;0;0;0;0;.00nan;0;0
1343;178789;554;0;0;0;0;.00nan;0;0
1343;-1;554;79;26;1;25;.962;3600000;0
1343;80596;556;0;0;0;0;.00nan;0;0
1343;85349;556;72;29;2;27;.931;3597000;0
1344;70573;553;94;42;2;40;.952;3900000;0
1344;86422;552;94;33;2;31;.939;3900000;0
1344;88692;552;0;0;0;0;.00nan;0;0
1344;144705;553;0;0;0;0;.00nan;0;0
6776;163784;77;0;0;0;0;.00nan;0;0
6776;179411;4922;0;0;0;0;.00nan;0;0
6776;161046;4922;82;35;2;33;.943;3600000;0
6776;161047;77;66;35;3;32;.914;3569000;0
6777;173874;158;0;0;0;0;.00nan;0;0
6777;178911;152;47;31;5;26;.839;3600000;0
6777;178950;152;0;0;0;0;.00nan;0;0
6777;91398;158;79;26;2;24;.923;3600000;0
6778;180873;69;0;0;0;0;.00nan;0;0
6778;181446;71;0;0;0;0;.00nan;0;0
6778;46790;71;76;36;4;32;.889;3560000;0
6778;57215;69;62;21;2;19;.905;3600000;0
6779;-1;149;0;0;0;0;.00nan;0;0
6779;64722;149;49;20;3;17;.850;3900000;0
6779;85437;4921;0;0;0;0;.00nan;0;0
6779;85661;4921;91;46;3;43;.935;3900000;0
6780;183730;4245;0;0;0;0;.00nan;0;0
6780;-1;78;78;33;2;31;.939;3600000;0
6780;184398;4245;70;30;3;27;.900;3542000;0
6780;184437;78;0;0;0;0;.00nan;0;0
6781;171970;74;0;0;0;0;.00nan;0;0
6781;173856;75;66;39;3;36;.923;3797000;0
6781;170612;74;55;30;4;26;.867;3797000;0
6781;171615;75;0;0;0;0;.00nan;0;0
6782;164987;85;0;0;0;0;.00nan;0;0
6782;165380;67;0;0;0;0;.00nan;0;0
6782;44487;67;62;38;5;33;.868;3600000;0
6782;57207;85;69;25;2;23;.920;3600000;0
6783;168651;151;0;0;0;0;.00nan;0;0
6783;-1;80;84;29;2;27;.931;3600000;0
6783;142492;151;63;26;3;23;.885;3586000;0
6783;152851;80;0;0;0;0;.00nan;0;0
6784;171970;74;55;40;5;35;.875;3525000;0
6784;2495;1097;78;40;3;37;.925;3600000;0
6784;170612;74;0;0;0;0;.00nan;0;0
6784;170728;1097;0;0;0;0;.00nan;0;0
6785;166441;2564;0;0;0;0;.00nan;0;0
6785;-1;2564;60;48;6;42;.875;3600000;0
6785;-1;1095;0;0;0;0;.00nan;0;0
6785;176770;1095;100;24;0;24;1.000;3600000;0
6786;180873;69;0;0;0;0;.00nan;0;0
6786;181446;71;0;0;0;0;.00nan;0;0
6786;46790;71;70;20;1;19;.950;3600000;0
6786;57215;69;72;33;3;30;.909;3594000;0
6787;182339;82;91;36;1;35;.972;3600000;0
6787;173856;75;40;31;5;26;.839;3600000;0
6787;171615;75;0;0;0;0;.00nan;0;0
6787;185812;82;0;0;0;0;.00nan;0;0
6788;173874;158;0;0;0;0;.00nan;0;0
6788;178911;152;70;39;5;34;.872;3600000;0
6788;178950;152;0;0;0;0;.00nan;0;0
6788;91398;158;67;51;6;45;.882;3562000;0
6789;-1;149;0;0;0;0;.00nan;0;0
6789;64722;149;73;22;2;20;.909;3600000;0
6789;85437;4921;53;3;0;3;1.000;326000;0
6789;85661;4921;39;34;6;28;.824;3274000;0
6790;179411;4922;80;43;3;40;.930;3600000;0
6790;85555;76;44;26;4;22;.846;3589000;0
6790;91703;76;0;0;0;0;.00nan;0;0
6790;161046;4922;0;0;0;0;.00nan;0;0
6791;173823;73;0;0;0;0;.00nan;0;0
6791;44189;72;0;0;0;0;.00nan;0;0
6791;64811;72;34;26;6;20;.769;3600000;0
6791;86472;73;70;31;3;28;.903;3600000;0
6792;168651;151;0;0;0;0;.00nan;0;0
6792;-1;80;0;0;0;0;.00nan;0;0
6792;142492;151;88;38;2;36;.947;3600000;0
6792;152851;80;79;43;5;38;.884;3600000;0
6793;164987;85;0;0;0;0;.00nan;0;0
6793;165380;67;0;0;0;0;.00nan;0;0
6793;44487;67;88;47;4;43;.915;3600000;0
6793;57207;85;62;36;5;31;.861;3555000;0
6794;183730;4245;0;0;0;0;.00nan;0;0
6794;-1;78;0;0;0;0;.00nan;0;0
6794;184398;4245;89;30;1;29;.967;3600000;0
6794;184437;78;76;32;3;29;.906;3525000;0
6795;163784;77;0;0;0;0;.00nan;0;0
6795;171660;1096;56;25;3;22;.880;3543000;0
6795;-1;1096;0;0;0;0;.00nan;0;0
6795;161047;77;73;27;2;25;.926;3600000;0
6796;165611;81;0;0;0;0;.00nan;0;0
6796;19708;157;0;0;0;0;.00nan;0;0
6796;186520;157;56;15;2;13;.867;3600000;0
6796;70213;81;90;46;3;43;.935;3600000;0
6797;4487;4920;57;19;2;17;.895;2684000;0
6797;-1;4620;57;24;3;21;.875;3600000;0
6797;173961;4620;0;0;0;0;.00nan;0;0
6797;149450;4920;25;11;4;7;.636;916000;0
6798;183730;4245;50;19;3;16;.842;3600000;0
6798;-1;78;60;40;4;36;.900;3575000;0
6798;184398;4245;0;0;0;0;.00nan;0;0
6798;184437;78;0;0;0;0;.00nan;0;0
6799;165611;81;61;29;4;25;.862;3039000;0
6799;19708;157;0;0;0;0;.00nan;0;0
6799;186520;157;25;26;6;20;.769;3600000;0
6799;70213;81;33;11;3;8;.727;532000;0
6800;164987;85;64;32;3;29;.906;3600000;0
6800;-1;4620;86;17;0;17;1.000;3600000;0
6800;173961;4620;0;0;0;0;.00nan;0;0
6800;57207;85;0;0;0;0;.00nan;0;0
6801;168651;151;72;31;2;29;.935;3683000;0
6801;-1;80;0;0;0;0;.00nan;0;0
6801;142492;151;0;0;0;0;.00nan;0;0
6801;152851;80;72;36;3;33;.917;3683000;0
6802;173823;73;0;0;0;0;.00nan;0;0
6802;181446;71;0;0;0;0;.00nan;0;0
6802;46790;71;92;30;1;29;.967;3900000;0
6802;86472;73;97;34;1;33;.971;3900000;0
6803;-1;4620;48;10;2;8;.800;3600000;0
6803;173856;75;89;46;3;43;.935;3203000;0
6803;173961;4620;0;0;0;0;.00nan;0;0
6803;171615;75;24;5;3;2;.400;397000;0
6804;183730;4245;53;10;1;9;.900;890000;0
6804;184398;4245;5;16;6;10;.625;2710000;0
6804;171660;1096;0;0;0;0;.00nan;0;0
6804;-1;1096;100;51;1;50;.980;3600000;0
6805;180873;69;0;0;0;0;.00nan;0;0
6805;44189;72;0;0;0;0;.00nan;0;0
6805;57215;69;72;21;1;20;.952;3600000;0
6805;64811;72;59;30;4;26;.867;3600000;0
6806;182339;82;48;18;3;15;.833;3600000;0
6806;171970;74;45;35;6;29;.829;2745000;0
6806;170612;74;36;6;2;4;.667;855000;0
6806;185812;82;0;0;0;0;.00nan;0;0
6807;173823;73;92;41;3;38;.927;3600000;0
6807;-1;1095;0;0;0;0;.00nan;0;0
6807;176770;1095;44;33;5;28;.848;3519000;0
6807;86472;73;0;0;0;0;.00nan;0;0
6808;4487;4920;0;0;0;0;.00nan;0;0
6808;165380;67;0;0;0;0;.00nan;0;0
6808;44487;67;95;46;4;42;.913;3570000;0
6808;149450;4920;69;29;2;27;.931;3600000;0
6809;-1;4620;78;10;0;10;1.000;3600000;0
6809;173856;75;97;45;2;43;.956;3540000;0
6809;173961;4620;0;0;0;0;.00nan;0;0
6809;171615;75;0;0;0;0;.00nan;0;0
6810;-1;149;0;0;0;0;.00nan;0;0
6810;168651;151;0;0;0;0;.00nan;0;0
6810;64722;149;69;25;3;22;.880;3900000;0
6810;142492;151;67;36;3;33;.917;3900000;0
6811;19708;157;43;24;5;19;.792;3900000;0
6811;173874;158;0;0;0;0;.00nan;0;0
6811;186520;157;0;0;0;0;.00nan;0;0
6811;91398;158;55;40;5;35;.875;3900000;0
6812;166441;2564;0;0;0;0;.00nan;0;0
6812;-1;80;0;0;0;0;.00nan;0;0
6812;-1;2564;64;31;3;28;.903;3586000;0
6812;152851;80;58;18;2;16;.889;3600000;0
6813;4487;4920;67;25;3;22;.880;3600000;0
6813;165380;67;89;58;5;53;.914;3585000;0
6813;44487;67;0;0;0;0;.00nan;0;0
6813;149450;4920;0;0;0;0;.00nan;0;0
6814;2495;1097;0;0;0;0;.00nan;0;0
6814;178911;152;0;0;0;0;.00nan;0;0
6814;178950;152;84;22;1;21;.955;3600000;0
6814;170728;1097;51;24;3;21;.875;3530000;0
6815;179411;4922;92;60;3;57;.950;3552000;0
6815;85555;76;70;27;2;25;.926;3600000;0
6815;91703;76;0;0;0;0;.00nan;0;0
6815;161046;4922;0;0;0;0;.00nan;0;0
6816;-1;1095;99;36;1;35;.972;3600000;0
6816;176770;1095;0;0;0;0;.00nan;0;0
6816;180873;69;63;42;5;37;.881;3600000;0
6816;57215;69;0;0;0;0;.00nan;0;0
6817;173823;73;0;0;0;0;.00nan;0;0
6817;181446;71;0;0;0;0;.00nan;0;0
6817;46790;71;60;18;2;16;.889;3569000;0
6817;86472;73;75;26;1;25;.962;3600000;0
6818;183730;4245;70;35;4;31;.886;3570000;0
6818;184398;4245;0;0;0;0;.00nan;0;0
6818;171660;1096;0;0;0;0;.00nan;0;0
6818;-1;1096;75;33;3;30;.909;3600000;0
6819;-1;149;100;24;0;24;1.000;3600000;0
6819;168651;151;53;31;4;27;.871;3600000;0
6819;64722;149;0;0;0;0;.00nan;0;0
6819;142492;151;0;0;0;0;.00nan;0;0
6820;164987;85;0;0;0;0;.00nan;0;0
6820;-1;78;0;0;0;0;.00nan;0;0
6820;184437;78;71;19;1;18;.947;3600000;0
6820;57207;85;66;37;4;33;.892;3600000;0
6821;165611;81;49;21;3;18;.857;3573000;0
6821;-1;2564;0;0;0;0;.00nan;0;0
6821;70213;81;0;0;0;0;.00nan;0;0
6821;161047;2564;79;36;2;34;.944;3600000;0
6822;19708;157;0;0;0;0;.00nan;0;0
6822;173874;158;41;26;4;22;.846;3600000;0
6822;186520;157;84;22;1;21;.955;3600000;0
6822;91398;158;0;0;0;0;.00nan;0;0
6823;-1;80;69;14;1;13;.929;3600000;0
6823;85437;4921;0;0;0;0;.00nan;0;0
6823;85661;4921;89;39;2;37;.949;3600000;0
6823;152851;80;0;0;0;0;.00nan;0;0
6824;2495;1097;60;4;0;4;1.000;433000;0
6824;178911;152;55;34;5;29;.853;3600000;0
6824;178950;152;0;0;0;0;.00nan;0;0
6824;170728;1097;31;29;6;23;.793;3118000;0
6825;183730;4245;0;0;0;0;.00nan;0;0
6825;184398;4245;47;35;5;30;.857;3600000;0
6825;171660;1096;0;0;0;0;.00nan;0;0
6825;-1;1096;60;28;4;24;.857;3600000;0
6826;-1;4620;54;29;4;25;.862;3548000;0
6826;173856;75;0;0;0;0;.00nan;0;0
6826;173961;4620;0;0;0;0;.00nan;0;0
6826;171615;75;86;42;3;39;.929;3600000;0
6827;163784;77;0;0;0;0;.00nan;0;0
6827;64961;77;92;40;2;38;.950;3600000;0
6827;85555;76;0;0;0;0;.00nan;0;0
6827;91703;76;37;14;3;11;.786;3577000;0
6828;164987;85;92;42;3;39;.929;3587000;0
6828;-1;78;75;20;1;19;.950;3600000;0
6828;184437;78;0;0;0;0;.00nan;0;0
6828;57207;85;0;0;0;0;.00nan;0;0
6829;165611;81;0;0;0;0;.00nan;0;0
6829;-1;2564;63;31;3;28;.903;3566000;0
6829;70213;81;77;29;2;27;.931;3600000;0
6829;161047;2564;0;0;0;0;.00nan;0;0
6830;-1;80;0;0;0;0;.00nan;0;0
6830;85437;4921;70;31;3;28;.903;3550000;0
6830;85661;4921;0;0;0;0;.00nan;0;0
6830;152851;80;59;21;2;19;.905;3600000;0
6831;-1;149;81;22;1;21;.955;3600000;0
6831;168651;151;0;0;0;0;.00nan;0;0
6831;64722;149;0;0;0;0;.00nan;0;0
6831;142492;151;69;28;3;25;.893;3573000;0
6832;182339;82;0;0;0;0;.00nan;0;0
6832;2495;1097;0;0;0;0;.00nan;0;0
6832;170728;1097;82;35;2;33;.943;3570000;0
6832;185812;82;75;25;1;24;.960;3600000;0
6833;163784;77;0;0;0;0;.00nan;0;0
6833;179411;4922;81;39;3;36;.923;3569000;0
6833;64961;77;78;26;2;24;.923;3600000;0
6833;161046;4922;0;0;0;0;.00nan;0;0
6834;-1;80;0;0;0;0;.00nan;0;0
6834;173874;158;79;21;1;20;.952;3064000;0
6834;91398;158;25;13;4;9;.692;836000;0
6834;152851;80;49;33;5;28;.848;3900000;0
6835;171660;1096;0;0;0;0;.00nan;0;0
6835;-1;1096;90;34;2;32;.941;3900000;0
6835;85555;76;53;17;2;15;.882;3900000;0
6835;91703;76;0;0;0;0;.00nan;0;0
6836;165611;81;69;28;2;26;.929;3600000;0
6836;178911;152;50;43;6;37;.860;2627000;0
6836;178950;152;50;10;1;9;.900;973000;0
6836;70213;81;0;0;0;0;.00nan;0;0
6837;2495;1097;4;42;10;32;.762;3022000;0
6837;170728;1097;56;7;1;6;.857;578000;0
6837;85555;76;0;0;0;0;.00nan;0;0
6837;91703;76;48;14;2;12;.857;3600000;0
6838;-1;2564;41;2;1;1;.500;735000;0
6838;85437;4921;0;0;0;0;.00nan;0;0
6838;85661;4921;74;31;3;28;.903;3600000;0
6838;161047;2564;15;23;6;17;.739;2865000;0
6839;163784;77;0;0;0;0;.00nan;0;0
6839;179411;4922;38;13;3;10;.769;1531000;0
6839;64961;77;69;38;3;35;.921;3600000;0
6839;161046;4922;24;23;6;17;.739;2069000;0
6840;182339;82;40;29;5;24;.828;3600000;0
6840;171970;74;68;28;2;26;.929;3600000;0
6840;170612;74;0;0;0;0;.00nan;0;0
6840;185812;82;0;0;0;0;.00nan;0;0
6841;-1;80;67;22;3;19;.864;3900000;0
6841;173874;158;0;0;0;0;.00nan;0;0
6841;91398;158;67;28;3;25;.893;3900000;0
6841;152851;80;0;0;0;0;.00nan;0;0
6842;173823;73;74;32;3;29;.906;3600000;0
6842;181446;71;0;0;0;0;.00nan;0;0
6842;46790;71;70;38;4;34;.895;3556000;0
6842;86472;73;0;0;0;0;.00nan;0;0
6843;-1;149;0;0;0;0;.00nan;0;0
6843;168651;151;0;0;0;0;.00nan;0;0
6843;64722;149;62;36;4;32;.889;3600000;0
6843;142492;151;65;27;3;24;.889;3600000;0
6844;165380;67;70;43;4;39;.907;3521000;0
6844;173856;75;83;32;2;30;.938;3600000;0
6844;171615;75;0;0;0;0;.00nan;0;0
6844;44487;67;0;0;0;0;.00nan;0;0
6845;-1;78;60;31;4;27;.871;3600000;0
6845;184437;78;0;0;0;0;.00nan;0;0
6845;44189;72;35;34;6;28;.824;3321000;0
6845;64811;72;51;2;0;2;1.000;246000;0
6846;164987;85;0;0;0;0;.00nan;0;0
6846;183730;4245;0;0;0;0;.00nan;0;0
6846;184398;4245;35;33;6;27;.818;3600000;0
6846;57207;85;100;33;1;32;.970;3600000;0
6847;165611;81;0;0;0;0;.00nan;0;0
6847;178911;152;58;14;1;13;.929;897000;0
6847;178950;152;3;13;6;7;.538;2686000;0
6847;70213;81;56;40;5;35;.875;3600000;0
6848;4487;4920;0;0;0;0;.00nan;0;0
6848;-1;4620;49;20;4;16;.800;3600000;0
6848;173961;4620;0;0;0;0;.00nan;0;0
6848;149450;4920;37;43;8;35;.814;3600000;0
6849;-1;2564;61;21;2;19;.905;3600000;0
6849;85437;4921;53;32;4;28;.875;3600000;0
6849;85661;4921;0;0;0;0;.00nan;0;0
6849;161047;2564;0;0;0;0;.00nan;0;0
6850;163784;77;0;0;0;0;.00nan;0;0
6850;179411;4922;76;30;2;28;.933;3600000;0
6850;64961;77;30;39;7;32;.821;3600000;0
6850;161046;4922;0;0;0;0;.00nan;0;0
6851;182339;82;0;0;0;0;.00nan;0;0
6851;185812;82;91;34;1;33;.971;3600000;0
6851;85555;76;78;31;2;29;.935;3545000;0
6851;91703;76;0;0;0;0;.00nan;0;0
6852;-1;80;0;0;0;0;.00nan;0;0
6852;173874;158;89;17;0;17;1.000;3600000;0
6852;91398;158;0;0;0;0;.00nan;0;0
6852;152851;80;58;49;6;43;.878;3600000;0
6853;173823;73;0;0;0;0;.00nan;0;0
6853;180873;69;0;0;0;0;.00nan;0;0
6853;57215;69;69;32;3;29;.906;3588000;0
6853;86472;73;89;33;2;31;.939;3600000;0
6854;-1;149;72;34;3;31;.912;3600000;0
6854;168651;151;77;34;2;32;.941;3600000;0
6854;64722;149;0;0;0;0;.00nan;0;0
6854;142492;151;0;0;0;0;.00nan;0;0
6855;165380;67;56;8;1;7;.875;582000;0
6855;173856;75;0;0;0;0;.00nan;0;0
6855;171615;75;100;32;0;32;1.000;3600000;0
6855;44487;67;68;41;6;35;.854;3018000;0
6856;171970;74;0;0;0;0;.00nan;0;0
6856;170612;74;97;45;1;44;.978;3600000;0
6856;171660;1096;62;22;2;20;.909;3554000;0
6856;-1;1096;0;0;0;0;.00nan;0;0
6857;181446;71;76;37;3;34;.919;3900000;0
6857;44189;72;0;0;0;0;.00nan;0;0
6857;46790;71;0;0;0;0;.00nan;0;0
6857;64811;72;81;34;3;31;.912;3900000;0
6858;164987;85;91;32;1;31;.969;3600000;0
6858;183730;4245;59;20;2;18;.900;3579000;0
6858;184398;4245;0;0;0;0;.00nan;0;0
6858;57207;85;0;0;0;0;.00nan;0;0
6859;-1;78;0;0;0;0;.00nan;0;0
6859;184437;78;37;17;4;13;.765;3600000;0
6859;-1;1095;67;26;2;24;.923;3600000;0
6859;176770;1095;0;0;0;0;.00nan;0;0
6860;4487;4920;84;28;1;27;.964;3691000;0
6860;-1;4620;0;0;0;0;.00nan;0;0
6860;173961;4620;72;31;2;29;.935;3691000;0
6860;149450;4920;0;0;0;0;.00nan;0;0
6861;2495;1097;0;0;0;0;.00nan;0;0
6861;170728;1097;71;37;4;33;.892;3600000;0
6861;171660;1096;0;0;0;0;.00nan;0;0
6861;-1;1096;68;34;3;31;.912;3600000;0
6862;165380;67;0;0;0;0;.00nan;0;0
6862;173856;75;26;19;5;14;.737;3600000;0
6862;171615;75;0;0;0;0;.00nan;0;0
6862;44487;67;99;55;2;53;.964;3600000;0
6863;182339;82;70;31;2;29;.935;3900000;0
6863;171970;74;93;48;2;46;.958;3900000;0
6863;170612;74;0;0;0;0;.00nan;0;0
6863;185812;82;0;0;0;0;.00nan;0;0
6864;164987;85;0;0;0;0;.00nan;0;0
6864;183730;4245;0;0;0;0;.00nan;0;0
6864;184398;4245;49;33;5;28;.848;3600000;0
6864;57207;85;72;31;2;29;.935;3600000;0
6865;165611;81;44;31;4;27;.871;3600000;0
6865;-1;149;0;0;0;0;.00nan;0;0
6865;64722;149;81;24;1;23;.958;3600000;0
6865;70213;81;0;0;0;0;.00nan;0;0
6866;-1;78;69;49;4;45;.918;3597000;0
6866;184437;78;0;0;0;0;.00nan;0;0
6866;-1;1095;0;0;0;0;.00nan;0;0
6866;176770;1095;58;25;3;22;.880;3600000;0
6867;168651;151;0;0;0;0;.00nan;0;0
6867;178911;152;70;15;1;14;.933;3600000;0
6867;178950;152;0;0;0;0;.00nan;0;0
6867;142492;151;33;31;6;25;.806;3600000;0
6868;163784;77;78;56;5;51;.911;3600000;0
6868;171660;1096;0;0;0;0;.00nan;0;0
6868;-1;1096;65;22;2;20;.909;3600000;0
6868;64961;77;0;0;0;0;.00nan;0;0
6869;4487;4920;0;0;0;0;.00nan;0;0
6869;-1;4620;65;17;1;16;.941;3600000;0
6869;173961;4620;0;0;0;0;.00nan;0;0
6869;149450;4920;34;32;7;25;.781;3600000;0
6870;173823;73;0;0;0;0;.00nan;0;0
6870;85437;4921;0;0;0;0;.00nan;0;0
6870;85661;4921;100;51;1;50;.980;3600000;0
6870;86472;73;62;25;2;23;.920;3593000;0
6871;-1;78;0;0;0;0;.00nan;0;0
6871;173856;75;76;41;4;37;.902;3546000;0
6871;184437;78;43;16;3;13;.813;3600000;0
6871;171615;75;0;0;0;0;.00nan;0;0
6872;-1;80;56;37;5;32;.865;3578000;0
6872;19708;157;0;0;0;0;.00nan;0;0
6872;186520;157;59;24;3;21;.875;3600000;0
6872;152851;80;0;0;0;0;.00nan;0;0
6873;173823;73;43;23;4;19;.826;3600000;0
6873;85437;4921;67;49;5;44;.898;3571000;0
6873;85661;4921;0;0;0;0;.00nan;0;0
6873;86472;73;0;0;0;0;.00nan;0;0
6874;183730;4245;41;22;4;18;.818;2593000;0
6874;-1;4620;100;22;0;22;1.000;3600000;0
6874;173961;4620;0;0;0;0;.00nan;0;0
6874;184398;4245;28;16;4;12;.750;1007000;0
6875;165611;81;0;0;0;0;.00nan;0;0
6875;-1;149;0;0;0;0;.00nan;0;0
6875;64722;149;70;31;3;28;.903;3600000;0
6875;70213;81;100;25;0;25;1.000;3600000;0
6876;4487;4920;40;26;5;21;.808;3540000;0
6876;173856;75;73;40;4;36;.900;3600000;0
6876;171615;75;0;0;0;0;.00nan;0;0
6876;149450;4920;0;0;0;0;.00nan;0;0
6877;168651;151;0;0;0;0;.00nan;0;0
6877;178911;152;44;32;5;27;.844;3600000;0
6877;178950;152;0;0;0;0;.00nan;0;0
6877;142492;151;99;34;1;33;.971;3600000;0
6878;180873;69;0;0;0;0;.00nan;0;0
6878;44189;72;0;0;0;0;.00nan;0;0
6878;57215;69;74;39;3;36;.923;3600000;0
6878;64811;72;89;21;0;21;1.000;3600000;0
6879;182339;82;0;0;0;0;.00nan;0;0
6879;179411;4922;0;0;0;0;.00nan;0;0
6879;185812;82;80;24;1;23;.958;3600000;0
6879;161046;4922;70;41;4;37;.902;3600000;0
6880;-1;2564;85;44;3;41;.932;3562000;0
6880;181446;71;0;0;0;0;.00nan;0;0
6880;46790;71;90;30;2;28;.933;3600000;0
6880;161047;2564;0;0;0;0;.00nan;0;0
6881;164987;85;0;0;0;0;.00nan;0;0
6881;165380;67;0;0;0;0;.00nan;0;0
6881;44487;67;87;25;1;24;.960;3576000;0
6881;57207;85;97;26;0;26;1.000;3600000;0
6882;183730;4245;0;0;0;0;.00nan;0;0
6882;-1;4620;48;20;3;17;.850;3845000;0
6882;173961;4620;0;0;0;0;.00nan;0;0
6882;184398;4245;73;42;4;38;.905;3845000;0
6883;165611;81;0;0;0;0;.00nan;0;0
6883;-1;149;73;26;2;24;.923;3600000;0
6883;64722;149;0;0;0;0;.00nan;0;0
6883;70213;81;70;37;3;34;.919;3564000;0
6884;171970;74;60;39;5;34;.872;3559000;0
6884;163784;77;0;0;0;0;.00nan;0;0
6884;170612;74;0;0;0;0;.00nan;0;0
6884;64961;77;54;31;4;27;.871;3600000;0
6885;2495;1097;0;0;0;0;.00nan;0;0
6885;170728;1097;88;35;3;32;.914;3600000;0
6885;171660;1096;0;0;0;0;.00nan;0;0
6885;-1;1096;52;37;5;32;.865;3549000;0
6886;-1;80;52;29;3;26;.897;3900000;0
6886;19708;157;80;38;3;35;.921;3900000;0
6886;186520;157;0;0;0;0;.00nan;0;0
6886;152851;80;0;0;0;0;.00nan;0;0
6887;173874;158;87;31;2;29;.935;3600000;0
6887;-1;1095;0;0;0;0;.00nan;0;0
6887;176770;1095;51;28;4;24;.857;3561000;0
6887;91398;158;0;0;0;0;.00nan;0;0
6888;168651;151;100;29;0;29;1.000;3600000;0
6888;178911;152;0;0;0;0;.00nan;0;0
6888;178950;152;57;33;3;30;.909;3600000;0
6888;142492;151;0;0;0;0;.00nan;0;0
6889;2495;1097;65;31;3;28;.903;3543000;0
6889;170728;1097;0;0;0;0;.00nan;0;0
6889;179411;4922;99;46;1;45;.978;3600000;0
6889;161046;4922;0;0;0;0;.00nan;0;0
6890;-1;2564;0;0;0;0;.00nan;0;0
6890;181446;71;43;20;4;16;.800;3600000;0
6890;46790;71;0;0;0;0;.00nan;0;0
6890;161047;2564;41;34;6;28;.824;3586000;0
6891;182339;82;60;40;5;35;.875;3600000;0
6891;185812;82;0;0;0;0;.00nan;0;0
6891;85555;76;73;24;1;23;.958;3600000;0
6891;91703;76;0;0;0;0;.00nan;0;0
6892;173823;73;54;30;4;26;.867;3586000;0
6892;85437;4921;0;0;0;0;.00nan;0;0
6892;85661;4921;66;27;3;24;.889;3600000;0
6892;86472;73;0;0;0;0;.00nan;0;0
6893;4487;4920;0;0;0;0;.00nan;0;0
6893;165380;67;91;47;3;44;.936;3900000;0
6893;44487;67;0;0;0;0;.00nan;0;0
6893;149450;4920;63;23;3;20;.870;3900000;0
6894;171970;74;0;0;0;0;.00nan;0;0
6894;163784;77;88;51;4;47;.922;3600000;0
6894;170612;74;71;18;1;17;.944;3600000;0
6894;64961;77;0;0;0;0;.00nan;0;0
6895;165611;81;77;28;2;26;.929;3600000;0
6895;-1;149;0;0;0;0;.00nan;0;0
6895;64722;149;85;38;3;35;.921;3600000;0
6895;70213;81;0;0;0;0;.00nan;0;0
6896;-1;78;0;0;0;0;.00nan;0;0
6896;173856;75;0;0;0;0;.00nan;0;0
6896;184437;78;53;16;2;14;.875;3600000;0
6896;171615;75;65;45;5;40;.889;3600000;0
6897;180873;69;90;36;1;35;.972;3900000;0
6897;44189;72;0;0;0;0;.00nan;0;0
6897;57215;69;0;0;0;0;.00nan;0;0
6897;64811;72;77;26;1;25;.962;3900000;0
6898;-1;80;0;0;0;0;.00nan;0;0
6898;19708;157;0;0;0;0;.00nan;0;0
6898;186520;157;82;37;2;35;.946;3600000;0
6898;152851;80;39;30;5;25;.833;3600000;0
6899;173874;158;0;0;0;0;.00nan;0;0
6899;-1;1095;36;28;5;23;.821;3600000;0
6899;176770;1095;0;0;0;0;.00nan;0;0
6899;91398;158;86;31;2;29;.935;3600000;0
6900;4487;4920;71;28;2;26;.929;3553000;0
6900;164987;85;0;0;0;0;.00nan;0;0
6900;57207;85;70;18;1;17;.944;3600000;0
6900;149450;4920;0;0;0;0;.00nan;0;0
6901;168651;151;99;47;2;45;.957;3600000;0
6901;178911;152;65;25;3;22;.880;3545000;0
6901;178950;152;0;0;0;0;.00nan;0;0
6901;142492;151;0;0;0;0;.00nan;0;0
6902;2495;1097;0;0;0;0;.00nan;0;0
6902;170728;1097;90;30;1;29;.967;3600000;0
6902;179411;4922;0;0;0;0;.00nan;0;0
6902;161046;4922;64;38;4;34;.895;3600000;0
6903;182339;82;92;39;1;38;.974;2697000;0
6903;185812;82;21;14;4;10;.714;865000;0
6903;85555;76;0;0;0;0;.00nan;0;0
6903;91703;76;50;21;3;18;.857;3600000;0
6904;183730;4245;79;33;2;31;.939;3600000;0
6904;-1;4620;71;31;3;28;.903;3544000;0
6904;173961;4620;0;0;0;0;.00nan;0;0
6904;184398;4245;0;0;0;0;.00nan;0;0
6905;180873;69;0;0;0;0;.00nan;0;0
6905;44189;72;54;28;4;24;.857;3600000;0
6905;57215;69;57;42;5;37;.881;3600000;0
6905;64811;72;0;0;0;0;.00nan;0;0
6906;173874;158;0;0;0;0;.00nan;0;0
6906;-1;1095;0;0;0;0;.00nan;0;0
6906;176770;1095;59;23;3;20;.870;3600000;0
6906;91398;158;97;43;2;41;.953;3600000;0
6907;182339;82;23;11;4;7;.636;1100000;0
6907;2495;1097;0;0;0;0;.00nan;0;0
6907;170728;1097;100;29;0;29;1.000;3600000;0
6907;185812;82;94;24;0;24;1.000;2500000;0
6908;-1;2564;69;27;3;24;.889;3541000;0
6908;180873;69;0;0;0;0;.00nan;0;0
6908;57215;69;99;36;2;34;.944;3600000;0
6908;161047;2564;0;0;0;0;.00nan;0;0
6909;163784;77;0;0;0;0;.00nan;0;0
6909;179411;4922;66;21;1;20;.952;3600000;0
6909;64961;77;81;33;3;30;.909;3548000;0
6909;161046;4922;0;0;0;0;.00nan;0;0
6910;173874;158;0;0;0;0;.00nan;0;0
6910;178911;152;1;15;7;8;.533;1874000;0
6910;178950;152;63;15;1;14;.933;1726000;0
6910;91398;158;86;39;3;36;.923;3600000;0
6911;19708;157;0;0;0;0;.00nan;0;0
6911;186520;157;98;23;0;23;1.000;3600000;0
6911;85437;4921;98;47;2;45;.957;3565000;0
6911;85661;4921;0;0;0;0;.00nan;0;0
6912;171660;1096;0;0;0;0;.00nan;0;0
6912;-1;1096;55;34;5;29;.853;3600000;0
6912;85555;76;0;0;0;0;.00nan;0;0
6912;91703;76;100;27;0;27;1.000;3600000;0
6913;-1;1095;0;0;0;0;.00nan;0;0
6913;176770;1095;76;32;2;30;.938;3600000;0
6913;44189;72;0;0;0;0;.00nan;0;0
6913;64811;72;38;32;6;26;.813;3600000;0
6914;182339;82;0;0;0;0;.00nan;0;0
6914;171970;74;72;43;4;39;.907;3678000;0
6914;170612;74;0;0;0;0;.00nan;0;0
6914;185812;82;53;21;3;18;.857;3678000;0
6915;2495;1097;0;0;0;0;.00nan;0;0
6915;170728;1097;78;26;1;25;.962;3600000;0
6915;179411;4922;0;0;0;0;.00nan;0;0
6915;161046;4922;51;36;5;31;.861;3600000;0
6916;173874;158;0;0;0;0;.00nan;0;0
6916;178911;152;77;46;5;41;.891;3600000;0
6916;178950;152;0;0;0;0;.00nan;0;0
6916;91398;158;40;33;6;27;.818;3588000;0
6917;-1;1095;0;0;0;0;.00nan;0;0
6917;176770;1095;68;22;2;20;.909;3600000;0
6917;181446;71;0;0;0;0;.00nan;0;0
6917;46790;71;63;38;5;33;.868;3600000;0
6918;19708;157;0;0;0;0;.00nan;0;0
6918;186520;157;47;16;3;13;.813;3600000;0
6918;85437;4921;0;0;0;0;.00nan;0;0
6918;85661;4921;51;37;6;31;.838;3600000;0
6919;182339;82;100;54;2;52;.963;3600000;0
6919;185812;82;0;0;0;0;.00nan;0;0
6919;85555;76;36;24;5;19;.792;3600000;0
6919;91703;76;0;0;0;0;.00nan;0;0
6920;4487;4920;0;0;0;0;.00nan;0;0
6920;173856;75;63;41;5;36;.878;3521000;0
6920;171615;75;0;0;0;0;.00nan;0;0
6920;149450;4920;76;35;3;32;.914;3600000;0
6921;183730;4245;0;0;0;0;.00nan;0;0
6921;-1;78;59;33;4;29;.879;3900000;0
6921;184398;4245;67;33;4;29;.879;3900000;0
6921;184437;78;0;0;0;0;.00nan;0;0
6922;171970;74;0;0;0;0;.00nan;0;0
6922;170612;74;79;25;1;24;.960;3600000;0
6922;171660;1096;0;0;0;0;.00nan;0;0
6922;-1;1096;65;25;2;23;.920;3577000;0
6923;173823;73;0;0;0;0;.00nan;0;0
6923;44189;72;65;21;1;20;.952;3600000;0
6923;64811;72;0;0;0;0;.00nan;0;0
6923;86472;73;67;28;2;26;.929;3550000;0
6924;164987;85;0;0;0;0;.00nan;0;0
6924;165380;67;0;0;0;0;.00nan;0;0
6924;44487;67;89;42;3;39;.929;3580000;0
6924;57207;85;74;27;2;25;.926;3600000;0
6925;165611;81;0;0;0;0;.00nan;0;0
6925;168651;151;0;0;0;0;.00nan;0;0
6925;70213;81;43;32;5;27;.844;3600000;0
6925;142492;151;83;31;2;29;.935;3600000;0
6926;-1;149;0;0;0;0;.00nan;0;0
6926;-1;80;83;35;3;32;.914;3565000;0
6926;64722;149;88;35;1;34;.971;3600000;0
6926;152851;80;0;0;0;0;.00nan;0;0
6927;-1;4620;58;20;2;18;.900;3600000;0
6927;173961;4620;0;0;0;0;.00nan;0;0
6927;-1;2564;56;53;6;47;.887;3600000;0
6927;161047;2564;0;0;0;0;.00nan;0;0
6928;2495;1097;24;25;6;19;.760;3600000;0
6928;170728;1097;0;0;0;0;.00nan;0;0
6928;179411;4922;100;34;1;33;.971;3600000;0
6928;161046;4922;0;0;0;0;.00nan;0;0
6929;180873;69;69;36;3;33;.917;3900000;0
6929;44189;72;0;0;0;0;.00nan;0;0
6929;57215;69;0;0;0;0;.00nan;0;0
6929;64811;72;64;26;3;23;.885;3900000;0
6930;173874;158;93;40;3;37;.925;3900000;0
6930;178911;152;0;0;0;0;.00nan;0;0
6930;178950;152;64;28;3;25;.893;3900000;0
6930;91398;158;0;0;0;0;.00nan;0;0
6931;173823;73;90;31;1;30;.968;3600000;0
6931;181446;71;50;35;5;30;.857;3209000;0
6931;46790;71;52;2;0;2;1.000;391000;0
6931;86472;73;0;0;0;0;.00nan;0;0
6932;19708;157;42;25;5;20;.800;3567000;0
6932;186520;157;0;0;0;0;.00nan;0;0
6932;85437;4921;81;37;3;34;.919;3600000;0
6932;85661;4921;0;0;0;0;.00nan;0;0
6933;182339;82;0;0;0;0;.00nan;0;0
6933;185812;82;58;33;4;29;.879;3544000;0
6933;85555;76;0;0;0;0;.00nan;0;0
6933;91703;76;71;23;2;21;.913;3600000;0
6934;183730;4245;66;37;4;33;.892;3754000;0
6934;-1;78;0;0;0;0;.00nan;0;0
6934;184398;4245;0;0;0;0;.00nan;0;0
6934;184437;78;79;33;3;30;.909;3754000;0
6935;171970;74;81;23;1;22;.957;3600000;0
6935;163784;77;0;0;0;0;.00nan;0;0
6935;170612;74;0;0;0;0;.00nan;0;0
6935;64961;77;60;22;2;20;.909;3579000;0
6936;164987;85;49;21;3;18;.857;3600000;0
6936;165380;67;44;5;1;4;.800;508000;0
6936;44487;67;51;42;6;36;.857;3092000;0
6936;57207;85;0;0;0;0;.00nan;0;0
6937;165611;81;76;26;1;25;.962;3600000;0
6937;168651;151;69;33;3;30;.909;3555000;0
6937;70213;81;0;0;0;0;.00nan;0;0
6937;142492;151;0;0;0;0;.00nan;0;0
6938;-1;149;0;0;0;0;.00nan;0;0
6938;-1;80;0;0;0;0;.00nan;0;0
6938;64722;149;48;28;4;24;.857;3600000;0
6938;152851;80;52;39;5;34;.872;3572000;0
6939;-1;4620;0;0;0;0;.00nan;0;0
6939;173961;4620;69;22;1;21;.955;3600000;0
6939;-1;2564;0;0;0;0;.00nan;0;0
6939;161047;2564;71;33;2;31;.939;3566000;0
6940;-1;1095;0;0;0;0;.00nan;0;0
6940;176770;1095;68;24;2;22;.917;3600000;0
6940;180873;69;0;0;0;0;.00nan;0;0
6940;57215;69;49;21;3;18;.857;3557000;0
6941;181446;71;39;1;1;0;.000;882000;0
6941;44189;72;59;29;4;25;.862;3600000;0
6941;46790;71;20;24;6;18;.750;2718000;0
6941;64811;72;0;0;0;0;.00nan;0;0
6942;4487;4920;0;0;0;0;.00nan;0;0
6942;173856;75;39;40;7;33;.825;2792000;0
6942;171615;75;48;6;1;5;.833;808000;0
6942;149450;4920;84;18;0;18;1.000;3600000;0
6943;163784;77;65;34;3;31;.912;3600000;0
6943;171660;1096;50;42;6;36;.857;2842000;0
6943;-1;1096;49;2;0;2;1.000;758000;0
6943;64961;77;0;0;0;0;.00nan;0;0
6944;-1;149;0;0;0;0;.00nan;0;0
6944;-1;80;86;39;3;36;.923;3600000;0
6944;64722;149;55;27;5;22;.815;3581000;0
6944;152851;80;0;0;0;0;.00nan;0;0
6945;165380;67;41;41;7;34;.829;3600000;0
6945;-1;4620;93;19;0;19;1.000;3600000;0
6945;173961;4620;0;0;0;0;.00nan;0;0
6945;44487;67;0;0;0;0;.00nan;0;0
6946;4487;4920;0;0;0;0;.00nan;0;0
6946;-1;78;17;21;6;15;.714;1215000;0
6946;184437;78;84;22;0;22;1.000;2345000;0
6946;149450;4920;63;33;4;29;.879;3600000;0
6947;182339;82;22;26;6;20;.769;3600000;0
6947;2495;1097;0;0;0;0;.00nan;0;0
6947;170728;1097;93;19;0;19;1.000;3600000;0
6947;185812;82;0;0;0;0;.00nan;0;0
6948;-1;2564;76;41;3;38;.927;3591000;0
6948;181446;71;0;0;0;0;.00nan;0;0
6948;46790;71;62;21;2;19;.905;3600000;0
6948;161047;2564;0;0;0;0;.00nan;0;0
6949;171660;1096;0;0;0;0;.00nan;0;0
6949;-1;1096;63;40;4;36;.900;3548000;0
6949;85555;76;95;37;2;35;.946;3600000;0
6949;91703;76;0;0;0;0;.00nan;0;0
6950;173823;73;0;0;0;0;.00nan;0;0
6950;85437;4921;0;0;0;0;.00nan;0;0
6950;85661;4921;65;30;3;27;.900;3600000;0
6950;86472;73;41;24;4;20;.833;3550000;0
6951;164987;85;0;0;0;0;.00nan;0;0
6951;173856;75;0;0;0;0;.00nan;0;0
6951;171615;75;94;52;2;50;.962;3812000;0
6951;57207;85;68;17;1;16;.941;3812000;0
6952;171970;74;49;29;4;25;.862;3600000;0
6952;163784;77;0;0;0;0;.00nan;0;0
6952;170612;74;0;0;0;0;.00nan;0;0
6952;64961;77;61;40;5;35;.875;3600000;0
6953;-1;149;0;0;0;0;.00nan;0;0
6953;173874;158;0;0;0;0;.00nan;0;0
6953;64722;149;56;29;4;25;.862;3600000;0
6953;91398;158;81;36;3;33;.917;3600000;0
6954;165611;81;0;0;0;0;.00nan;0;0
6954;168651;151;72;43;4;39;.907;3572000;0
6954;70213;81;94;42;2;40;.952;3600000;0
6954;142492;151;0;0;0;0;.00nan;0;0
6955;183730;4245;0;0;0;0;.00nan;0;0
6955;19708;157;0;0;0;0;.00nan;0;0
6955;184398;4245;91;30;1;29;.967;3900000;0
6955;186520;157;78;27;1;26;.963;3900000;0
6956;-1;1095;69;26;2;24;.923;3600000;0
6956;176770;1095;0;0;0;0;.00nan;0;0
6956;44189;72;34;30;6;24;.800;3600000;0
6956;64811;72;0;0;0;0;.00nan;0;0
6957;-1;80;0;0;0;0;.00nan;0;0
6957;178911;152;68;35;4;31;.886;3539000;0
6957;178950;152;0;0;0;0;.00nan;0;0
6957;152851;80;77;27;2;25;.926;3600000;0
6958;180873;69;42;25;5;20;.800;3552000;0
6958;57215;69;0;0;0;0;.00nan;0;0
6958;85437;4921;75;40;4;36;.900;3600000;0
6958;85661;4921;0;0;0;0;.00nan;0;0
6959;4487;4920;0;0;0;0;.00nan;0;0
6959;-1;4620;96;20;0;20;1.000;3600000;0
6959;173961;4620;0;0;0;0;.00nan;0;0
6959;149450;4920;79;32;2;30;.938;3567000;0
6960;171970;74;23;11;4;7;.636;853000;0
6960;2495;1097;0;0;0;0;.00nan;0;0
6960;170612;74;54;23;3;20;.870;2747000;0
6960;170728;1097;76;28;2;26;.929;3600000;0
6961;-1;2564;57;33;4;29;.879;3600000;0
6961;-1;1095;34;37;7;30;.811;3600000;0
6961;176770;1095;0;0;0;0;.00nan;0;0
6961;161047;2564;0;0;0;0;.00nan;0;0
6962;180873;69;0;0;0;0;.00nan;0;0
6962;181446;71;79;37;2;35;.946;3600000;0
6962;46790;71;0;0;0;0;.00nan;0;0
6962;57215;69;60;34;4;30;.882;3600000;0
6963;179411;4922;41;30;5;25;.833;2642000;0
6963;85555;76;0;0;0;0;.00nan;0;0
6963;91703;76;73;16;1;15;.938;3600000;0
6963;161046;4922;38;16;4;12;.750;958000;0
6964;168651;151;86;31;1;30;.968;3642000;0
6964;-1;80;72;24;2;22;.917;3642000;0
6964;142492;151;0;0;0;0;.00nan;0;0
6964;152851;80;0;0;0;0;.00nan;0;0
6965;165380;67;64;20;2;18;.900;3349000;0
6965;-1;78;0;0;0;0;.00nan;0;0
6965;184437;78;83;23;1;22;.957;3600000;0
6965;44487;67;29;8;3;5;.625;251000;0
6966;164987;85;0;0;0;0;.00nan;0;0
6966;173856;75;0;0;0;0;.00nan;0;0
6966;171615;75;71;37;3;34;.919;3547000;0
6966;57207;85;65;18;2;16;.889;3600000;0
6967;-1;149;72;39;4;35;.897;3592000;0
6967;173874;158;0;0;0;0;.00nan;0;0
6967;64722;149;0;0;0;0;.00nan;0;0
6967;91398;158;75;25;2;23;.920;3600000;0
6968;182339;82;38;33;6;27;.818;3600000;0
6968;171660;1096;73;33;3;30;.909;3600000;0
6968;-1;1096;0;0;0;0;.00nan;0;0
6968;185812;82;0;0;0;0;.00nan;0;0
6969;173823;73;0;0;0;0;.00nan;0;0
6969;44189;72;0;0;0;0;.00nan;0;0
6969;64811;72;77;34;3;31;.912;3862000;0
6969;86472;73;80;30;2;28;.933;3862000;0
6970;165611;81;0;0;0;0;.00nan;0;0
6970;178911;152;81;34;3;31;.912;3515000;0
6970;178950;152;0;0;0;0;.00nan;0;0
6970;70213;81;91;28;1;27;.964;3600000;0
6971;183730;4245;14;5;4;1;.200;729000;0
6971;19708;157;87;38;3;35;.921;3600000;0
6971;184398;4245;42;25;3;22;.880;2871000;0
6971;186520;157;0;0;0;0;.00nan;0;0
6972;4487;4920;80;30;2;28;.933;3600000;0
6972;-1;4620;56;31;4;27;.871;3589000;0
6972;173961;4620;0;0;0;0;.00nan;0;0
6972;149450;4920;0;0;0;0;.00nan;0;0
6973;182339;82;0;0;0;0;.00nan;0;0
6973;2495;1097;85;32;2;30;.938;3900000;0
6973;170728;1097;0;0;0;0;.00nan;0;0
6973;185812;82;92;45;2;43;.956;3900000;0
6974;180873;69;53;23;3;20;.870;3600000;0
6974;44189;72;47;28;5;23;.821;3559000;0
6974;57215;69;0;0;0;0;.00nan;0;0
6974;64811;72;0;0;0;0;.00nan;0;0
6975;171970;74;41;43;7;36;.837;3600000;0
6975;170612;74;0;0;0;0;.00nan;0;0
6975;85555;76;77;30;2;28;.933;3600000;0
6975;91703;76;0;0;0;0;.00nan;0;0
6976;173823;73;49;33;5;28;.848;3562000;0
6976;-1;2564;0;0;0;0;.00nan;0;0
6976;86472;73;0;0;0;0;.00nan;0;0
6976;161047;2564;69;40;4;36;.900;3600000;0
6977;168651;151;63;25;2;23;.920;3600000;0
6977;-1;80;0;0;0;0;.00nan;0;0
6977;142492;151;0;0;0;0;.00nan;0;0
6977;152851;80;53;28;4;24;.857;3577000;0
6978;165380;67;0;0;0;0;.00nan;0;0
6978;-1;78;73;30;2;28;.933;3600000;0
6978;184437;78;0;0;0;0;.00nan;0;0
6978;44487;67;42;37;6;31;.838;3600000;0
6979;164987;85;47;22;3;19;.864;3600000;0
6979;173856;75;51;35;6;29;.829;3350000;0
6979;171615;75;51;2;0;2;1.000;250000;0
6979;57207;85;0;0;0;0;.00nan;0;0
6980;163784;77;62;15;2;13;.867;3600000;0
6980;179411;4922;78;38;4;34;.895;3600000;0
6980;64961;77;0;0;0;0;.00nan;0;0
6980;161046;4922;0;0;0;0;.00nan;0;0
6981;-1;149;0;0;0;0;.00nan;0;0
6981;173874;158;100;35;1;34;.971;3600000;0
6981;64722;149;56;29;4;25;.862;3600000;0
6981;91398;158;0;0;0;0;.00nan;0;0
6982;165611;81;51;22;2;20;.909;3900000;0
6982;178911;152;0;0;0;0;.00nan;0;0
6982;178950;152;87;33;2;31;.939;3900000;0
6982;70213;81;0;0;0;0;.00nan;0;0
6983;183730;4245;81;28;1;27;.964;3600000;0
6983;19708;157;0;0;0;0;.00nan;0;0
6983;184398;4245;0;0;0;0;.00nan;0;0
6983;186520;157;45;22;4;18;.818;3600000;0
6984;-1;1095;69;26;2;24;.923;3600000;0
6984;176770;1095;0;0;0;0;.00nan;0;0
6984;85437;4921;0;0;0;0;.00nan;0;0
6984;85661;4921;39;47;7;40;.851;3600000;0
6985;173823;73;0;0;0;0;.00nan;0;0
6985;181446;71;0;0;0;0;.00nan;0;0
6985;46790;71;63;32;3;29;.906;3900000;0
6985;86472;73;71;31;3;28;.903;3900000;0
6986;171970;74;0;0;0;0;.00nan;0;0
6986;163784;77;0;0;0;0;.00nan;0;0
6986;170612;74;80;43;4;39;.907;3544000;0
6986;64961;77;59;21;3;18;.857;3600000;0
6987;165611;81;0;0;0;0;.00nan;0;0
6987;-1;80;33;30;6;24;.800;3600000;0
6987;70213;81;100;22;0;22;1.000;3600000;0
6987;152851;80;0;0;0;0;.00nan;0;0
6988;-1;1095;71;41;4;37;.902;3900000;0
6988;176770;1095;0;0;0;0;.00nan;0;0
6988;85437;4921;57;36;4;32;.889;3889000;0
6988;85661;4921;0;0;0;0;.00nan;0;0
6989;4487;4920;0;0;0;0;.00nan;0;0
6989;179411;4922;20;11;4;7;.636;940000;0
6989;149450;4920;59;16;1;15;.938;3600000;0
6989;161046;4922;50;29;4;25;.862;2660000;0
6990;183730;4245;0;0;0;0;.00nan;0;0
6990;173874;158;0;0;0;0;.00nan;0;0
6990;184398;4245;65;34;3;31;.912;3544000;0
6990;91398;158;99;37;1;36;.973;3600000;0
6991;-1;1095;66;40;4;36;.900;3900000;0
6991;176770;1095;0;0;0;0;.00nan;0;0
6991;181446;71;0;0;0;0;.00nan;0;0
6991;46790;71;56;34;4;30;.882;3900000;0
6992;163784;77;49;31;5;26;.839;3600000;0
6992;64961;77;0;0;0;0;.00nan;0;0
6992;85555;76;0;0;0;0;.00nan;0;0
6992;91703;76;44;21;4;17;.810;3600000;0
6993;164987;85;0;0;0;0;.00nan;0;0
6993;171660;1096;0;0;0;0;.00nan;0;0
6993;-1;1096;70;32;3;29;.906;3600000;0
6993;57207;85;75;34;4;30;.882;3545000;0
6994;165611;81;0;0;0;0;.00nan;0;0
6994;-1;80;0;0;0;0;.00nan;0;0
6994;70213;81;55;27;3;24;.889;3835000;0
6994;152851;80;78;39;4;35;.897;3835000;0
6995;168651;151;83;37;3;34;.919;3595000;0
6995;-1;4620;90;34;2;32;.941;3600000;0
6995;173961;4620;0;0;0;0;.00nan;0;0
6995;142492;151;0;0;0;0;.00nan;0;0
6996;171970;74;69;26;2;24;.923;3540000;0
6996;164987;85;89;32;1;31;.969;3600000;0
6996;170612;74;0;0;0;0;.00nan;0;0
6996;57207;85;0;0;0;0;.00nan;0;0
6997;4487;4920;0;0;0;0;.00nan;0;0
6997;179411;4922;99;43;1;42;.977;3600000;0
6997;149450;4920;51;18;3;15;.833;3511000;0
6997;161046;4922;0;0;0;0;.00nan;0;0
6998;19708;157;94;39;2;37;.949;3600000;0
6998;178911;152;60;27;3;24;.889;3546000;0
6998;178950;152;0;0;0;0;.00nan;0;0
6998;186520;157;0;0;0;0;.00nan;0;0
6999;-1;2564;59;37;5;32;.865;3900000;0
6999;85437;4921;0;0;0;0;.00nan;0;0
6999;85661;4921;58;40;5;35;.875;3900000;0
6999;161047;2564;0;0;0;0;.00nan;0;0
7000;180873;69;86;30;1;29;.967;3600000;0
7000;181446;71;51;2;0;2;1.000;390000;0
7000;46790;71;31;32;7;25;.781;3210000;0
7000;57215;69;0;0;0;0;.00nan;0;0
7001;182339;82;88;29;1;28;.966;3600000;0
7001;2495;1097;0;0;0;0;.00nan;0;0
7001;170728;1097;74;37;3;34;.919;3555000;0
7001;185812;82;0;0;0;0;.00nan;0;0
7002;183730;4245;83;34;2;32;.941;3900000;0
7002;173874;158;0;0;0;0;.00nan;0;0
7002;184398;4245;0;0;0;0;.00nan;0;0
7002;91398;158;70;26;2;24;.923;3900000;0
7003;165380;67;56;12;1;11;.917;1485000;0
7003;168651;151;70;18;1;17;.944;3600000;0
7003;44487;67;17;20;6;14;.700;2115000;0
7003;142492;151;0;0;0;0;.00nan;0;0
7004;163784;77;0;0;0;0;.00nan;0;0
7004;64961;77;58;34;4;30;.882;3600000;0
7004;85555;76;85;35;2;33;.943;3600000;0
7004;91703;76;0;0;0;0;.00nan;0;0
7005;-1;78;0;0;0;0;.00nan;0;0
7005;173823;73;74;35;3;32;.914;3545000;0
7005;184437;78;75;26;2;24;.923;3600000;0
7005;86472;73;0;0;0;0;.00nan;0;0
7006;171970;74;0;0;0;0;.00nan;0;0
7006;170612;74;56;40;5;35;.875;3600000;0
7006;171660;1096;76;23;1;22;.957;3600000;0
7006;-1;1096;0;0;0;0;.00nan;0;0
7007;-1;1095;78;34;2;32;.941;3600000;0
7007;176770;1095;0;0;0;0;.00nan;0;0
7007;44189;72;0;0;0;0;.00nan;0;0
7007;64811;72;100;37;0;37;1.000;3600000;0
7008;-1;4620;55;23;3;20;.870;3600000;0
7008;173856;75;36;14;3;11;.786;430000;0
7008;173961;4620;0;0;0;0;.00nan;0;0
7008;171615;75;51;44;7;37;.841;3170000;0
7009;4487;4920;72;24;2;22;.917;3600000;0
7009;179411;4922;0;0;0;0;.00nan;0;0
7009;149450;4920;0;0;0;0;.00nan;0;0
7009;161046;4922;85;43;3;40;.930;3547000;0
7010;-1;80;0;0;0;0;.00nan;0;0
7010;178911;152;0;0;0;0;.00nan;0;0
7010;178950;152;65;17;1;16;.941;3600000;0
7010;152851;80;98;48;2;46;.958;3572000;0
7011;171970;74;67;30;3;27;.900;3587000;0
7011;2495;1097;78;25;2;23;.920;3600000;0
7011;170612;74;0;0;0;0;.00nan;0;0
7011;170728;1097;0;0;0;0;.00nan;0;0
7012;-1;2564;0;0;0;0;.00nan;0;0
7012;180873;69;0;0;0;0;.00nan;0;0
7012;57215;69;83;30;2;28;.933;3881000;0
7012;161047;2564;54;20;3;17;.850;3881000;0
7013;182339;82;0;0;0;0;.00nan;0;0
7013;171660;1096;0;0;0;0;.00nan;0;0
7013;-1;1096;82;31;1;30;.968;3900000;0
7013;185812;82;73;26;1;25;.962;3900000;0
7014;183730;4245;39;1;1;0;.000;317000;0
7014;173874;158;0;0;0;0;.00nan;0;0
7014;184398;4245;22;25;6;19;.760;3283000;0
7014;91398;158;100;36;1;35;.972;3600000;0
7015;-1;1095;85;42;3;39;.929;3600000;0
7015;176770;1095;0;0;0;0;.00nan;0;0
7015;181446;71;34;29;5;24;.828;3544000;0
7015;46790;71;0;0;0;0;.00nan;0;0
7016;164987;85;0;0;0;0;.00nan;0;0
7016;57207;85;100;48;2;46;.958;3863000;0
7016;85555;76;0;0;0;0;.00nan;0;0
7016;91703;76;59;19;2;17;.895;3900000;0
7017;165380;67;97;36;1;35;.972;3595000;0
7017;168651;151;0;0;0;0;.00nan;0;0
7017;44487;67;0;0;0;0;.00nan;0;0
7017;142492;151;96;26;0;26;1.000;3600000;0
7018;-1;78;38;32;5;27;.844;3523000;0
7018;173823;73;0;0;0;0;.00nan;0;0
7018;184437;78;0;0;0;0;.00nan;0;0
7018;86472;73;78;31;3;28;.903;3600000;0
7019;44189;72;44;26;4;22;.846;3900000;0
7019;64811;72;0;0;0;0;.00nan;0;0
7019;85437;4921;50;32;4;28;.875;3900000;0
7019;85661;4921;0;0;0;0;.00nan;0;0
7020;165611;81;0;0;0;0;.00nan;0;0
7020;19708;157;0;0;0;0;.00nan;0;0
7020;186520;157;66;22;2;20;.909;3600000;0
7020;70213;81;75;37;4;33;.892;3563000;0
7021;-1;4620;0;0;0;0;.00nan;0;0
7021;173856;75;97;47;1;46;.979;3900000;0
7021;173961;4620;66;15;1;14;.933;3900000;0
7021;171615;75;0;0;0;0;.00nan;0;0
7022;2495;1097;0;0;0;0;.00nan;0;0
7022;163784;77;0;0;0;0;.00nan;0;0
7022;170728;1097;39;36;6;30;.833;3600000;0
7022;64961;77;67;23;2;21;.913;3600000;0
7023;180873;69;92;41;2;39;.951;3600000;0
7023;181446;71;0;0;0;0;.00nan;0;0
7023;46790;71;53;30;4;26;.867;3554000;0
7023;57215;69;0;0;0;0;.00nan;0;0
7024;164987;85;0;0;0;0;.00nan;0;0
7024;171660;1096;23;11;4;7;.636;1090000;0
7024;-1;1096;49;20;3;17;.850;2458000;0
7024;57207;85;42;34;6;28;.824;3600000;0
7025;44189;72;0;0;0;0;.00nan;0;0
7025;64811;72;58;15;2;13;.867;3600000;0
7025;85437;4921;0;0;0;0;.00nan;0;0
7025;85661;4921;75;53;6;47;.887;3600000;0
7026;165611;81;77;28;2;26;.929;3600000;0
7026;19708;157;58;33;4;29;.879;3525000;0
7026;186520;157;0;0;0;0;.00nan;0;0
7026;70213;81;0;0;0;0;.00nan;0;0
7027;173823;73;85;27;1;26;.963;3900000;0
7027;-1;1095;0;0;0;0;.00nan;0;0
7027;176770;1095;81;29;1;28;.966;3900000;0
7027;86472;73;0;0;0;0;.00nan;0;0
7028;-1;149;0;0;0;0;.00nan;0;0
7028;-1;80;58;31;4;27;.871;3545000;0
7028;64722;149;74;20;1;19;.950;3600000;0
7028;152851;80;0;0;0;0;.00nan;0;0
7029;171970;74;86;41;3;38;.927;3600000;0
7029;170612;74;0;0;0;0;.00nan;0;0
7029;85555;76;72;24;2;22;.917;3600000;0
7029;91703;76;0;0;0;0;.00nan;0;0
7030;4487;4920;0;0;0;0;.00nan;0;0
7030;-1;78;0;0;0;0;.00nan;0;0
7030;184437;78;98;36;1;35;.972;3600000;0
7030;149450;4920;100;29;0;29;1.000;3600000;0
7031;171660;1096;53;3;0;3;1.000;882000;0
7031;179411;4922;92;39;2;37;.949;3600000;0
7031;-1;1096;18;25;6;19;.760;2718000;0
7031;161046;4922;0;0;0;0;.00nan;0;0
7032;182339;82;75;31;3;28;.903;3600000;0
7032;-1;2564;71;26;2;24;.923;3104000;0
7032;185812;82;0;0;0;0;.00nan;0;0
7032;161047;2564;26;6;3;3;.500;446000;0
7033;168651;151;75;28;2;26;.929;3600000;0
7033;173874;158;0;0;0;0;.00nan;0;0
7033;91398;158;75;40;3;37;.925;3600000;0
7033;142492;151;0;0;0;0;.00nan;0;0
7034;173823;73;76;38;3;35;.921;3600000;0
7034;44189;72;0;0;0;0;.00nan;0;0
7034;64811;72;73;28;2;26;.929;3600000;0
7034;86472;73;0;0;0;0;.00nan;0;0
7035;164987;85;0;0;0;0;.00nan;0;0
7035;165380;67;62;31;4;27;.871;3600000;0
7035;44487;67;0;0;0;0;.00nan;0;0
7035;57207;85;52;34;5;29;.853;3547000;0
7036;19708;157;0;0;0;0;.00nan;0;0
7036;178911;152;0;0;0;0;.00nan;0;0
7036;178950;152;90;33;1;32;.970;3600000;0
7036;186520;157;60;28;4;24;.857;3600000;0
7037;-1;149;0;0;0;0;.00nan;0;0
7037;-1;80;0;0;0;0;.00nan;0;0
7037;64722;149;82;16;0;16;1.000;3600000;0
7037;152851;80;65;36;4;32;.889;3600000;0
7038;171660;1096;0;0;0;0;.00nan;0;0
7038;179411;4922;41;37;6;31;.838;3584000;0
7038;-1;1096;56;32;4;28;.875;3600000;0
7038;161046;4922;0;0;0;0;.00nan;0;0
7039;165611;81;0;0;0;0;.00nan;0;0
7039;180873;69;0;0;0;0;.00nan;0;0
7039;57215;69;85;41;3;38;.927;3600000;0
7039;70213;81;59;34;4;30;.882;3600000;0
7040;-1;1095;42;28;5;23;.821;3568000;0
7040;176770;1095;0;0;0;0;.00nan;0;0
7040;181446;71;51;26;4;22;.846;3600000;0
7040;46790;71;0;0;0;0;.00nan;0;0
7041;173823;73;0;0;0;0;.00nan;0;0
7041;85437;4921;0;0;0;0;.00nan;0;0
7041;85661;4921;59;49;6;43;.878;3600000;0
7041;86472;73;82;15;0;15;1.000;3600000;0
7042;168651;151;0;0;0;0;.00nan;0;0
7042;173874;158;0;0;0;0;.00nan;0;0
7042;91398;158;55;41;6;35;.854;3567000;0
7042;142492;151;33;24;5;19;.792;3600000;0
7043;165380;67;0;0;0;0;.00nan;0;0
7043;183730;4245;0;0;0;0;.00nan;0;0
7043;184398;4245;69;26;2;24;.923;3600000;0
7043;44487;67;59;41;5;36;.878;3600000;0
7044;173856;75;73;55;6;49;.891;3859000;0
7044;171615;75;0;0;0;0;.00nan;0;0
7044;85555;76;31;19;5;14;.737;3859000;0
7044;91703;76;0;0;0;0;.00nan;0;0
7045;182339;82;0;0;0;0;.00nan;0;0
7045;163784;77;0;0;0;0;.00nan;0;0
7045;185812;82;81;28;1;27;.964;3600000;0
7045;64961;77;46;33;5;28;.848;3600000;0
7046;-1;149;0;0;0;0;.00nan;0;0
7046;-1;80;95;39;1;38;.974;3600000;0
7046;64722;149;92;24;0;24;1.000;3600000;0
7046;152851;80;0;0;0;0;.00nan;0;0
7047;164987;85;0;0;0;0;.00nan;0;0
7047;-1;78;0;0;0;0;.00nan;0;0
7047;184437;78;52;29;4;25;.862;3600000;0
7047;57207;85;38;31;5;26;.839;3562000;0
7048;171970;74;96;38;1;37;.974;3600000;0
7048;2495;1097;0;0;0;0;.00nan;0;0
7048;170612;74;0;0;0;0;.00nan;0;0
7048;170728;1097;67;32;3;29;.906;3600000;0
7049;-1;2564;0;0;0;0;.00nan;0;0
7049;44189;72;0;0;0;0;.00nan;0;0
7049;64811;72;83;27;1;26;.963;3600000;0
7049;161047;2564;65;25;2;23;.920;3541000;0
7050;19708;157;66;29;3;26;.897;3600000;0
7050;178911;152;58;6;0;6;1.000;844000;0
7050;178950;152;28;29;6;23;.793;2756000;0
7050;186520;157;0;0;0;0;.00nan;0;0
7051;4487;4920;0;0;0;0;.00nan;0;0
7051;-1;4620;51;15;2;13;.867;3600000;0
7051;173961;4620;0;0;0;0;.00nan;0;0
7051;149450;4920;71;42;4;38;.905;3599000;0
7052;-1;2564;54;35;5;30;.857;3603000;0
7052;44189;72;64;31;4;27;.871;3609000;0
7052;64811;72;0;0;0;0;.00nan;0;0
7052;161047;2564;0;0;0;0;.00nan;0;0
7053;171660;1096;0;0;0;0;.00nan;0;0
7053;179411;4922;0;0;0;0;.00nan;0;0
7053;-1;1096;82;36;2;34;.944;3600000;0
7053;161046;4922;93;30;1;29;.967;3600000;0
7054;180873;69;33;16;4;12;.750;797000;0
7054;181446;71;0;0;0;0;.00nan;0;0
7054;46790;71;64;22;2;20;.909;3600000;0
7054;57215;69;62;36;4;32;.889;2803000;0
7055;173823;73;0;0;0;0;.00nan;0;0
7055;85437;4921;91;38;2;36;.947;3600000;0
7055;85661;4921;0;0;0;0;.00nan;0;0
7055;86472;73;66;38;4;34;.895;3550000;0
7056;168651;151;79;23;1;22;.957;3600000;0
7056;173874;158;0;0;0;0;.00nan;0;0
7056;91398;158;59;32;4;28;.875;3600000;0
7056;142492;151;0;0;0;0;.00nan;0;0
7057;165380;67;54;34;5;29;.853;3600000;0
7057;183730;4245;80;24;1;23;.958;3600000;0
7057;184398;4245;0;0;0;0;.00nan;0;0
7057;44487;67;0;0;0;0;.00nan;0;0
7058;173856;75;0;0;0;0;.00nan;0;0
7058;171615;75;89;53;4;49;.925;3584000;0
7058;85555;76;0;0;0;0;.00nan;0;0
7058;91703;76;67;21;2;19;.905;3600000;0
7059;2495;1097;76;31;2;29;.935;3600000;0
7059;163784;77;48;24;3;21;.875;3569000;0
7059;170728;1097;0;0;0;0;.00nan;0;0
7059;64961;77;0;0;0;0;.00nan;0;0
7060;-1;149;0;0;0;0;.00nan;0;0
7060;-1;80;0;0;0;0;.00nan;0;0
7060;64722;149;60;29;3;26;.897;3600000;0
7060;152851;80;48;48;7;41;.854;3600000;0
7061;164987;85;0;0;0;0;.00nan;0;0
7061;-1;78;81;35;3;32;.914;3900000;0
7061;184437;78;0;0;0;0;.00nan;0;0
7061;57207;85;75;35;3;32;.914;3870000;0
7062;182339;82;74;24;1;23;.958;3600000;0
7062;171970;74;0;0;0;0;.00nan;0;0
7062;170612;74;47;25;4;21;.840;3600000;0
7062;185812;82;0;0;0;0;.00nan;0;0
7063;19708;157;76;32;2;30;.938;3600000;0
7063;178911;152;23;25;6;19;.760;3364000;0
7063;178950;152;56;6;0;6;1.000;236000;0
7063;186520;157;0;0;0;0;.00nan;0;0
7064;165611;81;83;30;2;28;.933;3600000;0
7064;-1;1095;69;43;5;38;.884;3600000;0
7064;176770;1095;0;0;0;0;.00nan;0;0
7064;70213;81;0;0;0;0;.00nan;0;0
7065;4487;4920;68;39;4;35;.897;3900000;0
7065;-1;4620;50;30;4;26;.867;3900000;0
7065;173961;4620;0;0;0;0;.00nan;0;0
7065;149450;4920;0;0;0;0;.00nan;0;0
7066;180873;69;70;28;3;25;.893;3900000;0
7066;57215;69;0;0;0;0;.00nan;0;0
7066;85437;4921;0;0;0;0;.00nan;0;0
7066;85661;4921;88;39;3;36;.923;3900000;0
7067;182339;82;0;0;0;0;.00nan;0;0
7067;171970;74;67;43;4;39;.907;3900000;0
7067;170612;74;0;0;0;0;.00nan;0;0
7067;185812;82;52;22;4;18;.818;3900000;0
7068;173823;73;34;23;5;18;.783;3664000;0
7068;-1;2564;0;0;0;0;.00nan;0;0
7068;86472;73;0;0;0;0;.00nan;0;0
7068;161047;2564;69;45;4;41;.911;3664000;0
7069;165380;67;87;39;2;37;.949;2751000;0
7069;183730;4245;0;0;0;0;.00nan;0;0
7069;184398;4245;81;27;1;26;.963;3600000;0
7069;44487;67;24;12;4;8;.667;849000;0
7070;2495;1097;0;0;0;0;.00nan;0;0
7070;163784;77;0;0;0;0;.00nan;0;0
7070;170728;1097;65;30;3;27;.900;3600000;0
7070;64961;77;74;40;4;36;.900;3549000;0
7071;165611;81;0;0;0;0;.00nan;0;0
7071;-1;1095;0;0;0;0;.00nan;0;0
7071;176770;1095;70;29;2;27;.931;3900000;0
7071;70213;81;95;41;2;39;.951;3900000;0
7072;4487;4920;0;0;0;0;.00nan;0;0
7072;183730;4245;54;28;4;24;.857;3766000;0
7072;184398;4245;0;0;0;0;.00nan;0;0
7072;149450;4920;68;33;3;30;.909;3766000;0
7073;-1;2564;96;50;3;47;.940;3600000;0
7073;186520;157;0;0;0;0;.00nan;0;0
7073;85437;157;61;17;2;15;.882;3600000;0
7073;161047;2564;0;0;0;0;.00nan;0;0
7074;182339;82;100;36;0;36;1.000;3600000;0
7074;2495;1097;0;0;0;0;.00nan;0;0
7074;170728;1097;91;35;1;34;.971;3600000;0
7074;185812;82;0;0;0;0;.00nan;0;0
7075;-1;149;0;0;0;0;.00nan;0;0
7075;173874;158;0;0;0;0;.00nan;0;0
7075;64722;149;100;51;1;50;.980;3900000;0
7075;91398;158;83;23;1;22;.957;3900000;0
7076;168651;151;0;0;0;0;.00nan;0;0
7076;178911;152;0;0;0;0;.00nan;0;0
7076;178950;152;58;14;1;13;.929;3578000;0
7076;142492;151;100;41;0;41;1.000;3600000;0
7077;164987;85;0;0;0;0;.00nan;0;0
7077;173856;75;0;0;0;0;.00nan;0;0
7077;171615;75;99;34;1;33;.971;3600000;0
7077;57207;85;55;16;2;14;.875;3562000;0
7078;171970;74;81;42;3;39;.929;3573000;0
7078;170612;74;0;0;0;0;.00nan;0;0
7078;85555;76;65;25;2;23;.920;3600000;0
7078;91703;76;0;0;0;0;.00nan;0;0
7079;4487;4920;0;0;0;0;.00nan;0;0
7079;183730;4245;0;0;0;0;.00nan;0;0
7079;184398;4245;49;36;6;30;.833;3600000;0
7079;149450;4920;97;27;0;27;1.000;3600000;0
7080;2495;1097;54;29;4;25;.862;2012000;0
7080;170728;1097;12;17;6;11;.647;1588000;0
7080;85555;76;0;0;0;0;.00nan;0;0
7080;91703;76;70;32;3;29;.906;3600000;0
7081;173823;73;0;0;0;0;.00nan;0;0
7081;-1;2564;0;0;0;0;.00nan;0;0
7081;86472;73;97;21;0;21;1.000;3600000;0
7081;161047;2564;83;42;4;38;.905;3600000;0
7082;180873;69;0;0;0;0;.00nan;0;0
7082;186520;157;0;0;0;0;.00nan;0;0
7082;57215;69;99;41;2;39;.951;3600000;0
7082;85437;157;30;20;5;15;.750;3600000;0
7083;-1;149;0;0;0;0;.00nan;0;0
7083;173874;158;0;0;0;0;.00nan;0;0
7083;64722;149;77;31;2;29;.935;3600000;0
7083;91398;158;58;38;4;34;.895;3513000;0
7084;163195;4921;0;0;0;0;.00nan;0;0
7084;44189;72;0;0;0;0;.00nan;0;0
7084;64811;72;59;24;3;21;.875;3900000;0
7084;85661;4921;79;41;3;38;.927;3900000;0
7085;168651;151;91;32;1;31;.969;3600000;0
7085;178911;152;0;0;0;0;.00nan;0;0
7085;178950;152;48;40;6;34;.850;3600000;0
7085;142492;151;0;0;0;0;.00nan;0;0
7086;163784;77;0;0;0;0;.00nan;0;0
7086;179411;4922;80;35;3;32;.914;3600000;0
7086;64961;77;79;42;4;38;.905;3598000;0
7086;161046;4922;0;0;0;0;.00nan;0;0
7087;-1;78;0;0;0;0;.00nan;0;0
7087;-1;4620;63;17;1;16;.941;3600000;0
7087;173961;4620;0;0;0;0;.00nan;0;0
7087;184437;78;77;32;2;30;.938;3600000;0
7088;182339;82;88;45;3;42;.933;3594000;0
7088;171660;1096;88;12;0;12;1.000;3600000;0
7088;-1;1096;0;0;0;0;.00nan;0;0
7088;185812;82;0;0;0;0;.00nan;0;0
7089;164987;85;0;0;0;0;.00nan;0;0
7089;173856;75;95;44;3;41;.932;3600000;0
7089;171615;75;0;0;0;0;.00nan;0;0
7089;57207;85;100;23;0;23;1.000;3600000;0
7090;-1;1095;95;36;1;35;.972;3600000;0
7090;176770;1095;0;0;0;0;.00nan;0;0
7090;181446;71;0;0;0;0;.00nan;0;0
7090;46790;71;50;37;5;32;.865;3600000;0
7091;4487;4920;0;0;0;0;.00nan;0;0
7091;-1;4620;57;26;3;23;.885;3522000;0
7091;173961;4620;0;0;0;0;.00nan;0;0
7091;149450;4920;80;33;1;32;.970;3600000;0
7092;182339;82;0;0;0;0;.00nan;0;0
7092;2495;1097;0;0;0;0;.00nan;0;0
7092;170728;1097;85;26;1;25;.962;3600000;0
7092;185812;82;31;29;6;23;.793;3600000;0
7093;163784;77;28;37;7;30;.811;3600000;0
7093;179411;4922;0;0;0;0;.00nan;0;0
7093;64961;77;0;0;0;0;.00nan;0;0
7093;161046;4922;78;37;3;34;.919;3600000;0
7094;180873;69;46;36;5;31;.861;3600000;0
7094;186520;157;0;0;0;0;.00nan;0;0
7094;57215;69;0;0;0;0;.00nan;0;0
7094;85437;157;59;20;2;18;.900;3600000;0
7095;-1;149;56;24;3;21;.875;3600000;0
7095;173874;158;50;38;5;33;.868;3600000;0
7095;64722;149;0;0;0;0;.00nan;0;0
7095;91398;158;0;0;0;0;.00nan;0;0
7096;173823;73;0;0;0;0;.00nan;0;0
7096;181446;71;54;36;5;31;.861;3900000;0
7096;46790;71;0;0;0;0;.00nan;0;0
7096;86472;73;60;38;5;33;.868;3900000;0
7097;163195;4921;56;29;3;26;.897;3585000;0
7097;44189;72;67;24;2;22;.917;3600000;0
7097;64811;72;0;0;0;0;.00nan;0;0
7097;85661;4921;0;0;0;0;.00nan;0;0
7098;171970;74;0;0;0;0;.00nan;0;0
7098;170612;74;58;34;4;30;.882;3541000;0
7098;85555;76;72;29;3;26;.897;3600000;0
7098;91703;76;0;0;0;0;.00nan;0;0
7099;168651;151;0;0;0;0;.00nan;0;0
7099;178911;152;49;27;5;22;.815;3535000;0
7099;178950;152;0;0;0;0;.00nan;0;0
7099;142492;151;80;39;3;36;.923;3600000;0
7100;165380;67;0;0;0;0;.00nan;0;0
7100;183730;4245;89;56;5;51;.911;3595000;0
7100;184398;4245;0;0;0;0;.00nan;0;0
7100;44487;67;73;35;4;31;.886;3600000;0
7101;164987;85;0;0;0;0;.00nan;0;0
7101;173856;75;0;0;0;0;.00nan;0;0
7101;171615;75;80;46;4;42;.913;3600000;0
7101;57207;85;62;13;1;12;.923;3600000;0
7102;-1;2564;58;34;4;30;.882;3559000;0
7102;-1;1095;0;0;0;0;.00nan;0;0
7102;176770;1095;89;38;3;35;.921;3600000;0
7102;161047;2564;0;0;0;0;.00nan;0;0
7103;180873;69;0;0;0;0;.00nan;0;0
7103;186520;157;0;0;0;0;.00nan;0;0
7103;57215;69;94;60;5;55;.917;3529000;0
7103;85437;157;59;24;3;21;.875;3600000;0
7104;163195;4921;67;16;1;15;.938;1411000;0
7104;44189;72;0;0;0;0;.00nan;0;0
7104;64811;72;77;19;1;18;.947;3600000;0
7104;85661;4921;46;28;4;24;.857;2189000;0
7105;4487;4920;48;34;5;29;.853;3600000;0
7105;165380;67;100;40;1;39;.975;3600000;0
7105;44487;67;0;0;0;0;.00nan;0;0
7105;149450;4920;0;0;0;0;.00nan;0;0
7106;182339;82;39;31;6;25;.806;2561000;0
7106;171970;74;55;25;3;22;.880;3600000;0
7106;170612;74;0;0;0;0;.00nan;0;0
7106;185812;82;48;16;2;14;.875;1039000;0
7107;165611;81;0;0;0;0;.00nan;0;0
7107;-1;80;0;0;0;0;.00nan;0;0
7107;70213;81;57;26;3;23;.885;3550000;0
7107;152851;80;93;37;2;35;.946;3600000;0
7108;-1;149;0;0;0;0;.00nan;0;0
7108;178911;152;56;25;3;22;.880;3812000;0
7108;178950;152;0;0;0;0;.00nan;0;0
7108;64722;149;63;24;2;22;.917;3812000;0
7109;182339;82;0;0;0;0;.00nan;0;0
7109;2495;1097;0;0;0;0;.00nan;0;0
7109;170728;1097;55;31;4;27;.871;3900000;0
7109;185812;82;65;39;4;35;.897;3900000;0
7110;179411;4922;80;42;3;39;.929;3579000;0
7110;85555;76;60;18;2;16;.889;3600000;0
7110;91703;76;0;0;0;0;.00nan;0;0
7110;161046;4922;0;0;0;0;.00nan;0;0
7111;165611;81;0;0;0;0;.00nan;0;0
7111;168651;151;78;37;3;34;.919;3900000;0
7111;70213;81;63;30;3;27;.900;3900000;0
7111;142492;151;0;0;0;0;.00nan;0;0
7112;-1;78;40;9;2;7;.778;1344000;0
7112;173856;75;98;23;0;23;1.000;3600000;0
7112;184437;78;23;25;6;19;.760;2256000;0
7112;171615;75;0;0;0;0;.00nan;0;0
7113;4487;4920;0;0;0;0;.00nan;0;0
7113;164987;85;0;0;0;0;.00nan;0;0
7113;57207;85;56;26;3;23;.885;3551000;0
7113;149450;4920;63;23;2;21;.913;3600000;0
7114;163195;4921;52;36;5;31;.861;3600000;0
7114;180873;69;0;0;0;0;.00nan;0;0
7114;57215;69;91;35;2;33;.943;3600000;0
7114;85661;4921;0;0;0;0;.00nan;0;0
7115;171970;74;52;25;3;22;.880;3598000;0
7115;163784;77;0;0;0;0;.00nan;0;0
7115;170612;74;0;0;0;0;.00nan;0;0
7115;64961;77;68;27;2;25;.926;3600000;0
7116;4487;4920;0;0;0;0;.00nan;0;0
7116;165380;67;63;39;4;35;.897;3600000;0
7116;44487;67;0;0;0;0;.00nan;0;0
7116;149450;4920;82;28;1;27;.964;3600000;0
7117;-1;149;0;0;0;0;.00nan;0;0
7117;178911;152;0;0;0;0;.00nan;0;0
7117;178950;152;64;37;3;34;.919;3900000;0
7117;64722;149;78;33;3;30;.909;3900000;0
7118;-1;2564;100;42;1;41;.976;3600000;0
7118;-1;1095;34;33;6;27;.818;3600000;0
7118;176770;1095;0;0;0;0;.00nan;0;0
7118;161047;2564;0;0;0;0;.00nan;0;0
7119;182339;82;100;42;2;40;.952;3600000;0
7119;163784;77;65;27;3;24;.889;3600000;0
7119;185812;82;0;0;0;0;.00nan;0;0
7119;64961;77;0;0;0;0;.00nan;0;0
7120;173874;158;59;37;4;33;.892;3274000;0
7120;186520;157;0;0;0;0;.00nan;0;0
7120;85437;157;71;19;1;18;.947;3600000;0
7120;91398;158;31;8;3;5;.625;326000;0
7121;163195;4921;0;0;0;0;.00nan;0;0
7121;180873;69;91;26;1;25;.962;3600000;0
7121;57215;69;0;0;0;0;.00nan;0;0
7121;85661;4921;77;38;3;35;.921;3600000;0
7122;171660;1096;34;27;5;22;.815;3600000;0
7122;-1;1096;0;0;0;0;.00nan;0;0
7122;85555;76;0;0;0;0;.00nan;0;0
7122;91703;76;79;25;1;24;.960;3600000;0
7123;173823;73;0;0;0;0;.00nan;0;0
7123;181446;71;0;0;0;0;.00nan;0;0
7123;46790;71;68;28;3;25;.893;3583000;0
7123;86472;73;65;22;2;20;.909;3600000;0
7124;-1;78;0;0;0;0;.00nan;0;0
7124;173856;75;67;30;3;27;.900;3543000;0
7124;184437;78;71;29;2;27;.931;3600000;0
7124;171615;75;0;0;0;0;.00nan;0;0
7125;171970;74;0;0;0;0;.00nan;0;0
7125;170612;74;60;35;4;31;.886;3900000;0
7125;179411;4922;69;33;4;29;.879;3900000;0
7125;161046;4922;0;0;0;0;.00nan;0;0
7126;165611;81;0;0;0;0;.00nan;0;0
7126;168651;151;0;0;0;0;.00nan;0;0
7126;70213;81;74;27;2;25;.926;3728000;0
7126;142492;151;92;52;3;49;.942;3728000;0
7127;164987;85;0;0;0;0;.00nan;0;0
7127;-1;4620;59;25;3;22;.880;3600000;0
7127;173961;4620;0;0;0;0;.00nan;0;0
7127;57207;85;52;27;4;23;.852;3549000;0
7128;4487;4920;0;0;0;0;.00nan;0;0
7128;164987;85;0;0;0;0;.00nan;0;0
7128;57207;85;90;34;1;33;.971;3600000;0
7128;149450;4920;73;26;2;24;.923;3558000;0
7129;-1;149;62;39;4;35;.897;3520000;0
7129;178911;152;60;23;2;21;.913;3600000;0
7129;178950;152;0;0;0;0;.00nan;0;0
7129;64722;149;0;0;0;0;.00nan;0;0
7130;2495;1097;0;0;0;0;.00nan;0;0
7130;163784;77;0;0;0;0;.00nan;0;0
7130;170728;1097;57;19;2;17;.895;3600000;0
7130;64961;77;70;43;4;39;.907;3578000;0
7131;182339;82;0;0;0;0;.00nan;0;0
7131;171970;74;87;36;1;35;.972;3600000;0
7131;170612;74;0;0;0;0;.00nan;0;0
7131;185812;82;63;41;5;36;.878;3600000;0
7132;163195;4921;53;38;5;33;.868;3600000;0
7132;180873;69;0;0;0;0;.00nan;0;0
7132;57215;69;74;25;2;23;.920;3600000;0
7132;85661;4921;0;0;0;0;.00nan;0;0
7133;173823;73;57;26;3;23;.885;3544000;0
7133;181446;71;63;25;2;23;.920;3600000;0
7133;46790;71;0;0;0;0;.00nan;0;0
7133;86472;73;0;0;0;0;.00nan;0;0
7134;-1;78;29;19;5;14;.737;3900000;0
7134;173856;75;0;0;0;0;.00nan;0;0
7134;184437;78;0;0;0;0;.00nan;0;0
7134;171615;75;63;43;5;38;.884;3900000;0
7135;171660;1096;0;0;0;0;.00nan;0;0
7135;179411;4922;0;0;0;0;.00nan;0;0
7135;-1;1096;59;29;4;25;.862;3569000;0
7135;161046;4922;82;39;3;36;.923;3600000;0
7136;-1;2564;0;0;0;0;.00nan;0;0
7136;44189;72;0;0;0;0;.00nan;0;0
7136;64811;72;58;22;3;19;.864;3780000;0
7136;161047;2564;52;28;4;24;.857;3780000;0
7137;173874;158;0;0;0;0;.00nan;0;0
7137;186520;157;0;0;0;0;.00nan;0;0
7137;85437;157;68;19;1;18;.947;3600000;0
7137;91398;158;77;34;2;32;.941;3598000;0
7138;165611;81;82;23;1;22;.957;3600000;0
7138;-1;80;61;39;4;35;.897;3600000;0
7138;70213;81;0;0;0;0;.00nan;0;0
7138;152851;80;0;0;0;0;.00nan;0;0
7139;165380;67;0;0;0;0;.00nan;0;0
7139;-1;4620;0;0;0;0;.00nan;0;0
7139;173961;4620;63;13;1;12;.923;3600000;0
7139;44487;67;63;43;5;38;.884;3600000;0
7140;-1;1095;64;34;4;30;.882;3764000;0
7140;176770;1095;0;0;0;0;.00nan;0;0
7140;181446;71;0;0;0;0;.00nan;0;0
7140;46790;71;79;38;3;35;.921;3764000;0
7141;173823;73;0;0;0;0;.00nan;0;0
7141;180873;69;0;0;0;0;.00nan;0;0
7141;57215;69;77;30;2;28;.933;3600000;0
7141;86472;73;44;30;4;26;.867;3514000;0
7142;-1;2564;96;38;1;37;.974;3600000;0
7142;44189;72;0;0;0;0;.00nan;0;0
7142;64811;72;79;36;2;34;.944;3591000;0
7142;161047;2564;0;0;0;0;.00nan;0;0
7143;164987;85;62;25;3;22;.880;3898000;0
7143;183730;4245;0;0;0;0;.00nan;0;0
7143;184398;4245;46;31;4;27;.871;3898000;0
7143;57207;85;0;0;0;0;.00nan;0;0
7144;165380;67;35;45;8;37;.822;3600000;0
7144;-1;4620;26;19;5;14;.737;3600000;0
7144;173961;4620;0;0;0;0;.00nan;0;0
7144;44487;67;0;0;0;0;.00nan;0;0
7145;-1;2564;0;0;0;0;.00nan;0;0
7145;85555;76;81;15;0;15;1.000;3600000;0
7145;91703;76;0;0;0;0;.00nan;0;0
7145;161047;2564;73;52;5;47;.904;3600000;0
7146;182339;82;0;0;0;0;.00nan;0;0
7146;179411;4922;0;0;0;0;.00nan;0;0
7146;185812;82;99;37;1;36;.973;3600000;0
7146;161046;4922;67;40;4;36;.900;3600000;0
7147;163784;77;0;0;0;0;.00nan;0;0
7147;171660;1096;0;0;0;0;.00nan;0;0
7147;-1;1096;85;45;2;43;.956;3600000;0
7147;64961;77;60;25;3;22;.880;3561000;0
7148;173874;158;0;0;0;0;.00nan;0;0
7148;178911;152;77;36;3;33;.917;3863000;0
7148;178950;152;0;0;0;0;.00nan;0;0
7148;91398;158;77;36;2;34;.944;3863000;0
7149;171970;74;59;28;3;25;.893;3546000;0
7149;2495;1097;0;0;0;0;.00nan;0;0
7149;170612;74;0;0;0;0;.00nan;0;0
7149;170728;1097;81;27;1;26;.963;3600000;0
7150;182339;82;75;29;2;27;.931;3600000;0
7150;179411;4922;69;45;4;41;.911;3527000;0
7150;185812;82;0;0;0;0;.00nan;0;0
7150;161046;4922;0;0;0;0;.00nan;0;0
7151;173856;75;73;28;2;26;.929;3900000;0
7151;171615;75;0;0;0;0;.00nan;0;0
7151;180873;69;0;0;0;0;.00nan;0;0
7151;57215;69;90;33;2;31;.939;3900000;0
7152;181446;71;0;0;0;0;.00nan;0;0
7152;46790;71;44;23;4;19;.826;3560000;0
7152;85555;76;0;0;0;0;.00nan;0;0
7152;91703;76;61;19;2;17;.895;3600000;0
7153;173823;73;0;0;0;0;.00nan;0;0
7153;44189;72;0;0;0;0;.00nan;0;0
7153;64811;72;79;43;4;39;.907;3600000;0
7153;86472;73;67;40;5;35;.875;3600000;0
7154;4487;4920;0;0;0;0;.00nan;0;0
7154;165380;67;49;4;1;3;.750;580000;0
7154;44487;67;54;43;6;37;.860;3020000;0
7154;149450;4920;59;18;2;16;.889;3600000;0
7155;163784;77;99;25;0;25;1.000;3600000;0
7155;171660;1096;98;36;1;35;.972;3599000;0
7155;-1;1096;0;0;0;0;.00nan;0;0
7155;64961;77;0;0;0;0;.00nan;0;0
7156;163195;4921;0;0;0;0;.00nan;0;0
7156;-1;149;0;0;0;0;.00nan;0;0
7156;64722;149;66;13;1;12;.923;3600000;0
7156;85661;4921;71;41;4;37;.902;3600000;0
7157;-1;78;0;0;0;0;.00nan;0;0
7157;-1;4620;71;23;1;22;.957;3600000;0
7157;173961;4620;0;0;0;0;.00nan;0;0
7157;184437;78;83;44;4;40;.909;3600000;0
7158;164987;85;0;0;0;0;.00nan;0;0
7158;183730;4245;0;0;0;0;.00nan;0;0
7158;184398;4245;60;22;2;20;.909;3516000;0
7158;57207;85;100;24;0;24;1.000;3600000;0
7159;165611;81;0;0;0;0;.00nan;0;0
7159;186520;157;0;0;0;0;.00nan;0;0
7159;70213;81;70;33;3;30;.909;3600000;0
7159;85437;157;92;19;0;19;1.000;3600000;0
7160;168651;151;39;29;5;24;.828;3600000;0
7160;-1;80;0;0;0;0;.00nan;0;0
7160;142492;151;0;0;0;0;.00nan;0;0
7160;152851;80;88;33;2;31;.939;3600000;0
7161;4487;4920;72;25;2;23;.920;3600000;0
7161;183730;4245;40;34;6;28;.824;3600000;0
7161;184398;4245;0;0;0;0;.00nan;0;0
7161;149450;4920;0;0;0;0;.00nan;0;0
7162;173874;158;0;0;0;0;.00nan;0;0
7162;178911;152;0;0;0;0;.00nan;0;0
7162;178950;152;73;29;2;27;.931;3600000;0
7162;91398;158;24;22;6;16;.727;3600000;0
7163;171970;74;0;0;0;0;.00nan;0;0
7163;2495;1097;88;29;2;27;.931;3600000;0
7163;170612;74;53;27;3;24;.889;3568000;0
7163;170728;1097;0;0;0;0;.00nan;0;0
7164;180873;69;51;30;4;26;.867;3553000;0
7164;181446;71;62;24;2;22;.917;3600000;0
7164;46790;71;0;0;0;0;.00nan;0;0
7164;57215;69;0;0;0;0;.00nan;0;0
7165;164987;85;0;0;0;0;.00nan;0;0
7165;165380;67;91;48;2;46;.958;3600000;0
7165;44487;67;0;0;0;0;.00nan;0;0
7165;57207;85;63;28;3;25;.893;3540000;0
7166;163195;4921;98;53;2;51;.962;3900000;0
7166;-1;149;63;21;2;19;.905;3900000;0
7166;64722;149;0;0;0;0;.00nan;0;0
7166;85661;4921;0;0;0;0;.00nan;0;0
7167;-1;78;95;51;1;50;.980;3900000;0
7167;-1;4620;0;0;0;0;.00nan;0;0
7167;173961;4620;65;15;1;14;.933;3900000;0
7167;184437;78;0;0;0;0;.00nan;0;0
7168;163784;77;0;0;0;0;.00nan;0;0
7168;171660;1096;0;0;0;0;.00nan;0;0
7168;-1;1096;51;27;4;23;.852;3600000;0
7168;64961;77;58;33;5;28;.848;3554000;0
7169;-1;2564;0;0;0;0;.00nan;0;0
7169;44189;72;88;31;1;30;.968;3600000;0
7169;64811;72;0;0;0;0;.00nan;0;0
7169;161047;2564;36;26;5;21;.808;3600000;0
7170;165611;81;45;27;5;22;.815;3600000;0
7170;186520;157;0;0;0;0;.00nan;0;0
7170;70213;81;0;0;0;0;.00nan;0;0
7170;85437;157;80;35;3;32;.914;3600000;0
7171;173856;75;0;0;0;0;.00nan;0;0
7171;171615;75;57;39;5;34;.872;3600000;0
7171;-1;1095;0;0;0;0;.00nan;0;0
7171;176770;1095;66;16;1;15;.938;3600000;0
7172;168651;151;0;0;0;0;.00nan;0;0
7172;-1;80;58;24;3;21;.875;3600000;0
7172;142492;151;53;37;4;33;.892;3600000;0
7172;152851;80;0;0;0;0;.00nan;0;0
7173;4487;4920;0;0;0;0;.00nan;0;0
7173;183730;4245;0;0;0;0;.00nan;0;0
7173;184398;4245;95;38;1;37;.974;3557000;0
7173;149450;4920;89;20;0;20;1.000;3600000;0
7174;173874;158;54;20;2;18;.900;1427000;0
7174;178911;152;64;30;3;27;.900;3600000;0
7174;178950;152;0;0;0;0;.00nan;0;0
7174;91398;158;19;26;7;19;.731;2173000;0
7175;-1;2564;59;42;6;36;.857;2712000;0
7175;85555;76;51;21;4;17;.810;3600000;0
7175;91703;76;0;0;0;0;.00nan;0;0
7175;161047;2564;62;13;1;12;.923;888000;0
7176;180873;69;48;0;0;0;.00nan;311000;0
7176;44189;72;0;0;0;0;.00nan;0;0
7176;57215;69;64;41;5;36;.878;3289000;0
7176;64811;72;88;26;1;25;.962;3600000;0
7177;182339;82;0;0;0;0;.00nan;0;0
7177;179411;4922;76;27;2;25;.926;3600000;0
7177;185812;82;63;33;4;29;.879;3571000;0
7177;161046;4922;0;0;0;0;.00nan;0;0
7178;173823;73;0;0;0;0;.00nan;0;0
7178;181446;71;53;4;0;4;1.000;599000;0
7178;46790;71;35;31;6;25;.806;3001000;0
7178;86472;73;56;25;3;22;.880;3600000;0
7179;168651;151;49;31;5;26;.839;3600000;0
7179;-1;80;0;0;0;0;.00nan;0;0
7179;142492;151;0;0;0;0;.00nan;0;0
7179;152851;80;68;26;2;24;.923;3600000;0
7180;163195;4921;0;0;0;0;.00nan;0;0
7180;-1;149;0;0;0;0;.00nan;0;0
7180;64722;149;50;33;5;28;.848;3600000;0
7180;85661;4921;87;35;2;33;.943;3600000;0
7181;-1;78;0;0;0;0;.00nan;0;0
7181;-1;4620;76;20;1;19;.950;3600000;0
7181;173961;4620;0;0;0;0;.00nan;0;0
7181;184437;78;97;41;2;39;.951;3600000;0
7182;171970;74;67;34;3;31;.912;3600000;0
7182;2495;1097;0;0;0;0;.00nan;0;0
7182;170612;74;0;0;0;0;.00nan;0;0
7182;170728;1097;81;28;2;26;.929;3600000;0
7183;165611;81;0;0;0;0;.00nan;0;0
7183;186520;157;0;0;0;0;.00nan;0;0
7183;70213;81;62;37;5;32;.865;3592000;0
7183;85437;157;54;21;3;18;.857;3600000;0
7184;173856;75;82;48;4;44;.917;3573000;0
7184;171615;75;0;0;0;0;.00nan;0;0
7184;-1;1095;75;29;2;27;.931;3600000;0
7184;176770;1095;0;0;0;0;.00nan;0;0
7185;165611;81;0;0;0;0;.00nan;0;0
7185;178911;152;0;0;0;0;.00nan;0;0
7185;178950;152;52;31;3;28;.903;3900000;0
7185;70213;81;77;25;3;22;.880;3900000;0
7186;2495;1097;0;0;0;0;.00nan;0;0
7186;170728;1097;82;26;1;25;.962;3600000;0
7186;179411;4922;67;37;3;34;.919;3528000;0
7186;161046;4922;0;0;0;0;.00nan;0;0
7187;-1;78;0;0;0;0;.00nan;0;0
7187;173874;158;0;0;0;0;.00nan;0;0
7187;184437;78;82;33;3;30;.909;3846000;0
7187;91398;158;70;36;4;32;.889;3846000;0
7188;163784;77;0;0;0;0;.00nan;0;0
7188;64961;77;69;41;4;37;.902;3600000;0
7188;85555;76;82;12;0;12;1.000;3600000;0
7188;91703;76;0;0;0;0;.00nan;0;0
7189;173823;73;0;0;0;0;.00nan;0;0
7189;180873;69;0;0;0;0;.00nan;0;0
7189;57215;69;70;52;6;46;.885;3600000;0
7189;86472;73;72;27;3;24;.889;3600000;0
7190;4487;4920;0;0;0;0;.00nan;0;0
7190;164987;85;0;0;0;0;.00nan;0;0
7190;57207;85;60;26;3;23;.885;3587000;0
7190;149450;4920;90;34;2;32;.941;3600000;0
7191;4487;4920;0;0;0;0;.00nan;0;0
7191;165380;67;58;7;0;7;1.000;698000;0
7191;44487;67;54;44;6;38;.864;2902000;0
7191;149450;4920;68;21;2;19;.905;3600000;0
7192;2495;1097;0;0;0;0;.00nan;0;0
7192;170728;1097;100;28;0;28;1.000;3600000;0
7192;179411;4922;41;35;6;29;.829;2073000;0
7192;161046;4922;38;15;3;12;.800;1527000;0
7193;182339;82;64;26;2;24;.923;3600000;0
7193;171660;1096;0;0;0;0;.00nan;0;0
7193;-1;1096;59;36;5;31;.861;3600000;0
7193;185812;82;0;0;0;0;.00nan;0;0
7194;-1;78;60;30;3;27;.900;3600000;0
7194;173874;158;0;0;0;0;.00nan;0;0
7194;184437;78;0;0;0;0;.00nan;0;0
7194;91398;158;100;30;0;30;1.000;3600000;0
7195;171970;74;59;28;3;25;.893;3539000;0
7195;170612;74;0;0;0;0;.00nan;0;0
7195;85555;76;62;16;1;15;.938;3600000;0
7195;91703;76;0;0;0;0;.00nan;0;0
7196;173823;73;0;0;0;0;.00nan;0;0
7196;-1;2564;80;38;3;35;.921;3561000;0
7196;86472;73;68;17;1;16;.941;3600000;0
7196;161047;2564;0;0;0;0;.00nan;0;0
7197;183730;4245;54;47;7;40;.851;3534000;0
7197;184398;4245;0;0;0;0;.00nan;0;0
7197;186520;157;0;0;0;0;.00nan;0;0
7197;85437;157;89;44;4;40;.909;3600000;0
7198;173856;75;54;23;3;20;.870;1469000;0
7198;171615;75;45;36;6;30;.833;2131000;0
7198;181446;71;0;0;0;0;.00nan;0;0
7198;46790;71;83;23;1;22;.957;3600000;0
7199;163784;77;0;0;0;0;.00nan;0;0
7199;-1;1095;79;15;0;15;1.000;3900000;0
7199;176770;1095;0;0;0;0;.00nan;0;0
7199;64961;77;100;50;0;50;1.000;3900000;0
7200;180873;69;0;0;0;0;.00nan;0;0
7200;44189;72;0;0;0;0;.00nan;0;0
7200;57215;69;76;55;6;49;.891;3600000;0
7200;64811;72;100;33;0;33;1.000;3600000;0
7201;165611;81;0;0;0;0;.00nan;0;0
7201;-1;149;0;0;0;0;.00nan;0;0
7201;64722;149;54;23;3;20;.870;3593000;0
7201;70213;81;60;19;2;17;.895;3600000;0
7202;-1;80;0;0;0;0;.00nan;0;0
7202;178911;152;61;36;4;32;.889;3543000;0
7202;178950;152;0;0;0;0;.00nan;0;0
7202;152851;80;72;26;2;24;.923;3600000;0
7203;164987;85;0;0;0;0;.00nan;0;0
7203;-1;4620;76;19;1;18;.947;3600000;0
7203;173961;4620;0;0;0;0;.00nan;0;0
7203;57207;85;65;39;4;35;.897;3580000;0
7204;-1;2564;0;0;0;0;.00nan;0;0
7204;44189;72;0;0;0;0;.00nan;0;0
7204;64811;72;59;28;3;25;.893;3900000;0
7204;161047;2564;66;35;3;32;.914;3900000;0
7205;163195;4921;0;0;0;0;.00nan;0;0
7205;180873;69;100;34;1;33;.971;3701000;0
7205;57215;69;0;0;0;0;.00nan;0;0
7205;85661;4921;66;22;2;20;.909;3701000;0
7206;182339;82;0;0;0;0;.00nan;0;0
7206;179411;4922;73;33;2;31;.939;3549000;0
7206;185812;82;76;26;1;25;.962;3600000;0
7206;161046;4922;0;0;0;0;.00nan;0;0
7207;-1;78;0;0;0;0;.00nan;0;0
7207;173874;158;0;0;0;0;.00nan;0;0
7207;184437;78;51;30;4;26;.867;3600000;0
7207;91398;158;84;23;1;22;.957;3600000;0
7208;4487;4920;47;38;6;32;.842;3078000;0
7208;165380;67;77;41;4;37;.902;3600000;0
7208;44487;67;0;0;0;0;.00nan;0;0
7208;149450;4920;32;3;2;1;.333;522000;0
7209;183730;4245;0;0;0;0;.00nan;0;0
7209;184398;4245;95;46;4;42;.913;3900000;0
7209;186520;157;0;0;0;0;.00nan;0;0
7209;85437;157;62;35;4;31;.886;3900000;0
7210;173856;75;81;40;3;37;.925;3579000;0
7210;171615;75;0;0;0;0;.00nan;0;0
7210;181446;71;79;23;1;22;.957;3600000;0
7210;46790;71;0;0;0;0;.00nan;0;0
7211;163784;77;0;0;0;0;.00nan;0;0
7211;-1;1095;86;29;1;28;.966;3600000;0
7211;176770;1095;0;0;0;0;.00nan;0;0
7211;64961;77;86;31;2;29;.935;3600000;0
7212;171970;74;0;0;0;0;.00nan;0;0
7212;170612;74;84;39;2;37;.949;3600000;0
7212;85555;76;42;28;5;23;.821;3600000;0
7212;91703;76;0;0;0;0;.00nan;0;0
7213;2495;1097;0;0;0;0;.00nan;0;0
7213;170728;1097;63;32;3;29;.906;3600000;0
7213;171660;1096;8;24;7;17;.708;2906000;0
7213;-1;1096;56;5;0;5;1.000;694000;0
7214;165611;81;63;28;3;25;.893;3600000;0
7214;-1;149;87;47;4;43;.915;3561000;0
7214;64722;149;0;0;0;0;.00nan;0;0
7214;70213;81;0;0;0;0;.00nan;0;0
7215;-1;80;86;31;2;29;.935;3600000;0
7215;178911;152;0;0;0;0;.00nan;0;0
7215;178950;152;68;28;3;25;.893;3573000;0
7215;152851;80;0;0;0;0;.00nan;0;0
7216;164987;85;81;46;4;42;.913;3900000;0
7216;-1;4620;0;0;0;0;.00nan;0;0
7216;173961;4620;56;24;4;20;.833;3900000;0
7216;57207;85;0;0;0;0;.00nan;0;0
7217;4487;4920;0;0;0;0;.00nan;0;0
7217;164987;85;0;0;0;0;.00nan;0;0
7217;57207;85;90;43;2;41;.953;3900000;0
7217;149450;4920;77;28;2;26;.929;3900000;0
7218;2495;1097;89;49;3;46;.939;3600000;0
7218;170728;1097;0;0;0;0;.00nan;0;0
7218;85555;76;55;33;4;29;.879;3587000;0
7218;91703;76;0;0;0;0;.00nan;0;0
7219;163195;4921;78;40;3;37;.925;3598000;0
7219;180873;69;0;0;0;0;.00nan;0;0
7219;57215;69;71;20;1;19;.950;3600000;0
7219;85661;4921;0;0;0;0;.00nan;0;0
7220;165380;67;0;0;0;0;.00nan;0;0
7220;-1;4620;58;18;2;16;.889;3600000;0
7220;173961;4620;0;0;0;0;.00nan;0;0
7220;44487;67;56;32;4;28;.875;3592000;0
7221;183730;4245;100;30;0;30;1.000;3600000;0
7221;184398;4245;0;0;0;0;.00nan;0;0
7221;186520;157;0;0;0;0;.00nan;0;0
7221;85437;157;40;27;5;22;.815;3600000;0
7222;173856;75;53;3;0;3;1.000;1011000;0
7222;171615;75;41;37;6;31;.838;2589000;0
7222;181446;71;0;0;0;0;.00nan;0;0
7222;46790;71;62;20;2;18;.900;3600000;0
7223;163784;77;52;24;3;21;.875;3573000;0
7223;-1;1095;0;0;0;0;.00nan;0;0
7223;176770;1095;65;23;2;21;.913;3600000;0
7223;64961;77;0;0;0;0;.00nan;0;0
7224;182339;82;0;0;0;0;.00nan;0;0
7224;171660;1096;0;0;0;0;.00nan;0;0
7224;-1;1096;72;36;4;32;.889;3600000;0
7224;185812;82;91;35;1;34;.971;3600000;0
7225;-1;2564;98;50;3;47;.940;3600000;0
7225;44189;72;81;17;1;16;.941;3600000;0
7225;64811;72;0;0;0;0;.00nan;0;0
7225;161047;2564;0;0;0;0;.00nan;0;0
7226;165611;81;0;0;0;0;.00nan;0;0
7226;-1;149;0;0;0;0;.00nan;0;0
7226;64722;149;87;41;2;39;.951;3900000;0
7226;70213;81;86;37;2;35;.946;3900000;0
7227;-1;80;0;0;0;0;.00nan;0;0
7227;178911;152;73;30;3;27;.900;3600000;0
7227;178950;152;0;0;0;0;.00nan;0;0
7227;152851;80;65;37;4;33;.892;3581000;0
7228;178911;152;90;34;1;33;.971;3600000;0
7228;178950;152;0;0;0;0;.00nan;0;0
7228;186520;157;0;0;0;0;.00nan;0;0
7228;85437;157;85;31;2;29;.935;3542000;0
7229;171970;74;27;29;6;23;.793;1796000;0
7229;170612;74;48;21;3;18;.857;1804000;0
7229;179411;4922;78;30;2;28;.933;3600000;0
7229;161046;4922;0;0;0;0;.00nan;0;0
7230;182339;82;44;34;5;29;.853;3550000;0
7230;163784;77;0;0;0;0;.00nan;0;0
7230;185812;82;0;0;0;0;.00nan;0;0
7230;64961;77;61;36;4;32;.889;3600000;0
7231;168651;151;0;0;0;0;.00nan;0;0
7231;173874;158;0;0;0;0;.00nan;0;0
7231;91398;158;100;26;0;26;1.000;3600000;0
7231;142492;151;81;30;1;29;.967;3559000;0
7232;181446;71;0;0;0;0;.00nan;0;0
7232;44189;72;0;0;0;0;.00nan;0;0
7232;46790;71;100;28;0;28;1.000;3600000;0
7232;64811;72;83;30;2;28;.933;3551000;0
7233;164987;85;0;0;0;0;.00nan;0;0
7233;165380;67;82;39;3;36;.923;3600000;0
7233;44487;67;0;0;0;0;.00nan;0;0
7233;57207;85;32;16;4;12;.750;3536000;0
7234;-1;149;0;0;0;0;.00nan;0;0
7234;180873;69;0;0;0;0;.00nan;0;0
7234;57215;69;63;24;3;21;.875;3600000;0
7234;64722;149;62;40;4;36;.900;3599000;0
7235;4487;4920;50;1;0;1;1.000;504000;0
7235;183730;4245;76;27;2;25;.926;3600000;0
7235;184398;4245;0;0;0;0;.00nan;0;0
7235;149450;4920;7;21;7;14;.667;3096000;0
7236;178911;152;0;0;0;0;.00nan;0;0
7236;178950;152;44;23;4;19;.826;3573000;0
7236;186520;157;0;0;0;0;.00nan;0;0
7236;85437;157;81;36;3;33;.917;3600000;0
7237;171970;74;59;33;3;30;.909;3600000;0
7237;170612;74;0;0;0;0;.00nan;0;0
7237;179411;4922;0;0;0;0;.00nan;0;0
7237;161046;4922;100;34;0;34;1.000;3600000;0
7238;182339;82;0;0;0;0;.00nan;0;0
7238;163784;77;0;0;0;0;.00nan;0;0
7238;185812;82;83;32;2;30;.938;3600000;0
7238;64961;77;60;16;1;15;.938;3600000;0
7239;168651;151;86;32;1;31;.969;3600000;0
7239;173874;158;0;0;0;0;.00nan;0;0
7239;91398;158;68;30;3;27;.900;3533000;0
7239;142492;151;0;0;0;0;.00nan;0;0
7240;171660;1096;0;0;0;0;.00nan;0;0
7240;-1;1096;35;28;5;23;.821;3551000;0
7240;85555;76;25;6;3;3;.500;199000;0
7240;91703;76;100;43;1;42;.977;3401000;0
7241;173823;73;0;0;0;0;.00nan;0;0
7241;44189;72;0;0;0;0;.00nan;0;0
7241;64811;72;62;15;1;14;.933;3600000;0
7241;86472;73;98;47;2;45;.957;3600000;0
7242;-1;149;0;0;0;0;.00nan;0;0
7242;180873;69;0;0;0;0;.00nan;0;0
7242;57215;69;98;36;1;35;.972;3600000;0
7242;64722;149;81;34;2;32;.941;3565000;0
7243;165380;67;0;0;0;0;.00nan;0;0
7243;-1;78;87;32;2;30;.938;3600000;0
7243;184437;78;0;0;0;0;.00nan;0;0
7243;44487;67;59;27;3;24;.889;3564000;0
7244;2495;1097;0;0;0;0;.00nan;0;0
7244;164987;85;0;0;0;0;.00nan;0;0
7244;170728;1097;77;30;3;27;.900;3600000;0
7244;57207;85;90;31;1;30;.968;3600000;0
7245;163195;4921;53;41;5;36;.878;3600000;0
7245;165611;81;0;0;0;0;.00nan;0;0
7245;70213;81;53;25;4;21;.840;3600000;0
7245;85661;4921;0;0;0;0;.00nan;0;0
7246;-1;1095;0;0;0;0;.00nan;0;0
7246;176770;1095;69;23;2;21;.913;3600000;0
7246;181446;71;0;0;0;0;.00nan;0;0
7246;46790;71;55;31;4;27;.871;3567000;0
7247;-1;80;56;18;3;15;.833;3600000;0
7247;-1;2564;7;14;6;8;.571;1641000;0
7247;152851;80;0;0;0;0;.00nan;0;0
7247;161047;2564;66;15;1;14;.933;1959000;0
7248;-1;4620;76;23;1;22;.957;3600000;0
7248;173856;75;89;55;5;50;.909;3600000;0
7248;173961;4620;0;0;0;0;.00nan;0;0
7248;171615;75;0;0;0;0;.00nan;0;0
7249;178911;152;62;19;2;17;.895;3600000;0
7249;178950;152;0;0;0;0;.00nan;0;0
7249;186520;157;0;0;0;0;.00nan;0;0
7249;85437;157;98;69;4;65;.942;3569000;0
7250;171970;74;0;0;0;0;.00nan;0;0
7250;170612;74;72;46;4;42;.913;3900000;0
7250;179411;4922;0;0;0;0;.00nan;0;0
7250;161046;4922;57;33;4;29;.879;3900000;0
7251;168651;151;0;0;0;0;.00nan;0;0
7251;173874;158;79;29;2;27;.931;3900000;0
7251;91398;158;0;0;0;0;.00nan;0;0
7251;142492;151;71;28;2;26;.929;3900000;0
7252;182339;82;67;34;3;31;.912;3573000;0
7252;185812;82;0;0;0;0;.00nan;0;0
7252;85555;76;74;22;1;21;.955;3600000;0
7252;91703;76;0;0;0;0;.00nan;0;0
7253;4487;4920;0;0;0;0;.00nan;0;0
7253;183730;4245;0;0;0;0;.00nan;0;0
7253;184398;4245;79;27;1;26;.963;3543000;0
7253;149450;4920;98;23;0;23;1.000;3600000;0
7254;-1;149;59;23;3;20;.870;3575000;0
7254;180873;69;87;36;2;34;.944;3600000;0
7254;57215;69;0;0;0;0;.00nan;0;0
7254;64722;149;0;0;0;0;.00nan;0;0
7255;165380;67;98;36;1;35;.972;3600000;0
7255;-1;78;0;0;0;0;.00nan;0;0
7255;184437;78;85;15;0;15;1.000;3600000;0
7255;44487;67;0;0;0;0;.00nan;0;0
7256;163784;77;51;32;4;28;.875;3555000;0
7256;171660;1096;48;23;3;20;.870;3600000;0
7256;-1;1096;0;0;0;0;.00nan;0;0
7256;64961;77;0;0;0;0;.00nan;0;0
7257;173823;73;21;33;7;26;.788;3600000;0
7257;44189;72;83;29;2;27;.931;3600000;0
7257;64811;72;0;0;0;0;.00nan;0;0
7257;86472;73;0;0;0;0;.00nan;0;0
7258;2495;1097;72;40;4;36;.900;3828000;0
7258;164987;85;72;33;3;30;.909;3810000;0
7258;170728;1097;0;0;0;0;.00nan;0;0
7258;57207;85;0;0;0;0;.00nan;0;0
7259;163195;4921;0;0;0;0;.00nan;0;0
7259;165611;81;21;22;6;16;.727;2632000;0
7259;70213;81;51;2;0;2;1.000;913000;0
7259;85661;4921;76;38;4;34;.895;3600000;0
7260;-1;1095;67;31;3;28;.903;3591000;0
7260;176770;1095;0;0;0;0;.00nan;0;0
7260;181446;71;54;19;2;17;.895;3600000;0
7260;46790;71;0;0;0;0;.00nan;0;0
7261;-1;80;0;0;0;0;.00nan;0;0
7261;-1;2564;67;25;2;23;.920;3600000;0
7261;152851;80;48;20;3;17;.850;3600000;0
7261;161047;2564;0;0;0;0;.00nan;0;0
7262;-1;4620;0;0;0;0;.00nan;0;0
7262;173856;75;0;0;0;0;.00nan;0;0
7262;173961;4620;48;19;3;16;.842;3702000;0
7262;171615;75;71;27;2;25;.926;3702000;0
7263;4487;4920;0;0;0;0;.00nan;0;0
7263;183730;4245;82;33;3;30;.909;3900000;0
7263;184398;4245;0;0;0;0;.00nan;0;0
7263;149450;4920;57;26;3;23;.885;3900000;0
7264;171660;1096;0;0;0;0;.00nan;0;0
7264;-1;1096;52;32;4;28;.875;3600000;0
7264;85555;76;66;23;2;21;.913;3600000;0
7264;91703;76;0;0;0;0;.00nan;0;0
7265;181446;71;0;0;0;0;.00nan;0;0
7265;44189;72;52;11;2;9;.818;1668000;0
7265;46790;71;47;31;6;25;.806;3900000;0
7265;64811;72;41;17;4;13;.765;2232000;0
7266;173823;73;0;0;0;0;.00nan;0;0
7266;-1;1095;0;0;0;0;.00nan;0;0
7266;176770;1095;80;43;3;40;.930;3549000;0
7266;86472;73;88;32;1;31;.969;3600000;0
7267;-1;80;95;47;3;44;.936;3575000;0
7267;186520;157;0;0;0;0;.00nan;0;0
7267;85437;157;70;29;2;27;.931;3600000;0
7267;152851;80;0;0;0;0;.00nan;0;0
7268;-1;4620;67;30;3;27;.900;3600000;0
7268;173856;75;86;57;5;52;.912;3586000;0
7268;173961;4620;0;0;0;0;.00nan;0;0
7268;171615;75;0;0;0;0;.00nan;0;0
7269;165611;81;0;0;0;0;.00nan;0;0
7269;178911;152;73;45;5;40;.889;3600000;0
7269;178950;152;0;0;0;0;.00nan;0;0
7269;70213;81;90;30;1;29;.967;3600000;0
7270;163195;4921;0;0;0;0;.00nan;0;0
7270;-1;2564;100;28;0;28;1.000;3600000;0
7270;85661;4921;61;22;2;20;.909;3535000;0
7270;161047;2564;0;0;0;0;.00nan;0;0
7271;165380;67;0;0;0;0;.00nan;0;0
7271;-1;78;0;0;0;0;.00nan;0;0
7271;184437;78;81;26;1;25;.962;3600000;0
7271;44487;67;49;38;6;32;.842;3600000;0
7272;2495;1097;0;0;0;0;.00nan;0;0
7272;170728;1097;27;36;7;29;.806;3600000;0
7272;85555;76;78;37;2;35;.946;3600000;0
7272;91703;76;0;0;0;0;.00nan;0;0
7273;-1;2564;51;30;5;25;.833;2295000;0
7273;44189;72;0;0;0;0;.00nan;0;0
7273;64811;72;76;22;1;21;.955;3600000;0
7273;161047;2564;38;18;4;14;.778;1305000;0
7274;-1;4620;61;22;2;20;.909;3900000;0
7274;173961;4620;0;0;0;0;.00nan;0;0
7274;180873;69;0;0;0;0;.00nan;0;0
7274;57215;69;100;53;2;51;.962;3900000;0
7275;173823;73;0;0;0;0;.00nan;0;0
7275;181446;71;59;18;2;16;.889;2440000;0
7275;46790;71;44;23;4;19;.826;1160000;0
7275;86472;73;84;37;3;34;.919;3600000;0
7276;163195;4921;97;47;1;46;.979;3900000;0
7276;-1;1095;0;0;0;0;.00nan;0;0
7276;176770;1095;90;29;1;28;.966;3900000;0
7276;85661;4921;0;0;0;0;.00nan;0;0
7277;168651;151;88;48;2;46;.958;3587000;0
7277;186520;157;0;0;0;0;.00nan;0;0
7277;85437;157;82;26;1;25;.962;3600000;0
7277;142492;151;0;0;0;0;.00nan;0;0
7278;165380;67;63;32;3;29;.906;3534000;0
7278;-1;78;0;0;0;0;.00nan;0;0
7278;184437;78;81;22;1;21;.955;3600000;0
7278;44487;67;0;0;0;0;.00nan;0;0
7279;183730;4245;0;0;0;0;.00nan;0;0
7279;173856;75;51;20;3;17;.850;1437000;0
7279;184398;4245;72;24;1;23;.958;3600000;0
7279;171615;75;27;27;6;21;.778;2163000;0
7280;163784;77;0;0;0;0;.00nan;0;0
7280;179411;4922;54;38;5;33;.868;3600000;0
7280;64961;77;68;33;3;30;.909;3600000;0
7280;161046;4922;0;0;0;0;.00nan;0;0
7281;-1;149;0;0;0;0;.00nan;0;0
7281;173874;158;0;0;0;0;.00nan;0;0
7281;64722;149;82;30;2;28;.933;3600000;0
7281;91398;158;98;43;3;40;.930;3569000;0
7282;182339;82;0;0;0;0;.00nan;0;0
7282;171660;1096;0;0;0;0;.00nan;0;0
7282;-1;1096;57;37;5;32;.865;3588000;0
7282;185812;82;78;42;4;38;.905;3600000;0
7283;4487;4920;0;0;0;0;.00nan;0;0
7283;164987;85;0;0;0;0;.00nan;0;0
7283;57207;85;98;28;1;27;.964;3600000;0
7283;149450;4920;66;35;3;32;.914;3550000;0
7284;165611;81;0;0;0;0;.00nan;0;0
7284;-1;80;0;0;0;0;.00nan;0;0
7284;70213;81;60;27;3;24;.889;3900000;0
7284;152851;80;72;32;3;29;.906;3900000;0
7285;2495;1097;85;36;2;34;.944;3600000;0
7285;170728;1097;0;0;0;0;.00nan;0;0
7285;171660;1096;38;31;6;25;.806;3600000;0
7285;-1;1096;0;0;0;0;.00nan;0;0
7286;-1;4620;0;0;0;0;.00nan;0;0
7286;173961;4620;40;22;4;18;.818;3900000;0
7286;180873;69;85;48;4;44;.917;3900000;0
7286;57215;69;0;0;0;0;.00nan;0;0
7287;182339;82;80;38;3;35;.921;3528000;0
7287;185812;82;0;0;0;0;.00nan;0;0
7287;85555;76;0;0;0;0;.00nan;0;0
7287;91703;76;77;27;1;26;.963;3600000;0
7288;181446;71;0;0;0;0;.00nan;0;0
7288;44189;72;0;0;0;0;.00nan;0;0
7288;46790;71;65;22;2;20;.909;3900000;0
7288;64811;72;90;37;2;35;.946;3900000;0
7289;163195;4921;0;0;0;0;.00nan;0;0
7289;-1;1095;86;30;1;29;.967;3600000;0
7289;176770;1095;0;0;0;0;.00nan;0;0
7289;85661;4921;61;54;6;48;.889;3600000;0
7290;173823;73;55;34;4;30;.882;3613000;0
7290;-1;2564;65;27;3;24;.889;3613000;0
7290;86472;73;0;0;0;0;.00nan;0;0
7290;161047;2564;0;0;0;0;.00nan;0;0
7291;168651;151;0;0;0;0;.00nan;0;0
7291;186520;157;0;0;0;0;.00nan;0;0
7291;85437;157;46;21;3;18;.857;3600000;0
7291;142492;151;68;47;5;42;.894;3568000;0
7292;165380;67;0;0;0;0;.00nan;0;0
7292;-1;78;38;22;4;18;.818;3600000;0
7292;184437;78;0;0;0;0;.00nan;0;0
7292;44487;67;87;28;1;27;.964;3600000;0
7293;183730;4245;0;0;0;0;.00nan;0;0
7293;173856;75;0;0;0;0;.00nan;0;0
7293;184398;4245;60;26;3;23;.885;3575000;0
7293;171615;75;99;50;2;48;.960;3600000;0
7294;-1;149;60;27;3;24;.889;3600000;0
7294;173874;158;0;0;0;0;.00nan;0;0
7294;64722;149;0;0;0;0;.00nan;0;0
7294;91398;158;87;31;2;29;.935;3600000;0
7295;171970;74;71;26;2;24;.923;3600000;0
7295;170612;74;0;0;0;0;.00nan;0;0
7295;179411;4922;0;0;0;0;.00nan;0;0
7295;161046;4922;41;28;5;23;.821;3600000;0
7296;4487;4920;59;21;2;19;.905;3600000;0
7296;164987;85;40;29;5;24;.828;3600000;0
7296;57207;85;0;0;0;0;.00nan;0;0
7296;149450;4920;0;0;0;0;.00nan;0;0
7297;-1;4620;57;24;3;21;.875;3600000;0
7297;173961;4620;0;0;0;0;.00nan;0;0
7297;180873;69;64;12;1;11;.917;654000;0
7297;57215;69;47;37;6;31;.838;2946000;0
7298;182339;82;0;0;0;0;.00nan;0;0
7298;185812;82;86;41;2;39;.951;3562000;0
7298;85555;76;68;19;1;18;.947;3600000;0
7298;91703;76;0;0;0;0;.00nan;0;0
7299;165380;67;48;32;5;27;.844;3572000;0
7299;-1;78;0;0;0;0;.00nan;0;0
7299;184437;78;55;22;3;19;.864;3600000;0
7299;44487;67;0;0;0;0;.00nan;0;0
7300;183730;4245;53;33;4;29;.879;3514000;0
7300;173856;75;76;27;2;25;.926;3600000;0
7300;184398;4245;0;0;0;0;.00nan;0;0
7300;171615;75;0;0;0;0;.00nan;0;0
7301;171970;74;0;0;0;0;.00nan;0;0
7301;170612;74;91;20;0;20;1.000;3600000;0
7301;179411;4922;68;32;3;29;.906;3600000;0
7301;161046;4922;0;0;0;0;.00nan;0;0
7302;163784;77;0;0;0;0;.00nan;0;0
7302;171660;1096;0;0;0;0;.00nan;0;0
7302;-1;1096;64;30;4;26;.867;3877000;0
7302;64961;77;73;41;4;37;.902;3900000;0
7303;163195;4921;47;37;6;31;.838;3600000;0
7303;-1;2564;0;0;0;0;.00nan;0;0
7303;85661;4921;0;0;0;0;.00nan;0;0
7303;161047;2564;81;14;0;14;1.000;3600000;0
7304;2495;1097;0;0;0;0;.00nan;0;0
7304;170728;1097;48;20;3;17;.850;3590000;0
7304;179411;4922;100;44;1;43;.977;3600000;0
7304;161046;4922;0;0;0;0;.00nan;0;0
7305;168651;151;55;45;5;40;.889;3547000;0
7305;178911;152;51;25;4;21;.840;3600000;0
7305;178950;152;0;0;0;0;.00nan;0;0
7305;142492;151;0;0;0;0;.00nan;0;0
7306;183730;4245;50;18;2;16;.889;3557000;0
7306;173856;75;94;52;1;51;.981;3600000;0
7306;184398;4245;0;0;0;0;.00nan;0;0
7306;171615;75;0;0;0;0;.00nan;0;0
7307;-1;78;0;0;0;0;.00nan;0;0
7307;184437;78;100;34;1;33;.971;3600000;0
7307;-1;1095;0;0;0;0;.00nan;0;0
7307;176770;1095;78;30;2;28;.933;3550000;0
7308;-1;149;0;0;0;0;.00nan;0;0
7308;186520;157;83;28;1;27;.964;3600000;0
7308;64722;149;71;43;4;39;.907;3600000;0
7308;85437;157;0;0;0;0;.00nan;0;0
7309;171970;74;0;0;0;0;.00nan;0;0
7309;163784;77;0;0;0;0;.00nan;0;0
7309;170612;74;100;36;0;36;1.000;3600000;0
7309;64961;77;72;32;2;30;.938;3528000;0
7310;4487;4920;0;0;0;0;.00nan;0;0
7310;183730;4245;92;42;3;39;.929;3870000;0
7310;184398;4245;0;0;0;0;.00nan;0;0
7310;149450;4920;56;21;2;19;.905;3870000;0
7311;-1;2564;0;0;0;0;.00nan;0;0
7311;44189;72;0;0;0;0;.00nan;0;0
7311;64811;72;85;27;1;26;.963;3600000;0
7311;161047;2564;75;29;3;26;.897;3563000;0
7312;182339;82;0;0;0;0;.00nan;0;0
7312;179411;4922;69;47;5;42;.894;3525000;0
7312;185812;82;61;21;3;18;.857;3600000;0
7312;161046;4922;0;0;0;0;.00nan;0;0
7313;163195;4921;55;33;3;30;.909;3577000;0
7313;181446;71;0;0;0;0;.00nan;0;0
7313;46790;71;95;27;1;26;.963;3600000;0
7313;85661;4921;0;0;0;0;.00nan;0;0
7314;173823;73;0;0;0;0;.00nan;0;0
7314;180873;69;0;0;0;0;.00nan;0;0
7314;57215;69;72;34;4;30;.882;3600000;0
7314;86472;73;100;23;0;23;1.000;3600000;0
7315;168651;151;0;0;0;0;.00nan;0;0
7315;178911;152;57;26;3;23;.885;3600000;0
7315;178950;152;0;0;0;0;.00nan;0;0
7315;142492;151;49;33;5;28;.848;3572000;0
7316;2495;1097;0;0;0;0;.00nan;0;0
7316;163784;77;51;33;4;29;.879;3577000;0
7316;170728;1097;51;21;3;18;.857;3600000;0
7316;64961;77;0;0;0;0;.00nan;0;0
7317;-1;78;90;56;3;53;.946;3600000;0
7317;184437;78;0;0;0;0;.00nan;0;0
7317;-1;1095;75;26;2;24;.923;3600000;0
7317;176770;1095;0;0;0;0;.00nan;0;0
7318;171970;74;0;0;0;0;.00nan;0;0
7318;170612;74;72;36;3;33;.917;3600000;0
7318;85555;76;24;11;4;7;.636;923000;0
7318;91703;76;49;13;2;11;.846;2677000;0
7319;-1;80;0;0;0;0;.00nan;0;0
7319;171660;1096;0;0;0;0;.00nan;0;0
7319;-1;1096;64;40;4;36;.900;3900000;0
7319;152851;80;57;22;4;18;.818;3900000;0
7320;164987;85;0;0;0;0;.00nan;0;0
7320;165380;67;0;0;0;0;.00nan;0;0
7320;44487;67;72;45;4;41;.911;3600000;0
7320;57207;85;91;17;0;17;1.000;3600000;0
7321;165611;81;0;0;0;0;.00nan;0;0
7321;173874;158;0;0;0;0;.00nan;0;0
7321;70213;81;98;37;2;35;.946;3600000;0
7321;91398;158;61;29;3;26;.897;3556000;0
7322;-1;149;0;0;0;0;.00nan;0;0
7322;186520;157;0;0;0;0;.00nan;0;0
7322;64722;149;62;39;5;34;.872;3600000;0
7322;85437;157;65;23;2;21;.913;3600000;0
7323;-1;4620;0;0;0;0;.00nan;0;0
7323;173856;75;58;48;6;42;.875;3600000;0
7323;173961;4620;83;14;0;14;1.000;3600000;0
7323;171615;75;0;0;0;0;.00nan;0;0
7324;4487;4920;68;17;1;16;.941;3600000;0
7324;164987;85;0;0;0;0;.00nan;0;0
7324;57207;85;64;34;4;30;.882;3600000;0
7324;149450;4920;0;0;0;0;.00nan;0;0
7325;-1;2564;83;33;2;31;.939;3600000;0
7325;180873;69;36;20;4;16;.800;3600000;0
7325;57215;69;0;0;0;0;.00nan;0;0
7325;161047;2564;0;0;0;0;.00nan;0;0
7326;182339;82;47;19;3;16;.842;3600000;0
7326;179411;4922;0;0;0;0;.00nan;0;0
7326;185812;82;0;0;0;0;.00nan;0;0
7326;161046;4922;40;31;5;26;.839;3544000;0
7327;163195;4921;100;49;2;47;.959;3750000;0
7327;181446;71;71;31;3;28;.903;3750000;0
7327;46790;71;0;0;0;0;.00nan;0;0
7327;85661;4921;0;0;0;0;.00nan;0;0
7328;168651;151;90;40;2;38;.950;3600000;0
7328;178911;152;0;0;0;0;.00nan;0;0
7328;178950;152;38;29;5;24;.828;3600000;0
7328;142492;151;0;0;0;0;.00nan;0;0
7329;165380;67;47;38;6;32;.842;3600000;0
7329;183730;4245;0;0;0;0;.00nan;0;0
7329;184398;4245;71;26;2;24;.923;3600000;0
7329;44487;67;0;0;0;0;.00nan;0;0
7330;2495;1097;100;39;0;39;1.000;3900000;0
7330;163784;77;0;0;0;0;.00nan;0;0
7330;170728;1097;0;0;0;0;.00nan;0;0
7330;64961;77;94;28;0;28;1.000;3900000;0
7331;-1;78;0;0;0;0;.00nan;0;0
7331;184437;78;69;32;3;29;.906;3600000;0
7331;-1;1095;62;9;0;9;1.000;1356000;0
7331;176770;1095;27;30;6;24;.800;2244000;0
7332;171970;74;66;33;3;30;.909;3600000;0
7332;170612;74;0;0;0;0;.00nan;0;0
7332;85555;76;93;24;0;24;1.000;3600000;0
7332;91703;76;0;0;0;0;.00nan;0;0
7333;-1;80;73;18;1;17;.944;3900000;0
7333;171660;1096;69;20;1;19;.950;3900000;0
7333;-1;1096;0;0;0;0;.00nan;0;0
7333;152851;80;0;0;0;0;.00nan;0;0
7334;173823;73;66;16;1;15;.938;1371000;0
7334;44189;72;72;19;1;18;.947;3600000;0
7334;64811;72;0;0;0;0;.00nan;0;0
7334;86472;73;29;28;6;22;.786;2229000;0
7335;165611;81;89;27;1;26;.963;3600000;0
7335;173874;158;0;0;0;0;.00nan;0;0
7335;70213;81;0;0;0;0;.00nan;0;0
7335;91398;158;94;37;2;35;.946;3600000;0
7336;-1;149;53;35;4;31;.886;3600000;0
7336;186520;157;0;0;0;0;.00nan;0;0
7336;64722;149;0;0;0;0;.00nan;0;0
7336;85437;157;80;24;1;23;.958;3600000;0
7337;-1;4620;0;0;0;0;.00nan;0;0
7337;173856;75;52;34;5;29;.853;2397000;0
7337;173961;4620;52;16;3;13;.813;3600000;0
7337;171615;75;70;17;1;16;.941;1203000;0
7338;4487;4920;0;0;0;0;.00nan;0;0
7338;173856;75;91;52;1;51;.981;3600000;0
7338;171615;75;0;0;0;0;.00nan;0;0
7338;149450;4920;63;18;2;16;.889;3580000;0
7339;173823;73;51;34;5;29;.853;2400000;0
7339;181446;71;0;0;0;0;.00nan;0;0
7339;46790;71;63;30;4;26;.867;3600000;0
7339;86472;73;21;10;4;6;.600;1200000;0
7340;165380;67;0;0;0;0;.00nan;0;0
7340;183730;4245;86;17;0;17;1.000;3600000;0
7340;184398;4245;0;0;0;0;.00nan;0;0
7340;44487;67;88;36;2;34;.944;3588000;0
7341;-1;80;0;0;0;0;.00nan;0;0
7341;171660;1096;0;0;0;0;.00nan;0;0
7341;-1;1096;70;30;3;27;.900;3765000;0
7341;152851;80;73;23;2;21;.913;3765000;0
7342;-1;2564;0;0;0;0;.00nan;0;0
7342;44189;72;0;0;0;0;.00nan;0;0
7342;64811;72;81;13;0;13;1.000;3600000;0
7342;161047;2564;59;43;6;37;.860;3600000;0
7343;165611;81;0;0;0;0;.00nan;0;0
7343;173874;158;0;0;0;0;.00nan;0;0
7343;70213;81;82;28;2;26;.929;3600000;0
7343;91398;158;84;41;3;38;.927;3600000;0
7344;164987;85;62;30;3;27;.900;3600000;0
7344;-1;4620;80;28;2;26;.929;3600000;0
7344;173961;4620;0;0;0;0;.00nan;0;0
7344;57207;85;0;0;0;0;.00nan;0;0
7345;168651;151;84;32;2;30;.938;3600000;0
7345;186520;157;0;0;0;0;.00nan;0;0
7345;85437;157;62;26;3;23;.885;3582000;0
7345;142492;151;0;0;0;0;.00nan;0;0
7346;-1;2564;73;43;4;39;.907;3574000;0
7346;-1;1095;44;22;3;19;.864;3600000;0
7346;176770;1095;0;0;0;0;.00nan;0;0
7346;161047;2564;0;0;0;0;.00nan;0;0
7347;173874;158;0;0;0;0;.00nan;0;0
7347;178911;152;73;28;2;26;.929;3600000;0
7347;178950;152;0;0;0;0;.00nan;0;0
7347;91398;158;52;32;4;28;.875;3600000;0
7348;179411;4922;65;46;5;41;.891;3600000;0
7348;85555;76;80;13;0;13;1.000;3600000;0
7348;91703;76;0;0;0;0;.00nan;0;0
7348;161046;4922;0;0;0;0;.00nan;0;0
7349;4487;4920;0;0;0;0;.00nan;0;0
7349;169154;78;88;33;2;31;.939;3600000;0
7349;184437;78;0;0;0;0;.00nan;0;0
7349;149450;4920;69;18;1;17;.944;3600000;0
7350;-1;2564;35;38;6;32;.842;3600000;0
7350;180873;69;0;0;0;0;.00nan;0;0
7350;57215;69;68;21;1;20;.952;3600000;0
7350;161047;2564;0;0;0;0;.00nan;0;0
7351;182339;82;0;0;0;0;.00nan;0;0
7351;171660;1096;0;0;0;0;.00nan;0;0
7351;-1;1096;74;31;3;28;.903;3571000;0
7351;185812;82;65;26;2;24;.923;3600000;0
7352;173874;158;0;0;0;0;.00nan;0;0
7352;178911;152;69;22;1;21;.955;3600000;0
7352;178950;152;0;0;0;0;.00nan;0;0
7352;91398;158;62;23;2;21;.913;3575000;0
7353;2495;1097;53;33;5;28;.848;3600000;0
7353;170728;1097;0;0;0;0;.00nan;0;0
7353;85555;76;81;15;0;15;1.000;3600000;0
7353;91703;76;0;0;0;0;.00nan;0;0
7354;163195;4921;55;45;6;39;.867;3589000;0
7354;173823;73;0;0;0;0;.00nan;0;0
7354;85661;4921;0;0;0;0;.00nan;0;0
7354;86472;73;45;29;4;25;.862;3600000;0
7355;165380;67;0;0;0;0;.00nan;0;0
7355;-1;149;0;0;0;0;.00nan;0;0
7355;44487;67;81;62;5;57;.919;3600000;0
7355;64722;149;64;16;1;15;.938;3600000;0
7356;183730;4245;0;0;0;0;.00nan;0;0
7356;184398;4245;36;12;3;9;.750;3600000;0
7356;181446;71;0;0;0;0;.00nan;0;0
7356;46790;71;58;34;4;30;.882;3600000;0
7357;171970;74;0;0;0;0;.00nan;0;0
7357;170612;74;98;42;2;40;.952;3900000;0
7357;179411;4922;75;29;2;27;.931;3900000;0
7357;161046;4922;0;0;0;0;.00nan;0;0
7358;173856;75;64;37;4;33;.892;3600000;0
7358;171615;75;0;0;0;0;.00nan;0;0
7358;44189;72;0;0;0;0;.00nan;0;0
7358;64811;72;71;17;1;16;.941;3600000;0
7359;164987;85;50;27;3;24;.889;2568000;0
7359;-1;4620;91;15;0;15;1.000;3600000;0
7359;173961;4620;0;0;0;0;.00nan;0;0
7359;57207;85;26;15;5;10;.667;1032000;0
7360;165611;81;0;0;0;0;.00nan;0;0
7360;186520;157;0;0;0;0;.00nan;0;0
7360;70213;81;29;22;5;17;.773;3600000;0
7360;85437;157;94;29;1;28;.966;3600000;0
7361;163784;77;0;0;0;0;.00nan;0;0
7361;-1;1095;59;28;3;25;.893;3577000;0
7361;176770;1095;0;0;0;0;.00nan;0;0
7361;64961;77;76;24;1;23;.958;3600000;0
7362;168651;151;0;0;0;0;.00nan;0;0
7362;-1;80;0;0;0;0;.00nan;0;0
7362;142492;151;69;31;4;27;.871;3704000;0
7362;152851;80;91;40;3;37;.925;3704000;0
7363;2495;1097;0;0;0;0;.00nan;0;0
7363;170728;1097;56;38;5;33;.868;3600000;0
7363;171660;1096;79;35;2;33;.943;3600000;0
7363;-1;1096;0;0;0;0;.00nan;0;0
7364;-1;2564;0;0;0;0;.00nan;0;0
7364;180873;69;56;19;2;17;.895;3600000;0
7364;57215;69;0;0;0;0;.00nan;0;0
7364;161047;2564;90;52;4;48;.923;3589000;0
7365;182339;82;59;34;4;30;.882;3568000;0
7365;185812;82;0;0;0;0;.00nan;0;0
7365;85555;76;55;26;3;23;.885;3600000;0
7365;91703;76;0;0;0;0;.00nan;0;0
7366;173874;158;38;30;6;24;.800;2908000;0
7366;178911;152;0;0;0;0;.00nan;0;0
7366;178950;152;86;19;1;18;.947;3600000;0
7366;91398;158;50;6;1;5;.833;692000;0
7367;163195;4921;55;46;7;39;.848;3600000;0
7367;173823;73;72;24;2;22;.917;3600000;0
7367;85661;4921;0;0;0;0;.00nan;0;0
7367;86472;73;0;0;0;0;.00nan;0;0
7368;168651;151;85;28;2;26;.929;3569000;0
7368;-1;80;75;15;1;14;.933;3600000;0
7368;142492;151;0;0;0;0;.00nan;0;0
7368;152851;80;0;0;0;0;.00nan;0;0
7369;165380;67;29;15;4;11;.733;964000;0
7369;-1;149;50;18;3;15;.833;3600000;0
7369;44487;67;89;32;1;31;.969;2609000;0
7369;64722;149;0;0;0;0;.00nan;0;0
7370;183730;4245;86;28;1;27;.964;3600000;0
7370;184398;4245;0;0;0;0;.00nan;0;0
7370;181446;71;74;42;3;39;.929;3513000;0
7370;46790;71;0;0;0;0;.00nan;0;0
7371;4487;4920;0;0;0;0;.00nan;0;0
7371;169154;78;72;45;5;40;.889;3576000;0
7371;184437;78;0;0;0;0;.00nan;0;0
7371;149450;4920;71;31;3;28;.903;3600000;0
7372;171970;74;64;41;5;36;.878;3600000;0
7372;170612;74;0;0;0;0;.00nan;0;0
7372;179411;4922;0;0;0;0;.00nan;0;0
7372;161046;4922;54;32;4;28;.875;3600000;0
7373;173856;75;82;37;3;34;.919;3555000;0
7373;171615;75;0;0;0;0;.00nan;0;0
7373;44189;72;0;0;0;0;.00nan;0;0
7373;64811;72;73;21;2;19;.905;3600000;0
7374;164987;85;0;0;0;0;.00nan;0;0
7374;-1;4620;64;24;2;22;.917;3900000;0
7374;173961;4620;0;0;0;0;.00nan;0;0
7374;57207;85;72;25;2;23;.920;3900000;0
7375;165611;81;33;25;5;20;.800;3600000;0
7375;186520;157;0;0;0;0;.00nan;0;0
7375;70213;81;0;0;0;0;.00nan;0;0
7375;85437;157;73;20;1;19;.950;3600000;0
7376;163784;77;67;16;1;15;.938;3600000;0
7376;-1;1095;0;0;0;0;.00nan;0;0
7376;176770;1095;98;44;2;42;.955;3556000;0
7376;64961;77;0;0;0;0;.00nan;0;0
7377;2495;1097;70;28;3;25;.893;3600000;0
7377;170728;1097;0;0;0;0;.00nan;0;0
7377;171660;1096;0;0;0;0;.00nan;0;0
7377;-1;1096;46;36;6;30;.833;3600000;0
7378;173823;73;56;13;1;12;.923;1587000;0
7378;180873;69;0;0;0;0;.00nan;0;0
7378;57215;69;68;22;1;21;.955;3600000;0
7378;86472;73;18;18;6;12;.667;2013000;0
7379;182339;82;0;0;0;0;.00nan;0;0
7379;171970;74;0;0;0;0;.00nan;0;0
7379;170612;74;87;37;3;34;.919;3900000;0
7379;185812;82;87;42;3;39;.929;3900000;0
7380;165380;67;85;44;4;40;.909;3900000;0
7380;-1;149;0;0;0;0;.00nan;0;0
7380;44487;67;0;0;0;0;.00nan;0;0
7380;64722;149;50;26;4;22;.846;3900000;0
7381;183730;4245;0;0;0;0;.00nan;0;0
7381;184398;4245;78;43;3;40;.930;3600000;0
7381;181446;71;39;1;1;0;.000;248000;0
7381;46790;71;17;21;6;15;.714;3352000;0
7382;4487;4920;0;0;0;0;.00nan;0;0
7382;169154;78;82;39;3;36;.923;3600000;0
7382;184437;78;0;0;0;0;.00nan;0;0
7382;149450;4920;72;17;1;16;.941;3600000;0
7383;173856;75;0;0;0;0;.00nan;0;0
7383;171615;75;89;47;3;44;.936;3900000;0
7383;44189;72;58;25;3;22;.880;3893000;0
7383;64811;72;0;0;0;0;.00nan;0;0
7384;165611;81;0;0;0;0;.00nan;0;0
7384;186520;157;0;0;0;0;.00nan;0;0
7384;70213;81;78;30;2;28;.933;3600000;0
7384;85437;157;26;17;5;12;.706;3600000;0
7385;163784;77;0;0;0;0;.00nan;0;0
7385;-1;1095;82;31;1;30;.968;3600000;0
7385;176770;1095;0;0;0;0;.00nan;0;0
7385;64961;77;42;30;5;25;.833;3600000;0
7386;168651;151;0;0;0;0;.00nan;0;0
7386;-1;80;0;0;0;0;.00nan;0;0
7386;142492;151;56;27;3;24;.889;3600000;0
7386;152851;80;78;33;2;31;.939;3600000;0
7387;169154;78;60;30;4;26;.867;3586000;0
7387;184437;78;0;0;0;0;.00nan;0;0
7387;-1;1095;60;19;2;17;.895;3600000;0
7387;176770;1095;0;0;0;0;.00nan;0;0
7388;165611;81;0;0;0;0;.00nan;0;0
7388;178911;152;60;19;2;17;.895;3600000;0
7388;178950;152;0;0;0;0;.00nan;0;0
7388;70213;81;77;36;4;32;.889;3600000;0
7389;4487;4920;0;0;0;0;.00nan;0;0
7389;179411;4922;82;43;3;40;.930;3600000;0
7389;149450;4920;100;23;0;23;1.000;3600000;0
7389;161046;4922;0;0;0;0;.00nan;0;0
7390;163195;4921;69;38;4;34;.895;3585000;0
7390;173823;73;0;0;0;0;.00nan;0;0
7390;85661;4921;0;0;0;0;.00nan;0;0
7390;86472;73;87;29;3;26;.897;3600000;0
7391;163784;77;0;0;0;0;.00nan;0;0
7391;64961;77;82;32;1;31;.969;3600000;0
7391;85555;76;64;22;2;20;.909;3555000;0
7391;91703;76;0;0;0;0;.00nan;0;0
7392;168651;151;27;7;3;4;.571;486000;0
7392;180873;69;0;0;0;0;.00nan;0;0
7392;57215;69;100;28;0;28;1.000;3600000;0
7392;142492;151;44;29;5;24;.828;3114000;0
7393;2495;1097;46;51;7;44;.863;3600000;0
7393;170728;1097;0;0;0;0;.00nan;0;0
7393;181446;71;0;0;0;0;.00nan;0;0
7393;46790;71;100;29;0;29;1.000;3600000;0
7394;182339;82;0;0;0;0;.00nan;0;0
7394;183730;4245;67;32;3;29;.906;3600000;0
7394;184398;4245;0;0;0;0;.00nan;0;0
7394;185812;82;61;20;2;18;.900;3600000;0
7395;171970;74;86;36;2;34;.944;3600000;0
7395;170612;74;0;0;0;0;.00nan;0;0
7395;171660;1096;0;0;0;0;.00nan;0;0
7395;-1;1096;59;43;6;37;.860;3600000;0
7396;-1;80;0;0;0;0;.00nan;0;0
7396;180873;69;0;0;0;0;.00nan;0;0
7396;57215;69;70;37;3;34;.919;3600000;0
7396;152851;80;63;32;4;28;.875;3600000;0
7397;165611;81;0;0;0;0;.00nan;0;0
7397;178911;152;0;0;0;0;.00nan;0;0
7397;178950;152;58;26;3;23;.885;3582000;0
7397;70213;81;62;25;2;23;.920;3600000;0
7398;4487;4920;0;0;0;0;.00nan;0;0
7398;179411;4922;91;54;4;50;.926;3562000;0
7398;149450;4920;60;20;2;18;.900;3600000;0
7398;161046;4922;0;0;0;0;.00nan;0;0
7399;2495;1097;0;0;0;0;.00nan;0;0
7399;170728;1097;56;38;6;32;.842;3600000;0
7399;181446;71;0;0;0;0;.00nan;0;0
7399;46790;71;72;22;1;21;.955;3600000;0
7400;163195;4921;29;25;5;20;.800;3600000;0
7400;-1;2564;89;37;2;35;.946;3600000;0
7400;85661;4921;0;0;0;0;.00nan;0;0
7400;161047;2564;0;0;0;0;.00nan;0;0
7401;182339;82;44;20;3;17;.850;3551000;0
7401;183730;4245;0;0;0;0;.00nan;0;0
7401;184398;4245;83;32;2;30;.938;3600000;0
7401;185812;82;0;0;0;0;.00nan;0;0
7402;164987;85;0;0;0;0;.00nan;0;0
7402;173856;75;90;34;2;32;.941;3600000;0
7402;171615;75;0;0;0;0;.00nan;0;0
7402;57207;85;47;30;4;26;.867;3528000;0
7403;163784;77;0;0;0;0;.00nan;0;0
7403;64961;77;64;23;2;21;.913;3600000;0
7403;85555;76;60;30;3;27;.900;3600000;0
7403;91703;76;0;0;0;0;.00nan;0;0
7404;-1;149;0;0;0;0;.00nan;0;0
7404;168651;151;0;0;0;0;.00nan;0;0
7404;64722;149;71;26;1;25;.962;3600000;0
7404;142492;151;75;33;2;31;.939;3586000;0
7405;171970;74;0;0;0;0;.00nan;0;0
7405;170612;74;61;35;4;31;.886;3600000;0
7405;171660;1096;35;26;5;21;.808;3571000;0
7405;-1;1096;0;0;0;0;.00nan;0;0
7406;173823;73;0;0;0;0;.00nan;0;0
7406;44189;72;0;0;0;0;.00nan;0;0
7406;64811;72;38;28;5;23;.821;3900000;0
7406;86472;73;75;48;5;43;.896;3900000;0
7407;173874;158;0;0;0;0;.00nan;0;0
7407;186520;157;0;0;0;0;.00nan;0;0
7407;85437;157;66;26;3;23;.885;3600000;0
7407;91398;158;86;44;4;40;.909;3595000;0
7408;169154;78;45;19;4;15;.789;3600000;0
7408;184437;78;0;0;0;0;.00nan;0;0
7408;-1;1095;0;0;0;0;.00nan;0;0
7408;176770;1095;100;33;0;33;1.000;3600000;0
7409;165380;67;0;0;0;0;.00nan;0;0
7409;-1;4620;59;19;2;17;.895;3600000;0
7409;173961;4620;0;0;0;0;.00nan;0;0
7409;44487;67;96;47;3;44;.936;3564000;0
7410;165611;81;83;33;1;32;.970;3568000;0
7410;178911;152;91;23;0;23;1.000;3600000;0
7410;178950;152;0;0;0;0;.00nan;0;0
7410;70213;81;0;0;0;0;.00nan;0;0
7411;4487;4920;0;0;0;0;.00nan;0;0
7411;179411;4922;0;0;0;0;.00nan;0;0
7411;149450;4920;66;22;2;20;.909;3600000;0
7411;161046;4922;82;41;3;38;.927;3600000;0
7412;173874;158;0;0;0;0;.00nan;0;0
7412;186520;157;0;0;0;0;.00nan;0;0
7412;85437;157;59;18;2;16;.889;3600000;0
7412;91398;158;46;23;4;19;.826;3600000;0
7413;2495;1097;39;37;7;30;.811;3310000;0
7413;170728;1097;47;5;1;4;.800;290000;0
7413;181446;71;82;30;1;29;.967;3600000;0
7413;46790;71;0;0;0;0;.00nan;0;0
7414;163195;4921;68;31;3;28;.903;3600000;0
7414;-1;2564;0;0;0;0;.00nan;0;0
7414;85661;4921;0;0;0;0;.00nan;0;0
7414;161047;2564;74;21;1;20;.952;3600000;0
7415;163784;77;74;37;2;35;.946;3900000;0
7415;64961;77;0;0;0;0;.00nan;0;0
7415;85555;76;0;0;0;0;.00nan;0;0
7415;91703;76;86;41;2;39;.951;3900000;0
7416;173823;73;64;34;4;30;.882;3520000;0
7416;44189;72;0;0;0;0;.00nan;0;0
7416;64811;72;84;28;2;26;.929;3600000;0
7416;86472;73;0;0;0;0;.00nan;0;0
7417;182339;82;43;4;1;3;.750;391000;0
7417;183730;4245;67;18;1;17;.944;3600000;0
7417;184398;4245;0;0;0;0;.00nan;0;0
7417;185812;82;42;43;6;37;.860;3209000;0
7418;164987;85;0;0;0;0;.00nan;0;0
7418;173856;75;0;0;0;0;.00nan;0;0
7418;171615;75;76;36;3;33;.917;3600000;0
7418;57207;85;23;27;6;21;.778;3579000;0
7419;-1;149;51;20;3;17;.850;3515000;0
7419;168651;151;93;36;1;35;.972;3600000;0
7419;64722;149;0;0;0;0;.00nan;0;0
7419;142492;151;0;0;0;0;.00nan;0;0
7420;171970;74;63;36;4;32;.889;3537000;0
7420;170612;74;0;0;0;0;.00nan;0;0
7420;171660;1096;0;0;0;0;.00nan;0;0
7420;-1;1096;91;39;2;37;.949;3600000;0
7421;169154;78;90;20;0;20;1.000;3600000;0
7421;184437;78;0;0;0;0;.00nan;0;0
7421;-1;1095;88;40;2;38;.950;3599000;0
7421;176770;1095;0;0;0;0;.00nan;0;0
7422;-1;80;90;33;1;32;.970;3600000;0
7422;180873;69;0;0;0;0;.00nan;0;0
7422;57215;69;97;43;2;41;.953;3556000;0
7422;152851;80;0;0;0;0;.00nan;0;0
7423;165380;67;45;41;6;35;.854;3600000;0
7423;-1;4620;0;0;0;0;.00nan;0;0
7423;173961;4620;72;23;2;21;.913;3600000;0
7423;44487;67;0;0;0;0;.00nan;0;0
7424;2495;1097;0;0;0;0;.00nan;0;0
7424;170728;1097;72;42;4;38;.905;3600000;0
7424;171660;1096;0;0;0;0;.00nan;0;0
7424;-1;1096;56;28;3;25;.893;3600000;0
7425;-1;80;0;0;0;0;.00nan;0;0
7425;178911;152;96;32;1;31;.969;3600000;0
7425;178950;152;0;0;0;0;.00nan;0;0
7425;152851;80;85;34;3;31;.912;3533000;0
7426;163195;4921;83;48;3;45;.938;3900000;0
7426;181446;71;0;0;0;0;.00nan;0;0
7426;46790;71;65;24;3;21;.875;3900000;0
7426;85661;4921;0;0;0;0;.00nan;0;0
7427;-1;149;0;0;0;0;.00nan;0;0
7427;173874;158;0;0;0;0;.00nan;0;0
7427;64722;149;66;23;2;21;.913;3600000;0
7427;91398;158;69;40;4;36;.900;3579000;0
7428;165611;81;0;0;0;0;.00nan;0;0
7428;168651;151;0;0;0;0;.00nan;0;0
7428;70213;81;77;30;2;28;.933;3900000;0
7428;142492;151;98;38;2;36;.947;3900000;0
7429;4487;4920;0;0;0;0;.00nan;0;0
7429;169154;78;94;39;1;38;.974;3729000;0
7429;184437;78;0;0;0;0;.00nan;0;0
7429;149450;4920;70;23;2;21;.913;3729000;0
7430;171970;74;0;0;0;0;.00nan;0;0
7430;2495;1097;0;0;0;0;.00nan;0;0
7430;170612;74;91;29;1;28;.966;3600000;0
7430;170728;1097;45;31;5;26;.839;3600000;0
7431;-1;2564;82;27;1;26;.963;3600000;0
7431;44189;72;0;0;0;0;.00nan;0;0
7431;64811;72;74;32;3;29;.906;3524000;0
7431;161047;2564;0;0;0;0;.00nan;0;0
7432;182339;82;0;0;0;0;.00nan;0;0
7432;171660;1096;0;0;0;0;.00nan;0;0
7432;-1;1096;100;30;0;30;1.000;3600000;0
7432;185812;82;83;39;2;37;.949;3600000;0
7433;163195;4921;75;36;3;33;.917;3600000;0
7433;181446;71;0;0;0;0;.00nan;0;0
7433;46790;71;98;23;0;23;1.000;3600000;0
7433;85661;4921;0;0;0;0;.00nan;0;0
7434;179411;4922;44;47;6;41;.872;3585000;0
7434;85555;76;52;36;5;31;.861;3600000;0
7434;91703;76;0;0;0;0;.00nan;0;0
7434;161046;4922;0;0;0;0;.00nan;0;0
7435;173823;73;0;0;0;0;.00nan;0;0
7435;180873;69;0;0;0;0;.00nan;0;0
7435;57215;69;82;33;2;31;.939;3600000;0
7435;86472;73;71;36;3;33;.917;3595000;0
7436;165380;67;0;0;0;0;.00nan;0;0
7436;173856;75;62;33;4;29;.879;3594000;0
7436;171615;75;0;0;0;0;.00nan;0;0
7436;44487;67;84;27;2;25;.926;3600000;0
7437;163784;77;0;0;0;0;.00nan;0;0
7437;-1;4620;87;21;0;21;1.000;3600000;0
7437;173961;4620;0;0;0;0;.00nan;0;0
7437;64961;77;42;33;5;28;.848;3600000;0
7438;-1;149;0;0;0;0;.00nan;0;0
7438;173874;158;0;0;0;0;.00nan;0;0
7438;64722;149;52;27;4;23;.852;3570000;0
7438;91398;158;69;30;3;27;.900;3600000;0
7439;165611;81;0;0;0;0;.00nan;0;0
7439;178911;152;76;41;4;37;.902;3547000;0
7439;178950;152;0;0;0;0;.00nan;0;0
7439;70213;81;59;23;2;21;.913;3600000;0
7440;-1;1095;85;35;1;34;.971;2765000;0
7440;176770;1095;18;13;5;8;.615;835000;0
7440;186520;157;49;31;4;27;.871;1911000;0
7440;152418;157;54;9;1;8;.889;1689000;0
7441;168651;151;77;35;2;33;.943;3900000;0
7441;-1;80;58;27;2;25;.926;3900000;0
7441;142492;151;0;0;0;0;.00nan;0;0
7441;152851;80;0;0;0;0;.00nan;0;0
7442;4487;4920;0;0;0;0;.00nan;0;0
7442;164987;85;60;6;0;6;1.000;992000;0
7442;57207;85;25;26;6;20;.769;2594000;0
7442;149450;4920;49;28;5;23;.821;3600000;0
7443;165611;81;100;23;0;23;1.000;3600000;0
7443;178911;152;0;0;0;0;.00nan;0;0
7443;178950;152;72;34;3;31;.912;3600000;0
7443;70213;81;0;0;0;0;.00nan;0;0
7444;-1;2564;0;0;0;0;.00nan;0;0
7444;180873;69;72;27;2;25;.926;3600000;0
7444;57215;69;0;0;0;0;.00nan;0;0
7444;161047;2564;62;39;4;35;.897;3526000;0
7445;182339;82;87;27;1;26;.963;3600000;0
7445;2495;1097;74;31;3;28;.903;3565000;0
7445;170728;1097;0;0;0;0;.00nan;0;0
7445;185812;82;0;0;0;0;.00nan;0;0
7446;163195;4921;100;52;1;51;.981;3600000;0
7446;181446;71;0;0;0;0;.00nan;0;0
7446;46790;71;22;17;5;12;.706;3600000;0
7446;85661;4921;0;0;0;0;.00nan;0;0
7447;171970;74;47;40;6;34;.850;3600000;0
7447;170612;74;0;0;0;0;.00nan;0;0
7447;85555;76;72;27;2;25;.926;3600000;0
7447;91703;76;0;0;0;0;.00nan;0;0
7448;173823;73;0;0;0;0;.00nan;0;0
7448;44189;72;0;0;0;0;.00nan;0;0
7448;64811;72;59;33;4;29;.879;3600000;0
7448;86472;73;99;34;1;33;.971;3600000;0
7449;168651;151;0;0;0;0;.00nan;0;0
7449;-1;80;0;0;0;0;.00nan;0;0
7449;142492;151;100;29;0;29;1.000;3600000;0
7449;152851;80;73;27;2;25;.926;3549000;0
7450;165380;67;55;42;6;36;.857;3600000;0
7450;173856;75;0;0;0;0;.00nan;0;0
7450;171615;75;73;22;2;20;.909;3600000;0
7450;44487;67;0;0;0;0;.00nan;0;0
7451;163784;77;42;34;6;28;.824;3821000;0
7451;-1;4620;50;30;5;25;.833;3821000;0
7451;173961;4620;0;0;0;0;.00nan;0;0
7451;64961;77;0;0;0;0;.00nan;0;0
7452;-1;149;71;31;3;28;.903;3900000;0
7452;173874;158;0;0;0;0;.00nan;0;0
7452;64722;149;0;0;0;0;.00nan;0;0
7452;91398;158;82;35;3;32;.914;3900000;0
7453;183730;4245;0;0;0;0;.00nan;0;0
7453;169154;78;69;39;3;36;.923;3559000;0
7453;184398;4245;56;14;2;12;.857;3600000;0
7453;184437;78;0;0;0;0;.00nan;0;0
7454;171660;1096;0;0;0;0;.00nan;0;0
7454;179411;4922;0;0;0;0;.00nan;0;0
7454;-1;1096;56;24;3;21;.875;3545000;0
7454;161046;4922;83;40;2;38;.950;3600000;0
7455;-1;1095;0;0;0;0;.00nan;0;0
7455;176770;1095;80;48;4;44;.917;3542000;0
7455;186520;157;0;0;0;0;.00nan;0;0
7455;152418;157;54;21;3;18;.857;3600000;0
7456;182339;82;0;0;0;0;.00nan;0;0
7456;2495;1097;0;0;0;0;.00nan;0;0
7456;170728;1097;69;33;4;29;.879;3600000;0
7456;185812;82;35;32;6;26;.813;3573000;0
7457;-1;2564;98;49;3;46;.939;3600000;0
7457;180873;69;0;0;0;0;.00nan;0;0
7457;57215;69;100;26;0;26;1.000;3600000;0
7457;161047;2564;0;0;0;0;.00nan;0;0
7458;171970;74;0;0;0;0;.00nan;0;0
7458;170612;74;88;25;1;24;.960;3900000;0
7458;85555;76;0;0;0;0;.00nan;0;0
7458;91703;76;90;35;1;34;.971;3900000;0
7459;165380;67;0;0;0;0;.00nan;0;0
7459;173856;75;29;7;3;4;.571;498000;0
7459;171615;75;28;27;6;21;.778;3102000;0
7459;44487;67;100;30;1;29;.967;3600000;0
7460;163784;77;0;0;0;0;.00nan;0;0
7460;-1;4620;0;0;0;0;.00nan;0;0
7460;173961;4620;55;23;3;20;.870;3600000;0
7460;64961;77;65;41;5;36;.878;3600000;0
7461;171660;1096;62;24;2;22;.917;3600000;0
7461;179411;4922;35;32;6;26;.813;2381000;0
7461;-1;1096;0;0;0;0;.00nan;0;0
7461;161046;4922;50;8;1;7;.875;1219000;0
7462;165611;81;0;0;0;0;.00nan;0;0
7462;-1;80;45;28;5;23;.821;3600000;0
7462;70213;81;75;31;2;29;.935;3600000;0
7462;152851;80;0;0;0;0;.00nan;0;0
7463;183730;4245;83;33;2;31;.939;3900000;0
7463;169154;78;79;37;2;35;.946;3900000;0
7463;184398;4245;0;0;0;0;.00nan;0;0
7463;184437;78;0;0;0;0;.00nan;0;0
7464;-1;1095;0;0;0;0;.00nan;0;0
7464;176770;1095;50;32;4;28;.875;3600000;0
7464;186520;157;0;0;0;0;.00nan;0;0
7464;152418;157;44;28;5;23;.821;3579000;0
7465;-1;4620;81;23;1;22;.957;3600000;0
7465;173961;4620;0;0;0;0;.00nan;0;0
7465;179411;4922;65;43;4;39;.907;3600000;0
7465;161046;4922;0;0;0;0;.00nan;0;0
7466;163195;4921;69;33;3;30;.909;3600000;0
7466;-1;80;0;0;0;0;.00nan;0;0
7466;85661;4921;0;0;0;0;.00nan;0;0
7466;152851;80;72;39;4;35;.897;3600000;0
7467;165380;67;0;0;0;0;.00nan;0;0
7467;173823;73;0;0;0;0;.00nan;0;0
7467;44487;67;69;34;4;30;.882;3600000;0
7467;86472;73;64;29;3;26;.897;3600000;0
7468;183730;4245;0;0;0;0;.00nan;0;0
7468;169154;78;81;38;4;34;.895;3600000;0
7468;184398;4245;83;17;0;17;1.000;3600000;0
7468;184437;78;0;0;0;0;.00nan;0;0
7469;2495;1097;69;47;5;42;.894;3600000;0
7469;170728;1097;0;0;0;0;.00nan;0;0
7469;171660;1096;0;0;0;0;.00nan;0;0
7469;-1;1096;74;29;2;27;.931;3600000;0
7470;182339;82;0;0;0;0;.00nan;0;0
7470;-1;149;0;0;0;0;.00nan;0;0
7470;185812;82;100;46;1;45;.978;3600000;0
7470;64722;149;54;24;3;21;.875;3524000;0
7471;4487;4920;0;0;0;0;.00nan;0;0
7471;169154;78;93;43;2;41;.953;3600000;0
7471;184437;78;0;0;0;0;.00nan;0;0
7471;149450;4920;47;18;3;15;.833;3562000;0
7472;163195;4921;66;33;3;30;.909;3547000;0
7472;-1;2564;91;38;2;36;.947;3600000;0
7472;85661;4921;0;0;0;0;.00nan;0;0
7472;161047;2564;0;0;0;0;.00nan;0;0
7473;-1;4620;93;30;1;29;.967;3600000;0
7473;173961;4620;0;0;0;0;.00nan;0;0
7473;179411;4922;74;48;4;44;.917;3600000;0
7473;161046;4922;0;0;0;0;.00nan;0;0
7474;-1;80;0;0;0;0;.00nan;0;0
7474;181446;71;0;0;0;0;.00nan;0;0
7474;46790;71;79;27;2;25;.926;3567000;0
7474;152851;80;94;38;1;37;.974;3600000;0
7475;168651;151;41;38;6;32;.842;3600000;0
7475;186520;157;0;0;0;0;.00nan;0;0
7475;142492;151;0;0;0;0;.00nan;0;0
7475;152418;157;71;35;4;31;.886;3600000;0
7476;173856;75;0;0;0;0;.00nan;0;0
7476;171615;75;53;23;4;19;.826;3600000;0
7476;171660;1096;56;19;2;17;.895;1035000;0
7476;-1;1096;10;16;6;10;.625;2565000;0
7477;163784;77;0;0;0;0;.00nan;0;0
7477;57207;76;0;0;0;0;.00nan;0;0
7477;64961;77;65;46;5;41;.891;3600000;0
7477;85555;76;57;16;2;14;.875;3600000;0
7478;171970;74;0;0;0;0;.00nan;0;0
7478;2495;1097;55;39;5;34;.872;3600000;0
7478;170612;74;72;21;1;20;.952;3600000;0
7478;170728;1097;0;0;0;0;.00nan;0;0
7479;165380;67;0;0;0;0;.00nan;0;0
7479;44189;72;65;21;2;19;.905;3701000;0
7479;44487;67;92;45;3;42;.933;3701000;0
7479;64811;72;0;0;0;0;.00nan;0;0
7480;164987;85;68;37;3;34;.919;3600000;0
7480;183730;4245;0;0;0;0;.00nan;0;0
7480;184398;4245;85;19;0;19;1.000;3600000;0
7480;91703;85;0;0;0;0;.00nan;0;0
7481;165611;81;0;0;0;0;.00nan;0;0
7481;173874;158;0;0;0;0;.00nan;0;0
7481;70213;81;61;26;3;23;.885;3600000;0
7481;91398;158;61;34;4;30;.882;3584000;0
7482;-1;1095;71;33;3;30;.909;3554000;0
7482;176770;1095;0;0;0;0;.00nan;0;0
7482;180873;69;0;0;0;0;.00nan;0;0
7482;57215;69;77;24;2;22;.917;3600000;0
7483;4487;4920;0;0;0;0;.00nan;0;0
7483;169154;78;29;15;4;11;.733;1106000;0
7483;184437;78;34;19;4;15;.789;2494000;0
7483;149450;4920;94;18;0;18;1.000;3600000;0
7484;163195;4921;88;39;3;36;.923;3900000;0
7484;-1;2564;0;0;0;0;.00nan;0;0
7484;85661;4921;0;0;0;0;.00nan;0;0
7484;161047;2564;89;37;2;35;.946;3900000;0
7485;-1;4620;0;0;0;0;.00nan;0;0
7485;173961;4620;72;17;1;16;.941;3600000;0
7485;179411;4922;0;0;0;0;.00nan;0;0
7485;161046;4922;60;41;5;36;.878;3600000;0
7486;182339;82;0;0;0;0;.00nan;0;0
7486;-1;149;0;0;0;0;.00nan;0;0
7486;185812;82;71;29;2;27;.931;3900000;0
7486;64722;149;68;31;2;29;.935;3900000;0
7487;-1;80;74;28;2;26;.929;3586000;0
7487;181446;71;70;18;1;17;.944;3600000;0
7487;46790;71;0;0;0;0;.00nan;0;0
7487;152851;80;0;0;0;0;.00nan;0;0
7488;168651;151;0;0;0;0;.00nan;0;0
7488;186520;157;0;0;0;0;.00nan;0;0
7488;142492;151;27;29;6;23;.793;3513000;0
7488;152418;157;81;36;4;32;.889;3600000;0
7489;173856;75;87;40;2;38;.950;3600000;0
7489;171615;75;0;0;0;0;.00nan;0;0
7489;171660;1096;56;29;4;25;.862;3593000;0
7489;-1;1096;0;0;0;0;.00nan;0;0
7490;2495;1097;0;0;0;0;.00nan;0;0
7490;163784;77;52;23;3;20;.870;3572000;0
7490;170728;1097;62;24;2;22;.917;3600000;0
7490;64961;77;0;0;0;0;.00nan;0;0
7491;171970;74;56;35;4;31;.886;3600000;0
7491;170612;74;0;0;0;0;.00nan;0;0
7491;57207;76;73;27;3;24;.889;3600000;0
7491;85555;76;0;0;0;0;.00nan;0;0
7492;165380;67;39;22;4;18;.818;1148000;0
7492;44189;72;0;0;0;0;.00nan;0;0
7492;44487;67;66;21;2;19;.905;2452000;0
7492;64811;72;58;16;2;14;.875;3600000;0
7493;164987;85;91;49;4;45;.918;3684000;0
7493;183730;4245;0;0;0;0;.00nan;0;0
7493;184398;4245;60;31;3;28;.903;3684000;0
7493;91703;85;0;0;0;0;.00nan;0;0
7494;165611;81;66;29;3;26;.897;3600000;0
7494;173874;158;36;21;4;17;.810;3549000;0
7494;70213;81;0;0;0;0;.00nan;0;0
7494;91398;158;0;0;0;0;.00nan;0;0
7495;173823;73;0;0;0;0;.00nan;0;0
7495;-1;1095;0;0;0;0;.00nan;0;0
7495;176770;1095;73;30;3;27;.900;3600000;0
7495;86472;73;83;47;4;43;.915;3557000;0
7496;165380;67;85;51;3;48;.941;3600000;0
7496;-1;2564;100;35;0;35;1.000;3600000;0
7496;44487;67;0;0;0;0;.00nan;0;0
7496;161047;2564;0;0;0;0;.00nan;0;0
7497;182339;82;69;45;5;40;.889;3600000;0
7497;-1;149;38;17;4;13;.765;3600000;0
7497;185812;82;0;0;0;0;.00nan;0;0
7497;64722;149;0;0;0;0;.00nan;0;0
7498;168651;151;78;25;1;24;.960;3600000;0
7498;186520;157;0;0;0;0;.00nan;0;0
7498;142492;151;0;0;0;0;.00nan;0;0
7498;152418;157;58;27;3;24;.889;3513000;0
7499;2495;1097;94;38;2;36;.947;3791000;0
7499;163784;77;0;0;0;0;.00nan;0;0
7499;170728;1097;0;0;0;0;.00nan;0;0
7499;64961;77;64;13;1;12;.923;3791000;0
7500;180873;69;0;0;0;0;.00nan;0;0
7500;44189;72;82;36;2;34;.944;3600000;0
7500;57215;69;51;28;4;24;.857;3561000;0
7500;64811;72;0;0;0;0;.00nan;0;0
7501;165611;81;64;6;0;6;1.000;1036000;0
7501;173874;158;0;0;0;0;.00nan;0;0
7501;70213;81;18;17;6;11;.647;2564000;0
7501;91398;158;76;22;1;21;.955;3600000;0
7502;173823;73;0;0;0;0;.00nan;0;0
7502;-1;1095;68;26;2;24;.923;3600000;0
7502;176770;1095;0;0;0;0;.00nan;0;0
7502;86472;73;57;38;5;33;.868;3578000;0
7503;2495;1097;70;35;3;32;.914;2637000;0
7503;170728;1097;32;16;4;12;.750;928000;0
7503;57207;76;57;36;5;31;.861;3600000;0
7503;85555;76;0;0;0;0;.00nan;0;0
7504;-1;2564;37;34;7;27;.794;2770000;0
7504;181446;71;0;0;0;0;.00nan;0;0
7504;46790;71;37;15;4;11;.733;3600000;0
7504;161047;2564;51;9;1;8;.889;830000;0
7505;173874;158;0;0;0;0;.00nan;0;0
7505;186520;157;0;0;0;0;.00nan;0;0
7505;91398;158;97;40;2;38;.950;3576000;0
7505;152418;157;83;17;0;17;1.000;3600000;0
7506;4487;4920;0;0;0;0;.00nan;0;0
7506;173856;75;0;0;0;0;.00nan;0;0
7506;171615;75;76;31;3;28;.903;3600000;0
7506;149450;4920;45;30;4;26;.867;3600000;0
7507;171970;74;84;43;3;40;.930;3516000;0
7507;170612;74;0;0;0;0;.00nan;0;0
7507;38209;149;74;22;1;21;.955;3600000;0
7507;64722;149;0;0;0;0;.00nan;0;0
7508;169154;78;74;27;2;25;.926;3567000;0
7508;184437;78;0;0;0;0;.00nan;0;0
7508;-1;1095;0;0;0;0;.00nan;0;0
7508;176770;1095;73;24;1;23;.958;3600000;0
7509;165611;81;0;0;0;0;.00nan;0;0
7509;178911;152;87;24;1;23;.958;3600000;0
7509;178950;152;0;0;0;0;.00nan;0;0
7509;70213;81;83;30;2;28;.933;3556000;0
7510;-1;2564;0;0;0;0;.00nan;0;0
7510;-1;1095;30;20;5;15;.750;3578000;0
7510;176770;1095;0;0;0;0;.00nan;0;0
7510;161047;2564;93;46;4;42;.913;3600000;0
7511;173874;158;0;0;0;0;.00nan;0;0
7511;186520;157;0;0;0;0;.00nan;0;0
7511;91398;158;95;43;3;40;.930;3600000;0
7511;152418;157;33;20;4;16;.800;3600000;0
7512;163195;4921;48;36;6;30;.833;3600000;0
7512;181446;71;0;0;0;0;.00nan;0;0
7512;46790;71;71;25;2;23;.920;3600000;0
7512;85661;4921;0;0;0;0;.00nan;0;0
7513;168651;151;62;31;3;28;.903;3123000;0
7513;85009;80;69;24;2;22;.917;3600000;0
7513;92313;80;0;0;0;0;.00nan;0;0
7513;142492;151;33;10;3;7;.700;477000;0
7514;183730;4245;0;0;0;0;.00nan;0;0
7514;173823;73;0;0;0;0;.00nan;0;0
7514;184398;4245;86;32;2;30;.938;3600000;0
7514;86472;73;51;21;3;18;.857;3600000;0
7515;165380;67;0;0;0;0;.00nan;0;0
7515;173856;75;67;36;4;32;.889;3588000;0
7515;171615;75;0;0;0;0;.00nan;0;0
7515;44487;67;90;34;2;32;.941;3600000;0
7516;163784;77;0;0;0;0;.00nan;0;0
7516;179411;4922;90;32;1;31;.969;3600000;0
7516;64961;77;59;35;4;31;.886;3600000;0
7516;161046;4922;0;0;0;0;.00nan;0;0
7517;171970;74;0;0;0;0;.00nan;0;0
7517;170612;74;99;40;1;39;.975;3600000;0
7517;38209;149;45;25;4;21;.840;3600000;0
7517;64722;149;0;0;0;0;.00nan;0;0
7518;4487;4920;0;0;0;0;.00nan;0;0
7518;169154;78;60;44;5;39;.886;3561000;0
7518;184437;78;0;0;0;0;.00nan;0;0
7518;149450;4920;48;21;4;17;.810;3600000;0
7519;-1;1096;0;0;0;0;.00nan;0;0
7519;-1;1096;53;17;2;15;.882;3600000;0
7519;57207;76;59;42;6;36;.857;3600000;0
7519;85555;76;0;0;0;0;.00nan;0;0
7520;180873;69;0;0;0;0;.00nan;0;0
7520;44189;72;0;0;0;0;.00nan;0;0
7520;57215;69;61;43;5;38;.884;3600000;0
7520;64811;72;71;17;1;16;.941;3600000;0
7521;182339;82;0;0;0;0;.00nan;0;0
7521;2495;1097;86;31;1;30;.968;3600000;0
7521;170728;1097;0;0;0;0;.00nan;0;0
7521;185812;82;50;27;4;23;.852;3600000;0
7522;-1;2564;28;16;4;12;.750;1117000;0
7522;181446;71;65;23;2;21;.913;3600000;0
7522;46790;71;0;0;0;0;.00nan;0;0
7522;161047;2564;70;31;3;28;.903;2483000;0
7523;-1;1095;0;0;0;0;.00nan;0;0
7523;176770;1095;50;29;4;25;.862;3600000;0
7523;180873;69;92;37;1;36;.973;3600000;0
7523;57215;69;0;0;0;0;.00nan;0;0
7524;173874;158;0;0;0;0;.00nan;0;0
7524;186520;157;0;0;0;0;.00nan;0;0
7524;91398;158;60;34;4;30;.882;3709000;0
7524;152418;157;64;38;5;33;.868;3709000;0
7525;163784;77;52;22;3;19;.864;3600000;0
7525;57207;76;52;36;5;31;.861;3539000;0
7525;64961;77;0;0;0;0;.00nan;0;0
7525;85555;76;0;0;0;0;.00nan;0;0
7526;183730;4245;65;30;4;26;.867;3553000;0
7526;173823;73;97;45;2;43;.956;3600000;0
7526;184398;4245;0;0;0;0;.00nan;0;0
7526;86472;73;0;0;0;0;.00nan;0;0
7527;165380;67;63;33;3;30;.909;3650000;0
7527;173856;75;0;0;0;0;.00nan;0;0
7527;171615;75;100;51;2;49;.961;3650000;0
7527;44487;67;0;0;0;0;.00nan;0;0
7528;171970;74;29;27;5;22;.815;3600000;0
7528;170612;74;0;0;0;0;.00nan;0;0
7528;38209;149;0;0;0;0;.00nan;0;0
7528;64722;149;75;19;1;18;.947;3600000;0
7529;4487;4920;0;0;0;0;.00nan;0;0
7529;169154;78;92;32;1;31;.969;3900000;0
7529;184437;78;0;0;0;0;.00nan;0;0
7529;149450;4920;72;18;1;17;.944;3900000;0
7530;-1;1096;56;20;2;18;.900;3600000;0
7530;179411;4922;0;0;0;0;.00nan;0;0
7530;-1;1096;0;0;0;0;.00nan;0;0
7530;161046;4922;71;36;4;32;.889;3513000;0
7531;163195;4921;88;53;4;49;.925;3600000;0
7531;44189;72;52;20;2;18;.900;3600000;0
7531;64811;72;0;0;0;0;.00nan;0;0
7531;85661;4921;0;0;0;0;.00nan;0;0
7532;165611;81;58;12;1;11;.917;3600000;0
7532;168651;151;82;35;2;33;.943;3551000;0
7532;70213;81;0;0;0;0;.00nan;0;0
7532;142492;151;0;0;0;0;.00nan;0;0
7533;178911;152;0;0;0;0;.00nan;0;0
7533;178950;152;56;32;4;28;.875;3900000;0
7533;85009;80;0;0;0;0;.00nan;0;0
7533;92313;80;54;30;4;26;.867;3900000;0
7534;164987;85;48;20;3;17;.850;3529000;0
7534;-1;4620;62;14;1;13;.929;3600000;0
7534;173961;4620;0;0;0;0;.00nan;0;0
7534;91703;85;0;0;0;0;.00nan;0;0
7535;178911;152;99;34;1;33;.971;3600000;0
7535;178950;152;0;0;0;0;.00nan;0;0
7535;85009;80;88;43;2;41;.953;3545000;0
7535;92313;80;0;0;0;0;.00nan;0;0
7536;182339;82;0;0;0;0;.00nan;0;0
7536;2495;1097;52;8;1;7;.875;474000;0
7536;170728;1097;40;33;6;27;.818;3126000;0
7536;185812;82;100;27;0;27;1.000;3600000;0
7537;180873;69;0;0;0;0;.00nan;0;0
7537;181446;71;0;0;0;0;.00nan;0;0
7537;46790;71;86;45;4;41;.911;3562000;0
7537;57215;69;82;30;2;28;.933;3600000;0
7538;163784;77;0;0;0;0;.00nan;0;0
7538;57207;76;72;38;4;34;.895;3670000;0
7538;64961;77;69;32;3;29;.906;3670000;0
7538;85555;76;0;0;0;0;.00nan;0;0
7539;183730;4245;0;0;0;0;.00nan;0;0
7539;173823;73;0;0;0;0;.00nan;0;0
7539;184398;4245;84;18;1;17;.944;3600000;0
7539;86472;73;70;44;5;39;.886;3600000;0
7540;-1;1096;70;30;3;27;.900;3600000;0
7540;171608;4922;69;49;5;44;.898;3586000;0
7540;-1;1096;0;0;0;0;.00nan;0;0
7540;69902;4922;0;0;0;0;.00nan;0;0
7541;163195;4921;67;38;4;34;.895;3600000;0
7541;44189;72;0;0;0;0;.00nan;0;0
7541;64811;72;88;28;1;27;.964;3600000;0
7541;85661;4921;0;0;0;0;.00nan;0;0
7542;165611;81;0;0;0;0;.00nan;0;0
7542;168651;151;0;0;0;0;.00nan;0;0
7542;70213;81;64;23;2;21;.913;3600000;0
7542;142492;151;43;24;4;20;.833;3597000;0
7543;-1;2564;72;35;3;32;.914;3600000;0
7543;-1;1095;54;31;4;27;.871;3544000;0
7543;176770;1095;0;0;0;0;.00nan;0;0
7543;161047;2564;0;0;0;0;.00nan;0;0
7544;164987;85;81;32;2;30;.938;3517000;0
7544;-1;4620;0;0;0;0;.00nan;0;0
7544;173961;4620;98;26;0;26;1.000;3600000;0
7544;91703;85;0;0;0;0;.00nan;0;0
7545;165380;67;70;23;1;22;.957;1700000;0
7545;-1;4620;0;0;0;0;.00nan;0;0
7545;173961;4620;60;17;2;15;.882;3600000;0
7545;44487;67;44;27;4;23;.852;1900000;0
7546;170598;4922;59;43;6;37;.860;3044000;0
7546;171608;4922;53;5;0;5;1.000;556000;0
7546;57207;76;59;23;2;21;.913;3600000;0
7546;85555;76;0;0;0;0;.00nan;0;0
7547;169154;78;53;36;5;31;.861;3582000;0
7547;173856;75;66;39;4;35;.897;3600000;0
7547;184437;78;0;0;0;0;.00nan;0;0
7547;171615;75;0;0;0;0;.00nan;0;0
7548;4487;4920;0;0;0;0;.00nan;0;0
7548;164987;85;0;0;0;0;.00nan;0;0
7548;91703;85;78;37;3;34;.919;3600000;0
7548;149450;4920;51;22;4;18;.818;3546000;0
7549;165611;81;0;0;0;0;.00nan;0;0
7549;70213;81;84;46;4;42;.913;3545000;0
7549;85009;80;85;32;2;30;.938;3600000;0
7549;92313;80;0;0;0;0;.00nan;0;0
7550;168651;151;0;0;0;0;.00nan;0;0
7550;178911;152;89;36;3;33;.917;3600000;0
7550;178950;152;0;0;0;0;.00nan;0;0
7550;179411;151;39;31;6;25;.806;3600000;0
7551;163784;77;0;0;0;0;.00nan;0;0
7551;170598;4922;67;31;3;28;.903;3586000;0
7551;171608;4922;0;0;0;0;.00nan;0;0
7551;64961;77;73;24;1;23;.958;3600000;0
7552;-1;1095;0;0;0;0;.00nan;0;0
7552;176770;1095;54;26;3;23;.885;3530000;0
7552;180873;69;0;0;0;0;.00nan;0;0
7552;57953;69;80;28;1;27;.964;3600000;0
7553;173823;73;0;0;0;0;.00nan;0;0
7553;181446;71;0;0;0;0;.00nan;0;0
7553;46790;71;60;18;2;16;.889;3600000;0
7553;86472;73;38;41;7;34;.829;3600000;0
7554;4487;4920;0;0;0;0;.00nan;0;0
7554;165380;67;44;4;1;3;.750;624000;0
7554;44487;67;73;57;6;51;.895;2976000;0
7554;149450;4920;40;14;3;11;.786;3600000;0
7555;173874;158;0;0;0;0;.00nan;0;0
7555;184398;4245;51;34;4;30;.882;3579000;0
7555;186520;4245;0;0;0;0;.00nan;0;0
7555;91398;158;93;40;3;37;.925;3600000;0
7556;169154;78;53;21;3;18;.857;3600000;0
7556;173856;75;45;36;5;31;.861;3541000;0
7556;184437;78;0;0;0;0;.00nan;0;0
7556;171615;75;0;0;0;0;.00nan;0;0
7557;182339;82;0;0;0;0;.00nan;0;0
7557;171970;74;0;0;0;0;.00nan;0;0
7557;170612;74;88;36;2;34;.944;3600000;0
7557;185812;82;52;37;5;32;.865;3600000;0
7558;-1;1096;86;40;3;37;.925;3556000;0
7558;184049;1097;0;0;0;0;.00nan;0;0
7558;170728;1097;78;27;2;25;.926;3600000;0
7558;-1;1096;0;0;0;0;.00nan;0;0
7559;-1;2564;72;37;3;34;.919;3556000;0
7559;44189;72;0;0;0;0;.00nan;0;0
7559;64811;72;72;22;1;21;.955;3600000;0
7559;161047;2564;0;0;0;0;.00nan;0;0
7560;164987;85;54;44;5;39;.886;3517000;0
7560;-1;4620;60;28;3;25;.893;3600000;0
7560;173961;4620;0;0;0;0;.00nan;0;0
7560;91703;85;0;0;0;0;.00nan;0;0
7561;38209;149;0;0;0;0;.00nan;0;0
7561;64722;149;65;44;5;39;.886;3600000;0
7561;85437;157;41;9;2;7;.778;3600000;0
7561;152418;157;0;0;0;0;.00nan;0;0
7562;163195;4921;84;45;3;42;.933;3600000;0
7562;85009;80;0;0;0;0;.00nan;0;0
7562;85661;4921;0;0;0;0;.00nan;0;0
7562;92313;80;58;29;4;25;.862;3600000;0
7563;4487;4920;71;28;2;26;.929;3600000;0
7563;165380;67;78;51;6;45;.882;3600000;0
7563;44487;67;0;0;0;0;.00nan;0;0
7563;149450;4920;0;0;0;0;.00nan;0;0
7564;168651;151;69;43;5;38;.884;3600000;0
7564;178911;152;0;0;0;0;.00nan;0;0
7564;178950;152;55;16;2;14;.875;3600000;0
7564;179411;151;0;0;0;0;.00nan;0;0
7565;163784;77;80;32;2;30;.938;3900000;0
7565;170598;4922;92;39;2;37;.949;3900000;0
7565;171608;4922;0;0;0;0;.00nan;0;0
7565;64961;77;0;0;0;0;.00nan;0;0
7566;-1;1095;76;36;3;33;.917;3766000;0
7566;176770;1095;0;0;0;0;.00nan;0;0
7566;180873;69;60;35;4;31;.886;3766000;0
7566;57953;69;0;0;0;0;.00nan;0;0
7567;173874;158;0;0;0;0;.00nan;0;0
7567;184398;4245;0;0;0;0;.00nan;0;0
7567;186520;4245;43;19;3;16;.842;3594000;0
7567;91398;158;100;49;2;47;.959;3600000;0
7568;169154;78;71;38;4;34;.895;3570000;0
7568;173856;75;0;0;0;0;.00nan;0;0
7568;184437;78;0;0;0;0;.00nan;0;0
7568;171615;75;61;28;3;25;.893;3600000;0
7569;171970;74;26;13;4;9;.692;803000;0
7569;-1;1096;100;25;0;25;1.000;3600000;0
7569;170612;74;79;20;1;19;.950;2797000;0
7569;-1;1096;0;0;0;0;.00nan;0;0
7570;173823;73;65;37;3;34;.919;3567000;0
7570;44189;72;51;20;2;18;.900;3600000;0
7570;64811;72;0;0;0;0;.00nan;0;0
7570;86472;73;0;0;0;0;.00nan;0;0
7571;164987;85;100;29;0;29;1.000;3600000;0
7571;-1;4620;0;0;0;0;.00nan;0;0
7571;173961;4620;57;26;3;23;.885;3600000;0
7571;91703;85;0;0;0;0;.00nan;0;0
7572;38209;149;100;23;0;23;1.000;3600000;0
7572;64722;149;0;0;0;0;.00nan;0;0
7572;85437;157;0;0;0;0;.00nan;0;0
7572;152418;157;81;33;1;32;.970;3565000;0
7573;163195;4921;100;37;2;35;.946;3600000;0
7573;178695;4921;0;0;0;0;.00nan;0;0
7573;85009;80;76;35;3;32;.914;3546000;0
7573;92313;80;0;0;0;0;.00nan;0;0
7574;165611;81;0;0;0;0;.00nan;0;0
7574;178911;152;29;29;6;23;.793;3600000;0
7574;178950;152;0;0;0;0;.00nan;0;0
7574;70213;81;73;35;4;31;.886;3600000;0
7575;-1;1096;63;33;4;29;.879;3900000;0
7575;184049;1097;0;0;0;0;.00nan;0;0
7575;170728;1097;53;34;4;30;.882;3900000;0
7575;-1;1096;0;0;0;0;.00nan;0;0
7576;180873;69;58;5;0;5;1.000;325000;0
7576;181446;71;0;0;0;0;.00nan;0;0
7576;46790;71;78;27;2;25;.926;3600000;0
7576;57953;69;19;20;6;14;.700;3275000;0
7577;173823;73;0;0;0;0;.00nan;0;0
7577;44189;72;0;0;0;0;.00nan;0;0
7577;64811;72;82;31;2;29;.935;3600000;0
7577;86472;73;78;34;3;31;.912;3589000;0
7578;173874;158;0;0;0;0;.00nan;0;0
7578;184398;4245;63;25;2;23;.920;3571000;0
7578;37857;4245;0;0;0;0;.00nan;0;0
7578;91398;158;90;44;2;42;.955;3600000;0
7579;163784;77;0;0;0;0;.00nan;0;0
7579;57207;76;58;17;2;15;.882;3600000;0
7579;57434;76;0;0;0;0;.00nan;0;0
7579;64961;77;52;35;5;30;.857;3600000;0
7580;168651;151;0;0;0;0;.00nan;0;0
7580;85009;80;0;0;0;0;.00nan;0;0
7580;85636;151;49;27;4;23;.852;3589000;0
7580;92313;80;64;23;2;21;.913;3600000;0
7581;38209;149;54;33;4;29;.879;3584000;0
7581;64722;149;0;0;0;0;.00nan;0;0
7581;85437;157;63;21;3;18;.857;3600000;0
7581;152418;157;0;0;0;0;.00nan;0;0
7582;163195;4921;81;49;4;45;.918;3579000;0
7582;178695;4921;0;0;0;0;.00nan;0;0
7582;-1;1095;61;24;3;21;.875;3600000;0
7582;176770;1095;0;0;0;0;.00nan;0;0
7583;-1;1096;36;13;3;10;.769;3600000;0
7583;-1;1096;0;0;0;0;.00nan;0;0
7583;44189;72;0;0;0;0;.00nan;0;0
7583;64811;72;64;45;5;40;.889;3547000;0
7584;164987;85;100;39;1;38;.974;3600000;0
7584;173874;158;0;0;0;0;.00nan;0;0
7584;91398;158;69;26;2;24;.923;3551000;0
7584;91703;85;0;0;0;0;.00nan;0;0
7585;165611;81;0;0;0;0;.00nan;0;0
7585;70213;81;70;26;2;24;.923;3600000;0
7585;85009;80;68;31;3;28;.903;3555000;0
7585;92313;80;0;0;0;0;.00nan;0;0
7586;-1;4620;64;15;1;14;.933;3600000;0
7586;169154;78;68;44;6;38;.864;3600000;0
7586;173961;4620;0;0;0;0;.00nan;0;0
7586;184437;78;0;0;0;0;.00nan;0;0
7587;-1;2564;0;0;0;0;.00nan;0;0
7587;180873;69;0;0;0;0;.00nan;0;0
7587;57953;69;61;34;5;29;.853;3567000;0
7587;161047;2564;56;32;4;28;.875;3600000;0
7588;182339;82;0;0;0;0;.00nan;0;0
7588;185812;82;89;15;0;15;1.000;3600000;0
7588;44189;72;0;0;0;0;.00nan;0;0
7588;64811;72;57;30;4;26;.867;3600000;0
7589;165611;81;0;0;0;0;.00nan;0;0
7589;181446;71;0;0;0;0;.00nan;0;0
7589;46790;71;69;33;3;30;.909;3741000;0
7589;70213;81;49;27;4;23;.852;3741000;0
7590;163195;4921;63;43;5;38;.884;3881000;0
7590;178695;4921;0;0;0;0;.00nan;0;0
7590;-1;1095;0;0;0;0;.00nan;0;0
7590;176770;1095;56;37;4;33;.892;3881000;0
7591;170598;4922;26;27;6;21;.778;2654000;0
7591;171608;4922;50;11;1;10;.909;946000;0
7591;57207;76;0;0;0;0;.00nan;0;0
7591;57434;76;73;28;2;26;.929;3600000;0
7592;173823;73;0;0;0;0;.00nan;0;0
7592;178911;152;26;25;6;19;.760;3082000;0
7592;178950;152;51;7;1;6;.857;518000;0
7592;86472;73;93;43;3;40;.930;3600000;0
7593;168651;151;50;28;5;23;.821;3600000;0
7593;38209;149;32;28;6;22;.786;3600000;0
7593;64722;149;0;0;0;0;.00nan;0;0
7593;85636;151;0;0;0;0;.00nan;0;0
7594;4487;4920;0;0;0;0;.00nan;0;0
7594;165380;67;0;0;0;0;.00nan;0;0
7594;44487;67;100;49;2;47;.959;3900000;0
7594;149450;4920;65;19;2;17;.895;3900000;0
7595;171970;74;0;0;0;0;.00nan;0;0
7595;184049;1097;0;0;0;0;.00nan;0;0
7595;170612;74;87;35;2;33;.943;3600000;0
7595;170728;1097;38;29;6;23;.793;3600000;0
7596;163784;77;0;0;0;0;.00nan;0;0
7596;-1;1096;61;28;3;25;.893;3543000;0
7596;-1;1096;0;0;0;0;.00nan;0;0
7596;64961;77;68;29;2;27;.931;3600000;0
7597;164987;85;52;23;4;19;.826;3600000;0
7597;173874;158;0;0;0;0;.00nan;0;0
7597;91398;158;99;37;1;36;.973;3600000;0
7597;91703;85;0;0;0;0;.00nan;0;0
7598;173856;75;80;31;2;29;.935;3900000;0
7598;171615;75;0;0;0;0;.00nan;0;0
7598;85437;157;89;33;2;31;.939;3900000;0
7598;152418;157;0;0;0;0;.00nan;0;0
7599;-1;4620;77;28;2;26;.929;3600000;0
7599;169154;78;53;42;6;36;.857;3600000;0
7599;173961;4620;0;0;0;0;.00nan;0;0
7599;184437;78;0;0;0;0;.00nan;0;0
7600;-1;2564;59;24;3;21;.875;3600000;0
7600;180873;69;53;30;4;26;.867;3559000;0
7600;57953;69;0;0;0;0;.00nan;0;0
7600;161047;2564;0;0;0;0;.00nan;0;0
7601;182339;82;0;0;0;0;.00nan;0;0
7601;185812;82;70;34;4;30;.882;3600000;0
7601;44189;72;70;31;3;28;.903;3600000;0
7601;64811;72;0;0;0;0;.00nan;0;0
7602;165611;81;0;0;0;0;.00nan;0;0
7602;181446;71;29;25;6;19;.760;3600000;0
7602;46790;71;0;0;0;0;.00nan;0;0
7602;70213;81;78;23;1;22;.957;3600000;0
7603;163195;4921;0;0;0;0;.00nan;0;0
7603;178695;4921;88;34;2;32;.941;3900000;0
7603;-1;1095;79;36;2;34;.944;3900000;0
7603;176770;1095;0;0;0;0;.00nan;0;0
7604;-1;1096;62;29;3;26;.897;3600000;0
7604;-1;1096;0;0;0;0;.00nan;0;0
7604;57207;76;63;33;4;29;.879;3585000;0
7604;57434;76;0;0;0;0;.00nan;0;0
7605;173823;73;90;35;2;33;.943;3545000;0
7605;178911;152;0;0;0;0;.00nan;0;0
7605;178950;152;81;27;1;26;.963;3600000;0
7605;86472;73;0;0;0;0;.00nan;0;0
7606;168651;151;0;0;0;0;.00nan;0;0
7606;38209;149;0;0;0;0;.00nan;0;0
7606;64722;149;46;32;5;27;.844;3600000;0
7606;85636;151;77;25;1;24;.960;3600000;0
7607;165380;67;80;43;4;39;.907;3584000;0
7607;169154;78;60;19;2;17;.895;3600000;0
7607;184437;78;0;0;0;0;.00nan;0;0
7607;44487;67;0;0;0;0;.00nan;0;0
7608;163784;77;67;21;2;19;.905;3600000;0
7608;170598;4922;0;0;0;0;.00nan;0;0
7608;171608;4922;61;35;4;31;.886;3600000;0
7608;64961;77;0;0;0;0;.00nan;0;0
7609;171970;74;61;36;4;32;.889;3600000;0
7609;184049;1097;62;25;3;22;.880;3600000;0
7609;170612;74;0;0;0;0;.00nan;0;0
7609;170728;1097;0;0;0;0;.00nan;0;0
7610;164987;85;0;0;0;0;.00nan;0;0
7610;173874;158;0;0;0;0;.00nan;0;0
7610;91398;158;55;34;4;30;.882;3900000;0
7610;91703;85;57;32;4;28;.875;3900000;0
7611;173856;75;60;24;2;22;.917;3114000;0
7611;171615;75;34;8;3;5;.625;486000;0
7611;85437;157;0;0;0;0;.00nan;0;0
7611;152418;157;79;31;1;30;.968;3600000;0
7612;4487;4920;37;35;6;29;.829;3053000;0
7612;-1;4620;0;0;0;0;.00nan;0;0
7612;173961;4620;55;30;4;26;.867;3600000;0
7612;149450;4920;53;4;0;4;1.000;462000;0
7613;184049;1097;0;0;0;0;.00nan;0;0
7613;170728;1097;73;46;5;41;.891;3580000;0
7613;44189;72;0;0;0;0;.00nan;0;0
7613;64811;72;69;37;4;33;.892;3600000;0
7614;-1;2564;0;0;0;0;.00nan;0;0
7614;181446;71;0;0;0;0;.00nan;0;0
7614;46790;71;57;29;4;25;.862;3578000;0
7614;161047;2564;91;42;3;39;.929;3600000;0
7615;182339;82;98;47;2;45;.957;3585000;0
7615;185812;82;0;0;0;0;.00nan;0;0
7615;57207;76;0;0;0;0;.00nan;0;0
7615;57434;76;69;19;1;18;.947;3600000;0
7616;173823;73;0;0;0;0;.00nan;0;0
7616;178911;152;47;31;5;26;.839;3600000;0
7616;178950;152;0;0;0;0;.00nan;0;0
7616;86472;73;74;23;1;22;.957;3600000;0
7617;165380;67;0;0;0;0;.00nan;0;0
7617;169154;78;40;26;5;21;.808;3528000;0
7617;184437;78;0;0;0;0;.00nan;0;0
7617;44487;67;69;35;3;32;.914;3600000;0
7618;163784;77;0;0;0;0;.00nan;0;0
7618;170598;4922;51;37;5;32;.865;3572000;0
7618;171608;4922;0;0;0;0;.00nan;0;0
7618;64961;77;59;23;3;20;.870;3600000;0
7619;171970;74;0;0;0;0;.00nan;0;0
7619;-1;1096;41;19;3;16;.842;3557000;0
7619;170612;74;93;40;2;38;.950;3600000;0
7619;-1;1096;0;0;0;0;.00nan;0;0
7620;173856;75;0;0;0;0;.00nan;0;0
7620;171615;75;64;40;5;35;.875;3556000;0
7620;85437;157;80;38;4;34;.895;3600000;0
7620;152418;157;0;0;0;0;.00nan;0;0
7621;-1;1095;0;0;0;0;.00nan;0;0
7621;176770;1095;60;38;4;34;.895;3600000;0
7621;181446;71;0;0;0;0;.00nan;0;0
7621;46790;71;63;39;5;34;.872;3568000;0
7622;4487;4920;0;0;0;0;.00nan;0;0
7622;-1;4620;69;31;3;28;.903;3577000;0
7622;173961;4620;0;0;0;0;.00nan;0;0
7622;149450;4920;95;37;2;35;.946;3600000;0
7623;168651;151;72;34;3;31;.912;3900000;0
7623;178911;152;0;0;0;0;.00nan;0;0
7623;178950;152;45;21;3;18;.857;3900000;0
7623;85636;151;0;0;0;0;.00nan;0;0
7624;-1;2564;0;0;0;0;.00nan;0;0
7624;44189;72;0;0;0;0;.00nan;0;0
7624;64811;72;63;22;3;19;.864;3600000;0
7624;161047;2564;81;49;4;45;.918;3582000;0
7625;171970;74;0;0;0;0;.00nan;0;0
7625;170598;4922;0;0;0;0;.00nan;0;0
7625;170612;74;37;27;5;22;.815;3600000;0
7625;171608;4922;66;19;1;18;.947;3600000;0
7626;173823;73;0;0;0;0;.00nan;0;0
7626;180873;69;82;23;1;22;.957;3600000;0
7626;57953;69;0;0;0;0;.00nan;0;0
7626;86472;73;83;46;4;42;.913;3600000;0
7627;165611;81;0;0;0;0;.00nan;0;0
7627;173874;158;98;40;1;39;.975;3565000;0
7627;70213;81;92;18;0;18;1.000;3600000;0
7627;91398;158;0;0;0;0;.00nan;0;0
7628;164987;85;39;11;3;8;.727;435000;0
7628;57207;76;69;30;3;27;.900;3600000;0
7628;57434;76;0;0;0;0;.00nan;0;0
7628;91703;85;82;28;1;27;.964;3131000;0
7629;4487;4920;0;0;0;0;.00nan;0;0
7629;173856;75;73;24;2;22;.917;2908000;0
7629;171615;75;20;10;4;6;.600;680000;0
7629;149450;4920;56;31;4;27;.871;3600000;0
7630;168651;151;61;30;3;27;.900;3600000;0
7630;178911;152;74;24;2;22;.917;3600000;0
7630;178950;152;0;0;0;0;.00nan;0;0
7630;85636;151;0;0;0;0;.00nan;0;0
7631;164987;85;80;30;2;28;.933;3900000;0
7631;184049;1097;83;37;2;35;.946;3900000;0
7631;170728;1097;0;0;0;0;.00nan;0;0
7631;91703;85;0;0;0;0;.00nan;0;0
7632;171970;74;0;0;0;0;.00nan;0;0
7632;170598;4922;0;0;0;0;.00nan;0;0
7632;170612;74;99;36;1;35;.972;3600000;0
7632;171608;4922;49;38;6;32;.842;3600000;0
7633;165611;81;0;0;0;0;.00nan;0;0
7633;173874;158;0;0;0;0;.00nan;0;0
7633;70213;81;84;41;4;37;.902;3900000;0
7633;91398;158;57;28;4;24;.857;3900000;0
7634;-1;2564;100;42;1;41;.976;3900000;0
7634;181446;71;0;0;0;0;.00nan;0;0
7634;46790;71;77;18;1;17;.944;3900000;0
7634;161047;2564;0;0;0;0;.00nan;0;0
7635;163195;4921;44;23;4;19;.826;3562000;0
7635;85009;80;77;27;2;25;.926;3600000;0
7635;85661;4921;0;0;0;0;.00nan;0;0
7635;92313;80;0;0;0;0;.00nan;0;0
7636;182339;82;0;0;0;0;.00nan;0;0
7636;185812;82;76;42;3;39;.929;3548000;0
7636;57207;76;85;34;2;32;.941;3600000;0
7636;57434;76;0;0;0;0;.00nan;0;0
7637;165380;67;0;0;0;0;.00nan;0;0
7637;184398;4245;0;0;0;0;.00nan;0;0
7637;37857;4245;77;31;2;29;.935;3565000;0
7637;44487;67;100;37;1;36;.973;3600000;0
7638;38209;149;52;34;5;29;.853;3600000;0
7638;64722;149;0;0;0;0;.00nan;0;0
7638;85437;157;67;24;2;22;.917;3600000;0
7638;152418;157;0;0;0;0;.00nan;0;0
7639;-1;4620;86;26;1;25;.962;3600000;0
7639;169154;78;53;29;4;25;.862;3600000;0
7639;173961;4620;0;0;0;0;.00nan;0;0
7639;184437;78;0;0;0;0;.00nan;0;0
7640;163784;77;0;0;0;0;.00nan;0;0
7640;-1;1096;71;24;1;23;.958;3600000;0
7640;171660;1096;0;0;0;0;.00nan;0;0
7640;64961;77;41;32;5;27;.844;3600000;0
7641;180873;69;69;27;3;24;.889;3557000;0
7641;44189;72;0;0;0;0;.00nan;0;0
7641;57953;69;0;0;0;0;.00nan;0;0
7641;64811;72;100;37;1;36;.973;3600000;0
7642;173823;73;75;36;4;32;.889;3600000;0
7642;-1;1095;37;27;5;22;.815;3600000;0
7642;176770;1095;0;0;0;0;.00nan;0;0
7642;86472;73;0;0;0;0;.00nan;0;0
7643;4487;4920;33;24;5;19;.792;3562000;0
7643;173856;75;0;0;0;0;.00nan;0;0
7643;171615;75;95;48;3;45;.938;3600000;0
7643;149450;4920;0;0;0;0;.00nan;0;0
7644;168651;151;0;0;0;0;.00nan;0;0
7644;178911;152;0;0;0;0;.00nan;0;0
7644;178950;152;63;37;4;33;.892;3600000;0
7644;85636;151;84;42;3;39;.929;3600000;0
7645;163784;77;76;35;3;32;.914;3900000;0
7645;184049;1097;69;26;3;23;.885;3900000;0
7645;170728;1097;0;0;0;0;.00nan;0;0
7645;64961;77;0;0;0;0;.00nan;0;0
7646;173823;73;0;0;0;0;.00nan;0;0
7646;-1;2564;0;0;0;0;.00nan;0;0
7646;86472;73;89;36;1;35;.972;3600000;0
7646;161047;2564;62;25;2;23;.920;3543000;0
7647;171970;74;0;0;0;0;.00nan;0;0
7647;170598;4922;0;0;0;0;.00nan;0;0
7647;170612;74;70;20;1;19;.950;3687000;0
7647;171608;4922;92;38;2;36;.947;3687000;0
7648;165611;81;0;0;0;0;.00nan;0;0
7648;173874;158;0;0;0;0;.00nan;0;0
7648;70213;81;82;25;1;24;.960;3600000;0
7648;91398;158;61;30;3;27;.900;3593000;0
7649;181446;71;92;19;0;19;1.000;3600000;0
7649;44189;72;62;26;3;23;.885;3600000;0
7649;46790;71;0;0;0;0;.00nan;0;0
7649;64811;72;0;0;0;0;.00nan;0;0
7650;163195;4921;0;0;0;0;.00nan;0;0
7650;85009;80;0;0;0;0;.00nan;0;0
7650;85661;4921;81;38;3;35;.921;3600000;0
7650;92313;80;35;28;5;23;.821;3561000;0
7651;182339;82;0;0;0;0;.00nan;0;0
7651;185812;82;65;40;4;36;.900;3586000;0
7651;57207;76;0;0;0;0;.00nan;0;0
7651;57434;76;70;25;2;23;.920;3600000;0
7652;165380;67;76;41;4;37;.902;3600000;0
7652;184398;4245;0;0;0;0;.00nan;0;0
7652;37857;4245;61;24;3;21;.875;3600000;0
7652;44487;67;0;0;0;0;.00nan;0;0
7653;38209;149;100;33;0;33;1.000;3600000;0
7653;64722;149;0;0;0;0;.00nan;0;0
7653;85437;157;0;0;0;0;.00nan;0;0
7653;152418;157;59;24;3;21;.875;3600000;0
7654;-1;4620;0;0;0;0;.00nan;0;0
7654;169154;78;54;36;5;31;.861;3600000;0
7654;173961;4620;60;23;2;21;.913;3600000;0
7654;184437;78;0;0;0;0;.00nan;0;0
7655;164987;85;0;0;0;0;.00nan;0;0
7655;-1;1096;58;30;4;26;.867;3896000;0
7655;171660;1096;0;0;0;0;.00nan;0;0
7655;91703;85;59;29;3;26;.897;3896000;0
7656;-1;1095;0;0;0;0;.00nan;0;0
7656;176770;1095;55;41;5;36;.878;3600000;0
7656;180873;69;0;0;0;0;.00nan;0;0
7656;57953;69;72;31;2;29;.935;3600000;0
7657;4487;4920;0;0;0;0;.00nan;0;0
7657;173856;75;46;43;6;37;.860;3600000;0
7657;171615;75;0;0;0;0;.00nan;0;0
7657;149450;4920;45;18;3;15;.833;3600000;0
7658;173823;73;36;30;6;24;.800;2392000;0
7658;181446;71;69;28;2;26;.929;3600000;0
7658;46790;71;0;0;0;0;.00nan;0;0
7658;86472;73;57;9;1;8;.889;1208000;0
7659;163195;4921;64;30;3;27;.900;3900000;0
7659;85009;80;68;27;3;24;.889;3900000;0
7659;85661;4921;0;0;0;0;.00nan;0;0
7659;92313;80;0;0;0;0;.00nan;0;0
7660;165380;67;0;0;0;0;.00nan;0;0
7660;184398;4245;0;0;0;0;.00nan;0;0
7660;37857;4245;67;14;1;13;.929;3600000;0
7660;44487;67;98;49;2;47;.959;3595000;0
7661;38209;149;53;34;4;30;.882;3600000;0
7661;64722;149;0;0;0;0;.00nan;0;0
7661;85437;157;48;34;5;29;.853;3550000;0
7661;152418;157;0;0;0;0;.00nan;0;0
7662;-1;4620;65;22;2;20;.909;3600000;0
7662;169154;78;66;42;5;37;.881;3600000;0
7662;173961;4620;0;0;0;0;.00nan;0;0
7662;184437;78;0;0;0;0;.00nan;0;0
7663;164987;85;57;18;2;16;.889;3600000;0
7663;-1;1096;52;23;3;20;.870;3545000;0
7663;171660;1096;0;0;0;0;.00nan;0;0
7663;91703;85;0;0;0;0;.00nan;0;0
7664;-1;2564;64;51;6;45;.882;3115000;0
7664;-1;1095;65;24;2;22;.917;3600000;0
7664;176770;1095;0;0;0;0;.00nan;0;0
7664;161047;2564;52;8;1;7;.875;485000;0
7665;181446;71;0;0;0;0;.00nan;0;0
7665;44189;72;0;0;0;0;.00nan;0;0
7665;46790;71;66;23;2;21;.913;3600000;0
7665;64811;72;46;27;4;23;.852;3572000;0
7666;163195;4921;82;38;3;35;.921;3600000;0
7666;168651;151;27;21;5;16;.762;3563000;0
7666;85636;151;0;0;0;0;.00nan;0;0
7666;85661;4921;0;0;0;0;.00nan;0;0
7667;178911;152;44;26;5;21;.808;3600000;0
7667;178950;152;0;0;0;0;.00nan;0;0
7667;38209;149;37;47;8;39;.830;3600000;0
7667;64722;149;0;0;0;0;.00nan;0;0
7668;164987;85;77;24;1;23;.958;3600000;0
7668;169154;78;89;30;2;28;.933;3542000;0
7668;184437;78;0;0;0;0;.00nan;0;0
7668;91703;85;0;0;0;0;.00nan;0;0
7669;173874;158;0;0;0;0;.00nan;0;0
7669;85437;157;75;33;3;30;.909;3600000;0
7669;91398;158;100;32;0;32;1.000;3600000;0
7669;152418;157;0;0;0;0;.00nan;0;0
7670;-1;4620;57;24;3;21;.875;3600000;0
7670;173961;4620;0;0;0;0;.00nan;0;0
7670;184398;4245;84;24;1;23;.958;2555000;0
7670;37857;4245;31;16;4;12;.750;974000;0
7671;182339;82;0;0;0;0;.00nan;0;0
7671;171970;74;0;0;0;0;.00nan;0;0
7671;170612;74;59;34;4;30;.882;3789000;0
7671;185812;82;53;24;3;21;.875;3789000;0
7672;163784;77;0;0;0;0;.00nan;0;0
7672;57207;76;40;30;5;25;.833;3190000;0
7672;57434;76;58;6;0;6;1.000;410000;0
7672;64961;77;97;23;0;23;1.000;3600000;0
7673;4487;4920;0;0;0;0;.00nan;0;0
7673;169154;78;82;34;3;31;.912;3900000;0
7673;184437;78;0;0;0;0;.00nan;0;0
7673;149450;4920;56;22;3;19;.864;3900000;0
7674;170598;4922;0;0;0;0;.00nan;0;0
7674;171608;4922;84;38;3;35;.921;3600000;0
7674;57207;76;0;0;0;0;.00nan;0;0
7674;57434;76;61;19;1;18;.947;3600000;0
7675;180873;69;79;54;4;50;.926;3600000;0
7675;181446;71;0;0;0;0;.00nan;0;0
7675;46790;71;73;26;2;24;.923;3600000;0
7675;57953;69;0;0;0;0;.00nan;0;0
7676;182339;82;86;43;3;40;.930;3522000;0
7676;-1;1096;92;33;1;32;.970;3600000;0
7676;171660;1096;0;0;0;0;.00nan;0;0
7676;185812;82;0;0;0;0;.00nan;0;0
7677;173823;73;86;34;2;32;.941;3569000;0
7677;-1;2564;77;26;1;25;.962;3600000;0
7677;86472;73;0;0;0;0;.00nan;0;0
7677;161047;2564;0;0;0;0;.00nan;0;0
7678;163195;4921;91;41;3;38;.927;3600000;0
7678;168651;151;60;37;4;33;.892;3600000;0
7678;85636;151;0;0;0;0;.00nan;0;0
7678;85661;4921;0;0;0;0;.00nan;0;0
7679;184049;1097;31;27;6;21;.778;2943000;0
7679;173856;75;54;29;4;25;.862;3600000;0
7679;170728;1097;34;5;2;3;.600;657000;0
7679;171615;75;0;0;0;0;.00nan;0;0
7680;178911;152;0;0;0;0;.00nan;0;0
7680;178950;152;74;26;1;25;.962;3900000;0
7680;38209;149;91;30;1;29;.967;3900000;0
7680;64722;149;0;0;0;0;.00nan;0;0
7681;171970;74;0;0;0;0;.00nan;0;0
7681;163784;77;0;0;0;0;.00nan;0;0
7681;170612;74;94;41;2;39;.951;3900000;0
7681;64961;77;48;17;2;15;.882;3900000;0
7682;-1;1095;0;0;0;0;.00nan;0;0
7682;176770;1095;87;37;3;34;.919;3900000;0
7682;44189;72;0;0;0;0;.00nan;0;0
7682;64811;72;82;45;3;42;.933;3900000;0
7683;164987;85;66;24;2;22;.917;3600000;0
7683;165380;67;0;0;0;0;.00nan;0;0
7683;44487;67;70;35;4;31;.886;3512000;0
7683;91703;85;0;0;0;0;.00nan;0;0
7684;165611;81;49;21;3;18;.857;3845000;0
7684;70213;81;0;0;0;0;.00nan;0;0
7684;85009;80;64;27;3;24;.889;3900000;0
7684;92313;80;0;0;0;0;.00nan;0;0
7685;173874;158;0;0;0;0;.00nan;0;0
7685;85437;157;67;23;1;22;.957;3900000;0
7685;91398;158;93;29;1;28;.966;3900000;0
7685;152418;157;0;0;0;0;.00nan;0;0
7686;-1;4620;81;26;1;25;.962;3600000;0
7686;173961;4620;0;0;0;0;.00nan;0;0
7686;184398;4245;0;0;0;0;.00nan;0;0
7686;37857;4245;56;33;4;29;.879;3600000;0
7687;4487;4920;56;23;2;21;.913;3551000;0
7687;169154;78;0;0;0;0;.00nan;0;0
7687;184437;78;99;36;1;35;.972;3600000;0
7687;149450;4920;0;0;0;0;.00nan;0;0
7688;-1;2564;0;0;0;0;.00nan;0;0
7688;-1;1095;77;26;1;25;.962;3600000;0
7688;176770;1095;0;0;0;0;.00nan;0;0
7688;161047;2564;57;33;4;29;.879;3600000;0
7689;170598;4922;0;0;0;0;.00nan;0;0
7689;171608;4922;50;39;5;34;.872;3600000;0
7689;57207;76;53;30;4;26;.867;3600000;0
7689;57434;76;0;0;0;0;.00nan;0;0
7690;173823;73;0;0;0;0;.00nan;0;0
7690;180873;69;0;0;0;0;.00nan;0;0
7690;57953;69;68;30;3;27;.900;3528000;0
7690;86472;73;100;37;1;36;.973;3600000;0
7691;163195;4921;0;0;0;0;.00nan;0;0
7691;168651;151;0;0;0;0;.00nan;0;0
7691;85636;151;58;23;3;20;.870;3600000;0
7691;85661;4921;76;38;4;34;.895;3568000;0
7692;184049;1097;73;32;3;29;.906;3600000;0
7692;173856;75;0;0;0;0;.00nan;0;0
7692;170728;1097;0;0;0;0;.00nan;0;0
7692;171615;75;62;40;4;36;.900;3588000;0
7693;171970;74;0;0;0;0;.00nan;0;0
7693;163784;77;51;28;4;24;.857;3551000;0
7693;170612;74;95;43;2;41;.953;3600000;0
7693;64961;77;0;0;0;0;.00nan;0;0
7694;178911;152;56;25;3;22;.880;3557000;0
7694;178950;152;0;0;0;0;.00nan;0;0
7694;38209;149;78;24;1;23;.958;3600000;0
7694;64722;149;0;0;0;0;.00nan;0;0
7695;182339;82;0;0;0;0;.00nan;0;0
7695;-1;1096;85;32;2;30;.938;3600000;0
7695;171660;1096;0;0;0;0;.00nan;0;0
7695;185812;82;32;37;7;30;.811;3600000;0
7696;181446;71;50;19;2;17;.895;3566000;0
7696;44189;72;84;27;1;26;.963;3600000;0
7696;46790;71;0;0;0;0;.00nan;0;0
7696;64811;72;0;0;0;0;.00nan;0;0
7697;164987;85;0;0;0;0;.00nan;0;0
7697;165380;67;71;39;4;35;.897;3600000;0
7697;44487;67;0;0;0;0;.00nan;0;0
7697;91703;85;88;33;1;32;.970;3600000;0
7698;173874;158;0;0;0;0;.00nan;0;0
7698;85437;157;0;0;0;0;.00nan;0;0
7698;91398;158;68;30;3;27;.900;3600000;0
7698;152418;157;63;31;4;27;.871;3547000;0
7699;165611;81;0;0;0;0;.00nan;0;0
7699;70213;81;77;23;1;22;.957;3600000;0
7699;85009;80;0;0;0;0;.00nan;0;0
7699;92313;80;65;26;2;24;.923;3555000;0
7700;-1;4620;0;0;0;0;.00nan;0;0
7700;173961;4620;89;32;1;31;.969;3600000;0
7700;184398;4245;0;0;0;0;.00nan;0;0
7700;37857;4245;45;28;4;24;.857;3600000;0
7701;173823;73;86;31;1;30;.968;3600000;0
7701;-1;2564;79;44;4;40;.909;3600000;0
7701;86472;73;0;0;0;0;.00nan;0;0
7701;161047;2564;0;0;0;0;.00nan;0;0
7702;173874;158;0;0;0;0;.00nan;0;0
7702;38209;149;83;33;2;31;.939;3600000;0
7702;64722;149;0;0;0;0;.00nan;0;0
7702;91398;158;87;27;1;26;.963;3600000;0
7703;-1;1095;0;0;0;0;.00nan;0;0
7703;176770;1095;78;20;1;19;.950;3600000;0
7703;181446;71;0;0;0;0;.00nan;0;0
7703;46790;71;39;31;6;25;.806;3600000;0
7704;163195;4921;100;31;0;31;1.000;3600000;0
7704;44189;72;0;0;0;0;.00nan;0;0
7704;64811;72;50;32;4;28;.875;3600000;0
7704;85661;4921;0;0;0;0;.00nan;0;0
7705;169154;78;42;18;3;15;.833;3600000;0
7705;173856;75;25;23;6;17;.739;2281000;0
7705;184437;78;0;0;0;0;.00nan;0;0
7705;171615;75;46;11;2;9;.818;1319000;0
7706;164987;85;25;22;5;17;.773;3600000;0
7706;165380;67;44;5;1;4;.800;252000;0
7706;44487;67;49;41;6;35;.854;3348000;0
7706;91703;85;0;0;0;0;.00nan;0;0
7707;168651;151;95;42;2;40;.952;3900000;0
7707;85437;157;57;19;2;17;.895;3900000;0
7707;85636;151;0;0;0;0;.00nan;0;0
7707;152418;157;0;0;0;0;.00nan;0;0
7708;178911;152;100;34;0;34;1.000;3600000;0
7708;178950;152;0;0;0;0;.00nan;0;0
7708;85009;80;62;18;2;16;.889;3568000;0
7708;92313;80;0;0;0;0;.00nan;0;0
7709;184049;1097;75;21;1;20;.952;3600000;0
7709;170598;4922;0;0;0;0;.00nan;0;0
7709;170728;1097;0;0;0;0;.00nan;0;0
7709;171608;4922;52;41;6;35;.854;3600000;0
7710;171970;74;0;0;0;0;.00nan;0;0
7710;-1;1096;83;29;2;27;.931;3600000;0
7710;170612;74;85;44;3;41;.932;3600000;0
7710;171660;1096;0;0;0;0;.00nan;0;0
7711;4487;4920;0;0;0;0;.00nan;0;0
7711;178911;152;83;32;2;30;.938;3562000;0
7711;178950;152;0;0;0;0;.00nan;0;0
7711;149450;4920;82;28;1;27;.964;3600000;0
7712;184049;1097;60;27;3;24;.889;3600000;0
7712;170598;4922;54;50;7;43;.860;3600000;0
7712;170728;1097;0;0;0;0;.00nan;0;0
7712;171608;4922;0;0;0;0;.00nan;0;0
7713;173823;73;50;30;4;26;.867;3529000;0
7713;-1;2564;100;48;2;46;.958;3600000;0
7713;86472;73;0;0;0;0;.00nan;0;0
7713;161047;2564;0;0;0;0;.00nan;0;0
7714;173874;158;0;0;0;0;.00nan;0;0
7714;38209;149;69;27;2;25;.926;3600000;0
7714;64722;149;0;0;0;0;.00nan;0;0
7714;91398;158;61;33;4;29;.879;3547000;0
7715;163195;4921;86;41;2;39;.951;3600000;0
7715;44189;72;0;0;0;0;.00nan;0;0
7715;64811;72;80;36;3;33;.917;3558000;0
7715;85661;4921;0;0;0;0;.00nan;0;0
7716;165380;67;93;41;2;39;.951;2447000;0
7716;-1;4620;70;22;1;21;.955;3600000;0
7716;173961;4620;0;0;0;0;.00nan;0;0
7716;44487;67;41;23;4;19;.826;1153000;0
7717;164987;85;78;25;1;24;.960;3600000;0
7717;184398;4245;0;0;0;0;.00nan;0;0
7717;37857;4245;80;42;3;39;.929;3598000;0
7717;91703;85;0;0;0;0;.00nan;0;0
7718;169154;78;100;41;1;40;.976;3600000;0
7718;173856;75;0;0;0;0;.00nan;0;0
7718;184437;78;0;0;0;0;.00nan;0;0
7718;171615;75;54;31;4;27;.871;3600000;0
7719;182339;82;0;0;0;0;.00nan;0;0
7719;163784;77;57;5;0;5;1.000;900000;0
7719;185812;82;100;30;0;30;1.000;3600000;0
7719;64961;77;13;18;6;12;.667;2700000;0
7720;171970;74;0;0;0;0;.00nan;0;0
7720;-1;1096;39;24;4;20;.833;3739000;0
7720;170612;74;57;38;5;33;.868;3748000;0
7720;171660;1096;0;0;0;0;.00nan;0;0
7721;165611;81;0;0;0;0;.00nan;0;0
7721;70213;81;70;28;2;26;.929;3900000;0
7721;85009;80;60;20;2;18;.900;3900000;0
7721;92313;80;0;0;0;0;.00nan;0;0
7722;168651;151;68;30;2;28;.933;3600000;0
7722;85437;157;61;30;4;26;.867;3514000;0
7722;85636;151;0;0;0;0;.00nan;0;0
7722;152418;157;0;0;0;0;.00nan;0;0
7723;-1;1095;88;32;1;31;.969;3600000;0
7723;176770;1095;0;0;0;0;.00nan;0;0
7723;180873;69;50;30;4;26;.867;3600000;0
7723;57953;69;0;0;0;0;.00nan;0;0
7724;4487;4920;0;0;0;0;.00nan;0;0
7724;178911;152;0;0;0;0;.00nan;0;0
7724;178950;152;74;26;1;25;.962;3900000;0
7724;149450;4920;98;43;1;42;.977;3900000;0
7725;180873;69;70;37;4;33;.892;3545000;0
7725;181446;71;0;0;0;0;.00nan;0;0
7725;46790;71;53;25;3;22;.880;3600000;0
7725;57953;69;0;0;0;0;.00nan;0;0
7726;173874;158;34;25;5;20;.800;3558000;0
7726;38209;149;61;33;4;29;.879;3600000;0
7726;64722;149;0;0;0;0;.00nan;0;0
7726;91398;158;0;0;0;0;.00nan;0;0
7727;163195;4921;57;32;4;28;.875;3600000;0
7727;44189;72;83;25;1;24;.960;3600000;0
7727;64811;72;0;0;0;0;.00nan;0;0
7727;85661;4921;0;0;0;0;.00nan;0;0
7728;173823;73;0;0;0;0;.00nan;0;0
7728;-1;2564;0;0;0;0;.00nan;0;0
7728;86472;73;81;27;1;26;.963;3600000;0
7728;161047;2564;60;30;3;27;.900;3523000;0
7729;164987;85;0;0;0;0;.00nan;0;0
7729;184398;4245;0;0;0;0;.00nan;0;0
7729;37857;4245;74;31;4;27;.871;3552000;0
7729;91703;85;65;22;3;19;.864;3600000;0
7730;169154;78;0;0;0;0;.00nan;0;0
7730;173856;75;35;24;5;19;.792;3600000;0
7730;184437;78;41;34;6;28;.824;3558000;0
7730;171615;75;0;0;0;0;.00nan;0;0
7731;182339;82;0;0;0;0;.00nan;0;0
7731;163784;77;67;18;1;17;.944;3900000;0
7731;185812;82;100;34;1;33;.971;3900000;0
7731;64961;77;0;0;0;0;.00nan;0;0
7732;171970;74;33;25;5;20;.800;3600000;0
7732;170598;4922;0;0;0;0;.00nan;0;0
7732;170612;74;0;0;0;0;.00nan;0;0
7732;171608;4922;85;31;2;29;.935;3600000;0
7733;-1;1096;25;18;5;13;.722;3556000;0
7733;171660;1096;0;0;0;0;.00nan;0;0
7733;57207;76;78;37;3;34;.919;3600000;0
7733;57434;76;0;0;0;0;.00nan;0;0
7734;168651;151;0;0;0;0;.00nan;0;0
7734;85437;157;57;16;2;14;.875;3600000;0
7734;85636;151;78;39;3;36;.923;3577000;0
7734;152418;157;0;0;0;0;.00nan;0;0
7735;165611;81;63;45;6;39;.867;3600000;0
7735;70213;81;0;0;0;0;.00nan;0;0
7735;85009;80;0;0;0;0;.00nan;0;0
7735;92313;80;49;20;3;17;.850;3600000;0
7736;165380;67;0;0;0;0;.00nan;0;0
7736;-1;4620;67;21;2;19;.905;3600000;0
7736;173961;4620;0;0;0;0;.00nan;0;0
7736;44487;67;78;45;3;42;.933;3600000;0
7737;4487;4920;0;0;0;0;.00nan;0;0
7737;178911;152;84;34;2;32;.941;3811000;0
7737;178950;152;0;0;0;0;.00nan;0;0
7737;149450;4920;89;35;3;32;.914;3811000;0
7738;184049;1097;42;19;3;16;.842;3560000;0
7738;170728;1097;0;0;0;0;.00nan;0;0
7738;57207;76;0;0;0;0;.00nan;0;0
7738;57434;76;60;21;2;19;.905;3600000;0
7739;173823;73;94;22;0;22;1.000;3600000;0
7739;180873;69;82;31;1;30;.968;3547000;0
7739;57953;69;0;0;0;0;.00nan;0;0
7739;86472;73;0;0;0;0;.00nan;0;0
7740;164987;85;48;41;6;35;.854;3600000;0
7740;184398;4245;0;0;0;0;.00nan;0;0
7740;37857;4245;80;26;1;25;.962;3600000;0
7740;91703;85;0;0;0;0;.00nan;0;0
7741;182339;82;73;47;4;43;.915;3600000;0
7741;163784;77;0;0;0;0;.00nan;0;0
7741;185812;82;0;0;0;0;.00nan;0;0
7741;64961;77;79;23;1;22;.957;3600000;0
7742;-1;1095;0;0;0;0;.00nan;0;0
7742;176770;1095;64;19;1;18;.947;3600000;0
7742;181446;71;58;31;4;27;.871;3600000;0
7742;46790;71;0;0;0;0;.00nan;0;0
7743;165611;81;0;0;0;0;.00nan;0;0
7743;70213;81;64;21;2;19;.905;3600000;0
7743;85009;80;69;33;3;30;.909;3570000;0
7743;92313;80;0;0;0;0;.00nan;0;0
7744;165380;67;53;42;6;36;.857;3074000;0
7744;-1;4620;0;0;0;0;.00nan;0;0
7744;173961;4620;56;16;2;14;.875;3600000;0
7744;44487;67;66;12;0;12;1.000;526000;0
7745;168651;151;45;27;5;22;.815;3514000;0
7745;-1;2564;69;32;3;29;.906;3600000;0
7745;85636;151;0;0;0;0;.00nan;0;0
7745;161047;2564;0;0;0;0;.00nan;0;0
7746;170598;4922;82;41;3;38;.927;3900000;0
7746;171608;4922;0;0;0;0;.00nan;0;0
7746;57207;76;77;29;3;26;.897;3900000;0
7746;57434;76;0;0;0;0;.00nan;0;0
7747;163195;4921;99;39;1;38;.974;3600000;0
7747;173823;73;61;28;2;26;.929;3585000;0
7747;85661;4921;0;0;0;0;.00nan;0;0
7747;86472;73;0;0;0;0;.00nan;0;0
7748;168651;151;0;0;0;0;.00nan;0;0
7748;-1;2564;0;0;0;0;.00nan;0;0
7748;85636;151;95;32;1;31;.969;3600000;0
7748;161047;2564;64;40;4;36;.900;3600000;0
7749;173856;75;0;0;0;0;.00nan;0;0
7749;184398;4245;0;0;0;0;.00nan;0;0
7749;171615;75;92;29;1;28;.966;3600000;0
7749;37857;4245;98;43;2;41;.953;3592000;0
7750;38209;149;78;26;1;25;.962;3600000;0
7750;64722;149;0;0;0;0;.00nan;0;0
7750;85009;80;0;0;0;0;.00nan;0;0
7750;92313;80;63;38;4;34;.895;3600000;0
7751;-1;1096;76;22;1;21;.955;3600000;0
7751;170598;4922;89;36;2;34;.944;3600000;0
7751;171608;4922;0;0;0;0;.00nan;0;0
7751;171660;1096;0;0;0;0;.00nan;0;0
7752;180873;69;66;21;2;19;.905;3600000;0
7752;181446;71;0;0;0;0;.00nan;0;0
7752;46790;71;58;32;4;28;.875;3600000;0
7752;57953;69;0;0;0;0;.00nan;0;0
7753;182339;82;0;0;0;0;.00nan;0;0
7753;184049;1097;72;34;3;31;.912;3614000;0
7753;170728;1097;0;0;0;0;.00nan;0;0
7753;185812;82;61;21;2;19;.905;3614000;0
7754;173874;158;0;0;0;0;.00nan;0;0
7754;85437;157;51;30;5;25;.833;3520000;0
7754;91398;158;86;37;3;34;.919;3600000;0
7754;152418;157;0;0;0;0;.00nan;0;0
7755;163195;4921;100;36;0;36;1.000;3600000;0
7755;173823;73;71;29;2;27;.931;3572000;0
7755;85661;4921;0;0;0;0;.00nan;0;0
7755;86472;73;0;0;0;0;.00nan;0;0
7756;171970;74;0;0;0;0;.00nan;0;0
7756;170612;74;84;48;4;44;.917;3600000;0
7756;57207;76;0;0;0;0;.00nan;0;0
7756;57434;76;73;25;1;24;.960;3600000;0
7757;4487;4920;0;0;0;0;.00nan;0;0
7757;165380;67;0;0;0;0;.00nan;0;0
7757;44487;67;99;45;2;43;.956;3600000;0
7757;149450;4920;45;22;4;18;.818;3541000;0
7758;38209;149;76;21;1;20;.952;3600000;0
7758;64722;149;0;0;0;0;.00nan;0;0
7758;85009;80;63;31;3;28;.903;3554000;0
7758;92313;80;0;0;0;0;.00nan;0;0
7759;163784;77;0;0;0;0;.00nan;0;0
7759;169154;78;47;43;6;37;.860;3600000;0
7759;184437;78;0;0;0;0;.00nan;0;0
7759;64961;77;72;19;1;18;.947;3600000;0
7760;164987;85;72;51;4;47;.922;3900000;0
7760;-1;4620;62;26;4;22;.846;3900000;0
7760;173961;4620;0;0;0;0;.00nan;0;0
7760;91703;85;0;0;0;0;.00nan;0;0
7761;165611;81;51;30;4;26;.867;3600000;0
7761;178911;152;78;22;1;21;.955;3600000;0
7761;178950;152;0;0;0;0;.00nan;0;0
7761;70213;81;0;0;0;0;.00nan;0;0
7762;-1;1095;69;32;3;29;.906;3900000;0
7762;176770;1095;0;0;0;0;.00nan;0;0
7762;44189;72;0;0;0;0;.00nan;0;0
7762;64811;72;74;32;3;29;.906;3900000;0
7763;4487;4920;50;22;4;18;.818;3640000;0
7763;165380;67;76;50;5;45;.900;3640000;0
7763;44487;67;0;0;0;0;.00nan;0;0
7763;149450;4920;0;0;0;0;.00nan;0;0
7764;165611;81;0;0;0;0;.00nan;0;0
7764;178911;152;0;0;0;0;.00nan;0;0
7764;178950;152;46;24;4;20;.833;3570000;0
7764;70213;81;69;26;3;23;.885;3600000;0
7765;-1;1096;70;29;3;26;.897;3545000;0
7765;170598;4922;0;0;0;0;.00nan;0;0
7765;171608;4922;57;20;2;18;.900;3600000;0
7765;171660;1096;0;0;0;0;.00nan;0;0
7766;173874;158;0;0;0;0;.00nan;0;0
7766;85437;157;84;33;2;31;.939;3900000;0
7766;91398;158;79;23;2;21;.913;3900000;0
7766;152418;157;0;0;0;0;.00nan;0;0
7767;173823;73;0;0;0;0;.00nan;0;0
7767;181446;71;61;28;3;25;.893;3900000;0
7767;46790;71;0;0;0;0;.00nan;0;0
7767;86472;73;80;38;3;35;.921;3900000;0
7768;163195;4921;71;43;4;39;.907;3900000;0
7768;168651;151;65;33;4;29;.879;3900000;0
7768;85636;151;0;0;0;0;.00nan;0;0
7768;85661;4921;0;0;0;0;.00nan;0;0
7769;184049;1097;48;31;5;26;.839;3600000;0
7769;170728;1097;0;0;0;0;.00nan;0;0
7769;57207;76;72;26;2;24;.923;3600000;0
7769;57434;76;0;0;0;0;.00nan;0;0
7770;173856;75;48;34;5;29;.853;3600000;0
7770;184398;4245;0;0;0;0;.00nan;0;0
7770;171615;75;0;0;0;0;.00nan;0;0
7770;37857;4245;61;20;2;18;.900;3600000;0
7771;38209;149;59;24;3;21;.875;3600000;0
7771;64722;149;0;0;0;0;.00nan;0;0
7771;85009;80;0;0;0;0;.00nan;0;0
7771;92313;80;54;31;4;27;.871;3600000;0
7772;163784;77;51;25;3;22;.880;3600000;0
7772;169154;78;0;0;0;0;.00nan;0;0
7772;184437;78;45;31;5;26;.839;3550000;0
7772;64961;77;0;0;0;0;.00nan;0;0
7773;182339;82;74;24;1;23;.958;3600000;0
7773;171970;74;88;49;2;47;.959;3555000;0
7773;170612;74;0;0;0;0;.00nan;0;0
7773;185812;82;0;0;0;0;.00nan;0;0
7774;180873;69;64;41;5;36;.878;3573000;0
7774;44189;72;52;26;3;23;.885;3600000;0
7774;57953;69;0;0;0;0;.00nan;0;0
7774;64811;72;0;0;0;0;.00nan;0;0
7775;164987;85;0;0;0;0;.00nan;0;0
7775;-1;4620;80;24;1;23;.958;3600000;0
7775;173961;4620;0;0;0;0;.00nan;0;0
7775;91703;85;62;34;4;30;.882;3600000;0
7776;-1;2564;72;36;3;33;.917;3600000;0
7776;-1;1095;0;0;0;0;.00nan;0;0
7776;176770;1095;80;25;1;24;.960;3600000;0
7776;161047;2564;0;0;0;0;.00nan;0;0
7777;4487;4920;0;0;0;0;.00nan;0;0
7777;165380;67;0;0;0;0;.00nan;0;0
7777;44487;67;85;55;5;50;.909;3600000;0
7777;149450;4920;66;16;1;15;.938;3600000;0
7778;165611;81;90;31;1;30;.968;3600000;0
7778;178911;152;64;31;3;28;.903;3589000;0
7778;178950;152;0;0;0;0;.00nan;0;0
7778;70213;81;0;0;0;0;.00nan;0;0
7779;180873;69;0;0;0;0;.00nan;0;0
7779;44189;72;0;0;0;0;.00nan;0;0
7779;57953;69;56;27;3;24;.889;3600000;0
7779;64811;72;53;32;5;27;.844;3578000;0
7780;182339;82;0;0;0;0;.00nan;0;0
7780;171970;74;0;0;0;0;.00nan;0;0
7780;170612;74;53;22;3;19;.864;3554000;0
7780;185812;82;65;20;2;18;.900;3600000;0
7781;184049;1097;54;23;3;20;.870;3548000;0
7781;170728;1097;0;0;0;0;.00nan;0;0
7781;57207;76;0;0;0;0;.00nan;0;0
7781;57434;76;68;22;2;20;.909;3600000;0
7782;173856;75;0;0;0;0;.00nan;0;0
7782;184398;4245;0;0;0;0;.00nan;0;0
7782;171615;75;98;33;1;32;.970;3900000;0
7782;37857;4245;89;27;1;26;.963;3900000;0
7783;164987;85;55;28;4;24;.857;3594000;0
7783;-1;4620;91;33;2;31;.939;3600000;0
7783;173961;4620;0;0;0;0;.00nan;0;0
7783;91703;85;0;0;0;0;.00nan;0;0
7785;-1;4620;0;0;0;0;.00nan;0;0
7785;173961;4620;71;17;1;16;.941;3600000;0
7785;181446;71;0;0;0;0;.00nan;0;0
7785;46790;71;17;34;8;26;.765;3600000;0
7787;173856;75;64;32;4;28;.875;3572000;0
7787;171615;75;0;0;0;0;.00nan;0;0
7787;179411;4922;83;37;3;34;.919;3600000;0
7787;161046;4922;0;0;0;0;.00nan;0;0
7789;2495;1097;98;47;2;45;.957;3900000;0
7789;4487;4920;82;31;2;29;.935;3900000;0
7789;170728;1097;0;0;0;0;.00nan;0;0
7789;149450;4920;0;0;0;0;.00nan;0;0
7791;182339;82;55;18;2;16;.889;3600000;0
7791;171660;1096;54;23;3;20;.870;3562000;0
7791;-1;1096;0;0;0;0;.00nan;0;0
7791;186450;82;0;0;0;0;.00nan;0;0
7793;164987;85;58;28;3;25;.893;3566000;0
7793;19708;157;0;0;0;0;.00nan;0;0
7793;186520;157;72;22;1;21;.955;3600000;0
7793;57207;85;0;0;0;0;.00nan;0;0
7795;183730;4245;0;0;0;0;.00nan;0;0
7795;178911;152;70;28;3;25;.893;3836000;0
7795;178950;152;0;0;0;0;.00nan;0;0
7795;184398;4245;78;33;2;31;.939;3851000;0
7797;173823;73;0;0;0;0;.00nan;0;0
7797;44189;72;0;0;0;0;.00nan;0;0
7797;64811;72;98;23;0;23;1.000;3600000;0
7797;86472;73;63;32;3;29;.906;3600000;0
7799;173874;158;0;0;0;0;.00nan;0;0
7799;85555;76;92;40;2;38;.950;3600000;0
7799;91398;158;89;44;3;41;.932;3572000;0
7799;91703;76;0;0;0;0;.00nan;0;0
7801;163195;67;54;36;4;32;.889;3600000;0
7801;165380;67;0;0;0;0;.00nan;0;0
7801;168651;151;0;0;0;0;.00nan;0;0
7801;142492;151;61;29;3;26;.897;3600000;0
7803;171970;74;62;23;2;21;.913;3600000;0
7803;170612;74;0;0;0;0;.00nan;0;0
7803;85437;4921;0;0;0;0;.00nan;0;0
7803;85661;4921;85;47;4;43;.915;3526000;0
7805;163784;77;62;19;1;18;.947;3547000;0
7805;166441;2564;0;0;0;0;.00nan;0;0
7805;-1;2564;100;33;0;33;1.000;3600000;0
7805;161047;77;0;0;0;0;.00nan;0;0
7807;-1;78;0;0;0;0;.00nan;0;0
7807;184437;78;68;31;3;28;.903;3593000;0
7807;-1;1095;81;34;2;32;.941;3600000;0
7807;176770;1095;0;0;0;0;.00nan;0;0
7809;165611;81;0;0;0;0;.00nan;0;0
7809;-1;80;0;0;0;0;.00nan;0;0
7809;70213;81;76;29;2;27;.931;3600000;0
7809;152851;80;51;28;4;24;.857;3517000;0
7811;-1;149;0;0;0;0;.00nan;0;0
7811;180873;69;0;0;0;0;.00nan;0;0
7811;57215;69;96;41;2;39;.951;3900000;0
7811;64722;149;79;31;2;29;.935;3900000;0
1286;-1;4620;57;17;2;15;.882;3545000;0
1286;173961;4620;0;0;0;0;.00nan;0;0
1286;37857;4245;100;38;1;37;.974;3600000;0
1286;186520;4245;0;0;0;0;.00nan;0;0
1287;4487;4920;0;0;0;0;.00nan;0;0
1287;164987;85;62;30;3;27;.900;3585000;0
1287;91703;85;0;0;0;0;.00nan;0;0
1287;149450;4920;68;18;1;17;.944;3600000;0
1288;184049;1097;40;32;5;27;.844;3600000;0
1288;170728;1097;0;0;0;0;.00nan;0;0
1288;57207;76;97;23;0;23;1.000;3600000;0
1288;57434;76;0;0;0;0;.00nan;0;0
1289;182339;82;0;0;0;0;.00nan;0;0
1289;-1;1096;0;0;0;0;.00nan;0;0
1289;171660;1096;68;42;4;38;.905;3583000;0
1289;185812;82;86;34;2;32;.941;3600000;0
1290;180873;69;67;36;4;32;.889;5032000;0
1290;44189;72;0;0;0;0;.00nan;0;0
1290;57953;69;0;0;0;0;.00nan;0;0
1290;64811;72;93;65;5;60;.923;5032000;0
1291;-1;1095;0;0;0;0;.00nan;0;0
1291;176770;1095;60;32;4;28;.875;3600000;0
1291;181446;71;0;0;0;0;.00nan;0;0
1291;46790;71;74;34;3;31;.912;3600000;0
1292;178911;152;77;36;3;33;.917;3600000;0
1292;178950;152;0;0;0;0;.00nan;0;0
1292;85437;157;36;22;4;18;.818;3600000;0
1292;152418;157;0;0;0;0;.00nan;0;0
1293;165611;81;0;0;0;0;.00nan;0;0
1293;38209;149;67;34;3;31;.912;3595000;0
1293;64722;149;0;0;0;0;.00nan;0;0
1293;70213;81;84;27;1;26;.963;3600000;0
1294;-1;4620;90;23;1;22;.957;3600000;0
1294;173961;4620;0;0;0;0;.00nan;0;0
1294;37857;4245;77;38;3;35;.921;3542000;0
1294;186520;4245;0;0;0;0;.00nan;0;0
1296;184049;1097;81;33;2;31;.939;3600000;0
1296;170728;1097;0;0;0;0;.00nan;0;0
1296;57207;76;66;32;3;29;.906;3546000;0
1296;57434;76;0;0;0;0;.00nan;0;0
1298;180873;69;77;41;3;38;.927;3600000;0
1298;44189;72;0;0;0;0;.00nan;0;0
1298;57953;69;0;0;0;0;.00nan;0;0
1298;64811;72;72;20;2;18;.900;3600000;0
1300;178911;152;48;34;6;28;.824;2973000;0
1300;178950;152;55;4;0;4;1.000;627000;0
1300;85437;157;67;27;3;24;.889;3600000;0
1300;152418;157;0;0;0;0;.00nan;0;0
7812;187699;114;72;51;5;46;.902;3600000;0
7812;202180;114;0;0;0;0;.00nan;0;0
7812;-1;113;0;0;0;0;.00nan;0;0
7812;191709;113;59;36;4;32;.889;3600000;0
7813;187550;111;52;11;1;10;.909;1067000;0
7813;189008;108;0;0;0;0;.00nan;0;0
7813;196372;108;78;36;3;33;.917;3600000;0
7813;197912;111;13;19;6;13;.684;2533000;0
7814;187550;111;32;31;6;25;.806;2418000;0
7814;198141;110;0;0;0;0;.00nan;0;0
7814;196324;110;56;18;2;16;.889;3600000;0
7814;197912;111;68;13;0;13;1.000;1182000;0
7815;189008;108;0;0;0;0;.00nan;0;0
7815;201631;109;36;37;6;31;.838;3600000;0
7815;196372;108;73;34;2;32;.941;3600000;0
7815;197038;109;0;0;0;0;.00nan;0;0
7816;188888;116;70;35;3;32;.914;3600000;0
7816;200514;116;0;0;0;0;.00nan;0;0
7816;207493;121;0;0;0;0;.00nan;0;0
7816;192645;121;41;26;4;22;.846;3545000;0
7817;187699;114;40;41;7;34;.829;3600000;0
7817;202180;114;0;0;0;0;.00nan;0;0
7817;-1;113;0;0;0;0;.00nan;0;0
7817;191709;113;49;24;4;20;.833;3600000;0
7818;193687;120;47;19;3;16;.842;3600000;0
7818;189734;120;0;0;0;0;.00nan;0;0
7818;191125;123;31;37;6;31;.838;3324000;0
7818;-1;123;48;0;0;0;.00nan;276000;0
7819;188911;115;64;27;3;24;.889;3600000;0
7819;196414;118;0;0;0;0;.00nan;0;0
7819;191026;118;59;53;6;47;.887;3600000;0
7819;191698;115;0;0;0;0;.00nan;0;0
7820;187537;117;72;43;5;38;.884;3600000;0
7820;188918;112;2;23;7;16;.696;3340000;0
7820;189783;117;0;0;0;0;.00nan;0;0
7820;202246;112;55;1;0;1;1.000;259000;0
7821;195111;125;52;18;3;15;.833;3600000;0
7821;202314;127;50;8;1;7;.875;1118000;0
7821;191171;127;36;27;6;21;.778;2482000;0
7821;191813;125;0;0;0;0;.00nan;0;0
7822;195001;126;100;28;0;28;1.000;3600000;0
7822;195089;124;71;44;4;40;.909;3600000;0
7822;191687;124;0;0;0;0;.00nan;0;0
7822;192564;126;0;0;0;0;.00nan;0;0
7823;192776;119;12;22;6;16;.727;3558000;0
7823;199481;122;0;0;0;0;.00nan;0;0
7823;195017;119;0;0;0;0;.00nan;0;0
7823;191692;122;89;45;4;41;.911;3600000;0
7824;188911;115;37;20;4;16;.800;3559000;0
7824;196414;118;100;55;2;53;.964;3600000;0
7824;191026;118;0;0;0;0;.00nan;0;0
7824;191698;115;0;0;0;0;.00nan;0;0
7825;193687;120;83;15;0;15;1.000;3600000;0
7825;195089;124;36;39;7;32;.821;3143000;0
7825;189734;120;0;0;0;0;.00nan;0;0
7825;191687;124;54;5;0;5;1.000;457000;0
7826;188888;116;61;24;3;21;.875;3600000;0
7826;200514;116;0;0;0;0;.00nan;0;0
7826;207493;121;46;7;1;6;.857;456000;0
7826;192645;121;46;38;6;32;.842;3144000;0
7827;192776;119;64;24;2;22;.917;3811000;0
7827;187699;114;0;0;0;0;.00nan;0;0
7827;195017;119;0;0;0;0;.00nan;0;0
7827;202180;114;87;43;3;40;.930;3811000;0
7828;199481;122;0;0;0;0;.00nan;0;0
7828;195111;125;85;38;2;36;.947;3600000;0
7828;191692;122;61;28;3;25;.893;3550000;0
7828;191813;125;0;0;0;0;.00nan;0;0
7829;202314;127;0;0;0;0;.00nan;0;0
7829;191125;123;57;24;3;21;.875;3900000;0
7829;191171;127;73;45;3;42;.933;3900000;0
7829;-1;123;0;0;0;0;.00nan;0;0
7830;188918;112;0;0;0;0;.00nan;0;0
7830;195001;126;61;34;4;30;.882;3838000;0
7830;202246;112;95;52;3;49;.942;3838000;0
7830;192564;126;0;0;0;0;.00nan;0;0
7831;187537;117;100;38;0;38;1.000;3600000;0
7831;189783;117;0;0;0;0;.00nan;0;0
7831;-1;113;0;0;0;0;.00nan;0;0
7831;191709;113;47;29;5;24;.828;3600000;0
7832;187550;111;55;28;3;25;.893;1221000;0
7832;198141;110;0;0;0;0;.00nan;0;0
7832;196324;110;49;20;3;17;.850;3600000;0
7832;197912;111;54;31;4;27;.871;2379000;0
7833;193687;120;62;32;4;28;.875;3600000;0
7833;189734;120;0;0;0;0;.00nan;0;0
7833;202314;127;83;30;1;29;.967;3600000;0
7833;191171;127;0;0;0;0;.00nan;0;0
7834;195001;126;0;0;0;0;.00nan;0;0
7834;196414;118;89;43;2;41;.953;3535000;0
7834;191026;118;0;0;0;0;.00nan;0;0
7834;192564;126;100;20;0;20;1.000;3600000;0
7835;188888;116;38;34;6;28;.824;3600000;0
7835;188911;115;0;0;0;0;.00nan;0;0
7835;200514;116;0;0;0;0;.00nan;0;0
7835;191698;115;75;27;1;26;.963;3600000;0
7836;187537;117;61;26;3;23;.885;3563000;0
7836;189008;108;89;33;2;31;.939;3600000;0
7836;189783;117;0;0;0;0;.00nan;0;0
7836;196372;108;0;0;0;0;.00nan;0;0
7837;195111;125;0;0;0;0;.00nan;0;0
7837;-1;113;0;0;0;0;.00nan;0;0
7837;191709;113;56;11;1;10;.909;3600000;0
7837;191813;125;97;46;2;44;.957;3552000;0
7838;187537;117;54;31;4;27;.871;3563000;0
7838;187550;111;0;0;0;0;.00nan;0;0
7838;189783;117;0;0;0;0;.00nan;0;0
7838;197912;111;72;30;3;27;.900;3600000;0
7839;192776;119;66;27;2;25;.926;3600000;0
7839;193687;120;27;27;6;21;.778;3226000;0
7839;195017;119;0;0;0;0;.00nan;0;0
7839;189734;120;40;2;1;1;.500;374000;0
7840;196414;118;73;33;3;30;.909;3622000;0
7840;-1;113;69;38;4;34;.895;3622000;0
7840;191026;118;0;0;0;0;.00nan;0;0
7840;191709;113;0;0;0;0;.00nan;0;0
7841;195001;126;21;30;7;23;.767;3600000;0
7841;202314;127;0;0;0;0;.00nan;0;0
7841;191171;127;60;37;4;33;.892;3600000;0
7841;192564;126;0;0;0;0;.00nan;0;0
7842;199481;122;0;0;0;0;.00nan;0;0
7842;207493;121;0;0;0;0;.00nan;0;0
7842;191692;122;76;46;4;42;.913;3598000;0
7842;192645;121;72;31;2;29;.935;3600000;0
7843;198141;110;49;32;4;28;.875;3900000;0
7843;188888;116;74;35;4;31;.886;3900000;0
7843;200514;116;0;0;0;0;.00nan;0;0
7843;196324;110;0;0;0;0;.00nan;0;0
7844;187537;117;78;46;4;42;.913;3895000;0
7844;189783;117;0;0;0;0;.00nan;0;0
7844;201631;109;0;0;0;0;.00nan;0;0
7844;197038;109;47;31;4;27;.871;3900000;0
7845;195111;125;64;22;2;20;.909;3600000;0
7845;202314;127;70;45;4;41;.911;3524000;0
7845;191171;127;0;0;0;0;.00nan;0;0
7845;191813;125;0;0;0;0;.00nan;0;0
7846;198141;110;0;0;0;0;.00nan;0;0
7846;188918;112;0;0;0;0;.00nan;0;0
7846;196324;110;68;23;2;21;.913;3900000;0
7846;202246;112;79;35;2;33;.943;3900000;0
7847;195001;126;0;0;0;0;.00nan;0;0
7847;195089;124;0;0;0;0;.00nan;0;0
7847;191687;124;60;40;5;35;.875;3600000;0
7847;192564;126;56;16;2;14;.875;3600000;0
7848;192776;119;0;0;0;0;.00nan;0;0
7848;195017;119;67;28;2;26;.929;3600000;0
7848;207493;121;53;37;5;32;.865;3600000;0
7848;192645;121;0;0;0;0;.00nan;0;0
7849;199481;122;52;6;1;5;.833;708000;0
7849;196414;118;45;20;4;16;.800;3522000;0
7849;191026;118;27;6;3;3;.500;378000;0
7849;191692;122;11;16;6;10;.625;3192000;0
7850;193687;120;0;0;0;0;.00nan;0;0
7850;189734;120;43;37;5;32;.865;3600000;0
7850;191125;123;0;0;0;0;.00nan;0;0
7850;-1;123;71;27;2;25;.926;3600000;0
7851;187699;114;97;50;3;47;.940;3600000;0
7851;188911;115;51;25;4;21;.840;3544000;0
7851;202180;114;0;0;0;0;.00nan;0;0
7851;191698;115;0;0;0;0;.00nan;0;0
7852;187550;111;0;0;0;0;.00nan;0;0
7852;201631;109;0;0;0;0;.00nan;0;0
7852;197038;109;88;37;1;36;.973;3600000;0
7852;197912;111;43;23;4;19;.826;3600000;0
7853;188888;116;79;40;3;37;.925;3600000;0
7853;188918;112;0;0;0;0;.00nan;0;0
7853;200514;116;0;0;0;0;.00nan;0;0
7853;202246;112;68;23;2;21;.913;3600000;0
7854;192776;119;89;43;1;42;.977;3600000;0
7854;195017;119;0;0;0;0;.00nan;0;0
7854;-1;113;91;15;0;15;1.000;3600000;0
7854;191709;113;0;0;0;0;.00nan;0;0
7855;195001;126;48;28;3;25;.893;3544000;0
7855;195111;125;0;0;0;0;.00nan;0;0
7855;191813;125;100;45;2;43;.956;3600000;0
7855;192564;126;0;0;0;0;.00nan;0;0
7856;195089;124;71;41;3;38;.927;3600000;0
7856;191125;123;70;27;2;25;.926;3600000;0
7856;-1;123;0;0;0;0;.00nan;0;0
7856;191687;124;0;0;0;0;.00nan;0;0
7857;201631;109;0;0;0;0;.00nan;0;0
7857;-1;113;70;24;2;22;.917;3900000;0
7857;197038;109;75;37;2;35;.946;3900000;0
7857;191709;113;0;0;0;0;.00nan;0;0
7858;188911;115;0;0;0;0;.00nan;0;0
7858;207493;121;0;0;0;0;.00nan;0;0
7858;191698;115;71;27;1;26;.963;3600000;0
7858;192645;121;87;40;2;38;.950;3592000;0
7859;189008;108;0;0;0;0;.00nan;0;0
7859;196372;108;81;27;1;26;.963;3600000;0
7859;196414;118;1;19;7;12;.632;2290000;0
7859;191026;118;46;10;1;9;.900;1310000;0
7860;187550;111;0;0;0;0;.00nan;0;0
7860;195111;125;81;28;2;26;.929;3600000;0
7860;191813;125;0;0;0;0;.00nan;0;0
7860;197912;111;55;39;5;34;.872;3600000;0
7861;188918;112;0;0;0;0;.00nan;0;0
7861;189008;108;52;24;4;20;.833;3600000;0
7861;196372;108;0;0;0;0;.00nan;0;0
7861;202246;112;47;36;6;30;.833;3513000;0
7862;187699;114;54;38;5;33;.868;2198000;0
7862;193687;120;84;27;2;25;.926;3600000;0
7862;189734;120;0;0;0;0;.00nan;0;0
7862;202180;114;32;10;3;7;.700;1402000;0
7863;187550;111;48;40;6;34;.850;3339000;0
7863;196414;118;49;30;5;25;.833;3600000;0
7863;191026;118;0;0;0;0;.00nan;0;0
7863;197912;111;54;4;0;4;1.000;219000;0
7864;192776;119;34;33;6;27;.818;3900000;0
7864;187537;117;37;31;6;25;.806;2972000;0
7864;195017;119;0;0;0;0;.00nan;0;0
7864;189783;117;61;7;0;7;1.000;928000;0
7865;195089;124;54;26;3;23;.885;3600000;0
7865;202314;127;60;25;2;23;.920;636000;0
7865;191171;127;41;31;5;26;.839;2964000;0
7865;191687;124;0;0;0;0;.00nan;0;0
7866;195001;126;61;7;0;7;1.000;1571000;0
7866;201631;109;36;21;4;17;.810;2067000;0
7866;197038;109;28;17;4;13;.765;1533000;0
7866;192564;126;39;20;4;16;.800;2029000;0
7867;199481;122;80;55;6;49;.891;2699000;0
7867;188888;116;54;14;2;12;.857;3600000;0
7867;200514;116;0;0;0;0;.00nan;0;0
7867;191692;122;55;9;1;8;.889;901000;0
7868;198141;110;0;0;0;0;.00nan;0;0
7868;196324;110;66;22;2;20;.909;3600000;0
7868;191125;123;55;32;4;28;.875;2298000;0
7868;-1;123;38;12;3;9;.750;1302000;0
7869;188888;116;99;34;2;32;.941;3600000;0
7869;200514;116;0;0;0;0;.00nan;0;0
7869;191125;123;0;0;0;0;.00nan;0;0
7869;-1;123;57;28;3;25;.893;3571000;0
7870;187550;111;43;5;1;4;.800;437000;0
7870;188911;115;60;22;2;20;.909;3600000;0
7870;191698;115;0;0;0;0;.00nan;0;0
7870;197912;111;57;51;6;45;.882;3163000;0
7871;199481;122;48;17;3;14;.824;2460000;0
7871;195089;124;64;16;1;15;.938;1421000;0
7871;191687;124;34;20;5;15;.750;2179000;0
7871;191692;122;34;19;4;15;.789;1115000;0
7872;195111;125;95;36;1;35;.972;3600000;0
7872;207493;121;55;35;5;30;.857;3600000;0
7872;191813;125;0;0;0;0;.00nan;0;0
7872;192645;121;0;0;0;0;.00nan;0;0
7873;188918;112;57;34;4;30;.882;3900000;0
7873;189008;108;0;0;0;0;.00nan;0;0
7873;196372;108;58;34;4;30;.882;3900000;0
7873;202246;112;0;0;0;0;.00nan;0;0
7874;196414;118;59;7;0;7;1.000;654000;0
7874;202314;127;66;29;3;26;.897;3600000;0
7874;191026;118;24;26;6;20;.769;2946000;0
7874;191171;127;0;0;0;0;.00nan;0;0
7875;192776;119;0;0;0;0;.00nan;0;0
7875;195001;126;29;31;6;25;.806;3308000;0
7875;195017;119;76;42;3;39;.929;3600000;0
7875;192564;126;54;4;0;4;1.000;292000;0
7876;198141;110;65;32;3;29;.906;3563000;0
7876;187699;114;68;25;2;23;.920;3600000;0
7876;196324;110;0;0;0;0;.00nan;0;0
7876;202180;114;0;0;0;0;.00nan;0;0
7877;193687;120;72;34;4;30;.882;3567000;0
7877;195111;125;0;0;0;0;.00nan;0;0
7877;189734;120;0;0;0;0;.00nan;0;0
7877;191813;125;60;26;3;23;.885;3600000;0
7878;187537;117;21;22;6;16;.727;3005000;0
7878;189783;117;39;8;2;6;.750;595000;0
7878;201631;109;0;0;0;0;.00nan;0;0
7878;197038;109;51;34;4;30;.882;3600000;0
7879;188888;116;67;37;3;34;.919;2721000;0
7879;200514;116;20;11;4;7;.636;879000;0
7879;207493;121;0;0;0;0;.00nan;0;0
7879;192645;121;56;34;4;30;.882;3600000;0
7880;198141;110;0;0;0;0;.00nan;0;0
7880;196324;110;41;29;5;24;.828;3600000;0
7880;-1;113;0;0;0;0;.00nan;0;0
7880;191709;113;56;41;6;35;.854;3600000;0
7881;188918;112;0;0;0;0;.00nan;0;0
7881;196414;118;37;45;7;38;.844;3600000;0
7881;202246;112;60;18;2;16;.889;3600000;0
7881;191026;118;0;0;0;0;.00nan;0;0
7882;193687;120;62;38;5;33;.868;3600000;0
7882;188911;115;0;0;0;0;.00nan;0;0
7882;189734;120;0;0;0;0;.00nan;0;0
7882;191698;115;54;23;3;20;.870;3600000;0
7883;187537;117;47;29;5;24;.828;3548000;0
7883;188888;116;0;0;0;0;.00nan;0;0
7883;200514;116;42;22;4;18;.818;3600000;0
7883;189783;117;0;0;0;0;.00nan;0;0
7884;189008;108;0;0;0;0;.00nan;0;0
7884;195001;126;0;0;0;0;.00nan;0;0
7884;196372;108;53;36;5;31;.861;3579000;0
7884;192564;126;61;26;3;23;.885;3600000;0
7885;187699;114;64;30;3;27;.900;3600000;0
7885;195089;124;51;31;4;27;.871;3546000;0
7885;202180;114;0;0;0;0;.00nan;0;0
7885;191687;124;0;0;0;0;.00nan;0;0
7886;188888;116;58;19;2;17;.895;3600000;0
7886;200514;116;0;0;0;0;.00nan;0;0
7886;-1;113;55;26;3;23;.885;3579000;0
7886;191709;113;0;0;0;0;.00nan;0;0
7887;187550;111;0;0;0;0;.00nan;0;0
7887;195001;126;62;29;3;26;.897;3900000;0
7887;192564;126;0;0;0;0;.00nan;0;0
7887;197912;111;100;48;3;45;.938;3900000;0
7888;189008;108;56;37;5;32;.865;3698000;0
7888;201631;109;46;35;6;29;.829;3698000;0
7888;196372;108;0;0;0;0;.00nan;0;0
7888;197038;109;0;0;0;0;.00nan;0;0
7889;188911;115;58;19;2;17;.895;3600000;0
7889;202314;127;0;0;0;0;.00nan;0;0
7889;191171;127;48;30;5;25;.833;3600000;0
7889;191698;115;0;0;0;0;.00nan;0;0
7890;192776;119;47;41;6;35;.854;3600000;0
7890;193687;120;97;48;2;46;.958;3600000;0
7890;195017;119;0;0;0;0;.00nan;0;0
7890;189734;120;0;0;0;0;.00nan;0;0
7891;196414;118;69;38;4;34;.895;3600000;0
7891;207493;121;31;30;6;24;.800;3571000;0
7891;191026;118;0;0;0;0;.00nan;0;0
7891;192645;121;0;0;0;0;.00nan;0;0
7892;187537;117;79;23;1;22;.957;3600000;0
7892;195089;124;56;6;0;6;1.000;496000;0
7892;189783;117;0;0;0;0;.00nan;0;0
7892;191687;124;40;35;6;29;.829;3104000;0
7893;187699;114;0;0;0;0;.00nan;0;0
7893;199481;122;46;21;4;17;.810;3559000;0
7893;202180;114;64;33;3;30;.909;3600000;0
7893;191692;122;0;0;0;0;.00nan;0;0
7894;198141;110;59;37;4;33;.892;3600000;0
7894;188918;112;0;0;0;0;.00nan;0;0
7894;196324;110;0;0;0;0;.00nan;0;0
7894;202246;112;93;25;1;24;.960;3600000;0
7895;193687;120;0;0;0;0;.00nan;0;0
7895;188888;116;67;49;5;44;.898;3600000;0
7895;200514;116;0;0;0;0;.00nan;0;0
7895;189734;120;50;20;3;17;.850;3600000;0
7896;207493;121;0;0;0;0;.00nan;0;0
7896;202314;127;89;43;2;41;.953;3900000;0
7896;191171;127;0;0;0;0;.00nan;0;0
7896;192645;121;85;43;2;41;.953;3900000;0
7897;187550;111;65;30;3;27;.900;3600000;0
7897;199481;122;0;0;0;0;.00nan;0;0
7897;191692;122;47;28;4;24;.857;3585000;0
7897;197912;111;0;0;0;0;.00nan;0;0
7898;192776;119;0;0;0;0;.00nan;0;0
7898;188918;112;64;27;2;25;.926;3600000;0
7898;195017;119;66;42;4;38;.905;3515000;0
7898;202246;112;0;0;0;0;.00nan;0;0
7899;198141;110;0;0;0;0;.00nan;0;0
7899;189008;108;0;0;0;0;.00nan;0;0
7899;196324;110;100;28;0;28;1.000;3600000;0
7899;196372;108;55;30;4;26;.867;3600000;0
7900;195111;125;97;44;2;42;.955;3600000;0
7900;191125;123;13;20;6;14;.700;3600000;0
7900;-1;123;0;0;0;0;.00nan;0;0
7900;191813;125;0;0;0;0;.00nan;0;0
7901;187537;117;100;41;2;39;.951;3600000;0
7901;187699;114;20;9;4;5;.556;1073000;0
7901;189783;117;0;0;0;0;.00nan;0;0
7901;202180;114;61;11;0;11;1.000;2466000;0
7902;195001;126;0;0;0;0;.00nan;0;0
7902;201631;109;62;13;1;12;.923;1067000;0
7902;197038;109;34;34;6;28;.824;2776000;0
7902;192564;126;21;33;8;25;.758;3843000;0
7903;195089;124;53;39;5;34;.872;3600000;0
7903;-1;113;0;0;0;0;.00nan;0;0
7903;191687;124;0;0;0;0;.00nan;0;0
7903;191709;113;75;14;0;14;1.000;3600000;0
7904;192776;119;39;28;5;23;.821;3600000;0
7904;187550;111;0;0;0;0;.00nan;0;0
7904;195017;119;0;0;0;0;.00nan;0;0
7904;197912;111;84;36;1;35;.972;3600000;0
7905;188911;115;0;0;0;0;.00nan;0;0
7905;207493;121;80;40;3;37;.925;3600000;0
7905;191698;115;46;29;4;25;.862;3543000;0
7905;192645;121;0;0;0;0;.00nan;0;0
7906;196414;118;0;0;0;0;.00nan;0;0
7906;191026;118;55;46;6;40;.870;3600000;0
7906;191125;123;0;0;0;0;.00nan;0;0
7906;-1;123;88;22;0;22;1.000;3600000;0
7907;198141;110;0;0;0;0;.00nan;0;0
7907;199481;122;54;35;4;31;.886;3600000;0
7907;196324;110;100;26;0;26;1.000;3600000;0
7907;191692;122;0;0;0;0;.00nan;0;0
7908;193687;120;48;25;4;21;.840;3759000;0
7908;189734;120;0;0;0;0;.00nan;0;0
7908;202314;127;0;0;0;0;.00nan;0;0
7908;191171;127;49;35;5;30;.857;3759000;0
7909;195001;126;44;19;3;16;.842;3600000;0
7909;195089;124;43;41;6;35;.854;3600000;0
7909;191687;124;0;0;0;0;.00nan;0;0
7909;192564;126;0;0;0;0;.00nan;0;0
7910;187699;114;75;24;2;22;.917;3600000;0
7910;202180;114;0;0;0;0;.00nan;0;0
7910;207493;121;0;0;0;0;.00nan;0;0
7910;192645;121;60;36;4;32;.889;3600000;0
7911;199481;122;0;0;0;0;.00nan;0;0
7911;-1;113;0;0;0;0;.00nan;0;0
7911;191692;122;62;49;6;43;.878;3600000;0
7911;191709;113;65;29;2;27;.931;3600000;0
7912;195111;125;87;35;2;33;.943;3600000;0
7912;201631;109;0;0;0;0;.00nan;0;0
7912;197038;109;76;38;3;35;.921;3589000;0
7912;191813;125;0;0;0;0;.00nan;0;0
7913;188918;112;0;0;0;0;.00nan;0;0
7913;202246;112;60;20;2;18;.900;3600000;0
7913;-1;113;38;29;5;24;.828;3600000;0
7913;191709;113;0;0;0;0;.00nan;0;0
7914;187550;111;0;0;0;0;.00nan;0;0
7914;198141;110;0;0;0;0;.00nan;0;0
7914;196324;110;72;24;1;23;.958;3600000;0
7914;197912;111;45;38;5;33;.868;3600000;0
7915;187699;114;73;25;1;24;.960;3600000;0
7915;188888;116;23;11;4;7;.636;815000;0
7915;200514;116;55;18;2;16;.889;2785000;0
7915;202180;114;0;0;0;0;.00nan;0;0
7916;188911;115;69;28;2;26;.929;3600000;0
7916;189008;108;0;0;0;0;.00nan;0;0
7916;196372;108;58;51;6;45;.882;3600000;0
7916;191698;115;0;0;0;0;.00nan;0;0
7917;193687;120;43;18;3;15;.833;3600000;0
7917;189734;120;0;0;0;0;.00nan;0;0
7917;207493;121;27;28;6;22;.786;2574000;0
7917;192645;121;25;13;4;9;.692;1026000;0
7918;201631;109;55;30;4;26;.867;3544000;0
7918;196414;118;0;0;0;0;.00nan;0;0
7918;191026;118;81;39;2;37;.949;3600000;0
7918;197038;109;0;0;0;0;.00nan;0;0
7919;187537;117;53;29;4;25;.862;3743000;0
7919;199481;122;0;0;0;0;.00nan;0;0
7919;189783;117;0;0;0;0;.00nan;0;0
7919;191692;122;74;37;3;34;.919;3743000;0
7920;195111;125;0;0;0;0;.00nan;0;0
7920;202314;127;0;0;0;0;.00nan;0;0
7920;191171;127;76;21;1;20;.952;3600000;0
7920;191813;125;37;21;4;17;.810;3600000;0
7921;195001;126;0;0;0;0;.00nan;0;0
7921;191125;123;0;0;0;0;.00nan;0;0
7921;-1;123;80;26;2;24;.923;3600000;0
7921;192564;126;66;31;3;28;.903;3578000;0
7922;187550;111;89;40;2;38;.950;3600000;0
7922;188888;116;51;18;3;15;.833;3578000;0
7922;200514;116;0;0;0;0;.00nan;0;0
7922;197912;111;0;0;0;0;.00nan;0;0
7923;192776;119;0;0;0;0;.00nan;0;0
7923;193687;120;75;26;2;24;.923;3600000;0
7923;195017;119;65;25;3;22;.880;3600000;0
7923;189734;120;0;0;0;0;.00nan;0;0
7924;195001;126;79;25;2;23;.920;3600000;0
7924;195089;124;0;0;0;0;.00nan;0;0
7924;191687;124;29;38;7;31;.816;3600000;0
7924;192564;126;0;0;0;0;.00nan;0;0
7925;189008;108;85;43;2;41;.953;3600000;0
7925;196372;108;0;0;0;0;.00nan;0;0
7925;207493;121;0;0;0;0;.00nan;0;0
7925;192645;121;47;32;4;28;.875;3525000;0
7926;188911;115;56;8;1;7;.875;1545000;0
7926;195111;125;78;50;5;45;.900;3600000;0
7926;191698;115;31;21;5;16;.762;2047000;0
7926;191813;125;0;0;0;0;.00nan;0;0
7927;202314;127;59;42;5;37;.881;3519000;0
7927;191125;123;48;21;3;18;.857;3600000;0
7927;191171;127;0;0;0;0;.00nan;0;0
7927;-1;123;0;0;0;0;.00nan;0;0
7928;187699;114;0;0;0;0;.00nan;0;0
7928;188918;112;0;0;0;0;.00nan;0;0
7928;202180;114;45;36;5;31;.861;3900000;0
7928;202246;112;53;40;5;35;.875;3900000;0
7929;187537;117;59;36;4;32;.889;3600000;0
7929;189783;117;0;0;0;0;.00nan;0;0
7929;-1;113;57;5;0;5;1.000;593000;0
7929;191709;113;35;30;6;24;.800;2973000;0
7930;199481;122;63;39;5;34;.872;3600000;0
7930;201631;109;0;0;0;0;.00nan;0;0
7930;197038;109;41;34;6;28;.824;3543000;0
7930;191692;122;0;0;0;0;.00nan;0;0
7931;188911;115;0;0;0;0;.00nan;0;0
7931;202314;127;0;0;0;0;.00nan;0;0
7931;191171;127;27;35;7;28;.800;3600000;0
7931;191698;115;64;27;3;24;.889;3600000;0
7932;195089;124;48;26;4;22;.846;3600000;0
7932;191125;123;0;0;0;0;.00nan;0;0
7932;-1;123;65;28;3;25;.893;3600000;0
7932;191687;124;0;0;0;0;.00nan;0;0
7933;192776;119;13;26;7;19;.731;2852000;0
7933;198141;110;67;31;3;28;.903;3600000;0
7933;195017;119;40;3;1;2;.667;748000;0
7933;196324;110;0;0;0;0;.00nan;0;0
7934;199481;122;71;14;0;14;1.000;1371000;0
7934;188918;112;0;0;0;0;.00nan;0;0
7934;202246;112;71;28;3;25;.893;3600000;0
7934;191692;122;39;31;5;26;.839;2203000;0
7935;192776;119;55;25;3;22;.880;3600000;0
7935;195017;119;0;0;0;0;.00nan;0;0
7935;195089;124;31;38;7;31;.816;3207000;0
7935;191687;124;48;0;0;0;.00nan;393000;0
7936;187537;117;72;48;6;42;.875;3572000;0
7936;189783;117;0;0;0;0;.00nan;0;0
7936;-1;113;27;16;4;12;.750;3600000;0
7936;191709;113;0;0;0;0;.00nan;0;0
7937;198141;110;0;0;0;0;.00nan;0;0
7937;189008;108;0;0;0;0;.00nan;0;0
7937;196324;110;60;22;3;19;.864;3563000;0
7937;196372;108;68;30;2;28;.933;3600000;0
7938;193687;120;79;29;1;28;.966;3550000;0
7938;195111;125;100;53;0;53;1.000;3600000;0
7938;189734;120;0;0;0;0;.00nan;0;0
7938;191813;125;0;0;0;0;.00nan;0;0
7939;207493;121;0;0;0;0;.00nan;0;0
7939;191125;123;61;39;5;34;.872;3894000;0
7939;-1;123;0;0;0;0;.00nan;0;0
7939;192645;121;63;38;5;33;.868;3900000;0
7940;187550;111;88;41;2;39;.951;3600000;0
7940;187699;114;53;33;4;29;.879;3554000;0
7940;202180;114;0;0;0;0;.00nan;0;0
7940;197912;111;0;0;0;0;.00nan;0;0
7941;199481;122;43;9;2;7;.778;1010000;0
7941;201631;109;45;25;4;21;.840;3600000;0
7941;197038;109;0;0;0;0;.00nan;0;0
7941;191692;122;33;28;6;22;.786;2590000;0
7942;195089;124;63;32;4;28;.875;3600000;0
7942;207493;121;48;34;5;29;.853;3574000;0
7942;191687;124;0;0;0;0;.00nan;0;0
7942;192645;121;0;0;0;0;.00nan;0;0
7943;193687;120;0;0;0;0;.00nan;0;0
7943;189734;120;82;41;3;38;.927;3600000;0
7943;-1;113;53;29;4;25;.862;2578000;0
7943;191709;113;14;5;4;1;.200;1022000;0
7944;188918;112;0;0;0;0;.00nan;0;0
7944;196414;118;64;49;6;43;.878;3293000;0
7944;202246;112;88;27;1;26;.963;3600000;0
7944;191026;118;52;4;0;4;1.000;307000;0
7945;187537;117;81;37;3;34;.919;3198000;0
7945;188911;115;71;16;1;15;.938;3600000;0
7945;189783;117;29;12;4;8;.667;402000;0
7945;191698;115;0;0;0;0;.00nan;0;0
7946;192776;119;43;35;6;29;.829;3900000;0
7946;195017;119;0;0;0;0;.00nan;0;0
7946;202314;127;66;11;0;11;1.000;1923000;0
7946;191171;127;21;19;6;13;.684;1977000;0
7947;188888;116;45;28;4;24;.857;3900000;0
7947;200514;116;0;0;0;0;.00nan;0;0
7947;191125;123;0;0;0;0;.00nan;0;0
7947;-1;123;43;20;4;16;.800;3900000;0
7948;198141;110;52;36;5;31;.861;3600000;0
7948;189008;108;0;0;0;0;.00nan;0;0
7948;196324;110;0;0;0;0;.00nan;0;0
7948;196372;108;49;50;7;43;.860;3549000;0
7949;187550;111;0;0;0;0;.00nan;0;0
7949;199481;122;97;42;2;40;.952;3600000;0
7949;191692;122;0;0;0;0;.00nan;0;0
7949;197912;111;58;22;3;19;.864;3547000;0
7950;188911;115;0;0;0;0;.00nan;0;0
7950;-1;113;0;0;0;0;.00nan;0;0
7950;191698;115;56;30;4;26;.867;3600000;0
7950;191709;113;59;44;5;39;.886;3591000;0
7951;188888;116;94;31;1;30;.968;3600000;0
7951;200514;116;0;0;0;0;.00nan;0;0
7951;195089;124;0;0;0;0;.00nan;0;0
7951;191687;124;72;44;4;40;.909;3600000;0
7952;192776;119;0;0;0;0;.00nan;0;0
7952;195017;119;73;24;2;22;.917;3600000;0
7952;196414;118;0;0;0;0;.00nan;0;0
7952;191026;118;65;33;3;30;.909;3557000;0
7953;195001;126;0;0;0;0;.00nan;0;0
7953;195111;125;51;36;5;31;.861;3600000;0
7953;191813;125;0;0;0;0;.00nan;0;0
7953;192564;126;90;39;2;37;.949;3600000;0
7954;187699;114;32;28;5;23;.821;3545000;0
7954;201631;109;0;0;0;0;.00nan;0;0
7954;202180;114;0;0;0;0;.00nan;0;0
7954;197038;109;65;34;4;30;.882;3600000;0
7955;207493;121;0;0;0;0;.00nan;0;0
7955;202314;127;0;0;0;0;.00nan;0;0
7955;191171;127;99;36;2;34;.944;3600000;0
7955;192645;121;66;34;4;30;.882;3583000;0
7956;195001;126;57;21;3;18;.857;3600000;0
7956;195111;125;42;4;1;3;.750;455000;0
7956;191813;125;34;34;6;28;.824;3145000;0
7956;192564;126;0;0;0;0;.00nan;0;0
7957;193687;120;79;27;1;26;.963;3600000;0
7957;189734;120;0;0;0;0;.00nan;0;0
7957;196414;118;52;38;6;32;.842;3600000;0
7957;191026;118;0;0;0;0;.00nan;0;0
7958;198141;110;0;0;0;0;.00nan;0;0
7958;188918;112;0;0;0;0;.00nan;0;0
7958;196324;110;61;38;4;34;.895;3743000;0
7958;202246;112;85;39;3;36;.923;3775000;0
7959;202314;127;90;33;1;32;.970;3600000;0
7959;191125;123;51;30;4;26;.867;3600000;0
7959;191171;127;0;0;0;0;.00nan;0;0
7959;-1;123;0;0;0;0;.00nan;0;0
7960;192776;119;75;44;5;39;.886;3900000;0
7960;193687;120;57;37;5;32;.865;3900000;0
7960;195017;119;0;0;0;0;.00nan;0;0
7960;189734;120;0;0;0;0;.00nan;0;0
7961;195089;124;91;37;2;35;.946;3600000;0
7961;191125;123;0;0;0;0;.00nan;0;0
7961;-1;123;31;30;6;24;.800;3600000;0
7961;191687;124;0;0;0;0;.00nan;0;0
7962;187550;111;81;44;4;40;.909;3585000;0
7962;187699;114;74;28;2;26;.929;3600000;0
7962;202180;114;0;0;0;0;.00nan;0;0
7962;197912;111;0;0;0;0;.00nan;0;0
7963;195001;126;0;0;0;0;.00nan;0;0
7963;-1;113;41;22;4;18;.818;3600000;0
7963;191709;113;0;0;0;0;.00nan;0;0
7963;192564;126;68;49;6;43;.878;3574000;0
7964;187537;117;70;33;3;30;.909;3600000;0
7964;188911;115;0;0;0;0;.00nan;0;0
7964;189783;117;0;0;0;0;.00nan;0;0
7964;191698;115;43;34;6;28;.824;3600000;0
7965;189008;108;0;0;0;0;.00nan;0;0
7965;196372;108;66;31;3;28;.903;3600000;0
7965;202314;127;0;0;0;0;.00nan;0;0
7965;191171;127;47;40;6;34;.850;3600000;0
7966;195111;125;48;26;3;23;.885;3600000;0
7966;196414;118;57;34;5;29;.853;3599000;0
7966;191026;118;0;0;0;0;.00nan;0;0
7966;191813;125;0;0;0;0;.00nan;0;0
7967;188911;115;69;24;2;22;.917;3600000;0
7967;188918;112;0;0;0;0;.00nan;0;0
7967;202246;112;38;31;6;25;.806;3600000;0
7967;191698;115;0;0;0;0;.00nan;0;0
7968;187550;111;0;0;0;0;.00nan;0;0
7968;202314;127;59;24;3;21;.875;3600000;0
7968;191171;127;0;0;0;0;.00nan;0;0
7968;197912;111;63;43;4;39;.907;3600000;0
7969;198141;110;0;0;0;0;.00nan;0;0
7969;201631;109;54;37;4;33;.892;3600000;0
7969;196324;110;64;16;1;15;.938;3600000;0
7969;197038;109;0;0;0;0;.00nan;0;0
7970;187699;114;0;0;0;0;.00nan;0;0
7970;188888;116;50;24;4;20;.833;3600000;0
7970;200514;116;0;0;0;0;.00nan;0;0
7970;202180;114;54;39;5;34;.872;3569000;0
7971;187537;117;0;0;0;0;.00nan;0;0
7971;189783;117;60;34;5;29;.853;3900000;0
7971;207493;121;0;0;0;0;.00nan;0;0
7971;192645;121;64;46;5;41;.891;3900000;0
7972;193687;120;0;0;0;0;.00nan;0;0
7972;189008;108;0;0;0;0;.00nan;0;0
7972;189734;120;34;26;5;21;.808;3566000;0
7972;196372;108;60;33;4;29;.879;3600000;0
7973;192776;119;0;0;0;0;.00nan;0;0
7973;195017;119;36;22;5;17;.773;3554000;0
7973;196414;118;0;0;0;0;.00nan;0;0
7973;191026;118;73;34;3;31;.912;3600000;0
7974;199481;122;0;0;0;0;.00nan;0;0
7974;195089;124;85;44;4;40;.909;3600000;0
7974;191687;124;0;0;0;0;.00nan;0;0
7974;191692;122;21;29;7;22;.759;3600000;0
7975;187537;117;78;32;2;30;.938;3600000;0
7975;188918;112;0;0;0;0;.00nan;0;0
7975;189783;117;0;0;0;0;.00nan;0;0
7975;202246;112;57;28;3;25;.893;3544000;0
7976;188911;115;0;0;0;0;.00nan;0;0
7976;195001;126;69;26;2;24;.923;3900000;0
7976;191698;115;69;32;2;30;.938;3900000;0
7976;192564;126;0;0;0;0;.00nan;0;0
7977;195089;124;0;0;0;0;.00nan;0;0
7977;207493;121;75;48;5;43;.896;3900000;0
7977;191687;124;50;37;5;32;.865;3900000;0
7977;192645;121;0;0;0;0;.00nan;0;0
7978;192776;119;4;22;8;14;.636;3083000;0
7978;188888;116;50;21;3;18;.857;3600000;0
7978;200514;116;0;0;0;0;.00nan;0;0
7978;195017;119;43;5;1;4;.800;517000;0
7979;199481;122;39;29;5;24;.828;3523000;0
7979;196414;118;86;35;3;32;.914;3600000;0
7979;191026;118;0;0;0;0;.00nan;0;0
7979;191692;122;0;0;0;0;.00nan;0;0
7980;198141;110;62;24;2;22;.917;3600000;0
7980;201631;109;0;0;0;0;.00nan;0;0
7980;196324;110;0;0;0;0;.00nan;0;0
7980;197038;109;50;50;7;43;.860;3600000;0
7981;195111;125;69;43;4;39;.907;3900000;0
7981;191125;123;71;35;4;31;.886;3900000;0
7981;-1;123;0;0;0;0;.00nan;0;0
7981;191813;125;0;0;0;0;.00nan;0;0
7982;187699;114;82;33;2;31;.939;3600000;0
7982;202180;114;0;0;0;0;.00nan;0;0
7982;-1;113;44;20;3;17;.850;3574000;0
7982;191709;113;0;0;0;0;.00nan;0;0
7983;201631;109;51;30;4;26;.867;3600000;0
7983;202314;127;22;28;7;21;.750;2608000;0
7983;191171;127;24;13;4;9;.692;992000;0
7983;197038;109;0;0;0;0;.00nan;0;0
7984;193687;120;67;38;4;34;.895;3518000;0
7984;195001;126;0;0;0;0;.00nan;0;0
7984;189734;120;0;0;0;0;.00nan;0;0
7984;192564;126;78;38;2;36;.947;3600000;0
7985;188918;112;55;6;0;6;1.000;389000;0
7985;189008;108;0;0;0;0;.00nan;0;0
7985;196372;108;80;37;3;34;.919;3600000;0
7985;202246;112;29;26;6;20;.769;3211000;0
7986;195111;125;0;0;0;0;.00nan;0;0
7986;191125;123;0;0;0;0;.00nan;0;0
7986;-1;123;80;32;1;31;.969;3600000;0
7986;191813;125;54;40;5;35;.875;3600000;0
7987;187550;111;75;48;5;43;.896;3600000;0
7987;198141;110;0;0;0;0;.00nan;0;0
7987;196324;110;77;35;2;33;.943;3600000;0
7987;197912;111;0;0;0;0;.00nan;0;0
7988;187550;111;45;17;3;14;.824;3600000;0
7988;201631;109;9;20;7;13;.650;1724000;0
7988;197038;109;40;24;4;20;.833;1876000;0
7988;197912;111;0;0;0;0;.00nan;0;0
7989;199481;122;0;0;0;0;.00nan;0;0
7989;196414;118;86;38;2;36;.947;3600000;0
7989;191026;118;0;0;0;0;.00nan;0;0
7989;191692;122;52;37;5;32;.865;3600000;0
7990;188918;112;0;0;0;0;.00nan;0;0
7990;202246;112;88;32;1;31;.969;3600000;0
7990;202314;127;0;0;0;0;.00nan;0;0
7990;191171;127;21;27;6;21;.778;3600000;0
7991;187537;117;91;36;2;34;.944;3736000;0
7991;195001;126;90;34;1;33;.971;3736000;0
7991;189783;117;0;0;0;0;.00nan;0;0
7991;192564;126;0;0;0;0;.00nan;0;0
7992;189008;108;0;0;0;0;.00nan;0;0
7992;196372;108;82;25;1;24;.960;3600000;0
7992;-1;113;56;24;4;20;.833;2052000;0
7992;191709;113;44;12;2;10;.833;1548000;0
7993;187699;114;82;32;3;29;.906;3600000;0
7993;188911;115;100;38;0;38;1.000;3600000;0
7993;202180;114;0;0;0;0;.00nan;0;0
7993;191698;115;0;0;0;0;.00nan;0;0
7994;192776;119;56;29;3;26;.897;3600000;0
7994;195017;119;0;0;0;0;.00nan;0;0
7994;195111;125;65;26;2;24;.923;3600000;0
7994;191813;125;0;0;0;0;.00nan;0;0
7995;187550;111;0;0;0;0;.00nan;0;0
7995;188888;116;37;23;5;18;.783;3644000;0
7995;200514;116;0;0;0;0;.00nan;0;0
7995;197912;111;65;35;4;31;.886;3644000;0
7996;188918;112;0;0;0;0;.00nan;0;0
7996;201631;109;0;0;0;0;.00nan;0;0
7996;202246;112;87;31;2;29;.935;3600000;0
7996;197038;109;40;30;5;25;.833;3600000;0
7997;207493;121;0;0;0;0;.00nan;0;0
7997;191125;123;45;27;4;23;.852;3900000;0
7997;-1;123;0;0;0;0;.00nan;0;0
7997;192645;121;64;37;4;33;.892;3900000;0
7998;193687;120;47;12;2;10;.833;3600000;0
7998;195111;125;0;0;0;0;.00nan;0;0
7998;189734;120;0;0;0;0;.00nan;0;0
7998;191813;125;67;42;4;38;.905;3600000;0
7999;195089;124;51;27;3;24;.889;3848000;0
7999;196414;118;0;0;0;0;.00nan;0;0
7999;191026;118;72;33;3;30;.909;3900000;0
7999;191687;124;0;0;0;0;.00nan;0;0
8000;187537;117;78;22;1;21;.955;3600000;0
8000;189008;108;14;23;6;17;.739;2391000;0
8000;189783;117;0;0;0;0;.00nan;0;0
8000;196372;108;43;5;1;4;.800;1209000;0
8001;192776;119;0;0;0;0;.00nan;0;0
8001;195017;119;100;46;2;44;.957;3600000;0
8001;202314;127;0;0;0;0;.00nan;0;0
8001;191171;127;56;30;4;26;.867;3523000;0
8002;195001;126;89;18;0;18;1.000;3600000;0
8002;-1;113;0;0;0;0;.00nan;0;0
8002;191709;113;30;39;7;32;.821;3600000;0
8002;192564;126;0;0;0;0;.00nan;0;0
8003;199481;122;0;0;0;0;.00nan;0;0
8003;188911;115;100;27;0;27;1.000;3600000;0
8003;191692;122;91;33;1;32;.970;3600000;0
8003;191698;115;0;0;0;0;.00nan;0;0
8004;188888;116;3;20;8;12;.600;2910000;0
8004;200514;116;64;7;0;7;1.000;673000;0
8004;201631;109;52;34;4;30;.882;2255000;0
8004;197038;109;57;23;3;20;.870;1345000;0
8005;187550;111;63;32;4;28;.875;3600000;0
8005;188918;112;0;0;0;0;.00nan;0;0
8005;202246;112;58;38;5;33;.868;3600000;0
8005;197912;111;0;0;0;0;.00nan;0;0
8006;188911;115;49;30;5;25;.833;3600000;0
8006;191125;123;0;0;0;0;.00nan;0;0
8006;-1;123;70;24;2;22;.917;3600000;0
8006;191698;115;0;0;0;0;.00nan;0;0
8007;192776;119;57;23;3;20;.870;3600000;0
8007;195017;119;0;0;0;0;.00nan;0;0
8007;195089;124;49;2;0;2;1.000;558000;0
8007;191687;124;22;34;7;27;.794;3042000;0
8008;196414;118;55;35;5;30;.857;3900000;0
8008;207493;121;36;28;5;23;.821;3900000;0
8008;191026;118;0;0;0;0;.00nan;0;0
8008;192645;121;0;0;0;0;.00nan;0;0
8009;193687;120;0;0;0;0;.00nan;0;0
8009;195111;125;71;34;3;31;.912;3600000;0
8009;189734;120;40;27;4;23;.852;3563000;0
8009;191813;125;0;0;0;0;.00nan;0;0
8010;187699;114;47;24;4;20;.833;2373000;0
8010;199481;122;40;35;6;29;.829;3554000;0
8010;202180;114;52;3;0;3;1.000;1227000;0
8010;191692;122;0;0;0;0;.00nan;0;0
8011;187537;117;98;39;1;38;.974;3600000;0
8011;189783;117;0;0;0;0;.00nan;0;0
8011;-1;113;0;0;0;0;.00nan;0;0
8011;191709;113;50;36;5;31;.861;3600000;0
8012;198141;110;0;0;0;0;.00nan;0;0
8012;189008;108;0;0;0;0;.00nan;0;0
8012;196324;110;55;33;4;29;.879;3600000;0
8012;196372;108;35;39;6;33;.846;3523000;0
8013;195089;124;91;40;1;39;.975;3600000;0
8013;202314;127;30;13;4;9;.692;1917000;0
8013;191171;127;49;10;1;9;.900;1683000;0
8013;191687;124;0;0;0;0;.00nan;0;0
8014;193687;120;21;25;6;19;.760;2372000;0
8014;189734;120;52;9;1;8;.889;1228000;0
8014;207493;121;0;0;0;0;.00nan;0;0
8014;192645;121;58;31;4;27;.871;3600000;0
8015;195089;124;60;29;3;26;.897;3600000;0
8015;191125;123;24;25;6;19;.760;3600000;0
8015;-1;123;0;0;0;0;.00nan;0;0
8015;191687;124;0;0;0;0;.00nan;0;0
8016;192776;119;72;29;3;26;.897;3600000;0
8016;187699;114;66;44;5;39;.886;3561000;0
8016;195017;119;0;0;0;0;.00nan;0;0
8016;202180;114;0;0;0;0;.00nan;0;0
8017;196414;118;0;0;0;0;.00nan;0;0
8017;-1;113;62;22;2;20;.909;3600000;0
8017;191026;118;89;51;3;48;.941;3545000;0
8017;191709;113;0;0;0;0;.00nan;0;0
8018;188911;115;61;28;3;25;.893;3546000;0
8018;188918;112;0;0;0;0;.00nan;0;0
8018;202246;112;99;47;2;45;.957;3600000;0
8018;191698;115;0;0;0;0;.00nan;0;0
8019;195001;126;44;31;5;26;.839;3600000;0
8019;207493;121;31;24;5;19;.792;2038000;0
8019;192564;126;0;0;0;0;.00nan;0;0
8019;192645;121;56;9;1;8;.889;1507000;0
8020;189008;108;0;0;0;0;.00nan;0;0
8020;195111;125;47;40;6;34;.850;3600000;0
8020;196372;108;75;27;2;25;.926;3600000;0
8020;191813;125;0;0;0;0;.00nan;0;0
8021;188918;112;52;21;3;18;.857;3554000;0
8021;195001;126;0;0;0;0;.00nan;0;0
8021;202246;112;0;0;0;0;.00nan;0;0
8021;192564;126;84;35;2;33;.943;3600000;0
8022;187550;111;0;0;0;0;.00nan;0;0
8022;195111;125;69;37;4;33;.892;3852000;0
8022;191813;125;0;0;0;0;.00nan;0;0
8022;197912;111;69;31;3;28;.903;3852000;0
8023;188888;116;69;29;4;25;.862;3600000;0
8023;189008;108;0;0;0;0;.00nan;0;0
8023;200514;116;0;0;0;0;.00nan;0;0
8023;196372;108;33;23;5;18;.783;3570000;0
8024;192776;119;48;6;1;5;.833;671000;0
8024;193687;120;70;35;3;32;.914;3600000;0
8024;195017;119;16;29;7;22;.759;2929000;0
8024;189734;120;0;0;0;0;.00nan;0;0
8025;187537;117;37;20;4;16;.800;3600000;0
8025;189783;117;0;0;0;0;.00nan;0;0
8025;196414;118;46;44;7;37;.841;3600000;0
8025;191026;118;0;0;0;0;.00nan;0;0
8026;199481;122;0;0;0;0;.00nan;0;0
8026;-1;113;0;0;0;0;.00nan;0;0
8026;191692;122;48;26;4;22;.846;3600000;0
8026;191709;113;86;25;1;24;.960;3600000;0
8027;198141;110;0;0;0;0;.00nan;0;0
8027;201631;109;62;9;0;9;1.000;411000;0
8027;196324;110;60;21;2;19;.905;3600000;0
8027;197038;109;21;27;6;21;.778;3189000;0
8028;198141;110;83;29;1;28;.966;3600000;0
8028;201631;109;42;3;1;2;.667;256000;0
8028;196324;110;0;0;0;0;.00nan;0;0
8028;197038;109;48;45;7;38;.844;3344000;0
8029;193687;120;0;0;0;0;.00nan;0;0
8029;199481;122;44;29;4;25;.862;3600000;0
8029;189734;120;87;32;1;31;.969;3600000;0
8029;191692;122;0;0;0;0;.00nan;0;0
8030;188911;115;46;19;3;16;.842;3541000;0
8030;195089;124;76;35;2;33;.943;3600000;0
8030;191687;124;0;0;0;0;.00nan;0;0
8030;191698;115;0;0;0;0;.00nan;0;0
8031;188888;116;93;37;2;35;.946;3900000;0
8031;200514;116;0;0;0;0;.00nan;0;0
8031;207493;121;0;0;0;0;.00nan;0;0
8031;192645;121;94;37;2;35;.946;3900000;0
8032;192776;119;71;32;3;29;.906;3600000;0
8032;195017;119;0;0;0;0;.00nan;0;0
8032;-1;113;100;33;0;33;1.000;3600000;0
8032;191709;113;0;0;0;0;.00nan;0;0
8033;202314;127;0;0;0;0;.00nan;0;0
8033;191125;123;45;21;3;18;.857;3596000;0
8033;191171;127;85;34;2;32;.941;3600000;0
8033;-1;123;0;0;0;0;.00nan;0;0
8034;187699;114;68;23;2;21;.913;3600000;0
8034;196414;118;0;0;0;0;.00nan;0;0
8034;202180;114;0;0;0;0;.00nan;0;0
8034;191026;118;80;39;3;36;.923;3559000;0
8035;187550;111;74;28;2;26;.929;3544000;0
8035;188918;112;0;0;0;0;.00nan;0;0
8035;202246;112;79;24;1;23;.958;3600000;0
8035;197912;111;0;0;0;0;.00nan;0;0
8036;195111;125;16;26;7;19;.731;2762000;0
8036;201631;109;67;46;6;40;.870;3600000;0
8036;197038;109;0;0;0;0;.00nan;0;0
8036;191813;125;50;1;0;1;1.000;786000;0
8037;199481;122;0;0;0;0;.00nan;0;0
8037;202314;127;75;29;2;27;.931;3600000;0
8037;191171;127;0;0;0;0;.00nan;0;0
8037;191692;122;45;32;5;27;.844;3600000;0
8038;188888;116;0;0;0;0;.00nan;0;0
8038;200514;116;100;27;0;27;1.000;3600000;0
8038;195001;126;0;0;0;0;.00nan;0;0
8038;192564;126;44;23;4;19;.826;3600000;0
8039;193687;120;59;24;2;22;.917;3600000;0
8039;195089;124;0;0;0;0;.00nan;0;0
8039;189734;120;0;0;0;0;.00nan;0;0
8039;191687;124;62;40;5;35;.875;3600000;0
8040;188911;115;0;0;0;0;.00nan;0;0
8040;191125;123;0;0;0;0;.00nan;0;0
8040;-1;123;71;35;4;31;.886;3900000;0
8040;191698;115;73;42;4;38;.905;3900000;0
8041;187537;117;30;28;6;22;.786;2408000;0
8041;198141;110;0;0;0;0;.00nan;0;0
8041;189783;117;49;14;2;12;.857;1192000;0
8041;196324;110;88;16;0;16;1.000;3600000;0
8042;187537;117;59;26;3;23;.885;3900000;0
8042;189008;108;0;0;0;0;.00nan;0;0
8042;189783;117;0;0;0;0;.00nan;0;0
8042;196372;108;73;38;3;35;.921;3900000;0
8043;187550;111;0;0;0;0;.00nan;0;0
8043;201631;109;0;0;0;0;.00nan;0;0
8043;197038;109;99;37;1;36;.973;3600000;0
8043;197912;111;50;36;5;31;.861;3600000;0
8044;199481;122;0;0;0;0;.00nan;0;0
8044;188888;116;0;0;0;0;.00nan;0;0
8044;200514;116;72;35;3;32;.914;3900000;0
8044;191692;122;75;33;3;30;.909;3900000;0
8045;188911;115;57;26;4;22;.846;3546000;0
8045;188918;112;0;0;0;0;.00nan;0;0
8045;202246;112;64;25;3;22;.880;3600000;0
8045;191698;115;0;0;0;0;.00nan;0;0
8046;193687;120;56;39;5;34;.872;3764000;0
8046;189734;120;0;0;0;0;.00nan;0;0
8046;207493;121;48;34;4;30;.882;3764000;0
8046;192645;121;0;0;0;0;.00nan;0;0
8047;195001;126;72;22;1;21;.955;3600000;0
8047;191125;123;71;34;3;31;.912;3519000;0
8047;-1;123;0;0;0;0;.00nan;0;0
8047;192564;126;0;0;0;0;.00nan;0;0
8048;187699;114;81;34;2;32;.941;3581000;0
8048;195111;125;79;27;1;26;.963;3600000;0
8048;202180;114;0;0;0;0;.00nan;0;0
8048;191813;125;0;0;0;0;.00nan;0;0
8049;189008;108;0;0;0;0;.00nan;0;0
8049;195089;124;32;37;7;30;.811;2613000;0
8049;196372;108;58;20;2;18;.900;3600000;0
8049;191687;124;52;10;1;9;.900;987000;0
8050;187550;111;0;0;0;0;.00nan;0;0
8050;-1;113;0;0;0;0;.00nan;0;0
8050;191709;113;78;19;1;18;.947;3600000;0
8050;197912;111;69;48;5;43;.896;3600000;0
8051;193687;120;0;0;0;0;.00nan;0;0
8051;188911;115;35;28;6;22;.786;2946000;0
8051;189734;120;99;37;1;36;.973;3600000;0
8051;191698;115;53;8;1;7;.875;654000;0
8052;188888;116;43;27;4;23;.852;3543000;0
8052;200514;116;0;0;0;0;.00nan;0;0
8052;196414;118;0;0;0;0;.00nan;0;0
8052;191026;118;64;25;3;22;.880;3600000;0
8053;187537;117;82;43;4;39;.907;3900000;0
8053;187699;114;0;0;0;0;.00nan;0;0
8053;189783;117;0;0;0;0;.00nan;0;0
8053;202180;114;44;24;4;20;.833;3900000;0
8054;188918;112;0;0;0;0;.00nan;0;0
8054;202246;112;42;21;4;17;.810;3600000;0
8054;202314;127;50;11;1;10;.909;1628000;0
8054;191171;127;43;26;4;22;.846;1934000;0
8055;195001;126;41;14;3;11;.786;2567000;0
8055;191125;123;0;0;0;0;.00nan;0;0
8055;-1;123;58;34;4;30;.882;3600000;0
8055;192564;126;36;11;3;8;.727;1010000;0
8056;199481;122;0;0;0;0;.00nan;0;0
8056;195111;125;63;30;3;27;.900;3600000;0
8056;191692;122;65;33;4;29;.879;3552000;0
8056;191813;125;0;0;0;0;.00nan;0;0
8057;195089;124;90;40;1;39;.975;3900000;0
8057;201631;109;95;36;1;35;.972;3900000;0
8057;197038;109;0;0;0;0;.00nan;0;0
8057;191687;124;0;0;0;0;.00nan;0;0
8058;198141;110;0;0;0;0;.00nan;0;0
8058;188918;112;100;28;0;28;1.000;3600000;0
8058;196324;110;68;32;3;29;.906;3600000;0
8058;202246;112;0;0;0;0;.00nan;0;0
8059;192776;119;67;25;2;23;.920;3600000;0
8059;195017;119;0;0;0;0;.00nan;0;0
8059;207493;121;57;11;1;10;.909;1062000;0
8059;192645;121;5;22;7;15;.682;2538000;0
8060;189008;108;0;0;0;0;.00nan;0;0
8060;196372;108;28;30;6;24;.800;3600000;0
8060;-1;113;60;39;5;34;.872;3600000;0
8060;191709;113;0;0;0;0;.00nan;0;0
8061;196414;118;62;37;5;32;.865;3600000;0
8061;191026;118;0;0;0;0;.00nan;0;0
8061;191125;123;89;18;0;18;1.000;3600000;0
8061;-1;123;0;0;0;0;.00nan;0;0
8062;187699;114;98;59;3;56;.949;3598000;0
8062;195001;126;67;16;1;15;.938;3600000;0
8062;202180;114;0;0;0;0;.00nan;0;0
8062;192564;126;0;0;0;0;.00nan;0;0
8063;187550;111;0;0;0;0;.00nan;0;0
8063;195089;124;0;0;0;0;.00nan;0;0
8063;191687;124;100;35;0;35;1.000;3600000;0
8063;197912;111;42;25;4;21;.840;3600000;0
8064;201631;109;0;0;0;0;.00nan;0;0
8064;-1;113;0;0;0;0;.00nan;0;0
8064;197038;109;53;30;4;26;.867;3600000;0
8064;191709;113;54;35;5;30;.857;3556000;0
8065;187537;117;70;33;3;30;.909;3600000;0
8065;188888;116;0;0;0;0;.00nan;0;0
8065;200514;116;98;35;1;34;.971;3600000;0
8065;189783;117;0;0;0;0;.00nan;0;0
8066;188911;115;0;0;0;0;.00nan;0;0
8066;189008;108;74;35;3;32;.914;3600000;0
8066;196372;108;0;0;0;0;.00nan;0;0
8066;191698;115;60;32;4;28;.875;3600000;0
8067;198141;110;58;20;2;18;.900;3600000;0
8067;199481;122;0;0;0;0;.00nan;0;0
8067;196324;110;0;0;0;0;.00nan;0;0
8067;191692;122;60;38;4;34;.895;3581000;0
8068;192776;119;0;0;0;0;.00nan;0;0
8068;195017;119;48;33;5;28;.848;3600000;0
8068;207493;121;39;35;6;29;.829;2272000;0
8068;192645;121;45;16;2;14;.875;1328000;0
8069;193687;120;88;31;1;30;.968;3600000;0
8069;189734;120;0;0;0;0;.00nan;0;0
8069;202314;127;0;0;0;0;.00nan;0;0
8069;191171;127;81;35;2;33;.943;3562000;0
8070;193687;120;0;0;0;0;.00nan;0;0
8070;199481;122;0;0;0;0;.00nan;0;0
8070;189734;120;70;24;2;22;.917;3600000;0
8070;191692;122;90;53;4;49;.925;3562000;0
8071;196414;118;0;0;0;0;.00nan;0;0
8071;202314;127;9;24;7;17;.708;3127000;0
8071;191026;118;64;36;4;32;.889;3600000;0
8071;191171;127;48;0;0;0;.00nan;473000;0
8072;198141;110;0;0;0;0;.00nan;0;0
8072;201631;109;89;44;2;42;.955;3600000;0
8072;196324;110;31;23;5;18;.783;3600000;0
8072;197038;109;0;0;0;0;.00nan;0;0
8073;187537;117;33;19;4;15;.789;1138000;0
8073;195001;126;38;30;5;25;.833;1992000;0
8073;189783;117;57;23;3;20;.870;2449000;0
8073;192564;126;46;5;1;4;.800;1608000;0
8074;187699;114;41;22;4;18;.818;3594000;0
8074;202180;114;0;0;0;0;.00nan;0;0
8074;202314;127;0;0;0;0;.00nan;0;0
8074;191171;127;53;23;3;20;.870;3600000;0
8075;187550;111;0;0;0;0;.00nan;0;0
8075;-1;113;53;29;4;25;.862;3543000;0
8075;191709;113;0;0;0;0;.00nan;0;0
8075;197912;111;66;31;3;28;.903;3600000;0
8076;188911;115;59;19;2;17;.895;3600000;0
8076;207493;121;55;14;1;13;.929;504000;0
8076;191698;115;0;0;0;0;.00nan;0;0
8076;192645;121;19;38;8;30;.789;3096000;0
8077;188918;112;32;38;7;31;.816;3569000;0
8077;189008;108;0;0;0;0;.00nan;0;0
8077;196372;108;39;34;5;29;.853;3600000;0
8077;202246;112;0;0;0;0;.00nan;0;0
8078;187699;114;0;0;0;0;.00nan;0;0
8078;195111;125;0;0;0;0;.00nan;0;0
8078;202180;114;72;50;4;46;.920;3563000;0
8078;191813;125;53;22;3;19;.864;3600000;0
8079;189008;108;31;25;6;19;.760;3600000;0
8079;201631;109;0;0;0;0;.00nan;0;0
8079;196372;108;0;0;0;0;.00nan;0;0
8079;197038;109;73;33;2;31;.939;3600000;0
8080;188888;116;82;31;1;30;.968;3600000;0
8080;200514;116;0;0;0;0;.00nan;0;0
8080;-1;113;0;0;0;0;.00nan;0;0
8080;191709;113;79;32;2;30;.938;3544000;0
8081;193687;120;0;0;0;0;.00nan;0;0
8081;188918;112;0;0;0;0;.00nan;0;0
8081;189734;120;71;24;2;22;.917;3600000;0
8081;202246;112;50;42;5;37;.881;3600000;0
8082;196414;118;0;0;0;0;.00nan;0;0
8082;191026;118;81;42;4;38;.905;3900000;0
8082;191125;123;0;0;0;0;.00nan;0;0
8082;-1;123;52;24;4;20;.833;3899000;0
8083;187537;117;75;46;5;41;.891;3592000;0
8083;188911;115;0;0;0;0;.00nan;0;0
8083;189783;117;0;0;0;0;.00nan;0;0
8083;191698;115;60;26;3;23;.885;3600000;0
8084;187550;111;70;38;4;34;.895;3790000;0
8084;195001;126;0;0;0;0;.00nan;0;0
8084;192564;126;53;23;3;20;.870;3790000;0
8084;197912;111;0;0;0;0;.00nan;0;0
8085;192776;119;27;20;6;14;.700;2530000;0
8085;199481;122;79;53;5;48;.906;3600000;0
8085;195017;119;41;2;1;1;.500;1004000;0
8085;191692;122;0;0;0;0;.00nan;0;0
8086;193687;120;72;44;5;39;.886;3533000;0
8086;188918;112;59;28;3;25;.893;3600000;0
8086;189734;120;0;0;0;0;.00nan;0;0
8086;202246;112;0;0;0;0;.00nan;0;0
8087;195089;124;0;0;0;0;.00nan;0;0
8087;191125;123;21;21;6;15;.714;3600000;0
8087;-1;123;0;0;0;0;.00nan;0;0
8087;191687;124;82;36;2;34;.944;3600000;0
8088;199481;122;0;0;0;0;.00nan;0;0
8088;207493;121;0;0;0;0;.00nan;0;0
8088;191692;122;65;36;4;32;.889;3900000;0
8088;192645;121;84;49;4;45;.918;3900000;0
8089;192776;119;0;0;0;0;.00nan;0;0
8089;195017;119;53;31;4;27;.871;3564000;0
8089;202314;127;55;23;3;20;.870;3600000;0
8089;191171;127;0;0;0;0;.00nan;0;0
8090;198141;110;0;0;0;0;.00nan;0;0
8090;195111;125;88;53;4;49;.925;3576000;0
8090;196324;110;66;24;2;22;.917;3600000;0
8090;191813;125;0;0;0;0;.00nan;0;0
8091;187699;114;83;33;3;30;.909;3600000;0
8091;188888;116;0;0;0;0;.00nan;0;0
8091;200514;116;21;28;7;21;.750;3600000;0
8091;202180;114;0;0;0;0;.00nan;0;0
8092;189008;108;0;0;0;0;.00nan;0;0
8092;201631;109;98;39;1;38;.974;3600000;0
8092;196372;108;41;18;3;15;.833;3600000;0
8092;197038;109;0;0;0;0;.00nan;0;0
8093;187537;117;91;27;1;26;.963;3600000;0
8093;187550;111;0;0;0;0;.00nan;0;0
8093;189783;117;0;0;0;0;.00nan;0;0
8093;197912;111;96;51;3;48;.941;3573000;0
8094;198141;110;64;20;2;18;.900;3600000;0
8094;196324;110;0;0;0;0;.00nan;0;0
8094;202314;127;25;7;3;4;.571;829000;0
8094;191171;127;44;42;7;35;.833;2771000;0
8095;195001;126;0;0;0;0;.00nan;0;0
8095;196414;118;0;0;0;0;.00nan;0;0
8095;191026;118;33;43;8;35;.814;3600000;0
8095;192564;126;66;30;3;27;.900;3600000;0
8096;188888;116;56;35;5;30;.857;3600000;0
8096;188911;115;42;24;4;20;.833;3600000;0
8096;200514;116;0;0;0;0;.00nan;0;0
8096;191698;115;0;0;0;0;.00nan;0;0
8097;193687;120;0;0;0;0;.00nan;0;0
8097;199481;122;78;43;4;39;.907;3593000;0
8097;189734;120;65;26;3;23;.885;3600000;0
8097;191692;122;0;0;0;0;.00nan;0;0
8098;195089;124;85;50;4;46;.920;3900000;0
8098;195111;125;0;0;0;0;.00nan;0;0
8098;191687;124;0;0;0;0;.00nan;0;0
8098;191813;125;39;27;4;23;.852;3900000;0
8099;195001;126;47;31;4;27;.871;3551000;0
8099;-1;113;66;28;3;25;.893;3600000;0
8099;191709;113;0;0;0;0;.00nan;0;0
8099;192564;126;0;0;0;0;.00nan;0;0
8100;192776;119;0;0;0;0;.00nan;0;0
8100;199481;122;0;0;0;0;.00nan;0;0
8100;195017;119;65;22;2;20;.909;3600000;0
8100;191692;122;82;51;5;46;.902;3600000;0
8101;198141;110;0;0;0;0;.00nan;0;0
8101;188888;116;0;0;0;0;.00nan;0;0
8101;200514;116;96;41;1;40;.976;3600000;0
8101;196324;110;12;20;6;14;.700;3600000;0
8102;188911;115;55;24;3;21;.875;3600000;0
8102;201631;109;0;0;0;0;.00nan;0;0
8102;197038;109;62;44;5;39;.886;3564000;0
8102;191698;115;0;0;0;0;.00nan;0;0
8103;187550;111;0;0;0;0;.00nan;0;0
8103;189008;108;0;0;0;0;.00nan;0;0
8103;196372;108;61;22;2;20;.909;3600000;0
8103;197912;111;74;58;6;52;.897;3600000;0
8104;195111;125;56;23;3;20;.870;3770000;0
8104;196414;118;0;0;0;0;.00nan;0;0
8104;191026;118;73;44;4;40;.909;3770000;0
8104;191813;125;0;0;0;0;.00nan;0;0
8105;195089;124;66;40;4;36;.900;3295000;0
8105;191125;123;0;0;0;0;.00nan;0;0
8105;-1;123;58;24;2;22;.917;3600000;0
8105;191687;124;58;9;0;9;1.000;283000;0
8106;187699;114;68;42;4;38;.905;3600000;0
8106;188918;112;0;0;0;0;.00nan;0;0
8106;202180;114;0;0;0;0;.00nan;0;0
8106;202246;112;100;20;0;20;1.000;3600000;0
8107;187550;111;42;35;6;29;.829;2530000;0
8107;188911;115;0;0;0;0;.00nan;0;0
8107;191698;115;51;21;4;17;.810;3600000;0
8107;197912;111;43;11;2;9;.818;1070000;0
8108;198141;110;0;0;0;0;.00nan;0;0
8108;188888;116;43;39;6;33;.846;2732000;0
8108;200514;116;46;5;1;4;.800;836000;0
8108;196324;110;30;21;5;16;.762;3600000;0
8109;187537;117;68;25;2;23;.920;3600000;0
8109;195089;124;0;0;0;0;.00nan;0;0
8109;189783;117;0;0;0;0;.00nan;0;0
8109;191687;124;40;38;6;32;.842;3600000;0
8110;207493;121;0;0;0;0;.00nan;0;0
8110;-1;113;0;0;0;0;.00nan;0;0
8110;191709;113;46;30;5;25;.833;3900000;0
8110;192645;121;46;35;5;30;.857;3900000;0
8111;200390;120;0;0;0;0;.00nan;0;0
8111;195001;126;0;0;0;0;.00nan;0;0
8111;189734;120;62;28;4;24;.857;3582000;0
8111;192564;126;78;32;2;30;.938;3600000;0
8112;192776;119;49;13;2;11;.846;3600000;0
8112;195017;119;0;0;0;0;.00nan;0;0
8112;196414;118;66;31;3;28;.903;3600000;0
8112;191026;118;0;0;0;0;.00nan;0;0
8113;202314;127;0;0;0;0;.00nan;0;0
8113;191125;123;51;34;5;29;.853;3773000;0
8113;191171;127;46;32;6;26;.813;3773000;0
8113;-1;123;0;0;0;0;.00nan;0;0
8114;199481;122;0;0;0;0;.00nan;0;0
8114;189008;108;58;15;1;14;.933;3600000;0
8114;196372;108;0;0;0;0;.00nan;0;0
8114;191692;122;64;44;5;39;.886;3600000;0
8115;199481;122;54;41;5;36;.878;3589000;0
8115;195001;126;38;27;4;23;.852;3600000;0
8115;191692;122;0;0;0;0;.00nan;0;0
8115;192564;126;0;0;0;0;.00nan;0;0
8116;188911;115;29;22;6;16;.727;2808000;0
8116;-1;113;95;38;1;37;.974;3600000;0
8116;191698;115;61;6;0;6;1.000;792000;0
8116;191709;113;0;0;0;0;.00nan;0;0
8117;195089;124;54;34;4;30;.882;3600000;0
8117;202314;127;26;23;5;18;.783;3557000;0
8117;191171;127;0;0;0;0;.00nan;0;0
8117;191687;124;0;0;0;0;.00nan;0;0
8118;201631;109;75;30;2;28;.933;3600000;0
8118;207493;121;75;34;3;31;.912;3548000;0
8118;197038;109;0;0;0;0;.00nan;0;0
8118;192645;121;0;0;0;0;.00nan;0;0
8119;192776;119;0;0;0;0;.00nan;0;0
8119;195017;119;55;44;6;38;.864;3600000;0
8119;195111;125;81;34;1;33;.971;3600000;0
8119;191813;125;0;0;0;0;.00nan;0;0
8120;187537;117;37;29;5;24;.828;3900000;0
8120;189783;117;0;0;0;0;.00nan;0;0
8120;191125;123;0;0;0;0;.00nan;0;0
8120;-1;123;46;30;5;25;.833;3900000;0
8121;187699;114;0;0;0;0;.00nan;0;0
8121;200390;120;67;35;4;31;.886;3600000;0
8121;189734;120;0;0;0;0;.00nan;0;0
8121;202180;114;64;50;6;44;.880;3528000;0
8122;187550;111;72;22;1;21;.955;3290000;0
8122;188918;112;0;0;0;0;.00nan;0;0
8122;202246;112;63;25;3;22;.880;3600000;0
8122;197912;111;23;6;3;3;.500;256000;0
8123;188888;116;57;37;5;32;.865;3600000;0
8123;200514;116;0;0;0;0;.00nan;0;0
8123;201631;109;0;0;0;0;.00nan;0;0
8123;197038;109;56;27;4;23;.852;3600000;0
8124;187537;117;0;0;0;0;.00nan;0;0
8124;189783;117;51;26;4;22;.846;3600000;0
8124;196414;118;0;0;0;0;.00nan;0;0
8124;191026;118;76;23;1;22;.957;3600000;0
8125;198141;110;32;21;4;17;.810;3865000;0
8125;189008;108;0;0;0;0;.00nan;0;0
8125;196324;110;0;0;0;0;.00nan;0;0
8125;196372;108;52;38;5;33;.868;3865000;0
8126;187550;111;0;0;0;0;.00nan;0;0
8126;189008;108;0;0;0;0;.00nan;0;0
8126;196372;108;84;41;4;37;.902;3600000;0
8126;197912;111;74;27;2;25;.926;3600000;0
8127;203412;117;64;32;3;29;.906;3900000;0
8127;187699;114;70;38;3;35;.921;3900000;0
8127;189783;117;0;0;0;0;.00nan;0;0
8127;202180;114;0;0;0;0;.00nan;0;0
8128;200514;116;46;39;5;34;.872;3549000;0
8128;195111;125;53;28;4;24;.857;3600000;0
8128;191813;125;0;0;0;0;.00nan;0;0
8128;-1;116;0;0;0;0;.00nan;0;0
8129;201631;109;77;31;1;30;.968;3600000;0
8129;-1;113;0;0;0;0;.00nan;0;0
8129;197038;109;0;0;0;0;.00nan;0;0
8129;191709;113;38;20;4;16;.800;3600000;0
8130;199481;122;0;0;0;0;.00nan;0;0
8130;207493;121;0;0;0;0;.00nan;0;0
8130;191692;122;70;22;2;20;.909;3600000;0
8130;192645;121;67;42;5;37;.881;3600000;0
8131;192776;119;0;0;0;0;.00nan;0;0
8131;188911;115;26;25;6;19;.760;3576000;0
8131;195017;119;52;40;5;35;.875;3600000;0
8131;191698;115;0;0;0;0;.00nan;0;0
8132;198141;110;0;0;0;0;.00nan;0;0
8132;188918;112;47;6;1;5;.833;634000;0
8132;196324;110;74;24;2;22;.917;3600000;0
8132;202246;112;17;27;7;20;.741;2966000;0
8133;196414;118;0;0;0;0;.00nan;0;0
8133;202314;127;0;0;0;0;.00nan;0;0
8133;191026;118;61;40;4;36;.900;3875000;0
8133;191171;127;72;39;3;36;.923;3875000;0
8134;195001;126;76;34;3;31;.912;3600000;0
8134;191125;123;30;19;4;15;.789;1047000;0
8134;-1;123;69;29;2;27;.931;2553000;0
8134;192564;126;0;0;0;0;.00nan;0;0
8135;189008;108;56;29;3;26;.897;3600000;0
8135;200514;116;0;0;0;0;.00nan;0;0
8135;196372;108;0;0;0;0;.00nan;0;0
8135;-1;116;100;24;0;24;1.000;3600000;0
8136;193687;120;84;28;1;27;.964;3600000;0
8136;200390;120;0;0;0;0;.00nan;0;0
8136;195089;124;0;0;0;0;.00nan;0;0
8136;191687;124;71;26;3;23;.885;3564000;0
8137;196414;118;0;0;0;0;.00nan;0;0
8137;202314;127;39;29;5;24;.828;3600000;0
8137;191026;118;71;28;2;26;.929;3600000;0
8137;191171;127;0;0;0;0;.00nan;0;0
8138;203412;117;46;29;4;25;.862;3600000;0
8138;189783;117;0;0;0;0;.00nan;0;0
8138;-1;113;51;42;6;36;.857;3535000;0
8138;191709;113;0;0;0;0;.00nan;0;0
8139;187550;111;0;0;0;0;.00nan;0;0
8139;201631;109;0;0;0;0;.00nan;0;0
8139;197038;109;97;39;2;37;.949;3900000;0
8139;197912;111;79;33;2;31;.939;3900000;0
8140;187699;114;94;46;3;43;.935;3628000;0
8140;188918;112;0;0;0;0;.00nan;0;0
8140;202180;114;0;0;0;0;.00nan;0;0
8140;202246;112;60;32;4;28;.875;3628000;0
8141;199481;122;0;0;0;0;.00nan;0;0
8141;195089;124;64;23;2;21;.913;3600000;0
8141;191687;124;0;0;0;0;.00nan;0;0
8141;191692;122;63;26;3;23;.885;3578000;0
8142;188911;115;41;22;4;18;.818;3561000;0
8142;207493;121;0;0;0;0;.00nan;0;0
8142;191698;115;0;0;0;0;.00nan;0;0
8142;192645;121;73;34;3;31;.912;3600000;0
8143;192776;119;76;37;3;34;.919;3600000;0
8143;193687;120;0;0;0;0;.00nan;0;0
8143;200390;120;67;45;5;40;.889;3600000;0
8143;195017;119;0;0;0;0;.00nan;0;0
8144;195111;125;0;0;0;0;.00nan;0;0
8144;191125;123;57;6;0;6;1.000;414000;0
8144;-1;123;23;29;6;23;.793;3162000;0
8144;191813;125;56;28;4;24;.857;3600000;0
8145;203412;117;39;33;6;27;.818;3113000;0
8145;195001;126;64;8;0;8;1.000;761000;0
8145;189783;117;71;7;0;7;1.000;787000;0
8145;192564;126;36;37;6;31;.838;3139000;0
8146;198141;110;45;6;1;5;.833;1229000;0
8146;196324;110;47;23;4;19;.826;2331000;0
8146;-1;113;0;0;0;0;.00nan;0;0
8146;191709;113;95;53;4;49;.925;3600000;0
8147;189008;108;0;0;0;0;.00nan;0;0
8147;200514;116;0;0;0;0;.00nan;0;0
8147;196372;108;84;15;0;15;1.000;3600000;0
8147;-1;116;81;40;3;37;.925;3600000;0
8148;195111;125;81;14;0;14;1.000;3600000;0
8148;202314;127;0;0;0;0;.00nan;0;0
8148;191171;127;70;37;2;35;.946;3548000;0
8148;191813;125;0;0;0;0;.00nan;0;0
8149;195001;126;86;25;1;24;.960;3600000;0
8149;191125;123;42;30;6;24;.800;3600000;0
8149;-1;123;0;0;0;0;.00nan;0;0
8149;192564;126;0;0;0;0;.00nan;0;0
8150;188918;112;70;20;1;19;.950;3600000;0
8150;207493;121;49;43;7;36;.837;3600000;0
8150;202246;112;0;0;0;0;.00nan;0;0
8150;192645;121;0;0;0;0;.00nan;0;0
8151;195089;124;0;0;0;0;.00nan;0;0
8151;196414;118;0;0;0;0;.00nan;0;0
8151;191026;118;63;30;4;26;.867;3600000;0
8151;191687;124;31;37;7;30;.811;3600000;0
8152;199481;122;58;28;4;24;.857;3600000;0
8152;188911;115;0;0;0;0;.00nan;0;0
8152;191692;122;0;0;0;0;.00nan;0;0
8152;191698;115;100;38;0;38;1.000;3600000;0
8153;192776;119;0;0;0;0;.00nan;0;0
8153;187699;114;99;40;2;38;.950;3600000;0
8153;195017;119;62;30;3;27;.900;3575000;0
8153;202180;114;0;0;0;0;.00nan;0;0
8154;198141;110;94;35;1;34;.971;3600000;0
8154;193687;120;79;27;2;25;.926;3556000;0
8154;200390;120;0;0;0;0;.00nan;0;0
8154;196324;110;0;0;0;0;.00nan;0;0
8155;187550;111;57;30;4;26;.867;3600000;0
8155;201631;109;40;28;5;23;.821;3600000;0
8155;197038;109;0;0;0;0;.00nan;0;0
8155;197912;111;0;0;0;0;.00nan;0;0
8156;196414;118;0;0;0;0;.00nan;0;0
8156;207493;121;40;26;4;22;.846;2425000;0
8156;191026;118;54;25;3;22;.880;3600000;0
8156;192645;121;24;13;4;9;.692;1175000;0
8157;198141;110;0;0;0;0;.00nan;0;0
8157;195001;126;61;22;2;20;.909;3900000;0
8157;196324;110;61;23;2;21;.913;3900000;0
8157;192564;126;0;0;0;0;.00nan;0;0
8158;189008;108;0;0;0;0;.00nan;0;0
8158;196372;108;77;27;2;25;.926;3600000;0
8158;202314;127;49;7;1;6;.857;1338000;0
8158;191171;127;27;24;5;19;.792;2262000;0
8159;195089;124;53;35;4;31;.886;3600000;0
8159;195111;125;38;12;3;9;.750;3600000;0
8159;191687;124;0;0;0;0;.00nan;0;0
8159;191813;125;0;0;0;0;.00nan;0;0
8160;187699;114;99;35;1;34;.971;3600000;0
8160;202180;114;0;0;0;0;.00nan;0;0
8160;202314;127;0;0;0;0;.00nan;0;0
8160;191171;127;68;42;4;38;.905;3600000;0
8161;188918;112;0;0;0;0;.00nan;0;0
8161;202246;112;46;26;4;22;.846;3566000;0
8161;-1;113;82;42;3;39;.929;3600000;0
8161;191709;113;0;0;0;0;.00nan;0;0
8162;192776;119;57;23;3;20;.870;3600000;0
8162;195017;119;0;0;0;0;.00nan;0;0
8162;207493;121;0;0;0;0;.00nan;0;0
8162;192645;121;54;47;6;41;.872;3600000;0
8163;193687;120;76;21;1;20;.952;3600000;0
8163;200390;120;0;0;0;0;.00nan;0;0
8163;191125;123;0;0;0;0;.00nan;0;0
8163;-1;123;74;33;2;31;.939;3586000;0
8164;187550;111;0;0;0;0;.00nan;0;0
8164;200514;116;95;39;2;37;.949;3600000;0
8164;197912;111;50;33;5;28;.848;3600000;0
8164;-1;116;0;0;0;0;.00nan;0;0
8165;201631;109;0;0;0;0;.00nan;0;0
8165;-1;113;0;0;0;0;.00nan;0;0
8165;197038;109;88;26;1;25;.962;3600000;0
8165;191709;113;46;31;4;27;.871;3600000;0
8166;192776;119;0;0;0;0;.00nan;0;0
8166;188911;115;0;0;0;0;.00nan;0;0
8166;195017;119;79;39;2;37;.949;3900000;0
8166;191698;115;53;21;2;19;.905;3900000;0
8167;189008;108;0;0;0;0;.00nan;0;0
8167;195089;124;0;0;0;0;.00nan;0;0
8167;196372;108;18;28;7;21;.750;3600000;0
8167;191687;124;65;26;2;24;.923;3600000;0
8168;187699;114;67;30;2;28;.933;3900000;0
8168;196414;118;0;0;0;0;.00nan;0;0
8168;202180;114;0;0;0;0;.00nan;0;0
8168;191026;118;92;39;2;37;.949;3900000;0
8169;203412;117;77;43;5;38;.884;3600000;0
8169;188918;112;8;19;6;13;.684;1739000;0
8169;189783;117;0;0;0;0;.00nan;0;0
8169;202246;112;11;16;6;10;.625;1861000;0
8170;199481;122;0;0;0;0;.00nan;0;0
8170;195001;126;0;0;0;0;.00nan;0;0
8170;191692;122;99;40;1;39;.975;3600000;0
8170;192564;126;65;15;2;13;.867;3552000;0
8171;187550;111;85;29;2;27;.931;3698000;0
8171;201631;109;80;45;3;42;.933;3698000;0
8171;197038;109;0;0;0;0;.00nan;0;0
8171;197912;111;0;0;0;0;.00nan;0;0
8172;200514;116;71;17;1;16;.941;3600000;0
8172;196414;118;71;47;5;42;.894;3600000;0
8172;191026;118;0;0;0;0;.00nan;0;0
8172;-1;116;0;0;0;0;.00nan;0;0
8173;198141;110;60;23;2;21;.913;3600000;0
8173;195089;124;57;52;7;45;.865;3600000;0
8173;196324;110;0;0;0;0;.00nan;0;0
8173;191687;124;0;0;0;0;.00nan;0;0
8174;195111;125;59;20;2;18;.900;3600000;0
8174;207493;121;72;27;2;25;.926;2658000;0
8174;191813;125;0;0;0;0;.00nan;0;0
8174;192645;121;22;14;4;10;.714;942000;0
8175;192776;119;52;39;5;34;.872;3582000;0
8175;199481;122;33;14;4;10;.714;3600000;0
8175;195017;119;0;0;0;0;.00nan;0;0
8175;191692;122;0;0;0;0;.00nan;0;0
8176;203412;117;62;22;2;20;.909;3564000;0
8176;193687;120;100;48;1;47;.979;3600000;0
8176;200390;120;0;0;0;0;.00nan;0;0
8176;189783;117;0;0;0;0;.00nan;0;0
8177;189008;108;0;0;0;0;.00nan;0;0
8177;196372;108;69;30;2;28;.933;3600000;0
8177;191125;123;64;43;4;39;.907;3541000;0
8177;-1;123;0;0;0;0;.00nan;0;0
8178;187699;114;0;0;0;0;.00nan;0;0
8178;195001;126;4;24;8;16;.667;3109000;0
8178;202180;114;86;31;2;29;.935;3600000;0
8178;192564;126;52;4;0;4;1.000;491000;0
8179;188918;112;0;0;0;0;.00nan;0;0
8179;200514;116;32;12;3;9;.750;899000;0
8179;202246;112;47;38;5;33;.868;3600000;0
8179;-1;116;12;25;7;18;.720;2701000;0
8180;193687;120;0;0;0;0;.00nan;0;0
8180;200390;120;100;27;0;27;1.000;3600000;0
8180;-1;113;0;0;0;0;.00nan;0;0
8180;191709;113;76;36;3;33;.917;3600000;0
8181;188911;115;64;20;3;17;.850;3600000;0
8181;195111;125;0;0;0;0;.00nan;0;0
8181;191698;115;0;0;0;0;.00nan;0;0
8181;191813;125;47;31;4;27;.871;3600000;0
8182;199481;122;0;0;0;0;.00nan;0;0
8182;202314;127;78;31;3;28;.903;3618000;0
8182;191171;127;0;0;0;0;.00nan;0;0
8182;191692;122;73;35;4;31;.886;3618000;0
8183;198141;110;0;0;0;0;.00nan;0;0
8183;196324;110;65;25;2;23;.920;3600000;0
8183;191125;123;0;0;0;0;.00nan;0;0
8183;-1;123;60;38;5;33;.868;3600000;0
8184;192776;119;54;21;3;18;.857;3564000;0
8184;195017;119;0;0;0;0;.00nan;0;0
8184;195089;124;0;0;0;0;.00nan;0;0
8184;191687;124;97;34;1;33;.971;3600000;0
8185;187699;114;68;38;4;34;.895;3595000;0
8185;202180;114;0;0;0;0;.00nan;0;0
8185;207493;121;73;37;3;34;.919;3600000;0
8185;192645;121;0;0;0;0;.00nan;0;0
8186;203412;117;0;0;0;0;.00nan;0;0
8186;200514;116;90;30;1;29;.967;3600000;0
8186;189783;117;42;21;3;18;.857;3535000;0
8186;-1;116;0;0;0;0;.00nan;0;0
8187;196414;118;0;0;0;0;.00nan;0;0
8187;202314;127;0;0;0;0;.00nan;0;0
8187;191026;118;59;26;3;23;.885;3600000;0
8187;191171;127;35;16;4;12;.750;3552000;0
8188;195111;125;76;23;2;21;.913;3600000;0
8188;191125;123;81;44;3;41;.932;3600000;0
8188;-1;123;0;0;0;0;.00nan;0;0
8188;191813;125;0;0;0;0;.00nan;0;0
8189;188888;116;42;26;4;22;.846;3600000;0
8189;200514;116;0;0;0;0;.00nan;0;0
8189;-1;113;49;36;6;30;.833;3600000;0
8189;191709;113;0;0;0;0;.00nan;0;0
8190;187699;114;0;0;0;0;.00nan;0;0
8190;188911;115;73;18;1;17;.944;3600000;0
8190;202180;114;81;42;4;38;.905;3600000;0
8190;191698;115;0;0;0;0;.00nan;0;0
8191;187550;111;0;0;0;0;.00nan;0;0
8191;189008;108;0;0;0;0;.00nan;0;0
8191;196372;108;67;24;2;22;.917;3600000;0
8191;197912;111;44;37;5;32;.865;3600000;0
8192;188918;112;0;0;0;0;.00nan;0;0
8192;201631;109;0;0;0;0;.00nan;0;0
8192;202246;112;35;19;4;15;.789;3571000;0
8192;197038;109;64;33;3;30;.909;3600000;0
8193;187550;111;92;36;2;34;.944;3600000;0
8193;196324;110;41;19;3;16;.842;3546000;0
8193;191141;110;0;0;0;0;.00nan;0;0
8193;197912;111;0;0;0;0;.00nan;0;0
8194;188911;115;0;0;0;0;.00nan;0;0
8194;195089;124;42;44;6;38;.864;3600000;0
8194;191687;124;0;0;0;0;.00nan;0;0
8194;191698;115;71;18;1;17;.944;3600000;0
8195;193687;120;0;0;0;0;.00nan;0;0
8195;200390;120;66;39;4;35;.897;3600000;0
8195;207493;121;26;35;7;28;.800;3600000;0
8195;192645;121;0;0;0;0;.00nan;0;0
8196;196414;118;0;0;0;0;.00nan;0;0
8196;191026;118;78;57;6;51;.895;3600000;0
8196;191125;123;0;0;0;0;.00nan;0;0
8196;-1;123;43;19;3;16;.842;3600000;0
8197;187537;117;51;18;3;15;.833;3600000;0
8197;203412;117;0;0;0;0;.00nan;0;0
8197;202314;127;74;46;4;42;.913;3600000;0
8197;191171;127;0;0;0;0;.00nan;0;0
8198;199481;122;0;0;0;0;.00nan;0;0
8198;195001;126;0;0;0;0;.00nan;0;0
8198;191692;122;98;47;2;45;.957;3900000;0
8198;192564;126;44;14;2;12;.857;3900000;0
8199;192776;119;55;22;3;19;.864;3600000;0
8199;195017;119;0;0;0;0;.00nan;0;0
8199;201631;109;64;30;2;28;.933;3600000;0
8199;197038;109;0;0;0;0;.00nan;0;0
8200;195089;124;0;0;0;0;.00nan;0;0
8200;207493;121;0;0;0;0;.00nan;0;0
8200;191687;124;44;41;6;35;.854;3526000;0
8200;192645;121;45;26;4;22;.846;3600000;0
8201;189008;108;0;0;0;0;.00nan;0;0
8201;196324;110;0;0;0;0;.00nan;0;0
8201;196372;108;50;40;5;35;.875;3900000;0
8201;191141;110;38;27;5;22;.815;3900000;0
8202;187537;117;53;34;5;29;.853;3600000;0
8202;203412;117;0;0;0;0;.00nan;0;0
8202;195111;125;25;8;3;5;.625;590000;0
8202;191813;125;47;32;5;27;.844;3010000;0
8203;199481;122;17;16;5;11;.688;1155000;0
8203;191125;123;87;17;0;17;1.000;3600000;0
8203;-1;123;0;0;0;0;.00nan;0;0
8203;191692;122;67;23;2;21;.913;2445000;0
8204;195001;126;66;23;2;21;.913;3600000;0
8204;-1;113;0;0;0;0;.00nan;0;0
8204;191709;113;8;37;10;27;.730;3600000;0
8204;192564;126;0;0;0;0;.00nan;0;0
8205;187699;114;58;33;4;29;.879;3553000;0
8205;188918;112;61;32;3;29;.906;3600000;0
8205;202180;114;0;0;0;0;.00nan;0;0
8205;202246;112;0;0;0;0;.00nan;0;0
8206;188888;116;47;18;3;15;.833;3600000;0
8206;200514;116;0;0;0;0;.00nan;0;0
8206;202314;127;0;0;0;0;.00nan;0;0
8206;191171;127;74;41;4;37;.902;3596000;0
8207;193687;120;45;28;4;24;.857;3600000;0
8207;200390;120;0;0;0;0;.00nan;0;0
8207;201631;109;0;0;0;0;.00nan;0;0
8207;197038;109;35;39;6;33;.846;3600000;0
8208;192776;119;0;0;0;0;.00nan;0;0
8208;195017;119;42;21;4;17;.810;3575000;0
8208;196414;118;0;0;0;0;.00nan;0;0
8208;191026;118;92;51;3;48;.941;3600000;0
8209;187550;111;0;0;0;0;.00nan;0;0
8209;196324;110;21;31;7;24;.774;3600000;0
8209;191141;110;0;0;0;0;.00nan;0;0
8209;197912;111;79;45;4;41;.911;3600000;0
8210;207493;121;93;45;2;43;.956;3690000;0
8210;202314;127;94;44;3;41;.932;3690000;0
8210;191171;127;0;0;0;0;.00nan;0;0
8210;192645;121;0;0;0;0;.00nan;0;0
8211;193687;120;36;23;5;18;.783;3900000;0
8211;199481;122;80;36;2;34;.944;3322000;0
8211;200390;120;0;0;0;0;.00nan;0;0
8211;191692;122;29;7;3;4;.571;578000;0
8212;188918;112;0;0;0;0;.00nan;0;0
8212;196324;110;0;0;0;0;.00nan;0;0
8212;202246;112;69;39;4;35;.897;3600000;0
8212;191141;110;47;35;5;30;.857;3558000;0
8213;187537;117;69;26;2;24;.923;3600000;0
8213;203412;117;0;0;0;0;.00nan;0;0
8213;187699;114;82;45;3;42;.933;3598000;0
8213;202180;114;0;0;0;0;.00nan;0;0
8214;207493;121;38;28;5;23;.821;3600000;0
8214;-1;113;77;29;2;27;.931;3600000;0
8214;191709;113;0;0;0;0;.00nan;0;0
8214;192645;121;0;0;0;0;.00nan;0;0
8215;188888;116;45;26;5;21;.808;3618000;0
8215;188911;115;48;23;4;19;.826;3618000;0
8215;200514;116;0;0;0;0;.00nan;0;0
8215;191698;115;0;0;0;0;.00nan;0;0
8216;192776;119;61;35;4;31;.886;3600000;0
8216;189008;108;0;0;0;0;.00nan;0;0
8216;195017;119;0;0;0;0;.00nan;0;0
8216;196372;108;98;24;0;24;1.000;3600000;0
8217;195001;126;0;0;0;0;.00nan;0;0
8217;195111;125;54;43;6;37;.860;3600000;0
8217;191813;125;0;0;0;0;.00nan;0;0
8217;192564;126;77;22;1;21;.955;3600000;0
8218;192776;119;0;0;0;0;.00nan;0;0
8218;187550;111;0;0;0;0;.00nan;0;0
8218;195017;119;44;30;4;26;.867;3568000;0
8218;197912;111;88;41;2;39;.951;3600000;0
8219;201631;109;0;0;0;0;.00nan;0;0
8219;191125;123;77;39;3;36;.923;3882000;0
8219;-1;123;0;0;0;0;.00nan;0;0
8219;197038;109;74;39;3;36;.923;3900000;0
8220;188888;116;0;0;0;0;.00nan;0;0
8220;200514;116;68;30;3;27;.900;3600000;0
8220;-1;113;0;0;0;0;.00nan;0;0
8220;191709;113;61;40;4;36;.900;3557000;0
8221;193687;120;0;0;0;0;.00nan;0;0
8221;200390;120;75;20;1;19;.950;3600000;0
8221;196414;118;0;0;0;0;.00nan;0;0
8221;191026;118;45;37;6;31;.838;3600000;0
8222;187537;117;69;28;3;25;.893;3600000;0
8222;203412;117;0;0;0;0;.00nan;0;0
8222;207493;121;0;0;0;0;.00nan;0;0
8222;192645;121;33;26;5;21;.808;3566000;0
8223;195001;126;76;23;1;22;.957;3600000;0
8223;202314;127;0;0;0;0;.00nan;0;0
8223;191171;127;69;36;4;32;.889;3600000;0
8223;192564;126;0;0;0;0;.00nan;0;0
8224;199481;122;0;0;0;0;.00nan;0;0
8224;195089;124;0;0;0;0;.00nan;0;0
8224;191687;124;90;40;2;38;.950;3574000;0
8224;191692;122;81;15;0;15;1.000;3600000;0
8225;189008;108;0;0;0;0;.00nan;0;0
8225;196324;110;29;16;4;12;.750;3554000;0
8225;196372;108;80;42;3;39;.929;3600000;0
8225;191141;110;0;0;0;0;.00nan;0;0
8226;188918;112;0;0;0;0;.00nan;0;0
8226;195111;125;58;34;4;30;.882;3600000;0
8226;202246;112;92;47;1;46;.979;3600000;0
8226;191813;125;0;0;0;0;.00nan;0;0
8227;193687;120;61;34;4;30;.882;3600000;0
8227;200390;120;0;0;0;0;.00nan;0;0
8227;196414;118;30;21;5;16;.762;3556000;0
8227;191026;118;0;0;0;0;.00nan;0;0
8228;195089;124;50;33;5;28;.848;3900000;0
8228;202314;127;64;51;5;46;.902;3900000;0
8228;191171;127;0;0;0;0;.00nan;0;0
8228;191687;124;0;0;0;0;.00nan;0;0
8229;189008;108;90;39;2;37;.949;3600000;0
8229;196372;108;0;0;0;0;.00nan;0;0
8229;191125;123;0;0;0;0;.00nan;0;0
8229;-1;123;62;30;4;26;.867;3595000;0
8230;187699;114;95;41;2;39;.951;3600000;0
8230;188911;115;65;38;4;34;.895;3592000;0
8230;202180;114;0;0;0;0;.00nan;0;0
8230;191698;115;0;0;0;0;.00nan;0;0
8231;187550;111;0;0;0;0;.00nan;0;0
8231;191125;123;24;36;7;29;.806;3194000;0
8231;-1;123;40;3;1;2;.667;406000;0
8231;197912;111;68;31;2;29;.935;3600000;0
8232;192776;119;18;25;6;19;.760;2554000;0
8232;195017;119;49;9;1;8;.889;1001000;0
8232;201631;109;51;31;5;26;.839;3600000;0
8232;197038;109;0;0;0;0;.00nan;0;0
8233;188888;116;28;32;7;25;.781;2638000;0
8233;188918;112;70;23;2;21;.913;3600000;0
8233;200514;116;58;8;0;8;1.000;962000;0
8233;202246;112;0;0;0;0;.00nan;0;0
8234;188911;115;0;0;0;0;.00nan;0;0
8234;-1;113;75;52;4;48;.923;3600000;0
8234;191698;115;89;23;0;23;1.000;3600000;0
8234;191709;113;0;0;0;0;.00nan;0;0
8235;187537;117;64;26;2;24;.923;3600000;0
8235;203412;117;0;0;0;0;.00nan;0;0
8235;187699;114;51;8;1;7;.875;1472000;0
8235;202180;114;27;29;7;22;.759;2128000;0
8236;195001;126;0;0;0;0;.00nan;0;0
8236;207493;121;70;26;2;24;.923;3548000;0
8236;192564;126;90;22;0;22;1.000;3600000;0
8236;192645;121;0;0;0;0;.00nan;0;0
8237;195111;125;0;0;0;0;.00nan;0;0
8237;196324;110;0;0;0;0;.00nan;0;0
8237;191141;110;56;20;3;17;.850;3600000;0
8237;191813;125;72;54;5;49;.907;3600000;0
8238;192776;119;0;0;0;0;.00nan;0;0
8238;187699;114;77;34;3;31;.912;3600000;0
8238;195017;119;62;28;4;24;.857;3556000;0
8238;202180;114;0;0;0;0;.00nan;0;0
8239;187537;117;63;28;3;25;.893;3600000;0
8239;203412;117;0;0;0;0;.00nan;0;0
8239;-1;113;0;0;0;0;.00nan;0;0
8239;191709;113;77;41;4;37;.902;3543000;0
8240;188911;115;0;0;0;0;.00nan;0;0
8240;188918;112;0;0;0;0;.00nan;0;0
8240;202246;112;61;34;4;30;.882;3561000;0
8240;191698;115;96;44;2;42;.955;3600000;0
8241;189008;108;0;0;0;0;.00nan;0;0
8241;201631;109;0;0;0;0;.00nan;0;0
8241;196372;108;96;33;1;32;.970;3600000;0
8241;197038;109;27;23;5;18;.783;3600000;0
8242;195111;125;39;23;4;19;.826;3564000;0
8242;191125;123;0;0;0;0;.00nan;0;0
8242;-1;123;68;25;2;23;.920;3600000;0
8242;191813;125;0;0;0;0;.00nan;0;0
8243;187550;111;0;0;0;0;.00nan;0;0
8243;188911;115;57;23;3;20;.870;3653000;0
8243;191698;115;0;0;0;0;.00nan;0;0
8243;197912;111;90;38;2;36;.947;3658000;0
8244;188888;116;0;0;0;0;.00nan;0;0
8244;200514;116;57;30;4;26;.867;3600000;0
8244;195089;124;0;0;0;0;.00nan;0;0
8244;191687;124;63;31;3;28;.903;3600000;0
8245;189008;108;0;0;0;0;.00nan;0;0
8245;196372;108;69;22;2;20;.909;3600000;0
8245;196414;118;0;0;0;0;.00nan;0;0
8245;191026;118;82;37;3;34;.919;3562000;0
8246;187537;117;44;21;4;17;.810;2517000;0
8246;203412;117;29;14;4;10;.714;1083000;0
8246;-1;113;45;23;4;19;.826;3600000;0
8246;191709;113;0;0;0;0;.00nan;0;0
8247;193687;120;83;40;2;38;.950;3600000;0
8247;200390;120;0;0;0;0;.00nan;0;0
8247;195001;126;0;0;0;0;.00nan;0;0
8247;192564;126;49;21;3;18;.857;3598000;0
8248;199481;122;0;0;0;0;.00nan;0;0
8248;202314;127;0;0;0;0;.00nan;0;0
8248;191171;127;38;41;6;35;.854;3600000;0
8248;191692;122;70;28;2;26;.929;3600000;0
8249;196324;110;48;29;4;25;.862;3527000;0
8249;207493;121;93;42;2;40;.952;3600000;0
8249;191141;110;0;0;0;0;.00nan;0;0
8249;192645;121;0;0;0;0;.00nan;0;0
8250;188911;115;0;0;0;0;.00nan;0;0
8250;201631;109;60;38;4;34;.895;3673000;0
8250;197038;109;0;0;0;0;.00nan;0;0
8250;191698;115;43;32;5;27;.844;3675000;0
8251;187550;111;79;33;2;31;.939;3600000;0
8251;188918;112;0;0;0;0;.00nan;0;0
8251;202246;112;80;24;1;23;.958;3600000;0
8251;197912;111;0;0;0;0;.00nan;0;0
8252;196414;118;72;25;3;22;.880;3600000;0
8252;207493;121;0;0;0;0;.00nan;0;0
8252;191026;118;0;0;0;0;.00nan;0;0
8252;192645;121;60;37;5;32;.865;3600000;0
8253;192776;119;60;27;3;24;.889;3600000;0
8253;195017;119;0;0;0;0;.00nan;0;0
8253;195089;124;44;39;6;33;.846;2760000;0
8253;191687;124;40;2;1;1;.500;840000;0
8254;189008;108;43;31;5;26;.839;3600000;0
8254;195111;125;75;22;1;21;.955;3600000;0
8254;196372;108;0;0;0;0;.00nan;0;0
8254;191813;125;0;0;0;0;.00nan;0;0
8255;193687;120;0;0;0;0;.00nan;0;0
8255;200390;120;63;32;3;29;.906;3693000;0
8255;191125;123;63;35;4;31;.886;3693000;0
8255;-1;123;0;0;0;0;.00nan;0;0
8256;187699;114;58;44;5;39;.886;3526000;0
8256;196324;110;0;0;0;0;.00nan;0;0
8256;202180;114;0;0;0;0;.00nan;0;0
8256;191141;110;69;30;3;27;.900;3600000;0
8257;188888;116;42;31;5;26;.839;3516000;0
8257;188918;112;71;40;3;37;.925;3600000;0
8257;200514;116;0;0;0;0;.00nan;0;0
8257;202246;112;0;0;0;0;.00nan;0;0
8258;187699;114;76;27;2;25;.926;3900000;0
8258;202180;114;0;0;0;0;.00nan;0;0
8258;-1;113;0;0;0;0;.00nan;0;0
8258;191709;113;68;32;2;30;.938;3900000;0
8259;192776;119;0;0;0;0;.00nan;0;0
8259;199481;122;0;0;0;0;.00nan;0;0
8259;195017;119;81;21;1;20;.952;3681000;0
8259;191692;122;100;30;0;30;1.000;3681000;0
8260;195001;126;84;44;4;40;.909;3600000;0
8260;202314;127;35;38;6;32;.842;3026000;0
8260;191171;127;32;5;2;3;.600;574000;0
8260;192564;126;0;0;0;0;.00nan;0;0
8261;195111;125;46;29;4;25;.862;2715000;0
8261;191125;123;0;0;0;0;.00nan;0;0
8261;-1;123;90;25;1;24;.960;3600000;0
8261;191813;125;31;11;4;7;.636;885000;0
8262;201631;109;77;33;2;31;.939;2544000;0
8262;196324;110;65;24;2;22;.917;3600000;0
8262;191141;110;0;0;0;0;.00nan;0;0
8262;197038;109;28;9;4;5;.556;1056000;0
8263;193687;120;77;41;4;37;.902;3600000;0
8263;200390;120;0;0;0;0;.00nan;0;0
8263;196414;118;52;2;0;2;1.000;445000;0
8263;191026;118;26;33;7;26;.788;3155000;0
8264;192776;119;0;0;0;0;.00nan;0;0
8264;187699;114;45;26;3;23;.885;3600000;0
8264;195017;119;100;33;0;33;1.000;3600000;0
8264;202180;114;0;0;0;0;.00nan;0;0
8265;195001;126;0;0;0;0;.00nan;0;0
8265;191125;123;60;36;5;31;.861;3600000;0
8265;-1;123;0;0;0;0;.00nan;0;0
8265;192564;126;67;29;2;27;.931;3600000;0
8266;199481;122;0;0;0;0;.00nan;0;0
8266;207493;121;55;32;4;28;.875;3600000;0
8266;191692;122;81;38;3;35;.921;3600000;0
8266;192645;121;0;0;0;0;.00nan;0;0
8267;188888;116;41;36;6;30;.833;3600000;0
8267;200514;116;0;0;0;0;.00nan;0;0
8267;-1;113;59;38;5;33;.868;3600000;0
8267;191709;113;0;0;0;0;.00nan;0;0
8268;187537;117;89;35;2;33;.943;3600000;0
8268;203412;117;0;0;0;0;.00nan;0;0
8268;188911;115;71;36;4;32;.889;3578000;0
8268;191698;115;0;0;0;0;.00nan;0;0
8269;189008;108;0;0;0;0;.00nan;0;0
8269;196324;110;95;33;1;32;.970;3600000;0
8269;196372;108;73;31;3;28;.903;3565000;0
8269;191141;110;0;0;0;0;.00nan;0;0
8270;195111;125;29;15;4;11;.733;3600000;0
8270;202314;127;0;0;0;0;.00nan;0;0
8270;191171;127;89;23;1;22;.957;3600000;0
8270;191813;125;0;0;0;0;.00nan;0;0
8271;187537;117;0;0;0;0;.00nan;0;0
8271;203412;117;62;43;5;38;.884;3720000;0
8271;188918;112;0;0;0;0;.00nan;0;0
8271;202246;112;44;30;6;24;.800;3720000;0
8272;187550;111;0;0;0;0;.00nan;0;0
8272;196324;110;0;0;0;0;.00nan;0;0
8272;191141;110;44;36;6;30;.833;3773000;0
8272;197912;111;38;38;7;31;.816;3746000;0
8273;187699;114;30;22;5;17;.773;3600000;0
8273;195089;124;64;44;6;38;.864;3582000;0
8273;202180;114;0;0;0;0;.00nan;0;0
8273;191687;124;0;0;0;0;.00nan;0;0
8274;193687;120;74;31;2;29;.935;3600000;0
8274;199481;122;49;28;4;24;.857;3569000;0
8274;200390;120;0;0;0;0;.00nan;0;0
8274;191692;122;0;0;0;0;.00nan;0;0
8275;196414;118;0;0;0;0;.00nan;0;0
8275;207493;121;0;0;0;0;.00nan;0;0
8275;191026;118;52;29;4;25;.862;3600000;0
8275;192645;121;40;35;6;29;.829;3532000;0
8276;201631;109;63;34;4;30;.882;3600000;0
8276;202314;127;47;32;5;27;.844;3569000;0
8276;191171;127;0;0;0;0;.00nan;0;0
8276;197038;109;0;0;0;0;.00nan;0;0
8277;188888;116;0;0;0;0;.00nan;0;0
8277;200514;116;59;49;6;43;.878;3600000;0
8277;195001;126;65;29;3;26;.897;3600000;0
8277;192564;126;0;0;0;0;.00nan;0;0
8278;188918;112;73;23;1;22;.957;3600000;0
8278;202246;112;0;0;0;0;.00nan;0;0
8278;-1;113;0;0;0;0;.00nan;0;0
8278;191709;113;57;50;7;43;.860;3600000;0
8279;195089;124;0;0;0;0;.00nan;0;0
8279;201631;109;0;0;0;0;.00nan;0;0
8279;197038;109;41;30;5;25;.833;3640000;0
8279;191687;124;96;48;4;44;.917;3640000;0
8280;193687;120;0;0;0;0;.00nan;0;0
8280;200390;120;48;26;4;22;.846;3600000;0
8280;207493;121;26;26;6;20;.769;2510000;0
8280;192645;121;59;13;1;12;.923;1090000;0
8281;192776;119;0;0;0;0;.00nan;0;0
8281;195017;119;61;25;2;23;.920;3600000;0
8281;196414;118;90;33;1;32;.970;3600000;0
8281;191026;118;0;0;0;0;.00nan;0;0
8282;188911;115;59;35;5;30;.857;3658000;0
8282;189008;108;0;0;0;0;.00nan;0;0
8282;196372;108;43;23;4;19;.826;3631000;0
8282;191698;115;0;0;0;0;.00nan;0;0
8283;187699;114;48;34;5;29;.853;3600000;0
8283;202180;114;0;0;0;0;.00nan;0;0
8283;191125;123;0;0;0;0;.00nan;0;0
8283;-1;123;69;16;1;15;.938;3600000;0
8284;187550;111;0;0;0;0;.00nan;0;0
8284;189008;108;0;0;0;0;.00nan;0;0
8284;196372;108;92;37;2;35;.946;3900000;0
8284;197912;111;72;24;2;22;.917;3900000;0
8285;187537;117;80;26;1;25;.962;3600000;0
8285;203412;117;0;0;0;0;.00nan;0;0
8285;188888;116;69;38;4;34;.895;3600000;0
8285;200514;116;0;0;0;0;.00nan;0;0
8286;188911;115;0;0;0;0;.00nan;0;0
8286;-1;113;100;42;1;41;.976;3900000;0
8286;191698;115;74;27;1;26;.963;3900000;0
8286;191709;113;0;0;0;0;.00nan;0;0
8287;199481;122;0;0;0;0;.00nan;0;0
8287;196414;118;0;0;0;0;.00nan;0;0
8287;191026;118;61;35;5;30;.857;3600000;0
8287;191692;122;91;30;1;29;.967;3600000;0
8288;201631;109;72;37;3;34;.919;3600000;0
8288;191125;123;55;34;4;30;.882;3600000;0
8288;-1;123;0;0;0;0;.00nan;0;0
8288;197038;109;0;0;0;0;.00nan;0;0
8289;188918;112;0;0;0;0;.00nan;0;0
8289;196324;110;81;26;1;25;.962;3600000;0
8289;202246;112;97;47;2;45;.957;3597000;0
8289;191141;110;0;0;0;0;.00nan;0;0
8290;195111;125;74;38;5;33;.868;3651000;0
8290;202314;127;0;0;0;0;.00nan;0;0
8290;191171;127;87;55;4;51;.927;3651000;0
8290;191813;125;0;0;0;0;.00nan;0;0
8291;187550;111;0;0;0;0;.00nan;0;0
8291;196324;110;0;0;0;0;.00nan;0;0
8291;191141;110;75;25;2;23;.920;3600000;0
8291;197912;111;33;42;7;35;.833;3600000;0
8292;195089;124;0;0;0;0;.00nan;0;0
8292;196414;118;0;0;0;0;.00nan;0;0
8292;191026;118;36;23;5;18;.783;3546000;0
8292;191687;124;52;24;3;21;.875;3600000;0
8293;192776;119;29;30;6;24;.800;2890000;0
8293;195017;119;45;5;1;4;.800;710000;0
8293;202314;127;0;0;0;0;.00nan;0;0
8293;191171;127;77;47;4;43;.915;3600000;0
8294;187537;117;69;35;3;32;.914;3900000;0
8294;203412;117;0;0;0;0;.00nan;0;0
8294;195001;126;0;0;0;0;.00nan;0;0
8294;192564;126;57;30;3;27;.900;3900000;0
8295;188911;115;94;32;2;30;.938;3600000;0
8295;-1;113;0;0;0;0;.00nan;0;0
8295;191698;115;0;0;0;0;.00nan;0;0
8295;191709;113;71;36;4;32;.889;3600000;0
8296;188888;116;87;33;2;31;.939;3600000;0
8296;189008;108;0;0;0;0;.00nan;0;0
8296;200514;116;0;0;0;0;.00nan;0;0
8296;196372;108;56;37;4;33;.892;3575000;0
8297;195111;125;99;43;1;42;.977;3600000;0
8297;207493;121;0;0;0;0;.00nan;0;0
8297;191813;125;0;0;0;0;.00nan;0;0
8297;192645;121;52;25;4;21;.840;3600000;0
8298;187550;111;0;0;0;0;.00nan;0;0
8298;193687;120;35;18;4;14;.778;3600000;0
8298;200390;120;0;0;0;0;.00nan;0;0
8298;197912;111;72;52;5;47;.904;3585000;0
8299;189008;108;91;40;2;38;.950;3600000;0
8299;201631;109;0;0;0;0;.00nan;0;0
8299;196372;108;0;0;0;0;.00nan;0;0
8299;197038;109;52;21;3;18;.857;3597000;0
8300;187699;114;62;31;3;28;.903;3900000;0
8300;188888;116;0;0;0;0;.00nan;0;0
8300;200514;116;66;32;3;29;.906;3900000;0
8300;202180;114;0;0;0;0;.00nan;0;0
8301;195111;125;80;25;1;24;.960;3600000;0
8301;196414;118;0;0;0;0;.00nan;0;0
8301;191026;118;64;35;4;31;.886;3600000;0
8301;191813;125;0;0;0;0;.00nan;0;0
8302;187537;117;93;50;4;46;.920;3900000;0
8302;203412;117;0;0;0;0;.00nan;0;0
8302;188911;115;0;0;0;0;.00nan;0;0
8302;191698;115;51;31;4;27;.871;3900000;0
8303;207493;121;37;29;5;24;.828;3185000;0
8303;202314;127;0;0;0;0;.00nan;0;0
8303;191171;127;75;44;4;40;.909;3600000;0
8303;192645;121;51;2;0;2;1.000;390000;0
8304;192776;119;0;0;0;0;.00nan;0;0
8304;195017;119;54;37;5;32;.865;3900000;0
8304;191125;123;0;0;0;0;.00nan;0;0
8304;-1;123;60;37;5;32;.865;3900000;0
8305;199481;122;0;0;0;0;.00nan;0;0
8305;188918;112;0;0;0;0;.00nan;0;0
8305;202246;112;87;32;2;30;.938;3900000;0
8305;191692;122;89;43;2;41;.953;3900000;0
8306;195089;124;14;33;8;25;.758;3600000;0
8306;196324;110;68;24;2;22;.917;3600000;0
8306;191141;110;0;0;0;0;.00nan;0;0
8306;191687;124;0;0;0;0;.00nan;0;0
8307;193687;120;0;0;0;0;.00nan;0;0
8307;200390;120;35;39;7;32;.821;3581000;0
8307;201631;109;45;22;4;18;.818;2065000;0
8307;197038;109;57;11;1;10;.909;1535000;0
8308;188918;112;52;14;2;12;.857;3600000;0
8308;195089;124;0;0;0;0;.00nan;0;0
8308;202246;112;0;0;0;0;.00nan;0;0
8308;191687;124;47;49;6;43;.878;3600000;0
8309;199481;122;67;34;3;31;.912;3585000;0
8309;202314;127;92;29;1;28;.966;3600000;0
8309;191171;127;0;0;0;0;.00nan;0;0
8309;191692;122;0;0;0;0;.00nan;0;0
8310;192776;119;57;28;4;24;.857;3900000;0
8310;195017;119;0;0;0;0;.00nan;0;0
8310;195111;125;0;0;0;0;.00nan;0;0
8310;191813;125;55;35;4;31;.886;3900000;0
8311;207493;121;0;0;0;0;.00nan;0;0
8311;191125;123;55;25;3;22;.880;3557000;0
8311;-1;123;0;0;0;0;.00nan;0;0
8311;192645;121;79;25;1;24;.960;3600000;0
8312;188911;115;88;33;3;30;.909;3882000;0
8312;195001;126;48;28;4;24;.857;3882000;0
8312;191698;115;0;0;0;0;.00nan;0;0
8312;192564;126;0;0;0;0;.00nan;0;0
8313;187550;111;69;23;2;21;.913;3600000;0
8313;187699;114;67;30;3;27;.900;3600000;0
8313;202180;114;0;0;0;0;.00nan;0;0
8313;197912;111;0;0;0;0;.00nan;0;0
8314;188918;112;0;0;0;0;.00nan;0;0
8314;189008;108;0;0;0;0;.00nan;0;0
8314;196372;108;83;40;3;37;.925;3600000;0
8314;202246;112;46;27;4;23;.852;3583000;0
8315;187537;117;69;33;3;30;.909;3591000;0
8315;203412;117;0;0;0;0;.00nan;0;0
8315;188888;116;76;25;2;23;.920;3600000;0
8315;200514;116;0;0;0;0;.00nan;0;0
8316;196324;110;0;0;0;0;.00nan;0;0
8316;196414;118;0;0;0;0;.00nan;0;0
8316;191026;118;57;26;3;23;.885;3584000;0
8316;191141;110;63;22;2;20;.909;3600000;0
8317;195001;126;0;0;0;0;.00nan;0;0
8317;191125;123;0;0;0;0;.00nan;0;0
8317;-1;123;35;34;6;28;.824;3600000;0
8317;192564;126;62;26;3;23;.885;3600000;0
8318;187550;111;0;0;0;0;.00nan;0;0
8318;-1;113;67;25;2;23;.920;3554000;0
8318;191709;113;0;0;0;0;.00nan;0;0
8318;197912;111;99;33;1;32;.970;3600000;0
8319;193687;120;47;24;4;20;.833;3514000;0
8319;199481;122;0;0;0;0;.00nan;0;0
8319;200390;120;0;0;0;0;.00nan;0;0
8319;191692;122;100;51;2;49;.961;3600000;0
8320;192776;119;0;0;0;0;.00nan;0;0
8320;195017;119;59;27;3;24;.889;3550000;0
8320;196324;110;75;25;1;24;.960;3600000;0
8320;191141;110;0;0;0;0;.00nan;0;0
8321;187550;111;16;45;10;35;.778;3600000;0
8321;201631;109;0;0;0;0;.00nan;0;0
8321;197038;109;99;27;0;27;1.000;3600000;0
8321;197912;111;0;0;0;0;.00nan;0;0
8322;195089;124;72;28;2;26;.929;3900000;0
8322;202314;127;0;0;0;0;.00nan;0;0
8322;191171;127;81;32;2;30;.938;3900000;0
8322;191687;124;0;0;0;0;.00nan;0;0
8323;188911;115;64;30;3;27;.900;3600000;0
8323;207493;121;54;3;0;3;1.000;639000;0
8323;191698;115;0;0;0;0;.00nan;0;0
8323;192645;121;53;44;6;38;.864;2961000;0
8324;188918;112;0;0;0;0;.00nan;0;0
8324;195111;125;76;44;4;40;.909;3600000;0
8324;202246;112;69;21;1;20;.952;3600000;0
8324;191813;125;0;0;0;0;.00nan;0;0
8325;187537;117;67;42;5;37;.881;3571000;0
8325;203412;117;0;0;0;0;.00nan;0;0
8325;195001;126;62;30;3;27;.900;3600000;0
8325;192564;126;0;0;0;0;.00nan;0;0
8326;187699;114;79;24;1;23;.958;3600000;0
8326;202180;114;0;0;0;0;.00nan;0;0
8326;191125;123;66;28;3;25;.893;3555000;0
8326;-1;123;0;0;0;0;.00nan;0;0
8327;199481;122;0;0;0;0;.00nan;0;0
8327;189008;108;0;0;0;0;.00nan;0;0
8327;196372;108;57;21;3;18;.857;3900000;0
8327;191692;122;69;33;3;30;.909;3900000;0
8328;192776;119;0;0;0;0;.00nan;0;0
8328;188918;112;71;26;2;24;.923;3600000;0
8328;195017;119;97;45;3;42;.933;3568000;0
8328;202246;112;0;0;0;0;.00nan;0;0
8329;187550;111;0;0;0;0;.00nan;0;0
8329;189008;108;0;0;0;0;.00nan;0;0
8329;196372;108;63;37;4;33;.892;3545000;0
8329;197912;111;44;21;3;18;.857;3600000;0
8330;201631;109;0;0;0;0;.00nan;0;0
8330;-1;113;0;0;0;0;.00nan;0;0
8330;197038;109;65;36;4;32;.889;3544000;0
8330;191709;113;59;22;2;20;.909;3600000;0
8331;188911;115;77;18;1;17;.944;3600000;0
8331;196324;110;63;40;5;35;.875;3600000;0
8331;191141;110;0;0;0;0;.00nan;0;0
8331;191698;115;0;0;0;0;.00nan;0;0
8332;193687;120;0;0;0;0;.00nan;0;0
8332;188888;116;52;23;4;19;.826;3600000;0
8332;200390;120;46;33;5;28;.848;3598000;0
8332;200514;116;0;0;0;0;.00nan;0;0
8333;195001;126;0;0;0;0;.00nan;0;0
8333;196414;118;91;37;2;35;.946;2955000;0
8333;191026;118;20;11;4;7;.636;645000;0
8333;192564;126;66;27;2;25;.926;3600000;0
8334;187537;117;79;32;2;30;.938;3600000;0
8334;203412;117;0;0;0;0;.00nan;0;0
8334;191125;123;0;0;0;0;.00nan;0;0
8334;-1;123;59;32;4;28;.875;3567000;0
8335;195089;124;45;41;6;35;.854;3600000;0
8335;202314;127;0;0;0;0;.00nan;0;0
8335;191171;127;56;15;2;13;.867;3600000;0
8335;191687;124;0;0;0;0;.00nan;0;0
8336;199481;122;62;44;5;39;.886;3600000;0
8336;207493;121;0;0;0;0;.00nan;0;0
8336;191692;122;0;0;0;0;.00nan;0;0
8336;192645;121;70;26;2;24;.923;3600000;0
8337;187550;111;93;36;1;35;.972;3600000;0
8337;188888;116;0;0;0;0;.00nan;0;0
8337;200514;116;57;18;2;16;.889;3544000;0
8337;197912;111;0;0;0;0;.00nan;0;0
8338;195089;124;0;0;0;0;.00nan;0;0
8338;195111;125;79;17;0;17;1.000;3600000;0
8338;191687;124;68;42;5;37;.881;3600000;0
8338;191813;125;0;0;0;0;.00nan;0;0
8339;196324;110;0;0;0;0;.00nan;0;0
8339;207493;121;94;33;1;32;.970;3600000;0
8339;191141;110;64;23;2;21;.913;3574000;0
8339;192645;121;0;0;0;0;.00nan;0;0
8340;192776;119;96;42;2;40;.952;3600000;0
8340;195017;119;0;0;0;0;.00nan;0;0
8340;196414;118;0;0;0;0;.00nan;0;0
8340;191026;118;66;41;4;37;.902;3598000;0
8341;187699;114;72;29;2;27;.931;3600000;0
8341;201631;109;46;39;6;33;.846;3600000;0
8341;202180;114;0;0;0;0;.00nan;0;0
8341;197038;109;0;0;0;0;.00nan;0;0
8342;-1;113;63;26;3;23;.885;3600000;0
8342;191125;123;65;35;4;31;.886;3544000;0
8342;-1;123;0;0;0;0;.00nan;0;0
8342;191709;113;0;0;0;0;.00nan;0;0
8343;188911;115;67;29;3;26;.897;2854000;0
8343;188918;112;0;0;0;0;.00nan;0;0
8343;202246;112;76;31;2;29;.935;3600000;0
8343;191698;115;36;15;4;11;.733;746000;0
8344;187537;117;21;37;8;29;.784;3600000;0
8344;203412;117;0;0;0;0;.00nan;0;0
8344;193687;120;45;30;5;25;.833;3600000;0
8344;200390;120;0;0;0;0;.00nan;0;0
8345;195001;126;61;25;2;23;.920;3600000;0
8345;195111;125;29;28;6;22;.786;2091000;0
8345;191813;125;39;17;3;14;.824;1509000;0
8345;192564;126;0;0;0;0;.00nan;0;0
8346;188918;112;60;31;3;28;.903;3891000;0
8346;207493;121;0;0;0;0;.00nan;0;0
8346;202246;112;0;0;0;0;.00nan;0;0
8346;192645;121;85;32;2;30;.938;3891000;0
8347;187550;111;0;0;0;0;.00nan;0;0
8347;187699;114;47;26;5;21;.808;3600000;0
8347;202180;114;0;0;0;0;.00nan;0;0
8347;197912;111;80;29;2;27;.931;3600000;0
8348;201631;109;68;20;1;19;.950;3600000;0
8348;-1;113;0;0;0;0;.00nan;0;0
8348;197038;109;0;0;0;0;.00nan;0;0
8348;191709;113;72;40;3;37;.925;3588000;0
8349;192776;119;48;35;5;30;.857;3600000;0
8349;188888;116;15;21;6;15;.714;3156000;0
8349;200514;116;40;3;1;2;.667;390000;0
8349;195017;119;0;0;0;0;.00nan;0;0
8350;187537;117;20;38;8;30;.789;2612000;0
8350;203412;117;58;6;0;6;1.000;988000;0
8350;199481;122;0;0;0;0;.00nan;0;0
8350;191692;122;42;20;4;16;.800;3600000;0
8351;195111;125;65;24;2;22;.917;3774000;0
8351;196414;118;90;38;3;35;.921;3774000;0
8351;191026;118;0;0;0;0;.00nan;0;0
8351;191813;125;0;0;0;0;.00nan;0;0
8352;188911;115;0;0;0;0;.00nan;0;0
8352;196324;110;49;26;4;22;.846;3679000;0
8352;191141;110;0;0;0;0;.00nan;0;0
8352;191698;115;82;37;3;34;.919;3679000;0
8353;193687;120;0;0;0;0;.00nan;0;0
8353;189008;108;0;0;0;0;.00nan;0;0
8353;200390;120;64;31;3;28;.903;3600000;0
8353;196372;108;52;36;4;32;.889;3545000;0
8354;195001;126;0;0;0;0;.00nan;0;0
8354;202314;127;49;38;5;33;.868;3600000;0
8354;191171;127;0;0;0;0;.00nan;0;0
8354;192564;126;78;14;0;14;1.000;3600000;0
8355;192776;119;0;0;0;0;.00nan;0;0
8355;187699;114;76;45;5;40;.889;3600000;0
8355;195017;119;73;21;2;19;.905;3600000;0
8355;202180;114;0;0;0;0;.00nan;0;0
8356;195089;124;45;36;5;31;.861;3600000;0
8356;191125;123;0;0;0;0;.00nan;0;0
8356;-1;123;83;37;2;35;.946;3600000;0
8356;191687;124;0;0;0;0;.00nan;0;0
8357;187550;111;0;0;0;0;.00nan;0;0
8357;196414;118;0;0;0;0;.00nan;0;0
8357;191026;118;72;34;3;31;.912;3563000;0
8357;197912;111;59;24;2;22;.917;3600000;0
8358;201631;109;0;0;0;0;.00nan;0;0
8358;196324;110;0;0;0;0;.00nan;0;0
8358;191141;110;56;19;2;17;.895;3600000;0
8358;197038;109;31;34;6;28;.824;3600000;0
8359;188888;116;61;28;2;26;.929;3548000;0
8359;188911;115;100;24;0;24;1.000;3600000;0
8359;200514;116;0;0;0;0;.00nan;0;0
8359;191698;115;0;0;0;0;.00nan;0;0
8360;188918;112;0;0;0;0;.00nan;0;0
8360;195089;124;73;32;2;30;.938;3164000;0
8360;202246;112;51;23;3;20;.870;3600000;0
8360;191687;124;29;7;3;4;.571;421000;0
8361;193687;120;66;34;3;31;.912;3562000;0
8361;200390;120;0;0;0;0;.00nan;0;0
8361;202314;127;0;0;0;0;.00nan;0;0
8361;191171;127;71;27;2;25;.926;3600000;0
8362;187537;117;0;0;0;0;.00nan;0;0
8362;203412;117;63;25;3;22;.880;3900000;0
8362;189008;108;0;0;0;0;.00nan;0;0
8362;196372;108;86;40;3;37;.925;3900000;0
8363;-1;113;0;0;0;0;.00nan;0;0
8363;191125;123;44;29;5;24;.828;3600000;0
8363;-1;123;0;0;0;0;.00nan;0;0
8363;191709;113;87;29;1;28;.966;3600000;0
8364;199481;122;55;4;0;4;1.000;1220000;0
8364;195111;125;38;30;6;24;.800;3600000;0
8364;191692;122;18;28;7;21;.750;2328000;0
8364;191813;125;0;0;0;0;.00nan;0;0
8365;201631;109;68;55;5;50;.909;3745000;0
8365;196414;118;55;33;6;27;.818;3745000;0
8365;191026;118;0;0;0;0;.00nan;0;0
8365;197038;109;0;0;0;0;.00nan;0;0
8366;187550;111;57;45;6;39;.867;3600000;0
8366;188911;115;49;13;2;11;.846;3600000;0
8366;191698;115;0;0;0;0;.00nan;0;0
8366;197912;111;0;0;0;0;.00nan;0;0
8367;195089;124;55;3;0;3;1.000;323000;0
8367;-1;113;94;30;1;29;.967;3600000;0
8367;191687;124;39;31;5;26;.839;3277000;0
8367;191709;113;0;0;0;0;.00nan;0;0
8368;199481;122;0;0;0;0;.00nan;0;0
8368;207493;121;0;0;0;0;.00nan;0;0
8368;191692;122;88;36;2;34;.944;3900000;0
8368;192645;121;65;22;2;20;.909;3900000;0
8369;192776;119;0;0;0;0;.00nan;0;0
8369;195017;119;65;14;1;13;.929;3600000;0
8369;195111;125;0;0;0;0;.00nan;0;0
8369;191813;125;89;38;3;35;.921;3545000;0
8370;188918;112;79;30;1;29;.967;3600000;0
8370;202246;112;0;0;0;0;.00nan;0;0
8370;191125;123;0;0;0;0;.00nan;0;0
8370;-1;123;100;30;0;30;1.000;3600000;0
8371;189008;108;0;0;0;0;.00nan;0;0
8371;195001;126;28;15;4;11;.733;1194000;0
8371;196372;108;87;37;3;34;.919;3600000;0
8371;192564;126;70;21;1;20;.952;2383000;0
8372;187699;114;85;23;1;22;.957;3600000;0
8372;188888;116;0;0;0;0;.00nan;0;0
8372;200514;116;44;29;4;25;.862;3600000;0
8372;202180;114;0;0;0;0;.00nan;0;0
8373;202314;127;0;0;0;0;.00nan;0;0
8373;-1;113;0;0;0;0;.00nan;0;0
8373;191171;127;56;28;3;25;.893;3600000;0
8373;191709;113;48;40;6;34;.850;3600000;0
8374;193687;120;77;30;2;28;.933;3552000;0
8374;200390;120;0;0;0;0;.00nan;0;0
8374;195001;126;95;35;1;34;.971;3600000;0
8374;192564;126;0;0;0;0;.00nan;0;0
8375;187537;117;48;32;5;27;.844;3600000;0
8375;203412;117;0;0;0;0;.00nan;0;0
8375;188888;116;24;32;6;26;.813;2836000;0
8375;200514;116;48;15;2;13;.867;764000;0
8376;187550;111;0;0;0;0;.00nan;0;0
8376;207493;121;61;33;3;30;.909;3570000;0
8376;192645;121;0;0;0;0;.00nan;0;0
8376;197912;111;59;22;2;20;.909;3600000;0
8377;187699;114;51;35;5;30;.857;3591000;0
8377;196324;110;18;22;6;16;.727;3593000;0
8377;202180;114;0;0;0;0;.00nan;0;0
8377;191141;110;0;0;0;0;.00nan;0;0
8378;196324;110;0;0;0;0;.00nan;0;0
8378;196414;118;53;3;0;3;1.000;446000;0
8378;191026;118;24;27;6;21;.778;3101000;0
8378;191141;110;76;38;4;34;.895;3600000;0
8379;187537;117;52;31;5;26;.839;3732000;0
8379;203412;117;0;0;0;0;.00nan;0;0
8379;187699;114;64;37;4;33;.892;3732000;0
8379;202180;114;0;0;0;0;.00nan;0;0
8380;202314;127;0;0;0;0;.00nan;0;0
8380;-1;113;54;24;3;21;.875;3600000;0
8380;191171;127;49;27;4;23;.852;3550000;0
8380;191709;113;0;0;0;0;.00nan;0;0
8381;188911;115;0;0;0;0;.00nan;0;0
8381;201631;109;0;0;0;0;.00nan;0;0
8381;197038;109;71;31;3;28;.903;3600000;0
8381;191698;115;35;33;5;28;.848;3552000;0
8382;189008;108;0;0;0;0;.00nan;0;0
8382;196372;108;53;36;5;31;.861;3543000;0
8382;207493;121;0;0;0;0;.00nan;0;0
8382;192645;121;55;35;4;31;.886;3600000;0
8383;195089;124;63;30;3;27;.900;3555000;0
8383;195111;125;100;49;2;47;.959;3600000;0
8383;191687;124;0;0;0;0;.00nan;0;0
8383;191813;125;0;0;0;0;.00nan;0;0
8384;188918;112;0;0;0;0;.00nan;0;0
8384;202246;112;33;20;4;16;.800;3600000;0
8384;191125;123;62;27;3;24;.889;3600000;0
8384;-1;123;0;0;0;0;.00nan;0;0
8385;187550;111;0;0;0;0;.00nan;0;0
8385;207493;121;53;28;4;24;.857;3534000;0
8385;192645;121;0;0;0;0;.00nan;0;0
8385;197912;111;91;42;2;40;.952;3600000;0
8386;188888;116;100;27;0;27;1.000;3600000;0
8386;200514;116;0;0;0;0;.00nan;0;0
8386;201631;109;76;34;2;32;.941;3571000;0
8386;197038;109;0;0;0;0;.00nan;0;0
8387;195089;124;0;0;0;0;.00nan;0;0
8387;195111;125;0;0;0;0;.00nan;0;0
8387;191687;124;68;25;2;23;.920;3542000;0
8387;191813;125;83;29;1;28;.966;3600000;0
8388;193687;120;0;0;0;0;.00nan;0;0
8388;200390;120;41;30;5;25;.833;3600000;0
8388;196414;118;57;26;3;23;.885;1796000;0
8388;191026;118;48;24;4;20;.833;1778000;0
8389;187537;117;67;25;3;22;.880;3600000;0
8389;203412;117;0;0;0;0;.00nan;0;0
8389;202314;127;62;35;4;31;.886;3561000;0
8389;191171;127;0;0;0;0;.00nan;0;0
8390;195001;126;0;0;0;0;.00nan;0;0
8390;196324;110;34;20;4;16;.800;2293000;0
8390;191141;110;46;5;1;4;.800;1307000;0
8390;192564;126;65;26;3;23;.885;3600000;0
8391;192776;119;50;33;5;28;.848;3600000;0
8391;199481;122;0;0;0;0;.00nan;0;0
8391;195017;119;0;0;0;0;.00nan;0;0
8391;191692;122;55;44;6;38;.864;3572000;0
8392;187550;111;69;41;4;37;.902;3655000;0
8392;188918;112;73;29;3;26;.897;3655000;0
8392;202246;112;0;0;0;0;.00nan;0;0
8392;197912;111;0;0;0;0;.00nan;0;0
8393;195089;124;100;36;1;35;.972;3600000;0
8393;196414;118;44;17;3;14;.824;2676000;0
8393;191026;118;27;12;4;8;.667;924000;0
8393;191687;124;0;0;0;0;.00nan;0;0
8394;192776;119;0;0;0;0;.00nan;0;0
8394;195017;119;50;38;5;33;.868;3600000;0
8394;191125;123;57;19;2;17;.895;3600000;0
8394;-1;123;0;0;0;0;.00nan;0;0
8395;187537;117;0;0;0;0;.00nan;0;0
8395;203412;117;79;34;3;31;.912;3600000;0
8395;196324;110;69;40;5;35;.875;3582000;0
8395;191141;110;0;0;0;0;.00nan;0;0
8396;187699;114;83;46;4;42;.913;3711000;0
8396;188911;115;47;18;3;15;.833;3711000;0
8396;202180;114;0;0;0;0;.00nan;0;0
8396;191698;115;0;0;0;0;.00nan;0;0
8397;201631;109;0;0;0;0;.00nan;0;0
8397;207493;121;0;0;0;0;.00nan;0;0
8397;197038;109;83;29;1;28;.966;3600000;0
8397;192645;121;59;44;5;39;.886;3600000;0
8398;188911;115;0;0;0;0;.00nan;0;0
8398;-1;113;0;0;0;0;.00nan;0;0
8398;191698;115;53;29;4;25;.862;3544000;0
8398;191709;113;57;26;3;23;.885;3600000;0
8399;199481;122;0;0;0;0;.00nan;0;0
8399;191125;123;0;0;0;0;.00nan;0;0
8399;-1;123;80;23;2;21;.913;3590000;0
8399;191692;122;92;32;1;31;.969;3600000;0
8400;187550;111;24;18;5;13;.722;1506000;0
8400;193687;120;73;24;1;23;.958;3600000;0
8400;200390;120;0;0;0;0;.00nan;0;0
8400;197912;111;12;17;6;11;.647;2094000;0
8401;195001;126;21;26;6;20;.769;2357000;0
8401;202314;127;28;8;3;5;.625;551000;0
8401;191171;127;34;33;7;26;.788;3049000;0
8401;192564;126;70;8;0;8;1.000;1243000;0
8402;188888;116;78;32;2;30;.938;3600000;0
8402;200514;116;0;0;0;0;.00nan;0;0
8402;195111;125;55;41;6;35;.854;3600000;0
8402;191813;125;0;0;0;0;.00nan;0;0
8403;192776;119;30;11;3;8;.727;408000;0
8403;189008;108;0;0;0;0;.00nan;0;0
8403;195017;119;63;33;3;30;.909;3192000;0
8403;196372;108;87;30;1;29;.967;3600000;0
8404;201631;109;0;0;0;0;.00nan;0;0
8404;196324;110;0;0;0;0;.00nan;0;0
8404;191141;110;30;27;6;21;.778;3600000;0
8404;197038;109;93;43;3;40;.930;3600000;0
8405;187699;114;68;40;4;36;.900;3600000;0
8405;189008;108;43;27;5;22;.815;2367000;0
8405;196372;108;53;3;0;3;1.000;1187000;0
8405;202180;114;0;0;0;0;.00nan;0;0
8406;188888;116;92;32;1;31;.969;3600000;0
8406;188918;112;0;0;0;0;.00nan;0;0
8406;200514;116;0;0;0;0;.00nan;0;0
8406;202246;112;45;22;4;18;.818;3600000;0
8407;199481;122;0;0;0;0;.00nan;0;0
8407;196414;118;0;0;0;0;.00nan;0;0
8407;191026;118;87;50;4;46;.920;3859000;0
8407;191692;122;73;32;3;29;.906;3859000;0
8408;195089;124;66;44;4;40;.909;3900000;0
8408;191125;123;43;29;4;25;.862;3900000;0
8408;-1;123;0;0;0;0;.00nan;0;0
8408;191687;124;0;0;0;0;.00nan;0;0
8409;192776;119;33;14;4;10;.714;1136000;0
8409;193687;120;0;0;0;0;.00nan;0;0
8409;200390;120;85;38;3;35;.921;3600000;0
8409;195017;119;74;28;2;26;.929;2464000;0
8410;187537;117;71;32;4;28;.875;3600000;0
8410;203412;117;0;0;0;0;.00nan;0;0
8410;195001;126;46;5;1;4;.800;649000;0
8410;192564;126;32;38;7;31;.816;2951000;0
8411;187699;114;79;48;4;44;.917;3600000;0
8411;188888;116;0;0;0;0;.00nan;0;0
8411;200514;116;84;29;1;28;.966;3600000;0
8411;202180;114;0;0;0;0;.00nan;0;0
8412;195111;125;29;14;4;10;.714;964000;0
8412;-1;113;0;0;0;0;.00nan;0;0
8412;191709;113;66;31;3;28;.903;3600000;0
8412;191813;125;82;29;1;28;.966;2568000;0
8413;189008;108;0;0;0;0;.00nan;0;0
8413;201631;109;46;38;5;33;.868;3600000;0
8413;196372;108;86;34;2;32;.941;3600000;0
8413;197038;109;0;0;0;0;.00nan;0;0
8414;188918;112;0;0;0;0;.00nan;0;0
8414;196324;110;0;0;0;0;.00nan;0;0
8414;202246;112;76;26;2;24;.923;3600000;0
8414;191141;110;17;34;7;27;.794;3600000;0
8415;188911;115;61;19;2;17;.895;3600000;0
8415;201631;109;0;0;0;0;.00nan;0;0
8415;197038;109;33;47;8;39;.830;3600000;0
8415;191698;115;0;0;0;0;.00nan;0;0
8416;193687;120;53;24;4;20;.833;3584000;0
8416;200390;120;0;0;0;0;.00nan;0;0
8416;195089;124;81;44;3;41;.932;3600000;0
8416;191687;124;0;0;0;0;.00nan;0;0
8417;196414;118;54;20;3;17;.850;3560000;0
8417;202314;127;0;0;0;0;.00nan;0;0
8417;191026;118;0;0;0;0;.00nan;0;0
8417;191171;127;68;28;2;26;.929;3600000;0
8418;187537;117;70;17;1;16;.941;3600000;0
8418;203412;117;0;0;0;0;.00nan;0;0
8418;195111;125;40;32;5;27;.844;3600000;0
8418;191813;125;0;0;0;0;.00nan;0;0
8419;187550;111;0;0;0;0;.00nan;0;0
8419;191125;123;0;0;0;0;.00nan;0;0
8419;-1;123;77;43;4;39;.907;3552000;0
8419;197912;111;88;31;2;29;.935;3600000;0
8420;199481;122;0;0;0;0;.00nan;0;0
8420;195001;126;43;26;5;21;.808;3600000;0
8420;191692;122;76;41;4;37;.902;3600000;0
8420;192564;126;0;0;0;0;.00nan;0;0
8421;193687;120;0;0;0;0;.00nan;0;0
8421;200390;120;53;25;3;22;.880;3530000;0
8421;196414;118;0;0;0;0;.00nan;0;0
8421;191026;118;89;30;1;29;.967;3600000;0
8422;187550;111;58;14;1;13;.929;3600000;0
8422;195089;124;0;0;0;0;.00nan;0;0
8422;191687;124;88;49;3;46;.939;3600000;0
8422;197912;111;0;0;0;0;.00nan;0;0
8423;192776;119;95;24;0;24;1.000;3600000;0
8423;195017;119;0;0;0;0;.00nan;0;0
8423;207493;121;58;14;1;13;.929;1396000;0
8423;192645;121;17;26;6;20;.769;2204000;0
8424;188911;115;0;0;0;0;.00nan;0;0
8424;189008;108;0;0;0;0;.00nan;0;0
8424;196372;108;86;38;4;34;.895;3822000;0
8424;191698;115;70;32;3;29;.906;3822000;0
8425;199481;122;63;37;4;33;.892;3600000;0
8425;191125;123;90;32;1;31;.969;3600000;0
8425;-1;123;0;0;0;0;.00nan;0;0
8425;191692;122;0;0;0;0;.00nan;0;0
8426;195001;126;0;0;0;0;.00nan;0;0
8426;195111;125;0;0;0;0;.00nan;0;0
8426;191813;125;89;37;2;35;.946;3600000;0
8426;192564;126;46;20;3;17;.850;3578000;0
8427;187699;114;77;37;3;34;.919;3600000;0
8427;202180;114;0;0;0;0;.00nan;0;0
8427;-1;113;0;0;0;0;.00nan;0;0
8427;191709;113;56;38;4;34;.895;3558000;0
8428;188888;116;79;36;2;34;.944;3600000;0
8428;200514;116;0;0;0;0;.00nan;0;0
8428;201631;109;58;40;6;34;.850;3316000;0
8428;197038;109;52;5;0;5;1.000;284000;0
8429;187537;117;22;29;7;22;.759;3077000;0
8429;203412;117;51;2;0;2;1.000;523000;0
8429;-1;113;92;47;3;44;.936;3600000;0
8429;191709;113;0;0;0;0;.00nan;0;0
8430;187550;111;0;0;0;0;.00nan;0;0
8430;202314;127;69;28;2;26;.929;3600000;0
8430;191171;127;0;0;0;0;.00nan;0;0
8430;197912;111;52;43;6;37;.860;3600000;0
8431;188918;112;34;25;5;20;.800;3600000;0
8431;189008;108;44;50;8;42;.840;3600000;0
8431;196372;108;0;0;0;0;.00nan;0;0
8431;202246;112;0;0;0;0;.00nan;0;0
8432;192776;119;60;47;5;42;.894;3600000;0
8432;195017;119;0;0;0;0;.00nan;0;0
8432;207493;121;75;28;2;26;.929;3600000;0
8432;192645;121;0;0;0;0;.00nan;0;0
8433;187699;114;39;37;6;31;.838;3120000;0
8433;196324;110;0;0;0;0;.00nan;0;0
8433;202180;114;48;0;0;0;.00nan;416000;0
8433;191141;110;61;30;4;26;.867;3600000;0
8434;187699;114;48;22;3;19;.864;3900000;0
8434;201631;109;0;0;0;0;.00nan;0;0
8434;202180;114;0;0;0;0;.00nan;0;0
8434;197038;109;100;44;3;41;.932;3900000;0
8435;188888;116;52;17;2;15;.882;3600000;0
8435;200514;116;0;0;0;0;.00nan;0;0
8435;196324;110;21;10;4;6;.600;1028000;0
8435;191141;110;52;24;3;21;.875;2572000;0
8436;195001;126;49;21;3;18;.857;3625000;0
8436;195089;124;62;23;2;21;.913;3625000;0
8436;191687;124;0;0;0;0;.00nan;0;0
8436;192564;126;0;0;0;0;.00nan;0;0
8437;196414;118;75;30;2;28;.933;2568000;0
8437;207493;121;0;0;0;0;.00nan;0;0
8437;191026;118;22;12;4;8;.667;983000;0
8437;192645;121;79;45;5;40;.889;3600000;0
8438;187550;111;31;24;5;19;.792;2562000;0
8438;189008;108;0;0;0;0;.00nan;0;0
8438;196372;108;64;37;4;33;.892;3600000;0
8438;197912;111;24;12;4;8;.667;1038000;0
8439;188888;116;0;0;0;0;.00nan;0;0
8439;200514;116;43;25;5;20;.800;3600000;0
8439;202314;127;61;7;0;7;1.000;1172000;0
8439;191171;127;10;17;6;11;.647;2372000;0
8440;187699;114;53;29;4;25;.862;3561000;0
8440;201631;109;83;37;2;35;.946;3600000;0
8440;202180;114;0;0;0;0;.00nan;0;0
8440;197038;109;0;0;0;0;.00nan;0;0
8441;188918;112;0;0;0;0;.00nan;0;0
8441;202246;112;86;28;1;27;.964;3600000;0
8441;-1;113;55;34;4;30;.882;3600000;0
8441;191709;113;0;0;0;0;.00nan;0;0
8442;188911;115;78;29;2;27;.931;3600000;0
8442;207493;121;17;30;7;23;.767;3093000;0
8442;191698;115;0;0;0;0;.00nan;0;0
8442;192645;121;47;9;1;8;.889;507000;0
8443;199481;122;0;0;0;0;.00nan;0;0
8443;195111;125;79;24;2;22;.917;3900000;0
8443;191692;122;94;39;2;37;.949;3900000;0
8443;191813;125;0;0;0;0;.00nan;0;0
8444;187550;111;0;0;0;0;.00nan;0;0
8444;189008;108;0;0;0;0;.00nan;0;0
8444;196372;108;83;34;2;32;.941;3600000;0
8444;197912;111;82;43;4;39;.907;3514000;0
8445;188888;116;81;28;1;27;.964;3571000;0
8445;188911;115;0;0;0;0;.00nan;0;0
8445;200514;116;0;0;0;0;.00nan;0;0
8445;191698;115;97;26;0;26;1.000;3600000;0
8446;192776;119;67;8;0;8;1.000;414000;0
8446;193687;120;68;21;2;19;.905;3600000;0
8446;200390;120;0;0;0;0;.00nan;0;0
8446;195017;119;52;40;6;34;.850;3186000;0
8447;195001;126;0;0;0;0;.00nan;0;0
8447;196414;118;73;40;4;36;.900;3569000;0
8447;191026;118;0;0;0;0;.00nan;0;0
8447;192564;126;59;17;2;15;.882;3600000;0
8448;187537;117;49;31;5;26;.839;3579000;0
8448;203412;117;0;0;0;0;.00nan;0;0
8448;196324;110;52;25;3;22;.880;3600000;0
8448;191141;110;0;0;0;0;.00nan;0;0
8449;195089;124;10;23;7;16;.696;3600000;0
8449;202314;127;0;0;0;0;.00nan;0;0
8449;191171;127;85;43;3;40;.930;3600000;0
8449;191687;124;0;0;0;0;.00nan;0;0
8450;199481;122;49;37;5;32;.865;3600000;0
8450;191125;123;0;0;0;0;.00nan;0;0
8450;-1;123;46;17;3;14;.824;3600000;0
8450;191692;122;0;0;0;0;.00nan;0;0
8451;188918;112;0;0;0;0;.00nan;0;0
8451;201631;109;0;0;0;0;.00nan;0;0
8451;202246;112;47;27;4;23;.852;3600000;0
8451;197038;109;53;44;6;38;.864;3566000;0
8452;195089;124;0;0;0;0;.00nan;0;0
8452;195111;125;0;0;0;0;.00nan;0;0
8452;191687;124;87;48;3;45;.938;3600000;0
8452;191813;125;42;20;4;16;.800;3589000;0
8453;207493;121;0;0;0;0;.00nan;0;0
8453;191125;123;72;24;2;22;.917;3591000;0
8453;-1;123;0;0;0;0;.00nan;0;0
8453;192645;121;92;27;1;26;.963;3600000;0
8454;192776;119;23;27;6;21;.778;2528000;0
8454;195001;126;68;41;4;37;.902;3600000;0
8454;195017;119;45;13;2;11;.846;1072000;0
8454;192564;126;0;0;0;0;.00nan;0;0
8455;189008;108;48;48;6;42;.875;3359000;0
8455;196372;108;44;4;1;3;.750;241000;0
8455;-1;113;0;0;0;0;.00nan;0;0
8455;191709;113;53;33;5;28;.848;3600000;0
8456;187537;117;0;0;0;0;.00nan;0;0
8456;203412;117;60;33;4;29;.879;3571000;0
8456;187699;114;0;0;0;0;.00nan;0;0
8456;202180;114;66;27;2;25;.926;3600000;0
8457;188888;116;51;39;6;33;.846;3600000;0
8457;188918;112;57;24;3;21;.875;3600000;0
8457;200514;116;0;0;0;0;.00nan;0;0
8457;202246;112;0;0;0;0;.00nan;0;0
8458;187550;111;0;0;0;0;.00nan;0;0
8458;-1;113;100;28;0;28;1.000;3600000;0
8458;191709;113;0;0;0;0;.00nan;0;0
8458;197912;111;81;42;3;39;.929;3600000;0
8459;187699;114;65;32;4;28;.875;3600000;0
8459;188911;115;0;0;0;0;.00nan;0;0
8459;202180;114;0;0;0;0;.00nan;0;0
8459;191698;115;79;24;1;23;.958;3600000;0
8460;193687;120;71;22;2;20;.909;3900000;0
8460;199481;122;0;0;0;0;.00nan;0;0
8460;200390;120;0;0;0;0;.00nan;0;0
8460;191692;122;97;46;2;44;.957;3900000;0
8461;192776;119;0;0;0;0;.00nan;0;0
8461;187537;117;63;29;3;26;.897;3900000;0
8461;203412;117;0;0;0;0;.00nan;0;0
8461;195017;119;71;30;3;27;.900;3900000;0
8462;195111;125;78;32;3;29;.906;3628000;0
8462;196414;118;0;0;0;0;.00nan;0;0
8462;191026;118;80;31;2;29;.935;3628000;0
8462;191813;125;0;0;0;0;.00nan;0;0
8463;196324;110;0;0;0;0;.00nan;0;0
8463;202314;127;96;51;2;49;.961;3900000;0
8463;191141;110;65;21;2;19;.905;3900000;0
8463;191171;127;0;0;0;0;.00nan;0;0
8464;193687;120;0;0;0;0;.00nan;0;0
8464;199481;122;0;0;0;0;.00nan;0;0
8464;200390;120;89;19;0;19;1.000;3600000;0
8464;191692;122;45;41;6;35;.854;3600000;0
8465;188911;115;0;0;0;0;.00nan;0;0
8465;188918;112;0;0;0;0;.00nan;0;0
8465;202246;112;75;28;2;26;.929;3600000;0
8465;191698;115;28;34;6;28;.824;3600000;0
8466;187699;114;94;37;2;35;.946;3600000;0
8466;202180;114;0;0;0;0;.00nan;0;0
8466;-1;113;59;42;5;37;.881;3600000;0
8466;191709;113;0;0;0;0;.00nan;0;0
8467;195089;124;62;30;3;27;.900;3600000;0
8467;207493;121;0;0;0;0;.00nan;0;0
8467;191687;124;0;0;0;0;.00nan;0;0
8467;192645;121;72;30;2;28;.933;3600000;0
8468;195001;126;0;0;0;0;.00nan;0;0
8468;202314;127;0;0;0;0;.00nan;0;0
8468;191171;127;100;34;0;34;1.000;3600000;0
8468;192564;126;39;21;4;17;.810;3600000;0
8469;188888;116;45;27;4;23;.852;3545000;0
8469;188911;115;61;28;3;25;.893;3600000;0
8469;200514;116;0;0;0;0;.00nan;0;0
8469;191698;115;0;0;0;0;.00nan;0;0
8470;192776;119;67;27;2;25;.926;3600000;0
8470;199481;122;0;0;0;0;.00nan;0;0
8470;195017;119;0;0;0;0;.00nan;0;0
8470;191692;122;65;31;3;28;.903;3600000;0
8471;189008;108;0;0;0;0;.00nan;0;0
8471;201631;109;73;30;1;29;.967;3900000;0
8471;196372;108;100;37;1;36;.973;3900000;0
8471;197038;109;0;0;0;0;.00nan;0;0
8472;195111;125;0;0;0;0;.00nan;0;0
8472;207493;121;32;29;5;24;.828;3563000;0
8472;191813;125;62;29;3;26;.897;3600000;0
8472;192645;121;0;0;0;0;.00nan;0;0
8473;187550;111;0;0;0;0;.00nan;0;0
8473;201631;109;89;38;2;36;.947;3561000;0
8473;197038;109;28;6;3;3;.500;339000;0
8473;197912;111;46;34;5;29;.853;3900000;0
8474;188888;116;0;0;0;0;.00nan;0;0
8474;200514;116;91;35;1;34;.971;3600000;0
8474;-1;113;56;5;0;5;1.000;720000;0
8474;191709;113;25;31;7;24;.774;2880000;0
8475;193687;120;0;0;0;0;.00nan;0;0
8475;200390;120;72;41;4;37;.902;3600000;0
8475;196324;110;78;22;1;21;.955;3600000;0
8475;191141;110;0;0;0;0;.00nan;0;0
8476;195111;125;62;31;4;27;.871;3600000;0
8476;196414;118;41;33;5;28;.848;3557000;0
8476;191026;118;0;0;0;0;.00nan;0;0
8476;191813;125;0;0;0;0;.00nan;0;0
8477;187537;117;64;30;3;27;.900;3552000;0
8477;203412;117;0;0;0;0;.00nan;0;0
8477;187699;114;85;31;1;30;.968;3600000;0
8477;202180;114;0;0;0;0;.00nan;0;0
8478;202314;127;0;0;0;0;.00nan;0;0
8478;191125;123;58;24;2;22;.917;3600000;0
8478;191171;127;85;45;4;41;.911;3570000;0
8478;-1;123;0;0;0;0;.00nan;0;0
8479;195001;126;73;24;1;23;.958;3900000;0
8479;195089;124;80;31;1;30;.968;3900000;0
8479;191687;124;0;0;0;0;.00nan;0;0
8479;192564;126;0;0;0;0;.00nan;0;0
8480;192776;119;0;0;0;0;.00nan;0;0
8480;199481;122;0;0;0;0;.00nan;0;0
8480;195017;119;34;29;5;24;.828;3600000;0
8480;191692;122;91;44;2;42;.955;3600000;0
8481;187550;111;59;36;4;32;.889;3549000;0
8481;188918;112;0;0;0;0;.00nan;0;0
8481;202246;112;85;32;2;30;.938;3600000;0
8481;197912;111;0;0;0;0;.00nan;0;0
8482;187537;117;0;0;0;0;.00nan;0;0
8482;203412;117;49;34;5;29;.853;3587000;0
8482;188911;115;64;34;4;30;.882;3600000;0
8482;191698;115;0;0;0;0;.00nan;0;0
8483;195089;124;0;0;0;0;.00nan;0;0
8483;202314;127;32;31;5;26;.839;3517000;0
8483;191171;127;0;0;0;0;.00nan;0;0
8483;191687;124;53;23;3;20;.870;3600000;0
8484;193687;120;84;40;3;37;.925;3600000;0
8484;200390;120;0;0;0;0;.00nan;0;0
8484;207493;121;0;0;0;0;.00nan;0;0
8484;192645;121;25;31;6;25;.806;3600000;0
8485;195111;125;60;7;0;7;1.000;754000;0
8485;191125;123;0;0;0;0;.00nan;0;0
8485;-1;123;53;27;4;23;.852;3600000;0
8485;191813;125;22;27;7;20;.741;2846000;0
8486;187699;114;64;33;4;29;.879;3828000;0
8486;189008;108;0;0;0;0;.00nan;0;0
8486;196372;108;82;39;3;36;.923;3828000;0
8486;202180;114;0;0;0;0;.00nan;0;0
8487;188918;112;46;36;5;31;.861;3900000;0
8487;201631;109;87;48;5;43;.896;3900000;0
8487;202246;112;0;0;0;0;.00nan;0;0
8487;197038;109;0;0;0;0;.00nan;0;0
8488;189008;108;80;30;2;28;.933;3600000;0
8488;196372;108;0;0;0;0;.00nan;0;0
8488;-1;113;72;35;3;32;.914;3600000;0
8488;191709;113;0;0;0;0;.00nan;0;0
8489;195001;126;0;0;0;0;.00nan;0;0
8489;191125;123;79;34;3;31;.912;3600000;0
8489;-1;123;0;0;0;0;.00nan;0;0
8489;192564;126;63;35;4;31;.886;3544000;0
8490;199481;122;0;0;0;0;.00nan;0;0
8490;196414;118;0;0;0;0;.00nan;0;0
8490;191026;118;100;24;0;24;1.000;3600000;0
8490;191692;122;97;40;2;38;.950;3521000;0
8491;187537;117;97;42;3;39;.929;3600000;0
8491;203412;117;0;0;0;0;.00nan;0;0
8491;196324;110;34;25;5;20;.800;3252000;0
8491;191141;110;24;5;3;2;.400;348000;0
8493;189008;108;0;0;0;0;.00nan;0;0
8493;196372;108;33;17;4;13;.765;3600000;0
8493;207493;121;48;38;5;33;.868;3587000;0
8493;192645;121;0;0;0;0;.00nan;0;0
8495;192776;119;47;34;5;29;.853;3900000;0
8495;195017;119;0;0;0;0;.00nan;0;0
8495;195089;124;43;33;5;28;.848;3900000;0
8495;191687;124;0;0;0;0;.00nan;0;0
8497;201631;109;0;0;0;0;.00nan;0;0
8497;202314;127;25;26;6;20;.769;3600000;0
8497;191171;127;0;0;0;0;.00nan;0;0
8497;197038;109;76;22;1;21;.955;3600000;0
8499;187537;117;76;25;1;24;.960;3600000;0
8499;187550;111;76;34;3;31;.912;3532000;0
8499;189783;117;0;0;0;0;.00nan;0;0
8499;197912;111;0;0;0;0;.00nan;0;0
8501;193687;120;60;28;3;25;.893;3600000;0
8501;188918;112;0;0;0;0;.00nan;0;0
8501;189734;120;0;0;0;0;.00nan;0;0
8501;202246;112;39;24;4;20;.833;3558000;0
8503;188888;116;91;19;0;19;1.000;3600000;0
8503;200514;116;0;0;0;0;.00nan;0;0
8503;195111;125;24;30;7;23;.767;3294000;0
8503;191813;125;48;0;0;0;.00nan;306000;0
8505;187699;114;42;22;4;18;.818;3600000;0
8505;195001;126;25;33;6;27;.818;3339000;0
8505;202180;114;0;0;0;0;.00nan;0;0
8505;192564;126;48;0;0;0;.00nan;205000;0
8507;188911;115;0;0;0;0;.00nan;0;0
8507;191125;123;64;43;5;38;.884;3600000;0
8507;-1;123;0;0;0;0;.00nan;0;0
8507;191698;115;34;27;6;21;.778;3543000;0
8509;199481;122;0;0;0;0;.00nan;0;0
8509;-1;113;0;0;0;0;.00nan;0;0
8509;191692;122;85;29;1;28;.966;3600000;0
8509;191709;113;52;24;3;21;.875;3521000;0
8511;198141;110;0;0;0;0;.00nan;0;0
8511;196324;110;54;20;2;18;.900;3600000;0
8511;196414;118;80;46;4;42;.913;3557000;0
8511;191026;118;0;0;0;0;.00nan;0;0
8513;195111;125;0;0;0;0;.00nan;0;0
8513;196414;118;0;0;0;0;.00nan;0;0
8513;191026;118;51;40;6;34;.850;3632000;0
8513;191813;125;49;30;5;25;.833;3646000;0
8515;187537;117;0;0;0;0;.00nan;0;0
8515;189783;117;82;39;2;37;.949;3600000;0
8515;207493;121;0;0;0;0;.00nan;0;0
8515;192645;121;46;22;4;18;.818;3591000;0
8517;188888;116;75;32;3;29;.906;3600000;0
8517;200514;116;0;0;0;0;.00nan;0;0
8517;201631;109;74;39;4;35;.897;3555000;0
8517;197038;109;0;0;0;0;.00nan;0;0
8519;188911;115;24;27;6;21;.778;3579000;0
8519;202314;127;0;0;0;0;.00nan;0;0
8519;191171;127;64;45;5;40;.889;3600000;0
8519;191698;115;0;0;0;0;.00nan;0;0
8521;193687;120;0;0;0;0;.00nan;0;0
8521;189734;120;60;26;2;24;.923;3549000;0
8521;-1;113;85;28;1;27;.964;3600000;0
8521;191709;113;0;0;0;0;.00nan;0;0
8523;187550;111;0;0;0;0;.00nan;0;0
8523;195089;124;0;0;0;0;.00nan;0;0
8523;191687;124;76;31;2;29;.935;3600000;0
8523;197912;111;58;29;3;26;.897;3557000;0
8525;192776;119;35;13;3;10;.769;1387000;0
8525;195017;119;32;29;6;23;.793;2213000;0
8525;191125;123;0;0;0;0;.00nan;0;0
8525;-1;123;68;19;1;18;.947;3600000;0
8527;187699;114;0;0;0;0;.00nan;0;0
8527;195001;126;0;0;0;0;.00nan;0;0
8527;202180;114;69;44;4;40;.909;3600000;0
8527;192564;126;98;24;0;24;1.000;3600000;0
8529;198141;110;60;30;3;27;.900;3600000;0
8529;199481;122;48;29;5;24;.828;2367000;0
8529;196324;110;0;0;0;0;.00nan;0;0
8529;191692;122;38;16;3;13;.813;1233000;0
8531;188918;112;39;35;6;29;.829;3551000;0
8531;189008;108;50;26;4;22;.846;3600000;0
8531;196372;108;0;0;0;0;.00nan;0;0
8531;202246;112;0;0;0;0;.00nan;0;0
8533;187537;117;26;28;6;22;.786;3250000;0
8533;189783;117;49;1;0;1;1.000;301000;0
8533;191125;123;51;29;4;25;.862;3600000;0
8533;-1;123;0;0;0;0;.00nan;0;0
8535;195001;126;51;19;3;16;.842;3600000;0
8535;207493;121;55;5;0;5;1.000;613000;0
8535;192564;126;0;0;0;0;.00nan;0;0
8535;192645;121;55;46;6;40;.870;2987000;0
8537;188888;116;0;0;0;0;.00nan;0;0
8537;189008;108;0;0;0;0;.00nan;0;0
8537;200514;116;74;25;1;24;.960;3600000;0
8537;196372;108;33;34;6;28;.824;3600000;0
8539;193687;120;77;33;3;30;.909;3600000;0
8539;188918;112;0;0;0;0;.00nan;0;0
8539;189734;120;0;0;0;0;.00nan;0;0
8539;202246;112;50;26;4;22;.846;3563000;0
8541;195111;125;60;29;3;26;.897;3544000;0
8541;196414;118;73;26;2;24;.923;3600000;0
8541;191026;118;0;0;0;0;.00nan;0;0
8541;191813;125;0;0;0;0;.00nan;0;0
8543;187699;114;68;27;2;25;.926;3573000;0
8543;201631;109;0;0;0;0;.00nan;0;0
8543;202180;114;0;0;0;0;.00nan;0;0
8543;197038;109;73;23;1;22;.957;3600000;0
8545;202314;127;53;6;1;5;.833;1378000;0
8545;-1;113;0;0;0;0;.00nan;0;0
8545;191171;127;29;31;6;25;.806;2222000;0
8545;191709;113;92;29;1;28;.966;3600000;0
8547;192776;119;58;19;2;17;.895;3552000;0
8547;195017;119;0;0;0;0;.00nan;0;0
8547;195089;124;82;29;1;28;.966;3600000;0
8547;191687;124;0;0;0;0;.00nan;0;0
8549;198141;110;0;0;0;0;.00nan;0;0
8549;199481;122;0;0;0;0;.00nan;0;0
8549;196324;110;88;18;1;17;.944;3600000;0
8549;191692;122;39;21;4;17;.810;3600000;0
8551;187550;111;92;21;0;21;1.000;3600000;0
8551;188911;115;72;20;1;19;.950;3571000;0
8551;191698;115;0;0;0;0;.00nan;0;0
8551;197912;111;0;0;0;0;.00nan;0;0
8553;188918;112;27;28;6;22;.786;3600000;0
8553;202246;112;0;0;0;0;.00nan;0;0
8553;202314;127;0;0;0;0;.00nan;0;0
8553;191171;127;35;41;7;34;.829;3583000;0
8555;195001;126;0;0;0;0;.00nan;0;0
8555;207493;121;25;38;7;31;.816;2781000;0
8555;192564;126;47;28;4;24;.857;3600000;0
8555;192645;121;47;6;1;5;.833;819000;0
8557;195089;124;0;0;0;0;.00nan;0;0
8557;196414;118;0;0;0;0;.00nan;0;0
8557;191026;118;61;21;2;19;.905;3600000;0
8557;191687;124;65;34;3;31;.912;3600000;0
8559;198141;110;44;19;3;16;.842;3600000;0
8559;195111;125;0;0;0;0;.00nan;0;0
8559;196324;110;0;0;0;0;.00nan;0;0
8559;191813;125;40;27;5;22;.815;3537000;0
8561;199481;122;60;34;4;30;.882;3587000;0
8561;189008;108;81;25;2;23;.920;3600000;0
8561;196372;108;0;0;0;0;.00nan;0;0
8561;191692;122;0;0;0;0;.00nan;0;0
8563;187550;111;48;36;6;30;.833;3177000;0
8563;191125;123;0;0;0;0;.00nan;0;0
8563;-1;123;87;18;0;18;1.000;3600000;0
8563;197912;111;50;1;0;1;1.000;423000;0
8565;187699;114;0;0;0;0;.00nan;0;0
8565;188911;115;0;0;0;0;.00nan;0;0
8565;202180;114;62;30;3;27;.900;3559000;0
8565;191698;115;53;18;2;16;.889;3600000;0
8567;188888;116;45;22;3;19;.864;3547000;0
8567;200514;116;0;0;0;0;.00nan;0;0
8567;201631;109;86;30;1;29;.967;3600000;0
8567;197038;109;0;0;0;0;.00nan;0;0
8569;192776;119;0;0;0;0;.00nan;0;0
8569;187537;117;0;0;0;0;.00nan;0;0
8569;195017;119;32;29;6;23;.793;3610000;0
8569;189783;117;26;22;5;17;.773;3610000;0
8571;193687;120;0;0;0;0;.00nan;0;0
8571;189734;120;49;29;4;25;.862;3627000;0
8571;-1;113;55;33;5;28;.848;3627000;0
8571;191709;113;0;0;0;0;.00nan;0;0
8573;187550;111;0;0;0;0;.00nan;0;0
8573;193687;120;71;32;2;30;.938;3520000;0
8573;189734;120;0;0;0;0;.00nan;0;0
8573;197912;111;95;24;0;24;1.000;3600000;0
8575;188911;115;0;0;0;0;.00nan;0;0
8575;191125;123;39;8;2;6;.750;511000;0
8575;-1;123;2;32;9;23;.719;3089000;0
8575;191698;115;85;25;1;24;.960;3600000;0
8577;189008;108;0;0;0;0;.00nan;0;0
8577;195089;124;71;31;3;28;.903;3600000;0
8577;196372;108;45;26;4;22;.846;3575000;0
8577;191687;124;0;0;0;0;.00nan;0;0
8579;192776;119;51;29;4;25;.862;3600000;0
8579;195017;119;0;0;0;0;.00nan;0;0
8579;196414;118;30;15;4;11;.733;1199000;0
8579;191026;118;47;23;4;19;.826;2401000;0
8581;199481;122;0;0;0;0;.00nan;0;0
8581;207493;121;77;23;1;22;.957;3600000;0
8581;191692;122;71;52;5;47;.904;3600000;0
8581;192645;121;0;0;0;0;.00nan;0;0
8583;188888;116;0;0;0;0;.00nan;0;0
8583;200514;116;41;14;3;11;.786;3820000;0
8583;195111;125;88;38;2;36;.947;3820000;0
8583;191813;125;0;0;0;0;.00nan;0;0
8585;201631;109;59;33;4;29;.879;3566000;0
8585;202314;127;65;32;3;29;.906;3600000;0
8585;191171;127;0;0;0;0;.00nan;0;0
8585;197038;109;0;0;0;0;.00nan;0;0
8587;187699;114;75;32;2;30;.938;3600000;0
8587;188918;112;0;0;0;0;.00nan;0;0
8587;202180;114;0;0;0;0;.00nan;0;0
8587;202246;112;54;24;3;21;.875;3600000;0
8589;195001;126;0;0;0;0;.00nan;0;0
8589;-1;113;0;0;0;0;.00nan;0;0
8589;191709;113;61;26;2;24;.923;3591000;0
8589;192564;126;66;17;1;16;.941;3600000;0
8591;187537;117;71;33;3;30;.909;3589000;0
8591;198141;110;0;0;0;0;.00nan;0;0
8591;189783;117;0;0;0;0;.00nan;0;0
8591;196324;110;53;18;2;16;.889;3600000;0
8593;207493;121;37;20;4;16;.800;1231000;0
8593;-1;113;30;31;6;25;.806;3600000;0
8593;191709;113;0;0;0;0;.00nan;0;0
8593;192645;121;25;17;5;12;.706;2369000;0
8595;187699;114;0;0;0;0;.00nan;0;0
8595;202180;114;65;46;5;41;.891;3561000;0
8595;191125;123;60;26;3;23;.885;3600000;0
8595;-1;123;0;0;0;0;.00nan;0;0
8597;199481;122;61;30;3;27;.900;3561000;0
8597;202314;127;0;0;0;0;.00nan;0;0
8597;191171;127;70;25;2;23;.920;3600000;0
8597;191692;122;0;0;0;0;.00nan;0;0
8599;189008;108;60;26;3;23;.885;3600000;0
8599;196372;108;0;0;0;0;.00nan;0;0
8599;196414;118;90;34;1;33;.971;3600000;0
8599;191026;118;0;0;0;0;.00nan;0;0
8601;187537;117;0;0;0;0;.00nan;0;0
8601;195111;125;0;0;0;0;.00nan;0;0
8601;189783;117;64;27;3;24;.889;3600000;0
8601;191813;125;53;31;4;27;.871;3600000;0
8603;192776;119;0;0;0;0;.00nan;0;0
8603;193687;120;0;0;0;0;.00nan;0;0
8603;195017;119;98;42;2;40;.952;3900000;0
8603;189734;120;69;26;2;24;.923;3900000;0
8605;198141;110;78;38;2;36;.947;3600000;0
8605;188918;112;46;25;4;21;.840;3527000;0
8605;196324;110;0;0;0;0;.00nan;0;0
8605;202246;112;0;0;0;0;.00nan;0;0
8607;195001;126;61;15;1;14;.933;3600000;0
8607;195089;124;0;0;0;0;.00nan;0;0
8607;191687;124;57;35;4;31;.886;3600000;0
8607;192564;126;0;0;0;0;.00nan;0;0
8609;188888;116;38;28;5;23;.821;3600000;0
8609;200514;116;0;0;0;0;.00nan;0;0
8609;201631;109;0;0;0;0;.00nan;0;0
8609;197038;109;100;26;0;26;1.000;3600000;0
8611;187550;111;0;0;0;0;.00nan;0;0
8611;188911;115;42;20;4;16;.800;3542000;0
8611;191698;115;0;0;0;0;.00nan;0;0
8611;197912;111;72;26;2;24;.923;3600000;0
8613;195089;124;21;30;7;23;.767;2751000;0
8613;202314;127;66;28;3;25;.893;3600000;0
8613;191171;127;0;0;0;0;.00nan;0;0
8613;191687;124;23;4;3;1;.250;849000;0
8615;199481;122;0;0;0;0;.00nan;0;0
8615;207493;121;0;0;0;0;.00nan;0;0
8615;191692;122;51;23;3;20;.870;3600000;0
8615;192645;121;59;39;4;35;.897;3568000;0
8617;192776;119;57;34;4;30;.882;3563000;0
8617;189008;108;0;0;0;0;.00nan;0;0
8617;195017;119;0;0;0;0;.00nan;0;0
8617;196372;108;65;24;3;21;.875;3600000;0
8619;187699;114;55;35;4;31;.886;3600000;0
8619;188911;115;49;15;2;13;.867;3600000;0
8619;202180;114;0;0;0;0;.00nan;0;0
8619;191698;115;0;0;0;0;.00nan;0;0
8621;193687;120;58;24;3;21;.875;3600000;0
8621;188888;116;54;10;1;9;.900;749000;0
8621;200514;116;23;28;7;21;.750;2851000;0
8621;189734;120;0;0;0;0;.00nan;0;0
8623;187537;117;19;7;4;3;.429;597000;0
8623;195001;126;0;0;0;0;.00nan;0;0
8623;189783;117;56;20;2;18;.900;2986000;0
8623;192564;126;38;23;5;18;.783;3600000;0
8625;195111;125;60;49;5;44;.898;3900000;0
8625;191125;123;42;31;5;26;.839;3900000;0
8625;-1;123;0;0;0;0;.00nan;0;0
8625;191813;125;0;0;0;0;.00nan;0;0
8627;198141;110;0;0;0;0;.00nan;0;0
8627;201631;109;0;0;0;0;.00nan;0;0
8627;196324;110;73;19;1;18;.947;3600000;0
8627;197038;109;98;53;3;50;.943;3547000;0
8629;196414;118;95;38;2;36;.947;3900000;0
8629;-1;113;0;0;0;0;.00nan;0;0
8629;191026;118;0;0;0;0;.00nan;0;0
8629;191709;113;61;23;2;21;.913;3900000;0
8631;187550;111;56;29;4;25;.862;3600000;0
8631;188918;112;0;0;0;0;.00nan;0;0
8631;202246;112;68;14;1;13;.929;3600000;0
8631;197912;111;0;0;0;0;.00nan;0;0
807;187699;114;77;32;2;30;.938;3600000;0
807;188918;112;0;0;0;0;.00nan;0;0
807;202180;114;0;0;0;0;.00nan;0;0
807;202246;112;76;25;1;24;.960;3600000;0
808;188888;116;79;40;3;37;.925;3600000;0
808;188911;115;53;29;4;25;.862;3545000;0
808;200514;116;0;0;0;0;.00nan;0;0
808;191698;115;0;0;0;0;.00nan;0;0
809;201631;109;0;0;0;0;.00nan;0;0
809;196324;110;85;30;2;28;.933;3600000;0
809;191141;110;0;0;0;0;.00nan;0;0
809;197038;109;49;36;5;31;.861;3600000;0
810;187537;117;70;25;2;23;.920;3600000;0
810;203412;117;0;0;0;0;.00nan;0;0
810;189008;108;0;0;0;0;.00nan;0;0
810;196372;108;45;29;5;24;.828;3600000;0
811;195001;126;44;21;4;17;.810;3600000;0
811;195089;124;50;27;4;23;.852;1896000;0
811;191687;124;60;31;3;28;.903;1704000;0
811;192564;126;0;0;0;0;.00nan;0;0
812;193687;120;33;32;6;26;.813;3536000;0
812;200390;120;0;0;0;0;.00nan;0;0
812;196414;118;0;0;0;0;.00nan;0;0
812;191026;118;74;43;4;39;.907;3600000;0
813;195111;125;94;35;1;34;.971;3600000;0
813;202314;127;0;0;0;0;.00nan;0;0
813;191171;127;31;28;5;23;.821;3600000;0
813;191813;125;0;0;0;0;.00nan;0;0
814;192776;119;95;34;2;32;.941;3600000;0
814;195017;119;0;0;0;0;.00nan;0;0
814;191125;123;36;32;6;26;.813;3182000;0
814;-1;123;56;6;0;6;1.000;418000;0
815;187699;114;62;33;3;30;.909;3600000;0
815;188918;112;0;0;0;0;.00nan;0;0
815;202180;114;0;0;0;0;.00nan;0;0
815;202246;112;32;21;4;17;.810;3567000;0
816;188888;116;94;47;3;44;.936;3600000;0
816;188911;115;47;28;4;24;.857;3592000;0
816;200514;116;0;0;0;0;.00nan;0;0
816;191698;115;0;0;0;0;.00nan;0;0
817;201631;109;0;0;0;0;.00nan;0;0
817;196324;110;30;9;3;6;.667;501000;0
817;191141;110;38;21;4;17;.810;3085000;0
817;197038;109;66;47;5;42;.894;3600000;0
818;187537;117;69;24;2;22;.917;3600000;0
818;203412;117;0;0;0;0;.00nan;0;0
818;189008;108;0;0;0;0;.00nan;0;0
818;196372;108;59;27;3;24;.889;3558000;0
819;195001;126;86;27;1;26;.963;3600000;0
819;195089;124;33;32;6;26;.813;2187000;0
819;191687;124;48;13;2;11;.846;1413000;0
819;192564;126;0;0;0;0;.00nan;0;0
820;193687;120;55;28;4;24;.857;3588000;0
820;200390;120;0;0;0;0;.00nan;0;0
820;196414;118;0;0;0;0;.00nan;0;0
820;191026;118;82;43;3;40;.930;3600000;0
821;195111;125;80;29;1;28;.966;3600000;0
821;202314;127;0;0;0;0;.00nan;0;0
821;191171;127;58;34;3;31;.912;3581000;0
821;191813;125;0;0;0;0;.00nan;0;0
822;192776;119;25;26;6;20;.769;2991000;0
822;195017;119;52;3;0;3;1.000;609000;0
822;191125;123;66;27;2;25;.926;3600000;0
822;-1;123;0;0;0;0;.00nan;0;0
823;187699;114;26;5;3;2;.400;162000;0
823;188918;112;0;0;0;0;.00nan;0;0
823;202180;114;31;36;6;30;.833;3438000;0
823;202246;112;52;19;3;16;.842;3600000;0
824;188888;116;53;34;4;30;.882;3591000;0
824;188911;115;71;32;3;29;.906;3600000;0
824;200514;116;0;0;0;0;.00nan;0;0
824;191698;115;0;0;0;0;.00nan;0;0
825;201631;109;0;0;0;0;.00nan;0;0
825;196324;110;31;31;6;25;.806;3249000;0
825;191141;110;52;4;0;4;1.000;351000;0
825;197038;109;70;35;3;32;.914;3600000;0
826;187537;117;83;30;3;27;.900;3600000;0
826;203412;117;0;0;0;0;.00nan;0;0
826;189008;108;0;0;0;0;.00nan;0;0
826;196372;108;71;25;2;23;.920;3600000;0
827;195001;126;54;18;2;16;.889;3600000;0
827;195089;124;51;36;5;31;.861;3159000;0
827;191687;124;40;3;1;2;.667;441000;0
827;192564;126;0;0;0;0;.00nan;0;0
828;193687;120;60;18;2;16;.889;3600000;0
828;200390;120;0;0;0;0;.00nan;0;0
828;196414;118;56;6;0;6;1.000;290000;0
828;191026;118;45;39;6;33;.846;3310000;0
829;195111;125;76;30;2;28;.933;3600000;0
829;202314;127;0;0;0;0;.00nan;0;0
829;191171;127;51;42;5;37;.881;3600000;0
829;191813;125;0;0;0;0;.00nan;0;0
830;192776;119;66;50;6;44;.880;3600000;0
830;195017;119;0;0;0;0;.00nan;0;0
830;191125;123;75;25;1;24;.960;3600000;0
830;-1;123;0;0;0;0;.00nan;0;0
831;187699;114;63;31;3;28;.903;3600000;0
831;188918;112;0;0;0;0;.00nan;0;0
831;202180;114;0;0;0;0;.00nan;0;0
831;202246;112;50;27;4;23;.852;3577000;0
832;188888;116;100;32;0;32;1.000;3600000;0
832;188911;115;47;25;4;21;.840;3600000;0
832;200514;116;0;0;0;0;.00nan;0;0
832;191698;115;0;0;0;0;.00nan;0;0
833;201631;109;0;0;0;0;.00nan;0;0
833;196324;110;38;34;5;29;.853;3600000;0
833;191141;110;0;0;0;0;.00nan;0;0
833;197038;109;93;31;1;30;.968;3600000;0
834;187537;117;76;26;1;25;.962;3600000;0
834;203412;117;0;0;0;0;.00nan;0;0
834;189008;108;28;23;5;18;.783;2407000;0
834;196372;108;27;14;4;10;.714;1193000;0
835;195001;126;29;15;4;11;.733;3600000;0
835;195089;124;69;31;3;28;.903;3600000;0
835;191687;124;0;0;0;0;.00nan;0;0
835;192564;126;0;0;0;0;.00nan;0;0
836;193687;120;20;8;4;4;.500;850000;0
836;200390;120;84;21;1;20;.952;2750000;0
836;196414;118;52;3;0;3;1.000;238000;0
836;191026;118;64;47;6;41;.872;3342000;0
837;195111;125;56;32;3;29;.906;4776000;0
837;202314;127;0;0;0;0;.00nan;0;0
837;191171;127;94;44;2;42;.955;4776000;0
837;191813;125;0;0;0;0;.00nan;0;0
838;192776;119;86;33;1;32;.970;3600000;0
838;195017;119;0;0;0;0;.00nan;0;0
838;191125;123;62;35;4;31;.886;3600000;0
838;-1;123;0;0;0;0;.00nan;0;0
1009;187699;114;80;43;4;39;.907;3563000;0
1009;188918;112;0;0;0;0;.00nan;0;0
1009;202180;114;0;0;0;0;.00nan;0;0
1009;202246;112;66;29;3;26;.897;3600000;0
1010;188888;116;67;29;3;26;.897;3600000;0
1010;188911;115;70;23;2;21;.913;3600000;0
1010;200514;116;0;0;0;0;.00nan;0;0
1010;191698;115;0;0;0;0;.00nan;0;0
1011;201631;109;0;0;0;0;.00nan;0;0
1011;196324;110;76;31;2;29;.935;3600000;0
1011;191141;110;0;0;0;0;.00nan;0;0
1011;197038;109;51;29;4;25;.862;3600000;0
1012;187537;117;82;35;3;32;.914;3914000;0
1012;203412;117;0;0;0;0;.00nan;0;0
1012;189008;108;0;0;0;0;.00nan;0;0
1012;196372;108;70;25;2;23;.920;3914000;0
1013;195001;126;83;13;0;13;1.000;3600000;0
1013;195089;124;76;45;4;41;.911;3600000;0
1013;191687;124;0;0;0;0;.00nan;0;0
1013;192564;126;0;0;0;0;.00nan;0;0
1014;193687;120;33;4;2;2;.500;455000;0
1014;200390;120;44;39;6;33;.846;3145000;0
1014;196414;118;0;0;0;0;.00nan;0;0
1014;191026;118;63;27;3;24;.889;3600000;0
1015;195111;125;55;22;3;19;.864;3543000;0
1015;202314;127;0;0;0;0;.00nan;0;0
1015;191171;127;85;38;2;36;.947;3600000;0
1015;191813;125;0;0;0;0;.00nan;0;0
1016;192776;119;66;34;3;31;.912;3600000;0
1016;195017;119;0;0;0;0;.00nan;0;0
1016;191125;123;37;24;5;19;.792;3543000;0
1016;-1;123;0;0;0;0;.00nan;0;0
1055;187699;114;87;42;3;39;.929;3545000;0
1055;188918;112;0;0;0;0;.00nan;0;0
1055;202180;114;0;0;0;0;.00nan;0;0
1055;202246;112;67;23;2;21;.913;3600000;0
1056;188888;116;68;33;3;30;.909;3600000;0
1056;188911;115;35;19;4;15;.789;860000;0
1056;200514;116;0;0;0;0;.00nan;0;0
1056;191698;115;30;16;4;12;.750;2740000;0
1057;201631;109;0;0;0;0;.00nan;0;0
1057;196324;110;62;24;2;22;.917;3600000;0
1057;191141;110;0;0;0;0;.00nan;0;0
1057;197038;109;59;35;4;31;.886;3558000;0
1058;187537;117;50;27;3;24;.889;3600000;0
1058;203412;117;0;0;0;0;.00nan;0;0
1058;189008;108;0;0;0;0;.00nan;0;0
1058;196372;108;61;36;4;32;.889;3600000;0
1059;193687;120;54;28;4;24;.857;3600000;0
1059;200390;120;0;0;0;0;.00nan;0;0
1059;196414;118;0;0;0;0;.00nan;0;0
1059;191026;118;51;40;5;35;.875;3578000;0
1060;195111;125;27;21;5;16;.762;3600000;0
1060;202314;127;0;0;0;0;.00nan;0;0
1060;191171;127;96;34;1;33;.971;3600000;0
1060;191813;125;0;0;0;0;.00nan;0;0
1061;192776;119;69;47;4;43;.915;5319000;0
1061;195017;119;0;0;0;0;.00nan;0;0
1061;191125;123;43;34;5;29;.853;5319000;0
1061;-1;123;0;0;0;0;.00nan;0;0
1089;201631;109;0;0;0;0;.00nan;0;0
1089;196324;110;69;32;3;29;.906;3600000;0
1089;191141;110;0;0;0;0;.00nan;0;0
1089;197038;109;100;39;0;39;1.000;3600000;0
1090;193687;120;100;23;0;23;1.000;3600000;0
1090;200390;120;0;0;0;0;.00nan;0;0
1090;196414;118;0;0;0;0;.00nan;0;0
1090;191026;118;92;52;4;48;.923;3600000;0
1091;195111;125;39;29;5;24;.828;3696000;0
1091;202314;127;0;0;0;0;.00nan;0;0
1091;191171;127;52;28;4;24;.857;3747000;0
1091;191813;125;0;0;0;0;.00nan;0;0
1147;188888;116;54;22;3;19;.864;3600000;0
1147;188918;112;0;0;0;0;.00nan;0;0
1147;200514;116;0;0;0;0;.00nan;0;0
1147;202246;112;57;44;5;39;.886;3560000;0
1148;187537;117;48;37;6;31;.838;3600000;0
1148;203412;117;0;0;0;0;.00nan;0;0
1148;201631;109;0;0;0;0;.00nan;0;0
1148;197038;109;85;31;1;30;.968;3600000;0
1149;195001;126;83;15;0;15;1.000;3600000;0
1149;202314;127;0;0;0;0;.00nan;0;0
1149;191171;127;84;38;1;37;.974;3565000;0
1149;192564;126;0;0;0;0;.00nan;0;0
1150;192776;119;46;26;4;22;.846;3600000;0
1150;193687;120;33;25;5;20;.800;3559000;0
1150;200390;120;0;0;0;0;.00nan;0;0
1150;195017;119;0;0;0;0;.00nan;0;0
1151;188888;116;100;34;2;32;.941;3600000;0
1151;188918;112;0;0;0;0;.00nan;0;0
1151;200514;116;0;0;0;0;.00nan;0;0
1151;202246;112;64;36;5;31;.861;3600000;0
1152;187537;117;73;23;1;22;.957;3600000;0
1152;203412;117;0;0;0;0;.00nan;0;0
1152;201631;109;0;0;0;0;.00nan;0;0
1152;197038;109;61;32;4;28;.875;3600000;0
1153;195001;126;31;22;5;17;.773;3600000;0
1153;202314;127;22;19;5;14;.737;1759000;0
1153;191171;127;18;27;6;21;.778;1841000;0
1153;192564;126;0;0;0;0;.00nan;0;0
1154;192776;119;30;10;4;6;.600;670000;0
1154;193687;120;56;26;3;23;.885;3600000;0
1154;200390;120;0;0;0;0;.00nan;0;0
1154;195017;119;35;33;6;27;.818;2930000;0
1155;188888;116;43;22;4;18;.818;3544000;0
1155;188918;112;0;0;0;0;.00nan;0;0
1155;200514;116;0;0;0;0;.00nan;0;0
1155;202246;112;58;21;2;19;.905;3600000;0
1156;187537;117;90;24;1;23;.958;3600000;0
1156;203412;117;0;0;0;0;.00nan;0;0
1156;201631;109;0;0;0;0;.00nan;0;0
1156;197038;109;47;30;4;26;.867;3600000;0
1157;195001;126;49;15;2;13;.867;3600000;0
1157;202314;127;60;12;1;11;.917;976000;0
1157;191171;127;33;41;7;34;.829;2624000;0
1157;192564;126;0;0;0;0;.00nan;0;0
1158;192776;119;82;37;3;34;.919;3600000;0
1158;193687;120;44;24;4;20;.833;3598000;0
1158;200390;120;0;0;0;0;.00nan;0;0
1158;195017;119;0;0;0;0;.00nan;0;0
1159;188888;116;62;27;3;24;.889;3600000;0
1159;188918;112;0;0;0;0;.00nan;0;0
1159;200514;116;0;0;0;0;.00nan;0;0
1159;202246;112;69;41;4;37;.902;3544000;0
1160;187537;117;65;21;2;19;.905;4351000;0
1160;203412;117;0;0;0;0;.00nan;0;0
1160;201631;109;0;0;0;0;.00nan;0;0
1160;197038;109;85;51;3;48;.941;4351000;0
1161;195001;126;50;29;5;24;.828;3689000;0
1161;202314;127;0;0;0;0;.00nan;0;0
1161;191171;127;64;39;4;35;.897;3689000;0
1161;192564;126;0;0;0;0;.00nan;0;0
1162;192776;119;66;40;4;36;.900;3600000;0
1162;193687;120;65;17;1;16;.941;3600000;0
1162;200390;120;0;0;0;0;.00nan;0;0
1162;195017;119;0;0;0;0;.00nan;0;0
1373;188888;116;70;34;3;31;.912;3600000;0
1373;188918;112;0;0;0;0;.00nan;0;0
1373;200514;116;0;0;0;0;.00nan;0;0
1373;202246;112;100;32;1;31;.969;3600000;0
1375;195001;126;41;20;4;16;.800;3600000;0
1375;202314;127;0;0;0;0;.00nan;0;0
1375;191171;127;59;39;5;34;.872;3600000;0
1375;192564;126;0;0;0;0;.00nan;0;0
8632;189628;89;67;43;5;38;.884;3600000;0
8632;196495;87;42;36;6;30;.833;3565000;0
8632;-1;87;0;0;0;0;.00nan;0;0
8632;-1;89;0;0;0;0;.00nan;0;0
8633;189644;95;57;20;2;18;.900;3600000;0
8633;195346;95;0;0;0;0;.00nan;0;0
8633;-1;93;0;0;0;0;.00nan;0;0
8633;197675;93;45;25;4;21;.840;3558000;0
8634;192739;92;0;0;0;0;.00nan;0;0
8634;189576;97;66;45;5;40;.889;3600000;0
8634;190106;92;83;32;2;30;.938;3600000;0
8634;191331;97;0;0;0;0;.00nan;0;0
8635;194502;86;88;32;1;31;.969;3600000;0
8635;-1;90;66;35;3;32;.914;3564000;0
8635;-1;86;0;0;0;0;.00nan;0;0
8635;-1;90;0;0;0;0;.00nan;0;0
8636;189433;91;0;0;0;0;.00nan;0;0
8636;-1;96;66;28;2;26;.929;3900000;0
8636;-1;91;80;30;2;28;.933;3900000;0
8636;-1;96;0;0;0;0;.00nan;0;0
8637;192733;99;65;24;3;21;.875;3600000;0
8637;194531;99;0;0;0;0;.00nan;0;0
8637;189639;105;73;37;4;33;.892;3566000;0
8637;-1;105;0;0;0;0;.00nan;0;0
8638;194899;101;0;0;0;0;.00nan;0;0
8638;-1;94;71;27;2;25;.926;3600000;0
8638;-1;101;52;28;3;25;.893;3567000;0
8638;-1;94;0;0;0;0;.00nan;0;0
8639;192718;103;52;38;5;33;.868;3592000;0
8639;189439;107;54;33;4;29;.879;3600000;0
8639;189558;103;0;0;0;0;.00nan;0;0
8639;189581;107;0;0;0;0;.00nan;0;0
8640;197940;100;68;32;3;29;.906;3654000;0
8640;194632;102;60;33;4;29;.879;3654000;0
8640;189333;100;0;0;0;0;.00nan;0;0
8640;189573;102;0;0;0;0;.00nan;0;0
8641;189644;95;63;24;2;22;.917;3600000;0
8641;195346;95;0;0;0;0;.00nan;0;0
8641;-1;93;41;19;3;16;.842;3544000;0
8641;197675;93;0;0;0;0;.00nan;0;0
8642;194502;86;86;36;2;34;.944;3600000;0
8642;196495;87;58;33;4;29;.879;3584000;0
8642;-1;87;0;0;0;0;.00nan;0;0
8642;-1;86;0;0;0;0;.00nan;0;0
8643;194899;101;75;25;2;23;.920;3600000;0
8643;-1;94;0;0;0;0;.00nan;0;0
8643;-1;101;0;0;0;0;.00nan;0;0
8643;-1;94;59;29;4;25;.862;3528000;0
8644;189448;88;0;0;0;0;.00nan;0;0
8644;189628;89;56;43;5;38;.884;3600000;0
8644;-1;89;0;0;0;0;.00nan;0;0
8644;191318;88;88;22;1;21;.955;3600000;0
8645;192739;92;0;0;0;0;.00nan;0;0
8645;189576;97;52;18;2;16;.889;1940000;0
8645;190106;92;79;25;1;24;.960;3600000;0
8645;191331;97;36;22;5;17;.773;1660000;0
8646;189439;107;0;0;0;0;.00nan;0;0
8646;189581;107;68;38;4;34;.895;3797000;0
8646;190831;106;53;31;5;26;.839;3797000;0
8646;-1;106;0;0;0;0;.00nan;0;0
8647;189433;91;71;26;2;24;.923;3600000;0
8647;-1;96;36;36;6;30;.833;3600000;0
8647;-1;91;0;0;0;0;.00nan;0;0
8647;-1;96;0;0;0;0;.00nan;0;0
8648;194632;102;24;5;3;2;.400;359000;0
8648;194759;104;0;0;0;0;.00nan;0;0
8648;189573;102;48;24;3;21;.875;3233000;0
8648;191255;104;36;25;5;20;.800;3600000;0
8649;192718;103;0;0;0;0;.00nan;0;0
8649;189558;103;92;44;3;41;.932;3691000;0
8649;207118;98;0;0;0;0;.00nan;0;0
8649;-1;98;55;28;4;24;.857;3691000;0
8650;189448;88;68;28;3;25;.893;3600000;0
8650;-1;90;78;23;1;22;.957;3600000;0
8650;191318;88;0;0;0;0;.00nan;0;0
8650;-1;90;0;0;0;0;.00nan;0;0
8651;194759;104;0;0;0;0;.00nan;0;0
8651;189639;105;71;27;2;25;.926;3600000;0
8651;191255;104;61;24;3;21;.875;3545000;0
8651;-1;105;0;0;0;0;.00nan;0;0
8652;196495;87;0;0;0;0;.00nan;0;0
8652;-1;90;58;20;2;18;.900;3552000;0
8652;-1;87;97;22;0;22;1.000;3600000;0
8652;-1;90;0;0;0;0;.00nan;0;0
8653;194502;86;70;37;3;34;.919;3600000;0
8653;189628;89;38;34;6;28;.824;3600000;0
8653;-1;86;0;0;0;0;.00nan;0;0
8653;-1;89;0;0;0;0;.00nan;0;0
8654;194502;86;67;34;3;31;.912;3852000;0
8654;196495;87;60;23;2;21;.913;3852000;0
8654;-1;87;0;0;0;0;.00nan;0;0
8654;-1;86;0;0;0;0;.00nan;0;0
8655;189628;89;46;22;3;19;.864;3600000;0
8655;-1;90;69;52;5;47;.904;3569000;0
8655;-1;89;0;0;0;0;.00nan;0;0
8655;-1;90;0;0;0;0;.00nan;0;0
8656;189433;91;100;43;1;42;.977;3600000;0
8656;-1;93;0;0;0;0;.00nan;0;0
8656;-1;91;0;0;0;0;.00nan;0;0
8656;197675;93;62;22;2;20;.909;3560000;0
8657;189576;97;0;0;0;0;.00nan;0;0
8657;189644;95;49;25;4;21;.840;3600000;0
8657;195346;95;0;0;0;0;.00nan;0;0
8657;191331;97;90;38;2;36;.947;3600000;0
8658;192739;92;0;0;0;0;.00nan;0;0
8658;190106;92;76;40;4;36;.900;3582000;0
8658;-1;96;50;25;3;22;.880;3600000;0
8658;-1;96;0;0;0;0;.00nan;0;0
8659;197940;100;0;0;0;0;.00nan;0;0
8659;192733;99;74;30;2;28;.933;3600000;0
8659;194531;99;0;0;0;0;.00nan;0;0
8659;189333;100;29;19;4;15;.789;3545000;0
8660;194759;104;0;0;0;0;.00nan;0;0
8660;189439;107;0;0;0;0;.00nan;0;0
8660;189581;107;53;38;5;33;.868;3599000;0
8660;191255;104;54;26;4;22;.846;3600000;0
8661;194632;102;81;26;2;24;.923;3600000;0
8661;194899;101;37;41;7;34;.829;3600000;0
8661;189573;102;0;0;0;0;.00nan;0;0
8661;-1;101;0;0;0;0;.00nan;0;0
8662;189576;97;0;0;0;0;.00nan;0;0
8662;196495;87;0;0;0;0;.00nan;0;0
8662;-1;87;57;28;4;24;.857;3600000;0
8662;191331;97;93;35;1;34;.971;3600000;0
8663;189448;88;0;0;0;0;.00nan;0;0
8663;-1;93;74;33;3;30;.909;3783000;0
8663;191318;88;65;23;2;21;.913;3783000;0
8663;197675;93;0;0;0;0;.00nan;0;0
8664;194502;86;0;0;0;0;.00nan;0;0
8664;189628;89;0;0;0;0;.00nan;0;0
8664;-1;86;56;37;5;32;.865;3600000;0
8664;-1;89;68;32;3;29;.906;3600000;0
8665;192718;103;0;0;0;0;.00nan;0;0
8665;189558;103;62;38;5;33;.868;3568000;0
8665;190831;106;77;39;3;36;.923;3600000;0
8665;-1;106;0;0;0;0;.00nan;0;0
8666;189639;105;39;28;5;23;.821;3600000;0
8666;-1;94;0;0;0;0;.00nan;0;0
8666;-1;94;80;33;2;31;.939;3600000;0
8666;-1;105;0;0;0;0;.00nan;0;0
8667;192733;99;90;31;1;30;.968;3600000;0
8667;194531;99;0;0;0;0;.00nan;0;0
8667;194759;104;88;41;2;39;.951;3566000;0
8667;191255;104;0;0;0;0;.00nan;0;0
8668;194632;102;0;0;0;0;.00nan;0;0
8668;194899;101;91;35;2;33;.943;3600000;0
8668;189573;102;35;25;5;20;.800;3600000;0
8668;-1;101;0;0;0;0;.00nan;0;0
8669;189439;107;0;0;0;0;.00nan;0;0
8669;189581;107;31;21;5;16;.762;3600000;0
8669;207118;98;0;0;0;0;.00nan;0;0
8669;-1;98;99;26;0;26;1.000;3600000;0
8670;189448;88;40;38;6;32;.842;3600000;0
8670;189644;95;0;0;0;0;.00nan;0;0
8670;195346;95;54;22;3;19;.864;3600000;0
8670;191318;88;0;0;0;0;.00nan;0;0
8671;192739;92;0;0;0;0;.00nan;0;0
8671;190106;92;82;36;2;34;.944;3600000;0
8671;-1;96;68;41;4;37;.902;3575000;0
8671;-1;96;0;0;0;0;.00nan;0;0
8672;197940;100;0;0;0;0;.00nan;0;0
8672;189333;100;58;27;3;24;.889;3600000;0
8672;189439;107;71;39;4;35;.897;3600000;0
8672;189581;107;0;0;0;0;.00nan;0;0
8673;-1;90;0;0;0;0;.00nan;0;0
8673;-1;96;77;42;3;39;.929;3900000;0
8673;-1;90;82;34;3;31;.912;3861000;0
8673;-1;96;0;0;0;0;.00nan;0;0
8674;194899;101;0;0;0;0;.00nan;0;0
8674;207118;98;0;0;0;0;.00nan;0;0
8674;-1;98;80;35;2;33;.943;3600000;0
8674;-1;101;52;41;6;35;.854;3600000;0
8675;189576;97;0;0;0;0;.00nan;0;0
8675;196495;87;69;26;1;25;.962;3600000;0
8675;-1;87;0;0;0;0;.00nan;0;0
8675;191331;97;73;42;4;38;.905;3600000;0
8676;189628;89;61;47;5;42;.894;3600000;0
8676;-1;93;62;23;2;21;.913;3600000;0
8676;-1;89;0;0;0;0;.00nan;0;0
8676;197675;93;0;0;0;0;.00nan;0;0
8677;189448;88;0;0;0;0;.00nan;0;0
8677;-1;96;0;0;0;0;.00nan;0;0
8677;191318;88;100;24;0;24;1.000;3600000;0
8677;-1;96;59;29;3;26;.897;3600000;0
8678;194899;101;78;55;5;50;.909;3600000;0
8678;207118;98;0;0;0;0;.00nan;0;0
8678;-1;98;57;19;2;17;.895;3600000;0
8678;-1;101;0;0;0;0;.00nan;0;0
8679;192739;92;0;0;0;0;.00nan;0;0
8679;194502;86;96;36;1;35;.972;3560000;0
8679;190106;92;87;14;0;14;1.000;3600000;0
8679;-1;86;0;0;0;0;.00nan;0;0
8680;189433;91;59;31;5;26;.839;2350000;0
8680;-1;90;76;33;3;30;.909;3600000;0
8680;-1;91;43;11;2;9;.818;1250000;0
8680;-1;90;0;0;0;0;.00nan;0;0
8681;189576;97;26;22;5;17;.773;3900000;0
8681;-1;93;64;33;5;28;.848;3900000;0
8681;191331;97;0;0;0;0;.00nan;0;0
8681;197675;93;0;0;0;0;.00nan;0;0
8682;192733;99;75;36;2;34;.944;3600000;0
8682;194531;99;0;0;0;0;.00nan;0;0
8682;194632;102;30;23;5;18;.783;3600000;0
8682;189573;102;0;0;0;0;.00nan;0;0
8683;192718;103;51;35;4;31;.886;3546000;0
8683;194759;104;0;0;0;0;.00nan;0;0
8683;189558;103;0;0;0;0;.00nan;0;0
8683;191255;104;61;31;3;28;.903;3600000;0
8684;189439;107;0;0;0;0;.00nan;0;0
8684;194899;101;0;0;0;0;.00nan;0;0
8684;189581;107;68;17;1;16;.941;3777000;0
8684;-1;101;89;40;2;38;.950;3777000;0
8685;189639;105;66;27;3;24;.889;3600000;0
8685;190831;106;46;9;2;7;.778;933000;0
8685;-1;106;23;24;6;18;.750;2667000;0
8685;-1;105;0;0;0;0;.00nan;0;0
8686;189644;95;94;20;0;20;1.000;3600000;0
8686;195346;95;0;0;0;0;.00nan;0;0
8686;196495;87;0;0;0;0;.00nan;0;0
8686;-1;87;81;36;2;34;.944;3557000;0
8687;194502;86;0;0;0;0;.00nan;0;0
8687;-1;86;93;41;2;39;.951;3600000;0
8687;-1;93;0;0;0;0;.00nan;0;0
8687;197675;93;72;18;1;17;.944;3600000;0
8688;197940;100;0;0;0;0;.00nan;0;0
8688;192718;103;0;0;0;0;.00nan;0;0
8688;189333;100;58;30;3;27;.900;3600000;0
8688;189558;103;94;21;0;21;1.000;3600000;0
8689;189439;107;46;31;4;27;.871;3580000;0
8689;194899;101;64;31;3;28;.903;3600000;0
8689;189581;107;0;0;0;0;.00nan;0;0
8689;-1;101;0;0;0;0;.00nan;0;0
8690;192739;92;0;0;0;0;.00nan;0;0
8690;189433;91;0;0;0;0;.00nan;0;0
8690;190106;92;75;43;4;39;.907;3600000;0
8690;-1;91;44;29;5;24;.828;3600000;0
8691;189448;88;0;0;0;0;.00nan;0;0
8691;189628;89;41;35;6;29;.829;3600000;0
8691;-1;89;0;0;0;0;.00nan;0;0
8691;191318;88;68;27;2;25;.926;3600000;0
8692;-1;90;0;0;0;0;.00nan;0;0
8692;-1;96;70;26;2;24;.923;3544000;0
8692;-1;90;100;39;1;38;.974;3600000;0
8692;-1;96;0;0;0;0;.00nan;0;0
8693;194759;104;73;30;2;28;.933;3600000;0
8693;-1;94;64;43;4;39;.907;3515000;0
8693;-1;94;0;0;0;0;.00nan;0;0
8693;191255;104;0;0;0;0;.00nan;0;0
8694;189639;105;0;0;0;0;.00nan;0;0
8694;207118;98;92;45;3;42;.933;3600000;0
8694;-1;98;0;0;0;0;.00nan;0;0
8694;-1;105;52;41;5;36;.878;3542000;0
8695;192733;99;54;25;3;22;.880;3600000;0
8695;194531;99;0;0;0;0;.00nan;0;0
8695;189439;107;0;0;0;0;.00nan;0;0
8695;189581;107;82;39;4;35;.897;3600000;0
8696;194632;102;18;24;6;18;.750;2772000;0
8696;189573;102;51;4;0;4;1.000;828000;0
8696;207118;98;0;0;0;0;.00nan;0;0
8696;-1;98;100;42;1;41;.976;3600000;0
8697;192739;92;0;0;0;0;.00nan;0;0
8697;190106;92;98;36;1;35;.972;3600000;0
8697;-1;96;30;30;6;24;.800;3600000;0
8697;-1;96;0;0;0;0;.00nan;0;0
8698;194502;86;9;17;6;11;.647;2208000;0
8698;189644;95;84;33;2;31;.939;3600000;0
8698;195346;95;0;0;0;0;.00nan;0;0
8698;-1;86;28;15;4;11;.733;1392000;0
8699;192739;92;72;31;2;29;.935;3600000;0
8699;190106;92;0;0;0;0;.00nan;0;0
8699;196495;87;58;24;3;21;.875;3550000;0
8699;-1;87;0;0;0;0;.00nan;0;0
8700;189628;89;0;0;0;0;.00nan;0;0
8700;189644;95;0;0;0;0;.00nan;0;0
8700;195346;95;75;26;1;25;.962;3900000;0
8700;-1;89;93;40;1;39;.975;3900000;0
8701;194899;101;0;0;0;0;.00nan;0;0
8701;189576;97;0;0;0;0;.00nan;0;0
8701;-1;101;63;37;4;33;.892;3600000;0
8701;191331;97;96;41;2;39;.951;3600000;0
8702;192733;99;73;51;5;46;.902;3600000;0
8702;194531;99;0;0;0;0;.00nan;0;0
8702;189639;105;75;23;1;22;.957;3600000;0
8702;-1;105;0;0;0;0;.00nan;0;0
8703;192739;92;0;0;0;0;.00nan;0;0
8703;194502;86;46;25;4;21;.840;3551000;0
8703;190106;92;82;40;3;37;.925;3600000;0
8703;-1;86;0;0;0;0;.00nan;0;0
8704;189644;95;10;16;6;10;.625;3554000;0
8704;195346;95;0;0;0;0;.00nan;0;0
8704;-1;90;92;53;5;48;.906;3600000;0
8704;-1;90;0;0;0;0;.00nan;0;0
8705;189433;91;98;32;1;31;.969;3600000;0
8705;189628;89;29;17;4;13;.765;962000;0
8705;-1;89;62;34;4;30;.882;2638000;0
8705;-1;91;0;0;0;0;.00nan;0;0
8706;192718;103;0;0;0;0;.00nan;0;0
8706;192733;99;89;50;4;46;.920;3592000;0
8706;194531;99;0;0;0;0;.00nan;0;0
8706;189558;103;68;25;3;22;.880;3600000;0
8707;197940;100;46;29;5;24;.828;3600000;0
8707;189333;100;0;0;0;0;.00nan;0;0
8707;189576;97;52;2;0;2;1.000;241000;0
8707;191331;97;40;45;7;38;.844;3359000;0
8708;194899;101;52;36;4;32;.889;3528000;0
8708;207118;98;62;26;2;24;.923;3600000;0
8708;-1;98;0;0;0;0;.00nan;0;0
8708;-1;101;0;0;0;0;.00nan;0;0
8709;189439;107;41;41;7;34;.829;3600000;0
8709;189581;107;0;0;0;0;.00nan;0;0
8709;190831;106;75;34;3;31;.912;3600000;0
8709;-1;106;0;0;0;0;.00nan;0;0
8710;196495;87;57;24;3;21;.875;3600000;0
8710;-1;87;0;0;0;0;.00nan;0;0
8710;-1;94;44;40;6;34;.850;3120000;0
8710;-1;94;25;7;3;4;.571;480000;0
8711;194632;102;100;31;0;31;1.000;3600000;0
8711;194759;104;0;0;0;0;.00nan;0;0
8711;189573;102;0;0;0;0;.00nan;0;0
8711;191255;104;62;40;4;36;.900;3600000;0
8712;194502;86;0;0;0;0;.00nan;0;0
8712;-1;90;0;0;0;0;.00nan;0;0
8712;-1;86;86;40;2;38;.950;3900000;0
8712;-1;90;70;25;2;23;.920;3900000;0
8713;192739;92;62;26;2;24;.923;3600000;0
8713;189628;89;94;47;3;44;.936;3595000;0
8713;190106;92;0;0;0;0;.00nan;0;0
8713;-1;89;0;0;0;0;.00nan;0;0
8714;189448;88;0;0;0;0;.00nan;0;0
8714;189644;95;0;0;0;0;.00nan;0;0
8714;195346;95;91;46;4;42;.913;3900000;0
8714;191318;88;58;32;4;28;.875;3900000;0
8715;189639;105;73;28;2;26;.929;3600000;0
8715;196495;87;0;0;0;0;.00nan;0;0
8715;-1;87;43;24;4;20;.833;3600000;0
8715;-1;105;0;0;0;0;.00nan;0;0
8716;192733;99;0;0;0;0;.00nan;0;0
8716;194531;99;99;39;1;38;.974;3600000;0
8716;-1;94;0;0;0;0;.00nan;0;0
8716;-1;94;62;30;3;27;.900;3554000;0
8717;194632;102;51;21;3;18;.857;3559000;0
8717;189573;102;0;0;0;0;.00nan;0;0
8717;189576;97;90;38;1;37;.974;3600000;0
8717;191331;97;0;0;0;0;.00nan;0;0
8718;207118;98;0;0;0;0;.00nan;0;0
8718;-1;98;59;33;4;29;.879;3600000;0
8718;-1;93;100;28;0;28;1.000;3600000;0
8718;197675;93;0;0;0;0;.00nan;0;0
8719;189433;91;0;0;0;0;.00nan;0;0
8719;-1;96;76;29;2;27;.931;3588000;0
8719;-1;91;78;28;1;27;.964;3600000;0
8719;-1;96;0;0;0;0;.00nan;0;0
8720;192718;103;72;28;2;26;.929;3600000;0
8720;189558;103;0;0;0;0;.00nan;0;0
8720;-1;94;51;46;6;40;.870;2926000;0
8720;-1;94;59;5;0;5;1.000;674000;0
8721;189448;88;0;0;0;0;.00nan;0;0
8721;-1;90;100;43;2;41;.953;3900000;0
8721;191318;88;65;26;2;24;.923;3900000;0
8721;-1;90;0;0;0;0;.00nan;0;0
8722;194502;86;88;41;3;38;.927;3600000;0
8722;189628;89;92;22;0;22;1.000;3600000;0
8722;-1;86;0;0;0;0;.00nan;0;0
8722;-1;89;0;0;0;0;.00nan;0;0
8723;189433;91;84;40;3;37;.925;3600000;0
8723;-1;96;13;16;6;10;.625;2099000;0
8723;-1;91;0;0;0;0;.00nan;0;0
8723;-1;96;68;9;0;9;1.000;1501000;0
8724;192733;99;61;22;2;20;.909;3600000;0
8724;194531;99;0;0;0;0;.00nan;0;0
8724;189576;97;0;0;0;0;.00nan;0;0
8724;191331;97;55;35;4;31;.886;3532000;0
8725;196495;87;61;33;3;30;.909;3600000;0
8725;190831;106;35;11;3;8;.727;599000;0
8725;-1;87;0;0;0;0;.00nan;0;0
8725;-1;106;41;38;6;32;.842;3001000;0
8726;194632;102;80;38;3;35;.921;3600000;0
8726;189573;102;0;0;0;0;.00nan;0;0
8726;-1;93;100;25;0;25;1.000;3600000;0
8726;197675;93;0;0;0;0;.00nan;0;0
8727;192739;92;51;2;0;2;1.000;355000;0
8727;189644;95;75;22;1;21;.955;3600000;0
8727;195346;95;0;0;0;0;.00nan;0;0
8727;190106;92;24;29;6;23;.793;3245000;0
8728;192718;103;0;0;0;0;.00nan;0;0
8728;189558;103;60;33;4;29;.879;3646000;0
8728;196495;87;0;0;0;0;.00nan;0;0
8728;-1;87;81;37;3;34;.919;3646000;0
8729;197940;100;0;0;0;0;.00nan;0;0
8729;189333;100;76;35;3;32;.914;3600000;0
8729;-1;93;59;20;2;18;.900;3600000;0
8729;197675;93;0;0;0;0;.00nan;0;0
8730;189576;97;84;29;2;27;.931;3600000;0
8730;207118;98;47;26;4;22;.846;3592000;0
8730;-1;98;0;0;0;0;.00nan;0;0
8730;191331;97;0;0;0;0;.00nan;0;0
8731;189439;107;0;0;0;0;.00nan;0;0
8731;189581;107;38;30;5;25;.833;3900000;0
8731;-1;94;0;0;0;0;.00nan;0;0
8731;-1;94;75;42;5;37;.881;3900000;0
8732;189448;88;0;0;0;0;.00nan;0;0
8732;-1;96;76;42;4;38;.905;3900000;0
8732;191318;88;57;28;4;24;.857;3900000;0
8732;-1;96;0;0;0;0;.00nan;0;0
8733;189644;95;0;0;0;0;.00nan;0;0
8733;195346;95;85;38;3;35;.921;3900000;0
8733;190831;106;0;0;0;0;.00nan;0;0
8733;-1;106;86;47;3;44;.936;3900000;0
8734;192739;92;0;0;0;0;.00nan;0;0
8734;189433;91;35;18;4;14;.778;2238000;0
8734;190106;92;74;22;2;20;.909;3600000;0
8734;-1;91;61;15;1;14;.933;1362000;0
8735;189628;89;69;53;6;47;.887;3119000;0
8735;-1;90;76;31;2;29;.935;3600000;0
8735;-1;89;42;3;1;2;.667;481000;0
8735;-1;90;0;0;0;0;.00nan;0;0
8736;192733;99;99;34;1;33;.971;3600000;0
8736;194531;99;0;0;0;0;.00nan;0;0
8736;-1;93;58;36;4;32;.889;3600000;0
8736;197675;93;0;0;0;0;.00nan;0;0
8737;197940;100;65;35;4;31;.886;3530000;0
8737;189333;100;0;0;0;0;.00nan;0;0
8737;189439;107;65;23;2;21;.913;3600000;0
8737;189581;107;0;0;0;0;.00nan;0;0
8738;207118;98;0;0;0;0;.00nan;0;0
8738;-1;98;45;17;3;14;.824;3600000;0
8738;-1;94;89;54;4;50;.926;3600000;0
8738;-1;94;0;0;0;0;.00nan;0;0
8739;194759;104;62;14;0;14;1.000;2116000;0
8739;196495;87;76;47;4;43;.915;3900000;0
8739;-1;87;0;0;0;0;.00nan;0;0
8739;191255;104;34;17;4;13;.765;1784000;0
8740;194632;102;33;32;6;26;.813;2773000;0
8740;189573;102;52;3;0;3;1.000;827000;0
8740;189639;105;67;30;3;27;.900;3600000;0
8740;-1;105;0;0;0;0;.00nan;0;0
8741;194502;86;96;41;1;40;.976;3900000;0
8741;-1;90;0;0;0;0;.00nan;0;0
8741;-1;86;0;0;0;0;.00nan;0;0
8741;-1;90;100;35;1;34;.971;3900000;0
8742;192733;99;0;0;0;0;.00nan;0;0
8742;194531;99;89;44;3;41;.932;3600000;0
8742;194899;101;0;0;0;0;.00nan;0;0
8742;-1;101;64;37;4;33;.892;3573000;0
8743;189433;91;87;30;1;29;.967;3600000;0
8743;189448;88;52;4;0;4;1.000;434000;0
8743;191318;88;43;34;6;28;.824;3166000;0
8743;-1;91;0;0;0;0;.00nan;0;0
8744;189439;107;0;0;0;0;.00nan;0;0
8744;189581;107;100;40;0;40;1.000;3600000;0
8744;196495;87;0;0;0;0;.00nan;0;0
8744;-1;87;78;30;2;28;.933;3559000;0
8745;192718;103;0;0;0;0;.00nan;0;0
8745;194759;104;0;0;0;0;.00nan;0;0
8745;189558;103;65;22;2;20;.909;3600000;0
8745;191255;104;86;42;3;39;.929;3600000;0
8746;194632;102;0;0;0;0;.00nan;0;0
8746;189573;102;98;38;1;37;.974;3600000;0
8746;189639;105;0;0;0;0;.00nan;0;0
8746;-1;105;64;26;2;24;.923;3600000;0
8747;197940;100;0;0;0;0;.00nan;0;0
8747;189333;100;92;44;4;40;.909;3900000;0
8747;207118;98;0;0;0;0;.00nan;0;0
8747;-1;98;44;28;4;24;.857;3900000;0
8748;192739;92;0;0;0;0;.00nan;0;0
8748;189644;95;0;0;0;0;.00nan;0;0
8748;195346;95;64;27;3;24;.889;3600000;0
8748;190106;92;92;49;4;45;.918;3599000;0
8749;189576;97;81;40;3;37;.925;3600000;0
8749;189628;89;67;38;4;34;.895;3600000;0
8749;-1;89;0;0;0;0;.00nan;0;0
8749;191331;97;0;0;0;0;.00nan;0;0
8750;190831;106;94;35;2;33;.943;3575000;0
8750;-1;96;0;0;0;0;.00nan;0;0
8750;-1;106;0;0;0;0;.00nan;0;0
8750;-1;96;100;32;0;32;1.000;3600000;0
8751;197940;100;55;28;4;24;.857;3600000;0
8751;189333;100;0;0;0;0;.00nan;0;0
8751;189639;105;49;34;5;29;.853;3548000;0
8751;-1;105;0;0;0;0;.00nan;0;0
8752;194759;104;86;37;2;35;.946;3515000;0
8752;-1;94;0;0;0;0;.00nan;0;0
8752;-1;94;100;27;0;27;1.000;3600000;0
8752;191255;104;0;0;0;0;.00nan;0;0
8753;194899;101;65;36;4;32;.889;3600000;0
8753;-1;93;55;20;3;17;.850;3600000;0
8753;-1;101;0;0;0;0;.00nan;0;0
8753;197675;93;0;0;0;0;.00nan;0;0
8754;189433;91;0;0;0;0;.00nan;0;0
8754;190831;106;52;39;5;34;.872;3600000;0
8754;-1;106;0;0;0;0;.00nan;0;0
8754;-1;91;93;23;0;23;1.000;3600000;0
8755;194502;86;62;29;3;26;.897;3600000;0
8755;189448;88;100;39;0;39;1.000;3600000;0
8755;-1;86;0;0;0;0;.00nan;0;0
8755;191318;88;0;0;0;0;.00nan;0;0
8756;192733;99;96;32;1;31;.969;3900000;0
8756;194531;99;0;0;0;0;.00nan;0;0
8756;189439;107;0;0;0;0;.00nan;0;0
8756;189581;107;87;28;1;27;.964;3900000;0
8757;192739;92;90;18;0;18;1.000;3600000;0
8757;190106;92;0;0;0;0;.00nan;0;0
8757;190831;106;0;0;0;0;.00nan;0;0
8757;-1;106;79;49;5;44;.898;3600000;0
8758;189576;97;67;33;3;30;.909;3600000;0
8758;-1;90;24;25;6;19;.760;2460000;0
8758;191331;97;0;0;0;0;.00nan;0;0
8758;-1;90;65;16;1;15;.938;1140000;0
8759;194632;102;76;25;2;23;.920;3600000;0
8759;189573;102;0;0;0;0;.00nan;0;0
8759;207118;98;0;0;0;0;.00nan;0;0
8759;-1;98;71;35;3;32;.914;3572000;0
8760;194759;104;0;0;0;0;.00nan;0;0
8760;-1;94;0;0;0;0;.00nan;0;0
8760;-1;94;52;31;4;27;.871;3566000;0
8760;191255;104;51;23;3;20;.870;3600000;0
8761;194502;86;53;26;3;23;.885;3600000;0
8761;196495;87;55;30;4;26;.867;3584000;0
8761;-1;87;0;0;0;0;.00nan;0;0
8761;-1;86;0;0;0;0;.00nan;0;0
8762;192739;92;93;38;2;36;.947;3600000;0
8762;189644;95;0;0;0;0;.00nan;0;0
8762;195346;95;40;29;5;24;.828;3600000;0
8762;190106;92;0;0;0;0;.00nan;0;0
8763;-1;96;0;0;0;0;.00nan;0;0
8763;-1;93;29;12;4;8;.667;900000;0
8763;197675;93;49;15;2;13;.867;2700000;0
8763;-1;96;75;29;3;26;.897;3600000;0
8764;192718;103;0;0;0;0;.00nan;0;0
8764;189433;91;0;0;0;0;.00nan;0;0
8764;189558;103;73;41;4;37;.902;3560000;0
8764;-1;91;67;28;2;26;.929;3600000;0
8765;189448;88;29;28;6;22;.786;3267000;0
8765;189628;89;0;0;0;0;.00nan;0;0
8765;-1;89;60;34;5;29;.853;3600000;0
8765;191318;88;49;2;0;2;1.000;284000;0
8766;189576;97;0;0;0;0;.00nan;0;0
8766;190831;106;51;21;3;18;.857;3600000;0
8766;191331;97;68;40;4;36;.900;3600000;0
8766;-1;106;0;0;0;0;.00nan;0;0
8767;192733;99;0;0;0;0;.00nan;0;0
8767;194531;99;78;13;0;13;1.000;3600000;0
8767;-1;94;91;55;4;51;.927;3600000;0
8767;-1;94;0;0;0;0;.00nan;0;0
8768;197940;100;0;0;0;0;.00nan;0;0
8768;194632;102;25;25;6;19;.760;2665000;0
8768;189333;100;83;34;2;32;.941;3600000;0
8768;189573;102;22;10;4;6;.600;935000;0
8769;189639;105;51;25;3;22;.880;3550000;0
8769;207118;98;0;0;0;0;.00nan;0;0
8769;-1;98;76;27;1;26;.963;3600000;0
8769;-1;105;0;0;0;0;.00nan;0;0
8770;194759;104;0;0;0;0;.00nan;0;0
8770;189439;107;0;0;0;0;.00nan;0;0
8770;189581;107;62;27;3;24;.889;3600000;0
8770;191255;104;91;35;1;34;.971;3600000;0
8771;189448;88;0;0;0;0;.00nan;0;0
8771;196495;87;0;0;0;0;.00nan;0;0
8771;-1;87;80;36;3;33;.917;3542000;0
8771;191318;88;59;20;2;18;.900;3600000;0
8772;189433;91;34;11;3;8;.727;248000;0
8772;189644;95;48;31;5;26;.839;3545000;0
8772;195346;95;0;0;0;0;.00nan;0;0
8772;-1;91;89;34;1;33;.971;3352000;0
8773;192733;99;0;0;0;0;.00nan;0;0
8773;194531;99;49;28;4;24;.857;3600000;0
8773;-1;94;65;12;0;12;1.000;1807000;0
8773;-1;94;33;24;5;19;.792;1741000;0
8774;190831;106;0;0;0;0;.00nan;0;0
8774;-1;93;40;29;5;24;.828;3600000;0
8774;-1;106;34;35;6;29;.829;3600000;0
8774;197675;93;0;0;0;0;.00nan;0;0
8775;194502;86;60;26;3;23;.885;3604000;0
8775;194899;101;0;0;0;0;.00nan;0;0
8775;-1;86;0;0;0;0;.00nan;0;0
8775;-1;101;54;29;4;25;.862;3629000;0
8776;189576;97;68;42;4;38;.905;3600000;0
8776;-1;90;43;3;1;2;.667;368000;0
8776;191331;97;0;0;0;0;.00nan;0;0
8776;-1;90;37;33;6;27;.818;3232000;0
8777;189439;107;74;32;2;30;.938;3730000;0
8777;189581;107;0;0;0;0;.00nan;0;0
8777;207118;98;0;0;0;0;.00nan;0;0
8777;-1;98;77;19;1;18;.947;3730000;0
8778;192718;103;93;20;0;20;1.000;3600000;0
8778;189558;103;0;0;0;0;.00nan;0;0
8778;-1;96;73;37;3;34;.919;3600000;0
8778;-1;96;0;0;0;0;.00nan;0;0
8779;194759;104;56;19;2;17;.895;3600000;0
8779;189639;105;0;0;0;0;.00nan;0;0
8779;191255;104;0;0;0;0;.00nan;0;0
8779;-1;105;64;25;3;22;.880;3600000;0
8780;197940;100;76;40;3;37;.925;3566000;0
8780;194632;102;0;0;0;0;.00nan;0;0
8780;189333;100;0;0;0;0;.00nan;0;0
8780;189573;102;67;22;2;20;.909;3600000;0
8781;194502;86;0;0;0;0;.00nan;0;0
8781;-1;90;94;35;2;33;.943;3600000;0
8781;-1;86;58;30;3;27;.900;3552000;0
8781;-1;90;0;0;0;0;.00nan;0;0
8782;194899;101;71;22;1;21;.955;3600000;0
8782;189628;89;57;29;3;26;.897;3563000;0
8782;-1;89;0;0;0;0;.00nan;0;0
8782;-1;101;0;0;0;0;.00nan;0;0
8783;197940;100;0;0;0;0;.00nan;0;0
8783;192733;99;93;38;2;36;.947;3900000;0
8783;194531;99;0;0;0;0;.00nan;0;0
8783;189333;100;88;30;2;28;.933;3900000;0
8784;192718;103;0;0;0;0;.00nan;0;0
8784;189558;103;82;53;4;49;.925;3573000;0
8784;189644;95;0;0;0;0;.00nan;0;0
8784;195346;95;53;21;3;18;.857;3600000;0
8785;194899;101;0;0;0;0;.00nan;0;0
8785;196495;87;51;23;3;20;.870;3600000;0
8785;-1;87;0;0;0;0;.00nan;0;0
8785;-1;101;52;32;4;28;.875;3562000;0
8786;192739;92;43;25;4;21;.840;3561000;0
8786;194759;104;0;0;0;0;.00nan;0;0
8786;190106;92;0;0;0;0;.00nan;0;0
8786;191255;104;83;40;3;37;.925;3600000;0
8787;192718;103;0;0;0;0;.00nan;0;0
8787;189558;103;63;37;4;33;.892;3525000;0
8787;-1;93;0;0;0;0;.00nan;0;0
8787;197675;93;73;31;2;29;.935;3600000;0
8788;189628;89;76;25;2;23;.920;3600000;0
8788;-1;90;44;40;6;34;.850;3600000;0
8788;-1;89;0;0;0;0;.00nan;0;0
8788;-1;90;0;0;0;0;.00nan;0;0
8789;197940;100;57;10;1;9;.900;3600000;0
8789;189333;100;0;0;0;0;.00nan;0;0
8789;-1;94;67;43;4;39;.907;3600000;0
8789;-1;94;0;0;0;0;.00nan;0;0
8790;189448;88;0;0;0;0;.00nan;0;0
8790;-1;90;0;0;0;0;.00nan;0;0
8790;191318;88;45;22;4;18;.818;3600000;0
8790;-1;90;38;34;6;28;.824;3569000;0
8791;194759;104;0;0;0;0;.00nan;0;0
8791;189644;95;50;17;3;14;.824;3600000;0
8791;195346;95;0;0;0;0;.00nan;0;0
8791;191255;104;64;41;4;37;.902;3600000;0
8792;192739;92;98;44;2;42;.955;3900000;0
8792;190106;92;0;0;0;0;.00nan;0;0
8792;-1;93;73;27;2;25;.926;3900000;0
8792;197675;93;0;0;0;0;.00nan;0;0
8793;189628;89;66;42;5;37;.881;3600000;0
8793;196495;87;49;31;4;27;.871;3600000;0
8793;-1;87;0;0;0;0;.00nan;0;0
8793;-1;89;0;0;0;0;.00nan;0;0
8794;189448;88;45;21;3;18;.857;3572000;0
8794;194899;101;0;0;0;0;.00nan;0;0
8794;-1;101;72;29;2;27;.931;3600000;0
8794;191318;88;0;0;0;0;.00nan;0;0
8795;192718;103;0;0;0;0;.00nan;0;0
8795;189558;103;49;32;5;27;.844;3600000;0
8795;189576;97;0;0;0;0;.00nan;0;0
8795;191331;97;76;30;2;28;.933;3600000;0
8796;194502;86;71;22;1;21;.955;3600000;0
8796;-1;86;0;0;0;0;.00nan;0;0
8796;-1;96;0;0;0;0;.00nan;0;0
8796;-1;96;85;36;3;33;.917;3542000;0
8797;192733;99;0;0;0;0;.00nan;0;0
8797;194531;99;100;38;1;37;.974;3600000;0
8797;189433;91;40;35;5;30;.857;3600000;0
8797;-1;91;0;0;0;0;.00nan;0;0
8798;197940;100;0;0;0;0;.00nan;0;0
8798;189333;100;50;32;4;28;.875;3525000;0
8798;189439;107;0;0;0;0;.00nan;0;0
8798;189581;107;83;34;2;32;.941;3600000;0
8799;194632;102;58;27;3;24;.889;3600000;0
8799;189573;102;0;0;0;0;.00nan;0;0
8799;207118;98;54;40;5;35;.875;3600000;0
8799;-1;98;0;0;0;0;.00nan;0;0
8800;189639;105;72;33;3;30;.909;3600000;0
8800;190831;106;25;35;7;28;.800;2714000;0
8800;-1;106;58;7;0;7;1.000;886000;0
8800;-1;105;0;0;0;0;.00nan;0;0
8801;192718;103;30;36;7;29;.806;3512000;0
8801;192739;92;0;0;0;0;.00nan;0;0
8801;189558;103;0;0;0;0;.00nan;0;0
8801;190106;92;48;33;5;28;.848;3600000;0
8802;194759;104;64;16;1;15;.938;3600000;0
8802;-1;93;0;0;0;0;.00nan;0;0
8802;191255;104;0;0;0;0;.00nan;0;0
8802;197675;93;74;29;2;27;.931;3575000;0
8803;194899;101;69;22;2;20;.909;3600000;0
8803;-1;90;0;0;0;0;.00nan;0;0
8803;-1;101;0;0;0;0;.00nan;0;0
8803;-1;90;51;28;4;24;.857;3516000;0
8804;194632;102;0;0;0;0;.00nan;0;0
8804;189439;107;61;33;4;29;.879;3566000;0
8804;189573;102;54;16;2;14;.875;3600000;0
8804;189581;107;0;0;0;0;.00nan;0;0
8805;189639;105;0;0;0;0;.00nan;0;0
8805;-1;94;22;18;5;13;.722;2016000;0
8805;-1;94;72;19;0;19;1.000;1584000;0
8805;-1;105;58;12;1;11;.917;3600000;0
8806;197940;100;86;35;2;33;.943;3540000;0
8806;192733;99;65;15;1;14;.933;3600000;0
8806;194531;99;0;0;0;0;.00nan;0;0
8806;189333;100;0;0;0;0;.00nan;0;0
8807;189433;91;0;0;0;0;.00nan;0;0
8807;207118;98;0;0;0;0;.00nan;0;0
8807;-1;98;33;19;4;15;.789;3600000;0
8807;-1;91;99;62;1;61;.984;3600000;0
8808;189448;88;0;0;0;0;.00nan;0;0
8808;189628;89;48;35;5;30;.857;3600000;0
8808;-1;89;0;0;0;0;.00nan;0;0
8808;191318;88;82;28;1;27;.964;3600000;0
8809;194759;104;0;0;0;0;.00nan;0;0
8809;189576;97;47;25;4;21;.840;3520000;0
8809;191255;104;64;25;2;23;.920;3600000;0
8809;191331;97;0;0;0;0;.00nan;0;0
8810;194502;86;72;31;3;28;.903;3804000;0
8810;189644;95;66;38;4;34;.895;3804000;0
8810;195346;95;0;0;0;0;.00nan;0;0
8810;-1;86;0;0;0;0;.00nan;0;0
8811;-1;96;100;35;0;35;1.000;3600000;0
8811;-1;93;62;19;2;17;.895;3518000;0
8811;197675;93;0;0;0;0;.00nan;0;0
8811;-1;96;0;0;0;0;.00nan;0;0
8812;207118;98;0;0;0;0;.00nan;0;0
8812;-1;98;70;26;2;24;.923;3548000;0
8812;-1;94;0;0;0;0;.00nan;0;0
8812;-1;94;96;37;1;36;.973;3600000;0
8813;194632;102;24;23;6;17;.739;3070000;0
8813;189433;91;15;21;6;15;.714;1948000;0
8813;189573;102;51;1;0;1;1.000;530000;0
8813;-1;91;58;29;3;26;.897;1623000;0
8814;189448;88;0;0;0;0;.00nan;0;0
8814;189628;89;57;29;3;26;.897;3600000;0
8814;-1;89;0;0;0;0;.00nan;0;0
8814;191318;88;43;26;4;22;.846;3587000;0
8815;189439;107;42;39;7;32;.821;3600000;0
8815;189576;97;0;0;0;0;.00nan;0;0
8815;189581;107;0;0;0;0;.00nan;0;0
8815;191331;97;79;36;3;33;.917;3600000;0
8816;192739;92;66;36;5;31;.861;3900000;0
8816;190106;92;0;0;0;0;.00nan;0;0
8816;-1;90;56;41;5;36;.878;3900000;0
8816;-1;90;0;0;0;0;.00nan;0;0
8817;192718;103;66;29;3;26;.897;3600000;0
8817;192733;99;73;33;2;31;.939;3600000;0
8817;194531;99;0;0;0;0;.00nan;0;0
8817;189558;103;0;0;0;0;.00nan;0;0
8818;197940;100;0;0;0;0;.00nan;0;0
8818;189333;100;55;31;4;27;.871;3577000;0
8818;189433;91;0;0;0;0;.00nan;0;0
8818;-1;91;67;27;3;24;.889;3600000;0
8819;194502;86;0;0;0;0;.00nan;0;0
8819;196495;87;57;22;3;19;.864;3600000;0
8819;-1;87;0;0;0;0;.00nan;0;0
8819;-1;86;49;33;4;29;.879;3554000;0
8820;194502;86;51;40;5;35;.875;3583000;0
8820;-1;86;0;0;0;0;.00nan;0;0
8820;-1;93;58;23;3;20;.870;3600000;0
8820;197675;93;0;0;0;0;.00nan;0;0
8821;189448;88;83;22;0;22;1.000;3900000;0
8821;189576;97;100;39;0;39;1.000;3900000;0
8821;191318;88;0;0;0;0;.00nan;0;0
8821;191331;97;0;0;0;0;.00nan;0;0
8822;189644;95;0;0;0;0;.00nan;0;0
8822;195346;95;93;14;0;14;1.000;3600000;0
8822;-1;96;81;50;5;45;.900;3600000;0
8822;-1;96;0;0;0;0;.00nan;0;0
8823;192739;92;73;39;5;34;.872;3639000;0
8823;189439;107;59;43;6;37;.860;3639000;0
8823;189581;107;0;0;0;0;.00nan;0;0
8823;190106;92;0;0;0;0;.00nan;0;0
8824;189433;91;0;0;0;0;.00nan;0;0
8824;194899;101;0;0;0;0;.00nan;0;0
8824;-1;101;76;24;2;22;.917;3600000;0
8824;-1;91;60;32;3;29;.906;3591000;0
8825;197940;100;81;51;5;46;.902;3600000;0
8825;192718;103;0;0;0;0;.00nan;0;0
8825;189333;100;0;0;0;0;.00nan;0;0
8825;189558;103;99;36;1;35;.972;3600000;0
8826;189639;105;45;20;4;16;.800;3880000;0
8826;-1;90;0;0;0;0;.00nan;0;0
8826;-1;105;0;0;0;0;.00nan;0;0
8826;-1;90;75;50;5;45;.900;3880000;0
8827;192733;99;0;0;0;0;.00nan;0;0
8827;194531;99;34;18;4;14;.778;3600000;0
8827;-1;94;92;57;3;54;.947;3600000;0
8827;-1;94;0;0;0;0;.00nan;0;0
8828;194759;104;0;0;0;0;.00nan;0;0
8828;207118;98;0;0;0;0;.00nan;0;0
8828;-1;98;70;40;4;36;.900;3600000;0
8828;191255;104;48;37;5;32;.865;3553000;0
8829;194632;102;73;24;2;22;.917;3600000;0
8829;189573;102;0;0;0;0;.00nan;0;0
8829;190831;106;33;27;6;21;.778;2011000;0
8829;-1;106;53;18;2;16;.889;1589000;0
8830;189628;89;74;39;4;35;.897;3600000;0
8830;196495;87;0;0;0;0;.00nan;0;0
8830;-1;87;24;27;6;21;.778;3528000;0
8830;-1;89;0;0;0;0;.00nan;0;0
8831;189439;107;51;3;0;3;1.000;340000;0
8831;189581;107;12;28;8;20;.714;3260000;0
8831;-1;93;0;0;0;0;.00nan;0;0
8831;197675;93;77;31;2;29;.935;3600000;0
8832;189644;95;0;0;0;0;.00nan;0;0
8832;195346;95;71;28;3;25;.893;3600000;0
8832;-1;96;0;0;0;0;.00nan;0;0
8832;-1;96;69;41;4;37;.902;3600000;0
8833;194632;102;0;0;0;0;.00nan;0;0
8833;189573;102;61;29;4;25;.862;3600000;0
8833;190831;106;31;35;6;29;.829;2564000;0
8833;-1;106;40;9;2;7;.778;1036000;0
8834;192733;99;78;33;2;31;.939;3900000;0
8834;194531;99;0;0;0;0;.00nan;0;0
8834;189639;105;0;0;0;0;.00nan;0;0
8834;-1;105;63;26;2;24;.923;3900000;0
8835;-1;90;84;30;1;29;.967;3900000;0
8835;-1;94;0;0;0;0;.00nan;0;0
8835;-1;94;96;40;1;39;.975;3900000;0
8835;-1;90;0;0;0;0;.00nan;0;0
8836;197940;100;0;0;0;0;.00nan;0;0
8836;189333;100;67;54;5;49;.907;3600000;0
8836;194759;104;51;22;3;19;.864;3600000;0
8836;191255;104;0;0;0;0;.00nan;0;0
8837;189628;89;0;0;0;0;.00nan;0;0
8837;196495;87;83;32;2;30;.938;3600000;0
8837;-1;87;0;0;0;0;.00nan;0;0
8837;-1;89;38;28;5;23;.821;3600000;0
8838;194632;102;75;29;3;26;.897;3600000;0
8838;189573;102;0;0;0;0;.00nan;0;0
8838;207118;98;0;0;0;0;.00nan;0;0
8838;-1;98;67;32;4;28;.875;3555000;0
8839;194502;86;0;0;0;0;.00nan;0;0
8839;189448;88;37;29;5;24;.828;3579000;0
8839;-1;86;59;24;3;21;.875;3600000;0
8839;191318;88;0;0;0;0;.00nan;0;0
8840;189576;97;0;0;0;0;.00nan;0;0
8840;-1;93;53;31;4;27;.871;3590000;0
8840;191331;97;62;32;3;29;.906;3600000;0
8840;197675;93;0;0;0;0;.00nan;0;0
8841;197940;100;57;31;4;27;.871;3600000;0
8841;189333;100;0;0;0;0;.00nan;0;0
8841;194899;101;0;0;0;0;.00nan;0;0
8841;-1;101;92;35;1;34;.971;3600000;0
8842;190831;106;61;21;2;19;.905;3600000;0
8842;-1;90;0;0;0;0;.00nan;0;0
8842;-1;106;0;0;0;0;.00nan;0;0
8842;-1;90;49;34;5;29;.853;3600000;0
8843;194632;102;0;0;0;0;.00nan;0;0
8843;189573;102;75;35;2;33;.943;3600000;0
8843;207118;98;42;33;6;27;.818;3341000;0
8843;-1;98;47;3;1;2;.667;259000;0
8844;189628;89;71;32;3;29;.906;3773000;0
8844;-1;96;71;39;4;35;.897;3777000;0
8844;-1;89;0;0;0;0;.00nan;0;0
8844;-1;96;0;0;0;0;.00nan;0;0
8845;189439;107;0;0;0;0;.00nan;0;0
8845;189581;107;86;34;2;32;.941;3600000;0
8845;-1;94;0;0;0;0;.00nan;0;0
8845;-1;94;30;45;9;36;.800;3600000;0
8846;197940;100;0;0;0;0;.00nan;0;0
8846;189333;100;78;28;1;27;.964;3600000;0
8846;194899;101;57;39;5;34;.872;3600000;0
8846;-1;101;0;0;0;0;.00nan;0;0
8847;194759;104;0;0;0;0;.00nan;0;0
8847;-1;90;78;38;4;34;.895;3600000;0
8847;191255;104;77;27;1;26;.963;3600000;0
8847;-1;90;0;0;0;0;.00nan;0;0
8848;196495;87;0;0;0;0;.00nan;0;0
8848;-1;87;59;31;4;27;.871;3600000;0
8848;-1;96;44;35;6;29;.829;3559000;0
8848;-1;96;0;0;0;0;.00nan;0;0
8849;194502;86;52;32;4;28;.875;3600000;0
8849;189448;88;37;34;6;28;.824;3520000;0
8849;-1;86;0;0;0;0;.00nan;0;0
8849;191318;88;0;0;0;0;.00nan;0;0
8850;189576;97;0;0;0;0;.00nan;0;0
8850;189628;89;31;23;5;18;.783;2392000;0
8850;-1;89;53;8;1;7;.875;1208000;0
8850;191331;97;69;38;4;34;.895;3600000;0
8851;189433;91;56;13;1;12;.923;2431000;0
8851;189644;95;70;29;2;27;.931;3600000;0
8851;195346;95;0;0;0;0;.00nan;0;0
8851;-1;91;30;17;4;13;.765;1169000;0
8852;192718;103;0;0;0;0;.00nan;0;0
8852;189558;103;64;33;4;29;.879;3764000;0
8852;-1;90;0;0;0;0;.00nan;0;0
8852;-1;90;81;44;5;39;.886;3764000;0
8853;197940;100;45;25;4;21;.840;3549000;0
8853;189333;100;0;0;0;0;.00nan;0;0
8853;194899;101;0;0;0;0;.00nan;0;0
8853;-1;101;62;29;3;26;.897;3600000;0
8854;189439;107;54;18;2;16;.889;3566000;0
8854;189581;107;0;0;0;0;.00nan;0;0
8854;-1;94;100;47;1;46;.979;3600000;0
8854;-1;94;0;0;0;0;.00nan;0;0
8855;194759;104;100;27;0;27;1.000;3600000;0
8855;190831;106;67;45;5;40;.889;3600000;0
8855;191255;104;0;0;0;0;.00nan;0;0
8855;-1;106;0;0;0;0;.00nan;0;0
8856;192739;92;59;35;4;31;.886;3900000;0
8856;194632;102;58;28;4;24;.857;3900000;0
8856;189573;102;0;0;0;0;.00nan;0;0
8856;190106;92;0;0;0;0;.00nan;0;0
8857;196495;87;92;41;2;39;.951;3600000;0
8857;-1;87;0;0;0;0;.00nan;0;0
8857;-1;93;63;41;5;36;.878;3600000;0
8857;197675;93;0;0;0;0;.00nan;0;0
8858;189448;88;0;0;0;0;.00nan;0;0
8858;189576;97;71;48;5;43;.896;3600000;0
8858;191318;88;66;20;1;19;.950;3600000;0
8858;191331;97;0;0;0;0;.00nan;0;0
8859;189433;91;64;22;2;20;.909;3900000;0
8859;189644;95;89;36;2;34;.944;3900000;0
8859;195346;95;0;0;0;0;.00nan;0;0
8859;-1;91;0;0;0;0;.00nan;0;0
8860;194759;104;63;33;4;29;.879;3900000;0
8860;190831;106;0;0;0;0;.00nan;0;0
8860;191255;104;0;0;0;0;.00nan;0;0
8860;-1;106;85;45;4;41;.911;3900000;0
8861;189439;107;0;0;0;0;.00nan;0;0
8861;189581;107;54;32;5;27;.844;3600000;0
8861;189639;105;78;29;2;27;.931;3600000;0
8861;-1;105;0;0;0;0;.00nan;0;0
8862;194502;86;0;0;0;0;.00nan;0;0
8862;-1;86;62;25;2;23;.920;3600000;0
8862;-1;96;0;0;0;0;.00nan;0;0
8862;-1;96;73;58;6;52;.897;3600000;0
8863;197940;100;0;0;0;0;.00nan;0;0
8863;192739;92;0;0;0;0;.00nan;0;0
8863;189333;100;86;44;2;42;.955;3544000;0
8863;190106;92;100;38;1;37;.974;3600000;0
8864;194899;101;29;36;6;30;.833;3567000;0
8864;207118;98;0;0;0;0;.00nan;0;0
8864;-1;98;60;29;4;25;.862;3600000;0
8864;-1;101;0;0;0;0;.00nan;0;0
8865;189439;107;33;14;4;10;.714;1189000;0
8865;189581;107;70;32;2;30;.938;2711000;0
8865;-1;90;25;33;6;27;.818;3900000;0
8865;-1;90;0;0;0;0;.00nan;0;0
8866;192718;103;0;0;0;0;.00nan;0;0
8866;194759;104;0;0;0;0;.00nan;0;0
8866;189558;103;100;33;0;33;1.000;3600000;0
8866;191255;104;44;17;3;14;.824;3600000;0
8867;192733;99;70;37;4;33;.892;3600000;0
8867;194531;99;0;0;0;0;.00nan;0;0
8867;189639;105;0;0;0;0;.00nan;0;0
8867;-1;105;25;24;6;18;.750;3530000;0
8868;189439;107;0;0;0;0;.00nan;0;0
8868;189448;88;59;36;4;32;.889;3722000;0
8868;189581;107;83;48;3;45;.938;3722000;0
8868;191318;88;0;0;0;0;.00nan;0;0
8869;192739;92;65;22;2;20;.909;3600000;0
8869;190106;92;0;0;0;0;.00nan;0;0
8869;207118;98;0;0;0;0;.00nan;0;0
8869;-1;98;48;27;4;23;.852;3600000;0
8870;190831;106;60;24;3;21;.875;3600000;0
8870;-1;94;0;0;0;0;.00nan;0;0
8870;-1;94;43;36;5;31;.861;3592000;0
8870;-1;106;0;0;0;0;.00nan;0;0
8871;194759;104;0;0;0;0;.00nan;0;0
8871;189448;88;0;0;0;0;.00nan;0;0
8871;191255;104;86;30;2;28;.933;3600000;0
8871;191318;88;52;26;3;23;.885;3599000;0
8872;189628;89;43;40;6;34;.850;3600000;0
8872;-1;93;0;0;0;0;.00nan;0;0
8872;-1;89;0;0;0;0;.00nan;0;0
8872;197675;93;43;15;3;12;.800;3600000;0
8873;196495;87;57;27;3;24;.889;3600000;0
8873;-1;87;0;0;0;0;.00nan;0;0
8873;-1;96;22;23;6;17;.739;3046000;0
8873;-1;96;50;2;0;2;1.000;554000;0
8874;192733;99;80;33;2;31;.939;3600000;0
8874;192739;92;0;0;0;0;.00nan;0;0
8874;194531;99;0;0;0;0;.00nan;0;0
8874;190106;92;41;38;6;32;.842;3600000;0
8875;192718;103;0;0;0;0;.00nan;0;0
8875;194632;102;95;53;3;50;.943;3900000;0
8875;189558;103;72;35;3;32;.914;3900000;0
8875;189573;102;0;0;0;0;.00nan;0;0
8876;207118;98;85;37;3;34;.919;3900000;0
8876;190831;106;0;0;0;0;.00nan;0;0
8876;-1;98;0;0;0;0;.00nan;0;0
8876;-1;106;68;34;3;31;.912;3900000;0
8877;197940;100;0;0;0;0;.00nan;0;0
8877;189333;100;16;39;8;31;.795;3600000;0
8877;189639;105;59;24;3;21;.875;3600000;0
8877;-1;105;0;0;0;0;.00nan;0;0
8878;194502;86;52;24;3;21;.875;3600000;0
8878;189576;97;0;0;0;0;.00nan;0;0
8878;-1;86;0;0;0;0;.00nan;0;0
8878;191331;97;61;35;5;30;.857;3567000;0
8879;189433;91;62;41;6;35;.854;3600000;0
8879;196495;87;79;33;3;30;.909;3600000;0
8879;-1;87;0;0;0;0;.00nan;0;0
8879;-1;91;0;0;0;0;.00nan;0;0
8880;189628;89;65;41;5;36;.878;3532000;0
8880;-1;96;75;35;3;32;.914;3600000;0
8880;-1;89;0;0;0;0;.00nan;0;0
8880;-1;96;0;0;0;0;.00nan;0;0
8881;197940;100;0;0;0;0;.00nan;0;0
8881;192733;99;54;27;4;23;.852;3640000;0
8881;194531;99;0;0;0;0;.00nan;0;0
8881;189333;100;72;38;3;35;.921;3640000;0
8882;192739;92;0;0;0;0;.00nan;0;0
8882;194899;101;50;1;0;1;1.000;1064000;0
8882;190106;92;83;29;1;28;.966;3600000;0
8882;-1;101;41;31;6;25;.806;2536000;0
8883;189439;107;0;0;0;0;.00nan;0;0
8883;189581;107;64;34;3;31;.912;3900000;0
8883;189639;105;55;26;3;23;.885;3900000;0
8883;-1;105;0;0;0;0;.00nan;0;0
8884;189448;88;34;21;5;16;.762;3610000;0
8884;190831;106;48;29;4;25;.862;3610000;0
8884;191318;88;0;0;0;0;.00nan;0;0
8884;-1;106;0;0;0;0;.00nan;0;0
8885;194632;102;55;18;2;16;.889;3900000;0
8885;189573;102;0;0;0;0;.00nan;0;0
8885;-1;94;100;39;2;37;.949;3900000;0
8885;-1;94;0;0;0;0;.00nan;0;0
8886;192718;103;0;0;0;0;.00nan;0;0
8886;194759;104;92;43;2;41;.953;3900000;0
8886;189558;103;64;18;2;16;.889;3900000;0
8886;191255;104;0;0;0;0;.00nan;0;0
8887;194502;86;0;0;0;0;.00nan;0;0
8887;-1;90;0;0;0;0;.00nan;0;0
8887;-1;86;39;33;5;28;.848;3600000;0
8887;-1;90;55;24;3;21;.875;3600000;0
8888;189644;95;0;0;0;0;.00nan;0;0
8888;195346;95;45;29;5;24;.828;3600000;0
8888;-1;96;0;0;0;0;.00nan;0;0
8888;-1;96;81;33;2;31;.939;3600000;0
8889;192733;99;0;0;0;0;.00nan;0;0
8889;194531;99;81;34;2;32;.941;3600000;0
8889;194759;104;0;0;0;0;.00nan;0;0
8889;191255;104;62;31;3;28;.903;3560000;0
8890;196495;87;0;0;0;0;.00nan;0;0
8890;-1;87;65;25;3;22;.880;3600000;0
8890;-1;93;42;30;5;25;.833;3549000;0
8890;197675;93;0;0;0;0;.00nan;0;0
8891;192718;103;70;34;3;31;.912;3600000;0
8891;189448;88;0;0;0;0;.00nan;0;0
8891;189558;103;0;0;0;0;.00nan;0;0
8891;191318;88;52;35;5;30;.857;3600000;0
8892;189433;91;0;0;0;0;.00nan;0;0
8892;189628;89;0;0;0;0;.00nan;0;0
8892;-1;89;78;37;3;34;.919;3600000;0
8892;-1;91;55;30;4;26;.867;3552000;0
8893;194632;102;58;28;4;24;.857;3597000;0
8893;189573;102;0;0;0;0;.00nan;0;0
8893;189639;105;0;0;0;0;.00nan;0;0
8893;-1;105;68;28;2;26;.929;3600000;0
8894;197940;100;67;27;2;25;.926;3600000;0
8894;189333;100;0;0;0;0;.00nan;0;0
8894;-1;94;0;0;0;0;.00nan;0;0
8894;-1;94;64;32;4;28;.875;3570000;0
8895;207118;98;0;0;0;0;.00nan;0;0
8895;190831;106;83;46;3;43;.935;3900000;0
8895;-1;98;77;38;3;35;.921;3900000;0
8895;-1;106;0;0;0;0;.00nan;0;0
8896;196495;87;69;33;3;30;.909;3556000;0
8896;-1;90;65;29;2;27;.931;3600000;0
8896;-1;87;0;0;0;0;.00nan;0;0
8896;-1;90;0;0;0;0;.00nan;0;0
8897;192718;103;0;0;0;0;.00nan;0;0
8897;189558;103;64;32;4;28;.875;3600000;0
8897;189639;105;30;24;5;19;.792;3542000;0
8897;-1;105;0;0;0;0;.00nan;0;0
8898;194759;104;0;0;0;0;.00nan;0;0
8898;194899;101;64;31;3;28;.903;3600000;0
8898;-1;101;0;0;0;0;.00nan;0;0
8898;191255;104;47;39;6;33;.846;3600000;0
8899;194502;86;73;23;1;22;.957;3600000;0
8899;189576;97;95;46;3;43;.935;3582000;0
8899;-1;86;0;0;0;0;.00nan;0;0
8899;191331;97;0;0;0;0;.00nan;0;0
8900;189433;91;48;33;5;28;.848;3572000;0
8900;189644;95;64;25;4;21;.840;3600000;0
8900;195346;95;0;0;0;0;.00nan;0;0
8900;-1;91;0;0;0;0;.00nan;0;0
8901;194759;104;24;29;6;23;.793;3548000;0
8901;194899;101;0;0;0;0;.00nan;0;0
8901;-1;101;71;44;5;39;.886;3600000;0
8901;191255;104;0;0;0;0;.00nan;0;0
8902;189448;88;42;25;4;21;.840;3600000;0
8902;-1;94;90;32;1;31;.969;3600000;0
8902;-1;94;0;0;0;0;.00nan;0;0
8902;191318;88;0;0;0;0;.00nan;0;0
8903;192733;99;69;41;4;37;.902;3558000;0
8903;194531;99;0;0;0;0;.00nan;0;0
8903;194632;102;57;20;2;18;.900;3600000;0
8903;189573;102;0;0;0;0;.00nan;0;0
8904;189576;97;0;0;0;0;.00nan;0;0
8904;-1;93;0;0;0;0;.00nan;0;0
8904;191331;97;76;51;6;45;.882;3600000;0
8904;197675;93;61;20;2;18;.900;3600000;0
8905;192739;92;0;0;0;0;.00nan;0;0
8905;189644;95;0;0;0;0;.00nan;0;0
8905;195346;95;68;26;2;24;.923;3600000;0
8905;190106;92;74;39;3;36;.923;3583000;0
8906;189439;107;0;0;0;0;.00nan;0;0
8906;189581;107;39;27;5;22;.815;3600000;0
8906;207118;98;0;0;0;0;.00nan;0;0
8906;-1;98;76;33;2;31;.939;3600000;0
8907;189448;88;0;0;0;0;.00nan;0;0
8907;189639;105;87;22;1;21;.955;3600000;0
8907;191318;88;74;36;3;33;.917;3541000;0
8907;-1;105;0;0;0;0;.00nan;0;0
8908;192733;99;0;0;0;0;.00nan;0;0
8908;194531;99;93;38;1;37;.974;3900000;0
8908;194632;102;0;0;0;0;.00nan;0;0
8908;189573;102;72;24;1;23;.958;3900000;0
8909;189628;89;100;46;0;46;1.000;3600000;0
8909;196495;87;63;16;1;15;.938;3600000;0
8909;-1;87;0;0;0;0;.00nan;0;0
8909;-1;89;0;0;0;0;.00nan;0;0
8910;189576;97;15;13;5;8;.615;1132000;0
8910;-1;90;50;38;6;32;.842;3600000;0
8910;191331;97;62;23;2;21;.913;2451000;0
8910;-1;90;0;0;0;0;.00nan;0;0
8911;192739;92;0;0;0;0;.00nan;0;0
8911;189448;88;68;25;2;23;.920;3900000;0
8911;190106;92;99;38;2;36;.947;3900000;0
8911;191318;88;0;0;0;0;.00nan;0;0
8912;189644;95;78;24;1;23;.958;3600000;0
8912;195346;95;0;0;0;0;.00nan;0;0
8912;-1;93;46;19;3;16;.842;3529000;0
8912;197675;93;0;0;0;0;.00nan;0;0
8913;194502;86;65;25;2;23;.920;3600000;0
8913;189433;91;0;0;0;0;.00nan;0;0
8913;-1;86;0;0;0;0;.00nan;0;0
8913;-1;91;85;41;3;38;.927;3600000;0
8914;194759;104;0;0;0;0;.00nan;0;0
8914;-1;96;47;32;4;28;.875;3570000;0
8914;191255;104;87;31;2;29;.935;3600000;0
8914;-1;96;0;0;0;0;.00nan;0;0
8915;192733;99;100;39;0;39;1.000;3600000;0
8915;194531;99;0;0;0;0;.00nan;0;0
8915;194632;102;65;27;2;25;.926;3587000;0
8915;189573;102;0;0;0;0;.00nan;0;0
8916;192718;103;0;0;0;0;.00nan;0;0
8916;189439;107;75;49;4;45;.918;3575000;0
8916;189558;103;63;22;2;20;.909;3600000;0
8916;189581;107;0;0;0;0;.00nan;0;0
8917;197940;100;0;0;0;0;.00nan;0;0
8917;189333;100;61;32;4;28;.875;3900000;0
8917;207118;98;0;0;0;0;.00nan;0;0
8917;-1;98;57;32;4;28;.875;3900000;0
8918;194899;101;49;1;0;1;1.000;377000;0
8918;-1;94;81;26;1;25;.962;3600000;0
8918;-1;101;35;37;7;30;.811;3223000;0
8918;-1;94;0;0;0;0;.00nan;0;0
8919;189576;97;0;0;0;0;.00nan;0;0
8919;189628;89;88;30;1;29;.967;3600000;0
8919;-1;89;0;0;0;0;.00nan;0;0
8919;191331;97;54;34;5;29;.853;3600000;0
8920;-1;90;0;0;0;0;.00nan;0;0
8920;-1;93;0;0;0;0;.00nan;0;0
8920;-1;90;95;42;2;40;.952;3570000;0
8920;197675;93;85;30;1;29;.967;3600000;0
8921;192718;103;69;31;3;28;.903;3900000;0
8921;189439;107;0;0;0;0;.00nan;0;0
8921;189558;103;0;0;0;0;.00nan;0;0
8921;189581;107;61;25;3;22;.880;3900000;0
8922;194759;104;55;38;4;34;.895;3524000;0
8922;189433;91;90;35;2;33;.943;3600000;0
8922;191255;104;0;0;0;0;.00nan;0;0
8922;-1;91;0;0;0;0;.00nan;0;0
8923;207118;98;71;41;3;38;.927;3564000;0
8923;190831;106;86;30;2;28;.933;3600000;0
8923;-1;98;0;0;0;0;.00nan;0;0
8923;-1;106;0;0;0;0;.00nan;0;0
8924;194899;101;51;32;5;27;.844;3564000;0
8924;189639;105;69;31;3;28;.903;3600000;0
8924;-1;101;0;0;0;0;.00nan;0;0
8924;-1;105;0;0;0;0;.00nan;0;0
8925;197940;100;75;38;3;35;.921;3600000;0
8925;189333;100;0;0;0;0;.00nan;0;0
8925;-1;94;0;0;0;0;.00nan;0;0
8925;-1;94;41;34;6;28;.824;3600000;0
8926;192733;99;47;28;4;24;.857;3600000;0
8926;194531;99;0;0;0;0;.00nan;0;0
8926;194632;102;94;32;1;31;.969;3600000;0
8926;189573;102;0;0;0;0;.00nan;0;0
8927;189644;95;56;18;2;16;.889;3600000;0
8927;195346;95;0;0;0;0;.00nan;0;0
8927;-1;90;52;28;4;24;.857;3557000;0
8927;-1;90;0;0;0;0;.00nan;0;0
8928;194502;86;69;43;5;38;.884;3600000;0
8928;-1;86;0;0;0;0;.00nan;0;0
8928;-1;96;69;32;3;29;.906;3600000;0
8928;-1;96;0;0;0;0;.00nan;0;0
8929;189439;107;63;22;2;20;.909;3600000;0
8929;189581;107;0;0;0;0;.00nan;0;0
8929;-1;94;67;46;6;40;.870;3600000;0
8929;-1;94;0;0;0;0;.00nan;0;0
8930;192718;103;0;0;0;0;.00nan;0;0
8930;194899;101;0;0;0;0;.00nan;0;0
8930;189558;103;87;33;1;32;.970;3600000;0
8930;-1;101;51;44;6;38;.864;3600000;0
8931;197940;100;0;0;0;0;.00nan;0;0
8931;189333;100;67;38;4;34;.895;3600000;0
8931;189639;105;0;0;0;0;.00nan;0;0
8931;-1;105;66;19;1;18;.947;3600000;0
8932;189433;91;34;23;5;18;.783;3600000;0
8932;196495;87;81;27;2;25;.926;3600000;0
8932;-1;87;0;0;0;0;.00nan;0;0
8932;-1;91;0;0;0;0;.00nan;0;0
8933;194632;102;62;18;1;17;.944;3600000;0
8933;189573;102;0;0;0;0;.00nan;0;0
8933;190831;106;65;31;3;28;.903;3600000;0
8933;-1;106;0;0;0;0;.00nan;0;0
8934;194502;86;59;24;3;21;.875;3900000;0
8934;189433;91;0;0;0;0;.00nan;0;0
8934;-1;86;0;0;0;0;.00nan;0;0
8934;-1;91;87;37;3;34;.919;3900000;0
8935;189576;97;51;11;1;10;.909;1762000;0
8935;189644;95;100;32;0;32;1.000;3600000;0
8935;195346;95;0;0;0;0;.00nan;0;0
8935;191331;97;31;22;5;17;.773;1838000;0
8936;194502;86;32;20;4;16;.800;1492000;0
8936;196495;87;0;0;0;0;.00nan;0;0
8936;-1;87;80;14;0;14;1.000;3600000;0
8936;-1;86;20;22;6;16;.727;2108000;0
8937;189644;95;47;25;4;21;.840;3545000;0
8937;195346;95;0;0;0;0;.00nan;0;0
8937;-1;90;67;34;3;31;.912;3600000;0
8937;-1;90;0;0;0;0;.00nan;0;0
8938;192733;99;73;25;2;23;.920;3550000;0
8938;194531;99;0;0;0;0;.00nan;0;0
8938;189628;89;78;29;1;28;.966;3600000;0
8938;-1;89;0;0;0;0;.00nan;0;0
8939;189433;91;0;0;0;0;.00nan;0;0
8939;189448;88;100;38;1;37;.974;3600000;0
8939;191318;88;0;0;0;0;.00nan;0;0
8939;-1;91;27;37;7;30;.811;3600000;0
8940;192739;92;39;20;4;16;.800;3548000;0
8940;189576;97;92;44;3;41;.932;3600000;0
8940;190106;92;0;0;0;0;.00nan;0;0
8940;191331;97;0;0;0;0;.00nan;0;0
8941;-1;96;58;27;3;24;.889;3600000;0
8941;-1;93;0;0;0;0;.00nan;0;0
8941;197675;93;59;31;4;27;.871;3566000;0
8941;-1;96;0;0;0;0;.00nan;0;0
8942;192718;103;0;0;0;0;.00nan;0;0
8942;189558;103;72;45;4;41;.911;3600000;0
8942;189639;105;41;36;6;30;.833;3542000;0
8942;-1;105;0;0;0;0;.00nan;0;0
8943;194632;102;66;15;1;14;.933;3600000;0
8943;194899;101;59;40;5;35;.875;3600000;0
8943;189573;102;0;0;0;0;.00nan;0;0
8943;-1;101;0;0;0;0;.00nan;0;0
8944;190831;106;0;0;0;0;.00nan;0;0
8944;-1;94;91;42;2;40;.952;3552000;0
8944;-1;94;0;0;0;0;.00nan;0;0
8944;-1;106;100;37;0;37;1.000;3600000;0
8945;197940;100;0;0;0;0;.00nan;0;0
8945;189333;100;65;36;3;33;.917;3579000;0
8945;194759;104;0;0;0;0;.00nan;0;0
8945;191255;104;78;28;1;27;.964;3600000;0
8946;192733;99;100;34;0;34;1.000;3600000;0
8946;194531;99;0;0;0;0;.00nan;0;0
8946;196495;87;0;0;0;0;.00nan;0;0
8946;-1;87;31;35;6;29;.829;3600000;0
8947;194502;86;0;0;0;0;.00nan;0;0
8947;189448;88;43;23;4;19;.826;2525000;0
8947;-1;86;98;38;1;37;.974;3600000;0
8947;191318;88;20;11;4;7;.636;1075000;0
8948;189433;91;34;20;4;16;.800;3531000;0
8948;-1;90;0;0;0;0;.00nan;0;0
8948;-1;91;0;0;0;0;.00nan;0;0
8948;-1;90;92;39;2;37;.949;3600000;0
8949;189628;89;0;0;0;0;.00nan;0;0
8949;207118;98;0;0;0;0;.00nan;0;0
8949;-1;98;70;20;1;19;.950;3600000;0
8949;-1;89;85;54;5;49;.907;3600000;0
8950;192739;92;0;0;0;0;.00nan;0;0
8950;189576;97;20;31;7;24;.774;2672000;0
8950;190106;92;53;17;2;15;.882;3600000;0
8950;191331;97;49;7;1;6;.857;928000;0
8951;192718;103;72;32;2;30;.938;3900000;0
8951;189558;103;0;0;0;0;.00nan;0;0
8951;190831;106;0;0;0;0;.00nan;0;0
8951;-1;106;81;37;2;35;.946;3900000;0
8952;194632;102;0;0;0;0;.00nan;0;0
8952;194899;101;0;0;0;0;.00nan;0;0
8952;189573;102;71;18;1;17;.944;3600000;0
8952;-1;101;69;41;4;37;.902;3600000;0
8953;-1;96;0;0;0;0;.00nan;0;0
8953;-1;93;68;17;1;16;.941;3600000;0
8953;197675;93;0;0;0;0;.00nan;0;0
8953;-1;96;48;30;4;26;.867;3600000;0
8954;189439;107;0;0;0;0;.00nan;0;0
8954;189581;107;51;27;3;24;.889;3600000;0
8954;-1;94;79;31;1;30;.968;2473000;0
8954;-1;94;23;11;4;7;.636;1054000;0
8955;197940;100;77;29;1;28;.966;3600000;0
8955;189333;100;0;0;0;0;.00nan;0;0
8955;194759;104;0;0;0;0;.00nan;0;0
8955;191255;104;59;26;2;24;.923;3600000;0
8956;189448;88;0;0;0;0;.00nan;0;0
8956;189644;95;66;27;3;24;.889;3600000;0
8956;195346;95;0;0;0;0;.00nan;0;0
8956;191318;88;42;35;5;30;.857;3600000;0
8957;192718;103;0;0;0;0;.00nan;0;0
8957;194759;104;55;36;4;32;.889;3833000;0
8957;189558;103;70;30;3;27;.900;3833000;0
8957;191255;104;0;0;0;0;.00nan;0;0
8958;189439;107;90;34;1;33;.971;3600000;0
8958;189581;107;0;0;0;0;.00nan;0;0
8958;189639;105;75;28;2;26;.929;3544000;0
8958;-1;105;0;0;0;0;.00nan;0;0
8959;194502;86;94;32;1;31;.969;3600000;0
8959;207118;98;0;0;0;0;.00nan;0;0
8959;-1;86;0;0;0;0;.00nan;0;0
8959;-1;98;64;34;4;30;.882;3600000;0
8960;192733;99;49;32;5;27;.844;3578000;0
8960;194531;99;0;0;0;0;.00nan;0;0
8960;-1;90;0;0;0;0;.00nan;0;0
8960;-1;90;79;36;3;33;.917;3600000;0
8961;207118;98;100;43;2;41;.953;3900000;0
8961;196495;87;0;0;0;0;.00nan;0;0
8961;-1;87;65;27;2;25;.926;3900000;0
8961;-1;98;0;0;0;0;.00nan;0;0
8962;192733;99;47;26;4;22;.846;3600000;0
8962;194531;99;0;0;0;0;.00nan;0;0
8962;189448;88;63;16;1;15;.938;3600000;0
8962;191318;88;0;0;0;0;.00nan;0;0
8963;189433;91;0;0;0;0;.00nan;0;0
8963;189644;95;40;26;5;21;.808;3548000;0
8963;195346;95;0;0;0;0;.00nan;0;0
8963;-1;91;68;42;4;38;.905;3600000;0
8964;192739;92;0;0;0;0;.00nan;0;0
8964;190106;92;77;42;4;38;.905;3582000;0
8964;-1;93;100;41;2;39;.951;3600000;0
8964;197675;93;0;0;0;0;.00nan;0;0
8965;192718;103;0;0;0;0;.00nan;0;0
8965;189439;107;51;29;4;25;.862;2269000;0
8965;189558;103;99;28;0;28;1.000;3600000;0
8965;189581;107;38;6;2;4;.667;1331000;0
8966;189639;105;90;27;1;26;.963;3600000;0
8966;190831;106;0;0;0;0;.00nan;0;0
8966;-1;106;69;29;2;27;.931;3562000;0
8966;-1;105;0;0;0;0;.00nan;0;0
8967;194759;104;0;0;0;0;.00nan;0;0
8967;194899;101;0;0;0;0;.00nan;0;0
8967;-1;101;92;45;2;43;.956;3900000;0
8967;191255;104;89;38;2;36;.947;3900000;0
8968;189433;91;23;23;6;17;.739;3350000;0
8968;189576;97;59;8;0;8;1.000;641000;0
8968;191331;97;51;36;6;30;.833;3259000;0
8968;-1;91;46;2;0;2;1.000;550000;0
8969;192733;99;44;32;5;27;.844;3600000;0
8969;194502;86;100;32;0;32;1.000;3600000;0
8969;194531;99;0;0;0;0;.00nan;0;0
8969;-1;86;0;0;0;0;.00nan;0;0
8970;207118;98;0;0;0;0;.00nan;0;0
8970;-1;90;0;0;0;0;.00nan;0;0
8970;-1;98;100;27;0;27;1.000;3600000;0
8970;-1;90;54;42;5;37;.881;3600000;0
8971;189644;95;65;32;3;29;.906;3591000;0
8971;195346;95;0;0;0;0;.00nan;0;0
8971;-1;93;78;33;2;31;.939;3600000;0
8971;197675;93;0;0;0;0;.00nan;0;0
8972;192739;92;0;0;0;0;.00nan;0;0
8972;189628;89;74;44;4;40;.909;3580000;0
8972;190106;92;73;25;2;23;.920;3600000;0
8972;-1;89;0;0;0;0;.00nan;0;0
8973;189576;97;0;0;0;0;.00nan;0;0
8973;-1;96;100;29;0;29;1.000;3600000;0
8973;191331;97;98;48;3;45;.938;3600000;0
8973;-1;96;0;0;0;0;.00nan;0;0
8974;189439;107;0;0;0;0;.00nan;0;0
8974;194899;101;0;0;0;0;.00nan;0;0
8974;189581;107;66;23;3;20;.870;3600000;0
8974;-1;101;58;40;5;35;.875;3546000;0
8975;197940;100;100;28;0;28;1.000;3600000;0
8975;189333;100;0;0;0;0;.00nan;0;0
8975;190831;106;0;0;0;0;.00nan;0;0
8975;-1;106;58;32;4;28;.875;3600000;0
8976;192718;103;0;0;0;0;.00nan;0;0
8976;189558;103;40;22;4;18;.818;3540000;0
8976;189639;105;0;0;0;0;.00nan;0;0
8976;-1;105;70;25;2;23;.920;3600000;0
8977;194632;102;79;13;0;13;1.000;3600000;0
8977;189573;102;0;0;0;0;.00nan;0;0
8977;-1;94;79;65;7;58;.892;3600000;0
8977;-1;94;0;0;0;0;.00nan;0;0
8978;194502;86;68;36;4;32;.889;3900000;0
8978;196495;87;53;28;4;24;.857;3900000;0
8978;-1;87;0;0;0;0;.00nan;0;0
8978;-1;86;0;0;0;0;.00nan;0;0
8979;189448;88;69;22;1;21;.955;3600000;0
8979;207118;98;40;3;1;2;.667;249000;0
8979;-1;98;33;29;6;23;.793;3351000;0
8979;191318;88;0;0;0;0;.00nan;0;0
8980;192739;92;56;25;3;22;.880;3594000;0
8980;190106;92;0;0;0;0;.00nan;0;0
8980;-1;93;0;0;0;0;.00nan;0;0
8980;197675;93;71;27;2;25;.926;3600000;0
8981;192718;103;35;11;3;8;.727;491000;0
8981;189558;103;67;40;4;36;.900;3109000;0
8981;189639;105;76;28;2;26;.929;3600000;0
8981;-1;105;0;0;0;0;.00nan;0;0
8982;189433;91;0;0;0;0;.00nan;0;0
8982;189628;89;0;0;0;0;.00nan;0;0
8982;-1;89;72;42;5;37;.881;3600000;0
8982;-1;91;93;41;3;38;.927;3600000;0
8983;194759;104;0;0;0;0;.00nan;0;0
8983;190831;106;50;34;5;29;.853;3600000;0
8983;191255;104;70;27;2;25;.926;3600000;0
8983;-1;106;0;0;0;0;.00nan;0;0
8984;194632;102;62;22;2;20;.909;3600000;0
8984;189573;102;0;0;0;0;.00nan;0;0
8984;-1;94;0;0;0;0;.00nan;0;0
8984;-1;94;76;35;3;32;.914;3600000;0
8985;197940;100;0;0;0;0;.00nan;0;0
8985;189333;100;65;21;2;19;.905;3600000;0
8985;194899;101;95;54;3;51;.944;3600000;0
8985;-1;101;0;0;0;0;.00nan;0;0
8986;189576;97;53;11;1;10;.909;848000;0
8986;189644;95;67;21;1;20;.952;3600000;0
8986;195346;95;0;0;0;0;.00nan;0;0
8986;191331;97;52;42;6;36;.857;2752000;0
8987;189628;89;47;35;5;30;.857;3556000;0
8987;-1;96;66;35;4;31;.886;3600000;0
8987;-1;89;0;0;0;0;.00nan;0;0
8987;-1;96;0;0;0;0;.00nan;0;0
8988;194759;104;55;35;4;31;.886;3573000;0
8988;189439;107;69;28;3;25;.893;3600000;0
8988;189581;107;0;0;0;0;.00nan;0;0
8988;191255;104;0;0;0;0;.00nan;0;0
8989;197940;100;58;30;3;27;.900;3600000;0
8989;189333;100;0;0;0;0;.00nan;0;0
8989;190831;106;0;0;0;0;.00nan;0;0
8989;-1;106;35;33;6;27;.818;3600000;0
8990;189628;89;58;40;5;35;.875;3600000;0
8990;196495;87;87;41;2;39;.951;3600000;0
8990;-1;87;0;0;0;0;.00nan;0;0
8990;-1;89;0;0;0;0;.00nan;0;0
8991;189448;88;31;32;6;26;.813;2943000;0
8991;-1;90;0;0;0;0;.00nan;0;0
8991;191318;88;47;7;1;6;.857;651000;0
8991;-1;90;62;37;5;32;.865;3600000;0
8992;192739;92;55;26;3;23;.885;3600000;0
8992;189576;97;40;30;6;24;.800;2708000;0
8992;196532;92;0;0;0;0;.00nan;0;0
8992;191331;97;56;6;0;6;1.000;892000;0
8993;189433;91;66;18;1;17;.944;3600000;0
8993;-1;93;64;41;5;36;.878;3600000;0
8993;-1;91;0;0;0;0;.00nan;0;0
8993;197675;93;0;0;0;0;.00nan;0;0
8994;197962;99;0;0;0;0;.00nan;0;0
8994;194531;99;96;46;2;44;.957;3600000;0
8994;207118;98;0;0;0;0;.00nan;0;0
8994;-1;98;70;38;4;34;.895;3541000;0
8995;194899;101;0;0;0;0;.00nan;0;0
8995;-1;96;87;33;1;32;.970;3600000;0
8995;-1;101;52;39;6;33;.846;3600000;0
8995;-1;96;0;0;0;0;.00nan;0;0
8996;197940;100;60;26;3;23;.885;3600000;0
8996;194632;102;48;40;6;34;.850;3600000;0
8996;189333;100;0;0;0;0;.00nan;0;0
8996;189573;102;0;0;0;0;.00nan;0;0
8997;189439;107;0;0;0;0;.00nan;0;0
8997;189581;107;67;40;5;35;.875;3600000;0
8997;189639;105;38;35;6;29;.829;3583000;0
8997;-1;105;0;0;0;0;.00nan;0;0
8998;192718;103;0;0;0;0;.00nan;0;0
8998;189558;103;67;27;2;25;.926;3600000;0
8998;196525;94;0;0;0;0;.00nan;0;0
8998;-1;94;100;23;0;23;1.000;3600000;0
8999;194632;102;0;0;0;0;.00nan;0;0
8999;189439;107;100;44;0;44;1.000;3600000;0
8999;189573;102;60;37;4;33;.892;3600000;0
8999;189581;107;0;0;0;0;.00nan;0;0
9000;192718;103;70;19;1;18;.947;3600000;0
9000;189558;103;0;0;0;0;.00nan;0;0
9000;190831;106;26;36;7;29;.806;3600000;0
9000;-1;106;0;0;0;0;.00nan;0;0
9001;194899;101;42;49;8;41;.837;3600000;0
9001;189644;95;57;20;3;17;.850;3600000;0
9001;195346;95;0;0;0;0;.00nan;0;0
9001;-1;101;0;0;0;0;.00nan;0;0
9002;189448;88;52;25;3;22;.880;3568000;0
9002;196495;87;0;0;0;0;.00nan;0;0
9002;-1;87;78;30;2;28;.933;3600000;0
9002;191318;88;0;0;0;0;.00nan;0;0
9003;194502;86;60;20;2;18;.900;3600000;0
9003;189628;89;70;53;6;47;.887;3361000;0
9003;-1;86;0;0;0;0;.00nan;0;0
9003;-1;89;39;1;1;0;.000;239000;0
9004;192739;92;61;20;2;18;.900;3600000;0
9004;189433;91;0;0;0;0;.00nan;0;0
9004;196532;92;0;0;0;0;.00nan;0;0
9004;-1;91;52;43;6;37;.860;3600000;0
9005;189576;97;60;49;6;43;.878;3600000;0
9005;-1;93;55;17;2;15;.882;3600000;0
9005;191331;97;0;0;0;0;.00nan;0;0
9005;197675;93;0;0;0;0;.00nan;0;0
9006;197940;100;0;0;0;0;.00nan;0;0
9006;189333;100;74;31;3;28;.903;3600000;0
9006;-1;96;57;36;5;31;.861;3533000;0
9006;-1;96;0;0;0;0;.00nan;0;0
9007;197962;99;0;0;0;0;.00nan;0;0
9007;194531;99;47;53;7;46;.868;3900000;0
9007;207118;98;35;31;6;25;.806;2802000;0
9007;-1;98;49;5;1;4;.800;1098000;0
9008;194502;86;0;0;0;0;.00nan;0;0
9008;-1;90;0;0;0;0;.00nan;0;0
9008;-1;86;75;36;3;33;.917;3871000;0
9008;-1;90;59;34;4;30;.882;3871000;0
9009;189628;89;0;0;0;0;.00nan;0;0
9009;196495;87;57;24;2;22;.917;3600000;0
9009;-1;87;0;0;0;0;.00nan;0;0
9009;-1;89;64;32;3;29;.906;3542000;0
9010;189433;91;44;15;3;12;.800;3641000;0
9010;189576;97;0;0;0;0;.00nan;0;0
9010;191331;97;93;43;2;41;.953;3641000;0
9010;-1;91;0;0;0;0;.00nan;0;0
9011;197962;99;90;40;2;38;.950;3596000;0
9011;194531;99;0;0;0;0;.00nan;0;0
9011;194899;101;0;0;0;0;.00nan;0;0
9011;-1;101;90;18;0;18;1.000;3600000;0
9012;192739;92;0;0;0;0;.00nan;0;0
9012;196532;92;33;33;6;27;.818;3553000;0
9012;-1;93;0;0;0;0;.00nan;0;0
9012;197675;93;39;23;4;19;.826;3600000;0
9013;194759;104;0;0;0;0;.00nan;0;0
9013;190831;106;0;0;0;0;.00nan;0;0
9013;191255;104;67;38;4;34;.895;3558000;0
9013;-1;106;74;34;3;31;.912;3600000;0
9014;189639;105;70;25;2;23;.920;3625000;0
9014;196525;94;83;44;3;41;.932;3625000;0
9014;-1;94;0;0;0;0;.00nan;0;0
9014;-1;105;0;0;0;0;.00nan;0;0
9015;194632;102;56;27;3;24;.889;3900000;0
9015;189573;102;0;0;0;0;.00nan;0;0
9015;-1;96;0;0;0;0;.00nan;0;0
9015;-1;96;63;27;3;24;.889;3900000;0
9016;189644;95;42;26;4;22;.846;3600000;0
9016;195346;95;0;0;0;0;.00nan;0;0
9016;207118;98;0;0;0;0;.00nan;0;0
9016;-1;98;79;40;3;37;.925;3600000;0
9017;189439;107;76;30;2;28;.933;3600000;0
9017;189581;107;0;0;0;0;.00nan;0;0
9017;190831;106;60;30;3;27;.900;3543000;0
9017;-1;106;0;0;0;0;.00nan;0;0
9018;197940;100;60;42;5;37;.881;3900000;0
9018;192718;103;0;0;0;0;.00nan;0;0
9018;189333;100;0;0;0;0;.00nan;0;0
9018;189558;103;57;35;5;30;.857;3900000;0
9019;189639;105;0;0;0;0;.00nan;0;0
9019;196525;94;91;41;2;39;.951;3600000;0
9019;-1;94;0;0;0;0;.00nan;0;0
9019;-1;105;61;28;4;24;.857;3559000;0
9020;194502;86;100;26;0;26;1.000;3600000;0
9020;189628;89;80;47;3;44;.936;3600000;0
9020;-1;86;0;0;0;0;.00nan;0;0
9020;-1;89;0;0;0;0;.00nan;0;0
9021;189448;88;74;30;3;27;.900;3600000;0
9021;196495;87;49;12;2;10;.833;1756000;0
9021;-1;87;40;19;4;15;.789;1844000;0
9021;191318;88;0;0;0;0;.00nan;0;0
9022;194632;102;52;29;4;25;.862;3563000;0
9022;189573;102;0;0;0;0;.00nan;0;0
9022;189644;95;91;37;2;35;.946;3600000;0
9022;195346;95;0;0;0;0;.00nan;0;0
9023;194759;104;0;0;0;0;.00nan;0;0
9023;-1;96;78;48;5;43;.896;3900000;0
9023;191255;104;36;33;5;28;.848;3900000;0
9023;-1;96;0;0;0;0;.00nan;0;0
9024;189433;91;54;32;5;27;.844;3855000;0
9024;-1;93;47;28;4;24;.857;3855000;0
9024;-1;91;0;0;0;0;.00nan;0;0
9024;197675;93;0;0;0;0;.00nan;0;0
9025;192739;92;73;37;3;34;.919;3897000;0
9025;189576;97;0;0;0;0;.00nan;0;0
9025;196532;92;0;0;0;0;.00nan;0;0
9025;191331;97;47;23;4;19;.826;3897000;0
9026;189439;107;0;0;0;0;.00nan;0;0
9026;194899;101;0;0;0;0;.00nan;0;0
9026;189581;107;47;37;6;31;.838;3600000;0
9026;-1;101;50;36;5;31;.861;3600000;0
9027;197962;99;0;0;0;0;.00nan;0;0
9027;194531;99;24;31;7;24;.774;3600000;0
9027;-1;96;72;19;1;18;.947;3600000;0
9027;-1;96;0;0;0;0;.00nan;0;0
9028;197940;100;0;0;0;0;.00nan;0;0
9028;189333;100;88;53;3;50;.943;3600000;0
9028;189644;95;86;15;0;15;1.000;3600000;0
9028;195346;95;0;0;0;0;.00nan;0;0
9029;194502;86;74;22;1;21;.955;3600000;0
9029;-1;90;78;42;3;39;.929;3600000;0
9029;-1;86;0;0;0;0;.00nan;0;0
9029;-1;90;0;0;0;0;.00nan;0;0
9030;189448;88;47;27;4;23;.852;3593000;0
9030;189628;89;99;39;2;37;.949;3600000;0
9030;-1;89;0;0;0;0;.00nan;0;0
9030;191318;88;0;0;0;0;.00nan;0;0
9031;189576;97;68;42;4;38;.905;3650000;0
9031;189639;105;40;15;3;12;.800;3650000;0
9031;191331;97;0;0;0;0;.00nan;0;0
9031;192445;105;0;0;0;0;.00nan;0;0
9032;192739;92;54;20;3;17;.850;3600000;0
9032;196525;94;47;35;5;30;.857;3590000;0
9032;196532;92;0;0;0;0;.00nan;0;0
9032;-1;94;0;0;0;0;.00nan;0;0
9033;189433;91;0;0;0;0;.00nan;0;0
9033;-1;93;61;29;3;26;.897;3600000;0
9033;-1;91;58;34;4;30;.882;3580000;0
9033;197675;93;0;0;0;0;.00nan;0;0
9034;197962;99;0;0;0;0;.00nan;0;0
9034;194531;99;100;39;2;37;.949;3600000;0
9034;189644;95;64;24;3;21;.875;3552000;0
9034;195346;95;0;0;0;0;.00nan;0;0
9035;192718;103;0;0;0;0;.00nan;0;0
9035;194759;104;0;0;0;0;.00nan;0;0
9035;189558;103;100;36;0;36;1.000;3600000;0
9035;191255;104;59;35;4;31;.886;3600000;0
9036;207118;98;0;0;0;0;.00nan;0;0
9036;-1;96;78;38;3;35;.921;3547000;0
9036;-1;98;66;24;2;22;.917;3600000;0
9036;-1;96;0;0;0;0;.00nan;0;0
9037;194899;101;85;29;2;27;.931;3600000;0
9037;190831;106;74;34;3;31;.912;3561000;0
9037;-1;101;0;0;0;0;.00nan;0;0
9037;-1;106;0;0;0;0;.00nan;0;0
9038;197940;100;65;36;4;32;.889;3600000;0
9038;189333;100;0;0;0;0;.00nan;0;0
9038;196495;87;100;27;0;27;1.000;3600000;0
9038;-1;87;0;0;0;0;.00nan;0;0
9039;189448;88;0;0;0;0;.00nan;0;0
9039;-1;90;0;0;0;0;.00nan;0;0
9039;191318;88;75;38;3;35;.921;3900000;0
9039;-1;90;58;29;3;26;.897;3900000;0
9040;194632;102;43;32;5;27;.844;3825000;0
9040;189573;102;0;0;0;0;.00nan;0;0
9040;189628;89;0;0;0;0;.00nan;0;0
9040;-1;89;55;29;4;25;.862;3825000;0
9041;194502;86;28;24;6;18;.750;3082000;0
9041;189576;97;0;0;0;0;.00nan;0;0
9041;-1;86;41;4;1;3;.750;518000;0
9041;191331;97;77;41;3;38;.927;3600000;0
9042;196525;94;55;35;4;31;.886;3600000;0
9042;-1;93;0;0;0;0;.00nan;0;0
9042;-1;94;0;0;0;0;.00nan;0;0
9042;197675;93;65;18;1;17;.944;3600000;0
9043;192718;103;0;0;0;0;.00nan;0;0
9043;194899;101;0;0;0;0;.00nan;0;0
9043;189558;103;4;12;6;6;.500;3600000;0
9043;-1;101;97;49;3;46;.939;3600000;0
9044;189439;107;0;0;0;0;.00nan;0;0
9044;189581;107;84;32;2;30;.938;3600000;0
9044;207118;98;0;0;0;0;.00nan;0;0
9044;-1;98;43;27;4;23;.852;3517000;0
9045;194759;104;85;27;1;26;.963;3600000;0
9045;190831;106;0;0;0;0;.00nan;0;0
9045;191255;104;0;0;0;0;.00nan;0;0
9045;-1;106;86;37;2;35;.946;3569000;0
9046;189644;95;0;0;0;0;.00nan;0;0
9046;195346;95;45;31;5;26;.839;3569000;0
9046;-1;96;77;37;4;33;.892;3600000;0
9046;-1;96;0;0;0;0;.00nan;0;0
9047;189639;105;0;0;0;0;.00nan;0;0
9047;-1;93;47;15;3;12;.800;453000;0
9047;192445;105;78;35;2;33;.943;3600000;0
9047;197675;93;31;32;7;25;.781;3147000;0
9048;194759;104;0;0;0;0;.00nan;0;0
9048;194899;101;61;34;4;30;.882;3596000;0
9048;-1;101;0;0;0;0;.00nan;0;0
9048;191255;104;49;22;3;19;.864;3600000;0
9049;194632;102;100;38;0;38;1.000;3600000;0
9049;189573;102;0;0;0;0;.00nan;0;0
9049;196495;87;29;17;4;13;.765;3600000;0
9049;-1;87;0;0;0;0;.00nan;0;0
9050;197940;100;0;0;0;0;.00nan;0;0
9050;189333;100;37;23;5;18;.783;3600000;0
9050;-1;90;56;38;4;34;.895;3600000;0
9050;-1;90;0;0;0;0;.00nan;0;0
9051;192739;92;76;38;3;35;.921;3564000;0
9051;189639;105;55;14;2;12;.857;3600000;0
9051;196532;92;0;0;0;0;.00nan;0;0
9051;192445;105;0;0;0;0;.00nan;0;0
9052;189576;97;33;26;5;21;.808;3584000;0
9052;196525;94;54;32;4;28;.875;3600000;0
9052;-1;94;0;0;0;0;.00nan;0;0
9052;191331;97;0;0;0;0;.00nan;0;0
9053;194502;86;69;15;1;14;.933;3590000;0
9053;194632;102;100;36;0;36;1.000;3600000;0
9053;189573;102;0;0;0;0;.00nan;0;0
9053;-1;86;0;0;0;0;.00nan;0;0
9054;197940;100;0;0;0;0;.00nan;0;0
9054;189333;100;59;30;4;26;.867;3544000;0
9054;189448;88;65;33;3;30;.909;3600000;0
9054;191318;88;0;0;0;0;.00nan;0;0
9055;189433;91;60;9;0;9;1.000;486000;0
9055;189639;105;0;0;0;0;.00nan;0;0
9055;192445;105;39;24;5;19;.792;3600000;0
9055;-1;91;31;29;6;23;.793;3066000;0
9056;207118;98;0;0;0;0;.00nan;0;0
9056;190831;106;72;32;2;30;.938;3600000;0
9056;-1;98;52;30;4;26;.867;3550000;0
9056;-1;106;0;0;0;0;.00nan;0;0
9057;196525;94;60;40;5;35;.875;3600000;0
9057;-1;96;65;25;2;23;.920;3600000;0
9057;-1;94;0;0;0;0;.00nan;0;0
9057;-1;96;0;0;0;0;.00nan;0;0
9058;189639;105;68;37;4;33;.892;3544000;0
9058;189644;95;79;34;3;31;.912;3600000;0
9058;195346;95;0;0;0;0;.00nan;0;0
9058;192445;105;0;0;0;0;.00nan;0;0
9059;189576;97;72;32;2;30;.938;3096000;0
9059;196495;87;45;20;4;16;.800;3600000;0
9059;-1;87;0;0;0;0;.00nan;0;0
9059;191331;97;23;9;4;5;.556;462000;0
9060;194632;102;86;24;1;23;.958;3600000;0
9060;189573;102;0;0;0;0;.00nan;0;0
9060;-1;90;66;41;5;36;.878;3600000;0
9060;-1;90;0;0;0;0;.00nan;0;0
9061;197940;100;44;24;4;20;.833;3877000;0
9061;189333;100;0;0;0;0;.00nan;0;0
9061;189628;89;49;37;5;32;.865;3877000;0
9061;-1;89;0;0;0;0;.00nan;0;0
9062;192739;92;0;0;0;0;.00nan;0;0
9062;190106;92;73;36;3;33;.917;3600000;0
9062;-1;93;74;24;2;22;.917;3600000;0
9062;197675;93;0;0;0;0;.00nan;0;0
9063;189433;91;46;22;4;18;.818;3600000;0
9063;196525;94;58;51;6;45;.882;3600000;0
9063;-1;94;0;0;0;0;.00nan;0;0
9063;-1;91;0;0;0;0;.00nan;0;0
9064;192733;99;77;27;1;26;.963;3600000;0
9064;194531;99;0;0;0;0;.00nan;0;0
9064;191255;104;67;40;5;35;.875;3600000;0
9064;208300;104;0;0;0;0;.00nan;0;0
9065;194899;101;0;0;0;0;.00nan;0;0
9065;207118;98;0;0;0;0;.00nan;0;0
9065;-1;98;30;30;6;24;.800;3600000;0
9065;-1;101;91;45;3;42;.933;3600000;0
9066;192718;103;0;0;0;0;.00nan;0;0
9066;189558;103;63;33;5;28;.848;3875000;0
9066;190831;106;0;0;0;0;.00nan;0;0
9066;-1;106;79;43;4;39;.907;3875000;0
9067;197940;100;0;0;0;0;.00nan;0;0
9067;194502;86;63;17;2;15;.882;3600000;0
9067;189333;100;74;35;3;32;.914;3571000;0
9067;-1;86;0;0;0;0;.00nan;0;0
9068;189628;89;0;0;0;0;.00nan;0;0
9068;-1;90;0;0;0;0;.00nan;0;0
9068;-1;89;44;37;6;31;.838;3600000;0
9068;-1;90;42;33;5;28;.848;3600000;0
9069;194632;102;0;0;0;0;.00nan;0;0
9069;189448;88;68;29;3;26;.897;3900000;0
9069;189573;102;66;30;3;27;.900;3900000;0
9069;191318;88;0;0;0;0;.00nan;0;0
9070;192739;92;76;34;3;31;.912;3555000;0
9070;190106;92;0;0;0;0;.00nan;0;0
9070;-1;93;0;0;0;0;.00nan;0;0
9070;197675;93;83;28;1;27;.964;3600000;0
9071;192718;103;59;32;4;28;.875;3600000;0
9071;189558;103;0;0;0;0;.00nan;0;0
9071;190831;106;85;42;3;39;.929;3600000;0
9071;-1;106;0;0;0;0;.00nan;0;0
9072;194899;101;60;38;4;34;.895;3900000;0
9072;207118;98;64;38;4;34;.895;3862000;0
9072;-1;98;0;0;0;0;.00nan;0;0
9072;-1;101;0;0;0;0;.00nan;0;0
9073;189433;91;84;25;2;23;.920;3600000;0
9073;-1;96;73;49;6;43;.878;3600000;0
9073;-1;91;0;0;0;0;.00nan;0;0
9073;-1;96;0;0;0;0;.00nan;0;0
9074;192733;99;0;0;0;0;.00nan;0;0
9074;194531;99;34;34;6;28;.824;3600000;0
9074;191255;104;0;0;0;0;.00nan;0;0
9074;208300;104;75;28;2;26;.929;3600000;0
9075;196495;87;0;0;0;0;.00nan;0;0
9075;-1;90;45;41;6;35;.854;2683000;0
9075;-1;87;48;19;3;16;.842;3600000;0
9075;-1;90;49;8;1;7;.875;917000;0
9076;189644;95;32;21;5;16;.762;3595000;0
9076;195346;95;0;0;0;0;.00nan;0;0
9076;196525;94;61;46;6;40;.870;3600000;0
9076;-1;94;0;0;0;0;.00nan;0;0
9077;189448;88;0;0;0;0;.00nan;0;0
9077;189628;89;50;49;8;41;.837;3600000;0
9077;-1;89;0;0;0;0;.00nan;0;0
9077;191318;88;60;13;1;12;.923;3600000;0
9078;189639;105;61;33;4;29;.879;3600000;0
9078;-1;96;0;0;0;0;.00nan;0;0
9078;192445;105;0;0;0;0;.00nan;0;0
9078;-1;96;100;39;1;38;.974;3600000;0
9079;189439;107;0;0;0;0;.00nan;0;0
9079;189581;107;92;22;0;22;1.000;3600000;0
9079;191255;104;76;33;3;30;.909;3600000;0
9079;208300;104;0;0;0;0;.00nan;0;0
9080;192718;103;0;0;0;0;.00nan;0;0
9080;192733;99;100;35;0;35;1.000;3600000;0
9080;194531;99;0;0;0;0;.00nan;0;0
9080;189558;103;72;37;2;35;.946;3577000;0
9081;189576;97;64;14;1;13;.929;1671000;0
9081;-1;93;40;14;3;11;.786;3600000;0
9081;191331;97;1;24;8;16;.667;1929000;0
9081;197675;93;0;0;0;0;.00nan;0;0
9082;192733;99;49;33;5;28;.848;3600000;0
9082;194531;99;0;0;0;0;.00nan;0;0
9082;189439;107;0;0;0;0;.00nan;0;0
9082;189581;107;77;33;2;31;.939;3600000;0
9083;192739;92;0;0;0;0;.00nan;0;0
9083;194502;86;100;45;2;43;.956;3600000;0
9083;190106;92;66;27;3;24;.889;3549000;0
9083;-1;86;0;0;0;0;.00nan;0;0
9084;189433;91;0;0;0;0;.00nan;0;0
9084;189448;88;0;0;0;0;.00nan;0;0
9084;191318;88;65;37;4;33;.892;3900000;0
9084;-1;91;73;37;4;33;.892;3900000;0
9085;192718;103;0;0;0;0;.00nan;0;0
9085;189558;103;67;32;2;30;.938;3900000;0
9085;207118;98;99;45;2;43;.956;3900000;0
9085;-1;98;0;0;0;0;.00nan;0;0
9086;192739;92;76;16;0;16;1.000;1320000;0
9086;189628;89;62;29;3;26;.897;3600000;0
9086;190106;92;43;19;4;15;.789;2280000;0
9086;-1;89;0;0;0;0;.00nan;0;0
9087;194502;86;46;37;5;32;.865;3600000;0
9087;189576;97;100;42;1;41;.976;3600000;0
9087;-1;86;0;0;0;0;.00nan;0;0
9087;191331;97;0;0;0;0;.00nan;0;0
9088;189448;88;50;10;1;9;.900;615000;0
9088;189644;95;18;6;4;2;.333;968000;0
9088;195346;95;64;21;1;20;.952;2632000;0
9088;191318;88;29;28;6;22;.786;2959000;0
9089;189433;91;76;44;4;40;.909;3600000;0
9089;-1;93;82;14;0;14;1.000;3600000;0
9089;-1;91;0;0;0;0;.00nan;0;0
9089;197675;93;0;0;0;0;.00nan;0;0
9090;192718;103;0;0;0;0;.00nan;0;0
9090;194899;101;0;0;0;0;.00nan;0;0
9090;189558;103;56;29;3;26;.897;3546000;0
9090;-1;101;93;41;1;40;.976;3600000;0
9091;-1;90;0;0;0;0;.00nan;0;0
9091;-1;96;81;38;3;35;.921;3678000;0
9091;-1;90;70;28;2;26;.929;3694000;0
9091;-1;96;0;0;0;0;.00nan;0;0
9092;197940;100;87;35;2;33;.943;3627000;0
9092;189333;100;0;0;0;0;.00nan;0;0
9092;207118;98;0;0;0;0;.00nan;0;0
9092;-1;98;67;28;3;25;.893;3627000;0
9093;189639;105;81;25;1;24;.960;3600000;0
9093;191255;104;62;31;3;28;.903;3518000;0
9093;192445;105;0;0;0;0;.00nan;0;0
9093;208300;104;0;0;0;0;.00nan;0;0
9094;196525;94;41;36;6;30;.833;3600000;0
9094;190831;106;6;9;5;4;.444;832000;0
9094;-1;94;0;0;0;0;.00nan;0;0
9094;-1;106;63;24;2;22;.917;2738000;0
9095;192733;99;74;34;3;31;.912;3600000;0
9095;194531;99;0;0;0;0;.00nan;0;0
9095;194632;102;49;33;5;28;.848;3594000;0
9095;189573;102;0;0;0;0;.00nan;0;0
9096;192739;92;27;8;3;5;.625;585000;0
9096;190106;92;68;24;2;22;.917;3015000;0
9096;196495;87;66;36;4;32;.889;3600000;0
9096;-1;87;0;0;0;0;.00nan;0;0
9097;194502;86;59;21;3;18;.857;3600000;0
9097;189576;97;0;0;0;0;.00nan;0;0
9097;-1;86;0;0;0;0;.00nan;0;0
9097;191331;97;77;50;5;45;.900;3514000;0
9098;189628;89;0;0;0;0;.00nan;0;0
9098;-1;93;83;36;2;34;.944;3600000;0
9098;-1;89;65;43;5;38;.884;3600000;0
9098;197675;93;0;0;0;0;.00nan;0;0
9099;192718;103;72;42;4;38;.905;3900000;0
9099;194899;101;50;32;4;28;.875;3900000;0
9099;189558;103;0;0;0;0;.00nan;0;0
9099;-1;101;0;0;0;0;.00nan;0;0
9100;189433;91;0;0;0;0;.00nan;0;0
9100;-1;90;42;34;5;29;.853;3600000;0
9100;-1;91;90;35;1;34;.971;3600000;0
9100;-1;90;0;0;0;0;.00nan;0;0
9101;189439;107;57;26;3;23;.885;2640000;0
9101;189581;107;17;9;4;5;.556;960000;0
9101;189639;105;0;0;0;0;.00nan;0;0
9101;192445;105;49;30;5;25;.833;3600000;0
9102;196525;94;56;18;3;15;.833;3695000;0
9102;190831;106;82;43;4;39;.907;3695000;0
9102;-1;94;0;0;0;0;.00nan;0;0
9102;-1;106;0;0;0;0;.00nan;0;0
9103;197940;100;0;0;0;0;.00nan;0;0
9103;189333;100;52;31;4;27;.871;3547000;0
9103;207118;98;67;35;3;32;.914;3600000;0
9103;-1;98;0;0;0;0;.00nan;0;0
9104;196495;87;0;0;0;0;.00nan;0;0
9104;-1;87;60;24;3;21;.875;3600000;0
9104;-1;93;0;0;0;0;.00nan;0;0
9104;197675;93;64;42;5;37;.881;3600000;0
9105;189644;95;60;18;2;16;.889;3600000;0
9105;195346;95;0;0;0;0;.00nan;0;0
9105;-1;90;0;0;0;0;.00nan;0;0
9105;-1;90;51;44;6;38;.864;3600000;0
9106;189448;88;0;0;0;0;.00nan;0;0
9106;-1;96;57;33;4;29;.879;3600000;0
9106;191318;88;34;26;5;21;.808;3544000;0
9106;-1;96;0;0;0;0;.00nan;0;0
9107;192733;99;0;0;0;0;.00nan;0;0
9107;194531;99;25;37;8;29;.784;3600000;0
9107;194632;102;0;0;0;0;.00nan;0;0
9107;189573;102;54;37;5;32;.865;3600000;0
9108;196525;94;42;26;4;22;.846;1957000;0
9108;-1;94;57;18;2;16;.889;1605000;0
9108;191255;104;44;27;5;22;.815;3600000;0
9108;208300;104;0;0;0;0;.00nan;0;0
9109;189439;107;0;0;0;0;.00nan;0;0
9109;189581;107;54;32;4;28;.875;3566000;0
9109;190831;106;0;0;0;0;.00nan;0;0
9109;-1;106;83;39;2;37;.949;3600000;0
9110;189439;107;0;0;0;0;.00nan;0;0
9110;189581;107;84;28;1;27;.964;3600000;0
9110;196525;94;49;29;5;24;.828;3600000;0
9110;-1;94;0;0;0;0;.00nan;0;0
9111;207118;98;25;4;3;1;.250;349000;0
9111;-1;98;85;25;1;24;.960;3251000;0
9111;191255;104;63;41;5;36;.878;3591000;0
9111;208300;104;0;0;0;0;.00nan;0;0
9112;194502;86;9;23;7;16;.696;3141000;0
9112;-1;86;52;2;0;2;1.000;459000;0
9112;-1;93;58;32;4;28;.875;3600000;0
9112;197675;93;0;0;0;0;.00nan;0;0
9113;189448;88;59;24;2;22;.917;3600000;0
9113;-1;90;75;25;1;24;.960;3600000;0
9113;191318;88;0;0;0;0;.00nan;0;0
9113;-1;90;0;0;0;0;.00nan;0;0
9114;189644;95;95;35;1;34;.971;3600000;0
9114;195346;95;0;0;0;0;.00nan;0;0
9114;196495;87;67;29;2;27;.931;3575000;0
9114;-1;87;0;0;0;0;.00nan;0;0
9115;192739;92;62;24;2;22;.917;3593000;0
9115;189628;89;100;40;0;40;1.000;3600000;0
9115;190106;92;0;0;0;0;.00nan;0;0
9115;-1;89;0;0;0;0;.00nan;0;0
9116;189433;91;93;34;1;33;.971;3900000;0
9116;-1;96;100;45;1;44;.978;3900000;0
9116;-1;91;0;0;0;0;.00nan;0;0
9116;-1;96;0;0;0;0;.00nan;0;0
9117;189439;107;0;0;0;0;.00nan;0;0
9117;189581;107;76;32;2;30;.938;3600000;0
9117;190831;106;49;26;4;22;.846;3599000;0
9117;-1;106;0;0;0;0;.00nan;0;0
9118;197940;100;98;39;2;37;.949;3600000;0
9118;194632;102;37;18;4;14;.778;3517000;0
9118;189333;100;0;0;0;0;.00nan;0;0
9118;189573;102;0;0;0;0;.00nan;0;0
9119;192733;99;82;39;3;36;.923;3600000;0
9119;194531;99;0;0;0;0;.00nan;0;0
9119;207118;98;60;31;4;27;.871;3576000;0
9119;-1;98;0;0;0;0;.00nan;0;0
9120;194899;101;0;0;0;0;.00nan;0;0
9120;189639;105;61;19;2;17;.895;3578000;0
9120;-1;101;91;35;1;34;.971;3600000;0
9120;192445;105;0;0;0;0;.00nan;0;0
9121;192718;103;38;25;5;20;.800;3600000;0
9121;189558;103;0;0;0;0;.00nan;0;0
9121;196525;94;33;26;6;20;.769;2468000;0
9121;-1;94;32;13;4;9;.692;1132000;0
9122;189448;88;0;0;0;0;.00nan;0;0
9122;-1;90;0;0;0;0;.00nan;0;0
9122;191318;88;22;28;6;22;.786;3578000;0
9122;-1;90;42;28;5;23;.821;3600000;0
9123;192733;99;0;0;0;0;.00nan;0;0
9123;194531;99;90;28;1;27;.964;3600000;0
9123;207118;98;0;0;0;0;.00nan;0;0
9123;-1;98;39;19;3;16;.842;3566000;0
9124;194502;86;100;37;0;37;1.000;3600000;0
9124;-1;86;0;0;0;0;.00nan;0;0
9124;-1;93;0;0;0;0;.00nan;0;0
9124;197675;93;44;41;6;35;.854;3600000;0
9125;189433;91;0;0;0;0;.00nan;0;0
9125;196495;87;48;6;1;5;.833;334000;0
9125;-1;87;19;26;7;19;.731;3266000;0
9125;-1;91;74;49;4;45;.918;3600000;0
9126;190831;106;0;0;0;0;.00nan;0;0
9126;191255;104;75;24;1;23;.958;3600000;0
9126;-1;106;69;32;3;29;.906;3600000;0
9126;208300;104;0;0;0;0;.00nan;0;0
9127;192718;103;0;0;0;0;.00nan;0;0
9127;189558;103;83;50;4;46;.920;3600000;0
9127;189639;105;0;0;0;0;.00nan;0;0
9127;192445;105;40;33;6;27;.818;3586000;0
9128;194899;101;12;19;6;13;.684;2884000;0
9128;196525;94;97;27;0;27;1.000;3600000;0
9128;-1;94;0;0;0;0;.00nan;0;0
9128;-1;101;54;10;1;9;.900;716000;0
9129;197940;100;54;5;0;5;1.000;387000;0
9129;194632;102;0;0;0;0;.00nan;0;0
9129;189333;100;38;35;6;29;.829;3213000;0
9129;189573;102;68;25;2;23;.920;3600000;0
9130;189628;89;62;35;3;32;.914;3566000;0
9130;189644;95;88;29;1;28;.966;3600000;0
9130;195346;95;0;0;0;0;.00nan;0;0
9130;-1;89;0;0;0;0;.00nan;0;0
9131;189448;88;87;26;2;24;.923;3600000;0
9131;189576;97;53;3;0;3;1.000;445000;0
9131;191318;88;0;0;0;0;.00nan;0;0
9131;191331;97;15;28;7;21;.750;3155000;0
9132;196495;87;100;30;0;30;1.000;3600000;0
9132;-1;87;0;0;0;0;.00nan;0;0
9132;-1;96;68;38;4;34;.895;3600000;0
9132;-1;96;0;0;0;0;.00nan;0;0
9133;197940;100;62;34;4;30;.882;3900000;0
9133;194632;102;66;32;4;28;.875;3900000;0
9133;189333;100;0;0;0;0;.00nan;0;0
9133;189573;102;0;0;0;0;.00nan;0;0
9134;189439;107;0;0;0;0;.00nan;0;0
9134;194899;101;0;0;0;0;.00nan;0;0
9134;189581;107;65;21;2;19;.905;3600000;0
9134;-1;101;82;39;3;36;.923;3583000;0
9135;192739;92;0;0;0;0;.00nan;0;0
9135;190106;92;52;23;3;20;.870;3600000;0
9135;-1;96;65;33;4;29;.879;3544000;0
9135;-1;96;0;0;0;0;.00nan;0;0
9136;194899;101;45;8;1;7;.875;946000;0
9136;190831;106;46;36;6;30;.833;3301000;0
9136;-1;101;29;27;6;21;.778;2654000;0
9136;-1;106;53;4;0;4;1.000;299000;0
9137;189639;105;75;34;2;32;.941;3600000;0
9137;191255;104;51;28;4;24;.857;3535000;0
9137;192445;105;0;0;0;0;.00nan;0;0
9137;208300;104;0;0;0;0;.00nan;0;0
9138;189433;91;60;30;3;27;.900;3600000;0
9138;-1;90;59;42;5;37;.881;3600000;0
9138;-1;91;0;0;0;0;.00nan;0;0
9138;-1;90;0;0;0;0;.00nan;0;0
9139;189448;88;0;0;0;0;.00nan;0;0
9139;189628;89;68;39;4;35;.897;3600000;0
9139;-1;89;0;0;0;0;.00nan;0;0
9139;191318;88;64;30;3;27;.900;3600000;0
9140;192739;92;88;31;2;29;.935;3600000;0
9140;189576;97;79;42;3;39;.929;3544000;0
9140;190106;92;0;0;0;0;.00nan;0;0
9140;191331;97;0;0;0;0;.00nan;0;0
9141;196525;94;43;30;5;25;.833;3600000;0
9141;-1;94;0;0;0;0;.00nan;0;0
9141;191255;104;0;0;0;0;.00nan;0;0
9141;208300;104;55;25;3;22;.880;3600000;0
9142;192718;103;58;6;0;6;1.000;803000;0
9142;189558;103;37;29;6;23;.793;2796000;0
9142;207118;98;0;0;0;0;.00nan;0;0
9142;-1;98;54;29;4;25;.862;3600000;0
9143;189433;91;44;46;7;39;.848;3600000;0
9143;196495;87;67;28;2;26;.929;3600000;0
9143;-1;87;0;0;0;0;.00nan;0;0
9143;-1;91;0;0;0;0;.00nan;0;0
9144;194502;86;74;37;3;34;.919;3600000;0
9144;-1;90;60;7;0;7;1.000;865000;0
9144;-1;86;0;0;0;0;.00nan;0;0
9144;-1;90;28;34;7;27;.794;2735000;0
9145;189576;97;0;0;0;0;.00nan;0;0
9145;189628;89;64;45;4;41;.911;3900000;0
9145;-1;89;0;0;0;0;.00nan;0;0
9145;191331;97;57;32;4;28;.875;3900000;0
9146;189448;88;60;30;3;27;.900;3900000;0
9146;-1;93;70;28;3;25;.893;3900000;0
9146;191318;88;0;0;0;0;.00nan;0;0
9146;197675;93;0;0;0;0;.00nan;0;0
9147;189644;95;71;21;1;20;.952;3600000;0
9147;195346;95;0;0;0;0;.00nan;0;0
9147;-1;96;0;0;0;0;.00nan;0;0
9147;-1;96;98;44;2;42;.955;3584000;0
9148;192733;99;100;34;1;33;.971;3600000;0
9148;194531;99;0;0;0;0;.00nan;0;0
9148;189439;107;72;12;0;12;1.000;2045000;0
9148;189581;107;37;21;4;17;.810;1555000;0
9149;192718;103;57;6;0;6;1.000;1242000;0
9149;189558;103;38;14;4;10;.714;2358000;0
9149;207118;98;90;39;2;37;.949;3600000;0
9149;-1;98;0;0;0;0;.00nan;0;0
9150;197940;100;0;0;0;0;.00nan;0;0
9150;189333;100;51;23;3;20;.870;3544000;0
9150;194899;101;0;0;0;0;.00nan;0;0
9150;-1;101;99;47;2;45;.957;3600000;0
9151;189639;105;64;47;6;41;.872;3600000;0
9151;191255;104;53;26;3;23;.885;3600000;0
9151;192445;105;0;0;0;0;.00nan;0;0
9151;208300;104;0;0;0;0;.00nan;0;0
9152;194632;102;74;31;3;28;.903;3600000;0
9152;189573;102;0;0;0;0;.00nan;0;0
9152;190831;106;47;46;7;39;.848;3224000;0
9152;-1;106;48;0;0;0;.00nan;376000;0
9153;192739;92;68;13;0;13;1.000;1585000;0
9153;189644;95;84;40;3;37;.925;3600000;0
9153;195346;95;0;0;0;0;.00nan;0;0
9153;190106;92;28;24;6;18;.750;2015000;0
9154;194502;86;0;0;0;0;.00nan;0;0
9154;189433;91;0;0;0;0;.00nan;0;0
9154;-1;86;73;21;1;20;.952;3600000;0
9154;-1;91;82;38;2;36;.947;3570000;0
9155;-1;90;93;30;1;29;.967;3600000;0
9155;-1;93;0;0;0;0;.00nan;0;0
9155;-1;90;0;0;0;0;.00nan;0;0
9155;197675;93;49;23;3;20;.870;3542000;0
9156;189576;97;70;49;5;44;.898;3600000;0
9156;196495;87;0;0;0;0;.00nan;0;0
9156;-1;87;67;25;2;23;.920;3600000;0
9156;191331;97;0;0;0;0;.00nan;0;0
9157;192718;103;0;0;0;0;.00nan;0;0
9157;189558;103;74;22;1;21;.955;3600000;0
9157;190831;106;0;0;0;0;.00nan;0;0
9157;-1;106;59;47;6;41;.872;3600000;0
9158;189639;105;0;0;0;0;.00nan;0;0
9158;196525;94;35;33;6;27;.818;3270000;0
9158;-1;94;46;6;1;5;.833;330000;0
9158;192445;105;75;34;3;31;.912;3600000;0
9159;197940;100;62;31;3;28;.903;3544000;0
9159;189333;100;0;0;0;0;.00nan;0;0
9159;191255;104;0;0;0;0;.00nan;0;0
9159;208300;104;54;16;2;14;.875;3600000;0
9160;192733;99;45;28;5;23;.821;3600000;0
9160;194531;99;0;0;0;0;.00nan;0;0
9160;194899;101;34;35;6;29;.829;3559000;0
9160;-1;101;0;0;0;0;.00nan;0;0
9161;189433;91;75;30;2;28;.933;3900000;0
9161;189628;89;89;40;2;38;.950;3900000;0
9161;-1;89;0;0;0;0;.00nan;0;0
9161;-1;91;0;0;0;0;.00nan;0;0
9162;189448;88;0;0;0;0;.00nan;0;0
9162;196495;87;74;31;2;29;.935;3556000;0
9162;-1;87;0;0;0;0;.00nan;0;0
9162;191318;88;83;20;1;19;.950;3600000;0
9163;189644;95;0;0;0;0;.00nan;0;0
9163;195346;95;59;23;3;20;.870;3600000;0
9163;-1;96;73;41;4;37;.902;3543000;0
9163;-1;96;0;0;0;0;.00nan;0;0
9164;189439;107;0;0;0;0;.00nan;0;0
9164;189581;107;79;33;2;31;.939;3546000;0
9164;191255;104;89;34;1;33;.971;3600000;0
9164;208300;104;0;0;0;0;.00nan;0;0
9165;192718;103;29;20;5;15;.750;3588000;0
9165;189558;103;0;0;0;0;.00nan;0;0
9165;196525;94;85;45;4;41;.911;3600000;0
9165;-1;94;0;0;0;0;.00nan;0;0
9166;194632;102;59;22;2;20;.909;3600000;0
9166;189573;102;0;0;0;0;.00nan;0;0
9166;190831;106;88;54;4;50;.926;3594000;0
9166;-1;106;0;0;0;0;.00nan;0;0
9167;189639;105;89;36;2;34;.944;3600000;0
9167;207118;98;0;0;0;0;.00nan;0;0
9167;-1;98;53;27;3;24;.889;3545000;0
9167;192445;105;0;0;0;0;.00nan;0;0
9168;194502;86;72;23;1;22;.957;3600000;0
9168;-1;86;0;0;0;0;.00nan;0;0
9168;-1;96;74;30;2;28;.933;3548000;0
9168;-1;96;0;0;0;0;.00nan;0;0
9169;192739;92;0;0;0;0;.00nan;0;0
9169;189448;88;87;19;0;19;1.000;3600000;0
9169;190106;92;71;26;2;24;.923;3596000;0
9169;191318;88;0;0;0;0;.00nan;0;0
9170;189433;91;0;0;0;0;.00nan;0;0
9170;189576;97;62;34;4;30;.882;3551000;0
9170;191331;97;0;0;0;0;.00nan;0;0
9170;-1;91;58;19;2;17;.895;3600000;0
9171;189628;89;50;29;4;25;.862;3530000;0
9171;-1;93;61;19;2;17;.895;3600000;0
9171;-1;89;0;0;0;0;.00nan;0;0
9171;197675;93;0;0;0;0;.00nan;0;0
9172;196495;87;76;30;2;28;.933;3544000;0
9172;-1;87;0;0;0;0;.00nan;0;0
9172;-1;96;100;45;1;44;.978;3600000;0
9172;-1;96;0;0;0;0;.00nan;0;0
9173;189628;89;0;0;0;0;.00nan;0;0
9173;189644;95;69;22;2;20;.909;3600000;0
9173;195346;95;0;0;0;0;.00nan;0;0
9173;-1;89;55;50;7;43;.860;3600000;0
9174;189439;107;100;20;0;20;1.000;3600000;0
9174;189581;107;0;0;0;0;.00nan;0;0
9174;196525;94;97;46;2;44;.957;3514000;0
9174;-1;94;0;0;0;0;.00nan;0;0
9175;192733;99;89;29;1;28;.966;3600000;0
9175;194531;99;0;0;0;0;.00nan;0;0
9175;190831;106;35;11;3;8;.727;489000;0
9175;-1;106;95;36;1;35;.972;3111000;0
9176;192739;92;80;31;2;29;.935;3600000;0
9176;190106;92;0;0;0;0;.00nan;0;0
9176;-1;90;67;35;3;32;.914;3548000;0
9176;-1;90;0;0;0;0;.00nan;0;0
9177;194632;102;38;24;5;19;.792;3558000;0
9177;189573;102;0;0;0;0;.00nan;0;0
9177;207118;98;0;0;0;0;.00nan;0;0
9177;-1;98;70;31;3;28;.903;3600000;0
9178;192739;92;69;44;4;40;.909;3543000;0
9178;190106;92;0;0;0;0;.00nan;0;0
9178;196495;87;0;0;0;0;.00nan;0;0
9178;-1;87;57;17;2;15;.882;3600000;0
9179;189448;88;34;25;5;20;.800;3900000;0
9179;-1;90;0;0;0;0;.00nan;0;0
9179;191318;88;0;0;0;0;.00nan;0;0
9179;-1;90;70;43;5;38;.884;3900000;0
9180;189576;97;0;0;0;0;.00nan;0;0
9180;-1;96;78;23;1;22;.957;3600000;0
9180;191331;97;53;33;5;28;.848;3600000;0
9180;-1;96;0;0;0;0;.00nan;0;0
9181;189644;95;60;21;2;19;.905;3600000;0
9181;195346;95;0;0;0;0;.00nan;0;0
9181;-1;93;63;36;4;32;.889;3550000;0
9181;197675;93;0;0;0;0;.00nan;0;0
9182;194502;86;42;17;3;14;.824;3600000;0
9182;189433;91;40;35;6;29;.829;3600000;0
9182;-1;86;0;0;0;0;.00nan;0;0
9182;-1;91;0;0;0;0;.00nan;0;0
9183;192733;99;71;48;5;43;.896;3566000;0
9183;194531;99;0;0;0;0;.00nan;0;0
9183;207118;98;0;0;0;0;.00nan;0;0
9183;-1;98;61;27;3;24;.889;3600000;0
9184;194632;102;73;34;3;31;.912;3525000;0
9184;194899;101;0;0;0;0;.00nan;0;0
9184;189573;102;0;0;0;0;.00nan;0;0
9184;-1;101;74;23;1;22;.957;3600000;0
9185;189439;107;67;37;3;34;.919;3850000;0
9185;189581;107;0;0;0;0;.00nan;0;0
9185;191255;104;81;36;2;34;.944;3850000;0
9185;208300;104;0;0;0;0;.00nan;0;0
9186;197940;100;0;0;0;0;.00nan;0;0
9186;189333;100;61;22;2;20;.909;3900000;0
9186;190831;106;0;0;0;0;.00nan;0;0
9186;-1;106;100;51;2;49;.961;3900000;0
9187;189639;105;70;19;1;18;.947;3600000;0
9187;196525;94;97;45;2;43;.956;3581000;0
9187;-1;94;0;0;0;0;.00nan;0;0
9187;192445;105;0;0;0;0;.00nan;0;0
9188;194502;86;0;0;0;0;.00nan;0;0
9188;189644;95;58;25;3;22;.880;3600000;0
9188;195346;95;0;0;0;0;.00nan;0;0
9188;-1;86;75;55;6;49;.891;3600000;0
9189;196495;87;74;30;2;28;.933;3600000;0
9189;-1;90;34;21;4;17;.810;3575000;0
9189;-1;87;0;0;0;0;.00nan;0;0
9189;-1;90;0;0;0;0;.00nan;0;0
9190;189628;89;66;34;4;30;.882;3600000;0
9190;-1;96;100;30;0;30;1.000;3600000;0
9190;-1;89;0;0;0;0;.00nan;0;0
9190;-1;96;0;0;0;0;.00nan;0;0
9191;189448;88;0;0;0;0;.00nan;0;0
9191;189576;97;40;35;6;29;.829;3600000;0
9191;191318;88;65;33;3;30;.909;3600000;0
9191;191331;97;0;0;0;0;.00nan;0;0
9192;189433;91;0;0;0;0;.00nan;0;0
9192;-1;93;0;0;0;0;.00nan;0;0
9192;-1;91;58;37;6;31;.838;3600000;0
9192;197675;93;68;30;2;28;.933;3600000;0
9193;192718;103;0;0;0;0;.00nan;0;0
9193;189558;103;69;15;1;14;.933;3600000;0
9193;190831;106;39;39;7;32;.821;2460000;0
9193;-1;106;46;19;3;16;.842;1140000;0
9194;194632;102;0;0;0;0;.00nan;0;0
9194;194899;101;62;45;6;39;.867;3600000;0
9194;189573;102;89;31;2;29;.935;3600000;0
9194;-1;101;0;0;0;0;.00nan;0;0
9195;189639;105;0;0;0;0;.00nan;0;0
9195;191255;104;0;0;0;0;.00nan;0;0
9195;192445;105;39;41;7;34;.829;3600000;0
9195;208300;104;40;18;3;15;.833;3600000;0
9196;197940;100;50;31;4;27;.871;3649000;0
9196;189333;100;0;0;0;0;.00nan;0;0
9196;189439;107;0;0;0;0;.00nan;0;0
9196;189581;107;34;21;5;16;.762;3649000;0
9197;192733;99;74;32;2;30;.938;3571000;0
9197;194531;99;0;0;0;0;.00nan;0;0
9197;207118;98;75;27;1;26;.963;3600000;0
9197;-1;98;0;0;0;0;.00nan;0;0
9198;189628;89;86;47;4;43;.915;3600000;0
9198;-1;93;80;29;1;28;.966;3600000;0
9198;-1;89;0;0;0;0;.00nan;0;0
9198;197675;93;0;0;0;0;.00nan;0;0
9199;189433;91;0;0;0;0;.00nan;0;0
9199;189644;95;47;28;4;24;.857;3538000;0
9199;195346;95;0;0;0;0;.00nan;0;0
9199;-1;91;90;38;2;36;.947;3600000;0
9200;192718;103;0;0;0;0;.00nan;0;0
9200;189558;103;76;26;1;25;.962;3600000;0
9200;191255;104;61;30;3;27;.900;3552000;0
9200;208300;104;0;0;0;0;.00nan;0;0
9201;189639;105;49;34;5;29;.853;3600000;0
9201;207118;98;0;0;0;0;.00nan;0;0
9201;-1;98;80;24;1;23;.958;3600000;0
9201;192445;105;0;0;0;0;.00nan;0;0
9202;196525;94;0;0;0;0;.00nan;0;0
9202;190831;106;37;7;2;5;.714;956000;0
9202;-1;94;77;27;1;26;.963;3600000;0
9202;-1;106;53;52;6;46;.885;2644000;0
9203;192739;92;0;0;0;0;.00nan;0;0
9203;189576;97;0;0;0;0;.00nan;0;0
9203;190106;92;43;27;4;23;.852;3557000;0
9203;191331;97;99;47;3;44;.936;3600000;0
9204;189439;107;0;0;0;0;.00nan;0;0
9204;189581;107;70;30;3;27;.900;3600000;0
9204;190831;106;62;35;4;31;.886;3576000;0
9204;-1;106;0;0;0;0;.00nan;0;0
9205;197940;100;0;0;0;0;.00nan;0;0
9205;194632;102;95;33;2;31;.939;3600000;0
9205;189333;100;57;49;6;43;.878;3600000;0
9205;189573;102;0;0;0;0;.00nan;0;0
9206;194502;86;61;39;5;34;.872;3580000;0
9206;196495;87;63;34;4;30;.882;3600000;0
9206;-1;87;0;0;0;0;.00nan;0;0
9206;-1;86;0;0;0;0;.00nan;0;0
9207;189644;95;48;30;4;26;.867;3600000;0
9207;195346;95;0;0;0;0;.00nan;0;0
9207;196495;87;0;0;0;0;.00nan;0;0
9207;-1;87;49;42;6;36;.857;3520000;0
9208;189576;97;0;0;0;0;.00nan;0;0
9208;189628;89;76;42;3;39;.929;3543000;0
9208;-1;89;0;0;0;0;.00nan;0;0
9208;191331;97;67;26;2;24;.923;3600000;0
9209;192739;92;36;31;6;25;.806;2796000;0
9209;189448;88;84;31;2;29;.935;3600000;0
9209;190106;92;47;5;1;4;.800;804000;0
9209;191318;88;0;0;0;0;.00nan;0;0
9210;-1;90;0;0;0;0;.00nan;0;0
9210;-1;93;60;30;4;26;.867;3725000;0
9210;-1;90;50;35;5;30;.857;3725000;0
9210;197675;93;0;0;0;0;.00nan;0;0
9211;189433;91;62;28;3;25;.893;3600000;0
9211;-1;96;100;32;0;32;1.000;3600000;0
9211;-1;91;0;0;0;0;.00nan;0;0
9211;-1;96;0;0;0;0;.00nan;0;0
9212;192733;99;59;29;3;26;.897;3515000;0
9212;194531;99;0;0;0;0;.00nan;0;0
9212;194899;101;0;0;0;0;.00nan;0;0
9212;-1;101;99;31;1;30;.968;3600000;0
9213;189439;107;0;0;0;0;.00nan;0;0
9213;189581;107;60;24;3;21;.875;3600000;0
9213;191255;104;62;41;5;36;.878;3567000;0
9213;208300;104;0;0;0;0;.00nan;0;0
9214;197940;100;59;35;5;30;.857;3561000;0
9214;192718;103;0;0;0;0;.00nan;0;0
9214;189333;100;0;0;0;0;.00nan;0;0
9214;189558;103;53;33;4;29;.879;3600000;0
9215;189639;105;79;33;3;30;.909;3900000;0
9215;196525;94;68;35;3;32;.914;3900000;0
9215;-1;94;0;0;0;0;.00nan;0;0
9215;192445;105;0;0;0;0;.00nan;0;0
9216;194632;102;60;29;3;26;.897;3600000;0
9216;189573;102;0;0;0;0;.00nan;0;0
9216;207118;98;0;0;0;0;.00nan;0;0
9216;-1;98;67;40;4;36;.900;3600000;0
9217;192739;92;0;0;0;0;.00nan;0;0
9217;190106;92;92;31;2;29;.935;3600000;0
9217;-1;90;29;29;7;22;.759;2822000;0
9217;-1;90;56;11;1;10;.909;778000;0
9218;194502;86;59;44;6;38;.864;3534000;0
9218;189644;95;55;28;4;24;.857;3600000;0
9218;195346;95;0;0;0;0;.00nan;0;0
9218;-1;86;0;0;0;0;.00nan;0;0
9219;189576;97;48;34;5;29;.853;3600000;0
9219;189628;89;57;34;4;30;.882;3600000;0
9219;-1;89;0;0;0;0;.00nan;0;0
9219;191331;97;0;0;0;0;.00nan;0;0
9220;192733;99;56;33;4;29;.879;3600000;0
9220;194531;99;0;0;0;0;.00nan;0;0
9220;194899;101;18;27;6;21;.778;2211000;0
9220;-1;101;51;14;2;12;.857;1389000;0
9221;189448;88;0;0;0;0;.00nan;0;0
9221;-1;93;0;0;0;0;.00nan;0;0
9221;191318;88;64;33;4;29;.879;3553000;0
9221;197675;93;74;32;2;30;.938;3600000;0
9222;197940;100;0;0;0;0;.00nan;0;0
9222;192718;103;87;38;2;36;.947;3600000;0
9222;189333;100;69;33;3;30;.909;3546000;0
9222;189558;103;0;0;0;0;.00nan;0;0
9223;189433;91;0;0;0;0;.00nan;0;0
9223;-1;96;90;46;4;42;.913;3886000;0
9223;-1;91;59;27;4;23;.852;3900000;0
9223;-1;96;0;0;0;0;.00nan;0;0
9224;189639;105;0;0;0;0;.00nan;0;0
9224;196525;94;65;53;6;47;.887;3323000;0
9224;-1;94;51;2;0;2;1.000;277000;0
9224;192445;105;62;29;3;26;.897;3600000;0
9225;190831;106;23;12;4;8;.667;472000;0
9225;191255;104;0;0;0;0;.00nan;0;0
9225;-1;106;63;42;5;37;.881;3128000;0
9225;208300;104;38;21;4;17;.810;3600000;0
9226;194632;102;92;43;2;41;.953;3600000;0
9226;189573;102;0;0;0;0;.00nan;0;0
9226;207118;98;55;32;4;28;.875;3562000;0
9226;-1;98;0;0;0;0;.00nan;0;0
9227;192718;103;0;0;0;0;.00nan;0;0
9227;189558;103;67;25;2;23;.920;3545000;0
9227;191255;104;78;25;1;24;.960;3600000;0
9227;208300;104;0;0;0;0;.00nan;0;0
9228;189448;88;65;26;2;24;.923;3566000;0
9228;196495;87;91;34;1;33;.971;3600000;0
9228;-1;87;0;0;0;0;.00nan;0;0
9228;191318;88;0;0;0;0;.00nan;0;0
9229;189628;89;0;0;0;0;.00nan;0;0
9229;189644;95;40;28;5;23;.821;3600000;0
9229;195346;95;0;0;0;0;.00nan;0;0
9229;-1;89;78;43;4;39;.907;3600000;0
9230;192739;92;0;0;0;0;.00nan;0;0
9230;189433;91;14;26;7;19;.731;2217000;0
9230;190106;92;72;24;1;23;.958;3600000;0
9230;-1;91;56;22;3;19;.864;1383000;0
9231;-1;96;67;42;5;37;.881;3545000;0
9231;-1;93;67;32;3;29;.906;3600000;0
9231;197675;93;0;0;0;0;.00nan;0;0
9231;-1;96;0;0;0;0;.00nan;0;0
9232;192733;99;71;36;3;33;.917;3598000;0
9232;194531;99;0;0;0;0;.00nan;0;0
9232;194632;102;78;26;1;25;.962;3600000;0
9232;189573;102;0;0;0;0;.00nan;0;0
9233;197940;100;0;0;0;0;.00nan;0;0
9233;189333;100;39;22;4;18;.818;3531000;0
9233;189639;105;67;23;2;21;.913;3600000;0
9233;192445;105;0;0;0;0;.00nan;0;0
9234;207118;98;0;0;0;0;.00nan;0;0
9234;196525;94;49;51;7;44;.863;3600000;0
9234;-1;98;45;16;3;13;.813;3600000;0
9234;-1;94;0;0;0;0;.00nan;0;0
9235;194899;101;0;0;0;0;.00nan;0;0
9235;190831;106;53;40;5;35;.875;3520000;0
9235;-1;101;62;24;3;21;.875;3600000;0
9235;-1;106;0;0;0;0;.00nan;0;0
9236;194502;86;86;35;2;33;.943;3542000;0
9236;189576;97;0;0;0;0;.00nan;0;0
9236;-1;86;0;0;0;0;.00nan;0;0
9236;191331;97;100;34;0;34;1.000;3600000;0
9237;189439;107;0;0;0;0;.00nan;0;0
9237;189581;107;59;35;4;31;.886;3541000;0
9237;189639;105;0;0;0;0;.00nan;0;0
9237;192445;105;67;32;3;29;.906;3600000;0
9238;194899;101;74;24;1;23;.958;3600000;0
9238;190831;106;0;0;0;0;.00nan;0;0
9238;-1;101;0;0;0;0;.00nan;0;0
9238;-1;106;67;34;3;31;.912;3543000;0
9239;189644;95;80;27;2;25;.926;3546000;0
9239;195346;95;0;0;0;0;.00nan;0;0
9239;-1;96;0;0;0;0;.00nan;0;0
9239;-1;96;95;37;1;36;.973;3600000;0
9240;192739;92;61;32;3;29;.906;3900000;0
9240;194502;86;66;30;3;27;.900;3900000;0
9240;190106;92;0;0;0;0;.00nan;0;0
9240;-1;86;0;0;0;0;.00nan;0;0
9241;196495;87;42;31;6;25;.806;3559000;0
9241;-1;90;0;0;0;0;.00nan;0;0
9241;-1;87;0;0;0;0;.00nan;0;0
9241;-1;90;79;47;4;43;.915;3600000;0
9242;189448;88;87;43;2;41;.953;3600000;0
9242;196495;87;0;0;0;0;.00nan;0;0
9242;-1;87;84;33;1;32;.970;3600000;0
9242;191318;88;0;0;0;0;.00nan;0;0
9243;189576;97;0;0;0;0;.00nan;0;0
9243;-1;93;51;19;3;16;.842;3600000;0
9243;191331;97;74;52;5;47;.904;3524000;0
9243;197675;93;0;0;0;0;.00nan;0;0
9244;189439;107;86;49;3;46;.939;3600000;0
9244;189581;107;0;0;0;0;.00nan;0;0
9244;189644;95;100;26;0;26;1.000;3600000;0
9244;195346;95;0;0;0;0;.00nan;0;0
9245;192739;92;0;0;0;0;.00nan;0;0
9245;190106;92;94;22;0;22;1.000;3600000;0
9245;-1;96;62;40;4;36;.900;3600000;0
9245;-1;96;0;0;0;0;.00nan;0;0
9246;192733;99;72;26;2;24;.923;3600000;0
9246;194531;99;0;0;0;0;.00nan;0;0
9246;194899;101;0;0;0;0;.00nan;0;0
9246;-1;101;66;41;4;37;.902;3525000;0
9247;197940;100;61;28;3;25;.893;3568000;0
9247;189333;100;0;0;0;0;.00nan;0;0
9247;207118;98;87;36;2;34;.944;3600000;0
9247;-1;98;0;0;0;0;.00nan;0;0
9248;189628;89;84;36;2;34;.944;3600000;0
9248;189639;105;80;41;3;38;.927;3556000;0
9248;-1;89;0;0;0;0;.00nan;0;0
9248;192445;105;0;0;0;0;.00nan;0;0
9249;194502;86;55;27;3;24;.889;3541000;0
9249;196525;94;54;18;2;16;.889;3600000;0
9249;-1;86;0;0;0;0;.00nan;0;0
9249;-1;94;0;0;0;0;.00nan;0;0
9250;192718;103;0;0;0;0;.00nan;0;0
9250;194632;102;59;29;5;24;.828;3543000;0
9250;189558;103;87;53;4;49;.925;3600000;0
9250;189573;102;0;0;0;0;.00nan;0;0
9251;196495;87;70;30;2;28;.933;3595000;0
9251;-1;90;79;32;1;31;.969;3600000;0
9251;-1;87;0;0;0;0;.00nan;0;0
9251;-1;90;0;0;0;0;.00nan;0;0
9252;189576;97;82;33;2;31;.939;3600000;0
9252;-1;93;0;0;0;0;.00nan;0;0
9252;191331;97;0;0;0;0;.00nan;0;0
9252;197675;93;38;32;6;26;.813;3600000;0
9253;189433;91;0;0;0;0;.00nan;0;0
9253;189439;107;0;0;0;0;.00nan;0;0
9253;189581;107;67;36;3;33;.917;3900000;0
9253;-1;91;87;42;3;39;.929;3900000;0
9254;190831;106;54;37;5;32;.865;3600000;0
9254;191255;104;82;33;2;31;.939;3600000;0
9254;-1;106;0;0;0;0;.00nan;0;0
9254;208300;104;0;0;0;0;.00nan;0;0
9255;194502;86;0;0;0;0;.00nan;0;0
9255;189639;105;0;0;0;0;.00nan;0;0
9255;-1;86;74;18;1;17;.944;3600000;0
9255;192445;105;42;22;4;18;.818;3600000;0
9256;189628;89;51;2;0;2;1.000;267000;0
9256;196525;94;0;0;0;0;.00nan;0;0
9256;-1;89;26;30;6;24;.800;3333000;0
9256;-1;94;98;36;1;35;.972;3600000;0
9257;192718;103;70;20;1;19;.950;3600000;0
9257;194632;102;0;0;0;0;.00nan;0;0
9257;189558;103;0;0;0;0;.00nan;0;0
9257;189573;102;61;36;4;32;.889;3600000;0
9258;197940;100;57;34;4;30;.882;3900000;0
9258;192733;99;44;21;4;17;.810;3900000;0
9258;194531;99;0;0;0;0;.00nan;0;0
9258;189333;100;0;0;0;0;.00nan;0;0
9259;194899;101;95;49;3;46;.939;3580000;0
9259;207118;98;0;0;0;0;.00nan;0;0
9259;-1;98;50;16;2;14;.875;3600000;0
9259;-1;101;0;0;0;0;.00nan;0;0
9260;192739;92;53;18;2;16;.889;1736000;0
9260;189644;95;63;30;4;26;.867;3600000;0
9260;195346;95;0;0;0;0;.00nan;0;0
9260;190106;92;31;31;6;25;.806;1864000;0
9261;189439;107;79;25;1;24;.960;3600000;0
9261;189581;107;0;0;0;0;.00nan;0;0
9261;-1;96;74;35;3;32;.914;3535000;0
9261;-1;96;0;0;0;0;.00nan;0;0
9262;192733;99;83;36;2;34;.944;3600000;0
9262;194531;99;0;0;0;0;.00nan;0;0
9262;190831;106;0;0;0;0;.00nan;0;0
9262;-1;106;55;28;3;25;.893;3545000;0
9263;189433;91;33;37;6;31;.838;3535000;0
9263;189448;88;63;34;4;30;.882;3600000;0
9263;191318;88;0;0;0;0;.00nan;0;0
9263;-1;91;0;0;0;0;.00nan;0;0
9264;189628;89;57;27;3;24;.889;3600000;0
9264;190831;106;52;35;5;30;.857;3544000;0
9264;-1;89;0;0;0;0;.00nan;0;0
9264;-1;106;0;0;0;0;.00nan;0;0
9265;189644;95;55;19;3;16;.842;3877000;0
9265;195346;95;0;0;0;0;.00nan;0;0
9265;-1;96;81;37;3;34;.919;3900000;0
9265;-1;96;0;0;0;0;.00nan;0;0
9266;189433;91;90;37;2;35;.946;3600000;0
9266;-1;90;33;31;6;25;.806;3286000;0
9266;-1;91;0;0;0;0;.00nan;0;0
9266;-1;90;25;6;3;3;.500;314000;0
9267;189439;107;0;0;0;0;.00nan;0;0
9267;189581;107;76;26;2;24;.923;3751000;0
9267;189628;89;75;36;3;33;.917;3751000;0
9267;-1;89;0;0;0;0;.00nan;0;0
9268;192733;99;95;41;2;39;.951;3600000;0
9268;194531;99;0;0;0;0;.00nan;0;0
9268;189639;105;64;32;4;28;.875;3557000;0
9268;192445;105;0;0;0;0;.00nan;0;0
9269;192718;103;0;0;0;0;.00nan;0;0
9269;194502;86;73;6;0;6;1.000;3600000;0
9269;189558;103;63;41;4;37;.902;3600000;0
9269;-1;86;0;0;0;0;.00nan;0;0
9270;196495;87;0;0;0;0;.00nan;0;0
9270;-1;90;72;32;3;29;.906;3900000;0
9270;-1;87;97;37;3;34;.919;3900000;0
9270;-1;90;0;0;0;0;.00nan;0;0
9271;192739;92;0;0;0;0;.00nan;0;0
9271;189448;88;66;24;2;22;.917;3600000;0
9271;190106;92;56;33;4;29;.879;3543000;0
9271;191318;88;0;0;0;0;.00nan;0;0
9272;-1;96;82;39;3;36;.923;3600000;0
9272;-1;93;37;20;4;16;.800;3584000;0
9272;197675;93;0;0;0;0;.00nan;0;0
9272;-1;96;0;0;0;0;.00nan;0;0
9273;189433;91;0;0;0;0;.00nan;0;0
9273;189576;97;0;0;0;0;.00nan;0;0
9273;191331;97;55;35;5;30;.857;3596000;0
9273;-1;91;79;29;3;26;.897;3600000;0
9274;192733;99;0;0;0;0;.00nan;0;0
9274;194531;99;62;25;3;22;.880;3900000;0
9274;190831;106;0;0;0;0;.00nan;0;0
9274;-1;106;83;40;3;37;.925;3900000;0
9275;192718;103;0;0;0;0;.00nan;0;0
9275;189558;103;46;21;4;17;.810;3600000;0
9275;189628;89;25;18;5;13;.722;1753000;0
9275;-1;89;42;14;3;11;.786;1847000;0
9276;194899;101;100;32;0;32;1.000;3600000;0
9276;189639;105;57;25;3;22;.880;3600000;0
9276;-1;101;0;0;0;0;.00nan;0;0
9276;192445;105;0;0;0;0;.00nan;0;0
9277;197940;100;0;0;0;0;.00nan;0;0
9277;189333;100;88;50;4;46;.920;3753000;0
9277;207118;98;58;26;3;23;.885;3753000;0
9277;-1;98;0;0;0;0;.00nan;0;0
9278;194632;102;53;21;3;18;.857;3796000;0
9278;189573;102;0;0;0;0;.00nan;0;0
9278;196525;94;66;34;4;30;.882;3796000;0
9278;-1;94;0;0;0;0;.00nan;0;0
9279;194502;86;53;43;6;37;.860;3600000;0
9279;-1;86;0;0;0;0;.00nan;0;0
9279;191255;104;81;29;2;27;.931;3600000;0
9279;208300;104;0;0;0;0;.00nan;0;0
9280;189448;88;0;0;0;0;.00nan;0;0
9280;196495;87;60;50;6;44;.880;3600000;0
9280;-1;87;0;0;0;0;.00nan;0;0
9280;191318;88;69;21;2;19;.905;3600000;0
9281;192739;92;42;24;4;20;.833;3600000;0
9281;190106;92;0;0;0;0;.00nan;0;0
9281;-1;90;70;35;3;32;.914;2941000;0
9281;-1;90;28;10;3;7;.700;574000;0
9282;197940;100;0;0;0;0;.00nan;0;0
9282;192733;99;63;31;3;28;.903;3600000;0
9282;194531;99;0;0;0;0;.00nan;0;0
9282;189333;100;64;22;2;20;.909;3600000;0
9283;192718;103;25;15;4;11;.733;966000;0
9283;194632;102;71;29;2;27;.931;3600000;0
9283;189558;103;66;24;2;22;.917;2634000;0
9283;189573;102;0;0;0;0;.00nan;0;0
9284;194899;101;0;0;0;0;.00nan;0;0
9284;189639;105;0;0;0;0;.00nan;0;0
9284;-1;101;36;24;5;19;.792;3600000;0
9284;192445;105;85;24;1;23;.958;3600000;0
9285;189433;91;85;42;3;39;.929;3820000;0
9285;189644;95;75;25;2;23;.920;3820000;0
9285;195346;95;0;0;0;0;.00nan;0;0
9285;-1;91;0;0;0;0;.00nan;0;0
9286;189576;97;76;35;3;32;.914;3600000;0
9286;-1;96;0;0;0;0;.00nan;0;0
9286;191331;97;0;0;0;0;.00nan;0;0
9286;-1;96;60;29;4;25;.862;3546000;0
9287;194502;86;53;24;4;20;.833;3900000;0
9287;190831;106;74;42;4;38;.905;3900000;0
9287;-1;86;0;0;0;0;.00nan;0;0
9287;-1;106;0;0;0;0;.00nan;0;0
9288;207118;98;0;0;0;0;.00nan;0;0
9288;196525;94;0;0;0;0;.00nan;0;0
9288;-1;98;55;18;2;16;.889;3600000;0
9288;-1;94;98;54;4;50;.926;3590000;0
9289;189628;89;39;37;6;31;.838;3600000;0
9289;-1;89;0;0;0;0;.00nan;0;0
9289;191255;104;0;0;0;0;.00nan;0;0
9289;208300;104;66;25;2;23;.920;3600000;0
9290;189644;95;69;17;1;16;.941;3600000;0
9290;195346;95;0;0;0;0;.00nan;0;0
9290;-1;93;77;26;2;24;.923;3559000;0
9290;197675;93;0;0;0;0;.00nan;0;0
9291;194502;86;46;28;4;24;.857;3532000;0
9291;189439;107;0;0;0;0;.00nan;0;0
9291;189581;107;73;29;2;27;.931;3600000;0
9291;-1;86;0;0;0;0;.00nan;0;0
9292;197940;100;84;16;0;16;1.000;3600000;0
9292;189333;100;0;0;0;0;.00nan;0;0
9292;190831;106;0;0;0;0;.00nan;0;0
9292;-1;106;80;40;3;37;.925;3600000;0
9293;196495;87;85;37;2;35;.946;3600000;0
9293;-1;87;0;0;0;0;.00nan;0;0
9293;-1;93;0;0;0;0;.00nan;0;0
9293;197675;93;71;47;4;43;.915;3526000;0
9294;194632;102;78;29;2;27;.931;3600000;0
9294;189573;102;0;0;0;0;.00nan;0;0
9294;189639;105;71;37;3;34;.919;3579000;0
9294;192445;105;0;0;0;0;.00nan;0;0
9295;189576;97;0;0;0;0;.00nan;0;0
9295;-1;96;61;34;4;30;.882;3582000;0
9295;191331;97;63;31;3;28;.903;3600000;0
9295;-1;96;0;0;0;0;.00nan;0;0
9296;189644;95;76;26;2;24;.923;3600000;0
9296;195346;95;0;0;0;0;.00nan;0;0
9296;196495;87;0;0;0;0;.00nan;0;0
9296;-1;87;100;38;1;37;.974;3600000;0
9297;192739;92;0;0;0;0;.00nan;0;0
9297;190106;92;77;22;1;21;.955;3600000;0
9297;-1;93;80;43;5;38;.884;3600000;0
9297;197675;93;0;0;0;0;.00nan;0;0
9298;192718;103;0;0;0;0;.00nan;0;0
9298;192733;99;31;42;8;34;.810;3600000;0
9298;194531;99;0;0;0;0;.00nan;0;0
9298;189558;103;34;28;6;22;.786;3600000;0
9299;207118;98;86;20;0;20;1.000;3600000;0
9299;196525;94;35;36;7;29;.806;2781000;0
9299;-1;98;0;0;0;0;.00nan;0;0
9299;-1;94;58;8;0;8;1.000;819000;0
9300;194502;86;100;23;0;23;1.000;3600000;0
9300;189628;89;88;35;1;34;.971;3567000;0
9300;-1;86;0;0;0;0;.00nan;0;0
9300;-1;89;0;0;0;0;.00nan;0;0
9301;-1;90;66;22;2;20;.909;3600000;0
9301;-1;96;25;30;6;24;.800;2522000;0
9301;-1;90;0;0;0;0;.00nan;0;0
9301;-1;96;61;15;1;14;.933;1078000;0
9302;189448;88;82;26;1;25;.962;3900000;0
9302;-1;93;92;29;1;28;.966;3900000;0
9302;191318;88;0;0;0;0;.00nan;0;0
9302;197675;93;0;0;0;0;.00nan;0;0
9303;189433;91;53;44;7;37;.841;3600000;0
9303;189644;95;83;13;0;13;1.000;3600000;0
9303;195346;95;0;0;0;0;.00nan;0;0
9303;-1;91;0;0;0;0;.00nan;0;0
9304;192739;92;0;0;0;0;.00nan;0;0
9304;190106;92;97;55;3;52;.945;3582000;0
9304;196495;87;93;38;2;36;.947;3600000;0
9304;-1;87;0;0;0;0;.00nan;0;0
9305;197940;100;0;0;0;0;.00nan;0;0
9305;189333;100;63;39;4;35;.897;3553000;0
9305;194899;101;80;32;2;30;.938;3600000;0
9305;-1;101;0;0;0;0;.00nan;0;0
9306;192733;99;34;42;7;35;.833;3600000;0
9306;194531;99;0;0;0;0;.00nan;0;0
9306;207118;98;100;38;1;37;.974;3600000;0
9306;-1;98;0;0;0;0;.00nan;0;0
9307;189639;105;32;21;5;16;.762;2232000;0
9307;190831;106;86;33;2;31;.939;3600000;0
9307;192445;105;54;10;1;9;.900;1368000;0
9307;-1;106;0;0;0;0;.00nan;0;0
9308;189439;107;0;0;0;0;.00nan;0;0
9308;189581;107;67;24;2;22;.917;3600000;0
9308;196525;94;44;26;5;21;.808;3600000;0
9308;-1;94;0;0;0;0;.00nan;0;0
9309;194632;102;57;32;4;28;.875;3600000;0
9309;189573;102;0;0;0;0;.00nan;0;0
9309;191255;104;23;26;6;20;.769;3066000;0
9309;208300;104;52;4;0;4;1.000;516000;0
9310;192739;92;41;20;4;16;.800;2383000;0
9310;194502;86;44;36;6;30;.833;3585000;0
9310;190106;92;65;8;0;8;1.000;1217000;0
9310;-1;86;0;0;0;0;.00nan;0;0
9311;-1;90;0;0;0;0;.00nan;0;0
9311;-1;93;0;0;0;0;.00nan;0;0
9311;-1;90;93;40;1;39;.975;3600000;0
9311;197675;93;43;34;5;29;.853;3600000;0
9312;189448;88;0;0;0;0;.00nan;0;0
9312;-1;96;85;40;3;37;.925;3600000;0
9312;191318;88;57;18;2;16;.889;3600000;0
9312;-1;96;0;0;0;0;.00nan;0;0
9313;189576;97;0;0;0;0;.00nan;0;0
9313;196495;87;0;0;0;0;.00nan;0;0
9313;-1;87;61;31;3;28;.903;3532000;0
9313;191331;97;86;29;1;28;.966;3600000;0
9314;192733;99;0;0;0;0;.00nan;0;0
9314;194531;99;23;25;6;19;.760;3600000;0
9314;207118;98;0;0;0;0;.00nan;0;0
9314;-1;98;32;26;5;21;.808;3600000;0
9315;192718;103;0;0;0;0;.00nan;0;0
9315;189439;107;74;36;3;33;.917;3550000;0
9315;189558;103;70;29;2;27;.931;3600000;0
9315;189581;107;0;0;0;0;.00nan;0;0
9316;197940;100;23;26;6;20;.769;2756000;0
9316;189333;100;47;6;1;5;.833;844000;0
9316;194899;101;0;0;0;0;.00nan;0;0
9316;-1;101;74;29;2;27;.931;3600000;0
9317;189433;91;0;0;0;0;.00nan;0;0
9317;189644;95;62;24;2;22;.917;3600000;0
9317;195346;95;0;0;0;0;.00nan;0;0
9317;-1;91;54;29;4;25;.862;3543000;0
9318;189639;105;0;0;0;0;.00nan;0;0
9318;190831;106;0;0;0;0;.00nan;0;0
9318;192445;105;71;19;2;17;.895;3600000;0
9318;-1;106;59;42;5;37;.881;3600000;0
9319;194632;102;77;25;1;24;.960;3900000;0
9319;189573;102;0;0;0;0;.00nan;0;0
9319;191255;104;0;0;0;0;.00nan;0;0
9319;208300;104;76;29;1;28;.966;3900000;0
9320;196525;94;0;0;0;0;.00nan;0;0
9320;190831;106;72;22;2;20;.909;3600000;0
9320;-1;94;97;56;3;53;.946;3578000;0
9320;-1;106;0;0;0;0;.00nan;0;0
9321;189576;97;0;0;0;0;.00nan;0;0
9321;-1;90;89;32;1;31;.969;3600000;0
9321;191331;97;65;31;3;28;.903;3600000;0
9321;-1;90;0;0;0;0;.00nan;0;0
9322;189448;88;45;6;1;5;.833;719000;0
9322;196495;87;52;32;4;28;.875;3600000;0
9322;-1;87;0;0;0;0;.00nan;0;0
9322;191318;88;1;15;7;8;.533;2881000;0
9323;197940;100;0;0;0;0;.00nan;0;0
9323;189333;100;73;29;3;26;.897;3900000;0
9323;196525;94;0;0;0;0;.00nan;0;0
9323;-1;94;89;45;3;42;.933;3900000;0
9324;192718;103;0;0;0;0;.00nan;0;0
9324;189558;103;11;22;7;15;.682;3600000;0
9324;189639;105;88;45;3;42;.933;3600000;0
9324;192445;105;0;0;0;0;.00nan;0;0
9325;192739;92;0;0;0;0;.00nan;0;0
9325;190106;92;97;20;0;20;1.000;3600000;0
9325;-1;96;44;38;6;32;.842;3058000;0
9325;-1;96;52;9;1;8;.889;542000;0
9326;194899;101;0;0;0;0;.00nan;0;0
9326;207118;98;25;11;4;7;.636;664000;0
9326;-1;98;63;23;2;21;.913;2918000;0
9326;-1;101;70;34;4;30;.882;3600000;0
9327;192739;92;0;0;0;0;.00nan;0;0
9327;189433;91;0;0;0;0;.00nan;0;0
9327;190106;92;61;26;3;23;.885;3600000;0
9327;-1;91;64;38;4;34;.895;3600000;0
9328;189628;89;87;30;1;29;.967;3600000;0
9328;-1;90;40;31;5;26;.839;3600000;0
9328;-1;89;0;0;0;0;.00nan;0;0
9328;-1;90;0;0;0;0;.00nan;0;0
9329;194502;86;87;43;3;40;.930;3900000;0
9329;189448;88;90;40;3;37;.925;3900000;0
9329;-1;86;0;0;0;0;.00nan;0;0
9329;191318;88;0;0;0;0;.00nan;0;0
9330;189576;97;0;0;0;0;.00nan;0;0
9330;-1;93;64;25;3;22;.880;3900000;0
9330;191331;97;93;44;3;41;.932;3875000;0
9330;197675;93;0;0;0;0;.00nan;0;0
9331;189644;95;64;28;3;25;.893;3600000;0
9331;195346;95;0;0;0;0;.00nan;0;0
9331;-1;96;70;43;5;38;.884;3600000;0
9331;-1;96;0;0;0;0;.00nan;0;0
9332;192718;103;0;0;0;0;.00nan;0;0
9332;189558;103;48;26;5;21;.808;3900000;0
9332;196525;94;61;50;5;45;.900;3900000;0
9332;-1;94;0;0;0;0;.00nan;0;0
9333;189439;107;0;0;0;0;.00nan;0;0
9333;189581;107;51;35;4;31;.886;3587000;0
9333;189639;105;65;21;2;19;.905;3600000;0
9333;192445;105;0;0;0;0;.00nan;0;0
9334;197940;100;0;0;0;0;.00nan;0;0
9334;192733;99;43;30;5;25;.833;3600000;0
9334;194531;99;0;0;0;0;.00nan;0;0
9334;189333;100;45;43;6;37;.860;3565000;0
9335;207118;98;0;0;0;0;.00nan;0;0
9335;-1;98;72;37;3;34;.919;3600000;0
9335;191255;104;55;35;4;31;.886;3567000;0
9335;208300;104;0;0;0;0;.00nan;0;0
9336;194632;102;21;11;4;7;.636;1139000;0
9336;194899;101;65;39;4;35;.897;3600000;0
9336;189573;102;59;10;1;9;.900;2420000;0
9336;-1;101;0;0;0;0;.00nan;0;0
9337;196495;87;54;4;0;4;1.000;927000;0
9337;-1;90;0;0;0;0;.00nan;0;0
9337;-1;87;41;36;6;30;.833;2673000;0
9337;-1;90;70;30;3;27;.900;3600000;0
9338;197940;100;67;25;2;23;.920;3600000;0
9338;192733;99;0;0;0;0;.00nan;0;0
9338;194531;99;76;34;3;31;.912;3548000;0
9338;189333;100;0;0;0;0;.00nan;0;0
9339;189576;97;93;50;3;47;.940;3011000;0
9339;-1;93;0;0;0;0;.00nan;0;0
9339;191331;97;24;7;3;4;.571;589000;0
9339;197675;93;77;33;3;30;.909;3600000;0
9340;194502;86;0;0;0;0;.00nan;0;0
9340;189448;88;0;0;0;0;.00nan;0;0
9340;-1;86;60;30;3;27;.900;3600000;0
9340;191318;88;63;19;2;17;.895;3600000;0
9341;192739;92;64;34;4;30;.882;3767000;0
9341;189433;91;80;38;3;35;.921;3767000;0
9341;190106;92;0;0;0;0;.00nan;0;0
9341;-1;91;0;0;0;0;.00nan;0;0
9342;192718;103;56;36;4;32;.889;3546000;0
9342;189439;107;73;36;3;33;.917;3600000;0
9342;189558;103;0;0;0;0;.00nan;0;0
9342;189581;107;0;0;0;0;.00nan;0;0
9343;189639;105;0;0;0;0;.00nan;0;0
9343;196525;94;0;0;0;0;.00nan;0;0
9343;-1;94;95;59;4;55;.932;3596000;0
9343;192445;105;74;26;2;24;.923;3600000;0
9344;194632;102;84;14;0;14;1.000;3600000;0
9344;194899;101;0;0;0;0;.00nan;0;0
9344;189573;102;0;0;0;0;.00nan;0;0
9344;-1;101;56;41;6;35;.854;3600000;0
9345;207118;98;72;29;2;27;.931;3600000;0
9345;-1;98;0;0;0;0;.00nan;0;0
9345;191255;104;0;0;0;0;.00nan;0;0
9345;208300;104;47;35;5;30;.857;3600000;0
9346;192739;92;0;0;0;0;.00nan;0;0
9346;189644;95;0;0;0;0;.00nan;0;0
9346;195346;95;45;30;5;25;.833;3548000;0
9346;190106;92;68;31;3;28;.903;3600000;0
9347;194502;86;99;37;1;36;.973;3600000;0
9347;189628;89;77;37;4;33;.892;3600000;0
9347;-1;86;0;0;0;0;.00nan;0;0
9347;-1;89;0;0;0;0;.00nan;0;0
9348;197940;100;0;0;0;0;.00nan;0;0
9348;189333;100;42;29;5;24;.828;3540000;0
9348;194899;101;53;27;4;23;.852;3600000;0
9348;-1;101;0;0;0;0;.00nan;0;0
9349;189576;97;0;0;0;0;.00nan;0;0
9349;-1;96;54;29;4;25;.862;3567000;0
9349;191331;97;69;29;3;26;.897;3600000;0
9349;-1;96;0;0;0;0;.00nan;0;0
9350;192718;103;0;0;0;0;.00nan;0;0
9350;189558;103;37;30;6;24;.800;3600000;0
9350;190831;106;51;30;4;26;.867;2861000;0
9350;-1;106;17;9;4;5;.556;736000;0
9351;189439;107;0;0;0;0;.00nan;0;0
9351;189581;107;94;37;1;36;.973;3900000;0
9351;189639;105;96;27;1;26;.963;3900000;0
9351;192445;105;0;0;0;0;.00nan;0;0
9352;192733;99;96;22;0;22;1.000;3600000;0
9352;194531;99;0;0;0;0;.00nan;0;0
9352;190831;106;0;0;0;0;.00nan;0;0
9352;-1;106;43;34;5;29;.853;3600000;0
9353;189628;89;60;39;5;34;.872;3600000;0
9353;-1;90;0;0;0;0;.00nan;0;0
9353;-1;89;0;0;0;0;.00nan;0;0
9353;-1;90;86;33;1;32;.970;3600000;0
9354;189448;88;41;28;4;24;.857;3600000;0
9354;189644;95;83;23;1;22;.957;3600000;0
9354;195346;95;0;0;0;0;.00nan;0;0
9354;191318;88;0;0;0;0;.00nan;0;0
9355;189433;91;74;20;1;19;.950;3600000;0
9355;189576;97;0;0;0;0;.00nan;0;0
9355;191331;97;91;36;2;34;.944;3559000;0
9355;-1;91;0;0;0;0;.00nan;0;0
9356;194632;102;84;18;0;18;1.000;3600000;0
9356;189439;107;0;0;0;0;.00nan;0;0
9356;189573;102;0;0;0;0;.00nan;0;0
9356;189581;107;41;34;6;28;.824;3600000;0
9357;194502;86;94;48;3;45;.938;3600000;0
9357;196495;87;56;27;4;23;.852;3543000;0
9357;-1;87;0;0;0;0;.00nan;0;0
9357;-1;86;0;0;0;0;.00nan;0;0
9358;192739;92;0;0;0;0;.00nan;0;0
9358;190106;92;67;33;3;30;.909;3900000;0
9358;-1;93;78;37;3;34;.919;3900000;0
9358;197675;93;0;0;0;0;.00nan;0;0
9359;189448;88;3;15;6;9;.600;3105000;0
9359;-1;90;74;38;3;35;.921;3600000;0
9359;191318;88;19;10;4;6;.600;495000;0
9359;-1;90;0;0;0;0;.00nan;0;0
9360;189628;89;0;0;0;0;.00nan;0;0
9360;196495;87;68;11;0;11;1.000;1333000;0
9360;-1;87;16;20;6;14;.700;2267000;0
9360;-1;89;92;38;2;36;.947;3600000;0
9361;189576;97;0;0;0;0;.00nan;0;0
9361;189644;95;58;10;1;9;.900;3600000;0
9361;195346;95;0;0;0;0;.00nan;0;0
9361;191331;97;87;54;4;50;.926;3600000;0
9362;192733;99;38;24;5;19;.792;3600000;0
9362;194531;99;0;0;0;0;.00nan;0;0
9362;194899;101;55;4;0;4;1.000;833000;0
9362;-1;101;35;29;6;23;.793;2739000;0
9363;197940;100;0;0;0;0;.00nan;0;0
9363;189333;100;82;29;1;28;.966;3900000;0
9363;207118;98;0;0;0;0;.00nan;0;0
9363;-1;98;94;30;1;29;.967;3900000;0
9364;189639;105;51;31;6;25;.806;2618000;0
9364;190831;106;58;36;5;31;.861;3600000;0
9364;192445;105;31;10;3;7;.700;982000;0
9364;-1;106;0;0;0;0;.00nan;0;0
9365;192718;103;0;0;0;0;.00nan;0;0
9365;189558;103;99;21;0;21;1.000;3600000;0
9365;196525;94;73;36;3;33;.917;3600000;0
9365;-1;94;0;0;0;0;.00nan;0;0
9366;194632;102;53;26;3;23;.885;3900000;0
9366;189439;107;0;0;0;0;.00nan;0;0
9366;189573;102;0;0;0;0;.00nan;0;0
9366;189581;107;85;34;3;31;.912;3900000;0
9367;192739;92;97;34;1;33;.971;3600000;0
9367;190106;92;0;0;0;0;.00nan;0;0
9367;-1;93;0;0;0;0;.00nan;0;0
9367;197675;93;61;38;4;34;.895;3600000;0
9368;194502;86;84;29;2;27;.931;3900000;0
9368;189628;89;95;36;2;34;.944;3900000;0
9368;-1;86;0;0;0;0;.00nan;0;0
9368;-1;89;0;0;0;0;.00nan;0;0
9369;192718;103;0;0;0;0;.00nan;0;0
9369;189558;103;51;26;4;22;.846;3900000;0
9369;190831;106;0;0;0;0;.00nan;0;0
9369;-1;106;78;45;4;41;.911;3900000;0
9370;192733;99;0;0;0;0;.00nan;0;0
9370;194531;99;87;31;1;30;.968;3600000;0
9370;194899;101;100;30;0;30;1.000;3600000;0
9370;-1;101;0;0;0;0;.00nan;0;0
9371;189433;91;78;35;3;32;.914;3900000;0
9371;-1;96;74;36;3;33;.917;3900000;0
9371;-1;91;0;0;0;0;.00nan;0;0
9371;-1;96;0;0;0;0;.00nan;0;0
9372;189448;88;0;0;0;0;.00nan;0;0
9372;-1;90;0;0;0;0;.00nan;0;0
9372;191318;88;89;38;1;37;.974;3600000;0
9372;-1;90;39;28;5;23;.821;3600000;0
9373;189639;105;0;0;0;0;.00nan;0;0
9373;196525;94;0;0;0;0;.00nan;0;0
9373;-1;94;55;36;5;31;.861;3600000;0
9373;192445;105;62;14;1;13;.929;3600000;0
9374;189439;107;64;39;4;35;.897;3582000;0
9374;189581;107;0;0;0;0;.00nan;0;0
9374;191255;104;66;21;2;19;.905;3600000;0
9374;208300;104;0;0;0;0;.00nan;0;0
9375;197940;100;0;0;0;0;.00nan;0;0
9375;189333;100;75;40;4;36;.900;3600000;0
9375;207118;98;45;27;5;22;.815;3543000;0
9375;-1;98;0;0;0;0;.00nan;0;0
9376;189576;97;0;0;0;0;.00nan;0;0
9376;189644;95;66;15;1;14;.933;3600000;0
9376;195346;95;0;0;0;0;.00nan;0;0
9376;191331;97;86;54;4;50;.926;3600000;0
9377;189433;91;0;0;0;0;.00nan;0;0
9377;-1;96;0;0;0;0;.00nan;0;0
9377;-1;91;78;22;1;21;.955;3600000;0
9377;-1;96;80;33;2;31;.939;3545000;0
9378;196525;94;45;39;6;33;.846;3600000;0
9378;-1;94;0;0;0;0;.00nan;0;0
9378;191255;104;0;0;0;0;.00nan;0;0
9378;208300;104;78;20;1;19;.950;3600000;0
9379;192718;103;79;31;2;29;.935;3600000;0
9379;189558;103;0;0;0;0;.00nan;0;0
9379;190831;106;77;40;3;37;.925;3572000;0
9379;-1;106;0;0;0;0;.00nan;0;0
9381;-1;90;64;21;2;19;.905;3900000;0
9381;-1;94;0;0;0;0;.00nan;0;0
9381;-1;94;84;40;2;38;.950;3900000;0
9381;-1;90;0;0;0;0;.00nan;0;0
9383;194899;101;82;24;1;23;.958;3600000;0
9383;189576;97;24;33;7;26;.788;3193000;0
9383;-1;101;0;0;0;0;.00nan;0;0
9383;191331;97;50;1;0;1;1.000;407000;0
9385;192733;99;0;0;0;0;.00nan;0;0
9385;194531;99;68;43;5;38;.884;3573000;0
9385;194759;104;0;0;0;0;.00nan;0;0
9385;191255;104;84;40;3;37;.925;3600000;0
9387;194502;86;42;35;6;29;.829;3600000;0
9387;189639;105;93;41;2;39;.951;3600000;0
9387;-1;86;0;0;0;0;.00nan;0;0
9387;-1;105;0;0;0;0;.00nan;0;0
9389;189628;89;38;31;6;25;.806;2839000;0
9389;-1;96;51;27;4;23;.852;3600000;0
9389;-1;89;56;4;0;4;1.000;676000;0
9389;-1;96;0;0;0;0;.00nan;0;0
9391;189644;95;46;30;5;25;.833;2912000;0
9391;195346;95;74;18;0;18;1.000;688000;0
9391;-1;93;0;0;0;0;.00nan;0;0
9391;197675;93;82;24;1;23;.958;3600000;0
9393;192718;103;52;28;4;24;.857;3600000;0
9393;189558;103;0;0;0;0;.00nan;0;0
9393;190831;106;0;0;0;0;.00nan;0;0
9393;-1;106;52;25;3;22;.880;3600000;0
9395;189439;107;61;28;3;25;.893;3600000;0
9395;189581;107;0;0;0;0;.00nan;0;0
9395;196495;87;34;21;4;17;.810;3583000;0
9395;-1;87;0;0;0;0;.00nan;0;0
9397;197940;100;0;0;0;0;.00nan;0;0
9397;189333;100;76;29;2;27;.931;3600000;0
9397;207118;98;64;32;3;29;.906;3558000;0
9397;-1;98;0;0;0;0;.00nan;0;0
9399;192739;92;0;0;0;0;.00nan;0;0
9399;189448;88;53;31;4;27;.871;3579000;0
9399;190106;92;75;29;3;26;.897;3600000;0
9399;191318;88;0;0;0;0;.00nan;0;0
9401;194632;102;88;28;1;27;.964;3600000;0
9401;189433;91;72;27;2;25;.926;3542000;0
9401;189573;102;0;0;0;0;.00nan;0;0
9401;-1;91;0;0;0;0;.00nan;0;0
9403;189639;105;58;21;2;19;.905;3900000;0
9403;-1;90;0;0;0;0;.00nan;0;0
9403;-1;105;0;0;0;0;.00nan;0;0
9403;-1;90;89;35;2;33;.943;3900000;0
9405;189644;95;79;33;2;31;.939;3600000;0
9405;195346;95;0;0;0;0;.00nan;0;0
9405;207118;98;0;0;0;0;.00nan;0;0
9405;-1;98;64;35;4;31;.886;3562000;0
9407;192739;92;0;0;0;0;.00nan;0;0
9407;190106;92;78;37;3;34;.919;3551000;0
9407;190831;106;61;21;2;19;.905;3600000;0
9407;-1;106;0;0;0;0;.00nan;0;0
9409;189628;89;27;24;5;19;.792;3569000;0
9409;-1;96;72;37;3;34;.919;3600000;0
9409;-1;89;0;0;0;0;.00nan;0;0
9409;-1;96;0;0;0;0;.00nan;0;0
9411;189448;88;0;0;0;0;.00nan;0;0
9411;-1;93;49;25;4;21;.840;3567000;0
9411;191318;88;73;29;2;27;.931;3600000;0
9411;197675;93;0;0;0;0;.00nan;0;0
9413;192733;99;68;24;2;22;.917;3600000;0
9413;194502;86;0;0;0;0;.00nan;0;0
9413;194531;99;0;0;0;0;.00nan;0;0
9413;-1;86;44;29;5;24;.828;3600000;0
9415;189439;107;85;36;2;34;.944;3600000;0
9415;189581;107;0;0;0;0;.00nan;0;0
9415;196495;87;57;12;1;11;.917;1529000;0
9415;-1;87;31;34;6;28;.824;2071000;0
9417;192718;103;0;0;0;0;.00nan;0;0
9417;189433;91;57;41;5;36;.878;3151000;0
9417;189558;103;46;25;4;21;.840;3600000;0
9417;-1;91;52;8;1;7;.875;449000;0
9419;197940;100;52;26;4;22;.846;3600000;0
9419;194632;102;90;35;1;34;.971;3600000;0
9419;189333;100;0;0;0;0;.00nan;0;0
9419;189573;102;0;0;0;0;.00nan;0;0
9421;194899;101;85;34;2;32;.941;3600000;0
9421;189576;97;60;29;3;26;.897;3571000;0
9421;-1;101;0;0;0;0;.00nan;0;0
9421;191331;97;0;0;0;0;.00nan;0;0
9423;194759;104;0;0;0;0;.00nan;0;0
9423;-1;94;60;35;4;31;.886;3600000;0
9423;-1;94;0;0;0;0;.00nan;0;0
9423;191255;104;97;20;0;20;1.000;3600000;0
9425;189628;89;0;0;0;0;.00nan;0;0
9425;-1;89;49;47;7;40;.851;3600000;0
9425;-1;94;0;0;0;0;.00nan;0;0
9425;-1;94;58;29;3;26;.897;3600000;0
9427;192739;92;80;34;2;32;.941;3561000;0
9427;194759;104;0;0;0;0;.00nan;0;0
9427;190106;92;0;0;0;0;.00nan;0;0
9427;191255;104;71;22;1;21;.955;3600000;0
9429;189639;105;0;0;0;0;.00nan;0;0
9429;207118;98;69;46;5;41;.891;3600000;0
9429;-1;98;0;0;0;0;.00nan;0;0
9429;-1;105;100;25;0;25;1.000;3600000;0
9431;197940;100;0;0;0;0;.00nan;0;0
9431;189333;100;95;31;1;30;.968;3600000;0
9431;-1;96;0;0;0;0;.00nan;0;0
9431;-1;96;55;32;4;28;.875;3600000;0
9433;192718;103;64;35;4;31;.886;3565000;0
9433;189558;103;0;0;0;0;.00nan;0;0
9433;189644;95;0;0;0;0;.00nan;0;0
9433;195346;95;70;29;2;27;.931;3600000;0
9435;194502;86;78;23;2;21;.913;3600000;0
9435;196495;87;0;0;0;0;.00nan;0;0
9435;-1;87;99;42;1;41;.976;3600000;0
9435;-1;86;0;0;0;0;.00nan;0;0
9437;194632;102;55;5;0;5;1.000;1480000;0
9437;189573;102;17;24;6;18;.750;2120000;0
9437;190831;106;0;0;0;0;.00nan;0;0
9437;-1;106;87;38;2;36;.947;3600000;0
9439;192733;99;0;0;0;0;.00nan;0;0
9439;194531;99;73;31;2;29;.935;3600000;0
9439;189576;97;0;0;0;0;.00nan;0;0
9439;191331;97;59;37;5;32;.865;3600000;0
9441;189433;91;0;0;0;0;.00nan;0;0
9441;189448;88;61;26;3;23;.885;3600000;0
9441;191318;88;0;0;0;0;.00nan;0;0
9441;-1;91;59;32;4;28;.875;3568000;0
9443;-1;90;63;43;5;38;.884;3600000;0
9443;-1;93;0;0;0;0;.00nan;0;0
9443;-1;90;0;0;0;0;.00nan;0;0
9443;197675;93;55;18;2;16;.889;3600000;0
9445;189439;107;0;0;0;0;.00nan;0;0
9445;194899;101;0;0;0;0;.00nan;0;0
9445;189581;107;82;25;1;24;.960;3600000;0
9445;-1;101;1;25;8;17;.680;3600000;0
9447;189433;91;0;0;0;0;.00nan;0;0
9447;189628;89;54;41;6;35;.854;3217000;0
9447;-1;89;53;2;0;2;1.000;383000;0
9447;-1;91;84;27;1;26;.963;3600000;0
9449;189639;105;74;21;0;21;1.000;3325000;0
9449;-1;96;77;34;3;31;.912;3900000;0
9449;-1;105;21;3;3;0;.000;575000;0
9449;-1;96;0;0;0;0;.00nan;0;0
9451;192718;103;75;22;1;21;.955;3600000;0
9451;192733;99;54;33;5;28;.848;3600000;0
9451;194531;99;0;0;0;0;.00nan;0;0
9451;189558;103;0;0;0;0;.00nan;0;0
9453;194899;101;80;33;2;31;.939;3600000;0
9453;207118;98;0;0;0;0;.00nan;0;0
9453;-1;98;72;35;3;32;.914;3563000;0
9453;-1;101;0;0;0;0;.00nan;0;0
9455;194759;104;99;37;1;36;.973;3600000;0
9455;-1;90;68;29;2;27;.931;3600000;0
9455;191255;104;0;0;0;0;.00nan;0;0
9455;-1;90;0;0;0;0;.00nan;0;0
9457;192739;92;0;0;0;0;.00nan;0;0
9457;189576;97;0;0;0;0;.00nan;0;0
9457;190106;92;79;21;1;20;.952;3600000;0
9457;191331;97;57;30;3;27;.900;3534000;0
9459;197940;100;50;14;2;12;.857;3600000;0
9459;189333;100;0;0;0;0;.00nan;0;0
9459;190831;106;78;33;3;30;.909;3600000;0
9459;-1;106;0;0;0;0;.00nan;0;0
9461;189448;88;0;0;0;0;.00nan;0;0
9461;-1;94;19;30;7;23;.767;3139000;0
9461;-1;94;44;4;1;3;.750;461000;0
9461;191318;88;47;15;3;12;.800;3600000;0
9463;194502;86;66;35;3;32;.914;3900000;0
9463;194632;102;46;20;3;17;.850;3900000;0
9463;189573;102;0;0;0;0;.00nan;0;0
9463;-1;86;0;0;0;0;.00nan;0;0
9465;189644;95;49;32;5;27;.844;3512000;0
9465;195346;95;0;0;0;0;.00nan;0;0
9465;-1;93;63;30;3;27;.900;3600000;0
9465;197675;93;0;0;0;0;.00nan;0;0
9467;189439;107;59;32;4;28;.875;3600000;0
9467;189581;107;0;0;0;0;.00nan;0;0
9467;196495;87;0;0;0;0;.00nan;0;0
9467;-1;87;34;33;6;27;.818;3518000;0
9469;189628;89;0;0;0;0;.00nan;0;0
9469;-1;96;0;0;0;0;.00nan;0;0
9469;-1;89;63;29;3;26;.897;3600000;0
9469;-1;96;39;30;5;25;.833;3600000;0
9471;189439;107;0;0;0;0;.00nan;0;0
9471;189448;88;69;30;3;27;.900;3572000;0
9471;189581;107;71;19;1;18;.947;3600000;0
9471;191318;88;0;0;0;0;.00nan;0;0
9473;192733;99;0;0;0;0;.00nan;0;0
9473;194531;99;98;27;0;27;1.000;3600000;0
9473;189576;97;73;34;4;30;.882;3600000;0
9473;191331;97;0;0;0;0;.00nan;0;0
9475;192739;92;72;36;3;33;.917;3657000;0
9475;189639;105;0;0;0;0;.00nan;0;0
9475;190106;92;0;0;0;0;.00nan;0;0
9475;-1;105;72;25;2;23;.920;3657000;0
9477;192718;103;0;0;0;0;.00nan;0;0
9477;189558;103;90;35;2;33;.943;3600000;0
9477;189644;95;0;0;0;0;.00nan;0;0
9477;195346;95;72;34;3;31;.912;3556000;0
9479;197940;100;0;0;0;0;.00nan;0;0
9479;189333;100;72;30;2;28;.933;3554000;0
9479;-1;94;0;0;0;0;.00nan;0;0
9479;-1;94;94;37;1;36;.973;3600000;0
9481;-1;90;0;0;0;0;.00nan;0;0
9481;-1;93;0;0;0;0;.00nan;0;0
9481;-1;90;90;23;1;22;.957;3600000;0
9481;197675;93;56;20;2;18;.900;3546000;0
9483;194759;104;0;0;0;0;.00nan;0;0
9483;196495;87;73;32;4;28;.875;3900000;0
9483;-1;87;0;0;0;0;.00nan;0;0
9483;191255;104;96;51;4;47;.922;3900000;0
9485;194632;102;0;0;0;0;.00nan;0;0
9485;194899;101;0;0;0;0;.00nan;0;0
9485;189573;102;54;33;4;29;.879;3516000;0
9485;-1;101;81;35;2;33;.943;3600000;0
9487;189433;91;61;23;2;21;.913;3600000;0
9487;190831;106;0;0;0;0;.00nan;0;0
9487;-1;106;74;41;4;37;.902;3581000;0
9487;-1;91;0;0;0;0;.00nan;0;0
9489;194502;86;0;0;0;0;.00nan;0;0
9489;207118;98;43;24;4;20;.833;3584000;0
9489;-1;86;100;40;2;38;.950;3600000;0
9489;-1;98;0;0;0;0;.00nan;0;0
9491;192733;99;0;0;0;0;.00nan;0;0
9491;194531;99;60;34;4;30;.882;3900000;0
9491;-1;96;61;32;4;28;.875;3900000;0
9491;-1;96;0;0;0;0;.00nan;0;0
9493;189644;95;50;28;4;24;.857;3600000;0
9493;195346;95;0;0;0;0;.00nan;0;0
9493;-1;94;34;28;6;22;.786;3010000;0
9493;-1;94;50;2;0;2;1.000;563000;0
9495;189433;91;0;0;0;0;.00nan;0;0
9495;194899;101;54;33;5;28;.848;3360000;0
9495;-1;101;48;0;0;0;.00nan;153000;0
9495;-1;91;64;29;3;26;.897;3600000;0
9497;189439;107;40;24;4;20;.833;3600000;0
9497;189581;107;0;0;0;0;.00nan;0;0
9497;-1;93;52;37;6;31;.838;3579000;0
9497;197675;93;0;0;0;0;.00nan;0;0
9499;189639;105;77;32;3;29;.906;3598000;0
9499;196495;87;0;0;0;0;.00nan;0;0
9499;-1;87;94;34;2;32;.941;3600000;0
9499;-1;105;0;0;0;0;.00nan;0;0
9501;207118;98;0;0;0;0;.00nan;0;0
9501;-1;90;68;33;3;30;.909;3600000;0
9501;-1;98;81;33;2;31;.939;3600000;0
9501;-1;90;0;0;0;0;.00nan;0;0
9503;192739;92;0;0;0;0;.00nan;0;0
9503;194759;104;0;0;0;0;.00nan;0;0
9503;190106;92;74;28;2;26;.929;3600000;0
9503;191255;104;29;25;5;20;.800;3600000;0
9505;192718;103;0;0;0;0;.00nan;0;0
9505;189558;103;67;22;2;20;.909;3600000;0
9505;189628;89;22;23;6;17;.739;2448000;0
9505;-1;89;61;16;1;15;.938;1152000;0
9507;189448;88;0;0;0;0;.00nan;0;0
9507;190831;106;0;0;0;0;.00nan;0;0
9507;191318;88;23;21;6;15;.714;3600000;0
9507;-1;106;77;45;3;42;.933;3600000;0
9509;194502;86;61;15;1;14;.933;3600000;0
9509;194632;102;63;29;3;26;.897;3576000;0
9509;189573;102;0;0;0;0;.00nan;0;0
9509;-1;86;0;0;0;0;.00nan;0;0
9511;197940;100;74;27;2;25;.926;3600000;0
9511;189333;100;0;0;0;0;.00nan;0;0
9511;189576;97;66;41;5;36;.878;3600000;0
9511;191331;97;0;0;0;0;.00nan;0;0
9513;192739;92;54;29;4;25;.862;3600000;0
9513;194759;104;94;35;1;34;.971;3600000;0
9513;190106;92;0;0;0;0;.00nan;0;0
9513;191255;104;0;0;0;0;.00nan;0;0
9515;190831;106;41;35;6;29;.829;3298000;0
9515;-1;93;0;0;0;0;.00nan;0;0
9515;-1;106;52;4;0;4;1.000;302000;0
9515;197675;93;96;24;0;24;1.000;3600000;0
9517;189628;89;42;5;1;4;.800;1505000;0
9517;-1;89;46;29;4;25;.862;2389000;0
9517;-1;94;0;0;0;0;.00nan;0;0
9517;-1;94;35;33;5;28;.848;3900000;0
9519;189576;97;0;0;0;0;.00nan;0;0
9519;189639;105;0;0;0;0;.00nan;0;0
9519;191331;97;82;31;2;29;.935;3854000;0
9519;-1;105;56;23;3;20;.870;3854000;0
9521;189433;91;88;32;1;31;.969;3600000;0
9521;-1;90;68;20;1;19;.950;2948000;0
9521;-1;91;0;0;0;0;.00nan;0;0
9521;-1;90;11;12;5;7;.583;652000;0
9523;192733;99;97;51;2;49;.961;3569000;0
9523;194531;99;0;0;0;0;.00nan;0;0
9523;189644;95;84;17;0;17;1.000;3600000;0
9523;195346;95;0;0;0;0;.00nan;0;0
9525;194632;102;0;0;0;0;.00nan;0;0
9525;189573;102;72;26;2;24;.923;3600000;0
9525;207118;98;98;51;3;48;.941;3561000;0
9525;-1;98;0;0;0;0;.00nan;0;0
9527;192718;103;55;23;2;21;.913;3899000;0
9527;194502;86;0;0;0;0;.00nan;0;0
9527;189558;103;0;0;0;0;.00nan;0;0
9527;-1;86;92;46;3;43;.935;3899000;0
9529;197940;100;0;0;0;0;.00nan;0;0
9529;189333;100;22;31;7;24;.774;3675000;0
9529;189448;88;32;30;6;24;.800;3675000;0
9529;191318;88;0;0;0;0;.00nan;0;0
9531;189439;107;0;0;0;0;.00nan;0;0
9531;189581;107;83;34;2;32;.941;3900000;0
9531;196495;87;73;27;2;25;.926;3900000;0
9531;-1;87;0;0;0;0;.00nan;0;0
9533;194899;101;0;0;0;0;.00nan;0;0
9533;-1;96;0;0;0;0;.00nan;0;0
9533;-1;101;80;27;1;26;.963;3600000;0
9533;-1;96;42;26;5;21;.808;3600000;0
839;189433;91;53;38;6;32;.842;3538000;0
839;189644;95;47;21;4;17;.810;3600000;0
839;195346;95;0;0;0;0;.00nan;0;0
839;-1;91;0;0;0;0;.00nan;0;0
840;192739;92;0;0;0;0;.00nan;0;0
840;190106;92;72;30;2;28;.933;3600000;0
840;-1;93;59;31;3;28;.903;3542000;0
840;197675;93;0;0;0;0;.00nan;0;0
841;189448;88;89;34;2;32;.941;3692000;0
841;196495;87;70;31;3;28;.903;3692000;0
841;-1;87;0;0;0;0;.00nan;0;0
841;191318;88;0;0;0;0;.00nan;0;0
842;194502;86;38;36;6;30;.833;3600000;0
842;-1;90;34;41;7;34;.829;3550000;0
842;-1;86;0;0;0;0;.00nan;0;0
842;-1;90;0;0;0;0;.00nan;0;0
843;194632;102;63;29;4;25;.862;3576000;0
843;194899;101;74;32;3;29;.906;3600000;0
843;189573;102;0;0;0;0;.00nan;0;0
843;-1;101;0;0;0;0;.00nan;0;0
844;192733;99;82;43;3;40;.930;3516000;0
844;194531;99;0;0;0;0;.00nan;0;0
844;207118;98;0;0;0;0;.00nan;0;0
844;-1;98;82;28;1;27;.964;3600000;0
845;189439;107;0;0;0;0;.00nan;0;0
845;189581;107;82;36;3;33;.917;3600000;0
845;189639;105;31;23;5;18;.783;3583000;0
845;192445;105;0;0;0;0;.00nan;0;0
846;192718;103;0;0;0;0;.00nan;0;0
846;189558;103;96;40;1;39;.975;3600000;0
846;191255;104;65;30;3;27;.900;3577000;0
846;208300;104;0;0;0;0;.00nan;0;0
847;189433;91;46;50;6;44;.880;3149000;0
847;189644;95;58;17;2;15;.882;3600000;0
847;195346;95;0;0;0;0;.00nan;0;0
847;-1;91;47;6;1;5;.833;451000;0
848;192739;92;0;0;0;0;.00nan;0;0
848;190106;92;87;42;2;40;.952;4392000;0
848;-1;93;57;22;3;19;.864;4392000;0
848;197675;93;0;0;0;0;.00nan;0;0
849;189448;88;61;23;2;21;.913;3543000;0
849;196495;87;84;25;1;24;.960;3600000;0
849;-1;87;0;0;0;0;.00nan;0;0
849;191318;88;0;0;0;0;.00nan;0;0
850;194502;86;78;41;3;38;.927;3600000;0
850;-1;90;91;39;2;37;.949;3600000;0
850;-1;86;0;0;0;0;.00nan;0;0
850;-1;90;0;0;0;0;.00nan;0;0
851;194632;102;63;42;4;38;.905;5759000;0
851;194899;101;59;50;5;45;.900;5759000;0
851;189573;102;0;0;0;0;.00nan;0;0
851;-1;101;0;0;0;0;.00nan;0;0
852;192733;99;45;19;4;15;.789;3600000;0
852;194531;99;0;0;0;0;.00nan;0;0
852;207118;98;0;0;0;0;.00nan;0;0
852;-1;98;100;29;0;29;1.000;3600000;0
853;189439;107;0;0;0;0;.00nan;0;0
853;189581;107;52;40;6;34;.850;3600000;0
853;189639;105;61;22;2;20;.909;3600000;0
853;192445;105;0;0;0;0;.00nan;0;0
854;192718;103;0;0;0;0;.00nan;0;0
854;189558;103;87;40;3;37;.925;3517000;0
854;191255;104;86;27;1;26;.963;3600000;0
854;208300;104;0;0;0;0;.00nan;0;0
855;189433;91;61;53;6;47;.887;3600000;0
855;189644;95;69;24;2;22;.917;3600000;0
855;195346;95;0;0;0;0;.00nan;0;0
855;-1;91;0;0;0;0;.00nan;0;0
856;192739;92;0;0;0;0;.00nan;0;0
856;190106;92;89;42;3;39;.929;3600000;0
856;-1;93;100;30;0;30;1.000;3600000;0
856;197675;93;0;0;0;0;.00nan;0;0
857;189448;88;60;29;3;26;.897;3600000;0
857;196495;87;100;26;0;26;1.000;3600000;0
857;-1;87;0;0;0;0;.00nan;0;0
857;191318;88;0;0;0;0;.00nan;0;0
858;194502;86;93;39;2;37;.949;3600000;0
858;-1;90;33;28;6;22;.786;2813000;0
858;-1;86;0;0;0;0;.00nan;0;0
858;-1;90;56;11;1;10;.909;787000;0
859;194632;102;41;27;4;23;.852;3600000;0
859;194899;101;59;41;5;36;.878;3565000;0
859;189573;102;0;0;0;0;.00nan;0;0
859;-1;101;0;0;0;0;.00nan;0;0
860;192733;99;67;35;3;32;.914;3571000;0
860;194531;99;0;0;0;0;.00nan;0;0
860;207118;98;0;0;0;0;.00nan;0;0
860;-1;98;71;19;1;18;.947;3600000;0
861;189439;107;0;0;0;0;.00nan;0;0
861;189581;107;76;25;1;24;.960;3589000;0
861;189639;105;96;22;0;22;1.000;3600000;0
861;192445;105;0;0;0;0;.00nan;0;0
862;192718;103;0;0;0;0;.00nan;0;0
862;189558;103;55;27;3;24;.889;3600000;0
862;191255;104;43;29;4;25;.862;3592000;0
862;208300;104;0;0;0;0;.00nan;0;0
863;189433;91;77;44;4;40;.909;3600000;0
863;189644;95;83;22;1;21;.955;3600000;0
863;195346;95;0;0;0;0;.00nan;0;0
863;-1;91;0;0;0;0;.00nan;0;0
864;192739;92;0;0;0;0;.00nan;0;0
864;190106;92;64;27;3;24;.889;3566000;0
864;-1;93;81;27;1;26;.963;3600000;0
864;197675;93;0;0;0;0;.00nan;0;0
865;189448;88;70;30;3;27;.900;3549000;0
865;196495;87;92;38;2;36;.947;3600000;0
865;-1;87;0;0;0;0;.00nan;0;0
865;191318;88;0;0;0;0;.00nan;0;0
866;194502;86;26;41;8;33;.805;3600000;0
866;-1;90;0;0;0;0;.00nan;0;0
866;-1;86;0;0;0;0;.00nan;0;0
866;-1;90;32;17;4;13;.765;3600000;0
867;194632;102;55;40;6;34;.850;3553000;0
867;194899;101;77;46;4;42;.913;3600000;0
867;189573;102;0;0;0;0;.00nan;0;0
867;-1;101;0;0;0;0;.00nan;0;0
868;192733;99;30;23;5;18;.783;2170000;0
868;194531;99;66;17;1;16;.941;1430000;0
868;207118;98;0;0;0;0;.00nan;0;0
868;-1;98;64;30;3;27;.900;3600000;0
869;189439;107;0;0;0;0;.00nan;0;0
869;189581;107;58;26;3;23;.885;3600000;0
869;189639;105;96;26;0;26;1.000;3600000;0
869;192445;105;0;0;0;0;.00nan;0;0
870;192718;103;0;0;0;0;.00nan;0;0
870;189558;103;68;31;3;28;.903;3600000;0
870;191255;104;59;34;4;30;.882;3583000;0
870;208300;104;0;0;0;0;.00nan;0;0
1017;192739;92;0;0;0;0;.00nan;0;0
1017;190106;92;60;19;2;17;.895;3582000;0
1017;-1;93;96;26;0;26;1.000;3600000;0
1017;197675;93;0;0;0;0;.00nan;0;0
1018;189448;88;78;38;3;35;.921;3600000;0
1018;196495;87;60;35;4;31;.886;3571000;0
1018;-1;87;0;0;0;0;.00nan;0;0
1018;191318;88;0;0;0;0;.00nan;0;0
1019;194502;86;72;22;1;21;.955;3555000;0
1019;-1;90;0;0;0;0;.00nan;0;0
1019;-1;86;0;0;0;0;.00nan;0;0
1019;-1;90;100;42;0;42;1.000;3600000;0
1020;194632;102;71;35;3;32;.914;4061000;0
1020;194899;101;71;41;4;37;.902;4061000;0
1020;189573;102;0;0;0;0;.00nan;0;0
1020;-1;101;0;0;0;0;.00nan;0;0
1021;189439;107;0;0;0;0;.00nan;0;0
1021;189581;107;100;44;1;43;.977;3600000;0
1021;189639;105;39;34;6;28;.824;3600000;0
1021;192445;105;0;0;0;0;.00nan;0;0
1022;192718;103;0;0;0;0;.00nan;0;0
1022;189558;103;46;38;7;31;.816;3600000;0
1022;191255;104;32;25;5;20;.800;3600000;0
1022;208300;104;0;0;0;0;.00nan;0;0
1062;192739;92;0;0;0;0;.00nan;0;0
1062;190106;92;88;39;3;36;.923;3600000;0
1062;-1;93;51;29;4;25;.862;3570000;0
1062;197675;93;0;0;0;0;.00nan;0;0
1063;189448;88;72;29;2;27;.931;3556000;0
1063;196495;87;94;22;0;22;1.000;3600000;0
1063;-1;87;0;0;0;0;.00nan;0;0
1063;191318;88;0;0;0;0;.00nan;0;0
1064;194502;86;59;43;5;38;.884;3600000;0
1064;-1;90;89;33;2;31;.939;3600000;0
1064;-1;86;0;0;0;0;.00nan;0;0
1064;-1;90;0;0;0;0;.00nan;0;0
1065;194632;102;76;24;1;23;.958;3600000;0
1065;194899;101;71;44;4;40;.909;3600000;0
1065;189573;102;0;0;0;0;.00nan;0;0
1065;-1;101;0;0;0;0;.00nan;0;0
1066;189439;107;0;0;0;0;.00nan;0;0
1066;189581;107;40;35;6;29;.829;3539000;0
1066;189639;105;74;33;4;29;.879;3600000;0
1066;192445;105;0;0;0;0;.00nan;0;0
1067;192718;103;0;0;0;0;.00nan;0;0
1067;189558;103;88;30;1;29;.967;3600000;0
1067;191255;104;61;21;2;19;.905;3600000;0
1067;208300;104;0;0;0;0;.00nan;0;0
1092;192739;92;0;0;0;0;.00nan;0;0
1092;190106;92;69;42;4;38;.905;3543000;0
1092;-1;93;77;30;3;27;.900;3600000;0
1092;197675;93;0;0;0;0;.00nan;0;0
1163;189644;95;72;24;2;22;.917;3600000;0
1163;195346;95;0;0;0;0;.00nan;0;0
1163;-1;93;83;40;3;37;.925;3546000;0
1163;197675;93;0;0;0;0;.00nan;0;0
1164;196495;87;51;26;4;22;.846;3600000;0
1164;-1;90;82;27;1;26;.963;3600000;0
1164;-1;87;0;0;0;0;.00nan;0;0
1164;-1;90;0;0;0;0;.00nan;0;0
1165;194632;102;20;20;6;14;.700;2319000;0
1165;189573;102;42;12;2;10;.833;1281000;0
1165;207118;98;0;0;0;0;.00nan;0;0
1165;-1;98;71;35;3;32;.914;3600000;0
1166;192718;103;0;0;0;0;.00nan;0;0
1166;189558;103;89;49;5;44;.898;3600000;0
1166;189639;105;89;29;1;28;.966;3600000;0
1166;192445;105;0;0;0;0;.00nan;0;0
1167;189644;95;99;45;2;43;.956;3600000;0
1167;195346;95;0;0;0;0;.00nan;0;0
1167;-1;93;61;27;3;24;.889;3596000;0
1167;197675;93;0;0;0;0;.00nan;0;0
1168;196495;87;69;39;4;35;.897;3568000;0
1168;-1;90;67;31;3;28;.903;3600000;0
1168;-1;87;0;0;0;0;.00nan;0;0
1168;-1;90;0;0;0;0;.00nan;0;0
1169;194632;102;65;22;2;20;.909;3546000;0
1169;189573;102;0;0;0;0;.00nan;0;0
1169;207118;98;0;0;0;0;.00nan;0;0
1169;-1;98;76;26;1;25;.962;3600000;0
1170;192718;103;0;0;0;0;.00nan;0;0
1170;189558;103;58;25;3;22;.880;3600000;0
1170;189639;105;41;30;5;25;.833;3585000;0
1170;192445;105;0;0;0;0;.00nan;0;0
1171;189644;95;72;30;3;27;.900;3544000;0
1171;195346;95;0;0;0;0;.00nan;0;0
1171;-1;93;69;31;2;29;.935;3600000;0
1171;197675;93;0;0;0;0;.00nan;0;0
1172;196495;87;20;26;7;19;.731;2976000;0
1172;-1;90;58;36;5;31;.861;3600000;0
1172;-1;87;14;5;4;1;.200;624000;0
1172;-1;90;0;0;0;0;.00nan;0;0
1173;194632;102;53;32;4;28;.875;3600000;0
1173;189573;102;0;0;0;0;.00nan;0;0
1173;207118;98;0;0;0;0;.00nan;0;0
1173;-1;98;62;27;3;24;.889;3600000;0
1174;192718;103;0;0;0;0;.00nan;0;0
1174;189558;103;86;35;2;33;.943;3600000;0
1174;189639;105;52;32;4;28;.875;3600000;0
1174;192445;105;0;0;0;0;.00nan;0;0
1175;189644;95;97;28;1;27;.964;3600000;0
1175;195346;95;0;0;0;0;.00nan;0;0
1175;-1;93;74;38;4;34;.895;3600000;0
1175;197675;93;0;0;0;0;.00nan;0;0
1176;196495;87;42;17;3;14;.824;3600000;0
1176;-1;90;16;36;8;28;.778;3600000;0
1176;-1;87;0;0;0;0;.00nan;0;0
1176;-1;90;0;0;0;0;.00nan;0;0
1177;194632;102;70;21;2;19;.905;3600000;0
1177;189573;102;0;0;0;0;.00nan;0;0
1177;207118;98;0;0;0;0;.00nan;0;0
1177;-1;98;47;21;3;18;.857;3587000;0
1178;192718;103;0;0;0;0;.00nan;0;0
1178;189558;103;69;38;4;34;.895;3600000;0
1178;189639;105;18;22;6;16;.727;2656000;0
1178;192445;105;36;11;3;8;.727;944000;0
1377;189644;95;43;31;6;25;.806;3747000;0
1377;195346;95;0;0;0;0;.00nan;0;0
1377;-1;93;58;36;5;31;.861;3748000;0
1377;197675;93;0;0;0;0;.00nan;0;0
1379;194632;102;78;37;3;34;.919;3796000;0
1379;189573;102;0;0;0;0;.00nan;0;0
1379;207118;98;0;0;0;0;.00nan;0;0
1379;-1;98;50;27;4;23;.852;3796000;0
9534;183859;142;60;26;3;23;.885;3600000;0
9534;196456;142;0;0;0;0;.00nan;0;0
9534;-1;141;49;1;0;1;1.000;662000;0
9534;191574;141;36;34;6;28;.824;2938000;0
9535;192895;143;59;19;2;17;.895;3600000;0
9535;189944;144;98;55;3;52;.945;3600000;0
9535;191218;143;0;0;0;0;.00nan;0;0
9535;-1;144;0;0;0;0;.00nan;0;0
9536;203276;139;86;34;1;33;.971;3600000;0
9536;192889;139;0;0;0;0;.00nan;0;0
9536;196445;140;0;0;0;0;.00nan;0;0
9536;196812;140;57;29;4;25;.862;3600000;0
9537;187657;136;0;0;0;0;.00nan;0;0
9537;194264;137;30;14;4;10;.714;613000;0
9537;-1;136;35;28;5;23;.821;3600000;0
9537;-1;137;59;26;3;23;.885;2955000;0
9538;200436;130;0;0;0;0;.00nan;0;0
9538;206789;131;63;33;3;30;.909;3900000;0
9538;197759;130;67;32;3;29;.906;3900000;0
9538;-1;131;0;0;0;0;.00nan;0;0
9539;189225;1340;0;0;0;0;.00nan;0;0
9539;189264;129;66;33;2;31;.939;3540000;0
9539;195169;129;0;0;0;0;.00nan;0;0
9539;191571;1340;100;29;0;29;1.000;3600000;0
9540;187632;134;84;22;1;21;.955;3600000;0
9540;199437;134;0;0;0;0;.00nan;0;0
9540;199701;138;50;10;1;9;.900;501000;0
9540;-1;138;60;46;6;40;.870;3099000;0
9541;187632;134;61;48;5;43;.896;3600000;0
9541;199437;134;0;0;0;0;.00nan;0;0
9541;-1;133;0;0;0;0;.00nan;0;0
9541;192499;133;100;24;0;24;1.000;3600000;0
9542;-1;132;70;43;4;39;.907;3571000;0
9542;196809;132;0;0;0;0;.00nan;0;0
9542;-1;128;0;0;0;0;.00nan;0;0
9542;-1;128;51;24;3;21;.875;3600000;0
9543;203288;135;64;33;4;29;.879;3764000;0
9543;194197;135;0;0;0;0;.00nan;0;0
9543;189264;129;48;21;3;18;.857;3764000;0
9543;195169;129;0;0;0;0;.00nan;0;0
9544;192895;143;0;0;0;0;.00nan;0;0
9544;189944;144;68;35;3;32;.914;3600000;0
9544;191218;143;41;25;4;21;.840;3543000;0
9544;-1;144;0;0;0;0;.00nan;0;0
9545;203276;139;49;35;5;30;.857;3598000;0
9545;192889;139;0;0;0;0;.00nan;0;0
9545;196445;140;0;0;0;0;.00nan;0;0
9545;196812;140;61;32;4;28;.875;3600000;0
9546;183859;142;81;40;3;37;.925;3900000;0
9546;196456;142;0;0;0;0;.00nan;0;0
9546;-1;141;0;0;0;0;.00nan;0;0
9546;191574;141;71;30;3;27;.900;3898000;0
9547;187657;136;0;0;0;0;.00nan;0;0
9547;-1;136;79;31;2;29;.935;3600000;0
9547;-1;133;0;0;0;0;.00nan;0;0
9547;192499;133;70;30;3;27;.900;3552000;0
9548;203288;135;83;40;3;37;.925;3600000;0
9548;194197;135;0;0;0;0;.00nan;0;0
9548;189225;1340;0;0;0;0;.00nan;0;0
9548;191571;1340;100;26;0;26;1.000;3600000;0
9549;-1;132;45;5;1;4;.800;1106000;0
9549;196809;132;25;27;6;21;.778;2494000;0
9549;-1;128;0;0;0;0;.00nan;0;0
9549;-1;128;57;19;2;17;.895;3600000;0
9550;199701;138;0;0;0;0;.00nan;0;0
9550;206789;131;59;34;4;30;.882;3629000;0
9550;-1;131;0;0;0;0;.00nan;0;0
9550;-1;138;60;28;3;25;.893;3629000;0
9551;194264;137;44;23;3;20;.870;3900000;0
9551;200436;130;0;0;0;0;.00nan;0;0
9551;-1;137;0;0;0;0;.00nan;0;0
9551;197759;130;85;43;3;40;.930;3900000;0
9552;192895;143;0;0;0;0;.00nan;0;0
9552;183859;142;94;37;2;35;.946;3900000;0
9552;196456;142;0;0;0;0;.00nan;0;0
9552;191218;143;58;22;2;20;.909;3900000;0
9553;189944;144;95;22;0;22;1.000;3600000;0
9553;196445;140;0;0;0;0;.00nan;0;0
9553;196812;140;87;35;1;34;.971;3570000;0
9553;-1;144;0;0;0;0;.00nan;0;0
9554;187632;134;67;35;3;32;.914;3600000;0
9554;187657;136;39;23;4;19;.826;3579000;0
9554;199437;134;0;0;0;0;.00nan;0;0
9554;-1;136;0;0;0;0;.00nan;0;0
9555;206789;131;75;44;4;40;.909;3596000;0
9555;-1;131;0;0;0;0;.00nan;0;0
9555;-1;128;58;24;3;21;.875;3600000;0
9555;-1;128;0;0;0;0;.00nan;0;0
9556;203288;135;61;27;2;25;.926;3600000;0
9556;194197;135;0;0;0;0;.00nan;0;0
9556;-1;132;40;20;4;16;.800;3560000;0
9556;196809;132;0;0;0;0;.00nan;0;0
9557;199701;138;0;0;0;0;.00nan;0;0
9557;194264;137;27;27;6;21;.778;2995000;0
9557;-1;137;50;0;0;0;.00nan;605000;0
9557;-1;138;36;52;8;44;.846;3556000;0
9558;189264;129;0;0;0;0;.00nan;0;0
9558;200436;130;0;0;0;0;.00nan;0;0
9558;195169;129;66;32;3;29;.906;3900000;0
9558;197759;130;72;43;3;40;.930;3900000;0
9559;189225;1340;0;0;0;0;.00nan;0;0
9559;-1;133;66;25;2;23;.920;3557000;0
9559;191571;1340;100;25;0;25;1.000;3600000;0
9559;192499;133;0;0;0;0;.00nan;0;0
9560;187632;134;0;0;0;0;.00nan;0;0
9560;187657;136;0;0;0;0;.00nan;0;0
9560;199437;134;60;24;2;22;.917;3600000;0
9560;-1;136;68;30;3;27;.900;3579000;0
9561;206789;131;0;0;0;0;.00nan;0;0
9561;-1;132;0;0;0;0;.00nan;0;0
9561;196809;132;46;26;3;23;.885;3563000;0
9561;-1;131;86;32;1;31;.969;3600000;0
9562;203276;139;78;39;4;35;.897;3519000;0
9562;192889;139;0;0;0;0;.00nan;0;0
9562;189944;144;82;30;2;28;.933;3600000;0
9562;-1;144;0;0;0;0;.00nan;0;0
9563;196445;140;100;40;1;39;.975;3600000;0
9563;196812;140;0;0;0;0;.00nan;0;0
9563;-1;141;0;0;0;0;.00nan;0;0
9563;191574;141;84;34;2;32;.941;3575000;0
9564;192895;143;0;0;0;0;.00nan;0;0
9564;183859;142;0;0;0;0;.00nan;0;0
9564;196456;142;81;32;2;30;.938;3516000;0
9564;191218;143;83;14;0;14;1.000;3600000;0
9565;203288;135;0;0;0;0;.00nan;0;0
9565;194197;135;63;46;6;40;.870;3699000;0
9565;-1;128;0;0;0;0;.00nan;0;0
9565;-1;128;19;17;5;12;.706;3699000;0
9566;203276;139;0;0;0;0;.00nan;0;0
9566;192889;139;35;32;6;26;.813;3600000;0
9566;-1;141;67;23;2;21;.913;3600000;0
9566;191574;141;0;0;0;0;.00nan;0;0
9567;189264;129;58;32;3;29;.906;3759000;0
9567;200436;130;62;25;2;23;.920;3759000;0
9567;195169;129;0;0;0;0;.00nan;0;0
9567;197759;130;0;0;0;0;.00nan;0;0
9568;199701;138;0;0;0;0;.00nan;0;0
9568;-1;133;0;0;0;0;.00nan;0;0
9568;192499;133;63;22;2;20;.909;3600000;0
9568;-1;138;72;51;4;47;.922;3530000;0
9569;194264;137;0;0;0;0;.00nan;0;0
9569;189225;1340;0;0;0;0;.00nan;0;0
9569;-1;137;84;29;1;28;.966;3600000;0
9569;191571;1340;62;32;3;29;.906;3538000;0
9570;196445;140;0;0;0;0;.00nan;0;0
9570;196812;140;45;39;6;33;.846;3565000;0
9570;-1;141;0;0;0;0;.00nan;0;0
9570;191574;141;65;37;4;33;.892;3600000;0
9571;203276;139;58;37;4;33;.892;3578000;0
9571;192889;139;0;0;0;0;.00nan;0;0
9571;192895;143;0;0;0;0;.00nan;0;0
9571;191218;143;60;21;3;18;.857;3600000;0
9572;187657;136;85;28;1;27;.964;3600000;0
9572;189225;1340;0;0;0;0;.00nan;0;0
9572;-1;136;0;0;0;0;.00nan;0;0
9572;191571;1340;50;24;4;20;.833;3600000;0
9573;200436;130;0;0;0;0;.00nan;0;0
9573;197759;130;89;34;1;33;.971;3600000;0
9573;-1;128;88;33;2;31;.939;3585000;0
9573;-1;128;0;0;0;0;.00nan;0;0
9574;187632;134;82;26;1;25;.962;3600000;0
9574;199437;134;0;0;0;0;.00nan;0;0
9574;199701;138;50;2;0;2;1.000;435000;0
9574;-1;138;73;55;5;50;.909;3165000;0
9575;194264;137;24;5;3;2;.400;485000;0
9575;189944;144;100;46;3;43;.935;3600000;0
9575;-1;137;31;27;5;22;.815;3115000;0
9575;-1;144;0;0;0;0;.00nan;0;0
9576;206789;131;62;30;3;27;.900;3600000;0
9576;-1;131;0;0;0;0;.00nan;0;0
9576;-1;128;47;7;1;6;.857;514000;0
9576;-1;128;17;24;6;18;.750;3086000;0
9577;183859;142;82;25;2;23;.920;3600000;0
9577;196456;142;0;0;0;0;.00nan;0;0
9577;-1;141;0;0;0;0;.00nan;0;0
9577;191574;141;62;33;4;29;.879;3517000;0
9578;192895;143;49;16;3;13;.813;3600000;0
9578;189225;1340;85;19;0;19;1.000;2345000;0
9578;191218;143;0;0;0;0;.00nan;0;0
9578;191571;1340;32;17;4;13;.765;1200000;0
9579;203276;139;0;0;0;0;.00nan;0;0
9579;192889;139;70;41;4;37;.902;3600000;0
9579;194264;137;63;26;3;23;.885;3600000;0
9579;-1;137;0;0;0;0;.00nan;0;0
9580;-1;132;54;45;6;39;.867;3600000;0
9580;196809;132;0;0;0;0;.00nan;0;0
9580;-1;133;76;16;1;15;.938;3600000;0
9580;192499;133;0;0;0;0;.00nan;0;0
9581;187632;134;68;34;4;30;.882;3574000;0
9581;199437;134;0;0;0;0;.00nan;0;0
9581;196445;140;0;0;0;0;.00nan;0;0
9581;196812;140;63;23;2;21;.913;3600000;0
9582;187657;136;0;0;0;0;.00nan;0;0
9582;189264;129;47;6;1;5;.833;642000;0
9582;195169;129;55;43;6;37;.860;2958000;0
9582;-1;136;62;15;1;14;.933;3600000;0
9583;203288;135;94;31;1;30;.968;3600000;0
9583;199701;138;0;0;0;0;.00nan;0;0
9583;194197;135;0;0;0;0;.00nan;0;0
9583;-1;138;62;45;4;41;.911;3600000;0
9584;200436;130;0;0;0;0;.00nan;0;0
9584;206789;131;0;0;0;0;.00nan;0;0
9584;197759;130;54;26;3;23;.885;3528000;0
9584;-1;131;92;40;1;39;.975;3600000;0
9585;-1;132;0;0;0;0;.00nan;0;0
9585;196809;132;68;41;4;37;.902;3600000;0
9585;-1;133;0;0;0;0;.00nan;0;0
9585;192499;133;66;16;1;15;.938;3600000;0
9586;199701;138;99;45;1;44;.978;3600000;0
9586;196445;140;46;16;3;13;.813;3600000;0
9586;196812;140;0;0;0;0;.00nan;0;0
9586;-1;138;0;0;0;0;.00nan;0;0
9587;203288;135;67;26;3;23;.885;3600000;0
9587;194197;135;0;0;0;0;.00nan;0;0
9587;-1;128;33;30;6;24;.800;3600000;0
9587;-1;128;0;0;0;0;.00nan;0;0
9588;203276;139;99;43;1;42;.977;3600000;0
9588;192889;139;0;0;0;0;.00nan;0;0
9588;189225;1340;0;0;0;0;.00nan;0;0
9588;191571;1340;40;16;3;13;.813;3579000;0
9589;183859;142;56;32;5;27;.844;3658000;0
9589;189944;144;36;24;4;20;.833;3658000;0
9589;196456;142;0;0;0;0;.00nan;0;0
9589;-1;144;0;0;0;0;.00nan;0;0
9590;187657;136;50;1;0;1;1.000;313000;0
9590;-1;136;24;26;6;20;.769;3287000;0
9590;-1;141;92;36;2;34;.944;3600000;0
9590;191574;141;0;0;0;0;.00nan;0;0
9591;192895;143;0;0;0;0;.00nan;0;0
9591;194264;137;38;19;4;15;.789;1133000;0
9591;191218;143;57;25;3;22;.880;3600000;0
9591;-1;137;71;21;1;20;.952;2390000;0
9592;187632;134;82;28;1;27;.964;3600000;0
9592;199437;134;0;0;0;0;.00nan;0;0
9592;200436;130;37;29;5;24;.828;2593000;0
9592;197759;130;22;12;4;8;.667;1007000;0
9593;189264;129;78;31;2;29;.935;3600000;0
9593;195169;129;0;0;0;0;.00nan;0;0
9593;206789;131;63;40;5;35;.875;3600000;0
9593;-1;131;0;0;0;0;.00nan;0;0
9594;189225;1340;0;0;0;0;.00nan;0;0
9594;189944;144;0;0;0;0;.00nan;0;0
9594;191571;1340;83;36;2;34;.944;3900000;0
9594;-1;144;66;29;2;27;.931;3900000;0
9595;187657;136;70;29;2;27;.931;3600000;0
9595;196445;140;0;0;0;0;.00nan;0;0
9595;196812;140;48;28;4;24;.857;3600000;0
9595;-1;136;0;0;0;0;.00nan;0;0
9596;187632;134;0;0;0;0;.00nan;0;0
9596;199437;134;20;24;7;17;.708;3600000;0
9596;200436;130;0;0;0;0;.00nan;0;0
9596;197759;130;64;31;3;28;.903;3600000;0
9597;-1;132;19;8;4;4;.500;444000;0
9597;196809;132;88;29;1;28;.966;3156000;0
9597;-1;128;0;0;0;0;.00nan;0;0
9597;-1;128;63;19;2;17;.895;3600000;0
9598;203288;135;85;30;1;29;.967;3600000;0
9598;194197;135;0;0;0;0;.00nan;0;0
9598;189264;129;0;0;0;0;.00nan;0;0
9598;195169;129;54;25;3;22;.880;3533000;0
9599;189944;144;25;23;6;17;.739;3355000;0
9599;206789;131;34;36;6;30;.833;3900000;0
9599;-1;131;0;0;0;0;.00nan;0;0
9599;-1;144;49;2;0;2;1.000;518000;0
9600;203276;139;47;29;4;25;.862;1945000;0
9600;192889;139;44;16;3;13;.813;1655000;0
9600;187632;134;92;19;0;19;1.000;3600000;0
9600;199437;134;0;0;0;0;.00nan;0;0
9601;192895;143;0;0;0;0;.00nan;0;0
9601;200436;130;0;0;0;0;.00nan;0;0
9601;191218;143;60;31;4;27;.871;3884000;0
9601;197759;130;70;44;4;40;.909;3900000;0
9602;183859;142;57;22;3;19;.864;3900000;0
9602;189225;1340;0;0;0;0;.00nan;0;0
9602;196456;142;0;0;0;0;.00nan;0;0
9602;191571;1340;56;25;3;22;.880;3900000;0
9603;189264;129;61;26;3;23;.885;3600000;0
9603;195169;129;0;0;0;0;.00nan;0;0
9603;-1;133;0;0;0;0;.00nan;0;0
9603;192499;133;47;28;4;24;.857;3595000;0
9604;206789;131;0;0;0;0;.00nan;0;0
9604;196445;140;0;0;0;0;.00nan;0;0
9604;196812;140;47;29;4;25;.862;3600000;0
9604;-1;131;69;18;1;17;.944;3600000;0
9605;187657;136;0;0;0;0;.00nan;0;0
9605;-1;136;72;26;2;24;.923;3600000;0
9605;-1;141;0;0;0;0;.00nan;0;0
9605;191574;141;54;45;6;39;.867;3600000;0
9606;203288;135;0;0;0;0;.00nan;0;0
9606;187578;135;81;14;0;14;1.000;3600000;0
9606;-1;133;59;29;3;26;.897;3600000;0
9606;192499;133;0;0;0;0;.00nan;0;0
9607;194264;137;28;29;6;23;.793;3065000;0
9607;200436;130;0;0;0;0;.00nan;0;0
9607;-1;137;51;2;0;2;1.000;535000;0
9607;197759;130;78;36;2;34;.944;3600000;0
9608;203276;139;63;27;3;24;.889;3600000;0
9608;192889;139;0;0;0;0;.00nan;0;0
9608;199701;138;0;0;0;0;.00nan;0;0
9608;-1;138;57;30;4;26;.867;3554000;0
9609;206789;131;56;41;5;36;.878;3580000;0
9609;-1;141;42;23;4;19;.826;3600000;0
9609;191574;141;0;0;0;0;.00nan;0;0
9609;-1;131;0;0;0;0;.00nan;0;0
9610;183859;142;74;16;1;15;.938;3600000;0
9610;196456;142;0;0;0;0;.00nan;0;0
9610;-1;132;0;0;0;0;.00nan;0;0
9610;196809;132;72;30;3;27;.900;3582000;0
9611;187632;134;65;17;1;16;.941;3600000;0
9611;199437;134;0;0;0;0;.00nan;0;0
9611;189264;129;0;0;0;0;.00nan;0;0
9611;195169;129;48;33;5;28;.848;3600000;0
9612;189944;144;51;18;3;15;.833;3621000;0
9612;196445;140;69;40;4;36;.900;3621000;0
9612;196812;140;0;0;0;0;.00nan;0;0
9612;-1;144;0;0;0;0;.00nan;0;0
9613;192895;143;0;0;0;0;.00nan;0;0
9613;191218;143;66;29;2;27;.931;3600000;0
9613;-1;128;43;37;6;31;.838;3600000;0
9613;-1;128;0;0;0;0;.00nan;0;0
9614;199701;138;0;0;0;0;.00nan;0;0
9614;-1;133;0;0;0;0;.00nan;0;0
9614;192499;133;79;27;3;24;.889;3600000;0
9614;-1;138;42;33;5;28;.848;3532000;0
9615;203276;139;27;9;3;6;.667;528000;0
9615;192889;139;63;41;5;36;.878;3072000;0
9615;187657;136;53;23;3;20;.870;3600000;0
9615;-1;136;0;0;0;0;.00nan;0;0
9616;192895;143;45;19;3;16;.842;3600000;0
9616;-1;132;65;43;4;39;.907;3600000;0
9616;196809;132;0;0;0;0;.00nan;0;0
9616;191218;143;0;0;0;0;.00nan;0;0
9617;189225;1340;43;20;4;16;.800;3600000;0
9617;200436;130;0;0;0;0;.00nan;0;0
9617;191571;1340;0;0;0;0;.00nan;0;0
9617;197759;130;64;47;6;41;.872;3558000;0
9618;203288;135;0;0;0;0;.00nan;0;0
9618;187578;135;77;35;4;31;.886;3900000;0
9618;189264;129;65;41;4;37;.902;3900000;0
9618;195169;129;0;0;0;0;.00nan;0;0
9619;189944;144;0;0;0;0;.00nan;0;0
9619;-1;141;0;0;0;0;.00nan;0;0
9619;191574;141;52;34;5;29;.853;3600000;0
9619;-1;144;90;40;2;38;.950;3600000;0
9620;183859;142;54;31;4;27;.871;3600000;0
9620;196456;142;0;0;0;0;.00nan;0;0
9620;-1;128;0;0;0;0;.00nan;0;0
9620;-1;128;55;24;3;21;.875;3600000;0
9621;187632;134;0;0;0;0;.00nan;0;0
9621;199437;134;90;36;1;35;.972;3600000;0
9621;194264;137;0;0;0;0;.00nan;0;0
9621;-1;137;66;30;2;28;.933;3558000;0
9622;189225;1340;0;0;0;0;.00nan;0;0
9622;-1;133;0;0;0;0;.00nan;0;0
9622;191571;1340;73;37;3;34;.919;3545000;0
9622;192499;133;72;19;1;18;.947;3600000;0
9623;203288;135;0;0;0;0;.00nan;0;0
9623;187578;135;63;44;4;40;.909;3511000;0
9623;200436;130;0;0;0;0;.00nan;0;0
9623;197759;130;78;32;2;30;.938;3600000;0
9624;192895;143;0;0;0;0;.00nan;0;0
9624;191218;143;92;26;1;25;.962;3900000;0
9624;-1;141;0;0;0;0;.00nan;0;0
9624;191574;141;96;54;1;53;.981;3900000;0
9625;196445;140;0;0;0;0;.00nan;0;0
9625;196812;140;94;51;2;49;.961;3732000;0
9625;-1;128;70;19;1;18;.947;3732000;0
9625;-1;128;0;0;0;0;.00nan;0;0
9626;194264;137;60;21;2;19;.905;3600000;0
9626;206789;131;48;26;4;22;.846;1747000;0
9626;-1;137;0;0;0;0;.00nan;0;0
9626;-1;131;67;19;1;18;.947;1853000;0
9627;187657;136;0;0;0;0;.00nan;0;0
9627;199701;138;59;4;0;4;1.000;476000;0
9627;-1;136;50;23;4;19;.826;3600000;0
9627;-1;138;28;27;6;21;.778;3088000;0
9628;192895;143;42;16;3;13;.813;3900000;0
9628;-1;132;92;47;3;44;.936;3900000;0
9628;196809;132;0;0;0;0;.00nan;0;0
9628;191218;143;0;0;0;0;.00nan;0;0
9629;203276;139;0;0;0;0;.00nan;0;0
9629;192889;139;94;46;2;44;.957;3578000;0
9629;-1;128;0;0;0;0;.00nan;0;0
9629;-1;128;87;27;1;26;.963;3600000;0
9630;187657;136;80;28;2;26;.929;3600000;0
9630;-1;136;0;0;0;0;.00nan;0;0
9630;-1;133;0;0;0;0;.00nan;0;0
9630;192499;133;12;32;8;24;.750;3600000;0
9631;203288;135;0;0;0;0;.00nan;0;0
9631;187578;135;93;43;2;41;.953;3900000;0
9631;187632;134;68;26;2;24;.923;3900000;0
9631;199437;134;0;0;0;0;.00nan;0;0
9632;189264;129;63;42;5;37;.881;3544000;0
9632;200436;130;0;0;0;0;.00nan;0;0
9632;195169;129;0;0;0;0;.00nan;0;0
9632;197759;130;43;22;4;18;.818;3600000;0
9633;189225;1340;0;0;0;0;.00nan;0;0
9633;206789;131;66;36;4;32;.889;3600000;0
9633;191571;1340;54;24;3;21;.875;3600000;0
9633;-1;131;0;0;0;0;.00nan;0;0
9634;196445;140;0;0;0;0;.00nan;0;0
9634;196812;140;58;41;5;36;.878;3600000;0
9634;-1;141;0;0;0;0;.00nan;0;0
9634;191574;141;100;27;0;27;1.000;3600000;0
9635;194264;137;75;41;3;38;.927;3600000;0
9635;-1;133;69;23;2;21;.913;3600000;0
9635;-1;137;0;0;0;0;.00nan;0;0
9635;192499;133;0;0;0;0;.00nan;0;0
9636;203288;135;0;0;0;0;.00nan;0;0
9636;187578;135;62;41;4;37;.902;3600000;0
9636;199701;138;0;0;0;0;.00nan;0;0
9636;-1;138;89;25;1;24;.960;3600000;0
9637;203276;139;78;34;3;31;.912;3600000;0
9637;192889;139;0;0;0;0;.00nan;0;0
9637;-1;132;0;0;0;0;.00nan;0;0
9637;196809;132;53;35;5;30;.857;3600000;0
9638;183859;142;63;34;4;30;.882;3521000;0
9638;189944;144;81;32;2;30;.938;3600000;0
9638;196456;142;0;0;0;0;.00nan;0;0
9638;-1;144;0;0;0;0;.00nan;0;0
9639;192895;143;0;0;0;0;.00nan;0;0
9639;191218;143;71;34;3;31;.912;3900000;0
9639;-1;128;0;0;0;0;.00nan;0;0
9639;-1;128;61;28;3;25;.893;3900000;0
9640;183859;142;82;33;2;31;.939;3600000;0
9640;196456;142;0;0;0;0;.00nan;0;0
9640;-1;141;0;0;0;0;.00nan;0;0
9640;191574;141;83;45;4;41;.911;3600000;0
9641;189225;1340;0;0;0;0;.00nan;0;0
9641;200436;130;0;0;0;0;.00nan;0;0
9641;191571;1340;92;39;2;37;.949;3600000;0
9641;197759;130;50;31;4;27;.871;3568000;0
9642;189944;144;77;23;1;22;.957;3600000;0
9642;-1;132;92;42;3;39;.929;3600000;0
9642;196809;132;0;0;0;0;.00nan;0;0
9642;-1;144;0;0;0;0;.00nan;0;0
9643;187632;134;79;29;2;27;.931;3600000;0
9643;199437;134;0;0;0;0;.00nan;0;0
9643;199701;138;26;8;3;5;.625;434000;0
9643;-1;138;63;38;4;34;.895;3166000;0
9644;189264;129;94;22;0;22;1.000;3600000;0
9644;195169;129;0;0;0;0;.00nan;0;0
9644;206789;131;0;0;0;0;.00nan;0;0
9644;-1;131;81;41;3;38;.927;3600000;0
9645;187657;136;82;17;1;16;.941;1646000;0
9645;194264;137;0;0;0;0;.00nan;0;0
9645;-1;136;38;27;5;22;.815;1954000;0
9645;-1;137;66;28;3;25;.893;3600000;0
9646;203276;139;55;31;4;27;.871;3658000;0
9646;192889;139;0;0;0;0;.00nan;0;0
9646;189944;144;66;29;3;26;.897;3658000;0
9646;-1;144;0;0;0;0;.00nan;0;0
9647;187632;134;86;31;1;30;.968;3600000;0
9647;199437;134;0;0;0;0;.00nan;0;0
9647;194264;137;80;35;2;33;.943;3592000;0
9647;-1;137;0;0;0;0;.00nan;0;0
9648;187657;136;0;0;0;0;.00nan;0;0
9648;199701;138;50;9;1;8;.889;517000;0
9648;-1;136;62;21;2;19;.905;3600000;0
9648;-1;138;43;38;6;32;.842;3083000;0
9649;183859;142;63;32;3;29;.906;3600000;0
9649;196445;140;82;17;0;17;1.000;3600000;0
9649;196456;142;0;0;0;0;.00nan;0;0
9649;196812;140;0;0;0;0;.00nan;0;0
9650;192895;143;0;0;0;0;.00nan;0;0
9650;206789;131;51;43;6;37;.860;3600000;0
9650;191218;143;86;17;0;17;1.000;3600000;0
9650;-1;131;0;0;0;0;.00nan;0;0
9651;183859;142;16;7;4;3;.429;962000;0
9651;189944;144;69;30;2;28;.933;3600000;0
9651;196456;142;77;21;1;20;.952;2638000;0
9651;-1;144;0;0;0;0;.00nan;0;0
9652;-1;141;72;39;4;35;.897;3600000;0
9652;-1;133;0;0;0;0;.00nan;0;0
9652;191574;141;0;0;0;0;.00nan;0;0
9652;192499;133;21;16;5;11;.688;3547000;0
9653;203276;139;54;33;4;29;.879;3600000;0
9653;192889;139;0;0;0;0;.00nan;0;0
9653;196445;140;72;19;1;18;.947;3600000;0
9653;196812;140;0;0;0;0;.00nan;0;0
9654;187632;134;29;41;8;33;.805;3600000;0
9654;187657;136;87;25;1;24;.960;3600000;0
9654;199437;134;0;0;0;0;.00nan;0;0
9654;-1;136;0;0;0;0;.00nan;0;0
9655;200436;130;0;0;0;0;.00nan;0;0
9655;197759;130;61;35;4;31;.886;3545000;0
9655;-1;128;0;0;0;0;.00nan;0;0
9655;-1;128;80;40;3;37;.925;3600000;0
9656;203288;135;0;0;0;0;.00nan;0;0
9656;187578;135;80;26;1;25;.962;3600000;0
9656;194264;137;70;23;2;21;.913;3546000;0
9656;-1;137;0;0;0;0;.00nan;0;0
9657;192895;143;0;0;0;0;.00nan;0;0
9657;189264;129;87;41;3;38;.927;3600000;0
9657;195169;129;0;0;0;0;.00nan;0;0
9657;191218;143;39;21;4;17;.810;3556000;0
9658;199701;138;0;0;0;0;.00nan;0;0
9658;189225;1340;0;0;0;0;.00nan;0;0
9658;191571;1340;42;20;4;16;.800;3542000;0
9658;-1;138;75;29;2;27;.931;3600000;0
9659;203276;139;0;0;0;0;.00nan;0;0
9659;192889;139;72;24;1;23;.958;3854000;0
9659;-1;141;0;0;0;0;.00nan;0;0
9659;191574;141;71;25;2;23;.920;3854000;0
9660;187632;134;49;27;5;22;.815;3708000;0
9660;187657;136;0;0;0;0;.00nan;0;0
9660;199437;134;0;0;0;0;.00nan;0;0
9660;-1;136;74;43;4;39;.907;3708000;0
9661;200436;130;0;0;0;0;.00nan;0;0
9661;-1;132;0;0;0;0;.00nan;0;0
9661;196809;132;47;24;4;20;.833;3600000;0
9661;197759;130;29;24;5;19;.792;3579000;0
9662;192895;143;68;22;2;20;.909;3600000;0
9662;189225;1340;0;0;0;0;.00nan;0;0
9662;191218;143;0;0;0;0;.00nan;0;0
9662;191571;1340;51;30;4;26;.867;3581000;0
9663;203288;135;0;0;0;0;.00nan;0;0
9663;187578;135;87;28;1;27;.964;3653000;0
9663;194264;137;0;0;0;0;.00nan;0;0
9663;-1;137;72;26;2;24;.923;3653000;0
9664;199701;138;26;31;6;25;.806;3002000;0
9664;189264;129;0;0;0;0;.00nan;0;0
9664;195169;129;67;21;1;20;.952;3600000;0
9664;-1;138;39;7;2;5;.714;598000;0
9665;189944;144;0;0;0;0;.00nan;0;0
9665;-1;133;69;40;4;36;.900;3892000;0
9665;192499;133;0;0;0;0;.00nan;0;0
9665;-1;144;90;43;3;40;.930;3892000;0
9666;206789;131;0;0;0;0;.00nan;0;0
9666;-1;131;62;43;5;38;.884;3900000;0
9666;-1;128;18;11;4;7;.636;2282000;0
9666;-1;128;56;14;1;13;.929;1618000;0
9667;183859;142;48;26;4;22;.846;3600000;0
9667;196456;142;0;0;0;0;.00nan;0;0
9667;-1;133;0;0;0;0;.00nan;0;0
9667;192499;133;48;29;5;24;.828;3576000;0
9668;206789;131;77;28;2;26;.929;3600000;0
9668;-1;132;57;28;3;25;.893;3544000;0
9668;196809;132;0;0;0;0;.00nan;0;0
9668;-1;131;0;0;0;0;.00nan;0;0
9669;203276;139;69;40;4;36;.900;3600000;0
9669;192889;139;0;0;0;0;.00nan;0;0
9669;-1;141;0;0;0;0;.00nan;0;0
9669;191574;141;65;31;3;28;.903;3600000;0
9670;200436;130;0;0;0;0;.00nan;0;0
9670;196445;140;0;0;0;0;.00nan;0;0
9670;196812;140;23;26;6;20;.769;3600000;0
9670;197759;130;89;32;1;31;.969;3600000;0
9671;189944;144;58;23;3;20;.870;3900000;0
9671;-1;132;0;0;0;0;.00nan;0;0
9671;196809;132;91;43;3;40;.930;3900000;0
9671;-1;144;0;0;0;0;.00nan;0;0
9672;203288;135;0;0;0;0;.00nan;0;0
9672;187578;135;95;38;1;37;.974;3900000;0
9672;187632;134;73;20;1;19;.950;3900000;0
9672;199437;134;0;0;0;0;.00nan;0;0
9673;199701;138;0;0;0;0;.00nan;0;0
9673;189225;1340;0;0;0;0;.00nan;0;0
9673;191571;1340;90;44;3;41;.932;3600000;0
9673;-1;138;58;32;4;28;.875;3581000;0
9674;192895;143;61;14;1;13;.929;3600000;0
9674;189264;129;47;26;4;22;.846;3600000;0
9674;195169;129;0;0;0;0;.00nan;0;0
9674;191218;143;0;0;0;0;.00nan;0;0
9675;189944;144;0;0;0;0;.00nan;0;0
9675;191215;128;50;34;5;29;.853;3900000;0
9675;-1;128;0;0;0;0;.00nan;0;0
9675;-1;144;74;51;5;46;.902;3900000;0
9676;203276;139;0;0;0;0;.00nan;0;0
9676;192889;139;81;45;4;41;.911;3600000;0
9676;187657;136;59;17;3;14;.824;3600000;0
9676;-1;136;0;0;0;0;.00nan;0;0
9677;183859;142;0;0;0;0;.00nan;0;0
9677;196456;142;72;23;1;22;.957;3600000;0
9677;-1;141;78;36;2;34;.944;3429000;0
9677;191574;141;24;6;3;3;.500;171000;0
9678;203288;135;0;0;0;0;.00nan;0;0
9678;187578;135;65;52;5;47;.904;3600000;0
9678;-1;133;52;26;4;22;.846;3600000;0
9678;192499;133;0;0;0;0;.00nan;0;0
9679;196445;140;54;38;5;33;.868;3565000;0
9679;196812;140;0;0;0;0;.00nan;0;0
9679;191215;128;68;31;3;28;.903;3600000;0
9679;-1;128;0;0;0;0;.00nan;0;0
9680;194264;137;81;16;0;16;1.000;3600000;0
9680;206789;131;84;43;2;41;.953;3600000;0
9680;-1;137;0;0;0;0;.00nan;0;0
9680;-1;131;0;0;0;0;.00nan;0;0
9681;187632;134;51;23;3;20;.870;3591000;0
9681;199437;134;0;0;0;0;.00nan;0;0
9681;189225;1340;0;0;0;0;.00nan;0;0
9681;191571;1340;73;32;2;30;.938;3600000;0
9682;183859;142;80;35;3;32;.914;3600000;0
9682;196456;142;0;0;0;0;.00nan;0;0
9682;-1;141;0;0;0;0;.00nan;0;0
9682;191574;141;30;25;5;20;.800;3565000;0
9683;199701;138;0;0;0;0;.00nan;0;0
9683;194264;137;51;23;3;20;.870;3893000;0
9683;-1;137;0;0;0;0;.00nan;0;0
9683;-1;138;72;38;3;35;.921;3900000;0
9684;200436;130;43;34;5;29;.853;3881000;0
9684;189944;144;58;38;5;33;.868;3900000;0
9684;197759;130;0;0;0;0;.00nan;0;0
9684;-1;144;0;0;0;0;.00nan;0;0
9685;196445;140;0;0;0;0;.00nan;0;0
9685;-1;132;43;23;4;19;.826;3600000;0
9685;196809;132;0;0;0;0;.00nan;0;0
9685;196812;140;94;29;1;28;.966;3600000;0
9686;187632;134;66;22;2;20;.909;3600000;0
9686;199437;134;0;0;0;0;.00nan;0;0
9686;189225;1340;40;28;5;23;.821;3600000;0
9686;191571;1340;0;0;0;0;.00nan;0;0
9687;203288;135;73;23;1;22;.957;3900000;0
9687;187578;135;0;0;0;0;.00nan;0;0
9687;206789;131;0;0;0;0;.00nan;0;0
9687;-1;131;87;35;1;34;.971;3900000;0
9688;203276;139;30;29;6;23;.793;2596000;0
9688;192889;139;44;6;1;5;.833;1004000;0
9688;189264;129;65;24;2;22;.917;3600000;0
9688;195169;129;0;0;0;0;.00nan;0;0
9689;192895;143;0;0;0;0;.00nan;0;0
9689;187657;136;0;0;0;0;.00nan;0;0
9689;191218;143;51;26;3;23;.885;3599000;0
9689;-1;136;89;28;1;27;.964;3600000;0
9690;183859;142;0;0;0;0;.00nan;0;0
9690;189264;129;0;0;0;0;.00nan;0;0
9690;195169;129;48;17;3;14;.824;3600000;0
9690;196456;142;30;36;7;29;.806;3600000;0
9691;199701;138;56;25;3;22;.880;3600000;0
9691;-1;133;55;31;4;27;.871;3083000;0
9691;192499;133;25;6;3;3;.500;517000;0
9691;-1;138;0;0;0;0;.00nan;0;0
9692;191215;128;64;20;2;18;.900;3600000;0
9692;-1;133;0;0;0;0;.00nan;0;0
9692;192499;133;49;38;5;33;.868;3600000;0
9692;-1;128;0;0;0;0;.00nan;0;0
9693;187632;134;60;22;2;20;.909;3600000;0
9693;199437;134;0;0;0;0;.00nan;0;0
9693;199701;138;0;0;0;0;.00nan;0;0
9693;-1;138;79;26;1;25;.962;3600000;0
9694;187657;136;57;34;4;30;.882;3600000;0
9694;206789;131;56;43;6;37;.860;3600000;0
9694;-1;136;0;0;0;0;.00nan;0;0
9694;-1;131;0;0;0;0;.00nan;0;0
9695;189944;144;68;16;1;15;.938;3600000;0
9695;196445;140;0;0;0;0;.00nan;0;0
9695;196812;140;90;35;2;33;.943;3573000;0
9695;-1;144;0;0;0;0;.00nan;0;0
9696;203288;135;0;0;0;0;.00nan;0;0
9696;187578;135;99;43;1;42;.977;3600000;0
9696;192895;143;0;0;0;0;.00nan;0;0
9696;191218;143;70;24;2;22;.917;3568000;0
9697;203276;139;70;34;3;31;.912;3160000;0
9697;192889;139;30;10;3;7;.700;440000;0
9697;183859;142;45;17;3;14;.824;3600000;0
9697;196456;142;0;0;0;0;.00nan;0;0
9698;187657;136;0;0;0;0;.00nan;0;0
9698;191215;128;59;26;3;23;.885;3544000;0
9698;-1;136;81;29;1;28;.966;3600000;0
9698;-1;128;0;0;0;0;.00nan;0;0
9699;200436;130;0;0;0;0;.00nan;0;0
9699;-1;133;81;29;2;27;.931;3600000;0
9699;192499;133;0;0;0;0;.00nan;0;0
9699;197759;130;40;28;5;23;.821;3600000;0
9700;187632;134;59;32;5;27;.844;3600000;0
9700;199437;134;0;0;0;0;.00nan;0;0
9700;206789;131;21;23;6;17;.739;2060000;0
9700;-1;131;42;16;3;13;.813;1540000;0
9701;194264;137;66;25;2;23;.920;3600000;0
9701;189264;129;42;37;6;31;.838;3600000;0
9701;195169;129;0;0;0;0;.00nan;0;0
9701;-1;137;0;0;0;0;.00nan;0;0
9702;199701;138;0;0;0;0;.00nan;0;0
9702;-1;132;0;0;0;0;.00nan;0;0
9702;196809;132;47;31;5;26;.839;3764000;0
9702;-1;138;43;26;4;22;.846;3764000;0
9703;189225;1340;0;0;0;0;.00nan;0;0
9703;-1;141;35;4;2;2;.500;424000;0
9703;191571;1340;70;32;2;30;.938;3600000;0
9703;191574;141;27;26;6;20;.769;3176000;0
9704;199701;138;71;37;3;34;.919;3600000;0
9704;-1;132;30;26;6;20;.769;3600000;0
9704;196809;132;0;0;0;0;.00nan;0;0
9704;-1;138;0;0;0;0;.00nan;0;0
9705;187657;136;87;28;1;27;.964;3600000;0
9705;191215;128;70;42;3;39;.929;3590000;0
9705;-1;136;0;0;0;0;.00nan;0;0
9705;-1;128;0;0;0;0;.00nan;0;0
9706;200436;130;41;25;4;21;.840;3801000;0
9706;-1;133;0;0;0;0;.00nan;0;0
9706;192499;133;71;50;5;45;.900;3801000;0
9706;197759;130;0;0;0;0;.00nan;0;0
9707;194264;137;0;0;0;0;.00nan;0;0
9707;-1;141;61;30;4;26;.867;3600000;0
9707;-1;137;92;36;1;35;.972;3600000;0
9707;191574;141;0;0;0;0;.00nan;0;0
9708;189225;1340;76;28;2;26;.929;3900000;0
9708;206789;131;74;34;2;32;.941;3900000;0
9708;191571;1340;0;0;0;0;.00nan;0;0
9708;-1;131;0;0;0;0;.00nan;0;0
9709;203276;139;0;0;0;0;.00nan;0;0
9709;203288;135;65;25;3;22;.880;3547000;0
9709;187578;135;0;0;0;0;.00nan;0;0
9709;192889;139;89;36;2;34;.944;3600000;0
9710;203276;139;19;24;6;18;.750;3121000;0
9710;192889;139;50;1;0;1;1.000;479000;0
9710;192895;143;65;24;3;21;.875;3600000;0
9710;191218;143;0;0;0;0;.00nan;0;0
9711;183859;142;74;23;2;21;.913;3649000;0
9711;196445;140;88;42;3;39;.929;3649000;0
9711;196456;142;0;0;0;0;.00nan;0;0
9711;196812;140;0;0;0;0;.00nan;0;0
9712;189225;1340;0;0;0;0;.00nan;0;0
9712;200436;130;0;0;0;0;.00nan;0;0
9712;191571;1340;66;31;3;28;.903;3772000;0
9712;197759;130;78;41;4;37;.902;3772000;0
9713;189264;129;50;24;3;21;.875;3083000;0
9713;195169;129;21;3;3;0;.000;517000;0
9713;-1;141;0;0;0;0;.00nan;0;0
9713;191574;141;72;34;3;31;.912;3600000;0
9714;203288;135;0;0;0;0;.00nan;0;0
9714;187578;135;84;56;3;53;.946;3600000;0
9714;189944;144;35;25;5;20;.800;3559000;0
9714;-1;144;0;0;0;0;.00nan;0;0
9715;187632;134;44;16;3;13;.813;3600000;0
9715;199437;134;0;0;0;0;.00nan;0;0
9715;-1;132;0;0;0;0;.00nan;0;0
9715;196809;132;73;44;4;40;.909;3575000;0
9716;192895;143;0;0;0;0;.00nan;0;0
9716;183859;142;0;0;0;0;.00nan;0;0
9716;196456;142;75;32;2;30;.938;3582000;0
9716;191218;143;75;25;1;24;.960;3600000;0
9717;192895;143;45;26;4;22;.846;3600000;0
9717;196445;140;22;29;7;22;.759;3600000;0
9717;196812;140;0;0;0;0;.00nan;0;0
9717;191218;143;0;0;0;0;.00nan;0;0
9718;189944;144;56;23;3;20;.870;3600000;0
9718;-1;141;0;0;0;0;.00nan;0;0
9718;191574;141;46;39;6;33;.846;3600000;0
9718;-1;144;0;0;0;0;.00nan;0;0
9719;187632;134;46;29;4;25;.862;3584000;0
9719;199437;134;0;0;0;0;.00nan;0;0
9719;183859;142;63;26;3;23;.885;3600000;0
9719;196456;142;0;0;0;0;.00nan;0;0
9720;187657;136;0;0;0;0;.00nan;0;0
9720;189264;129;60;48;6;42;.875;3600000;0
9720;195169;129;0;0;0;0;.00nan;0;0
9720;-1;136;63;25;3;22;.880;3600000;0
9721;199701;138;0;0;0;0;.00nan;0;0
9721;200436;130;0;0;0;0;.00nan;0;0
9721;197759;130;85;36;2;34;.944;3900000;0
9721;-1;138;78;31;2;29;.935;3900000;0
9722;203276;139;0;0;0;0;.00nan;0;0
9722;192889;139;64;38;4;34;.895;3600000;0
9722;196445;140;55;26;3;23;.885;3600000;0
9722;196812;140;0;0;0;0;.00nan;0;0
9723;189264;129;0;0;0;0;.00nan;0;0
9723;195169;129;78;34;2;32;.941;3600000;0
9723;-1;133;0;0;0;0;.00nan;0;0
9723;192499;133;65;27;3;24;.889;3564000;0
9724;206789;131;38;26;5;21;.808;3600000;0
9724;191215;128;63;33;3;30;.909;3600000;0
9724;-1;131;0;0;0;0;.00nan;0;0
9724;-1;128;0;0;0;0;.00nan;0;0
9725;189225;1340;0;0;0;0;.00nan;0;0
9725;-1;132;50;35;5;30;.857;3540000;0
9725;196809;132;0;0;0;0;.00nan;0;0
9725;191571;1340;57;25;3;22;.880;3600000;0
9726;203288;135;0;0;0;0;.00nan;0;0
9726;187578;135;47;37;6;31;.838;3580000;0
9726;194264;137;55;26;4;22;.846;3600000;0
9726;-1;137;0;0;0;0;.00nan;0;0
9727;199701;138;92;43;1;42;.977;3600000;0
9727;183859;142;57;5;0;5;1.000;636000;0
9727;196456;142;26;24;5;19;.792;2964000;0
9727;-1;138;0;0;0;0;.00nan;0;0
9728;187632;134;75;31;3;28;.903;3900000;0
9728;199437;134;0;0;0;0;.00nan;0;0
9728;200436;130;0;0;0;0;.00nan;0;0
9728;197759;130;69;27;3;24;.889;3900000;0
9729;206789;131;0;0;0;0;.00nan;0;0
9729;-1;132;85;26;1;25;.962;3600000;0
9729;196809;132;0;0;0;0;.00nan;0;0
9729;-1;131;59;31;4;27;.871;3600000;0
9730;203288;135;63;39;5;34;.872;3600000;0
9730;187578;135;0;0;0;0;.00nan;0;0
9730;194264;137;65;16;1;15;.938;1307000;0
9730;-1;137;28;21;6;15;.714;2270000;0
9731;189264;129;64;24;2;22;.917;3600000;0
9731;195169;129;0;0;0;0;.00nan;0;0
9731;-1;133;72;30;3;27;.900;3558000;0
9731;192499;133;0;0;0;0;.00nan;0;0
9732;203276;139;16;23;6;17;.739;2364000;0
9732;192889;139;55;11;1;10;.909;1236000;0
9732;-1;141;0;0;0;0;.00nan;0;0
9732;191574;141;78;30;2;28;.933;3600000;0
9733;192895;143;0;0;0;0;.00nan;0;0
9733;189944;144;73;36;4;32;.889;3600000;0
9733;191218;143;55;38;5;33;.868;3600000;0
9733;-1;144;0;0;0;0;.00nan;0;0
9734;192895;143;66;26;3;23;.885;3600000;0
9734;196445;140;50;35;5;30;.857;3600000;0
9734;196812;140;0;0;0;0;.00nan;0;0
9734;191218;143;0;0;0;0;.00nan;0;0
9735;187657;136;50;18;3;15;.833;3600000;0
9735;183859;142;69;45;4;41;.911;3600000;0
9735;196456;142;0;0;0;0;.00nan;0;0
9735;-1;136;0;0;0;0;.00nan;0;0
9736;187632;134;0;0;0;0;.00nan;0;0
9736;199437;134;73;27;2;25;.926;3588000;0
9736;200436;130;100;42;1;41;.976;3600000;0
9736;197759;130;0;0;0;0;.00nan;0;0
9737;189225;1340;0;0;0;0;.00nan;0;0
9737;191215;128;55;27;3;24;.889;3600000;0
9737;191571;1340;21;29;6;23;.793;3600000;0
9737;-1;128;0;0;0;0;.00nan;0;0
9738;206789;131;100;52;0;52;1.000;3600000;0
9738;-1;133;0;0;0;0;.00nan;0;0
9738;192499;133;65;19;1;18;.947;3545000;0
9738;-1;131;0;0;0;0;.00nan;0;0
9739;187632;134;55;30;4;26;.867;3600000;0
9739;199437;134;0;0;0;0;.00nan;0;0
9739;196445;140;0;0;0;0;.00nan;0;0
9739;196812;140;41;34;6;28;.824;3600000;0
9740;187657;136;0;0;0;0;.00nan;0;0
9740;-1;132;54;10;1;9;.900;924000;0
9740;196809;132;35;35;6;29;.829;2676000;0
9740;-1;136;63;27;3;24;.889;3600000;0
9741;189944;144;50;26;5;21;.808;3585000;0
9741;196445;140;69;33;3;30;.909;3600000;0
9741;196812;140;0;0;0;0;.00nan;0;0
9741;-1;144;0;0;0;0;.00nan;0;0
9742;203276;139;0;0;0;0;.00nan;0;0
9742;192889;139;46;29;5;24;.828;3600000;0
9742;187632;134;0;0;0;0;.00nan;0;0
9742;199437;134;79;35;3;32;.914;3600000;0
9743;199701;138;0;0;0;0;.00nan;0;0
9743;-1;133;0;0;0;0;.00nan;0;0
9743;192499;133;70;25;2;23;.920;3900000;0
9743;-1;138;80;30;2;28;.933;3900000;0
9744;189264;129;40;35;6;29;.829;3600000;0
9744;200436;130;0;0;0;0;.00nan;0;0
9744;195169;129;0;0;0;0;.00nan;0;0
9744;197759;130;57;21;2;19;.905;3600000;0
9745;189225;1340;0;0;0;0;.00nan;0;0
9745;206789;131;63;47;5;42;.894;3600000;0
9745;191571;1340;70;25;2;23;.920;3600000;0
9745;-1;131;0;0;0;0;.00nan;0;0
9746;189944;144;0;0;0;0;.00nan;0;0
9746;191215;128;100;32;0;32;1.000;3600000;0
9746;-1;144;70;25;2;23;.920;3582000;0
9746;-1;128;0;0;0;0;.00nan;0;0
9747;-1;132;27;32;7;25;.781;3600000;0
9747;196809;132;0;0;0;0;.00nan;0;0
9747;-1;141;0;0;0;0;.00nan;0;0
9747;191574;141;51;15;2;13;.867;3600000;0
9748;203276;139;49;27;4;23;.852;3600000;0
9748;192889;139;0;0;0;0;.00nan;0;0
9748;192895;143;0;0;0;0;.00nan;0;0
9748;191218;143;49;13;2;11;.846;3600000;0
9749;194264;137;47;27;4;23;.852;3600000;0
9749;200436;130;40;35;6;29;.829;2841000;0
9749;-1;137;0;0;0;0;.00nan;0;0
9749;197759;130;54;6;0;6;1.000;755000;0
9750;203288;135;0;0;0;0;.00nan;0;0
9750;187578;135;77;40;4;36;.900;3600000;0
9750;187657;136;56;19;2;17;.895;3600000;0
9750;-1;136;0;0;0;0;.00nan;0;0
9751;199701;138;63;42;5;37;.881;3559000;0
9751;189225;1340;27;13;4;9;.692;3600000;0
9751;191571;1340;0;0;0;0;.00nan;0;0
9751;-1;138;0;0;0;0;.00nan;0;0
9752;194264;137;91;28;1;27;.964;3600000;0
9752;189264;129;0;0;0;0;.00nan;0;0
9752;195169;129;74;34;3;31;.912;3543000;0
9752;-1;137;0;0;0;0;.00nan;0;0
9753;192895;143;70;22;1;21;.955;3600000;0
9753;187632;134;57;31;4;27;.871;3600000;0
9753;199437;134;0;0;0;0;.00nan;0;0
9753;191218;143;0;0;0;0;.00nan;0;0
9754;196445;140;0;0;0;0;.00nan;0;0
9754;-1;132;0;0;0;0;.00nan;0;0
9754;196809;132;65;43;5;38;.884;3543000;0
9754;196812;140;48;22;3;19;.864;3600000;0
9755;183859;142;99;49;1;48;.980;3600000;0
9755;196456;142;0;0;0;0;.00nan;0;0
9755;191215;128;44;21;4;17;.810;3600000;0
9755;-1;128;0;0;0;0;.00nan;0;0
9756;191215;128;45;22;3;19;.864;3600000;0
9756;-1;141;79;57;5;52;.912;3548000;0
9756;191574;141;0;0;0;0;.00nan;0;0
9756;-1;128;0;0;0;0;.00nan;0;0
9757;183859;142;0;0;0;0;.00nan;0;0
9757;196456;142;72;25;2;23;.920;3600000;0
9757;-1;132;51;31;4;27;.871;3600000;0
9757;196809;132;0;0;0;0;.00nan;0;0
9758;189225;1340;0;0;0;0;.00nan;0;0
9758;189264;129;26;6;3;3;.500;530000;0
9758;195169;129;67;19;1;18;.947;3022000;0
9758;191571;1340;70;33;3;30;.909;3600000;0
9759;203276;139;0;0;0;0;.00nan;0;0
9759;192889;139;43;31;5;26;.839;3600000;0
9759;189944;144;53;15;2;13;.867;3600000;0
9759;-1;144;0;0;0;0;.00nan;0;0
9760;187657;136;0;0;0;0;.00nan;0;0
9760;199701;138;0;0;0;0;.00nan;0;0
9760;-1;136;49;26;4;22;.846;3600000;0
9760;-1;138;76;50;5;45;.900;3600000;0
9761;203288;135;0;0;0;0;.00nan;0;0
9761;187578;135;83;28;1;27;.964;3600000;0
9761;206789;131;27;23;5;18;.783;3600000;0
9761;-1;131;0;0;0;0;.00nan;0;0
9762;194264;137;71;22;1;21;.955;3600000;0
9762;-1;133;44;32;5;27;.844;3600000;0
9762;-1;137;0;0;0;0;.00nan;0;0
9762;192499;133;0;0;0;0;.00nan;0;0
9763;192895;143;51;18;2;16;.889;3600000;0
9763;191218;143;0;0;0;0;.00nan;0;0
9763;-1;141;78;44;4;40;.909;3600000;0
9763;191574;141;0;0;0;0;.00nan;0;0
9764;187657;136;57;22;3;19;.864;3600000;0
9764;199701;138;0;0;0;0;.00nan;0;0
9764;-1;136;0;0;0;0;.00nan;0;0
9764;-1;138;25;41;8;33;.805;3600000;0
9765;203276;139;90;38;2;36;.947;3600000;0
9765;192889;139;0;0;0;0;.00nan;0;0
9765;189225;1340;0;0;0;0;.00nan;0;0
9765;191571;1340;75;37;3;34;.919;3588000;0
9766;183859;142;87;41;3;38;.927;3623000;0
9766;189944;144;83;34;2;32;.941;3643000;0
9766;196456;142;0;0;0;0;.00nan;0;0
9766;-1;144;0;0;0;0;.00nan;0;0
9767;203288;135;0;0;0;0;.00nan;0;0
9767;187578;135;78;38;3;35;.921;3548000;0
9767;194264;137;80;31;2;29;.935;3600000;0
9767;-1;137;0;0;0;0;.00nan;0;0
9768;200436;130;0;0;0;0;.00nan;0;0
9768;206789;131;78;35;2;33;.943;3600000;0
9768;197759;130;55;33;4;29;.879;3576000;0
9768;-1;131;0;0;0;0;.00nan;0;0
9769;189264;129;32;25;5;20;.800;3553000;0
9769;195169;129;0;0;0;0;.00nan;0;0
9769;196445;140;68;33;3;30;.909;3600000;0
9769;196812;140;0;0;0;0;.00nan;0;0
9770;199701;138;0;0;0;0;.00nan;0;0
9770;-1;141;0;0;0;0;.00nan;0;0
9770;191574;141;68;29;2;27;.931;3600000;0
9770;-1;138;42;33;5;28;.848;3600000;0
9771;187632;134;61;24;2;22;.917;3900000;0
9771;199437;134;0;0;0;0;.00nan;0;0
9771;189225;1340;0;0;0;0;.00nan;0;0
9771;191571;1340;81;37;2;35;.946;3858000;0
9772;187657;136;52;4;0;4;1.000;737000;0
9772;200436;130;74;27;2;25;.926;3600000;0
9772;-1;136;53;38;6;32;.842;2863000;0
9772;197759;130;0;0;0;0;.00nan;0;0
9773;203276;139;66;30;3;27;.900;3600000;0
9773;192889;139;0;0;0;0;.00nan;0;0
9773;-1;132;0;0;0;0;.00nan;0;0
9773;196809;132;41;28;5;23;.821;3537000;0
9774;203288;135;0;0;0;0;.00nan;0;0
9774;187578;135;62;24;2;22;.917;3600000;0
9774;196445;140;0;0;0;0;.00nan;0;0
9774;196812;140;70;35;3;32;.914;3600000;0
9775;189264;129;0;0;0;0;.00nan;0;0
9775;195169;129;79;30;2;28;.933;3600000;0
9775;206789;131;0;0;0;0;.00nan;0;0
9775;-1;131;54;29;4;25;.862;3600000;0
9776;196445;140;77;40;4;36;.900;3558000;0
9776;196812;140;0;0;0;0;.00nan;0;0
9776;-1;133;0;0;0;0;.00nan;0;0
9776;192499;133;61;26;3;23;.885;3600000;0
9777;187632;134;0;0;0;0;.00nan;0;0
9777;199437;134;37;23;4;19;.826;3600000;0
9777;189225;1340;35;18;4;14;.778;3209000;0
9777;191571;1340;19;8;4;4;.500;391000;0
9778;187657;136;69;31;3;28;.903;3600000;0
9778;200436;130;0;0;0;0;.00nan;0;0
9778;-1;136;0;0;0;0;.00nan;0;0
9778;197759;130;50;42;6;36;.857;3600000;0
9779;194264;137;64;25;2;23;.920;3600000;0
9779;-1;132;15;20;6;14;.700;2262000;0
9779;196809;132;19;11;4;7;.636;1338000;0
9779;-1;137;0;0;0;0;.00nan;0;0
9780;203288;135;81;28;1;27;.964;3569000;0
9780;187578;135;0;0;0;0;.00nan;0;0
9780;189264;129;100;31;0;31;1.000;3600000;0
9780;195169;129;0;0;0;0;.00nan;0;0
9781;199701;138;28;13;4;9;.692;940000;0
9781;189944;144;34;29;6;23;.793;3600000;0
9781;-1;138;30;33;6;27;.818;2660000;0
9781;-1;144;0;0;0;0;.00nan;0;0
9782;192895;143;25;20;5;15;.750;3574000;0
9782;183859;142;67;32;3;29;.906;3600000;0
9782;196456;142;0;0;0;0;.00nan;0;0
9782;191218;143;0;0;0;0;.00nan;0;0
9783;203276;139;0;0;0;0;.00nan;0;0
9783;192889;139;79;41;3;38;.927;3598000;0
9783;191215;128;59;17;2;15;.882;3600000;0
9783;-1;128;0;0;0;0;.00nan;0;0
9784;192895;143;0;0;0;0;.00nan;0;0
9784;191218;143;52;21;3;18;.857;3588000;0
9784;-1;141;0;0;0;0;.00nan;0;0
9784;191574;141;83;36;2;34;.944;3600000;0
9785;199701;138;50;40;6;34;.850;3578000;0
9785;183859;142;0;0;0;0;.00nan;0;0
9785;196456;142;46;24;4;20;.833;3600000;0
9785;-1;138;0;0;0;0;.00nan;0;0
9786;194264;137;35;19;4;15;.789;3600000;0
9786;191215;128;1;32;9;23;.719;2812000;0
9786;-1;137;0;0;0;0;.00nan;0;0
9786;-1;128;39;11;2;9;.818;788000;0
9787;206789;131;66;37;3;34;.919;3600000;0
9787;-1;133;49;26;4;22;.846;3548000;0
9787;192499;133;0;0;0;0;.00nan;0;0
9787;-1;131;0;0;0;0;.00nan;0;0
9788;192895;143;0;0;0;0;.00nan;0;0
9788;196445;140;62;5;0;5;1.000;999000;0
9788;196812;140;23;29;6;23;.793;2601000;0
9788;191218;143;24;35;7;28;.800;3584000;0
9789;183859;142;78;25;1;24;.960;3600000;0
9789;206789;131;52;40;5;35;.875;3600000;0
9789;196456;142;0;0;0;0;.00nan;0;0
9789;-1;131;0;0;0;0;.00nan;0;0
9790;-1;141;0;0;0;0;.00nan;0;0
9790;-1;133;0;0;0;0;.00nan;0;0
9790;191574;141;50;34;4;30;.882;3600000;0
9790;192499;133;78;30;1;29;.967;3600000;0
9791;194264;137;0;0;0;0;.00nan;0;0
9791;-1;132;0;0;0;0;.00nan;0;0
9791;196809;132;81;41;4;37;.902;3600000;0
9791;-1;137;67;20;1;19;.950;3600000;0
9792;203276;139;85;36;3;33;.917;3900000;0
9792;192889;139;0;0;0;0;.00nan;0;0
9792;206789;131;0;0;0;0;.00nan;0;0
9792;-1;131;61;26;3;23;.885;3900000;0
9793;200436;130;0;0;0;0;.00nan;0;0
9793;196445;140;0;0;0;0;.00nan;0;0
9793;196812;140;32;32;6;26;.813;3600000;0
9793;197759;130;70;36;4;32;.889;3600000;0
9794;203288;135;0;0;0;0;.00nan;0;0
9794;187578;135;54;37;5;32;.865;3576000;0
9794;187657;136;0;0;0;0;.00nan;0;0
9794;-1;136;36;20;4;16;.800;3600000;0
9795;189264;129;78;44;4;40;.909;3642000;0
9795;195169;129;0;0;0;0;.00nan;0;0
9795;189944;144;58;25;3;22;.880;3646000;0
9795;-1;144;0;0;0;0;.00nan;0;0
9796;203276;139;0;0;0;0;.00nan;0;0
9796;192889;139;62;38;4;34;.895;3571000;0
9796;200436;130;61;18;2;16;.889;3600000;0
9796;197759;130;0;0;0;0;.00nan;0;0
9797;183859;142;100;40;1;39;.975;3600000;0
9797;196445;140;88;44;4;40;.909;3600000;0
9797;196456;142;0;0;0;0;.00nan;0;0
9797;196812;140;0;0;0;0;.00nan;0;0
9798;189944;144;84;34;3;31;.912;3600000;0
9798;-1;133;93;19;0;19;1.000;3600000;0
9798;192499;133;0;0;0;0;.00nan;0;0
9798;-1;144;0;0;0;0;.00nan;0;0
9799;187632;134;48;22;4;18;.818;3600000;0
9799;199437;134;0;0;0;0;.00nan;0;0
9799;-1;141;0;0;0;0;.00nan;0;0
9799;191574;141;27;28;6;22;.786;3591000;0
9800;189264;129;0;0;0;0;.00nan;0;0
9800;195169;129;80;36;3;33;.917;3713000;0
9800;-1;132;59;34;4;30;.882;3713000;0
9800;196809;132;0;0;0;0;.00nan;0;0
9801;189225;1340;0;0;0;0;.00nan;0;0
9801;191215;128;61;26;2;24;.923;3900000;0
9801;191571;1340;75;29;2;27;.931;3900000;0
9801;-1;128;0;0;0;0;.00nan;0;0
9802;199701;138;0;0;0;0;.00nan;0;0
9802;-1;141;70;35;3;32;.914;3600000;0
9802;191574;141;0;0;0;0;.00nan;0;0
9802;-1;138;36;29;5;24;.828;3589000;0
9803;187657;136;62;27;3;24;.889;3600000;0
9803;-1;136;0;0;0;0;.00nan;0;0
9803;-1;133;42;32;5;27;.844;3537000;0
9803;192499;133;0;0;0;0;.00nan;0;0
9804;189225;1340;70;20;1;19;.950;3600000;0
9804;-1;132;0;0;0;0;.00nan;0;0
9804;196809;132;65;40;5;35;.875;3600000;0
9804;191571;1340;0;0;0;0;.00nan;0;0
9805;203288;135;0;0;0;0;.00nan;0;0
9805;187578;135;55;32;4;28;.875;3600000;0
9805;189944;144;75;30;3;27;.900;3600000;0
9805;-1;144;0;0;0;0;.00nan;0;0
9806;194264;137;89;36;2;34;.944;3600000;0
9806;191215;128;0;0;0;0;.00nan;0;0
9806;-1;137;0;0;0;0;.00nan;0;0
9806;-1;128;52;26;3;23;.885;3584000;0
9807;192895;143;0;0;0;0;.00nan;0;0
9807;206789;131;93;41;2;39;.951;3600000;0
9807;191218;143;43;20;4;16;.800;3591000;0
9807;-1;131;0;0;0;0;.00nan;0;0
9808;203276;139;49;32;5;27;.844;3600000;0
9808;192889;139;0;0;0;0;.00nan;0;0
9808;183859;142;56;20;2;18;.900;2500000;0
9808;196456;142;15;6;4;2;.333;1059000;0
9809;192895;143;73;34;3;31;.912;3600000;0
9809;200436;130;27;13;4;9;.692;1062000;0
9809;191218;143;0;0;0;0;.00nan;0;0
9809;197759;130;15;15;5;10;.667;2538000;0
9810;194264;137;0;0;0;0;.00nan;0;0
9810;189264;129;72;43;4;39;.907;3670000;0
9810;195169;129;0;0;0;0;.00nan;0;0
9810;-1;137;48;25;3;22;.880;3670000;0
9811;187632;134;27;19;5;14;.737;3598000;0
9811;199437;134;0;0;0;0;.00nan;0;0
9811;199701;138;79;34;3;31;.912;3600000;0
9811;-1;138;0;0;0;0;.00nan;0;0
9812;203288;135;78;44;4;40;.909;3704000;0
9812;187578;135;0;0;0;0;.00nan;0;0
9812;191215;128;50;33;5;28;.848;3704000;0
9812;-1;128;0;0;0;0;.00nan;0;0
9813;203276;139;79;32;2;30;.938;3600000;0
9813;192889;139;0;0;0;0;.00nan;0;0
9813;-1;141;0;0;0;0;.00nan;0;0
9813;191574;141;54;25;3;22;.880;3560000;0
9814;-1;132;67;37;5;32;.865;3600000;0
9814;196809;132;0;0;0;0;.00nan;0;0
9814;191215;128;65;24;2;22;.917;3600000;0
9814;-1;128;0;0;0;0;.00nan;0;0
9815;203288;135;0;0;0;0;.00nan;0;0
9815;187578;135;56;34;5;29;.853;3600000;0
9815;187657;136;0;0;0;0;.00nan;0;0
9815;-1;136;9;24;7;17;.708;3600000;0
9816;199701;138;0;0;0;0;.00nan;0;0
9816;-1;133;0;0;0;0;.00nan;0;0
9816;192499;133;23;25;6;19;.760;3588000;0
9816;-1;138;89;51;4;47;.922;3600000;0
9817;189944;144;76;35;3;32;.914;3600000;0
9817;-1;141;0;0;0;0;.00nan;0;0
9817;191574;141;63;38;4;34;.895;3579000;0
9817;-1;144;0;0;0;0;.00nan;0;0
9818;203276;139;95;55;2;53;.964;3600000;0
9818;192889;139;0;0;0;0;.00nan;0;0
9818;183859;142;72;18;1;17;.944;3600000;0
9818;196456;142;0;0;0;0;.00nan;0;0
9819;192895;143;72;23;1;22;.957;3600000;0
9819;196445;140;0;0;0;0;.00nan;0;0
9819;196812;140;85;38;2;36;.947;3562000;0
9819;191218;143;0;0;0;0;.00nan;0;0
9820;187632;134;43;22;4;18;.818;3600000;0
9820;199437;134;0;0;0;0;.00nan;0;0
9820;-1;133;32;32;6;26;.813;2517000;0
9820;192499;133;60;10;0;10;1.000;1010000;0
9821;189264;129;79;35;2;33;.943;3880000;0
9821;195169;129;0;0;0;0;.00nan;0;0
9821;191215;128;68;38;3;35;.921;3890000;0
9821;-1;128;0;0;0;0;.00nan;0;0
9822;199701;138;0;0;0;0;.00nan;0;0
9822;200436;130;51;28;4;24;.857;3600000;0
9822;197759;130;0;0;0;0;.00nan;0;0
9822;-1;138;78;35;3;32;.914;3600000;0
9823;189225;1340;0;0;0;0;.00nan;0;0
9823;-1;132;0;0;0;0;.00nan;0;0
9823;196809;132;66;50;5;45;.900;3600000;0
9823;191571;1340;62;28;2;26;.929;3600000;0
9824;187657;136;62;26;3;23;.885;3538000;0
9824;206789;131;84;32;1;31;.969;3600000;0
9824;-1;136;0;0;0;0;.00nan;0;0
9824;-1;131;0;0;0;0;.00nan;0;0
9825;203288;135;0;0;0;0;.00nan;0;0
9825;187578;135;80;42;4;38;.905;3600000;0
9825;194264;137;71;20;1;19;.950;3600000;0
9825;-1;137;0;0;0;0;.00nan;0;0
9826;187632;134;0;0;0;0;.00nan;0;0
9826;199437;134;48;22;3;19;.864;3900000;0
9826;-1;133;0;0;0;0;.00nan;0;0
9826;192499;133;80;45;3;42;.933;3900000;0
9827;203288;135;0;0;0;0;.00nan;0;0
9827;187578;135;74;49;6;43;.878;3600000;0
9827;200436;130;0;0;0;0;.00nan;0;0
9827;197759;130;60;29;3;26;.897;3600000;0
9828;189264;129;66;24;2;22;.917;3600000;0
9828;195169;129;0;0;0;0;.00nan;0;0
9828;-1;132;75;37;3;34;.919;3585000;0
9828;196809;132;0;0;0;0;.00nan;0;0
9829;199701;138;44;33;5;28;.848;3600000;0
9829;206789;131;0;0;0;0;.00nan;0;0
9829;-1;131;90;40;2;38;.950;3600000;0
9829;-1;138;0;0;0;0;.00nan;0;0
9830;187657;136;0;0;0;0;.00nan;0;0
9830;194264;137;0;0;0;0;.00nan;0;0
9830;-1;136;100;30;0;30;1.000;3600000;0
9830;-1;137;83;34;1;33;.971;3560000;0
9831;192895;143;0;0;0;0;.00nan;0;0
9831;189944;144;39;24;5;19;.792;3558000;0
9831;191218;143;73;38;3;35;.921;3600000;0
9831;-1;144;0;0;0;0;.00nan;0;0
9832;196445;140;68;30;3;27;.900;3900000;0
9832;196812;140;0;0;0;0;.00nan;0;0
9832;-1;141;95;47;3;44;.936;3900000;0
9832;191574;141;0;0;0;0;.00nan;0;0
9833;203276;139;0;0;0;0;.00nan;0;0
9833;192889;139;60;39;5;34;.872;3573000;0
9833;183859;142;0;0;0;0;.00nan;0;0
9833;196456;142;46;18;3;15;.833;3600000;0
9834;189225;1340;0;0;0;0;.00nan;0;0
9834;191215;128;0;0;0;0;.00nan;0;0
9834;191571;1340;72;30;3;27;.900;3600000;0
9834;-1;128;85;27;1;26;.963;3600000;0
9835;192847;144;52;25;4;21;.840;3755000;0
9835;-1;141;0;0;0;0;.00nan;0;0
9835;191574;141;49;34;5;29;.853;3755000;0
9835;-1;144;0;0;0;0;.00nan;0;0
9836;192895;143;0;0;0;0;.00nan;0;0
9836;183859;142;65;48;5;43;.896;3548000;0
9836;196456;142;0;0;0;0;.00nan;0;0
9836;191218;143;61;38;4;34;.895;3600000;0
9837;203276;139;63;36;5;31;.861;3544000;0
9837;192889;139;0;0;0;0;.00nan;0;0
9837;196445;140;0;0;0;0;.00nan;0;0
9837;196812;140;66;38;4;34;.895;3600000;0
9838;189264;129;49;39;6;33;.846;2881000;0
9838;195169;129;39;8;2;6;.750;719000;0
9838;-1;133;0;0;0;0;.00nan;0;0
9838;192499;133;68;26;2;24;.923;3600000;0
9839;198091;136;0;0;0;0;.00nan;0;0
9839;187657;136;63;26;3;23;.885;3560000;0
9839;194264;137;94;31;2;29;.935;3600000;0
9839;-1;137;0;0;0;0;.00nan;0;0
9840;200436;130;0;0;0;0;.00nan;0;0
9840;191215;128;71;20;1;19;.950;3600000;0
9840;197759;130;78;41;3;38;.927;3592000;0
9840;-1;128;0;0;0;0;.00nan;0;0
9841;203288;135;0;0;0;0;.00nan;0;0
9841;187578;135;51;32;5;27;.844;3600000;0
9841;187632;134;0;0;0;0;.00nan;0;0
9841;199437;134;75;23;1;22;.957;3600000;0
9842;199701;138;0;0;0;0;.00nan;0;0
9842;206789;131;65;34;3;31;.912;3900000;0
9842;-1;131;0;0;0;0;.00nan;0;0
9842;-1;138;66;37;3;34;.919;3900000;0
9843;196445;140;18;24;6;18;.750;3161000;0
9843;196812;140;40;2;1;1;.500;391000;0
9843;-1;141;44;41;6;35;.854;3600000;0
9843;191574;141;0;0;0;0;.00nan;0;0
9844;203288;135;83;23;2;21;.913;3900000;0
9844;187578;135;0;0;0;0;.00nan;0;0
9844;200436;130;96;45;2;43;.956;3900000;0
9844;197759;130;0;0;0;0;.00nan;0;0
9845;203276;139;21;34;7;27;.794;3600000;0
9845;192889;139;0;0;0;0;.00nan;0;0
9845;192895;143;66;35;4;31;.886;3600000;0
9845;191218;143;0;0;0;0;.00nan;0;0
9846;187632;134;0;0;0;0;.00nan;0;0
9846;199437;134;31;22;5;17;.773;3600000;0
9846;199701;138;40;10;2;8;.800;854000;0
9846;-1;138;43;36;6;30;.833;2746000;0
9847;198091;136;67;24;2;22;.917;3600000;0
9847;187657;136;0;0;0;0;.00nan;0;0
9847;-1;133;57;48;6;42;.875;3227000;0
9847;192499;133;55;5;0;5;1.000;373000;0
9848;-1;132;0;0;0;0;.00nan;0;0
9848;196809;132;59;38;4;34;.895;3875000;0
9848;191215;128;42;21;4;17;.810;3900000;0
9848;-1;128;0;0;0;0;.00nan;0;0
9849;189225;1340;0;0;0;0;.00nan;0;0
9849;206789;131;25;19;4;15;.789;3900000;0
9849;191571;1340;80;38;4;34;.895;3900000;0
9849;-1;131;0;0;0;0;.00nan;0;0
9850;194264;137;26;32;6;26;.813;3600000;0
9850;189264;129;0;0;0;0;.00nan;0;0
9850;195169;129;85;34;2;32;.941;3600000;0
9850;-1;137;0;0;0;0;.00nan;0;0
9851;192847;144;68;30;2;28;.933;3600000;0
9851;183859;142;61;36;4;32;.889;3597000;0
9851;196456;142;0;0;0;0;.00nan;0;0
9851;-1;144;0;0;0;0;.00nan;0;0
9852;203276;139;0;0;0;0;.00nan;0;0
9852;192889;139;90;32;1;31;.969;3600000;0
9852;192895;143;0;0;0;0;.00nan;0;0
9852;191218;143;54;24;3;21;.875;3546000;0
9853;183859;142;0;0;0;0;.00nan;0;0
9853;196456;142;66;33;4;29;.879;3571000;0
9853;-1;141;0;0;0;0;.00nan;0;0
9853;191574;141;59;30;3;27;.900;3600000;0
9854;198091;136;0;0;0;0;.00nan;0;0
9854;187657;136;55;40;5;35;.875;3592000;0
9854;-1;133;0;0;0;0;.00nan;0;0
9854;192499;133;67;31;3;28;.903;3600000;0
9855;187632;134;59;26;3;23;.885;3600000;0
9855;199437;134;0;0;0;0;.00nan;0;0
9855;199701;138;50;41;5;36;.878;3568000;0
9855;-1;138;0;0;0;0;.00nan;0;0
9856;-1;132;54;23;3;20;.870;3564000;0
9856;196809;132;0;0;0;0;.00nan;0;0
9856;191215;128;0;0;0;0;.00nan;0;0
9856;-1;128;81;21;1;20;.952;3600000;0
9857;203288;135;0;0;0;0;.00nan;0;0
9857;187578;135;67;18;2;16;.889;3900000;0
9857;206789;131;0;0;0;0;.00nan;0;0
9857;-1;131;76;29;2;27;.931;3900000;0
9858;194264;137;0;0;0;0;.00nan;0;0
9858;200436;130;0;0;0;0;.00nan;0;0
9858;-1;137;59;14;1;13;.929;3600000;0
9858;197759;130;71;36;4;32;.889;3600000;0
9859;189225;1340;0;0;0;0;.00nan;0;0
9859;189264;129;50;33;4;29;.879;3600000;0
9859;195169;129;0;0;0;0;.00nan;0;0
9859;191571;1340;41;38;6;32;.842;3538000;0
9860;192847;144;61;27;3;24;.889;3600000;0
9860;196445;140;0;0;0;0;.00nan;0;0
9860;196812;140;73;35;4;31;.886;3560000;0
9860;-1;144;0;0;0;0;.00nan;0;0
9861;203276;139;46;38;6;32;.842;2260000;0
9861;192889;139;73;12;0;12;1.000;1340000;0
9861;-1;141;0;0;0;0;.00nan;0;0
9861;191574;141;50;21;3;18;.857;3600000;0
9862;194264;137;44;28;4;24;.857;3332000;0
9862;200436;130;0;0;0;0;.00nan;0;0
9862;-1;137;39;1;1;0;.000;204000;0
9862;197759;130;74;36;3;33;.917;3600000;0
9863;189225;1340;0;0;0;0;.00nan;0;0
9863;-1;132;50;6;1;5;.833;316000;0
9863;196809;132;64;53;6;47;.887;3284000;0
9863;191571;1340;63;27;2;25;.926;3600000;0
9864;206789;131;77;45;3;42;.933;3595000;0
9864;-1;133;67;22;2;20;.909;3600000;0
9864;192499;133;0;0;0;0;.00nan;0;0
9864;-1;131;0;0;0;0;.00nan;0;0
9865;198091;136;0;0;0;0;.00nan;0;0
9865;187657;136;28;33;6;27;.818;3531000;0
9865;199701;138;0;0;0;0;.00nan;0;0
9865;-1;138;74;41;4;37;.902;3600000;0
9866;183859;142;87;35;2;33;.943;3600000;0
9866;196445;140;0;0;0;0;.00nan;0;0
9866;196456;142;0;0;0;0;.00nan;0;0
9866;196812;140;74;22;1;21;.955;3600000;0
9867;187632;134;42;26;4;22;.846;3600000;0
9867;199437;134;0;0;0;0;.00nan;0;0
9867;189264;129;15;21;6;15;.714;2885000;0
9867;195169;129;46;5;1;4;.800;715000;0
9868;203288;135;0;0;0;0;.00nan;0;0
9868;187578;135;65;45;5;40;.889;3600000;0
9868;192895;143;0;0;0;0;.00nan;0;0
9868;191218;143;60;23;2;21;.913;3600000;0
9869;183859;142;75;31;2;29;.935;3900000;0
9869;196445;140;62;23;2;21;.913;3900000;0
9869;196456;142;0;0;0;0;.00nan;0;0
9869;196812;140;0;0;0;0;.00nan;0;0
9870;192895;143;38;26;5;21;.808;3551000;0
9870;191218;143;0;0;0;0;.00nan;0;0
9870;-1;133;0;0;0;0;.00nan;0;0
9870;192499;133;57;35;4;31;.886;3600000;0
9871;189225;1340;0;0;0;0;.00nan;0;0
9871;191215;128;27;7;3;4;.571;592000;0
9871;191571;1340;69;40;4;36;.900;3600000;0
9871;-1;128;73;25;2;23;.920;3008000;0
9872;200436;130;0;0;0;0;.00nan;0;0
9872;-1;132;100;34;0;34;1.000;3600000;0
9872;196809;132;0;0;0;0;.00nan;0;0
9872;197759;130;72;33;2;31;.939;3529000;0
9873;203288;135;0;0;0;0;.00nan;0;0
9873;187578;135;52;25;3;22;.880;3600000;0
9873;-1;141;96;26;0;26;1.000;3600000;0
9873;191574;141;0;0;0;0;.00nan;0;0
9874;194264;137;0;0;0;0;.00nan;0;0
9874;206789;131;0;0;0;0;.00nan;0;0
9874;-1;137;39;20;4;16;.800;3600000;0
9874;-1;131;56;36;5;31;.861;3600000;0
9875;199701;138;0;0;0;0;.00nan;0;0
9875;189264;129;0;0;0;0;.00nan;0;0
9875;195169;129;47;32;5;27;.844;3522000;0
9875;-1;138;62;26;3;23;.885;3600000;0
9876;198091;136;55;19;3;16;.842;3600000;0
9876;187632;134;52;28;4;24;.857;3586000;0
9876;187657;136;0;0;0;0;.00nan;0;0
9876;199437;134;0;0;0;0;.00nan;0;0
9877;189225;1340;79;45;4;41;.911;3574000;0
9877;-1;132;82;27;2;25;.926;3600000;0
9877;196809;132;0;0;0;0;.00nan;0;0
9877;191571;1340;0;0;0;0;.00nan;0;0
9878;192895;143;0;0;0;0;.00nan;0;0
9878;194264;137;56;34;4;30;.882;3578000;0
9878;191218;143;53;22;3;19;.864;3600000;0
9878;-1;137;0;0;0;0;.00nan;0;0
9879;206789;131;96;42;3;39;.929;3900000;0
9879;-1;141;72;30;3;27;.900;3900000;0
9879;191574;141;0;0;0;0;.00nan;0;0
9879;-1;131;0;0;0;0;.00nan;0;0
9880;203276;139;0;0;0;0;.00nan;0;0
9880;192847;144;65;24;2;22;.917;3600000;0
9880;192889;139;59;40;5;35;.875;3600000;0
9880;-1;144;0;0;0;0;.00nan;0;0
9881;200436;130;100;36;1;35;.972;3600000;0
9881;191215;128;47;36;5;31;.861;3600000;0
9881;197759;130;0;0;0;0;.00nan;0;0
9881;-1;128;0;0;0;0;.00nan;0;0
9882;203276;139;93;36;1;35;.972;3600000;0
9882;192889;139;0;0;0;0;.00nan;0;0
9882;196445;140;0;0;0;0;.00nan;0;0
9882;196812;140;81;30;2;28;.933;3569000;0
9883;192847;144;89;43;2;41;.953;3900000;0
9883;183859;142;85;31;2;29;.935;3900000;0
9883;196456;142;0;0;0;0;.00nan;0;0
9883;-1;144;0;0;0;0;.00nan;0;0
9884;203288;135;0;0;0;0;.00nan;0;0
9884;187578;135;78;41;4;37;.902;3600000;0
9884;-1;133;72;23;1;22;.957;3600000;0
9884;192499;133;0;0;0;0;.00nan;0;0
9885;198091;136;0;0;0;0;.00nan;0;0
9885;187632;134;0;0;0;0;.00nan;0;0
9885;187657;136;63;35;4;31;.886;3600000;0
9885;199437;134;66;42;5;37;.881;3544000;0
9886;199701;138;0;0;0;0;.00nan;0;0
9886;189264;129;66;21;1;20;.952;3600000;0
9886;195169;129;0;0;0;0;.00nan;0;0
9886;-1;138;82;38;3;35;.921;3572000;0
9887;-1;132;0;0;0;0;.00nan;0;0
9887;196809;132;71;38;3;35;.921;3566000;0
9887;191215;128;89;24;1;23;.958;3600000;0
9887;-1;128;0;0;0;0;.00nan;0;0
9888;192847;144;5;23;7;16;.696;2736000;0
9888;-1;141;80;37;3;34;.919;3600000;0
9888;191574;141;0;0;0;0;.00nan;0;0
9888;-1;144;65;9;0;9;1.000;864000;0
9889;189225;1340;0;0;0;0;.00nan;0;0
9889;200436;130;54;9;1;8;.889;1702000;0
9889;191571;1340;71;31;3;28;.903;3600000;0
9889;197759;130;26;21;6;15;.714;1898000;0
9890;192895;143;76;35;3;32;.914;3600000;0
9890;191218;143;0;0;0;0;.00nan;0;0
9890;-1;133;0;0;0;0;.00nan;0;0
9890;192499;133;47;29;4;25;.862;3548000;0
9891;194264;137;36;36;5;31;.861;3544000;0
9891;196445;140;59;29;4;25;.862;3600000;0
9891;196812;140;0;0;0;0;.00nan;0;0
9891;-1;137;0;0;0;0;.00nan;0;0
9892;187657;136;0;0;0;0;.00nan;0;0
9892;183859;142;98;45;1;44;.978;3600000;0
9892;196456;142;0;0;0;0;.00nan;0;0
9892;-1;136;61;25;3;22;.880;3519000;0
9893;194264;137;0;0;0;0;.00nan;0;0
9893;-1;141;40;29;5;24;.828;3600000;0
9893;-1;137;83;27;2;25;.926;3600000;0
9893;191574;141;0;0;0;0;.00nan;0;0
9894;187657;136;0;0;0;0;.00nan;0;0
9894;196445;140;42;6;2;4;.667;625000;0
9894;196812;140;27;34;6;28;.824;2975000;0
9894;-1;136;86;30;2;28;.933;3600000;0
9895;200436;130;0;0;0;0;.00nan;0;0
9895;-1;132;67;43;5;38;.884;3552000;0
9895;196809;132;0;0;0;0;.00nan;0;0
9895;197759;130;62;27;3;24;.889;3600000;0
9896;189225;1340;0;0;0;0;.00nan;0;0
9896;206789;131;49;29;4;25;.862;3600000;0
9896;191571;1340;55;25;3;22;.880;3600000;0
9896;-1;131;0;0;0;0;.00nan;0;0
9897;203288;135;44;10;2;8;.800;1062000;0
9897;187578;135;10;27;7;20;.741;2538000;0
9897;189264;129;76;30;2;28;.933;3600000;0
9897;195169;129;0;0;0;0;.00nan;0;0
9898;199701;138;0;0;0;0;.00nan;0;0
9898;191215;128;61;19;2;17;.895;3600000;0
9898;-1;138;51;45;6;39;.867;3600000;0
9898;-1;128;0;0;0;0;.00nan;0;0
9899;199701;138;36;31;6;25;.806;3600000;0
9899;189225;1340;43;19;3;16;.842;3600000;0
9899;191571;1340;0;0;0;0;.00nan;0;0
9899;-1;138;0;0;0;0;.00nan;0;0
9900;187632;134;67;24;2;22;.917;3600000;0
9900;199437;134;0;0;0;0;.00nan;0;0
9900;191215;128;90;51;3;48;.941;3600000;0
9900;-1;128;0;0;0;0;.00nan;0;0
9901;206789;131;0;0;0;0;.00nan;0;0
9901;-1;132;0;0;0;0;.00nan;0;0
9901;196809;132;72;29;2;27;.931;3900000;0
9901;-1;131;75;32;2;30;.938;3900000;0
9902;192847;144;0;0;0;0;.00nan;0;0
9902;187657;136;0;0;0;0;.00nan;0;0
9902;189944;144;51;31;5;26;.839;3562000;0
9902;-1;136;81;41;3;38;.927;3600000;0
9903;203276;139;0;0;0;0;.00nan;0;0
9903;192889;139;52;36;4;32;.889;3543000;0
9903;-1;133;63;31;3;28;.903;3600000;0
9903;192499;133;0;0;0;0;.00nan;0;0
9904;194264;137;69;40;4;36;.900;3600000;0
9904;183859;142;100;39;1;38;.974;3600000;0
9904;196456;142;0;0;0;0;.00nan;0;0
9904;-1;137;0;0;0;0;.00nan;0;0
9905;192895;143;58;17;3;14;.824;3600000;0
9905;191218;143;0;0;0;0;.00nan;0;0
9905;-1;141;86;49;4;45;.918;3587000;0
9905;191574;141;0;0;0;0;.00nan;0;0
9906;196445;140;0;0;0;0;.00nan;0;0
9906;196812;140;70;36;4;32;.889;3600000;0
9906;-1;133;0;0;0;0;.00nan;0;0
9906;192499;133;32;32;6;26;.813;3513000;0
9907;189264;129;71;28;2;26;.929;3600000;0
9907;195169;129;0;0;0;0;.00nan;0;0
9907;206789;131;39;41;6;35;.854;3275000;0
9907;-1;131;49;1;0;1;1.000;325000;0
9908;203276;139;58;30;3;27;.900;3600000;0
9908;192847;144;0;0;0;0;.00nan;0;0
9908;192889;139;0;0;0;0;.00nan;0;0
9908;189944;144;68;19;1;18;.947;3600000;0
9909;187632;134;0;0;0;0;.00nan;0;0
9909;199437;134;38;33;6;27;.818;3600000;0
9909;191215;128;59;30;3;27;.900;3600000;0
9909;-1;128;0;0;0;0;.00nan;0;0
9910;203288;135;0;0;0;0;.00nan;0;0
9910;187578;135;65;34;3;31;.912;3889000;0
9910;200436;130;0;0;0;0;.00nan;0;0
9910;197759;130;52;29;4;25;.862;3889000;0
9911;183859;142;72;30;3;27;.900;3600000;0
9911;196445;140;0;0;0;0;.00nan;0;0
9911;196456;142;0;0;0;0;.00nan;0;0
9911;196812;140;58;37;5;32;.865;3598000;0
9912;192847;144;0;0;0;0;.00nan;0;0
9912;189225;1340;0;0;0;0;.00nan;0;0
9912;189944;144;96;39;1;38;.974;3600000;0
9912;191571;1340;98;45;2;43;.956;3600000;0
9913;192895;143;54;20;2;18;.900;3600000;0
9913;199701;138;0;0;0;0;.00nan;0;0
9913;191218;143;0;0;0;0;.00nan;0;0
9913;-1;138;61;43;5;38;.884;3600000;0
9914;203276;139;0;0;0;0;.00nan;0;0
9914;192889;139;68;42;4;38;.905;3798000;0
9914;-1;141;53;29;5;24;.828;3798000;0
9914;191574;141;0;0;0;0;.00nan;0;0
9915;203288;135;0;0;0;0;.00nan;0;0
9915;187578;135;100;30;0;30;1.000;3600000;0
9915;183859;142;45;17;3;14;.824;3600000;0
9915;196456;142;0;0;0;0;.00nan;0;0
9916;187632;134;69;32;3;29;.906;3600000;0
9916;199437;134;0;0;0;0;.00nan;0;0
9916;191215;128;25;12;4;8;.667;1010000;0
9916;-1;128;52;12;1;11;.917;2526000;0
9917;192847;144;62;28;4;24;.857;3582000;0
9917;194264;137;61;26;3;23;.885;3600000;0
9917;189944;144;0;0;0;0;.00nan;0;0
9917;-1;137;0;0;0;0;.00nan;0;0
9918;189264;129;49;45;6;39;.867;3600000;0
9918;200436;130;55;11;1;10;.909;1697000;0
9918;195169;129;0;0;0;0;.00nan;0;0
9918;197759;130;32;16;4;12;.750;1903000;0
9919;203288;135;0;0;0;0;.00nan;0;0
9919;187578;135;100;45;3;42;.933;3900000;0
9919;196445;140;68;34;3;31;.912;3900000;0
9919;196812;140;0;0;0;0;.00nan;0;0
9920;187657;136;0;0;0;0;.00nan;0;0
9920;206789;131;81;44;3;41;.932;3600000;0
9920;-1;136;99;26;0;26;1.000;3600000;0
9920;-1;131;0;0;0;0;.00nan;0;0
9921;187632;134;0;0;0;0;.00nan;0;0
9921;199437;134;70;32;3;29;.906;3900000;0
9921;-1;132;66;31;3;28;.903;3900000;0
9921;196809;132;0;0;0;0;.00nan;0;0
9922;189225;1340;0;0;0;0;.00nan;0;0
9922;-1;133;0;0;0;0;.00nan;0;0
9922;191571;1340;55;23;3;20;.870;3553000;0
9922;192499;133;75;32;2;30;.938;3600000;0
9923;192847;144;42;18;3;15;.833;2555000;0
9923;187657;136;0;0;0;0;.00nan;0;0
9923;189944;144;33;17;4;13;.765;1045000;0
9923;-1;136;68;21;2;19;.905;3600000;0
9924;200436;130;82;35;2;33;.943;3600000;0
9924;191215;128;69;32;3;29;.906;3563000;0
9924;197759;130;0;0;0;0;.00nan;0;0
9924;-1;128;0;0;0;0;.00nan;0;0
9925;187632;134;46;18;3;15;.833;3600000;0
9925;199437;134;0;0;0;0;.00nan;0;0
9925;-1;132;0;0;0;0;.00nan;0;0
9925;196809;132;66;40;4;36;.900;3600000;0
9926;194264;137;0;0;0;0;.00nan;0;0
9926;189264;129;48;31;4;27;.871;3653000;0
9926;195169;129;0;0;0;0;.00nan;0;0
9926;-1;137;49;24;3;21;.875;3607000;0
9927;203288;135;0;0;0;0;.00nan;0;0
9927;187578;135;83;31;2;29;.935;3676000;0
9927;-1;141;78;33;3;30;.909;3700000;0
9927;191574;141;0;0;0;0;.00nan;0;0
9928;192895;143;58;33;3;30;.909;3556000;0
9928;183859;142;78;32;2;30;.938;3600000;0
9928;196456;142;0;0;0;0;.00nan;0;0
9928;191218;143;0;0;0;0;.00nan;0;0
9929;203276;139;67;35;3;32;.914;3600000;0
9929;192889;139;0;0;0;0;.00nan;0;0
9929;199701;138;67;11;0;11;1.000;594000;0
9929;-1;138;34;31;6;25;.806;3006000;0
9930;203276;139;59;8;0;8;1.000;1097000;0
9930;192889;139;21;37;8;29;.784;2503000;0
9930;192895;143;0;0;0;0;.00nan;0;0
9930;191218;143;83;16;0;16;1.000;3600000;0
9931;199701;138;59;6;0;6;1.000;676000;0
9931;196445;140;0;0;0;0;.00nan;0;0
9931;196812;140;68;38;3;35;.921;3600000;0
9931;-1;138;26;37;7;30;.811;2924000;0
9932;206789;131;62;35;4;31;.886;3600000;0
9932;-1;133;62;35;3;32;.914;3600000;0
9932;192499;133;0;0;0;0;.00nan;0;0
9932;-1;131;0;0;0;0;.00nan;0;0
9933;189225;1340;0;0;0;0;.00nan;0;0
9933;200436;130;0;0;0;0;.00nan;0;0
9933;191571;1340;65;30;3;27;.900;3600000;0
9933;197759;130;62;33;4;29;.879;3562000;0
9934;189264;129;51;7;1;6;.857;986000;0
9934;195169;129;34;30;6;24;.800;2564000;0
9934;191215;128;44;35;5;30;.857;3600000;0
9934;-1;128;0;0;0;0;.00nan;0;0
9935;189264;129;59;29;3;26;.897;3672000;0
9935;195169;129;0;0;0;0;.00nan;0;0
9935;-1;141;55;32;4;28;.875;3672000;0
9935;191574;141;0;0;0;0;.00nan;0;0
9936;192847;144;0;0;0;0;.00nan;0;0
9936;192895;143;0;0;0;0;.00nan;0;0
9936;189944;144;79;46;4;42;.913;3900000;0
9936;191218;143;49;27;4;23;.852;3900000;0
9937;203276;139;41;32;6;26;.813;2382000;0
9937;192889;139;49;7;1;6;.857;1218000;0
9937;196445;140;0;0;0;0;.00nan;0;0
9937;196812;140;74;27;3;24;.889;3600000;0
9938;187632;134;0;0;0;0;.00nan;0;0
9938;199437;134;55;18;2;16;.889;3600000;0
9938;199701;138;63;27;3;24;.889;2435000;0
9938;-1;138;25;18;5;13;.722;1165000;0
9939;200436;130;100;27;0;27;1.000;3600000;0
9939;206789;131;27;34;6;28;.824;3600000;0
9939;197759;130;0;0;0;0;.00nan;0;0
9939;-1;131;0;0;0;0;.00nan;0;0
9940;187657;136;0;0;0;0;.00nan;0;0
9940;-1;132;97;46;2;44;.957;3600000;0
9940;196809;132;0;0;0;0;.00nan;0;0
9940;-1;136;52;26;3;23;.885;3576000;0
9941;203288;135;0;0;0;0;.00nan;0;0
9941;187578;135;100;41;1;40;.976;3900000;0
9941;183859;142;81;21;1;20;.952;3900000;0
9941;196456;142;0;0;0;0;.00nan;0;0
9942;194264;137;81;33;2;31;.939;3600000;0
9942;189225;1340;50;1;0;1;1.000;285000;0
9942;-1;137;0;0;0;0;.00nan;0;0
9942;191571;1340;39;43;7;36;.837;3315000;0
9943;187632;134;67;29;4;25;.862;3900000;0
9943;199437;134;0;0;0;0;.00nan;0;0
9943;-1;133;75;54;4;50;.926;3900000;0
9943;192499;133;0;0;0;0;.00nan;0;0
9944;203288;135;0;0;0;0;.00nan;0;0
9944;187578;135;36;33;6;27;.818;3600000;0
9944;189225;1340;60;23;2;21;.913;3600000;0
9944;191571;1340;0;0;0;0;.00nan;0;0
9945;194264;137;0;0;0;0;.00nan;0;0
9945;183859;142;100;45;3;42;.933;3600000;0
9945;196456;142;0;0;0;0;.00nan;0;0
9945;-1;137;59;30;4;26;.867;3556000;0
9946;189264;129;0;0;0;0;.00nan;0;0
9946;195169;129;83;41;4;37;.902;3900000;0
9946;196445;140;40;27;4;23;.852;3900000;0
9946;196812;140;0;0;0;0;.00nan;0;0
9947;187657;136;13;17;6;11;.647;2172000;0
9947;191215;128;0;0;0;0;.00nan;0;0
9947;-1;136;69;17;0;17;1.000;1728000;0
9947;-1;128;47;40;6;34;.850;3900000;0
9948;196445;140;0;0;0;0;.00nan;0;0
9948;196812;140;55;31;4;27;.871;3600000;0
9948;-1;141;63;20;2;18;.900;3600000;0
9948;191574;141;0;0;0;0;.00nan;0;0
9949;203276;139;0;0;0;0;.00nan;0;0
9949;192889;139;65;39;5;34;.872;3600000;0
9949;192895;143;73;19;1;18;.947;3600000;0
9949;191218;143;0;0;0;0;.00nan;0;0
9950;183859;142;86;38;2;36;.947;3600000;0
9950;200436;130;21;3;3;0;.000;386000;0
9950;196456;142;0;0;0;0;.00nan;0;0
9950;197759;130;45;20;3;17;.850;3214000;0
9951;187657;136;0;0;0;0;.00nan;0;0
9951;-1;132;0;0;0;0;.00nan;0;0
9951;196809;132;45;26;4;22;.846;3557000;0
9951;-1;136;69;37;3;34;.919;3600000;0
9952;192847;144;0;0;0;0;.00nan;0;0
9952;189264;129;23;31;7;24;.774;2858000;0
9952;195169;129;56;10;1;9;.900;742000;0
9952;189944;144;94;34;1;33;.971;3600000;0
9953;199701;138;0;0;0;0;.00nan;0;0
9953;-1;133;0;0;0;0;.00nan;0;0
9953;192499;133;30;30;7;23;.767;3600000;0
9953;-1;138;94;34;1;33;.971;3600000;0
9954;203288;135;0;0;0;0;.00nan;0;0
9954;187578;135;84;35;2;33;.943;3578000;0
9954;191215;128;69;20;1;19;.950;3600000;0
9954;-1;128;0;0;0;0;.00nan;0;0
9955;200436;130;0;0;0;0;.00nan;0;0
9955;-1;133;63;39;4;35;.897;3558000;0
9955;192499;133;0;0;0;0;.00nan;0;0
9955;197759;130;62;22;2;20;.909;3600000;0
9956;203288;135;0;0;0;0;.00nan;0;0
9956;187578;135;47;31;5;26;.839;3576000;0
9956;-1;132;81;45;4;41;.911;3600000;0
9956;196809;132;0;0;0;0;.00nan;0;0
9957;189225;1340;0;0;0;0;.00nan;0;0
9957;191215;128;48;38;6;32;.842;2911000;0
9957;191571;1340;63;22;2;20;.909;3600000;0
9957;-1;128;49;7;1;6;.857;689000;0
9958;187632;134;58;20;2;18;.900;3600000;0
9958;199437;134;0;0;0;0;.00nan;0;0
9958;206789;131;66;32;3;29;.906;3600000;0
9958;-1;131;0;0;0;0;.00nan;0;0
9959;203276;139;51;43;6;37;.860;3600000;0
9959;192889;139;0;0;0;0;.00nan;0;0
9959;194264;137;53;14;2;12;.857;3600000;0
9959;-1;137;0;0;0;0;.00nan;0;0
9960;199701;138;0;0;0;0;.00nan;0;0
9960;200436;130;33;23;5;18;.783;3543000;0
9960;197759;130;0;0;0;0;.00nan;0;0
9960;-1;138;72;39;4;35;.897;3600000;0
9961;183859;142;51;25;4;21;.840;3514000;0
9961;196456;142;0;0;0;0;.00nan;0;0
9961;-1;141;78;31;2;29;.935;3600000;0
9961;191574;141;0;0;0;0;.00nan;0;0
9962;192895;143;62;27;3;24;.889;3855000;0
9962;196445;140;0;0;0;0;.00nan;0;0
9962;196812;140;92;38;2;36;.947;3859000;0
9962;191218;143;0;0;0;0;.00nan;0;0
9963;187632;134;0;0;0;0;.00nan;0;0
9963;199437;134;46;18;2;16;.889;3600000;0
9963;-1;133;31;10;3;7;.700;682000;0
9963;192499;133;31;30;6;24;.800;2918000;0
9964;203276;139;0;0;0;0;.00nan;0;0
9964;192889;139;82;35;2;33;.943;3600000;0
9964;206789;131;0;0;0;0;.00nan;0;0
9964;-1;131;62;33;4;29;.879;3588000;0
9965;194264;137;0;0;0;0;.00nan;0;0
9965;191215;128;0;0;0;0;.00nan;0;0
9965;-1;137;75;32;3;29;.906;3600000;0
9965;-1;128;64;30;2;28;.933;3600000;0
9966;189264;129;0;0;0;0;.00nan;0;0
9966;195169;129;81;27;1;26;.963;3600000;0
9966;-1;132;81;43;4;39;.907;3600000;0
9966;196809;132;0;0;0;0;.00nan;0;0
9967;187632;134;35;17;4;13;.765;3542000;0
9967;199437;134;0;0;0;0;.00nan;0;0
9967;-1;133;68;25;2;23;.920;3600000;0
9967;192499;133;0;0;0;0;.00nan;0;0
9968;200436;130;0;0;0;0;.00nan;0;0
9968;-1;132;63;12;0;12;1.000;1440000;0
9968;196809;132;26;22;6;16;.727;2160000;0
9968;197759;130;73;25;2;23;.920;3600000;0
9969;187657;136;0;0;0;0;.00nan;0;0
9969;189225;1340;0;0;0;0;.00nan;0;0
9969;-1;136;60;32;4;28;.875;3574000;0
9969;191571;1340;72;30;3;27;.900;3600000;0
9970;203276;139;53;37;5;32;.865;3612000;0
9970;203288;135;43;25;4;21;.840;3597000;0
9970;187578;135;0;0;0;0;.00nan;0;0
9970;192889;139;0;0;0;0;.00nan;0;0
9971;192847;144;0;0;0;0;.00nan;0;0
9971;189944;144;55;24;3;21;.875;3600000;0
9971;-1;141;62;32;3;29;.906;3113000;0
9971;191574;141;30;9;3;6;.667;487000;0
9972;192895;143;0;0;0;0;.00nan;0;0
9972;196445;140;75;33;3;30;.909;3600000;0
9972;196812;140;0;0;0;0;.00nan;0;0
9972;191218;143;46;25;4;21;.840;3600000;0
9973;187657;136;69;36;3;33;.917;3570000;0
9973;189225;1340;77;30;2;28;.933;3600000;0
9973;-1;136;0;0;0;0;.00nan;0;0
9973;191571;1340;0;0;0;0;.00nan;0;0
9974;189264;129;0;0;0;0;.00nan;0;0
9974;195169;129;47;31;5;26;.839;3900000;0
9974;191215;128;29;30;5;25;.833;3900000;0
9974;-1;128;0;0;0;0;.00nan;0;0
9975;192847;144;100;44;2;42;.955;3600000;0
9975;183859;142;55;37;5;32;.865;3600000;0
9975;189944;144;0;0;0;0;.00nan;0;0
9975;196456;142;0;0;0;0;.00nan;0;0
9976;203288;135;0;0;0;0;.00nan;0;0
9976;187578;135;80;31;3;28;.903;3600000;0
9976;199701;138;0;0;0;0;.00nan;0;0
9976;-1;138;41;31;6;25;.806;3600000;0
9977;194264;137;88;26;1;25;.962;3600000;0
9977;206789;131;44;32;5;27;.844;3600000;0
9977;-1;137;0;0;0;0;.00nan;0;0
9977;-1;131;0;0;0;0;.00nan;0;0
9978;200436;130;79;25;1;24;.960;3600000;0
9978;-1;141;0;0;0;0;.00nan;0;0
9978;191574;141;55;38;5;33;.868;3600000;0
9978;197759;130;0;0;0;0;.00nan;0;0
9979;192847;144;0;0;0;0;.00nan;0;0
9979;187632;134;0;0;0;0;.00nan;0;0
9979;199437;134;58;29;3;26;.897;3900000;0
9979;189944;144;76;35;3;32;.914;3900000;0
9980;192895;143;68;42;3;39;.929;3542000;0
9980;187657;136;0;0;0;0;.00nan;0;0
9980;191218;143;0;0;0;0;.00nan;0;0
9980;-1;136;74;30;2;28;.933;3600000;0
9981;203276;139;59;27;4;23;.852;3600000;0
9981;192889;139;0;0;0;0;.00nan;0;0
9981;183859;142;39;30;6;24;.800;3251000;0
9981;196456;142;53;4;0;4;1.000;312000;0
9982;191215;128;86;19;0;19;1.000;3600000;0
9982;-1;141;87;39;1;38;.974;3574000;0
9982;191574;141;0;0;0;0;.00nan;0;0
9982;-1;128;0;0;0;0;.00nan;0;0
9983;194264;137;52;25;3;22;.880;3600000;0
9983;189225;1340;0;0;0;0;.00nan;0;0
9983;-1;137;0;0;0;0;.00nan;0;0
9983;191571;1340;86;59;5;54;.915;3600000;0
9984;183859;142;41;2;1;1;.500;300000;0
9984;196445;140;0;0;0;0;.00nan;0;0
9984;196456;142;26;34;6;28;.824;3300000;0
9984;196812;140;64;26;2;24;.923;3600000;0
9985;192895;143;56;23;3;20;.870;3597000;0
9985;187632;134;68;27;2;25;.926;3600000;0
9985;199437;134;0;0;0;0;.00nan;0;0
9985;191218;143;0;0;0;0;.00nan;0;0
9986;187657;136;0;0;0;0;.00nan;0;0
9986;200436;130;49;9;1;8;.889;1050000;0
9986;-1;136;84;30;1;29;.967;3600000;0
9986;197759;130;32;32;6;26;.813;2550000;0
9987;-1;132;79;32;3;29;.906;3600000;0
9987;196809;132;0;0;0;0;.00nan;0;0
9987;-1;141;0;0;0;0;.00nan;0;0
9987;191574;141;100;40;1;39;.975;3600000;0
9988;203288;135;0;0;0;0;.00nan;0;0
9988;187578;135;89;33;2;31;.939;3559000;0
9988;206789;131;100;29;0;29;1.000;3600000;0
9988;-1;131;0;0;0;0;.00nan;0;0
9989;189264;129;78;35;2;33;.943;3600000;0
9989;195169;129;0;0;0;0;.00nan;0;0
9989;-1;133;0;0;0;0;.00nan;0;0
9989;192499;133;48;22;3;19;.864;3565000;0
9990;192847;144;0;0;0;0;.00nan;0;0
9990;199701;138;0;0;0;0;.00nan;0;0
9990;189944;144;62;19;2;17;.895;3666000;0
9990;-1;138;86;47;3;44;.936;3666000;0
9991;192895;143;0;0;0;0;.00nan;0;0
9991;199701;138;35;24;5;19;.792;2091000;0
9991;191218;143;59;30;3;27;.900;3600000;0
9991;-1;138;36;13;3;10;.769;1509000;0
9992;187657;136;87;30;2;28;.933;3600000;0
9992;200436;130;55;33;5;28;.848;3600000;0
9992;-1;136;0;0;0;0;.00nan;0;0
9992;197759;130;0;0;0;0;.00nan;0;0
9993;194264;137;32;25;5;20;.800;3600000;0
9993;-1;132;0;0;0;0;.00nan;0;0
9993;196809;132;90;35;1;34;.971;3600000;0
9993;-1;137;0;0;0;0;.00nan;0;0
9994;189225;1340;0;0;0;0;.00nan;0;0
9994;189264;129;0;0;0;0;.00nan;0;0
9994;195169;129;35;19;4;15;.789;3559000;0
9994;191571;1340;71;33;3;30;.909;3600000;0
9995;192847;144;48;30;5;25;.833;3579000;0
9995;189944;144;0;0;0;0;.00nan;0;0
9995;206789;131;41;22;4;18;.818;3600000;0
9995;-1;131;0;0;0;0;.00nan;0;0
9996;203276;139;54;33;5;28;.848;3600000;0
9996;192889;139;0;0;0;0;.00nan;0;0
9996;196445;140;96;36;2;34;.944;3600000;0
9996;196812;140;0;0;0;0;.00nan;0;0
9997;203288;135;0;0;0;0;.00nan;0;0
9997;187578;135;70;31;3;28;.903;3568000;0
9997;-1;133;0;0;0;0;.00nan;0;0
9997;192499;133;77;31;2;29;.935;3600000;0
9998;194264;137;0;0;0;0;.00nan;0;0
9998;191215;128;70;43;4;39;.907;3600000;0
9998;-1;137;43;38;5;33;.868;3552000;0
9998;-1;128;0;0;0;0;.00nan;0;0
9999;199701;138;0;0;0;0;.00nan;0;0
9999;-1;133;27;19;5;14;.737;3546000;0
9999;192499;133;0;0;0;0;.00nan;0;0
9999;-1;138;99;51;4;47;.922;3600000;0
10000;192847;144;0;0;0;0;.00nan;0;0
10000;192895;143;57;31;4;27;.871;3573000;0
10000;189944;144;77;33;3;30;.909;3600000;0
10000;191218;143;0;0;0;0;.00nan;0;0
10001;183859;142;41;19;3;16;.842;3532000;0
10001;189225;1340;0;0;0;0;.00nan;0;0
10001;196456;142;0;0;0;0;.00nan;0;0
10001;191571;1340;93;41;1;40;.976;3600000;0
10002;206789;131;70;21;1;20;.952;3600000;0
10002;-1;132;0;0;0;0;.00nan;0;0
10002;196809;132;47;35;5;30;.857;3600000;0
10002;-1;131;0;0;0;0;.00nan;0;0
10003;187657;136;0;0;0;0;.00nan;0;0
10003;189264;129;55;4;0;4;1.000;408000;0
10003;195169;129;31;31;6;25;.806;3192000;0
10003;-1;136;75;33;3;30;.909;3600000;0
10004;203288;135;0;0;0;0;.00nan;0;0
10004;187578;135;69;36;3;33;.917;3600000;0
10004;199701;138;0;0;0;0;.00nan;0;0
10004;-1;138;47;24;4;20;.833;3549000;0
10005;192847;144;0;0;0;0;.00nan;0;0
10005;200436;130;0;0;0;0;.00nan;0;0
10005;189944;144;88;39;2;37;.949;3600000;0
10005;197759;130;54;26;3;23;.885;3584000;0
10006;189225;1340;65;26;3;23;.885;3630000;0
10006;-1;141;72;42;4;38;.905;3630000;0
10006;191571;1340;0;0;0;0;.00nan;0;0
10006;191574;141;0;0;0;0;.00nan;0;0
10007;203276;139;27;12;4;8;.667;752000;0
10007;192889;139;40;26;5;21;.808;2848000;0
10007;192895;143;0;0;0;0;.00nan;0;0
10007;191218;143;69;16;1;15;.938;3600000;0
10008;203288;135;37;33;6;27;.818;3600000;0
10008;187578;135;0;0;0;0;.00nan;0;0
10008;187632;134;99;35;1;34;.971;3600000;0
10008;199437;134;0;0;0;0;.00nan;0;0
10009;191215;128;0;0;0;0;.00nan;0;0
10009;-1;133;57;44;6;38;.864;3600000;0
10009;192499;133;0;0;0;0;.00nan;0;0
10009;-1;128;85;36;3;33;.917;3600000;0
10010;194264;137;52;30;4;26;.867;3600000;0
10010;-1;132;42;34;5;29;.853;3600000;0
10010;196809;132;0;0;0;0;.00nan;0;0
10010;-1;137;0;0;0;0;.00nan;0;0
10011;189264;129;41;26;5;21;.808;3539000;0
10011;195169;129;0;0;0;0;.00nan;0;0
10011;206789;131;0;0;0;0;.00nan;0;0
10011;-1;131;78;43;4;39;.907;3600000;0
10012;187657;136;0;0;0;0;.00nan;0;0
10012;199701;138;38;18;3;15;.833;1774000;0
10012;-1;136;32;31;6;25;.806;3600000;0
10012;-1;138;23;26;6;20;.769;1826000;0
10013;189225;1340;0;0;0;0;.00nan;0;0
10013;196445;140;0;0;0;0;.00nan;0;0
10013;196812;140;47;33;5;28;.848;3600000;0
10013;191571;1340;83;29;1;28;.966;3600000;0
10014;183859;142;57;30;4;26;.867;3878000;0
10014;200436;130;70;32;3;29;.906;3878000;0
10014;196456;142;0;0;0;0;.00nan;0;0
10014;197759;130;0;0;0;0;.00nan;0;0
10015;191215;128;47;33;5;28;.848;3559000;0
10015;-1;133;0;0;0;0;.00nan;0;0
10015;192499;133;32;18;4;14;.778;3600000;0
10015;-1;128;0;0;0;0;.00nan;0;0
10016;200436;130;0;0;0;0;.00nan;0;0
10016;-1;141;64;38;4;34;.895;3559000;0
10016;191574;141;0;0;0;0;.00nan;0;0
10016;197759;130;62;22;2;20;.909;3600000;0
10017;203276;139;0;0;0;0;.00nan;0;0
10017;192847;144;0;0;0;0;.00nan;0;0
10017;192889;139;91;46;3;43;.935;3600000;0
10017;189944;144;87;37;2;35;.946;3600000;0
10018;187657;136;79;30;2;28;.933;3600000;0
10018;189264;129;0;0;0;0;.00nan;0;0
10018;195169;129;63;39;4;35;.897;3589000;0
10018;-1;136;0;0;0;0;.00nan;0;0
10019;-1;132;67;33;4;29;.879;3863000;0
10019;196809;132;0;0;0;0;.00nan;0;0
10019;-1;133;57;32;5;27;.844;3863000;0
10019;192499;133;0;0;0;0;.00nan;0;0
10020;203288;135;0;0;0;0;.00nan;0;0
10020;187578;135;37;28;5;23;.821;3600000;0
10020;206789;131;100;31;0;31;1.000;3600000;0
10020;-1;131;0;0;0;0;.00nan;0;0
10021;187632;134;37;38;7;31;.816;2831000;0
10021;199437;134;46;6;1;5;.833;769000;0
10021;194264;137;58;15;1;14;.933;3600000;0
10021;-1;137;0;0;0;0;.00nan;0;0
10022;203276;139;74;47;5;42;.894;3600000;0
10022;192847;144;11;24;7;17;.708;3554000;0
10022;192889;139;0;0;0;0;.00nan;0;0
10022;189944;144;0;0;0;0;.00nan;0;0
10023;196445;140;77;31;2;29;.935;3600000;0
10023;196812;140;0;0;0;0;.00nan;0;0
10023;-1;141;0;0;0;0;.00nan;0;0
10023;191574;141;53;36;5;31;.861;3600000;0
10024;192895;143;90;32;1;31;.969;3600000;0
10024;183859;142;84;34;2;32;.941;3543000;0
10024;196456;142;0;0;0;0;.00nan;0;0
10024;191218;143;0;0;0;0;.00nan;0;0
10025;192847;144;0;0;0;0;.00nan;0;0
10025;189944;144;87;31;1;30;.968;3600000;0
10025;-1;141;58;33;4;29;.879;3600000;0
10025;191574;141;0;0;0;0;.00nan;0;0
10026;187632;134;0;0;0;0;.00nan;0;0
10026;199437;134;82;35;2;33;.943;3593000;0
10026;194264;137;93;37;1;36;.973;3600000;0
10026;-1;137;0;0;0;0;.00nan;0;0
10027;189225;1340;0;0;0;0;.00nan;0;0
10027;200436;130;0;0;0;0;.00nan;0;0
10027;191571;1340;78;44;4;40;.909;3900000;0
10027;197759;130;61;33;4;29;.879;3900000;0
10028;-1;132;50;20;3;17;.850;3221000;0
10028;196809;132;25;6;3;3;.500;379000;0
10028;191215;128;70;9;0;9;1.000;3600000;0
10028;-1;128;0;0;0;0;.00nan;0;0
10029;203276;139;0;0;0;0;.00nan;0;0
10029;192889;139;74;22;1;21;.955;3600000;0
10029;189264;129;47;25;3;22;.880;3550000;0
10029;195169;129;0;0;0;0;.00nan;0;0
10030;187657;136;0;0;0;0;.00nan;0;0
10030;199701;138;0;0;0;0;.00nan;0;0
10030;-1;136;69;29;3;26;.897;3521000;0
10030;-1;138;93;33;1;32;.970;3600000;0
10031;183859;142;8;19;7;12;.632;1994000;0
10031;196456;142;53;9;1;8;.889;1606000;0
10031;-1;133;0;0;0;0;.00nan;0;0
10031;192499;133;82;33;3;30;.909;3600000;0
10032;203276;139;37;29;5;24;.828;3600000;0
10032;192889;139;0;0;0;0;.00nan;0;0
10032;200436;130;71;17;1;16;.941;3600000;0
10032;197759;130;0;0;0;0;.00nan;0;0
10033;203288;135;0;0;0;0;.00nan;0;0
10033;187578;135;79;22;1;21;.955;3900000;0
10033;206789;131;94;41;1;40;.976;3900000;0
10033;-1;131;0;0;0;0;.00nan;0;0
10034;199701;138;10;30;7;23;.767;2959000;0
10034;194264;137;0;0;0;0;.00nan;0;0
10034;-1;137;69;28;2;26;.929;3600000;0
10034;-1;138;49;7;1;6;.857;641000;0
10035;187632;134;54;4;0;4;1.000;698000;0
10035;187657;136;0;0;0;0;.00nan;0;0
10035;199437;134;30;30;6;24;.800;2902000;0
10035;-1;136;60;20;2;18;.900;3600000;0
10036;189225;1340;0;0;0;0;.00nan;0;0
10036;191215;128;49;31;4;27;.871;3600000;0
10036;191571;1340;100;31;0;31;1.000;3600000;0
10036;-1;128;0;0;0;0;.00nan;0;0
10037;183859;142;65;25;3;22;.880;3900000;0
10037;206789;131;0;0;0;0;.00nan;0;0
10037;196456;142;0;0;0;0;.00nan;0;0
10037;-1;131;77;40;3;37;.925;3900000;0
10038;189264;129;0;0;0;0;.00nan;0;0
10038;195169;129;58;27;3;24;.889;3900000;0
10038;-1;132;69;35;3;32;.914;3900000;0
10038;196809;132;0;0;0;0;.00nan;0;0
10039;192847;144;0;0;0;0;.00nan;0;0
10039;189944;144;63;27;3;24;.889;3600000;0
10039;196445;140;65;44;5;39;.886;3548000;0
10039;196812;140;0;0;0;0;.00nan;0;0
10040;192895;143;0;0;0;0;.00nan;0;0
10040;191218;143;63;23;3;20;.870;3600000;0
10040;-1;141;47;42;7;35;.833;3600000;0
10040;191574;141;0;0;0;0;.00nan;0;0
10041;192895;143;62;24;2;22;.917;3600000;0
10041;191218;143;0;0;0;0;.00nan;0;0
10041;-1;141;0;0;0;0;.00nan;0;0
10041;191574;141;47;34;5;29;.853;3600000;0
10042;192847;144;86;27;1;26;.963;3600000;0
10042;189944;144;0;0;0;0;.00nan;0;0
10042;196445;140;0;0;0;0;.00nan;0;0
10042;196812;140;58;36;4;32;.889;3600000;0
10043;203276;139;0;0;0;0;.00nan;0;0
10043;192889;139;79;46;4;42;.913;3545000;0
10043;-1;133;0;0;0;0;.00nan;0;0
10043;192499;133;50;19;3;16;.842;3600000;0
10044;189225;1340;0;0;0;0;.00nan;0;0
10044;-1;132;0;0;0;0;.00nan;0;0
10044;196809;132;69;39;4;35;.897;3900000;0
10044;191571;1340;72;35;4;31;.886;3900000;0
10045;183859;142;0;0;0;0;.00nan;0;0
10045;189264;129;86;13;0;13;1.000;3600000;0
10045;195169;129;0;0;0;0;.00nan;0;0
10045;196456;142;51;35;5;30;.857;3600000;0
10046;187632;134;62;43;5;38;.884;3600000;0
10046;187657;136;0;0;0;0;.00nan;0;0
10046;199437;134;0;0;0;0;.00nan;0;0
10046;-1;136;53;26;4;22;.846;3600000;0
10047;203288;135;0;0;0;0;.00nan;0;0
10047;187578;135;100;31;0;31;1.000;3600000;0
10047;194264;137;51;26;3;23;.885;3600000;0
10047;-1;137;0;0;0;0;.00nan;0;0
10048;206789;131;71;40;3;37;.925;3554000;0
10048;191215;128;0;0;0;0;.00nan;0;0
10048;-1;131;0;0;0;0;.00nan;0;0
10048;-1;128;56;20;2;18;.900;3600000;0
10049;203276;139;53;41;6;35;.854;3533000;0
10049;192889;139;0;0;0;0;.00nan;0;0
10049;192895;143;0;0;0;0;.00nan;0;0
10049;191218;143;48;21;4;17;.810;3600000;0
10050;199701;138;0;0;0;0;.00nan;0;0
10050;200436;130;50;8;1;7;.875;1371000;0
10050;197759;130;27;20;5;15;.750;2229000;0
10050;-1;138;76;40;3;37;.925;3600000;0
10051;189225;1340;53;4;0;4;1.000;563000;0
10051;196445;140;0;0;0;0;.00nan;0;0
10051;196812;140;79;38;3;35;.921;3600000;0
10051;191571;1340;38;35;6;29;.829;3037000;0
10052;194264;137;65;27;3;24;.889;3600000;0
10052;-1;133;77;39;4;35;.897;3562000;0
10052;-1;137;0;0;0;0;.00nan;0;0
10052;192499;133;0;0;0;0;.00nan;0;0
10053;192847;144;0;0;0;0;.00nan;0;0
10053;187632;134;73;34;3;31;.912;3595000;0
10053;199437;134;0;0;0;0;.00nan;0;0
10053;189944;144;88;29;2;27;.931;3600000;0
10054;203276;139;0;0;0;0;.00nan;0;0
10054;192889;139;93;37;2;35;.946;3692000;0
10054;-1;141;66;26;3;23;.885;3692000;0
10054;191574;141;0;0;0;0;.00nan;0;0
10055;203288;135;0;0;0;0;.00nan;0;0
10055;187578;135;50;34;5;29;.853;3600000;0
10055;-1;132;20;9;4;5;.556;1037000;0
10055;196809;132;34;26;5;21;.808;2563000;0
10056;187632;134;0;0;0;0;.00nan;0;0
10056;199437;134;69;38;4;34;.895;3600000;0
10056;183859;142;77;29;3;26;.897;3600000;0
10056;196456;142;0;0;0;0;.00nan;0;0
10057;199701;138;62;9;0;9;1.000;1264000;0
10057;191215;128;63;22;2;20;.909;3600000;0
10057;-1;138;25;37;7;30;.811;2336000;0
10057;-1;128;0;0;0;0;.00nan;0;0
10058;200436;130;67;37;4;33;.892;3654000;0
10058;-1;132;65;33;3;30;.909;3654000;0
10058;196809;132;0;0;0;0;.00nan;0;0
10058;197759;130;0;0;0;0;.00nan;0;0
10059;203288;135;98;34;2;32;.941;3900000;0
10059;187578;135;0;0;0;0;.00nan;0;0
10059;189264;129;73;28;2;26;.929;3900000;0
10059;195169;129;0;0;0;0;.00nan;0;0
10060;206789;131;53;28;4;24;.857;3569000;0
10060;196445;140;0;0;0;0;.00nan;0;0
10060;196812;140;61;31;3;28;.903;3600000;0
10060;-1;131;0;0;0;0;.00nan;0;0
10061;194264;137;0;0;0;0;.00nan;0;0
10061;189225;1340;0;0;0;0;.00nan;0;0
10061;-1;137;34;19;4;15;.789;3600000;0
10061;191571;1340;65;47;6;41;.872;3582000;0
10062;187632;134;37;18;4;14;.778;3900000;0
10062;199437;134;0;0;0;0;.00nan;0;0
10062;-1;141;0;0;0;0;.00nan;0;0
10062;191574;141;60;43;4;39;.907;3900000;0
10063;187657;136;63;20;1;19;.950;3600000;0
10063;-1;136;0;0;0;0;.00nan;0;0
10063;-1;133;0;0;0;0;.00nan;0;0
10063;192499;133;48;39;6;33;.846;3600000;0
10064;189225;1340;24;26;6;20;.769;2358000;0
10064;200436;130;0;0;0;0;.00nan;0;0
10064;191571;1340;58;16;2;14;.875;1242000;0
10064;197759;130;83;38;3;35;.921;3600000;0
10065;194264;137;49;26;3;23;.885;3588000;0
10065;196445;140;81;36;2;34;.944;3600000;0
10065;196812;140;0;0;0;0;.00nan;0;0
10065;-1;137;0;0;0;0;.00nan;0;0
10066;192847;144;0;0;0;0;.00nan;0;0
10066;192895;143;29;19;4;15;.789;2232000;0
10066;189944;144;88;33;2;31;.939;3600000;0
10066;191218;143;47;11;2;9;.818;1368000;0
10067;203276;139;37;34;6;28;.824;3240000;0
10067;192889;139;50;1;0;1;1.000;360000;0
10067;183859;142;0;0;0;0;.00nan;0;0
10067;196456;142;98;25;0;25;1.000;3600000;0
10068;199701;138;0;0;0;0;.00nan;0;0
10068;191215;128;0;0;0;0;.00nan;0;0
10068;-1;138;90;45;3;42;.933;3560000;0
10068;-1;128;54;19;2;17;.895;3600000;0
10069;192895;143;0;0;0;0;.00nan;0;0
10069;191218;143;67;17;1;16;.941;3600000;0
10069;-1;141;85;47;4;43;.915;3600000;0
10069;191574;141;0;0;0;0;.00nan;0;0
10070;203288;135;0;0;0;0;.00nan;0;0
10070;187578;135;93;51;2;49;.961;3600000;0
10070;187657;136;0;0;0;0;.00nan;0;0
10070;-1;136;66;30;3;27;.900;3544000;0
10071;199701;138;94;33;1;32;.970;3600000;0
10071;-1;132;0;0;0;0;.00nan;0;0
10071;196809;132;70;35;3;32;.914;3565000;0
10071;-1;138;0;0;0;0;.00nan;0;0
10072;189264;129;0;0;0;0;.00nan;0;0
10072;195169;129;39;31;5;26;.839;3580000;0
10072;206789;131;55;21;3;18;.857;3600000;0
10072;-1;131;0;0;0;0;.00nan;0;0
10073;192847;144;0;0;0;0;.00nan;0;0
10073;183859;142;0;0;0;0;.00nan;0;0
10073;189944;144;63;39;5;34;.872;3580000;0
10073;196456;142;63;35;3;32;.914;3600000;0
10074;192895;143;0;0;0;0;.00nan;0;0
10074;196445;140;0;0;0;0;.00nan;0;0
10074;196812;140;75;31;2;29;.935;3565000;0
10074;191218;143;80;28;1;27;.964;3600000;0
10075;194264;137;28;31;6;25;.806;3202000;0
10075;-1;133;76;32;2;30;.938;3600000;0
10075;-1;137;54;4;0;4;1.000;398000;0
10075;192499;133;0;0;0;0;.00nan;0;0
10076;187632;134;70;18;1;17;.944;3695000;0
10076;199437;134;0;0;0;0;.00nan;0;0
10076;206789;131;92;45;2;43;.956;3695000;0
10076;-1;131;0;0;0;0;.00nan;0;0
10077;-1;132;80;41;4;37;.902;3600000;0
10077;196809;132;0;0;0;0;.00nan;0;0
10077;191215;128;54;17;2;15;.882;3600000;0
10077;-1;128;0;0;0;0;.00nan;0;0
10078;189225;1340;0;0;0;0;.00nan;0;0
10078;189264;129;0;0;0;0;.00nan;0;0
10078;195169;129;76;37;3;34;.919;3600000;0
10078;191571;1340;48;33;5;28;.848;3525000;0
10079;192895;143;91;37;2;35;.946;3600000;0
10079;183859;142;89;42;4;38;.905;3564000;0
10079;196456;142;0;0;0;0;.00nan;0;0
10079;191218;143;0;0;0;0;.00nan;0;0
10080;203276;139;0;0;0;0;.00nan;0;0
10080;192889;139;55;29;4;25;.862;3600000;0
10080;-1;141;36;14;3;11;.786;1942000;0
10080;191574;141;34;19;4;15;.789;1630000;0
10081;200436;130;55;12;1;11;.917;1798000;0
10081;-1;133;0;0;0;0;.00nan;0;0
10081;192499;133;66;36;4;32;.889;3600000;0
10081;197759;130;11;19;6;13;.684;1802000;0
10082;187657;136;0;0;0;0;.00nan;0;0
10082;189225;1340;0;0;0;0;.00nan;0;0
10082;-1;136;94;40;3;37;.925;3600000;0
10082;191571;1340;36;28;6;22;.786;3600000;0
10083;189264;129;40;27;5;22;.815;3600000;0
10083;195169;129;0;0;0;0;.00nan;0;0
10083;-1;132;0;0;0;0;.00nan;0;0
10083;196809;132;85;32;2;30;.938;3600000;0
10084;194264;137;0;0;0;0;.00nan;0;0
10084;206789;131;0;0;0;0;.00nan;0;0
10084;-1;137;78;24;1;23;.958;3567000;0
10084;-1;131;100;28;0;28;1.000;3600000;0
10085;200436;130;0;0;0;0;.00nan;0;0
10085;-1;133;62;41;5;36;.878;3600000;0
10085;192499;133;0;0;0;0;.00nan;0;0
10085;197759;130;70;43;6;37;.860;3600000;0
10086;187632;134;79;26;1;25;.962;3600000;0
10086;199437;134;0;0;0;0;.00nan;0;0
10086;199701;138;0;0;0;0;.00nan;0;0
10086;-1;138;58;29;3;26;.897;3554000;0
10087;187657;136;62;20;2;18;.900;3600000;0
10087;189225;1340;60;43;5;38;.884;3600000;0
10087;-1;136;0;0;0;0;.00nan;0;0
10087;191571;1340;0;0;0;0;.00nan;0;0
10088;203288;135;0;0;0;0;.00nan;0;0
10088;187578;135;63;31;3;28;.903;3536000;0
10088;-1;132;92;35;1;34;.971;3600000;0
10088;196809;132;0;0;0;0;.00nan;0;0
10089;192895;143;0;0;0;0;.00nan;0;0
10089;183859;142;0;0;0;0;.00nan;0;0
10089;196456;142;70;32;4;28;.875;3600000;0
10089;191218;143;83;24;1;23;.958;3600000;0
10090;192847;144;0;0;0;0;.00nan;0;0
10090;189944;144;87;40;3;37;.925;3592000;0
10090;196445;140;0;0;0;0;.00nan;0;0
10090;196812;140;80;27;1;26;.963;3600000;0
10091;189264;129;0;0;0;0;.00nan;0;0
10091;195169;129;78;44;3;41;.932;3600000;0
10091;191215;128;62;20;2;18;.900;3600000;0
10091;-1;128;0;0;0;0;.00nan;0;0
10092;196445;140;56;29;4;25;.862;3663000;0
10092;196812;140;0;0;0;0;.00nan;0;0
10092;-1;141;95;43;3;40;.930;3663000;0
10092;191574;141;0;0;0;0;.00nan;0;0
10093;203276;139;49;2;0;2;1.000;340000;0
10093;192847;144;79;21;1;20;.952;3600000;0
10093;192889;139;39;32;6;26;.813;3260000;0
10093;189944;144;0;0;0;0;.00nan;0;0
10094;187632;134;0;0;0;0;.00nan;0;0
10094;199437;134;76;25;1;24;.960;3600000;0
10094;199701;138;47;36;5;31;.861;3600000;0
10094;-1;138;0;0;0;0;.00nan;0;0
10095;203288;135;81;34;3;31;.912;3600000;0
10095;187578;135;0;0;0;0;.00nan;0;0
10095;191215;128;0;0;0;0;.00nan;0;0
10095;-1;128;88;18;0;18;1.000;3600000;0
10096;194264;137;59;29;3;26;.897;3900000;0
10096;206789;131;0;0;0;0;.00nan;0;0
10096;-1;137;0;0;0;0;.00nan;0;0
10096;-1;131;91;44;3;41;.932;3900000;0
10097;187632;134;83;31;2;29;.935;3600000;0
10097;199437;134;0;0;0;0;.00nan;0;0
10097;-1;133;0;0;0;0;.00nan;0;0
10097;192499;133;42;32;5;27;.844;3600000;0
10098;187657;136;0;0;0;0;.00nan;0;0
10098;199701;138;82;49;4;45;.918;3600000;0
10098;-1;136;67;28;3;25;.893;3600000;0
10098;-1;138;0;0;0;0;.00nan;0;0
10099;206789;131;61;24;3;21;.875;3547000;0
10099;-1;132;0;0;0;0;.00nan;0;0
10099;196809;132;99;49;2;47;.959;3600000;0
10099;-1;131;0;0;0;0;.00nan;0;0
10100;194264;137;59;41;5;36;.878;3600000;0
10100;191215;128;0;0;0;0;.00nan;0;0
10100;-1;137;0;0;0;0;.00nan;0;0
10100;-1;128;45;18;3;15;.833;3600000;0
10101;192847;144;0;0;0;0;.00nan;0;0
10101;192895;143;88;34;1;33;.971;3600000;0
10101;189944;144;71;31;3;28;.903;3518000;0
10101;191218;143;0;0;0;0;.00nan;0;0
10102;203276;139;89;47;2;45;.957;3900000;0
10102;192889;139;0;0;0;0;.00nan;0;0
10102;196445;140;0;0;0;0;.00nan;0;0
10102;196812;140;68;23;2;21;.913;3900000;0
10103;183859;142;53;30;4;26;.867;3546000;0
10103;196456;142;0;0;0;0;.00nan;0;0
10103;-1;141;0;0;0;0;.00nan;0;0
10103;191574;141;89;45;3;42;.933;3600000;0
10104;203288;135;0;0;0;0;.00nan;0;0
10104;187578;135;72;41;3;38;.927;3900000;0
10104;191215;128;66;34;3;31;.912;3900000;0
10104;-1;128;0;0;0;0;.00nan;0;0
10105;194264;137;0;0;0;0;.00nan;0;0
10105;189264;129;89;30;2;28;.933;3900000;0
10105;195169;129;0;0;0;0;.00nan;0;0
10105;-1;137;96;53;2;51;.962;3900000;0
10106;203288;135;0;0;0;0;.00nan;0;0
10106;187578;135;55;26;3;23;.885;3600000;0
10106;-1;132;59;7;0;7;1.000;509000;0
10106;196809;132;38;32;7;25;.781;3091000;0
10107;187657;136;0;0;0;0;.00nan;0;0
10107;189264;129;0;0;0;0;.00nan;0;0
10107;195169;129;58;26;3;23;.885;3828000;0
10107;-1;136;79;29;2;27;.931;3828000;0
10108;199701;138;0;0;0;0;.00nan;0;0
10108;-1;133;0;0;0;0;.00nan;0;0
10108;192499;133;62;25;2;23;.920;3578000;0
10108;-1;138;100;42;0;42;1.000;3600000;0
10109;189225;1340;0;0;0;0;.00nan;0;0
10109;206789;131;0;0;0;0;.00nan;0;0
10109;191571;1340;60;22;2;20;.909;3600000;0
10109;-1;131;50;39;6;33;.846;3600000;0
10110;192895;143;30;15;4;11;.733;3600000;0
10110;191218;143;0;0;0;0;.00nan;0;0
10110;-1;141;45;42;6;36;.857;2876000;0
10110;191574;141;62;7;0;7;1.000;694000;0
10111;187632;134;80;40;4;36;.900;3600000;0
10111;199437;134;0;0;0;0;.00nan;0;0
10111;-1;133;16;8;4;4;.500;1032000;0
10111;192499;133;57;21;3;18;.857;2568000;0
10112;200436;130;24;12;4;8;.667;828000;0
10112;191215;128;41;35;6;29;.829;3900000;0
10112;197759;130;67;24;2;22;.917;3072000;0
10112;-1;128;0;0;0;0;.00nan;0;0
10113;189225;1340;77;31;2;29;.935;3600000;0
10113;-1;132;37;31;6;25;.806;2625000;0
10113;196809;132;48;7;1;6;.857;975000;0
10113;191571;1340;0;0;0;0;.00nan;0;0
10114;187657;136;56;27;4;23;.852;3747000;0
10114;206789;131;70;34;3;31;.912;3748000;0
10114;-1;136;0;0;0;0;.00nan;0;0
10114;-1;131;0;0;0;0;.00nan;0;0
10115;203276;139;0;0;0;0;.00nan;0;0
10115;192847;144;0;0;0;0;.00nan;0;0
10115;192889;139;41;37;6;31;.838;3600000;0
10115;189944;144;95;35;1;34;.971;3600000;0
10116;183859;142;59;20;2;18;.900;3600000;0
10116;196445;140;0;0;0;0;.00nan;0;0
10116;196456;142;0;0;0;0;.00nan;0;0
10116;196812;140;71;38;4;34;.895;3558000;0
10117;183859;142;0;0;0;0;.00nan;0;0
10117;196445;140;49;32;5;27;.844;3719000;0
10117;196456;142;66;36;4;32;.889;3719000;0
10117;196812;140;0;0;0;0;.00nan;0;0
10118;203288;135;0;0;0;0;.00nan;0;0
10118;187578;135;35;28;5;23;.821;3600000;0
10118;200436;130;71;25;2;23;.920;3600000;0
10118;197759;130;0;0;0;0;.00nan;0;0
10119;187632;134;49;1;0;1;1.000;454000;0
10119;199437;134;25;30;6;24;.800;3146000;0
10119;189264;129;87;31;1;30;.968;3600000;0
10119;195169;129;0;0;0;0;.00nan;0;0
10120;192847;144;78;32;2;30;.938;3569000;0
10120;192895;143;0;0;0;0;.00nan;0;0
10120;189944;144;0;0;0;0;.00nan;0;0
10120;191218;143;69;25;1;24;.960;3600000;0
10121;199701;138;0;0;0;0;.00nan;0;0
10121;194264;137;41;30;5;25;.833;3600000;0
10121;-1;137;0;0;0;0;.00nan;0;0
10121;-1;138;65;57;7;50;.877;3600000;0
10122;189264;129;0;0;0;0;.00nan;0;0
10122;195169;129;83;33;2;31;.939;3600000;0
10122;206789;131;66;35;3;32;.914;3574000;0
10122;-1;131;0;0;0;0;.00nan;0;0
10123;196445;140;0;0;0;0;.00nan;0;0
10123;196812;140;60;27;3;24;.889;3600000;0
10123;-1;141;0;0;0;0;.00nan;0;0
10123;191574;141;41;38;5;33;.868;3600000;0
10124;192847;144;0;0;0;0;.00nan;0;0
10124;183859;142;60;42;5;37;.881;3600000;0
10124;189944;144;67;25;2;23;.920;3600000;0
10124;196456;142;0;0;0;0;.00nan;0;0
10125;189225;1340;0;0;0;0;.00nan;0;0
10125;-1;133;61;39;4;35;.897;3900000;0
10125;191571;1340;68;37;4;33;.892;3900000;0
10125;192499;133;0;0;0;0;.00nan;0;0
10126;-1;132;21;22;6;16;.727;1849000;0
10126;196809;132;44;20;3;17;.850;1751000;0
10126;191215;128;46;22;4;18;.818;3600000;0
10126;-1;128;0;0;0;0;.00nan;0;0
10127;203288;135;0;0;0;0;.00nan;0;0
10127;187578;135;32;41;8;33;.805;3600000;0
10127;194264;137;67;31;3;28;.903;3600000;0
10127;-1;137;0;0;0;0;.00nan;0;0
10128;203288;135;0;0;0;0;.00nan;0;0
10128;187578;135;95;28;2;26;.929;3900000;0
10128;189225;1340;70;28;2;26;.929;3900000;0
10128;191571;1340;0;0;0;0;.00nan;0;0
10129;192847;144;0;0;0;0;.00nan;0;0
10129;189944;144;58;29;3;26;.897;3564000;0
10129;-1;141;84;36;2;34;.944;3600000;0
10129;191574;141;0;0;0;0;.00nan;0;0
10130;203276;139;79;26;2;24;.923;3600000;0
10130;192889;139;0;0;0;0;.00nan;0;0
10130;183859;142;65;31;3;28;.903;3561000;0
10130;196456;142;0;0;0;0;.00nan;0;0
10131;192895;143;0;0;0;0;.00nan;0;0
10131;196445;140;0;0;0;0;.00nan;0;0
10131;196812;140;43;32;5;27;.844;3600000;0
10131;191218;143;47;27;4;23;.852;3600000;0
10132;187632;134;47;32;5;27;.844;3600000;0
10132;199437;134;0;0;0;0;.00nan;0;0
10132;189264;129;79;29;2;27;.931;3600000;0
10132;195169;129;0;0;0;0;.00nan;0;0
10133;187657;136;0;0;0;0;.00nan;0;0
10133;-1;136;77;32;3;29;.906;3600000;0
10133;-1;133;71;12;0;12;1.000;1133000;0
10133;192499;133;31;26;5;21;.808;2392000;0
10134;194264;137;0;0;0;0;.00nan;0;0
10134;191215;128;63;28;3;25;.893;3892000;0
10134;-1;137;88;41;2;39;.951;3892000;0
10134;-1;128;0;0;0;0;.00nan;0;0
10135;200436;130;0;0;0;0;.00nan;0;0
10135;-1;132;0;0;0;0;.00nan;0;0
10135;196809;132;73;36;3;33;.917;3598000;0
10135;197759;130;57;17;2;15;.882;3600000;0
10136;199701;138;0;0;0;0;.00nan;0;0
10136;206789;131;0;0;0;0;.00nan;0;0
10136;-1;131;73;41;4;37;.902;3900000;0
10136;-1;138;57;36;4;32;.889;3900000;0
10137;192847;144;31;29;6;23;.793;3043000;0
10137;189944;144;52;9;1;8;.889;557000;0
10137;-1;141;0;0;0;0;.00nan;0;0
10137;191574;141;44;35;5;30;.857;3600000;0
10138;192895;143;52;19;2;17;.895;3551000;0
10138;196445;140;100;36;0;36;1.000;3600000;0
10138;196812;140;0;0;0;0;.00nan;0;0
10138;191218;143;0;0;0;0;.00nan;0;0
10139;203276;139;50;15;2;13;.867;1052000;0
10139;192889;139;17;29;7;22;.759;2548000;0
10139;183859;142;0;0;0;0;.00nan;0;0
10139;196456;142;65;32;3;29;.906;3600000;0
10140;187657;136;31;7;3;4;.571;462000;0
10140;-1;136;91;39;3;36;.923;3138000;0
10140;-1;133;1;24;9;15;.625;2166000;0
10140;192499;133;58;13;1;12;.923;1434000;0
10141;199701;138;69;32;3;29;.906;3600000;0
10141;189264;129;0;0;0;0;.00nan;0;0
10141;195169;129;55;34;4;30;.882;3558000;0
10141;-1;138;0;0;0;0;.00nan;0;0
10142;187632;134;0;0;0;0;.00nan;0;0
10142;199437;134;47;22;3;19;.864;3600000;0
10142;206789;131;28;14;4;10;.714;979000;0
10142;-1;131;57;23;3;20;.870;2621000;0
10143;200436;130;67;42;5;37;.881;3752000;0
10143;191215;128;0;0;0;0;.00nan;0;0
10143;197759;130;0;0;0;0;.00nan;0;0
10143;-1;128;54;33;4;29;.879;3752000;0
10144;194264;137;18;28;7;21;.750;2656000;0
10144;-1;132;60;27;3;24;.889;3600000;0
10144;196809;132;0;0;0;0;.00nan;0;0
10144;-1;137;55;3;0;3;1.000;944000;0
10145;203288;135;0;0;0;0;.00nan;0;0
10145;187578;135;57;18;2;16;.889;3600000;0
10145;189225;1340;0;0;0;0;.00nan;0;0
10145;191571;1340;39;36;6;30;.833;3600000;0
10147;203276;139;61;26;3;23;.885;3600000;0
10147;203288;135;57;32;4;28;.875;3591000;0
10147;192889;139;0;0;0;0;.00nan;0;0
10147;194197;135;0;0;0;0;.00nan;0;0
10149;206789;131;71;30;3;27;.900;3600000;0
10149;196445;140;0;0;0;0;.00nan;0;0
10149;196812;140;60;43;5;38;.884;3545000;0
10149;-1;131;0;0;0;0;.00nan;0;0
10151;187632;134;88;43;3;40;.930;3557000;0
10151;199437;134;0;0;0;0;.00nan;0;0
10151;183859;142;69;29;2;27;.931;3600000;0
10151;196456;142;0;0;0;0;.00nan;0;0
10153;189225;1340;0;0;0;0;.00nan;0;0
10153;189944;144;73;37;3;34;.919;3547000;0
10153;191571;1340;75;25;1;24;.960;3600000;0
10153;-1;144;0;0;0;0;.00nan;0;0
10155;194264;137;53;28;3;25;.893;3600000;0
10155;-1;141;0;0;0;0;.00nan;0;0
10155;-1;137;0;0;0;0;.00nan;0;0
10155;191574;141;39;31;5;26;.839;3578000;0
10157;-1;133;99;34;1;33;.971;3600000;0
10157;192499;133;0;0;0;0;.00nan;0;0
10157;-1;128;34;23;4;19;.826;3600000;0
10157;-1;128;0;0;0;0;.00nan;0;0
10159;192895;143;84;32;1;31;.969;3600000;0
10159;199701;138;0;0;0;0;.00nan;0;0
10159;191218;143;0;0;0;0;.00nan;0;0
10159;-1;138;67;28;2;26;.929;3600000;0
10161;187657;136;0;0;0;0;.00nan;0;0
10161;200436;130;0;0;0;0;.00nan;0;0
10161;-1;136;40;32;6;26;.813;3600000;0
10161;197759;130;100;41;1;40;.976;3600000;0
10163;189264;129;0;0;0;0;.00nan;0;0
10163;195169;129;56;26;3;23;.885;3626000;0
10163;-1;132;0;0;0;0;.00nan;0;0
10163;196809;132;61;29;4;25;.862;3626000;0
10165;183859;142;80;39;4;35;.897;3900000;0
10165;196456;142;0;0;0;0;.00nan;0;0
10165;-1;132;69;44;4;40;.909;3900000;0
10165;196809;132;0;0;0;0;.00nan;0;0
10167;203276;139;100;32;0;32;1.000;3600000;0
10167;192889;139;0;0;0;0;.00nan;0;0
10167;192895;143;0;0;0;0;.00nan;0;0
10167;191218;143;80;37;2;35;.946;3535000;0
10169;203288;135;77;27;1;26;.963;3600000;0
10169;199701;138;0;0;0;0;.00nan;0;0
10169;194197;135;0;0;0;0;.00nan;0;0
10169;-1;138;73;33;2;31;.939;3600000;0
10171;189264;129;65;25;3;22;.880;3663000;0
10171;195169;129;0;0;0;0;.00nan;0;0
10171;206789;131;0;0;0;0;.00nan;0;0
10171;-1;131;54;28;4;24;.857;3663000;0
10173;200436;130;74;31;2;29;.935;3600000;0
10173;-1;141;0;0;0;0;.00nan;0;0
10173;191574;141;58;40;4;36;.900;3582000;0
10173;197759;130;0;0;0;0;.00nan;0;0
10175;189225;1340;0;0;0;0;.00nan;0;0
10175;196445;140;0;0;0;0;.00nan;0;0
10175;196812;140;49;30;4;26;.867;3600000;0
10175;191571;1340;69;52;5;47;.904;3565000;0
10177;187632;134;0;0;0;0;.00nan;0;0
10177;199437;134;54;31;4;27;.871;3545000;0
10177;189944;144;69;33;3;30;.909;3600000;0
10177;-1;144;0;0;0;0;.00nan;0;0
10179;194264;137;0;0;0;0;.00nan;0;0
10179;-1;137;96;42;1;41;.976;3600000;0
10179;-1;128;57;25;3;22;.880;3514000;0
10179;-1;128;0;0;0;0;.00nan;0;0
10181;187657;136;82;29;1;28;.966;3600000;0
10181;-1;136;0;0;0;0;.00nan;0;0
10181;-1;133;0;0;0;0;.00nan;0;0
10181;192499;133;87;59;4;55;.932;3600000;0
10183;203288;135;0;0;0;0;.00nan;0;0
10183;194197;135;69;30;3;27;.900;3600000;0
10183;189944;144;0;0;0;0;.00nan;0;0
10183;-1;144;50;31;4;27;.871;3596000;0
10185;183859;142;0;0;0;0;.00nan;0;0
10185;196456;142;55;33;5;28;.848;3699000;0
10185;-1;141;53;31;4;27;.871;2063000;0
10185;191574;141;79;17;0;17;1.000;1636000;0
10187;199701;138;61;38;5;33;.868;3583000;0
10187;189264;129;0;0;0;0;.00nan;0;0
10187;195169;129;62;27;4;23;.852;3600000;0
10187;-1;138;0;0;0;0;.00nan;0;0
10189;189225;1340;41;30;5;25;.833;3537000;0
10189;-1;133;50;21;3;18;.857;3600000;0
10189;191571;1340;0;0;0;0;.00nan;0;0
10189;192499;133;0;0;0;0;.00nan;0;0
10191;194264;137;50;38;5;33;.868;3686000;0
10191;200436;130;0;0;0;0;.00nan;0;0
10191;-1;137;0;0;0;0;.00nan;0;0
10191;197759;130;68;51;6;45;.882;3686000;0
10193;206789;131;75;29;2;27;.931;3632000;0
10193;-1;132;0;0;0;0;.00nan;0;0
10193;196809;132;72;33;3;30;.909;3641000;0
10193;-1;131;0;0;0;0;.00nan;0;0
10195;203276;139;0;0;0;0;.00nan;0;0
10195;192889;139;75;43;3;40;.930;3564000;0
10195;192895;143;68;23;2;21;.913;3600000;0
10195;191218;143;0;0;0;0;.00nan;0;0
10197;196445;140;59;31;3;28;.903;3555000;0
10197;196812;140;0;0;0;0;.00nan;0;0
10197;-1;128;0;0;0;0;.00nan;0;0
10197;-1;128;84;34;2;32;.941;3600000;0
10199;187632;134;82;31;1;30;.968;3600000;0
10199;187657;136;0;0;0;0;.00nan;0;0
10199;199437;134;0;0;0;0;.00nan;0;0
10199;-1;136;69;40;4;36;.900;3600000;0
10201;189225;1340;0;0;0;0;.00nan;0;0
10201;196445;140;0;0;0;0;.00nan;0;0
10201;196812;140;61;29;3;26;.897;3561000;0
10201;191571;1340;74;23;1;22;.957;3600000;0
10203;203276;139;65;34;4;30;.882;3600000;0
10203;192889;139;0;0;0;0;.00nan;0;0
10203;183859;142;38;33;6;27;.818;2367000;0
10203;196456;142;69;15;0;15;1.000;1233000;0
10205;199701;138;0;0;0;0;.00nan;0;0
10205;206789;131;0;0;0;0;.00nan;0;0
10205;-1;131;80;29;2;27;.931;3600000;0
10205;-1;138;39;41;7;34;.829;3600000;0
10207;187632;134;0;0;0;0;.00nan;0;0
10207;199437;134;75;20;1;19;.950;3600000;0
10207;-1;128;0;0;0;0;.00nan;0;0
10207;-1;128;34;27;5;22;.815;3600000;0
10209;189264;129;53;44;6;38;.864;3600000;0
10209;195169;129;0;0;0;0;.00nan;0;0
10209;189944;144;80;30;2;28;.933;3600000;0
10209;-1;144;0;0;0;0;.00nan;0;0
10211;203288;135;100;40;0;40;1.000;3600000;0
10211;192895;143;0;0;0;0;.00nan;0;0
10211;194197;135;0;0;0;0;.00nan;0;0
10211;191218;143;51;29;4;25;.862;3600000;0
10213;-1;132;57;34;4;30;.882;3558000;0
10213;196809;132;0;0;0;0;.00nan;0;0
10213;-1;141;71;28;2;26;.929;3600000;0
10213;191574;141;0;0;0;0;.00nan;0;0
10215;194264;137;0;0;0;0;.00nan;0;0
10215;200436;130;60;26;3;23;.885;3553000;0
10215;-1;137;78;22;1;21;.955;3600000;0
10215;197759;130;0;0;0;0;.00nan;0;0
10217;187657;136;45;23;4;19;.826;3600000;0
10217;-1;136;0;0;0;0;.00nan;0;0
10217;-1;133;0;0;0;0;.00nan;0;0
10217;192499;133;61;39;5;34;.872;3600000;0
10219;203276;139;0;0;0;0;.00nan;0;0
10219;192889;139;78;38;2;36;.947;3600000;0
10219;-1;141;0;0;0;0;.00nan;0;0
10219;191574;141;41;26;4;22;.846;3553000;0
10221;199701;138;69;44;4;40;.909;3600000;0
10221;189944;144;0;0;0;0;.00nan;0;0
10221;-1;138;0;0;0;0;.00nan;0;0
10221;-1;144;48;37;6;31;.838;3588000;0
10223;187632;134;36;12;3;9;.750;3600000;0
10223;199437;134;0;0;0;0;.00nan;0;0
10223;-1;132;98;47;2;45;.957;3021000;0
10223;196809;132;26;8;3;5;.625;553000;0
10225;196445;140;80;34;3;31;.912;3827000;0
10225;196812;140;0;0;0;0;.00nan;0;0
10225;-1;133;57;23;2;21;.913;3827000;0
10225;192499;133;0;0;0;0;.00nan;0;0
10227;192895;143;11;19;6;13;.684;3303000;0
10227;189264;129;0;0;0;0;.00nan;0;0
10227;195169;129;99;50;2;48;.960;3600000;0
10227;191218;143;49;1;0;1;1.000;297000;0
10229;194264;137;31;35;7;28;.800;3600000;0
10229;200436;130;0;0;0;0;.00nan;0;0
10229;-1;137;0;0;0;0;.00nan;0;0
10229;197759;130;97;46;3;43;.935;3600000;0
10231;183859;142;55;32;4;28;.875;3900000;0
10231;196456;142;0;0;0;0;.00nan;0;0
10231;-1;128;59;28;4;24;.857;3900000;0
10231;-1;128;0;0;0;0;.00nan;0;0
10233;203288;135;39;35;6;29;.829;3600000;0
10233;194197;135;0;0;0;0;.00nan;0;0
10233;189225;1340;57;22;2;20;.909;3600000;0
10233;191571;1340;0;0;0;0;.00nan;0;0
10235;187657;136;0;0;0;0;.00nan;0;0
10235;206789;131;100;46;0;46;1.000;3600000;0
10235;-1;136;61;24;2;22;.917;3523000;0
10235;-1;131;0;0;0;0;.00nan;0;0
10237;192895;143;54;30;4;26;.867;3514000;0
10237;191218;143;0;0;0;0;.00nan;0;0
10237;-1;133;0;0;0;0;.00nan;0;0
10237;192499;133;78;29;2;27;.931;3600000;0
10239;194264;137;0;0;0;0;.00nan;0;0
10239;189225;1340;0;0;0;0;.00nan;0;0
10239;-1;137;82;24;1;23;.958;3600000;0
10239;191571;1340;74;27;2;25;.926;3546000;0
10241;199701;138;0;0;0;0;.00nan;0;0
10241;196445;140;0;0;0;0;.00nan;0;0
10241;196812;140;75;33;2;31;.939;3600000;0
10241;-1;138;86;51;5;46;.902;3600000;0
10243;203288;135;65;40;5;35;.875;3523000;0
10243;194197;135;0;0;0;0;.00nan;0;0
10243;206789;131;62;30;3;27;.900;3600000;0
10243;-1;131;0;0;0;0;.00nan;0;0
10245;203276;139;80;19;1;18;.947;3600000;0
10245;192889;139;0;0;0;0;.00nan;0;0
10245;189944;144;92;20;0;20;1.000;3600000;0
10245;-1;144;0;0;0;0;.00nan;0;0
10247;187657;136;49;23;3;20;.870;3600000;0
10247;189264;129;24;21;6;15;.714;1773000;0
10247;195169;129;41;17;3;14;.824;1827000;0
10247;-1;136;0;0;0;0;.00nan;0;0
10249;183859;142;0;0;0;0;.00nan;0;0
10249;196456;142;57;26;3;23;.885;3707000;0
10249;-1;132;0;0;0;0;.00nan;0;0
10249;196809;132;74;41;4;37;.902;3707000;0
10251;-1;141;0;0;0;0;.00nan;0;0
10251;191574;141;84;41;4;37;.902;3600000;0
10251;-1;128;0;0;0;0;.00nan;0;0
10251;-1;128;73;22;1;21;.955;3600000;0
10253;187632;134;0;0;0;0;.00nan;0;0
10253;199437;134;100;32;1;31;.969;3600000;0
10253;200436;130;44;33;6;27;.818;3600000;0
10253;197759;130;0;0;0;0;.00nan;0;0
10255;187632;134;94;23;0;23;1.000;3600000;0
10255;199437;134;0;0;0;0;.00nan;0;0
10255;-1;132;77;30;2;28;.933;3576000;0
10255;196809;132;0;0;0;0;.00nan;0;0
10257;189225;1340;38;41;6;35;.854;3600000;0
10257;189264;129;0;0;0;0;.00nan;0;0
10257;195169;129;68;28;2;26;.929;3600000;0
10257;191571;1340;0;0;0;0;.00nan;0;0
10259;187657;136;0;0;0;0;.00nan;0;0
10259;183859;142;71;34;3;31;.912;3554000;0
10259;196456;142;0;0;0;0;.00nan;0;0
10259;-1;136;76;23;1;22;.957;3600000;0
10261;199701;138;63;19;2;17;.895;3600000;0
10261;196445;140;15;14;5;9;.643;1989000;0
10261;196812;140;64;18;1;17;.944;1611000;0
10261;-1;138;0;0;0;0;.00nan;0;0
10263;203288;135;0;0;0;0;.00nan;0;0
10263;194197;135;77;30;2;28;.933;3565000;0
10263;194264;137;80;28;1;27;.964;3600000;0
10263;-1;137;0;0;0;0;.00nan;0;0
10265;192895;143;0;0;0;0;.00nan;0;0
10265;191218;143;77;32;2;30;.938;3600000;0
10265;-1;141;37;32;6;26;.813;2426000;0
10265;191574;141;62;15;1;14;.933;1174000;0
10267;206789;131;0;0;0;0;.00nan;0;0
10267;-1;131;50;44;6;38;.864;3567000;0
10267;-1;128;48;30;5;25;.833;3600000;0
10267;-1;128;0;0;0;0;.00nan;0;0
10269;200436;130;0;0;0;0;.00nan;0;0
10269;-1;133;72;36;3;33;.917;3600000;0
10269;192499;133;0;0;0;0;.00nan;0;0
10269;197759;130;68;30;2;28;.933;3600000;0
10271;203276;139;0;0;0;0;.00nan;0;0
10271;192889;139;61;26;3;23;.885;3600000;0
10271;189944;144;37;29;5;24;.828;3586000;0
10271;-1;144;0;0;0;0;.00nan;0;0
749;187657;136;0;0;0;0;.00nan;0;0
749;199701;138;0;0;0;0;.00nan;0;0
749;-1;136;97;22;0;22;1.000;3600000;0
749;-1;138;42;45;7;38;.844;3600000;0
750;192895;143;0;0;0;0;.00nan;0;0
750;206789;131;0;0;0;0;.00nan;0;0
750;191218;143;75;22;2;20;.909;4092000;0
750;-1;131;100;46;1;45;.978;4092000;0
751;191215;128;81;37;3;34;.919;3600000;0
751;-1;133;0;0;0;0;.00nan;0;0
751;192499;133;55;33;5;28;.848;3584000;0
751;-1;128;0;0;0;0;.00nan;0;0
752;192847;144;0;0;0;0;.00nan;0;0
752;189944;144;64;31;4;27;.871;3600000;0
752;-1;141;41;2;1;1;.500;281000;0
752;191574;141;40;32;6;26;.813;3319000;0
753;187632;134;100;25;0;25;1.000;3600000;0
753;199437;134;0;0;0;0;.00nan;0;0
753;196445;140;0;0;0;0;.00nan;0;0
753;196812;140;52;27;3;24;.889;3600000;0
754;194264;137;81;35;3;32;.914;3600000;0
754;189264;129;42;33;6;27;.818;3016000;0
754;195169;129;47;7;1;6;.857;584000;0
754;-1;137;0;0;0;0;.00nan;0;0
755;203288;135;40;3;1;2;.667;306000;0
755;187578;135;21;43;9;34;.791;3294000;0
755;189225;1340;0;0;0;0;.00nan;0;0
755;191571;1340;38;22;4;18;.818;3600000;0
756;183859;142;54;26;4;22;.846;3622000;0
756;200436;130;0;0;0;0;.00nan;0;0
756;196456;142;0;0;0;0;.00nan;0;0
756;197759;130;77;28;3;25;.893;3622000;0
757;187657;136;0;0;0;0;.00nan;0;0
757;199701;138;0;0;0;0;.00nan;0;0
757;-1;136;76;16;1;15;.938;3600000;0
757;-1;138;96;49;3;46;.939;3576000;0
758;192895;143;0;0;0;0;.00nan;0;0
758;206789;131;0;0;0;0;.00nan;0;0
758;191218;143;59;25;2;23;.920;3600000;0
758;-1;131;72;45;5;40;.889;3600000;0
759;191215;128;99;46;2;44;.957;3600000;0
759;-1;133;0;0;0;0;.00nan;0;0
759;192499;133;56;34;4;30;.882;3556000;0
759;-1;128;0;0;0;0;.00nan;0;0
760;192847;144;0;0;0;0;.00nan;0;0
760;189944;144;67;24;2;22;.917;3600000;0
760;-1;141;0;0;0;0;.00nan;0;0
760;191574;141;63;30;3;27;.900;3551000;0
761;187632;134;72;23;2;21;.913;3600000;0
761;199437;134;0;0;0;0;.00nan;0;0
761;196445;140;0;0;0;0;.00nan;0;0
761;196812;140;68;36;3;33;.917;3558000;0
762;194264;137;76;24;1;23;.958;3600000;0
762;189264;129;59;34;4;30;.882;3600000;0
762;195169;129;0;0;0;0;.00nan;0;0
762;-1;137;0;0;0;0;.00nan;0;0
763;203288;135;0;0;0;0;.00nan;0;0
763;187578;135;83;34;2;32;.941;3600000;0
763;189225;1340;0;0;0;0;.00nan;0;0
763;191571;1340;49;21;3;18;.857;3600000;0
764;183859;142;91;38;1;37;.974;3600000;0
764;200436;130;0;0;0;0;.00nan;0;0
764;196456;142;0;0;0;0;.00nan;0;0
764;197759;130;67;27;2;25;.926;3600000;0
765;187657;136;0;0;0;0;.00nan;0;0
765;199701;138;0;0;0;0;.00nan;0;0
765;-1;136;47;30;5;25;.833;4406000;0
765;-1;138;60;50;6;44;.880;4406000;0
766;192895;143;0;0;0;0;.00nan;0;0
766;206789;131;0;0;0;0;.00nan;0;0
766;191218;143;54;27;3;24;.889;3573000;0
766;-1;131;99;38;1;37;.974;3600000;0
767;191215;128;65;45;4;41;.911;4282000;0
767;-1;133;0;0;0;0;.00nan;0;0
767;192499;133;57;41;5;36;.878;4282000;0
767;-1;128;0;0;0;0;.00nan;0;0
768;192847;144;0;0;0;0;.00nan;0;0
768;189944;144;82;23;1;22;.957;3600000;0
768;-1;141;0;0;0;0;.00nan;0;0
768;191574;141;73;27;2;25;.926;3590000;0
769;187632;134;83;27;1;26;.963;3600000;0
769;199437;134;0;0;0;0;.00nan;0;0
769;196445;140;0;0;0;0;.00nan;0;0
769;196812;140;56;23;3;20;.870;3541000;0
770;194264;137;84;35;2;33;.943;3600000;0
770;189264;129;100;35;1;34;.971;3600000;0
770;195169;129;0;0;0;0;.00nan;0;0
770;-1;137;0;0;0;0;.00nan;0;0
771;203288;135;0;0;0;0;.00nan;0;0
771;187578;135;59;41;5;36;.878;3512000;0
771;189225;1340;0;0;0;0;.00nan;0;0
771;191571;1340;49;22;3;19;.864;3600000;0
772;183859;142;69;31;3;28;.903;3600000;0
772;200436;130;0;0;0;0;.00nan;0;0
772;196456;142;0;0;0;0;.00nan;0;0
772;197759;130;47;39;6;33;.846;3600000;0
773;187657;136;0;0;0;0;.00nan;0;0
773;199701;138;0;0;0;0;.00nan;0;0
773;-1;136;89;28;1;27;.964;3600000;0
773;-1;138;74;46;5;41;.891;3600000;0
774;192895;143;0;0;0;0;.00nan;0;0
774;206789;131;0;0;0;0;.00nan;0;0
774;191218;143;64;13;1;12;.923;3600000;0
774;-1;131;81;50;5;45;.900;3600000;0
775;191215;128;75;40;4;36;.900;3541000;0
775;-1;133;0;0;0;0;.00nan;0;0
775;192499;133;62;24;2;22;.917;3600000;0
775;-1;128;0;0;0;0;.00nan;0;0
776;192847;144;0;0;0;0;.00nan;0;0
776;189944;144;69;28;3;25;.893;3600000;0
776;-1;141;0;0;0;0;.00nan;0;0
776;191574;141;78;32;2;30;.938;3600000;0
777;187632;134;76;24;1;23;.958;3600000;0
777;199437;134;0;0;0;0;.00nan;0;0
777;196445;140;0;0;0;0;.00nan;0;0
777;196812;140;95;23;0;23;1.000;3600000;0
778;194264;137;45;13;2;11;.846;3600000;0
778;189264;129;22;23;6;17;.739;2600000;0
778;195169;129;50;8;1;7;.875;1000000;0
778;-1;137;0;0;0;0;.00nan;0;0
779;203288;135;0;0;0;0;.00nan;0;0
779;187578;135;100;23;0;23;1.000;3600000;0
779;189225;1340;0;0;0;0;.00nan;0;0
779;191571;1340;56;31;4;27;.871;3600000;0
780;183859;142;77;35;3;32;.914;3551000;0
780;200436;130;0;0;0;0;.00nan;0;0
780;196456;142;0;0;0;0;.00nan;0;0
780;197759;130;99;43;2;41;.953;3600000;0
994;192895;143;0;0;0;0;.00nan;0;0
994;206789;131;0;0;0;0;.00nan;0;0
994;191218;143;64;18;2;16;.889;3600000;0
994;-1;131;71;39;3;36;.923;3557000;0
995;191215;128;60;38;3;35;.921;4462000;0
995;-1;133;0;0;0;0;.00nan;0;0
995;192499;133;92;61;4;57;.934;4462000;0
995;-1;128;0;0;0;0;.00nan;0;0
996;192847;144;0;0;0;0;.00nan;0;0
996;189944;144;51;31;5;26;.839;3576000;0
996;-1;141;0;0;0;0;.00nan;0;0
996;191574;141;67;27;3;24;.889;3600000;0
997;187632;134;76;26;1;25;.962;3600000;0
997;199437;134;0;0;0;0;.00nan;0;0
997;196445;140;0;0;0;0;.00nan;0;0
997;196812;140;76;33;2;31;.939;3595000;0
998;194264;137;59;26;3;23;.885;3600000;0
998;189264;129;73;44;4;40;.909;3573000;0
998;195169;129;0;0;0;0;.00nan;0;0
998;-1;137;0;0;0;0;.00nan;0;0
999;203288;135;0;0;0;0;.00nan;0;0
999;187578;135;87;32;1;31;.969;3600000;0
999;189225;1340;0;0;0;0;.00nan;0;0
999;191571;1340;53;19;2;17;.895;3600000;0
1000;183859;142;75;33;2;31;.939;4735000;0
1000;200436;130;0;0;0;0;.00nan;0;0
1000;196456;142;0;0;0;0;.00nan;0;0
1000;197759;130;70;38;3;35;.921;4737000;0
1041;192895;143;0;0;0;0;.00nan;0;0
1041;206789;131;0;0;0;0;.00nan;0;0
1041;191218;143;32;21;4;17;.810;3546000;0
1041;-1;131;91;42;2;40;.952;3600000;0
1042;192847;144;0;0;0;0;.00nan;0;0
1042;189944;144;98;24;0;24;1.000;3600000;0
1042;-1;141;0;0;0;0;.00nan;0;0
1042;191574;141;73;26;2;24;.923;3600000;0
1043;203288;135;0;0;0;0;.00nan;0;0
1043;187578;135;45;32;5;27;.844;3600000;0
1043;189225;1340;0;0;0;0;.00nan;0;0
1043;191571;1340;93;27;1;26;.963;3600000;0
1044;183859;142;94;51;3;48;.941;4921000;0
1044;200436;130;0;0;0;0;.00nan;0;0
1044;196456;142;0;0;0;0;.00nan;0;0
1044;197759;130;90;39;2;37;.949;4921000;0
1080;192895;143;0;0;0;0;.00nan;0;0
1080;206789;131;46;18;3;15;.833;1624000;0
1080;191218;143;69;32;3;29;.906;3600000;0
1080;-1;131;18;21;6;15;.714;1976000;0
1081;203288;135;0;0;0;0;.00nan;0;0
1081;187578;135;79;32;2;30;.938;3600000;0
1081;189225;1340;0;0;0;0;.00nan;0;0
1081;191571;1340;90;27;1;26;.963;3600000;0
1082;183859;142;56;42;6;36;.857;3553000;0
1082;200436;130;0;0;0;0;.00nan;0;0
1082;196456;142;0;0;0;0;.00nan;0;0
1082;197759;130;77;37;4;33;.892;3600000;0
1117;187657;136;0;0;0;0;.00nan;0;0
1117;200436;130;0;0;0;0;.00nan;0;0
1117;-1;136;100;53;0;53;1.000;4610000;0
1117;197759;130;90;34;1;33;.971;4610000;0
1118;194264;137;32;35;7;28;.800;3579000;0
1118;191215;128;35;25;5;20;.800;3600000;0
1118;-1;137;0;0;0;0;.00nan;0;0
1118;-1;128;0;0;0;0;.00nan;0;0
1119;192847;144;0;0;0;0;.00nan;0;0
1119;187632;134;69;41;4;37;.902;3731000;0
1119;199437;134;0;0;0;0;.00nan;0;0
1119;189944;144;60;24;3;21;.875;3731000;0
1120;192895;143;0;0;0;0;.00nan;0;0
1120;189225;1340;0;0;0;0;.00nan;0;0
1120;191218;143;74;24;2;22;.917;3600000;0
1120;191571;1340;79;36;3;33;.917;3577000;0
1121;187657;136;0;0;0;0;.00nan;0;0
1121;200436;130;0;0;0;0;.00nan;0;0
1121;-1;136;89;35;2;33;.943;3600000;0
1121;197759;130;49;23;4;19;.826;3577000;0
1122;194264;137;80;24;1;23;.958;3600000;0
1122;191215;128;69;30;2;28;.933;3544000;0
1122;-1;137;0;0;0;0;.00nan;0;0
1122;-1;128;0;0;0;0;.00nan;0;0
1123;192847;144;0;0;0;0;.00nan;0;0
1123;187632;134;38;50;7;43;.860;3600000;0
1123;199437;134;0;0;0;0;.00nan;0;0
1123;189944;144;70;19;1;18;.947;3600000;0
1124;192895;143;0;0;0;0;.00nan;0;0
1124;189225;1340;0;0;0;0;.00nan;0;0
1124;191218;143;45;24;4;20;.833;4218000;0
1124;191571;1340;65;40;5;35;.875;4218000;0
1125;187657;136;0;0;0;0;.00nan;0;0
1125;200436;130;0;0;0;0;.00nan;0;0
1125;-1;136;100;26;0;26;1.000;3600000;0
1125;197759;130;66;43;5;38;.884;3600000;0
1126;194264;137;31;31;6;25;.806;2613000;0
1126;191215;128;100;35;1;34;.971;3600000;0
1126;-1;137;62;10;0;10;1.000;987000;0
1126;-1;128;0;0;0;0;.00nan;0;0
1127;192847;144;0;0;0;0;.00nan;0;0
1127;187632;134;47;33;5;28;.848;3835000;0
1127;199437;134;0;0;0;0;.00nan;0;0
1127;189944;144;39;19;4;15;.789;3835000;0
1128;192895;143;0;0;0;0;.00nan;0;0
1128;189225;1340;0;0;0;0;.00nan;0;0
1128;191218;143;51;21;3;18;.857;4548000;0
1128;191571;1340;81;38;2;36;.947;4548000;0
1129;187657;136;0;0;0;0;.00nan;0;0
1129;200436;130;0;0;0;0;.00nan;0;0
1129;-1;136;65;37;4;33;.892;3600000;0
1129;197759;130;86;31;2;29;.935;3600000;0
1130;194264;137;68;23;1;22;.957;3600000;0
1130;191215;128;38;29;5;24;.828;1878000;0
1130;-1;137;0;0;0;0;.00nan;0;0
1130;-1;128;68;26;3;23;.885;1722000;0
1131;192847;144;0;0;0;0;.00nan;0;0
1131;187632;134;71;32;2;30;.938;3553000;0
1131;199437;134;0;0;0;0;.00nan;0;0
1131;189944;144;92;37;1;36;.973;3600000;0
1132;192895;143;0;0;0;0;.00nan;0;0
1132;189225;1340;0;0;0;0;.00nan;0;0
1132;191218;143;71;22;1;21;.955;3543000;0
1132;191571;1340;100;30;0;30;1.000;3600000;0
1345;187657;136;0;0;0;0;.00nan;0;0
1345;200436;130;0;0;0;0;.00nan;0;0
1345;-1;136;71;31;2;29;.935;3877000;0
1345;197759;130;66;33;3;30;.909;3877000;0
1346;194264;137;79;33;3;30;.909;3550000;0
1346;191215;128;85;27;2;25;.926;3600000;0
1346;-1;137;0;0;0;0;.00nan;0;0
1346;-1;128;0;0;0;0;.00nan;0;0
1347;192895;143;0;0;0;0;.00nan;0;0
1347;189225;1340;0;0;0;0;.00nan;0;0
1347;191218;143;63;25;3;22;.880;3600000;0
1347;191571;1340;44;44;6;38;.864;3600000;0
11514;-1;203;51;29;4;25;.862;3600000;0
11514;-1;203;0;0;0;0;.00nan;0;0
11514;-1;207;59;50;7;43;.860;3107000;0
11514;-1;207;36;6;2;4;.667;493000;0
10424;177248;201;0;0;0;0;.00nan;0;0
10424;195238;200;0;0;0;0;.00nan;0;0
10424;185743;201;57;18;2;16;.889;3600000;0
10424;187295;200;70;44;4;40;.909;3517000;0
10329;-1;227;96;39;1;38;.974;3900000;0
10329;189885;225;100;40;1;39;.975;3900000;0
10329;184785;225;0;0;0;0;.00nan;0;0
10329;187217;227;0;0;0;0;.00nan;0;0
10416;171839;189;0;0;0;0;.00nan;0;0
10416;-1;189;44;25;4;21;.840;3600000;0
10416;176200;195;79;15;0;15;1.000;3600000;0
10416;179647;195;0;0;0;0;.00nan;0;0
10290;169166;226;75;36;3;33;.917;3623000;0
10290;189902;204;0;0;0;0;.00nan;0;0
10290;182049;204;62;26;2;24;.923;3639000;0
10290;192629;226;0;0;0;0;.00nan;0;0
10306;168954;228;50;37;5;32;.865;3600000;0
10306;184610;222;55;19;2;17;.895;3600000;0
10306;175354;228;0;0;0;0;.00nan;0;0
10306;185851;222;0;0;0;0;.00nan;0;0
10657;182454;4864;0;0;0;0;.00nan;0;0
10657;183737;4864;58;29;3;26;.897;3600000;0
10657;170114;4959;0;0;0;0;.00nan;0;0
10657;195363;4959;49;28;4;24;.857;3600000;0
10297;174147;179;0;0;0;0;.00nan;0;0
10297;-1;210;0;0;0;0;.00nan;0;0
10297;187355;179;34;27;6;21;.778;3600000;0
10297;192461;210;96;41;3;38;.927;3600000;0
10654;166762;213;0;0;0;0;.00nan;0;0
10654;179400;183;75;39;3;36;.923;3600000;0
10654;180575;213;91;17;0;17;1.000;3600000;0
10654;182089;183;0;0;0;0;.00nan;0;0
10446;166545;193;71;26;1;25;.962;3600000;0
10446;178394;188;69;33;3;30;.909;3556000;0
10446;174153;188;0;0;0;0;.00nan;0;0
10446;186451;193;0;0;0;0;.00nan;0;0
11409;171730;220;75;21;1;20;.952;3600000;0
11409;179388;182;0;0;0;0;.00nan;0;0
11409;182116;182;88;43;3;40;.930;3600000;0
11409;187443;220;0;0;0;0;.00nan;0;0
10355;173340;231;57;28;3;25;.893;3600000;0
10355;179406;232;48;34;5;29;.853;3562000;0
10355;179434;232;0;0;0;0;.00nan;0;0
10355;185034;231;0;0;0;0;.00nan;0;0
10274;195164;218;0;0;0;0;.00nan;0;0
10274;176938;180;80;32;2;30;.938;3569000;0
10274;-1;180;0;0;0;0;.00nan;0;0
10274;192457;218;100;27;0;27;1.000;3600000;0
11620;168907;186;0;0;0;0;.00nan;0;0
11620;169226;186;63;31;3;28;.903;3600000;0
11620;190034;217;45;27;4;23;.852;3600000;0
11620;190041;217;0;0;0;0;.00nan;0;0
10275;175364;206;57;30;4;26;.867;3600000;0
10275;175370;199;0;0;0;0;.00nan;0;0
10275;196283;206;0;0;0;0;.00nan;0;0
10275;161006;199;70;21;1;20;.952;3600000;0
11537;190125;184;64;38;4;34;.895;3545000;0
11537;179668;184;0;0;0;0;.00nan;0;0
11537;180578;181;0;0;0;0;.00nan;0;0
11537;-1;181;62;24;2;22;.917;3600000;0
10497;-1;4949;43;16;3;13;.813;3600000;0
10497;195251;4949;0;0;0;0;.00nan;0;0
10497;179400;183;0;0;0;0;.00nan;0;0
10497;182089;183;73;47;4;43;.915;3554000;0
10302;169096;190;84;39;2;37;.949;3600000;0
10302;170351;194;71;35;4;31;.886;3583000;0
10302;196352;194;0;0;0;0;.00nan;0;0
10302;197704;190;0;0;0;0;.00nan;0;0
10307;195238;200;45;45;7;38;.844;2697000;0
10307;189902;204;0;0;0;0;.00nan;0;0
10307;182049;204;55;16;2;14;.875;3600000;0
10307;187295;200;60;9;0;9;1.000;903000;0
10304;171730;220;52;27;4;23;.852;3517000;0
10304;-1;1371;0;0;0;0;.00nan;0;0
10304;187443;220;0;0;0;0;.00nan;0;0
10304;192688;1371;70;25;2;23;.920;3600000;0
10352;167404;215;99;37;1;36;.973;3600000;0
10352;165731;215;0;0;0;0;.00nan;0;0
10352;168907;186;0;0;0;0;.00nan;0;0
10352;169226;186;43;29;5;24;.828;3600000;0
10311;182467;185;0;0;0;0;.00nan;0;0
10311;190125;184;54;32;4;28;.875;3600000;0
10311;179668;184;0;0;0;0;.00nan;0;0
10311;180110;185;64;40;5;35;.875;3600000;0
10398;168954;228;85;54;6;48;.889;3600000;0
10398;175354;228;0;0;0;0;.00nan;0;0
10398;181338;230;0;0;0;0;.00nan;0;0
10398;186495;230;62;22;3;19;.864;3600000;0
10321;182454;4864;0;0;0;0;.00nan;0;0
10321;183737;4864;89;40;2;38;.950;3600000;0
10321;171405;2620;0;0;0;0;.00nan;0;0
10321;-1;2620;60;33;4;29;.879;3527000;0
10335;171835;4960;73;36;3;33;.917;3900000;0
10335;194219;4960;0;0;0;0;.00nan;0;0
10335;-1;221;0;0;0;0;.00nan;0;0
10335;187362;221;52;34;3;31;.912;3900000;0
10320;171662;176;88;26;1;25;.962;3600000;0
10320;179169;209;0;0;0;0;.00nan;0;0
10320;176932;176;0;0;0;0;.00nan;0;0
10320;186205;209;87;35;2;33;.943;3600000;0
10342;166762;213;0;0;0;0;.00nan;0;0
10342;179602;177;64;34;4;30;.882;3600000;0
10342;176672;177;0;0;0;0;.00nan;0;0
10342;180575;213;38;29;5;24;.828;3600000;0
10334;175370;199;0;0;0;0;.00nan;0;0
10334;-1;205;55;27;4;23;.852;3600000;0
10334;187092;205;0;0;0;0;.00nan;0;0
10334;161006;199;69;47;5;42;.894;3549000;0
10340;194416;191;0;0;0;0;.00nan;0;0
10340;194893;191;63;41;5;36;.878;3574000;0
10340;176200;195;77;28;2;26;.929;3600000;0
10340;179647;195;0;0;0;0;.00nan;0;0
10272;171839;189;0;0;0;0;.00nan;0;0
10272;179197;198;0;0;0;0;.00nan;0;0
10272;-1;189;87;54;3;51;.944;3810000;0
10272;181431;198;61;20;2;18;.900;3810000;0
10276;184069;208;0;0;0;0;.00nan;0;0
10276;179702;208;80;26;1;25;.962;3600000;0
10276;-1;207;0;0;0;0;.00nan;0;0
10276;-1;207;67;32;3;29;.906;3600000;0
10273;179388;182;0;0;0;0;.00nan;0;0
10273;182116;182;71;40;3;37;.925;3600000;0
10273;-1;214;0;0;0;0;.00nan;0;0
10273;191518;214;93;23;0;23;1.000;3600000;0
10286;-1;210;0;0;0;0;.00nan;0;0
10286;187240;216;67;40;4;36;.900;3600000;0
10286;191557;216;0;0;0;0;.00nan;0;0
10286;192461;210;32;30;6;24;.800;3569000;0
10288;-1;211;55;31;4;27;.871;3669000;0
10288;179646;211;0;0;0;0;.00nan;0;0
10288;181065;219;39;32;5;27;.844;3669000;0
10288;181102;219;0;0;0;0;.00nan;0;0
10292;169166;226;44;30;5;25;.833;3600000;0
10292;180623;202;97;38;1;37;.974;3600000;0
10292;192498;202;0;0;0;0;.00nan;0;0
10292;192629;226;0;0;0;0;.00nan;0;0
10474;175423;223;86;38;2;36;.947;3551000;0
10474;179430;229;0;0;0;0;.00nan;0;0
10474;185800;229;100;41;0;41;1.000;3600000;0
10474;187118;223;0;0;0;0;.00nan;0;0
10280;184175;224;0;0;0;0;.00nan;0;0
10280;184610;222;44;9;2;7;.778;454000;0
10280;185840;224;64;37;4;33;.892;3600000;0
10280;185851;222;41;42;7;35;.833;3146000;0
10296;174209;178;0;0;0;0;.00nan;0;0
10296;180762;1505;0;0;0;0;.00nan;0;0
10296;186549;1505;61;14;1;13;.929;3600000;0
10296;-1;178;97;49;2;47;.959;3597000;0
10278;176938;180;67;24;2;22;.917;3560000;0
10278;179679;212;0;0;0;0;.00nan;0;0
10278;186641;212;70;8;0;8;1.000;3600000;0
10278;-1;180;0;0;0;0;.00nan;0;0
10282;178394;188;0;0;0;0;.00nan;0;0
10282;174153;188;85;14;0;14;1.000;3600000;0
10282;174325;197;79;47;4;43;.915;3600000;0
10282;175436;197;0;0;0;0;.00nan;0;0
10283;192862;187;59;16;2;14;.875;3600000;0
10283;189081;187;0;0;0;0;.00nan;0;0
10283;-1;196;0;0;0;0;.00nan;0;0
10283;184648;196;58;31;3;28;.903;3523000;0
10277;189885;225;60;39;5;34;.872;3600000;0
10277;184785;225;0;0;0;0;.00nan;0;0
10277;181338;230;0;0;0;0;.00nan;0;0
10277;186495;230;100;33;0;33;1.000;3600000;0
10327;195164;218;0;0;0;0;.00nan;0;0
10327;181065;219;0;0;0;0;.00nan;0;0
10327;181102;219;45;37;6;31;.838;3574000;0
10327;192457;218;57;29;4;25;.862;3600000;0
10279;179602;177;29;27;6;21;.778;2317000;0
10279;176672;177;54;14;1;13;.929;1283000;0
10279;180762;1505;64;19;2;17;.895;3600000;0
10279;186549;1505;0;0;0;0;.00nan;0;0
10379;184069;208;72;30;2;28;.933;3600000;0
10379;-1;203;62;29;3;26;.897;3591000;0
10379;179702;208;0;0;0;0;.00nan;0;0
10379;-1;203;0;0;0;0;.00nan;0;0
10285;192862;187;0;0;0;0;.00nan;0;0
10285;189081;187;46;34;5;29;.853;3699000;0
10285;-1;196;0;0;0;0;.00nan;0;0
10285;184648;196;60;42;6;36;.857;3699000;0
10284;184175;224;94;23;1;22;.957;3600000;0
10284;-1;227;64;24;2;22;.917;3582000;0
10284;185840;224;0;0;0;0;.00nan;0;0
10284;187217;227;0;0;0;0;.00nan;0;0
11453;168117;192;0;0;0;0;.00nan;0;0
11453;194416;191;0;0;0;0;.00nan;0;0
11453;194893;191;38;20;4;16;.800;3579000;0
11453;-1;192;56;25;3;22;.880;3600000;0
10374;175364;206;90;51;2;49;.961;3895000;0
10374;196283;206;0;0;0;0;.00nan;0;0
10374;-1;205;64;24;2;22;.917;3900000;0
10374;187092;205;0;0;0;0;.00nan;0;0
10357;171835;4960;26;31;6;25;.806;2397000;0
10357;194219;4960;39;11;2;9;.818;1203000;0
10357;173340;231;0;0;0;0;.00nan;0;0
10357;185034;231;45;28;5;23;.821;3600000;0
10295;180578;181;0;0;0;0;.00nan;0;0
10295;-1;181;100;21;0;21;1.000;3600000;0
10295;-1;214;91;31;1;30;.968;3552000;0
10295;191518;214;0;0;0;0;.00nan;0;0
10298;170114;4959;56;32;4;28;.875;3559000;0
10298;195363;4959;0;0;0;0;.00nan;0;0
10298;179169;209;0;0;0;0;.00nan;0;0
10298;186205;209;53;19;2;17;.895;3600000;0
10299;169096;190;76;43;4;39;.907;3600000;0
10299;179197;198;0;0;0;0;.00nan;0;0
10299;181431;198;88;21;0;21;1.000;3600000;0
10299;197704;190;0;0;0;0;.00nan;0;0
10303;167404;215;63;31;3;28;.903;3600000;0
10303;165731;215;0;0;0;0;.00nan;0;0
10303;-1;211;72;28;2;26;.929;3600000;0
10303;179646;211;0;0;0;0;.00nan;0;0
10305;182467;185;70;49;5;44;.898;3600000;0
10305;-1;1371;0;0;0;0;.00nan;0;0
10305;180110;185;0;0;0;0;.00nan;0;0
10305;192688;1371;74;19;1;18;.947;3600000;0
10289;170351;194;68;25;2;23;.920;3600000;0
10289;174325;197;68;39;4;35;.897;3577000;0
10289;175436;197;0;0;0;0;.00nan;0;0
10289;196352;194;0;0;0;0;.00nan;0;0
10328;171405;2620;78;25;1;24;.960;3600000;0
10328;171662;176;67;32;3;29;.906;3600000;0
10328;176932;176;0;0;0;0;.00nan;0;0
10328;-1;2620;0;0;0;0;.00nan;0;0
10473;-1;221;72;23;1;22;.957;3600000;0
10473;175423;223;78;41;3;38;.927;3547000;0
10473;187118;223;0;0;0;0;.00nan;0;0
10473;187362;221;0;0;0;0;.00nan;0;0
10350;169166;226;48;27;4;23;.852;3900000;0
10350;189902;204;59;31;4;27;.871;3900000;0
10350;182049;204;0;0;0;0;.00nan;0;0
10350;192629;226;0;0;0;0;.00nan;0;0
10366;174209;178;73;46;5;41;.891;3600000;0
10366;-1;210;81;17;1;16;.941;3600000;0
10366;192461;210;0;0;0;0;.00nan;0;0
10366;-1;178;0;0;0;0;.00nan;0;0
10348;168907;186;0;0;0;0;.00nan;0;0
10348;169226;186;54;30;4;26;.867;3675000;0
10348;195164;218;60;27;3;24;.889;3675000;0
10348;192457;218;0;0;0;0;.00nan;0;0
10338;-1;203;0;0;0;0;.00nan;0;0
10338;-1;203;69;21;1;20;.952;3900000;0
10338;-1;207;0;0;0;0;.00nan;0;0
10338;-1;207;97;40;1;39;.975;3900000;0
10360;166545;193;68;15;1;14;.933;3600000;0
10360;178394;188;0;0;0;0;.00nan;0;0
10360;174153;188;98;48;2;46;.958;3600000;0
10360;186451;193;0;0;0;0;.00nan;0;0
10475;177248;201;0;0;0;0;.00nan;0;0
10475;175370;199;82;25;1;24;.960;3566000;0
10475;185743;201;100;23;0;23;1.000;3600000;0
10475;161006;199;0;0;0;0;.00nan;0;0
10287;176938;180;98;39;1;38;.974;3600000;0
10287;179679;212;0;0;0;0;.00nan;0;0
10287;186641;212;55;25;3;22;.880;3561000;0
10287;-1;180;0;0;0;0;.00nan;0;0
10558;-1;4949;59;17;1;16;.941;3600000;0
10558;195251;4949;0;0;0;0;.00nan;0;0
10558;179400;183;0;0;0;0;.00nan;0;0
10558;182089;183;98;45;2;43;.956;3583000;0
10293;189885;225;0;0;0;0;.00nan;0;0
10293;179406;232;84;43;3;40;.930;3900000;0
10293;179434;232;0;0;0;0;.00nan;0;0
10293;184785;225;46;25;3;22;.880;3900000;0
10312;166762;213;36;33;6;27;.818;3600000;0
10312;180575;213;0;0;0;0;.00nan;0;0
10312;187240;216;35;27;5;22;.815;3600000;0
10312;191557;216;0;0;0;0;.00nan;0;0
10492;171839;189;0;0;0;0;.00nan;0;0
10492;168117;192;0;0;0;0;.00nan;0;0
10492;-1;189;97;36;1;35;.972;3900000;0
10492;-1;192;61;13;1;12;.923;3900000;0
10323;173340;231;0;0;0;0;.00nan;0;0
10323;184610;222;65;37;4;33;.892;3600000;0
10323;185034;231;97;33;1;32;.970;3600000;0
10323;185851;222;0;0;0;0;.00nan;0;0
10412;195238;200;0;0;0;0;.00nan;0;0
10412;180623;202;0;0;0;0;.00nan;0;0
10412;187295;200;82;35;2;33;.943;3600000;0
10412;192498;202;38;38;6;32;.842;3600000;0
10281;171730;220;35;28;6;22;.786;3192000;0
10281;179388;182;0;0;0;0;.00nan;0;0
10281;182116;182;92;35;1;34;.971;3600000;0
10281;187443;220;48;0;0;0;.00nan;408000;0
10557;171730;220;0;0;0;0;.00nan;0;0
10557;187443;220;70;28;2;26;.929;3600000;0
10557;-1;214;53;35;4;31;.886;3557000;0
10557;191518;214;0;0;0;0;.00nan;0;0
10359;184175;224;48;45;7;38;.844;3544000;0
10359;179406;232;0;0;0;0;.00nan;0;0
10359;179434;232;51;31;5;26;.839;3600000;0
10359;185840;224;0;0;0;0;.00nan;0;0
10489;177248;201;0;0;0;0;.00nan;0;0
10489;180623;202;83;29;1;28;.966;3600000;0
10489;185743;201;60;30;3;27;.900;3591000;0
10489;192498;202;0;0;0;0;.00nan;0;0
10369;182454;4864;60;16;1;15;.938;3900000;0
10369;183737;4864;0;0;0;0;.00nan;0;0
10369;179169;209;100;53;1;52;.981;3900000;0
10369;186205;209;0;0;0;0;.00nan;0;0
10478;171835;4960;23;4;3;1;.250;578000;0
10478;194219;4960;66;19;1;18;.947;2999000;0
10478;179430;229;0;0;0;0;.00nan;0;0
10478;185800;229;100;50;3;47;.940;3600000;0
10406;168954;228;98;36;1;35;.972;3588000;0
10406;175354;228;0;0;0;0;.00nan;0;0
10406;181338;230;0;0;0;0;.00nan;0;0
10406;186495;230;88;16;0;16;1.000;3600000;0
11629;-1;4949;0;0;0;0;.00nan;0;0
11629;195251;4949;65;23;3;20;.870;3555000;0
11629;-1;210;0;0;0;0;.00nan;0;0
11629;192461;210;81;27;1;26;.963;3600000;0
10377;184069;208;73;23;2;21;.913;3600000;0
10377;175364;206;0;0;0;0;.00nan;0;0
10377;179702;208;0;0;0;0;.00nan;0;0
10377;196283;206;47;31;4;27;.871;3533000;0
11332;169096;190;99;35;1;34;.971;3600000;0
11332;-1;196;30;26;6;20;.769;3600000;0
11332;184648;196;0;0;0;0;.00nan;0;0
11332;197704;190;0;0;0;0;.00nan;0;0
11379;-1;227;0;0;0;0;.00nan;0;0
11379;175423;223;0;0;0;0;.00nan;0;0
11379;187118;223;59;32;4;28;.875;3600000;0
11379;187217;227;79;28;1;27;.964;3600000;0
10371;170114;4959;40;32;6;26;.813;3600000;0
10371;195363;4959;0;0;0;0;.00nan;0;0
10371;171662;176;79;35;2;33;.943;3600000;0
10371;176932;176;0;0;0;0;.00nan;0;0
10317;-1;1371;0;0;0;0;.00nan;0;0
10317;190125;184;81;37;2;35;.946;3600000;0
10317;179668;184;0;0;0;0;.00nan;0;0
10317;192688;1371;71;39;4;35;.897;3600000;0
10314;179197;198;0;0;0;0;.00nan;0;0
10314;176200;195;88;16;0;16;1.000;3600000;0
10314;179647;195;0;0;0;0;.00nan;0;0
10314;181431;198;95;43;1;42;.977;3575000;0
10318;-1;211;67;25;2;23;.920;3551000;0
10318;179646;211;0;0;0;0;.00nan;0;0
10318;181065;219;0;0;0;0;.00nan;0;0
10318;181102;219;94;23;0;23;1.000;3600000;0
10345;192862;187;0;0;0;0;.00nan;0;0
10345;189081;187;95;35;1;34;.971;3600000;0
10345;194416;191;82;31;2;29;.935;3578000;0
10345;194893;191;0;0;0;0;.00nan;0;0
10333;168907;186;33;29;6;23;.793;2726000;0
10333;169226;186;66;13;0;13;1.000;874000;0
10333;179679;212;79;24;1;23;.958;3600000;0
10333;186641;212;0;0;0;0;.00nan;0;0
10331;179602;177;0;0;0;0;.00nan;0;0
10331;176672;177;48;43;6;37;.860;3600000;0
10331;180762;1505;85;25;1;24;.960;3600000;0
10331;186549;1505;0;0;0;0;.00nan;0;0
10346;-1;207;0;0;0;0;.00nan;0;0
10346;-1;205;0;0;0;0;.00nan;0;0
10346;187092;205;53;12;2;10;.833;3600000;0
10346;-1;207;80;42;3;39;.929;3600000;0
10291;179388;182;0;0;0;0;.00nan;0;0
10291;180578;181;0;0;0;0;.00nan;0;0
10291;182116;182;96;42;3;39;.929;3600000;0
10291;-1;181;70;16;1;15;.938;3600000;0
10330;174147;179;0;0;0;0;.00nan;0;0
10330;174209;178;57;32;4;28;.875;3600000;0
10330;187355;179;79;27;1;26;.963;3600000;0
10330;-1;178;0;0;0;0;.00nan;0;0
10313;166545;193;0;0;0;0;.00nan;0;0
10313;174325;197;83;51;4;47;.922;3600000;0
10313;175436;197;0;0;0;0;.00nan;0;0
10313;186451;193;59;14;1;13;.929;3600000;0
10404;168117;192;0;0;0;0;.00nan;0;0
10404;170351;194;0;0;0;0;.00nan;0;0
10404;-1;192;31;25;5;20;.800;3547000;0
10404;196352;194;68;43;4;39;.907;3600000;0
10388;-1;211;50;20;3;17;.850;1705000;0
10388;190034;217;79;29;2;27;.931;3600000;0
10388;190041;217;0;0;0;0;.00nan;0;0
10388;179646;211;40;28;6;22;.786;1895000;0
10389;182467;185;55;30;4;26;.867;3600000;0
10389;180110;185;0;0;0;0;.00nan;0;0
10389;-1;214;89;35;1;34;.971;3600000;0
10389;191518;214;0;0;0;0;.00nan;0;0
10392;175364;206;44;35;5;30;.857;3518000;0
10392;196283;206;0;0;0;0;.00nan;0;0
10392;-1;205;50;20;3;17;.850;3600000;0
10392;187092;205;0;0;0;0;.00nan;0;0
10336;194416;191;0;0;0;0;.00nan;0;0
10336;194893;191;88;19;0;19;1.000;3600000;0
10336;174325;197;0;0;0;0;.00nan;0;0
10336;175436;197;93;51;3;48;.941;3600000;0
10471;179430;229;28;8;3;5;.625;296000;0
10471;181338;230;0;0;0;0;.00nan;0;0
10471;185800;229;84;46;3;43;.935;3304000;0
10471;186495;230;96;23;0;23;1.000;3600000;0
10308;180762;1505;61;21;2;19;.905;3600000;0
10308;186549;1505;0;0;0;0;.00nan;0;0
10308;187240;216;63;35;3;32;.914;3565000;0
10308;191557;216;0;0;0;0;.00nan;0;0
10520;169166;226;64;28;4;24;.857;3600000;0
10520;175370;199;33;4;2;2;.500;1149000;0
10520;192629;226;0;0;0;0;.00nan;0;0
10520;161006;199;27;30;6;24;.800;2451000;0
10301;184175;224;83;41;3;38;.927;3552000;0
10301;189885;225;70;24;2;22;.917;3600000;0
10301;184785;225;0;0;0;0;.00nan;0;0
10301;185840;224;0;0;0;0;.00nan;0;0
10385;171839;189;0;0;0;0;.00nan;0;0
10385;169096;190;0;0;0;0;.00nan;0;0
10385;-1;189;86;41;3;38;.927;3520000;0
10385;197704;190;87;26;1;25;.962;3600000;0
10332;-1;221;35;24;4;20;.833;3600000;0
10332;184610;222;100;38;1;37;.974;3600000;0
10332;185851;222;0;0;0;0;.00nan;0;0
10332;187362;221;0;0;0;0;.00nan;0;0
10322;176938;180;50;26;3;23;.885;3561000;0
10322;181065;219;0;0;0;0;.00nan;0;0
10322;181102;219;82;25;1;24;.960;3600000;0
10322;-1;180;0;0;0;0;.00nan;0;0
10354;171405;2620;63;28;3;25;.893;3845000;0
10354;171662;176;0;0;0;0;.00nan;0;0
10354;176932;176;85;41;2;39;.951;3835000;0
10354;-1;2620;0;0;0;0;.00nan;0;0
10347;166762;213;0;0;0;0;.00nan;0;0
10347;174147;179;82;13;0;13;1.000;3600000;0
10347;180575;213;92;52;3;49;.942;3600000;0
10347;187355;179;0;0;0;0;.00nan;0;0
10470;192862;187;48;0;0;0;.00nan;453000;0
10470;189081;187;60;37;5;32;.865;3147000;0
10470;176200;195;70;30;2;28;.933;3600000;0
10470;179647;195;0;0;0;0;.00nan;0;0
10324;170114;4959;51;26;4;22;.846;3600000;0
10324;195363;4959;0;0;0;0;.00nan;0;0
10324;179169;209;0;0;0;0;.00nan;0;0
10324;186205;209;56;45;7;38;.844;3600000;0
10429;184069;208;70;32;3;29;.906;3600000;0
10429;179702;208;0;0;0;0;.00nan;0;0
10429;180623;202;0;0;0;0;.00nan;0;0
10429;192498;202;71;40;4;36;.900;3576000;0
10300;166545;193;78;35;2;33;.943;3600000;0
10300;179197;198;0;0;0;0;.00nan;0;0
10300;181431;198;35;39;7;32;.821;3600000;0
10300;186451;193;0;0;0;0;.00nan;0;0
10399;178394;188;0;0;0;0;.00nan;0;0
10399;170351;194;100;38;2;36;.947;3600000;0
10399;174153;188;51;29;4;25;.862;3533000;0
10399;196352;194;0;0;0;0;.00nan;0;0
10425;168907;186;0;0;0;0;.00nan;0;0
10425;169226;186;67;28;3;25;.893;3561000;0
10425;179679;212;0;0;0;0;.00nan;0;0
10425;186641;212;67;19;1;18;.947;3600000;0
10372;168117;192;63;25;2;23;.920;3600000;0
10372;-1;196;57;18;2;16;.889;1392000;0
10372;184648;196;22;22;6;16;.727;2208000;0
10372;-1;192;0;0;0;0;.00nan;0;0
10460;182467;185;88;36;2;34;.944;3600000;0
10460;-1;1371;0;0;0;0;.00nan;0;0
10460;180110;185;0;0;0;0;.00nan;0;0
10460;192688;1371;100;32;1;31;.969;3600000;0
10397;166762;213;100;58;2;56;.966;3600000;0
10397;-1;210;50;20;3;17;.850;3567000;0
10397;180575;213;0;0;0;0;.00nan;0;0
10397;192461;210;0;0;0;0;.00nan;0;0
10344;179400;183;0;0;0;0;.00nan;0;0
10344;179602;177;100;31;0;31;1.000;3600000;0
10344;176672;177;0;0;0;0;.00nan;0;0
10344;182089;183;98;39;1;38;.974;3567000;0
10382;171730;220;70;27;2;25;.926;3900000;0
10382;180578;181;0;0;0;0;.00nan;0;0
10382;-1;181;73;27;2;25;.926;3900000;0
10382;187443;220;0;0;0;0;.00nan;0;0
10361;-1;227;79;34;2;32;.941;3600000;0
10361;179406;232;55;25;3;22;.880;3590000;0
10361;179434;232;0;0;0;0;.00nan;0;0
10361;187217;227;0;0;0;0;.00nan;0;0
10363;195164;218;0;0;0;0;.00nan;0;0
10363;190034;217;51;3;0;3;1.000;416000;0
10363;190041;217;11;28;8;20;.714;3184000;0
10363;192457;218;75;30;3;27;.900;3600000;0
10380;171835;4960;37;19;4;15;.789;906000;0
10380;194219;4960;56;24;3;21;.875;2694000;0
10380;-1;221;67;41;4;37;.902;3600000;0
10380;187362;221;0;0;0;0;.00nan;0;0
10337;179388;182;0;0;0;0;.00nan;0;0
10337;190125;184;50;32;5;27;.844;3600000;0
10337;179668;184;0;0;0;0;.00nan;0;0
10337;182116;182;90;36;2;34;.944;3600000;0
10316;-1;4949;90;36;2;34;.944;3600000;0
10316;195251;4949;0;0;0;0;.00nan;0;0
10316;187240;216;0;0;0;0;.00nan;0;0
10316;191557;216;65;29;3;26;.897;3554000;0
10364;189902;204;0;0;0;0;.00nan;0;0
10364;-1;207;65;36;3;33;.917;3727000;0
10364;182049;204;75;38;4;34;.895;3727000;0
10364;-1;207;0;0;0;0;.00nan;0;0
10528;169166;226;0;0;0;0;.00nan;0;0
10528;195238;200;0;0;0;0;.00nan;0;0
10528;187295;200;76;39;3;36;.923;3582000;0
10528;192629;226;65;18;1;17;.944;3600000;0
10543;171835;4960;98;32;1;31;.969;3900000;0
10543;194219;4960;0;0;0;0;.00nan;0;0
10543;175423;223;88;26;1;25;.962;3900000;0
10543;187118;223;0;0;0;0;.00nan;0;0
11532;177248;201;51;15;2;13;.867;3600000;0
11532;195238;200;74;39;3;36;.923;3549000;0
11532;185743;201;0;0;0;0;.00nan;0;0
11532;187295;200;0;0;0;0;.00nan;0;0
10499;-1;210;0;0;0;0;.00nan;0;0
10499;179400;183;64;42;4;38;.905;3600000;0
10499;182089;183;0;0;0;0;.00nan;0;0
10499;192461;210;99;37;1;36;.973;3600000;0
11436;182454;4864;0;0;0;0;.00nan;0;0
11436;183737;4864;80;11;0;11;1.000;3600000;0
11436;171662;176;0;0;0;0;.00nan;0;0
11436;176932;176;80;44;3;41;.932;3600000;0
10309;173340;231;0;0;0;0;.00nan;0;0
10309;189885;225;30;18;4;14;.778;1165000;0
10309;184785;225;59;22;2;20;.909;2435000;0
10309;185034;231;65;26;2;24;.923;3600000;0
11633;189902;204;100;34;0;34;1.000;3600000;0
11633;182049;204;0;0;0;0;.00nan;0;0
11633;-1;205;75;28;2;26;.929;3551000;0
11633;187092;205;0;0;0;0;.00nan;0;0
10356;167404;215;0;0;0;0;.00nan;0;0
10356;165731;215;90;35;1;34;.971;3600000;0
10356;195164;218;60;28;3;25;.893;3600000;0
10356;192457;218;0;0;0;0;.00nan;0;0
10339;171405;2620;44;20;3;17;.850;3575000;0
10339;179169;209;84;41;2;39;.951;3600000;0
10339;-1;2620;0;0;0;0;.00nan;0;0
10339;186205;209;0;0;0;0;.00nan;0;0
10401;184610;222;0;0;0;0;.00nan;0;0
10401;179406;232;0;0;0;0;.00nan;0;0
10401;179434;232;95;35;1;34;.971;3600000;0
10401;185851;222;41;30;5;25;.833;3600000;0
11595;169096;190;46;36;5;31;.861;3580000;0
11595;174325;197;53;30;4;26;.867;3600000;0
11595;175436;197;0;0;0;0;.00nan;0;0
11595;197704;190;0;0;0;0;.00nan;0;0
10431;177248;201;0;0;0;0;.00nan;0;0
10431;175364;206;49;28;4;24;.857;3562000;0
10431;196283;206;0;0;0;0;.00nan;0;0
10431;185743;201;83;35;2;33;.943;3600000;0
10326;174147;179;0;0;0;0;.00nan;0;0
10326;187240;216;77;35;3;32;.914;3600000;0
10326;187355;179;44;37;5;32;.865;3600000;0
10326;191557;216;0;0;0;0;.00nan;0;0
10325;192862;187;51;34;5;29;.853;3724000;0
10325;189081;187;0;0;0;0;.00nan;0;0
10325;179197;198;0;0;0;0;.00nan;0;0
10325;181431;198;32;28;6;22;.786;3724000;0
10315;171730;220;61;27;3;24;.889;3783000;0
10315;180578;181;0;0;0;0;.00nan;0;0
10315;-1;181;93;45;2;43;.956;3783000;0
10315;187443;220;0;0;0;0;.00nan;0;0
10415;182467;185;0;0;0;0;.00nan;0;0
10415;-1;1371;75;17;0;17;1.000;3038000;0
10415;180110;185;87;46;4;42;.913;3600000;0
10415;192688;1371;30;6;3;3;.500;562000;0
10427;190125;184;0;0;0;0;.00nan;0;0
10427;179668;184;65;27;3;24;.889;3600000;0
10427;-1;214;63;40;4;36;.900;3547000;0
10427;191518;214;0;0;0;0;.00nan;0;0
10420;184069;208;0;0;0;0;.00nan;0;0
10420;179702;208;100;26;0;26;1.000;3600000;0
10420;-1;205;0;0;0;0;.00nan;0;0
10420;187092;205;60;30;3;27;.900;3600000;0
10319;184175;224;67;38;4;34;.895;3658000;0
10319;189885;225;73;32;3;29;.906;3658000;0
10319;184785;225;0;0;0;0;.00nan;0;0
10319;185840;224;0;0;0;0;.00nan;0;0
10407;166762;213;0;0;0;0;.00nan;0;0
10407;179602;177;79;13;0;13;1.000;3600000;0
10407;176672;177;0;0;0;0;.00nan;0;0
10407;180575;213;79;27;1;26;.963;3568000;0
10349;166545;193;57;15;1;14;.933;3600000;0
10349;169096;190;0;0;0;0;.00nan;0;0
10349;186451;193;0;0;0;0;.00nan;0;0
10349;197704;190;77;41;3;38;.927;3513000;0
10310;-1;211;50;37;6;31;.838;3600000;0
10310;179646;211;0;0;0;0;.00nan;0;0
10310;176938;180;69;28;2;26;.929;3600000;0
10310;-1;180;0;0;0;0;.00nan;0;0
10373;182454;4864;0;0;0;0;.00nan;0;0
10373;183737;4864;98;18;0;18;1.000;3600000;0
10373;171662;176;70;46;4;42;.913;3600000;0
10373;176932;176;0;0;0;0;.00nan;0;0
10351;170114;4959;86;37;2;35;.946;3600000;0
10351;195363;4959;0;0;0;0;.00nan;0;0
10351;171405;2620;0;0;0;0;.00nan;0;0
10351;-1;2620;25;22;5;17;.773;3600000;0
10468;167404;215;37;44;7;37;.841;3247000;0
10468;165731;215;49;2;0;2;1.000;353000;0
10468;181065;219;69;36;4;32;.889;3600000;0
10468;181102;219;0;0;0;0;.00nan;0;0
10294;190034;217;57;29;4;25;.862;3600000;0
10294;190041;217;0;0;0;0;.00nan;0;0
10294;179679;212;0;0;0;0;.00nan;0;0
10294;186641;212;86;23;1;22;.957;3600000;0
10532;194416;191;0;0;0;0;.00nan;0;0
10532;178394;188;97;44;2;42;.955;3600000;0
10532;194893;191;71;23;1;22;.957;3600000;0
10532;174153;188;0;0;0;0;.00nan;0;0
10408;-1;227;71;45;5;40;.889;3600000;0
10408;181338;230;0;0;0;0;.00nan;0;0
10408;186495;230;86;15;0;15;1.000;3600000;0
10408;187217;227;0;0;0;0;.00nan;0;0
10527;171839;189;0;0;0;0;.00nan;0;0
10527;-1;189;84;49;4;45;.918;3600000;0
10527;176200;195;100;25;0;25;1.000;3600000;0
10527;179647;195;0;0;0;0;.00nan;0;0
10353;-1;207;0;0;0;0;.00nan;0;0
10353;180623;202;0;0;0;0;.00nan;0;0
10353;-1;207;66;44;5;39;.886;3512000;0
10353;192498;202;70;30;3;27;.900;3600000;0
10450;168954;228;90;36;3;33;.917;3900000;0
10450;175354;228;0;0;0;0;.00nan;0;0
10450;179430;229;0;0;0;0;.00nan;0;0
10450;185800;229;84;38;3;35;.921;3900000;0
10403;-1;203;63;29;3;26;.897;3600000;0
10403;175370;199;81;49;5;44;.898;3600000;0
10403;-1;203;0;0;0;0;.00nan;0;0
10403;161006;199;0;0;0;0;.00nan;0;0
10343;-1;221;35;29;5;24;.828;3573000;0
10343;184610;222;75;33;3;30;.909;3600000;0
10343;185851;222;0;0;0;0;.00nan;0;0
10343;187362;221;0;0;0;0;.00nan;0;0
10502;-1;4949;88;24;1;23;.958;3600000;0
10502;195251;4949;0;0;0;0;.00nan;0;0
10502;174209;178;85;39;2;37;.949;3576000;0
10502;-1;178;0;0;0;0;.00nan;0;0
10598;179430;229;74;49;4;45;.918;3600000;0
10598;181338;230;0;0;0;0;.00nan;0;0
10598;185800;229;0;0;0;0;.00nan;0;0
10598;186495;230;70;20;1;19;.950;3600000;0
10584;171839;189;0;0;0;0;.00nan;0;0
10584;-1;189;97;55;4;51;.927;3600000;0
10584;176200;195;77;23;1;22;.957;3600000;0
10584;179647;195;0;0;0;0;.00nan;0;0
10627;174209;178;0;0;0;0;.00nan;0;0
10627;179400;183;0;0;0;0;.00nan;0;0
10627;182089;183;82;52;4;48;.923;3900000;0
10627;-1;178;56;34;4;30;.882;3900000;0
10480;-1;4949;0;0;0;0;.00nan;0;0
10480;195251;4949;52;24;3;21;.875;3600000;0
10480;179602;177;73;36;4;32;.889;3600000;0
10480;176672;177;0;0;0;0;.00nan;0;0
10442;192862;187;0;0;0;0;.00nan;0;0
10442;168117;192;0;0;0;0;.00nan;0;0
10442;189081;187;80;40;3;37;.925;3668000;0
10442;-1;192;78;30;2;28;.933;3668000;0
10358;174147;179;68;42;4;38;.905;3536000;0
10358;180762;1505;0;0;0;0;.00nan;0;0
10358;186549;1505;58;17;2;15;.882;3600000;0
10358;187355;179;0;0;0;0;.00nan;0;0
10365;168907;186;0;0;0;0;.00nan;0;0
10365;169226;186;38;35;6;29;.829;3560000;0
10365;176938;180;61;33;5;28;.848;3600000;0
10365;-1;180;0;0;0;0;.00nan;0;0
10422;170114;4959;0;0;0;0;.00nan;0;0
10422;195363;4959;59;19;2;17;.895;3600000;0
10422;179169;209;0;0;0;0;.00nan;0;0
10422;186205;209;58;45;5;40;.889;3600000;0
10341;171730;220;0;0;0;0;.00nan;0;0
10341;190125;184;51;31;4;27;.871;3600000;0
10341;179668;184;0;0;0;0;.00nan;0;0
10341;187443;220;91;33;1;32;.970;3600000;0
10391;173340;231;72;21;2;19;.905;3600000;0
10391;175423;223;0;0;0;0;.00nan;0;0
10391;185034;231;0;0;0;0;.00nan;0;0
10391;187118;223;44;33;5;28;.848;3600000;0
10394;169166;226;29;15;4;11;.733;1148000;0
10394;-1;207;53;34;5;29;.853;3875000;0
10394;-1;207;0;0;0;0;.00nan;0;0
10394;192629;226;74;22;0;22;1.000;2727000;0
10370;166545;193;0;0;0;0;.00nan;0;0
10370;174325;197;99;44;2;42;.955;3900000;0
10370;175436;197;0;0;0;0;.00nan;0;0
10370;186451;193;35;7;2;5;.714;3900000;0
11672;166762;213;87;34;2;32;.941;3565000;0
11672;-1;210;93;28;1;27;.964;3600000;0
11672;180575;213;0;0;0;0;.00nan;0;0
11672;192461;210;0;0;0;0;.00nan;0;0
10400;189902;204;0;0;0;0;.00nan;0;0
10400;180623;202;48;31;4;27;.871;3514000;0
10400;182049;204;88;44;2;42;.955;3600000;0
10400;192498;202;0;0;0;0;.00nan;0;0
10767;179388;182;0;0;0;0;.00nan;0;0
10767;182116;182;87;33;3;30;.909;3900000;0
10767;-1;214;0;0;0;0;.00nan;0;0
10767;191518;214;77;34;3;31;.912;3900000;0
10930;195238;200;0;0;0;0;.00nan;0;0
10930;175364;206;0;0;0;0;.00nan;0;0
10930;196283;206;68;23;2;21;.913;3900000;0
10930;187295;200;81;33;2;31;.939;3900000;0
10383;178394;188;49;1;0;1;1.000;268000;0
10383;174153;188;76;60;6;54;.900;3332000;0
10383;179197;198;77;19;1;18;.947;3600000;0
10383;181431;198;0;0;0;0;.00nan;0;0
10384;170351;194;97;33;1;32;.970;3600000;0
10384;-1;196;0;0;0;0;.00nan;0;0
10384;184648;196;93;18;0;18;1.000;3600000;0
10384;196352;194;0;0;0;0;.00nan;0;0
10432;195164;218;52;10;1;9;.900;1641000;0
10432;179679;212;46;27;5;22;.815;3600000;0
10432;186641;212;0;0;0;0;.00nan;0;0
10432;192457;218;21;24;6;18;.750;1888000;0
10428;-1;1371;0;0;0;0;.00nan;0;0
10428;180578;181;54;25;3;22;.880;3900000;0
10428;-1;181;0;0;0;0;.00nan;0;0
10428;192688;1371;84;37;3;34;.919;3900000;0
11584;195164;218;0;0;0;0;.00nan;0;0
11584;190034;217;38;32;6;26;.813;3600000;0
11584;190041;217;0;0;0;0;.00nan;0;0
11584;192457;218;72;27;3;24;.889;3600000;0
10390;184175;224;49;38;5;33;.868;3535000;0
10390;175423;223;88;38;3;35;.921;3600000;0
10390;185840;224;0;0;0;0;.00nan;0;0
10390;187118;223;0;0;0;0;.00nan;0;0
10387;177248;201;0;0;0;0;.00nan;0;0
10387;-1;203;64;25;2;23;.920;3551000;0
10387;-1;203;0;0;0;0;.00nan;0;0
10387;185743;201;94;30;1;29;.967;3600000;0
11609;-1;221;55;31;3;28;.903;3900000;0
11609;184610;222;100;49;3;46;.939;3900000;0
11609;185851;222;0;0;0;0;.00nan;0;0
11609;187362;221;0;0;0;0;.00nan;0;0
11668;171405;2620;54;24;4;20;.833;3600000;0
11668;179169;209;44;35;5;30;.857;3553000;0
11668;-1;2620;0;0;0;0;.00nan;0;0
11668;186205;209;0;0;0;0;.00nan;0;0
10454;184069;208;76;30;1;29;.967;3600000;0
10454;175370;199;0;0;0;0;.00nan;0;0
10454;179702;208;0;0;0;0;.00nan;0;0
10454;161006;199;69;38;4;34;.895;3600000;0
10417;173340;231;0;0;0;0;.00nan;0;0
10417;-1;227;33;10;3;7;.700;497000;0
10417;185034;231;84;24;1;23;.958;3600000;0
10417;187217;227;63;31;3;28;.903;3103000;0
10362;-1;211;67;37;3;34;.919;3556000;0
10362;168907;186;77;25;1;24;.960;3600000;0
10362;169226;186;0;0;0;0;.00nan;0;0
10362;179646;211;0;0;0;0;.00nan;0;0
11109;167404;215;100;31;0;31;1.000;3600000;0
11109;165731;215;0;0;0;0;.00nan;0;0
11109;181065;219;0;0;0;0;.00nan;0;0
11109;181102;219;62;30;3;27;.900;3600000;0
10632;182454;4864;0;0;0;0;.00nan;0;0
10632;183737;4864;80;24;1;23;.958;3600000;0
10632;171662;176;0;0;0;0;.00nan;0;0
10632;176932;176;81;44;3;41;.932;3600000;0
10414;169096;190;84;25;1;24;.960;3900000;0
10414;174325;197;0;0;0;0;.00nan;0;0
10414;175436;197;89;34;1;33;.971;3900000;0
10414;197704;190;0;0;0;0;.00nan;0;0
10706;194416;191;44;14;3;11;.786;3532000;0
10706;194893;191;0;0;0;0;.00nan;0;0
10706;-1;196;0;0;0;0;.00nan;0;0
10706;184648;196;99;42;1;41;.976;3600000;0
10505;168954;228;71;29;2;27;.931;3584000;0
10505;179406;232;71;21;1;20;.952;3600000;0
10505;175354;228;0;0;0;0;.00nan;0;0
10505;179434;232;0;0;0;0;.00nan;0;0
11388;-1;1371;0;0;0;0;.00nan;0;0
11388;180578;181;0;0;0;0;.00nan;0;0
11388;-1;181;78;43;3;40;.930;3600000;0
11388;192688;1371;62;17;2;15;.882;3600000;0
11583;179679;212;0;0;0;0;.00nan;0;0
11583;181065;219;77;25;1;24;.960;3600000;0
11583;181102;219;0;0;0;0;.00nan;0;0
11583;186641;212;69;32;3;29;.906;3554000;0
11592;179400;183;83;31;1;30;.968;3600000;0
11592;179602;177;89;35;2;33;.943;3550000;0
11592;176672;177;0;0;0;0;.00nan;0;0
11592;182089;183;0;0;0;0;.00nan;0;0
11524;184175;224;44;18;3;15;.833;1537000;0
11524;181338;230;0;0;0;0;.00nan;0;0
11524;185840;224;65;41;5;36;.878;2063000;0
11524;186495;230;52;10;1;9;.900;3600000;0
11456;171730;220;74;30;3;27;.900;3600000;0
11456;187443;220;0;0;0;0;.00nan;0;0
11456;-1;214;54;39;5;34;.872;3570000;0
11456;191518;214;0;0;0;0;.00nan;0;0
10481;-1;210;0;0;0;0;.00nan;0;0
10481;180762;1505;73;25;2;23;.920;3600000;0
10481;186549;1505;0;0;0;0;.00nan;0;0
10481;192461;210;49;29;4;25;.862;3545000;0
11669;182467;185;96;33;1;32;.970;3600000;0
11669;190125;184;71;31;3;28;.903;3516000;0
11669;179668;184;0;0;0;0;.00nan;0;0
11669;180110;185;0;0;0;0;.00nan;0;0
11545;166545;193;80;31;1;30;.968;3600000;0
11545;176200;195;48;46;6;40;.870;3600000;0
11545;179647;195;0;0;0;0;.00nan;0;0
11545;186451;193;0;0;0;0;.00nan;0;0
11679;175364;206;100;38;1;37;.974;3600000;0
11679;175370;199;44;23;4;19;.826;3600000;0
11679;196283;206;0;0;0;0;.00nan;0;0
11679;161006;199;0;0;0;0;.00nan;0;0
10435;177248;201;97;45;2;43;.956;3574000;0
10435;189902;204;0;0;0;0;.00nan;0;0
10435;182049;204;88;28;1;27;.964;3600000;0
10435;185743;201;0;0;0;0;.00nan;0;0
10405;-1;203;0;0;0;0;.00nan;0;0
10405;-1;203;88;35;2;33;.943;3600000;0
10405;-1;205;97;30;0;30;1.000;3600000;0
10405;187092;205;0;0;0;0;.00nan;0;0
10433;171405;2620;63;15;1;14;.933;3600000;0
10433;179169;209;0;0;0;0;.00nan;0;0
10433;-1;2620;0;0;0;0;.00nan;0;0
10433;186205;209;61;41;5;36;.878;3600000;0
10708;171835;4960;65;30;3;27;.900;3798000;0
10708;194219;4960;0;0;0;0;.00nan;0;0
10708;181338;230;0;0;0;0;.00nan;0;0
10708;186495;230;67;35;4;31;.886;3798000;0
10521;166762;213;0;0;0;0;.00nan;0;0
10521;-1;4949;38;25;5;20;.800;3600000;0
10521;195251;4949;0;0;0;0;.00nan;0;0
10521;180575;213;32;30;6;24;.800;3600000;0
10589;184069;208;54;3;0;3;1.000;304000;0
10589;169166;226;77;35;3;32;.914;3600000;0
10589;179702;208;24;37;7;30;.811;3296000;0
10589;192629;226;0;0;0;0;.00nan;0;0
10367;179602;177;0;0;0;0;.00nan;0;0
10367;176672;177;88;46;3;43;.935;3900000;0
10367;187240;216;51;18;3;15;.833;3900000;0
10367;191557;216;0;0;0;0;.00nan;0;0
11612;173340;231;51;23;3;20;.870;3638000;0
11612;-1;227;69;26;2;24;.923;3638000;0
11612;185034;231;0;0;0;0;.00nan;0;0
11612;187217;227;0;0;0;0;.00nan;0;0
10547;175423;223;0;0;0;0;.00nan;0;0
10547;179430;229;0;0;0;0;.00nan;0;0
10547;185800;229;87;26;1;25;.962;3600000;0
10547;187118;223;44;34;5;29;.853;3600000;0
10423;195238;200;0;0;0;0;.00nan;0;0
10423;-1;207;0;0;0;0;.00nan;0;0
10423;187295;200;96;56;3;53;.946;3900000;0
10423;-1;207;72;38;3;35;.921;3900000;0
10410;167404;215;31;26;5;21;.808;3600000;0
10410;165731;215;0;0;0;0;.00nan;0;0
10410;176938;180;79;33;2;31;.939;3600000;0
10410;-1;180;0;0;0;0;.00nan;0;0
10395;-1;221;68;25;2;23;.920;3600000;0
10395;189885;225;82;34;3;31;.912;3552000;0
10395;184785;225;0;0;0;0;.00nan;0;0
10395;187362;221;0;0;0;0;.00nan;0;0
10418;171839;189;0;0;0;0;.00nan;0;0
10418;170351;194;0;0;0;0;.00nan;0;0
10418;-1;189;59;38;5;33;.868;3547000;0
10418;196352;194;56;27;3;24;.889;3600000;0
11457;182454;4864;0;0;0;0;.00nan;0;0
11457;183737;4864;89;16;0;16;1.000;3600000;0
11457;171662;176;60;50;6;44;.880;3233000;0
11457;176932;176;44;4;1;3;.750;367000;0
10513;192862;187;73;25;2;23;.920;3562000;0
10513;189081;187;0;0;0;0;.00nan;0;0
10513;178394;188;57;12;1;11;.917;3600000;0
10513;174153;188;0;0;0;0;.00nan;0;0
10483;174209;178;48;40;6;34;.850;2576000;0
10483;180762;1505;0;0;0;0;.00nan;0;0
10483;186549;1505;75;19;1;18;.947;3600000;0
10483;-1;178;62;17;1;16;.941;1024000;0
10463;190125;184;0;0;0;0;.00nan;0;0
10463;179668;184;76;18;1;17;.944;3600000;0
10463;-1;214;53;12;1;11;.917;1276000;0
10463;191518;214;20;27;6;21;.778;2324000;0
11675;-1;196;0;0;0;0;.00nan;0;0
11675;174325;197;53;40;5;35;.875;3600000;0
11675;184648;196;69;7;0;7;1.000;3600000;0
11675;175436;197;0;0;0;0;.00nan;0;0
10438;177248;201;0;0;0;0;.00nan;0;0
10438;175364;206;60;27;3;24;.889;3545000;0
10438;196283;206;0;0;0;0;.00nan;0;0
10438;185743;201;79;33;2;31;.939;3600000;0
11188;169166;226;0;0;0;0;.00nan;0;0
11188;195238;200;56;44;6;38;.864;3600000;0
11188;187295;200;0;0;0;0;.00nan;0;0
11188;192629;226;52;31;4;27;.871;3600000;0
10402;-1;211;62;25;2;23;.920;3566000;0
10402;168907;186;0;0;0;0;.00nan;0;0
10402;169226;186;65;16;1;15;.938;3600000;0
10402;179646;211;0;0;0;0;.00nan;0;0
10482;175370;199;0;0;0;0;.00nan;0;0
10482;180623;202;0;0;0;0;.00nan;0;0
10482;192498;202;62;31;3;28;.903;3547000;0
10482;161006;199;93;37;1;36;.973;3600000;0
10378;166545;193;100;35;0;35;1.000;3600000;0
10378;168117;192;0;0;0;0;.00nan;0;0
10378;-1;192;69;29;2;27;.931;3529000;0
10378;186451;193;0;0;0;0;.00nan;0;0
10511;182454;4864;0;0;0;0;.00nan;0;0
10511;183737;4864;79;13;0;13;1.000;3600000;0
10511;179169;209;49;42;6;36;.857;3600000;0
10511;186205;209;0;0;0;0;.00nan;0;0
10381;195164;218;0;0;0;0;.00nan;0;0
10381;176938;180;0;0;0;0;.00nan;0;0
10381;-1;180;66;23;2;21;.913;3600000;0
10381;192457;218;59;31;4;27;.871;3600000;0
10546;171835;4960;0;0;0;0;.00nan;0;0
10546;194219;4960;100;32;0;32;1.000;3600000;0
10546;168954;228;48;44;6;38;.864;2806000;0
10546;175354;228;55;4;0;4;1.000;794000;0
10439;179388;182;0;0;0;0;.00nan;0;0
10439;180578;181;0;0;0;0;.00nan;0;0
10439;182116;182;25;32;7;25;.781;3600000;0
10439;-1;181;48;19;3;16;.842;3600000;0
10396;171405;2620;0;0;0;0;.00nan;0;0
10396;171662;176;0;0;0;0;.00nan;0;0
10396;176932;176;29;34;6;28;.824;3600000;0
10396;-1;2620;64;14;1;13;.929;3600000;0
10440;170351;194;56;26;3;23;.885;3900000;0
10440;-1;196;0;0;0;0;.00nan;0;0
10440;184648;196;67;33;3;30;.909;3900000;0
10440;196352;194;0;0;0;0;.00nan;0;0
10479;171839;189;0;0;0;0;.00nan;0;0
10479;179197;198;83;36;2;34;.944;3600000;0
10479;-1;189;56;38;5;33;.868;3600000;0
10479;181431;198;0;0;0;0;.00nan;0;0
10693;184610;222;40;12;3;9;.750;3600000;0
10693;179406;232;49;35;5;30;.857;3600000;0
10693;179434;232;0;0;0;0;.00nan;0;0
10693;185851;222;0;0;0;0;.00nan;0;0
10537;192862;187;0;0;0;0;.00nan;0;0
10537;189081;187;70;17;1;16;.941;3600000;0
10537;174325;197;40;8;2;6;.750;413000;0
10537;175436;197;39;32;6;26;.813;3187000;0
10393;171730;220;81;30;1;29;.967;3900000;0
10393;-1;1371;100;47;1;46;.979;3900000;0
10393;187443;220;0;0;0;0;.00nan;0;0
10393;192688;1371;0;0;0;0;.00nan;0;0
10419;-1;203;53;34;4;30;.882;3600000;0
10419;189902;204;55;37;5;32;.865;3585000;0
10419;-1;203;0;0;0;0;.00nan;0;0
10419;182049;204;0;0;0;0;.00nan;0;0
10421;173340;231;0;0;0;0;.00nan;0;0
10421;189885;225;0;0;0;0;.00nan;0;0
10421;184785;225;84;36;2;34;.944;3600000;0
10421;185034;231;82;23;1;22;.957;3600000;0
10485;174147;179;0;0;0;0;.00nan;0;0
10485;179400;183;46;5;1;4;.800;796000;0
10485;182089;183;39;35;6;29;.829;2804000;0
10485;187355;179;54;21;3;18;.857;3600000;0
10723;194416;191;0;0;0;0;.00nan;0;0
10723;169096;190;86;50;3;47;.940;3600000;0
10723;194893;191;76;18;1;17;.944;3600000;0
10723;197704;190;0;0;0;0;.00nan;0;0
10747;190034;217;30;26;5;21;.808;3520000;0
10747;190041;217;0;0;0;0;.00nan;0;0
10747;181065;219;0;0;0;0;.00nan;0;0
10747;181102;219;75;38;3;35;.921;3600000;0
10459;167404;215;0;0;0;0;.00nan;0;0
10459;165731;215;92;47;2;45;.957;3900000;0
10459;179679;212;0;0;0;0;.00nan;0;0
10459;186641;212;55;20;2;18;.900;3870000;0
10368;174209;178;0;0;0;0;.00nan;0;0
10368;187240;216;0;0;0;0;.00nan;0;0
10368;191557;216;92;32;2;30;.938;3600000;0
10368;-1;178;63;27;3;24;.889;3598000;0
10491;184175;224;67;49;5;44;.898;3560000;0
10491;-1;227;0;0;0;0;.00nan;0;0
10491;185840;224;0;0;0;0;.00nan;0;0
10491;187217;227;73;36;4;32;.889;3600000;0
10507;-1;207;88;35;2;33;.943;3523000;0
10507;-1;205;100;29;0;29;1.000;3600000;0
10507;187092;205;0;0;0;0;.00nan;0;0
10507;-1;207;0;0;0;0;.00nan;0;0
10484;182467;185;58;27;3;24;.889;3600000;0
10484;179388;182;0;0;0;0;.00nan;0;0
10484;180110;185;0;0;0;0;.00nan;0;0
10484;182116;182;71;24;2;22;.917;3600000;0
10386;166545;193;77;30;2;28;.933;3600000;0
10386;194416;191;0;0;0;0;.00nan;0;0
10386;194893;191;57;28;3;25;.893;3555000;0
10386;186451;193;0;0;0;0;.00nan;0;0
10488;-1;4949;82;35;3;32;.914;3600000;0
10488;195251;4949;0;0;0;0;.00nan;0;0
10488;180762;1505;75;25;1;24;.960;3600000;0
10488;186549;1505;0;0;0;0;.00nan;0;0
10607;168954;228;0;0;0;0;.00nan;0;0
10607;175354;228;100;39;0;39;1.000;3600000;0
10607;179430;229;0;0;0;0;.00nan;0;0
10607;185800;229;66;25;2;23;.920;3581000;0
10531;-1;211;0;0;0;0;.00nan;0;0
10531;195164;218;62;33;3;30;.909;3754000;0
10531;179646;211;52;36;4;32;.889;3754000;0
10531;192457;218;0;0;0;0;.00nan;0;0
10827;179400;183;98;55;2;53;.964;3900000;0
10827;179602;177;65;21;2;19;.905;3900000;0
10827;176672;177;0;0;0;0;.00nan;0;0
10827;182089;183;0;0;0;0;.00nan;0;0
10539;174209;178;68;25;2;23;.920;3560000;0
10539;179602;177;0;0;0;0;.00nan;0;0
10539;176672;177;97;39;1;38;.974;3600000;0
10539;-1;178;0;0;0;0;.00nan;0;0
10456;174147;179;82;35;1;34;.971;3600000;0
10456;-1;210;0;0;0;0;.00nan;0;0
10456;187355;179;0;0;0;0;.00nan;0;0
10456;192461;210;100;27;0;27;1.000;3600000;0
10758;178394;188;0;0;0;0;.00nan;0;0
10758;174153;188;75;31;2;29;.935;3513000;0
10758;-1;196;0;0;0;0;.00nan;0;0
10758;184648;196;100;32;0;32;1.000;3600000;0
10503;-1;1371;0;0;0;0;.00nan;0;0
10503;190125;184;73;36;3;33;.917;3559000;0
10503;179668;184;0;0;0;0;.00nan;0;0
10503;192688;1371;84;38;2;36;.947;3600000;0
10494;171662;176;74;34;3;31;.912;3581000;0
10494;179169;209;0;0;0;0;.00nan;0;0
10494;176932;176;0;0;0;0;.00nan;0;0
10494;186205;209;94;31;1;30;.968;3600000;0
10434;175364;206;99;49;2;47;.959;3600000;0
10434;196283;206;0;0;0;0;.00nan;0;0
10434;-1;205;45;18;3;15;.833;3555000;0
10434;187092;205;0;0;0;0;.00nan;0;0
11492;179406;232;16;21;6;15;.714;1958000;0
11492;179434;232;50;12;2;10;.833;1642000;0
11492;181338;230;0;0;0;0;.00nan;0;0
11492;186495;230;69;20;1;19;.950;3600000;0
10447;175370;199;0;0;0;0;.00nan;0;0
10447;-1;207;41;8;2;6;.750;328000;0
10447;-1;207;43;38;6;32;.842;3272000;0
10447;161006;199;72;24;2;22;.917;3600000;0
10413;168907;186;0;0;0;0;.00nan;0;0
10413;169226;186;52;31;4;27;.871;3597000;0
10413;176938;180;83;34;3;31;.912;3600000;0
10413;-1;180;0;0;0;0;.00nan;0;0
10551;184175;224;96;36;1;35;.972;3600000;0
10551;184610;222;82;47;5;42;.894;3600000;0
10551;185840;224;0;0;0;0;.00nan;0;0
10551;185851;222;0;0;0;0;.00nan;0;0
10467;170114;4959;68;27;3;24;.889;3600000;0
10467;195363;4959;0;0;0;0;.00nan;0;0
10467;171405;2620;58;36;4;32;.889;3600000;0
10467;-1;2620;0;0;0;0;.00nan;0;0
10411;168117;192;0;0;0;0;.00nan;0;0
10411;170351;194;50;2;0;2;1.000;355000;0
10411;-1;192;72;26;2;24;.923;3600000;0
10411;196352;194;20;22;6;16;.727;3245000;0
10409;184069;208;94;34;2;32;.941;3600000;0
10409;-1;203;98;47;3;44;.936;3600000;0
10409;179702;208;0;0;0;0;.00nan;0;0
10409;-1;203;0;0;0;0;.00nan;0;0
10477;171839;189;0;0;0;0;.00nan;0;0
10477;169096;190;90;31;1;30;.968;3600000;0
10477;-1;189;65;26;2;24;.923;3550000;0
10477;197704;190;0;0;0;0;.00nan;0;0
10441;171730;220;70;29;3;26;.897;3600000;0
10441;187443;220;0;0;0;0;.00nan;0;0
10441;-1;214;47;29;4;25;.862;1809000;0
10441;191518;214;24;18;5;13;.722;1791000;0
10604;-1;227;94;34;1;33;.971;3900000;0
10604;179430;229;66;18;1;17;.944;3900000;0
10604;185800;229;0;0;0;0;.00nan;0;0
10604;187217;227;0;0;0;0;.00nan;0;0
10437;177248;201;0;0;0;0;.00nan;0;0
10437;180623;202;41;28;5;23;.821;3584000;0
10437;185743;201;79;42;4;38;.905;3600000;0
10437;192498;202;0;0;0;0;.00nan;0;0
10519;179679;212;0;0;0;0;.00nan;0;0
10519;181065;219;0;0;0;0;.00nan;0;0
10519;181102;219;86;43;3;40;.930;3900000;0
10519;186641;212;72;35;3;32;.914;3900000;0
10453;182467;185;0;0;0;0;.00nan;0;0
10453;180110;185;88;28;1;27;.964;3600000;0
10453;180578;181;0;0;0;0;.00nan;0;0
10453;-1;181;65;30;3;27;.900;3535000;0
11659;192862;187;100;44;1;43;.977;3600000;0
11659;189081;187;0;0;0;0;.00nan;0;0
11659;179197;198;0;0;0;0;.00nan;0;0
11659;181431;198;46;17;3;14;.824;3536000;0
10376;180762;1505;0;0;0;0;.00nan;0;0
10376;186549;1505;34;32;6;26;.813;3582000;0
10376;187240;216;68;51;5;46;.902;3600000;0
10376;191557;216;0;0;0;0;.00nan;0;0
10530;173340;231;0;0;0;0;.00nan;0;0
10530;175423;223;79;36;3;33;.917;3600000;0
10530;185034;231;100;32;1;31;.969;3600000;0
10530;187118;223;0;0;0;0;.00nan;0;0
10426;-1;221;0;0;0;0;.00nan;0;0
10426;189885;225;42;41;6;35;.854;3600000;0
10426;184785;225;0;0;0;0;.00nan;0;0
10426;187362;221;83;27;1;26;.963;3600000;0
10515;174325;197;98;62;3;59;.952;3600000;0
10515;175436;197;0;0;0;0;.00nan;0;0
10515;176200;195;59;15;2;13;.867;3600000;0
10515;179647;195;0;0;0;0;.00nan;0;0
10587;168954;228;0;0;0;0;.00nan;0;0
10587;175354;228;61;28;3;25;.893;3598000;0
10587;175423;223;0;0;0;0;.00nan;0;0
10587;187118;223;87;31;2;29;.935;3600000;0
10560;195164;218;0;0;0;0;.00nan;0;0
10560;190034;217;0;0;0;0;.00nan;0;0
10560;190041;217;89;31;1;30;.968;3600000;0
10560;192457;218;67;26;2;24;.923;3585000;0
10670;-1;227;0;0;0;0;.00nan;0;0
10670;179406;232;56;26;3;23;.885;3600000;0
10670;179434;232;0;0;0;0;.00nan;0;0
10670;187217;227;40;43;6;37;.860;3600000;0
10443;-1;203;52;26;4;22;.846;3556000;0
10443;175364;206;0;0;0;0;.00nan;0;0
10443;-1;203;0;0;0;0;.00nan;0;0
10443;196283;206;64;27;3;24;.889;3600000;0
11500;194416;191;0;0;0;0;.00nan;0;0
11500;194893;191;66;19;1;18;.947;3600000;0
11500;170351;194;83;39;3;36;.923;3544000;0
11500;196352;194;0;0;0;0;.00nan;0;0
10610;179197;198;78;50;5;45;.900;3582000;0
10610;176200;195;0;0;0;0;.00nan;0;0
10610;179647;195;63;28;3;25;.893;3600000;0
10610;181431;198;0;0;0;0;.00nan;0;0
10430;180578;181;0;0;0;0;.00nan;0;0
10430;-1;181;86;33;1;32;.970;3600000;0
10430;-1;214;61;35;4;31;.886;3600000;0
10430;191518;214;0;0;0;0;.00nan;0;0
10602;195238;200;0;0;0;0;.00nan;0;0
10602;175370;199;75;26;1;25;.962;3600000;0
10602;187295;200;79;36;2;34;.944;3600000;0
10602;161006;199;0;0;0;0;.00nan;0;0
10671;178394;188;47;12;2;10;.833;3600000;0
10671;174153;188;0;0;0;0;.00nan;0;0
10671;-1;196;0;0;0;0;.00nan;0;0
10671;184648;196;58;32;3;29;.906;3582000;0
10905;-1;210;0;0;0;0;.00nan;0;0
10905;179400;183;0;0;0;0;.00nan;0;0
10905;182089;183;72;42;4;38;.905;3600000;0
10905;192461;210;67;19;1;18;.947;3600000;0
10619;189902;204;84;48;5;43;.896;3600000;0
10619;180623;202;0;0;0;0;.00nan;0;0
10619;182049;204;0;0;0;0;.00nan;0;0
10619;192498;202;97;25;0;25;1.000;3600000;0
10490;167404;215;90;34;1;33;.971;3600000;0
10490;165731;215;0;0;0;0;.00nan;0;0
10490;168907;186;53;31;4;27;.871;3600000;0
10490;169226;186;0;0;0;0;.00nan;0;0
10461;168117;192;0;0;0;0;.00nan;0;0
10461;169096;190;0;0;0;0;.00nan;0;0
10461;-1;192;69;19;1;18;.947;3600000;0
10461;197704;190;76;37;3;34;.919;3587000;0
10464;166762;213;0;0;0;0;.00nan;0;0
10464;-1;4949;100;39;0;39;1.000;3600000;0
10464;195251;4949;0;0;0;0;.00nan;0;0
10464;180575;213;46;28;5;23;.821;3600000;0
10544;-1;211;100;31;0;31;1.000;3600000;0
10544;179646;211;0;0;0;0;.00nan;0;0
10544;179679;212;26;14;4;10;.714;1151000;0
10544;186641;212;62;24;2;22;.917;2449000;0
10462;171730;220;0;0;0;0;.00nan;0;0
10462;179388;182;0;0;0;0;.00nan;0;0
10462;182116;182;100;53;3;50;.943;3600000;0
10462;187443;220;48;32;5;27;.844;3574000;0
10496;173340;231;59;29;3;26;.897;3526000;0
10496;-1;221;100;37;1;36;.973;3600000;0
10496;185034;231;0;0;0;0;.00nan;0;0
10496;187362;221;0;0;0;0;.00nan;0;0
10375;166545;193;38;18;4;14;.778;3593000;0
10375;192862;187;0;0;0;0;.00nan;0;0
10375;189081;187;75;37;3;34;.919;3600000;0
10375;186451;193;0;0;0;0;.00nan;0;0
10457;170114;4959;0;0;0;0;.00nan;0;0
10457;195363;4959;78;21;1;20;.952;3600000;0
10457;171662;176;0;0;0;0;.00nan;0;0
10457;176932;176;58;33;4;29;.879;3600000;0
10694;190034;217;75;29;2;27;.931;3600000;0
10694;190041;217;0;0;0;0;.00nan;0;0
10694;181065;219;95;27;0;27;1.000;3600000;0
10694;181102;219;0;0;0;0;.00nan;0;0
11617;-1;4949;0;0;0;0;.00nan;0;0
11617;195251;4949;51;26;4;22;.846;3600000;0
11617;179602;177;55;40;5;35;.875;3600000;0
11617;176672;177;0;0;0;0;.00nan;0;0
11619;167404;215;0;0;0;0;.00nan;0;0
11619;165731;215;78;25;1;24;.960;3600000;0
11619;176938;180;97;46;3;43;.935;3541000;0
11619;-1;180;0;0;0;0;.00nan;0;0
11594;-1;211;100;35;0;35;1.000;3600000;0
11594;195164;218;69;27;2;25;.926;3568000;0
11594;179646;211;0;0;0;0;.00nan;0;0
11594;192457;218;0;0;0;0;.00nan;0;0
10718;171835;4960;51;2;0;2;1.000;546000;0
10718;194219;4960;12;20;6;14;.700;3023000;0
10718;184610;222;57;38;5;33;.868;3600000;0
10718;185851;222;0;0;0;0;.00nan;0;0
10608;166762;213;79;39;3;36;.923;3900000;0
10608;174147;179;0;0;0;0;.00nan;0;0
10608;180575;213;0;0;0;0;.00nan;0;0
10608;187355;179;81;36;3;33;.917;3900000;0
10613;184175;224;41;39;6;33;.846;2835000;0
10613;181338;230;0;0;0;0;.00nan;0;0
10613;185840;224;62;17;1;16;.941;765000;0
10613;186495;230;50;14;2;12;.857;3600000;0
10498;182467;185;45;24;3;21;.875;3900000;0
10498;190125;184;82;39;3;36;.923;3900000;0
10498;179668;184;0;0;0;0;.00nan;0;0
10498;180110;185;0;0;0;0;.00nan;0;0
11568;180762;1505;75;28;2;26;.929;3600000;0
11568;186549;1505;0;0;0;0;.00nan;0;0
11568;187240;216;80;36;3;33;.917;3600000;0
11568;191557;216;0;0;0;0;.00nan;0;0
10448;184069;208;67;29;2;27;.931;3614000;0
10448;179702;208;0;0;0;0;.00nan;0;0
10448;-1;205;99;35;1;34;.971;3614000;0
10448;187092;205;0;0;0;0;.00nan;0;0
11142;-1;210;65;20;2;18;.900;3860000;0
11142;179400;183;92;49;3;46;.939;3860000;0
11142;182089;183;0;0;0;0;.00nan;0;0
11142;192461;210;0;0;0;0;.00nan;0;0
11538;195238;200;0;0;0;0;.00nan;0;0
11538;175370;199;0;0;0;0;.00nan;0;0
11538;187295;200;98;43;2;41;.953;3802000;0
11538;161006;199;84;40;3;37;.925;3810000;0
11635;171730;220;64;26;2;24;.923;3726000;0
11635;179388;182;0;0;0;0;.00nan;0;0
11635;182116;182;94;64;3;61;.953;3726000;0
11635;187443;220;0;0;0;0;.00nan;0;0
11529;190125;184;0;0;0;0;.00nan;0;0
11529;179668;184;100;36;0;36;1.000;3600000;0
11529;-1;214;55;26;3;23;.885;3600000;0
11529;191518;214;0;0;0;0;.00nan;0;0
11656;184069;208;0;0;0;0;.00nan;0;0
11656;175364;206;100;53;2;51;.962;3900000;0
11656;179702;208;58;20;2;18;.900;3900000;0
11656;196283;206;0;0;0;0;.00nan;0;0
10588;177248;201;0;0;0;0;.00nan;0;0
10588;189902;204;0;0;0;0;.00nan;0;0
10588;182049;204;67;26;3;23;.885;3900000;0
10588;185743;201;74;40;3;37;.925;3900000;0
11602;171839;189;0;0;0;0;.00nan;0;0
11602;178394;188;0;0;0;0;.00nan;0;0
11602;174153;188;54;17;3;14;.824;3587000;0
11602;-1;189;82;37;2;35;.946;3600000;0
10575;182454;4864;0;0;0;0;.00nan;0;0
10575;183737;4864;76;23;1;22;.957;3600000;0
10575;170114;4959;65;24;2;22;.917;3578000;0
10575;195363;4959;0;0;0;0;.00nan;0;0
11589;194416;191;43;5;1;4;.800;376000;0
11589;194893;191;41;33;6;27;.818;3224000;0
11589;176200;195;74;23;2;21;.913;3600000;0
11589;179647;195;0;0;0;0;.00nan;0;0
10476;179197;198;0;0;0;0;.00nan;0;0
10476;174325;197;51;48;6;42;.875;2626000;0
10476;175436;197;66;15;1;14;.933;974000;0
10476;181431;198;73;7;0;7;1.000;3600000;0
10851;-1;211;76;33;3;30;.909;3600000;0
10851;179646;211;0;0;0;0;.00nan;0;0
10851;181065;219;55;35;4;31;.886;3549000;0
10851;181102;219;0;0;0;0;.00nan;0;0
10667;171835;4960;47;22;3;19;.864;3600000;0
10667;194219;4960;0;0;0;0;.00nan;0;0
10667;184175;224;37;43;7;36;.837;3284000;0
10667;185840;224;51;2;0;2;1.000;316000;0
10556;192862;187;0;0;0;0;.00nan;0;0
10556;189081;187;75;23;2;21;.913;3600000;0
10556;178394;188;64;30;3;27;.900;3548000;0
10556;174153;188;0;0;0;0;.00nan;0;0
10755;168954;228;60;30;3;27;.900;3560000;0
10755;179406;232;76;29;2;27;.931;3600000;0
10755;175354;228;0;0;0;0;.00nan;0;0
10755;179434;232;0;0;0;0;.00nan;0;0
10596;180578;181;0;0;0;0;.00nan;0;0
10596;-1;181;54;17;2;15;.882;3600000;0
10596;-1;214;0;0;0;0;.00nan;0;0
10596;191518;214;65;26;3;23;.885;3599000;0
11576;195238;200;69;45;5;40;.889;3548000;0
11576;180623;202;0;0;0;0;.00nan;0;0
11576;187295;200;0;0;0;0;.00nan;0;0
11576;192498;202;63;21;3;18;.857;3600000;0
11581;171839;189;0;0;0;0;.00nan;0;0
11581;170351;194;76;21;1;20;.952;3600000;0
11581;-1;189;98;48;2;46;.958;3559000;0
11581;196352;194;0;0;0;0;.00nan;0;0
10542;168907;186;0;0;0;0;.00nan;0;0
10542;169226;186;32;18;5;13;.722;3684000;0
10542;195164;218;0;0;0;0;.00nan;0;0
10542;192457;218;69;34;4;30;.882;3684000;0
10524;171662;176;100;27;0;27;1.000;3600000;0
10524;179169;209;98;41;2;39;.951;3537000;0
10524;176932;176;0;0;0;0;.00nan;0;0
10524;186205;209;0;0;0;0;.00nan;0;0
10540;167404;215;93;40;1;39;.975;3600000;0
10540;165731;215;0;0;0;0;.00nan;0;0
10540;190034;217;61;31;3;28;.903;3582000;0
10540;190041;217;0;0;0;0;.00nan;0;0
11386;194416;191;56;22;3;19;.864;3600000;0
11386;194893;191;0;0;0;0;.00nan;0;0
11386;-1;196;0;0;0;0;.00nan;0;0
11386;184648;196;52;48;6;42;.875;3600000;0
10656;175423;223;65;37;3;34;.919;3600000;0
10656;181338;230;0;0;0;0;.00nan;0;0
10656;186495;230;98;24;0;24;1.000;3600000;0
10656;187118;223;0;0;0;0;.00nan;0;0
11578;166762;213;0;0;0;0;.00nan;0;0
11578;174209;178;62;27;3;24;.889;3600000;0
11578;180575;213;56;37;5;32;.865;3544000;0
11578;-1;178;0;0;0;0;.00nan;0;0
10535;-1;4949;91;41;2;39;.951;3600000;0
10535;195251;4949;0;0;0;0;.00nan;0;0
10535;180762;1505;0;0;0;0;.00nan;0;0
10535;186549;1505;47;34;5;29;.853;3600000;0
10661;177248;201;68;49;5;44;.898;3600000;0
10661;175370;199;61;13;1;12;.923;3600000;0
10661;185743;201;0;0;0;0;.00nan;0;0
10661;161006;199;0;0;0;0;.00nan;0;0
10609;166762;213;100;43;2;41;.953;3900000;0
10609;-1;4949;0;0;0;0;.00nan;0;0
10609;195251;4949;63;27;2;25;.926;3900000;0
10609;180575;213;0;0;0;0;.00nan;0;0
10466;171730;220;76;36;3;33;.917;3900000;0
10466;179388;182;0;0;0;0;.00nan;0;0
10466;182116;182;87;49;3;46;.939;3900000;0
10466;187443;220;0;0;0;0;.00nan;0;0
10614;-1;1371;0;0;0;0;.00nan;0;0
10614;180578;181;0;0;0;0;.00nan;0;0
10614;-1;181;96;43;2;41;.953;3600000;0
10614;192688;1371;32;28;6;22;.786;3600000;0
10495;184175;224;0;0;0;0;.00nan;0;0
10495;189885;225;42;22;4;18;.818;3542000;0
10495;184785;225;0;0;0;0;.00nan;0;0
10495;185840;224;85;40;3;37;.925;3600000;0
10668;171835;4960;0;0;0;0;.00nan;0;0
10668;194219;4960;56;11;1;10;.909;3600000;0
10668;179430;229;0;0;0;0;.00nan;0;0
10668;185800;229;80;43;4;39;.907;3600000;0
10509;-1;221;70;36;3;33;.917;3553000;0
10509;179406;232;0;0;0;0;.00nan;0;0
10509;179434;232;72;22;1;21;.955;3600000;0
10509;187362;221;0;0;0;0;.00nan;0;0
10522;167404;215;61;23;2;21;.913;1387000;0
10522;165731;215;50;26;4;22;.846;2154000;0
10522;179679;212;0;0;0;0;.00nan;0;0
10522;186641;212;58;24;4;20;.833;3600000;0
10525;179400;183;0;0;0;0;.00nan;0;0
10525;180762;1505;82;25;1;24;.960;3600000;0
10525;182089;183;98;49;2;47;.959;3545000;0
10525;186549;1505;0;0;0;0;.00nan;0;0
10458;174209;178;0;0;0;0;.00nan;0;0
10458;187240;216;48;28;4;24;.857;3600000;0
10458;191557;216;0;0;0;0;.00nan;0;0
10458;-1;178;53;35;5;30;.857;3548000;0
10451;-1;203;54;24;4;20;.833;3553000;0
10451;175364;206;77;31;2;29;.935;3600000;0
10451;-1;203;0;0;0;0;.00nan;0;0
10451;196283;206;0;0;0;0;.00nan;0;0
10536;182454;4864;0;0;0;0;.00nan;0;0
10536;183737;4864;61;31;4;27;.871;3600000;0
10536;171405;2620;75;28;2;26;.929;3600000;0
10536;-1;2620;0;0;0;0;.00nan;0;0
11491;170114;4959;69;39;3;36;.923;3900000;0
11491;195363;4959;0;0;0;0;.00nan;0;0
11491;171662;176;51;24;3;21;.875;3900000;0
11491;176932;176;0;0;0;0;.00nan;0;0
10449;170351;194;34;4;2;2;.500;354000;0
10449;176200;195;72;21;1;20;.952;3600000;0
10449;179647;195;0;0;0;0;.00nan;0;0
10449;196352;194;62;48;6;42;.875;3246000;0
10516;169096;190;75;45;5;40;.889;3600000;0
10516;179197;198;0;0;0;0;.00nan;0;0
10516;181431;198;50;16;2;14;.875;3600000;0
10516;197704;190;0;0;0;0;.00nan;0;0
10735;173340;231;0;0;0;0;.00nan;0;0
10735;185034;231;86;40;2;38;.950;3600000;0
10735;181338;230;0;0;0;0;.00nan;0;0
10735;186495;230;63;34;4;30;.882;3523000;0
10595;195164;218;43;27;4;23;.852;3600000;0
10595;181065;219;0;0;0;0;.00nan;0;0
10595;181102;219;65;30;3;27;.900;3600000;0
10595;192457;218;0;0;0;0;.00nan;0;0
10643;192862;187;71;7;0;7;1.000;3600000;0
10643;189081;187;0;0;0;0;.00nan;0;0
10643;174325;197;85;42;3;39;.929;3600000;0
10643;175436;197;0;0;0;0;.00nan;0;0
10436;168907;186;88;46;3;43;.935;3544000;0
10436;169226;186;0;0;0;0;.00nan;0;0
10436;176938;180;90;31;2;29;.935;3600000;0
10436;-1;180;0;0;0;0;.00nan;0;0
10800;182467;185;0;0;0;0;.00nan;0;0
10800;190125;184;0;0;0;0;.00nan;0;0
10800;179668;184;35;38;6;32;.842;3600000;0
10800;180110;185;100;39;2;37;.949;3600000;0
10869;-1;210;0;0;0;0;.00nan;0;0
10869;179602;177;60;40;5;35;.875;3555000;0
10869;176672;177;0;0;0;0;.00nan;0;0
10869;192461;210;53;28;4;24;.857;3600000;0
10508;-1;207;75;29;2;27;.931;3900000;0
10508;180623;202;86;35;2;33;.943;3900000;0
10508;-1;207;0;0;0;0;.00nan;0;0
10508;192498;202;0;0;0;0;.00nan;0;0
10628;168954;228;0;0;0;0;.00nan;0;0
10628;175354;228;75;27;3;24;.889;3600000;0
10628;175423;223;0;0;0;0;.00nan;0;0
10628;187118;223;67;38;4;34;.895;3543000;0
10469;189902;204;43;28;5;23;.821;3600000;0
10469;175364;206;0;0;0;0;.00nan;0;0
10469;196283;206;83;35;2;33;.943;3600000;0
10469;182049;204;0;0;0;0;.00nan;0;0
10465;168117;192;0;0;0;0;.00nan;0;0
10465;179197;198;72;42;4;38;.905;3900000;0
10465;-1;192;67;35;4;31;.886;3900000;0
10465;181431;198;0;0;0;0;.00nan;0;0
10523;174147;179;86;33;2;31;.939;3600000;0
10523;187240;216;0;0;0;0;.00nan;0;0
10523;187355;179;0;0;0;0;.00nan;0;0
10523;191557;216;61;40;5;35;.875;3600000;0
11016;-1;196;81;20;0;20;1.000;1267000;0
11016;184648;196;48;29;5;24;.828;2333000;0
11016;176200;195;68;19;1;18;.947;3600000;0
11016;179647;195;0;0;0;0;.00nan;0;0
10572;171405;2620;0;0;0;0;.00nan;0;0
10572;179169;209;65;35;4;31;.886;3169000;0
10572;-1;2620;76;33;2;31;.939;3600000;0
10572;186205;209;30;7;3;4;.571;431000;0
10680;177248;201;47;18;3;15;.833;1470000;0
10680;169166;226;62;17;2;15;.882;3600000;0
10680;185743;201;32;34;6;28;.824;2130000;0
10680;192629;226;0;0;0;0;.00nan;0;0
10771;-1;196;99;35;1;34;.971;3900000;0
10771;174325;197;51;8;1;7;.875;3900000;0
10771;184648;196;0;0;0;0;.00nan;0;0
10771;175436;197;0;0;0;0;.00nan;0;0
10698;189902;204;0;0;0;0;.00nan;0;0
10698;180623;202;0;0;0;0;.00nan;0;0
10698;182049;204;77;27;1;26;.963;3600000;0
10698;192498;202;41;31;5;26;.839;3600000;0
11624;168954;228;98;55;4;51;.927;3592000;0
11624;175354;228;0;0;0;0;.00nan;0;0
11624;181338;230;0;0;0;0;.00nan;0;0
11624;186495;230;43;9;2;7;.778;3600000;0
10642;-1;221;0;0;0;0;.00nan;0;0
10642;179406;232;44;40;6;34;.850;3079000;0
10642;179434;232;42;3;1;2;.667;521000;0
10642;187362;221;65;18;2;16;.889;3600000;0
11564;184175;224;0;0;0;0;.00nan;0;0
11564;175423;223;68;34;3;31;.912;3600000;0
11564;185840;224;100;31;0;31;1.000;3600000;0
11564;187118;223;0;0;0;0;.00nan;0;0
10901;166762;213;0;0;0;0;.00nan;0;0
10901;179400;183;97;42;2;40;.952;3900000;0
10901;180575;213;76;30;2;28;.933;3900000;0
10901;182089;183;0;0;0;0;.00nan;0;0
10687;184610;222;73;33;2;31;.939;3900000;0
10687;179430;229;0;0;0;0;.00nan;0;0
10687;185800;229;90;35;2;33;.943;3900000;0
10687;185851;222;0;0;0;0;.00nan;0;0
10719;182454;4864;0;0;0;0;.00nan;0;0
10719;183737;4864;51;28;5;23;.821;3600000;0
10719;170114;4959;100;31;1;30;.968;3600000;0
10719;195363;4959;0;0;0;0;.00nan;0;0
10472;178394;188;0;0;0;0;.00nan;0;0
10472;170351;194;64;40;4;36;.900;3600000;0
10472;174153;188;78;14;1;13;.929;3600000;0
10472;196352;194;0;0;0;0;.00nan;0;0
10526;174147;179;0;0;0;0;.00nan;0;0
10526;180762;1505;0;0;0;0;.00nan;0;0
10526;186549;1505;60;23;3;20;.870;3600000;0
10526;187355;179;45;33;5;28;.848;3513000;0
10504;182467;185;66;29;3;26;.897;3600000;0
10504;171730;220;93;33;2;31;.939;3600000;0
10504;180110;185;0;0;0;0;.00nan;0;0
10504;187443;220;0;0;0;0;.00nan;0;0
10514;179388;182;0;0;0;0;.00nan;0;0
10514;190125;184;63;35;4;31;.886;3600000;0
10514;179668;184;0;0;0;0;.00nan;0;0
10514;182116;182;93;33;2;31;.939;3600000;0
10455;184069;208;86;35;2;33;.943;3600000;0
10455;-1;203;0;0;0;0;.00nan;0;0
10455;179702;208;0;0;0;0;.00nan;0;0
10455;-1;203;47;28;4;24;.857;3567000;0
10585;174209;178;92;40;2;38;.950;3600000;0
10585;179602;177;51;23;3;20;.870;3562000;0
10585;176672;177;0;0;0;0;.00nan;0;0
10585;-1;178;0;0;0;0;.00nan;0;0
10452;176938;180;78;47;5;42;.894;3720000;0
10452;179679;212;0;0;0;0;.00nan;0;0
10452;186641;212;57;30;4;26;.867;3720000;0
10452;-1;180;0;0;0;0;.00nan;0;0
10573;-1;211;90;33;2;31;.939;3570000;0
10573;190034;217;0;0;0;0;.00nan;0;0
10573;190041;217;99;35;1;34;.971;3600000;0
10573;179646;211;0;0;0;0;.00nan;0;0
10541;175370;199;98;53;2;51;.962;3564000;0
10541;-1;205;92;21;0;21;1.000;3600000;0
10541;187092;205;0;0;0;0;.00nan;0;0
10541;161006;199;0;0;0;0;.00nan;0;0
10582;192862;187;91;33;2;31;.939;3600000;0
10582;189081;187;0;0;0;0;.00nan;0;0
10582;169096;190;81;34;3;31;.912;3600000;0
10582;197704;190;0;0;0;0;.00nan;0;0
10555;173340;231;0;0;0;0;.00nan;0;0
10555;-1;227;78;46;4;42;.913;3600000;0
10555;185034;231;89;19;0;19;1.000;3600000;0
10555;187217;227;0;0;0;0;.00nan;0;0
10445;166545;193;81;28;1;27;.964;3900000;0
10445;171839;189;0;0;0;0;.00nan;0;0
10445;-1;189;97;47;1;46;.979;3900000;0
10445;186451;193;0;0;0;0;.00nan;0;0
10518;177248;201;0;0;0;0;.00nan;0;0
10518;-1;207;0;0;0;0;.00nan;0;0
10518;185743;201;77;36;3;33;.917;3852000;0
10518;-1;207;56;30;4;26;.867;3852000;0
10580;167404;215;67;43;5;38;.884;3795000;0
10580;165731;215;0;0;0;0;.00nan;0;0
10580;195164;218;0;0;0;0;.00nan;0;0
10580;192457;218;86;43;4;39;.907;3795000;0
10486;-1;1371;0;0;0;0;.00nan;0;0
10486;-1;214;62;29;3;26;.897;3572000;0
10486;191518;214;0;0;0;0;.00nan;0;0
10486;192688;1371;83;26;1;25;.962;3600000;0
11605;179400;183;0;0;0;0;.00nan;0;0
11605;182089;183;83;39;3;36;.923;3860000;0
11605;187240;216;55;30;3;27;.900;3900000;0
11605;191557;216;0;0;0;0;.00nan;0;0
10583;171405;2620;53;32;4;28;.875;3600000;0
10583;179169;209;98;34;1;33;.971;3600000;0
10583;-1;2620;0;0;0;0;.00nan;0;0
10583;186205;209;0;0;0;0;.00nan;0;0
11650;194416;191;52;33;5;28;.848;3600000;0
11650;194893;191;0;0;0;0;.00nan;0;0
11650;176200;195;66;27;2;25;.926;3600000;0
11650;179647;195;0;0;0;0;.00nan;0;0
10675;171839;189;0;0;0;0;.00nan;0;0
10675;169096;190;86;29;1;28;.966;3696000;0
10675;-1;189;60;21;2;19;.905;3696000;0
10675;197704;190;0;0;0;0;.00nan;0;0
10501;168907;186;0;0;0;0;.00nan;0;0
10501;169226;186;53;33;4;29;.879;3718000;0
10501;179679;212;0;0;0;0;.00nan;0;0
10501;186641;212;57;34;5;29;.853;3718000;0
10565;166545;193;0;0;0;0;.00nan;0;0
10565;170351;194;0;0;0;0;.00nan;0;0
10565;196352;194;63;40;4;36;.900;3600000;0
10565;186451;193;69;14;1;13;.929;3600000;0
10553;190125;184;0;0;0;0;.00nan;0;0
10553;179668;184;71;27;2;25;.926;3600000;0
10553;180578;181;0;0;0;0;.00nan;0;0
10553;-1;181;61;16;1;15;.938;3600000;0
10564;168117;192;0;0;0;0;.00nan;0;0
10564;179197;198;53;4;0;4;1.000;387000;0
10564;-1;192;74;33;3;30;.909;3600000;0
10564;181431;198;35;33;6;27;.818;3213000;0
10510;170114;4959;0;0;0;0;.00nan;0;0
10510;195363;4959;57;24;3;21;.875;3563000;0
10510;171662;176;0;0;0;0;.00nan;0;0
10510;176932;176;97;48;2;46;.958;3600000;0
10615;168954;228;83;17;0;17;1.000;2457000;0
10615;184175;224;0;0;0;0;.00nan;0;0
10615;175354;228;29;13;4;9;.692;1143000;0
10615;185840;224;62;41;5;36;.878;3543000;0
10689;171835;4960;62;22;2;20;.909;3600000;0
10689;194219;4960;0;0;0;0;.00nan;0;0
10689;-1;227;0;0;0;0;.00nan;0;0
10689;187217;227;43;46;7;39;.848;3600000;0
10843;-1;210;0;0;0;0;.00nan;0;0
10843;179602;177;0;0;0;0;.00nan;0;0
10843;176672;177;80;45;3;42;.933;3600000;0
10843;192461;210;76;17;1;16;.941;3600000;0
10529;169166;226;48;21;3;18;.857;3900000;0
10529;175364;206;79;40;3;37;.925;3900000;0
10529;196283;206;0;0;0;0;.00nan;0;0
10529;192629;226;0;0;0;0;.00nan;0;0
10500;-1;221;41;30;5;25;.833;3543000;0
10500;189885;225;74;37;4;33;.892;3600000;0
10500;184785;225;0;0;0;0;.00nan;0;0
10500;187362;221;0;0;0;0;.00nan;0;0
10739;178394;188;64;20;2;18;.900;3600000;0
10739;174153;188;0;0;0;0;.00nan;0;0
10739;174325;197;0;0;0;0;.00nan;0;0
10739;175436;197;72;54;5;49;.907;3600000;0
11101;-1;211;0;0;0;0;.00nan;0;0
11101;179646;211;98;22;0;22;1.000;3600000;0
11101;181065;219;0;0;0;0;.00nan;0;0
11101;181102;219;77;25;1;24;.960;3545000;0
10561;182467;185;63;16;1;15;.938;3048000;0
10561;180110;185;29;9;3;6;.667;547000;0
10561;-1;214;0;0;0;0;.00nan;0;0
10561;191518;214;82;31;2;29;.935;3600000;0
10630;174209;178;57;6;0;6;1.000;672000;0
10630;-1;210;40;27;5;22;.815;3600000;0
10630;192461;210;0;0;0;0;.00nan;0;0
10630;-1;178;38;32;6;26;.813;2901000;0
11644;177248;201;0;0;0;0;.00nan;0;0
11644;195238;200;0;0;0;0;.00nan;0;0
11644;185743;201;75;40;4;36;.900;3600000;0
11644;187295;200;47;30;5;25;.833;3558000;0
10444;190034;217;88;30;1;29;.967;3597000;0
10444;190041;217;0;0;0;0;.00nan;0;0
10444;176938;180;99;24;0;24;1.000;3600000;0
10444;-1;180;0;0;0;0;.00nan;0;0
10562;189885;225;0;0;0;0;.00nan;0;0
10562;179430;229;0;0;0;0;.00nan;0;0
10562;184785;225;84;33;2;31;.939;3565000;0
10562;185800;229;96;35;1;34;.971;3600000;0
10512;-1;1371;0;0;0;0;.00nan;0;0
10512;179388;182;0;0;0;0;.00nan;0;0
10512;182116;182;66;29;3;26;.897;3527000;0
10512;192688;1371;99;32;1;31;.969;3600000;0
10578;168117;192;0;0;0;0;.00nan;0;0
10578;176200;195;0;0;0;0;.00nan;0;0
10578;179647;195;52;39;6;33;.846;3600000;0
10578;-1;192;78;25;1;24;.960;3600000;0
10493;184069;208;37;33;6;27;.818;3600000;0
10493;-1;203;64;31;3;28;.903;3600000;0
10493;179702;208;0;0;0;0;.00nan;0;0
10493;-1;203;0;0;0;0;.00nan;0;0
10534;175370;199;0;0;0;0;.00nan;0;0
10534;-1;207;32;17;4;13;.765;907000;0
10534;-1;207;80;27;1;26;.963;2619000;0
10534;161006;199;57;25;3;22;.880;3600000;0
10846;173340;231;0;0;0;0;.00nan;0;0
10846;185034;231;72;35;3;32;.914;3543000;0
10846;181338;230;0;0;0;0;.00nan;0;0
10846;186495;230;83;26;1;25;.962;3600000;0
10549;180623;202;70;25;2;23;.920;3600000;0
10549;-1;205;44;28;5;23;.821;3600000;0
10549;187092;205;0;0;0;0;.00nan;0;0
10549;192498;202;0;0;0;0;.00nan;0;0
10734;169166;226;0;0;0;0;.00nan;0;0
10734;189902;204;49;35;5;30;.857;3600000;0
10734;182049;204;0;0;0;0;.00nan;0;0
10734;192629;226;64;29;2;27;.931;3600000;0
10571;-1;4949;100;28;0;28;1.000;3600000;0
10571;195251;4949;0;0;0;0;.00nan;0;0
10571;174147;179;64;33;3;30;.909;3600000;0
10571;187355;179;0;0;0;0;.00nan;0;0
10793;-1;227;91;32;1;31;.969;3900000;0
10793;175423;223;0;0;0;0;.00nan;0;0
10793;187118;223;91;31;1;30;.968;3900000;0
10793;187217;227;0;0;0;0;.00nan;0;0
10554;166762;213;70;51;5;46;.902;3600000;0
10554;180575;213;0;0;0;0;.00nan;0;0
10554;187240;216;56;21;3;18;.857;3600000;0
10554;191557;216;0;0;0;0;.00nan;0;0
11608;194416;191;0;0;0;0;.00nan;0;0
11608;169096;190;78;45;3;42;.933;3600000;0
11608;194893;191;52;14;2;12;.857;3600000;0
11608;197704;190;0;0;0;0;.00nan;0;0
11661;167404;215;61;41;5;36;.878;3564000;0
11661;165731;215;0;0;0;0;.00nan;0;0
11661;190034;217;0;0;0;0;.00nan;0;0
11661;190041;217;55;30;4;26;.867;3600000;0
11639;179679;212;0;0;0;0;.00nan;0;0
11639;181065;219;0;0;0;0;.00nan;0;0
11639;181102;219;77;25;1;24;.960;3564000;0
11639;186641;212;100;35;0;35;1.000;3600000;0
11434;-1;1371;0;0;0;0;.00nan;0;0
11434;180578;181;0;0;0;0;.00nan;0;0
11434;-1;181;97;38;0;38;1.000;3900000;0
11434;192688;1371;99;23;0;23;1.000;3900000;0
10576;166545;193;50;22;3;19;.864;3545000;0
10576;171839;189;0;0;0;0;.00nan;0;0
10576;-1;189;89;40;2;38;.950;3600000;0
10576;186451;193;0;0;0;0;.00nan;0;0
10506;184069;208;0;0;0;0;.00nan;0;0
10506;179702;208;77;25;1;24;.960;3600000;0
10506;-1;205;0;0;0;0;.00nan;0;0
10506;187092;205;55;32;4;28;.875;3600000;0
10774;182454;4864;0;0;0;0;.00nan;0;0
10774;183737;4864;78;23;1;22;.957;3600000;0
10774;171662;176;0;0;0;0;.00nan;0;0
10774;176932;176;98;51;2;49;.961;3600000;0
11446;170114;4959;89;37;3;34;.919;3758000;0
11446;195363;4959;0;0;0;0;.00nan;0;0
11446;171405;2620;0;0;0;0;.00nan;0;0
11446;-1;2620;66;24;2;22;.917;3758000;0
10720;177248;201;0;0;0;0;.00nan;0;0
10720;169166;226;77;32;1;31;.969;3900000;0
10720;185743;201;100;39;1;38;.974;3900000;0
10720;192629;226;0;0;0;0;.00nan;0;0
10606;182467;185;58;38;5;33;.868;3600000;0
10606;180110;185;0;0;0;0;.00nan;0;0
10606;-1;214;81;25;1;24;.960;3600000;0
10606;191518;214;0;0;0;0;.00nan;0;0
10664;-1;221;68;26;2;24;.923;3600000;0
10664;175423;223;77;38;3;35;.921;3600000;0
10664;187118;223;0;0;0;0;.00nan;0;0
10664;187362;221;0;0;0;0;.00nan;0;0
10612;-1;4949;87;30;1;29;.967;3600000;0
10612;195251;4949;0;0;0;0;.00nan;0;0
10612;-1;210;0;0;0;0;.00nan;0;0
10612;192461;210;74;44;5;39;.886;3600000;0
11621;171662;176;67;30;4;26;.867;3600000;0
11621;179169;209;0;0;0;0;.00nan;0;0
11621;176932;176;0;0;0;0;.00nan;0;0
11621;186205;209;49;33;5;28;.848;3553000;0
10611;166762;213;0;0;0;0;.00nan;0;0
10611;180575;213;68;31;3;28;.903;3600000;0
10611;187240;216;49;1;0;1;1.000;348000;0
10611;191557;216;32;31;6;25;.806;3252000;0
10711;-1;211;0;0;0;0;.00nan;0;0
10711;195164;218;76;39;3;36;.923;3555000;0
10711;179646;211;85;35;2;33;.943;3600000;0
10711;192457;218;0;0;0;0;.00nan;0;0
10517;179388;182;0;0;0;0;.00nan;0;0
10517;190125;184;100;40;1;39;.975;3600000;0
10517;179668;184;0;0;0;0;.00nan;0;0
10517;182116;182;73;38;4;34;.895;3600000;0
11574;192862;187;0;0;0;0;.00nan;0;0
11574;168117;192;0;0;0;0;.00nan;0;0
11574;189081;187;97;20;0;20;1.000;3600000;0
11574;-1;192;64;27;3;24;.889;3600000;0
10487;167404;215;0;0;0;0;.00nan;0;0
10487;165731;215;45;25;4;21;.840;3600000;0
10487;176938;180;66;26;2;24;.923;3600000;0
10487;-1;180;0;0;0;0;.00nan;0;0
10733;171835;4960;64;25;2;23;.920;3600000;0
10733;194219;4960;0;0;0;0;.00nan;0;0
10733;181338;230;0;0;0;0;.00nan;0;0
10733;186495;230;75;33;3;30;.909;3543000;0
10622;182454;4864;84;32;1;31;.969;3618000;0
10622;183737;4864;0;0;0;0;.00nan;0;0
10622;171405;2620;70;26;2;24;.923;3618000;0
10622;-1;2620;0;0;0;0;.00nan;0;0
10620;194416;191;59;18;2;16;.889;3600000;0
10620;194893;191;0;0;0;0;.00nan;0;0
10620;170351;194;0;0;0;0;.00nan;0;0
10620;196352;194;82;44;4;40;.909;3573000;0
10748;168907;186;0;0;0;0;.00nan;0;0
10748;169226;186;99;34;1;33;.971;3637000;0
10748;181065;219;62;21;2;19;.905;3637000;0
10748;181102;219;0;0;0;0;.00nan;0;0
10570;166545;193;0;0;0;0;.00nan;0;0
10570;179197;198;43;26;4;22;.846;3541000;0
10570;181431;198;0;0;0;0;.00nan;0;0
10570;186451;193;62;24;3;21;.875;3600000;0
10629;175364;206;71;32;3;29;.906;3593000;0
10629;175370;199;56;16;2;14;.875;3600000;0
10629;196283;206;0;0;0;0;.00nan;0;0
10629;161006;199;0;0;0;0;.00nan;0;0
10617;168954;228;93;41;2;39;.951;3556000;0
10617;189885;225;73;25;1;24;.960;3600000;0
10617;175354;228;0;0;0;0;.00nan;0;0
10617;184785;225;0;0;0;0;.00nan;0;0
10697;-1;227;0;0;0;0;.00nan;0;0
10697;179430;229;0;0;0;0;.00nan;0;0
10697;185800;229;57;21;3;18;.857;3545000;0
10697;187217;227;91;36;2;34;.944;3600000;0
10651;174209;178;94;44;3;41;.932;3900000;0
10651;179400;183;71;39;3;36;.923;3900000;0
10651;182089;183;0;0;0;0;.00nan;0;0
10651;-1;178;0;0;0;0;.00nan;0;0
10753;-1;4949;92;33;2;31;.939;3600000;0
10753;195251;4949;0;0;0;0;.00nan;0;0
10753;174147;179;0;0;0;0;.00nan;0;0
10753;187355;179;60;25;3;22;.880;3557000;0
10552;169166;226;0;0;0;0;.00nan;0;0
10552;-1;207;0;0;0;0;.00nan;0;0
10552;-1;207;65;28;2;26;.929;3600000;0
10552;192629;226;79;38;3;35;.921;3549000;0
10600;170114;4959;21;24;6;18;.750;3514000;0
10600;195363;4959;0;0;0;0;.00nan;0;0
10600;179169;209;47;27;4;23;.852;3600000;0
10600;186205;209;0;0;0;0;.00nan;0;0
10550;175364;206;0;0;0;0;.00nan;0;0
10550;196283;206;62;33;3;30;.909;3600000;0
10550;180623;202;0;0;0;0;.00nan;0;0
10550;192498;202;71;27;2;25;.926;3600000;0
10965;184610;222;53;37;5;32;.865;3600000;0
10965;181338;230;0;0;0;0;.00nan;0;0
10965;185851;222;0;0;0;0;.00nan;0;0
10965;186495;230;75;30;2;28;.933;3600000;0
10902;195238;200;0;0;0;0;.00nan;0;0
10902;-1;205;67;6;0;6;1.000;3600000;0
10902;187092;205;0;0;0;0;.00nan;0;0
10902;187295;200;88;69;6;63;.913;3600000;0
10548;190034;217;82;35;2;33;.943;3600000;0
10548;190041;217;0;0;0;0;.00nan;0;0
10548;176938;180;56;29;4;25;.862;3544000;0
10548;-1;180;0;0;0;0;.00nan;0;0
10533;177248;201;93;35;2;33;.943;3900000;0
10533;-1;203;53;17;2;15;.882;3900000;0
10533;-1;203;0;0;0;0;.00nan;0;0
10533;185743;201;0;0;0;0;.00nan;0;0
10732;189902;204;0;0;0;0;.00nan;0;0
10732;175370;199;0;0;0;0;.00nan;0;0
10732;182049;204;75;41;4;37;.902;3625000;0
10732;161006;199;28;20;5;15;.750;3625000;0
10646;182467;185;0;0;0;0;.00nan;0;0
10646;180110;185;78;44;3;41;.932;3520000;0
10646;-1;214;0;0;0;0;.00nan;0;0
10646;191518;214;87;24;1;23;.958;3600000;0
10677;184175;224;0;0;0;0;.00nan;0;0
10677;179406;232;90;37;2;35;.946;3600000;0
10677;179434;232;0;0;0;0;.00nan;0;0
10677;185840;224;44;28;4;24;.857;3579000;0
10673;168117;192;0;0;0;0;.00nan;0;0
10673;169096;190;64;30;3;27;.900;3600000;0
10673;-1;192;84;17;1;16;.941;3600000;0
10673;197704;190;0;0;0;0;.00nan;0;0
10684;171839;189;87;30;1;29;.967;3600000;0
10684;170351;194;50;33;5;28;.848;3600000;0
10684;-1;189;0;0;0;0;.00nan;0;0
10684;196352;194;0;0;0;0;.00nan;0;0
10621;-1;1371;0;0;0;0;.00nan;0;0
10621;180578;181;0;0;0;0;.00nan;0;0
10621;-1;181;85;15;0;15;1.000;3600000;0
10621;192688;1371;81;34;2;32;.941;3549000;0
10669;195164;218;0;0;0;0;.00nan;0;0
10669;179679;212;0;0;0;0;.00nan;0;0
10669;186641;212;82;34;2;32;.941;3600000;0
10669;192457;218;56;28;3;25;.893;3568000;0
10579;179388;182;0;0;0;0;.00nan;0;0
10579;190125;184;0;0;0;0;.00nan;0;0
10579;179668;184;80;29;2;27;.931;3600000;0
10579;182116;182;96;37;3;34;.919;3545000;0
10659;168954;228;0;0;0;0;.00nan;0;0
10659;-1;221;0;0;0;0;.00nan;0;0
10659;175354;228;79;39;3;36;.923;3600000;0
10659;187362;221;80;13;0;13;1.000;3600000;0
11242;178394;188;0;0;0;0;.00nan;0;0
11242;174153;188;53;32;4;28;.875;3600000;0
11242;174325;197;18;14;5;9;.643;1135000;0
11242;175436;197;78;21;0;21;1.000;2429000;0
10566;179400;183;0;0;0;0;.00nan;0;0
10566;180762;1505;85;19;0;19;1.000;3600000;0
10566;182089;183;97;56;3;53;.946;3600000;0
10566;186549;1505;0;0;0;0;.00nan;0;0
10618;171835;4960;0;0;0;0;.00nan;0;0
10618;194219;4960;63;22;2;20;.909;3600000;0
10618;189885;225;0;0;0;0;.00nan;0;0
10618;184785;225;86;46;3;43;.935;3548000;0
10633;-1;196;0;0;0;0;.00nan;0;0
10633;179197;198;0;0;0;0;.00nan;0;0
10633;184648;196;61;35;4;31;.886;3600000;0
10633;181431;198;49;14;2;12;.857;3600000;0
11677;-1;211;74;30;2;28;.933;3544000;0
11677;179646;211;0;0;0;0;.00nan;0;0
11677;181065;219;0;0;0;0;.00nan;0;0
11677;181102;219;100;31;0;31;1.000;3600000;0
10591;-1;210;0;0;0;0;.00nan;0;0
10591;180762;1505;91;20;0;20;1.000;3600000;0
10591;186549;1505;0;0;0;0;.00nan;0;0
10591;192461;210;92;43;2;41;.953;3511000;0
10701;-1;227;65;45;5;40;.889;3600000;0
10701;179406;232;0;0;0;0;.00nan;0;0
10701;179434;232;99;38;1;37;.974;3600000;0
10701;187217;227;0;0;0;0;.00nan;0;0
10764;184175;224;92;40;1;39;.975;3597000;0
10764;175423;223;0;0;0;0;.00nan;0;0
10764;185840;224;0;0;0;0;.00nan;0;0
10764;187118;223;100;30;0;30;1.000;3600000;0
10639;174209;178;30;31;6;25;.806;2395000;0
10639;187240;216;90;35;2;33;.943;3600000;0
10639;191557;216;0;0;0;0;.00nan;0;0
10639;-1;178;55;5;0;5;1.000;1205000;0
10994;173340;231;0;0;0;0;.00nan;0;0
10994;184610;222;0;0;0;0;.00nan;0;0
10994;185034;231;66;31;3;28;.903;3600000;0
10994;185851;222;61;43;5;38;.884;3576000;0
10545;184069;208;31;28;5;23;.821;2166000;0
10545;179702;208;72;12;0;12;1.000;1434000;0
10545;-1;207;58;33;4;29;.879;3600000;0
10545;-1;207;0;0;0;0;.00nan;0;0
10581;166545;193;66;22;2;20;.909;3600000;0
10581;173770;193;0;0;0;0;.00nan;0;0
10581;176200;195;84;37;3;34;.919;3555000;0
10581;179647;195;0;0;0;0;.00nan;0;0
10785;195238;200;0;0;0;0;.00nan;0;0
10785;189902;204;0;0;0;0;.00nan;0;0
10785;182049;204;55;16;2;14;.875;3600000;0
10785;187295;200;98;58;4;54;.931;3590000;0
10593;-1;227;0;0;0;0;.00nan;0;0
10593;189885;225;100;27;0;27;1.000;3600000;0
10593;184785;225;0;0;0;0;.00nan;0;0
10593;187217;227;62;26;2;24;.923;3519000;0
10834;167404;215;76;31;2;29;.935;3600000;0
10834;165731;215;0;0;0;0;.00nan;0;0
10834;195164;218;0;0;0;0;.00nan;0;0
10834;192457;218;72;30;3;27;.900;3552000;0
10563;-1;211;0;0;0;0;.00nan;0;0
10563;168907;186;0;0;0;0;.00nan;0;0
10563;169226;186;89;17;0;17;1.000;3600000;0
10563;179646;211;72;39;3;36;.923;3600000;0
10749;177248;201;0;0;0;0;.00nan;0;0
10749;180623;202;100;29;0;29;1.000;3600000;0
10749;185743;201;62;24;2;22;.917;3537000;0
10749;192498;202;0;0;0;0;.00nan;0;0
10559;190034;217;0;0;0;0;.00nan;0;0
10559;190041;217;57;30;3;27;.900;3900000;0
10559;176938;180;86;41;3;38;.927;3900000;0
10559;-1;180;0;0;0;0;.00nan;0;0
10721;171835;4960;56;17;2;15;.882;3600000;0
10721;194219;4960;0;0;0;0;.00nan;0;0
10721;168954;228;58;44;5;39;.886;3600000;0
10721;175354;228;0;0;0;0;.00nan;0;0
11615;171839;189;0;0;0;0;.00nan;0;0
11615;170351;194;0;0;0;0;.00nan;0;0
11615;-1;189;41;22;4;18;.818;3891000;0
11615;196352;194;80;39;3;36;.923;3891000;0
10853;194416;191;0;0;0;0;.00nan;0;0
10853;169096;190;77;47;4;43;.915;3571000;0
10853;194893;191;56;19;2;17;.895;3600000;0
10853;197704;190;0;0;0;0;.00nan;0;0
10631;192862;187;0;0;0;0;.00nan;0;0
10631;189081;187;82;43;4;39;.907;3600000;0
10631;179197;198;81;25;1;24;.960;3600000;0
10631;181431;198;0;0;0;0;.00nan;0;0
10699;-1;221;0;0;0;0;.00nan;0;0
10699;179430;229;0;0;0;0;.00nan;0;0
10699;185800;229;100;39;0;39;1.000;3600000;0
10699;187362;221;56;18;2;16;.889;3569000;0
11651;182467;185;59;31;3;28;.903;3595000;0
11651;171730;220;63;25;2;23;.920;3600000;0
11651;180110;185;0;0;0;0;.00nan;0;0
11651;187443;220;0;0;0;0;.00nan;0;0
10648;175370;199;49;22;3;19;.864;3900000;0
10648;-1;205;79;43;3;40;.930;3900000;0
10648;187092;205;0;0;0;0;.00nan;0;0
10648;161006;199;0;0;0;0;.00nan;0;0
10624;190125;184;74;37;3;34;.919;3557000;0
10624;179668;184;0;0;0;0;.00nan;0;0
10624;180578;181;0;0;0;0;.00nan;0;0
10624;-1;181;79;34;2;32;.941;3600000;0
10658;168117;192;0;0;0;0;.00nan;0;0
10658;-1;196;0;0;0;0;.00nan;0;0
10658;184648;196;99;41;2;39;.951;3885000;0
10658;-1;192;62;25;3;22;.880;3885000;0
10666;170114;4959;61;47;5;42;.894;3600000;0
10666;195363;4959;0;0;0;0;.00nan;0;0
10666;171405;2620;59;26;3;23;.885;3600000;0
10666;-1;2620;0;0;0;0;.00nan;0;0
10660;174147;179;54;22;3;19;.864;3698000;0
10660;-1;210;74;30;2;28;.933;3698000;0
10660;187355;179;0;0;0;0;.00nan;0;0
10660;192461;210;0;0;0;0;.00nan;0;0
10872;182454;4864;0;0;0;0;.00nan;0;0
10872;183737;4864;69;18;1;17;.944;3600000;0
10872;171662;176;83;44;3;41;.932;3600000;0
10872;176932;176;0;0;0;0;.00nan;0;0
10647;-1;1371;0;0;0;0;.00nan;0;0
10647;-1;214;74;44;4;40;.909;3600000;0
10647;191518;214;0;0;0;0;.00nan;0;0
10647;192688;1371;70;15;1;14;.933;3600000;0
10538;-1;203;62;21;3;18;.857;3600000;0
10538;175364;206;62;37;4;33;.892;3551000;0
10538;-1;203;0;0;0;0;.00nan;0;0
10538;196283;206;0;0;0;0;.00nan;0;0
11596;189885;225;31;34;7;27;.794;2836000;0
11596;179406;232;38;26;6;20;.769;3600000;0
11596;179434;232;0;0;0;0;.00nan;0;0
11596;184785;225;51;2;0;2;1.000;701000;0
10726;182454;4864;51;20;2;18;.900;3543000;0
10726;183737;4864;0;0;0;0;.00nan;0;0
10726;170114;4959;99;43;1;42;.977;3600000;0
10726;195363;4959;0;0;0;0;.00nan;0;0
10568;-1;203;0;0;0;0;.00nan;0;0
10568;-1;203;42;23;4;19;.826;3676000;0
10568;-1;205;0;0;0;0;.00nan;0;0
10568;187092;205;70;35;3;32;.914;3676000;0
10679;-1;196;65;29;3;26;.897;3600000;0
10679;174325;197;100;25;0;25;1.000;3600000;0
10679;184648;196;0;0;0;0;.00nan;0;0
10679;175436;197;0;0;0;0;.00nan;0;0
10590;166545;193;0;0;0;0;.00nan;0;0
10590;192862;187;82;47;4;43;.915;3600000;0
10590;189081;187;0;0;0;0;.00nan;0;0
10590;173770;193;80;15;0;15;1.000;3600000;0
10731;168907;186;0;0;0;0;.00nan;0;0
10731;169226;186;62;25;2;23;.920;3600000;0
10731;181065;219;0;0;0;0;.00nan;0;0
10731;181102;219;92;32;1;31;.969;3600000;0
11671;167404;215;0;0;0;0;.00nan;0;0
11671;165731;215;51;38;5;33;.868;3600000;0
11671;195164;218;79;28;1;27;.964;3600000;0
11671;192457;218;0;0;0;0;.00nan;0;0
10644;182467;185;0;0;0;0;.00nan;0;0
10644;180110;185;91;47;4;43;.915;3600000;0
10644;180578;181;0;0;0;0;.00nan;0;0
10644;-1;181;86;17;0;17;1.000;3600000;0
11189;184610;222;91;36;2;34;.944;3600000;0
11189;181338;230;0;0;0;0;.00nan;0;0
11189;185851;222;0;0;0;0;.00nan;0;0
11189;186495;230;51;25;4;21;.840;3600000;0
10574;174209;178;58;6;0;6;1.000;523000;0
10574;187240;216;84;30;2;28;.933;3600000;0
10574;191557;216;0;0;0;0;.00nan;0;0
10574;-1;178;31;31;6;25;.806;3077000;0
10601;184069;208;65;13;1;12;.923;3600000;0
10601;195238;200;67;56;7;49;.875;3600000;0
10601;179702;208;0;0;0;0;.00nan;0;0
10601;187295;200;0;0;0;0;.00nan;0;0
10775;-1;4949;0;0;0;0;.00nan;0;0
10775;195251;4949;54;17;2;15;.882;3600000;0
10775;179400;183;80;54;5;49;.907;3600000;0
10775;182089;183;0;0;0;0;.00nan;0;0
10895;171839;189;0;0;0;0;.00nan;0;0
10895;194416;191;77;11;0;11;1.000;3600000;0
10895;194893;191;0;0;0;0;.00nan;0;0
10895;-1;189;91;45;3;42;.933;3600000;0
10616;171662;176;0;0;0;0;.00nan;0;0
10616;179169;209;0;0;0;0;.00nan;0;0
10616;176932;176;79;43;4;39;.907;3576000;0
10616;186205;209;52;23;3;20;.870;3600000;0
10597;179602;177;72;37;3;34;.919;3547000;0
10597;176672;177;0;0;0;0;.00nan;0;0
10597;180762;1505;64;19;2;17;.895;3600000;0
10597;186549;1505;0;0;0;0;.00nan;0;0
10710;173340;231;0;0;0;0;.00nan;0;0
10710;179430;229;0;0;0;0;.00nan;0;0
10710;185034;231;75;8;0;8;1.000;3600000;0
10710;185800;229;64;39;4;35;.897;3600000;0
10752;169166;226;96;24;0;24;1.000;3600000;0
10752;189902;204;67;28;2;26;.929;3561000;0
10752;182049;204;0;0;0;0;.00nan;0;0
10752;192629;226;0;0;0;0;.00nan;0;0
10594;-1;1371;64;23;2;21;.913;3600000;0
10594;179388;182;0;0;0;0;.00nan;0;0
10594;182116;182;92;49;3;46;.939;3573000;0
10594;192688;1371;0;0;0;0;.00nan;0;0
11630;168954;228;88;31;1;30;.968;3600000;0
11630;184610;222;0;0;0;0;.00nan;0;0
11630;175354;228;0;0;0;0;.00nan;0;0
11630;185851;222;43;24;4;20;.833;3600000;0
10744;169096;190;0;0;0;0;.00nan;0;0
10744;176200;195;52;24;3;21;.875;3600000;0
10744;179647;195;0;0;0;0;.00nan;0;0
10744;197704;190;84;42;4;38;.905;3600000;0
10845;179406;232;0;0;0;0;.00nan;0;0
10845;175423;223;100;44;1;43;.977;3600000;0
10845;179434;232;77;31;2;29;.935;3544000;0
10845;187118;223;0;0;0;0;.00nan;0;0
10700;-1;211;72;40;3;37;.925;3600000;0
10700;179646;211;0;0;0;0;.00nan;0;0
10700;179679;212;0;0;0;0;.00nan;0;0
10700;186641;212;96;21;0;21;1.000;3600000;0
10638;171405;2620;0;0;0;0;.00nan;0;0
10638;179169;209;66;39;3;36;.923;3900000;0
10638;-1;2620;59;23;3;20;.870;3900000;0
10638;186205;209;0;0;0;0;.00nan;0;0
10863;169166;226;61;32;3;29;.906;3600000;0
10863;175370;199;0;0;0;0;.00nan;0;0
10863;192629;226;0;0;0;0;.00nan;0;0
10863;161006;199;43;30;4;26;.867;3554000;0
10864;174147;179;0;0;0;0;.00nan;0;0
10864;179602;177;0;0;0;0;.00nan;0;0
10864;176672;177;94;48;2;46;.958;3585000;0
10864;187355;179;93;23;0;23;1.000;3600000;0
11631;179388;182;52;27;5;22;.815;3600000;0
11631;182116;182;0;0;0;0;.00nan;0;0
11631;-1;214;73;29;2;27;.931;3600000;0
11631;191518;214;0;0;0;0;.00nan;0;0
10929;173340;231;0;0;0;0;.00nan;0;0
10929;184175;224;78;45;4;41;.911;3600000;0
10929;185034;231;69;24;2;22;.917;3600000;0
10929;185840;224;0;0;0;0;.00nan;0;0
10678;168117;192;0;0;0;0;.00nan;0;0
10678;174325;197;96;47;3;44;.936;3568000;0
10678;175436;197;0;0;0;0;.00nan;0;0
10678;-1;192;74;14;1;13;.929;3600000;0
10967;167404;215;59;37;5;32;.865;3596000;0
10967;165731;215;0;0;0;0;.00nan;0;0
10967;181065;219;55;27;3;24;.889;3600000;0
10967;181102;219;0;0;0;0;.00nan;0;0
11168;170114;4959;68;27;3;24;.889;3600000;0
11168;195363;4959;0;0;0;0;.00nan;0;0
11168;171662;176;46;28;5;23;.821;3577000;0
11168;176932;176;0;0;0;0;.00nan;0;0
10796;170351;194;0;0;0;0;.00nan;0;0
10796;176200;195;82;25;1;24;.960;3600000;0
10796;179647;195;0;0;0;0;.00nan;0;0
10796;196352;194;83;46;3;43;.935;3547000;0
10567;190034;217;59;14;2;12;.857;953000;0
10567;190041;217;35;27;6;21;.778;2647000;0
10567;179679;212;0;0;0;0;.00nan;0;0
10567;186641;212;56;24;3;21;.875;3600000;0
10713;171839;189;0;0;0;0;.00nan;0;0
10713;192862;187;0;0;0;0;.00nan;0;0
10713;189081;187;94;19;0;19;1.000;3600000;0
10713;-1;189;63;26;2;24;.923;3600000;0
10623;184069;208;85;32;2;30;.938;3600000;0
10623;179702;208;0;0;0;0;.00nan;0;0
10623;-1;207;60;49;6;43;.878;3600000;0
10623;-1;207;0;0;0;0;.00nan;0;0
10882;171835;4960;50;32;4;28;.875;3600000;0
10882;194219;4960;0;0;0;0;.00nan;0;0
10882;181338;230;0;0;0;0;.00nan;0;0
10882;186495;230;27;20;5;15;.750;3560000;0
11050;-1;4949;73;25;2;23;.920;3600000;0
11050;195251;4949;0;0;0;0;.00nan;0;0
11050;174147;179;0;0;0;0;.00nan;0;0
11050;187355;179;83;43;3;40;.930;3591000;0
10826;177248;201;0;0;0;0;.00nan;0;0
10826;195238;200;0;0;0;0;.00nan;0;0
10826;185743;201;70;28;3;25;.893;3900000;0
10826;187295;200;100;50;3;47;.940;3900000;0
10950;175423;223;83;35;2;33;.943;3600000;0
10950;179430;229;0;0;0;0;.00nan;0;0
10950;185800;229;64;31;4;27;.871;3541000;0
10950;187118;223;0;0;0;0;.00nan;0;0
10824;182467;185;55;28;3;25;.893;3600000;0
10824;179388;182;0;0;0;0;.00nan;0;0
10824;180110;185;0;0;0;0;.00nan;0;0
10824;182116;182;87;34;2;32;.941;3600000;0
10969;194416;191;64;16;1;15;.938;3600000;0
10969;178394;188;0;0;0;0;.00nan;0;0
10969;194893;191;0;0;0;0;.00nan;0;0
10969;174153;188;83;36;2;34;.944;3580000;0
10635;166762;213;55;41;5;36;.878;3600000;0
10635;180575;213;0;0;0;0;.00nan;0;0
10635;180762;1505;0;0;0;0;.00nan;0;0
10635;186549;1505;94;19;0;19;1.000;3600000;0
10626;175364;206;38;41;6;35;.854;3057000;0
10626;-1;207;0;0;0;0;.00nan;0;0
10626;196283;206;61;8;0;8;1.000;543000;0
10626;-1;207;71;35;2;33;.943;3600000;0
10759;190125;184;48;32;5;27;.844;3558000;0
10759;179668;184;0;0;0;0;.00nan;0;0
10759;180578;181;80;13;0;13;1.000;1498000;0
10759;-1;181;43;21;4;17;.810;2102000;0
10832;168907;186;0;0;0;0;.00nan;0;0
10832;169226;186;55;29;4;25;.862;3545000;0
10832;195164;218;0;0;0;0;.00nan;0;0
10832;192457;218;73;38;3;35;.921;3600000;0
10724;171730;220;58;10;1;9;.900;3600000;0
10724;187443;220;0;0;0;0;.00nan;0;0
10724;-1;214;81;52;5;47;.904;3600000;0
10724;191518;214;0;0;0;0;.00nan;0;0
10703;182454;4864;0;0;0;0;.00nan;0;0
10703;183737;4864;44;28;4;24;.857;3600000;0
10703;171405;2620;61;29;3;26;.897;3600000;0
10703;-1;2620;0;0;0;0;.00nan;0;0
11603;169166;226;70;20;1;19;.950;3600000;0
11603;180623;202;78;33;2;31;.939;3575000;0
11603;192498;202;0;0;0;0;.00nan;0;0
11603;192629;226;0;0;0;0;.00nan;0;0
10705;168117;192;78;23;1;22;.957;3600000;0
10705;170351;194;67;37;4;33;.892;3600000;0
10705;-1;192;0;0;0;0;.00nan;0;0
10705;196352;194;0;0;0;0;.00nan;0;0
10794;184175;224;76;31;2;29;.935;3600000;0
10794;-1;227;0;0;0;0;.00nan;0;0
10794;185840;224;0;0;0;0;.00nan;0;0
10794;187217;227;53;40;5;35;.875;3600000;0
10569;-1;211;23;12;4;8;.667;908000;0
10569;179646;211;98;22;0;22;1.000;2659000;0
10569;176938;180;86;33;2;31;.939;3600000;0
10569;-1;180;0;0;0;0;.00nan;0;0
11666;194416;191;0;0;0;0;.00nan;0;0
11666;194893;191;64;14;1;13;.929;3600000;0
11666;-1;196;0;0;0;0;.00nan;0;0
11666;184648;196;93;59;4;55;.932;3600000;0
10637;178394;188;43;52;7;45;.865;3600000;0
10637;174153;188;0;0;0;0;.00nan;0;0
10637;179197;198;38;18;4;14;.778;3600000;0
10637;181431;198;0;0;0;0;.00nan;0;0
10692;-1;1371;0;0;0;0;.00nan;0;0
10692;190125;184;0;0;0;0;.00nan;0;0
10692;179668;184;87;42;2;40;.952;3600000;0
10692;192688;1371;81;27;1;26;.963;3600000;0
11643;171405;2620;0;0;0;0;.00nan;0;0
11643;171662;176;66;40;4;36;.900;3600000;0
11643;176932;176;0;0;0;0;.00nan;0;0
11643;-1;2620;71;26;2;24;.923;3600000;0
10685;171839;189;0;0;0;0;.00nan;0;0
10685;174325;197;0;0;0;0;.00nan;0;0
10685;-1;189;80;23;2;21;.913;3600000;0
10685;175436;197;93;55;4;51;.927;3600000;0
10652;168954;228;84;26;1;25;.962;3600000;0
10652;189885;225;83;33;2;31;.939;3561000;0
10652;175354;228;0;0;0;0;.00nan;0;0
10652;184785;225;0;0;0;0;.00nan;0;0
10681;174147;179;80;58;5;53;.914;3896000;0
10681;-1;210;0;0;0;0;.00nan;0;0
10681;187355;179;0;0;0;0;.00nan;0;0
10681;192461;210;44;25;5;20;.800;3900000;0
10625;-1;203;72;28;2;26;.929;3600000;0
10625;189902;204;0;0;0;0;.00nan;0;0
10625;-1;203;0;0;0;0;.00nan;0;0
10625;182049;204;78;38;3;35;.921;3591000;0
10672;182454;4864;49;18;2;16;.889;3582000;0
10672;183737;4864;0;0;0;0;.00nan;0;0
10672;179169;209;0;0;0;0;.00nan;0;0
10672;186205;209;95;33;1;32;.970;3600000;0
10641;179602;177;78;38;3;35;.921;3600000;0
10641;176672;177;0;0;0;0;.00nan;0;0
10641;180762;1505;0;0;0;0;.00nan;0;0
10641;186549;1505;93;22;0;22;1.000;3600000;0
10663;182467;185;0;0;0;0;.00nan;0;0
10663;179388;182;58;27;3;24;.889;3543000;0
10663;180110;185;70;30;2;28;.933;3600000;0
10663;182116;182;0;0;0;0;.00nan;0;0
10722;168117;192;0;0;0;0;.00nan;0;0
10722;176200;195;63;29;3;26;.897;3600000;0
10722;179647;195;0;0;0;0;.00nan;0;0
10722;-1;192;43;23;4;19;.826;3542000;0
10599;166545;193;0;0;0;0;.00nan;0;0
10599;192862;187;0;0;0;0;.00nan;0;0
10599;189081;187;100;43;2;41;.953;3619000;0
10599;173770;193;71;31;3;28;.903;3619000;0
10717;166762;213;0;0;0;0;.00nan;0;0
10717;174209;178;0;0;0;0;.00nan;0;0
10717;180575;213;83;33;2;31;.939;3900000;0
10717;-1;178;52;19;2;17;.895;3900000;0
10997;175370;199;52;31;4;27;.871;3578000;0
10997;180623;202;0;0;0;0;.00nan;0;0
10997;192498;202;76;33;2;31;.939;3600000;0
10997;161006;199;0;0;0;0;.00nan;0;0
11017;195164;218;91;31;1;30;.968;3600000;0
11017;181065;219;38;27;5;22;.815;3600000;0
11017;181102;219;0;0;0;0;.00nan;0;0
11017;192457;218;0;0;0;0;.00nan;0;0
10577;190034;217;99;46;2;44;.957;3600000;0
10577;190041;217;0;0;0;0;.00nan;0;0
10577;176938;180;56;29;4;25;.862;3565000;0
10577;-1;180;0;0;0;0;.00nan;0;0
10762;184069;208;0;0;0;0;.00nan;0;0
10762;195238;200;99;53;2;51;.962;3755000;0
10762;179702;208;43;12;3;9;.750;3755000;0
10762;187295;200;0;0;0;0;.00nan;0;0
10741;-1;221;25;22;5;17;.773;3559000;0
10741;179406;232;88;52;4;48;.923;3600000;0
10741;179434;232;0;0;0;0;.00nan;0;0
10741;187362;221;0;0;0;0;.00nan;0;0
11187;171835;4960;0;0;0;0;.00nan;0;0
11187;194219;4960;79;43;3;40;.930;3600000;0
11187;173340;231;0;0;0;0;.00nan;0;0
11187;185034;231;32;21;5;16;.762;3515000;0
10806;-1;227;61;40;5;35;.875;3545000;0
10806;184610;222;42;19;4;15;.789;3600000;0
10806;185851;222;0;0;0;0;.00nan;0;0
10806;187217;227;0;0;0;0;.00nan;0;0
10923;167404;215;28;21;5;16;.762;3595000;0
10923;165731;215;0;0;0;0;.00nan;0;0
10923;-1;211;67;31;3;28;.903;3600000;0
10923;179646;211;0;0;0;0;.00nan;0;0
10932;180578;181;0;0;0;0;.00nan;0;0
10932;-1;181;70;20;1;19;.950;3600000;0
10932;-1;214;0;0;0;0;.00nan;0;0
10932;191518;214;72;27;2;25;.926;3600000;0
10737;184175;224;43;4;1;3;.750;443000;0
10737;179430;229;0;0;0;0;.00nan;0;0
10737;185800;229;74;21;1;20;.952;3600000;0
10737;185840;224;45;39;6;33;.846;3157000;0
10937;175423;223;0;0;0;0;.00nan;0;0
10937;181338;230;0;0;0;0;.00nan;0;0
10937;186495;230;71;8;0;8;1.000;3600000;0
10937;187118;223;98;54;3;51;.944;3600000;0
11641;169166;226;66;32;3;29;.906;3900000;0
11641;175370;199;0;0;0;0;.00nan;0;0
11641;192629;226;0;0;0;0;.00nan;0;0
11641;161006;199;80;41;3;38;.927;3900000;0
10634;-1;207;93;42;2;40;.952;3600000;0
10634;-1;205;63;38;4;34;.895;3521000;0
10634;187092;205;0;0;0;0;.00nan;0;0
10634;-1;207;0;0;0;0;.00nan;0;0
10662;-1;4949;75;42;3;39;.929;3533000;0
10662;195251;4949;0;0;0;0;.00nan;0;0
10662;-1;210;72;20;1;19;.950;3600000;0
10662;192461;210;0;0;0;0;.00nan;0;0
10686;170114;4959;53;19;3;16;.842;3600000;0
10686;195363;4959;0;0;0;0;.00nan;0;0
10686;179169;209;44;44;6;38;.864;3600000;0
10686;186205;209;0;0;0;0;.00nan;0;0
10757;179602;177;0;0;0;0;.00nan;0;0
10757;176672;177;86;50;3;47;.940;3600000;0
10757;187240;216;83;10;0;10;1.000;3600000;0
10757;191557;216;0;0;0;0;.00nan;0;0
10781;168907;186;0;0;0;0;.00nan;0;0
10781;169226;186;60;33;4;29;.879;3745000;0
10781;179679;212;0;0;0;0;.00nan;0;0
10781;186641;212;41;31;5;26;.839;3745000;0
10792;171835;4960;39;26;5;21;.808;3900000;0
10792;194219;4960;0;0;0;0;.00nan;0;0
10792;179406;232;62;52;5;47;.904;3900000;0
10792;179434;232;0;0;0;0;.00nan;0;0
10688;182467;185;95;42;2;40;.952;3900000;0
10688;-1;1371;0;0;0;0;.00nan;0;0
10688;180110;185;0;0;0;0;.00nan;0;0
10688;192688;1371;69;28;2;26;.929;3900000;0
10605;166545;193;74;30;2;28;.933;3600000;0
10605;173770;193;0;0;0;0;.00nan;0;0
10605;179197;198;28;8;3;5;.625;554000;0
10605;181431;198;64;20;2;18;.900;3046000;0
10777;-1;221;0;0;0;0;.00nan;0;0
10777;181338;230;0;0;0;0;.00nan;0;0
10777;186495;230;76;23;1;22;.957;3600000;0
10777;187362;221;64;40;4;36;.900;3600000;0
10650;-1;207;0;0;0;0;.00nan;0;0
10650;-1;205;0;0;0;0;.00nan;0;0
10650;187092;205;81;21;1;20;.952;3600000;0
10650;-1;207;62;34;3;31;.912;3582000;0
10887;174147;179;100;25;0;25;1.000;3600000;0
10887;179400;183;0;0;0;0;.00nan;0;0
10887;182089;183;94;39;1;38;.974;3600000;0
10887;187355;179;0;0;0;0;.00nan;0;0
10725;171839;189;0;0;0;0;.00nan;0;0
10725;174325;197;51;33;4;29;.879;3545000;0
10725;-1;189;83;35;3;32;.914;3600000;0
10725;175436;197;0;0;0;0;.00nan;0;0
10801;166762;213;100;28;0;28;1.000;3600000;0
10801;174209;178;86;31;1;30;.968;3600000;0
10801;180575;213;0;0;0;0;.00nan;0;0
10801;-1;178;0;0;0;0;.00nan;0;0
10819;168954;228;86;38;3;35;.921;3900000;0
10819;184610;222;73;33;3;30;.909;3900000;0
10819;175354;228;0;0;0;0;.00nan;0;0
10819;185851;222;0;0;0;0;.00nan;0;0
10866;179388;182;0;0;0;0;.00nan;0;0
10866;182116;182;64;22;2;20;.909;3600000;0
10866;-1;214;20;23;6;17;.739;2807000;0
10866;191518;214;46;7;1;6;.857;793000;0
10740;171730;220;32;33;6;27;.818;3530000;0
10740;190125;184;67;38;4;34;.895;3600000;0
10740;179668;184;0;0;0;0;.00nan;0;0
10740;187443;220;0;0;0;0;.00nan;0;0
10695;192862;187;80;32;2;30;.938;3600000;0
10695;189081;187;0;0;0;0;.00nan;0;0
10695;169096;190;77;48;5;43;.896;3600000;0
10695;197704;190;0;0;0;0;.00nan;0;0
10636;189885;225;0;0;0;0;.00nan;0;0
10636;179430;229;0;0;0;0;.00nan;0;0
10636;184785;225;72;29;2;27;.931;3600000;0
10636;185800;229;70;19;1;18;.947;3600000;0
10674;-1;203;40;21;4;17;.810;3600000;0
10674;-1;203;0;0;0;0;.00nan;0;0
10674;180623;202;99;45;1;44;.978;3600000;0
10674;192498;202;0;0;0;0;.00nan;0;0
10807;184069;208;0;0;0;0;.00nan;0;0
10807;169166;226;0;0;0;0;.00nan;0;0
10807;179702;208;63;16;1;15;.938;3600000;0
10807;192629;226;89;37;2;35;.946;3600000;0
10730;189902;204;0;0;0;0;.00nan;0;0
10730;175364;206;91;44;2;42;.955;3900000;0
10730;196283;206;0;0;0;0;.00nan;0;0
10730;182049;204;85;27;2;25;.926;3900000;0
10756;182454;4864;0;0;0;0;.00nan;0;0
10756;183737;4864;100;27;0;27;1.000;3600000;0
10756;171405;2620;65;25;2;23;.920;3600000;0
10756;-1;2620;0;0;0;0;.00nan;0;0
10776;195238;200;0;0;0;0;.00nan;0;0
10776;-1;203;0;0;0;0;.00nan;0;0
10776;-1;203;46;31;4;27;.871;3534000;0
10776;187295;200;71;27;2;25;.926;3600000;0
11662;171835;4960;0;0;0;0;.00nan;0;0
11662;194219;4960;87;20;0;20;1.000;3600000;0
11662;179430;229;73;38;3;35;.921;3600000;0
11662;185800;229;0;0;0;0;.00nan;0;0
10586;167404;215;41;24;4;20;.833;3550000;0
10586;165731;215;0;0;0;0;.00nan;0;0
10586;190034;217;78;31;2;29;.935;3600000;0
10586;190041;217;0;0;0;0;.00nan;0;0
10876;182467;185;56;33;4;29;.879;2172000;0
10876;190125;184;0;0;0;0;.00nan;0;0
10876;179668;184;67;15;1;14;.933;3600000;0
10876;180110;185;23;23;6;17;.739;1428000;0
10742;189902;204;83;36;2;34;.944;3556000;0
10742;175370;199;0;0;0;0;.00nan;0;0
10742;182049;204;0;0;0;0;.00nan;0;0
10742;161006;199;90;33;1;32;.970;3600000;0
10649;189885;225;74;41;3;38;.927;3600000;0
10649;184610;222;0;0;0;0;.00nan;0;0
10649;184785;225;0;0;0;0;.00nan;0;0
10649;185851;222;100;30;0;30;1.000;3600000;0
10783;-1;221;60;43;5;38;.884;3582000;0
10783;-1;227;31;7;3;4;.571;456000;0
10783;187217;227;83;27;1;26;.963;3144000;0
10783;187362;221;0;0;0;0;.00nan;0;0
10645;166545;193;0;0;0;0;.00nan;0;0
10645;173770;193;100;42;2;40;.952;3600000;0
10645;176200;195;72;30;3;27;.900;3551000;0
10645;179647;195;0;0;0;0;.00nan;0;0
10773;168907;186;0;0;0;0;.00nan;0;0
10773;169226;186;68;27;3;24;.889;3600000;0
10773;181065;219;31;29;6;23;.793;3600000;0
10773;181102;219;0;0;0;0;.00nan;0;0
10707;171730;220;0;0;0;0;.00nan;0;0
10707;-1;1371;100;29;0;29;1.000;3600000;0
10707;187443;220;51;34;5;29;.853;3600000;0
10707;192688;1371;0;0;0;0;.00nan;0;0
10836;170351;194;0;0;0;0;.00nan;0;0
10836;-1;196;0;0;0;0;.00nan;0;0
10836;184648;196;60;38;5;33;.868;3900000;0
10836;196352;194;37;29;5;24;.828;3900000;0
10849;168954;228;0;0;0;0;.00nan;0;0
10849;184175;224;54;24;3;21;.875;3600000;0
10849;175354;228;91;30;1;29;.967;3600000;0
10849;185840;224;0;0;0;0;.00nan;0;0
10829;177248;201;0;0;0;0;.00nan;0;0
10829;184069;208;60;30;4;26;.867;3587000;0
10829;179702;208;0;0;0;0;.00nan;0;0
10829;185743;201;74;37;3;34;.919;3600000;0
10790;-1;211;90;28;1;27;.964;3600000;0
10790;179646;211;0;0;0;0;.00nan;0;0
10790;179679;212;0;0;0;0;.00nan;0;0
10790;186641;212;75;40;3;37;.925;3556000;0
10736;-1;210;0;0;0;0;.00nan;0;0
10736;187240;216;90;42;2;40;.952;3569000;0
10736;191557;216;0;0;0;0;.00nan;0;0
10736;192461;210;100;26;0;26;1.000;3600000;0
10716;-1;4949;75;28;2;26;.929;3600000;0
10716;195251;4949;0;0;0;0;.00nan;0;0
10716;180762;1505;0;0;0;0;.00nan;0;0
10716;186549;1505;60;33;4;29;.879;3550000;0
11607;174147;179;0;0;0;0;.00nan;0;0
11607;179400;183;62;46;5;41;.891;3600000;0
11607;182089;183;0;0;0;0;.00nan;0;0
11607;187355;179;90;31;2;29;.935;3600000;0
10754;171839;189;0;0;0;0;.00nan;0;0
10754;192862;187;0;0;0;0;.00nan;0;0
10754;189081;187;84;24;1;23;.958;3600000;0
10754;-1;189;51;32;4;28;.875;3600000;0
10712;168117;192;0;0;0;0;.00nan;0;0
10712;169096;190;62;45;5;40;.889;3600000;0
10712;-1;192;71;9;0;9;1.000;3600000;0
10712;197704;190;0;0;0;0;.00nan;0;0
10970;178394;188;51;2;0;2;1.000;404000;0
10970;170351;194;74;26;2;24;.923;3600000;0
10970;174153;188;37;33;6;27;.818;3196000;0
10970;196352;194;0;0;0;0;.00nan;0;0
11149;169166;226;78;46;6;40;.870;3900000;0
11149;175370;199;30;24;6;18;.750;2924000;0
11149;192629;226;0;0;0;0;.00nan;0;0
11149;161006;199;54;1;0;1;1.000;976000;0
10683;175364;206;48;20;3;17;.850;3600000;0
10683;196283;206;0;0;0;0;.00nan;0;0
10683;-1;205;34;24;5;19;.792;3595000;0
10683;187092;205;0;0;0;0;.00nan;0;0
10640;179197;198;0;0;0;0;.00nan;0;0
10640;176200;195;0;0;0;0;.00nan;0;0
10640;179647;195;77;32;3;29;.906;3600000;0
10640;181431;198;52;36;5;31;.861;3581000;0
11175;167404;215;0;0;0;0;.00nan;0;0
11175;165731;215;92;43;2;41;.953;3900000;0
11175;181065;219;0;0;0;0;.00nan;0;0
11175;181102;219;74;28;2;26;.929;3900000;0
10791;195164;218;79;27;1;26;.963;3600000;0
10791;179679;212;0;0;0;0;.00nan;0;0
10791;186641;212;51;23;3;20;.870;3595000;0
10791;192457;218;0;0;0;0;.00nan;0;0
10867;179406;232;45;31;5;26;.839;3581000;0
10867;175423;223;69;29;3;26;.897;3600000;0
10867;179434;232;0;0;0;0;.00nan;0;0
10867;187118;223;0;0;0;0;.00nan;0;0
11014;168117;192;0;0;0;0;.00nan;0;0
11014;-1;196;71;37;3;34;.919;3600000;0
11014;184648;196;0;0;0;0;.00nan;0;0
11014;-1;192;53;11;2;9;.818;3600000;0
10874;174209;178;92;33;1;32;.970;3600000;0
10874;179602;177;50;28;4;24;.857;3600000;0
10874;176672;177;0;0;0;0;.00nan;0;0
10874;-1;178;0;0;0;0;.00nan;0;0
10592;190034;217;0;0;0;0;.00nan;0;0
10592;190041;217;58;33;4;29;.879;3577000;0
10592;176938;180;0;0;0;0;.00nan;0;0
10592;-1;180;57;24;3;21;.875;3600000;0
10702;170114;4959;63;30;3;27;.900;3600000;0
10702;195363;4959;0;0;0;0;.00nan;0;0
10702;179169;209;0;0;0;0;.00nan;0;0
10702;186205;209;74;41;4;37;.902;3566000;0
10750;169096;190;71;22;1;21;.955;3600000;0
10750;174325;197;83;37;3;34;.919;3600000;0
10750;175436;197;0;0;0;0;.00nan;0;0
10750;197704;190;0;0;0;0;.00nan;0;0
11646;174209;178;0;0;0;0;.00nan;0;0
11646;179602;177;0;0;0;0;.00nan;0;0
11646;176672;177;49;29;4;25;.862;3600000;0
11646;-1;178;62;26;2;24;.923;3600000;0
11275;168954;228;44;25;4;21;.840;3595000;0
11275;189885;225;83;33;2;31;.939;3600000;0
11275;175354;228;0;0;0;0;.00nan;0;0
11275;184785;225;0;0;0;0;.00nan;0;0
10765;179400;183;0;0;0;0;.00nan;0;0
10765;182089;183;97;49;2;47;.959;3900000;0
10765;187240;216;0;0;0;0;.00nan;0;0
10765;191557;216;69;19;2;17;.895;3900000;0
10786;170114;4959;50;27;3;24;.889;3900000;0
10786;195363;4959;0;0;0;0;.00nan;0;0
10786;171405;2620;90;42;3;39;.929;3900000;0
10786;-1;2620;0;0;0;0;.00nan;0;0
11340;173340;231;0;0;0;0;.00nan;0;0
11340;-1;227;0;0;0;0;.00nan;0;0
11340;185034;231;88;18;0;18;1.000;3600000;0
11340;187217;227;62;41;4;37;.902;3600000;0
10803;177248;201;0;0;0;0;.00nan;0;0
10803;180623;202;84;31;2;29;.935;3600000;0
10803;185743;201;52;38;5;33;.868;3600000;0
10803;192498;202;0;0;0;0;.00nan;0;0
11640;195164;218;56;34;4;30;.882;3600000;0
11640;181065;219;0;0;0;0;.00nan;0;0
11640;181102;219;93;16;0;16;1.000;3600000;0
11640;192457;218;0;0;0;0;.00nan;0;0
11058;182454;4864;0;0;0;0;.00nan;0;0
11058;183737;4864;66;35;4;31;.886;3549000;0
11058;171662;176;0;0;0;0;.00nan;0;0
11058;176932;176;85;46;3;43;.935;3600000;0
10709;171405;2620;0;0;0;0;.00nan;0;0
10709;179169;209;0;0;0;0;.00nan;0;0
10709;-1;2620;81;26;1;25;.962;3600000;0
10709;186205;209;38;40;7;33;.825;3600000;0
10738;179400;183;0;0;0;0;.00nan;0;0
10738;180762;1505;61;18;2;16;.889;3600000;0
10738;182089;183;63;49;6;43;.878;3600000;0
10738;186549;1505;0;0;0;0;.00nan;0;0
10828;171835;4960;0;0;0;0;.00nan;0;0
10828;194219;4960;44;18;3;15;.833;3900000;0
10828;179406;232;97;50;3;47;.940;3900000;0
10828;179434;232;0;0;0;0;.00nan;0;0
10854;168117;192;43;18;4;14;.778;3600000;0
10854;176200;195;87;36;3;33;.917;3600000;0
10854;179647;195;0;0;0;0;.00nan;0;0
10854;-1;192;0;0;0;0;.00nan;0;0
11186;171839;189;0;0;0;0;.00nan;0;0
11186;-1;196;0;0;0;0;.00nan;0;0
11186;-1;189;59;29;3;26;.897;3580000;0
11186;184648;196;80;22;1;21;.955;3600000;0
10789;166545;193;78;42;3;39;.929;3600000;0
10789;194416;191;0;0;0;0;.00nan;0;0
10789;194893;191;34;25;5;20;.800;3542000;0
10789;173770;193;0;0;0;0;.00nan;0;0
10868;184069;208;53;29;4;25;.862;3600000;0
10868;195238;200;57;43;5;38;.884;3600000;0
10868;179702;208;0;0;0;0;.00nan;0;0
10868;187295;200;0;0;0;0;.00nan;0;0
10886;166762;213;32;36;7;29;.806;3600000;0
10886;180575;213;0;0;0;0;.00nan;0;0
10886;187240;216;75;32;2;30;.938;3600000;0
10886;191557;216;0;0;0;0;.00nan;0;0
11550;175423;223;55;47;6;41;.872;3013000;0
11550;181338;230;0;0;0;0;.00nan;0;0
11550;186495;230;77;21;1;20;.952;3600000;0
11550;187118;223;59;5;0;5;1.000;587000;0
10788;171730;220;48;34;5;29;.853;3900000;0
10788;187443;220;0;0;0;0;.00nan;0;0
10788;-1;214;68;51;5;46;.902;3900000;0
10788;191518;214;0;0;0;0;.00nan;0;0
10875;190125;184;54;29;4;25;.862;3572000;0
10875;179668;184;0;0;0;0;.00nan;0;0
10875;180578;181;0;0;0;0;.00nan;0;0
10875;-1;181;56;19;3;16;.842;3600000;0
11673;175370;199;0;0;0;0;.00nan;0;0
11673;-1;207;0;0;0;0;.00nan;0;0
11673;-1;207;69;27;2;25;.926;3600000;0
11673;161006;199;47;24;4;20;.833;3575000;0
10805;173340;231;0;0;0;0;.00nan;0;0
10805;-1;221;63;33;4;29;.879;2637000;0
10805;185034;231;80;26;1;25;.962;3600000;0
10805;187362;221;15;13;5;8;.615;963000;0
10961;170351;194;81;31;2;29;.935;3600000;0
10961;174325;197;0;0;0;0;.00nan;0;0
10961;175436;197;60;52;7;45;.865;3600000;0
10961;196352;194;0;0;0;0;.00nan;0;0
10727;-1;4949;61;38;4;34;.895;3600000;0
10727;195251;4949;0;0;0;0;.00nan;0;0
10727;180762;1505;68;19;1;18;.947;3600000;0
10727;186549;1505;0;0;0;0;.00nan;0;0
10799;-1;1371;41;38;6;32;.842;3600000;0
10799;180578;181;71;32;3;29;.906;3600000;0
10799;-1;181;0;0;0;0;.00nan;0;0
10799;192688;1371;0;0;0;0;.00nan;0;0
10971;184610;222;0;0;0;0;.00nan;0;0
10971;179430;229;0;0;0;0;.00nan;0;0
10971;185800;229;91;40;1;39;.975;3600000;0
10971;185851;222;53;20;2;18;.900;3554000;0
10603;168907;186;0;0;0;0;.00nan;0;0
10603;169226;186;100;24;0;24;1.000;3600000;0
10603;176938;180;85;31;2;29;.935;3580000;0
10603;-1;180;0;0;0;0;.00nan;0;0
10808;166545;193;0;0;0;0;.00nan;0;0
10808;178394;188;46;26;5;21;.808;3600000;0
10808;173770;193;71;27;2;25;.926;3600000;0
10808;174153;188;0;0;0;0;.00nan;0;0
10704;168954;228;76;35;2;33;.943;3648000;0
10704;189885;225;0;0;0;0;.00nan;0;0
10704;175354;228;0;0;0;0;.00nan;0;0
10704;184785;225;83;42;3;39;.929;3648000;0
10714;189902;204;56;26;3;23;.885;3027000;0
10714;182049;204;26;9;3;6;.667;573000;0
10714;-1;205;76;25;1;24;.960;3600000;0
10714;187092;205;0;0;0;0;.00nan;0;0
10903;182467;185;73;22;1;21;.955;3600000;0
10903;179388;182;0;0;0;0;.00nan;0;0
10903;180110;185;0;0;0;0;.00nan;0;0
10903;182116;182;70;38;4;34;.895;3600000;0
10779;169166;226;72;27;2;25;.926;3600000;0
10779;175364;206;74;32;3;29;.906;3577000;0
10779;196283;206;0;0;0;0;.00nan;0;0
10779;192629;226;0;0;0;0;.00nan;0;0
10859;182454;4864;78;39;3;36;.923;3817000;0
10859;183737;4864;0;0;0;0;.00nan;0;0
10859;170114;4959;69;30;2;28;.933;3817000;0
10859;195363;4959;0;0;0;0;.00nan;0;0
10896;171839;189;0;0;0;0;.00nan;0;0
10896;168117;192;0;0;0;0;.00nan;0;0
10896;-1;189;91;45;3;42;.933;3588000;0
10896;-1;192;60;21;2;19;.905;3600000;0
10893;177248;201;0;0;0;0;.00nan;0;0
10893;195238;200;0;0;0;0;.00nan;0;0
10893;185743;201;61;26;3;23;.885;3555000;0
10893;187295;200;86;34;2;32;.941;3600000;0
10655;-1;211;63;36;5;31;.861;3600000;0
10655;190034;217;72;27;2;25;.926;3600000;0
10655;190041;217;0;0;0;0;.00nan;0;0
10655;179646;211;0;0;0;0;.00nan;0;0
10847;-1;227;53;44;6;38;.864;3338000;0
10847;181338;230;25;4;3;1;.250;129000;0
10847;186495;230;47;12;2;10;.833;3471000;0
10847;187217;227;51;2;0;2;1.000;208000;0
10837;192862;187;0;0;0;0;.00nan;0;0
10837;189081;187;61;27;2;25;.926;3864000;0
10837;176200;195;0;0;0;0;.00nan;0;0
10837;179647;195;73;32;3;29;.906;3864000;0
11034;166762;213;0;0;0;0;.00nan;0;0
11034;179602;177;55;28;3;25;.893;3600000;0
11034;176672;177;0;0;0;0;.00nan;0;0
11034;180575;213;35;28;5;23;.821;3567000;0
10772;174209;178;53;42;5;37;.881;3600000;0
10772;-1;210;0;0;0;0;.00nan;0;0
10772;192461;210;91;18;0;18;1.000;3600000;0
10772;-1;178;0;0;0;0;.00nan;0;0
10855;184175;224;86;34;2;32;.941;3600000;0
10855;179406;232;0;0;0;0;.00nan;0;0
10855;179434;232;50;33;4;29;.879;3563000;0
10855;185840;224;0;0;0;0;.00nan;0;0
10761;171662;176;65;34;4;30;.882;3600000;0
10761;179169;209;100;30;0;30;1.000;3600000;0
10761;176932;176;0;0;0;0;.00nan;0;0
10761;186205;209;0;0;0;0;.00nan;0;0
10653;169096;190;54;38;6;32;.842;2434000;0
10653;179197;198;76;24;1;23;.958;3600000;0
10653;181431;198;0;0;0;0;.00nan;0;0
10653;197704;190;72;20;1;19;.950;1166000;0
10665;184069;208;0;0;0;0;.00nan;0;0
10665;179702;208;58;28;3;25;.893;3522000;0
10665;-1;207;90;47;2;45;.957;3600000;0
10665;-1;207;0;0;0;0;.00nan;0;0
10841;195164;218;0;0;0;0;.00nan;0;0
10841;179679;212;62;22;2;20;.909;3600000;0
10841;186641;212;0;0;0;0;.00nan;0;0
10841;192457;218;60;35;4;31;.886;3578000;0
10877;-1;211;0;0;0;0;.00nan;0;0
10877;179646;211;75;29;2;27;.931;3600000;0
10877;179679;212;0;0;0;0;.00nan;0;0
10877;186641;212;56;27;3;24;.889;3600000;0
10778;171730;220;69;29;2;27;.931;3600000;0
10778;-1;1371;0;0;0;0;.00nan;0;0
10778;187443;220;0;0;0;0;.00nan;0;0
10778;192688;1371;72;41;4;37;.902;3565000;0
10907;179400;183;99;58;1;57;.983;3600000;0
10907;182089;183;0;0;0;0;.00nan;0;0
10907;187240;216;43;12;2;10;.833;3551000;0
10907;191557;216;0;0;0;0;.00nan;0;0
11125;174147;179;62;20;2;18;.900;3600000;0
11125;179602;177;79;42;3;39;.929;3600000;0
11125;176672;177;0;0;0;0;.00nan;0;0
11125;187355;179;0;0;0;0;.00nan;0;0
10850;169096;190;55;39;5;34;.872;3600000;0
10850;170351;194;0;0;0;0;.00nan;0;0
10850;196352;194;57;19;2;17;.895;3600000;0
10850;197704;190;0;0;0;0;.00nan;0;0
10690;190034;217;0;0;0;0;.00nan;0;0
10690;190041;217;61;27;2;25;.926;3545000;0
10690;176938;180;0;0;0;0;.00nan;0;0
10690;-1;180;86;31;1;30;.968;3600000;0
10848;179388;182;0;0;0;0;.00nan;0;0
10848;190125;184;73;41;3;38;.927;3659000;0
10848;179668;184;0;0;0;0;.00nan;0;0
10848;182116;182;74;40;4;36;.900;3659000;0
10879;179400;183;0;0;0;0;.00nan;0;0
10879;182089;183;73;49;5;44;.898;3600000;0
10879;187240;216;0;0;0;0;.00nan;0;0
10879;191557;216;81;22;1;21;.955;3600000;0
10945;195238;200;0;0;0;0;.00nan;0;0
10945;175370;199;69;22;1;21;.955;3600000;0
10945;187295;200;91;42;3;39;.929;3600000;0
10945;161006;199;0;0;0;0;.00nan;0;0
11334;167404;215;0;0;0;0;.00nan;0;0
11334;165731;215;100;39;1;38;.974;3600000;0
11334;181065;219;0;0;0;0;.00nan;0;0
11334;181102;219;60;24;3;21;.875;3565000;0
10821;174147;179;0;0;0;0;.00nan;0;0
10821;-1;210;0;0;0;0;.00nan;0;0
10821;187355;179;45;30;4;26;.867;3562000;0
10821;192461;210;69;26;2;24;.923;3600000;0
10860;192862;187;61;32;4;28;.875;3584000;0
10860;168117;192;0;0;0;0;.00nan;0;0
10860;189081;187;0;0;0;0;.00nan;0;0
10860;-1;192;67;27;2;25;.926;3600000;0
10857;168907;186;0;0;0;0;.00nan;0;0
10857;169226;186;52;28;4;24;.857;3900000;0
10857;195164;218;77;45;4;41;.911;3900000;0
10857;192457;218;0;0;0;0;.00nan;0;0
10745;171730;220;0;0;0;0;.00nan;0;0
10745;187443;220;41;24;5;19;.792;3600000;0
10745;-1;214;91;33;1;32;.970;3600000;0
10745;191518;214;0;0;0;0;.00nan;0;0
10818;178394;188;0;0;0;0;.00nan;0;0
10818;174153;188;72;31;4;27;.871;3578000;0
10818;176200;195;74;32;3;29;.906;3600000;0
10818;179647;195;0;0;0;0;.00nan;0;0
10816;184175;224;98;55;3;52;.945;3600000;0
10816;-1;221;91;19;0;19;1.000;3600000;0
10816;185840;224;0;0;0;0;.00nan;0;0
10816;187362;221;0;0;0;0;.00nan;0;0
10769;189885;225;79;40;3;37;.925;3600000;0
10769;184610;222;0;0;0;0;.00nan;0;0
10769;184785;225;0;0;0;0;.00nan;0;0
10769;185851;222;53;33;4;29;.879;3560000;0
11010;171839;189;0;0;0;0;.00nan;0;0
11010;-1;196;0;0;0;0;.00nan;0;0
11010;-1;189;77;40;4;36;.900;3600000;0
11010;184648;196;78;24;1;23;.958;3600000;0
11059;194416;191;0;0;0;0;.00nan;0;0
11059;194893;191;71;6;0;6;1.000;3600000;0
11059;174325;197;81;46;4;42;.913;3600000;0
11059;175436;197;0;0;0;0;.00nan;0;0
11002;173340;231;0;0;0;0;.00nan;0;0
11002;179430;229;0;0;0;0;.00nan;0;0
11002;185034;231;88;17;0;17;1.000;3600000;0
11002;185800;229;96;53;2;51;.962;3600000;0
10784;174209;178;96;64;2;62;.969;3600000;0
10784;180762;1505;43;15;3;12;.800;3563000;0
10784;186549;1505;0;0;0;0;.00nan;0;0
10784;-1;178;0;0;0;0;.00nan;0;0
10899;168954;228;70;31;3;28;.903;3600000;0
10899;-1;227;0;0;0;0;.00nan;0;0
10899;175354;228;0;0;0;0;.00nan;0;0
10899;187217;227;46;26;4;22;.846;3594000;0
10842;175364;206;0;0;0;0;.00nan;0;0
10842;196283;206;74;36;2;34;.944;3600000;0
10842;180623;202;71;18;1;17;.944;3600000;0
10842;192498;202;0;0;0;0;.00nan;0;0
10696;169166;226;0;0;0;0;.00nan;0;0
10696;-1;207;0;0;0;0;.00nan;0;0
10696;-1;207;77;46;4;42;.913;3600000;0
10696;192629;226;95;35;1;34;.971;3600000;0
10835;170114;4959;90;40;2;38;.950;3600000;0
10835;195363;4959;0;0;0;0;.00nan;0;0
10835;171405;2620;36;30;5;25;.833;3600000;0
10835;-1;2620;0;0;0;0;.00nan;0;0
10691;-1;203;59;30;3;27;.900;3600000;0
10691;-1;203;0;0;0;0;.00nan;0;0
10691;-1;205;50;23;4;19;.826;3552000;0
10691;187092;205;0;0;0;0;.00nan;0;0
10676;166545;193;71;26;2;24;.923;3600000;0
10676;173770;193;0;0;0;0;.00nan;0;0
10676;179197;198;0;0;0;0;.00nan;0;0
10676;181431;198;78;36;3;33;.917;3580000;0
11062;166762;213;0;0;0;0;.00nan;0;0
11062;-1;4949;0;0;0;0;.00nan;0;0
11062;195251;4949;62;22;3;19;.864;3887000;0
11062;180575;213;85;49;4;45;.918;3887000;0
10972;173340;231;0;0;0;0;.00nan;0;0
10972;168954;228;0;0;0;0;.00nan;0;0
10972;175354;228;97;61;3;58;.951;3600000;0
10972;185034;231;54;16;2;14;.875;3600000;0
10964;192862;187;0;0;0;0;.00nan;0;0
10964;189081;187;84;17;0;17;1.000;3600000;0
10964;174325;197;0;0;0;0;.00nan;0;0
10964;175436;197;94;48;2;46;.958;3540000;0
10944;171835;4960;66;23;2;21;.913;3600000;0
10944;194219;4960;0;0;0;0;.00nan;0;0
10944;184610;222;55;38;6;32;.842;3600000;0
10944;185851;222;0;0;0;0;.00nan;0;0
10746;189902;204;69;20;2;18;.900;3873000;0
10746;-1;207;93;55;2;53;.964;3900000;0
10746;182049;204;0;0;0;0;.00nan;0;0
10746;-1;207;0;0;0;0;.00nan;0;0
10770;-1;1371;0;0;0;0;.00nan;0;0
10770;190125;184;0;0;0;0;.00nan;0;0
10770;179668;184;86;29;1;28;.966;3600000;0
10770;192688;1371;75;36;3;33;.917;3600000;0
11423;169096;190;0;0;0;0;.00nan;0;0
11423;-1;196;54;31;4;27;.871;3583000;0
11423;184648;196;0;0;0;0;.00nan;0;0
11423;197704;190;89;40;2;38;.950;3600000;0
10760;168907;186;0;0;0;0;.00nan;0;0
10760;169226;186;82;32;2;30;.938;3600000;0
10760;176938;180;35;19;4;15;.789;3544000;0
10760;-1;180;0;0;0;0;.00nan;0;0
10998;184069;208;59;52;6;46;.885;3354000;0
10998;175370;199;0;0;0;0;.00nan;0;0
10998;179702;208;51;2;0;2;1.000;246000;0
10998;161006;199;75;24;1;23;.958;3600000;0
10993;177248;201;0;0;0;0;.00nan;0;0
10993;180623;202;0;0;0;0;.00nan;0;0
10993;185743;201;100;40;0;40;1.000;3600000;0
10993;192498;202;75;29;2;27;.931;3569000;0
10780;189885;225;0;0;0;0;.00nan;0;0
10780;179430;229;0;0;0;0;.00nan;0;0
10780;184785;225;100;44;1;43;.977;3600000;0
10780;185800;229;59;29;4;25;.862;3600000;0
10912;182467;185;74;21;1;20;.952;3600000;0
10912;180110;185;0;0;0;0;.00nan;0;0
10912;-1;214;0;0;0;0;.00nan;0;0
10912;191518;214;50;31;4;27;.871;3600000;0
11113;194416;191;0;0;0;0;.00nan;0;0
11113;194893;191;66;17;1;16;.941;3600000;0
11113;170351;194;86;35;2;33;.943;3600000;0
11113;196352;194;0;0;0;0;.00nan;0;0
11126;-1;4949;92;23;0;23;1.000;3600000;0
11126;195251;4949;0;0;0;0;.00nan;0;0
11126;179602;177;69;38;4;34;.895;3600000;0
11126;176672;177;0;0;0;0;.00nan;0;0
10865;170114;4959;76;33;3;30;.909;3705000;0
10865;195363;4959;0;0;0;0;.00nan;0;0
10865;171405;2620;0;0;0;0;.00nan;0;0
10865;-1;2620;61;19;2;17;.895;3705000;0
10729;-1;203;69;21;1;20;.952;3600000;0
10729;-1;203;0;0;0;0;.00nan;0;0
10729;-1;205;67;24;2;22;.917;3566000;0
10729;187092;205;0;0;0;0;.00nan;0;0
10751;189902;204;0;0;0;0;.00nan;0;0
10751;175364;206;98;30;1;29;.967;3882000;0
10751;196283;206;0;0;0;0;.00nan;0;0
10751;182049;204;85;24;1;23;.958;3900000;0
11239;177248;201;0;0;0;0;.00nan;0;0
11239;169166;226;83;16;0;16;1.000;3600000;0
11239;185743;201;85;45;3;42;.933;3600000;0
11239;192629;226;0;0;0;0;.00nan;0;0
10934;167404;215;0;0;0;0;.00nan;0;0
10934;165731;215;86;29;1;28;.966;3600000;0
10934;179679;212;0;0;0;0;.00nan;0;0
10934;186641;212;83;28;2;26;.929;3550000;0
10915;182467;185;0;0;0;0;.00nan;0;0
10915;179388;182;0;0;0;0;.00nan;0;0
10915;180110;185;78;36;3;33;.917;3600000;0
10915;182116;182;86;29;2;27;.931;3600000;0
10728;182454;4864;0;0;0;0;.00nan;0;0
10728;183737;4864;87;14;0;14;1.000;3600000;0
10728;179169;209;0;0;0;0;.00nan;0;0
10728;186205;209;98;37;2;35;.946;3567000;0
10949;171835;4960;0;0;0;0;.00nan;0;0
10949;194219;4960;64;21;2;19;.905;3600000;0
10949;-1;227;98;51;3;48;.941;3586000;0
10949;187217;227;0;0;0;0;.00nan;0;0
10817;174209;178;92;54;4;50;.926;3565000;0
10817;-1;210;0;0;0;0;.00nan;0;0
10817;192461;210;70;20;2;18;.900;3600000;0
10817;-1;178;0;0;0;0;.00nan;0;0
10682;178394;188;0;0;0;0;.00nan;0;0
10682;174153;188;100;36;0;36;1.000;3600000;0
10682;179197;198;55;23;3;20;.870;3600000;0
10682;181431;198;0;0;0;0;.00nan;0;0
11628;171730;220;70;27;2;25;.926;3600000;0
11628;180578;181;52;24;3;21;.875;3008000;0
11628;-1;181;25;7;3;4;.571;592000;0
11628;187443;220;0;0;0;0;.00nan;0;0
10825;184175;224;99;51;3;48;.941;3600000;0
10825;-1;221;45;26;4;22;.846;3597000;0
10825;185840;224;0;0;0;0;.00nan;0;0
10825;187362;221;0;0;0;0;.00nan;0;0
10815;-1;211;75;33;2;31;.939;3570000;0
10815;190034;217;0;0;0;0;.00nan;0;0
10815;190041;217;86;30;1;29;.967;3600000;0
10815;179646;211;0;0;0;0;.00nan;0;0
10870;179406;232;98;54;3;51;.944;3600000;0
10870;179434;232;0;0;0;0;.00nan;0;0
10870;181338;230;0;0;0;0;.00nan;0;0
10870;186495;230;73;20;1;19;.950;3600000;0
10820;-1;203;0;0;0;0;.00nan;0;0
10820;-1;203;58;23;3;20;.870;3600000;0
10820;180623;202;0;0;0;0;.00nan;0;0
10820;192498;202;35;37;6;31;.838;3600000;0
11652;170114;4959;64;32;3;29;.906;3600000;0
11652;195363;4959;0;0;0;0;.00nan;0;0
11652;171405;2620;100;31;0;31;1.000;3600000;0
11652;-1;2620;0;0;0;0;.00nan;0;0
11323;167404;215;72;30;3;27;.900;3600000;0
11323;165731;215;0;0;0;0;.00nan;0;0
11323;195164;218;0;0;0;0;.00nan;0;0
11323;192457;218;52;27;4;23;.852;3547000;0
11676;184610;222;89;25;1;24;.960;3600000;0
11676;175423;223;90;37;2;35;.946;3568000;0
11676;185851;222;0;0;0;0;.00nan;0;0
11676;187118;223;0;0;0;0;.00nan;0;0
10919;174209;178;86;46;5;41;.891;3544000;0
10919;-1;210;0;0;0;0;.00nan;0;0
10919;192461;210;44;23;4;19;.826;3600000;0
10919;-1;178;0;0;0;0;.00nan;0;0
11013;179430;229;0;0;0;0;.00nan;0;0
11013;181338;230;0;0;0;0;.00nan;0;0
11013;185800;229;87;42;2;40;.952;3600000;0
11013;186495;230;83;27;1;26;.963;3600000;0
10795;182467;185;78;47;5;42;.894;3600000;0
10795;171730;220;65;21;2;19;.905;3600000;0
10795;180110;185;0;0;0;0;.00nan;0;0
10795;187443;220;0;0;0;0;.00nan;0;0
10766;170114;4959;0;0;0;0;.00nan;0;0
10766;195363;4959;34;25;5;20;.800;3600000;0
10766;179169;209;0;0;0;0;.00nan;0;0
10766;186205;209;79;27;2;25;.926;3600000;0
10802;177248;201;65;45;5;40;.889;3600000;0
10802;-1;205;55;17;2;15;.882;3600000;0
10802;185743;201;0;0;0;0;.00nan;0;0
10802;187092;205;0;0;0;0;.00nan;0;0
10933;178394;188;0;0;0;0;.00nan;0;0
10933;169096;190;24;22;6;16;.727;2375000;0
10933;174153;188;62;21;2;19;.905;3600000;0
10933;197704;190;38;12;3;9;.750;1225000;0
10852;189885;225;91;35;2;33;.943;3600000;0
10852;175423;223;0;0;0;0;.00nan;0;0
10852;184785;225;0;0;0;0;.00nan;0;0
10852;187118;223;40;29;5;24;.828;3600000;0
10940;174147;179;0;0;0;0;.00nan;0;0
10940;179400;183;0;0;0;0;.00nan;0;0
10940;182089;183;84;43;2;41;.953;3900000;0
10940;187355;179;79;27;2;25;.926;3900000;0
10988;179602;177;99;54;2;52;.963;3600000;0
10988;176672;177;0;0;0;0;.00nan;0;0
10988;187240;216;48;27;4;23;.852;3543000;0
10988;191557;216;0;0;0;0;.00nan;0;0
10942;184175;224;64;30;3;27;.900;3900000;0
10942;184610;222;0;0;0;0;.00nan;0;0
10942;185840;224;0;0;0;0;.00nan;0;0
10942;185851;222;88;49;3;46;.939;3900000;0
10880;-1;211;75;29;2;27;.931;3900000;0
10880;168907;186;0;0;0;0;.00nan;0;0
10880;169226;186;77;30;1;29;.967;3900000;0
10880;179646;211;0;0;0;0;.00nan;0;0
11182;170351;194;70;23;2;21;.913;3600000;0
11182;174325;197;81;39;3;36;.923;3568000;0
11182;175436;197;0;0;0;0;.00nan;0;0
11182;196352;194;0;0;0;0;.00nan;0;0
10797;180762;1505;0;0;0;0;.00nan;0;0
10797;186549;1505;89;16;0;16;1.000;3600000;0
10797;187240;216;26;36;7;29;.806;3600000;0
10797;191557;216;0;0;0;0;.00nan;0;0
10897;-1;221;42;22;4;18;.818;3543000;0
10897;-1;227;89;50;3;47;.940;3600000;0
10897;187217;227;0;0;0;0;.00nan;0;0
10897;187362;221;0;0;0;0;.00nan;0;0
10768;175364;206;61;38;4;34;.895;3600000;0
10768;-1;207;0;0;0;0;.00nan;0;0
10768;196283;206;0;0;0;0;.00nan;0;0
10768;-1;207;91;23;0;23;1.000;3600000;0
10782;173340;231;0;0;0;0;.00nan;0;0
10782;189885;225;0;0;0;0;.00nan;0;0
10782;184785;225;74;37;3;34;.919;3564000;0
10782;185034;231;57;17;2;15;.882;3600000;0
10787;182454;4864;45;6;1;5;.833;1438000;0
10787;183737;4864;15;24;7;17;.708;2162000;0
10787;179169;209;81;49;4;45;.918;3600000;0
10787;186205;209;0;0;0;0;.00nan;0;0
10900;190034;217;0;0;0;0;.00nan;0;0
10900;190041;217;81;26;1;25;.962;3600000;0
10900;179679;212;0;0;0;0;.00nan;0;0
10900;186641;212;59;29;3;26;.897;3587000;0
10862;166545;193;82;32;3;29;.906;3900000;0
10862;168117;192;0;0;0;0;.00nan;0;0
10862;173770;193;0;0;0;0;.00nan;0;0
10862;-1;192;56;25;3;22;.880;3900000;0
10891;169166;226;72;28;2;26;.929;3600000;0
10891;-1;203;53;38;5;33;.868;3600000;0
10891;-1;203;0;0;0;0;.00nan;0;0
10891;192629;226;0;0;0;0;.00nan;0;0
11670;174147;179;64;24;2;22;.917;3600000;0
11670;174209;178;56;4;0;4;1.000;937000;0
11670;187355;179;0;0;0;0;.00nan;0;0
11670;-1;178;38;32;6;26;.813;2663000;0
10858;192862;187;0;0;0;0;.00nan;0;0
10858;189081;187;78;42;4;38;.905;3600000;0
10858;176200;195;93;36;1;35;.972;3600000;0
10858;179647;195;0;0;0;0;.00nan;0;0
10840;180623;202;83;32;1;31;.969;3600000;0
10840;-1;205;0;0;0;0;.00nan;0;0
10840;187092;205;53;27;3;24;.889;3537000;0
10840;192498;202;0;0;0;0;.00nan;0;0
10911;179388;182;0;0;0;0;.00nan;0;0
10911;190125;184;61;45;6;39;.867;3600000;0
10911;179668;184;0;0;0;0;.00nan;0;0
10911;182116;182;84;42;3;39;.929;3600000;0
10991;167404;215;0;0;0;0;.00nan;0;0
10991;165731;215;54;32;3;29;.906;3526000;0
10991;-1;211;0;0;0;0;.00nan;0;0
10991;179646;211;74;26;1;25;.962;3600000;0
10715;194416;191;0;0;0;0;.00nan;0;0
10715;194893;191;74;31;2;29;.935;3674000;0
10715;179197;198;0;0;0;0;.00nan;0;0
10715;181431;198;97;44;1;43;.977;3674000;0
10935;184069;208;0;0;0;0;.00nan;0;0
10935;189902;204;85;35;2;33;.943;3900000;0
10935;179702;208;65;24;2;22;.917;3900000;0
10935;182049;204;0;0;0;0;.00nan;0;0
11218;169096;190;33;9;3;6;.667;572000;0
11218;174325;197;0;0;0;0;.00nan;0;0
11218;175436;197;29;27;6;21;.778;3600000;0
11218;197704;190;49;15;2;13;.867;3028000;0
10962;182467;185;0;0;0;0;.00nan;0;0
10962;180110;185;83;35;1;34;.971;3900000;0
10962;180578;181;0;0;0;0;.00nan;0;0
10962;-1;181;87;32;1;31;.969;3900000;0
11222;-1;4949;60;35;4;31;.886;3600000;0
11222;195251;4949;0;0;0;0;.00nan;0;0
11222;179602;177;85;39;3;36;.923;3600000;0
11222;176672;177;0;0;0;0;.00nan;0;0
10810;176938;180;71;28;3;25;.893;3583000;0
10810;181065;219;0;0;0;0;.00nan;0;0
10810;181102;219;97;35;1;34;.971;3600000;0
10810;-1;180;0;0;0;0;.00nan;0;0
10979;178394;188;75;37;3;34;.919;3600000;0
10979;174153;188;0;0;0;0;.00nan;0;0
10979;-1;196;0;0;0;0;.00nan;0;0
10979;184648;196;47;29;5;24;.828;3516000;0
10973;166762;213;0;0;0;0;.00nan;0;0
10973;-1;210;65;14;1;13;.929;3600000;0
10973;180575;213;70;52;6;46;.885;3600000;0
10973;192461;210;0;0;0;0;.00nan;0;0
10974;195238;200;0;0;0;0;.00nan;0;0
10974;175370;199;0;0;0;0;.00nan;0;0
10974;187295;200;53;39;5;34;.872;3600000;0
10974;161006;199;79;22;1;21;.955;3600000;0
10811;171730;220;42;10;2;8;.800;732000;0
10811;-1;1371;0;0;0;0;.00nan;0;0
10811;187443;220;38;33;6;27;.818;2868000;0
10811;192688;1371;59;33;4;29;.879;3600000;0
10928;171835;4960;64;15;1;14;.933;3600000;0
10928;194219;4960;0;0;0;0;.00nan;0;0
10928;184175;224;0;0;0;0;.00nan;0;0
10928;185840;224;54;33;4;29;.879;3600000;0
10976;168954;228;60;44;6;38;.864;3900000;0
10976;179406;232;16;21;6;15;.714;2633000;0
10976;175354;228;0;0;0;0;.00nan;0;0
10976;179434;232;64;6;0;6;1.000;1267000;0
10844;-1;1371;0;0;0;0;.00nan;0;0
10844;180578;181;56;29;3;26;.897;3600000;0
10844;-1;181;0;0;0;0;.00nan;0;0
10844;192688;1371;64;14;1;13;.929;3600000;0
10839;166545;193;0;0;0;0;.00nan;0;0
10839;171839;189;0;0;0;0;.00nan;0;0
10839;173770;193;66;21;2;19;.905;3600000;0
10839;-1;189;83;42;4;38;.905;3526000;0
10743;170351;194;0;0;0;0;.00nan;0;0
10743;179197;198;72;25;2;23;.920;3600000;0
10743;196352;194;87;43;3;40;.930;3586000;0
10743;181431;198;0;0;0;0;.00nan;0;0
10813;166762;213;72;49;5;44;.898;3600000;0
10813;180575;213;0;0;0;0;.00nan;0;0
10813;180762;1505;0;0;0;0;.00nan;0;0
10813;186549;1505;82;13;0;13;1.000;3600000;0
10814;168907;186;0;0;0;0;.00nan;0;0
10814;169226;186;60;21;2;19;.905;3546000;0
10814;176938;180;87;33;1;32;.970;3600000;0
10814;-1;180;0;0;0;0;.00nan;0;0
10906;182454;4864;0;0;0;0;.00nan;0;0
10906;183737;4864;83;13;0;13;1.000;3600000;0
10906;170114;4959;81;52;5;47;.904;3600000;0
10906;195363;4959;0;0;0;0;.00nan;0;0
10798;171662;176;0;0;0;0;.00nan;0;0
10798;179169;209;0;0;0;0;.00nan;0;0
10798;176932;176;75;28;2;26;.929;3791000;0
10798;186205;209;51;26;3;23;.885;3791000;0
11330;-1;210;0;0;0;0;.00nan;0;0
11330;179602;177;0;0;0;0;.00nan;0;0
11330;176672;177;84;40;3;37;.925;3568000;0
11330;192461;210;49;17;2;15;.882;3600000;0
11164;190125;184;41;18;4;14;.778;3870000;0
11164;179668;184;0;0;0;0;.00nan;0;0
11164;-1;214;83;44;3;41;.932;3870000;0
11164;191518;214;0;0;0;0;.00nan;0;0
11043;179679;212;0;0;0;0;.00nan;0;0
11043;181065;219;0;0;0;0;.00nan;0;0
11043;181102;219;59;19;2;17;.895;3600000;0
11043;186641;212;62;33;3;30;.909;3580000;0
11094;178394;188;85;15;0;15;1.000;3600000;0
11094;170351;194;54;49;7;42;.857;3600000;0
11094;174153;188;0;0;0;0;.00nan;0;0
11094;196352;194;0;0;0;0;.00nan;0;0
10977;184610;222;100;34;1;33;.971;3600000;0
10977;179406;232;66;37;3;34;.919;3600000;0
10977;179434;232;0;0;0;0;.00nan;0;0
10977;185851;222;0;0;0;0;.00nan;0;0
10881;169166;226;70;21;1;20;.952;3600000;0
10881;175364;206;67;44;5;39;.886;3600000;0
10881;196283;206;0;0;0;0;.00nan;0;0
10881;192629;226;0;0;0;0;.00nan;0;0
10804;189885;225;76;58;6;52;.897;3600000;0
10804;184785;225;0;0;0;0;.00nan;0;0
10804;181338;230;0;0;0;0;.00nan;0;0
10804;186495;230;83;12;0;12;1.000;3600000;0
10957;174147;179;0;0;0;0;.00nan;0;0
10957;187240;216;0;0;0;0;.00nan;0;0
10957;187355;179;56;16;3;13;.813;3600000;0
10957;191557;216;68;35;4;31;.886;3554000;0
10888;169096;190;49;36;6;30;.833;3072000;0
10888;176200;195;72;24;2;22;.917;3600000;0
10888;179647;195;0;0;0;0;.00nan;0;0
10888;197704;190;70;14;0;14;1.000;528000;0
10953;177248;201;0;0;0;0;.00nan;0;0
10953;195238;200;0;0;0;0;.00nan;0;0
10953;185743;201;73;42;3;39;.929;3600000;0
10953;187295;200;88;26;1;25;.962;3600000;0
10909;174209;178;68;39;4;35;.897;3700000;0
10909;179400;183;72;30;3;27;.900;3700000;0
10909;182089;183;0;0;0;0;.00nan;0;0
10909;-1;178;0;0;0;0;.00nan;0;0
10809;171730;220;100;29;0;29;1.000;3600000;0
10809;179388;182;0;0;0;0;.00nan;0;0
10809;182116;182;77;41;3;38;.927;3600000;0
10809;187443;220;0;0;0;0;.00nan;0;0
10925;-1;221;100;39;0;39;1.000;3600000;0
10925;-1;227;0;0;0;0;.00nan;0;0
10925;187217;227;61;36;4;32;.889;3600000;0
10925;187362;221;0;0;0;0;.00nan;0;0
10918;167404;215;56;18;2;16;.889;3600000;0
10918;165731;215;0;0;0;0;.00nan;0;0
10918;190034;217;20;18;5;13;.722;2177000;0
10918;190041;217;56;13;2;11;.846;1423000;0
10830;-1;207;0;0;0;0;.00nan;0;0
10830;180623;202;48;30;5;25;.833;3544000;0
10830;-1;207;74;42;4;38;.905;3600000;0
10830;192498;202;0;0;0;0;.00nan;0;0
11421;-1;196;0;0;0;0;.00nan;0;0
11421;174325;197;48;29;4;25;.862;3600000;0
11421;184648;196;91;26;1;25;.962;3600000;0
11421;175436;197;0;0;0;0;.00nan;0;0
10763;-1;203;43;25;4;21;.840;3600000;0
10763;189902;204;75;35;3;32;.914;3600000;0
10763;-1;203;0;0;0;0;.00nan;0;0
10763;182049;204;0;0;0;0;.00nan;0;0
11030;171835;4960;63;35;4;31;.886;3600000;0
11030;194219;4960;0;0;0;0;.00nan;0;0
11030;175423;223;25;6;3;3;.500;252000;0
11030;187118;223;83;35;2;33;.943;3293000;0
10982;168117;192;0;0;0;0;.00nan;0;0
10982;194416;191;25;6;3;3;.500;405000;0
10982;194893;191;48;14;2;12;.857;3156000;0
10982;-1;192;83;46;4;42;.913;3600000;0
11060;184069;208;76;40;3;37;.925;3900000;0
11060;169166;226;87;43;3;40;.930;3900000;0
11060;179702;208;0;0;0;0;.00nan;0;0
11060;192629;226;0;0;0;0;.00nan;0;0
11667;-1;210;66;24;2;22;.917;3600000;0
11667;179602;177;79;49;5;44;.898;3600000;0
11667;176672;177;0;0;0;0;.00nan;0;0
11667;192461;210;0;0;0;0;.00nan;0;0
11132;171835;4960;0;0;0;0;.00nan;0;0
11132;194219;4960;48;20;3;17;.850;3832000;0
11132;179430;229;0;0;0;0;.00nan;0;0
11132;185800;229;64;40;4;36;.900;3832000;0
10873;166545;193;73;25;1;24;.960;3600000;0
10873;192862;187;0;0;0;0;.00nan;0;0
10873;189081;187;98;50;2;48;.960;3553000;0
10873;173770;193;0;0;0;0;.00nan;0;0
10861;-1;1371;70;29;2;27;.931;3600000;0
10861;190125;184;0;0;0;0;.00nan;0;0
10861;179668;184;60;29;3;26;.897;3550000;0
10861;192688;1371;0;0;0;0;.00nan;0;0
10823;168907;186;0;0;0;0;.00nan;0;0
10823;169226;186;66;39;4;35;.897;3600000;0
10823;176938;180;81;39;3;36;.923;3600000;0
10823;-1;180;0;0;0;0;.00nan;0;0
10856;189902;204;0;0;0;0;.00nan;0;0
10856;180623;202;0;0;0;0;.00nan;0;0
10856;182049;204;70;23;1;22;.957;3900000;0
10856;192498;202;79;25;1;24;.960;3900000;0
11637;178394;188;69;25;2;23;.920;3600000;0
11637;169096;190;0;0;0;0;.00nan;0;0
11637;174153;188;0;0;0;0;.00nan;0;0
11637;197704;190;73;40;4;36;.900;3600000;0
10985;173340;231;0;0;0;0;.00nan;0;0
10985;179406;232;78;46;4;42;.913;3600000;0
10985;179434;232;0;0;0;0;.00nan;0;0
10985;185034;231;72;21;1;20;.952;3600000;0
10980;-1;203;69;10;0;10;1.000;500000;0
10980;175370;199;62;21;2;19;.905;3600000;0
10980;-1;203;43;34;6;28;.824;3100000;0
10980;161006;199;0;0;0;0;.00nan;0;0
11575;-1;4949;78;26;2;24;.923;3600000;0
11575;195251;4949;0;0;0;0;.00nan;0;0
11575;174147;179;69;41;5;36;.878;3600000;0
11575;187355;179;0;0;0;0;.00nan;0;0
11527;168954;228;49;21;3;18;.857;3560000;0
11527;175354;228;0;0;0;0;.00nan;0;0
11527;175423;223;79;34;2;32;.941;3600000;0
11527;187118;223;0;0;0;0;.00nan;0;0
11000;179388;182;78;37;2;35;.946;3584000;0
11000;180578;181;0;0;0;0;.00nan;0;0
11000;182116;182;0;0;0;0;.00nan;0;0
11000;-1;181;80;23;1;22;.957;3600000;0
11203;182467;185;51;24;3;21;.875;3600000;0
11203;180110;185;0;0;0;0;.00nan;0;0
11203;-1;214;0;0;0;0;.00nan;0;0
11203;191518;214;51;30;4;26;.867;3600000;0
11407;195164;218;48;36;5;31;.861;3600000;0
11407;181065;219;68;25;2;23;.920;3600000;0
11407;181102;219;0;0;0;0;.00nan;0;0
11407;192457;218;0;0;0;0;.00nan;0;0
10831;171839;189;0;0;0;0;.00nan;0;0
10831;179197;198;0;0;0;0;.00nan;0;0
10831;-1;189;99;51;1;50;.980;3600000;0
10831;181431;198;69;26;2;24;.923;3580000;0
10955;182454;4864;0;0;0;0;.00nan;0;0
10955;183737;4864;84;27;1;26;.963;3730000;0
10955;171405;2620;83;41;2;39;.951;3730000;0
10955;-1;2620;0;0;0;0;.00nan;0;0
10922;-1;221;63;44;5;39;.886;3600000;0
10922;181338;230;0;0;0;0;.00nan;0;0
10922;186495;230;73;23;1;22;.957;3600000;0
10922;187362;221;0;0;0;0;.00nan;0;0
11162;168954;228;0;0;0;0;.00nan;0;0
11162;175354;228;72;24;2;22;.917;3600000;0
11162;179430;229;0;0;0;0;.00nan;0;0
11162;185800;229;85;37;3;34;.919;3567000;0
11616;182467;185;0;0;0;0;.00nan;0;0
11616;180110;185;62;41;4;37;.902;3552000;0
11616;180578;181;0;0;0;0;.00nan;0;0
11616;-1;181;82;30;2;28;.933;3600000;0
11163;168117;192;79;14;0;14;1.000;3600000;0
11163;-1;196;0;0;0;0;.00nan;0;0
11163;184648;196;78;55;5;50;.909;3600000;0
11163;-1;192;0;0;0;0;.00nan;0;0
10833;177248;201;0;0;0;0;.00nan;0;0
10833;-1;207;74;34;3;31;.912;3567000;0
10833;185743;201;98;40;2;38;.950;3600000;0
10833;-1;207;0;0;0;0;.00nan;0;0
10927;195164;218;0;0;0;0;.00nan;0;0
10927;190034;217;94;45;3;42;.933;3600000;0
10927;190041;217;0;0;0;0;.00nan;0;0
10927;192457;218;23;28;6;22;.786;3600000;0
11018;-1;227;52;32;4;28;.875;3543000;0
11018;184610;222;90;41;3;38;.927;3600000;0
11018;185851;222;0;0;0;0;.00nan;0;0
11018;187217;227;0;0;0;0;.00nan;0;0
10992;192862;187;37;21;4;17;.810;3600000;0
10992;189081;187;0;0;0;0;.00nan;0;0
10992;194416;191;100;37;0;37;1.000;3600000;0
10992;194893;191;0;0;0;0;.00nan;0;0
11063;173340;231;100;28;0;28;1.000;3600000;0
11063;184175;224;64;40;5;35;.875;3600000;0
11063;185034;231;0;0;0;0;.00nan;0;0
11063;185840;224;0;0;0;0;.00nan;0;0
10943;166762;213;0;0;0;0;.00nan;0;0
10943;179400;183;0;0;0;0;.00nan;0;0
10943;180575;213;48;26;4;22;.846;3537000;0
10943;182089;183;72;28;2;26;.929;3600000;0
10939;174209;178;86;36;2;34;.944;3561000;0
10939;180762;1505;74;23;1;22;.957;3600000;0
10939;186549;1505;0;0;0;0;.00nan;0;0
10939;-1;178;0;0;0;0;.00nan;0;0
10908;171839;189;43;34;6;28;.824;2916000;0
10908;-1;189;51;9;1;8;.889;684000;0
10908;176200;195;95;21;0;21;1.000;3600000;0
10908;179647;195;0;0;0;0;.00nan;0;0
10889;171405;2620;0;0;0;0;.00nan;0;0
10889;171662;176;0;0;0;0;.00nan;0;0
10889;176932;176;68;33;3;30;.909;3555000;0
10889;-1;2620;52;14;2;12;.857;3600000;0
11042;-1;211;99;38;2;36;.947;3600000;0
11042;179646;211;0;0;0;0;.00nan;0;0
11042;179679;212;0;0;0;0;.00nan;0;0
11042;186641;212;65;28;3;25;.893;3559000;0
11623;184069;208;0;0;0;0;.00nan;0;0
11623;179702;208;85;26;1;25;.962;3600000;0
11623;180623;202;0;0;0;0;.00nan;0;0
11623;192498;202;65;24;2;22;.917;3594000;0
10987;195238;200;0;0;0;0;.00nan;0;0
10987;175370;199;0;0;0;0;.00nan;0;0
10987;187295;200;77;46;4;42;.913;3589000;0
10987;161006;199;60;29;3;26;.897;3600000;0
10924;170114;4959;44;18;3;15;.833;3600000;0
10924;195363;4959;0;0;0;0;.00nan;0;0
10924;171662;176;55;44;6;38;.864;3600000;0
10924;176932;176;0;0;0;0;.00nan;0;0
10894;175364;206;0;0;0;0;.00nan;0;0
10894;196283;206;67;27;3;24;.889;3516000;0
10894;-1;205;91;30;1;29;.967;3600000;0
10894;187092;205;0;0;0;0;.00nan;0;0
10890;166545;193;75;16;1;15;.938;3600000;0
10890;173770;193;0;0;0;0;.00nan;0;0
10890;174325;197;63;61;7;54;.885;3600000;0
10890;175436;197;0;0;0;0;.00nan;0;0
11067;195164;218;90;36;2;34;.944;3600000;0
11067;179679;212;0;0;0;0;.00nan;0;0
11067;186641;212;51;20;3;17;.850;3553000;0
11067;192457;218;0;0;0;0;.00nan;0;0
10917;178394;188;0;0;0;0;.00nan;0;0
10917;174153;188;100;29;0;29;1.000;3600000;0
10917;176200;195;71;22;1;21;.955;3581000;0
10917;179647;195;0;0;0;0;.00nan;0;0
11099;167404;215;56;29;3;26;.897;3514000;0
11099;165731;215;0;0;0;0;.00nan;0;0
11099;-1;211;92;29;1;28;.966;3600000;0
11099;179646;211;0;0;0;0;.00nan;0;0
10921;189885;225;78;28;2;26;.929;3600000;0
10921;175423;223;0;0;0;0;.00nan;0;0
10921;184785;225;0;0;0;0;.00nan;0;0
10921;187118;223;59;31;5;26;.839;3600000;0
10952;-1;4949;96;50;2;48;.960;3900000;0
10952;195251;4949;0;0;0;0;.00nan;0;0
10952;180762;1505;56;24;2;22;.917;3900000;0
10952;186549;1505;0;0;0;0;.00nan;0;0
10812;171730;220;83;31;1;30;.968;3600000;0
10812;179388;182;43;31;5;26;.839;2157000;0
10812;182116;182;32;25;5;20;.800;1443000;0
10812;187443;220;0;0;0;0;.00nan;0;0
10951;195238;200;48;49;7;42;.857;3095000;0
10951;-1;207;83;13;0;13;1.000;3600000;0
10951;187295;200;62;6;0;6;1.000;505000;0
10951;-1;207;0;0;0;0;.00nan;0;0
11045;171835;4960;64;23;2;21;.913;3600000;0
11045;194219;4960;0;0;0;0;.00nan;0;0
11045;184610;222;77;38;3;35;.921;3600000;0
11045;185851;222;0;0;0;0;.00nan;0;0
11040;166762;213;0;0;0;0;.00nan;0;0
11040;179400;183;0;0;0;0;.00nan;0;0
11040;180575;213;73;35;3;32;.914;3550000;0
11040;182089;183;90;38;2;36;.947;3600000;0
10883;-1;196;0;0;0;0;.00nan;0;0
10883;179197;198;74;26;2;24;.923;3600000;0
10883;184648;196;62;45;5;40;.889;3600000;0
10883;181431;198;0;0;0;0;.00nan;0;0
10995;182454;4864;0;0;0;0;.00nan;0;0
10995;183737;4864;100;31;0;31;1.000;3600000;0
10995;179169;209;70;36;4;32;.889;3600000;0
10995;186205;209;0;0;0;0;.00nan;0;0
11166;192862;187;0;0;0;0;.00nan;0;0
11166;168117;192;67;24;2;22;.917;3600000;0
11166;189081;187;66;32;3;29;.906;3566000;0
11166;-1;192;0;0;0;0;.00nan;0;0
11256;173340;231;67;16;1;15;.938;3600000;0
11256;184175;224;97;55;3;52;.945;3549000;0
11256;185034;231;0;0;0;0;.00nan;0;0
11256;185840;224;0;0;0;0;.00nan;0;0
11024;192862;187;76;28;3;25;.893;3900000;0
11024;189081;187;0;0;0;0;.00nan;0;0
11024;-1;196;86;37;3;34;.919;3900000;0
11024;184648;196;0;0;0;0;.00nan;0;0
10920;166545;193;0;0;0;0;.00nan;0;0
10920;169096;190;55;17;2;15;.882;1429000;0
10920;173770;193;94;30;1;29;.967;3600000;0
10920;197704;190;49;39;5;34;.872;2171000;0
11065;-1;221;26;21;5;16;.762;3540000;0
11065;175423;223;93;49;3;46;.939;3600000;0
11065;187118;223;0;0;0;0;.00nan;0;0
11065;187362;221;0;0;0;0;.00nan;0;0
11021;179388;182;0;0;0;0;.00nan;0;0
11021;180578;181;0;0;0;0;.00nan;0;0
11021;182116;182;99;50;1;49;.980;3600000;0
11021;-1;181;57;21;2;19;.905;3600000;0
11291;173340;231;0;0;0;0;.00nan;0;0
11291;168954;228;0;0;0;0;.00nan;0;0
11291;175354;228;91;42;2;40;.952;3556000;0
11291;185034;231;85;16;0;16;1.000;3600000;0
11135;179406;232;90;38;3;35;.921;3600000;0
11135;179430;229;0;0;0;0;.00nan;0;0
11135;179434;232;0;0;0;0;.00nan;0;0
11135;185800;229;52;26;4;22;.846;3543000;0
11140;169166;226;68;28;3;25;.893;3600000;0
11140;180623;202;75;42;4;38;.905;3559000;0
11140;192498;202;0;0;0;0;.00nan;0;0
11140;192629;226;0;0;0;0;.00nan;0;0
10959;-1;227;0;0;0;0;.00nan;0;0
10959;189885;225;0;0;0;0;.00nan;0;0
10959;184785;225;77;33;2;31;.939;3600000;0
10959;187217;227;64;30;3;27;.900;3600000;0
10966;180762;1505;0;0;0;0;.00nan;0;0
10966;186549;1505;75;31;2;29;.935;3600000;0
10966;187240;216;56;36;4;32;.889;3573000;0
10966;191557;216;0;0;0;0;.00nan;0;0
10914;195164;218;0;0;0;0;.00nan;0;0
10914;176938;180;75;36;3;33;.917;3900000;0
10914;-1;180;0;0;0;0;.00nan;0;0
10914;192457;218;83;41;3;38;.927;3900000;0
11054;171405;2620;52;27;4;23;.852;3562000;0
11054;171662;176;0;0;0;0;.00nan;0;0
11054;176932;176;70;31;3;28;.903;3600000;0
11054;-1;2620;0;0;0;0;.00nan;0;0
10984;-1;4949;56;7;0;7;1.000;491000;0
10984;195251;4949;35;24;5;19;.792;3055000;0
10984;174209;178;0;0;0;0;.00nan;0;0
10984;-1;178;79;49;4;45;.918;3600000;0
10986;171839;189;0;0;0;0;.00nan;0;0
10986;168117;192;0;0;0;0;.00nan;0;0
10986;-1;189;96;44;2;42;.955;3900000;0
10986;-1;192;61;23;2;21;.913;3900000;0
11477;167404;215;0;0;0;0;.00nan;0;0
11477;165731;215;68;38;4;34;.895;3589000;0
11477;181065;219;0;0;0;0;.00nan;0;0
11477;181102;219;80;33;2;31;.939;3600000;0
11003;177248;201;0;0;0;0;.00nan;0;0
11003;175370;199;56;11;1;10;.909;3012000;0
11003;185743;201;90;57;3;54;.947;3600000;0
11003;161006;199;32;10;3;7;.700;543000;0
10938;184069;208;43;26;4;22;.846;3555000;0
10938;189902;204;93;42;2;40;.952;3600000;0
10938;179702;208;0;0;0;0;.00nan;0;0
10938;182049;204;0;0;0;0;.00nan;0;0
11073;166762;213;97;64;4;60;.938;3600000;0
11073;-1;210;0;0;0;0;.00nan;0;0
11073;180575;213;0;0;0;0;.00nan;0;0
11073;192461;210;44;10;2;8;.800;3600000;0
11089;184610;222;0;0;0;0;.00nan;0;0
11089;181338;230;0;0;0;0;.00nan;0;0
11089;185851;222;97;73;5;68;.932;3600000;0
11089;186495;230;78;27;2;25;.926;3600000;0
11075;174147;179;0;0;0;0;.00nan;0;0
11075;179400;183;61;56;7;49;.875;3600000;0
11075;182089;183;0;0;0;0;.00nan;0;0
11075;187355;179;63;19;2;17;.895;3600000;0
10871;194416;191;43;25;4;21;.840;3781000;0
10871;194893;191;0;0;0;0;.00nan;0;0
10871;179197;198;0;0;0;0;.00nan;0;0
10871;181431;198;64;30;3;27;.900;3781000;0
10910;-1;203;67;37;3;34;.919;3578000;0
10910;-1;203;0;0;0;0;.00nan;0;0
10910;-1;207;76;26;2;24;.923;3600000;0
10910;-1;207;0;0;0;0;.00nan;0;0
10838;171730;220;0;0;0;0;.00nan;0;0
10838;190125;184;74;31;2;29;.935;3600000;0
10838;179668;184;0;0;0;0;.00nan;0;0
10838;187443;220;100;40;1;39;.975;3600000;0
10822;182454;4864;0;0;0;0;.00nan;0;0
10822;183737;4864;92;27;1;26;.963;3600000;0
10822;179169;209;0;0;0;0;.00nan;0;0
10822;186205;209;83;36;3;33;.917;3585000;0
10904;168907;186;79;31;2;29;.935;3600000;0
10904;169226;186;0;0;0;0;.00nan;0;0
10904;190034;217;75;40;3;37;.925;3547000;0
10904;190041;217;0;0;0;0;.00nan;0;0
11041;184175;224;100;36;0;36;1.000;3600000;0
11041;-1;227;61;23;2;21;.913;3520000;0
11041;185840;224;0;0;0;0;.00nan;0;0
11041;187217;227;0;0;0;0;.00nan;0;0
10981;189902;204;0;0;0;0;.00nan;0;0
10981;182049;204;79;37;4;33;.892;3600000;0
10981;-1;205;44;18;3;15;.833;3600000;0
10981;187092;205;0;0;0;0;.00nan;0;0
11625;184069;208;0;0;0;0;.00nan;0;0
11625;179702;208;57;24;3;21;.875;3600000;0
11625;180623;202;0;0;0;0;.00nan;0;0
11625;192498;202;51;39;5;34;.872;3565000;0
11012;180578;181;0;0;0;0;.00nan;0;0
11012;-1;181;50;29;4;25;.862;3600000;0
11012;-1;214;85;30;1;29;.967;3600000;0
11012;191518;214;0;0;0;0;.00nan;0;0
11006;177248;201;0;0;0;0;.00nan;0;0
11006;-1;207;0;0;0;0;.00nan;0;0
11006;185743;201;29;15;4;11;.733;3600000;0
11006;-1;207;48;35;6;29;.829;3513000;0
11008;-1;4949;42;27;4;23;.852;3598000;0
11008;195251;4949;0;0;0;0;.00nan;0;0
11008;187240;216;76;29;3;26;.897;3600000;0
11008;191557;216;0;0;0;0;.00nan;0;0
11172;179406;232;60;35;5;30;.857;3864000;0
11172;179430;229;0;0;0;0;.00nan;0;0
11172;179434;232;0;0;0;0;.00nan;0;0
11172;185800;229;100;51;4;47;.922;3864000;0
10963;168117;192;64;25;2;23;.920;3600000;0
10963;169096;190;100;53;1;52;.981;3600000;0
10963;-1;192;0;0;0;0;.00nan;0;0
10963;197704;190;0;0;0;0;.00nan;0;0
11090;171839;189;0;0;0;0;.00nan;0;0
11090;194416;191;0;0;0;0;.00nan;0;0
11090;194893;191;48;13;2;11;.846;3600000;0
11090;-1;189;60;38;5;33;.868;3600000;0
10878;-1;1371;0;0;0;0;.00nan;0;0
10878;179388;182;0;0;0;0;.00nan;0;0
10878;182116;182;80;39;3;36;.923;3600000;0
10878;192688;1371;43;23;4;19;.826;3564000;0
10968;174209;178;57;39;5;34;.872;3600000;0
10968;180762;1505;60;16;1;15;.938;3600000;0
10968;186549;1505;0;0;0;0;.00nan;0;0
10968;-1;178;0;0;0;0;.00nan;0;0
11020;169166;226;31;16;4;12;.750;1110000;0
11020;-1;203;82;42;3;39;.929;3600000;0
11020;-1;203;0;0;0;0;.00nan;0;0
11020;192629;226;55;20;2;18;.900;2490000;0
10941;176938;180;51;39;5;34;.872;3600000;0
10941;179679;212;0;0;0;0;.00nan;0;0
10941;186641;212;92;30;1;29;.967;3600000;0
10941;-1;180;0;0;0;0;.00nan;0;0
10947;179197;198;54;15;2;13;.867;3600000;0
10947;174325;197;57;39;5;34;.872;3600000;0
10947;175436;197;0;0;0;0;.00nan;0;0
10947;181431;198;0;0;0;0;.00nan;0;0
11007;192862;187;0;0;0;0;.00nan;0;0
11007;189081;187;63;23;2;21;.913;3900000;0
11007;170351;194;89;41;2;39;.951;3900000;0
11007;196352;194;0;0;0;0;.00nan;0;0
11074;170114;4959;79;12;0;12;1.000;3600000;0
11074;195363;4959;0;0;0;0;.00nan;0;0
11074;171662;176;49;44;6;38;.864;3305000;0
11074;176932;176;51;2;0;2;1.000;295000;0
11038;195238;200;0;0;0;0;.00nan;0;0
11038;175370;199;0;0;0;0;.00nan;0;0
11038;187295;200;78;32;2;30;.938;3565000;0
11038;161006;199;94;25;0;25;1.000;3600000;0
11305;182467;185;80;39;3;36;.923;3563000;0
11305;190125;184;94;41;2;39;.951;3600000;0
11305;179668;184;0;0;0;0;.00nan;0;0
11305;180110;185;0;0;0;0;.00nan;0;0
10916;168907;186;0;0;0;0;.00nan;0;0
10916;169226;186;94;31;1;30;.968;3600000;0
10916;190034;217;97;41;2;39;.951;3590000;0
10916;190041;217;0;0;0;0;.00nan;0;0
11654;168954;228;81;17;0;17;1.000;3600000;0
11654;184175;224;51;38;5;33;.868;3600000;0
11654;175354;228;0;0;0;0;.00nan;0;0
11654;185840;224;0;0;0;0;.00nan;0;0
11039;171835;4960;60;26;3;23;.885;3600000;0
11039;194219;4960;0;0;0;0;.00nan;0;0
11039;-1;221;28;15;4;11;.733;2216000;0
11039;187362;221;67;13;0;13;1.000;1343000;0
11033;175364;206;73;39;3;36;.923;3591000;0
11033;196283;206;0;0;0;0;.00nan;0;0
11033;-1;205;0;0;0;0;.00nan;0;0
11033;187092;205;71;27;2;25;.926;3600000;0
11418;167404;215;46;37;5;32;.865;3572000;0
11418;165731;215;0;0;0;0;.00nan;0;0
11418;195164;218;66;27;3;24;.889;3600000;0
11418;192457;218;0;0;0;0;.00nan;0;0
11119;166762;213;0;0;0;0;.00nan;0;0
11119;174147;179;45;30;5;25;.833;3586000;0
11119;180575;213;74;43;4;39;.907;3600000;0
11119;187355;179;0;0;0;0;.00nan;0;0
10885;-1;1371;55;10;1;9;.900;3600000;0
10885;190125;184;0;0;0;0;.00nan;0;0
10885;179668;184;62;49;5;44;.898;3600000;0
10885;192688;1371;0;0;0;0;.00nan;0;0
11095;184069;208;96;34;1;33;.971;3600000;0
11095;175370;199;0;0;0;0;.00nan;0;0
11095;179702;208;0;0;0;0;.00nan;0;0
11095;161006;199;72;36;4;32;.889;3600000;0
10978;171839;189;0;0;0;0;.00nan;0;0
10978;178394;188;0;0;0;0;.00nan;0;0
10978;174153;188;70;22;1;21;.955;3600000;0
10978;-1;189;81;31;2;29;.935;3600000;0
11277;170114;4959;57;18;2;16;.889;3600000;0
11277;195363;4959;0;0;0;0;.00nan;0;0
11277;171662;176;0;0;0;0;.00nan;0;0
11277;176932;176;62;32;3;29;.906;3600000;0
11091;184610;222;84;14;0;14;1.000;3600000;0
11091;179406;232;98;47;1;46;.979;3583000;0
11091;179434;232;0;0;0;0;.00nan;0;0
11091;185851;222;0;0;0;0;.00nan;0;0
11046;169096;190;70;27;2;25;.926;1619000;0
11046;176200;195;77;13;0;13;1.000;3600000;0
11046;179647;195;0;0;0;0;.00nan;0;0
11046;197704;190;21;29;6;23;.793;1981000;0
11308;173340;231;0;0;0;0;.00nan;0;0
11308;168954;228;0;0;0;0;.00nan;0;0
11308;175354;228;79;47;4;43;.915;3600000;0
11308;185034;231;63;13;1;12;.923;3600000;0
10958;182454;4864;84;31;1;30;.968;3600000;0
10958;183737;4864;0;0;0;0;.00nan;0;0
10958;171405;2620;98;39;2;37;.949;3600000;0
10958;-1;2620;0;0;0;0;.00nan;0;0
10956;177248;201;0;0;0;0;.00nan;0;0
10956;189902;204;82;21;1;20;.952;3600000;0
10956;182049;204;0;0;0;0;.00nan;0;0
10956;185743;201;50;27;4;23;.852;3600000;0
11055;-1;227;78;40;3;37;.925;3600000;0
11055;181338;230;0;0;0;0;.00nan;0;0
11055;186495;230;55;12;1;11;.917;3600000;0
11055;187217;227;0;0;0;0;.00nan;0;0
10936;168907;186;0;0;0;0;.00nan;0;0
10936;169226;186;44;25;4;21;.840;3600000;0
10936;181065;219;0;0;0;0;.00nan;0;0
10936;181102;219;85;30;1;29;.967;3600000;0
11066;-1;203;0;0;0;0;.00nan;0;0
11066;-1;203;75;22;1;21;.955;3600000;0
11066;180623;202;52;24;3;21;.875;3600000;0
11066;192498;202;0;0;0;0;.00nan;0;0
10892;182467;185;0;0;0;0;.00nan;0;0
10892;171730;220;80;23;1;22;.957;3600000;0
10892;180110;185;59;39;5;34;.872;3600000;0
10892;187443;220;0;0;0;0;.00nan;0;0
11057;179602;177;88;44;4;40;.909;3575000;0
11057;176672;177;0;0;0;0;.00nan;0;0
11057;187240;216;0;0;0;0;.00nan;0;0
11057;191557;216;64;25;2;23;.920;3600000;0
10983;-1;211;100;42;1;41;.976;3600000;0
10983;179646;211;0;0;0;0;.00nan;0;0
10983;176938;180;64;29;3;26;.897;3539000;0
10983;-1;180;0;0;0;0;.00nan;0;0
11048;171835;4960;0;0;0;0;.00nan;0;0
11048;194219;4960;68;19;1;18;.947;3600000;0
11048;189885;225;61;40;5;35;.875;3600000;0
11048;184785;225;0;0;0;0;.00nan;0;0
11053;180623;202;0;0;0;0;.00nan;0;0
11053;-1;205;63;24;2;22;.917;3900000;0
11053;187092;205;0;0;0;0;.00nan;0;0
11053;192498;202;97;44;2;42;.955;3900000;0
10975;174325;197;84;51;4;47;.922;3550000;0
10975;175436;197;0;0;0;0;.00nan;0;0
10975;176200;195;62;21;2;19;.905;3600000;0
10975;179647;195;0;0;0;0;.00nan;0;0
11035;195238;200;0;0;0;0;.00nan;0;0
11035;175364;206;50;16;2;14;.875;3600000;0
11035;196283;206;0;0;0;0;.00nan;0;0
11035;187295;200;97;32;1;31;.969;3600000;0
11081;174209;178;100;36;0;36;1.000;3600000;0
11081;179400;183;0;0;0;0;.00nan;0;0
11081;182089;183;73;33;2;31;.939;3553000;0
11081;-1;178;0;0;0;0;.00nan;0;0
11378;174147;179;0;0;0;0;.00nan;0;0
11378;179602;177;0;0;0;0;.00nan;0;0
11378;176672;177;65;46;5;41;.891;3600000;0
11378;187355;179;85;15;0;15;1.000;3600000;0
11116;194416;191;30;25;5;20;.800;3543000;0
11116;178394;188;84;50;4;46;.920;3600000;0
11116;194893;191;0;0;0;0;.00nan;0;0
11116;174153;188;0;0;0;0;.00nan;0;0
10884;166545;193;32;25;5;20;.800;3617000;0
10884;173770;193;0;0;0;0;.00nan;0;0
10884;170351;194;76;42;4;38;.905;3617000;0
10884;196352;194;0;0;0;0;.00nan;0;0
11106;184069;208;0;0;0;0;.00nan;0;0
11106;169166;226;71;25;2;23;.920;3600000;0
11106;179702;208;63;33;3;30;.909;3600000;0
11106;192629;226;0;0;0;0;.00nan;0;0
11128;184175;224;0;0;0;0;.00nan;0;0
11128;181338;230;0;0;0;0;.00nan;0;0
11128;185840;224;91;59;4;55;.932;3600000;0
11128;186495;230;58;12;1;11;.917;3600000;0
10948;190034;217;86;46;3;43;.935;3873000;0
10948;190041;217;0;0;0;0;.00nan;0;0
10948;181065;219;57;27;3;24;.889;3900000;0
10948;181102;219;0;0;0;0;.00nan;0;0
11051;-1;221;54;25;3;22;.880;3600000;0
11051;175423;223;94;48;4;44;.917;3600000;0
11051;187118;223;0;0;0;0;.00nan;0;0
11051;187362;221;0;0;0;0;.00nan;0;0
11037;182467;185;58;29;3;26;.897;3600000;0
11037;180110;185;0;0;0;0;.00nan;0;0
11037;180574;181;0;0;0;0;.00nan;0;0
11037;-1;181;66;35;4;31;.886;3593000;0
11156;170114;4959;96;34;1;33;.971;3600000;0
11156;195363;4959;0;0;0;0;.00nan;0;0
11156;171405;2620;58;23;2;21;.913;3600000;0
11156;-1;2620;0;0;0;0;.00nan;0;0
11183;179406;232;54;22;3;19;.864;3600000;0
11183;179430;229;0;0;0;0;.00nan;0;0
11183;179434;232;0;0;0;0;.00nan;0;0
11183;185800;229;34;31;6;25;.806;3600000;0
11422;170351;194;76;30;3;27;.900;3600000;0
11422;-1;196;0;0;0;0;.00nan;0;0
11422;184648;196;53;29;4;25;.862;3575000;0
11422;196352;194;0;0;0;0;.00nan;0;0
11092;-1;211;86;35;2;33;.943;3600000;0
11092;179646;211;0;0;0;0;.00nan;0;0
11092;179679;212;0;0;0;0;.00nan;0;0
11092;186641;212;33;18;4;14;.778;3556000;0
10898;-1;1371;0;0;0;0;.00nan;0;0
10898;179388;182;0;0;0;0;.00nan;0;0
10898;182116;182;73;32;3;29;.906;3569000;0
10898;192688;1371;80;29;2;27;.931;3600000;0
11265;184069;208;81;41;3;38;.927;3847000;0
11265;175364;206;0;0;0;0;.00nan;0;0
11265;179702;208;0;0;0;0;.00nan;0;0
11265;196283;206;65;24;2;22;.917;3847000;0
11121;174325;197;61;38;4;34;.895;3600000;0
11121;175436;197;0;0;0;0;.00nan;0;0
11121;176200;195;93;18;0;18;1.000;3600000;0
11121;179647;195;0;0;0;0;.00nan;0;0
11029;167404;215;0;0;0;0;.00nan;0;0
11029;165731;215;37;33;5;28;.848;3539000;0
11029;190034;217;61;27;3;24;.889;3600000;0
11029;190041;217;0;0;0;0;.00nan;0;0
11144;171835;4960;55;10;1;9;.900;3600000;0
11144;194219;4960;0;0;0;0;.00nan;0;0
11144;189885;225;86;40;2;38;.950;3600000;0
11144;184785;225;0;0;0;0;.00nan;0;0
11044;-1;203;65;41;5;36;.878;3558000;0
11044;175370;199;51;29;4;25;.862;3600000;0
11044;-1;203;0;0;0;0;.00nan;0;0
11044;161006;199;0;0;0;0;.00nan;0;0
11147;194416;191;0;0;0;0;.00nan;0;0
11147;169096;190;64;37;4;33;.892;3600000;0
11147;194893;191;67;24;2;22;.917;3600000;0
11147;197704;190;0;0;0;0;.00nan;0;0
11023;-1;4949;60;14;1;13;.929;3600000;0
11023;195251;4949;0;0;0;0;.00nan;0;0
11023;174209;178;94;45;2;43;.956;3600000;0
11023;-1;178;0;0;0;0;.00nan;0;0
10996;171839;189;0;0;0;0;.00nan;0;0
10996;179197;198;0;0;0;0;.00nan;0;0
10996;-1;189;69;41;5;36;.878;3600000;0
10996;181431;198;89;21;0;21;1.000;3600000;0
11180;171405;2620;0;0;0;0;.00nan;0;0
11180;171662;176;99;67;3;64;.955;3600000;0
11180;176932;176;0;0;0;0;.00nan;0;0
11180;-1;2620;43;20;4;16;.800;3567000;0
11061;189902;204;0;0;0;0;.00nan;0;0
11061;182049;204;85;29;1;28;.966;3600000;0
11061;-1;205;61;30;3;27;.900;3529000;0
11061;187092;205;0;0;0;0;.00nan;0;0
11177;184610;222;60;39;4;35;.897;3582000;0
11177;175423;223;0;0;0;0;.00nan;0;0
11177;185851;222;0;0;0;0;.00nan;0;0
11177;187118;223;97;43;2;41;.953;3600000;0
11069;-1;203;34;28;6;22;.786;3005000;0
11069;-1;203;25;7;3;4;.571;595000;0
11069;180623;202;0;0;0;0;.00nan;0;0
11069;192498;202;100;33;0;33;1.000;3600000;0
11005;176938;180;64;38;4;34;.895;3600000;0
11005;181065;219;0;0;0;0;.00nan;0;0
11005;181102;219;92;27;0;27;1.000;3600000;0
11005;-1;180;0;0;0;0;.00nan;0;0
10913;171730;220;100;30;0;30;1.000;3600000;0
10913;180574;181;0;0;0;0;.00nan;0;0
10913;-1;181;55;38;4;34;.895;3600000;0
10913;187443;220;0;0;0;0;.00nan;0;0
11019;177248;201;0;0;0;0;.00nan;0;0
11019;184069;208;0;0;0;0;.00nan;0;0
11019;179702;208;85;31;2;29;.935;3600000;0
11019;185743;201;70;35;3;32;.914;3573000;0
11208;195238;200;0;0;0;0;.00nan;0;0
11208;175364;206;56;29;4;25;.862;3600000;0
11208;196283;206;0;0;0;0;.00nan;0;0
11208;187295;200;74;30;2;28;.933;3600000;0
11371;182467;185;68;21;2;19;.905;3600000;0
11371;180110;185;0;0;0;0;.00nan;0;0
11371;-1;214;0;0;0;0;.00nan;0;0
11371;191518;214;31;18;4;14;.778;3600000;0
10931;-1;1371;0;0;0;0;.00nan;0;0
10931;179388;182;0;0;0;0;.00nan;0;0
10931;182116;182;83;41;3;38;.927;3596000;0
10931;192688;1371;93;33;1;32;.970;3600000;0
11077;-1;211;55;39;5;34;.872;3600000;0
11077;168907;186;0;0;0;0;.00nan;0;0
11077;169226;186;92;33;2;31;.939;3600000;0
11077;179646;211;0;0;0;0;.00nan;0;0
11245;194416;191;74;32;2;30;.938;3557000;0
11245;194893;191;0;0;0;0;.00nan;0;0
11245;170351;194;100;38;1;37;.974;3600000;0
11245;196352;194;0;0;0;0;.00nan;0;0
11211;173340;231;0;0;0;0;.00nan;0;0
11211;179406;232;100;30;0;30;1.000;3600000;0
11211;179434;232;0;0;0;0;.00nan;0;0
11211;185034;231;54;19;2;17;.895;3538000;0
11160;171839;189;86;42;3;39;.929;3600000;0
11160;192862;187;0;0;0;0;.00nan;0;0
11160;189081;187;48;26;4;22;.846;3583000;0
11160;-1;189;0;0;0;0;.00nan;0;0
10946;166545;193;0;0;0;0;.00nan;0;0
10946;173770;193;46;20;3;17;.850;3511000;0
10946;-1;196;0;0;0;0;.00nan;0;0
10946;184648;196;99;40;1;39;.975;3600000;0
11052;179197;198;0;0;0;0;.00nan;0;0
11052;176200;195;77;34;2;32;.941;3900000;0
11052;179647;195;0;0;0;0;.00nan;0;0
11052;181431;198;78;28;2;26;.929;3900000;0
10989;174147;179;30;10;3;7;.700;1326000;0
10989;180762;1505;0;0;0;0;.00nan;0;0
10989;186549;1505;80;32;3;29;.906;3600000;0
10989;187355;179;23;18;5;13;.722;2274000;0
11192;179400;183;0;0;0;0;.00nan;0;0
11192;179602;177;36;22;5;17;.773;3600000;0
11192;176672;177;0;0;0;0;.00nan;0;0
11192;182089;183;88;42;2;40;.952;3600000;0
11100;189885;225;0;0;0;0;.00nan;0;0
11100;184785;225;89;38;2;36;.947;3900000;0
11100;181338;230;0;0;0;0;.00nan;0;0
11100;186495;230;68;18;2;16;.889;3847000;0
11070;189902;204;83;27;1;26;.963;3900000;0
11070;-1;207;0;0;0;0;.00nan;0;0
11070;182049;204;0;0;0;0;.00nan;0;0
11070;-1;207;96;48;1;47;.979;3900000;0
11079;166762;213;0;0;0;0;.00nan;0;0
11079;180575;213;71;31;3;28;.903;3600000;0
11079;187240;216;61;23;2;21;.913;3600000;0
11079;191557;216;0;0;0;0;.00nan;0;0
11097;178394;188;0;0;0;0;.00nan;0;0
11097;169096;190;0;0;0;0;.00nan;0;0
11097;174153;188;97;25;0;25;1.000;3600000;0
11097;197704;190;59;47;6;41;.872;3600000;0
11084;182454;4864;0;0;0;0;.00nan;0;0
11084;183737;4864;62;27;3;24;.889;3600000;0
11084;179169;209;92;38;2;36;.947;3600000;0
11084;186205;209;0;0;0;0;.00nan;0;0
11078;171835;4960;75;23;1;22;.957;3600000;0
11078;194219;4960;0;0;0;0;.00nan;0;0
11078;-1;221;0;0;0;0;.00nan;0;0
11078;187362;221;100;29;0;29;1.000;3600000;0
11124;-1;227;0;0;0;0;.00nan;0;0
11124;179430;229;0;0;0;0;.00nan;0;0
11124;185800;229;61;17;1;16;.941;3600000;0
11124;187217;227;85;43;3;40;.930;3524000;0
10990;167404;215;62;21;2;19;.905;3600000;0
10990;165731;215;0;0;0;0;.00nan;0;0
10990;190034;217;0;0;0;0;.00nan;0;0
10990;190041;217;76;45;4;41;.911;3580000;0
10960;171730;220;46;27;4;23;.852;3600000;0
10960;180574;181;79;30;2;28;.933;3600000;0
10960;-1;181;0;0;0;0;.00nan;0;0
10960;187443;220;0;0;0;0;.00nan;0;0
11220;-1;210;0;0;0;0;.00nan;0;0
11220;179400;183;63;22;2;20;.909;2635000;0
11220;182089;183;10;11;5;6;.545;965000;0
11220;192461;210;80;20;1;19;.950;3600000;0
11161;192862;187;62;18;2;16;.889;3600000;0
11161;189081;187;0;0;0;0;.00nan;0;0
11161;174325;197;0;0;0;0;.00nan;0;0
11161;175436;197;81;44;3;41;.932;3571000;0
11408;169166;226;88;53;3;50;.943;3900000;0
11408;180623;202;0;0;0;0;.00nan;0;0
11408;192498;202;69;32;3;29;.906;3900000;0
11408;192629;226;0;0;0;0;.00nan;0;0
11049;174147;179;81;36;2;34;.944;3600000;0
11049;180762;1505;46;33;5;28;.848;3600000;0
11049;186549;1505;0;0;0;0;.00nan;0;0
11049;187355;179;0;0;0;0;.00nan;0;0
11131;-1;4949;65;25;2;23;.920;3600000;0
11131;195251;4949;0;0;0;0;.00nan;0;0
11131;187240;216;0;0;0;0;.00nan;0;0
11131;191557;216;52;32;4;28;.875;3560000;0
11296;184175;224;27;22;5;17;.773;3600000;0
11296;175423;223;81;31;2;29;.935;3600000;0
11296;185840;224;0;0;0;0;.00nan;0;0
11296;187118;223;0;0;0;0;.00nan;0;0
11122;182454;4864;75;32;3;29;.906;3600000;0
11122;183737;4864;0;0;0;0;.00nan;0;0
11122;171662;176;55;34;4;30;.882;3550000;0
11122;176932;176;0;0;0;0;.00nan;0;0
11087;168954;228;0;0;0;0;.00nan;0;0
11087;-1;221;0;0;0;0;.00nan;0;0
11087;175354;228;66;33;3;30;.909;3549000;0
11087;187362;221;78;30;2;28;.933;3600000;0
11653;184610;222;0;0;0;0;.00nan;0;0
11653;181338;230;96;16;0;16;1.000;3600000;0
11653;185851;222;88;45;3;42;.933;3600000;0
11653;186495;230;0;0;0;0;.00nan;0;0
11216;171405;2620;64;34;3;31;.912;3849000;0
11216;179169;209;0;0;0;0;.00nan;0;0
11216;-1;2620;0;0;0;0;.00nan;0;0
11216;186205;209;59;32;3;29;.906;3900000;0
11009;166545;193;87;27;1;26;.963;3900000;0
11009;178394;188;97;42;1;41;.976;3900000;0
11009;173770;193;0;0;0;0;.00nan;0;0
11009;174153;188;0;0;0;0;.00nan;0;0
11130;166762;213;0;0;0;0;.00nan;0;0
11130;174209;178;64;33;4;29;.879;3600000;0
11130;180575;213;99;36;1;35;.972;3600000;0
11130;-1;178;0;0;0;0;.00nan;0;0
11032;179388;182;0;0;0;0;.00nan;0;0
11032;190125;184;0;0;0;0;.00nan;0;0
11032;179668;184;75;29;2;27;.931;3600000;0
11032;182116;182;78;34;3;31;.912;3544000;0
11268;171839;189;0;0;0;0;.00nan;0;0
11268;169096;190;48;37;5;32;.865;3562000;0
11268;-1;189;80;38;3;35;.921;3600000;0
11268;197704;190;0;0;0;0;.00nan;0;0
11112;168954;228;100;40;1;39;.975;3900000;0
11112;184610;222;91;24;1;23;.958;3900000;0
11112;175354;228;0;0;0;0;.00nan;0;0
11112;185851;222;0;0;0;0;.00nan;0;0
11246;169166;226;0;0;0;0;.00nan;0;0
11246;195238;200;44;12;2;10;.833;1361000;0
11246;187295;200;41;37;6;31;.838;2239000;0
11246;192629;226;63;16;1;15;.938;3600000;0
10954;-1;1371;0;0;0;0;.00nan;0;0
10954;-1;214;83;34;2;32;.941;3600000;0
10954;191518;214;0;0;0;0;.00nan;0;0
10954;192688;1371;39;29;5;24;.828;3586000;0
11088;171835;4960;50;25;3;22;.880;3600000;0
11088;194219;4960;0;0;0;0;.00nan;0;0
11088;-1;227;84;32;2;30;.938;3600000;0
11088;187217;227;0;0;0;0;.00nan;0;0
11011;184069;208;0;0;0;0;.00nan;0;0
11011;189902;204;0;0;0;0;.00nan;0;0
11011;179702;208;69;31;3;28;.903;3589000;0
11011;182049;204;68;25;2;23;.920;3600000;0
11047;195164;218;0;0;0;0;.00nan;0;0
11047;176938;180;20;10;4;6;.600;1026000;0
11047;-1;180;44;25;4;21;.840;2574000;0
11047;192457;218;100;31;0;31;1.000;3600000;0
11001;167404;215;0;0;0;0;.00nan;0;0
11001;165731;215;63;32;4;28;.875;3900000;0
11001;168907;186;0;0;0;0;.00nan;0;0
11001;169226;186;56;25;4;21;.840;3900000;0
11004;-1;196;0;0;0;0;.00nan;0;0
11004;179197;198;63;25;3;22;.880;3600000;0
11004;184648;196;73;44;4;40;.909;3581000;0
11004;181431;198;0;0;0;0;.00nan;0;0
11026;177248;201;53;39;5;34;.872;3600000;0
11026;-1;205;71;23;2;21;.913;3600000;0
11026;185743;201;0;0;0;0;.00nan;0;0
11026;187092;205;0;0;0;0;.00nan;0;0
11159;189885;225;70;37;3;34;.919;3532000;0
11159;179406;232;79;28;1;27;.964;3600000;0
11159;179434;232;0;0;0;0;.00nan;0;0
11159;184785;225;0;0;0;0;.00nan;0;0
11022;175370;199;0;0;0;0;.00nan;0;0
11022;-1;207;0;0;0;0;.00nan;0;0
11022;-1;207;77;46;4;42;.913;3600000;0
11022;161006;199;74;26;2;24;.923;3600000;0
11150;-1;211;71;35;3;32;.914;3900000;0
11150;179646;211;0;0;0;0;.00nan;0;0
11150;179679;212;61;28;3;25;.893;3900000;0
11150;186641;212;0;0;0;0;.00nan;0;0
11184;173340;231;58;33;4;29;.879;3557000;0
11184;185034;231;0;0;0;0;.00nan;0;0
11184;181338;230;83;31;2;29;.935;3600000;0
11184;186495;230;0;0;0;0;.00nan;0;0
11127;-1;227;0;0;0;0;.00nan;0;0
11127;179430;229;0;0;0;0;.00nan;0;0
11127;185800;229;91;36;2;34;.944;3600000;0
11127;187217;227;53;27;3;24;.889;3553000;0
11114;177248;201;0;0;0;0;.00nan;0;0
11114;-1;205;0;0;0;0;.00nan;0;0
11114;185743;201;100;51;2;49;.961;3900000;0
11114;187092;205;73;32;2;30;.938;3900000;0
11199;192862;187;0;0;0;0;.00nan;0;0
11199;189081;187;40;11;2;9;.818;3546000;0
11199;170351;194;99;40;1;39;.975;3600000;0
11199;196352;194;0;0;0;0;.00nan;0;0
11085;175364;206;64;28;3;25;.893;3589000;0
11085;-1;207;73;21;1;20;.952;3600000;0
11085;196283;206;0;0;0;0;.00nan;0;0
11085;-1;207;0;0;0;0;.00nan;0;0
11193;168117;192;0;0;0;0;.00nan;0;0
11193;174325;197;30;14;4;10;.714;550000;0
11193;175436;197;76;38;3;35;.921;3050000;0
11193;-1;192;59;15;1;14;.933;3600000;0
11104;168907;186;69;30;2;28;.933;3600000;0
11104;169226;186;0;0;0;0;.00nan;0;0
11104;195164;218;0;0;0;0;.00nan;0;0
11104;192457;218;66;42;5;37;.881;3600000;0
11068;190034;217;55;37;5;32;.865;3600000;0
11068;190041;217;0;0;0;0;.00nan;0;0
11068;181065;219;0;0;0;0;.00nan;0;0
11068;181102;219;100;36;1;35;.972;3600000;0
11025;179388;182;0;0;0;0;.00nan;0;0
11025;180574;181;0;0;0;0;.00nan;0;0
11025;182116;182;69;44;6;38;.864;3600000;0
11025;-1;181;88;27;1;26;.963;3600000;0
11111;166762;213;71;44;3;41;.932;3600000;0
11111;180575;213;0;0;0;0;.00nan;0;0
11111;180762;1505;0;0;0;0;.00nan;0;0
11111;186549;1505;83;15;0;15;1.000;3600000;0
11027;166545;193;61;18;1;17;.944;3600000;0
11027;173770;193;0;0;0;0;.00nan;0;0
11027;-1;196;67;46;4;42;.913;3600000;0
11027;184648;196;0;0;0;0;.00nan;0;0
10926;171730;220;74;26;2;24;.923;3600000;0
10926;190125;184;88;44;3;41;.932;3592000;0
10926;179668;184;0;0;0;0;.00nan;0;0
10926;187443;220;0;0;0;0;.00nan;0;0
11212;182454;4864;0;0;0;0;.00nan;0;0
11212;183737;4864;82;19;1;18;.947;3600000;0
11212;171662;176;74;32;3;29;.906;3513000;0
11212;176932;176;0;0;0;0;.00nan;0;0
11337;174147;179;53;17;2;15;.882;3600000;0
11337;179400;183;47;9;1;8;.889;249000;0
11337;182089;183;38;47;8;39;.830;3351000;0
11337;187355;179;0;0;0;0;.00nan;0;0
11105;-1;4949;80;15;0;15;1.000;3600000;0
11105;195251;4949;0;0;0;0;.00nan;0;0
11105;174209;178;0;0;0;0;.00nan;0;0
11105;-1;178;81;35;1;34;.971;3578000;0
11141;195238;200;0;0;0;0;.00nan;0;0
11141;180623;202;100;22;0;22;1.000;3600000;0
11141;187295;200;98;48;4;44;.917;3600000;0
11141;192498;202;0;0;0;0;.00nan;0;0
11354;173340;231;0;0;0;0;.00nan;0;0
11354;175423;223;60;38;4;34;.895;3600000;0
11354;185034;231;74;21;1;20;.952;3600000;0
11354;187118;223;0;0;0;0;.00nan;0;0
11028;-1;1371;0;0;0;0;.00nan;0;0
11028;-1;214;96;39;2;37;.949;3900000;0
11028;191518;214;0;0;0;0;.00nan;0;0
11028;192688;1371;80;20;2;18;.900;3900000;0
11072;170351;194;0;0;0;0;.00nan;0;0
11072;176200;195;59;14;1;13;.929;3600000;0
11072;179647;195;0;0;0;0;.00nan;0;0
11072;196352;194;73;44;4;40;.909;3600000;0
11185;-1;221;75;23;1;22;.957;3600000;0
11185;184610;222;0;0;0;0;.00nan;0;0
11185;185851;222;48;35;5;30;.857;3600000;0
11185;187362;221;0;0;0;0;.00nan;0;0
11227;171405;2620;100;30;0;30;1.000;3600000;0
11227;179169;209;55;21;2;19;.905;3552000;0
11227;-1;2620;0;0;0;0;.00nan;0;0
11227;186205;209;0;0;0;0;.00nan;0;0
11117;176938;180;59;24;3;21;.875;3600000;0
11117;181065;219;69;26;2;24;.923;3600000;0
11117;181102;219;0;0;0;0;.00nan;0;0
11117;-1;180;0;0;0;0;.00nan;0;0
11071;-1;210;0;0;0;0;.00nan;0;0
11071;187240;216;98;40;2;38;.950;3549000;0
11071;191557;216;0;0;0;0;.00nan;0;0
11071;192461;210;83;30;1;29;.967;3600000;0
11347;179406;232;81;45;4;41;.911;3600000;0
11347;179434;232;0;0;0;0;.00nan;0;0
11347;181338;230;0;0;0;0;.00nan;0;0
11347;186495;230;74;21;1;20;.952;3600000;0
11154;171839;189;0;0;0;0;.00nan;0;0
11154;178394;188;0;0;0;0;.00nan;0;0
11154;174153;188;85;28;1;27;.964;3600000;0
11154;-1;189;78;35;2;33;.943;3600000;0
11224;-1;211;88;36;1;35;.972;3900000;0
11224;195164;218;73;22;1;21;.955;3900000;0
11224;179646;211;0;0;0;0;.00nan;0;0
11224;192457;218;0;0;0;0;.00nan;0;0
11458;168117;192;0;0;0;0;.00nan;0;0
11458;194416;191;0;0;0;0;.00nan;0;0
11458;194893;191;56;20;3;17;.850;3551000;0
11458;-1;192;82;39;2;37;.949;3600000;0
11571;-1;210;53;25;4;21;.840;3600000;0
11571;179602;177;42;42;7;35;.833;2903000;0
11571;176672;177;58;5;0;5;1.000;697000;0
11571;192461;210;0;0;0;0;.00nan;0;0
11083;-1;203;94;35;1;34;.971;3600000;0
11083;175370;199;0;0;0;0;.00nan;0;0
11083;-1;203;0;0;0;0;.00nan;0;0
11083;161006;199;78;42;4;38;.905;3600000;0
11430;182467;185;92;39;3;36;.923;3877000;0
11430;190125;184;68;35;4;31;.886;3865000;0
11430;179668;184;0;0;0;0;.00nan;0;0
11430;180110;185;0;0;0;0;.00nan;0;0
11210;168954;228;37;25;5;20;.800;2279000;0
11210;175354;228;58;5;0;5;1.000;1321000;0
11210;179430;229;0;0;0;0;.00nan;0;0
11210;185800;229;100;36;0;36;1.000;3600000;0
11145;175370;199;70;30;3;27;.900;3600000;0
11145;180623;202;60;40;4;36;.900;3551000;0
11145;192498;202;0;0;0;0;.00nan;0;0
11145;161006;199;0;0;0;0;.00nan;0;0
11031;167404;215;0;0;0;0;.00nan;0;0
11031;165731;215;84;30;2;28;.933;3900000;0
11031;190034;217;67;25;2;23;.920;3900000;0
11031;190041;217;0;0;0;0;.00nan;0;0
11138;-1;4949;18;42;9;33;.786;3600000;0
11138;195251;4949;0;0;0;0;.00nan;0;0
11138;180762;1505;0;0;0;0;.00nan;0;0
11138;186549;1505;84;34;2;32;.941;3600000;0
11217;182454;4864;0;0;0;0;.00nan;0;0
11217;183737;4864;99;36;1;35;.972;3600000;0
11217;171405;2620;47;28;5;23;.821;3600000;0
11217;-1;2620;0;0;0;0;.00nan;0;0
11197;177248;201;0;0;0;0;.00nan;0;0
11197;175364;206;0;0;0;0;.00nan;0;0
11197;196283;206;54;30;4;26;.867;3516000;0
11197;185743;201;65;25;2;23;.920;3600000;0
11279;169096;190;74;40;3;37;.925;3900000;0
11279;170351;194;88;30;3;27;.900;3872000;0
11279;196352;194;0;0;0;0;.00nan;0;0
11279;197704;190;0;0;0;0;.00nan;0;0
11202;166762;213;0;0;0;0;.00nan;0;0
11202;179602;177;0;0;0;0;.00nan;0;0
11202;176672;177;84;37;2;35;.946;3619000;0
11202;180575;213;67;28;3;25;.893;3619000;0
11226;182467;185;68;11;0;11;1.000;1285000;0
11226;171730;220;38;6;2;4;.667;3600000;0
11226;180110;185;32;31;6;25;.806;2315000;0
11226;187443;220;0;0;0;0;.00nan;0;0
11181;171835;4960;0;0;0;0;.00nan;0;0
11181;194219;4960;59;11;1;10;.909;3600000;0
11181;-1;227;0;0;0;0;.00nan;0;0
11181;187217;227;66;39;3;36;.923;3600000;0
11076;168117;192;0;0;0;0;.00nan;0;0
11076;179197;198;0;0;0;0;.00nan;0;0
11076;-1;192;68;40;4;36;.900;3694000;0
11076;181431;198;72;37;3;34;.919;3694000;0
11558;173340;231;0;0;0;0;.00nan;0;0
11558;179406;232;35;12;3;9;.750;595000;0
11558;179434;232;81;60;6;54;.900;3005000;0
11558;185034;231;47;6;1;5;.833;3600000;0
11294;195238;200;0;0;0;0;.00nan;0;0
11294;175364;206;68;32;3;29;.906;3575000;0
11294;196283;206;0;0;0;0;.00nan;0;0
11294;187295;200;75;27;2;25;.926;3600000;0
11304;171405;2620;0;0;0;0;.00nan;0;0
11304;179169;209;97;38;1;37;.974;3892000;0
11304;-1;2620;61;26;2;24;.923;3892000;0
11304;186205;209;0;0;0;0;.00nan;0;0
11082;166545;193;0;0;0;0;.00nan;0;0
11082;173770;193;90;41;2;39;.951;3600000;0
11082;176200;195;37;23;4;19;.826;3600000;0
11082;179647;195;0;0;0;0;.00nan;0;0
11107;184069;208;70;35;3;32;.914;3564000;0
11107;189902;204;72;21;1;20;.952;3600000;0
11107;179702;208;0;0;0;0;.00nan;0;0
11107;182049;204;0;0;0;0;.00nan;0;0
11155;174147;179;0;0;0;0;.00nan;0;0
11155;174209;178;72;35;3;32;.914;3566000;0
11155;187355;179;88;33;1;32;.970;3600000;0
11155;-1;178;0;0;0;0;.00nan;0;0
11321;-1;211;69;38;4;34;.895;3600000;0
11321;179646;211;0;0;0;0;.00nan;0;0
11321;179679;212;0;0;0;0;.00nan;0;0
11321;186641;212;76;23;1;22;.957;3600000;0
11213;170351;194;0;0;0;0;.00nan;0;0
11213;174325;197;65;17;1;16;.941;3600000;0
11213;175436;197;0;0;0;0;.00nan;0;0
11213;196352;194;68;33;4;29;.879;3600000;0
11219;-1;221;76;28;2;26;.929;3900000;0
11219;181338;230;0;0;0;0;.00nan;0;0
11219;186495;230;74;28;2;26;.929;3900000;0
11219;187362;221;0;0;0;0;.00nan;0;0
11174;171835;4960;51;19;2;17;.895;3600000;0
11174;194219;4960;0;0;0;0;.00nan;0;0
11174;168954;228;63;45;4;41;.911;3600000;0
11174;175354;228;0;0;0;0;.00nan;0;0
11167;-1;203;66;38;4;34;.895;3549000;0
11167;-1;203;0;0;0;0;.00nan;0;0
11167;180623;202;0;0;0;0;.00nan;0;0
11167;192498;202;60;28;3;25;.893;3600000;0
11278;184610;222;81;27;2;25;.926;3600000;0
11278;175423;223;93;59;4;55;.932;3555000;0
11278;185851;222;0;0;0;0;.00nan;0;0
11278;187118;223;0;0;0;0;.00nan;0;0
11080;-1;1371;0;0;0;0;.00nan;0;0
11080;180574;181;0;0;0;0;.00nan;0;0
11080;-1;181;47;15;3;12;.800;3600000;0
11080;192688;1371;47;38;5;33;.868;3529000;0
11176;169166;226;59;29;4;25;.862;3600000;0
11176;-1;205;44;37;6;31;.838;3573000;0
11176;187092;205;0;0;0;0;.00nan;0;0
11176;192629;226;0;0;0;0;.00nan;0;0
11368;184175;224;54;38;5;33;.868;3600000;0
11368;179430;229;0;0;0;0;.00nan;0;0
11368;185800;229;79;21;2;19;.905;3600000;0
11368;185840;224;0;0;0;0;.00nan;0;0
11206;192862;187;92;42;1;41;.976;3600000;0
11206;189081;187;0;0;0;0;.00nan;0;0
11206;178394;188;57;20;2;18;.900;3341000;0
11206;174153;188;26;6;3;3;.500;259000;0
11143;166762;213;98;42;2;40;.952;3573000;0
11143;180575;213;0;0;0;0;.00nan;0;0
11143;187240;216;89;27;1;26;.963;3600000;0
11143;191557;216;0;0;0;0;.00nan;0;0
11118;168907;186;0;0;0;0;.00nan;0;0
11118;169226;186;89;39;3;36;.923;3900000;0
11118;181065;219;0;0;0;0;.00nan;0;0
11118;181102;219;86;46;3;43;.935;3900000;0
11484;171839;189;0;0;0;0;.00nan;0;0
11484;194416;191;0;0;0;0;.00nan;0;0
11484;194893;191;73;22;1;21;.955;3600000;0
11484;-1;189;96;42;2;40;.952;3554000;0
11152;179388;182;0;0;0;0;.00nan;0;0
11152;182116;182;67;26;2;24;.923;3600000;0
11152;-1;214;55;35;4;31;.886;3515000;0
11152;191518;214;0;0;0;0;.00nan;0;0
11146;179400;183;0;0;0;0;.00nan;0;0
11146;180762;1505;41;32;5;27;.844;3543000;0
11146;182089;183;82;49;4;45;.918;3600000;0
11146;186549;1505;0;0;0;0;.00nan;0;0
11108;167404;215;81;35;2;33;.943;3600000;0
11108;165731;215;0;0;0;0;.00nan;0;0
11108;176938;180;34;21;4;17;.810;3543000;0
11108;-1;180;0;0;0;0;.00nan;0;0
11036;-1;196;0;0;0;0;.00nan;0;0
11036;179197;198;67;23;2;21;.913;3600000;0
11036;184648;196;80;38;3;35;.921;3548000;0
11036;181431;198;0;0;0;0;.00nan;0;0
11394;177248;201;61;33;3;30;.909;3600000;0
11394;-1;207;0;0;0;0;.00nan;0;0
11394;185743;201;0;0;0;0;.00nan;0;0
11394;-1;207;36;29;6;23;.793;3600000;0
11056;-1;196;95;51;3;48;.941;3576000;0
11056;184648;196;0;0;0;0;.00nan;0;0
11056;176200;195;55;16;2;14;.875;3600000;0
11056;179647;195;0;0;0;0;.00nan;0;0
11234;168954;228;0;0;0;0;.00nan;0;0
11234;-1;227;49;30;4;26;.867;3557000;0
11234;175354;228;70;25;2;23;.920;3600000;0
11234;187217;227;0;0;0;0;.00nan;0;0
11139;182454;4864;0;0;0;0;.00nan;0;0
11139;183737;4864;38;22;4;18;.818;3600000;0
11139;171662;176;0;0;0;0;.00nan;0;0
11139;176932;176;60;40;5;35;.875;3594000;0
11102;-1;1371;0;0;0;0;.00nan;0;0
11102;-1;214;0;0;0;0;.00nan;0;0
11102;191518;214;83;37;3;34;.919;3554000;0
11102;192688;1371;73;19;1;18;.947;3600000;0
11335;-1;4949;77;24;1;23;.958;3900000;0
11335;195251;4949;0;0;0;0;.00nan;0;0
11335;-1;210;0;0;0;0;.00nan;0;0
11335;192461;210;88;30;1;29;.967;3900000;0
11120;189902;204;0;0;0;0;.00nan;0;0
11120;175370;199;70;23;2;21;.913;3881000;0
11120;182049;204;78;32;3;29;.906;3881000;0
11120;161006;199;0;0;0;0;.00nan;0;0
11228;192862;187;0;0;0;0;.00nan;0;0
11228;189081;187;83;33;2;31;.939;3900000;0
11228;178394;188;0;0;0;0;.00nan;0;0
11228;174153;188;75;28;2;26;.929;3900000;0
11015;182467;185;100;40;1;39;.975;3600000;0
11015;171730;220;66;33;3;30;.909;3513000;0
11015;180110;185;0;0;0;0;.00nan;0;0
11015;187443;220;0;0;0;0;.00nan;0;0
11229;171839;189;80;31;2;29;.935;3600000;0
11229;174325;197;0;0;0;0;.00nan;0;0
11229;-1;189;0;0;0;0;.00nan;0;0
11229;175436;197;41;30;5;25;.833;3600000;0
11165;168907;186;67;42;5;37;.881;3600000;0
11165;169226;186;0;0;0;0;.00nan;0;0
11165;176938;180;38;33;6;27;.818;2960000;0
11165;-1;180;50;3;0;3;1.000;640000;0
11169;179400;183;63;47;6;41;.872;3600000;0
11169;182089;183;0;0;0;0;.00nan;0;0
11169;187240;216;0;0;0;0;.00nan;0;0
11169;191557;216;64;28;2;26;.929;3600000;0
11157;174209;178;63;29;3;26;.897;3641000;0
11157;179602;177;60;22;2;20;.909;3641000;0
11157;176672;177;0;0;0;0;.00nan;0;0
11157;-1;178;0;0;0;0;.00nan;0;0
11329;170114;4959;62;26;3;23;.885;3600000;0
11329;195363;4959;0;0;0;0;.00nan;0;0
11329;171405;2620;79;42;5;37;.881;3515000;0
11329;-1;2620;0;0;0;0;.00nan;0;0
11634;179406;232;83;50;6;44;.880;3600000;0
11634;179434;232;0;0;0;0;.00nan;0;0
11634;181338;230;0;0;0;0;.00nan;0;0
11634;186495;230;46;19;3;16;.842;3600000;0
11179;-1;4949;0;0;0;0;.00nan;0;0
11179;195251;4949;44;30;5;25;.833;3600000;0
11179;180762;1505;69;24;2;22;.917;3600000;0
11179;186549;1505;0;0;0;0;.00nan;0;0
11235;-1;221;0;0;0;0;.00nan;0;0
11235;179430;229;51;9;1;8;.889;1387000;0
11235;185800;229;24;26;6;20;.769;2213000;0
11235;187362;221;44;16;3;13;.813;3600000;0
11569;168117;192;0;0;0;0;.00nan;0;0
11569;194416;191;0;0;0;0;.00nan;0;0
11569;194893;191;81;24;1;23;.958;3900000;0
11569;-1;192;83;26;1;25;.962;3900000;0
11195;171835;4960;64;20;2;18;.900;3900000;0
11195;194219;4960;0;0;0;0;.00nan;0;0
11195;175423;223;0;0;0;0;.00nan;0;0
11195;187118;223;97;47;2;45;.957;3900000;0
11137;190034;217;39;30;5;25;.833;3600000;0
11137;190041;217;0;0;0;0;.00nan;0;0
11137;179679;212;0;0;0;0;.00nan;0;0
11137;186641;212;81;26;1;25;.962;3600000;0
10999;171730;220;0;0;0;0;.00nan;0;0
10999;190125;184;56;26;4;22;.846;3600000;0
10999;179668;184;0;0;0;0;.00nan;0;0
10999;187443;220;69;29;2;27;.931;3600000;0
11353;177248;201;0;0;0;0;.00nan;0;0
11353;180623;202;0;0;0;0;.00nan;0;0
11353;185743;201;96;45;2;43;.956;3900000;0
11353;192498;202;91;34;2;32;.941;3900000;0
11264;-1;227;0;0;0;0;.00nan;0;0
11264;189885;225;29;26;5;21;.808;3600000;0
11264;184785;225;0;0;0;0;.00nan;0;0
11264;187217;227;74;41;4;37;.902;3600000;0
11223;182454;4864;74;37;2;35;.946;3597000;0
11223;183737;4864;0;0;0;0;.00nan;0;0
11223;179169;209;0;0;0;0;.00nan;0;0
11223;186205;209;85;21;1;20;.952;3600000;0
11351;179388;182;0;0;0;0;.00nan;0;0
11351;180574;181;0;0;0;0;.00nan;0;0
11351;182116;182;82;34;2;32;.941;3600000;0
11351;-1;181;50;29;4;25;.862;3544000;0
11093;175364;206;49;2;0;2;1.000;666000;0
11093;-1;207;84;15;0;15;1.000;3600000;0
11093;196283;206;32;32;6;26;.813;2934000;0
11093;-1;207;0;0;0;0;.00nan;0;0
11198;169166;226;92;22;0;22;1.000;3600000;0
11198;-1;205;82;32;2;30;.938;3534000;0
11198;187092;205;0;0;0;0;.00nan;0;0
11198;192629;226;0;0;0;0;.00nan;0;0
11406;173340;231;0;0;0;0;.00nan;0;0
11406;184175;224;0;0;0;0;.00nan;0;0
11406;185034;231;84;23;2;21;.913;3600000;0
11406;185840;224;80;52;5;47;.904;3600000;0
11282;169166;226;62;24;2;22;.917;3560000;0
11282;-1;205;0;0;0;0;.00nan;0;0
11282;187092;205;100;37;0;37;1.000;3600000;0
11282;192629;226;0;0;0;0;.00nan;0;0
11205;-1;211;20;11;4;7;.636;791000;0
11205;168907;186;0;0;0;0;.00nan;0;0
11205;169226;186;40;31;5;26;.839;3600000;0
11205;179646;211;63;24;2;22;.917;2785000;0
11349;184175;224;72;29;2;27;.931;3600000;0
11349;184610;222;37;24;4;20;.833;3170000;0
11349;185840;224;0;0;0;0;.00nan;0;0
11349;185851;222;26;6;3;3;.500;430000;0
11110;179388;182;0;0;0;0;.00nan;0;0
11110;182116;182;80;24;1;23;.958;3600000;0
11110;-1;214;40;29;5;24;.828;3600000;0
11110;191518;214;0;0;0;0;.00nan;0;0
11098;166545;193;97;25;0;25;1.000;3600000;0
11098;171839;189;0;0;0;0;.00nan;0;0
11098;173770;193;0;0;0;0;.00nan;0;0
11098;-1;189;98;44;2;42;.955;3558000;0
11196;168117;192;73;21;1;20;.952;3600000;0
11196;174325;197;35;30;6;24;.800;2830000;0
11196;175436;197;68;15;0;15;1.000;770000;0
11196;-1;192;0;0;0;0;.00nan;0;0
11369;170351;194;92;46;3;43;.935;3600000;0
11369;179197;198;83;25;1;24;.960;3600000;0
11369;196352;194;0;0;0;0;.00nan;0;0
11369;181431;198;0;0;0;0;.00nan;0;0
11221;179679;212;75;29;2;27;.931;3600000;0
11221;181065;219;0;0;0;0;.00nan;0;0
11221;181102;219;82;26;1;25;.962;3600000;0
11221;186641;212;0;0;0;0;.00nan;0;0
11103;195238;200;56;20;2;18;.900;1535000;0
11103;-1;203;74;32;2;30;.938;3600000;0
11103;-1;203;0;0;0;0;.00nan;0;0
11103;187295;200;57;23;4;19;.826;2065000;0
11301;174147;179;0;0;0;0;.00nan;0;0
11301;174209;178;0;0;0;0;.00nan;0;0
11301;187355;179;65;15;1;14;.933;3600000;0
11301;-1;178;97;57;2;55;.965;3600000;0
11244;179430;229;0;0;0;0;.00nan;0;0
11244;181338;230;0;0;0;0;.00nan;0;0
11244;185800;229;91;41;3;38;.927;3853000;0
11244;186495;230;51;19;2;17;.895;3853000;0
11225;-1;221;42;22;4;18;.818;3792000;0
11225;179406;232;57;36;5;31;.861;3792000;0
11225;179434;232;0;0;0;0;.00nan;0;0
11225;187362;221;0;0;0;0;.00nan;0;0
11365;173340;231;64;16;1;15;.938;3600000;0
11365;168954;228;79;31;2;29;.935;3600000;0
11365;175354;228;0;0;0;0;.00nan;0;0
11365;185034;231;0;0;0;0;.00nan;0;0
11241;190125;184;74;44;4;40;.909;3587000;0
11241;179668;184;0;0;0;0;.00nan;0;0
11241;180574;181;0;0;0;0;.00nan;0;0
11241;-1;181;64;24;3;21;.875;3600000;0
11194;-1;203;0;0;0;0;.00nan;0;0
11194;-1;203;43;23;4;19;.826;3600000;0
11194;-1;207;0;0;0;0;.00nan;0;0
11194;-1;207;25;28;7;21;.750;3600000;0
11133;182467;185;0;0;0;0;.00nan;0;0
11133;-1;1371;0;0;0;0;.00nan;0;0
11133;180110;185;99;35;1;34;.971;3600000;0
11133;192688;1371;68;23;2;21;.913;3569000;0
11064;192862;187;0;0;0;0;.00nan;0;0
11064;189081;187;100;39;0;39;1.000;3600000;0
11064;179197;198;0;0;0;0;.00nan;0;0
11064;181431;198;69;32;2;30;.938;3549000;0
11123;195238;200;0;0;0;0;.00nan;0;0
11123;189902;204;85;23;0;23;1.000;3600000;0
11123;182049;204;0;0;0;0;.00nan;0;0
11123;187295;200;41;33;5;28;.848;3600000;0
11258;194416;191;54;16;2;14;.875;3600000;0
11258;178394;188;0;0;0;0;.00nan;0;0
11258;194893;191;0;0;0;0;.00nan;0;0
11258;174153;188;64;38;3;35;.921;3600000;0
11281;170351;194;0;0;0;0;.00nan;0;0
11281;176200;195;54;17;3;14;.824;3600000;0
11281;179647;195;0;0;0;0;.00nan;0;0
11281;196352;194;76;48;5;43;.896;3594000;0
11460;174147;179;100;35;0;35;1.000;3600000;0
11460;179602;177;66;28;3;25;.893;3600000;0
11460;176672;177;0;0;0;0;.00nan;0;0
11460;187355;179;0;0;0;0;.00nan;0;0
11173;189885;225;0;0;0;0;.00nan;0;0
11173;184610;222;0;0;0;0;.00nan;0;0
11173;184785;225;88;33;2;31;.939;3600000;0
11173;185851;222;46;33;5;28;.848;3600000;0
11339;184069;208;0;0;0;0;.00nan;0;0
11339;175370;199;0;0;0;0;.00nan;0;0
11339;179702;208;30;22;5;17;.773;3594000;0
11339;161006;199;65;37;4;33;.892;3600000;0
11328;-1;211;51;29;4;25;.862;3600000;0
11328;195164;218;77;26;1;25;.962;3600000;0
11328;179646;211;0;0;0;0;.00nan;0;0
11328;192457;218;0;0;0;0;.00nan;0;0
11287;171662;176;40;32;6;26;.813;3600000;0
11287;179169;209;95;38;2;36;.947;3600000;0
11287;176932;176;0;0;0;0;.00nan;0;0
11287;186205;209;0;0;0;0;.00nan;0;0
11178;166762;213;68;35;4;31;.886;3600000;0
11178;179400;183;0;0;0;0;.00nan;0;0
11178;180575;213;0;0;0;0;.00nan;0;0
11178;182089;183;37;25;5;20;.800;3600000;0
11190;167404;215;55;5;0;5;1.000;1302000;0
11190;165731;215;41;35;6;29;.829;2273000;0
11190;176938;180;45;27;4;23;.852;3600000;0
11190;-1;180;0;0;0;0;.00nan;0;0
11611;182454;4864;0;0;0;0;.00nan;0;0
11611;183737;4864;85;28;1;27;.964;3600000;0
11611;171405;2620;68;23;2;21;.913;3600000;0
11611;-1;2620;0;0;0;0;.00nan;0;0
11207;-1;210;0;0;0;0;.00nan;0;0
11207;187240;216;69;44;5;39;.886;3600000;0
11207;191557;216;0;0;0;0;.00nan;0;0
11207;192461;210;83;29;2;27;.931;3600000;0
11240;189885;225;63;35;4;31;.886;3600000;0
11240;175423;223;0;0;0;0;.00nan;0;0
11240;184785;225;0;0;0;0;.00nan;0;0
11240;187118;223;99;22;0;22;1.000;3600000;0
11115;166545;193;62;25;2;23;.920;3600000;0
11115;173770;193;0;0;0;0;.00nan;0;0
11115;-1;196;0;0;0;0;.00nan;0;0
11115;184648;196;94;33;1;32;.970;3600000;0
11129;190034;217;51;39;5;34;.872;3600000;0
11129;190041;217;0;0;0;0;.00nan;0;0
11129;181065;219;0;0;0;0;.00nan;0;0
11129;181102;219;74;17;1;16;.941;3600000;0
11286;170114;4959;62;21;2;19;.905;3600000;0
11286;195363;4959;0;0;0;0;.00nan;0;0
11286;171662;176;58;7;0;7;1.000;857000;0
11286;176932;176;32;42;7;35;.833;2743000;0
11231;171730;220;86;19;0;19;1.000;3600000;0
11231;190125;184;78;24;1;23;.958;3550000;0
11231;179668;184;0;0;0;0;.00nan;0;0
11231;187443;220;0;0;0;0;.00nan;0;0
11236;189902;204;51;2;0;2;1.000;254000;0
11236;175370;199;62;23;2;21;.913;3600000;0
11236;182049;204;36;31;6;25;.806;3346000;0
11236;161006;199;0;0;0;0;.00nan;0;0
11387;179400;183;0;0;0;0;.00nan;0;0
11387;179602;177;59;22;2;20;.909;3600000;0
11387;176672;177;0;0;0;0;.00nan;0;0
11387;182089;183;74;41;4;37;.902;3514000;0
11153;195164;218;0;0;0;0;.00nan;0;0
11153;190034;217;0;0;0;0;.00nan;0;0
11153;190041;217;100;42;0;42;1.000;3600000;0
11153;192457;218;57;20;2;18;.900;3534000;0
11454;178394;188;49;18;3;15;.833;3600000;0
11454;169096;190;44;26;4;22;.846;3560000;0
11454;174153;188;0;0;0;0;.00nan;0;0
11454;197704;190;0;0;0;0;.00nan;0;0
11191;167404;215;0;0;0;0;.00nan;0;0
11191;165731;215;69;23;2;21;.913;3600000;0
11191;168907;186;0;0;0;0;.00nan;0;0
11191;169226;186;38;29;5;24;.828;3600000;0
11232;171835;4960;0;0;0;0;.00nan;0;0
11232;194219;4960;77;30;2;28;.933;3600000;0
11232;184610;222;41;42;7;35;.833;3600000;0
11232;185851;222;0;0;0;0;.00nan;0;0
11261;175423;223;65;38;4;34;.895;3600000;0
11261;179430;229;0;0;0;0;.00nan;0;0
11261;185800;229;70;31;3;28;.903;3600000;0
11261;187118;223;0;0;0;0;.00nan;0;0
11310;-1;211;0;0;0;0;.00nan;0;0
11310;179646;211;61;39;4;35;.897;3564000;0
11310;176938;180;50;20;3;17;.850;3600000;0
11310;-1;180;0;0;0;0;.00nan;0;0
11325;174209;178;77;44;4;40;.909;3600000;0
11325;187240;216;21;24;6;18;.750;3578000;0
11325;191557;216;0;0;0;0;.00nan;0;0
11325;-1;178;0;0;0;0;.00nan;0;0
11316;177248;201;0;0;0;0;.00nan;0;0
11316;-1;203;90;27;1;26;.963;3600000;0
11316;-1;203;0;0;0;0;.00nan;0;0
11316;185743;201;64;33;3;30;.909;3570000;0
11251;-1;1371;0;0;0;0;.00nan;0;0
11251;179388;182;0;0;0;0;.00nan;0;0
11251;182116;182;84;37;3;34;.919;3600000;0
11251;192688;1371;72;27;2;25;.926;3600000;0
11526;195238;200;0;0;0;0;.00nan;0;0
11526;180623;202;43;14;3;11;.786;3600000;0
11526;187295;200;69;48;5;43;.896;3600000;0
11526;192498;202;0;0;0;0;.00nan;0;0
11252;192862;187;0;0;0;0;.00nan;0;0
11252;189081;187;72;53;5;48;.906;3600000;0
11252;194416;191;0;0;0;0;.00nan;0;0
11252;194893;191;52;10;1;9;.900;3600000;0
11360;-1;4949;30;29;6;23;.793;3270000;0
11360;195251;4949;57;2;0;2;1.000;330000;0
11360;-1;210;0;0;0;0;.00nan;0;0
11360;192461;210;75;41;3;38;.927;3600000;0
11355;184069;208;81;30;2;28;.933;3600000;0
11355;179702;208;0;0;0;0;.00nan;0;0
11355;-1;205;0;0;0;0;.00nan;0;0
11355;187092;205;88;39;3;36;.923;3545000;0
11136;-1;196;63;34;3;31;.912;3596000;0
11136;184648;196;0;0;0;0;.00nan;0;0
11136;176200;195;60;16;2;14;.875;3600000;0
11136;179647;195;0;0;0;0;.00nan;0;0
11257;180574;181;0;0;0;0;.00nan;0;0
11257;-1;181;57;25;3;22;.880;3572000;0
11257;-1;214;69;30;2;28;.933;3600000;0
11257;191518;214;0;0;0;0;.00nan;0;0
11271;166762;213;74;30;2;28;.933;3587000;0
11271;180575;213;0;0;0;0;.00nan;0;0
11271;180762;1505;0;0;0;0;.00nan;0;0
11271;186549;1505;67;22;1;21;.955;3600000;0
11521;171839;189;0;0;0;0;.00nan;0;0
11521;168117;192;0;0;0;0;.00nan;0;0
11521;-1;189;79;36;2;34;.944;3553000;0
11521;-1;192;75;23;1;22;.957;3600000;0
11250;182454;4864;0;0;0;0;.00nan;0;0
11250;183737;4864;54;24;3;21;.875;3600000;0
11250;179169;209;0;0;0;0;.00nan;0;0
11250;186205;209;50;35;5;30;.857;3571000;0
11402;166762;213;0;0;0;0;.00nan;0;0
11402;174209;178;0;0;0;0;.00nan;0;0
11402;180575;213;48;26;4;22;.846;3530000;0
11402;-1;178;73;33;2;31;.939;3600000;0
11326;169166;226;88;19;0;19;1.000;3600000;0
11326;-1;203;0;0;0;0;.00nan;0;0
11326;-1;203;98;35;1;34;.971;3599000;0
11326;192629;226;0;0;0;0;.00nan;0;0
11201;167404;215;64;36;4;32;.889;3574000;0
11201;165731;215;0;0;0;0;.00nan;0;0
11201;179679;212;0;0;0;0;.00nan;0;0
11201;186641;212;77;20;1;19;.950;3600000;0
11269;189885;225;0;0;0;0;.00nan;0;0
11269;179430;229;62;30;3;27;.900;3541000;0
11269;184785;225;88;34;2;32;.941;3600000;0
11269;185800;229;0;0;0;0;.00nan;0;0
11512;182467;185;90;34;2;32;.941;3600000;0
11512;179388;182;0;0;0;0;.00nan;0;0
11512;180110;185;0;0;0;0;.00nan;0;0
11512;182116;182;88;46;3;43;.935;3568000;0
11255;195238;200;74;41;3;38;.927;3600000;0
11255;189902;204;65;21;2;19;.905;3600000;0
11255;182049;204;0;0;0;0;.00nan;0;0
11255;187295;200;0;0;0;0;.00nan;0;0
11233;171730;220;89;34;1;33;.971;3600000;0
11233;180574;181;76;35;3;32;.914;3600000;0
11233;-1;181;0;0;0;0;.00nan;0;0
11233;187443;220;0;0;0;0;.00nan;0;0
11288;169096;190;81;23;1;22;.957;1632000;0
11288;176200;195;58;26;3;23;.885;3600000;0
11288;179647;195;0;0;0;0;.00nan;0;0
11288;197704;190;19;25;6;19;.760;1968000;0
11215;166545;193;56;17;2;15;.882;3600000;0
11215;173770;193;0;0;0;0;.00nan;0;0
11215;174325;197;70;44;5;39;.886;3600000;0
11215;175436;197;0;0;0;0;.00nan;0;0
11399;174147;179;48;30;5;25;.833;3900000;0
11399;179400;183;67;46;5;41;.891;3900000;0
11399;182089;183;0;0;0;0;.00nan;0;0
11399;187355;179;0;0;0;0;.00nan;0;0
11289;-1;221;0;0;0;0;.00nan;0;0
11289;-1;227;0;0;0;0;.00nan;0;0
11289;187217;227;89;35;1;34;.971;3600000;0
11289;187362;221;64;19;2;17;.895;3600000;0
11473;173340;231;0;0;0;0;.00nan;0;0
11473;184610;222;0;0;0;0;.00nan;0;0
11473;185034;231;67;20;2;18;.900;3600000;0
11473;185851;222;52;36;5;31;.861;3600000;0
11346;168907;186;63;30;3;27;.900;3530000;0
11346;169226;186;0;0;0;0;.00nan;0;0
11346;181065;219;0;0;0;0;.00nan;0;0
11346;181102;219;71;19;1;18;.947;3600000;0
11476;184175;224;68;24;2;22;.917;3600000;0
11476;179406;232;53;40;5;35;.875;3600000;0
11476;179434;232;0;0;0;0;.00nan;0;0
11476;185840;224;0;0;0;0;.00nan;0;0
11472;171405;2620;70;28;2;26;.929;3600000;0
11472;171662;176;54;35;4;31;.886;3571000;0
11472;176932;176;0;0;0;0;.00nan;0;0
11472;-1;2620;0;0;0;0;.00nan;0;0
11238;168954;228;64;42;5;37;.881;3600000;0
11238;175354;228;0;0;0;0;.00nan;0;0
11238;181338;230;0;0;0;0;.00nan;0;0
11238;186495;230;76;24;1;23;.958;3600000;0
11341;175364;206;49;38;5;33;.868;3578000;0
11341;-1;207;55;28;4;24;.857;3600000;0
11341;196283;206;0;0;0;0;.00nan;0;0
11341;-1;207;0;0;0;0;.00nan;0;0
11237;-1;1371;0;0;0;0;.00nan;0;0
11237;190125;184;0;0;0;0;.00nan;0;0
11237;179668;184;83;45;3;42;.933;3600000;0
11237;192688;1371;52;27;4;23;.852;3561000;0
11344;175370;199;0;0;0;0;.00nan;0;0
11344;180623;202;0;0;0;0;.00nan;0;0
11344;192498;202;61;28;3;25;.893;3600000;0
11344;161006;199;57;31;4;27;.871;3544000;0
11362;-1;4949;22;12;4;8;.667;1023000;0
11362;195251;4949;83;24;0;24;1.000;2529000;0
11362;187240;216;0;0;0;0;.00nan;0;0
11362;191557;216;69;33;3;30;.909;3600000;0
11086;170351;194;80;30;2;28;.933;3600000;0
11086;179197;198;62;43;5;38;.884;3600000;0
11086;196352;194;0;0;0;0;.00nan;0;0
11086;181431;198;0;0;0;0;.00nan;0;0
11313;170114;4959;70;34;3;31;.912;3600000;0
11313;195363;4959;0;0;0;0;.00nan;0;0
11313;179169;209;77;42;4;38;.905;3557000;0
11313;186205;209;0;0;0;0;.00nan;0;0
11170;178394;188;0;0;0;0;.00nan;0;0
11170;174153;188;100;32;0;32;1.000;3600000;0
11170;-1;196;0;0;0;0;.00nan;0;0
11170;184648;196;75;36;4;32;.889;3600000;0
11253;171835;4960;31;35;6;29;.829;3338000;0
11253;194219;4960;51;3;0;3;1.000;262000;0
11253;181338;230;0;0;0;0;.00nan;0;0
11253;186495;230;79;31;3;28;.903;3600000;0
11333;-1;211;95;47;2;45;.957;3600000;0
11333;179646;211;0;0;0;0;.00nan;0;0
11333;176938;180;38;14;3;11;.786;3600000;0
11333;-1;180;0;0;0;0;.00nan;0;0
11270;-1;210;36;30;6;24;.800;3600000;0
11270;180762;1505;0;0;0;0;.00nan;0;0
11270;186549;1505;97;42;2;40;.952;3600000;0
11270;192461;210;0;0;0;0;.00nan;0;0
11441;195164;218;0;0;0;0;.00nan;0;0
11441;181065;219;76;26;1;25;.962;3600000;0
11441;181102;219;0;0;0;0;.00nan;0;0
11441;192457;218;92;49;4;45;.918;3600000;0
11266;168117;192;53;2;0;2;1.000;332000;0
11266;178394;188;84;36;2;34;.944;3600000;0
11266;174153;188;0;0;0;0;.00nan;0;0
11266;-1;192;15;19;6;13;.684;3268000;0
11555;171405;2620;95;32;1;31;.969;3600000;0
11555;171662;176;0;0;0;0;.00nan;0;0
11555;176932;176;43;26;4;22;.846;3600000;0
11555;-1;2620;0;0;0;0;.00nan;0;0
11259;171839;189;0;0;0;0;.00nan;0;0
11259;174325;197;75;36;3;33;.917;3534000;0
11259;-1;189;80;23;1;22;.957;3600000;0
11259;175436;197;0;0;0;0;.00nan;0;0
11254;171835;4960;0;0;0;0;.00nan;0;0
11254;194219;4960;41;24;4;20;.833;3528000;0
11254;173340;231;0;0;0;0;.00nan;0;0
11254;185034;231;72;36;3;33;.917;3600000;0
11452;192862;187;88;37;2;35;.946;3839000;0
11452;189081;187;0;0;0;0;.00nan;0;0
11452;170351;194;0;0;0;0;.00nan;0;0
11452;196352;194;74;31;3;28;.903;3839000;0
11363;-1;4949;98;22;0;22;1.000;3600000;0
11363;195251;4949;0;0;0;0;.00nan;0;0
11363;179602;177;67;37;5;32;.865;3600000;0
11363;176672;177;0;0;0;0;.00nan;0;0
11262;171730;220;71;26;2;24;.923;3579000;0
11262;-1;1371;0;0;0;0;.00nan;0;0
11262;187443;220;0;0;0;0;.00nan;0;0
11262;192688;1371;76;24;1;23;.958;3600000;0
11588;182467;185;60;32;3;29;.906;3900000;0
11588;179388;182;0;0;0;0;.00nan;0;0
11588;180110;185;0;0;0;0;.00nan;0;0
11588;182116;182;99;60;3;57;.950;3900000;0
11134;166545;193;74;26;2;24;.923;3900000;0
11134;169096;190;97;48;2;46;.958;3900000;0
11134;173770;193;0;0;0;0;.00nan;0;0
11134;197704;190;0;0;0;0;.00nan;0;0
11678;189885;225;59;27;3;24;.889;3540000;0
11678;184610;222;72;24;1;23;.958;3600000;0
11678;184785;225;0;0;0;0;.00nan;0;0
11678;185851;222;0;0;0;0;.00nan;0;0
11274;184175;224;78;42;3;39;.929;3900000;0
11274;179430;229;0;0;0;0;.00nan;0;0
11274;185800;229;57;29;3;26;.897;3900000;0
11274;185840;224;0;0;0;0;.00nan;0;0
11364;175364;206;0;0;0;0;.00nan;0;0
11364;-1;207;78;20;1;19;.950;3545000;0
11364;196283;206;100;31;0;31;1.000;3600000;0
11364;-1;207;0;0;0;0;.00nan;0;0
11300;182454;4864;0;0;0;0;.00nan;0;0
11300;183737;4864;74;30;2;28;.933;3900000;0
11300;170114;4959;95;32;2;30;.938;3900000;0
11300;195363;4959;0;0;0;0;.00nan;0;0
11096;194416;191;66;29;3;26;.897;3600000;0
11096;194893;191;0;0;0;0;.00nan;0;0
11096;179197;198;0;0;0;0;.00nan;0;0
11096;181431;198;40;31;5;26;.839;3515000;0
11214;195164;218;52;37;6;31;.838;3794000;0
11214;176938;180;0;0;0;0;.00nan;0;0
11214;-1;180;31;38;7;31;.816;3794000;0
11214;192457;218;0;0;0;0;.00nan;0;0
11613;-1;210;0;0;0;0;.00nan;0;0
11613;179400;183;0;0;0;0;.00nan;0;0
11613;182089;183;92;46;3;43;.935;3600000;0
11613;192461;210;100;25;0;25;1.000;3600000;0
11315;174147;179;0;0;0;0;.00nan;0;0
11315;174209;178;97;63;5;58;.921;3600000;0
11315;187355;179;51;14;2;12;.857;3600000;0
11315;-1;178;0;0;0;0;.00nan;0;0
11151;190034;217;0;0;0;0;.00nan;0;0
11151;190041;217;93;28;1;27;.964;3600000;0
11151;179679;212;0;0;0;0;.00nan;0;0
11151;186641;212;69;34;3;31;.912;3518000;0
11248;180574;181;0;0;0;0;.00nan;0;0
11248;-1;181;63;26;2;24;.923;3600000;0
11248;-1;214;55;40;5;35;.875;3600000;0
11248;191518;214;0;0;0;0;.00nan;0;0
11336;-1;227;0;0;0;0;.00nan;0;0
11336;179406;232;74;12;0;12;1.000;1271000;0
11336;179434;232;44;31;6;25;.806;2329000;0
11336;187217;227;61;27;3;24;.889;3600000;0
11247;168954;228;0;0;0;0;.00nan;0;0
11247;-1;221;55;18;2;16;.889;3900000;0
11247;175354;228;87;38;2;36;.947;3889000;0
11247;187362;221;0;0;0;0;.00nan;0;0
11158;189902;204;55;5;0;5;1.000;361000;0
11158;182049;204;40;42;7;35;.833;3239000;0
11158;-1;205;78;22;1;21;.955;3600000;0
11158;187092;205;0;0;0;0;.00nan;0;0
11200;180762;1505;47;16;3;13;.813;3600000;0
11200;186549;1505;0;0;0;0;.00nan;0;0
11200;187240;216;73;42;4;38;.905;3591000;0
11200;191557;216;0;0;0;0;.00nan;0;0
11298;184069;208;73;24;2;22;.917;3600000;0
11298;195238;200;0;0;0;0;.00nan;0;0
11298;179702;208;0;0;0;0;.00nan;0;0
11298;187295;200;60;56;7;49;.875;3600000;0
11283;168954;228;89;29;1;28;.966;3600000;0
11283;-1;227;74;30;2;28;.933;3560000;0
11283;175354;228;0;0;0;0;.00nan;0;0
11283;187217;227;0;0;0;0;.00nan;0;0
11293;166545;193;0;0;0;0;.00nan;0;0
11293;194416;191;0;0;0;0;.00nan;0;0
11293;194893;191;79;24;1;23;.958;3900000;0
11293;173770;193;96;29;1;28;.966;3876000;0
11447;-1;4949;36;29;6;23;.793;3694000;0
11447;195251;4949;0;0;0;0;.00nan;0;0
11447;179602;177;0;0;0;0;.00nan;0;0
11447;176672;177;46;34;5;29;.853;3694000;0
11327;-1;203;55;29;3;26;.897;3587000;0
11327;-1;203;0;0;0;0;.00nan;0;0
11327;180623;202;82;23;1;22;.957;3600000;0
11327;192498;202;0;0;0;0;.00nan;0;0
11397;179406;232;84;25;1;24;.960;3600000;0
11397;175423;223;0;0;0;0;.00nan;0;0
11397;179434;232;0;0;0;0;.00nan;0;0
11397;187118;223;85;28;2;26;.929;3549000;0
11331;169166;226;54;32;4;28;.875;3600000;0
11331;175370;199;0;0;0;0;.00nan;0;0
11331;192629;226;0;0;0;0;.00nan;0;0
11331;161006;199;86;34;1;33;.971;3600000;0
11292;195238;200;51;38;5;33;.868;3600000;0
11292;-1;205;0;0;0;0;.00nan;0;0
11292;187092;205;75;19;1;18;.947;3600000;0
11292;187295;200;0;0;0;0;.00nan;0;0
11243;179679;212;88;38;2;36;.947;3900000;0
11243;181065;219;0;0;0;0;.00nan;0;0
11243;181102;219;80;31;2;29;.935;3900000;0
11243;186641;212;0;0;0;0;.00nan;0;0
11230;167404;215;99;39;1;38;.974;3600000;0
11230;165731;215;0;0;0;0;.00nan;0;0
11230;168907;186;0;0;0;0;.00nan;0;0
11230;169226;186;74;26;2;24;.923;3566000;0
11420;166762;213;70;36;4;32;.889;3600000;0
11420;174147;179;43;33;5;28;.848;3571000;0
11420;180575;213;0;0;0;0;.00nan;0;0
11420;187355;179;0;0;0;0;.00nan;0;0
11400;168117;192;0;0;0;0;.00nan;0;0
11400;174325;197;0;0;0;0;.00nan;0;0
11400;175436;197;83;50;4;46;.920;3600000;0
11400;-1;192;52;16;3;13;.813;3600000;0
11272;192862;187;0;0;0;0;.00nan;0;0
11272;189081;187;65;20;2;18;.900;3600000;0
11272;-1;196;0;0;0;0;.00nan;0;0
11272;184648;196;88;42;3;39;.929;3570000;0
11307;173340;231;71;29;2;27;.931;3900000;0
11307;-1;221;0;0;0;0;.00nan;0;0
11307;185034;231;0;0;0;0;.00nan;0;0
11307;187362;221;86;37;2;35;.946;3900000;0
11533;169166;226;0;0;0;0;.00nan;0;0
11533;175364;206;0;0;0;0;.00nan;0;0
11533;196283;206;53;40;6;34;.850;3600000;0
11533;192629;226;100;25;0;25;1.000;3600000;0
11381;190125;184;71;25;2;23;.920;3600000;0
11381;179668;184;0;0;0;0;.00nan;0;0
11381;-1;214;63;39;4;35;.897;3600000;0
11381;191518;214;0;0;0;0;.00nan;0;0
11171;-1;211;74;26;1;25;.962;3600000;0
11171;190034;217;63;36;4;32;.889;3600000;0
11171;190041;217;0;0;0;0;.00nan;0;0
11171;179646;211;0;0;0;0;.00nan;0;0
11396;182454;4864;0;0;0;0;.00nan;0;0
11396;183737;4864;90;33;1;32;.970;3600000;0
11396;171662;176;64;33;4;29;.879;3600000;0
11396;176932;176;0;0;0;0;.00nan;0;0
11148;170351;194;53;33;4;29;.879;3577000;0
11148;179197;198;57;19;2;17;.895;3600000;0
11148;196352;194;0;0;0;0;.00nan;0;0
11148;181431;198;0;0;0;0;.00nan;0;0
11392;175423;223;70;44;5;39;.886;3600000;0
11392;181338;230;0;0;0;0;.00nan;0;0
11392;186495;230;90;14;0;14;1.000;3600000;0
11392;187118;223;0;0;0;0;.00nan;0;0
11405;184069;208;0;0;0;0;.00nan;0;0
11405;179702;208;46;33;5;28;.848;3600000;0
11405;180623;202;0;0;0;0;.00nan;0;0
11405;192498;202;100;36;0;36;1.000;3600000;0
11318;170114;4959;72;37;4;33;.892;3563000;0
11318;195363;4959;0;0;0;0;.00nan;0;0
11318;179169;209;0;0;0;0;.00nan;0;0
11318;186205;209;68;30;2;28;.933;3600000;0
11489;-1;4949;82;21;1;20;.952;3600000;0
11489;195251;4949;0;0;0;0;.00nan;0;0
11489;179400;183;0;0;0;0;.00nan;0;0
11489;182089;183;77;42;3;39;.929;3600000;0
11373;182454;4864;0;0;0;0;.00nan;0;0
11373;183737;4864;61;42;5;37;.881;3600000;0
11373;170114;4959;81;32;2;30;.938;3600000;0
11373;195363;4959;0;0;0;0;.00nan;0;0
11377;184175;224;0;0;0;0;.00nan;0;0
11377;179430;229;50;1;0;1;1.000;377000;0
11377;185800;229;25;19;5;14;.737;3223000;0
11377;185840;224;74;32;3;29;.906;3600000;0
11374;177248;201;0;0;0;0;.00nan;0;0
11374;189902;204;91;36;1;35;.972;3600000;0
11374;182049;204;0;0;0;0;.00nan;0;0
11374;185743;201;46;20;3;17;.850;3600000;0
11320;195238;200;0;0;0;0;.00nan;0;0
11320;-1;203;61;24;2;22;.917;3600000;0
11320;-1;203;0;0;0;0;.00nan;0;0
11320;187295;200;66;32;3;29;.906;3574000;0
11487;168907;186;0;0;0;0;.00nan;0;0
11487;169226;186;74;25;2;23;.920;3600000;0
11487;190034;217;98;59;3;56;.949;3595000;0
11487;190041;217;0;0;0;0;.00nan;0;0
11494;166762;213;86;44;3;41;.932;3600000;0
11494;174147;179;0;0;0;0;.00nan;0;0
11494;180575;213;0;0;0;0;.00nan;0;0
11494;187355;179;100;30;0;30;1.000;3600000;0
11348;175364;206;99;49;2;47;.959;3600000;0
11348;175370;199;0;0;0;0;.00nan;0;0
11348;196283;206;0;0;0;0;.00nan;0;0
11348;161006;199;27;19;5;14;.737;3600000;0
11503;-1;207;79;25;2;23;.920;3582000;0
11503;180623;202;0;0;0;0;.00nan;0;0
11503;-1;207;0;0;0;0;.00nan;0;0
11503;192498;202;80;22;1;21;.955;3600000;0
11249;166545;193;55;18;3;15;.833;3600000;0
11249;173770;193;0;0;0;0;.00nan;0;0
11249;170351;194;77;39;4;35;.897;3579000;0
11249;196352;194;0;0;0;0;.00nan;0;0
11674;167404;215;0;0;0;0;.00nan;0;0
11674;165731;215;66;25;3;22;.880;3615000;0
11674;-1;211;69;29;2;27;.931;3615000;0
11674;179646;211;0;0;0;0;.00nan;0;0
11543;171835;4960;48;14;2;12;.857;3600000;0
11543;194219;4960;0;0;0;0;.00nan;0;0
11543;179406;232;82;51;4;47;.922;3600000;0
11543;179434;232;0;0;0;0;.00nan;0;0
11432;-1;227;0;0;0;0;.00nan;0;0
11432;184610;222;0;0;0;0;.00nan;0;0
11432;185851;222;68;28;2;26;.929;3600000;0
11432;187217;227;55;35;4;31;.886;3514000;0
11606;190125;184;92;37;1;36;.973;3600000;0
11606;179668;184;0;0;0;0;.00nan;0;0
11606;-1;214;45;32;5;27;.844;3600000;0
11606;191518;214;0;0;0;0;.00nan;0;0
11464;171405;2620;100;29;1;28;.966;3600000;0
11464;171662;176;44;31;5;26;.839;3600000;0
11464;176932;176;0;0;0;0;.00nan;0;0
11464;-1;2620;0;0;0;0;.00nan;0;0
11435;-1;210;0;0;0;0;.00nan;0;0
11435;187240;216;61;41;5;36;.878;3600000;0
11435;191557;216;0;0;0;0;.00nan;0;0
11435;192461;210;100;23;0;23;1.000;3600000;0
11204;168117;192;0;0;0;0;.00nan;0;0
11204;179197;198;0;0;0;0;.00nan;0;0
11204;-1;192;67;27;3;24;.889;3900000;0
11204;181431;198;52;31;3;28;.903;3900000;0
11389;178394;188;0;0;0;0;.00nan;0;0
11389;174153;188;48;31;5;26;.839;3566000;0
11389;176200;195;72;31;3;28;.903;3600000;0
11389;179647;195;0;0;0;0;.00nan;0;0
11314;170114;4959;0;0;0;0;.00nan;0;0
11314;195363;4959;64;34;3;31;.912;3597000;0
11314;179169;209;65;19;2;17;.895;3600000;0
11314;186205;209;0;0;0;0;.00nan;0;0
11263;171730;220;90;44;2;42;.955;3600000;0
11263;-1;1371;87;35;3;32;.914;3560000;0
11263;187443;220;0;0;0;0;.00nan;0;0
11263;192688;1371;0;0;0;0;.00nan;0;0
11276;189902;204;0;0;0;0;.00nan;0;0
11276;182049;204;100;39;1;38;.974;3900000;0
11276;-1;205;75;25;1;24;.960;3900000;0
11276;187092;205;0;0;0;0;.00nan;0;0
11515;182454;4864;48;30;5;25;.833;3234000;0
11515;183737;4864;57;11;0;11;1.000;666000;0
11515;171405;2620;0;0;0;0;.00nan;0;0
11515;-1;2620;55;28;5;23;.821;3900000;0
11312;-1;196;0;0;0;0;.00nan;0;0
11312;184648;196;73;43;4;39;.907;3600000;0
11312;176200;195;0;0;0;0;.00nan;0;0
11312;179647;195;98;32;1;31;.969;3600000;0
11290;166762;213;0;0;0;0;.00nan;0;0
11290;180575;213;80;50;4;46;.920;3600000;0
11290;180762;1505;0;0;0;0;.00nan;0;0
11290;186549;1505;64;12;1;11;.917;3600000;0
11306;184175;224;92;39;2;37;.949;3600000;0
11306;189885;225;74;40;4;36;.900;3577000;0
11306;184785;225;0;0;0;0;.00nan;0;0
11306;185840;224;0;0;0;0;.00nan;0;0
11285;167404;215;74;37;4;33;.892;3900000;0
11285;165731;215;0;0;0;0;.00nan;0;0
11285;179679;212;57;9;0;9;1.000;1702000;0
11285;186641;212;61;31;4;27;.871;2198000;0
11284;-1;227;59;33;4;29;.879;3600000;0
11284;181338;230;0;0;0;0;.00nan;0;0
11284;186495;230;100;23;0;23;1.000;3600000;0
11284;187217;227;0;0;0;0;.00nan;0;0
11445;-1;4949;0;0;0;0;.00nan;0;0
11445;195251;4949;91;30;1;29;.967;3600000;0
11445;179400;183;0;0;0;0;.00nan;0;0
11445;182089;183;49;36;4;32;.889;3600000;0
11467;194416;191;0;0;0;0;.00nan;0;0
11467;194893;191;100;25;0;25;1.000;3600000;0
11467;174325;197;89;49;4;45;.918;3600000;0
11467;175436;197;0;0;0;0;.00nan;0;0
11544;192862;187;0;0;0;0;.00nan;0;0
11544;189081;187;88;31;2;29;.935;3900000;0
11544;170351;194;0;0;0;0;.00nan;0;0
11544;196352;194;65;32;2;30;.938;3900000;0
11410;182467;185;79;39;3;36;.923;3571000;0
11410;180110;185;0;0;0;0;.00nan;0;0
11410;180574;181;0;0;0;0;.00nan;0;0
11410;-1;181;50;16;2;14;.875;3600000;0
11438;184069;208;55;28;3;25;.893;3600000;0
11438;179702;208;0;0;0;0;.00nan;0;0
11438;-1;207;100;31;0;31;1.000;3600000;0
11438;-1;207;0;0;0;0;.00nan;0;0
11419;173340;231;0;0;0;0;.00nan;0;0
11419;175423;223;0;0;0;0;.00nan;0;0
11419;185034;231;70;26;2;24;.923;3600000;0
11419;187118;223;73;40;4;36;.900;3561000;0
11385;179602;177;89;43;3;40;.930;3600000;0
11385;176672;177;0;0;0;0;.00nan;0;0
11385;187240;216;0;0;0;0;.00nan;0;0
11385;191557;216;100;26;0;26;1.000;3600000;0
11655;175364;206;0;0;0;0;.00nan;0;0
11655;196283;206;62;28;3;25;.893;3600000;0
11655;180623;202;36;22;4;18;.818;3571000;0
11655;192498;202;0;0;0;0;.00nan;0;0
11372;177248;201;0;0;0;0;.00nan;0;0
11372;169166;226;0;0;0;0;.00nan;0;0
11372;185743;201;86;41;3;38;.927;3900000;0
11372;192629;226;76;36;3;33;.917;3900000;0
11209;179388;182;0;0;0;0;.00nan;0;0
11209;182116;182;81;35;2;33;.943;3600000;0
11209;-1;214;0;0;0;0;.00nan;0;0
11209;191518;214;61;26;3;23;.885;3576000;0
11352;195164;218;53;34;5;29;.853;3600000;0
11352;176938;180;84;31;1;30;.968;3600000;0
11352;-1;180;0;0;0;0;.00nan;0;0
11352;192457;218;0;0;0;0;.00nan;0;0
11520;189885;225;0;0;0;0;.00nan;0;0
11520;184785;225;69;41;4;37;.902;3600000;0
11520;181338;230;0;0;0;0;.00nan;0;0
11520;186495;230;91;19;0;19;1.000;3600000;0
11536;179197;198;0;0;0;0;.00nan;0;0
11536;174325;197;0;0;0;0;.00nan;0;0
11536;175436;197;95;55;3;52;.945;3550000;0
11536;181431;198;64;16;1;15;.938;3600000;0
11590;179388;182;0;0;0;0;.00nan;0;0
11590;190125;184;42;28;5;23;.821;3574000;0
11590;179668;184;0;0;0;0;.00nan;0;0
11590;182116;182;81;35;3;32;.914;3600000;0
11535;173340;231;84;29;1;28;.966;3600000;0
11535;184610;222;72;46;6;40;.870;3325000;0
11535;185034;231;0;0;0;0;.00nan;0;0
11535;185851;222;53;3;0;3;1.000;275000;0
11260;171730;220;38;26;5;21;.808;3600000;0
11260;180574;181;59;27;2;25;.926;3600000;0
11260;-1;181;0;0;0;0;.00nan;0;0
11260;187443;220;0;0;0;0;.00nan;0;0
11299;195238;200;89;53;4;49;.925;3546000;0
11299;-1;205;0;0;0;0;.00nan;0;0
11299;187092;205;76;31;2;29;.935;3600000;0
11299;187295;200;0;0;0;0;.00nan;0;0
11302;166545;193;69;20;1;19;.950;3600000;0
11302;169096;190;66;39;4;35;.897;3600000;0
11302;173770;193;0;0;0;0;.00nan;0;0
11302;197704;190;0;0;0;0;.00nan;0;0
11295;168907;186;0;0;0;0;.00nan;0;0
11295;169226;186;50;34;5;29;.853;3810000;0
11295;190034;217;48;25;4;21;.840;3810000;0
11295;190041;217;0;0;0;0;.00nan;0;0
11303;176938;180;38;35;6;29;.829;2855000;0
11303;179679;212;0;0;0;0;.00nan;0;0
11303;186641;212;64;27;3;24;.889;3600000;0
11303;-1;180;51;7;1;6;.857;745000;0
11403;-1;211;74;27;2;25;.926;3600000;0
11403;195164;218;57;4;0;4;1.000;1005000;0
11403;179646;211;0;0;0;0;.00nan;0;0
11403;192457;218;30;29;6;23;.793;2595000;0
11311;182467;185;58;12;1;11;.917;1163000;0
11311;-1;1371;0;0;0;0;.00nan;0;0
11311;180110;185;30;25;6;19;.760;2437000;0
11311;192688;1371;68;39;4;35;.897;3600000;0
11459;192862;187;79;51;5;46;.902;3600000;0
11459;189081;187;0;0;0;0;.00nan;0;0
11459;194416;191;0;0;0;0;.00nan;0;0
11459;194893;191;66;18;1;17;.944;3600000;0
11465;168954;228;73;50;5;45;.900;3600000;0
11465;-1;221;73;24;1;23;.958;3600000;0
11465;175354;228;0;0;0;0;.00nan;0;0
11465;187362;221;0;0;0;0;.00nan;0;0
11358;179406;232;6;24;8;16;.667;3600000;0
11358;179430;229;0;0;0;0;.00nan;0;0
11358;179434;232;0;0;0;0;.00nan;0;0
11358;185800;229;100;33;1;32;.970;3600000;0
11427;174147;179;0;0;0;0;.00nan;0;0
11427;174209;178;90;40;3;37;.925;3600000;0
11427;187355;179;92;21;0;21;1.000;3600000;0
11427;-1;178;0;0;0;0;.00nan;0;0
11361;171662;176;0;0;0;0;.00nan;0;0
11361;179169;209;0;0;0;0;.00nan;0;0
11361;176932;176;59;30;3;27;.900;3600000;0
11361;186205;209;50;24;4;20;.833;3600000;0
11324;-1;210;0;0;0;0;.00nan;0;0
11324;180762;1505;75;36;3;33;.917;3639000;0
11324;186549;1505;0;0;0;0;.00nan;0;0
11324;192461;210;79;24;2;22;.917;3639000;0
11359;168117;192;0;0;0;0;.00nan;0;0
11359;178394;188;55;22;3;19;.864;3845000;0
11359;174153;188;0;0;0;0;.00nan;0;0
11359;-1;192;79;28;2;26;.929;3845000;0
11404;170114;4959;70;24;3;21;.875;3600000;0
11404;195363;4959;0;0;0;0;.00nan;0;0
11404;171662;176;53;35;4;31;.886;3600000;0
11404;176932;176;0;0;0;0;.00nan;0;0
11356;171835;4960;0;0;0;0;.00nan;0;0
11356;194219;4960;20;21;6;15;.714;3600000;0
11356;184175;224;82;42;3;39;.929;3600000;0
11356;185840;224;0;0;0;0;.00nan;0;0
11559;177248;201;0;0;0;0;.00nan;0;0
11559;184069;208;0;0;0;0;.00nan;0;0
11559;179702;208;40;28;5;23;.821;3553000;0
11559;185743;201;63;33;4;29;.879;3600000;0
11357;169166;226;78;34;2;32;.941;3600000;0
11357;195238;200;0;0;0;0;.00nan;0;0
11357;187295;200;57;30;4;26;.867;3566000;0
11357;192629;226;0;0;0;0;.00nan;0;0
11322;171839;189;0;0;0;0;.00nan;0;0
11322;-1;196;0;0;0;0;.00nan;0;0
11322;-1;189;69;31;3;28;.903;3564000;0
11322;184648;196;77;26;1;25;.962;3600000;0
11469;174147;179;0;0;0;0;.00nan;0;0
11469;187240;216;0;0;0;0;.00nan;0;0
11469;187355;179;69;28;3;25;.893;3600000;0
11469;191557;216;62;42;4;38;.905;3567000;0
11483;174209;178;30;28;6;22;.786;2987000;0
11483;179602;177;80;25;1;24;.960;3600000;0
11483;176672;177;0;0;0;0;.00nan;0;0
11483;-1;178;33;4;2;2;.500;613000;0
11367;-1;203;73;22;1;21;.955;3600000;0
11367;175364;206;79;51;4;47;.922;3600000;0
11367;-1;203;0;0;0;0;.00nan;0;0
11367;196283;206;0;0;0;0;.00nan;0;0
11309;-1;211;70;28;2;26;.929;3600000;0
11309;190034;217;0;0;0;0;.00nan;0;0
11309;190041;217;37;24;4;20;.833;3585000;0
11309;179646;211;0;0;0;0;.00nan;0;0
11267;169096;190;82;25;0;25;1.000;1620000;0
11267;179197;198;81;13;0;13;1.000;3600000;0
11267;181431;198;0;0;0;0;.00nan;0;0
11267;197704;190;23;23;6;17;.739;1980000;0
11425;-1;221;0;0;0;0;.00nan;0;0
11425;179430;229;0;0;0;0;.00nan;0;0
11425;185800;229;98;40;1;39;.975;3560000;0
11425;187362;221;88;19;0;19;1.000;3600000;0
11412;168954;228;0;0;0;0;.00nan;0;0
11412;175354;228;77;33;3;30;.909;3561000;0
11412;175423;223;0;0;0;0;.00nan;0;0
11412;187118;223;84;28;1;27;.964;3600000;0
11541;171835;4960;79;25;1;24;.960;3600000;0
11541;194219;4960;0;0;0;0;.00nan;0;0
11541;173340;231;0;0;0;0;.00nan;0;0
11541;185034;231;82;31;2;29;.935;3543000;0
11297;182467;185;62;24;2;22;.917;3552000;0
11297;-1;1371;0;0;0;0;.00nan;0;0
11297;180110;185;0;0;0;0;.00nan;0;0
11297;192688;1371;100;45;1;44;.978;3600000;0
11599;171405;2620;86;32;1;31;.969;3600000;0
11599;179169;209;0;0;0;0;.00nan;0;0
11599;-1;2620;0;0;0;0;.00nan;0;0
11599;186205;209;82;35;3;32;.914;3531000;0
11433;-1;203;0;0;0;0;.00nan;0;0
11433;189902;204;0;0;0;0;.00nan;0;0
11433;-1;203;70;26;3;23;.885;3600000;0
11433;182049;204;78;49;4;45;.918;3594000;0
11370;166545;193;100;23;0;23;1.000;3600000;0
11370;173770;193;0;0;0;0;.00nan;0;0
11370;-1;196;29;37;7;30;.811;3318000;0
11370;184648;196;31;3;2;1;.333;282000;0
11470;179400;183;82;52;4;48;.923;3578000;0
11470;180762;1505;66;21;2;19;.905;3600000;0
11470;182089;183;0;0;0;0;.00nan;0;0
11470;186549;1505;0;0;0;0;.00nan;0;0
11479;171839;189;46;28;5;23;.821;2614000;0
11479;194416;191;92;15;0;15;1.000;3600000;0
11479;194893;191;0;0;0;0;.00nan;0;0
11479;-1;189;22;13;4;9;.692;986000;0
11428;174325;197;97;47;2;45;.957;3600000;0
11428;175436;197;0;0;0;0;.00nan;0;0
11428;176200;195;59;27;3;24;.889;3544000;0
11428;179647;195;0;0;0;0;.00nan;0;0
11468;166762;213;0;0;0;0;.00nan;0;0
11468;-1;210;0;0;0;0;.00nan;0;0
11468;180575;213;96;64;5;59;.922;3600000;0
11468;192461;210;69;23;2;21;.913;3600000;0
11531;169166;226;0;0;0;0;.00nan;0;0
11531;-1;207;78;31;1;30;.968;3600000;0
11531;-1;207;0;0;0;0;.00nan;0;0
11531;192629;226;77;29;2;27;.931;3578000;0
11451;175370;199;0;0;0;0;.00nan;0;0
11451;-1;205;100;32;0;32;1.000;3600000;0
11451;187092;205;0;0;0;0;.00nan;0;0
11451;161006;199;56;23;3;20;.870;3600000;0
11426;168117;192;75;20;1;19;.950;3600000;0
11426;178394;188;0;0;0;0;.00nan;0;0
11426;174153;188;73;54;5;49;.907;3600000;0
11426;-1;192;0;0;0;0;.00nan;0;0
11317;168907;186;0;0;0;0;.00nan;0;0
11317;169226;186;100;22;0;22;1.000;3600000;0
11317;179679;212;52;10;1;9;.900;959000;0
11317;186641;212;26;27;6;21;.778;2641000;0
11342;182454;4864;0;0;0;0;.00nan;0;0
11342;183737;4864;52;28;4;24;.857;3569000;0
11342;170114;4959;98;48;3;45;.938;3600000;0
11342;195363;4959;0;0;0;0;.00nan;0;0
11523;190125;184;69;33;3;30;.909;3562000;0
11523;179668;184;0;0;0;0;.00nan;0;0
11523;-1;214;84;31;1;30;.968;3600000;0
11523;191518;214;0;0;0;0;.00nan;0;0
11443;176938;180;90;30;1;29;.967;3600000;0
11443;181065;219;0;0;0;0;.00nan;0;0
11443;181102;219;69;28;2;26;.929;3585000;0
11443;-1;180;0;0;0;0;.00nan;0;0
11442;184610;222;62;27;2;25;.926;3600000;0
11442;175423;223;51;29;4;25;.862;3558000;0
11442;185851;222;0;0;0;0;.00nan;0;0
11442;187118;223;0;0;0;0;.00nan;0;0
11411;166545;193;85;24;1;23;.958;3600000;0
11411;168117;192;0;0;0;0;.00nan;0;0
11411;173770;193;0;0;0;0;.00nan;0;0
11411;-1;192;52;27;4;23;.852;3600000;0
11440;184175;224;98;59;2;57;.966;3600000;0
11440;181338;230;0;0;0;0;.00nan;0;0
11440;185840;224;0;0;0;0;.00nan;0;0
11440;186495;230;68;18;1;17;.944;3600000;0
11466;184069;208;97;20;0;20;1.000;3600000;0
11466;175364;206;68;36;4;32;.889;3600000;0
11466;179702;208;0;0;0;0;.00nan;0;0
11466;196283;206;0;0;0;0;.00nan;0;0
11437;168907;186;0;0;0;0;.00nan;0;0
11437;169226;186;57;33;4;29;.879;3566000;0
11437;190034;217;71;28;3;25;.893;3600000;0
11437;190041;217;0;0;0;0;.00nan;0;0
11382;180762;1505;0;0;0;0;.00nan;0;0
11382;186549;1505;49;16;3;13;.813;3595000;0
11382;187240;216;100;54;2;52;.963;3600000;0
11382;191557;216;0;0;0;0;.00nan;0;0
11343;166762;213;79;49;4;45;.918;3600000;0
11343;-1;4949;72;19;1;18;.947;3600000;0
11343;195251;4949;0;0;0;0;.00nan;0;0
11343;180575;213;0;0;0;0;.00nan;0;0
11498;-1;221;0;0;0;0;.00nan;0;0
11498;189885;225;72;27;2;25;.926;3600000;0
11498;184785;225;0;0;0;0;.00nan;0;0
11498;187362;221;66;28;3;25;.893;3544000;0
11280;171730;220;79;26;2;24;.923;3600000;0
11280;190125;184;0;0;0;0;.00nan;0;0
11280;179668;184;50;35;5;30;.857;3600000;0
11280;187443;220;0;0;0;0;.00nan;0;0
11665;177248;201;0;0;0;0;.00nan;0;0
11665;175370;199;70;26;2;24;.923;3600000;0
11665;185743;201;53;25;3;22;.880;3600000;0
11665;161006;199;0;0;0;0;.00nan;0;0
11548;168954;228;88;27;1;26;.963;3600000;0
11548;-1;227;0;0;0;0;.00nan;0;0
11548;175354;228;0;0;0;0;.00nan;0;0
11548;187217;227;53;17;2;15;.882;3572000;0
11528;171835;4960;45;20;3;17;.850;3579000;0
11528;194219;4960;0;0;0;0;.00nan;0;0
11528;189885;225;0;0;0;0;.00nan;0;0
11528;184785;225;100;43;1;42;.977;3600000;0
11507;174147;179;58;21;2;19;.905;3600000;0
11507;179602;177;81;40;3;37;.925;3600000;0
11507;176672;177;0;0;0;0;.00nan;0;0
11507;187355;179;0;0;0;0;.00nan;0;0
11471;-1;211;72;23;1;22;.957;3600000;0
11471;179646;211;0;0;0;0;.00nan;0;0
11471;181065;219;0;0;0;0;.00nan;0;0
11471;181102;219;64;23;2;21;.913;3582000;0
11401;176938;180;86;45;3;42;.933;3900000;0
11401;179679;212;0;0;0;0;.00nan;0;0
11401;186641;212;69;35;3;32;.914;3876000;0
11401;-1;180;0;0;0;0;.00nan;0;0
11393;-1;203;34;28;6;22;.786;3048000;0
11393;189902;204;73;46;5;41;.891;3600000;0
11393;-1;203;45;5;1;4;.800;517000;0
11393;182049;204;0;0;0;0;.00nan;0;0
11461;173340;231;0;0;0;0;.00nan;0;0
11461;179430;229;0;0;0;0;.00nan;0;0
11461;185034;231;92;27;1;26;.963;3600000;0
11461;185800;229;54;40;5;35;.875;3600000;0
11462;178394;188;77;36;3;33;.917;3583000;0
11462;174153;188;0;0;0;0;.00nan;0;0
11462;176200;195;68;27;2;25;.926;3600000;0
11462;179647;195;0;0;0;0;.00nan;0;0
11338;-1;1371;0;0;0;0;.00nan;0;0
11338;-1;214;65;28;2;26;.929;3600000;0
11338;191518;214;0;0;0;0;.00nan;0;0
11338;192688;1371;27;12;4;8;.667;3590000;0
11429;171662;176;0;0;0;0;.00nan;0;0
11429;179169;209;100;23;0;23;1.000;3600000;0
11429;176932;176;98;43;1;42;.977;3600000;0
11429;186205;209;0;0;0;0;.00nan;0;0
11499;-1;210;0;0;0;0;.00nan;0;0
11499;179400;183;0;0;0;0;.00nan;0;0
11499;182089;183;98;61;3;58;.951;3565000;0
11499;192461;210;56;18;2;16;.889;3600000;0
11450;169096;190;50;36;5;31;.861;3600000;0
11450;-1;196;0;0;0;0;.00nan;0;0
11450;184648;196;78;25;2;23;.920;3600000;0
11450;197704;190;0;0;0;0;.00nan;0;0
11439;169166;226;92;30;1;29;.967;3900000;0
11439;-1;205;83;38;1;37;.974;3900000;0
11439;187092;205;0;0;0;0;.00nan;0;0
11439;192629;226;0;0;0;0;.00nan;0;0
11273;182467;185;69;33;3;30;.909;3584000;0
11273;171730;220;95;36;1;35;.972;3600000;0
11273;180110;185;0;0;0;0;.00nan;0;0
11273;187443;220;0;0;0;0;.00nan;0;0
11444;-1;227;84;33;2;31;.939;3900000;0
11444;175423;223;0;0;0;0;.00nan;0;0
11444;187118;223;75;26;2;24;.923;3900000;0
11444;187217;227;0;0;0;0;.00nan;0;0
11513;179388;182;0;0;0;0;.00nan;0;0
11513;180574;181;0;0;0;0;.00nan;0;0
11513;182116;182;89;26;1;25;.962;3577000;0
11513;-1;181;100;35;0;35;1.000;3600000;0
11579;177248;201;0;0;0;0;.00nan;0;0
11579;175364;206;0;0;0;0;.00nan;0;0
11579;196283;206;67;48;5;43;.896;3600000;0
11579;185743;201;55;24;3;21;.875;3600000;0
11560;168954;228;77;30;2;28;.933;3600000;0
11560;179406;232;75;43;4;39;.907;3519000;0
11560;175354;228;0;0;0;0;.00nan;0;0
11560;179434;232;0;0;0;0;.00nan;0;0
11481;195238;200;48;36;5;31;.861;3566000;0
11481;-1;207;50;29;4;25;.862;3600000;0
11481;187295;200;0;0;0;0;.00nan;0;0
11481;-1;207;0;0;0;0;.00nan;0;0
11642;179197;198;0;0;0;0;.00nan;0;0
11642;174325;197;50;47;7;40;.851;3600000;0
11642;175436;197;0;0;0;0;.00nan;0;0
11642;181431;198;58;14;1;13;.929;3600000;0
11366;170114;4959;100;35;1;34;.971;3900000;0
11366;195363;4959;0;0;0;0;.00nan;0;0
11366;171405;2620;69;25;1;24;.960;3900000;0
11366;-1;2620;0;0;0;0;.00nan;0;0
11567;-1;4949;0;0;0;0;.00nan;0;0
11567;195251;4949;59;22;3;19;.864;3600000;0
11567;174209;178;38;19;4;15;.789;1092000;0
11567;-1;178;63;26;2;24;.923;2508000;0
11345;167404;215;49;32;4;28;.875;3900000;0
11345;165731;215;0;0;0;0;.00nan;0;0
11345;190034;217;0;0;0;0;.00nan;0;0
11345;190041;217;76;41;4;37;.902;3900000;0
11505;174147;179;0;0;0;0;.00nan;0;0
11505;180762;1505;88;18;0;18;1.000;3600000;0
11505;186549;1505;0;0;0;0;.00nan;0;0
11505;187355;179;98;49;2;47;.959;3565000;0
11474;168117;192;0;0;0;0;.00nan;0;0
11474;170351;194;65;34;4;30;.882;3568000;0
11474;-1;192;75;32;2;30;.938;3600000;0
11474;196352;194;0;0;0;0;.00nan;0;0
11414;184175;224;99;37;1;36;.973;3600000;0
11414;-1;221;77;28;2;26;.929;3556000;0
11414;185840;224;0;0;0;0;.00nan;0;0
11414;187362;221;0;0;0;0;.00nan;0;0
11383;169166;226;0;0;0;0;.00nan;0;0
11383;-1;203;0;0;0;0;.00nan;0;0
11383;-1;203;69;31;3;28;.903;3644000;0
11383;192629;226;80;35;2;33;.943;3644000;0
11551;174209;178;56;40;4;36;.900;3564000;0
11551;179602;177;90;36;2;34;.944;3600000;0
11551;176672;177;0;0;0;0;.00nan;0;0
11551;-1;178;0;0;0;0;.00nan;0;0
11391;167404;215;0;0;0;0;.00nan;0;0
11391;165731;215;89;35;2;33;.943;3900000;0
11391;179679;212;56;23;2;21;.913;3900000;0
11391;186641;212;0;0;0;0;.00nan;0;0
11455;168907;186;0;0;0;0;.00nan;0;0
11455;169226;186;53;31;4;27;.871;3600000;0
11455;195164;218;0;0;0;0;.00nan;0;0
11455;192457;218;83;26;1;25;.962;3600000;0
11390;170114;4959;0;0;0;0;.00nan;0;0
11390;195363;4959;70;29;2;27;.931;3600000;0
11390;171662;176;98;41;1;40;.976;3600000;0
11390;176932;176;0;0;0;0;.00nan;0;0
11598;177248;201;0;0;0;0;.00nan;0;0
11598;184069;208;70;33;3;30;.909;3742000;0
11598;179702;208;0;0;0;0;.00nan;0;0
11598;185743;201;58;31;4;27;.871;3742000;0
11565;190034;217;99;43;2;41;.953;3600000;0
11565;190041;217;0;0;0;0;.00nan;0;0
11565;181065;219;0;0;0;0;.00nan;0;0
11565;181102;219;46;18;3;15;.833;3555000;0
11449;184175;224;0;0;0;0;.00nan;0;0
11449;-1;221;0;0;0;0;.00nan;0;0
11449;185840;224;67;44;6;38;.864;3600000;0
11449;187362;221;68;20;1;19;.950;3600000;0
11509;179388;182;0;0;0;0;.00nan;0;0
11509;180574;181;0;0;0;0;.00nan;0;0
11509;182116;182;64;41;5;36;.878;3600000;0
11509;-1;181;74;26;1;25;.962;3600000;0
11431;168117;192;66;24;2;22;.917;3600000;0
11431;178394;188;0;0;0;0;.00nan;0;0
11431;174153;188;78;36;3;33;.917;3600000;0
11431;-1;192;0;0;0;0;.00nan;0;0
11395;169096;190;18;21;6;15;.714;1371000;0
11395;170351;194;0;0;0;0;.00nan;0;0
11395;196352;194;69;28;2;26;.929;3600000;0
11395;197704;190;86;21;0;21;1.000;2229000;0
11591;173340;231;0;0;0;0;.00nan;0;0
11591;185034;231;15;27;7;20;.741;3600000;0
11591;181338;230;0;0;0;0;.00nan;0;0
11591;186495;230;54;24;3;21;.875;3600000;0
11627;-1;210;0;0;0;0;.00nan;0;0
11627;179400;183;0;0;0;0;.00nan;0;0
11627;182089;183;70;48;4;44;.917;3600000;0
11627;192461;210;78;11;0;11;1.000;3600000;0
11658;171839;189;0;0;0;0;.00nan;0;0
11658;-1;196;56;4;0;4;1.000;450000;0
11658;-1;189;79;33;3;30;.909;3600000;0
11658;184648;196;22;30;7;23;.767;3150000;0
11566;189885;225;67;29;2;27;.931;3600000;0
11566;175423;223;52;33;4;29;.879;3531000;0
11566;184785;225;0;0;0;0;.00nan;0;0
11566;187118;223;0;0;0;0;.00nan;0;0
11384;182467;185;0;0;0;0;.00nan;0;0
11384;180110;185;89;36;2;34;.944;3520000;0
11384;-1;214;100;28;0;28;1.000;3600000;0
11384;191518;214;0;0;0;0;.00nan;0;0
11448;189902;204;0;0;0;0;.00nan;0;0
11448;-1;207;100;44;2;42;.955;3600000;0
11448;182049;204;36;22;5;17;.773;3600000;0
11448;-1;207;0;0;0;0;.00nan;0;0
11319;171730;220;68;31;3;28;.903;3600000;0
11319;-1;1371;0;0;0;0;.00nan;0;0
11319;187443;220;0;0;0;0;.00nan;0;0
11319;192688;1371;86;32;2;30;.938;3600000;0
11518;195238;200;0;0;0;0;.00nan;0;0
11518;-1;205;67;17;1;16;.941;3600000;0
11518;187092;205;0;0;0;0;.00nan;0;0
11518;187295;200;85;43;3;40;.930;3527000;0
11480;194416;191;72;38;3;35;.921;3900000;0
11480;194893;191;0;0;0;0;.00nan;0;0
11480;176200;195;70;37;3;34;.919;3900000;0
11480;179647;195;0;0;0;0;.00nan;0;0
11478;166762;213;63;40;5;35;.875;3600000;0
11478;180575;213;0;0;0;0;.00nan;0;0
11478;187240;216;85;36;2;34;.944;3600000;0
11478;191557;216;0;0;0;0;.00nan;0;0
11557;171835;4960;58;22;3;19;.864;3527000;0
11557;194219;4960;0;0;0;0;.00nan;0;0
11557;179406;232;100;42;1;41;.976;3600000;0
11557;179434;232;0;0;0;0;.00nan;0;0
11585;-1;211;80;25;1;24;.960;3543000;0
11585;179646;211;0;0;0;0;.00nan;0;0
11585;176938;180;0;0;0;0;.00nan;0;0
11585;-1;180;100;23;0;23;1.000;3600000;0
11660;173340;231;73;18;1;17;.944;3600000;0
11660;179430;229;0;0;0;0;.00nan;0;0
11660;185034;231;0;0;0;0;.00nan;0;0
11660;185800;229;61;30;4;26;.867;3600000;0
11375;-1;1371;0;0;0;0;.00nan;0;0
11375;-1;214;54;37;5;32;.865;3537000;0
11375;191518;214;0;0;0;0;.00nan;0;0
11375;192688;1371;69;26;3;23;.885;3600000;0
11413;195164;218;100;29;0;29;1.000;3600000;0
11413;179679;212;0;0;0;0;.00nan;0;0
11413;186641;212;49;31;5;26;.839;3600000;0
11413;192457;218;0;0;0;0;.00nan;0;0
11618;179406;232;0;0;0;0;.00nan;0;0
11618;175423;223;0;0;0;0;.00nan;0;0
11618;179434;232;69;24;2;22;.917;3600000;0
11618;187118;223;85;26;1;25;.962;3600000;0
11424;177248;201;99;36;1;35;.972;3600000;0
11424;-1;203;54;20;2;18;.900;3583000;0
11424;-1;203;0;0;0;0;.00nan;0;0
11424;185743;201;0;0;0;0;.00nan;0;0
11416;182454;4864;0;0;0;0;.00nan;0;0
11416;183737;4864;89;33;3;30;.909;3543000;0
11416;170114;4959;81;31;2;29;.935;3600000;0
11416;195363;4959;0;0;0;0;.00nan;0;0
11501;182467;185;77;36;3;33;.917;3900000;0
11501;180110;185;0;0;0;0;.00nan;0;0
11501;180574;181;61;22;3;19;.864;3900000;0
11501;-1;181;0;0;0;0;.00nan;0;0
11522;166762;213;80;23;1;22;.957;1512000;0
11522;-1;210;0;0;0;0;.00nan;0;0
11522;180575;213;52;28;4;24;.857;2051000;0
11522;192461;210;65;30;3;27;.900;3600000;0
11490;179602;177;100;50;3;47;.940;3900000;0
11490;176672;177;0;0;0;0;.00nan;0;0
11490;180762;1505;53;22;3;19;.864;3900000;0
11490;186549;1505;0;0;0;0;.00nan;0;0
11496;171662;176;91;32;1;31;.969;3900000;0
11496;179169;209;0;0;0;0;.00nan;0;0
11496;176932;176;0;0;0;0;.00nan;0;0
11496;186205;209;80;24;1;23;.958;3900000;0
11580;-1;4949;91;43;3;40;.930;3802000;0
11580;195251;4949;0;0;0;0;.00nan;0;0
11580;187240;216;90;35;2;33;.943;3802000;0
11580;191557;216;0;0;0;0;.00nan;0;0
11540;192862;187;0;0;0;0;.00nan;0;0
11540;189081;187;67;34;3;31;.912;3900000;0
11540;176200;195;100;45;3;42;.933;3900000;0
11540;179647;195;0;0;0;0;.00nan;0;0
11488;-1;227;0;0;0;0;.00nan;0;0
11488;184610;222;60;29;4;25;.862;3600000;0
11488;185851;222;0;0;0;0;.00nan;0;0
11488;187217;227;50;45;6;39;.867;3600000;0
11495;192862;187;95;40;2;38;.950;3582000;0
11495;189081;187;0;0;0;0;.00nan;0;0
11495;169096;190;93;36;1;35;.972;3600000;0
11495;197704;190;0;0;0;0;.00nan;0;0
11380;182454;4864;88;20;0;20;1.000;3600000;0
11380;183737;4864;0;0;0;0;.00nan;0;0
11380;179169;209;66;26;2;24;.923;3554000;0
11380;186205;209;0;0;0;0;.00nan;0;0
11485;189902;204;78;24;1;23;.958;3600000;0
11485;175364;206;66;48;6;42;.875;3600000;0
11485;196283;206;0;0;0;0;.00nan;0;0
11485;182049;204;0;0;0;0;.00nan;0;0
11463;166545;193;76;35;3;32;.914;3900000;0
11463;194416;191;0;0;0;0;.00nan;0;0
11463;194893;191;60;27;3;24;.889;3900000;0
11463;173770;193;0;0;0;0;.00nan;0;0
11530;-1;221;100;25;0;25;1.000;3600000;0
11530;181338;230;0;0;0;0;.00nan;0;0
11530;186495;230;71;26;3;23;.885;3600000;0
11530;187362;221;0;0;0;0;.00nan;0;0
11572;171835;4960;0;0;0;0;.00nan;0;0
11572;194219;4960;37;14;3;11;.786;3600000;0
11572;168954;228;65;45;5;40;.889;3537000;0
11572;175354;228;0;0;0;0;.00nan;0;0
11556;184610;222;0;0;0;0;.00nan;0;0
11556;179430;229;0;0;0;0;.00nan;0;0
11556;185800;229;77;36;3;33;.917;3521000;0
11556;185851;222;59;16;1;15;.938;3600000;0
11508;174147;179;0;0;0;0;.00nan;0;0
11508;174209;178;0;0;0;0;.00nan;0;0
11508;187355;179;83;27;1;26;.963;3600000;0
11508;-1;178;80;34;2;32;.941;3577000;0
11482;195164;218;0;0;0;0;.00nan;0;0
11482;181065;219;0;0;0;0;.00nan;0;0
11482;181102;219;77;48;5;43;.896;3600000;0
11482;192457;218;76;27;2;25;.926;3600000;0
11601;180623;202;0;0;0;0;.00nan;0;0
11601;-1;205;59;14;1;13;.929;3600000;0
11601;187092;205;0;0;0;0;.00nan;0;0
11601;192498;202;59;28;3;25;.893;3600000;0
11502;184069;208;85;40;2;38;.950;3600000;0
11502;169166;226;86;27;1;26;.963;3600000;0
11502;179702;208;0;0;0;0;.00nan;0;0
11502;192629;226;0;0;0;0;.00nan;0;0
11511;167404;215;88;48;4;44;.917;3600000;0
11511;165731;215;0;0;0;0;.00nan;0;0
11511;176938;180;0;0;0;0;.00nan;0;0
11511;-1;180;89;20;0;20;1.000;3600000;0
11517;195238;200;91;42;2;40;.952;3600000;0
11517;-1;207;64;28;3;25;.893;3557000;0
11517;187295;200;0;0;0;0;.00nan;0;0
11517;-1;207;0;0;0;0;.00nan;0;0
11486;194416;191;77;9;0;9;1.000;3600000;0
11486;194893;191;0;0;0;0;.00nan;0;0
11486;-1;196;0;0;0;0;.00nan;0;0
11486;184648;196;76;42;4;38;.905;3600000;0
11516;171839;189;53;9;1;8;.889;929000;0
11516;178394;188;78;32;3;29;.906;3600000;0
11516;174153;188;0;0;0;0;.00nan;0;0
11516;-1;189;43;33;6;27;.818;2671000;0
11539;184069;208;52;28;4;24;.857;3559000;0
11539;179702;208;0;0;0;0;.00nan;0;0
11539;-1;207;74;27;2;25;.926;3600000;0
11539;-1;207;0;0;0;0;.00nan;0;0
11350;171730;220;76;23;1;22;.957;3600000;0
11350;187443;220;0;0;0;0;.00nan;0;0
11350;-1;214;74;41;4;37;.902;3600000;0
11350;191518;214;0;0;0;0;.00nan;0;0
11552;171839;189;0;0;0;0;.00nan;0;0
11552;192862;187;0;0;0;0;.00nan;0;0
11552;189081;187;95;24;0;24;1.000;3600000;0
11552;-1;189;91;51;3;48;.941;3600000;0
11534;174147;179;0;0;0;0;.00nan;0;0
11534;187240;216;61;23;2;21;.913;3600000;0
11534;187355;179;55;30;3;27;.900;3569000;0
11534;191557;216;0;0;0;0;.00nan;0;0
11542;169166;226;59;28;3;25;.893;3551000;0
11542;175370;199;0;0;0;0;.00nan;0;0
11542;192629;226;0;0;0;0;.00nan;0;0
11542;161006;199;84;32;2;30;.938;3600000;0
11570;173340;231;0;0;0;0;.00nan;0;0
11570;189885;225;88;38;1;37;.974;3600000;0
11570;184785;225;0;0;0;0;.00nan;0;0
11570;185034;231;74;22;2;20;.909;3600000;0
11597;-1;4949;47;25;4;21;.840;3754000;0
11597;195251;4949;0;0;0;0;.00nan;0;0
11597;179602;177;91;38;3;35;.921;3754000;0
11597;176672;177;0;0;0;0;.00nan;0;0
11510;-1;221;78;33;3;30;.909;3600000;0
11510;179430;229;0;0;0;0;.00nan;0;0
11510;185800;229;35;26;5;21;.808;3592000;0
11510;187362;221;0;0;0;0;.00nan;0;0
11475;182454;4864;69;29;2;27;.931;3600000;0
11475;183737;4864;0;0;0;0;.00nan;0;0
11475;170114;4959;89;41;3;38;.927;3600000;0
11475;195363;4959;0;0;0;0;.00nan;0;0
11506;166545;193;75;28;2;26;.929;3600000;0
11506;168117;192;0;0;0;0;.00nan;0;0
11506;173770;193;0;0;0;0;.00nan;0;0
11506;-1;192;41;22;4;18;.818;3576000;0
11493;195238;200;0;0;0;0;.00nan;0;0
11493;-1;203;59;22;2;20;.909;3870000;0
11493;-1;203;0;0;0;0;.00nan;0;0
11493;187295;200;94;46;3;43;.935;3870000;0
11664;171835;4960;0;0;0;0;.00nan;0;0
11664;194219;4960;86;32;2;30;.938;3900000;0
11664;175423;223;0;0;0;0;.00nan;0;0
11664;187118;223;96;38;2;36;.947;3900000;0
11573;171405;2620;67;26;2;24;.923;3600000;0
11573;171662;176;94;39;3;36;.923;3600000;0
11573;176932;176;0;0;0;0;.00nan;0;0
11573;-1;2620;0;0;0;0;.00nan;0;0
11561;195164;218;100;29;0;29;1.000;3600000;0
11561;181065;219;0;0;0;0;.00nan;0;0
11561;181102;219;70;40;4;36;.900;3600000;0
11561;192457;218;0;0;0;0;.00nan;0;0
11657;168117;192;81;16;0;16;1.000;3600000;0
11657;176200;195;97;50;3;47;.940;3600000;0
11657;179647;195;0;0;0;0;.00nan;0;0
11657;-1;192;0;0;0;0;.00nan;0;0
11504;168907;186;0;0;0;0;.00nan;0;0
11504;169226;186;88;53;3;50;.943;3859000;0
11504;179679;212;0;0;0;0;.00nan;0;0
11504;186641;212;73;29;2;27;.931;3859000;0
11663;175364;206;29;27;5;22;.815;3572000;0
11663;196283;206;0;0;0;0;.00nan;0;0
11663;180623;202;0;0;0;0;.00nan;0;0
11663;192498;202;37;22;4;18;.818;3600000;0
11525;166545;193;0;0;0;0;.00nan;0;0
11525;173770;193;59;18;2;16;.889;3600000;0
11525;170351;194;56;40;5;35;.875;3600000;0
11525;196352;194;0;0;0;0;.00nan;0;0
11497;194416;191;79;34;2;32;.941;3600000;0
11497;194893;191;0;0;0;0;.00nan;0;0
11497;179197;198;64;45;5;40;.889;3600000;0
11497;181431;198;0;0;0;0;.00nan;0;0
11645;166762;213;83;24;1;23;.958;3600000;0
11645;179602;177;0;0;0;0;.00nan;0;0
11645;176672;177;53;24;3;21;.875;3590000;0
11645;180575;213;0;0;0;0;.00nan;0;0
11600;174209;178;70;39;5;34;.872;3545000;0
11600;179400;183;0;0;0;0;.00nan;0;0
11600;182089;183;54;26;4;22;.846;3600000;0
11600;-1;178;0;0;0;0;.00nan;0;0
11563;192862;187;0;0;0;0;.00nan;0;0
11563;189081;187;64;20;2;18;.900;3519000;0
11563;169096;190;100;28;0;28;1.000;3600000;0
11563;197704;190;0;0;0;0;.00nan;0;0
11562;195164;218;0;0;0;0;.00nan;0;0
11562;190034;217;0;0;0;0;.00nan;0;0
11562;190041;217;84;35;2;33;.943;3600000;0
11562;192457;218;60;36;5;31;.861;3600000;0
11632;189885;225;50;15;2;13;.867;1497000;0
11632;179406;232;70;25;2;23;.920;3600000;0
11632;179434;232;0;0;0;0;.00nan;0;0
11632;184785;225;13;18;6;12;.667;2103000;0
11415;167404;215;50;29;4;25;.862;3561000;0
11415;165731;215;0;0;0;0;.00nan;0;0
11415;-1;211;89;32;2;30;.938;3600000;0
11415;179646;211;0;0;0;0;.00nan;0;0
11398;-1;1371;0;0;0;0;.00nan;0;0
11398;179388;182;0;0;0;0;.00nan;0;0
11398;182116;182;75;31;3;28;.903;3600000;0
11398;192688;1371;80;28;1;27;.964;3600000;0
11582;182454;4864;0;0;0;0;.00nan;0;0
11582;183737;4864;64;26;3;23;.885;3528000;0
11582;171405;2620;0;0;0;0;.00nan;0;0
11582;-1;2620;93;40;1;39;.975;3600000;0
11593;173340;231;0;0;0;0;.00nan;0;0
11593;-1;221;0;0;0;0;.00nan;0;0
11593;185034;231;100;25;0;25;1.000;3846000;0
11593;187362;221;94;35;1;34;.971;3846000;0
11622;-1;203;62;5;0;5;1.000;311000;0
11622;189902;204;0;0;0;0;.00nan;0;0
11622;-1;203;26;25;6;19;.760;3289000;0
11622;182049;204;79;42;4;38;.905;3600000;0
11587;184610;222;0;0;0;0;.00nan;0;0
11587;179430;229;44;16;3;13;.813;3572000;0
11587;185800;229;0;0;0;0;.00nan;0;0
11587;185851;222;100;42;2;40;.952;3600000;0
11417;170114;4959;68;25;2;23;.920;3600000;0
11417;195363;4959;0;0;0;0;.00nan;0;0
11417;179169;209;0;0;0;0;.00nan;0;0
11417;186205;209;37;38;7;31;.816;3600000;0
11546;168954;228;67;22;2;20;.909;3600000;0
11546;184175;224;55;30;4;26;.867;3600000;0
11546;175354;228;0;0;0;0;.00nan;0;0
11546;185840;224;0;0;0;0;.00nan;0;0
11648;176938;180;0;0;0;0;.00nan;0;0
11648;181065;219;97;40;1;39;.975;3900000;0
11648;181102;219;0;0;0;0;.00nan;0;0
11648;-1;180;82;32;1;31;.969;3900000;0
11647;-1;4949;0;0;0;0;.00nan;0;0
11647;195251;4949;94;56;1;55;.982;3701000;0
11647;174147;179;69;20;2;18;.900;3701000;0
11647;187355;179;0;0;0;0;.00nan;0;0
11604;178394;188;0;0;0;0;.00nan;0;0
11604;174153;188;82;12;0;12;1.000;3600000;0
11604;174325;197;88;42;2;40;.952;3581000;0
11604;175436;197;0;0;0;0;.00nan;0;0
11376;171730;220;0;0;0;0;.00nan;0;0
11376;187443;220;66;13;1;12;.923;3600000;0
11376;-1;214;60;14;1;13;.929;1304000;0
11376;191518;214;29;25;5;20;.800;2296000;0
11554;177248;201;0;0;0;0;.00nan;0;0
11554;-1;205;0;0;0;0;.00nan;0;0
11554;185743;201;77;51;6;45;.882;3674000;0
11554;187092;205;40;27;5;22;.815;3673000;0
11553;-1;210;89;31;2;29;.935;3600000;0
11553;180762;1505;0;0;0;0;.00nan;0;0
11553;186549;1505;64;31;4;27;.871;3578000;0
11553;192461;210;0;0;0;0;.00nan;0;0
11549;190125;184;60;24;3;21;.875;3581000;0
11549;179668;184;0;0;0;0;.00nan;0;0
11549;180574;181;0;0;0;0;.00nan;0;0
11549;-1;181;96;36;1;35;.972;3600000;0
11614;167404;215;0;0;0;0;.00nan;0;0
11614;165731;215;84;33;2;31;.939;3674000;0
11614;168907;186;0;0;0;0;.00nan;0;0
11614;169226;186;84;38;3;35;.921;3674000;0
11626;171835;4960;76;23;1;22;.957;3600000;0
11626;194219;4960;0;0;0;0;.00nan;0;0
11626;184175;224;0;0;0;0;.00nan;0;0
11626;185840;224;77;52;4;48;.923;3600000;0
11610;194416;191;0;0;0;0;.00nan;0;0
11610;194893;191;66;16;1;15;.938;3600000;0
11610;174325;197;0;0;0;0;.00nan;0;0
11610;175436;197;64;40;4;36;.900;3600000;0
11547;178394;188;52;36;6;30;.833;3600000;0
11547;174153;188;0;0;0;0;.00nan;0;0
11547;179197;198;0;0;0;0;.00nan;0;0
11547;181431;198;65;23;2;21;.913;3600000;0
11586;184069;208;69;33;3;30;.909;3600000;0
11586;169166;226;0;0;0;0;.00nan;0;0
11586;179702;208;0;0;0;0;.00nan;0;0
11586;192629;226;90;42;2;40;.952;3600000;0
11638;-1;227;48;23;3;20;.870;3513000;0
11638;175423;223;99;43;1;42;.977;3600000;0
11638;187118;223;0;0;0;0;.00nan;0;0
11638;187217;227;0;0;0;0;.00nan;0;0
11636;182467;185;72;39;3;36;.923;3600000;0
11636;190125;184;0;0;0;0;.00nan;0;0
11636;179668;184;81;36;2;34;.944;3600000;0
11636;180110;185;0;0;0;0;.00nan;0;0
11519;190034;217;70;31;3;28;.903;3600000;0
11519;190041;217;0;0;0;0;.00nan;0;0
11519;179679;212;57;32;4;28;.875;3563000;0
11519;186641;212;0;0;0;0;.00nan;0;0
11649;169096;190;91;34;2;32;.941;3600000;0
11649;-1;196;0;0;0;0;.00nan;0;0
11649;184648;196;36;31;6;25;.806;3600000;0
11649;197704;190;0;0;0;0;.00nan;0;0
11577;166762;213;0;0;0;0;.00nan;0;0
11577;-1;210;0;0;0;0;.00nan;0;0
11577;180575;213;63;44;5;39;.886;3600000;0
11577;192461;210;96;18;0;18;1.000;3600000;0
11681;177248;201;0;0;0;0;.00nan;0;0
11681;179430;229;0;0;0;0;.00nan;0;0
11681;185743;201;55;15;2;13;.867;3900000;0
11681;185800;229;72;32;2;30;.938;3900000;0
11683;184069;208;50;31;4;27;.871;3563000;0
11683;189885;225;73;33;2;31;.939;3600000;0
11683;184785;225;0;0;0;0;.00nan;0;0
11683;179702;208;0;0;0;0;.00nan;0;0
11685;-1;203;0;0;0;0;.00nan;0;0
11685;-1;203;62;31;3;28;.903;3556000;0
11685;181065;219;0;0;0;0;.00nan;0;0
11685;181102;219;68;27;2;25;.926;3600000;0
11687;169166;226;68;37;4;33;.892;3600000;0
11687;181338;230;0;0;0;0;.00nan;0;0
11687;186495;230;100;36;0;36;1.000;3600000;0
11687;192629;226;0;0;0;0;.00nan;0;0
11689;171835;4960;98;20;0;20;1.000;3600000;0
11689;194219;4960;0;0;0;0;.00nan;0;0
11689;174209;178;56;41;5;36;.878;3600000;0
11689;-1;178;0;0;0;0;.00nan;0;0
11691;171662;176;0;0;0;0;.00nan;0;0
11691;176932;176;65;43;5;38;.884;3600000;0
11691;187240;216;68;29;2;27;.931;3600000;0
11691;191557;216;0;0;0;0;.00nan;0;0
11693;166762;213;45;34;4;30;.882;3893000;0
11693;180575;213;0;0;0;0;.00nan;0;0
11693;-1;205;56;36;4;32;.889;3900000;0
11693;187092;205;0;0;0;0;.00nan;0;0
11695;171839;189;0;0;0;0;.00nan;0;0
11695;-1;189;79;32;2;30;.938;3600000;0
11695;180623;202;47;33;5;28;.848;3600000;0
11695;192498;202;0;0;0;0;.00nan;0;0
11697;179197;198;0;0;0;0;.00nan;0;0
11697;179388;182;0;0;0;0;.00nan;0;0
11697;181431;198;85;15;0;15;1.000;3600000;0
11697;182116;182;90;56;4;52;.929;3600000;0
11699;170351;194;67;17;1;16;.941;3600000;0
11699;-1;227;72;46;5;41;.891;3600000;0
11699;196352;194;0;0;0;0;.00nan;0;0
11699;187217;227;0;0;0;0;.00nan;0;0
11701;179406;232;63;28;3;25;.893;3600000;0
11701;175423;223;0;0;0;0;.00nan;0;0
11701;179434;232;0;0;0;0;.00nan;0;0
11701;187118;223;58;34;4;30;.882;3600000;0
11703;176200;195;43;21;4;17;.810;3553000;0
11703;179647;195;0;0;0;0;.00nan;0;0
11703;180578;181;0;0;0;0;.00nan;0;0
11703;-1;181;68;34;3;31;.912;3600000;0
11705;179169;209;0;0;0;0;.00nan;0;0
11705;179602;177;29;22;5;17;.773;3600000;0
11705;176672;177;0;0;0;0;.00nan;0;0
11705;186205;209;81;33;2;31;.939;3600000;0
11707;182454;4864;59;27;3;24;.889;3600000;0
11707;183737;4864;0;0;0;0;.00nan;0;0
11707;-1;196;0;0;0;0;.00nan;0;0
11707;184648;196;73;27;2;25;.926;3600000;0
11709;184610;222;0;0;0;0;.00nan;0;0
11709;185851;222;100;36;0;36;1.000;3600000;0
11709;-1;214;67;27;3;24;.889;3600000;0
11709;191518;214;0;0;0;0;.00nan;0;0
11711;168954;228;38;46;7;39;.848;2956000;0
11711;175354;228;51;4;1;3;.750;644000;0
11711;175370;199;80;33;2;31;.939;3600000;0
11711;161006;199;0;0;0;0;.00nan;0;0
11713;195164;218;0;0;0;0;.00nan;0;0
11713;174325;197;0;0;0;0;.00nan;0;0
11713;175436;197;58;42;4;38;.905;3556000;0
11713;192457;218;66;31;3;28;.903;3600000;0
11715;184175;224;72;47;5;42;.894;3600000;0
11715;189902;204;0;0;0;0;.00nan;0;0
11715;182049;204;75;26;2;24;.923;3600000;0
11715;185840;224;0;0;0;0;.00nan;0;0
11717;171730;220;59;18;2;16;.889;3600000;0
11717;175364;206;62;37;4;33;.892;3600000;0
11717;196283;206;0;0;0;0;.00nan;0;0
11717;187443;220;0;0;0;0;.00nan;0;0
11719;192862;187;0;0;0;0;.00nan;0;0
11719;189081;187;59;38;4;34;.895;3600000;0
11719;173340;231;0;0;0;0;.00nan;0;0
11719;185034;231;78;26;1;25;.962;3600000;0
11721;179400;183;0;0;0;0;.00nan;0;0
11721;180762;1505;0;0;0;0;.00nan;0;0
11721;182089;183;59;47;6;41;.872;3600000;0
11721;186549;1505;53;9;1;8;.889;3600000;0
11723;-1;4949;95;21;0;21;1.000;3600000;0
11723;195251;4949;0;0;0;0;.00nan;0;0
11723;190125;184;27;12;4;8;.667;1153000;0
11723;179668;184;58;30;4;26;.867;2447000;0
11725;166545;193;0;0;0;0;.00nan;0;0
11725;-1;1371;0;0;0;0;.00nan;0;0
11725;186451;193;96;25;0;25;1.000;3600000;0
11725;192688;1371;98;52;3;49;.942;3600000;0
11727;190034;217;0;0;0;0;.00nan;0;0
11727;190041;217;87;31;1;30;.968;3600000;0
11727;-1;207;64;29;4;25;.862;3600000;0
11727;-1;207;0;0;0;0;.00nan;0;0
11729;194893;191;62;17;1;16;.941;3600000;0
11729;176938;180;69;36;4;32;.889;3600000;0
11729;-1;180;0;0;0;0;.00nan;0;0
11729;197090;191;0;0;0;0;.00nan;0;0
11731;169096;190;56;33;4;29;.879;3570000;0
11731;179679;212;0;0;0;0;.00nan;0;0
11731;186641;212;58;27;3;24;.889;3600000;0
11731;197704;190;0;0;0;0;.00nan;0;0
11733;182467;185;0;0;0;0;.00nan;0;0
11733;170114;4959;63;42;5;37;.881;3600000;0
11733;195363;4959;0;0;0;0;.00nan;0;0
11733;180110;185;46;26;4;22;.846;3600000;0
11735;167404;215;84;64;5;59;.922;3600000;0
11735;165731;215;0;0;0;0;.00nan;0;0
11735;-1;210;0;0;0;0;.00nan;0;0
11735;192461;210;72;29;2;27;.931;3600000;0
11737;178394;188;0;0;0;0;.00nan;0;0
11737;-1;211;50;45;6;39;.867;3532000;0
11737;174153;188;50;28;4;24;.857;3600000;0
11737;179646;211;0;0;0;0;.00nan;0;0
11739;171405;2620;0;0;0;0;.00nan;0;0
11739;175900;192;0;0;0;0;.00nan;0;0
11739;-1;192;39;30;5;25;.833;3900000;0
11739;-1;2620;62;41;5;36;.878;3900000;0
11741;195238;200;0;0;0;0;.00nan;0;0
11741;174147;179;0;0;0;0;.00nan;0;0
11741;187295;200;61;46;5;41;.891;3600000;0
11741;187355;179;83;26;1;25;.962;3600000;0
11743;168907;186;0;0;0;0;.00nan;0;0
11743;169226;186;58;40;6;34;.850;3657000;0
11743;-1;221;45;34;5;29;.853;3657000;0
11743;187362;221;0;0;0;0;.00nan;0;0
11745;171839;189;0;0;0;0;.00nan;0;0
11745;179169;209;52;9;1;8;.889;3600000;0
11745;-1;189;75;49;4;45;.918;3600000;0
11745;186205;209;0;0;0;0;.00nan;0;0
11747;-1;227;78;45;4;41;.911;3721000;0
11747;179430;229;51;27;3;24;.889;3721000;0
11747;185800;229;0;0;0;0;.00nan;0;0
11747;187217;227;0;0;0;0;.00nan;0;0
11749;166762;213;0;0;0;0;.00nan;0;0
11749;180575;213;44;48;7;41;.854;3600000;0
11749;181065;219;0;0;0;0;.00nan;0;0
11749;181102;219;100;31;0;31;1.000;3600000;0
11751;167404;215;59;48;6;42;.875;3574000;0
11751;165731;215;0;0;0;0;.00nan;0;0
11751;179602;177;79;41;4;37;.902;3600000;0
11751;176672;177;0;0;0;0;.00nan;0;0
11753;168907;186;0;0;0;0;.00nan;0;0
11753;169226;186;78;31;2;29;.935;3544000;0
11753;180578;181;0;0;0;0;.00nan;0;0
11753;-1;181;79;24;1;23;.958;3600000;0
11755;195164;218;0;0;0;0;.00nan;0;0
11755;179197;198;0;0;0;0;.00nan;0;0
11755;181431;198;52;15;2;13;.867;3600000;0
11755;192457;218;92;52;4;48;.923;3569000;0
11757;171835;4960;90;20;0;20;1.000;3600000;0
11757;194219;4960;0;0;0;0;.00nan;0;0
11757;180623;202;0;0;0;0;.00nan;0;0
11757;192498;202;49;37;5;32;.865;3600000;0
11759;173340;231;0;0;0;0;.00nan;0;0
11759;179388;182;0;0;0;0;.00nan;0;0
11759;185034;231;79;24;1;23;.958;3600000;0
11759;182116;182;50;28;4;24;.857;3600000;0
11761;174147;179;98;43;2;41;.953;3900000;0
11761;175370;199;0;0;0;0;.00nan;0;0
11761;187355;179;0;0;0;0;.00nan;0;0
11761;161006;199;67;26;2;24;.923;3900000;0
11763;182454;4864;0;0;0;0;.00nan;0;0
11763;183737;4864;70;24;1;23;.958;3576000;0
11763;-1;207;0;0;0;0;.00nan;0;0
11763;-1;207;98;24;0;24;1.000;3600000;0
11765;178394;188;78;34;2;32;.941;3600000;0
11765;174153;188;0;0;0;0;.00nan;0;0
11765;190034;217;72;39;3;36;.923;3591000;0
11765;190041;217;0;0;0;0;.00nan;0;0
11767;192862;187;75;36;3;33;.917;3600000;0
11767;189081;187;0;0;0;0;.00nan;0;0
11767;174325;197;55;9;1;8;.889;822000;0
11767;175436;197;12;21;6;15;.714;2778000;0
11769;-1;203;52;20;3;17;.850;3665000;0
11769;-1;203;0;0;0;0;.00nan;0;0
11769;-1;214;0;0;0;0;.00nan;0;0
11769;191518;214;78;33;2;31;.939;3665000;0
11771;175900;192;100;28;0;28;1.000;3600000;0
11771;179679;212;0;0;0;0;.00nan;0;0
11771;-1;192;0;0;0;0;.00nan;0;0
11771;186641;212;59;39;5;34;.872;3600000;0
11773;194893;191;0;0;0;0;.00nan;0;0
11773;195238;200;73;27;1;26;.963;1050000;0
11773;187295;200;35;39;7;32;.821;2550000;0
11773;197090;191;75;22;1;21;.955;3600000;0
11775;175364;206;40;30;5;25;.833;3600000;0
11775;176200;195;100;20;0;20;1.000;3600000;0
11775;179647;195;0;0;0;0;.00nan;0;0
11775;196283;206;0;0;0;0;.00nan;0;0
11777;-1;221;0;0;0;0;.00nan;0;0
11777;189902;204;59;30;4;26;.867;3184000;0
11777;182049;204;32;11;3;8;.727;416000;0
11777;187362;221;50;28;4;24;.857;3600000;0
11779;-1;4949;72;30;2;28;.933;3633000;0
11779;195251;4949;0;0;0;0;.00nan;0;0
11779;176938;180;76;26;1;25;.962;3633000;0
11779;-1;180;0;0;0;0;.00nan;0;0
11781;177248;201;0;0;0;0;.00nan;0;0
11781;170114;4959;48;0;0;0;.00nan;337000;0
11781;195363;4959;50;42;6;36;.857;3263000;0
11781;185743;201;70;31;3;28;.903;3600000;0
11783;175423;223;100;28;0;28;1.000;3600000;0
11783;187118;223;0;0;0;0;.00nan;0;0
11783;187240;216;56;40;5;35;.875;3600000;0
11783;191557;216;0;0;0;0;.00nan;0;0
11785;182467;185;74;32;2;30;.938;3600000;0
11785;170351;194;0;0;0;0;.00nan;0;0
11785;180110;185;0;0;0;0;.00nan;0;0
11785;196352;194;58;29;3;26;.897;3575000;0
11787;184610;222;72;30;3;27;.900;3021000;0
11787;180762;1505;74;26;1;25;.962;3600000;0
11787;185851;222;36;13;3;10;.769;579000;0
11787;186549;1505;0;0;0;0;.00nan;0;0
11789;169096;190;0;0;0;0;.00nan;0;0
11789;-1;210;72;31;3;28;.903;3600000;0
11789;192461;210;0;0;0;0;.00nan;0;0
11789;197704;190;50;30;4;26;.867;3588000;0
11791;-1;211;17;36;8;28;.778;3149000;0
11791;179646;211;53;3;0;3;1.000;451000;0
11791;-1;205;87;29;1;28;.966;3600000;0
11791;187092;205;0;0;0;0;.00nan;0;0
11793;169166;226;58;19;2;17;.895;3600000;0
11793;174209;178;92;59;4;55;.932;3559000;0
11793;192629;226;0;0;0;0;.00nan;0;0
11793;-1;178;0;0;0;0;.00nan;0;0
11795;168954;228;80;31;2;29;.935;3600000;0
11795;171662;176;0;0;0;0;.00nan;0;0
11795;175354;228;0;0;0;0;.00nan;0;0
11795;176932;176;60;31;3;28;.903;3543000;0
11797;-1;196;91;39;2;37;.949;3600000;0
11797;184648;196;0;0;0;0;.00nan;0;0
11797;181338;230;0;0;0;0;.00nan;0;0
11797;186495;230;43;18;3;15;.833;3551000;0
11799;166545;193;0;0;0;0;.00nan;0;0
11799;-1;1371;0;0;0;0;.00nan;0;0
11799;186451;193;52;19;2;17;.895;3900000;0
11799;192688;1371;93;47;2;45;.957;3900000;0
11801;189885;225;66;23;2;21;.913;3549000;0
11801;179400;183;0;0;0;0;.00nan;0;0
11801;184785;225;0;0;0;0;.00nan;0;0
11801;182089;183;88;29;1;28;.966;3600000;0
11803;184069;208;0;0;0;0;.00nan;0;0
11803;190125;184;75;60;5;55;.917;3584000;0
11803;179668;184;0;0;0;0;.00nan;0;0
11803;179702;208;45;21;4;17;.810;3600000;0
11805;184175;224;84;30;1;29;.967;3600000;0
11805;171730;220;43;28;5;23;.821;3600000;0
11805;185840;224;0;0;0;0;.00nan;0;0
11805;187443;220;0;0;0;0;.00nan;0;0
11807;171405;2620;44;32;5;27;.844;3900000;0
11807;179406;232;33;21;5;16;.762;1749000;0
11807;179434;232;74;13;0;13;1.000;2151000;0
11807;-1;2620;0;0;0;0;.00nan;0;0
11809;170351;194;55;31;4;27;.871;3600000;0
11809;179679;212;84;28;1;27;.964;3600000;0
11809;196352;194;0;0;0;0;.00nan;0;0
11809;186641;212;0;0;0;0;.00nan;0;0
11811;177248;201;78;28;2;26;.929;3575000;0
11811;-1;207;0;0;0;0;.00nan;0;0
11811;185743;201;0;0;0;0;.00nan;0;0
11811;-1;207;77;24;1;23;.958;3600000;0
11813;168907;186;33;25;5;20;.800;3588000;0
11813;169226;186;0;0;0;0;.00nan;0;0
11813;174325;197;75;45;4;41;.911;3600000;0
11813;175436;197;0;0;0;0;.00nan;0;0
11815;-1;221;49;30;4;26;.867;3600000;0
11815;179406;232;98;31;1;30;.968;3600000;0
11815;179434;232;0;0;0;0;.00nan;0;0
11815;187362;221;0;0;0;0;.00nan;0;0
11817;184069;208;53;23;3;20;.870;3545000;0
11817;168954;228;0;0;0;0;.00nan;0;0
11817;175354;228;73;27;2;25;.926;3600000;0
11817;179702;208;0;0;0;0;.00nan;0;0
11819;171839;189;69;32;3;29;.906;3597000;0
11819;-1;196;0;0;0;0;.00nan;0;0
11819;-1;189;0;0;0;0;.00nan;0;0
11819;184648;196;63;25;2;23;.920;3600000;0
11821;174147;179;0;0;0;0;.00nan;0;0
11821;187355;179;54;22;3;19;.864;3600000;0
11821;-1;214;100;39;0;39;1.000;3600000;0
11821;191518;214;0;0;0;0;.00nan;0;0
11823;171835;4960;56;19;2;17;.895;3805000;0
11823;166762;213;76;43;3;40;.930;3805000;0
11823;194219;4960;0;0;0;0;.00nan;0;0
11823;180575;213;0;0;0;0;.00nan;0;0
11825;171730;220;0;0;0;0;.00nan;0;0
11825;-1;1371;69;31;3;28;.903;3900000;0
11825;187443;220;69;32;3;29;.906;3900000;0
11825;192688;1371;0;0;0;0;.00nan;0;0
11827;179169;209;24;14;4;10;.714;1512000;0
11827;180762;1505;0;0;0;0;.00nan;0;0
11827;186205;209;17;23;6;17;.739;2088000;0
11827;186549;1505;92;16;0;16;1.000;3600000;0
11829;173340;231;95;23;0;23;1.000;3600000;0
11829;169166;226;0;0;0;0;.00nan;0;0
11829;185034;231;0;0;0;0;.00nan;0;0
11829;192629;226;74;56;6;50;.893;3600000;0
11831;182467;185;0;0;0;0;.00nan;0;0
11831;179400;183;75;40;4;36;.900;3540000;0
11831;180110;185;80;34;2;32;.941;3600000;0
11831;182089;183;0;0;0;0;.00nan;0;0
11833;166545;193;88;18;0;18;1.000;3600000;0
11833;186451;193;0;0;0;0;.00nan;0;0
11833;187240;216;0;0;0;0;.00nan;0;0
11833;191557;216;75;30;2;28;.933;3536000;0
11835;192862;187;0;0;0;0;.00nan;0;0
11835;189081;187;82;35;2;33;.943;3600000;0
11835;179388;182;62;34;3;31;.912;3555000;0
11835;182116;182;0;0;0;0;.00nan;0;0
11837;-1;210;0;0;0;0;.00nan;0;0
11837;179602;177;90;51;3;48;.941;3586000;0
11837;176672;177;0;0;0;0;.00nan;0;0
11837;192461;210;77;28;1;27;.964;3600000;0
11839;182454;4864;81;14;0;14;1.000;3600000;0
11839;183737;4864;0;0;0;0;.00nan;0;0
11839;171662;176;56;33;4;29;.879;3600000;0
11839;176932;176;0;0;0;0;.00nan;0;0
11841;170114;4959;93;43;3;40;.930;3561000;0
11841;195363;4959;0;0;0;0;.00nan;0;0
11841;176938;180;0;0;0;0;.00nan;0;0
11841;-1;180;76;28;2;26;.929;3600000;0
11843;-1;4949;0;0;0;0;.00nan;0;0
11843;195251;4949;71;21;1;20;.952;3600000;0
11843;179197;198;68;28;2;26;.929;3587000;0
11843;181431;198;0;0;0;0;.00nan;0;0
11845;175370;199;45;30;5;25;.833;3519000;0
11845;180623;202;66;29;3;26;.897;3600000;0
11845;192498;202;0;0;0;0;.00nan;0;0
11845;161006;199;0;0;0;0;.00nan;0;0
11847;167404;215;88;42;3;39;.929;3900000;0
11847;165731;215;0;0;0;0;.00nan;0;0
11847;175364;206;0;0;0;0;.00nan;0;0
11847;196283;206;63;25;3;22;.880;3900000;0
11849;190034;217;0;0;0;0;.00nan;0;0
11849;190041;217;75;46;4;42;.913;3600000;0
11849;190125;184;0;0;0;0;.00nan;0;0
11849;179668;184;39;32;5;27;.844;3560000;0
11851;195164;218;69;48;6;42;.875;3585000;0
11851;176200;195;35;20;5;15;.750;3600000;0
11851;179647;195;0;0;0;0;.00nan;0;0
11851;192457;218;0;0;0;0;.00nan;0;0
11853;-1;203;0;0;0;0;.00nan;0;0
11853;-1;203;96;23;0;23;1.000;3600000;0
11853;-1;205;0;0;0;0;.00nan;0;0
11853;187092;205;75;34;2;32;.941;3581000;0
11855;-1;227;0;0;0;0;.00nan;0;0
11855;180578;181;80;26;1;25;.962;3600000;0
11855;-1;181;0;0;0;0;.00nan;0;0
11855;187217;227;72;41;3;38;.927;3573000;0
11857;-1;211;0;0;0;0;.00nan;0;0
11857;184610;222;0;0;0;0;.00nan;0;0
11857;179646;211;74;40;3;37;.925;3591000;0
11857;185851;222;71;27;2;25;.926;3600000;0
11859;178394;188;0;0;0;0;.00nan;0;0
11859;184175;224;0;0;0;0;.00nan;0;0
11859;174153;188;70;29;2;27;.931;3600000;0
11859;185840;224;79;50;4;46;.920;3536000;0
11861;175423;223;62;20;2;18;.900;3900000;0
11861;181065;219;0;0;0;0;.00nan;0;0
11861;181102;219;87;33;2;31;.939;3900000;0
11861;187118;223;0;0;0;0;.00nan;0;0
11863;194893;191;89;32;1;31;.969;3600000;0
11863;189885;225;0;0;0;0;.00nan;0;0
11863;184785;225;77;39;3;36;.923;3518000;0
11863;197090;191;0;0;0;0;.00nan;0;0
11865;174209;178;0;0;0;0;.00nan;0;0
11865;181338;230;40;20;4;16;.800;3545000;0
11865;186495;230;0;0;0;0;.00nan;0;0
11865;-1;178;74;36;3;33;.917;3600000;0
11867;189902;204;0;0;0;0;.00nan;0;0
11867;175900;192;17;20;6;14;.700;3600000;0
11867;-1;192;0;0;0;0;.00nan;0;0
11867;182049;204;80;29;3;26;.897;3600000;0
11869;195238;200;86;36;2;34;.944;3578000;0
11869;179430;229;0;0;0;0;.00nan;0;0
11869;185800;229;100;31;0;31;1.000;3600000;0
11869;187295;200;0;0;0;0;.00nan;0;0
11871;169096;190;75;28;2;26;.929;3600000;0
11871;171405;2620;0;0;0;0;.00nan;0;0
11871;-1;2620;55;32;3;29;.906;3554000;0
11871;197704;190;0;0;0;0;.00nan;0;0
11873;170114;4959;95;47;3;44;.936;3900000;0
11873;195363;4959;0;0;0;0;.00nan;0;0
11873;179388;182;0;0;0;0;.00nan;0;0
11873;182116;182;67;32;3;29;.906;3900000;0
11875;174209;178;61;37;4;33;.892;2117000;0
11875;176200;195;88;16;0;16;1.000;3600000;0
11875;179647;195;0;0;0;0;.00nan;0;0
11875;-1;178;63;10;0;10;1.000;1483000;0
11877;179400;183;0;0;0;0;.00nan;0;0
11877;181338;230;0;0;0;0;.00nan;0;0
11877;182089;183;91;42;3;39;.929;3600000;0
11877;186495;230;66;14;1;13;.929;3600000;0
11879;171662;176;50;42;6;36;.857;3600000;0
11879;179406;232;74;25;1;24;.960;3600000;0
11879;179434;232;0;0;0;0;.00nan;0;0
11879;176932;176;0;0;0;0;.00nan;0;0
11881;-1;203;64;8;0;8;1.000;1155000;0
11881;175364;206;0;0;0;0;.00nan;0;0
11881;-1;203;26;30;6;24;.800;2445000;0
11881;196283;206;84;28;1;27;.964;3600000;0
11883;166762;213;100;43;2;41;.953;3900000;0
11883;180575;213;0;0;0;0;.00nan;0;0
11883;187240;216;78;27;2;25;.926;3900000;0
11883;191557;216;0;0;0;0;.00nan;0;0
11885;167404;215;57;18;2;16;.889;3600000;0
11885;165731;215;0;0;0;0;.00nan;0;0
11885;174325;197;58;38;5;33;.868;3552000;0
11885;175436;197;0;0;0;0;.00nan;0;0
11887;179602;177;57;30;3;27;.900;3597000;0
11887;176672;177;0;0;0;0;.00nan;0;0
11887;180623;202;0;0;0;0;.00nan;0;0
11887;192498;202;78;27;1;26;.963;3600000;0
11889;174147;179;71;34;3;31;.912;3900000;0
11889;171405;2620;63;32;3;29;.906;3900000;0
11889;-1;2620;0;0;0;0;.00nan;0;0
11889;187355;179;0;0;0;0;.00nan;0;0
11891;173340;231;97;26;0;26;1.000;3600000;0
11891;-1;4949;64;32;3;29;.906;3600000;0
11891;195251;4949;0;0;0;0;.00nan;0;0
11891;185034;231;0;0;0;0;.00nan;0;0
11893;169166;226;58;29;3;26;.897;3550000;0
11893;-1;196;84;34;2;32;.941;3600000;0
11893;184648;196;0;0;0;0;.00nan;0;0
11893;192629;226;0;0;0;0;.00nan;0;0
11895;175370;199;0;0;0;0;.00nan;0;0
11895;-1;207;0;0;0;0;.00nan;0;0
11895;-1;207;78;27;1;26;.963;3600000;0
11895;161006;199;57;25;3;22;.880;3518000;0
11897;171730;220;42;20;4;16;.800;1789000;0
11897;-1;227;25;25;6;19;.760;2970000;0
11897;187217;227;61;8;0;8;1.000;582000;0
11897;187443;220;62;18;1;17;.944;1811000;0
11899;195164;218;75;26;2;24;.923;3900000;0
11899;190034;217;0;0;0;0;.00nan;0;0
11899;190041;217;82;40;2;38;.950;3900000;0
11899;192457;218;0;0;0;0;.00nan;0;0
11901;168907;186;0;0;0;0;.00nan;0;0
11901;184069;208;0;0;0;0;.00nan;0;0
11901;169226;186;87;36;1;35;.972;3600000;0
11901;179702;208;49;29;4;25;.862;3600000;0
11903;-1;205;62;17;2;15;.882;3660000;0
11903;187092;205;0;0;0;0;.00nan;0;0
11903;-1;214;96;35;1;34;.971;3660000;0
11903;191518;214;0;0;0;0;.00nan;0;0
11905;195238;200;0;0;0;0;.00nan;0;0
11905;190125;184;44;26;4;22;.846;3900000;0
11905;179668;184;0;0;0;0;.00nan;0;0
11905;187295;200;79;44;4;40;.909;3900000;0
11907;171839;189;0;0;0;0;.00nan;0;0
11907;-1;211;81;25;1;24;.960;3600000;0
11907;-1;189;69;34;3;31;.912;3530000;0
11907;179646;211;0;0;0;0;.00nan;0;0
11909;166545;193;45;18;3;15;.833;3600000;0
11909;169096;190;0;0;0;0;.00nan;0;0
11909;186451;193;0;0;0;0;.00nan;0;0
11909;197704;190;71;45;4;41;.911;3600000;0
11911;182454;4864;76;41;3;38;.927;3551000;0
11911;182467;185;67;24;2;22;.917;3600000;0
11911;183737;4864;0;0;0;0;.00nan;0;0
11911;180110;185;0;0;0;0;.00nan;0;0
11913;-1;221;0;0;0;0;.00nan;0;0
11913;175900;192;0;0;0;0;.00nan;0;0
11913;-1;192;70;30;3;27;.900;3600000;0
11913;187362;221;100;41;0;41;1.000;3600000;0
11915;184175;224;0;0;0;0;.00nan;0;0
11915;180762;1505;0;0;0;0;.00nan;0;0
11915;185840;224;92;61;1;60;.984;3768000;0
11915;186549;1505;84;17;0;17;1.000;3768000;0
11917;194893;191;49;23;4;19;.826;3600000;0
11917;180578;181;0;0;0;0;.00nan;0;0
11917;-1;181;92;37;1;36;.973;3600000;0
11917;197090;191;0;0;0;0;.00nan;0;0
11919;179169;209;0;0;0;0;.00nan;0;0
11919;179430;229;0;0;0;0;.00nan;0;0
11919;185800;229;60;20;2;18;.900;3545000;0
11919;186205;209;85;31;1;30;.968;3600000;0
11921;192862;187;61;24;2;22;.917;3583000;0
11921;189081;187;0;0;0;0;.00nan;0;0
11921;-1;1371;0;0;0;0;.00nan;0;0
11921;192688;1371;100;45;1;44;.978;3600000;0
11923;177248;201;0;0;0;0;.00nan;0;0
11923;179679;212;0;0;0;0;.00nan;0;0
11923;185743;201;64;38;3;35;.921;3600000;0
11923;186641;212;82;14;0;14;1.000;3600000;0
11925;168954;228;59;34;4;30;.882;3558000;0
11925;-1;210;76;25;2;23;.920;3600000;0
11925;175354;228;0;0;0;0;.00nan;0;0
11925;192461;210;0;0;0;0;.00nan;0;0
11927;179197;198;0;0;0;0;.00nan;0;0
11927;175423;223;0;0;0;0;.00nan;0;0
11927;181431;198;61;23;3;20;.870;3600000;0
11927;187118;223;81;45;4;41;.911;3571000;0
11929;178394;188;0;0;0;0;.00nan;0;0
11929;174153;188;60;25;3;22;.880;3600000;0
11929;176938;180;44;28;5;23;.821;3534000;0
11929;-1;180;0;0;0;0;.00nan;0;0
11931;189885;225;64;39;4;35;.897;3900000;0
11931;189902;204;86;50;4;46;.920;3900000;0
11931;184785;225;0;0;0;0;.00nan;0;0
11931;182049;204;0;0;0;0;.00nan;0;0
11933;171835;4960;66;33;3;30;.909;3520000;0
11933;194219;4960;0;0;0;0;.00nan;0;0
11933;170351;194;0;0;0;0;.00nan;0;0
11933;196352;194;87;32;1;31;.969;3600000;0
11935;184610;222;39;24;4;20;.833;3600000;0
11935;181065;219;0;0;0;0;.00nan;0;0
11935;181102;219;76;30;3;27;.900;3600000;0
11935;185851;222;0;0;0;0;.00nan;0;0
543;166545;193;87;40;1;39;.975;4697000;0
543;173770;193;0;0;0;0;.00nan;0;0
543;179388;182;0;0;0;0;.00nan;0;0
543;182116;182;93;53;2;51;.962;4697000;0
544;171835;4960;68;39;3;36;.923;3529000;0
544;168117;192;0;0;0;0;.00nan;0;0
544;194219;4960;0;0;0;0;.00nan;0;0
544;-1;192;75;17;1;16;.941;3600000;0
545;194416;191;0;0;0;0;.00nan;0;0
545;169166;226;93;24;0;24;1.000;3600000;0
545;194893;191;57;33;4;29;.879;3600000;0
545;192629;226;0;0;0;0;.00nan;0;0
546;176200;195;57;14;2;12;.857;3600000;0
546;179647;195;0;0;0;0;.00nan;0;0
546;181065;219;0;0;0;0;.00nan;0;0
546;181102;219;66;51;6;45;.882;3600000;0
547;-1;210;0;0;0;0;.00nan;0;0
547;176938;180;66;20;2;18;.900;3600000;0
547;-1;180;0;0;0;0;.00nan;0;0
547;192461;210;73;29;3;26;.897;3559000;0
548;173340;231;0;0;0;0;.00nan;0;0
548;185034;231;91;29;1;28;.966;3600000;0
548;180578;181;0;0;0;0;.00nan;0;0
548;-1;181;76;32;2;30;.938;3600000;0
549;180623;202;0;0;0;0;.00nan;0;0
549;181338;230;0;0;0;0;.00nan;0;0
549;186495;230;56;15;2;13;.867;3600000;0
549;192498;202;77;36;3;33;.917;3578000;0
550;192862;187;0;0;0;0;.00nan;0;0
550;189081;187;68;42;5;37;.881;3600000;0
550;180762;1505;33;33;6;27;.818;3546000;0
550;186549;1505;0;0;0;0;.00nan;0;0
781;166545;193;54;24;3;21;.875;3600000;0
781;168117;192;0;0;0;0;.00nan;0;0
781;173770;193;0;0;0;0;.00nan;0;0
781;-1;192;72;30;2;28;.933;3600000;0
782;169166;226;80;39;4;35;.897;3854000;0
782;176200;195;55;29;3;26;.897;3854000;0
782;179647;195;0;0;0;0;.00nan;0;0
782;192629;226;0;0;0;0;.00nan;0;0
783;173340;231;0;0;0;0;.00nan;0;0
783;176938;180;51;34;5;29;.853;3600000;0
783;185034;231;80;24;1;23;.958;3600000;0
783;-1;180;0;0;0;0;.00nan;0;0
784;192862;187;0;0;0;0;.00nan;0;0
784;189081;187;74;34;3;31;.912;3600000;0
784;181338;230;0;0;0;0;.00nan;0;0
784;186495;230;23;11;4;7;.636;3549000;0
916;168117;192;0;0;0;0;.00nan;0;0
916;176200;195;77;26;2;24;.923;4514000;0
916;179647;195;0;0;0;0;.00nan;0;0
916;-1;192;99;39;1;38;.974;4514000;0
917;192862;187;0;0;0;0;.00nan;0;0
917;189081;187;72;31;2;29;.935;3560000;0
917;173340;231;0;0;0;0;.00nan;0;0
917;185034;231;84;22;1;21;.955;3600000;0
1068;168117;192;0;0;0;0;.00nan;0;0
1068;173340;231;0;0;0;0;.00nan;0;0
1068;-1;192;82;35;2;33;.943;3575000;0
1068;185034;231;63;20;1;19;.950;3600000;0
11936;13976;710;0;0;0;0;.00nan;0;0
11936;53857;711;0;0;0;0;.00nan;0;0
11936;77086;710;86;31;1;30;.968;3600000;0
11936;85935;711;42;27;5;22;.815;3600000;0
11937;8478;714;0;0;0;0;.00nan;0;0
11937;11882;706;65;31;3;28;.903;3900000;0
11937;17565;714;62;22;3;19;.864;3900000;0
11937;71648;706;0;0;0;0;.00nan;0;0
11938;883;707;0;0;0;0;.00nan;0;0
11938;1213;713;0;0;0;0;.00nan;0;0
11938;41399;713;43;15;3;12;.800;3600000;0
11938;156932;707;71;43;4;39;.907;3544000;0
11939;5997;712;0;0;0;0;.00nan;0;0
11939;18801;2465;97;38;1;37;.974;3588000;0
11939;61425;712;100;23;0;23;1.000;3600000;0
11939;145636;2465;0;0;0;0;.00nan;0;0
11940;31165;2473;0;0;0;0;.00nan;0;0
11940;35897;2474;0;0;0;0;.00nan;0;0
11940;181748;2473;57;11;1;10;.909;3600000;0
11940;72229;2474;66;36;4;32;.889;3600000;0
11941;5997;712;0;0;0;0;.00nan;0;0
11941;8478;714;0;0;0;0;.00nan;0;0
11941;17565;714;69;30;3;27;.900;3600000;0
11941;61425;712;100;26;0;26;1.000;3600000;0
11942;13976;710;0;0;0;0;.00nan;0;0
11942;35897;2474;0;0;0;0;.00nan;0;0
11942;72229;2474;90;35;1;34;.971;3600000;0
11942;77086;710;51;13;2;11;.846;3546000;0
11943;1213;713;90;29;1;28;.966;3600000;0
11943;8478;714;60;38;4;34;.895;3600000;0
11943;17565;714;0;0;0;0;.00nan;0;0
11943;41399;713;0;0;0;0;.00nan;0;0
11944;11882;706;64;24;2;22;.917;3543000;0
11944;18801;2465;0;0;0;0;.00nan;0;0
11944;71648;706;0;0;0;0;.00nan;0;0
11944;145636;2465;86;31;1;30;.968;3600000;0
11945;883;707;62;12;1;11;.917;605000;0
11945;31165;2473;39;15;3;12;.800;3600000;0
11945;181748;2473;0;0;0;0;.00nan;0;0
11945;156932;707;44;35;6;29;.829;2995000;0
11946;5997;712;50;2;0;2;1.000;371000;0
11946;53857;711;0;0;0;0;.00nan;0;0
11946;61425;712;51;45;6;39;.867;3229000;0
11946;85935;711;89;16;0;16;1.000;3600000;0
11947;8478;714;0;0;0;0;.00nan;0;0
11947;17565;714;48;23;4;19;.826;3600000;0
11947;35897;2474;91;42;2;40;.952;3036000;0
11947;72229;2474;28;7;3;4;.571;544000;0
11948;5997;712;0;0;0;0;.00nan;0;0
11948;13976;710;0;0;0;0;.00nan;0;0
11948;61425;712;90;53;4;49;.925;3560000;0
11948;77086;710;44;13;2;11;.846;3600000;0
11949;11882;706;98;31;1;30;.968;3600000;0
11949;31165;2473;34;25;5;20;.800;3600000;0
11949;181748;2473;0;0;0;0;.00nan;0;0
11949;71648;706;0;0;0;0;.00nan;0;0
11950;883;707;58;40;6;34;.850;3092000;0
11950;53857;711;0;0;0;0;.00nan;0;0
11950;85935;711;38;22;4;18;.818;3600000;0
11950;156932;707;59;7;0;7;1.000;508000;0
11951;1213;713;100;24;0;24;1.000;3600000;0
11951;18801;2465;0;0;0;0;.00nan;0;0
11951;41399;713;0;0;0;0;.00nan;0;0
11951;145636;2465;58;44;6;38;.864;3600000;0
11952;18801;2465;0;0;0;0;.00nan;0;0
11952;31165;2473;83;18;0;18;1.000;3600000;0
11952;181748;2473;0;0;0;0;.00nan;0;0
11952;145636;2465;69;37;3;34;.919;3600000;0
11953;883;707;56;16;2;14;.875;964000;0
11953;13976;710;0;0;0;0;.00nan;0;0
11953;77086;710;53;13;2;11;.846;3600000;0
11953;156932;707;35;33;6;27;.818;2636000;0
11954;5997;712;0;0;0;0;.00nan;0;0
11954;35897;2474;0;0;0;0;.00nan;0;0
11954;61425;712;74;22;1;21;.955;3600000;0
11954;72229;2474;54;52;7;45;.865;3600000;0
11955;1213;713;100;30;0;30;1.000;3900000;0
11955;31165;2473;96;25;0;25;1.000;3900000;0
11955;181748;2473;0;0;0;0;.00nan;0;0
11955;41399;713;0;0;0;0;.00nan;0;0
11956;11882;706;32;35;6;29;.829;2136000;0
11956;53857;711;0;0;0;0;.00nan;0;0
11956;71648;706;58;13;1;12;.923;1464000;0
11956;85935;711;79;17;0;17;1.000;3600000;0
11957;8478;714;42;16;3;13;.813;3622000;0
11957;17565;714;0;0;0;0;.00nan;0;0
11957;18801;2465;62;34;4;30;.882;3638000;0
11957;145636;2465;0;0;0;0;.00nan;0;0
11958;1213;713;72;37;2;35;.946;3900000;0
11958;41399;713;0;0;0;0;.00nan;0;0
11958;53857;711;0;0;0;0;.00nan;0;0
11958;85935;711;74;25;2;23;.920;3900000;0
11959;883;707;40;24;5;19;.792;3600000;0
11959;35897;2474;0;0;0;0;.00nan;0;0
11959;72229;2474;61;17;2;15;.882;3600000;0
11959;156932;707;0;0;0;0;.00nan;0;0
11960;5997;712;0;0;0;0;.00nan;0;0
11960;8478;714;0;0;0;0;.00nan;0;0
11960;17565;714;48;29;5;24;.828;3558000;0
11960;61425;712;47;28;4;24;.857;3600000;0
11961;11882;706;72;29;2;27;.931;3600000;0
11961;13976;710;0;0;0;0;.00nan;0;0
11961;71648;706;0;0;0;0;.00nan;0;0
11961;77086;710;89;31;1;30;.968;3600000;0
11962;18801;2465;0;0;0;0;.00nan;0;0
11962;31165;2473;57;18;2;16;.889;3600000;0
11962;181748;2473;0;0;0;0;.00nan;0;0
11962;145636;2465;79;41;3;38;.927;3547000;0
11963;883;707;89;30;1;29;.967;3336000;0
11963;11882;706;52;31;4;27;.871;3900000;0
11963;71648;706;0;0;0;0;.00nan;0;0
11963;156932;707;23;5;3;2;.400;564000;0
11964;1213;713;59;33;4;29;.879;3570000;0
11964;13976;710;0;0;0;0;.00nan;0;0
11964;41399;713;0;0;0;0;.00nan;0;0
11964;77086;710;72;28;2;26;.929;3600000;0
11965;883;707;0;0;0;0;.00nan;0;0
11965;5997;712;0;0;0;0;.00nan;0;0
11965;61425;712;100;27;0;27;1.000;3600000;0
11965;156932;707;40;40;7;33;.825;3600000;0
11966;11882;706;42;20;3;17;.850;3591000;0
11966;35897;2474;0;0;0;0;.00nan;0;0
11966;71648;706;0;0;0;0;.00nan;0;0
11966;72229;2474;71;29;2;27;.931;3600000;0
11967;8478;714;0;0;0;0;.00nan;0;0
11967;17565;714;45;32;5;27;.844;3600000;0
11967;31165;2473;0;0;0;0;.00nan;0;0
11967;181748;2473;100;46;0;46;1.000;3600000;0
11968;18801;2465;55;48;6;42;.875;2920000;0
11968;53857;711;0;0;0;0;.00nan;0;0
11968;85935;711;80;20;1;19;.950;3600000;0
11968;145636;2465;55;4;0;4;1.000;680000;0
11969;5997;712;0;0;0;0;.00nan;0;0
11969;11882;706;76;32;3;29;.906;3520000;0
11969;61425;712;70;21;1;20;.952;3600000;0
11969;71648;706;0;0;0;0;.00nan;0;0
11970;13976;710;0;0;0;0;.00nan;0;0
11970;18801;2465;0;0;0;0;.00nan;0;0
11970;77086;710;70;17;1;16;.941;3564000;0
11970;145636;2465;100;32;0;32;1.000;3600000;0
11971;31165;2473;0;0;0;0;.00nan;0;0
11971;181748;2473;65;30;3;27;.900;3600000;0
11971;53857;711;0;0;0;0;.00nan;0;0
11971;85935;711;59;41;5;36;.878;3541000;0
11972;883;707;0;0;0;0;.00nan;0;0
11972;8478;714;67;15;1;14;.933;3600000;0
11972;17565;714;0;0;0;0;.00nan;0;0
11972;156932;707;54;26;3;23;.885;3571000;0
11973;1213;713;33;26;5;21;.808;3600000;0
11973;35897;2474;0;0;0;0;.00nan;0;0
11973;41399;713;0;0;0;0;.00nan;0;0
11973;72229;2474;77;31;2;29;.935;3600000;0
11974;13976;710;0;0;0;0;.00nan;0;0
11974;31165;2473;67;23;2;21;.913;3600000;0
11974;181748;2473;0;0;0;0;.00nan;0;0
11974;77086;710;45;26;4;22;.846;3541000;0
11975;1213;713;97;21;0;21;1.000;3600000;0
11975;5997;712;0;0;0;0;.00nan;0;0
11975;41399;713;0;0;0;0;.00nan;0;0
11975;61425;712;75;25;2;23;.920;3570000;0
11976;18801;2465;0;0;0;0;.00nan;0;0
11976;35897;2474;45;28;4;24;.857;3589000;0
11976;72229;2474;0;0;0;0;.00nan;0;0
11976;145636;2465;66;31;3;28;.903;3600000;0
11977;8478;714;47;21;4;17;.810;3575000;0
11977;17565;714;0;0;0;0;.00nan;0;0
11977;53857;711;0;0;0;0;.00nan;0;0
11977;85935;711;58;29;3;26;.897;3600000;0
11978;13976;710;0;0;0;0;.00nan;0;0
11978;53857;711;58;7;0;7;1.000;840000;0
11978;77086;710;66;30;3;27;.900;3600000;0
11978;85935;711;27;27;6;21;.778;2760000;0
11979;5997;712;0;0;0;0;.00nan;0;0
11979;18801;2465;83;43;2;41;.953;3547000;0
11979;61425;712;65;16;1;15;.938;3600000;0
11979;145636;2465;0;0;0;0;.00nan;0;0
11980;883;707;91;34;1;33;.971;3600000;0
11980;1213;713;100;21;0;21;1.000;3600000;0
11980;41399;713;0;0;0;0;.00nan;0;0
11980;156932;707;0;0;0;0;.00nan;0;0
11981;31165;2473;0;0;0;0;.00nan;0;0
11981;35897;2474;0;0;0;0;.00nan;0;0
11981;181748;2473;100;27;0;27;1.000;3600000;0
11981;72229;2474;88;29;1;28;.966;3600000;0
11982;8478;714;0;0;0;0;.00nan;0;0
11982;11882;706;75;25;1;24;.960;3600000;0
11982;17565;714;86;34;2;32;.941;3542000;0
11982;71648;706;0;0;0;0;.00nan;0;0
11983;8478;714;72;42;5;37;.881;3600000;0
11983;13976;710;37;7;2;5;.714;1195000;0
11983;17565;714;0;0;0;0;.00nan;0;0
11983;77086;710;22;16;6;10;.625;2405000;0
11984;1213;713;65;23;3;20;.870;3600000;0
11984;11882;706;59;34;4;30;.882;3600000;0
11984;41399;713;0;0;0;0;.00nan;0;0
11984;71648;706;0;0;0;0;.00nan;0;0
11985;5997;712;0;0;0;0;.00nan;0;0
11985;31165;2473;0;0;0;0;.00nan;0;0
11985;181748;2473;100;26;0;26;1.000;3600000;0
11985;61425;712;76;41;4;37;.902;3600000;0
11986;35897;2474;31;28;6;22;.786;2623000;0
11986;53857;711;0;0;0;0;.00nan;0;0
11986;72229;2474;34;14;4;10;.714;977000;0
11986;85935;711;55;13;1;12;.923;3600000;0
11987;1213;713;51;33;5;28;.848;3600000;0
11987;8478;714;95;23;0;23;1.000;3600000;0
11987;17565;714;0;0;0;0;.00nan;0;0
11987;41399;713;0;0;0;0;.00nan;0;0
11988;5997;712;41;3;1;2;.667;544000;0
11988;53857;711;0;0;0;0;.00nan;0;0
11988;61425;712;27;28;6;22;.786;3056000;0
11988;85935;711;75;28;1;27;.964;3600000;0
11989;883;707;0;0;0;0;.00nan;0;0
11989;31165;2473;68;14;1;13;.929;3600000;0
11989;181748;2473;0;0;0;0;.00nan;0;0
11989;156932;707;87;40;2;38;.950;3577000;0
11990;13976;710;0;0;0;0;.00nan;0;0
11990;35897;2474;0;0;0;0;.00nan;0;0
11990;72229;2474;63;41;4;37;.902;3600000;0
11990;77086;710;94;17;0;17;1.000;3600000;0
11991;11882;706;50;24;3;21;.875;3900000;0
11991;18801;2465;98;45;3;42;.933;3900000;0
11991;71648;706;0;0;0;0;.00nan;0;0
11991;145636;2465;0;0;0;0;.00nan;0;0
11992;8478;714;91;26;1;25;.962;3600000;0
11992;17565;714;0;0;0;0;.00nan;0;0
11992;18801;2465;0;0;0;0;.00nan;0;0
11992;145636;2465;90;50;2;48;.960;3600000;0
11993;5997;712;50;1;0;1;1.000;363000;0
11993;35897;2474;0;0;0;0;.00nan;0;0
11993;61425;712;39;32;6;26;.813;3237000;0
11993;72229;2474;82;36;2;34;.944;3600000;0
11994;11882;706;8;16;6;10;.625;1213000;0
11994;53857;711;0;0;0;0;.00nan;0;0
11994;71648;706;73;28;2;26;.929;2387000;0
11994;85935;711;56;22;3;19;.864;3600000;0
11995;1213;713;0;0;0;0;.00nan;0;0
11995;31165;2473;0;0;0;0;.00nan;0;0
11995;181748;2473;100;21;0;21;1.000;3600000;0
11995;41399;713;66;26;2;24;.923;3547000;0
11996;883;707;34;12;3;9;.750;532000;0
11996;13976;710;0;0;0;0;.00nan;0;0
11996;77086;710;78;31;2;29;.935;3600000;0
11996;156932;707;88;40;2;38;.950;3068000;0
11997;5997;712;0;0;0;0;.00nan;0;0
11997;31165;2473;99;22;0;22;1.000;3600000;0
11997;181748;2473;0;0;0;0;.00nan;0;0
11997;61425;712;48;33;5;28;.848;3600000;0
11998;11882;706;53;35;5;30;.857;3567000;0
11998;13976;710;50;25;4;21;.840;3600000;0
11998;71648;706;0;0;0;0;.00nan;0;0
11998;77086;710;0;0;0;0;.00nan;0;0
11999;883;707;87;32;1;31;.969;3600000;0
11999;35897;2474;58;34;4;30;.882;3600000;0
11999;72229;2474;0;0;0;0;.00nan;0;0
11999;156932;707;0;0;0;0;.00nan;0;0
12000;1213;713;100;28;0;28;1.000;3600000;0
12000;41399;713;0;0;0;0;.00nan;0;0
12000;53857;711;0;0;0;0;.00nan;0;0
12000;85935;711;50;19;3;16;.842;3600000;0
12001;883;707;0;0;0;0;.00nan;0;0
12001;18801;2465;43;30;5;25;.833;3600000;0
12001;145636;2465;0;0;0;0;.00nan;0;0
12001;156932;707;76;31;2;29;.935;3600000;0
12002;8478;714;68;19;2;17;.895;3756000;0
12002;17565;714;0;0;0;0;.00nan;0;0
12002;31165;2473;100;34;1;33;.971;3756000;0
12002;181748;2473;0;0;0;0;.00nan;0;0
12003;11882;706;64;17;1;16;.941;3600000;0
12003;35897;2474;46;5;1;4;.800;307000;0
12003;71648;706;0;0;0;0;.00nan;0;0
12003;72229;2474;39;36;6;30;.833;3293000;0
12004;1213;713;51;28;4;24;.857;3655000;0
12004;13976;710;0;0;0;0;.00nan;0;0
12004;41399;713;0;0;0;0;.00nan;0;0
12004;77086;710;47;30;5;25;.833;3655000;0
12005;18801;2465;57;6;0;6;1.000;936000;0
12005;53857;711;0;0;0;0;.00nan;0;0
12005;85935;711;50;16;2;14;.875;3600000;0
12005;145636;2465;51;37;6;31;.838;2664000;0
12006;883;707;0;0;0;0;.00nan;0;0
12006;5997;712;0;0;0;0;.00nan;0;0
12006;61425;712;70;22;1;21;.955;3600000;0
12006;156932;707;80;43;3;40;.930;3526000;0
12007;883;707;0;0;0;0;.00nan;0;0
12007;8478;714;61;16;1;15;.938;3600000;0
12007;17565;714;0;0;0;0;.00nan;0;0
12007;156932;707;90;57;3;54;.947;3559000;0
12008;13976;710;0;0;0;0;.00nan;0;0
12008;18801;2465;100;45;0;45;1.000;3600000;0
12008;77086;710;83;23;1;22;.957;3585000;0
12008;145636;2465;0;0;0;0;.00nan;0;0
12009;1213;713;65;19;1;18;.947;3600000;0
12009;35897;2474;54;5;0;5;1.000;494000;0
12009;41399;713;0;0;0;0;.00nan;0;0
12009;72229;2474;73;48;6;42;.875;3106000;0
12010;31165;2473;0;0;0;0;.00nan;0;0
12010;181748;2473;82;36;2;34;.944;3900000;0
12010;53857;711;0;0;0;0;.00nan;0;0
12010;85935;711;52;23;2;21;.913;3900000;0
12011;5997;712;0;0;0;0;.00nan;0;0
12011;11882;706;0;0;0;0;.00nan;0;0
12011;61425;712;47;24;4;20;.833;3535000;0
12011;71648;706;82;36;2;34;.944;3600000;0
12012;8478;714;63;36;4;32;.889;3900000;0
12012;17565;714;0;0;0;0;.00nan;0;0
12012;53857;711;64;10;0;10;1.000;2831000;0
12012;85935;711;15;5;4;1;.200;1069000;0
12013;1213;713;77;23;1;22;.957;3600000;0
12013;5997;712;0;0;0;0;.00nan;0;0
12013;41399;713;0;0;0;0;.00nan;0;0
12013;61425;712;67;43;5;38;.884;3600000;0
12014;18801;2465;0;0;0;0;.00nan;0;0
12014;35897;2474;0;0;0;0;.00nan;0;0
12014;72229;2474;43;24;4;20;.833;3900000;0
12014;145636;2465;66;29;4;25;.862;3900000;0
12015;883;707;0;0;0;0;.00nan;0;0
12015;11882;706;63;20;2;18;.900;3600000;0
12015;71648;706;0;0;0;0;.00nan;0;0
12015;156932;707;57;28;3;25;.893;3544000;0
12016;13976;710;0;0;0;0;.00nan;0;0
12016;31165;2473;0;0;0;0;.00nan;0;0
12016;181748;2473;65;25;2;23;.920;3600000;0
12016;77086;710;62;31;4;27;.871;3516000;0
12017;883;707;0;0;0;0;.00nan;0;0
12017;1213;713;64;17;1;16;.941;3582000;0
12017;41399;713;0;0;0;0;.00nan;0;0
12017;156932;707;100;28;0;28;1.000;3600000;0
12018;5997;712;0;0;0;0;.00nan;0;0
12018;18801;2465;26;13;4;9;.692;747000;0
12018;61425;712;54;16;3;13;.813;3600000;0
12018;145636;2465;87;48;3;45;.938;2853000;0
12019;31165;2473;73;27;2;25;.926;3748000;0
12019;35897;2474;0;0;0;0;.00nan;0;0
12019;181748;2473;0;0;0;0;.00nan;0;0
12019;72229;2474;92;42;3;39;.929;3709000;0
12020;13976;710;0;0;0;0;.00nan;0;0
12020;53857;711;51;2;0;2;1.000;374000;0
12020;77086;710;63;23;2;21;.913;3600000;0
12020;85935;711;50;35;6;29;.829;3226000;0
12021;8478;714;0;0;0;0;.00nan;0;0
12021;11882;706;28;33;6;27;.818;3272000;0
12021;17565;714;92;36;2;34;.944;3600000;0
12021;71648;706;49;2;0;2;1.000;328000;0
12022;883;707;97;30;0;30;1.000;2536000;0
12022;53857;711;0;0;0;0;.00nan;0;0
12022;85935;711;82;12;0;12;1.000;3600000;0
12022;156932;707;7;15;6;9;.600;1064000;0
12023;8478;714;58;34;4;30;.882;3600000;0
12023;13976;710;0;0;0;0;.00nan;0;0
12023;17565;714;0;0;0;0;.00nan;0;0
12023;77086;710;56;29;3;26;.897;3600000;0
12024;5997;712;75;32;3;29;.906;3600000;0
12024;31165;2473;0;0;0;0;.00nan;0;0
12024;181748;2473;50;29;4;25;.862;3562000;0
12024;61425;712;0;0;0;0;.00nan;0;0
12025;1213;713;92;39;2;37;.949;3600000;0
12025;11882;706;72;21;1;20;.952;3600000;0
12025;41399;713;0;0;0;0;.00nan;0;0
12025;71648;706;0;0;0;0;.00nan;0;0
12026;883;707;71;25;3;22;.880;3900000;0
12026;18801;2465;0;0;0;0;.00nan;0;0
12026;145636;2465;79;35;3;32;.914;3900000;0
12026;156932;707;0;0;0;0;.00nan;0;0
12027;35897;2474;0;0;0;0;.00nan;0;0
12027;53857;711;0;0;0;0;.00nan;0;0
12027;72229;2474;58;47;6;41;.872;3600000;0
12027;85935;711;36;17;4;13;.765;3600000;0
12028;13976;710;71;25;2;23;.920;3600000;0
12028;35897;2474;48;15;2;13;.867;1587000;0
12028;72229;2474;20;25;6;19;.760;2013000;0
12028;77086;710;0;0;0;0;.00nan;0;0
12029;11882;706;53;24;3;21;.875;3900000;0
12029;18801;2465;94;40;3;37;.925;3900000;0
12029;71648;706;0;0;0;0;.00nan;0;0
12029;145636;2465;0;0;0;0;.00nan;0;0
12030;883;707;0;0;0;0;.00nan;0;0
12030;31165;2473;88;16;0;16;1.000;3600000;0
12030;181748;2473;0;0;0;0;.00nan;0;0
12030;156932;707;57;39;4;35;.897;3600000;0
12031;1213;713;61;44;6;38;.864;3600000;0
12031;8478;714;0;0;0;0;.00nan;0;0
12031;17565;714;45;19;3;16;.842;3600000;0
12031;41399;713;0;0;0;0;.00nan;0;0
12032;5997;712;0;0;0;0;.00nan;0;0
12032;53857;711;0;0;0;0;.00nan;0;0
12032;61425;712;74;37;3;34;.919;3564000;0
12032;85935;711;68;28;2;26;.929;3600000;0
12033;8478;714;0;0;0;0;.00nan;0;0
12033;17565;714;83;16;0;16;1.000;3600000;0
12033;35897;2474;0;0;0;0;.00nan;0;0
12033;72229;2474;84;41;3;38;.927;3600000;0
12034;5997;712;0;0;0;0;.00nan;0;0
12034;13976;710;0;0;0;0;.00nan;0;0
12034;61425;712;94;26;1;25;.962;3600000;0
12034;77086;710;51;25;3;22;.880;3600000;0
12035;11882;706;87;32;1;31;.969;3600000;0
12035;31165;2473;65;20;2;18;.900;3551000;0
12035;181748;2473;0;0;0;0;.00nan;0;0
12035;71648;706;0;0;0;0;.00nan;0;0
12036;1213;713;49;14;2;12;.857;3600000;0
12036;18801;2465;0;0;0;0;.00nan;0;0
12036;41399;713;0;0;0;0;.00nan;0;0
12036;145636;2465;55;41;5;36;.878;3600000;0
12037;883;707;0;0;0;0;.00nan;0;0
12037;13976;710;0;0;0;0;.00nan;0;0
12037;77086;710;57;13;1;12;.923;3600000;0
12037;156932;707;56;54;6;48;.889;3600000;0
12038;8478;714;66;22;2;20;.909;3600000;0
12038;17565;714;0;0;0;0;.00nan;0;0
12038;18801;2465;0;0;0;0;.00nan;0;0
12038;145636;2465;84;36;3;33;.917;3600000;0
12039;5997;712;0;0;0;0;.00nan;0;0
12039;35897;2474;92;38;1;37;.974;3900000;0
12039;61425;712;98;33;1;32;.970;3900000;0
12039;72229;2474;0;0;0;0;.00nan;0;0
12040;1213;713;32;24;5;19;.792;3600000;0
12040;31165;2473;71;22;2;20;.909;3600000;0
12040;181748;2473;0;0;0;0;.00nan;0;0
12040;41399;713;0;0;0;0;.00nan;0;0
12041;11882;706;55;32;4;28;.875;3542000;0
12041;53857;711;0;0;0;0;.00nan;0;0
12041;71648;706;0;0;0;0;.00nan;0;0
12041;85935;711;47;21;3;18;.857;3600000;0
12042;5997;712;0;0;0;0;.00nan;0;0
12042;8478;714;0;0;0;0;.00nan;0;0
12042;17565;714;78;26;1;25;.962;3600000;0
12042;61425;712;49;30;4;26;.867;3600000;0
12043;11882;706;0;0;0;0;.00nan;0;0
12043;13976;710;0;0;0;0;.00nan;0;0
12043;71648;706;46;40;6;34;.850;3600000;0
12043;77086;710;83;24;1;23;.958;3600000;0
12044;1213;713;73;38;3;35;.921;3600000;0
12044;41399;713;0;0;0;0;.00nan;0;0
12044;53857;711;0;0;0;0;.00nan;0;0
12044;85935;711;51;18;2;16;.889;3600000;0
12045;18801;2465;63;46;6;40;.870;3600000;0
12045;31165;2473;59;13;1;12;.923;3600000;0
12045;181748;2473;0;0;0;0;.00nan;0;0
12045;145636;2465;0;0;0;0;.00nan;0;0
12046;883;707;0;0;0;0;.00nan;0;0
12046;35897;2474;0;0;0;0;.00nan;0;0
12046;72229;2474;73;18;1;17;.944;3600000;0
12046;156932;707;72;38;3;35;.921;3521000;0
12047;1213;713;85;44;4;40;.909;3900000;0
12047;13976;710;0;0;0;0;.00nan;0;0
12047;41399;713;0;0;0;0;.00nan;0;0
12047;77086;710;69;34;4;30;.882;3900000;0
12048;883;707;0;0;0;0;.00nan;0;0
12048;5997;712;61;15;1;14;.933;3600000;0
12048;61425;712;0;0;0;0;.00nan;0;0
12048;156932;707;50;33;5;28;.848;3600000;0
12049;11882;706;63;19;1;18;.947;3600000;0
12049;35897;2474;0;0;0;0;.00nan;0;0
12049;71648;706;0;0;0;0;.00nan;0;0
12049;72229;2474;53;39;5;34;.872;3600000;0
12050;8478;714;80;46;3;43;.935;3576000;0
12050;17565;714;0;0;0;0;.00nan;0;0
12050;31165;2473;92;33;1;32;.970;3600000;0
12050;181748;2473;0;0;0;0;.00nan;0;0
12051;18801;2465;0;0;0;0;.00nan;0;0
12051;53857;711;59;14;1;13;.929;3600000;0
12051;85935;711;0;0;0;0;.00nan;0;0
12051;145636;2465;84;46;3;43;.935;3600000;0
12052;5997;712;0;0;0;0;.00nan;0;0
12052;11882;706;74;42;4;38;.905;3900000;0
12052;61425;712;60;23;4;19;.826;3900000;0
12052;71648;706;0;0;0;0;.00nan;0;0
12053;1213;713;64;20;2;18;.900;3600000;0
12053;35897;2474;0;0;0;0;.00nan;0;0
12053;41399;713;0;0;0;0;.00nan;0;0
12053;72229;2474;56;31;4;27;.871;3522000;0
12054;13976;710;0;0;0;0;.00nan;0;0
12054;18801;2465;71;40;3;37;.925;3542000;0
12054;77086;710;85;19;1;18;.947;3600000;0
12054;145636;2465;0;0;0;0;.00nan;0;0
12055;883;707;99;50;1;49;.980;3600000;0
12055;8478;714;0;0;0;0;.00nan;0;0
12055;17565;714;55;17;2;15;.882;3543000;0
12055;156932;707;0;0;0;0;.00nan;0;0
12056;31165;2473;52;23;3;20;.870;3600000;0
12056;181748;2473;0;0;0;0;.00nan;0;0
12056;53857;711;0;0;0;0;.00nan;0;0
12056;85935;711;70;17;1;16;.941;3600000;0
12057;13976;710;0;0;0;0;.00nan;0;0
12057;31165;2473;57;33;4;29;.879;3600000;0
12057;181748;2473;0;0;0;0;.00nan;0;0
12057;77086;710;85;26;1;25;.962;3600000;0
12058;1213;713;34;33;6;27;.818;3600000;0
12058;5997;712;0;0;0;0;.00nan;0;0
12058;41399;713;0;0;0;0;.00nan;0;0
12058;61425;712;47;20;3;17;.850;3600000;0
12059;883;707;85;34;2;32;.941;3566000;0
12059;11882;706;69;18;1;17;.944;3600000;0
12059;71648;706;0;0;0;0;.00nan;0;0
12059;156932;707;0;0;0;0;.00nan;0;0
12060;8478;714;74;44;3;41;.932;3600000;0
12060;17565;714;0;0;0;0;.00nan;0;0
12060;53857;711;0;0;0;0;.00nan;0;0
12060;85935;711;37;18;4;14;.778;3584000;0
12061;18801;2465;0;0;0;0;.00nan;0;0
12061;35897;2474;66;30;3;27;.900;3600000;0
12061;72229;2474;0;0;0;0;.00nan;0;0
12061;145636;2465;37;32;6;26;.813;3600000;0
12062;13976;710;83;38;2;36;.947;3600000;0
12062;53857;711;0;0;0;0;.00nan;0;0
12062;77086;710;0;0;0;0;.00nan;0;0
12062;85935;711;59;16;1;15;.938;3600000;0
12063;5997;712;0;0;0;0;.00nan;0;0
12063;18801;2465;94;54;3;51;.944;3547000;0
12063;61425;712;54;15;2;13;.867;3600000;0
12063;145636;2465;0;0;0;0;.00nan;0;0
12064;8478;714;0;0;0;0;.00nan;0;0
12064;11882;706;22;24;6;18;.750;3151000;0
12064;17565;714;51;16;2;14;.875;3600000;0
12064;71648;706;47;4;1;3;.750;449000;0
12065;883;707;0;0;0;0;.00nan;0;0
12065;1213;713;85;15;0;15;1.000;3600000;0
12065;41399;713;0;0;0;0;.00nan;0;0
12065;156932;707;58;37;5;32;.865;3600000;0
12066;31165;2473;83;32;2;30;.938;3600000;0
12066;35897;2474;0;0;0;0;.00nan;0;0
12066;181748;2473;0;0;0;0;.00nan;0;0
12066;72229;2474;53;37;5;32;.865;3600000;0
12067;8478;714;83;36;2;34;.944;3600000;0
12067;13976;710;0;0;0;0;.00nan;0;0
12067;17565;714;0;0;0;0;.00nan;0;0
12067;77086;710;70;35;3;32;.914;3567000;0
12068;1213;713;56;26;3;23;.885;3600000;0
12068;11882;706;32;23;5;18;.783;3584000;0
12068;41399;713;0;0;0;0;.00nan;0;0
12068;71648;706;0;0;0;0;.00nan;0;0
12069;883;707;0;0;0;0;.00nan;0;0
12069;18801;2465;0;0;0;0;.00nan;0;0
12069;145636;2465;69;34;3;31;.912;3599000;0
12069;156932;707;80;30;1;29;.967;3600000;0
12070;5997;712;0;0;0;0;.00nan;0;0
12070;31165;2473;62;38;4;34;.895;3600000;0
12070;181748;2473;0;0;0;0;.00nan;0;0
12070;61425;712;100;35;0;35;1.000;3600000;0
12071;35897;2474;0;0;0;0;.00nan;0;0
12071;53857;711;0;0;0;0;.00nan;0;0
12071;72229;2474;76;44;4;40;.909;3549000;0
12071;85935;711;42;15;3;12;.800;3600000;0
12072;1213;713;76;38;3;35;.921;3600000;0
12072;8478;714;0;0;0;0;.00nan;0;0
12072;17565;714;65;31;4;27;.871;3558000;0
12072;41399;713;0;0;0;0;.00nan;0;0
12073;5997;712;0;0;0;0;.00nan;0;0
12073;53857;711;0;0;0;0;.00nan;0;0
12073;61425;712;71;28;2;26;.929;3693000;0
12073;85935;711;76;31;3;28;.903;3693000;0
12074;11882;706;87;16;0;16;1.000;3600000;0
12074;18801;2465;69;42;4;38;.905;3600000;0
12074;71648;706;0;0;0;0;.00nan;0;0
12074;145636;2465;0;0;0;0;.00nan;0;0
12075;883;707;0;0;0;0;.00nan;0;0
12075;31165;2473;43;11;2;9;.818;3600000;0
12075;181748;2473;0;0;0;0;.00nan;0;0
12075;156932;707;68;35;3;32;.914;3549000;0
12076;13976;710;0;0;0;0;.00nan;0;0
12076;35897;2474;57;46;6;40;.870;3600000;0
12076;72229;2474;0;0;0;0;.00nan;0;0
12076;77086;710;89;21;0;21;1.000;3600000;0
12077;5997;712;58;20;2;18;.900;2020000;0
12077;13976;710;0;0;0;0;.00nan;0;0
12077;61425;712;31;18;4;14;.778;1580000;0
12077;77086;710;75;27;2;25;.926;3600000;0
12078;1213;713;94;33;1;32;.970;3600000;0
12078;18801;2465;0;0;0;0;.00nan;0;0
12078;41399;713;0;0;0;0;.00nan;0;0
12078;145636;2465;75;35;2;33;.943;3600000;0
12079;8478;714;85;21;1;20;.952;3600000;0
12079;17565;714;0;0;0;0;.00nan;0;0
12079;35897;2474;0;0;0;0;.00nan;0;0
12079;72229;2474;84;44;3;41;.932;3582000;0
12080;11882;706;100;46;2;44;.957;3600000;0
12080;31165;2473;0;0;0;0;.00nan;0;0
12080;181748;2473;64;29;3;26;.897;3600000;0
12080;71648;706;0;0;0;0;.00nan;0;0
12081;883;707;0;0;0;0;.00nan;0;0
12081;53857;711;0;0;0;0;.00nan;0;0
12081;85935;711;100;26;0;26;1.000;3600000;0
12081;156932;707;65;34;3;31;.912;3600000;0
12082;8478;714;0;0;0;0;.00nan;0;0
12082;17565;714;30;16;4;12;.750;3517000;0
12082;18801;2465;92;45;2;43;.956;3600000;0
12082;145636;2465;0;0;0;0;.00nan;0;0
12083;5997;712;0;0;0;0;.00nan;0;0
12083;35897;2474;0;0;0;0;.00nan;0;0
12083;61425;712;65;19;1;18;.947;3600000;0
12083;72229;2474;87;36;2;34;.944;3600000;0
12084;11882;706;74;35;3;32;.914;3572000;0
12084;53857;711;0;0;0;0;.00nan;0;0
12084;71648;706;0;0;0;0;.00nan;0;0
12084;85935;711;59;19;2;17;.895;3600000;0
12085;1213;713;0;0;0;0;.00nan;0;0
12085;31165;2473;70;35;3;32;.914;3550000;0
12085;181748;2473;0;0;0;0;.00nan;0;0
12085;41399;713;65;24;2;22;.917;3600000;0
12086;883;707;0;0;0;0;.00nan;0;0
12086;13976;710;0;0;0;0;.00nan;0;0
12086;77086;710;71;15;1;14;.933;3600000;0
12086;156932;707;63;32;3;29;.906;3569000;0
12087;5997;712;69;29;2;27;.931;3594000;0
12087;8478;714;67;18;1;17;.944;3600000;0
12087;17565;714;0;0;0;0;.00nan;0;0
12087;61425;712;0;0;0;0;.00nan;0;0
12088;883;707;0;0;0;0;.00nan;0;0
12088;35897;2474;60;34;4;30;.882;3600000;0
12088;72229;2474;0;0;0;0;.00nan;0;0
12088;156932;707;61;36;5;31;.861;3591000;0
12089;18801;2465;0;0;0;0;.00nan;0;0
12089;31165;2473;57;20;3;17;.850;3600000;0
12089;181748;2473;0;0;0;0;.00nan;0;0
12089;145636;2465;59;45;6;39;.867;3600000;0
12090;1213;713;23;26;6;20;.769;3600000;0
12090;41399;713;0;0;0;0;.00nan;0;0
12090;53857;711;0;0;0;0;.00nan;0;0
12090;85935;711;61;20;2;18;.900;3600000;0
12091;11882;706;67;33;3;30;.909;3556000;0
12091;13976;710;0;0;0;0;.00nan;0;0
12091;71648;706;0;0;0;0;.00nan;0;0
12091;77086;710;79;26;1;25;.962;3600000;0
12092;8478;714;0;0;0;0;.00nan;0;0
12092;17565;714;82;32;2;30;.938;3547000;0
12092;31165;2473;75;21;1;20;.952;3600000;0
12092;181748;2473;0;0;0;0;.00nan;0;0
12093;11882;706;56;22;3;19;.864;3600000;0
12093;35897;2474;0;0;0;0;.00nan;0;0
12093;71648;706;0;0;0;0;.00nan;0;0
12093;72229;2474;40;29;5;24;.828;3517000;0
12094;1213;713;90;28;1;27;.964;3600000;0
12094;13976;710;0;0;0;0;.00nan;0;0
12094;41399;713;0;0;0;0;.00nan;0;0
12094;77086;710;57;24;2;22;.917;3544000;0
12095;18801;2465;81;34;2;32;.941;3592000;0
12095;53857;711;0;0;0;0;.00nan;0;0
12095;85935;711;80;13;0;13;1.000;3600000;0
12095;145636;2465;0;0;0;0;.00nan;0;0
12096;883;707;0;0;0;0;.00nan;0;0
12096;5997;712;0;0;0;0;.00nan;0;0
12096;61425;712;95;22;0;22;1.000;3600000;0
12096;156932;707;65;36;4;32;.889;3600000;0
12097;13976;710;0;0;0;0;.00nan;0;0
12097;18801;2465;0;0;0;0;.00nan;0;0
12097;77086;710;74;17;1;16;.941;3600000;0
12097;145636;2465;78;46;4;42;.913;3600000;0
12098;883;707;59;46;6;40;.870;2755000;0
12098;8478;714;70;18;1;17;.944;3600000;0
12098;17565;714;0;0;0;0;.00nan;0;0
12098;156932;707;52;13;2;11;.846;845000;0
12099;1213;713;71;25;3;22;.880;3671000;0
12099;35897;2474;81;54;4;50;.926;3671000;0
12099;41399;713;0;0;0;0;.00nan;0;0
12099;72229;2474;0;0;0;0;.00nan;0;0
12100;31165;2473;88;30;1;29;.967;3600000;0
12100;181748;2473;0;0;0;0;.00nan;0;0
12100;53857;711;0;0;0;0;.00nan;0;0
12100;85935;711;64;28;3;25;.893;3600000;0
12101;5997;712;0;0;0;0;.00nan;0;0
12101;11882;706;59;33;4;29;.879;3524000;0
12101;61425;712;63;18;2;16;.889;3600000;0
12101;71648;706;0;0;0;0;.00nan;0;0
12102;8478;714;73;33;3;30;.909;3576000;0
12102;11882;706;62;23;2;21;.913;3600000;0
12102;17565;714;0;0;0;0;.00nan;0;0
12102;71648;706;0;0;0;0;.00nan;0;0
12103;883;707;0;0;0;0;.00nan;0;0
12103;1213;713;48;28;4;24;.857;3600000;0
12103;41399;713;0;0;0;0;.00nan;0;0
12103;156932;707;51;23;3;20;.870;3600000;0
12104;5997;712;0;0;0;0;.00nan;0;0
12104;18801;2465;93;43;2;41;.953;3600000;0
12104;61425;712;45;17;3;14;.824;3571000;0
12104;145636;2465;0;0;0;0;.00nan;0;0
12105;31165;2473;51;19;3;16;.842;3600000;0
12105;35897;2474;33;47;8;39;.830;3600000;0
12105;181748;2473;0;0;0;0;.00nan;0;0
12105;72229;2474;0;0;0;0;.00nan;0;0
12106;13976;710;0;0;0;0;.00nan;0;0
12106;53857;711;0;0;0;0;.00nan;0;0
12106;77086;710;70;39;3;36;.923;3573000;0
12106;85935;711;55;17;2;15;.882;3600000;0
12107;5997;712;0;0;0;0;.00nan;0;0
12107;31165;2473;83;37;2;35;.946;3881000;0
12107;181748;2473;0;0;0;0;.00nan;0;0
12107;61425;712;59;24;3;21;.875;3881000;0
12108;883;707;0;0;0;0;.00nan;0;0
12108;18801;2465;0;0;0;0;.00nan;0;0
12108;145636;2465;61;29;4;25;.862;3600000;0
12108;156932;707;86;32;1;31;.969;3600000;0
12109;35897;2474;41;30;5;25;.833;3600000;0
12109;53857;711;0;0;0;0;.00nan;0;0
12109;72229;2474;0;0;0;0;.00nan;0;0
12109;85935;711;64;19;2;17;.895;3600000;0
12110;8478;714;94;52;3;49;.942;3600000;0
12110;13976;710;67;22;2;20;.909;3600000;0
12110;17565;714;0;0;0;0;.00nan;0;0
12110;77086;710;0;0;0;0;.00nan;0;0
12111;1213;713;79;37;3;34;.919;3531000;0
12111;11882;706;0;0;0;0;.00nan;0;0
12111;41399;713;0;0;0;0;.00nan;0;0
12111;71648;706;82;26;1;25;.962;3600000;0
12112;13976;710;0;0;0;0;.00nan;0;0
12112;35897;2474;28;33;6;27;.818;2327000;0
12112;72229;2474;62;14;1;13;.929;1273000;0
12112;77086;710;78;13;0;13;1.000;3600000;0
12113;1213;713;0;0;0;0;.00nan;0;0
12113;8478;714;0;0;0;0;.00nan;0;0
12113;17565;714;49;19;3;16;.842;3586000;0
12113;41399;713;60;23;2;21;.913;3600000;0
12114;11882;706;28;27;6;21;.778;3600000;0
12114;18801;2465;92;40;1;39;.975;3600000;0
12114;71648;706;0;0;0;0;.00nan;0;0
12114;145636;2465;0;0;0;0;.00nan;0;0
12115;883;707;0;0;0;0;.00nan;0;0
12115;31165;2473;65;23;2;21;.913;3847000;0
12115;181748;2473;0;0;0;0;.00nan;0;0
12115;156932;707;76;39;3;36;.923;3847000;0
12116;5997;712;0;0;0;0;.00nan;0;0
12116;53857;711;0;0;0;0;.00nan;0;0
12116;61425;712;47;22;3;19;.864;3600000;0
12116;85935;711;45;30;5;25;.833;3576000;0
12117;8478;714;61;18;1;17;.944;3600000;0
12117;17565;714;0;0;0;0;.00nan;0;0
12117;35897;2474;0;0;0;0;.00nan;0;0
12117;72229;2474;70;30;3;27;.900;3563000;0
12118;1213;713;62;21;2;19;.905;3600000;0
12118;18801;2465;0;0;0;0;.00nan;0;0
12118;41399;713;0;0;0;0;.00nan;0;0
12118;145636;2465;55;33;5;28;.848;3600000;0
12119;883;707;0;0;0;0;.00nan;0;0
12119;53857;711;0;0;0;0;.00nan;0;0
12119;85935;711;39;13;3;10;.769;3524000;0
12119;156932;707;100;50;1;49;.980;3600000;0
12120;5997;712;0;0;0;0;.00nan;0;0
12120;13976;710;0;0;0;0;.00nan;0;0
12120;61425;712;61;28;3;25;.893;3600000;0
12120;77086;710;47;29;5;24;.828;3584000;0
12121;11882;706;88;28;1;27;.964;3600000;0
12121;31165;2473;65;20;2;18;.900;3549000;0
12121;181748;2473;0;0;0;0;.00nan;0;0
12121;71648;706;0;0;0;0;.00nan;0;0
12122;883;707;0;0;0;0;.00nan;0;0
12122;13976;710;0;0;0;0;.00nan;0;0
12122;77086;710;52;15;2;13;.867;3600000;0
12122;156932;707;65;54;6;48;.889;3600000;0
12123;5997;712;0;0;0;0;.00nan;0;0
12123;35897;2474;0;0;0;0;.00nan;0;0
12123;61425;712;72;19;2;17;.895;3600000;0
12123;72229;2474;45;42;6;36;.857;3600000;0
12124;1213;713;79;43;4;39;.907;3600000;0
12124;31165;2473;70;19;1;18;.947;3600000;0
12124;181748;2473;0;0;0;0;.00nan;0;0
12124;41399;713;0;0;0;0;.00nan;0;0
12125;11882;706;60;29;4;25;.862;3600000;0
12125;53857;711;0;0;0;0;.00nan;0;0
12125;71648;706;0;0;0;0;.00nan;0;0
12125;85935;711;78;33;2;31;.939;3600000;0
12126;8478;714;0;0;0;0;.00nan;0;0
12126;17565;714;61;24;3;21;.875;3900000;0
12126;18801;2465;0;0;0;0;.00nan;0;0
12126;145636;2465;88;50;3;47;.940;3900000;0
12127;883;707;0;0;0;0;.00nan;0;0
12127;35897;2474;0;0;0;0;.00nan;0;0
12127;72229;2474;87;47;3;44;.936;3585000;0
12127;156932;707;81;23;1;22;.957;3600000;0
12128;5997;712;0;0;0;0;.00nan;0;0
12128;8478;714;74;30;2;28;.933;3600000;0
12128;17565;714;0;0;0;0;.00nan;0;0
12128;61425;712;62;29;3;26;.897;3556000;0
12129;11882;706;89;35;2;33;.943;3600000;0
12129;13976;710;0;0;0;0;.00nan;0;0
12129;71648;706;0;0;0;0;.00nan;0;0
12129;77086;710;57;28;3;25;.893;3600000;0
12130;1213;713;65;33;3;30;.909;3900000;0
12130;41399;713;0;0;0;0;.00nan;0;0
12130;53857;711;0;0;0;0;.00nan;0;0
12130;85935;711;67;28;3;25;.893;3900000;0
12131;18801;2465;97;38;1;37;.974;3600000;0
12131;31165;2473;45;18;3;15;.833;3517000;0
12131;181748;2473;0;0;0;0;.00nan;0;0
12131;145636;2465;0;0;0;0;.00nan;0;0
12132;1213;713;96;52;2;50;.962;3900000;0
12132;13976;710;0;0;0;0;.00nan;0;0
12132;41399;713;0;0;0;0;.00nan;0;0
12132;77086;710;74;33;2;31;.939;3900000;0
12133;883;707;49;1;0;1;1.000;328000;0
12133;5997;712;0;0;0;0;.00nan;0;0
12133;61425;712;61;17;1;16;.941;3600000;0
12133;156932;707;60;50;6;44;.880;3272000;0
12134;11882;706;44;23;4;19;.826;3600000;0
12134;35897;2474;73;22;1;21;.955;3600000;0
12134;71648;706;0;0;0;0;.00nan;0;0
12134;72229;2474;0;0;0;0;.00nan;0;0
12135;8478;714;0;0;0;0;.00nan;0;0
12135;17565;714;76;31;3;28;.903;3600000;0
12135;31165;2473;53;30;4;26;.867;3553000;0
12135;181748;2473;0;0;0;0;.00nan;0;0
12136;18801;2465;0;0;0;0;.00nan;0;0
12136;53857;711;0;0;0;0;.00nan;0;0
12136;85935;711;100;22;0;22;1.000;3600000;0
12136;145636;2465;55;47;7;40;.851;3600000;0
12137;1213;713;91;34;1;33;.971;3600000;0
12137;35897;2474;0;0;0;0;.00nan;0;0
12137;41399;713;0;0;0;0;.00nan;0;0
12137;72229;2474;59;38;4;34;.895;3600000;0
12138;13976;710;0;0;0;0;.00nan;0;0
12138;18801;2465;0;0;0;0;.00nan;0;0
12138;77086;710;60;21;1;20;.952;3900000;0
12138;145636;2465;100;44;1;43;.977;3900000;0
12139;31165;2473;74;28;3;25;.893;3900000;0
12139;181748;2473;0;0;0;0;.00nan;0;0
12139;53857;711;0;0;0;0;.00nan;0;0
12139;85935;711;88;40;3;37;.925;3900000;0
12140;883;707;0;0;0;0;.00nan;0;0
12140;8478;714;0;0;0;0;.00nan;0;0
12140;17565;714;77;12;0;12;1.000;3600000;0
12140;156932;707;84;39;2;37;.949;3540000;0
12141;5997;712;0;0;0;0;.00nan;0;0
12141;11882;706;30;33;6;27;.818;3600000;0
12141;61425;712;58;24;3;21;.875;3600000;0
12141;71648;706;0;0;0;0;.00nan;0;0
12142;13976;710;79;32;2;30;.938;3600000;0
12142;31165;2473;93;25;1;24;.960;3600000;0
12142;181748;2473;0;0;0;0;.00nan;0;0
12142;77086;710;0;0;0;0;.00nan;0;0
12143;1213;713;69;25;2;23;.920;3600000;0
12143;5997;712;0;0;0;0;.00nan;0;0
12143;41399;713;0;0;0;0;.00nan;0;0
12143;61425;712;77;34;3;31;.912;3560000;0
12144;883;707;0;0;0;0;.00nan;0;0
12144;11882;706;51;20;3;17;.850;3600000;0
12144;71648;706;0;0;0;0;.00nan;0;0
12144;156932;707;58;37;4;33;.892;3549000;0
12145;18801;2465;0;0;0;0;.00nan;0;0
12145;35897;2474;73;21;1;20;.952;3600000;0
12145;72229;2474;0;0;0;0;.00nan;0;0
12145;145636;2465;96;41;3;38;.927;3516000;0
12146;8478;714;52;28;4;24;.857;3563000;0
12146;17565;714;0;0;0;0;.00nan;0;0
12146;53857;711;0;0;0;0;.00nan;0;0
12146;85935;711;68;25;2;23;.920;3600000;0
12147;8478;714;0;0;0;0;.00nan;0;0
12147;13976;710;0;0;0;0;.00nan;0;0
12147;17565;714;89;33;3;30;.909;3900000;0
12147;77086;710;71;37;3;34;.919;3900000;0
12148;883;707;0;0;0;0;.00nan;0;0
12148;18801;2465;76;26;1;25;.962;3737000;0
12148;145636;2465;0;0;0;0;.00nan;0;0
12148;156932;707;92;39;2;37;.949;3737000;0
12149;35897;2474;0;0;0;0;.00nan;0;0
12149;53857;711;0;0;0;0;.00nan;0;0
12149;72229;2474;81;41;2;39;.951;3600000;0
12149;85935;711;81;16;0;16;1.000;3600000;0
12150;1213;713;68;31;3;28;.903;3900000;0
12150;11882;706;0;0;0;0;.00nan;0;0
12150;41399;713;0;0;0;0;.00nan;0;0
12150;71648;706;66;32;3;29;.906;3900000;0
12151;5997;712;0;0;0;0;.00nan;0;0
12151;13976;710;0;0;0;0;.00nan;0;0
12151;61425;712;63;37;4;33;.892;3600000;0
12151;77086;710;73;29;2;27;.931;3600000;0
12152;1213;713;83;20;1;19;.950;3600000;0
12152;18801;2465;82;38;3;35;.921;3598000;0
12152;41399;713;0;0;0;0;.00nan;0;0
12152;145636;2465;0;0;0;0;.00nan;0;0
12153;8478;714;43;16;3;13;.813;3557000;0
12153;17565;714;0;0;0;0;.00nan;0;0
12153;35897;2474;99;44;2;42;.955;3600000;0
12153;72229;2474;0;0;0;0;.00nan;0;0
12154;11882;706;35;26;5;21;.808;3600000;0
12154;31165;2473;77;29;2;27;.931;3600000;0
12154;181748;2473;0;0;0;0;.00nan;0;0
12154;71648;706;0;0;0;0;.00nan;0;0
12155;883;707;0;0;0;0;.00nan;0;0
12155;53857;711;0;0;0;0;.00nan;0;0
12155;85935;711;86;13;0;13;1.000;3600000;0
12155;156932;707;41;36;5;31;.861;3600000;0
12156;8478;714;0;0;0;0;.00nan;0;0
12156;17565;714;76;50;6;44;.880;3600000;0
12156;53857;711;0;0;0;0;.00nan;0;0
12156;85935;711;79;20;1;19;.950;3600000;0
12157;883;707;0;0;0;0;.00nan;0;0
12157;11882;706;74;23;1;22;.957;3600000;0
12157;71648;706;0;0;0;0;.00nan;0;0
12157;156932;707;65;32;3;29;.906;3564000;0
12158;1213;713;60;31;4;27;.871;3543000;0
12158;5997;712;0;0;0;0;.00nan;0;0
12158;41399;713;0;0;0;0;.00nan;0;0
12158;61425;712;73;34;3;31;.912;3600000;0
12159;18801;2465;91;42;3;39;.929;3826000;0
12159;35897;2474;0;0;0;0;.00nan;0;0
12159;72229;2474;59;19;2;17;.895;3826000;0
12159;145636;2465;0;0;0;0;.00nan;0;0
12160;13976;710;0;0;0;0;.00nan;0;0
12160;31165;2473;98;39;1;38;.974;3596000;0
12160;181748;2473;0;0;0;0;.00nan;0;0
12160;77086;710;100;28;0;28;1.000;3600000;0
12162;883;707;59;19;2;17;.895;3516000;0
12162;35897;2474;0;0;0;0;.00nan;0;0
12162;72229;2474;100;29;0;29;1.000;3600000;0
12162;156932;707;0;0;0;0;.00nan;0;0
12164;8478;714;62;19;2;17;.895;3616000;0
12164;17565;714;0;0;0;0;.00nan;0;0
12164;31165;2473;78;21;1;20;.952;3616000;0
12164;181748;2473;0;0;0;0;.00nan;0;0
12166;5997;712;0;0;0;0;.00nan;0;0
12166;11882;706;76;29;2;27;.931;3542000;0
12166;61425;712;94;34;1;33;.971;3600000;0
12166;71648;706;0;0;0;0;.00nan;0;0
12168;1213;713;0;0;0;0;.00nan;0;0
12168;41399;713;70;34;4;30;.882;3577000;0
12168;53857;711;0;0;0;0;.00nan;0;0
12168;85935;711;56;24;3;21;.875;3600000;0
12170;13976;710;0;0;0;0;.00nan;0;0
12170;18801;2465;90;52;3;49;.942;3543000;0
12170;77086;710;57;10;1;9;.900;3600000;0
12170;145636;2465;0;0;0;0;.00nan;0;0
12172;18801;2465;57;39;4;35;.897;3549000;0
12172;31165;2473;0;0;0;0;.00nan;0;0
12172;181748;2473;53;12;2;10;.833;3600000;0
12172;145636;2465;0;0;0;0;.00nan;0;0
12174;883;707;0;0;0;0;.00nan;0;0
12174;35897;2474;0;0;0;0;.00nan;0;0
12174;72229;2474;91;19;0;19;1.000;3600000;0
12174;156932;707;59;22;2;20;.909;3529000;0
12176;5997;712;0;0;0;0;.00nan;0;0
12176;13976;710;0;0;0;0;.00nan;0;0
12176;61425;712;74;29;2;27;.931;3804000;0
12176;77086;710;80;35;3;32;.914;3804000;0
12178;8478;714;0;0;0;0;.00nan;0;0
12178;17565;714;54;36;4;32;.889;3600000;0
12178;53857;711;0;0;0;0;.00nan;0;0
12178;85935;711;96;17;0;17;1.000;3600000;0
12180;1213;713;73;33;2;31;.939;3600000;0
12180;11882;706;69;19;1;18;.947;3600000;0
12180;41399;713;0;0;0;0;.00nan;0;0
12180;71648;706;0;0;0;0;.00nan;0;0
12182;1213;713;0;0;0;0;.00nan;0;0
12182;41399;713;64;37;3;34;.919;3900000;0
12182;53857;711;0;0;0;0;.00nan;0;0
12182;85935;711;49;19;3;16;.842;3900000;0
12184;8478;714;90;42;3;39;.929;3600000;0
12184;17565;714;0;0;0;0;.00nan;0;0
12184;31165;2473;54;28;4;24;.857;3598000;0
12184;181748;2473;0;0;0;0;.00nan;0;0
12186;13976;710;43;22;4;18;.818;3900000;0
12186;35897;2474;0;0;0;0;.00nan;0;0
12186;72229;2474;70;36;4;32;.889;3900000;0
12186;77086;710;0;0;0;0;.00nan;0;0
12188;5997;712;80;32;3;29;.906;3600000;0
12188;11882;706;0;0;0;0;.00nan;0;0
12188;61425;712;0;0;0;0;.00nan;0;0
12188;71648;706;85;30;2;28;.933;3600000;0
12190;883;707;87;30;1;29;.967;3600000;0
12190;18801;2465;0;0;0;0;.00nan;0;0
12190;145636;2465;48;22;3;19;.864;3581000;0
12190;156932;707;0;0;0;0;.00nan;0;0
12192;8478;714;90;33;2;31;.939;3600000;0
12192;13976;710;0;0;0;0;.00nan;0;0
12192;17565;714;0;0;0;0;.00nan;0;0
12192;77086;710;48;20;3;17;.850;3586000;0
12194;883;707;0;0;0;0;.00nan;0;0
12194;1213;713;0;0;0;0;.00nan;0;0
12194;41399;713;59;17;2;15;.882;3600000;0
12194;156932;707;49;36;5;31;.861;3600000;0
12196;35897;2474;0;0;0;0;.00nan;0;0
12196;53857;711;0;0;0;0;.00nan;0;0
12196;72229;2474;50;33;5;28;.848;3600000;0
12196;85935;711;59;19;2;17;.895;3600000;0
12198;18801;2465;70;32;4;28;.875;3600000;0
12198;31165;2473;58;22;3;19;.864;3600000;0
12198;181748;2473;0;0;0;0;.00nan;0;0
12198;145636;2465;0;0;0;0;.00nan;0;0
12200;5997;712;0;0;0;0;.00nan;0;0
12200;11882;706;46;21;3;18;.857;3600000;0
12200;61425;712;41;23;4;19;.826;3543000;0
12200;71648;706;0;0;0;0;.00nan;0;0
12202;883;707;93;49;3;46;.939;3600000;0
12202;53857;711;78;13;0;13;1.000;3600000;0
12202;85935;711;0;0;0;0;.00nan;0;0
12202;156932;707;0;0;0;0;.00nan;0;0
12204;1213;713;67;24;2;22;.917;3764000;0
12204;11882;706;0;0;0;0;.00nan;0;0
12204;41399;713;0;0;0;0;.00nan;0;0
12204;71648;706;85;37;3;34;.919;3764000;0
12206;5997;712;47;39;6;33;.846;3600000;0
12206;8478;714;0;0;0;0;.00nan;0;0
12206;17565;714;65;23;2;21;.913;3600000;0
12206;61425;712;0;0;0;0;.00nan;0;0
12208;13976;710;29;29;6;23;.793;3333000;0
12208;31165;2473;0;0;0;0;.00nan;0;0
12208;181748;2473;92;36;1;35;.972;3600000;0
12208;77086;710;35;6;2;4;.667;267000;0
12210;18801;2465;0;0;0;0;.00nan;0;0
12210;35897;2474;93;31;1;30;.968;3600000;0
12210;72229;2474;0;0;0;0;.00nan;0;0
12210;145636;2465;40;20;4;16;.800;3600000;0
12212;8478;714;75;39;4;35;.897;3571000;0
12212;17565;714;0;0;0;0;.00nan;0;0
12212;31165;2473;52;20;3;17;.850;3600000;0
12212;181748;2473;0;0;0;0;.00nan;0;0
12214;883;707;0;0;0;0;.00nan;0;0
12214;1213;713;0;0;0;0;.00nan;0;0
12214;41399;713;90;19;0;19;1.000;3600000;0
12214;156932;707;33;33;6;27;.818;3600000;0
12216;5997;712;0;0;0;0;.00nan;0;0
12216;11882;706;54;31;4;27;.871;3600000;0
12216;61425;712;49;32;5;27;.844;3578000;0
12216;71648;706;0;0;0;0;.00nan;0;0
12218;13976;710;0;0;0;0;.00nan;0;0
12218;18801;2465;98;44;3;41;.932;3538000;0
12218;77086;710;72;20;1;19;.950;3600000;0
12218;145636;2465;0;0;0;0;.00nan;0;0
12220;35897;2474;58;6;0;6;1.000;348000;0
12220;53857;711;63;16;1;15;.938;3600000;0
12220;72229;2474;62;38;4;34;.895;3252000;0
12220;85935;711;0;0;0;0;.00nan;0;0
12222;1213;713;0;0;0;0;.00nan;0;0
12222;13976;710;64;21;2;19;.905;3566000;0
12222;41399;713;89;28;1;27;.964;3600000;0
12222;77086;710;0;0;0;0;.00nan;0;0
12224;8478;714;0;0;0;0;.00nan;0;0
12224;17565;714;71;31;3;28;.903;3600000;0
12224;31165;2473;0;0;0;0;.00nan;0;0
12224;181748;2473;50;31;4;27;.871;3551000;0
12226;5997;712;23;29;6;23;.793;3146000;0
12226;11882;706;0;0;0;0;.00nan;0;0
12226;61425;712;46;5;1;4;.800;454000;0
12226;71648;706;95;31;1;30;.968;3600000;0
12228;18801;2465;0;0;0;0;.00nan;0;0
12228;35897;2474;44;18;3;15;.833;3544000;0
12228;72229;2474;0;0;0;0;.00nan;0;0
12228;145636;2465;86;32;2;30;.938;3600000;0
12230;883;707;39;40;6;34;.850;2873000;0
12230;53857;711;0;0;0;0;.00nan;0;0
12230;85935;711;78;9;0;9;1.000;3600000;0
12230;156932;707;75;19;0;19;1.000;727000;0
322;35897;2474;0;0;0;0;.00nan;0;0
322;53857;711;0;0;0;0;.00nan;0;0
322;72229;2474;73;39;3;36;.923;3600000;0
322;85935;711;84;14;0;14;1.000;3600000;0
323;11882;706;52;36;5;31;.861;3600000;0
323;31165;2473;58;15;1;14;.933;3600000;0
323;181748;2473;0;0;0;0;.00nan;0;0
323;71648;706;0;0;0;0;.00nan;0;0
324;8478;714;73;26;2;24;.923;3600000;0
324;13976;710;0;0;0;0;.00nan;0;0
324;17565;714;0;0;0;0;.00nan;0;0
324;77086;710;45;22;4;18;.818;3600000;0
325;1213;713;49;20;3;17;.850;3562000;0
325;5997;712;0;0;0;0;.00nan;0;0
325;41399;713;0;0;0;0;.00nan;0;0
325;61425;712;97;37;1;36;.973;3600000;0
326;35897;2474;53;9;1;8;.889;789000;0
326;53857;711;0;0;0;0;.00nan;0;0
326;72229;2474;62;46;6;40;.870;2811000;0
326;85935;711;54;13;2;11;.846;3600000;0
327;11882;706;70;24;1;23;.958;3600000;0
327;31165;2473;37;19;4;15;.789;3600000;0
327;181748;2473;0;0;0;0;.00nan;0;0
327;71648;706;0;0;0;0;.00nan;0;0
328;8478;714;37;30;5;25;.833;3600000;0
328;13976;710;0;0;0;0;.00nan;0;0
328;17565;714;0;0;0;0;.00nan;0;0
328;77086;710;67;18;1;17;.944;3600000;0
329;1213;713;98;49;4;45;.918;3600000;0
329;5997;712;0;0;0;0;.00nan;0;0
329;41399;713;0;0;0;0;.00nan;0;0
329;61425;712;83;32;1;31;.969;3600000;0
330;35897;2474;0;0;0;0;.00nan;0;0
330;53857;711;0;0;0;0;.00nan;0;0
330;72229;2474;79;37;3;34;.919;3600000;0
330;85935;711;80;11;0;11;1.000;3600000;0
331;11882;706;44;25;4;21;.840;3600000;0
331;31165;2473;95;28;1;27;.964;3600000;0
331;181748;2473;0;0;0;0;.00nan;0;0
331;71648;706;0;0;0;0;.00nan;0;0
332;8478;714;73;38;4;34;.895;3531000;0
332;13976;710;0;0;0;0;.00nan;0;0
332;17565;714;0;0;0;0;.00nan;0;0
332;77086;710;55;20;2;18;.900;3600000;0
333;1213;713;71;37;4;33;.892;3721000;0
333;5997;712;0;0;0;0;.00nan;0;0
333;41399;713;0;0;0;0;.00nan;0;0
333;61425;712;61;25;3;22;.880;3721000;0
334;35897;2474;0;0;0;0;.00nan;0;0
334;53857;711;0;0;0;0;.00nan;0;0
334;72229;2474;88;38;2;36;.947;3545000;0
334;85935;711;73;17;1;16;.941;3600000;0
335;11882;706;42;23;4;19;.826;3723000;0
335;31165;2473;75;38;3;35;.921;3723000;0
335;181748;2473;0;0;0;0;.00nan;0;0
335;71648;706;0;0;0;0;.00nan;0;0
336;8478;714;70;34;3;31;.912;3600000;0
336;13976;710;0;0;0;0;.00nan;0;0
336;17565;714;0;0;0;0;.00nan;0;0
336;77086;710;35;22;4;18;.818;3552000;0
337;1213;713;67;18;1;17;.944;3600000;0
337;5997;712;0;0;0;0;.00nan;0;0
337;41399;713;0;0;0;0;.00nan;0;0
337;61425;712;58;29;4;25;.862;3600000;0
634;11882;706;77;36;3;33;.917;3592000;0
634;31165;2473;89;25;1;24;.960;3600000;0
634;181748;2473;0;0;0;0;.00nan;0;0
634;71648;706;0;0;0;0;.00nan;0;0
635;8478;714;50;28;4;24;.857;3600000;0
635;13976;710;0;0;0;0;.00nan;0;0
635;17565;714;0;0;0;0;.00nan;0;0
635;77086;710;84;15;0;15;1.000;3600000;0
636;1213;713;49;28;4;24;.857;3600000;0
636;5997;712;0;0;0;0;.00nan;0;0
636;41399;713;0;0;0;0;.00nan;0;0
636;61425;712;95;24;0;24;1.000;3600000;0
678;8478;714;88;27;1;26;.963;3600000;0
678;13976;710;0;0;0;0;.00nan;0;0
678;17565;714;0;0;0;0;.00nan;0;0
678;77086;710;64;24;3;21;.875;3585000;0
703;8478;714;75;46;5;41;.891;3600000;0
703;13976;710;0;0;0;0;.00nan;0;0
703;17565;714;0;0;0;0;.00nan;0;0
703;77086;710;100;28;0;28;1.000;3600000;0
871;5997;712;0;0;0;0;.00nan;0;0
871;53857;711;0;0;0;0;.00nan;0;0
871;61425;712;93;48;2;46;.958;5189000;0
871;85935;711;64;33;3;30;.909;5189000;0
872;13976;710;0;0;0;0;.00nan;0;0
872;31165;2473;79;43;4;39;.907;3600000;0
872;181748;2473;0;0;0;0;.00nan;0;0
872;77086;710;74;22;1;21;.955;3600000;0
873;5997;712;0;0;0;0;.00nan;0;0
873;53857;711;0;0;0;0;.00nan;0;0
873;61425;712;98;46;2;44;.957;3594000;0
873;85935;711;64;14;1;13;.929;3600000;0
874;13976;710;0;0;0;0;.00nan;0;0
874;31165;2473;100;33;0;33;1.000;3600000;0
874;181748;2473;0;0;0;0;.00nan;0;0
874;77086;710;92;47;4;43;.915;3600000;0
875;5997;712;0;0;0;0;.00nan;0;0
875;53857;711;0;0;0;0;.00nan;0;0
875;61425;712;51;39;6;33;.846;3600000;0
875;85935;711;89;16;0;16;1.000;3600000;0
876;13976;710;0;0;0;0;.00nan;0;0
876;31165;2473;76;27;1;26;.963;3600000;0
876;181748;2473;0;0;0;0;.00nan;0;0
876;77086;710;66;21;3;18;.857;3555000;0
877;5997;712;0;0;0;0;.00nan;0;0
877;53857;711;0;0;0;0;.00nan;0;0
877;61425;712;81;61;6;55;.902;4851000;0
877;85935;711;35;25;5;20;.800;4851000;0
878;13976;710;0;0;0;0;.00nan;0;0
878;31165;2473;72;25;2;23;.920;3576000;0
878;181748;2473;0;0;0;0;.00nan;0;0
878;77086;710;100;29;0;29;1.000;3600000;0
1023;5997;712;0;0;0;0;.00nan;0;0
1023;53857;711;0;0;0;0;.00nan;0;0
1023;61425;712;72;34;2;32;.941;3677000;0
1023;85935;711;81;26;1;25;.962;3677000;0
1024;13976;710;0;0;0;0;.00nan;0;0
1024;31165;2473;78;24;1;23;.958;3600000;0
1024;181748;2473;0;0;0;0;.00nan;0;0
1024;77086;710;54;35;4;31;.886;3600000;0
1069;13976;710;0;0;0;0;.00nan;0;0
1069;31165;2473;72;32;2;30;.938;4604000;0
1069;181748;2473;0;0;0;0;.00nan;0;0
1069;77086;710;57;28;3;25;.893;4604000;0
1093;31165;2473;75;47;5;42;.894;3600000;0
1093;181748;2473;0;0;0;0;.00nan;0;0
1093;53857;711;0;0;0;0;.00nan;0;0
1093;85935;711;62;20;2;18;.900;3600000;0
1094;31165;2473;58;36;5;31;.861;4021000;0
1094;181748;2473;0;0;0;0;.00nan;0;0
1094;53857;711;0;0;0;0;.00nan;0;0
1094;85935;711;49;26;4;22;.846;4021000;0
1095;31165;2473;90;30;1;29;.967;3600000;0
1095;181748;2473;0;0;0;0;.00nan;0;0
1095;53857;711;0;0;0;0;.00nan;0;0
1095;85935;711;69;23;2;21;.913;3574000;0
1096;31165;2473;51;31;5;26;.839;4459000;0
1096;181748;2473;0;0;0;0;.00nan;0;0
1096;53857;711;0;0;0;0;.00nan;0;0
1096;85935;711;77;49;4;45;.918;4459000;0
1318;31165;2473;78;28;1;27;.964;3600000;0
1318;181748;2473;0;0;0;0;.00nan;0;0
1318;53857;711;0;0;0;0;.00nan;0;0
1318;85935;711;49;13;2;11;.846;3576000;0
1348;31165;2473;47;14;2;12;.857;3543000;0
1348;181748;2473;0;0;0;0;.00nan;0;0
1348;53857;711;0;0;0;0;.00nan;0;0
1348;85935;711;99;33;1;32;.970;3600000;0
12231;34959;612;0;0;0;0;.00nan;0;0
12231;56316;612;63;23;2;21;.913;3773000;0
12231;65434;2308;66;29;3;26;.897;3773000;0
12231;156254;2308;0;0;0;0;.00nan;0;0
12232;173279;4644;80;29;2;27;.931;3600000;0
12232;45193;620;0;0;0;0;.00nan;0;0
12232;86875;620;45;27;4;23;.852;3580000;0
12232;156148;4644;0;0;0;0;.00nan;0;0
12233;43925;614;72;26;2;24;.923;3600000;0
12233;45323;622;0;0;0;0;.00nan;0;0
12233;73187;614;0;0;0;0;.00nan;0;0
12233;156322;622;56;27;3;24;.889;3568000;0
12234;10141;2167;66;13;0;13;1.000;1171000;0
12234;32712;611;52;28;4;24;.857;3600000;0
12234;63529;2167;18;26;6;20;.769;2386000;0
12234;156298;611;0;0;0;0;.00nan;0;0
12235;584;3923;38;37;6;31;.838;3313000;0
12235;3075;617;0;0;0;0;.00nan;0;0
12235;73699;3923;57;8;0;8;1.000;287000;0
12235;143412;617;46;19;3;16;.842;3600000;0
12236;584;3923;96;60;3;57;.950;3596000;0
12236;65434;2308;0;0;0;0;.00nan;0;0
12236;73699;3923;0;0;0;0;.00nan;0;0
12236;156254;2308;62;13;1;12;.923;3600000;0
12237;16742;619;40;30;5;25;.833;3565000;0
12237;43925;614;67;33;4;29;.879;3600000;0
12237;73187;614;0;0;0;0;.00nan;0;0
12237;78262;619;0;0;0;0;.00nan;0;0
12238;32712;611;85;40;3;37;.925;3600000;0
12238;63848;2319;50;21;4;17;.810;3559000;0
12238;156221;2319;0;0;0;0;.00nan;0;0
12238;156298;611;0;0;0;0;.00nan;0;0
12239;34959;612;0;0;0;0;.00nan;0;0
12239;45323;622;0;0;0;0;.00nan;0;0
12239;56316;612;23;26;6;20;.769;3596000;0
12239;156322;622;61;43;5;38;.884;3600000;0
12240;10141;2167;0;0;0;0;.00nan;0;0
12240;173279;4644;43;22;4;18;.818;3600000;0
12240;63529;2167;33;27;5;22;.815;3548000;0
12240;156148;4644;0;0;0;0;.00nan;0;0
12241;3075;617;91;35;2;33;.943;3600000;0
12241;45193;620;0;0;0;0;.00nan;0;0
12241;86875;620;69;37;4;33;.892;3579000;0
12241;143412;617;0;0;0;0;.00nan;0;0
12242;34959;612;0;0;0;0;.00nan;0;0
12242;43925;614;25;6;3;3;.500;393000;0
12242;56316;612;54;26;3;23;.885;3600000;0
12242;73187;614;49;23;4;19;.826;3207000;0
12243;45193;620;0;0;0;0;.00nan;0;0
12243;65434;2308;60;19;1;18;.947;3600000;0
12243;86875;620;59;31;3;28;.903;3586000;0
12243;156254;2308;0;0;0;0;.00nan;0;0
12244;173279;4644;99;47;1;46;.979;3600000;0
12244;63848;2319;71;29;3;26;.897;3557000;0
12244;156148;4644;0;0;0;0;.00nan;0;0
12244;156221;2319;0;0;0;0;.00nan;0;0
12245;584;3923;30;30;6;24;.800;2146000;0
12245;45323;622;0;0;0;0;.00nan;0;0
12245;73699;3923;35;30;6;24;.800;1454000;0
12245;156322;622;43;18;3;15;.833;3600000;0
12246;3075;617;76;28;2;26;.929;3600000;0
12246;10141;2167;0;0;0;0;.00nan;0;0
12246;63529;2167;69;19;1;18;.947;3600000;0
12246;143412;617;0;0;0;0;.00nan;0;0
12247;16742;619;41;22;4;18;.818;3968000;0
12247;32712;611;89;53;5;48;.906;3968000;0
12247;78262;619;0;0;0;0;.00nan;0;0
12247;156298;611;0;0;0;0;.00nan;0;0
12248;16742;619;100;44;1;43;.977;4200000;0
12248;63848;2319;61;26;1;25;.962;4200000;0
12248;78262;619;0;0;0;0;.00nan;0;0
12248;156221;2319;0;0;0;0;.00nan;0;0
12249;584;3923;0;0;0;0;.00nan;0;0
12249;43925;614;44;13;3;10;.769;3690000;0
12249;73187;614;0;0;0;0;.00nan;0;0
12249;73699;3923;87;69;4;65;.942;3690000;0
12250;3075;617;82;41;3;38;.927;3600000;0
12250;63848;2319;72;25;2;23;.920;3600000;0
12250;143412;617;0;0;0;0;.00nan;0;0
12250;156221;2319;0;0;0;0;.00nan;0;0
12251;16742;619;60;21;2;19;.905;3600000;0
12251;34959;612;0;0;0;0;.00nan;0;0
12251;56316;612;69;37;5;32;.865;3600000;0
12251;78262;619;0;0;0;0;.00nan;0;0
12252;10141;2167;30;52;9;43;.827;3600000;0
12252;63529;2167;0;0;0;0;.00nan;0;0
12252;65434;2308;53;26;3;23;.885;3600000;0
12252;156254;2308;0;0;0;0;.00nan;0;0
12253;45193;620;0;0;0;0;.00nan;0;0
12253;45323;622;0;0;0;0;.00nan;0;0
12253;86875;620;65;35;4;31;.886;3587000;0
12253;156322;622;64;23;2;21;.913;3600000;0
12254;173279;4644;71;20;1;19;.950;3600000;0
12254;32712;611;84;36;2;34;.944;3566000;0
12254;156148;4644;0;0;0;0;.00nan;0;0
12254;156298;611;0;0;0;0;.00nan;0;0
12255;43925;614;47;13;2;11;.846;3600000;0
12255;45193;620;58;9;1;8;.889;1173000;0
12255;73187;614;0;0;0;0;.00nan;0;0
12255;86875;620;18;39;8;31;.795;2427000;0
12256;63848;2319;54;34;4;30;.882;3827000;0
12256;65434;2308;0;0;0;0;.00nan;0;0
12256;156221;2319;0;0;0;0;.00nan;0;0
12256;156254;2308;61;30;3;27;.900;3827000;0
12257;584;3923;0;0;0;0;.00nan;0;0
12257;34959;612;43;13;3;10;.769;3600000;0
12257;56316;612;0;0;0;0;.00nan;0;0
12257;73699;3923;78;51;5;46;.902;3600000;0
12258;10141;2167;53;3;0;3;1.000;353000;0
12258;45323;622;0;0;0;0;.00nan;0;0
12258;63529;2167;54;47;7;40;.851;3247000;0
12258;156322;622;66;15;1;14;.933;3600000;0
12259;3075;617;0;0;0;0;.00nan;0;0
12259;32712;611;59;26;3;23;.885;3600000;0
12259;143412;617;38;22;4;18;.818;3543000;0
12259;156298;611;0;0;0;0;.00nan;0;0
12260;173279;4644;52;49;6;43;.878;3600000;0
12260;16742;619;0;0;0;0;.00nan;0;0
12260;78262;619;90;21;0;21;1.000;3600000;0
12260;156148;4644;0;0;0;0;.00nan;0;0
12261;584;3923;36;38;7;31;.816;2977000;0
12261;16742;619;62;26;2;24;.923;3600000;0
12261;73699;3923;71;15;0;15;1.000;623000;0
12261;78262;619;0;0;0;0;.00nan;0;0
12262;45323;622;0;0;0;0;.00nan;0;0
12262;63848;2319;70;37;3;34;.919;3600000;0
12262;156221;2319;0;0;0;0;.00nan;0;0
12262;156322;622;50;33;4;29;.879;3567000;0
12263;3075;617;56;36;5;31;.861;3561000;0
12263;173279;4644;0;0;0;0;.00nan;0;0
12263;143412;617;0;0;0;0;.00nan;0;0
12263;156148;4644;52;29;4;25;.862;3600000;0
12264;10141;2167;0;0;0;0;.00nan;0;0
12264;43925;614;100;30;0;30;1.000;3600000;0
12264;63529;2167;80;40;3;37;.925;3600000;0
12264;73187;614;0;0;0;0;.00nan;0;0
12265;34959;612;0;0;0;0;.00nan;0;0
12265;45193;620;0;0;0;0;.00nan;0;0
12265;56316;612;90;32;2;30;.938;3600000;0
12265;86875;620;86;31;1;30;.968;3600000;0
12266;32712;611;79;41;3;38;.927;3644000;0
12266;65434;2308;42;22;4;18;.818;3644000;0
12266;156254;2308;0;0;0;0;.00nan;0;0
12266;156298;611;0;0;0;0;.00nan;0;0
12267;43925;614;60;17;2;15;.882;3600000;0
12267;63848;2319;73;39;4;35;.897;3518000;0
12267;73187;614;0;0;0;0;.00nan;0;0
12267;156221;2319;0;0;0;0;.00nan;0;0
12268;173279;4644;75;37;4;33;.892;3600000;0
12268;65434;2308;62;25;3;22;.880;3600000;0
12268;156148;4644;0;0;0;0;.00nan;0;0
12268;156254;2308;0;0;0;0;.00nan;0;0
12269;10141;2167;0;0;0;0;.00nan;0;0
12269;34959;612;85;19;0;19;1.000;3600000;0
12269;56316;612;0;0;0;0;.00nan;0;0
12269;63529;2167;91;46;3;43;.935;3600000;0
12270;32712;611;82;53;4;49;.925;3600000;0
12270;45323;622;0;0;0;0;.00nan;0;0
12270;156298;611;0;0;0;0;.00nan;0;0
12270;156322;622;90;16;0;16;1.000;3600000;0
12271;3075;617;0;0;0;0;.00nan;0;0
12271;16742;619;56;25;3;22;.880;3600000;0
12271;78262;619;0;0;0;0;.00nan;0;0
12271;143412;617;100;37;0;37;1.000;3600000;0
12272;34959;612;41;22;4;18;.818;3559000;0
12272;56316;612;0;0;0;0;.00nan;0;0
12272;63848;2319;56;25;2;23;.920;3600000;0
12272;156221;2319;0;0;0;0;.00nan;0;0
12273;173279;4644;35;18;4;14;.778;1132000;0
12273;45323;622;0;0;0;0;.00nan;0;0
12273;156148;4644;58;27;3;24;.889;2468000;0
12273;156322;622;76;22;1;21;.955;3600000;0
12274;584;3923;0;0;0;0;.00nan;0;0
12274;10141;2167;0;0;0;0;.00nan;0;0
12274;63529;2167;69;31;3;28;.903;3600000;0
12274;73699;3923;64;40;4;36;.900;3568000;0
12275;16742;619;62;38;4;34;.895;3600000;0
12275;45193;620;0;0;0;0;.00nan;0;0
12275;78262;619;0;0;0;0;.00nan;0;0
12275;86875;620;64;44;5;39;.886;3555000;0
12276;32712;611;61;32;3;29;.906;3600000;0
12276;43925;614;74;20;1;19;.950;3600000;0
12276;73187;614;0;0;0;0;.00nan;0;0
12276;156298;611;0;0;0;0;.00nan;0;0
12277;3075;617;51;19;3;16;.842;3600000;0
12277;65434;2308;63;19;1;18;.947;3600000;0
12277;143412;617;0;0;0;0;.00nan;0;0
12277;156254;2308;0;0;0;0;.00nan;0;0
12278;584;3923;70;35;3;32;.914;3559000;0
12278;63848;2319;82;27;2;25;.926;3600000;0
12278;73699;3923;0;0;0;0;.00nan;0;0
12278;156221;2319;0;0;0;0;.00nan;0;0
12279;173279;4644;0;0;0;0;.00nan;0;0
12279;43925;614;81;27;2;25;.926;3600000;0
12279;73187;614;0;0;0;0;.00nan;0;0
12279;156148;4644;43;30;5;25;.833;3600000;0
12280;32712;611;74;39;4;35;.897;3600000;0
12280;34959;612;80;14;0;14;1.000;3600000;0
12280;56316;612;0;0;0;0;.00nan;0;0
12280;156298;611;0;0;0;0;.00nan;0;0
12281;3075;617;0;0;0;0;.00nan;0;0
12281;45323;622;61;37;5;32;.865;3919000;0
12281;143412;617;72;34;4;30;.882;3919000;0
12281;156322;622;0;0;0;0;.00nan;0;0
12282;10141;2167;0;0;0;0;.00nan;0;0
12282;45193;620;0;0;0;0;.00nan;0;0
12282;63529;2167;38;33;5;28;.848;3600000;0
12282;86875;620;85;24;1;23;.958;3600000;0
12283;16742;619;73;34;3;31;.912;4035000;0
12283;65434;2308;50;33;4;29;.879;4035000;0
12283;78262;619;0;0;0;0;.00nan;0;0
12283;156254;2308;0;0;0;0;.00nan;0;0
12284;45323;622;0;0;0;0;.00nan;0;0
12284;65434;2308;0;0;0;0;.00nan;0;0
12284;156254;2308;64;38;4;34;.895;3579000;0
12284;156322;622;72;27;2;25;.926;3600000;0
12285;45193;620;0;0;0;0;.00nan;0;0
12285;63848;2319;66;18;1;17;.944;3600000;0
12285;86875;620;88;56;5;51;.911;3600000;0
12285;156221;2319;0;0;0;0;.00nan;0;0
12286;173279;4644;47;30;4;26;.867;3600000;0
12286;34959;612;0;0;0;0;.00nan;0;0
12286;56316;612;85;31;2;29;.935;3600000;0
12286;156148;4644;0;0;0;0;.00nan;0;0
12287;584;3923;0;0;0;0;.00nan;0;0
12287;32712;611;77;29;3;26;.897;3600000;0
12287;73699;3923;71;52;5;47;.904;3591000;0
12287;156298;611;0;0;0;0;.00nan;0;0
12288;3075;617;56;30;3;27;.900;3579000;0
12288;43925;614;79;28;2;26;.929;3600000;0
12288;73187;614;0;0;0;0;.00nan;0;0
12288;143412;617;0;0;0;0;.00nan;0;0
12289;584;3923;69;35;4;31;.886;3661000;0
12289;173279;4644;44;18;3;15;.833;3661000;0
12289;73699;3923;0;0;0;0;.00nan;0;0
12289;156148;4644;0;0;0;0;.00nan;0;0
12290;43925;614;83;31;2;29;.935;3600000;0
12290;65434;2308;49;29;4;25;.862;3549000;0
12290;73187;614;0;0;0;0;.00nan;0;0
12290;156254;2308;0;0;0;0;.00nan;0;0
12291;3075;617;0;0;0;0;.00nan;0;0
12291;34959;612;71;31;3;28;.903;3600000;0
12291;56316;612;0;0;0;0;.00nan;0;0
12291;143412;617;58;43;6;37;.860;3600000;0
12292;10141;2167;0;0;0;0;.00nan;0;0
12292;63529;2167;59;36;5;31;.861;3600000;0
12292;63848;2319;62;22;2;20;.909;3600000;0
12292;156221;2319;0;0;0;0;.00nan;0;0
12293;32712;611;55;32;4;28;.875;3518000;0
12293;45193;620;0;0;0;0;.00nan;0;0
12293;86875;620;83;34;2;32;.941;3600000;0
12293;156298;611;0;0;0;0;.00nan;0;0
12294;16742;619;91;42;3;39;.929;3893000;0
12294;45323;622;0;0;0;0;.00nan;0;0
12294;78262;619;0;0;0;0;.00nan;0;0
12294;156322;622;39;19;4;15;.789;3893000;0
12295;43925;614;56;31;4;27;.871;3600000;0
12295;65434;2308;0;0;0;0;.00nan;0;0
12295;73187;614;0;0;0;0;.00nan;0;0
12295;156254;2308;95;20;0;20;1.000;3600000;0
12296;10141;2167;0;0;0;0;.00nan;0;0
12296;63529;2167;85;37;3;34;.919;3600000;0
12296;63848;2319;23;18;5;13;.722;3550000;0
12296;156221;2319;0;0;0;0;.00nan;0;0
12297;584;3923;100;44;2;42;.955;3600000;0
12297;173279;4644;0;0;0;0;.00nan;0;0
12297;73699;3923;0;0;0;0;.00nan;0;0
12297;156148;4644;44;17;3;14;.824;3600000;0
12298;32712;611;67;35;4;31;.886;3600000;0
12298;45193;620;0;0;0;0;.00nan;0;0
12298;86875;620;100;30;1;29;.967;3600000;0
12298;156298;611;0;0;0;0;.00nan;0;0
12299;3075;617;69;26;2;24;.923;3521000;0
12299;34959;612;0;0;0;0;.00nan;0;0
12299;56316;612;100;22;0;22;1.000;3600000;0
12299;143412;617;0;0;0;0;.00nan;0;0
12300;584;3923;70;44;4;40;.909;3531000;0
12300;32712;611;44;22;3;19;.864;3600000;0
12300;73699;3923;0;0;0;0;.00nan;0;0
12300;156298;611;0;0;0;0;.00nan;0;0
12301;3075;617;0;0;0;0;.00nan;0;0
12301;43925;614;94;29;1;28;.966;3600000;0
12301;73187;614;0;0;0;0;.00nan;0;0
12301;143412;617;69;22;2;20;.909;3548000;0
12302;173279;4644;55;35;5;30;.857;3825000;0
12302;34959;612;0;0;0;0;.00nan;0;0
12302;56316;612;63;34;4;30;.882;3825000;0
12302;156148;4644;0;0;0;0;.00nan;0;0
12303;45323;622;0;0;0;0;.00nan;0;0
12303;65434;2308;70;34;3;31;.912;4200000;0
12303;156254;2308;0;0;0;0;.00nan;0;0
12303;156322;622;59;31;3;28;.903;4200000;0
12304;45193;620;0;0;0;0;.00nan;0;0
12304;63848;2319;89;43;3;40;.930;3786000;0
12304;86875;620;74;31;2;29;.935;3786000;0
12304;156221;2319;0;0;0;0;.00nan;0;0
12305;10141;2167;0;0;0;0;.00nan;0;0
12305;16742;619;36;18;5;13;.722;3783000;0
12305;63529;2167;85;49;6;43;.878;3783000;0
12305;78262;619;0;0;0;0;.00nan;0;0
12306;10141;2167;0;0;0;0;.00nan;0;0
12306;16742;619;66;20;1;19;.950;3600000;0
12306;63529;2167;82;46;3;43;.935;3577000;0
12306;78262;619;0;0;0;0;.00nan;0;0
12307;16742;619;59;35;4;31;.886;3545000;0
12307;65434;2308;76;36;3;33;.917;3600000;0
12307;78262;619;0;0;0;0;.00nan;0;0
12307;156254;2308;0;0;0;0;.00nan;0;0
12308;584;3923;56;4;0;4;1.000;632000;0
12308;63848;2319;0;0;0;0;.00nan;0;0
12308;73699;3923;47;34;6;28;.824;2968000;0
12308;156221;2319;83;21;1;20;.952;3600000;0
12309;173279;4644;55;3;0;3;1.000;484000;0
12309;43925;614;100;22;0;22;1.000;3600000;0
12309;73187;614;0;0;0;0;.00nan;0;0
12309;156148;4644;44;42;7;35;.833;3116000;0
12310;10141;2167;66;30;2;28;.933;3287000;0
12310;45193;620;0;0;0;0;.00nan;0;0
12310;63529;2167;21;3;3;0;.000;313000;0
12310;86875;620;54;32;4;28;.875;3600000;0
12311;32712;611;59;34;4;30;.882;3592000;0
12311;34959;612;59;20;3;17;.850;3600000;0
12311;56316;612;0;0;0;0;.00nan;0;0
12311;156298;611;0;0;0;0;.00nan;0;0
12312;3075;617;0;0;0;0;.00nan;0;0
12312;45323;622;0;0;0;0;.00nan;0;0
12312;143412;617;67;40;4;36;.900;3528000;0
12312;156322;622;60;18;2;16;.889;3600000;0
12313;584;3923;48;37;6;31;.838;3528000;0
12313;10141;2167;0;0;0;0;.00nan;0;0
12313;63529;2167;40;21;4;17;.810;3600000;0
12313;73699;3923;0;0;0;0;.00nan;0;0
12314;3075;617;41;35;6;29;.829;3100000;0
12314;65434;2308;62;18;1;17;.944;3600000;0
12314;143412;617;50;1;0;1;1.000;500000;0
12314;156254;2308;0;0;0;0;.00nan;0;0
12315;34959;612;86;32;2;30;.938;3600000;0
12315;56316;612;0;0;0;0;.00nan;0;0
12315;63848;2319;52;31;4;27;.871;3560000;0
12315;156221;2319;0;0;0;0;.00nan;0;0
12316;173279;4644;64;34;4;30;.882;3600000;0
12316;45323;622;32;23;5;18;.783;3600000;0
12316;156148;4644;0;0;0;0;.00nan;0;0
12316;156322;622;0;0;0;0;.00nan;0;0
12317;16742;619;62;16;1;15;.938;3600000;0
12317;45193;620;0;0;0;0;.00nan;0;0
12317;78262;619;0;0;0;0;.00nan;0;0
12317;86875;620;39;29;5;24;.828;3600000;0
12318;43925;614;60;27;3;24;.889;3565000;0
12318;63848;2319;64;21;2;19;.905;3600000;0
12318;73187;614;0;0;0;0;.00nan;0;0
12318;156221;2319;0;0;0;0;.00nan;0;0
12319;173279;4644;78;35;2;33;.943;4200000;0
12319;65434;2308;75;36;2;34;.944;4200000;0
12319;156148;4644;0;0;0;0;.00nan;0;0
12319;156254;2308;0;0;0;0;.00nan;0;0
12320;10141;2167;78;52;5;47;.904;3600000;0
12320;34959;612;0;0;0;0;.00nan;0;0
12320;56316;612;61;21;2;19;.905;3600000;0
12320;63529;2167;0;0;0;0;.00nan;0;0
12321;584;3923;24;14;4;10;.714;1152000;0
12321;45193;620;0;0;0;0;.00nan;0;0
12321;73699;3923;86;34;1;33;.971;2448000;0
12321;86875;620;87;29;1;28;.966;3600000;0
12322;32712;611;0;0;0;0;.00nan;0;0
12322;45323;622;0;0;0;0;.00nan;0;0
12322;156298;611;80;47;4;43;.915;3570000;0
12322;156322;622;61;22;2;20;.909;3600000;0
12323;3075;617;0;0;0;0;.00nan;0;0
12323;16742;619;88;29;1;28;.966;3600000;0
12323;78262;619;0;0;0;0;.00nan;0;0
12323;143412;617;97;48;3;45;.938;3600000;0
12324;10141;2167;0;0;0;0;.00nan;0;0
12324;43925;614;0;0;0;0;.00nan;0;0
12324;63529;2167;78;42;4;38;.905;3600000;0
12324;73187;614;65;16;1;15;.938;3600000;0
12325;32712;611;57;42;5;37;.881;3566000;0
12325;65434;2308;43;19;4;15;.789;3600000;0
12325;156254;2308;0;0;0;0;.00nan;0;0
12325;156298;611;0;0;0;0;.00nan;0;0
12326;45323;622;0;0;0;0;.00nan;0;0
12326;63848;2319;92;63;3;60;.952;4200000;0
12326;156221;2319;0;0;0;0;.00nan;0;0
12326;156322;622;74;27;3;24;.889;4200000;0
12327;3075;617;62;36;4;32;.889;3578000;0
12327;173279;4644;73;22;2;20;.909;3600000;0
12327;143412;617;0;0;0;0;.00nan;0;0
12327;156148;4644;0;0;0;0;.00nan;0;0
12328;584;3923;89;41;2;39;.951;3557000;0
12328;16742;619;80;12;0;12;1.000;3600000;0
12328;73699;3923;0;0;0;0;.00nan;0;0
12328;78262;619;0;0;0;0;.00nan;0;0
12329;32712;611;70;40;5;35;.875;3600000;0
12329;43925;614;55;18;2;16;.889;3600000;0
12329;73187;614;0;0;0;0;.00nan;0;0
12329;156298;611;0;0;0;0;.00nan;0;0
12330;584;3923;0;0;0;0;.00nan;0;0
12330;34959;612;0;0;0;0;.00nan;0;0
12330;56316;612;57;18;2;16;.889;3600000;0
12330;73699;3923;71;45;4;41;.911;3600000;0
12331;63848;2319;97;39;1;38;.974;4200000;0
12331;65434;2308;89;31;1;30;.968;4200000;0
12331;156221;2319;0;0;0;0;.00nan;0;0
12331;156254;2308;0;0;0;0;.00nan;0;0
12332;173279;4644;0;0;0;0;.00nan;0;0
12332;16742;619;54;18;2;16;.889;3600000;0
12332;78262;619;0;0;0;0;.00nan;0;0
12332;156148;4644;51;34;5;29;.853;3600000;0
12333;10141;2167;0;0;0;0;.00nan;0;0
12333;45323;622;0;0;0;0;.00nan;0;0
12333;63529;2167;100;57;4;53;.930;4200000;0
12333;156322;622;53;20;4;16;.800;4200000;0
12334;43925;614;82;22;1;21;.955;3600000;0
12334;45193;620;0;0;0;0;.00nan;0;0
12334;73187;614;0;0;0;0;.00nan;0;0
12334;86875;620;82;39;2;37;.949;3543000;0
12335;3075;617;0;0;0;0;.00nan;0;0
12335;32712;611;95;40;0;40;1.000;4200000;0
12335;143412;617;79;14;0;14;1.000;4200000;0
12335;156298;611;0;0;0;0;.00nan;0;0
12336;584;3923;36;19;4;15;.789;1131000;0
12336;43925;614;75;16;1;15;.938;3600000;0
12336;73187;614;0;0;0;0;.00nan;0;0
12336;73699;3923;31;28;6;22;.786;2469000;0
12337;10141;2167;56;5;0;5;1.000;368000;0
12337;63529;2167;77;53;6;47;.887;3232000;0
12337;65434;2308;51;9;1;8;.889;3600000;0
12337;156254;2308;0;0;0;0;.00nan;0;0
12338;173279;4644;42;15;3;12;.800;3586000;0
12338;32712;611;66;28;2;26;.929;3600000;0
12338;156148;4644;0;0;0;0;.00nan;0;0
12338;156298;611;0;0;0;0;.00nan;0;0
12339;45193;620;0;0;0;0;.00nan;0;0
12339;45323;622;61;35;4;31;.886;4081000;0
12339;86875;620;59;42;5;37;.881;4081000;0
12339;156322;622;0;0;0;0;.00nan;0;0
12340;3075;617;0;0;0;0;.00nan;0;0
12340;63848;2319;64;19;1;18;.947;3600000;0
12340;143412;617;73;46;5;41;.891;3600000;0
12340;156221;2319;0;0;0;0;.00nan;0;0
12341;16742;619;61;32;3;29;.906;3585000;0
12341;34959;612;79;27;2;25;.926;3600000;0
12341;56316;612;0;0;0;0;.00nan;0;0
12341;78262;619;0;0;0;0;.00nan;0;0
12342;584;3923;76;18;0;18;1.000;880000;0
12342;45323;622;0;0;0;0;.00nan;0;0
12342;73699;3923;22;40;8;32;.800;2720000;0
12342;156322;622;48;17;3;14;.824;3600000;0
12343;173279;4644;41;40;6;34;.850;2562000;0
12343;63848;2319;42;13;3;10;.769;3600000;0
12343;156148;4644;48;7;1;6;.857;1038000;0
12343;156221;2319;0;0;0;0;.00nan;0;0
12344;34959;612;59;15;1;14;.933;3600000;0
12344;43925;614;74;38;3;35;.921;3535000;0
12344;56316;612;0;0;0;0;.00nan;0;0
12344;73187;614;0;0;0;0;.00nan;0;0
12345;3075;617;0;0;0;0;.00nan;0;0
12345;10141;2167;0;0;0;0;.00nan;0;0
12345;63529;2167;99;27;1;26;.963;3600000;0
12345;143412;617;60;23;2;21;.913;3600000;0
12346;45193;620;0;0;0;0;.00nan;0;0
12346;65434;2308;0;0;0;0;.00nan;0;0
12346;86875;620;99;39;1;38;.974;3600000;0
12346;156254;2308;54;24;3;21;.875;3515000;0
12347;16742;619;55;26;3;23;.885;3566000;0
12347;32712;611;88;35;2;33;.943;3600000;0
12347;78262;619;0;0;0;0;.00nan;0;0
12347;156298;611;0;0;0;0;.00nan;0;0
12348;584;3923;0;0;0;0;.00nan;0;0
12348;65434;2308;47;6;1;5;.833;3600000;0
12348;73699;3923;83;53;4;49;.925;3600000;0
12348;156254;2308;0;0;0;0;.00nan;0;0
12349;10141;2167;0;0;0;0;.00nan;0;0
12349;173279;4644;16;24;7;17;.708;3600000;0
12349;63529;2167;61;30;4;26;.867;3600000;0
12349;156148;4644;0;0;0;0;.00nan;0;0
12350;34959;612;0;0;0;0;.00nan;0;0
12350;45323;622;0;0;0;0;.00nan;0;0
12350;56316;612;70;22;1;21;.955;3600000;0
12350;156322;622;54;36;5;31;.861;3600000;0
12351;32712;611;49;21;3;18;.857;3600000;0
12351;63848;2319;46;32;5;27;.844;3529000;0
12351;156221;2319;0;0;0;0;.00nan;0;0
12351;156298;611;0;0;0;0;.00nan;0;0
12352;3075;617;52;9;1;8;.889;1628000;0
12352;45193;620;0;0;0;0;.00nan;0;0
12352;86875;620;43;24;4;20;.833;3600000;0
12352;143412;617;31;31;6;25;.806;1972000;0
12353;16742;619;0;0;0;0;.00nan;0;0
12353;43925;614;63;31;3;28;.903;3514000;0
12353;73187;614;0;0;0;0;.00nan;0;0
12353;78262;619;98;34;1;33;.971;3600000;0
12354;584;3923;54;28;3;25;.893;3600000;0
12354;3075;617;0;0;0;0;.00nan;0;0
12354;73699;3923;0;0;0;0;.00nan;0;0
12354;143412;617;57;19;2;17;.895;3600000;0
12355;43925;614;0;0;0;0;.00nan;0;0
12355;45323;622;0;0;0;0;.00nan;0;0
12355;73187;614;100;26;0;26;1.000;3600000;0
12355;156322;622;61;29;3;26;.897;3600000;0
12356;16742;619;90;33;3;30;.909;4200000;0
12356;63848;2319;53;22;3;19;.864;4200000;0
12356;78262;619;0;0;0;0;.00nan;0;0
12356;156221;2319;0;0;0;0;.00nan;0;0
12357;34959;612;0;0;0;0;.00nan;0;0
12357;56316;612;88;29;1;28;.966;3600000;0
12357;65434;2308;65;29;3;26;.897;3583000;0
12357;156254;2308;0;0;0;0;.00nan;0;0
12358;10141;2167;0;0;0;0;.00nan;0;0
12358;32712;611;57;22;2;20;.909;3546000;0
12358;63529;2167;100;35;0;35;1.000;3600000;0
12358;156298;611;0;0;0;0;.00nan;0;0
12359;173279;4644;44;24;4;20;.833;3600000;0
12359;45193;620;72;27;2;25;.926;3600000;0
12359;86875;620;0;0;0;0;.00nan;0;0
12359;156148;4644;0;0;0;0;.00nan;0;0
12360;584;3923;0;0;0;0;.00nan;0;0
12360;32712;611;70;21;2;19;.905;4200000;0
12360;73699;3923;99;41;2;39;.951;4200000;0
12360;156298;611;0;0;0;0;.00nan;0;0
12361;43925;614;0;0;0;0;.00nan;0;0
12361;45323;622;0;0;0;0;.00nan;0;0
12361;73187;614;88;40;2;38;.950;3600000;0
12361;156322;622;77;40;3;37;.925;3560000;0
12362;63848;2319;68;32;3;29;.906;3577000;0
12362;65434;2308;0;0;0;0;.00nan;0;0
12362;156221;2319;0;0;0;0;.00nan;0;0
12362;156254;2308;58;22;2;20;.909;3600000;0
12363;173279;4644;0;0;0;0;.00nan;0;0
12363;34959;612;68;33;4;29;.879;3600000;0
12363;56316;612;0;0;0;0;.00nan;0;0
12363;156148;4644;55;39;5;34;.872;3600000;0
12364;3075;617;69;43;4;39;.907;3600000;0
12364;10141;2167;0;0;0;0;.00nan;0;0
12364;63529;2167;89;30;1;29;.967;3600000;0
12364;143412;617;0;0;0;0;.00nan;0;0
12365;16742;619;99;24;0;24;1.000;3600000;0
12365;45193;620;0;0;0;0;.00nan;0;0
12365;78262;619;0;0;0;0;.00nan;0;0
12365;86875;620;46;26;4;22;.846;3600000;0
12366;584;3923;71;56;6;50;.893;3600000;0
12366;63848;2319;65;14;1;13;.929;3600000;0
12366;73699;3923;0;0;0;0;.00nan;0;0
12366;156221;2319;0;0;0;0;.00nan;0;0
12367;34959;612;0;0;0;0;.00nan;0;0
12367;43925;614;52;35;5;30;.857;3600000;0
12367;56316;612;52;26;4;22;.846;3600000;0
12367;73187;614;0;0;0;0;.00nan;0;0
12368;16742;619;56;51;7;44;.863;3600000;0
12368;45323;622;0;0;0;0;.00nan;0;0
12368;78262;619;0;0;0;0;.00nan;0;0
12368;156322;622;75;22;1;21;.955;3600000;0
12369;10141;2167;0;0;0;0;.00nan;0;0
12369;63529;2167;100;28;0;28;1.000;3600000;0
12369;65434;2308;72;23;1;22;.957;3544000;0
12369;156254;2308;0;0;0;0;.00nan;0;0
12370;3075;617;0;0;0;0;.00nan;0;0
12370;45193;620;0;0;0;0;.00nan;0;0
12370;86875;620;84;39;3;36;.923;3600000;0
12370;143412;617;46;25;4;21;.840;3600000;0
12371;173279;4644;47;31;4;27;.871;3531000;0
12371;32712;611;81;35;2;33;.943;3600000;0
12371;156148;4644;0;0;0;0;.00nan;0;0
12371;156298;611;0;0;0;0;.00nan;0;0
12372;584;3923;0;0;0;0;.00nan;0;0
12372;10141;2167;0;0;0;0;.00nan;0;0
12372;63529;2167;52;23;3;20;.870;3600000;0
12372;73699;3923;100;27;0;27;1.000;3600000;0
12373;45193;620;0;0;0;0;.00nan;0;0
12373;65434;2308;62;19;1;18;.947;3600000;0
12373;86875;620;83;40;3;37;.925;3600000;0
12373;156254;2308;0;0;0;0;.00nan;0;0
12374;173279;4644;68;26;3;23;.885;3543000;0
12374;43925;614;78;25;1;24;.960;3600000;0
12374;73187;614;0;0;0;0;.00nan;0;0
12374;156148;4644;0;0;0;0;.00nan;0;0
12375;32712;611;100;39;2;37;.949;3629000;0
12375;63848;2319;59;19;3;16;.842;3629000;0
12375;156221;2319;0;0;0;0;.00nan;0;0
12375;156298;611;0;0;0;0;.00nan;0;0
12376;3075;617;0;0;0;0;.00nan;0;0
12376;45323;622;0;0;0;0;.00nan;0;0
12376;143412;617;50;30;4;26;.867;3600000;0
12376;156322;622;80;26;1;25;.962;3600000;0
12377;16742;619;84;35;2;33;.943;3600000;0
12377;34959;612;64;28;4;24;.857;3584000;0
12377;56316;612;0;0;0;0;.00nan;0;0
12377;78262;619;0;0;0;0;.00nan;0;0
12378;16742;619;73;41;4;37;.902;3514000;0
12378;43925;614;72;31;2;29;.935;3600000;0
12378;73187;614;0;0;0;0;.00nan;0;0
12378;78262;619;0;0;0;0;.00nan;0;0
12379;173279;4644;79;50;5;45;.900;3596000;0
12379;63848;2319;48;24;4;20;.833;3600000;0
12379;156148;4644;0;0;0;0;.00nan;0;0
12379;156221;2319;0;0;0;0;.00nan;0;0
12380;3075;617;65;14;1;13;.929;1169000;0
12380;34959;612;0;0;0;0;.00nan;0;0
12380;56316;612;92;19;0;19;1.000;3600000;0
12380;143412;617;35;29;6;23;.793;2431000;0
12381;45323;622;79;29;2;27;.931;3600000;0
12381;65434;2308;88;49;4;45;.918;3552000;0
12381;156254;2308;0;0;0;0;.00nan;0;0
12381;156322;622;0;0;0;0;.00nan;0;0
12382;10141;2167;0;0;0;0;.00nan;0;0
12382;32712;611;63;32;4;28;.875;3678000;0
12382;63529;2167;64;27;3;24;.889;3678000;0
12382;156298;611;0;0;0;0;.00nan;0;0
12383;584;3923;77;55;6;49;.891;3205000;0
12383;45193;620;0;0;0;0;.00nan;0;0
12383;73699;3923;42;10;2;8;.800;395000;0
12383;86875;620;86;23;1;22;.957;3600000;0
12384;584;3923;37;32;6;26;.813;2400000;0
12384;45323;622;0;0;0;0;.00nan;0;0
12384;73699;3923;25;25;6;19;.760;1200000;0
12384;156322;622;69;11;1;10;.909;3600000;0
12385;34959;612;0;0;0;0;.00nan;0;0
12385;56316;612;92;29;1;28;.966;3600000;0
12385;65434;2308;0;0;0;0;.00nan;0;0
12385;156254;2308;74;38;3;35;.921;3529000;0
12386;10141;2167;0;0;0;0;.00nan;0;0
12386;63529;2167;45;44;7;37;.841;3600000;0
12386;63848;2319;62;20;3;17;.850;3600000;0
12386;156221;2319;0;0;0;0;.00nan;0;0
12387;173279;4644;0;0;0;0;.00nan;0;0
12387;16742;619;33;23;5;18;.783;3600000;0
12387;78262;619;0;0;0;0;.00nan;0;0
12387;156148;4644;100;38;0;38;1.000;3600000;0
12388;32712;611;81;36;3;33;.917;4200000;0
12388;45193;620;0;0;0;0;.00nan;0;0
12388;86875;620;76;48;3;45;.938;4200000;0
12388;156298;611;0;0;0;0;.00nan;0;0
12389;3075;617;0;0;0;0;.00nan;0;0
12389;43925;614;86;14;0;14;1.000;3600000;0
12389;73187;614;0;0;0;0;.00nan;0;0
12389;143412;617;85;47;4;43;.915;3600000;0
12390;43925;614;56;31;4;27;.871;3881000;0
12390;65434;2308;55;25;3;22;.880;3881000;0
12390;73187;614;0;0;0;0;.00nan;0;0
12390;156254;2308;0;0;0;0;.00nan;0;0
12391;584;3923;80;65;6;59;.908;3600000;0
12391;34959;612;78;11;0;11;1.000;3600000;0
12391;56316;612;0;0;0;0;.00nan;0;0
12391;73699;3923;0;0;0;0;.00nan;0;0
12392;32712;611;40;21;4;17;.810;925000;0
12392;45323;622;0;0;0;0;.00nan;0;0
12392;156298;611;57;36;4;32;.889;2675000;0
12392;156322;622;48;23;4;19;.826;3600000;0
12393;10141;2167;0;0;0;0;.00nan;0;0
12393;173279;4644;0;0;0;0;.00nan;0;0
12393;63529;2167;71;23;2;21;.913;3536000;0
12393;156148;4644;85;18;0;18;1.000;3600000;0
12394;45193;620;0;0;0;0;.00nan;0;0
12394;63848;2319;77;25;1;24;.960;3600000;0
12394;86875;620;84;34;2;32;.941;3600000;0
12394;156221;2319;0;0;0;0;.00nan;0;0
12395;3075;617;58;8;0;8;1.000;536000;0
12395;16742;619;100;31;0;31;1.000;3600000;0
12395;78262;619;0;0;0;0;.00nan;0;0
12395;143412;617;28;38;7;31;.816;3064000;0
12396;584;3923;0;0;0;0;.00nan;0;0
12396;43925;614;35;18;4;14;.778;3600000;0
12396;73187;614;0;0;0;0;.00nan;0;0
12396;73699;3923;59;39;5;34;.872;3571000;0
12397;16742;619;81;22;1;21;.955;3600000;0
12397;65434;2308;0;0;0;0;.00nan;0;0
12397;78262;619;0;0;0;0;.00nan;0;0
12397;156254;2308;71;32;3;29;.906;3600000;0
12398;45323;622;61;4;0;4;1.000;422000;0
12398;63848;2319;0;0;0;0;.00nan;0;0
12398;156221;2319;89;47;4;43;.915;3600000;0
12398;156322;622;23;25;6;19;.760;3126000;0
12399;3075;617;64;16;1;15;.938;1226000;0
12399;173279;4644;0;0;0;0;.00nan;0;0
12399;143412;617;34;25;5;20;.800;2374000;0
12399;156148;4644;48;20;3;17;.850;3600000;0
12400;10141;2167;0;0;0;0;.00nan;0;0
12400;45193;620;0;0;0;0;.00nan;0;0
12400;63529;2167;84;33;2;31;.939;3600000;0
12400;86875;620;72;32;3;29;.906;3591000;0
12401;32712;611;0;0;0;0;.00nan;0;0
12401;34959;612;48;28;4;24;.857;3600000;0
12401;56316;612;0;0;0;0;.00nan;0;0
12401;156298;611;66;38;5;33;.868;3529000;0
12402;32712;611;59;24;3;21;.875;3600000;0
12402;43925;614;63;20;2;18;.900;3600000;0
12402;73187;614;0;0;0;0;.00nan;0;0
12402;156298;611;0;0;0;0;.00nan;0;0
12403;34959;612;0;0;0;0;.00nan;0;0
12403;56316;612;45;23;4;19;.826;3600000;0
12403;63848;2319;74;39;3;36;.923;3600000;0
12403;156221;2319;0;0;0;0;.00nan;0;0
12404;10141;2167;0;0;0;0;.00nan;0;0
12404;45323;622;63;13;1;12;.923;3600000;0
12404;63529;2167;77;43;4;39;.907;3600000;0
12404;156322;622;0;0;0;0;.00nan;0;0
12405;173279;4644;0;0;0;0;.00nan;0;0
12405;45193;620;0;0;0;0;.00nan;0;0
12405;86875;620;76;31;3;28;.903;3543000;0
12405;156148;4644;57;19;2;17;.895;3600000;0
12406;3075;617;0;0;0;0;.00nan;0;0
12406;65434;2308;75;23;1;22;.957;3600000;0
12406;143412;617;79;31;2;29;.935;3563000;0
12406;156254;2308;0;0;0;0;.00nan;0;0
12407;584;3923;76;59;6;53;.898;3600000;0
12407;16742;619;0;0;0;0;.00nan;0;0
12407;73699;3923;0;0;0;0;.00nan;0;0
12407;78262;619;45;11;2;9;.818;3600000;0
12408;584;3923;0;0;0;0;.00nan;0;0
12408;3075;617;0;0;0;0;.00nan;0;0
12408;73699;3923;89;46;3;43;.935;3544000;0
12408;143412;617;57;18;2;16;.889;3600000;0
12409;43925;614;55;28;3;25;.893;3551000;0
12409;63848;2319;99;39;1;38;.974;3600000;0
12409;73187;614;0;0;0;0;.00nan;0;0
12409;156221;2319;0;0;0;0;.00nan;0;0
12410;173279;4644;73;27;2;25;.926;3600000;0
12410;65434;2308;54;25;3;22;.880;3546000;0
12410;156148;4644;0;0;0;0;.00nan;0;0
12410;156254;2308;0;0;0;0;.00nan;0;0
12411;10141;2167;0;0;0;0;.00nan;0;0
12411;34959;612;0;0;0;0;.00nan;0;0
12411;56316;612;40;22;4;18;.818;3548000;0
12411;63529;2167;75;38;3;35;.921;3600000;0
12412;45193;620;0;0;0;0;.00nan;0;0
12412;45323;622;0;0;0;0;.00nan;0;0
12412;86875;620;77;53;5;48;.906;3549000;0
12412;156322;622;53;22;3;19;.864;3600000;0
12413;16742;619;82;15;0;15;1.000;3600000;0
12413;32712;611;49;40;5;35;.875;3600000;0
12413;78262;619;0;0;0;0;.00nan;0;0
12413;156298;611;0;0;0;0;.00nan;0;0
12414;10141;2167;0;0;0;0;.00nan;0;0
12414;43925;614;100;17;0;17;1.000;3600000;0
12414;63529;2167;86;35;3;32;.914;3600000;0
12414;73187;614;0;0;0;0;.00nan;0;0
12415;584;3923;82;63;6;57;.905;3600000;0
12415;65434;2308;0;0;0;0;.00nan;0;0
12415;73699;3923;0;0;0;0;.00nan;0;0
12415;156254;2308;37;13;3;10;.769;3600000;0
12416;34959;612;0;0;0;0;.00nan;0;0
12416;45193;620;0;0;0;0;.00nan;0;0
12416;56316;612;68;19;1;18;.947;3600000;0
12416;86875;620;64;32;3;29;.906;3600000;0
12417;173279;4644;0;0;0;0;.00nan;0;0
12417;45323;622;0;0;0;0;.00nan;0;0
12417;156148;4644;65;38;4;34;.895;3600000;0
12417;156322;622;67;18;1;17;.944;3600000;0
12418;3075;617;68;33;2;31;.939;4200000;0
12418;32712;611;81;32;2;30;.938;4200000;0
12418;143412;617;0;0;0;0;.00nan;0;0
12418;156298;611;0;0;0;0;.00nan;0;0
12419;16742;619;62;35;4;31;.886;3600000;0
12419;63848;2319;93;36;2;34;.944;3600000;0
12419;78262;619;0;0;0;0;.00nan;0;0
12419;156221;2319;0;0;0;0;.00nan;0;0
12420;3075;617;0;0;0;0;.00nan;0;0
12420;63848;2319;58;18;2;16;.889;3560000;0
12420;143412;617;91;36;1;35;.972;3600000;0
12420;156221;2319;0;0;0;0;.00nan;0;0
12421;584;3923;43;10;2;8;.800;762000;0
12421;173279;4644;0;0;0;0;.00nan;0;0
12421;73699;3923;38;48;7;41;.854;2838000;0
12421;156148;4644;88;16;0;16;1.000;3600000;0
12422;45323;622;80;41;3;38;.927;3600000;0
12422;56316;612;52;27;4;23;.852;3591000;0
12422;65672;612;0;0;0;0;.00nan;0;0
12422;156322;622;0;0;0;0;.00nan;0;0
12423;10141;2167;48;17;2;15;.882;1414000;0
12423;16742;619;52;27;4;23;.852;3600000;0
12423;63529;2167;23;20;6;14;.700;2186000;0
12423;78262;619;0;0;0;0;.00nan;0;0
12424;43925;614;64;30;4;26;.867;3600000;0
12424;45193;620;0;0;0;0;.00nan;0;0
12424;73187;614;0;0;0;0;.00nan;0;0
12424;86875;620;76;25;1;24;.960;3600000;0
12425;32712;611;49;9;1;8;.889;1411000;0
12425;34959;2308;64;23;2;21;.913;3600000;0
12425;65434;2308;0;0;0;0;.00nan;0;0
12425;156298;611;9;30;8;22;.733;2189000;0
12426;584;3923;85;43;2;41;.953;4200000;0
12426;45193;620;0;0;0;0;.00nan;0;0
12426;73699;3923;0;0;0;0;.00nan;0;0
12426;86875;620;69;23;2;21;.913;4200000;0
12427;584;3923;0;0;0;0;.00nan;0;0
12427;63848;2319;63;12;1;11;.917;3600000;0
12427;73699;3923;80;40;3;37;.925;3600000;0
12427;156221;2319;0;0;0;0;.00nan;0;0
12428;43925;614;63;15;1;14;.933;1763000;0
12428;56316;612;82;14;0;14;1.000;3600000;0
12428;65672;612;0;0;0;0;.00nan;0;0
12428;73187;614;27;18;6;12;.667;1837000;0
12429;10141;2167;0;0;0;0;.00nan;0;0
12429;34959;2308;60;13;1;12;.923;3600000;0
12429;63529;2167;57;44;6;38;.864;3600000;0
12429;65434;2308;0;0;0;0;.00nan;0;0
12430;173279;4644;0;0;0;0;.00nan;0;0
12430;32712;611;52;33;5;28;.848;3600000;0
12430;156148;4644;71;27;2;25;.926;3600000;0
12430;156298;611;0;0;0;0;.00nan;0;0
12431;3075;617;0;0;0;0;.00nan;0;0
12431;45193;620;0;0;0;0;.00nan;0;0
12431;86875;620;56;34;4;30;.882;3573000;0
12431;143412;617;67;21;2;19;.905;3600000;0
12432;16742;619;28;28;6;22;.786;1844000;0
12432;45323;622;90;40;3;37;.925;3600000;0
12432;78262;619;35;11;3;8;.727;1756000;0
12432;156322;622;0;0;0;0;.00nan;0;0
12433;173279;4644;0;0;0;0;.00nan;0;0
12433;43925;614;79;46;4;42;.913;4200000;0
12433;73187;614;0;0;0;0;.00nan;0;0
12433;156148;4644;47;29;4;25;.862;4200000;0
12434;32712;611;98;42;1;41;.976;3563000;0
12434;63848;2319;97;23;0;23;1.000;3600000;0
12434;156221;2319;0;0;0;0;.00nan;0;0
12434;156298;611;0;0;0;0;.00nan;0;0
12435;16742;619;81;39;3;36;.923;3600000;0
12435;56316;612;74;23;2;21;.913;3600000;0
12435;65672;612;0;0;0;0;.00nan;0;0
12435;78262;619;0;0;0;0;.00nan;0;0
12436;3075;617;68;35;4;31;.886;3521000;0
12436;45323;622;69;27;2;25;.926;3600000;0
12436;143412;617;0;0;0;0;.00nan;0;0
12436;156322;622;0;0;0;0;.00nan;0;0
12437;584;3923;64;52;6;46;.885;2991000;0
12437;10141;2167;0;0;0;0;.00nan;0;0
12437;63529;2167;74;22;2;20;.909;3600000;0
12437;73699;3923;56;5;0;5;1.000;609000;0
12438;34959;2308;61;20;3;17;.850;3570000;0
12438;45193;620;0;0;0;0;.00nan;0;0
12438;65434;2308;0;0;0;0;.00nan;0;0
12438;86875;620;87;38;2;36;.947;3600000;0
12439;584;3923;0;0;0;0;.00nan;0;0
12439;45193;620;0;0;0;0;.00nan;0;0
12439;73699;3923;81;51;3;48;.941;3581000;0
12439;86875;620;65;17;1;16;.941;3600000;0
12440;34959;2308;66;25;2;23;.920;3600000;0
12440;45323;622;60;43;5;38;.884;3600000;0
12440;65434;2308;0;0;0;0;.00nan;0;0
12440;156322;622;0;0;0;0;.00nan;0;0
12441;173279;4644;77;41;3;38;.927;4081000;0
12441;63848;2319;71;29;2;27;.931;4081000;0
12441;156148;4644;0;0;0;0;.00nan;0;0
12441;156221;2319;0;0;0;0;.00nan;0;0
12442;10141;2167;0;0;0;0;.00nan;0;0
12442;32712;611;36;24;5;19;.792;3513000;0
12442;63529;2167;89;43;3;40;.930;3600000;0
12442;156298;611;0;0;0;0;.00nan;0;0
12443;3075;617;0;0;0;0;.00nan;0;0
12443;56316;612;77;21;1;20;.952;3600000;0
12443;65672;612;0;0;0;0;.00nan;0;0
12443;143412;617;76;46;4;42;.913;3600000;0
12444;16742;619;51;2;0;2;1.000;532000;0
12444;43925;614;83;28;1;27;.964;3600000;0
12444;73187;614;0;0;0;0;.00nan;0;0
12444;78262;619;46;38;6;32;.842;3068000;0
12445;3075;617;0;0;0;0;.00nan;0;0
12445;43925;614;71;16;1;15;.938;3600000;0
12445;73187;614;0;0;0;0;.00nan;0;0
12445;143412;617;96;38;2;36;.947;3600000;0
12446;34959;2308;97;32;1;31;.969;3600000;0
12446;56316;612;76;34;3;31;.912;3562000;0
12446;65434;2308;0;0;0;0;.00nan;0;0
12446;65672;612;0;0;0;0;.00nan;0;0
12447;584;3923;58;45;6;39;.867;2388000;0
12447;45323;622;48;7;1;6;.857;3600000;0
12447;73699;3923;41;25;4;21;.840;1212000;0
12447;156322;622;0;0;0;0;.00nan;0;0
12448;10141;2167;0;0;0;0;.00nan;0;0
12448;63529;2167;88;51;4;47;.922;3600000;0
12448;63848;2319;64;16;1;15;.938;3600000;0
12448;156221;2319;0;0;0;0;.00nan;0;0
12449;32712;611;52;27;3;24;.889;4200000;0
12449;45193;620;0;0;0;0;.00nan;0;0
12449;86875;620;52;29;3;26;.897;4200000;0
12449;156298;611;0;0;0;0;.00nan;0;0
12450;173279;4644;67;12;0;12;1.000;882000;0
12450;16742;619;100;26;0;26;1.000;3600000;0
12450;78262;619;0;0;0;0;.00nan;0;0
12450;156148;4644;26;29;6;23;.793;2718000;0
12451;584;3923;0;0;0;0;.00nan;0;0
12451;56316;612;80;11;0;11;1.000;3600000;0
12451;65672;612;0;0;0;0;.00nan;0;0
12451;73699;3923;98;56;1;55;.982;3600000;0
12452;34959;2308;11;19;7;12;.632;2114000;0
12452;43925;614;30;35;7;28;.800;3600000;0
12452;65434;2308;52;16;2;14;.875;1400000;0
12452;73187;614;0;0;0;0;.00nan;0;0
12453;45193;620;0;0;0;0;.00nan;0;0
12453;63848;2319;96;41;1;40;.976;3600000;0
12453;86875;620;76;35;3;32;.914;3573000;0
12453;156221;2319;0;0;0;0;.00nan;0;0
12454;10141;2167;0;0;0;0;.00nan;0;0
12454;173279;4644;0;0;0;0;.00nan;0;0
12454;63529;2167;59;49;7;42;.857;3600000;0
12454;156148;4644;55;18;2;16;.889;3600000;0
12455;32712;611;38;7;2;5;.714;769000;0
12455;45323;622;50;5;1;4;.800;1230000;0
12455;156298;611;37;36;6;30;.833;2763000;0
12455;156322;622;29;21;5;16;.762;2370000;0
12456;3075;617;21;20;6;14;.700;1627000;0
12456;16742;619;42;15;3;12;.800;3600000;0
12456;78262;619;0;0;0;0;.00nan;0;0
12456;143412;617;92;32;1;31;.969;1973000;0
12457;584;3923;83;51;4;47;.922;3600000;0
12457;43925;614;83;13;0;13;1.000;3600000;0
12457;73187;614;0;0;0;0;.00nan;0;0
12457;73699;3923;0;0;0;0;.00nan;0;0
12458;32712;611;32;37;7;30;.811;1706000;0
12458;56316;612;75;21;2;19;.905;3600000;0
12458;65672;612;0;0;0;0;.00nan;0;0
12458;156298;611;58;34;4;30;.882;1894000;0
12459;45323;622;0;0;0;0;.00nan;0;0
12459;63848;2319;74;36;3;33;.917;3600000;0
12459;156221;2319;0;0;0;0;.00nan;0;0
12459;156322;622;51;26;4;22;.846;3542000;0
12460;10141;2167;0;0;0;0;.00nan;0;0
12460;45193;620;0;0;0;0;.00nan;0;0
12460;63529;2167;80;29;2;27;.931;3600000;0
12460;86875;620;77;34;3;31;.912;3542000;0
12461;3075;617;0;0;0;0;.00nan;0;0
12461;173279;4644;0;0;0;0;.00nan;0;0
12461;143412;617;61;44;5;39;.886;3550000;0
12461;156148;4644;37;22;4;18;.818;3600000;0
12462;16742;619;99;47;1;46;.979;3600000;0
12462;34959;2308;62;40;5;35;.875;3600000;0
12462;65434;2308;0;0;0;0;.00nan;0;0
12462;78262;619;0;0;0;0;.00nan;0;0
12463;584;3923;55;42;6;36;.857;2621000;0
12463;16742;619;51;19;3;16;.842;3600000;0
12463;73699;3923;51;25;3;22;.880;979000;0
12463;78262;619;0;0;0;0;.00nan;0;0
12464;3075;617;37;25;5;20;.800;1239000;0
12464;34959;2308;81;15;0;15;1.000;3600000;0
12464;65434;2308;0;0;0;0;.00nan;0;0
12464;143412;617;38;35;7;28;.800;2361000;0
12465;56316;612;46;20;3;17;.850;3992000;0
12465;63848;2319;97;57;2;55;.965;3992000;0
12465;65672;612;0;0;0;0;.00nan;0;0
12465;156221;2319;0;0;0;0;.00nan;0;0
12466;173279;4644;0;0;0;0;.00nan;0;0
12466;45193;620;0;0;0;0;.00nan;0;0
12466;86875;620;64;35;4;31;.886;3669000;0
12466;156148;4644;28;24;5;19;.792;3669000;0
12467;10141;2167;73;33;3;30;.909;3600000;0
12467;45323;622;0;0;0;0;.00nan;0;0
12467;63529;2167;0;0;0;0;.00nan;0;0
12467;156322;622;41;23;4;19;.826;3593000;0
12468;32712;611;98;39;1;38;.974;3600000;0
12468;43925;614;98;22;0;22;1.000;3600000;0
12468;73187;614;0;0;0;0;.00nan;0;0
12468;156298;611;0;0;0;0;.00nan;0;0
12469;43925;614;100;34;0;34;1.000;3600000;0
12469;63848;2319;89;35;2;33;.943;3566000;0
12469;73187;614;0;0;0;0;.00nan;0;0
12469;156221;2319;0;0;0;0;.00nan;0;0
12470;173279;4644;0;0;0;0;.00nan;0;0
12470;34959;2308;53;24;3;21;.875;3600000;0
12470;65434;2308;0;0;0;0;.00nan;0;0
12470;156148;4644;47;34;5;29;.853;3538000;0
12471;10141;2167;62;21;2;19;.905;1203000;0
12471;56316;612;68;22;2;20;.909;3600000;0
12471;63529;2167;35;26;6;20;.769;2397000;0
12471;65672;612;0;0;0;0;.00nan;0;0
12472;45193;620;0;0;0;0;.00nan;0;0
12472;45323;622;76;29;2;27;.931;3600000;0
12472;86875;620;33;28;5;23;.821;3600000;0
12472;156322;622;0;0;0;0;.00nan;0;0
12473;584;3923;86;34;2;32;.941;3600000;0
12473;3075;617;100;25;0;25;1.000;3600000;0
12473;73699;3923;0;0;0;0;.00nan;0;0
12473;143412;617;0;0;0;0;.00nan;0;0
12474;16742;619;32;22;5;17;.773;3554000;0
12474;32712;611;63;36;4;32;.889;3600000;0
12474;78262;619;0;0;0;0;.00nan;0;0
12474;156298;611;0;0;0;0;.00nan;0;0
12475;584;3923;0;0;0;0;.00nan;0;0
12475;34959;2308;61;14;1;13;.929;3600000;0
12475;65434;2308;0;0;0;0;.00nan;0;0
12475;73699;3923;63;58;8;50;.862;3600000;0
12476;16742;619;64;39;4;35;.897;3522000;0
12476;63848;2319;100;44;2;42;.955;3600000;0
12476;78262;619;0;0;0;0;.00nan;0;0
12476;156221;2319;0;0;0;0;.00nan;0;0
12477;173279;4644;41;44;6;38;.864;3600000;0
12477;45323;622;45;5;1;4;.800;853000;0
12477;156148;4644;0;0;0;0;.00nan;0;0
12477;156322;622;26;31;7;24;.774;2700000;0
12478;10141;2167;0;0;0;0;.00nan;0;0
12478;43925;614;71;22;1;21;.955;3600000;0
12478;63529;2167;82;46;4;42;.913;3600000;0
12478;73187;614;0;0;0;0;.00nan;0;0
12479;45193;620;92;46;1;45;.978;3751000;0
12479;56316;612;100;26;0;26;1.000;3751000;0
12479;65672;612;0;0;0;0;.00nan;0;0
12479;86875;620;0;0;0;0;.00nan;0;0
12480;3075;617;78;20;1;19;.950;3600000;0
12480;32712;611;64;22;2;20;.909;3567000;0
12480;143412;617;0;0;0;0;.00nan;0;0
12480;156298;611;0;0;0;0;.00nan;0;0
12481;45193;620;61;31;4;27;.871;3600000;0
12481;56316;612;78;16;1;15;.938;3600000;0
12481;65672;612;0;0;0;0;.00nan;0;0
12481;86875;620;0;0;0;0;.00nan;0;0
12482;16742;619;77;39;3;36;.923;3600000;0
12482;45323;622;0;0;0;0;.00nan;0;0
12482;78262;619;0;0;0;0;.00nan;0;0
12482;156322;622;100;42;0;42;1.000;3600000;0
12483;584;3923;69;48;6;42;.875;3600000;0
12483;173279;4644;88;15;0;15;1.000;3600000;0
12483;73699;3923;0;0;0;0;.00nan;0;0
12483;156148;4644;0;0;0;0;.00nan;0;0
12484;43925;614;66;23;2;21;.913;3600000;0
12484;45193;620;0;0;0;0;.00nan;0;0
12484;73187;614;0;0;0;0;.00nan;0;0
12484;86875;620;46;39;5;34;.872;3600000;0
12485;32712;611;49;46;7;39;.848;3600000;0
12485;34959;2308;49;21;3;18;.857;3600000;0
12485;65434;2308;0;0;0;0;.00nan;0;0
12485;156298;611;0;0;0;0;.00nan;0;0
12486;45323;622;0;0;0;0;.00nan;0;0
12486;56316;612;63;29;3;26;.897;3600000;0
12486;65672;612;0;0;0;0;.00nan;0;0
12486;156322;622;67;19;1;18;.947;3600000;0
12487;3075;617;0;0;0;0;.00nan;0;0
12487;63848;2319;39;21;4;17;.810;3523000;0
12487;143412;617;85;41;2;39;.951;3600000;0
12487;156221;2319;0;0;0;0;.00nan;0;0
12488;10141;2167;0;0;0;0;.00nan;0;0
12488;16742;619;0;0;0;0;.00nan;0;0
12488;63529;2167;99;47;1;46;.979;3600000;0
12488;78262;619;48;13;2;11;.846;3543000;0
12489;34959;2308;78;37;3;34;.919;3600000;0
12489;63848;2319;62;35;4;31;.886;3594000;0
12489;65434;2308;0;0;0;0;.00nan;0;0
12489;156221;2319;0;0;0;0;.00nan;0;0
12490;173279;4644;98;25;0;25;1.000;3600000;0
12490;56316;612;78;26;1;25;.962;3578000;0
12490;65672;612;0;0;0;0;.00nan;0;0
12490;156148;4644;0;0;0;0;.00nan;0;0
12491;43925;614;40;29;5;24;.828;3600000;0
12491;45323;622;64;23;2;21;.913;3600000;0
12491;73187;614;0;0;0;0;.00nan;0;0
12491;156322;622;0;0;0;0;.00nan;0;0
12492;3075;617;0;0;0;0;.00nan;0;0
12492;10141;2167;51;3;0;3;1.000;425000;0
12492;63529;2167;43;35;6;29;.829;3175000;0
12492;143412;617;66;27;2;25;.926;3600000;0
12493;16742;619;55;18;2;16;.889;3600000;0
12493;45193;620;0;0;0;0;.00nan;0;0
12493;78262;619;0;0;0;0;.00nan;0;0
12493;86875;620;75;45;4;41;.911;3588000;0
12494;584;3923;0;0;0;0;.00nan;0;0
12494;32712;611;0;0;0;0;.00nan;0;0
12494;73699;3923;75;43;3;40;.930;3600000;0
12494;156298;611;77;27;1;26;.963;3600000;0
12496;63848;2319;77;37;4;33;.892;3573000;0
12496;65434;2308;71;28;2;26;.929;3600000;0
12496;66477;2319;0;0;0;0;.00nan;0;0
12496;156254;2308;0;0;0;0;.00nan;0;0
12498;16742;619;62;25;3;22;.880;3600000;0
12498;43925;614;83;46;4;42;.913;3600000;0
12498;73187;614;0;0;0;0;.00nan;0;0
12498;78262;619;0;0;0;0;.00nan;0;0
12500;3075;617;79;46;3;43;.935;3600000;0
12500;34959;612;0;0;0;0;.00nan;0;0
12500;56316;612;86;15;0;15;1.000;3600000;0
12500;143412;617;0;0;0;0;.00nan;0;0
12502;173279;4644;98;54;3;51;.944;3600000;0
12502;45323;622;0;0;0;0;.00nan;0;0
12502;156148;4644;0;0;0;0;.00nan;0;0
12502;156322;622;61;22;2;20;.909;3600000;0
12504;584;3923;78;34;2;32;.941;3600000;0
12504;45193;620;0;0;0;0;.00nan;0;0
12504;73699;3923;0;0;0;0;.00nan;0;0
12504;86875;620;35;16;4;12;.750;3515000;0
12506;10141;2167;0;0;0;0;.00nan;0;0
12506;32712;611;78;25;1;24;.960;4200000;0
12506;63529;2167;85;36;1;35;.972;4200000;0
12506;156298;611;0;0;0;0;.00nan;0;0
12508;16742;619;0;0;0;0;.00nan;0;0
12508;43925;614;67;37;4;33;.892;3120000;0
12508;73187;614;30;7;3;4;.571;480000;0
12508;78262;619;65;22;3;19;.864;3600000;0
12510;32712;611;0;0;0;0;.00nan;0;0
12510;63848;2319;79;21;1;20;.952;3600000;0
12510;66477;2319;0;0;0;0;.00nan;0;0
12510;156298;611;57;35;5;30;.857;3600000;0
12512;3075;617;0;0;0;0;.00nan;0;0
12512;45193;620;0;0;0;0;.00nan;0;0
12512;86875;620;66;36;3;33;.917;3600000;0
12512;143412;617;72;29;2;27;.931;3600000;0
12514;10141;2167;63;49;6;43;.878;3600000;0
12514;63529;2167;0;0;0;0;.00nan;0;0
12514;65434;2308;0;0;0;0;.00nan;0;0
12514;156254;2308;62;22;3;19;.864;3600000;0
12516;173279;4644;0;0;0;0;.00nan;0;0
12516;45323;622;82;29;2;27;.931;3600000;0
12516;156148;4644;81;46;4;42;.913;3599000;0
12516;156322;622;0;0;0;0;.00nan;0;0
12518;584;3923;59;12;1;11;.917;997000;0
12518;34959;612;0;0;0;0;.00nan;0;0
12518;56316;612;46;23;4;19;.826;3600000;0
12518;73699;3923;43;39;6;33;.846;2603000;0
12520;10141;2167;0;0;0;0;.00nan;0;0
12520;63529;2167;87;44;3;41;.932;3600000;0
12520;65434;2308;61;13;1;12;.923;3600000;0
12520;156254;2308;0;0;0;0;.00nan;0;0
12522;16742;619;58;23;2;21;.913;3543000;0
12522;43925;614;95;37;1;36;.973;3600000;0
12522;73187;614;0;0;0;0;.00nan;0;0
12522;78262;619;0;0;0;0;.00nan;0;0
12524;173279;4644;59;45;6;39;.867;3600000;0
12524;45323;622;0;0;0;0;.00nan;0;0
12524;156148;4644;0;0;0;0;.00nan;0;0
12524;156322;622;65;35;3;32;.914;3600000;0
12526;34959;612;54;32;4;28;.875;3581000;0
12526;56316;612;0;0;0;0;.00nan;0;0
12526;63848;2319;64;27;3;24;.889;3600000;0
12526;66477;2319;0;0;0;0;.00nan;0;0
12528;32712;611;55;42;5;37;.881;3518000;0
12528;45193;620;0;0;0;0;.00nan;0;0
12528;86875;620;67;36;3;33;.917;3600000;0
12528;156298;611;0;0;0;0;.00nan;0;0
12530;584;3923;89;41;2;39;.951;3600000;0
12530;3075;617;0;0;0;0;.00nan;0;0
12530;73699;3923;0;0;0;0;.00nan;0;0
12530;143412;617;48;23;3;20;.870;3577000;0
12534;32712;611;27;15;4;11;.733;882000;0
12534;34959;612;0;0;0;0;.00nan;0;0
12534;56316;612;100;21;0;21;1.000;3600000;0
12534;156298;611;77;40;3;37;.925;2718000;0
12536;584;3923;0;0;0;0;.00nan;0;0
12536;45323;622;0;0;0;0;.00nan;0;0
12536;73699;3923;97;65;5;60;.923;3600000;0
12536;156322;622;45;15;3;12;.800;3600000;0
12538;3075;617;35;22;5;17;.773;3600000;0
12538;173279;4644;28;37;7;30;.811;3575000;0
12538;143412;617;0;0;0;0;.00nan;0;0
12538;156148;4644;0;0;0;0;.00nan;0;0
12540;45193;620;0;0;0;0;.00nan;0;0
12540;63848;2319;100;21;0;21;1.000;3600000;0
12540;66477;2319;0;0;0;0;.00nan;0;0
12540;86875;620;80;34;2;32;.941;3600000;0
12542;10141;2167;0;0;0;0;.00nan;0;0
12542;16742;619;61;26;2;24;.923;3600000;0
12542;63529;2167;98;51;3;48;.941;3600000;0
12542;78262;619;0;0;0;0;.00nan;0;0
12546;16742;619;0;0;0;0;.00nan;0;0
12546;45323;622;72;21;1;20;.952;3600000;0
12546;78262;619;21;39;9;30;.769;3600000;0
12546;156322;622;0;0;0;0;.00nan;0;0
12548;10141;2167;0;0;0;0;.00nan;0;0
12548;173279;4644;0;0;0;0;.00nan;0;0
12548;63529;2167;89;36;2;34;.944;4200000;0
12548;156148;4644;93;40;2;38;.950;4200000;0
12550;34959;612;0;0;0;0;.00nan;0;0
12550;56316;612;66;24;3;21;.875;3600000;0
12550;63848;2319;59;42;6;36;.857;3600000;0
12550;156221;2319;0;0;0;0;.00nan;0;0
12552;584;3923;69;45;5;40;.889;3600000;0
12552;3075;617;0;0;0;0;.00nan;0;0
12552;73699;3923;0;0;0;0;.00nan;0;0
12552;143412;617;70;8;0;8;1.000;3600000;0
12554;43925;614;64;18;1;17;.944;3600000;0
12554;45193;620;74;32;2;30;.938;3592000;0
12554;73187;614;0;0;0;0;.00nan;0;0
12554;86875;620;0;0;0;0;.00nan;0;0
12556;16742;619;46;34;5;29;.853;3600000;0
12556;45323;622;0;0;0;0;.00nan;0;0
12556;78262;619;0;0;0;0;.00nan;0;0
12556;156322;622;90;38;2;36;.947;3600000;0
12558;173279;4644;59;41;5;36;.878;3318000;0
12558;43925;614;45;15;2;13;.867;3600000;0
12558;73187;614;0;0;0;0;.00nan;0;0
12558;156148;4644;36;6;2;4;.667;282000;0
12560;3075;617;44;32;5;27;.844;3397000;0
12560;34959;612;82;23;1;22;.957;3600000;0
12560;56316;612;0;0;0;0;.00nan;0;0
12560;143412;617;26;7;3;4;.571;203000;0
12562;584;3923;0;0;0;0;.00nan;0;0
12562;63848;2319;88;12;0;12;1.000;3600000;0
12562;73699;3923;97;57;4;53;.930;3600000;0
12562;156221;2319;0;0;0;0;.00nan;0;0
12564;32712;611;90;38;2;36;.947;3600000;0
12564;45193;620;0;0;0;0;.00nan;0;0
12564;86875;620;66;39;5;34;.872;3600000;0
12564;156298;611;0;0;0;0;.00nan;0;0
12568;584;3923;71;49;5;44;.898;3600000;0
12568;3075;617;0;0;0;0;.00nan;0;0
12568;73699;3923;0;0;0;0;.00nan;0;0
12568;143412;617;57;12;2;10;.833;3600000;0
12570;34959;612;0;0;0;0;.00nan;0;0
12570;45193;620;73;40;4;36;.900;2450000;0
12570;56316;612;63;16;1;15;.938;3600000;0
12570;86875;620;28;17;4;13;.765;1150000;0
12574;173279;4644;0;0;0;0;.00nan;0;0
12574;16742;619;0;0;0;0;.00nan;0;0
12574;78262;619;68;24;2;22;.917;3557000;0
12574;156148;4644;92;37;1;36;.973;3600000;0
12576;10141;2167;0;0;0;0;.00nan;0;0
12576;63529;2167;65;37;4;33;.892;3554000;0
12576;63848;2319;67;20;2;18;.900;3600000;0
12576;156221;2319;0;0;0;0;.00nan;0;0
12578;32712;611;0;0;0;0;.00nan;0;0
12578;43925;614;0;0;0;0;.00nan;0;0
12578;73187;614;23;22;5;17;.773;3600000;0
12578;156298;611;93;40;1;39;.975;3600000;0
29;10141;2167;0;0;0;0;.00nan;0;0
29;43925;614;93;18;0;18;1.000;3600000;0
29;63529;2167;68;39;4;35;.897;3600000;0
29;73187;614;0;0;0;0;.00nan;0;0
30;173279;4644;68;41;4;37;.902;3600000;0
30;56316;612;96;20;0;20;1.000;3600000;0
30;65672;612;0;0;0;0;.00nan;0;0
30;156148;4644;0;0;0;0;.00nan;0;0
31;16742;619;62;29;4;25;.862;3521000;0
31;45323;622;0;0;0;0;.00nan;0;0
31;78262;619;0;0;0;0;.00nan;0;0
31;156322;622;72;33;2;31;.939;3600000;0
32;34959;2308;70;36;4;32;.889;3874000;0
32;63848;2319;69;34;3;31;.912;3874000;0
32;65434;2308;0;0;0;0;.00nan;0;0
32;156221;2319;0;0;0;0;.00nan;0;0
33;10141;2167;0;0;0;0;.00nan;0;0
33;43925;614;93;21;0;21;1.000;3600000;0
33;63529;2167;56;35;5;30;.857;3600000;0
33;73187;614;0;0;0;0;.00nan;0;0
34;173279;4644;61;30;3;27;.900;3600000;0
34;56316;612;84;14;0;14;1.000;3600000;0
34;65672;612;0;0;0;0;.00nan;0;0
34;156148;4644;0;0;0;0;.00nan;0;0
35;16742;619;84;43;3;40;.930;3600000;0
35;45323;622;0;0;0;0;.00nan;0;0
35;78262;619;0;0;0;0;.00nan;0;0
35;156322;622;65;20;2;18;.900;3600000;0
36;34959;2308;98;24;0;24;1.000;3600000;0
36;63848;2319;61;27;3;24;.889;3600000;0
36;65434;2308;0;0;0;0;.00nan;0;0
36;156221;2319;0;0;0;0;.00nan;0;0
37;10141;2167;0;0;0;0;.00nan;0;0
37;43925;614;83;27;1;26;.963;3600000;0
37;63529;2167;73;34;3;31;.912;3547000;0
37;73187;614;0;0;0;0;.00nan;0;0
38;173279;4644;79;50;4;46;.920;3600000;0
38;56316;612;43;18;3;15;.833;3600000;0
38;65672;612;0;0;0;0;.00nan;0;0
38;156148;4644;0;0;0;0;.00nan;0;0
39;16742;619;74;35;2;33;.943;4183000;0
39;45323;622;0;0;0;0;.00nan;0;0
39;78262;619;0;0;0;0;.00nan;0;0
39;156322;622;76;35;3;32;.914;4183000;0
40;34959;2308;56;15;2;13;.867;3600000;0
40;63848;2319;36;35;6;29;.829;3600000;0
40;65434;2308;0;0;0;0;.00nan;0;0
40;156221;2319;0;0;0;0;.00nan;0;0
41;10141;2167;0;0;0;0;.00nan;0;0
41;43925;614;79;12;0;12;1.000;3600000;0
41;63529;2167;51;32;5;27;.844;3600000;0
41;73187;614;0;0;0;0;.00nan;0;0
42;173279;4644;62;49;6;43;.878;3558000;0
42;56316;612;45;21;4;17;.810;3600000;0
42;65672;612;0;0;0;0;.00nan;0;0
42;156148;4644;0;0;0;0;.00nan;0;0
43;16742;619;90;50;3;47;.940;3521000;0
43;45323;622;0;0;0;0;.00nan;0;0
43;78262;619;0;0;0;0;.00nan;0;0
43;156322;622;83;24;1;23;.958;3600000;0
44;34959;2308;56;23;3;20;.870;3567000;0
44;63848;2319;90;41;2;39;.951;3600000;0
44;65434;2308;0;0;0;0;.00nan;0;0
44;156221;2319;0;0;0;0;.00nan;0;0
432;16742;619;79;33;3;30;.909;3592000;0
432;45323;622;0;0;0;0;.00nan;0;0
432;78262;619;0;0;0;0;.00nan;0;0
432;156322;622;81;33;2;31;.939;3600000;0
433;34959;2308;68;20;2;18;.900;3543000;0
433;63848;2319;100;38;1;37;.974;3600000;0
433;65434;2308;0;0;0;0;.00nan;0;0
433;156221;2319;0;0;0;0;.00nan;0;0
518;34959;2308;89;39;2;37;.949;3847000;0
518;63848;2319;100;31;1;30;.968;3847000;0
518;65434;2308;0;0;0;0;.00nan;0;0
518;156221;2319;0;0;0;0;.00nan;0;0
580;43925;614;70;34;4;30;.882;3621000;0
580;63848;2319;63;31;3;28;.903;3621000;0
580;73187;614;0;0;0;0;.00nan;0;0
580;156221;2319;0;0;0;0;.00nan;0;0
581;45323;622;0;0;0;0;.00nan;0;0
581;56316;612;90;31;2;29;.935;3546000;0
581;65672;612;0;0;0;0;.00nan;0;0
581;156322;622;80;32;1;31;.969;3600000;0
582;43925;614;78;31;2;29;.935;3600000;0
582;63848;2319;76;21;1;20;.952;3600000;0
582;73187;614;0;0;0;0;.00nan;0;0
582;156221;2319;0;0;0;0;.00nan;0;0
583;45323;622;0;0;0;0;.00nan;0;0
583;56316;612;75;25;2;23;.920;3600000;0
583;65672;612;0;0;0;0;.00nan;0;0
583;156322;622;51;36;5;31;.861;3600000;0
584;43925;614;63;31;5;26;.839;3761000;0
584;63848;2319;22;21;5;16;.762;2134000;0
584;73187;614;0;0;0;0;.00nan;0;0
584;156221;2319;66;11;1;10;.909;1627000;0
585;45323;622;0;0;0;0;.00nan;0;0
585;56316;612;27;21;5;16;.762;2013000;0
585;65672;612;45;11;2;9;.818;1587000;0
585;156322;622;64;27;3;24;.889;3600000;0
586;43925;614;58;19;2;17;.895;3578000;0
586;63848;2319;85;30;1;29;.967;3600000;0
586;73187;614;0;0;0;0;.00nan;0;0
586;156221;2319;0;0;0;0;.00nan;0;0
587;45323;622;0;0;0;0;.00nan;0;0
587;56316;612;71;37;4;33;.892;3600000;0
587;65672;612;0;0;0;0;.00nan;0;0
587;156322;622;62;17;1;16;.941;3600000;0
894;43925;614;67;29;3;26;.897;3573000;0
894;63848;2319;71;27;2;25;.926;3600000;0
894;73187;614;0;0;0;0;.00nan;0;0
894;156221;2319;0;0;0;0;.00nan;0;0
895;45323;622;0;0;0;0;.00nan;0;0
895;56316;612;45;36;6;30;.833;3600000;0
895;65672;612;0;0;0;0;.00nan;0;0
895;156322;622;69;26;2;24;.923;3600000;0
929;45323;622;0;0;0;0;.00nan;0;0
929;63848;2319;62;42;5;37;.881;3600000;0
929;156221;2319;0;0;0;0;.00nan;0;0
929;156322;622;79;26;1;25;.962;3600000;0
930;45323;622;0;0;0;0;.00nan;0;0
930;63848;2319;52;42;5;37;.881;3551000;0
930;156221;2319;0;0;0;0;.00nan;0;0
930;156322;622;70;29;3;26;.897;3600000;0
931;45323;622;0;0;0;0;.00nan;0;0
931;63848;2319;75;30;2;28;.933;3600000;0
931;156221;2319;0;0;0;0;.00nan;0;0
931;156322;622;61;32;4;28;.875;3562000;0
932;45323;622;0;0;0;0;.00nan;0;0
932;63848;2319;98;43;2;41;.953;3547000;0
932;156221;2319;0;0;0;0;.00nan;0;0
932;156322;622;69;19;1;18;.947;3600000;0
1083;45323;622;0;0;0;0;.00nan;0;0
1083;63848;2319;55;35;5;30;.857;3600000;0
1083;156221;2319;0;0;0;0;.00nan;0;0
1083;156322;622;93;23;0;23;1.000;3600000;0
12579;173840;718;85;16;0;16;1.000;3600000;0
12579;55918;718;0;0;0;0;.00nan;0;0
12579;55932;721;0;0;0;0;.00nan;0;0
12579;77009;721;60;32;3;29;.906;3600000;0
12580;180929;715;45;30;5;25;.833;3600000;0
12580;49545;717;55;28;3;25;.893;3600000;0
12580;85619;717;0;0;0;0;.00nan;0;0
12580;161163;715;0;0;0;0;.00nan;0;0
12581;161540;716;0;0;0;0;.00nan;0;0
12581;62392;2529;0;0;0;0;.00nan;0;0
12581;76486;716;61;35;4;31;.886;3553000;0
12581;94134;2529;50;22;3;19;.864;3600000;0
12582;168089;720;88;19;0;19;1.000;3600000;0
12582;-1;719;0;0;0;0;.00nan;0;0
12582;61170;720;0;0;0;0;.00nan;0;0
12582;78587;719;77;25;1;24;.960;3552000;0
12583;-1;2188;35;12;3;9;.750;478000;0
12583;-1;2188;67;38;3;35;.921;3122000;0
12583;62392;2529;0;0;0;0;.00nan;0;0
12583;94134;2529;56;18;2;16;.889;3600000;0
12584;161540;716;0;0;0;0;.00nan;0;0
12584;168089;720;66;33;3;30;.909;3600000;0
12584;61170;720;0;0;0;0;.00nan;0;0
12584;76486;716;99;19;0;19;1.000;3600000;0
12585;173840;718;43;34;5;29;.853;3531000;0
12585;180929;715;71;31;3;28;.903;3600000;0
12585;55918;718;0;0;0;0;.00nan;0;0
12585;161163;715;0;0;0;0;.00nan;0;0
12586;-1;719;0;0;0;0;.00nan;0;0
12586;49545;717;57;27;3;24;.889;3546000;0
12586;78587;719;78;27;2;25;.926;3600000;0
12586;85619;717;0;0;0;0;.00nan;0;0
12587;173840;718;65;29;3;26;.897;3563000;0
12587;-1;719;0;0;0;0;.00nan;0;0
12587;55918;718;0;0;0;0;.00nan;0;0
12587;78587;719;89;37;2;35;.946;3600000;0
12588;161540;716;0;0;0;0;.00nan;0;0
12588;49545;717;87;17;0;17;1.000;3600000;0
12588;76486;716;70;39;4;35;.897;3600000;0
12588;85619;717;0;0;0;0;.00nan;0;0
12589;180929;715;50;26;4;22;.846;3600000;0
12589;55932;721;48;7;1;6;.857;460000;0
12589;77009;721;36;47;8;39;.830;3140000;0
12589;161163;715;0;0;0;0;.00nan;0;0
12590;168089;720;41;25;4;21;.840;3591000;0
12590;-1;2188;65;28;3;25;.893;3600000;0
12590;-1;2188;0;0;0;0;.00nan;0;0
12590;61170;720;0;0;0;0;.00nan;0;0
12591;-1;2188;70;32;2;30;.938;3900000;0
12591;-1;2188;0;0;0;0;.00nan;0;0
12591;49545;717;96;45;2;43;.956;3900000;0
12591;85619;717;0;0;0;0;.00nan;0;0
12592;161540;716;0;0;0;0;.00nan;0;0
12592;173840;718;33;39;7;32;.821;2268000;0
12592;76486;716;74;22;1;21;.955;3600000;0
12592;86268;718;48;7;1;6;.857;1332000;0
12593;168089;720;85;41;3;38;.927;3900000;0
12593;61170;720;0;0;0;0;.00nan;0;0
12593;62392;2529;0;0;0;0;.00nan;0;0
12593;94134;2529;65;24;3;21;.875;3900000;0
12594;-1;719;0;0;0;0;.00nan;0;0
12594;55932;721;0;0;0;0;.00nan;0;0
12594;77009;721;92;24;0;24;1.000;3600000;0
12594;78587;719;73;26;2;24;.923;3556000;0
12595;173840;718;55;45;6;39;.867;3600000;0
12595;-1;2188;0;0;0;0;.00nan;0;0
12595;-1;2188;100;33;0;33;1.000;3600000;0
12595;86268;718;0;0;0;0;.00nan;0;0
12596;49545;717;64;27;2;25;.926;3600000;0
12596;62392;2529;0;0;0;0;.00nan;0;0
12596;85619;717;0;0;0;0;.00nan;0;0
12596;94134;2529;76;20;1;19;.950;3600000;0
12597;161540;716;0;0;0;0;.00nan;0;0
12597;55932;721;0;0;0;0;.00nan;0;0
12597;76486;716;52;16;2;14;.875;3600000;0
12597;77009;721;94;45;3;42;.933;3600000;0
12598;180929;715;0;0;0;0;.00nan;0;0
12598;-1;719;0;0;0;0;.00nan;0;0
12598;78587;719;77;34;2;32;.941;3600000;0
12598;161163;715;74;10;0;10;1.000;3600000;0
12599;-1;2188;0;0;0;0;.00nan;0;0
12599;-1;2188;66;29;3;26;.897;3600000;0
12599;55932;721;0;0;0;0;.00nan;0;0
12599;77009;721;50;33;5;28;.848;3515000;0
12600;161540;716;0;0;0;0;.00nan;0;0
12600;180929;715;0;0;0;0;.00nan;0;0
12600;76486;716;70;30;2;28;.933;3600000;0
12600;161163;715;64;29;3;26;.897;3600000;0
12601;173840;718;70;35;3;32;.914;3600000;0
12601;62392;2529;0;0;0;0;.00nan;0;0
12601;86268;718;0;0;0;0;.00nan;0;0
12601;94134;2529;54;13;2;11;.846;3600000;0
12602;168089;720;66;30;3;27;.900;3558000;0
12602;49545;717;91;29;1;28;.966;3600000;0
12602;61170;720;0;0;0;0;.00nan;0;0
12602;85619;717;0;0;0;0;.00nan;0;0
12603;168089;720;73;30;2;28;.933;3600000;0
12603;173840;718;61;30;3;27;.900;3600000;0
12603;61170;720;0;0;0;0;.00nan;0;0
12603;86268;718;0;0;0;0;.00nan;0;0
12604;55932;721;99;63;2;61;.968;3600000;0
12604;62392;2529;0;0;0;0;.00nan;0;0
12604;77009;721;0;0;0;0;.00nan;0;0
12604;94134;2529;37;16;3;13;.813;3543000;0
12605;-1;2188;44;32;6;26;.813;3600000;0
12605;180929;715;90;29;1;28;.966;3600000;0
12605;-1;2188;0;0;0;0;.00nan;0;0
12605;161163;715;0;0;0;0;.00nan;0;0
12606;161540;716;0;0;0;0;.00nan;0;0
12606;-1;719;0;0;0;0;.00nan;0;0
12606;76486;716;83;13;0;13;1.000;3600000;0
12606;78587;719;47;38;6;32;.842;3600000;0
12607;-1;2188;0;0;0;0;.00nan;0;0
12607;-1;719;54;4;0;4;1.000;872000;0
12607;-1;2188;70;22;2;20;.909;3600000;0
12607;78587;719;27;33;7;26;.788;2728000;0
12608;173840;718;70;20;1;19;.950;3600000;0
12608;49545;717;78;37;3;34;.919;3516000;0
12608;85619;717;0;0;0;0;.00nan;0;0
12608;86268;718;0;0;0;0;.00nan;0;0
12609;180929;715;60;35;4;31;.886;2939000;0
12609;62392;2529;0;0;0;0;.00nan;0;0
12609;94134;2529;88;17;0;17;1.000;3600000;0
12609;161163;715;13;19;6;13;.684;661000;0
12610;168089;720;82;13;0;13;1.000;3600000;0
12610;55932;721;46;5;1;4;.800;557000;0
12610;61170;720;0;0;0;0;.00nan;0;0
12610;77009;721;34;33;6;27;.818;3043000;0
12611;161540;716;0;0;0;0;.00nan;0;0
12611;-1;2188;36;11;3;8;.727;540000;0
12611;-1;2188;52;41;5;36;.878;3060000;0
12611;76486;716;73;16;1;15;.938;3600000;0
12612;49545;717;74;21;1;20;.952;3600000;0
12612;55932;721;64;42;5;37;.881;3600000;0
12612;77009;721;0;0;0;0;.00nan;0;0
12612;85619;717;0;0;0;0;.00nan;0;0
12613;168089;720;74;28;2;26;.929;3559000;0
12613;180929;715;92;32;1;31;.969;3600000;0
12613;61170;720;0;0;0;0;.00nan;0;0
12613;161163;715;0;0;0;0;.00nan;0;0
12614;-1;719;0;0;0;0;.00nan;0;0
12614;62392;2529;0;0;0;0;.00nan;0;0
12614;78587;719;97;39;1;38;.974;3900000;0
12614;94134;2529;89;23;1;22;.957;3900000;0
12615;161540;716;0;0;0;0;.00nan;0;0
12615;62392;2529;0;0;0;0;.00nan;0;0
12615;76486;716;71;27;2;25;.926;3571000;0
12615;94134;2529;83;28;1;27;.964;3600000;0
12616;173840;718;65;17;1;16;.941;3600000;0
12616;55932;721;0;0;0;0;.00nan;0;0
12616;77009;721;92;39;2;37;.949;3600000;0
12616;86268;718;0;0;0;0;.00nan;0;0
12617;180929;715;0;0;0;0;.00nan;0;0
12617;49545;717;94;54;3;51;.944;3849000;0
12617;85619;717;0;0;0;0;.00nan;0;0
12617;161163;715;72;24;2;22;.917;3849000;0
12618;168089;720;80;13;0;13;1.000;3600000;0
12618;-1;719;0;0;0;0;.00nan;0;0
12618;61170;720;0;0;0;0;.00nan;0;0
12618;78587;719;81;30;2;28;.933;3526000;0
12619;173840;718;0;0;0;0;.00nan;0;0
12619;180929;715;87;31;3;28;.903;3900000;0
12619;86268;718;78;31;3;28;.903;3900000;0
12619;161163;715;0;0;0;0;.00nan;0;0
12620;-1;719;0;0;0;0;.00nan;0;0
12620;49545;717;0;0;0;0;.00nan;0;0
12620;78587;719;99;57;2;55;.965;3600000;0
12620;85619;717;52;20;3;17;.850;3544000;0
12621;-1;2188;0;0;0;0;.00nan;0;0
12621;-1;2188;80;34;2;32;.941;3600000;0
12621;62392;2529;59;24;3;21;.875;3569000;0
12621;94134;2529;0;0;0;0;.00nan;0;0
12622;161540;716;0;0;0;0;.00nan;0;0
12622;168089;720;56;24;4;20;.833;3783000;0
12622;61170;720;0;0;0;0;.00nan;0;0
12622;76486;716;77;37;3;34;.919;3783000;0
12623;168089;720;69;38;4;34;.895;3600000;0
12623;-1;2188;65;15;1;14;.933;3600000;0
12623;-1;2188;0;0;0;0;.00nan;0;0
12623;61170;720;0;0;0;0;.00nan;0;0
12624;161540;716;0;0;0;0;.00nan;0;0
12624;49545;717;64;30;3;27;.900;3600000;0
12624;76486;716;70;21;1;20;.952;3600000;0
12624;85619;717;0;0;0;0;.00nan;0;0
12625;180929;715;0;0;0;0;.00nan;0;0
12625;55932;721;93;40;1;39;.975;3885000;0
12625;77009;721;0;0;0;0;.00nan;0;0
12625;161163;715;68;22;2;20;.909;3885000;0
12626;173840;718;73;21;1;20;.952;3600000;0
12626;-1;719;0;0;0;0;.00nan;0;0
12626;78587;719;73;42;4;38;.905;3600000;0
12626;86268;718;0;0;0;0;.00nan;0;0
12627;161540;716;0;0;0;0;.00nan;0;0
12627;173840;718;0;0;0;0;.00nan;0;0
12627;76486;716;66;20;1;19;.950;3600000;0
12627;86268;718;90;38;2;36;.947;3600000;0
12628;-1;2188;81;34;2;32;.941;3583000;0
12628;-1;2188;0;0;0;0;.00nan;0;0
12628;49545;717;89;26;1;25;.962;3600000;0
12628;85619;717;0;0;0;0;.00nan;0;0
12629;-1;719;0;0;0;0;.00nan;0;0
12629;55932;721;77;27;2;25;.926;3600000;0
12629;77009;721;0;0;0;0;.00nan;0;0
12629;78587;719;63;28;3;25;.893;3596000;0
12630;168089;720;0;0;0;0;.00nan;0;0
12630;61170;720;66;43;5;38;.884;3600000;0
12630;62392;2529;0;0;0;0;.00nan;0;0
12630;94134;2529;90;18;0;18;1.000;3600000;0
12631;173840;718;0;0;0;0;.00nan;0;0
12631;-1;2188;0;0;0;0;.00nan;0;0
12631;-1;2188;69;42;4;38;.905;3677000;0
12631;86268;718;52;33;5;28;.848;3677000;0
12632;161540;716;0;0;0;0;.00nan;0;0
12632;55932;721;93;51;2;49;.961;3900000;0
12632;76486;716;69;21;2;19;.905;3900000;0
12632;77009;721;0;0;0;0;.00nan;0;0
12633;49545;717;42;26;4;22;.846;3600000;0
12633;62392;2529;0;0;0;0;.00nan;0;0
12633;85619;717;0;0;0;0;.00nan;0;0
12633;94134;2529;73;21;1;20;.952;3600000;0
12634;180929;715;48;27;4;23;.852;3673000;0
12634;-1;719;0;0;0;0;.00nan;0;0
12634;78587;719;57;43;5;38;.884;3673000;0
12634;161163;715;0;0;0;0;.00nan;0;0
12635;173840;718;64;33;3;30;.909;3600000;0
12635;62392;2529;0;0;0;0;.00nan;0;0
12635;86268;718;0;0;0;0;.00nan;0;0
12635;94134;2529;86;17;0;17;1.000;3600000;0
12636;168089;720;100;50;2;48;.960;3600000;0
12636;49545;717;0;0;0;0;.00nan;0;0
12636;61170;720;0;0;0;0;.00nan;0;0
12636;85619;717;73;29;3;26;.897;3572000;0
12637;-1;2188;60;28;3;25;.893;3600000;0
12637;-1;2188;0;0;0;0;.00nan;0;0
12637;55932;721;67;46;5;41;.891;3578000;0
12637;77009;721;0;0;0;0;.00nan;0;0
12638;161540;716;0;0;0;0;.00nan;0;0
12638;180929;715;39;31;5;26;.839;3600000;0
12638;76486;716;95;24;0;24;1.000;3600000;0
12638;161163;715;0;0;0;0;.00nan;0;0
12639;-1;2188;0;0;0;0;.00nan;0;0
12639;180929;715;0;0;0;0;.00nan;0;0
12639;-1;2188;24;28;6;22;.786;3600000;0
12639;161163;715;86;30;2;28;.933;3600000;0
12640;161540;716;0;0;0;0;.00nan;0;0
12640;-1;719;0;0;0;0;.00nan;0;0
12640;76486;716;48;16;2;14;.875;3900000;0
12640;78587;719;100;41;2;39;.951;3898000;0
12641;55932;721;0;0;0;0;.00nan;0;0
12641;62392;2529;0;0;0;0;.00nan;0;0
12641;77009;721;93;55;4;51;.927;3600000;0
12641;94134;2529;77;14;0;14;1.000;3600000;0
12642;168089;720;72;30;2;28;.933;3600000;0
12642;173840;718;48;27;3;24;.889;3600000;0
12642;61170;720;0;0;0;0;.00nan;0;0
12642;86268;718;0;0;0;0;.00nan;0;0
12643;173840;718;0;0;0;0;.00nan;0;0
12643;49545;717;95;19;0;19;1.000;3600000;0
12643;85619;717;0;0;0;0;.00nan;0;0
12643;86268;718;61;24;2;22;.917;3523000;0
12644;168089;720;44;23;3;20;.870;3544000;0
12644;55932;721;66;25;2;23;.920;3600000;0
12644;61170;720;0;0;0;0;.00nan;0;0
12644;77009;721;0;0;0;0;.00nan;0;0
12645;180929;715;22;26;6;20;.769;3223000;0
12645;62392;2529;0;0;0;0;.00nan;0;0
12645;94134;2529;64;28;3;25;.893;3600000;0
12645;161163;715;49;2;0;2;1.000;377000;0
12646;-1;2188;75;32;2;30;.938;3600000;0
12646;-1;719;0;0;0;0;.00nan;0;0
12646;-1;2188;0;0;0;0;.00nan;0;0
12646;78587;719;64;33;4;29;.879;3600000;0
12647;161540;716;0;0;0;0;.00nan;0;0
12647;-1;2188;42;36;6;30;.833;3600000;0
12647;-1;2188;0;0;0;0;.00nan;0;0
12647;76486;716;100;26;0;26;1.000;3600000;0
12648;49545;717;82;13;0;13;1.000;3600000;0
12648;55932;721;0;0;0;0;.00nan;0;0
12648;77009;721;67;52;6;46;.885;3600000;0
12648;85619;717;0;0;0;0;.00nan;0;0
12649;168089;720;88;40;3;37;.925;3900000;0
12649;180929;715;0;0;0;0;.00nan;0;0
12649;61170;720;0;0;0;0;.00nan;0;0
12649;161163;715;53;22;3;19;.864;3900000;0
12650;-1;719;0;0;0;0;.00nan;0;0
12650;62392;2529;0;0;0;0;.00nan;0;0
12650;78587;719;80;45;3;42;.933;3900000;0
12650;94134;2529;58;20;3;17;.850;3900000;0
12651;173840;718;74;22;1;21;.955;3600000;0
12651;55932;721;68;29;2;27;.931;3600000;0
12651;77009;721;0;0;0;0;.00nan;0;0
12651;86268;718;0;0;0;0;.00nan;0;0
12652;180929;715;81;45;4;41;.911;3574000;0
12652;49545;717;71;20;2;18;.900;3600000;0
12652;85619;717;0;0;0;0;.00nan;0;0
12652;161163;715;0;0;0;0;.00nan;0;0
12653;161540;716;0;0;0;0;.00nan;0;0
12653;62392;2529;0;0;0;0;.00nan;0;0
12653;76486;716;67;43;5;38;.884;3888000;0
12653;94134;2529;50;26;4;22;.846;3888000;0
12654;168089;720;67;35;3;32;.914;3565000;0
12654;-1;719;0;0;0;0;.00nan;0;0
12654;61170;720;0;0;0;0;.00nan;0;0
12654;78587;719;76;20;1;19;.950;3600000;0
12655;-1;2188;0;0;0;0;.00nan;0;0
12655;-1;2188;60;34;4;30;.882;3545000;0
12655;62392;2529;0;0;0;0;.00nan;0;0
12655;94134;2529;59;24;3;21;.875;3600000;0
12656;161540;716;0;0;0;0;.00nan;0;0
12656;168089;720;81;37;2;35;.946;3564000;0
12656;61170;720;0;0;0;0;.00nan;0;0
12656;76486;716;100;25;0;25;1.000;3600000;0
12657;173840;718;70;37;3;34;.919;3539000;0
12657;180929;715;82;31;1;30;.968;3600000;0
12657;86268;718;0;0;0;0;.00nan;0;0
12657;161163;715;0;0;0;0;.00nan;0;0
12658;-1;719;0;0;0;0;.00nan;0;0
12658;49545;717;44;17;3;14;.824;3600000;0
12658;78587;719;59;35;5;30;.857;3600000;0
12658;85619;717;0;0;0;0;.00nan;0;0
12659;173840;718;78;24;1;23;.958;3600000;0
12659;-1;719;0;0;0;0;.00nan;0;0
12659;78587;719;66;26;2;24;.923;3552000;0
12659;86268;718;0;0;0;0;.00nan;0;0
12660;161540;716;0;0;0;0;.00nan;0;0
12660;49545;717;38;21;4;17;.810;3523000;0
12660;76486;716;91;48;2;46;.958;3600000;0
12660;85619;717;0;0;0;0;.00nan;0;0
12661;180929;715;30;16;4;12;.750;3662000;0
12661;55932;721;0;0;0;0;.00nan;0;0
12661;77009;721;60;45;5;40;.889;3662000;0
12661;161163;715;0;0;0;0;.00nan;0;0
12662;168089;720;50;42;6;36;.857;3600000;0
12662;-1;2188;15;21;6;15;.714;2756000;0
12662;-1;2188;47;8;1;7;.875;788000;0
12662;61170;720;0;0;0;0;.00nan;0;0
12663;-1;2188;0;0;0;0;.00nan;0;0
12663;-1;2188;47;34;5;29;.853;3527000;0
12663;49545;717;75;28;3;25;.893;3600000;0
12663;85619;717;0;0;0;0;.00nan;0;0
12664;161540;716;0;0;0;0;.00nan;0;0
12664;173840;718;26;27;6;21;.778;3600000;0
12664;76486;716;100;24;0;24;1.000;3600000;0
12664;86268;718;0;0;0;0;.00nan;0;0
12665;168089;720;83;33;2;31;.939;3548000;0
12665;61170;720;0;0;0;0;.00nan;0;0
12665;62392;2529;0;0;0;0;.00nan;0;0
12665;94134;2529;72;21;1;20;.952;3600000;0
12666;-1;719;0;0;0;0;.00nan;0;0
12666;55932;721;89;39;2;37;.949;3581000;0
12666;77009;721;0;0;0;0;.00nan;0;0
12666;78587;719;58;18;1;17;.944;3600000;0
12667;173840;718;0;0;0;0;.00nan;0;0
12667;-1;2188;57;26;3;23;.885;3694000;0
12667;-1;2188;0;0;0;0;.00nan;0;0
12667;86268;718;67;30;4;26;.867;3694000;0
12668;49545;717;48;34;5;29;.853;3600000;0
12668;62392;2529;0;0;0;0;.00nan;0;0
12668;85619;717;0;0;0;0;.00nan;0;0
12668;94134;2529;74;30;2;28;.933;3600000;0
12669;161540;716;0;0;0;0;.00nan;0;0
12669;55932;721;0;0;0;0;.00nan;0;0
12669;76486;716;69;19;1;18;.947;3600000;0
12669;77009;721;91;38;2;36;.947;3552000;0
12670;180929;715;0;0;0;0;.00nan;0;0
12670;-1;719;0;0;0;0;.00nan;0;0
12670;78587;719;94;46;2;44;.957;3867000;0
12670;161163;715;59;24;3;21;.875;3867000;0
12671;-1;2188;0;0;0;0;.00nan;0;0
12671;-1;2188;69;28;2;26;.929;3600000;0
12671;55932;721;0;0;0;0;.00nan;0;0
12671;77009;721;67;49;5;44;.898;3600000;0
12672;161540;716;0;0;0;0;.00nan;0;0
12672;180929;715;87;31;1;30;.968;3580000;0
12672;76486;716;98;27;0;27;1.000;3600000;0
12672;161163;715;0;0;0;0;.00nan;0;0
12673;173840;718;55;35;4;31;.886;3582000;0
12673;62392;2529;0;0;0;0;.00nan;0;0
12673;86268;718;0;0;0;0;.00nan;0;0
12673;94134;2529;56;16;2;14;.875;3600000;0
12674;168089;720;40;19;4;15;.789;948000;0
12674;49545;717;69;19;1;18;.947;3600000;0
12674;61170;720;66;29;3;26;.897;2652000;0
12674;85619;717;0;0;0;0;.00nan;0;0
12675;168089;720;77;28;2;26;.929;3600000;0
12675;173840;718;100;19;0;19;1.000;3600000;0
12675;61170;720;0;0;0;0;.00nan;0;0
12675;86268;718;0;0;0;0;.00nan;0;0
12676;55932;721;55;40;5;35;.875;3600000;0
12676;62392;2529;0;0;0;0;.00nan;0;0
12676;77009;721;0;0;0;0;.00nan;0;0
12676;94134;2529;80;12;0;12;1.000;3600000;0
12677;-1;2188;70;46;5;41;.891;3600000;0
12677;180929;715;84;26;1;25;.962;3600000;0
12677;-1;2188;0;0;0;0;.00nan;0;0
12677;161163;715;0;0;0;0;.00nan;0;0
12678;161540;716;0;0;0;0;.00nan;0;0
12678;-1;719;0;0;0;0;.00nan;0;0
12678;76486;716;90;30;1;29;.967;3572000;0
12678;78587;719;100;30;0;30;1.000;3600000;0
12679;-1;2188;42;24;4;20;.833;3892000;0
12679;-1;719;0;0;0;0;.00nan;0;0
12679;-1;2188;0;0;0;0;.00nan;0;0
12679;78587;719;85;57;5;52;.912;3892000;0
12680;173840;718;61;41;5;36;.878;3586000;0
12680;49545;717;0;0;0;0;.00nan;0;0
12680;85619;717;82;40;4;36;.900;3600000;0
12680;86268;718;0;0;0;0;.00nan;0;0
12681;180929;715;79;38;3;35;.921;3900000;0
12681;62392;2529;0;0;0;0;.00nan;0;0
12681;94134;2529;74;31;3;28;.903;3900000;0
12681;161163;715;0;0;0;0;.00nan;0;0
12682;168089;720;79;24;1;23;.958;3600000;0
12682;55932;721;0;0;0;0;.00nan;0;0
12682;61170;720;0;0;0;0;.00nan;0;0
12682;77009;721;51;36;5;31;.861;3600000;0
12683;161540;716;0;0;0;0;.00nan;0;0
12683;-1;2188;0;0;0;0;.00nan;0;0
12683;-1;2188;69;43;4;39;.907;3554000;0
12683;76486;716;84;35;2;33;.943;3600000;0
12684;49545;717;87;17;0;17;1.000;3600000;0
12684;55932;721;88;62;4;58;.935;3600000;0
12684;77009;721;0;0;0;0;.00nan;0;0
12684;85619;717;0;0;0;0;.00nan;0;0
12685;168089;720;77;34;3;31;.912;3600000;0
12685;180929;715;100;27;0;27;1.000;3600000;0
12685;61170;720;0;0;0;0;.00nan;0;0
12685;161163;715;0;0;0;0;.00nan;0;0
12686;-1;719;0;0;0;0;.00nan;0;0
12686;62392;2529;0;0;0;0;.00nan;0;0
12686;78587;719;87;46;3;43;.935;3556000;0
12686;94134;2529;69;22;2;20;.909;3600000;0
12687;161540;716;0;0;0;0;.00nan;0;0
12687;62392;2529;0;0;0;0;.00nan;0;0
12687;76486;716;82;51;5;46;.902;3600000;0
12687;94134;2529;61;16;1;15;.938;3600000;0
12688;173840;718;55;29;4;25;.862;3724000;0
12688;55932;721;0;0;0;0;.00nan;0;0
12688;77009;721;98;53;3;50;.943;3724000;0
12688;86268;718;0;0;0;0;.00nan;0;0
12689;180929;715;84;28;1;27;.964;3600000;0
12689;49545;717;76;37;2;35;.946;3553000;0
12689;85619;717;0;0;0;0;.00nan;0;0
12689;161163;715;0;0;0;0;.00nan;0;0
12690;168089;720;41;31;5;26;.839;3900000;0
12690;-1;719;0;0;0;0;.00nan;0;0
12690;61170;720;0;0;0;0;.00nan;0;0
12690;78587;719;48;32;5;27;.844;3900000;0
12691;173840;718;46;39;6;33;.846;3600000;0
12691;180929;715;94;25;2;23;.920;3600000;0
12691;86268;718;0;0;0;0;.00nan;0;0
12691;161163;715;0;0;0;0;.00nan;0;0
12692;-1;719;0;0;0;0;.00nan;0;0
12692;49545;717;47;25;3;22;.880;3900000;0
12692;78587;719;94;49;3;46;.939;3900000;0
12692;85619;717;0;0;0;0;.00nan;0;0
12693;-1;2188;78;37;3;34;.919;3900000;0
12693;-1;2188;0;0;0;0;.00nan;0;0
12693;62392;2529;50;27;3;24;.889;3900000;0
12693;94134;2529;0;0;0;0;.00nan;0;0
12694;161540;716;0;0;0;0;.00nan;0;0
12694;168089;720;0;0;0;0;.00nan;0;0
12694;61170;720;70;32;3;29;.906;3600000;0
12694;76486;716;72;28;2;26;.929;3600000;0
12695;168089;720;70;58;7;51;.879;3251000;0
12695;-1;2188;60;15;2;13;.867;3600000;0
12695;-1;2188;0;0;0;0;.00nan;0;0
12695;61170;720;50;10;1;9;.900;349000;0
12696;161540;716;27;14;4;10;.714;811000;0
12696;49545;717;76;27;1;26;.963;3600000;0
12696;76486;716;98;35;1;34;.971;2789000;0
12696;85619;717;0;0;0;0;.00nan;0;0
12697;180929;715;0;0;0;0;.00nan;0;0
12697;55932;721;0;0;0;0;.00nan;0;0
12697;77009;721;38;38;7;31;.816;3600000;0
12697;161163;715;70;21;1;20;.952;3600000;0
12698;173840;718;100;27;0;27;1.000;3600000;0
12698;-1;719;29;28;6;22;.786;3600000;0
12698;78587;719;0;0;0;0;.00nan;0;0
12698;86268;718;0;0;0;0;.00nan;0;0
12699;161540;716;0;0;0;0;.00nan;0;0
12699;173840;718;59;28;3;25;.893;3600000;0
12699;76486;716;85;26;1;25;.962;3600000;0
12699;86268;718;0;0;0;0;.00nan;0;0
12700;-1;2188;69;45;4;41;.911;3529000;0
12700;-1;2188;0;0;0;0;.00nan;0;0
12700;49545;717;75;24;2;22;.917;3600000;0
12700;85619;717;0;0;0;0;.00nan;0;0
12701;-1;719;0;0;0;0;.00nan;0;0
12701;55932;721;100;34;1;33;.971;3600000;0
12701;77009;721;0;0;0;0;.00nan;0;0
12701;78587;719;42;26;4;22;.846;3600000;0
12702;168089;720;93;44;3;41;.932;3600000;0
12702;61170;720;0;0;0;0;.00nan;0;0
12702;62392;2529;0;0;0;0;.00nan;0;0
12702;94134;2529;94;18;0;18;1.000;3600000;0
12703;173840;718;97;34;1;33;.971;3900000;0
12703;-1;2188;0;0;0;0;.00nan;0;0
12703;-1;2188;74;26;1;25;.962;3900000;0
12703;86268;718;0;0;0;0;.00nan;0;0
12704;161540;716;0;0;0;0;.00nan;0;0
12704;55932;721;0;0;0;0;.00nan;0;0
12704;76486;716;77;22;1;21;.955;3600000;0
12704;77009;721;56;35;5;30;.857;3600000;0
12705;49545;717;83;34;2;32;.941;3600000;0
12705;62392;2529;0;0;0;0;.00nan;0;0
12705;85619;717;0;0;0;0;.00nan;0;0
12705;94134;2529;70;34;3;31;.912;3600000;0
12706;180929;715;37;14;3;11;.786;3600000;0
12706;-1;719;0;0;0;0;.00nan;0;0
12706;78587;719;36;30;5;25;.833;3567000;0
12706;161163;715;0;0;0;0;.00nan;0;0
12707;173840;718;0;0;0;0;.00nan;0;0
12707;62392;2529;0;0;0;0;.00nan;0;0
12707;86268;718;38;36;6;30;.833;3600000;0
12707;94134;2529;100;26;0;26;1.000;3600000;0
12708;168089;720;89;34;2;32;.941;3600000;0
12708;49545;717;57;25;3;22;.880;3545000;0
12708;61170;720;0;0;0;0;.00nan;0;0
12708;85619;717;0;0;0;0;.00nan;0;0
12709;-1;2188;73;19;1;18;.947;3600000;0
12709;-1;2188;0;0;0;0;.00nan;0;0
12709;55932;721;56;31;4;27;.871;3600000;0
12709;77009;721;0;0;0;0;.00nan;0;0
12710;161540;716;0;0;0;0;.00nan;0;0
12710;180929;715;30;30;6;24;.800;3213000;0
12710;76486;716;65;34;4;30;.882;3600000;0
12710;161163;715;47;5;1;4;.800;387000;0
12711;-1;2188;82;44;3;41;.932;3600000;0
12711;180929;715;60;23;2;21;.913;3600000;0
12711;-1;2188;0;0;0;0;.00nan;0;0
12711;161163;715;0;0;0;0;.00nan;0;0
12712;161540;716;0;0;0;0;.00nan;0;0
12712;-1;719;0;0;0;0;.00nan;0;0
12712;76486;716;55;29;4;25;.862;3600000;0
12712;78587;719;34;24;5;19;.792;3600000;0
12713;55932;721;0;0;0;0;.00nan;0;0
12713;62392;2529;0;0;0;0;.00nan;0;0
12713;77009;721;94;66;5;61;.924;3600000;0
12713;94134;2529;53;15;2;13;.867;3600000;0
12714;168089;720;69;37;4;33;.892;3841000;0
12714;173840;718;67;31;3;28;.903;3841000;0
12714;61170;720;0;0;0;0;.00nan;0;0
12714;86268;718;0;0;0;0;.00nan;0;0
12715;173840;718;0;0;0;0;.00nan;0;0
12715;49545;717;73;22;2;20;.909;3600000;0
12715;85619;717;0;0;0;0;.00nan;0;0
12715;86268;718;81;47;4;43;.915;3565000;0
12716;168089;720;23;9;4;5;.556;762000;0
12716;55932;721;0;0;0;0;.00nan;0;0
12716;61170;720;57;11;1;10;.909;2838000;0
12716;77009;721;50;44;7;37;.841;3564000;0
12717;180929;715;0;0;0;0;.00nan;0;0
12717;62392;2529;45;29;4;25;.862;2413000;0
12717;94134;2529;21;11;4;7;.636;1187000;0
12717;161163;715;79;32;2;30;.938;3600000;0
12718;-1;2188;62;24;2;22;.917;3900000;0
12718;-1;719;0;0;0;0;.00nan;0;0
12718;-1;2188;0;0;0;0;.00nan;0;0
12718;78587;719;61;28;2;26;.929;3900000;0
12719;161540;716;0;0;0;0;.00nan;0;0
12719;-1;2188;0;0;0;0;.00nan;0;0
12719;-1;2188;60;47;5;42;.894;3600000;0
12719;76486;716;72;25;1;24;.960;3600000;0
12720;49545;717;63;16;1;15;.938;3600000;0
12720;55932;721;0;0;0;0;.00nan;0;0
12720;77009;721;88;41;3;38;.927;3556000;0
12720;85619;717;0;0;0;0;.00nan;0;0
12721;-1;719;0;0;0;0;.00nan;0;0
12721;62392;2529;0;0;0;0;.00nan;0;0
12721;78587;719;50;44;6;38;.864;3600000;0
12721;94134;2529;65;20;2;18;.900;3600000;0
12722;168089;720;77;36;3;33;.917;3600000;0
12722;180929;715;28;15;4;11;.733;3589000;0
12722;61170;720;0;0;0;0;.00nan;0;0
12722;161163;715;0;0;0;0;.00nan;0;0
12724;161540;716;0;0;0;0;.00nan;0;0
12724;67910;2529;0;0;0;0;.00nan;0;0
12724;76486;716;71;35;3;32;.914;3512000;0
12724;94134;2529;71;22;1;21;.955;3600000;0
12726;-1;2188;0;0;0;0;.00nan;0;0
12726;-1;2188;75;27;1;26;.963;3600000;0
12726;49545;717;63;28;3;25;.893;3600000;0
12726;85619;717;0;0;0;0;.00nan;0;0
12728;168089;720;72;39;4;35;.897;3545000;0
12728;173840;718;72;33;3;30;.909;3600000;0
12728;55918;718;0;0;0;0;.00nan;0;0
12728;61170;720;0;0;0;0;.00nan;0;0
12730;-1;719;0;0;0;0;.00nan;0;0
12730;55932;721;0;0;0;0;.00nan;0;0
12730;77009;721;58;34;4;30;.882;3589000;0
12730;78587;719;49;21;3;18;.857;3600000;0
12732;-1;719;0;0;0;0;.00nan;0;0
12732;55932;721;0;0;0;0;.00nan;0;0
12732;77009;721;50;24;4;20;.833;3582000;0
12732;78587;719;60;25;3;22;.880;3600000;0
12734;161540;716;55;19;2;17;.895;3173000;0
12734;173840;718;74;26;2;24;.923;3600000;0
12734;55918;718;0;0;0;0;.00nan;0;0
12734;76486;716;30;7;3;4;.571;427000;0
12736;-1;2188;62;25;3;22;.880;3900000;0
12736;180929;715;80;38;3;35;.921;3900000;0
12736;-1;2188;0;0;0;0;.00nan;0;0
12736;161163;715;0;0;0;0;.00nan;0;0
12740;-1;2188;0;0;0;0;.00nan;0;0
12740;-1;2188;88;30;1;29;.967;3600000;0
12740;62392;2529;0;0;0;0;.00nan;0;0
12740;94134;2529;39;29;5;24;.828;3600000;0
12742;161540;716;0;0;0;0;.00nan;0;0
12742;180929;715;0;0;0;0;.00nan;0;0
12742;76486;716;65;24;2;22;.917;3600000;0
12742;161163;715;38;27;5;22;.815;3600000;0
12744;168089;720;77;27;2;25;.926;3900000;0
12744;-1;719;84;36;2;34;.944;3900000;0
12744;61170;720;0;0;0;0;.00nan;0;0
12744;78587;719;0;0;0;0;.00nan;0;0
12746;173840;718;0;0;0;0;.00nan;0;0
12746;49545;717;57;26;3;23;.885;3567000;0
12746;55918;718;88;35;2;33;.943;3600000;0
12746;85619;717;0;0;0;0;.00nan;0;0
12748;161540;716;0;0;0;0;.00nan;0;0
12748;55932;721;65;32;3;29;.906;3536000;0
12748;76486;716;88;25;1;24;.960;3600000;0
12748;77009;721;0;0;0;0;.00nan;0;0
12750;-1;2188;70;21;1;20;.952;3600000;0
12750;-1;719;0;0;0;0;.00nan;0;0
12750;-1;2188;0;0;0;0;.00nan;0;0
12750;78587;719;60;25;2;23;.920;3583000;0
12752;168089;720;84;38;2;36;.947;3900000;0
12752;173840;718;80;32;2;30;.938;3900000;0
12752;55918;718;0;0;0;0;.00nan;0;0
12752;61170;720;0;0;0;0;.00nan;0;0
12754;180929;715;62;25;3;22;.880;3593000;0
12754;49545;717;88;31;1;30;.968;3600000;0
12754;85619;717;0;0;0;0;.00nan;0;0
12754;161163;715;0;0;0;0;.00nan;0;0
12758;168089;720;0;0;0;0;.00nan;0;0
12758;-1;2188;0;0;0;0;.00nan;0;0
12758;-1;2188;71;27;2;25;.926;3600000;0
12758;61170;720;67;39;3;36;.923;3584000;0
12760;161540;716;65;23;2;21;.913;3600000;0
12760;180929;715;0;0;0;0;.00nan;0;0
12760;76486;716;0;0;0;0;.00nan;0;0
12760;161163;715;57;31;4;27;.871;3547000;0
12762;173840;718;44;26;4;22;.846;3600000;0
12762;-1;719;0;0;0;0;.00nan;0;0
12762;55918;718;0;0;0;0;.00nan;0;0
12762;78587;719;100;27;0;27;1.000;3600000;0
19766;161540;716;0;0;0;0;.00nan;0;0
19766;-1;2188;88;30;1;29;.967;3600000;0
19766;-1;2188;0;0;0;0;.00nan;0;0
19766;76486;716;54;33;4;29;.879;3600000;0
19767;180929;715;55;33;4;29;.879;3562000;0
19767;49545;717;72;26;2;24;.923;3600000;0
19767;85619;717;0;0;0;0;.00nan;0;0
19767;161163;715;0;0;0;0;.00nan;0;0
19768;-1;2188;92;38;2;36;.947;3600000;0
19768;-1;2188;0;0;0;0;.00nan;0;0
19768;62392;2529;0;0;0;0;.00nan;0;0
19768;94134;2529;58;30;3;27;.900;3579000;0
19769;161540;716;0;0;0;0;.00nan;0;0
19769;49545;717;81;32;1;31;.969;3600000;0
19769;76486;716;47;37;6;31;.838;3600000;0
19769;85619;717;0;0;0;0;.00nan;0;0
19770;180929;715;45;26;4;22;.846;3584000;0
19770;62392;2529;0;0;0;0;.00nan;0;0
19770;94134;2529;86;28;2;26;.929;3600000;0
19770;161163;715;0;0;0;0;.00nan;0;0
19771;-1;2188;57;36;4;32;.889;3590000;0
19771;-1;2188;0;0;0;0;.00nan;0;0
19771;49545;717;0;0;0;0;.00nan;0;0
19771;85619;717;73;24;2;22;.917;3600000;0
19772;49545;717;77;20;1;19;.950;3600000;0
19772;62392;2529;0;0;0;0;.00nan;0;0
19772;85619;717;0;0;0;0;.00nan;0;0
19772;94134;2529;67;28;2;26;.929;3585000;0
19773;161540;716;63;8;0;8;1.000;941000;0
19773;180929;715;0;0;0;0;.00nan;0;0
19773;76486;716;42;31;6;25;.806;2659000;0
19773;161163;715;40;22;4;18;.818;3600000;0
19774;161540;716;70;38;4;34;.895;3840000;0
19774;62392;2529;0;0;0;0;.00nan;0;0
19774;76486;716;0;0;0;0;.00nan;0;0
19774;94134;2529;34;24;5;19;.792;3840000;0
19775;-1;2188;0;0;0;0;.00nan;0;0
19775;180929;715;56;40;5;35;.875;3685000;0
19775;-1;2188;70;43;6;37;.860;3685000;0
19775;161163;715;0;0;0;0;.00nan;0;0
19776;161540;716;0;0;0;0;.00nan;0;0
19776;-1;2188;80;38;3;35;.921;3543000;0
19776;-1;2188;0;0;0;0;.00nan;0;0
19776;76486;716;75;26;2;24;.923;3600000;0
19777;180929;715;52;29;4;25;.862;3544000;0
19777;49545;717;49;19;3;16;.842;3600000;0
19777;85619;717;0;0;0;0;.00nan;0;0
19777;161163;715;0;0;0;0;.00nan;0;0
19778;-1;2188;82;30;1;29;.967;3589000;0
19778;-1;2188;0;0;0;0;.00nan;0;0
19778;62392;2529;0;0;0;0;.00nan;0;0
19778;94134;2529;100;23;0;23;1.000;3600000;0
19779;161540;716;0;0;0;0;.00nan;0;0
19779;49545;717;78;22;1;21;.955;3600000;0
19779;76486;716;42;38;6;32;.842;3600000;0
19779;85619;717;0;0;0;0;.00nan;0;0
19780;180929;715;52;32;4;28;.875;3600000;0
19780;62392;2529;0;0;0;0;.00nan;0;0
19780;94134;2529;73;24;1;23;.958;3600000;0
19780;161163;715;0;0;0;0;.00nan;0;0
19781;-1;2188;80;38;3;35;.921;3900000;0
19781;-1;2188;0;0;0;0;.00nan;0;0
19781;49545;717;92;45;3;42;.933;3900000;0
19781;85619;717;0;0;0;0;.00nan;0;0
19782;49545;717;67;37;4;33;.892;3590000;0
19782;62392;2529;0;0;0;0;.00nan;0;0
19782;85619;717;0;0;0;0;.00nan;0;0
19782;94134;2529;87;33;2;31;.939;3600000;0
19783;161540;716;0;0;0;0;.00nan;0;0
19783;180929;715;20;9;4;5;.556;1042000;0
19783;76486;716;51;29;4;25;.862;3600000;0
19783;161163;715;60;13;1;12;.923;2513000;0
19784;161540;716;0;0;0;0;.00nan;0;0
19784;62392;2529;0;0;0;0;.00nan;0;0
19784;76486;716;74;38;4;34;.895;3600000;0
19784;94134;2529;96;26;1;25;.962;3600000;0
19785;-1;2188;25;5;3;2;.400;590000;0
19785;180929;715;0;0;0;0;.00nan;0;0
19785;-1;2188;51;31;4;27;.871;3010000;0
19785;161163;715;36;20;4;16;.800;3600000;0
19786;168089;720;79;32;2;30;.938;3855000;0
19786;55932;721;0;0;0;0;.00nan;0;0
19786;61170;720;0;0;0;0;.00nan;0;0
19786;77009;721;62;28;3;25;.893;3855000;0
19787;173840;718;81;39;3;36;.923;3600000;0
19787;-1;719;68;8;0;8;1.000;1405000;0
19787;78587;719;28;17;4;13;.765;2157000;0
19787;86268;718;0;0;0;0;.00nan;0;0
19788;168089;720;72;21;1;20;.952;3600000;0
19788;-1;719;0;0;0;0;.00nan;0;0
19788;61170;720;0;0;0;0;.00nan;0;0
19788;78587;719;55;34;5;29;.853;3600000;0
19789;173840;718;81;24;1;23;.958;3600000;0
19789;55932;721;62;42;5;37;.881;3600000;0
19789;77009;721;0;0;0;0;.00nan;0;0
19789;86268;718;0;0;0;0;.00nan;0;0
19790;168089;720;83;36;2;34;.944;3515000;0
19790;173840;718;100;36;0;36;1.000;3600000;0
19790;61170;720;0;0;0;0;.00nan;0;0
19790;86268;718;0;0;0;0;.00nan;0;0
19791;-1;719;0;0;0;0;.00nan;0;0
19791;55932;721;74;26;2;24;.923;3600000;0
19791;77009;721;0;0;0;0;.00nan;0;0
19791;78587;719;35;14;3;11;.786;3600000;0
19792;168089;720;70;31;2;29;.935;3600000;0
19792;55932;721;79;39;3;36;.923;3600000;0
19792;61170;720;0;0;0;0;.00nan;0;0
19792;77009;721;0;0;0;0;.00nan;0;0
19793;173840;718;50;8;1;7;.875;3600000;0
19793;-1;719;0;0;0;0;.00nan;0;0
19793;78587;719;60;30;4;26;.867;3600000;0
19793;86268;718;0;0;0;0;.00nan;0;0
19794;168089;720;75;20;1;19;.950;3600000;0
19794;-1;719;0;0;0;0;.00nan;0;0
19794;61170;720;0;0;0;0;.00nan;0;0
19794;78587;719;56;27;3;24;.889;3513000;0
19795;173840;718;65;23;2;21;.913;3600000;0
19795;55932;721;39;30;6;24;.800;3600000;0
19795;77009;721;0;0;0;0;.00nan;0;0
19795;86268;718;0;0;0;0;.00nan;0;0
19796;168089;720;0;0;0;0;.00nan;0;0
19796;173840;718;50;30;4;26;.867;3600000;0
19796;61170;720;72;23;1;22;.957;3600000;0
19796;86268;718;0;0;0;0;.00nan;0;0
19797;-1;719;0;0;0;0;.00nan;0;0
19797;55932;721;93;41;2;39;.951;3600000;0
19797;77009;721;0;0;0;0;.00nan;0;0
19797;78587;719;48;23;3;20;.870;3546000;0
20059;-1;719;0;0;0;0;.00nan;0;0
20059;62392;2529;0;0;0;0;.00nan;0;0
20059;78587;719;97;65;3;62;.954;3600000;0
20059;94134;2529;71;16;1;15;.938;3600000;0
20060;161540;716;0;0;0;0;.00nan;0;0
20060;173840;718;86;41;2;39;.951;3857000;0
20060;76486;716;53;22;3;19;.864;3857000;0
20060;86268;718;0;0;0;0;.00nan;0;0
20061;168089;720;97;41;2;39;.951;3542000;0
20061;49545;717;94;19;0;19;1.000;3600000;0
20061;61170;720;0;0;0;0;.00nan;0;0
20061;85619;717;0;0;0;0;.00nan;0;0
20062;-1;2188;96;59;4;55;.932;3589000;0
20062;180929;715;52;20;3;17;.850;3600000;0
20062;-1;2188;0;0;0;0;.00nan;0;0
20062;161163;715;0;0;0;0;.00nan;0;0
20063;-1;719;55;16;2;14;.875;1268000;0
20063;62392;2529;0;0;0;0;.00nan;0;0
20063;78587;719;55;28;4;24;.857;2332000;0
20063;94134;2529;85;11;0;11;1.000;3600000;0
20064;161540;716;0;0;0;0;.00nan;0;0
20064;173840;718;81;36;2;34;.944;3600000;0
20064;76486;716;69;33;3;30;.909;3556000;0
20064;86268;718;0;0;0;0;.00nan;0;0
20065;168089;720;53;33;5;28;.848;3600000;0
20065;49545;717;64;16;1;15;.938;3600000;0
20065;61170;720;0;0;0;0;.00nan;0;0
20065;85619;717;0;0;0;0;.00nan;0;0
20066;-1;2188;49;41;5;36;.878;3600000;0
20066;180929;715;75;23;1;22;.957;3600000;0
20066;-1;2188;0;0;0;0;.00nan;0;0
20066;161163;715;0;0;0;0;.00nan;0;0
20067;-1;719;0;0;0;0;.00nan;0;0
20067;62392;2529;0;0;0;0;.00nan;0;0
20067;78587;719;67;35;2;33;.943;3555000;0
20067;94134;2529;88;21;0;21;1.000;3600000;0
20068;161540;716;0;0;0;0;.00nan;0;0
20068;173840;718;51;22;3;19;.864;3600000;0
20068;76486;716;67;37;4;33;.892;3588000;0
20068;86268;718;0;0;0;0;.00nan;0;0
20069;168089;720;84;39;3;36;.923;3555000;0
20069;49545;717;63;19;2;17;.895;3600000;0
20069;61170;720;0;0;0;0;.00nan;0;0
20069;85619;717;0;0;0;0;.00nan;0;0
20070;-1;2188;76;27;2;25;.926;4065000;0
20070;180929;715;67;33;3;30;.909;4065000;0
20070;-1;2188;0;0;0;0;.00nan;0;0
20070;161163;715;0;0;0;0;.00nan;0;0
20071;-1;719;0;0;0;0;.00nan;0;0
20071;62392;2529;0;0;0;0;.00nan;0;0
20071;78587;719;91;40;2;38;.950;3580000;0
20071;94134;2529;81;20;1;19;.950;3600000;0
20072;161540;716;0;0;0;0;.00nan;0;0
20072;173840;718;82;32;2;30;.938;3630000;0
20072;76486;716;89;35;3;32;.914;3630000;0
20072;86268;718;0;0;0;0;.00nan;0;0
20073;168089;720;81;30;1;29;.967;3600000;0
20073;49545;717;71;27;2;25;.926;3544000;0
20073;61170;720;0;0;0;0;.00nan;0;0
20073;85619;717;0;0;0;0;.00nan;0;0
20074;-1;2188;97;41;2;39;.951;3586000;0
20074;180929;715;88;20;0;20;1.000;3600000;0
20074;-1;2188;0;0;0;0;.00nan;0;0
20074;161163;715;0;0;0;0;.00nan;0;0
139;168089;720;100;29;0;29;1.000;3600000;0
139;49545;717;70;36;4;32;.889;3600000;0
139;61170;720;0;0;0;0;.00nan;0;0
139;85619;717;0;0;0;0;.00nan;0;0
140;-1;2188;45;34;5;29;.853;3598000;0
140;180929;715;39;19;4;15;.789;3600000;0
140;-1;2188;0;0;0;0;.00nan;0;0
140;161163;715;0;0;0;0;.00nan;0;0
198;168089;720;81;30;2;28;.933;3600000;0
198;49545;717;64;31;4;27;.871;3578000;0
198;61170;720;0;0;0;0;.00nan;0;0
198;85619;717;0;0;0;0;.00nan;0;0
206;168089;720;72;36;3;33;.917;3597000;0
206;49545;717;93;29;1;28;.966;3600000;0
206;61170;720;0;0;0;0;.00nan;0;0
206;85619;717;0;0;0;0;.00nan;0;0
350;173840;718;38;21;4;17;.810;3600000;0
350;62392;2529;0;0;0;0;.00nan;0;0
350;86268;718;0;0;0;0;.00nan;0;0
350;94134;2529;100;20;0;20;1.000;3600000;0
351;180929;715;86;19;0;19;1.000;3600000;0
351;49545;717;80;37;3;34;.919;3600000;0
351;85619;717;0;0;0;0;.00nan;0;0
351;161163;715;0;0;0;0;.00nan;0;0
352;173840;718;63;46;6;40;.870;2900000;0
352;62392;2529;0;0;0;0;.00nan;0;0
352;86268;718;47;7;1;6;.857;700000;0
352;94134;2529;55;13;1;12;.923;3600000;0
353;180929;715;83;33;2;31;.939;3600000;0
353;49545;717;56;24;4;20;.833;3278000;0
353;85619;717;39;1;1;0;.000;322000;0
353;161163;715;0;0;0;0;.00nan;0;0
354;173840;718;67;35;4;31;.886;3600000;0
354;62392;2529;0;0;0;0;.00nan;0;0
354;86268;718;0;0;0;0;.00nan;0;0
354;94134;2529;100;24;0;24;1.000;3600000;0
355;180929;715;81;30;2;28;.933;3624000;0
355;49545;717;63;30;3;27;.900;3624000;0
355;85619;717;0;0;0;0;.00nan;0;0
355;161163;715;0;0;0;0;.00nan;0;0
356;173840;718;83;49;4;45;.918;3600000;0
356;62392;2529;0;0;0;0;.00nan;0;0
356;86268;718;0;0;0;0;.00nan;0;0
356;94134;2529;83;23;1;22;.957;3600000;0
357;180929;715;75;29;2;27;.931;3600000;0
357;49545;717;29;27;6;21;.778;2642000;0
357;85619;717;55;4;0;4;1.000;958000;0
357;161163;715;0;0;0;0;.00nan;0;0
637;180929;715;48;39;5;34;.872;3600000;0
637;62392;2529;0;0;0;0;.00nan;0;0
637;94134;2529;86;28;1;27;.964;3600000;0
637;161163;715;0;0;0;0;.00nan;0;0
638;180929;715;63;37;4;33;.892;3567000;0
638;62392;2529;0;0;0;0;.00nan;0;0
638;94134;2529;55;20;3;17;.850;3600000;0
638;161163;715;0;0;0;0;.00nan;0;0
639;180929;715;100;32;0;32;1.000;3600000;0
639;62392;2529;0;0;0;0;.00nan;0;0
639;94134;2529;48;25;4;21;.840;3600000;0
639;161163;715;0;0;0;0;.00nan;0;0
640;180929;715;78;37;3;34;.919;3567000;0
640;62392;2529;0;0;0;0;.00nan;0;0
640;94134;2529;84;25;1;24;.960;3600000;0
640;161163;715;0;0;0;0;.00nan;0;0
918;180929;715;85;45;4;41;.911;3885000;0
918;62392;2529;0;0;0;0;.00nan;0;0
918;94134;2529;59;25;3;22;.880;3885000;0
918;161163;715;0;0;0;0;.00nan;0;0
12763;38277;476;0;0;0;0;.00nan;0;0
12763;55864;474;52;16;2;14;.875;1430000;0
12763;66491;474;34;26;5;21;.808;2170000;0
12763;86343;476;64;26;3;23;.885;3600000;0
12764;166878;472;0;0;0;0;.00nan;0;0
12764;3435;675;100;29;0;29;1.000;3600000;0
12764;193041;472;66;35;4;31;.886;3600000;0
12764;149969;675;0;0;0;0;.00nan;0;0
12765;147;482;56;20;2;18;.900;3600000;0
12765;11500;5004;64;47;5;42;.894;3600000;0
12765;46318;5004;0;0;0;0;.00nan;0;0
12765;67222;482;0;0;0;0;.00nan;0;0
12766;1072;481;81;40;3;37;.925;3600000;0
12766;-1;480;0;0;0;0;.00nan;0;0
12766;56296;481;0;0;0;0;.00nan;0;0
12766;66551;480;62;25;2;23;.920;3600000;0
12767;43158;676;0;0;0;0;.00nan;0;0
12767;46195;676;34;16;4;12;.750;3600000;0
12767;53870;490;97;63;3;60;.952;3600000;0
12767;71297;490;0;0;0;0;.00nan;0;0
12768;163528;682;90;45;3;42;.933;3729000;0
12768;168021;473;80;29;2;27;.931;3729000;0
12768;18169;682;0;0;0;0;.00nan;0;0
12768;85127;473;0;0;0;0;.00nan;0;0
12769;38277;476;47;12;2;10;.833;3600000;0
12769;53870;490;86;49;4;45;.918;3551000;0
12769;71297;490;0;0;0;0;.00nan;0;0
12769;86343;476;0;0;0;0;.00nan;0;0
12770;193870;4535;0;0;0;0;.00nan;0;0
12770;11500;5004;52;40;6;34;.850;3539000;0
12770;12048;4535;55;34;4;30;.882;3600000;0
12770;46318;5004;0;0;0;0;.00nan;0;0
12771;1072;481;77;26;2;24;.923;3544000;0
12771;3435;675;100;48;1;47;.979;3600000;0
12771;56296;481;0;0;0;0;.00nan;0;0
12771;149969;675;0;0;0;0;.00nan;0;0
12772;163528;682;57;32;4;28;.875;3722000;0
12772;18169;682;0;0;0;0;.00nan;0;0
12772;43158;676;46;33;5;28;.848;3722000;0
12772;46195;676;0;0;0;0;.00nan;0;0
12773;147;482;95;30;1;29;.967;3600000;0
12773;166878;472;43;38;6;32;.842;3600000;0
12773;193041;472;0;0;0;0;.00nan;0;0
12773;67222;482;0;0;0;0;.00nan;0;0
12774;168021;473;64;18;1;17;.944;3600000;0
12774;46139;473;0;0;0;0;.00nan;0;0
12774;55864;474;0;0;0;0;.00nan;0;0
12774;66491;474;84;57;5;52;.912;3600000;0
12775;193870;4535;0;0;0;0;.00nan;0;0
12775;12048;4535;60;13;1;12;.923;3600000;0
12775;53870;490;85;43;3;40;.930;3600000;0
12775;71297;490;0;0;0;0;.00nan;0;0
12776;-1;480;57;11;1;10;.909;3600000;0
12776;53870;490;83;62;6;56;.903;3600000;0
12776;66551;480;0;0;0;0;.00nan;0;0
12776;71297;490;0;0;0;0;.00nan;0;0
12777;1072;481;77;42;3;39;.929;3567000;0
12777;38277;476;68;20;1;19;.950;3600000;0
12777;56296;481;0;0;0;0;.00nan;0;0
12777;86343;476;0;0;0;0;.00nan;0;0
12778;147;482;93;28;1;27;.964;3600000;0
12778;3435;675;87;30;2;28;.933;3576000;0
12778;67222;482;0;0;0;0;.00nan;0;0
12778;149969;675;0;0;0;0;.00nan;0;0
12779;163528;682;0;0;0;0;.00nan;0;0
12779;18169;682;51;12;2;10;.833;3600000;0
12779;55864;474;0;0;0;0;.00nan;0;0
12779;66491;474;63;56;7;49;.875;3600000;0
12780;193870;4535;0;0;0;0;.00nan;0;0
12780;12048;4535;97;47;3;44;.936;3568000;0
12780;43158;676;71;19;1;18;.947;3600000;0
12780;46195;676;0;0;0;0;.00nan;0;0
12781;11500;5004;77;33;2;31;.939;3600000;0
12781;168021;473;80;23;1;22;.957;3600000;0
12781;46139;473;0;0;0;0;.00nan;0;0
12781;46318;5004;0;0;0;0;.00nan;0;0
12782;147;482;0;0;0;0;.00nan;0;0
12782;43158;676;78;49;4;45;.918;4020000;0
12782;46195;676;0;0;0;0;.00nan;0;0
12782;67222;482;37;22;4;18;.818;4020000;0
12783;53870;490;94;45;3;42;.933;3600000;0
12783;55864;474;0;0;0;0;.00nan;0;0
12783;66491;474;90;19;0;19;1.000;3600000;0
12783;71297;490;0;0;0;0;.00nan;0;0
12784;163528;682;70;18;1;17;.944;3564000;0
12784;11500;5004;100;34;0;34;1.000;3600000;0
12784;18169;682;0;0;0;0;.00nan;0;0
12784;46318;5004;0;0;0;0;.00nan;0;0
12785;38277;476;72;44;4;40;.909;3565000;0
12785;-1;480;74;33;3;30;.909;3600000;0
12785;66551;480;0;0;0;0;.00nan;0;0
12785;86343;476;0;0;0;0;.00nan;0;0
12786;1072;481;87;37;2;35;.946;3563000;0
12786;168021;473;86;16;0;16;1.000;3600000;0
12786;46139;473;0;0;0;0;.00nan;0;0
12786;56296;481;0;0;0;0;.00nan;0;0
12787;166878;472;75;18;1;17;.944;3600000;0
12787;193041;472;0;0;0;0;.00nan;0;0
12787;193870;4535;0;0;0;0;.00nan;0;0
12787;12048;4535;54;46;6;40;.870;3600000;0
12788;147;482;68;15;1;14;.933;3600000;0
12788;53870;490;46;71;11;60;.845;3600000;0
12788;67222;482;0;0;0;0;.00nan;0;0
12788;71297;490;0;0;0;0;.00nan;0;0
12789;3435;675;56;39;5;34;.872;3543000;0
12789;38277;476;0;0;0;0;.00nan;0;0
12789;86343;476;65;35;4;31;.886;3600000;0
12789;149969;675;0;0;0;0;.00nan;0;0
12790;1072;481;74;32;3;29;.906;3600000;0
12790;43158;676;0;0;0;0;.00nan;0;0
12790;46195;676;37;33;6;27;.818;3600000;0
12790;56296;481;0;0;0;0;.00nan;0;0
12791;163528;682;53;23;3;20;.870;3600000;0
12791;18169;682;0;0;0;0;.00nan;0;0
12791;-1;480;73;45;4;41;.911;3600000;0
12791;66551;480;0;0;0;0;.00nan;0;0
12792;193870;4535;0;0;0;0;.00nan;0;0
12792;12048;4535;82;35;2;33;.943;4020000;0
12792;55864;474;0;0;0;0;.00nan;0;0
12792;66491;474;99;42;2;40;.952;4020000;0
12793;166878;472;66;29;3;26;.897;3600000;0
12793;193041;472;0;0;0;0;.00nan;0;0
12793;168021;473;30;20;4;16;.800;3544000;0
12793;46139;473;0;0;0;0;.00nan;0;0
12794;163528;682;51;10;2;8;.800;3600000;0
12794;18169;682;0;0;0;0;.00nan;0;0
12794;53870;490;73;52;5;47;.904;3600000;0
12794;71297;490;0;0;0;0;.00nan;0;0
12795;3435;675;0;0;0;0;.00nan;0;0
12795;43158;676;92;44;3;41;.932;3600000;0
12795;46195;676;0;0;0;0;.00nan;0;0
12795;149969;675;70;33;4;29;.879;3572000;0
12796;147;482;77;34;2;32;.941;3600000;0
12796;168021;473;22;26;7;19;.731;2323000;0
12796;46139;473;50;12;2;10;.833;1277000;0
12796;67222;482;0;0;0;0;.00nan;0;0
12797;11500;5004;55;46;6;40;.870;3600000;0
12797;-1;480;62;28;3;25;.893;3600000;0
12797;46318;5004;0;0;0;0;.00nan;0;0
12797;66551;480;0;0;0;0;.00nan;0;0
12798;1072;481;75;29;3;26;.897;3600000;0
12798;193870;4535;0;0;0;0;.00nan;0;0
12798;12048;4535;81;52;5;47;.904;3556000;0
12798;56296;481;0;0;0;0;.00nan;0;0
12799;166878;472;0;0;0;0;.00nan;0;0
12799;193041;472;29;24;6;18;.750;3569000;0
12799;38277;476;57;42;5;37;.881;3600000;0
12799;86343;476;0;0;0;0;.00nan;0;0
12800;38277;476;0;0;0;0;.00nan;0;0
12800;43158;676;0;0;0;0;.00nan;0;0
12800;46195;676;90;26;1;25;.962;3600000;0
12800;86343;476;78;44;3;41;.932;3527000;0
12801;11500;5004;0;0;0;0;.00nan;0;0
12801;46318;5004;66;21;2;19;.905;3600000;0
12801;55864;474;0;0;0;0;.00nan;0;0
12801;66491;474;32;27;6;21;.778;3600000;0
12802;3435;675;82;31;2;29;.935;3518000;0
12802;168021;473;94;21;0;21;1.000;3600000;0
12802;46139;473;0;0;0;0;.00nan;0;0
12802;149969;675;0;0;0;0;.00nan;0;0
12803;147;482;62;36;5;31;.861;3600000;0
12803;163528;682;24;11;4;7;.636;567000;0
12803;18169;682;55;18;2;16;.889;2984000;0
12803;67222;482;0;0;0;0;.00nan;0;0
12804;1072;481;27;19;5;14;.737;472000;0
12804;166878;472;43;23;4;19;.826;3600000;0
12804;193041;472;0;0;0;0;.00nan;0;0
12804;56296;481;64;29;3;26;.897;3128000;0
12805;193870;4535;71;39;3;36;.923;3571000;0
12805;12048;4535;0;0;0;0;.00nan;0;0
12805;-1;480;67;29;2;27;.931;3600000;0
12805;66551;480;0;0;0;0;.00nan;0;0
12806;3435;675;0;0;0;0;.00nan;0;0
12806;55864;474;34;32;6;26;.813;3222000;0
12806;66491;474;56;5;0;5;1.000;378000;0
12806;149969;675;52;16;2;14;.875;3600000;0
12807;166878;472;30;28;6;22;.786;2146000;0
12807;193041;472;73;12;0;12;1.000;1454000;0
12807;-1;480;0;0;0;0;.00nan;0;0
12807;66551;480;76;30;2;28;.933;3600000;0
12808;1072;481;0;0;0;0;.00nan;0;0
12808;163528;682;38;27;5;22;.815;3595000;0
12808;18169;682;0;0;0;0;.00nan;0;0
12808;56296;481;57;34;4;30;.882;3600000;0
12809;11500;5004;100;32;0;32;1.000;3600000;0
12809;43158;676;75;27;2;25;.926;3565000;0
12809;46195;676;0;0;0;0;.00nan;0;0
12809;46318;5004;0;0;0;0;.00nan;0;0
12810;193870;4535;0;0;0;0;.00nan;0;0
12810;12048;4535;85;43;2;41;.953;3600000;0
12810;38277;476;41;24;4;20;.833;3524000;0
12810;86343;476;0;0;0;0;.00nan;0;0
12811;168021;473;49;18;3;15;.833;3672000;0
12811;46139;473;0;0;0;0;.00nan;0;0
12811;53870;490;94;50;4;46;.920;3672000;0
12811;71297;490;0;0;0;0;.00nan;0;0
12812;166878;472;43;14;3;11;.786;3600000;0
12812;193041;472;0;0;0;0;.00nan;0;0
12812;55864;474;92;42;2;40;.952;2402000;0
12812;66491;474;37;20;4;16;.800;1198000;0
12813;11500;5004;54;40;6;34;.850;3600000;0
12813;38277;476;13;26;7;19;.731;3540000;0
12813;46318;5004;0;0;0;0;.00nan;0;0
12813;86343;476;0;0;0;0;.00nan;0;0
12814;147;482;94;32;1;31;.969;3600000;0
12814;1072;481;67;40;4;36;.900;3600000;0
12814;56296;481;0;0;0;0;.00nan;0;0
12814;67222;482;0;0;0;0;.00nan;0;0
12815;-1;480;71;23;1;22;.957;3600000;0
12815;43158;676;0;0;0;0;.00nan;0;0
12815;46195;676;52;41;5;36;.878;3600000;0
12815;66551;480;0;0;0;0;.00nan;0;0
12816;3435;675;71;32;4;28;.875;3543000;0
12816;163528;682;57;24;3;21;.875;3600000;0
12816;18169;682;0;0;0;0;.00nan;0;0
12816;149969;675;0;0;0;0;.00nan;0;0
12817;166878;472;0;0;0;0;.00nan;0;0
12817;193041;472;36;27;5;22;.815;4020000;0
12817;53870;490;72;23;0;23;1.000;1651000;0
12817;71297;490;56;44;5;39;.886;2369000;0
12818;147;482;74;27;2;25;.926;3981000;0
12818;38277;476;0;0;0;0;.00nan;0;0
12818;67222;482;0;0;0;0;.00nan;0;0
12818;86343;476;82;46;3;43;.935;3981000;0
12819;3435;675;0;0;0;0;.00nan;0;0
12819;11500;5004;73;47;5;42;.894;3600000;0
12819;46318;5004;0;0;0;0;.00nan;0;0
12819;149969;675;75;21;1;20;.952;3600000;0
12820;-1;480;52;17;2;15;.882;3600000;0
12820;55864;474;62;19;1;18;.947;751000;0
12820;66491;474;49;48;7;41;.854;2849000;0
12820;66551;480;0;0;0;0;.00nan;0;0
12821;163528;682;84;14;0;14;1.000;3600000;0
12821;193870;4535;0;0;0;0;.00nan;0;0
12821;12048;4535;91;59;3;56;.949;3600000;0
12821;18169;682;0;0;0;0;.00nan;0;0
12822;168021;473;63;29;3;26;.897;3600000;0
12822;43158;676;41;49;7;42;.857;3600000;0
12822;46139;473;0;0;0;0;.00nan;0;0
12822;46195;676;0;0;0;0;.00nan;0;0
12823;147;482;49;25;3;22;.880;3600000;0
12823;11500;5004;55;36;5;31;.861;3572000;0
12823;46318;5004;0;0;0;0;.00nan;0;0
12823;67222;482;0;0;0;0;.00nan;0;0
12824;1072;481;62;32;3;29;.906;3802000;0
12824;11500;5004;94;52;4;48;.923;3802000;0
12824;46318;5004;0;0;0;0;.00nan;0;0
12824;56296;481;0;0;0;0;.00nan;0;0
12825;3435;675;66;15;1;14;.933;3600000;0
12825;53870;490;0;0;0;0;.00nan;0;0
12825;71297;490;89;58;5;53;.914;3600000;0
12825;149969;675;0;0;0;0;.00nan;0;0
12826;147;482;41;16;3;13;.813;3600000;0
12826;193870;4535;86;40;2;38;.950;2824000;0
12826;12048;4535;35;20;4;16;.800;776000;0
12826;67222;482;0;0;0;0;.00nan;0;0
12827;168021;473;79;24;2;22;.917;3560000;0
12827;-1;480;78;21;1;20;.952;3600000;0
12827;46139;473;0;0;0;0;.00nan;0;0
12827;66551;480;0;0;0;0;.00nan;0;0
12828;166878;472;75;35;3;32;.914;3600000;0
12828;193041;472;0;0;0;0;.00nan;0;0
12828;163528;682;52;43;6;37;.860;3600000;0
12828;18169;682;0;0;0;0;.00nan;0;0
12829;163528;682;0;0;0;0;.00nan;0;0
12829;18169;682;47;26;4;22;.846;3529000;0
12829;38277;476;99;47;2;45;.957;3600000;0
12829;86343;476;0;0;0;0;.00nan;0;0
12830;193870;4535;0;0;0;0;.00nan;0;0
12830;12048;4535;90;47;3;44;.936;3600000;0
12830;168021;473;0;0;0;0;.00nan;0;0
12830;46139;473;82;14;0;14;1.000;3600000;0
12831;147;482;53;17;2;15;.882;3619000;0
12831;55864;474;0;0;0;0;.00nan;0;0
12831;66491;474;87;39;3;36;.923;3619000;0
12831;67222;482;0;0;0;0;.00nan;0;0
12832;3435;675;88;32;1;31;.969;3600000;0
12832;-1;480;90;34;2;32;.941;3545000;0
12832;66551;480;0;0;0;0;.00nan;0;0
12832;149969;675;0;0;0;0;.00nan;0;0
12833;1072;481;34;13;3;10;.769;3600000;0
12833;53870;490;80;39;3;36;.923;2467000;0
12833;56296;481;0;0;0;0;.00nan;0;0
12833;71297;490;29;15;4;11;.733;1133000;0
12834;166878;472;21;19;5;14;.737;3600000;0
12834;193041;472;0;0;0;0;.00nan;0;0
12834;11500;5004;93;44;2;42;.955;3600000;0
12834;46318;5004;0;0;0;0;.00nan;0;0
12835;11500;5004;86;17;0;17;1.000;3600000;0
12835;46318;5004;0;0;0;0;.00nan;0;0
12835;53870;490;50;31;4;27;.871;3355000;0
12835;71297;490;41;2;1;1;.500;245000;0
12836;3435;675;0;0;0;0;.00nan;0;0
12836;193870;4535;0;0;0;0;.00nan;0;0
12836;12048;4535;73;42;4;38;.905;3600000;0
12836;149969;675;93;17;0;17;1.000;3600000;0
12837;147;482;54;27;3;24;.889;3563000;0
12837;-1;480;82;34;2;32;.941;3600000;0
12837;66551;480;0;0;0;0;.00nan;0;0
12837;67222;482;0;0;0;0;.00nan;0;0
12838;1072;481;96;25;0;25;1.000;3600000;0
12838;55864;474;0;0;0;0;.00nan;0;0
12838;56296;481;0;0;0;0;.00nan;0;0
12838;66491;474;92;41;2;39;.951;3579000;0
12839;166878;472;87;29;2;27;.931;3600000;0
12839;193041;472;0;0;0;0;.00nan;0;0
12839;43158;676;0;0;0;0;.00nan;0;0
12839;85797;676;76;37;3;34;.919;3600000;0
12840;168021;473;0;0;0;0;.00nan;0;0
12840;38277;476;0;0;0;0;.00nan;0;0
12840;46139;473;66;29;2;27;.931;3600000;0
12840;86343;476;61;32;4;28;.875;3532000;0
12841;38277;476;75;27;1;26;.963;3600000;0
12841;43158;676;0;0;0;0;.00nan;0;0
12841;85797;676;65;24;2;22;.917;3553000;0
12841;86343;476;0;0;0;0;.00nan;0;0
12842;166878;472;0;0;0;0;.00nan;0;0
12842;193041;472;58;24;2;22;.917;3545000;0
12842;163528;682;85;32;1;31;.969;3600000;0
12842;18169;682;0;0;0;0;.00nan;0;0
12843;168021;473;57;16;2;14;.875;3600000;0
12843;46139;473;0;0;0;0;.00nan;0;0
12843;55864;474;0;0;0;0;.00nan;0;0
12843;66491;474;68;42;4;38;.905;3600000;0
12844;11500;5004;89;38;2;36;.947;3600000;0
12844;-1;480;53;22;3;19;.864;3543000;0
12844;46318;5004;0;0;0;0;.00nan;0;0
12844;66551;480;0;0;0;0;.00nan;0;0
12845;147;482;73;9;0;9;1.000;3600000;0
12845;53870;490;98;40;2;38;.950;3600000;0
12845;67222;482;0;0;0;0;.00nan;0;0
12845;71297;490;0;0;0;0;.00nan;0;0
12846;1072;481;95;22;0;22;1.000;3600000;0
12846;193870;4535;0;0;0;0;.00nan;0;0
12846;12048;4535;66;33;3;30;.909;3600000;0
12846;56296;481;0;0;0;0;.00nan;0;0
12847;3435;675;0;0;0;0;.00nan;0;0
12847;11500;5004;42;32;5;27;.844;3590000;0
12847;46318;5004;0;0;0;0;.00nan;0;0
12847;149969;675;65;29;3;26;.897;3600000;0
12848;53870;490;0;0;0;0;.00nan;0;0
12848;55864;474;0;0;0;0;.00nan;0;0
12848;66491;474;56;16;2;14;.875;3549000;0
12848;71297;490;98;41;1;40;.976;3600000;0
12849;147;482;69;34;4;30;.882;3545000;0
12849;38277;476;97;46;3;43;.935;3600000;0
12849;67222;482;0;0;0;0;.00nan;0;0
12849;86343;476;0;0;0;0;.00nan;0;0
12850;1072;481;50;31;4;27;.871;3600000;0
12850;163528;682;91;19;0;19;1.000;3600000;0
12850;18169;682;0;0;0;0;.00nan;0;0
12850;56296;481;0;0;0;0;.00nan;0;0
12851;166878;472;66;28;2;26;.929;3536000;0
12851;193041;472;0;0;0;0;.00nan;0;0
12851;-1;480;100;29;0;29;1.000;3600000;0
12851;66551;480;0;0;0;0;.00nan;0;0
12852;193870;4535;0;0;0;0;.00nan;0;0
12852;12048;4535;65;52;6;46;.885;3600000;0
12852;168021;473;48;14;2;12;.857;3600000;0
12852;46139;473;0;0;0;0;.00nan;0;0
12853;163528;682;66;17;1;16;.941;3600000;0
12853;18169;682;0;0;0;0;.00nan;0;0
12853;55864;474;73;42;4;38;.905;3600000;0
12853;66491;474;0;0;0;0;.00nan;0;0
12854;38277;476;36;24;5;19;.792;3551000;0
12854;53870;490;100;52;3;49;.942;3600000;0
12854;71297;490;0;0;0;0;.00nan;0;0
12854;86343;476;0;0;0;0;.00nan;0;0
12855;3435;675;73;23;2;21;.913;3570000;0
12855;-1;480;100;28;0;28;1.000;3600000;0
12855;66551;480;0;0;0;0;.00nan;0;0
12855;149969;675;0;0;0;0;.00nan;0;0
12856;1072;481;96;49;3;46;.939;3548000;0
12856;166878;472;59;20;2;18;.900;3600000;0
12856;193041;472;0;0;0;0;.00nan;0;0
12856;56296;481;0;0;0;0;.00nan;0;0
12857;168021;473;61;21;2;19;.905;3600000;0
12857;43158;676;0;0;0;0;.00nan;0;0
12857;46139;473;0;0;0;0;.00nan;0;0
12857;85797;676;76;36;3;33;.917;3592000;0
12858;193870;4535;91;40;2;38;.950;3600000;0
12858;11500;5004;43;27;4;23;.852;3596000;0
12858;12048;4535;0;0;0;0;.00nan;0;0
12858;46318;5004;0;0;0;0;.00nan;0;0
12859;11500;5004;32;33;6;27;.818;1896000;0
12859;43158;676;0;0;0;0;.00nan;0;0
12859;46318;5004;58;20;2;18;.900;1704000;0
12859;85797;676;50;28;4;24;.857;3600000;0
12860;1072;481;85;32;2;30;.938;3600000;0
12860;3435;675;0;0;0;0;.00nan;0;0
12860;56296;481;0;0;0;0;.00nan;0;0
12860;149969;675;77;35;3;32;.914;3577000;0
12861;147;482;62;11;1;10;.909;3600000;0
12861;55864;474;0;0;0;0;.00nan;0;0
12861;66491;474;81;43;4;39;.907;3600000;0
12861;67222;482;0;0;0;0;.00nan;0;0
12862;163528;682;61;30;4;26;.867;3600000;0
12862;18169;682;0;0;0;0;.00nan;0;0
12862;38277;476;96;37;1;36;.973;3600000;0
12862;86343;476;0;0;0;0;.00nan;0;0
12863;166878;472;83;12;0;12;1.000;3600000;0
12863;193041;472;0;0;0;0;.00nan;0;0
12863;53870;490;19;31;7;24;.774;1989000;0
12863;71297;490;76;42;4;38;.905;1611000;0
12864;168021;473;84;31;2;29;.935;3600000;0
12864;-1;480;65;30;3;27;.900;3600000;0
12864;46139;473;0;0;0;0;.00nan;0;0
12864;66551;480;0;0;0;0;.00nan;0;0
12865;193870;4535;0;0;0;0;.00nan;0;0
12865;12048;4535;97;35;1;34;.971;3547000;0
12865;55864;474;0;0;0;0;.00nan;0;0
12865;66491;474;100;31;0;31;1.000;3600000;0
12866;3435;675;0;0;0;0;.00nan;0;0
12866;163528;682;81;21;1;20;.952;3600000;0
12866;18169;682;0;0;0;0;.00nan;0;0
12866;149969;675;62;34;4;30;.882;3600000;0
12867;147;482;75;38;3;35;.921;3600000;0
12867;166878;472;99;30;0;30;1.000;3600000;0
12867;193041;472;0;0;0;0;.00nan;0;0
12867;67222;482;0;0;0;0;.00nan;0;0
12868;-1;480;0;0;0;0;.00nan;0;0
12868;53870;490;69;41;4;37;.902;3600000;0
12868;66551;480;59;11;1;10;.909;3600000;0
12868;71297;490;0;0;0;0;.00nan;0;0
12869;1072;481;0;0;0;0;.00nan;0;0
12869;43158;676;0;0;0;0;.00nan;0;0
12869;56296;481;93;31;1;30;.968;3600000;0
12869;85797;676;96;38;2;36;.947;3600000;0
12870;-1;480;84;10;0;10;1.000;3600000;0
12870;55864;474;0;0;0;0;.00nan;0;0
12870;66491;474;93;44;2;42;.955;3532000;0
12870;66551;480;0;0;0;0;.00nan;0;0
12871;147;482;74;27;2;25;.926;3600000;0
12871;11500;5004;0;0;0;0;.00nan;0;0
12871;46318;5004;79;43;4;39;.907;3600000;0
12871;67222;482;0;0;0;0;.00nan;0;0
12872;1072;481;36;17;4;13;.765;3600000;0
12872;53870;490;0;0;0;0;.00nan;0;0
12872;56296;481;0;0;0;0;.00nan;0;0
12872;71297;490;96;72;5;67;.931;3572000;0
12873;163528;682;85;29;2;27;.931;3600000;0
12873;18169;682;0;0;0;0;.00nan;0;0
12873;43158;676;0;0;0;0;.00nan;0;0
12873;85797;676;56;36;5;31;.861;3600000;0
12874;166878;472;63;37;4;33;.892;3600000;0
12874;193041;472;0;0;0;0;.00nan;0;0
12874;168021;473;43;27;5;22;.815;3585000;0
12874;46139;473;0;0;0;0;.00nan;0;0
12875;3435;675;70;25;2;23;.920;3600000;0
12875;193870;4535;0;0;0;0;.00nan;0;0
12875;12048;4535;88;55;5;50;.909;3600000;0
12875;149969;675;0;0;0;0;.00nan;0;0
12876;168021;473;77;24;1;23;.958;3600000;0
12876;38277;476;0;0;0;0;.00nan;0;0
12876;46139;473;0;0;0;0;.00nan;0;0
12876;86343;476;89;49;2;47;.959;3589000;0
12877;166878;472;0;0;0;0;.00nan;0;0
12877;193041;472;68;24;2;22;.917;3600000;0
12877;38277;476;87;58;5;53;.914;3600000;0
12877;86343;476;0;0;0;0;.00nan;0;0
12878;3435;675;60;15;2;13;.867;3544000;0
12878;53870;490;0;0;0;0;.00nan;0;0
12878;71297;490;99;49;1;48;.980;3600000;0
12878;149969;675;0;0;0;0;.00nan;0;0
12879;147;482;0;0;0;0;.00nan;0;0
12879;163528;682;65;28;4;24;.857;4020000;0
12879;18169;682;0;0;0;0;.00nan;0;0
12879;67222;482;82;53;4;49;.925;4020000;0
12880;193870;4535;0;0;0;0;.00nan;0;0
12880;12048;4535;74;45;4;41;.911;3600000;0
12880;-1;480;80;14;0;14;1.000;3600000;0
12880;66551;480;0;0;0;0;.00nan;0;0
12881;1072;481;70;22;1;21;.955;3600000;0
12881;11500;5004;67;34;4;30;.882;3600000;0
12881;46318;5004;0;0;0;0;.00nan;0;0
12881;56296;481;0;0;0;0;.00nan;0;0
12882;43158;676;0;0;0;0;.00nan;0;0
12882;55864;474;0;0;0;0;.00nan;0;0
12882;66491;474;82;57;5;52;.912;3600000;0
12882;85797;676;72;25;2;23;.920;3600000;0
12883;163528;682;85;29;1;28;.966;3600000;0
12883;11500;5004;98;49;3;46;.939;3534000;0
12883;18169;682;0;0;0;0;.00nan;0;0
12883;46318;5004;0;0;0;0;.00nan;0;0
12884;193870;4535;0;0;0;0;.00nan;0;0
12884;12048;4535;88;23;1;22;.957;3600000;0
12884;53870;490;0;0;0;0;.00nan;0;0
12884;71297;490;56;40;5;35;.875;3600000;0
12885;38277;476;90;31;1;30;.968;3600000;0
12885;-1;480;78;29;2;27;.931;3557000;0
12885;66551;480;0;0;0;0;.00nan;0;0
12885;86343;476;0;0;0;0;.00nan;0;0
12886;147;482;94;32;1;31;.969;3773000;0
12886;43158;676;0;0;0;0;.00nan;0;0
12886;67222;482;0;0;0;0;.00nan;0;0
12886;85797;676;92;38;2;36;.947;3773000;0
12887;166878;472;61;27;3;24;.889;3600000;0
12887;193041;472;0;0;0;0;.00nan;0;0
12887;55864;474;0;0;0;0;.00nan;0;0
12887;66491;474;85;45;4;41;.911;3600000;0
12888;3435;675;0;0;0;0;.00nan;0;0
12888;168021;473;0;0;0;0;.00nan;0;0
12888;46139;473;43;21;4;17;.810;3590000;0
12888;149969;675;89;42;3;39;.929;3600000;0
12889;38277;476;0;0;0;0;.00nan;0;0
12889;55864;474;62;46;5;41;.891;3600000;0
12889;66491;474;0;0;0;0;.00nan;0;0
12889;86343;476;72;20;2;18;.900;3600000;0
12890;3435;675;58;27;3;24;.889;3571000;0
12890;43158;676;80;29;2;27;.931;3600000;0
12890;85797;676;0;0;0;0;.00nan;0;0
12890;149969;675;0;0;0;0;.00nan;0;0
12891;147;482;61;10;0;10;1.000;1688000;0
12891;168021;473;69;30;4;26;.867;4020000;0
12891;46139;473;0;0;0;0;.00nan;0;0
12891;67222;482;40;27;4;23;.852;2332000;0
12892;166878;472;8;21;7;14;.667;3600000;0
12892;193041;472;0;0;0;0;.00nan;0;0
12892;11500;5004;99;41;1;40;.976;3600000;0
12892;46318;5004;0;0;0;0;.00nan;0;0
12893;1072;481;0;0;0;0;.00nan;0;0
12893;-1;480;54;28;3;25;.893;3600000;0
12893;56296;481;72;21;1;20;.952;3600000;0
12893;66551;480;0;0;0;0;.00nan;0;0
12894;163528;682;37;5;2;3;.600;3600000;0
12894;193870;4535;0;0;0;0;.00nan;0;0
12894;12048;4535;86;48;4;44;.917;3600000;0
12894;18169;682;0;0;0;0;.00nan;0;0
12895;11500;5004;70;46;5;41;.891;3600000;0
12895;168021;473;70;27;2;25;.926;3600000;0
12895;46139;473;0;0;0;0;.00nan;0;0
12895;46318;5004;0;0;0;0;.00nan;0;0
12896;43158;676;0;0;0;0;.00nan;0;0
12896;53870;490;0;0;0;0;.00nan;0;0
12896;71297;490;98;66;4;62;.939;3600000;0
12896;85797;676;50;18;3;15;.833;3600000;0
12897;3435;675;29;10;4;6;.600;1010000;0
12897;38277;476;59;47;5;42;.894;4020000;0
12897;86343;476;0;0;0;0;.00nan;0;0
12897;149969;675;74;17;1;16;.941;3010000;0
12898;163528;682;75;30;2;28;.933;4020000;0
12898;18169;682;0;0;0;0;.00nan;0;0
12898;-1;480;86;35;2;33;.943;4020000;0
12898;66551;480;0;0;0;0;.00nan;0;0
12899;147;482;73;28;2;26;.929;3600000;0
12899;1072;481;65;35;4;31;.886;3600000;0
12899;56296;481;0;0;0;0;.00nan;0;0
12899;67222;482;0;0;0;0;.00nan;0;0
12900;166878;472;24;23;6;17;.739;3600000;0
12900;193041;472;0;0;0;0;.00nan;0;0
12900;193870;4535;0;0;0;0;.00nan;0;0
12900;12048;4535;99;67;3;64;.955;3600000;0
12901;1072;481;0;0;0;0;.00nan;0;0
12901;55864;474;0;0;0;0;.00nan;0;0
12901;56296;481;64;28;3;25;.893;3563000;0
12901;66491;474;86;37;2;35;.946;3600000;0
12902;168021;473;75;21;1;20;.952;3600000;0
12902;46139;473;0;0;0;0;.00nan;0;0
12902;53870;490;0;0;0;0;.00nan;0;0
12902;71297;490;98;56;3;53;.946;3561000;0
12903;11500;5004;87;44;3;41;.932;3600000;0
12903;38277;476;57;28;4;24;.857;3548000;0
12903;46318;5004;0;0;0;0;.00nan;0;0
12903;86343;476;0;0;0;0;.00nan;0;0
12904;147;482;51;27;4;23;.852;4020000;0
12904;-1;480;65;34;4;30;.882;4020000;0
12904;66551;480;0;0;0;0;.00nan;0;0
12904;67222;482;0;0;0;0;.00nan;0;0
12905;193870;4535;0;0;0;0;.00nan;0;0
12905;12048;4535;75;30;2;28;.933;3570000;0
12905;43158;676;0;0;0;0;.00nan;0;0
12905;85797;676;93;36;1;35;.972;3600000;0
12906;166878;472;0;0;0;0;.00nan;0;0
12906;3435;675;72;34;3;31;.912;3555000;0
12906;193041;472;58;18;2;16;.889;3600000;0
12906;149969;675;0;0;0;0;.00nan;0;0
12907;11500;5004;0;0;0;0;.00nan;0;0
12907;46318;5004;89;35;2;33;.943;4020000;0
12907;53870;490;0;0;0;0;.00nan;0;0
12907;71297;490;98;42;2;40;.952;4020000;0
12908;3435;675;0;0;0;0;.00nan;0;0
12908;55864;474;0;0;0;0;.00nan;0;0
12908;66491;474;52;51;7;44;.863;3600000;0
12908;149969;675;51;21;3;18;.857;3600000;0
12909;-1;480;55;26;3;23;.885;3600000;0
12909;43158;676;0;0;0;0;.00nan;0;0
12909;66551;480;0;0;0;0;.00nan;0;0
12909;85797;676;55;31;4;27;.871;3535000;0
12910;1072;481;35;31;6;25;.806;3303000;0
12910;38277;476;1;18;7;11;.611;1823000;0
12910;56296;481;52;1;0;1;1.000;297000;0
12910;86343;476;34;11;3;8;.727;1777000;0
12911;147;482;72;21;1;20;.952;3600000;0
12911;193870;4535;0;0;0;0;.00nan;0;0
12911;12048;4535;88;47;2;45;.957;3600000;0
12911;67222;482;0;0;0;0;.00nan;0;0
12912;163528;682;96;32;0;32;1.000;4020000;0
12912;168021;473;100;41;0;41;1.000;4020000;0
12912;18169;682;0;0;0;0;.00nan;0;0
12912;46139;473;0;0;0;0;.00nan;0;0
12913;11500;5004;52;21;3;18;.857;3600000;0
12913;46318;5004;0;0;0;0;.00nan;0;0
12913;55864;474;42;30;5;25;.833;2153000;0
12913;66491;474;66;12;0;12;1.000;1367000;0
12914;193870;4535;0;0;0;0;.00nan;0;0
12914;12048;4535;61;34;4;30;.882;4020000;0
12914;38277;476;0;0;0;0;.00nan;0;0
12914;86343;476;59;32;4;28;.875;4020000;0
12915;147;482;65;34;3;31;.912;4020000;0
12915;3435;675;0;0;0;0;.00nan;0;0
12915;67222;482;0;0;0;0;.00nan;0;0
12915;149969;675;85;40;3;37;.925;4020000;0
12916;163528;682;65;14;1;13;.929;3600000;0
12916;18169;682;0;0;0;0;.00nan;0;0
12916;53870;490;54;31;4;27;.871;1856000;0
12916;71297;490;42;29;5;24;.828;1744000;0
12917;166878;472;100;24;0;24;1.000;3600000;0
12917;193041;472;0;0;0;0;.00nan;0;0
12917;43158;676;0;0;0;0;.00nan;0;0
12917;85797;676;89;37;2;35;.946;3556000;0
12918;1072;481;75;43;4;39;.907;3600000;0
12918;168021;473;65;19;1;18;.947;3600000;0
12918;46139;473;0;0;0;0;.00nan;0;0
12918;56296;481;0;0;0;0;.00nan;0;0
12919;38277;476;83;46;4;42;.913;3600000;0
12919;43158;676;40;29;5;24;.828;3600000;0
12919;85797;676;0;0;0;0;.00nan;0;0
12919;86343;476;0;0;0;0;.00nan;0;0
12920;163528;682;0;0;0;0;.00nan;0;0
12920;11500;5004;61;20;2;18;.900;1450000;0
12920;18169;682;67;19;1;18;.947;3600000;0
12920;46318;5004;30;35;6;29;.829;2150000;0
12921;-1;480;85;16;0;16;1.000;3600000;0
12921;55864;474;0;0;0;0;.00nan;0;0
12921;66491;474;91;50;4;46;.920;3600000;0
12921;66551;480;0;0;0;0;.00nan;0;0
12922;3435;675;56;14;2;12;.857;3600000;0
12922;53870;490;41;37;6;31;.838;3600000;0
12922;71297;490;0;0;0;0;.00nan;0;0
12922;149969;675;0;0;0;0;.00nan;0;0
12923;166878;472;40;24;4;20;.833;3600000;0
12923;193041;472;0;0;0;0;.00nan;0;0
12923;168021;473;100;22;0;22;1.000;3600000;0
12923;46139;473;0;0;0;0;.00nan;0;0
12924;1072;481;72;22;1;21;.955;3600000;0
12924;193870;4535;0;0;0;0;.00nan;0;0
12924;12048;4535;43;34;5;29;.853;3600000;0
12924;56296;481;0;0;0;0;.00nan;0;0
12925;168021;473;50;23;4;19;.826;3743000;0
12925;38277;476;0;0;0;0;.00nan;0;0
12925;46139;473;0;0;0;0;.00nan;0;0
12925;86343;476;87;44;3;41;.932;3743000;0
12926;166878;472;94;38;2;36;.947;3600000;0
12926;193041;472;0;0;0;0;.00nan;0;0
12926;11500;5004;89;48;3;45;.938;3556000;0
12926;46318;5004;0;0;0;0;.00nan;0;0
12927;38277;476;43;17;3;14;.824;3600000;0
12927;55864;474;54;7;1;6;.857;1051000;0
12927;66491;474;44;40;6;34;.850;2549000;0
12927;86343;476;0;0;0;0;.00nan;0;0
12928;3435;675;46;16;3;13;.813;3600000;0
12928;163528;682;100;28;0;28;1.000;3600000;0
12928;18169;682;0;0;0;0;.00nan;0;0
12928;149969;675;0;0;0;0;.00nan;0;0
12929;-1;480;71;10;0;10;1.000;3600000;0
12929;53870;490;0;0;0;0;.00nan;0;0
12929;66551;480;0;0;0;0;.00nan;0;0
12929;71297;490;84;61;5;56;.918;3600000;0
12930;147;482;100;22;0;22;1.000;3600000;0
12930;43158;676;0;0;0;0;.00nan;0;0
12930;67222;482;0;0;0;0;.00nan;0;0
12930;85797;676;61;25;3;22;.880;3600000;0
12931;193870;4535;0;0;0;0;.00nan;0;0
12931;12048;4535;83;50;4;46;.920;3560000;0
12931;168021;473;65;18;2;16;.889;3600000;0
12931;46139;473;0;0;0;0;.00nan;0;0
12932;166878;472;0;0;0;0;.00nan;0;0
12932;193041;472;84;14;0;14;1.000;3600000;0
12932;55864;474;77;57;5;52;.912;3600000;0
12932;66491;474;0;0;0;0;.00nan;0;0
12933;147;482;49;28;4;24;.857;3544000;0
12933;168021;473;70;25;2;23;.920;3600000;0
12933;46139;473;0;0;0;0;.00nan;0;0
12933;67222;482;0;0;0;0;.00nan;0;0
12934;11500;5004;94;19;0;19;1.000;3600000;0
12934;46318;5004;0;0;0;0;.00nan;0;0
12934;53870;490;54;39;5;34;.872;3123000;0
12934;71297;490;66;7;0;7;1.000;477000;0
12935;1072;481;57;32;5;27;.844;3600000;0
12935;43158;676;0;0;0;0;.00nan;0;0
12935;56296;481;0;0;0;0;.00nan;0;0
12935;85797;676;74;22;2;20;.909;3600000;0
12936;163528;682;63;15;2;13;.867;3600000;0
12936;18169;682;0;0;0;0;.00nan;0;0
12936;38277;476;78;49;5;44;.898;3600000;0
12936;86343;476;0;0;0;0;.00nan;0;0
12937;193870;4535;0;0;0;0;.00nan;0;0
12937;12048;4535;94;39;2;37;.949;4020000;0
12937;-1;480;49;14;2;12;.857;4020000;0
12937;66551;480;0;0;0;0;.00nan;0;0
12938;43158;676;0;0;0;0;.00nan;0;0
12938;55864;474;0;0;0;0;.00nan;0;0
12938;66491;474;76;48;4;44;.917;3600000;0
12938;85797;676;86;16;0;16;1.000;3600000;0
12939;3435;675;0;0;0;0;.00nan;0;0
12939;55864;474;0;0;0;0;.00nan;0;0
12939;66491;474;92;35;1;34;.971;3600000;0
12939;149969;675;64;21;3;18;.857;3600000;0
12940;1072;481;62;31;4;27;.871;3553000;0
12940;-1;480;71;23;2;21;.913;3600000;0
12940;56296;481;0;0;0;0;.00nan;0;0
12940;66551;480;0;0;0;0;.00nan;0;0
12941;163528;682;59;12;1;11;.917;3600000;0
12941;18169;682;0;0;0;0;.00nan;0;0
12941;43158;676;0;0;0;0;.00nan;0;0
12941;85797;676;72;42;4;38;.905;3600000;0
12942;166878;472;0;0;0;0;.00nan;0;0
12942;193041;472;45;11;2;9;.818;3600000;0
12942;53870;490;0;0;0;0;.00nan;0;0
12942;71297;490;96;57;4;53;.930;3533000;0
12943;168021;473;100;31;0;31;1.000;3600000;0
12943;38277;476;76;33;2;31;.939;3537000;0
12943;46139;473;0;0;0;0;.00nan;0;0
12943;86343;476;0;0;0;0;.00nan;0;0
12944;11500;5004;83;50;4;46;.920;3600000;0
12944;38277;476;0;0;0;0;.00nan;0;0
12944;46318;5004;0;0;0;0;.00nan;0;0
12944;86343;476;47;33;6;27;.818;3539000;0
12945;147;482;46;18;3;15;.833;3600000;0
12945;53870;490;49;50;7;43;.860;3600000;0
12945;67222;482;0;0;0;0;.00nan;0;0
12945;71297;490;0;0;0;0;.00nan;0;0
12946;3435;675;0;0;0;0;.00nan;0;0
12946;-1;480;69;26;2;24;.923;3683000;0
12946;66551;480;0;0;0;0;.00nan;0;0
12946;149969;675;84;36;3;33;.917;3683000;0
12947;1072;481;0;0;0;0;.00nan;0;0
12947;163528;682;57;21;3;18;.857;3578000;0
12947;18169;682;0;0;0;0;.00nan;0;0
12947;56296;481;94;41;2;39;.951;3600000;0
12948;166878;472;43;25;4;21;.840;3600000;0
12948;193041;472;0;0;0;0;.00nan;0;0
12948;43158;676;0;0;0;0;.00nan;0;0
12948;85797;676;78;21;1;20;.952;3600000;0
12949;193870;4535;0;0;0;0;.00nan;0;0
12949;12048;4535;74;20;1;19;.950;3600000;0
12949;55864;474;0;0;0;0;.00nan;0;0
12949;66491;474;81;31;2;29;.935;3590000;0
12950;11500;5004;57;26;4;22;.846;3600000;0
12950;43158;676;0;0;0;0;.00nan;0;0
12950;46318;5004;0;0;0;0;.00nan;0;0
12950;85797;676;53;31;5;26;.839;3560000;0
12951;193870;4535;0;0;0;0;.00nan;0;0
12951;12048;4535;83;32;1;31;.969;4020000;0
12951;53870;490;0;0;0;0;.00nan;0;0
12951;71297;490;97;42;1;41;.976;4020000;0
12952;3435;675;97;37;0;37;1.000;4020000;0
12952;38277;476;100;30;0;30;1.000;4020000;0
12952;86343;476;0;0;0;0;.00nan;0;0
12952;149969;675;0;0;0;0;.00nan;0;0
12953;147;482;50;25;4;21;.840;3585000;0
12953;-1;480;89;36;2;34;.944;3600000;0
12953;66551;480;0;0;0;0;.00nan;0;0
12953;67222;482;0;0;0;0;.00nan;0;0
12954;163528;682;44;27;5;22;.815;3600000;0
12954;168021;473;81;27;2;25;.926;3600000;0
12954;18169;682;0;0;0;0;.00nan;0;0
12954;46139;473;0;0;0;0;.00nan;0;0
12955;1072;481;43;24;4;20;.833;1985000;0
12955;166878;472;79;27;2;25;.926;3600000;0
12955;193041;472;0;0;0;0;.00nan;0;0
12955;56296;481;41;18;4;14;.778;1615000;0
12956;53870;490;87;52;4;48;.923;3565000;0
12956;55864;474;47;19;3;16;.842;3600000;0
12956;66491;474;0;0;0;0;.00nan;0;0
12956;71297;490;0;0;0;0;.00nan;0;0
12957;166878;472;0;0;0;0;.00nan;0;0
12957;3435;675;87;39;2;37;.949;3600000;0
12957;193041;472;36;18;4;14;.778;3564000;0
12957;149969;675;0;0;0;0;.00nan;0;0
12958;163528;682;65;28;3;25;.893;3600000;0
12958;18169;682;0;0;0;0;.00nan;0;0
12958;-1;480;62;32;4;28;.875;3577000;0
12958;66551;480;0;0;0;0;.00nan;0;0
12959;147;482;85;33;2;31;.939;3600000;0
12959;1072;481;59;31;4;27;.871;3553000;0
12959;56296;481;0;0;0;0;.00nan;0;0
12959;67222;482;0;0;0;0;.00nan;0;0
12960;193870;4535;0;0;0;0;.00nan;0;0
12960;12048;4535;59;35;4;31;.886;3863000;0
12960;38277;476;67;25;3;22;.880;3831000;0
12960;86343;476;0;0;0;0;.00nan;0;0
12961;11500;5004;70;35;3;32;.914;3600000;0
12961;168021;473;69;18;1;17;.944;3600000;0
12961;46139;473;0;0;0;0;.00nan;0;0
12961;46318;5004;0;0;0;0;.00nan;0;0
12962;3435;675;62;30;3;27;.900;4020000;0
12962;11500;5004;68;37;3;34;.919;4020000;0
12962;46318;5004;0;0;0;0;.00nan;0;0
12962;149969;675;0;0;0;0;.00nan;0;0
12963;38277;476;77;38;4;34;.895;3600000;0
12963;-1;480;52;42;5;37;.881;3562000;0
12963;66551;480;0;0;0;0;.00nan;0;0
12963;86343;476;0;0;0;0;.00nan;0;0
12964;147;482;68;19;1;18;.947;3600000;0
12964;55864;474;51;55;8;47;.855;3600000;0
12964;66491;474;0;0;0;0;.00nan;0;0
12964;67222;482;0;0;0;0;.00nan;0;0
12965;1072;481;0;0;0;0;.00nan;0;0
12965;53870;490;0;0;0;0;.00nan;0;0
12965;56296;481;66;21;2;19;.905;3600000;0
12965;71297;490;97;53;3;50;.943;3600000;0
12966;168021;473;61;28;3;25;.893;3600000;0
12966;43158;676;0;0;0;0;.00nan;0;0
12966;46139;473;0;0;0;0;.00nan;0;0
12966;85797;676;83;31;1;30;.968;3600000;0
12967;163528;682;61;16;3;13;.813;3600000;0
12967;193870;4535;52;4;0;4;1.000;604000;0
12967;12048;4535;50;42;6;36;.857;2996000;0
12967;18169;682;0;0;0;0;.00nan;0;0
12968;168021;473;59;11;1;10;.909;3600000;0
12968;46139;473;0;0;0;0;.00nan;0;0
12968;55864;474;0;0;0;0;.00nan;0;0
12968;66491;474;97;45;2;43;.956;3600000;0
12969;43158;676;0;0;0;0;.00nan;0;0
12969;53870;490;77;62;7;55;.887;3600000;0
12969;71297;490;0;0;0;0;.00nan;0;0
12969;85797;676;84;23;1;22;.957;3600000;0
12970;147;482;69;32;3;29;.906;3869000;0
12970;38277;476;0;0;0;0;.00nan;0;0
12970;67222;482;0;0;0;0;.00nan;0;0
12970;86343;476;71;42;4;38;.905;3869000;0
12971;1072;481;68;31;3;28;.903;3513000;0
12971;3435;675;0;0;0;0;.00nan;0;0
12971;56296;481;0;0;0;0;.00nan;0;0
12971;149969;675;73;20;1;19;.950;3600000;0
12972;166878;472;50;32;4;28;.875;4020000;0
12972;193041;472;0;0;0;0;.00nan;0;0
12972;-1;480;46;22;4;18;.818;4020000;0
12972;66551;480;0;0;0;0;.00nan;0;0
12973;193870;4535;0;0;0;0;.00nan;0;0
12973;11500;5004;87;27;1;26;.963;3600000;0
12973;12048;4535;54;31;4;27;.871;3600000;0
12973;46318;5004;0;0;0;0;.00nan;0;0
12974;147;482;25;6;3;3;.500;447000;0
12974;3435;675;73;32;3;29;.906;3600000;0
12974;67222;482;83;32;2;30;.938;3128000;0
12974;149969;675;0;0;0;0;.00nan;0;0
12975;1072;481;94;22;0;22;1.000;3600000;0
12975;11500;5004;47;34;5;29;.853;3600000;0
12975;46318;5004;0;0;0;0;.00nan;0;0
12975;56296;481;0;0;0;0;.00nan;0;0
12976;193870;4535;0;0;0;0;.00nan;0;0
12976;12048;4535;80;44;4;40;.909;3600000;0
12976;43158;676;0;0;0;0;.00nan;0;0
12976;85797;676;81;13;0;13;1.000;3600000;0
12977;163528;682;42;20;3;17;.850;3517000;0
12977;18169;682;0;0;0;0;.00nan;0;0
12977;55864;474;0;0;0;0;.00nan;0;0
12977;66491;474;100;49;1;48;.980;3600000;0
12978;166878;472;51;24;3;21;.875;4020000;0
12978;193041;472;0;0;0;0;.00nan;0;0
12978;38277;476;100;45;3;42;.933;4020000;0
12978;86343;476;0;0;0;0;.00nan;0;0
12979;168021;473;65;16;1;15;.938;3600000;0
12979;46139;473;0;0;0;0;.00nan;0;0
12979;53870;490;78;18;0;18;1.000;1462000;0
12979;71297;490;28;29;6;23;.793;2138000;0
12980;43158;676;0;0;0;0;.00nan;0;0
12980;55864;474;98;58;3;55;.948;3600000;0
12980;66491;474;0;0;0;0;.00nan;0;0
12980;85797;676;47;13;2;11;.846;3600000;0
12981;163528;682;35;10;3;7;.700;3600000;0
12981;18169;682;0;0;0;0;.00nan;0;0
12981;53870;490;82;56;5;51;.911;3600000;0
12981;71297;490;0;0;0;0;.00nan;0;0
12982;3435;675;82;27;1;26;.963;3600000;0
12982;193870;4535;30;8;3;5;.625;1064000;0
12982;12048;4535;21;23;6;17;.739;2536000;0
12982;149969;675;0;0;0;0;.00nan;0;0
12983;11500;5004;56;45;6;39;.867;3600000;0
12983;-1;480;46;20;3;17;.850;3600000;0
12983;46318;5004;0;0;0;0;.00nan;0;0
12983;66551;480;0;0;0;0;.00nan;0;0
12984;147;482;83;36;2;34;.944;3550000;0
12984;166878;472;0;0;0;0;.00nan;0;0
12984;193041;472;91;27;0;27;1.000;3600000;0
12984;67222;482;0;0;0;0;.00nan;0;0
12985;1072;481;68;32;3;29;.906;3576000;0
12985;168021;473;83;25;1;24;.960;3600000;0
12985;46139;473;0;0;0;0;.00nan;0;0
12985;56296;481;0;0;0;0;.00nan;0;0
12986;38277;476;61;21;2;19;.905;3600000;0
12986;53870;490;43;23;4;19;.826;1112000;0
12986;71297;490;81;48;3;45;.938;2488000;0
12986;86343;476;0;0;0;0;.00nan;0;0
12987;1072;481;89;19;0;19;1.000;3600000;0
12987;55864;474;32;26;5;21;.808;2291000;0
12987;56296;481;0;0;0;0;.00nan;0;0
12987;66491;474;76;22;1;21;.955;1309000;0
12988;-1;480;78;40;4;36;.900;3600000;0
12988;43158;676;38;27;5;22;.815;3600000;0
12988;66551;480;0;0;0;0;.00nan;0;0
12988;85797;676;0;0;0;0;.00nan;0;0
12989;147;482;55;31;4;27;.871;3561000;0
12989;163528;682;0;0;0;0;.00nan;0;0
12989;18169;682;64;26;2;24;.923;3600000;0
12989;67222;482;0;0;0;0;.00nan;0;0
12990;166878;472;0;0;0;0;.00nan;0;0
12990;193041;472;74;24;1;23;.958;3600000;0
12990;193870;4535;50;38;5;33;.868;3600000;0
12990;12048;4535;0;0;0;0;.00nan;0;0
12991;3435;675;0;0;0;0;.00nan;0;0
12991;168021;473;100;30;0;30;1.000;3600000;0
12991;46139;473;0;0;0;0;.00nan;0;0
12991;149969;675;59;31;4;27;.871;3600000;0
12992;11500;5004;96;17;0;17;1.000;3600000;0
12992;46318;5004;0;0;0;0;.00nan;0;0
12992;55864;474;86;34;2;32;.941;3566000;0
12992;66491;474;0;0;0;0;.00nan;0;0
12993;1072;481;100;39;0;39;1.000;3600000;0
12993;38277;476;77;22;1;21;.955;3549000;0
12993;56296;481;0;0;0;0;.00nan;0;0
12993;86343;476;0;0;0;0;.00nan;0;0
12994;3435;675;74;34;3;31;.912;3600000;0
12994;43158;676;0;0;0;0;.00nan;0;0
12994;85797;676;71;17;1;16;.941;3600000;0
12994;149969;675;0;0;0;0;.00nan;0;0
12995;147;482;63;18;1;17;.944;3600000;0
12995;193870;4535;65;31;3;28;.903;1949000;0
12995;12048;4535;33;29;6;23;.793;1651000;0
12995;67222;482;0;0;0;0;.00nan;0;0
12996;168021;473;53;25;3;22;.880;3600000;0
12996;-1;480;71;37;4;33;.892;3562000;0
12996;46139;473;0;0;0;0;.00nan;0;0
12996;66551;480;0;0;0;0;.00nan;0;0
12997;166878;472;81;23;1;22;.957;3600000;0
12997;193041;472;0;0;0;0;.00nan;0;0
12997;163528;682;72;42;3;39;.929;3596000;0
12997;18169;682;0;0;0;0;.00nan;0;0
12998;163528;682;0;0;0;0;.00nan;0;0
12998;18169;682;82;27;1;26;.963;4020000;0
12998;38277;476;0;0;0;0;.00nan;0;0
12998;86343;476;95;51;1;50;.980;4020000;0
12999;166878;472;63;35;4;31;.886;3600000;0
12999;193041;472;0;0;0;0;.00nan;0;0
12999;43158;676;0;0;0;0;.00nan;0;0
12999;85797;676;69;29;3;26;.897;3600000;0
13000;193870;4535;0;0;0;0;.00nan;0;0
13000;12048;4535;70;41;4;37;.902;3555000;0
13000;168021;473;42;14;3;11;.786;3600000;0
13000;46139;473;0;0;0;0;.00nan;0;0
13001;3435;675;76;24;1;23;.958;3600000;0
13001;11500;5004;35;37;7;30;.811;3206000;0
13001;46318;5004;45;5;1;4;.800;394000;0
13001;149969;675;0;0;0;0;.00nan;0;0
13002;147;482;50;5;1;4;.800;3600000;0
13002;53870;490;0;0;0;0;.00nan;0;0
13002;67222;482;0;0;0;0;.00nan;0;0
13002;71297;490;92;64;6;58;.906;3600000;0
13003;1072;481;27;8;3;5;.625;523000;0
13003;-1;480;93;19;0;19;1.000;3600000;0
13003;56296;481;60;34;4;30;.882;3077000;0
13003;66551;480;0;0;0;0;.00nan;0;0
13004;147;482;58;17;2;15;.882;3600000;0
13004;55864;474;0;0;0;0;.00nan;0;0
13004;66491;474;98;58;3;55;.948;3588000;0
13004;67222;482;0;0;0;0;.00nan;0;0
13005;38277;476;73;20;2;18;.900;3600000;0
13005;53870;490;0;0;0;0;.00nan;0;0
13005;71297;490;81;33;3;30;.909;3596000;0
13005;86343;476;0;0;0;0;.00nan;0;0
13006;3435;675;96;36;2;34;.944;4020000;0
13006;-1;480;69;27;2;25;.926;4020000;0
13006;66551;480;0;0;0;0;.00nan;0;0
13006;149969;675;0;0;0;0;.00nan;0;0
13007;1072;481;99;49;1;48;.980;3975000;0
13007;56296;481;0;0;0;0;.00nan;0;0
13007;64230;676;58;18;2;16;.889;3975000;0
13007;85797;676;0;0;0;0;.00nan;0;0
13008;163528;682;53;12;2;10;.833;3600000;0
13008;12048;4535;98;49;3;46;.939;3549000;0
13008;18169;682;0;0;0;0;.00nan;0;0
13008;20958;4535;0;0;0;0;.00nan;0;0
13009;166878;472;28;8;3;5;.625;483000;0
13009;193041;472;52;34;5;29;.853;3117000;0
13009;168021;473;58;33;4;29;.879;3600000;0
13009;46139;473;0;0;0;0;.00nan;0;0
13010;38277;476;0;0;0;0;.00nan;0;0
13010;55864;474;59;40;5;35;.875;3600000;0
13010;66491;474;0;0;0;0;.00nan;0;0
13010;86343;476;59;26;2;24;.923;3600000;0
13011;1072;481;0;0;0;0;.00nan;0;0
13011;53870;490;35;22;4;18;.818;838000;0
13011;56296;481;65;14;1;13;.929;3600000;0
13011;71297;490;77;45;4;41;.911;2762000;0
13012;166878;472;36;28;5;23;.821;3600000;0
13012;193041;472;0;0;0;0;.00nan;0;0
13012;163528;682;0;0;0;0;.00nan;0;0
13012;18169;682;66;22;2;20;.909;3600000;0
13013;147;482;82;36;3;33;.917;3525000;0
13013;3435;675;0;0;0;0;.00nan;0;0
13013;67222;482;0;0;0;0;.00nan;0;0
13013;149969;675;99;43;1;42;.977;3600000;0
13014;11500;5004;92;49;4;45;.918;3600000;0
13014;46318;5004;0;0;0;0;.00nan;0;0
13014;64230;676;0;0;0;0;.00nan;0;0
13014;85797;676;92;19;0;19;1.000;3600000;0
13015;168021;473;90;36;2;34;.944;3600000;0
13015;-1;480;40;23;4;19;.826;3563000;0
13015;46139;473;0;0;0;0;.00nan;0;0
13015;66551;480;0;0;0;0;.00nan;0;0
13016;1072;481;74;37;3;34;.919;4020000;0
13016;11500;5004;0;0;0;0;.00nan;0;0
13016;46318;5004;50;26;3;23;.885;4020000;0
13016;56296;481;0;0;0;0;.00nan;0;0
13017;12048;4535;95;31;1;30;.968;3600000;0
13017;20958;4535;0;0;0;0;.00nan;0;0
13017;38277;476;51;26;4;22;.846;3600000;0
13017;86343;476;0;0;0;0;.00nan;0;0
13018;147;482;0;0;0;0;.00nan;0;0
13018;163528;682;66;31;3;28;.903;3579000;0
13018;18169;682;0;0;0;0;.00nan;0;0
13018;67222;482;95;36;1;35;.972;3600000;0
13019;-1;480;79;38;3;35;.921;4020000;0
13019;55864;474;0;0;0;0;.00nan;0;0
13019;66491;474;85;45;3;42;.933;4020000;0
13019;66551;480;0;0;0;0;.00nan;0;0
13020;53870;490;42;37;6;31;.838;1926000;0
13020;64230;676;0;0;0;0;.00nan;0;0
13020;71297;490;77;24;1;23;.958;1674000;0
13020;85797;676;64;22;2;20;.909;3600000;0
13021;166878;472;100;41;1;40;.976;3823000;0
13021;3435;675;73;29;2;27;.931;3823000;0
13021;193041;472;0;0;0;0;.00nan;0;0
13021;149969;675;0;0;0;0;.00nan;0;0
13022;166878;472;38;21;3;18;.857;3543000;0
13022;193041;472;0;0;0;0;.00nan;0;0
13022;55864;474;100;41;1;40;.976;3600000;0
13022;66491;474;0;0;0;0;.00nan;0;0
13023;147;482;82;36;2;34;.944;4020000;0
13023;168021;473;70;27;2;25;.926;4020000;0
13023;46139;473;0;0;0;0;.00nan;0;0
13023;67222;482;0;0;0;0;.00nan;0;0
13024;-1;480;87;48;4;44;.917;3600000;0
13024;64230;676;0;0;0;0;.00nan;0;0
13024;66551;480;0;0;0;0;.00nan;0;0
13024;85797;676;32;26;5;21;.808;3553000;0
13025;163528;682;75;21;1;20;.952;3600000;0
13025;11500;5004;88;40;3;37;.925;3569000;0
13025;18169;682;0;0;0;0;.00nan;0;0
13025;46318;5004;0;0;0;0;.00nan;0;0
13026;3435;675;100;21;0;21;1.000;3600000;0
13026;12048;4535;91;47;3;44;.936;3600000;0
13026;20958;4535;0;0;0;0;.00nan;0;0
13026;149969;675;0;0;0;0;.00nan;0;0
13027;166878;472;68;14;1;13;.929;3600000;0
13027;193041;472;0;0;0;0;.00nan;0;0
13027;53870;490;46;7;1;6;.857;473000;0
13027;71297;490;73;69;6;63;.913;3127000;0
13028;3435;675;90;44;3;41;.932;3600000;0
13028;168021;473;42;22;4;18;.818;3559000;0
13028;46139;473;0;0;0;0;.00nan;0;0
13028;149969;675;0;0;0;0;.00nan;0;0
13029;147;482;40;26;4;22;.846;3600000;0
13029;64230;676;56;27;3;24;.889;3600000;0
13029;67222;482;0;0;0;0;.00nan;0;0
13029;85797;676;0;0;0;0;.00nan;0;0
13030;163528;682;58;18;2;16;.889;3600000;0
13030;18169;682;0;0;0;0;.00nan;0;0
13030;55864;474;0;0;0;0;.00nan;0;0
13030;66491;474;79;60;6;54;.900;3600000;0
13031;11500;5004;75;46;4;42;.913;3600000;0
13031;-1;480;52;16;3;13;.813;3600000;0
13031;46318;5004;0;0;0;0;.00nan;0;0
13031;66551;480;0;0;0;0;.00nan;0;0
13032;1072;481;82;27;1;26;.963;3600000;0
13032;12048;4535;100;28;0;28;1.000;3600000;0
13032;20958;4535;0;0;0;0;.00nan;0;0
13032;56296;481;0;0;0;0;.00nan;0;0
13033;1072;481;34;35;6;29;.829;3236000;0
13033;38277;476;80;31;2;29;.935;3600000;0
13033;56296;481;46;5;1;4;.800;364000;0
13033;86343;476;0;0;0;0;.00nan;0;0
13034;11500;5004;99;24;0;24;1.000;3600000;0
13034;46318;5004;0;0;0;0;.00nan;0;0
13034;53870;490;93;45;3;42;.933;3600000;0
13034;71297;490;0;0;0;0;.00nan;0;0
13035;166878;472;39;31;5;26;.839;3600000;0
13035;193041;472;0;0;0;0;.00nan;0;0
13035;38277;476;97;36;1;35;.972;3600000;0
13035;86343;476;0;0;0;0;.00nan;0;0
13036;1072;481;80;16;0;16;1.000;3600000;0
13036;3435;675;38;27;5;22;.815;3600000;0
13036;56296;481;0;0;0;0;.00nan;0;0
13036;149969;675;0;0;0;0;.00nan;0;0
13037;163528;682;75;36;3;33;.917;3600000;0
13037;18169;682;0;0;0;0;.00nan;0;0
13037;-1;480;44;23;4;19;.826;3569000;0
13037;66551;480;0;0;0;0;.00nan;0;0
13038;147;482;49;20;3;17;.850;3600000;0
13038;12048;4535;39;36;6;30;.833;2805000;0
13038;20958;4535;37;9;2;7;.778;795000;0
13038;67222;482;0;0;0;0;.00nan;0;0
13039;168021;473;0;0;0;0;.00nan;0;0
13039;46139;473;69;15;1;14;.933;3600000;0
13039;55864;474;63;22;2;20;.909;2541000;0
13039;66491;474;30;17;4;13;.765;1059000;0
13040;1072;481;75;27;2;25;.926;3600000;0
13040;55864;474;73;43;5;38;.884;3600000;0
13040;56296;481;0;0;0;0;.00nan;0;0
13040;66491;474;0;0;0;0;.00nan;0;0
13041;168021;473;68;6;0;6;1.000;3600000;0
13041;46139;473;0;0;0;0;.00nan;0;0
13041;53870;490;0;0;0;0;.00nan;0;0
13041;71297;490;97;72;5;67;.931;3600000;0
13042;12048;4535;77;43;3;40;.930;3582000;0
13042;20958;4535;0;0;0;0;.00nan;0;0
13042;-1;480;0;0;0;0;.00nan;0;0
13042;66551;480;82;28;1;27;.964;3600000;0
13043;163528;682;88;32;2;30;.938;3600000;0
13043;18169;682;0;0;0;0;.00nan;0;0
13043;64230;676;0;0;0;0;.00nan;0;0
13043;85797;676;70;19;1;18;.947;3600000;0
13044;166878;472;0;0;0;0;.00nan;0;0
13044;193041;472;59;19;2;17;.895;3600000;0
13044;11500;5004;80;48;4;44;.917;3600000;0
13044;46318;5004;0;0;0;0;.00nan;0;0
13045;12048;4535;83;32;2;30;.938;3600000;0
13045;20958;4535;0;0;0;0;.00nan;0;0
13045;55864;474;0;0;0;0;.00nan;0;0
13045;66491;474;66;35;3;32;.914;3564000;0
13046;11500;5004;56;44;6;38;.864;3228000;0
13046;168021;473;48;26;4;22;.846;3600000;0
13046;46139;473;0;0;0;0;.00nan;0;0
13046;46318;5004;59;8;0;8;1.000;348000;0
13047;147;482;91;30;1;29;.967;3600000;0
13047;166878;472;77;23;2;21;.913;3575000;0
13047;193041;472;0;0;0;0;.00nan;0;0
13047;67222;482;0;0;0;0;.00nan;0;0
13048;38277;476;94;48;2;46;.958;4020000;0
13048;-1;480;59;20;2;18;.900;4020000;0
13048;66551;480;0;0;0;0;.00nan;0;0
13048;86343;476;0;0;0;0;.00nan;0;0
13049;3435;675;73;33;3;30;.909;3600000;0
13049;64230;676;0;0;0;0;.00nan;0;0
13049;85797;676;92;19;0;19;1.000;3600000;0
13049;149969;675;0;0;0;0;.00nan;0;0
13050;163528;682;83;18;0;18;1.000;3600000;0
13050;18169;682;0;0;0;0;.00nan;0;0
13050;53870;490;93;53;3;50;.943;3600000;0
13050;71297;490;0;0;0;0;.00nan;0;0
13051;11500;5004;73;34;4;30;.882;3617000;0
13051;38277;476;77;32;3;29;.906;3617000;0
13051;46318;5004;0;0;0;0;.00nan;0;0
13051;86343;476;0;0;0;0;.00nan;0;0
13052;3435;675;52;15;2;13;.867;4020000;0
13052;55864;474;100;53;2;51;.962;4020000;0
13052;66491;474;0;0;0;0;.00nan;0;0
13052;149969;675;0;0;0;0;.00nan;0;0
13053;147;482;76;27;2;25;.926;4020000;0
13053;1072;481;88;32;2;30;.938;4020000;0
13053;56296;481;0;0;0;0;.00nan;0;0
13053;67222;482;0;0;0;0;.00nan;0;0
13054;166878;472;57;24;3;21;.875;3849000;0
13054;193041;472;0;0;0;0;.00nan;0;0
13054;-1;480;79;44;4;40;.909;3849000;0
13054;66551;480;0;0;0;0;.00nan;0;0
13055;12048;4535;56;23;4;19;.826;3639000;0
13055;20958;4535;0;0;0;0;.00nan;0;0
13055;53870;490;0;0;0;0;.00nan;0;0
13055;71297;490;79;51;5;46;.902;3639000;0
13056;168021;473;56;25;3;22;.880;3546000;0
13056;46139;473;0;0;0;0;.00nan;0;0
13056;64230;676;0;0;0;0;.00nan;0;0
13056;85797;676;99;37;1;36;.973;3600000;0
13057;11500;5004;55;43;5;38;.884;3600000;0
13057;12048;4535;87;34;2;32;.941;3600000;0
13057;20958;4535;0;0;0;0;.00nan;0;0
13057;46318;5004;0;0;0;0;.00nan;0;0
13058;53870;490;100;38;0;38;1.000;3600000;0
13058;55864;474;0;0;0;0;.00nan;0;0
13058;66491;474;85;31;2;29;.935;3524000;0
13058;71297;490;0;0;0;0;.00nan;0;0
13059;147;482;94;40;2;38;.950;4020000;0
13059;-1;480;76;26;2;24;.923;4020000;0
13059;66551;480;0;0;0;0;.00nan;0;0
13059;67222;482;0;0;0;0;.00nan;0;0
13060;1072;481;68;32;2;30;.938;4020000;0
13060;168021;473;73;23;2;21;.913;4020000;0
13060;46139;473;0;0;0;0;.00nan;0;0
13060;56296;481;0;0;0;0;.00nan;0;0
13061;38277;476;100;47;0;47;1.000;3600000;0
13061;64230;676;0;0;0;0;.00nan;0;0
13061;85797;676;97;31;1;30;.968;3549000;0
13061;86343;476;0;0;0;0;.00nan;0;0
13062;3435;675;100;44;2;42;.955;3600000;0
13062;163528;682;56;20;3;17;.850;3600000;0
13062;18169;682;0;0;0;0;.00nan;0;0
13062;149969;675;0;0;0;0;.00nan;0;0
13063;11500;5004;57;24;3;21;.875;3600000;0
13063;46318;5004;0;0;0;0;.00nan;0;0
13063;55864;474;77;25;1;24;.960;3029000;0
13063;66491;474;29;8;3;5;.625;525000;0
13064;3435;675;91;17;0;17;1.000;3600000;0
13064;53870;490;97;77;6;71;.922;3600000;0
13064;71297;490;0;0;0;0;.00nan;0;0
13064;149969;675;0;0;0;0;.00nan;0;0
13065;147;482;46;16;3;13;.813;3600000;0
13065;38277;476;50;37;6;31;.838;2708000;0
13065;67222;482;0;0;0;0;.00nan;0;0
13065;86343;476;37;7;2;5;.714;892000;0
13066;1072;481;0;0;0;0;.00nan;0;0
13066;166878;472;100;41;3;38;.927;3863000;0
13066;193041;472;0;0;0;0;.00nan;0;0
13066;56296;481;86;46;4;42;.913;3863000;0
13067;12048;4535;0;0;0;0;.00nan;0;0
13067;20958;4535;91;55;4;51;.927;3600000;0
13067;64230;676;0;0;0;0;.00nan;0;0
13067;85797;676;59;19;2;17;.895;3600000;0
13068;163528;682;93;41;2;39;.951;3577000;0
13068;168021;473;68;18;1;17;.944;3600000;0
13068;18169;682;0;0;0;0;.00nan;0;0
13068;46139;473;0;0;0;0;.00nan;0;0
13069;147;482;99;35;1;34;.971;3600000;0
13069;11500;5004;0;0;0;0;.00nan;0;0
13069;46318;5004;68;31;3;28;.903;3591000;0
13069;67222;482;0;0;0;0;.00nan;0;0
13070;-1;480;79;20;1;19;.950;3600000;0
13070;53870;490;0;0;0;0;.00nan;0;0
13070;66551;480;0;0;0;0;.00nan;0;0
13070;71297;490;97;55;3;52;.945;3561000;0
13071;3435;675;30;26;6;20;.769;2860000;0
13071;38277;476;46;27;5;22;.815;3600000;0
13071;86343;476;0;0;0;0;.00nan;0;0
13071;149969;675;53;3;0;3;1.000;738000;0
13072;55864;474;0;0;0;0;.00nan;0;0
13072;64230;676;0;0;0;0;.00nan;0;0
13072;66491;474;85;55;5;50;.909;3600000;0
13072;85797;676;92;19;0;19;1.000;3600000;0
13073;1072;481;59;34;4;30;.882;3600000;0
13073;163528;682;86;29;2;27;.931;3600000;0
13073;18169;682;0;0;0;0;.00nan;0;0
13073;56296;481;0;0;0;0;.00nan;0;0
13074;166878;472;0;0;0;0;.00nan;0;0
13074;193041;472;70;7;0;7;1.000;3600000;0
13074;12048;4535;76;50;5;45;.900;3600000;0
13074;20958;4535;0;0;0;0;.00nan;0;0
13076;1072;481;34;19;5;14;.737;4020000;0
13076;166878;472;38;36;5;31;.861;4020000;0
13076;193041;472;0;0;0;0;.00nan;0;0
13076;56296;481;0;0;0;0;.00nan;0;0
13078;163528;682;49;17;2;15;.882;3525000;0
13078;11500;5004;100;36;0;36;1.000;3600000;0
13078;18169;682;0;0;0;0;.00nan;0;0
13078;46318;5004;0;0;0;0;.00nan;0;0
13080;3435;675;0;0;0;0;.00nan;0;0
13080;55864;474;0;0;0;0;.00nan;0;0
13080;66491;474;92;41;2;39;.951;3956000;0
13080;149969;675;57;11;1;10;.909;3956000;0
13086;193870;4535;0;0;0;0;.00nan;0;0
13086;12048;4535;83;39;3;36;.923;3600000;0
13086;-1;480;100;26;0;26;1.000;3600000;0
13086;66551;480;0;0;0;0;.00nan;0;0
13088;1072;481;0;0;0;0;.00nan;0;0
13088;53870;490;63;47;6;41;.872;2633000;0
13088;56296;481;87;17;0;17;1.000;3600000;0
13088;71297;490;19;22;6;16;.727;967000;0
13090;166878;472;0;0;0;0;.00nan;0;0
13090;193041;472;93;33;1;32;.970;3600000;0
13090;193870;4535;0;0;0;0;.00nan;0;0
13090;12048;4535;91;55;4;51;.927;3600000;0
13096;38277;476;0;0;0;0;.00nan;0;0
13096;55864;474;86;51;4;47;.922;3600000;0
13096;66491;474;0;0;0;0;.00nan;0;0
13096;86343;476;40;15;3;12;.800;3600000;0
13100;193870;4535;84;23;1;22;.957;3600000;0
13100;12048;4535;0;0;0;0;.00nan;0;0
13100;53870;490;0;0;0;0;.00nan;0;0
13100;71297;490;76;53;5;48;.906;3600000;0
13102;-1;480;39;21;4;17;.810;3966000;0
13102;55864;474;0;0;0;0;.00nan;0;0
13102;66491;474;63;50;5;45;.900;3966000;0
13102;66551;480;0;0;0;0;.00nan;0;0
13108;1072;481;0;0;0;0;.00nan;0;0
13108;163528;682;97;23;0;23;1.000;3600000;0
13108;18169;682;0;0;0;0;.00nan;0;0
13108;56296;481;63;37;4;33;.892;3600000;0
13110;3435;675;65;13;1;12;.923;3600000;0
13110;11500;5004;73;44;3;41;.932;3576000;0
13110;46318;5004;0;0;0;0;.00nan;0;0
13110;149969;675;0;0;0;0;.00nan;0;0
13118;3435;675;82;25;1;24;.960;3600000;0
13118;-1;480;36;26;5;21;.808;3600000;0
13118;66551;480;0;0;0;0;.00nan;0;0
13118;149969;675;0;0;0;0;.00nan;0;0
13120;38277;476;98;22;0;22;1.000;3600000;0
13120;53870;490;0;0;0;0;.00nan;0;0
13120;71297;490;96;48;1;47;.979;3547000;0
13120;86343;476;0;0;0;0;.00nan;0;0
13122;1072;481;0;0;0;0;.00nan;0;0
13122;11500;5004;49;19;3;16;.842;3600000;0
13122;46318;5004;0;0;0;0;.00nan;0;0
13122;56296;481;43;45;7;38;.844;3600000;0
13124;1072;481;87;31;1;30;.968;3600000;0
13124;163528;682;76;33;3;30;.909;3529000;0
13124;18169;682;0;0;0;0;.00nan;0;0
13124;56296;481;0;0;0;0;.00nan;0;0
13130;11500;5004;0;0;0;0;.00nan;0;0
13130;46318;5004;62;18;2;16;.889;3600000;0
13130;53870;490;41;28;4;24;.857;1182000;0
13130;71297;490;60;30;3;27;.900;2418000;0
13132;193870;4535;0;0;0;0;.00nan;0;0
13132;12048;4535;99;45;2;43;.956;3743000;0
13132;38277;476;71;29;3;26;.897;3743000;0
13132;86343;476;0;0;0;0;.00nan;0;0
13140;3435;675;67;18;1;17;.944;3600000;0
13140;55864;474;0;0;0;0;.00nan;0;0
13140;66491;474;92;56;5;51;.911;3600000;0
13140;149969;675;0;0;0;0;.00nan;0;0
13142;-1;480;54;10;1;9;.900;3600000;0
13142;53870;490;67;31;3;28;.903;1548000;0
13142;66551;480;0;0;0;0;.00nan;0;0
13142;71297;490;62;49;6;43;.878;2052000;0
13144;166878;472;50;22;3;19;.864;3600000;0
13144;193041;472;0;0;0;0;.00nan;0;0
13144;11500;5004;83;59;5;54;.915;3600000;0
13144;46318;5004;0;0;0;0;.00nan;0;0
13148;11500;5004;0;0;0;0;.00nan;0;0
13148;-1;480;0;0;0;0;.00nan;0;0
13148;46318;5004;62;41;4;37;.902;3600000;0
13148;66551;480;89;16;0;16;1.000;3600000;0
13150;3435;675;0;0;0;0;.00nan;0;0
13150;53870;490;63;35;3;32;.914;1708000;0
13150;71297;490;38;28;5;23;.821;1892000;0
13150;149969;675;36;13;3;10;.769;3600000;0
13158;166878;472;0;0;0;0;.00nan;0;0
13158;193041;472;79;14;0;14;1.000;3600000;0
13158;55864;474;40;41;6;35;.854;3235000;0
13158;66491;474;57;5;0;5;1.000;365000;0
20049;11500;5004;80;30;2;28;.933;3600000;0
20049;38277;476;26;20;5;15;.750;3600000;0
20049;46318;5004;0;0;0;0;.00nan;0;0
20049;86343;476;0;0;0;0;.00nan;0;0
20050;1072;481;94;26;1;25;.962;3600000;0
20050;3435;675;77;25;2;23;.920;3554000;0
20050;56296;481;0;0;0;0;.00nan;0;0
20050;149969;675;0;0;0;0;.00nan;0;0
20051;11500;5004;80;30;2;28;.933;3600000;0
20051;38277;476;69;37;4;33;.892;3570000;0
20051;46318;5004;0;0;0;0;.00nan;0;0
20051;86343;476;0;0;0;0;.00nan;0;0
20052;1072;481;56;43;5;38;.884;3600000;0
20052;3435;675;49;21;3;18;.857;3600000;0
20052;56296;481;0;0;0;0;.00nan;0;0
20052;149969;675;0;0;0;0;.00nan;0;0
20109;1072;481;93;42;2;40;.952;3600000;0
20109;3435;675;55;19;3;16;.842;3594000;0
20109;56296;481;0;0;0;0;.00nan;0;0
20109;149969;675;0;0;0;0;.00nan;0;0
0;11500;5004;64;43;5;38;.884;3583000;0
0;168021;473;39;13;3;10;.769;3600000;0
0;46139;473;0;0;0;0;.00nan;0;0
0;46318;5004;0;0;0;0;.00nan;0;0
1;147;482;60;32;3;29;.906;3600000;0
1;1072;481;78;45;5;40;.889;3568000;0
1;56296;481;0;0;0;0;.00nan;0;0
1;67222;482;0;0;0;0;.00nan;0;0
2;163528;682;70;25;3;22;.880;3554000;0
2;18169;682;0;0;0;0;.00nan;0;0
2;64230;676;0;0;0;0;.00nan;0;0
2;85797;676;92;28;1;27;.964;3600000;0
3;166878;472;36;20;4;16;.800;3546000;0
3;193041;472;0;0;0;0;.00nan;0;0
3;-1;480;62;32;3;29;.906;3600000;0
3;66551;480;0;0;0;0;.00nan;0;0
4;11500;5004;49;36;5;31;.861;3542000;0
4;168021;473;53;22;3;19;.864;3600000;0
4;46139;473;0;0;0;0;.00nan;0;0
4;46318;5004;0;0;0;0;.00nan;0;0
5;147;482;58;26;3;23;.885;3600000;0
5;1072;481;57;40;5;35;.875;3529000;0
5;56296;481;0;0;0;0;.00nan;0;0
5;67222;482;0;0;0;0;.00nan;0;0
6;163528;682;100;29;0;29;1.000;3600000;0
6;18169;682;0;0;0;0;.00nan;0;0
6;64230;676;47;9;2;7;.778;872000;0
6;85797;676;20;24;6;18;.750;2728000;0
7;166878;472;36;24;5;19;.792;3600000;0
7;193041;472;0;0;0;0;.00nan;0;0
7;-1;480;90;38;1;37;.974;3600000;0
7;66551;480;0;0;0;0;.00nan;0;0
8;11500;5004;92;54;4;50;.926;4001000;0
8;168021;473;41;15;3;12;.800;3990000;0
8;46139;473;0;0;0;0;.00nan;0;0
8;46318;5004;0;0;0;0;.00nan;0;0
9;147;482;55;20;3;17;.850;3545000;0
9;1072;481;80;35;2;33;.943;3600000;0
9;56296;481;0;0;0;0;.00nan;0;0
9;67222;482;0;0;0;0;.00nan;0;0
10;163528;682;72;27;2;25;.926;3600000;0
10;18169;682;0;0;0;0;.00nan;0;0
10;64230;676;0;0;0;0;.00nan;0;0
10;85797;676;81;43;4;39;.907;3523000;0
11;166878;472;42;22;4;18;.818;2196000;0
11;193041;472;46;13;2;11;.846;1347000;0
11;-1;480;82;44;5;39;.886;3600000;0
11;66551;480;0;0;0;0;.00nan;0;0
12;11500;5004;45;42;6;36;.857;3600000;0
12;168021;473;70;25;2;23;.920;3600000;0
12;46139;473;0;0;0;0;.00nan;0;0
12;46318;5004;0;0;0;0;.00nan;0;0
13;147;482;77;24;2;22;.917;3600000;0
13;1072;481;50;35;5;30;.857;3600000;0
13;56296;481;0;0;0;0;.00nan;0;0
13;67222;482;0;0;0;0;.00nan;0;0
14;163528;682;64;24;2;22;.917;3550000;0
14;18169;682;0;0;0;0;.00nan;0;0
14;64230;676;0;0;0;0;.00nan;0;0
14;85797;676;97;31;1;30;.968;3600000;0
15;166878;472;97;24;0;24;1.000;3600000;0
15;193041;472;0;0;0;0;.00nan;0;0
15;-1;480;68;49;5;44;.898;3600000;0
15;66551;480;0;0;0;0;.00nan;0;0
207;147;482;75;27;2;25;.926;3600000;0
207;1072;481;65;29;3;26;.897;3549000;0
207;56296;481;0;0;0;0;.00nan;0;0
207;67222;482;0;0;0;0;.00nan;0;0
208;163528;682;60;24;3;21;.875;3600000;0
208;18169;682;0;0;0;0;.00nan;0;0
208;64230;676;17;23;6;17;.739;2603000;0
208;85797;676;27;12;4;8;.667;997000;0
209;166878;472;91;20;0;20;1.000;3600000;0
209;193041;472;0;0;0;0;.00nan;0;0
209;-1;480;49;34;5;29;.853;3600000;0
209;66551;480;0;0;0;0;.00nan;0;0
358;163528;682;52;31;4;27;.871;3600000;0
358;18169;682;0;0;0;0;.00nan;0;0
358;64230;676;0;0;0;0;.00nan;0;0
358;85797;676;59;22;3;19;.864;3600000;0
359;166878;472;69;26;2;24;.923;3600000;0
359;193041;472;0;0;0;0;.00nan;0;0
359;-1;480;51;31;5;26;.839;3600000;0
359;66551;480;0;0;0;0;.00nan;0;0
434;163528;682;67;16;1;15;.938;3799000;0
434;18169;682;0;0;0;0;.00nan;0;0
434;64230;676;0;0;0;0;.00nan;0;0
434;85797;676;100;31;0;31;1.000;3799000;0
435;166878;472;76;34;2;32;.941;3600000;0
435;193041;472;0;0;0;0;.00nan;0;0
435;-1;480;84;39;3;36;.923;3574000;0
435;66551;480;0;0;0;0;.00nan;0;0
519;168021;473;89;31;2;29;.935;3600000;0
519;46139;473;0;0;0;0;.00nan;0;0
519;64230;676;0;0;0;0;.00nan;0;0
519;85797;676;72;27;3;24;.889;3600000;0
520;147;482;76;26;2;24;.923;3600000;0
520;166878;472;99;33;1;32;.970;3600000;0
520;193041;472;0;0;0;0;.00nan;0;0
520;67222;482;0;0;0;0;.00nan;0;0
521;168021;473;67;37;4;33;.892;3573000;0
521;46139;473;0;0;0;0;.00nan;0;0
521;64230;676;0;0;0;0;.00nan;0;0
521;85797;676;90;42;3;39;.929;3600000;0
522;147;482;63;35;3;32;.914;3600000;0
522;166878;472;63;21;2;19;.905;3600000;0
522;193041;472;0;0;0;0;.00nan;0;0
522;67222;482;0;0;0;0;.00nan;0;0
523;168021;473;99;41;1;40;.976;3600000;0
523;46139;473;0;0;0;0;.00nan;0;0
523;64230;676;0;0;0;0;.00nan;0;0
523;85797;676;74;31;2;29;.935;3546000;0
524;147;482;75;43;4;39;.907;3596000;0
524;166878;472;56;26;3;23;.885;3600000;0
524;193041;472;0;0;0;0;.00nan;0;0
524;67222;482;0;0;0;0;.00nan;0;0
525;168021;473;71;29;2;27;.931;3600000;0
525;46139;473;0;0;0;0;.00nan;0;0
525;64230;676;0;0;0;0;.00nan;0;0
525;85797;676;43;24;4;20;.833;3573000;0
526;147;482;80;33;3;30;.909;3644000;0
526;166878;472;68;29;2;27;.931;3644000;0
526;193041;472;0;0;0;0;.00nan;0;0
526;67222;482;0;0;0;0;.00nan;0;0
684;168021;473;58;18;2;16;.889;3600000;0
684;46139;473;0;0;0;0;.00nan;0;0
684;64230;676;0;0;0;0;.00nan;0;0
684;85797;676;60;36;4;32;.889;3576000;0
704;166878;472;43;24;4;20;.833;3600000;0
704;193041;472;0;0;0;0;.00nan;0;0
704;168021;473;100;35;0;35;1.000;3600000;0
704;46139;473;0;0;0;0;.00nan;0;0
705;166878;472;94;17;0;17;1.000;3600000;0
705;193041;472;0;0;0;0;.00nan;0;0
705;168021;473;60;19;2;17;.895;3573000;0
705;46139;473;0;0;0;0;.00nan;0;0
706;166878;472;76;21;1;20;.952;3600000;0
706;193041;472;0;0;0;0;.00nan;0;0
706;168021;473;64;24;2;22;.917;3595000;0
706;46139;473;0;0;0;0;.00nan;0;0
707;166878;472;49;24;4;20;.833;3627000;0
707;193041;472;0;0;0;0;.00nan;0;0
707;168021;473;39;27;5;22;.815;3670000;0
707;46139;473;0;0;0;0;.00nan;0;0
961;166878;472;73;32;2;30;.938;3533000;0
961;193041;472;0;0;0;0;.00nan;0;0
961;168021;473;89;19;0;19;1.000;3600000;0
961;46139;473;0;0;0;0;.00nan;0;0
978;166878;472;49;18;3;15;.833;3740000;0
978;193041;472;0;0;0;0;.00nan;0;0
978;168021;473;73;39;4;35;.897;3740000;0
978;46139;473;0;0;0;0;.00nan;0;0
13159;177356;4636;0;0;0;0;.00nan;0;0
13159;197409;502;0;0;0;0;.00nan;0;0
13159;148503;4636;89;31;2;29;.935;3900000;0
13159;152624;502;95;39;2;37;.949;3900000;0
13160;1061;505;0;0;0;0;.00nan;0;0
13160;43730;505;56;47;6;41;.872;3600000;0
13160;49674;498;0;0;0;0;.00nan;0;0
13160;148691;498;41;33;5;28;.848;3600000;0
13161;6603;2591;72;22;1;21;.955;3600000;0
13161;174898;2591;0;0;0;0;.00nan;0;0
13161;-1;504;0;0;0;0;.00nan;0;0
13161;-1;504;67;43;5;38;.884;3600000;0
13162;167480;503;0;0;0;0;.00nan;0;0
13162;170536;503;96;22;0;22;1.000;3600000;0
13162;66271;495;98;34;2;32;.941;3547000;0
13162;148508;495;0;0;0;0;.00nan;0;0
13163;1756;500;64;34;4;30;.882;3566000;0
13163;187813;499;0;0;0;0;.00nan;0;0
13163;175593;499;77;29;2;27;.931;3600000;0
13163;63707;500;0;0;0;0;.00nan;0;0
13164;-1;497;0;0;0;0;.00nan;0;0
13164;81085;496;76;23;1;22;.957;3900000;0
13164;142810;497;81;29;1;28;.966;3900000;0
13164;148573;496;0;0;0;0;.00nan;0;0
13165;6603;2591;57;23;3;20;.870;3600000;0
13165;174898;2591;0;0;0;0;.00nan;0;0
13165;66271;495;0;0;0;0;.00nan;0;0
13165;148508;495;92;22;0;22;1.000;3600000;0
13166;1756;500;84;27;1;26;.963;3600000;0
13166;167480;503;0;0;0;0;.00nan;0;0
13166;170536;503;71;30;2;28;.933;3593000;0
13166;63707;500;0;0;0;0;.00nan;0;0
13167;187813;499;0;0;0;0;.00nan;0;0
13167;-1;497;0;0;0;0;.00nan;0;0
13167;175593;499;76;31;2;29;.935;3585000;0
13167;142810;497;99;37;1;36;.973;3600000;0
13168;49674;498;0;0;0;0;.00nan;0;0
13168;81085;496;68;25;2;23;.920;3600000;0
13168;148573;496;0;0;0;0;.00nan;0;0
13168;148691;498;62;27;3;24;.889;3600000;0
13169;177356;4636;0;0;0;0;.00nan;0;0
13169;-1;504;78;22;1;21;.955;3600000;0
13169;-1;504;0;0;0;0;.00nan;0;0
13169;148503;4636;49;35;5;30;.857;3600000;0
13170;1061;505;0;0;0;0;.00nan;0;0
13170;43730;505;30;24;5;19;.792;3650000;0
13170;197409;502;0;0;0;0;.00nan;0;0
13170;152624;502;45;24;4;20;.833;3650000;0
13171;6603;2591;27;13;4;9;.692;1006000;0
13171;174898;2591;50;24;3;21;.875;2594000;0
13171;66271;495;0;0;0;0;.00nan;0;0
13171;148508;495;54;21;3;18;.857;3600000;0
13172;1756;500;83;25;1;24;.960;3900000;0
13172;167480;503;0;0;0;0;.00nan;0;0
13172;170536;503;71;22;1;21;.955;3900000;0
13172;63707;500;0;0;0;0;.00nan;0;0
13173;187813;499;0;0;0;0;.00nan;0;0
13173;-1;497;0;0;0;0;.00nan;0;0
13173;175593;499;91;40;2;38;.950;3900000;0
13173;142810;497;61;25;2;23;.920;3900000;0
13174;49674;498;0;0;0;0;.00nan;0;0
13174;81085;496;0;0;0;0;.00nan;0;0
13174;148573;496;77;31;2;29;.935;3600000;0
13174;148691;498;38;22;4;18;.818;3567000;0
13175;177356;4636;0;0;0;0;.00nan;0;0
13175;-1;504;55;20;2;18;.900;3823000;0
13175;-1;504;0;0;0;0;.00nan;0;0
13175;148503;4636;74;38;3;35;.921;3823000;0
13176;1061;505;68;34;4;30;.882;3600000;0
13176;43730;505;0;0;0;0;.00nan;0;0
13176;197409;502;0;0;0;0;.00nan;0;0
13176;152624;502;44;32;6;26;.813;3559000;0
13177;1061;505;60;28;3;25;.893;3585000;0
13177;-1;504;0;0;0;0;.00nan;0;0
13177;-1;504;90;44;2;42;.955;3600000;0
13177;43730;505;0;0;0;0;.00nan;0;0
13178;197409;502;0;0;0;0;.00nan;0;0
13178;81085;496;62;33;4;29;.879;3571000;0
13178;148573;496;0;0;0;0;.00nan;0;0
13178;152624;502;48;20;3;17;.850;3600000;0
13179;177356;4636;0;0;0;0;.00nan;0;0
13179;6603;2591;0;0;0;0;.00nan;0;0
13179;174898;2591;33;24;5;19;.792;3516000;0
13179;148503;4636;68;31;3;28;.903;3600000;0
13180;167480;503;0;0;0;0;.00nan;0;0
13180;-1;497;0;0;0;0;.00nan;0;0
13180;170536;503;82;33;2;31;.939;3900000;0
13180;142810;497;70;24;2;22;.917;3900000;0
13181;1756;500;92;32;2;30;.938;3900000;0
13181;63707;500;0;0;0;0;.00nan;0;0
13181;66271;495;0;0;0;0;.00nan;0;0
13181;148508;495;82;26;2;24;.923;3900000;0
13182;187813;499;0;0;0;0;.00nan;0;0
13182;175593;499;82;44;4;40;.909;3900000;0
13182;49674;498;0;0;0;0;.00nan;0;0
13182;148691;498;41;26;4;22;.846;3900000;0
13183;1061;505;0;0;0;0;.00nan;0;0
13183;-1;504;71;37;4;33;.892;3582000;0
13183;-1;504;0;0;0;0;.00nan;0;0
13183;43730;505;75;36;3;33;.917;3600000;0
13184;197409;502;0;0;0;0;.00nan;0;0
13184;81085;496;86;36;2;34;.944;3600000;0
13184;148573;496;0;0;0;0;.00nan;0;0
13184;152624;502;84;25;1;24;.960;3600000;0
13185;177356;4636;0;0;0;0;.00nan;0;0
13185;6603;2591;0;0;0;0;.00nan;0;0
13185;174898;2591;51;21;3;18;.857;3600000;0
13185;148503;4636;65;19;2;17;.895;3600000;0
13186;167480;503;41;48;6;42;.875;3900000;0
13186;-1;497;0;0;0;0;.00nan;0;0
13186;170536;503;0;0;0;0;.00nan;0;0
13186;142810;497;37;31;6;25;.806;3900000;0
13187;1756;500;100;27;0;27;1.000;3600000;0
13187;63707;500;0;0;0;0;.00nan;0;0
13187;66271;495;81;19;1;18;.947;3567000;0
13187;148508;495;0;0;0;0;.00nan;0;0
13188;187813;499;0;0;0;0;.00nan;0;0
13188;175593;499;58;34;4;30;.882;3600000;0
13188;49674;498;0;0;0;0;.00nan;0;0
13188;148691;498;73;32;2;30;.938;3600000;0
13189;167480;503;0;0;0;0;.00nan;0;0
13189;170536;503;57;35;5;30;.857;3600000;0
13189;49674;498;81;28;2;26;.929;3600000;0
13189;148691;498;0;0;0;0;.00nan;0;0
13190;187813;499;0;0;0;0;.00nan;0;0
13190;175593;499;62;37;5;32;.865;3600000;0
13190;197409;502;0;0;0;0;.00nan;0;0
13190;152624;502;88;26;1;25;.962;3600000;0
13191;-1;497;0;0;0;0;.00nan;0;0
13191;66271;495;0;0;0;0;.00nan;0;0
13191;142810;497;59;25;3;22;.880;3543000;0
13191;148508;495;68;27;2;25;.926;3600000;0
13192;1061;505;68;28;2;26;.929;3559000;0
13192;177356;4636;0;0;0;0;.00nan;0;0
13192;43730;505;0;0;0;0;.00nan;0;0
13192;148503;4636;85;28;1;27;.964;3600000;0
13193;1756;500;59;17;2;15;.882;3900000;0
13193;6603;2591;0;0;0;0;.00nan;0;0
13193;174898;2591;95;47;2;45;.957;3900000;0
13193;63707;500;0;0;0;0;.00nan;0;0
13194;-1;504;49;24;4;20;.833;3600000;0
13194;-1;504;0;0;0;0;.00nan;0;0
13194;81085;496;66;33;3;30;.909;3600000;0
13194;148573;496;0;0;0;0;.00nan;0;0
13195;167480;503;0;0;0;0;.00nan;0;0
13195;170536;503;93;25;0;25;1.000;3600000;0
13195;49674;498;0;0;0;0;.00nan;0;0
13195;148691;498;53;29;4;25;.862;3600000;0
13196;187813;499;0;0;0;0;.00nan;0;0
13196;175593;499;79;34;2;32;.941;3900000;0
13196;197409;502;0;0;0;0;.00nan;0;0
13196;152624;502;94;34;2;32;.941;3900000;0
13197;615;497;67;23;2;21;.913;3600000;0
13197;66271;495;52;21;3;18;.857;2827000;0
13197;142810;497;0;0;0;0;.00nan;0;0
13197;148508;495;20;8;4;4;.500;773000;0
13198;1061;505;83;39;2;37;.949;3570000;0
13198;177356;4636;83;25;1;24;.960;3600000;0
13198;43730;505;0;0;0;0;.00nan;0;0
13198;148503;4636;0;0;0;0;.00nan;0;0
13199;1756;500;100;34;1;33;.971;3600000;0
13199;6603;2591;72;38;3;35;.921;3540000;0
13199;174898;2591;0;0;0;0;.00nan;0;0
13199;63707;500;0;0;0;0;.00nan;0;0
13200;-1;504;0;0;0;0;.00nan;0;0
13200;-1;504;84;32;1;31;.969;3900000;0
13200;81085;496;100;39;1;38;.974;3900000;0
13200;148573;496;0;0;0;0;.00nan;0;0
13201;49674;498;0;0;0;0;.00nan;0;0
13201;66271;495;32;17;4;13;.765;3566000;0
13201;148508;495;0;0;0;0;.00nan;0;0
13201;148691;498;93;45;2;43;.956;3600000;0
13202;187813;499;0;0;0;0;.00nan;0;0
13202;175593;499;48;27;4;23;.852;3600000;0
13202;-1;504;32;33;6;27;.818;3220000;0
13202;-1;504;52;3;0;3;1.000;337000;0
13203;177356;4636;0;0;0;0;.00nan;0;0
13203;81085;496;71;21;2;19;.905;3600000;0
13203;148503;4636;58;30;4;26;.867;3577000;0
13203;148573;496;0;0;0;0;.00nan;0;0
13204;167480;503;0;0;0;0;.00nan;0;0
13204;170536;503;68;29;3;26;.897;3617000;0
13204;197409;502;0;0;0;0;.00nan;0;0
13204;152624;502;48;26;4;22;.846;3617000;0
13205;615;497;70;31;3;28;.903;3550000;0
13205;1756;500;100;35;1;34;.971;3600000;0
13205;63707;500;0;0;0;0;.00nan;0;0
13205;142810;497;0;0;0;0;.00nan;0;0
13206;1061;505;87;35;1;34;.971;3574000;0
13206;6603;2591;100;26;0;26;1.000;3600000;0
13206;174898;2591;0;0;0;0;.00nan;0;0
13206;43730;505;0;0;0;0;.00nan;0;0
13207;49674;498;0;0;0;0;.00nan;0;0
13207;66271;495;98;41;1;40;.976;3600000;0
13207;148508;495;0;0;0;0;.00nan;0;0
13207;148691;498;100;29;0;29;1.000;3600000;0
13208;187813;499;0;0;0;0;.00nan;0;0
13208;175593;499;87;33;1;32;.970;3600000;0
13208;-1;504;0;0;0;0;.00nan;0;0
13208;-1;504;87;19;0;19;1.000;3600000;0
13209;177356;4636;0;0;0;0;.00nan;0;0
13209;81085;496;93;31;1;30;.968;3600000;0
13209;148503;4636;50;31;4;27;.871;3600000;0
13209;148573;496;0;0;0;0;.00nan;0;0
13210;167480;503;0;0;0;0;.00nan;0;0
13210;170536;503;72;37;4;33;.892;3600000;0
13210;197409;502;0;0;0;0;.00nan;0;0
13210;152624;502;100;27;0;27;1.000;3600000;0
13211;615;497;72;30;2;28;.933;3900000;0
13211;1756;500;88;32;2;30;.938;3900000;0
13211;63707;500;0;0;0;0;.00nan;0;0
13211;142810;497;0;0;0;0;.00nan;0;0
13212;1061;505;58;30;3;27;.900;3747000;0
13212;6603;2591;43;19;4;15;.789;3747000;0
13212;174898;2591;0;0;0;0;.00nan;0;0
13212;43730;505;0;0;0;0;.00nan;0;0
13213;1061;505;0;0;0;0;.00nan;0;0
13213;43730;505;100;23;0;23;1.000;3600000;0
13213;81085;496;58;37;5;32;.865;3600000;0
13213;148573;496;0;0;0;0;.00nan;0;0
13214;1756;500;65;33;3;30;.909;3568000;0
13214;49674;498;0;0;0;0;.00nan;0;0
13214;63707;500;0;0;0;0;.00nan;0;0
13214;148691;498;81;27;1;26;.963;3600000;0
13215;197409;502;0;0;0;0;.00nan;0;0
13215;66271;495;0;0;0;0;.00nan;0;0
13215;148508;495;44;31;6;25;.806;3581000;0
13215;152624;502;42;25;5;20;.800;3600000;0
13216;187813;499;0;0;0;0;.00nan;0;0
13216;177356;4636;0;0;0;0;.00nan;0;0
13216;175593;499;77;28;2;26;.929;3600000;0
13216;148503;4636;61;31;3;28;.903;3569000;0
13217;167480;503;0;0;0;0;.00nan;0;0
13217;170536;503;27;41;7;34;.829;3600000;0
13217;-1;504;0;0;0;0;.00nan;0;0
13217;-1;504;47;27;4;23;.852;3600000;0
13218;615;497;75;24;1;23;.958;3600000;0
13218;6603;2591;58;28;3;25;.893;3574000;0
13218;174898;2591;0;0;0;0;.00nan;0;0
13218;142810;497;0;0;0;0;.00nan;0;0
13219;1061;505;0;0;0;0;.00nan;0;0
13219;43730;505;87;35;2;33;.943;3563000;0
13219;81085;496;85;28;1;27;.964;3600000;0
13219;148573;496;0;0;0;0;.00nan;0;0
13220;1756;500;86;24;1;23;.958;3679000;0
13220;49674;498;0;0;0;0;.00nan;0;0
13220;63707;500;0;0;0;0;.00nan;0;0
13220;148691;498;83;33;2;31;.939;3679000;0
13221;197409;502;0;0;0;0;.00nan;0;0
13221;66271;495;80;46;4;42;.913;3589000;0
13221;148508;495;0;0;0;0;.00nan;0;0
13221;152624;502;74;27;2;25;.926;3600000;0
13222;187813;499;0;0;0;0;.00nan;0;0
13222;177356;4636;0;0;0;0;.00nan;0;0
13222;175593;499;74;28;2;26;.929;3600000;0
13222;148503;4636;59;39;4;35;.897;3586000;0
13223;167480;503;0;0;0;0;.00nan;0;0
13223;170536;503;63;37;4;33;.892;3553000;0
13223;-1;504;84;33;2;31;.939;3600000;0
13223;-1;504;0;0;0;0;.00nan;0;0
13224;615;497;73;21;1;20;.952;3556000;0
13224;6603;2591;100;30;0;30;1.000;3600000;0
13224;174898;2591;0;0;0;0;.00nan;0;0
13224;142810;497;0;0;0;0;.00nan;0;0
13225;177356;4636;0;0;0;0;.00nan;0;0
13225;167480;503;0;0;0;0;.00nan;0;0
13225;170536;503;92;49;4;45;.918;3600000;0
13225;148503;4636;84;16;0;16;1.000;3600000;0
13226;1061;505;56;27;3;24;.889;3567000;0
13226;187813;499;84;31;1;30;.968;3600000;0
13226;175593;499;0;0;0;0;.00nan;0;0
13226;43730;505;0;0;0;0;.00nan;0;0
13227;615;497;88;38;2;36;.947;3900000;0
13227;49674;498;0;0;0;0;.00nan;0;0
13227;142810;497;0;0;0;0;.00nan;0;0
13227;148691;498;76;26;2;24;.923;3900000;0
13228;-1;504;73;35;3;32;.914;3600000;0
13228;-1;504;0;0;0;0;.00nan;0;0
13228;66271;495;0;0;0;0;.00nan;0;0
13228;148508;495;79;29;2;27;.931;3600000;0
13229;1756;500;0;0;0;0;.00nan;0;0
13229;197409;502;0;0;0;0;.00nan;0;0
13229;63707;500;94;42;1;41;.976;3900000;0
13229;152624;502;81;25;1;24;.960;3900000;0
13230;6603;2591;96;36;1;35;.972;3900000;0
13230;174898;2591;0;0;0;0;.00nan;0;0
13230;81085;496;89;27;1;26;.963;3900000;0
13230;148573;496;0;0;0;0;.00nan;0;0
13231;177356;4636;0;0;0;0;.00nan;0;0
13231;167480;503;0;0;0;0;.00nan;0;0
13231;170536;503;63;24;2;22;.917;3900000;0
13231;148503;4636;81;25;2;23;.920;3900000;0
13232;1061;505;0;0;0;0;.00nan;0;0
13232;187813;499;0;0;0;0;.00nan;0;0
13232;175593;499;63;37;4;33;.892;3565000;0
13232;43730;505;69;29;3;26;.897;3600000;0
13233;615;497;80;39;3;36;.923;3900000;0
13233;49674;498;71;29;3;26;.897;3900000;0
13233;142810;497;0;0;0;0;.00nan;0;0
13233;148691;498;0;0;0;0;.00nan;0;0
13234;-1;504;0;0;0;0;.00nan;0;0
13234;-1;504;70;27;2;25;.926;3590000;0
13234;66271;495;0;0;0;0;.00nan;0;0
13234;148508;495;89;27;1;26;.963;3600000;0
13235;1756;500;80;34;2;32;.941;3600000;0
13235;197409;502;0;0;0;0;.00nan;0;0
13235;63707;500;0;0;0;0;.00nan;0;0
13235;152624;502;78;37;3;34;.919;3569000;0
13236;6603;2591;0;0;0;0;.00nan;0;0
13236;174898;2591;66;28;2;26;.929;3600000;0
13236;81085;496;55;34;4;30;.882;3542000;0
13236;148573;496;0;0;0;0;.00nan;0;0
13237;1061;505;58;23;3;20;.870;3600000;0
13237;167480;503;0;0;0;0;.00nan;0;0
13237;170536;503;70;40;4;36;.900;3564000;0
13237;43730;505;0;0;0;0;.00nan;0;0
13238;1756;500;100;41;1;40;.976;3600000;0
13238;-1;504;43;29;5;24;.828;3600000;0
13238;-1;504;0;0;0;0;.00nan;0;0
13238;63707;500;0;0;0;0;.00nan;0;0
13239;615;497;98;41;2;39;.951;3600000;0
13239;197409;502;0;0;0;0;.00nan;0;0
13239;142810;497;0;0;0;0;.00nan;0;0
13239;152624;502;68;14;1;13;.929;3600000;0
13240;177356;4636;0;0;0;0;.00nan;0;0
13240;66271;495;0;0;0;0;.00nan;0;0
13240;148503;4636;83;36;3;33;.917;3600000;0
13240;148508;495;55;34;4;30;.882;3544000;0
13241;6603;2591;64;22;2;20;.909;3600000;0
13241;174898;2591;0;0;0;0;.00nan;0;0
13241;49674;498;0;0;0;0;.00nan;0;0
13241;148691;498;33;19;4;15;.789;3539000;0
13242;187813;499;0;0;0;0;.00nan;0;0
13242;175593;499;100;36;0;36;1.000;3600000;0
13242;81085;496;0;0;0;0;.00nan;0;0
13242;148573;496;71;15;1;14;.933;3552000;0
13243;1061;505;79;24;1;23;.958;3600000;0
13243;167480;503;0;0;0;0;.00nan;0;0
13243;170536;503;92;38;2;36;.947;3563000;0
13243;43730;505;0;0;0;0;.00nan;0;0
13244;1756;500;57;29;4;25;.862;3600000;0
13244;-1;504;94;27;1;26;.963;3600000;0
13244;-1;504;0;0;0;0;.00nan;0;0
13244;63707;500;0;0;0;0;.00nan;0;0
13245;615;497;72;38;3;35;.921;3600000;0
13245;197409;502;0;0;0;0;.00nan;0;0
13245;142810;497;0;0;0;0;.00nan;0;0
13245;152624;502;63;21;2;19;.905;3600000;0
13246;177356;4636;0;0;0;0;.00nan;0;0
13246;66271;495;81;36;3;33;.917;3600000;0
13246;148503;4636;77;26;2;24;.923;3600000;0
13246;148508;495;0;0;0;0;.00nan;0;0
13247;6603;2591;63;25;2;23;.920;3551000;0
13247;174898;2591;0;0;0;0;.00nan;0;0
13247;49674;498;0;0;0;0;.00nan;0;0
13247;148691;498;89;26;0;26;1.000;3600000;0
13248;187813;499;0;0;0;0;.00nan;0;0
13248;175593;499;69;36;3;33;.917;3514000;0
13248;81085;496;78;26;1;25;.962;3600000;0
13248;148573;496;0;0;0;0;.00nan;0;0
13249;167480;503;0;0;0;0;.00nan;0;0
13249;170536;503;93;50;3;47;.940;3587000;0
13249;81085;496;64;15;1;14;.933;3600000;0
13249;148573;496;0;0;0;0;.00nan;0;0
13250;1061;505;0;0;0;0;.00nan;0;0
13250;43730;505;88;33;2;31;.939;3900000;0
13250;66271;495;0;0;0;0;.00nan;0;0
13250;148508;495;77;29;2;27;.931;3900000;0
13251;1756;500;87;37;3;34;.919;3576000;0
13251;177356;4636;0;0;0;0;.00nan;0;0
13251;63707;500;0;0;0;0;.00nan;0;0
13251;148503;4636;100;36;1;35;.972;3600000;0
13252;197409;502;0;0;0;0;.00nan;0;0
13252;49674;498;0;0;0;0;.00nan;0;0
13252;148691;498;90;44;3;41;.932;3554000;0
13252;152624;502;88;27;2;25;.926;3600000;0
13253;615;497;75;41;3;38;.927;3900000;0
13253;-1;504;0;0;0;0;.00nan;0;0
13253;-1;504;62;30;3;27;.900;3900000;0
13253;142810;497;0;0;0;0;.00nan;0;0
13254;187813;499;0;0;0;0;.00nan;0;0
13254;6603;2591;86;49;4;45;.918;3552000;0
13254;174898;2591;0;0;0;0;.00nan;0;0
13254;175593;499;70;25;2;23;.920;3600000;0
13255;167480;503;0;0;0;0;.00nan;0;0
13255;170536;503;92;54;2;52;.963;3600000;0
13255;81085;496;84;22;1;21;.955;3600000;0
13255;148573;496;0;0;0;0;.00nan;0;0
13256;1061;505;0;0;0;0;.00nan;0;0
13256;43730;505;74;29;3;26;.897;3600000;0
13256;66271;495;0;0;0;0;.00nan;0;0
13256;148508;495;28;30;6;24;.800;3600000;0
13257;1756;500;0;0;0;0;.00nan;0;0
13257;177356;4636;74;34;2;32;.941;3546000;0
13257;63707;500;87;29;1;28;.966;3600000;0
13257;148503;4636;0;0;0;0;.00nan;0;0
13258;197409;502;0;0;0;0;.00nan;0;0
13258;49674;498;0;0;0;0;.00nan;0;0
13258;148691;498;76;33;2;31;.939;3900000;0
13258;152624;502;79;32;2;30;.938;3900000;0
13259;615;497;69;27;2;25;.926;3553000;0
13259;-1;504;100;29;0;29;1.000;3600000;0
13259;-1;504;0;0;0;0;.00nan;0;0
13259;142810;497;0;0;0;0;.00nan;0;0
13260;187813;499;0;0;0;0;.00nan;0;0
13260;6603;2591;85;28;1;27;.964;3600000;0
13260;174898;2591;0;0;0;0;.00nan;0;0
13260;175593;499;76;34;3;31;.912;3536000;0
13261;615;497;69;21;2;19;.905;3900000;0
13261;177356;4636;0;0;0;0;.00nan;0;0
13261;142810;497;0;0;0;0;.00nan;0;0
13261;148503;4636;92;40;2;38;.950;3900000;0
13262;-1;504;63;30;3;27;.900;3600000;0
13262;-1;504;0;0;0;0;.00nan;0;0
13262;49674;498;50;18;3;15;.833;2448000;0
13262;148691;498;19;13;5;8;.615;1152000;0
13263;6603;2591;99;45;2;43;.956;3600000;0
13263;174898;2591;0;0;0;0;.00nan;0;0
13263;197409;502;0;0;0;0;.00nan;0;0
13263;152624;502;58;29;4;25;.862;3520000;0
13264;1061;505;0;0;0;0;.00nan;0;0
13264;1756;500;31;30;6;24;.800;3600000;0
13264;43730;505;84;28;1;27;.964;3600000;0
13264;63707;500;0;0;0;0;.00nan;0;0
13265;187813;499;81;15;0;15;1.000;3600000;0
13265;167480;503;0;0;0;0;.00nan;0;0
13265;170536;503;80;36;2;34;.944;3600000;0
13265;175593;499;0;0;0;0;.00nan;0;0
13266;66271;495;0;0;0;0;.00nan;0;0
13266;81085;496;76;20;1;19;.950;3600000;0
13266;148508;495;67;41;4;37;.902;3600000;0
13266;148573;496;0;0;0;0;.00nan;0;0
13267;615;497;76;29;2;27;.931;3634000;0
13267;177356;4636;0;0;0;0;.00nan;0;0
13267;142810;497;0;0;0;0;.00nan;0;0
13267;148503;4636;64;23;3;20;.870;3634000;0
13268;-1;504;97;38;1;37;.974;3600000;0
13268;-1;504;0;0;0;0;.00nan;0;0
13268;49674;498;0;0;0;0;.00nan;0;0
13268;148691;498;67;34;3;31;.912;3551000;0
13269;6603;2591;57;25;3;22;.880;3600000;0
13269;174898;2591;0;0;0;0;.00nan;0;0
13269;197409;502;0;0;0;0;.00nan;0;0
13269;152624;502;99;23;0;23;1.000;3600000;0
13270;1061;505;47;21;3;18;.857;3600000;0
13270;1756;500;100;42;0;42;1.000;3600000;0
13270;43730;505;0;0;0;0;.00nan;0;0
13270;63707;500;0;0;0;0;.00nan;0;0
13271;187813;499;57;21;2;19;.905;3900000;0
13271;167480;503;0;0;0;0;.00nan;0;0
13271;170536;503;79;32;2;30;.938;3900000;0
13271;175593;499;0;0;0;0;.00nan;0;0
13272;66271;495;55;35;4;31;.886;3594000;0
13272;81085;496;0;0;0;0;.00nan;0;0
13272;148508;495;0;0;0;0;.00nan;0;0
13272;148573;496;78;25;2;23;.920;3600000;0
13273;187813;499;0;0;0;0;.00nan;0;0
13273;175593;499;57;37;4;33;.892;3600000;0
13273;66271;495;0;0;0;0;.00nan;0;0
13273;148508;495;75;16;1;15;.938;3600000;0
13274;1756;500;80;38;3;35;.921;3545000;0
13274;63707;500;0;0;0;0;.00nan;0;0
13274;81085;496;95;37;2;35;.946;3600000;0
13274;148573;496;0;0;0;0;.00nan;0;0
13275;6603;2591;68;26;2;24;.923;3600000;0
13275;167480;503;0;0;0;0;.00nan;0;0
13275;170536;503;92;45;3;42;.933;3554000;0
13275;174898;2591;0;0;0;0;.00nan;0;0
13276;177356;4636;0;0;0;0;.00nan;0;0
13276;49674;498;59;26;3;23;.885;3548000;0
13276;148503;4636;57;21;2;19;.905;3600000;0
13276;148691;498;0;0;0;0;.00nan;0;0
13277;-1;504;0;0;0;0;.00nan;0;0
13277;-1;504;95;49;2;47;.959;3545000;0
13277;197409;502;0;0;0;0;.00nan;0;0
13277;152624;502;86;21;1;20;.952;3600000;0
13278;615;497;95;46;2;44;.957;3600000;0
13278;1061;505;0;0;0;0;.00nan;0;0
13278;43730;505;42;15;3;12;.800;3564000;0
13278;142810;497;0;0;0;0;.00nan;0;0
13279;187813;499;0;0;0;0;.00nan;0;0
13279;175593;499;79;34;2;32;.941;3545000;0
13279;66271;495;0;0;0;0;.00nan;0;0
13279;148508;495;66;17;1;16;.941;3600000;0
13280;1756;500;53;30;4;26;.867;3600000;0
13280;63707;500;0;0;0;0;.00nan;0;0
13280;81085;496;73;27;2;25;.926;3600000;0
13280;148573;496;0;0;0;0;.00nan;0;0
13281;6603;2591;56;29;3;26;.897;3900000;0
13281;167480;503;0;0;0;0;.00nan;0;0
13281;170536;503;94;48;3;45;.938;3900000;0
13281;174898;2591;0;0;0;0;.00nan;0;0
13282;177356;4636;0;0;0;0;.00nan;0;0
13282;49674;498;0;0;0;0;.00nan;0;0
13282;148503;4636;82;40;2;38;.950;3900000;0
13282;148691;498;70;26;2;24;.923;3900000;0
13283;-1;504;52;26;3;23;.885;3900000;0
13283;-1;504;0;0;0;0;.00nan;0;0
13283;197409;502;0;0;0;0;.00nan;0;0
13283;152624;502;67;30;3;27;.900;3900000;0
13284;615;497;89;39;3;36;.923;3600000;0
13284;1061;505;0;0;0;0;.00nan;0;0
13284;43730;505;100;23;0;23;1.000;3600000;0
13284;142810;497;0;0;0;0;.00nan;0;0
13285;167480;503;0;0;0;0;.00nan;0;0
13285;170536;503;100;45;2;43;.956;3900000;0
13285;66271;495;0;0;0;0;.00nan;0;0
13285;148508;495;78;32;2;30;.938;3900000;0
13286;1756;500;100;24;0;24;1.000;3600000;0
13286;187813;499;0;0;0;0;.00nan;0;0
13286;175593;499;57;36;5;31;.861;3600000;0
13286;63707;500;0;0;0;0;.00nan;0;0
13287;615;497;100;32;0;32;1.000;3600000;0
13287;81085;496;85;26;1;25;.962;3576000;0
13287;142810;497;0;0;0;0;.00nan;0;0
13287;148573;496;0;0;0;0;.00nan;0;0
13288;1061;505;0;0;0;0;.00nan;0;0
13288;43730;505;100;27;0;27;1.000;3600000;0
13288;49674;498;0;0;0;0;.00nan;0;0
13288;148691;498;71;33;3;30;.909;3600000;0
13289;6603;2591;100;26;0;26;1.000;3600000;0
13289;174898;2591;0;0;0;0;.00nan;0;0
13289;-1;504;57;40;5;35;.875;3600000;0
13289;-1;504;0;0;0;0;.00nan;0;0
13290;177356;4636;0;0;0;0;.00nan;0;0
13290;197409;502;0;0;0;0;.00nan;0;0
13290;148503;4636;92;35;1;34;.971;3600000;0
13290;152624;502;67;26;2;24;.923;3586000;0
13291;167480;503;0;0;0;0;.00nan;0;0
13291;170536;503;87;42;3;39;.929;3523000;0
13291;66271;495;73;20;1;19;.950;3600000;0
13291;148508;495;0;0;0;0;.00nan;0;0
13292;1756;500;83;28;1;27;.964;3600000;0
13292;187813;499;0;0;0;0;.00nan;0;0
13292;175593;499;64;35;4;31;.886;3600000;0
13292;63707;500;0;0;0;0;.00nan;0;0
13293;615;497;96;40;2;38;.950;3563000;0
13293;81085;496;99;41;1;40;.976;3600000;0
13293;142810;497;0;0;0;0;.00nan;0;0
13293;148573;496;0;0;0;0;.00nan;0;0
13294;1061;505;0;0;0;0;.00nan;0;0
13294;43730;505;67;33;3;30;.909;3597000;0
13294;49674;498;62;21;2;19;.905;3600000;0
13294;148691;498;0;0;0;0;.00nan;0;0
13295;6603;2591;86;28;1;27;.964;3600000;0
13295;174898;2591;0;0;0;0;.00nan;0;0
13295;-1;504;0;0;0;0;.00nan;0;0
13295;-1;504;88;40;2;38;.950;3600000;0
13296;177356;4636;55;11;1;10;.909;1268000;0
13296;197409;502;0;0;0;0;.00nan;0;0
13296;148503;4636;58;29;4;25;.862;2332000;0
13296;152624;502;66;14;1;13;.929;3600000;0
13297;177356;4636;0;0;0;0;.00nan;0;0
13297;-1;504;82;41;3;38;.927;3571000;0
13297;-1;504;0;0;0;0;.00nan;0;0
13297;148503;4636;71;22;1;21;.955;3600000;0
13298;1061;505;0;0;0;0;.00nan;0;0
13298;43730;505;81;34;2;32;.941;3600000;0
13298;197409;502;0;0;0;0;.00nan;0;0
13298;152624;502;86;36;3;33;.917;3590000;0
13299;49674;498;0;0;0;0;.00nan;0;0
13299;81085;496;87;24;1;23;.958;3600000;0
13299;148573;496;0;0;0;0;.00nan;0;0
13299;148691;498;54;35;4;31;.886;3600000;0
13300;1756;500;56;25;3;22;.880;3600000;0
13300;167480;503;0;0;0;0;.00nan;0;0
13300;170536;503;89;43;2;41;.953;3600000;0
13300;63707;500;0;0;0;0;.00nan;0;0
13301;615;497;91;26;1;25;.962;3600000;0
13301;187813;499;70;29;2;27;.931;3587000;0
13301;175593;499;0;0;0;0;.00nan;0;0
13301;142810;497;0;0;0;0;.00nan;0;0
13302;6603;2591;0;0;0;0;.00nan;0;0
13302;174898;2591;67;32;4;28;.875;3600000;0
13302;66271;495;0;0;0;0;.00nan;0;0
13302;148508;495;85;23;1;22;.957;3600000;0
13303;177356;4636;0;0;0;0;.00nan;0;0
13303;-1;504;0;0;0;0;.00nan;0;0
13303;-1;504;100;26;0;26;1.000;3600000;0
13303;148503;4636;76;31;2;29;.935;3550000;0
13304;1061;505;0;0;0;0;.00nan;0;0
13304;43730;505;50;29;4;25;.862;3546000;0
13304;197409;502;0;0;0;0;.00nan;0;0
13304;152624;502;71;21;2;19;.905;3600000;0
13305;49674;498;54;18;3;15;.833;3600000;0
13305;81085;496;83;46;4;42;.913;3575000;0
13305;148573;496;0;0;0;0;.00nan;0;0
13305;148691;498;0;0;0;0;.00nan;0;0
13306;1756;500;86;27;1;26;.963;3783000;0
13306;167480;503;0;0;0;0;.00nan;0;0
13306;170536;503;90;40;2;38;.950;3783000;0
13306;63707;500;0;0;0;0;.00nan;0;0
13307;615;497;73;36;3;33;.917;3559000;0
13307;187813;499;0;0;0;0;.00nan;0;0
13307;175593;499;68;25;2;23;.920;3600000;0
13307;142810;497;0;0;0;0;.00nan;0;0
13308;6603;2591;94;33;1;32;.970;3600000;0
13308;174898;2591;0;0;0;0;.00nan;0;0
13308;66271;495;98;38;2;36;.947;3553000;0
13308;148508;495;0;0;0;0;.00nan;0;0
13309;187813;499;0;0;0;0;.00nan;0;0
13309;175593;499;78;30;2;28;.933;3600000;0
13309;49674;498;67;18;1;17;.944;3600000;0
13309;148691;498;0;0;0;0;.00nan;0;0
13310;1756;500;99;33;1;32;.970;3600000;0
13310;63707;500;0;0;0;0;.00nan;0;0
13310;66271;495;0;0;0;0;.00nan;0;0
13310;148508;495;60;33;4;29;.879;3600000;0
13311;615;497;94;37;1;36;.973;3733000;0
13311;167480;503;0;0;0;0;.00nan;0;0
13311;170536;503;100;34;0;34;1.000;3733000;0
13311;142810;497;0;0;0;0;.00nan;0;0
13312;177356;4636;0;0;0;0;.00nan;0;0
13312;6603;2591;97;23;0;23;1.000;3600000;0
13312;174898;2591;0;0;0;0;.00nan;0;0
13312;148503;4636;68;27;2;25;.926;3585000;0
13313;1061;505;0;0;0;0;.00nan;0;0
13313;-1;504;0;0;0;0;.00nan;0;0
13313;-1;504;55;39;5;34;.872;3600000;0
13313;43730;505;52;23;3;20;.870;3600000;0
13314;197409;502;0;0;0;0;.00nan;0;0
13314;81085;496;56;29;3;26;.897;3600000;0
13314;148573;496;0;0;0;0;.00nan;0;0
13314;152624;502;100;20;0;20;1.000;3600000;0
13315;187813;499;0;0;0;0;.00nan;0;0
13315;175593;499;79;37;3;34;.919;3600000;0
13315;49674;498;0;0;0;0;.00nan;0;0
13315;148691;498;17;35;8;27;.771;3600000;0
13316;1756;500;58;32;4;28;.875;3691000;0
13316;63707;500;0;0;0;0;.00nan;0;0
13316;66271;495;0;0;0;0;.00nan;0;0
13316;148508;495;47;32;5;27;.844;3691000;0
13317;615;497;77;22;1;21;.955;3600000;0
13317;167480;503;0;0;0;0;.00nan;0;0
13317;170536;503;76;37;3;34;.919;3600000;0
13317;142810;497;0;0;0;0;.00nan;0;0
13318;177356;4636;63;24;3;21;.875;3563000;0
13318;6603;2591;70;27;2;25;.926;3600000;0
13318;174898;2591;0;0;0;0;.00nan;0;0
13318;148503;4636;0;0;0;0;.00nan;0;0
13319;1061;505;0;0;0;0;.00nan;0;0
13319;-1;504;75;37;3;34;.919;3600000;0
13319;-1;504;0;0;0;0;.00nan;0;0
13319;43730;505;61;34;4;30;.882;3600000;0
13320;197409;502;0;0;0;0;.00nan;0;0
13320;81085;496;62;19;2;17;.895;3701000;0
13320;148573;496;0;0;0;0;.00nan;0;0
13320;152624;502;72;32;3;29;.906;3701000;0
13321;1061;505;97;20;0;20;1.000;3600000;0
13321;177356;4636;52;18;2;16;.889;1422000;0
13321;43730;505;0;0;0;0;.00nan;0;0
13321;148503;4636;44;18;4;14;.778;2178000;0
13322;-1;504;41;30;5;25;.833;3600000;0
13322;-1;504;0;0;0;0;.00nan;0;0
13322;81085;496;0;0;0;0;.00nan;0;0
13322;148573;496;99;39;1;38;.974;3600000;0
13323;1756;500;29;9;3;6;.667;416000;0
13323;6603;2591;95;27;0;27;1.000;3600000;0
13323;174898;2591;0;0;0;0;.00nan;0;0
13323;63707;500;68;28;2;26;.929;3184000;0
13324;167480;503;0;0;0;0;.00nan;0;0
13324;170536;503;89;47;3;44;.936;3600000;0
13324;49674;498;0;0;0;0;.00nan;0;0
13324;148691;498;94;21;0;21;1.000;3600000;0
13325;615;497;88;30;1;29;.967;3900000;0
13325;66271;495;0;0;0;0;.00nan;0;0
13325;142810;497;0;0;0;0;.00nan;0;0
13325;148508;495;83;26;1;25;.962;3900000;0
13326;187813;499;0;0;0;0;.00nan;0;0
13326;175593;499;88;39;2;37;.949;3900000;0
13326;197409;502;0;0;0;0;.00nan;0;0
13326;152624;502;86;35;2;33;.943;3900000;0
13327;1061;505;0;0;0;0;.00nan;0;0
13327;177356;4636;0;0;0;0;.00nan;0;0
13327;43730;505;86;28;1;27;.964;3574000;0
13327;148503;4636;92;17;0;17;1.000;3600000;0
13328;-1;504;64;38;5;33;.868;3600000;0
13328;-1;504;0;0;0;0;.00nan;0;0
13328;81085;496;68;23;1;22;.957;3600000;0
13328;148573;496;0;0;0;0;.00nan;0;0
13329;1756;500;89;33;1;32;.970;3600000;0
13329;6603;2591;80;29;2;27;.931;3600000;0
13329;174898;2591;0;0;0;0;.00nan;0;0
13329;63707;500;0;0;0;0;.00nan;0;0
13330;167480;503;0;0;0;0;.00nan;0;0
13330;170536;503;86;28;1;27;.964;3600000;0
13330;49674;498;0;0;0;0;.00nan;0;0
13330;148691;498;66;21;2;19;.905;3600000;0
13331;615;497;75;36;3;33;.917;3600000;0
13331;66271;495;79;24;1;23;.958;3600000;0
13331;142810;497;0;0;0;0;.00nan;0;0
13331;148508;495;0;0;0;0;.00nan;0;0
13332;187813;499;100;27;0;27;1.000;3900000;0
13332;175593;499;0;0;0;0;.00nan;0;0
13332;197409;502;0;0;0;0;.00nan;0;0
13332;152624;502;75;20;0;20;1.000;3900000;0
13333;1061;505;64;32;2;30;.938;3900000;0
13333;6603;2591;97;40;2;38;.950;3900000;0
13333;174898;2591;0;0;0;0;.00nan;0;0
13333;43730;505;0;0;0;0;.00nan;0;0
13334;167480;503;0;0;0;0;.00nan;0;0
13334;170536;503;67;50;6;44;.880;3600000;0
13334;197409;502;0;0;0;0;.00nan;0;0
13334;152624;502;80;22;1;21;.955;3600000;0
13335;615;497;64;40;4;36;.900;3600000;0
13335;1756;500;94;32;1;31;.969;3600000;0
13335;63707;500;0;0;0;0;.00nan;0;0
13335;142810;497;0;0;0;0;.00nan;0;0
13336;177356;4636;0;0;0;0;.00nan;0;0
13336;81085;496;87;30;1;29;.967;3900000;0
13336;148503;4636;84;29;1;28;.966;3900000;0
13336;148573;496;0;0;0;0;.00nan;0;0
13337;49674;498;0;0;0;0;.00nan;0;0
13337;66271;495;0;0;0;0;.00nan;0;0
13337;148508;495;90;35;1;34;.971;3600000;0
13337;148691;498;58;29;4;25;.862;3600000;0
13338;187813;499;69;32;3;29;.906;3600000;0
13338;175593;499;0;0;0;0;.00nan;0;0
13338;-1;504;0;0;0;0;.00nan;0;0
13338;-1;504;54;28;4;24;.857;3524000;0
13339;1061;505;0;0;0;0;.00nan;0;0
13339;6603;2591;81;40;3;37;.925;3600000;0
13339;174898;2591;0;0;0;0;.00nan;0;0
13339;43730;505;59;15;1;14;.933;3600000;0
13340;167480;503;0;0;0;0;.00nan;0;0
13340;170536;503;79;38;3;35;.921;3598000;0
13340;197409;502;0;0;0;0;.00nan;0;0
13340;152624;502;73;23;2;21;.913;3600000;0
13341;615;497;0;0;0;0;.00nan;0;0
13341;1756;500;73;38;4;34;.895;3717000;0
13341;63707;500;0;0;0;0;.00nan;0;0
13341;142810;497;68;28;3;25;.893;3717000;0
13342;177356;4636;0;0;0;0;.00nan;0;0
13342;81085;496;92;19;0;19;1.000;3600000;0
13342;148503;4636;83;39;2;37;.949;3546000;0
13342;148573;496;0;0;0;0;.00nan;0;0
13343;49674;498;0;0;0;0;.00nan;0;0
13343;66271;495;0;0;0;0;.00nan;0;0
13343;148508;495;67;26;2;24;.923;3545000;0
13343;148691;498;80;32;1;31;.969;3600000;0
13344;187813;499;0;0;0;0;.00nan;0;0
13344;175593;499;56;31;4;27;.871;3575000;0
13344;-1;504;78;37;3;34;.919;3600000;0
13344;-1;504;0;0;0;0;.00nan;0;0
13345;167480;503;49;32;5;27;.844;3600000;0
13345;170536;503;0;0;0;0;.00nan;0;0
13345;-1;504;0;0;0;0;.00nan;0;0
13345;-1;504;100;28;0;28;1.000;3600000;0
13346;187813;499;0;0;0;0;.00nan;0;0
13346;177356;4636;0;0;0;0;.00nan;0;0
13346;175593;499;64;21;2;19;.905;3600000;0
13346;148503;4636;86;40;3;37;.925;3570000;0
13347;615;497;100;30;0;30;1.000;3600000;0
13347;6603;2591;0;0;0;0;.00nan;0;0
13347;174898;2591;74;31;3;28;.903;3600000;0
13347;142810;497;0;0;0;0;.00nan;0;0
13348;197409;502;0;0;0;0;.00nan;0;0
13348;66271;495;0;0;0;0;.00nan;0;0
13348;148508;495;65;31;4;27;.871;3900000;0
13348;152624;502;65;41;4;37;.902;3900000;0
13349;1756;500;69;29;2;27;.931;2760000;0
13349;49674;498;0;0;0;0;.00nan;0;0
13349;63707;500;30;14;4;10;.714;840000;0
13349;148691;498;79;28;2;26;.929;3600000;0
13350;1061;505;0;0;0;0;.00nan;0;0
13350;43730;505;60;23;2;21;.913;3552000;0
13350;81085;496;100;29;0;29;1.000;3600000;0
13350;148573;496;0;0;0;0;.00nan;0;0
13351;167480;503;0;0;0;0;.00nan;0;0
13351;170536;503;56;45;5;40;.889;3600000;0
13351;-1;504;0;0;0;0;.00nan;0;0
13351;-1;504;41;17;3;14;.824;3600000;0
13352;187813;499;0;0;0;0;.00nan;0;0
13352;177356;4636;0;0;0;0;.00nan;0;0
13352;175593;499;57;35;4;31;.886;3600000;0
13352;148503;4636;67;20;1;19;.950;3600000;0
13353;615;497;70;40;3;37;.925;3900000;0
13353;6603;2591;66;27;3;24;.889;3893000;0
13353;174898;2591;0;0;0;0;.00nan;0;0
13353;142810;497;0;0;0;0;.00nan;0;0
13354;197409;502;0;0;0;0;.00nan;0;0
13354;66271;495;97;45;2;43;.956;3600000;0
13354;148508;495;0;0;0;0;.00nan;0;0
13354;152624;502;79;27;1;26;.963;3600000;0
13355;1756;500;54;34;6;28;.824;3600000;0
13355;49674;498;0;0;0;0;.00nan;0;0
13355;63707;500;0;0;0;0;.00nan;0;0
13355;148691;498;71;25;2;23;.920;3600000;0
13356;1061;505;0;0;0;0;.00nan;0;0
13356;43730;505;80;28;1;27;.964;3900000;0
13356;81085;496;75;19;1;18;.947;3900000;0
13356;148573;496;0;0;0;0;.00nan;0;0
13357;-1;504;0;0;0;0;.00nan;0;0
13357;-1;504;97;51;3;48;.941;3900000;0
13357;66271;495;0;0;0;0;.00nan;0;0
13357;148508;495;77;36;3;33;.917;3900000;0
13358;6603;2591;69;39;3;36;.923;3600000;0
13358;174898;2591;0;0;0;0;.00nan;0;0
13358;81085;496;0;0;0;0;.00nan;0;0
13358;148573;496;94;20;0;20;1.000;3600000;0
13359;1756;500;35;10;3;7;.700;454000;0
13359;180188;502;0;0;0;0;.00nan;0;0
13359;63707;500;83;38;2;36;.947;3146000;0
13359;152624;502;75;27;2;25;.926;3600000;0
13360;177356;4636;0;0;0;0;.00nan;0;0
13360;167480;503;0;0;0;0;.00nan;0;0
13360;170536;503;85;33;3;30;.909;3600000;0
13360;148503;4636;82;15;0;15;1.000;3600000;0
13361;1061;505;57;26;3;23;.885;3556000;0
13361;178114;499;0;0;0;0;.00nan;0;0
13361;175593;499;87;34;2;32;.941;3600000;0
13361;43730;505;0;0;0;0;.00nan;0;0
13362;615;497;63;26;3;23;.885;3587000;0
13362;49674;498;0;0;0;0;.00nan;0;0
13362;142810;497;0;0;0;0;.00nan;0;0
13362;148691;498;81;28;1;27;.964;3600000;0
13363;-1;504;0;0;0;0;.00nan;0;0
13363;-1;504;83;28;1;27;.964;3600000;0
13363;66271;495;0;0;0;0;.00nan;0;0
13363;148508;495;67;29;3;26;.897;3515000;0
13364;6603;2591;76;27;2;25;.926;3900000;0
13364;174898;2591;0;0;0;0;.00nan;0;0
13364;81085;496;0;0;0;0;.00nan;0;0
13364;148573;496;80;30;2;28;.933;3900000;0
13365;1756;500;48;31;5;26;.839;3600000;0
13365;180188;502;0;0;0;0;.00nan;0;0
13365;63707;500;0;0;0;0;.00nan;0;0
13365;152624;502;100;38;0;38;1.000;3600000;0
13366;177356;4636;0;0;0;0;.00nan;0;0
13366;167480;503;0;0;0;0;.00nan;0;0
13366;170536;503;97;40;2;38;.950;3900000;0
13366;148503;4636;82;31;2;29;.935;3900000;0
13367;1061;505;79;26;1;25;.962;3600000;0
13367;187813;499;0;0;0;0;.00nan;0;0
13367;175593;499;100;32;0;32;1.000;3600000;0
13367;43730;505;0;0;0;0;.00nan;0;0
13368;615;497;73;31;4;27;.871;3600000;0
13368;49674;498;79;23;1;22;.957;3600000;0
13368;142810;497;0;0;0;0;.00nan;0;0
13368;148691;498;0;0;0;0;.00nan;0;0
13369;177356;4636;0;0;0;0;.00nan;0;0
13369;66271;495;100;28;1;27;.964;3900000;0
13369;148503;4636;97;42;1;41;.976;3900000;0
13369;148508;495;0;0;0;0;.00nan;0;0
13370;187813;499;0;0;0;0;.00nan;0;0
13370;175593;499;77;28;2;26;.929;3600000;0
13370;81085;496;0;0;0;0;.00nan;0;0
13370;148573;496;77;37;3;34;.919;3600000;0
13371;615;497;82;40;3;37;.925;3600000;0
13371;180188;502;0;0;0;0;.00nan;0;0
13371;142810;497;0;0;0;0;.00nan;0;0
13371;152624;502;96;22;0;22;1.000;3600000;0
13372;1061;505;76;29;2;27;.931;3600000;0
13372;167480;503;0;0;0;0;.00nan;0;0
13372;170536;503;67;39;4;35;.897;3546000;0
13372;43730;505;0;0;0;0;.00nan;0;0
13373;1756;500;0;0;0;0;.00nan;0;0
13373;-1;504;0;0;0;0;.00nan;0;0
13373;-1;504;79;29;2;27;.931;3725000;0
13373;63707;500;81;41;3;38;.927;3725000;0
13374;6603;2591;69;41;4;37;.902;3600000;0
13374;174898;2591;0;0;0;0;.00nan;0;0
13374;49674;498;0;0;0;0;.00nan;0;0
13374;148691;498;87;18;0;18;1.000;3600000;0
13375;177356;4636;0;0;0;0;.00nan;0;0
13375;66271;495;0;0;0;0;.00nan;0;0
13375;148503;4636;76;26;1;25;.962;3600000;0
13375;148508;495;100;23;0;23;1.000;3600000;0
13376;187813;499;0;0;0;0;.00nan;0;0
13376;175593;499;51;39;5;34;.872;3600000;0
13376;81085;496;84;33;2;31;.939;3600000;0
13376;148573;496;0;0;0;0;.00nan;0;0
13377;615;497;0;0;0;0;.00nan;0;0
13377;180188;502;0;0;0;0;.00nan;0;0
13377;142810;497;97;33;1;32;.970;3600000;0
13377;152624;502;45;16;3;13;.813;3514000;0
13378;1061;505;68;26;2;24;.923;3600000;0
13378;167480;503;0;0;0;0;.00nan;0;0
13378;170536;503;91;40;3;37;.925;3577000;0
13378;43730;505;0;0;0;0;.00nan;0;0
13379;1756;500;43;36;5;31;.861;3595000;0
13379;-1;504;58;23;3;20;.870;3600000;0
13379;-1;504;0;0;0;0;.00nan;0;0
13379;63707;500;0;0;0;0;.00nan;0;0
13380;6603;2591;99;36;2;34;.944;3600000;0
13380;174898;2591;0;0;0;0;.00nan;0;0
13380;49674;498;0;0;0;0;.00nan;0;0
13380;148691;498;48;20;3;17;.850;3551000;0
13381;615;497;88;29;1;28;.966;3546000;0
13381;-1;504;0;0;0;0;.00nan;0;0
13381;-1;504;100;31;0;31;1.000;3600000;0
13381;142810;497;0;0;0;0;.00nan;0;0
13382;187813;499;100;33;1;32;.970;3900000;0
13382;6603;2591;85;28;1;27;.964;3900000;0
13382;174898;2591;0;0;0;0;.00nan;0;0
13382;175593;499;0;0;0;0;.00nan;0;0
13383;180188;502;0;0;0;0;.00nan;0;0
13383;49674;498;0;0;0;0;.00nan;0;0
13383;148691;498;79;40;3;37;.925;3528000;0
13383;152624;502;99;37;1;36;.973;3600000;0
13384;1756;500;0;0;0;0;.00nan;0;0
13384;177356;4636;0;0;0;0;.00nan;0;0
13384;63707;500;59;25;3;22;.880;3599000;0
13384;148503;4636;91;37;2;35;.946;3600000;0
13385;1061;505;43;35;6;29;.829;3600000;0
13385;43730;505;0;0;0;0;.00nan;0;0
13385;66271;495;0;0;0;0;.00nan;0;0
13385;148508;495;92;21;0;21;1.000;3600000;0
13386;167480;503;0;0;0;0;.00nan;0;0
13386;170536;503;78;36;3;33;.917;3900000;0
13386;81085;496;64;27;3;24;.889;3866000;0
13386;148573;496;0;0;0;0;.00nan;0;0
13387;615;497;58;27;3;24;.889;3577000;0
13387;-1;504;0;0;0;0;.00nan;0;0
13387;-1;504;100;41;1;40;.976;3600000;0
13387;142810;497;0;0;0;0;.00nan;0;0
13388;187813;499;0;0;0;0;.00nan;0;0
13388;6603;2591;84;41;3;38;.927;3556000;0
13388;174898;2591;0;0;0;0;.00nan;0;0
13388;175593;499;77;33;2;31;.939;3600000;0
13389;180188;502;0;0;0;0;.00nan;0;0
13389;49674;498;0;0;0;0;.00nan;0;0
13389;148691;498;92;36;2;34;.944;3753000;0
13389;152624;502;69;19;1;18;.947;3753000;0
13390;1756;500;0;0;0;0;.00nan;0;0
13390;177356;4636;0;0;0;0;.00nan;0;0
13390;63707;500;79;25;1;24;.960;3600000;0
13390;148503;4636;68;23;2;21;.913;3594000;0
13391;1061;505;52;21;3;18;.857;3600000;0
13391;43730;505;0;0;0;0;.00nan;0;0
13391;66271;495;0;0;0;0;.00nan;0;0
13391;148508;495;87;35;2;33;.943;3600000;0
13392;167480;503;0;0;0;0;.00nan;0;0
13392;170536;503;90;29;1;28;.966;3900000;0
13392;81085;496;87;32;1;31;.969;3900000;0
13392;148573;496;0;0;0;0;.00nan;0;0
13393;-1;504;85;31;1;30;.968;3600000;0
13393;-1;504;0;0;0;0;.00nan;0;0
13393;49674;498;0;0;0;0;.00nan;0;0
13393;148691;498;86;33;2;31;.939;3545000;0
13394;615;497;97;43;1;42;.977;3900000;0
13394;177356;4636;0;0;0;0;.00nan;0;0
13394;142810;497;0;0;0;0;.00nan;0;0
13394;148503;4636;90;34;1;33;.971;3900000;0
13395;6603;2591;84;35;2;33;.943;3593000;0
13395;174898;2591;0;0;0;0;.00nan;0;0
13395;180188;502;0;0;0;0;.00nan;0;0
13395;152624;502;81;26;1;25;.962;3600000;0
13396;187813;499;0;0;0;0;.00nan;0;0
13396;167480;503;0;0;0;0;.00nan;0;0
13396;170536;503;85;36;2;34;.944;3516000;0
13396;175593;499;92;26;0;26;1.000;3600000;0
13397;66271;495;0;0;0;0;.00nan;0;0
13397;81085;496;100;42;1;41;.976;3600000;0
13397;148508;495;51;23;3;20;.870;3512000;0
13397;148573;496;0;0;0;0;.00nan;0;0
13398;1061;505;79;30;2;28;.933;3600000;0
13398;1756;500;0;0;0;0;.00nan;0;0
13398;43730;505;0;0;0;0;.00nan;0;0
13398;63707;500;46;30;5;25;.833;3600000;0
13399;-1;504;97;39;1;38;.974;3600000;0
13399;-1;504;0;0;0;0;.00nan;0;0
13399;49674;498;46;14;2;12;.857;3569000;0
13399;148691;498;0;0;0;0;.00nan;0;0
13400;615;497;83;24;1;23;.958;3600000;0
13400;177356;4636;0;0;0;0;.00nan;0;0
13400;142810;497;0;0;0;0;.00nan;0;0
13400;148503;4636;69;25;2;23;.920;3564000;0
13401;6603;2591;71;34;3;31;.912;3600000;0
13401;174898;2591;0;0;0;0;.00nan;0;0
13401;180188;502;0;0;0;0;.00nan;0;0
13401;152624;502;75;38;4;34;.895;3558000;0
13402;187813;499;0;0;0;0;.00nan;0;0
13402;167480;503;0;0;0;0;.00nan;0;0
13402;170536;503;84;29;1;28;.966;3600000;0
13402;175593;499;71;26;2;24;.923;3591000;0
13403;66271;495;0;0;0;0;.00nan;0;0
13403;81085;496;91;30;1;29;.967;3600000;0
13403;148508;495;91;47;3;44;.936;3563000;0
13403;148573;496;0;0;0;0;.00nan;0;0
13404;1061;505;67;29;3;26;.897;3599000;0
13404;1756;500;90;42;2;40;.952;3600000;0
13404;43730;505;0;0;0;0;.00nan;0;0
13404;63707;500;0;0;0;0;.00nan;0;0
13405;6603;2591;100;34;0;34;1.000;3600000;0
13405;167480;503;0;0;0;0;.00nan;0;0
13405;170536;503;59;22;3;19;.864;3600000;0
13405;174898;2591;0;0;0;0;.00nan;0;0
13406;177356;4636;66;34;3;31;.912;3600000;0
13406;49674;498;0;0;0;0;.00nan;0;0
13406;148503;4636;0;0;0;0;.00nan;0;0
13406;148691;498;97;20;0;20;1.000;3600000;0
13407;-1;504;70;38;4;34;.895;3600000;0
13407;-1;504;0;0;0;0;.00nan;0;0
13407;180188;502;47;5;1;4;.800;366000;0
13407;152624;502;47;37;6;31;.838;3234000;0
13408;615;497;86;31;1;30;.968;3600000;0
13408;1061;505;55;18;2;16;.889;3566000;0
13408;43730;505;0;0;0;0;.00nan;0;0
13408;142810;497;0;0;0;0;.00nan;0;0
13409;187813;499;0;0;0;0;.00nan;0;0
13409;175593;499;66;23;2;21;.913;3610000;0
13409;66271;495;0;0;0;0;.00nan;0;0
13409;148508;495;95;38;1;37;.974;3610000;0
13410;1756;500;62;30;3;27;.900;3554000;0
13410;63707;500;0;0;0;0;.00nan;0;0
13410;81085;496;83;20;1;19;.950;3600000;0
13410;148573;496;0;0;0;0;.00nan;0;0
13411;6603;2591;39;14;3;11;.786;3600000;0
13411;167480;503;0;0;0;0;.00nan;0;0
13411;170536;503;69;42;5;37;.881;3590000;0
13411;174898;2591;0;0;0;0;.00nan;0;0
13412;177356;4636;0;0;0;0;.00nan;0;0
13412;49674;498;0;0;0;0;.00nan;0;0
13412;148503;4636;90;33;1;32;.970;3600000;0
13412;148691;498;61;19;2;17;.895;3543000;0
13413;-1;504;0;0;0;0;.00nan;0;0
13413;-1;504;86;28;1;27;.964;3808000;0
13413;180188;502;0;0;0;0;.00nan;0;0
13413;152624;502;79;35;2;33;.943;3808000;0
13414;615;497;67;39;4;35;.897;3600000;0
13414;1061;505;94;19;0;19;1.000;3600000;0
13414;43730;505;0;0;0;0;.00nan;0;0
13414;142810;497;0;0;0;0;.00nan;0;0
13415;187813;499;0;0;0;0;.00nan;0;0
13415;175593;499;68;20;1;19;.950;3548000;0
13415;66271;495;0;0;0;0;.00nan;0;0
13415;148508;495;100;42;0;42;1.000;3600000;0
13416;1756;500;53;40;5;35;.875;3600000;0
13416;63707;500;0;0;0;0;.00nan;0;0
13416;81085;496;65;25;2;23;.920;3600000;0
13416;148573;496;0;0;0;0;.00nan;0;0
13417;66271;495;0;0;0;0;.00nan;0;0
13417;81085;496;80;32;2;30;.938;3600000;0
13417;148508;495;50;21;3;18;.857;3549000;0
13417;148573;496;0;0;0;0;.00nan;0;0
13418;1756;500;49;27;4;23;.852;3900000;0
13418;187813;499;0;0;0;0;.00nan;0;0
13418;175593;499;64;38;4;34;.895;3900000;0
13418;63707;500;0;0;0;0;.00nan;0;0
13419;615;497;46;37;5;32;.865;3600000;0
13419;180188;502;0;0;0;0;.00nan;0;0
13419;142810;497;0;0;0;0;.00nan;0;0
13419;152624;502;74;22;1;21;.955;3600000;0
13420;177356;4636;0;0;0;0;.00nan;0;0
13420;167480;503;0;0;0;0;.00nan;0;0
13420;170536;503;82;36;2;34;.944;3900000;0
13420;148503;4636;100;38;2;36;.947;3900000;0
13421;1061;505;51;25;3;22;.880;3600000;0
13421;43730;505;0;0;0;0;.00nan;0;0
13421;49674;498;0;0;0;0;.00nan;0;0
13421;148691;498;58;31;4;27;.871;3568000;0
13422;6603;2591;0;0;0;0;.00nan;0;0
13422;174898;2591;82;32;1;31;.969;3900000;0
13422;-1;504;96;49;1;48;.980;3900000;0
13422;-1;504;0;0;0;0;.00nan;0;0
13423;1756;500;73;48;5;43;.896;3600000;0
13423;63707;500;0;0;0;0;.00nan;0;0
13423;66271;495;0;0;0;0;.00nan;0;0
13423;148508;495;79;21;1;20;.952;3600000;0
13424;615;497;100;31;0;31;1.000;3600000;0
13424;187813;499;71;29;3;26;.897;3600000;0
13424;175593;499;0;0;0;0;.00nan;0;0
13424;142810;497;0;0;0;0;.00nan;0;0
13425;180188;502;0;0;0;0;.00nan;0;0
13425;81085;496;76;20;1;19;.950;3600000;0
13425;148573;496;0;0;0;0;.00nan;0;0
13425;152624;502;61;33;3;30;.909;3591000;0
13426;177356;4636;0;0;0;0;.00nan;0;0
13426;-1;504;0;0;0;0;.00nan;0;0
13426;-1;504;94;37;2;35;.946;3900000;0
13426;148503;4636;84;27;2;25;.926;3900000;0
13427;167480;503;0;0;0;0;.00nan;0;0
13427;170536;503;58;38;5;33;.868;3600000;0
13427;49674;498;72;23;1;22;.957;3600000;0
13427;148691;498;0;0;0;0;.00nan;0;0
13428;1061;505;100;40;1;39;.975;3600000;0
13428;6603;2591;95;38;2;36;.947;3589000;0
13428;174898;2591;0;0;0;0;.00nan;0;0
13428;43730;505;0;0;0;0;.00nan;0;0
13429;615;497;80;36;3;33;.917;3554000;0
13429;66271;495;64;22;2;20;.909;3600000;0
13429;142810;497;0;0;0;0;.00nan;0;0
13429;148508;495;0;0;0;0;.00nan;0;0
13430;187813;499;0;0;0;0;.00nan;0;0
13430;175593;499;69;28;3;25;.893;3542000;0
13430;81085;496;84;35;2;33;.943;3600000;0
13430;148573;496;0;0;0;0;.00nan;0;0
13431;1756;500;55;28;4;24;.857;3579000;0
13431;180188;502;0;0;0;0;.00nan;0;0
13431;63707;500;0;0;0;0;.00nan;0;0
13431;152624;502;71;23;2;21;.913;3600000;0
13432;1061;505;64;18;2;16;.889;3600000;0
13432;177356;4636;0;0;0;0;.00nan;0;0
13432;43730;505;0;0;0;0;.00nan;0;0
13432;148503;4636;55;23;3;20;.870;3579000;0
13433;-1;504;66;34;4;30;.882;3600000;0
13433;-1;504;0;0;0;0;.00nan;0;0
13433;49674;498;0;0;0;0;.00nan;0;0
13433;148691;498;76;22;1;21;.955;3600000;0
13434;6603;2591;100;27;0;27;1.000;3600000;0
13434;167480;503;0;0;0;0;.00nan;0;0
13434;170536;503;68;25;2;23;.920;3554000;0
13434;174898;2591;0;0;0;0;.00nan;0;0
13435;1756;500;0;0;0;0;.00nan;0;0
13435;49674;498;0;0;0;0;.00nan;0;0
13435;63707;500;74;33;3;30;.909;3556000;0
13435;148691;498;89;34;2;32;.941;3600000;0
13436;6603;2591;89;34;1;33;.971;3900000;0
13436;174898;2591;0;0;0;0;.00nan;0;0
13436;81085;496;78;28;1;27;.964;3900000;0
13436;148573;496;0;0;0;0;.00nan;0;0
13437;615;497;64;19;2;17;.895;3900000;0
13437;177356;4636;0;0;0;0;.00nan;0;0
13437;142810;497;0;0;0;0;.00nan;0;0
13437;148503;4636;58;21;2;19;.905;3900000;0
13438;167480;503;0;0;0;0;.00nan;0;0
13438;170536;503;68;30;3;27;.900;3531000;0
13438;66271;495;0;0;0;0;.00nan;0;0
13438;148508;495;63;17;1;16;.941;3600000;0
13439;1061;505;0;0;0;0;.00nan;0;0
13439;187813;499;0;0;0;0;.00nan;0;0
13439;175593;499;100;32;0;32;1.000;3600000;0
13439;43730;505;52;28;4;24;.857;3600000;0
13440;-1;504;0;0;0;0;.00nan;0;0
13440;-1;504;50;31;5;26;.839;3556000;0
13440;180188;502;0;0;0;0;.00nan;0;0
13440;152624;502;71;44;4;40;.909;3600000;0
13441;1756;500;92;32;2;30;.938;3635000;0
13441;177356;4636;0;0;0;0;.00nan;0;0
13441;63707;500;0;0;0;0;.00nan;0;0
13441;148503;4636;89;27;1;26;.963;3635000;0
13442;49674;498;68;29;3;26;.897;3585000;0
13442;81085;496;100;37;1;36;.973;3600000;0
13442;148573;496;0;0;0;0;.00nan;0;0
13442;148691;498;0;0;0;0;.00nan;0;0
13443;615;497;63;34;4;30;.882;3600000;0
13443;6603;2591;96;24;0;24;1.000;3600000;0
13443;174898;2591;0;0;0;0;.00nan;0;0
13443;142810;497;0;0;0;0;.00nan;0;0
13444;167480;503;58;32;4;28;.875;3547000;0
13444;170536;503;0;0;0;0;.00nan;0;0
13444;180188;502;0;0;0;0;.00nan;0;0
13444;152624;502;73;31;3;28;.903;3600000;0
13445;1061;505;72;22;2;20;.909;3639000;0
13445;43730;505;0;0;0;0;.00nan;0;0
13445;66271;495;0;0;0;0;.00nan;0;0
13445;148508;495;85;35;3;32;.914;3639000;0
13446;187813;499;0;0;0;0;.00nan;0;0
13446;175593;499;73;39;4;35;.897;3599000;0
13446;-1;504;66;23;2;21;.913;3600000;0
13446;-1;504;0;0;0;0;.00nan;0;0
13447;1756;500;76;41;4;37;.902;3524000;0
13447;6603;2591;100;40;2;38;.950;3600000;0
13447;174898;2591;0;0;0;0;.00nan;0;0
13447;63707;500;0;0;0;0;.00nan;0;0
13448;177356;4636;0;0;0;0;.00nan;0;0
13448;81085;496;70;29;3;26;.897;3600000;0
13448;148503;4636;97;25;0;25;1.000;3600000;0
13448;148573;496;0;0;0;0;.00nan;0;0
13449;615;497;87;26;1;25;.962;3600000;0
13449;49674;498;0;0;0;0;.00nan;0;0
13449;142810;497;0;0;0;0;.00nan;0;0
13449;148691;498;54;29;4;25;.862;3600000;0
13450;187813;499;0;0;0;0;.00nan;0;0
13450;167480;503;0;0;0;0;.00nan;0;0
13450;170536;503;76;34;3;31;.912;3600000;0
13450;175593;499;39;32;5;27;.844;3600000;0
13451;1061;505;100;32;0;32;1.000;3600000;0
13451;180188;502;0;0;0;0;.00nan;0;0
13451;43730;505;0;0;0;0;.00nan;0;0
13451;152624;502;35;33;6;27;.818;3600000;0
13452;-1;504;0;0;0;0;.00nan;0;0
13452;-1;504;100;32;0;32;1.000;3600000;0
13452;66271;495;0;0;0;0;.00nan;0;0
13452;148508;495;70;39;4;35;.897;3600000;0
13453;1061;505;82;25;1;24;.960;3600000;0
13453;167480;503;0;0;0;0;.00nan;0;0
13453;170536;503;82;41;3;38;.927;3600000;0
13453;43730;505;0;0;0;0;.00nan;0;0
13454;1756;500;0;0;0;0;.00nan;0;0
13454;-1;504;79;31;2;29;.935;3600000;0
13454;-1;504;0;0;0;0;.00nan;0;0
13454;63707;500;67;38;4;34;.895;3577000;0
13455;615;497;96;42;1;41;.976;3900000;0
13455;81085;496;0;0;0;0;.00nan;0;0
13455;142810;497;0;0;0;0;.00nan;0;0
13455;148573;496;95;33;1;32;.970;3900000;0
13456;177356;4636;0;0;0;0;.00nan;0;0
13456;180188;502;0;0;0;0;.00nan;0;0
13456;148503;4636;60;18;2;16;.889;3600000;0
13456;152624;502;92;34;1;33;.971;3600000;0
13457;49674;498;0;0;0;0;.00nan;0;0
13457;66271;495;0;0;0;0;.00nan;0;0
13457;148508;495;69;35;4;31;.886;3548000;0
13457;148691;498;56;28;3;25;.893;3600000;0
13458;187813;499;60;9;0;9;1.000;942000;0
13458;6603;2591;100;21;0;21;1.000;3600000;0
13458;174898;2591;0;0;0;0;.00nan;0;0
13458;175593;499;43;32;6;26;.813;2658000;0
13459;1756;500;100;38;0;38;1.000;3900000;0
13459;167480;503;0;0;0;0;.00nan;0;0
13459;170536;503;98;35;0;35;1.000;3900000;0
13459;63707;500;0;0;0;0;.00nan;0;0
13460;1061;505;60;23;2;21;.913;3596000;0
13460;43730;505;0;0;0;0;.00nan;0;0
13460;81085;496;91;34;1;33;.971;3600000;0
13460;148573;496;0;0;0;0;.00nan;0;0
13461;615;497;73;23;2;21;.913;3600000;0
13461;-1;504;0;0;0;0;.00nan;0;0
13461;-1;504;51;34;5;29;.853;3600000;0
13461;142810;497;0;0;0;0;.00nan;0;0
13462;187813;499;0;0;0;0;.00nan;0;0
13462;175593;499;87;37;2;35;.946;3567000;0
13462;66271;495;0;0;0;0;.00nan;0;0
13462;148508;495;92;31;1;30;.968;3600000;0
13463;177356;4636;0;0;0;0;.00nan;0;0
13463;49674;498;0;0;0;0;.00nan;0;0
13463;148503;4636;66;24;2;22;.917;3600000;0
13463;148691;498;93;27;0;27;1.000;3600000;0
13464;6603;2591;68;31;2;29;.935;3900000;0
13464;174898;2591;0;0;0;0;.00nan;0;0
13464;180188;502;0;0;0;0;.00nan;0;0
13464;152624;502;72;23;2;21;.913;3900000;0
13465;615;497;61;22;2;20;.909;3600000;0
13465;167480;503;0;0;0;0;.00nan;0;0
13465;170536;503;57;40;5;35;.875;3600000;0
13465;142810;497;0;0;0;0;.00nan;0;0
13466;1061;505;71;23;1;22;.957;3868000;0
13466;1756;500;91;36;2;34;.944;3868000;0
13466;43730;505;0;0;0;0;.00nan;0;0
13466;63707;500;0;0;0;0;.00nan;0;0
13467;-1;504;84;32;1;31;.969;3600000;0
13467;-1;504;0;0;0;0;.00nan;0;0
13467;81085;496;82;42;3;39;.929;3600000;0
13467;148573;496;0;0;0;0;.00nan;0;0
13468;180188;502;0;0;0;0;.00nan;0;0
13468;66271;495;0;0;0;0;.00nan;0;0
13468;148508;495;100;29;0;29;1.000;3600000;0
13468;152624;502;75;38;3;35;.921;3600000;0
13469;187813;499;81;39;3;36;.923;3623000;0
13469;175593;499;0;0;0;0;.00nan;0;0
13469;49674;498;0;0;0;0;.00nan;0;0
13469;148691;498;59;21;2;19;.905;3623000;0
13470;177356;4636;0;0;0;0;.00nan;0;0
13470;6603;2591;0;0;0;0;.00nan;0;0
13470;174898;2591;61;21;2;19;.905;3559000;0
13470;148503;4636;80;24;1;23;.958;3600000;0
13471;167480;503;0;0;0;0;.00nan;0;0
13471;170536;503;76;39;3;36;.923;3600000;0
13471;-1;504;88;23;0;23;1.000;3600000;0
13471;-1;504;0;0;0;0;.00nan;0;0
13472;1756;500;72;47;5;42;.894;3600000;0
13472;63707;500;0;0;0;0;.00nan;0;0
13472;81085;496;80;26;1;25;.962;3600000;0
13472;148573;496;0;0;0;0;.00nan;0;0
13473;615;497;72;37;4;33;.892;3600000;0
13473;1061;505;82;24;1;23;.958;3600000;0
13473;43730;505;0;0;0;0;.00nan;0;0
13473;142810;497;0;0;0;0;.00nan;0;0
13474;187813;499;0;0;0;0;.00nan;0;0
13474;177356;4636;0;0;0;0;.00nan;0;0
13474;175593;499;83;32;1;31;.969;3900000;0
13474;148503;4636;94;31;1;30;.968;3900000;0
13475;180188;502;0;0;0;0;.00nan;0;0
13475;49674;498;0;0;0;0;.00nan;0;0
13475;148691;498;68;31;3;28;.903;3600000;0
13475;152624;502;100;34;0;34;1.000;3600000;0
13476;6603;2591;53;38;5;33;.868;3861000;0
13476;174898;2591;0;0;0;0;.00nan;0;0
13476;66271;495;0;0;0;0;.00nan;0;0
13476;148508;495;69;35;4;31;.886;3861000;0
13477;1061;505;69;35;3;32;.914;3600000;0
13477;-1;504;0;0;0;0;.00nan;0;0
13477;-1;504;94;17;0;17;1.000;3600000;0
13477;43730;505;0;0;0;0;.00nan;0;0
13478;167480;503;0;0;0;0;.00nan;0;0
13478;170536;503;73;39;4;35;.897;3574000;0
13478;81085;496;46;18;3;15;.833;3600000;0
13478;148573;496;0;0;0;0;.00nan;0;0
13479;615;497;72;34;3;31;.912;3600000;0
13479;1756;500;100;34;0;34;1.000;3600000;0
13479;63707;500;0;0;0;0;.00nan;0;0
13479;142810;497;0;0;0;0;.00nan;0;0
13480;177356;4636;61;44;5;39;.886;3600000;0
13480;66271;495;0;0;0;0;.00nan;0;0
13480;148503;4636;0;0;0;0;.00nan;0;0
13480;148508;495;63;21;2;19;.905;3600000;0
13481;187813;499;0;0;0;0;.00nan;0;0
13481;175593;499;87;34;2;32;.941;3900000;0
13481;180188;502;0;0;0;0;.00nan;0;0
13481;152624;502;69;28;2;26;.929;3900000;0
13482;6603;2591;0;0;0;0;.00nan;0;0
13482;174898;2591;86;29;2;27;.931;3600000;0
13482;49674;498;0;0;0;0;.00nan;0;0
13482;148691;498;84;46;4;42;.913;3600000;0
13483;177356;4636;0;0;0;0;.00nan;0;0
13483;180188;502;0;0;0;0;.00nan;0;0
13483;148503;4636;95;34;1;33;.971;3600000;0
13483;152624;502;67;29;3;26;.897;3576000;0
13484;1061;505;100;28;0;28;1.000;3600000;0
13484;43730;505;0;0;0;0;.00nan;0;0
13484;49674;498;0;0;0;0;.00nan;0;0
13484;148691;498;38;21;4;17;.810;3600000;0
13485;6603;2591;77;23;1;22;.957;3600000;0
13485;174898;2591;0;0;0;0;.00nan;0;0
13485;-1;504;73;39;3;36;.923;3600000;0
13485;-1;504;0;0;0;0;.00nan;0;0
13486;167480;503;0;0;0;0;.00nan;0;0
13486;170536;503;65;46;6;40;.870;3600000;0
13486;66271;495;0;0;0;0;.00nan;0;0
13486;148508;495;94;30;1;29;.967;3600000;0
13487;1756;500;82;36;2;34;.944;3600000;0
13487;187813;499;67;31;3;28;.903;3545000;0
13487;175593;499;0;0;0;0;.00nan;0;0
13487;63707;500;0;0;0;0;.00nan;0;0
13488;615;497;66;33;3;30;.909;3600000;0
13488;81085;496;35;26;5;21;.808;3552000;0
13488;142810;497;0;0;0;0;.00nan;0;0
13488;148573;496;0;0;0;0;.00nan;0;0
13490;1061;505;100;21;0;21;1.000;3600000;0
13490;-1;497;0;0;0;0;.00nan;0;0
13490;43730;505;0;0;0;0;.00nan;0;0
13490;142810;497;73;30;2;28;.933;3553000;0
13492;187813;499;0;0;0;0;.00nan;0;0
13492;175593;499;73;24;2;22;.917;3900000;0
13492;81085;496;0;0;0;0;.00nan;0;0
13492;148573;496;70;28;2;26;.929;3900000;0
13494;6603;2591;0;0;0;0;.00nan;0;0
13494;174898;2591;67;31;3;28;.903;3600000;0
13494;-1;504;43;42;6;36;.857;3600000;0
13494;-1;504;0;0;0;0;.00nan;0;0
13496;197409;502;0;0;0;0;.00nan;0;0
13496;66271;495;0;0;0;0;.00nan;0;0
13496;148508;495;90;36;2;34;.944;3584000;0
13496;152624;502;100;18;0;18;1.000;3600000;0
13498;1756;500;66;27;3;24;.889;3560000;0
13498;167480;503;0;0;0;0;.00nan;0;0
13498;170536;503;91;41;2;39;.951;3600000;0
13498;63707;500;0;0;0;0;.00nan;0;0
13500;177356;4636;0;0;0;0;.00nan;0;0
13500;49674;498;0;0;0;0;.00nan;0;0
13500;148503;4636;96;37;1;36;.973;3600000;0
13500;148691;498;73;24;2;22;.917;3580000;0
13502;-1;497;100;43;2;41;.953;3600000;0
13502;49674;498;57;32;4;28;.875;3541000;0
13502;142810;497;0;0;0;0;.00nan;0;0
13502;148691;498;0;0;0;0;.00nan;0;0
13504;187813;499;75;39;3;36;.923;3600000;0
13504;175593;499;0;0;0;0;.00nan;0;0
13504;66271;495;96;23;0;23;1.000;3600000;0
13504;148508;495;0;0;0;0;.00nan;0;0
13506;1061;505;100;31;0;31;1.000;3600000;0
13506;-1;504;0;0;0;0;.00nan;0;0
13506;-1;504;49;23;3;20;.870;3600000;0
13506;43730;505;0;0;0;0;.00nan;0;0
13508;177356;4636;64;30;3;27;.900;3554000;0
13508;6603;2591;71;22;1;21;.955;3600000;0
13508;174898;2591;0;0;0;0;.00nan;0;0
13508;148503;4636;0;0;0;0;.00nan;0;0
13510;1756;500;0;0;0;0;.00nan;0;0
13510;167480;503;98;39;1;38;.974;3600000;0
13510;170536;503;0;0;0;0;.00nan;0;0
13510;63707;500;52;24;3;21;.875;3587000;0
13512;197409;502;0;0;0;0;.00nan;0;0
13512;81085;496;74;24;1;23;.958;3553000;0
13512;148573;496;0;0;0;0;.00nan;0;0
13512;152624;502;100;27;0;27;1.000;3600000;0
13514;187813;499;0;0;0;0;.00nan;0;0
13514;175593;499;89;51;2;49;.961;3545000;0
13514;197409;502;0;0;0;0;.00nan;0;0
13514;152624;502;73;18;1;17;.944;3600000;0
13516;1756;500;0;0;0;0;.00nan;0;0
13516;-1;497;0;0;0;0;.00nan;0;0
13516;63707;500;77;33;2;31;.939;3517000;0
13516;142810;497;100;20;0;20;1.000;3600000;0
13518;177356;4636;0;0;0;0;.00nan;0;0
13518;81085;496;0;0;0;0;.00nan;0;0
13518;148503;4636;79;28;2;26;.929;3600000;0
13518;148573;496;83;24;1;23;.958;3600000;0
13520;-1;504;47;33;5;28;.848;3561000;0
13520;-1;504;0;0;0;0;.00nan;0;0
13520;49674;498;0;0;0;0;.00nan;0;0
13520;148691;498;65;37;4;33;.892;3600000;0
13522;167480;503;0;0;0;0;.00nan;0;0
13522;170536;503;70;35;5;30;.857;3559000;0
13522;66271;495;59;15;3;12;.800;3600000;0
13522;148508;495;0;0;0;0;.00nan;0;0
13524;1061;505;45;38;6;32;.842;3541000;0
13524;6603;2591;66;36;4;32;.889;3600000;0
13524;174898;2591;0;0;0;0;.00nan;0;0
13524;43730;505;0;0;0;0;.00nan;0;0
13526;1756;500;100;40;0;40;1.000;3600000;0
13526;-1;497;0;0;0;0;.00nan;0;0
13526;63707;500;0;0;0;0;.00nan;0;0
13526;142810;497;89;38;1;37;.974;3595000;0
13528;187813;499;77;30;2;28;.933;3600000;0
13528;175593;499;0;0;0;0;.00nan;0;0
13528;-1;504;0;0;0;0;.00nan;0;0
13528;-1;504;64;28;3;25;.893;3564000;0
13530;167480;503;36;21;5;16;.762;1710000;0
13530;170536;503;51;22;3;19;.864;1890000;0
13530;197409;502;0;0;0;0;.00nan;0;0
13530;152624;502;67;21;2;19;.905;3600000;0
13532;49674;498;65;37;5;32;.865;3900000;0
13532;81085;496;30;9;3;6;.667;571000;0
13532;148573;496;70;24;2;22;.917;3329000;0
13532;148691;498;0;0;0;0;.00nan;0;0
13534;6603;2591;0;0;0;0;.00nan;0;0
13534;174898;2591;82;29;1;28;.966;3600000;0
13534;66271;495;0;0;0;0;.00nan;0;0
13534;148508;495;80;33;2;31;.939;3564000;0
13536;1061;505;0;0;0;0;.00nan;0;0
13536;177356;4636;75;22;1;21;.955;3600000;0
13536;43730;505;81;31;2;29;.935;3600000;0
13536;148503;4636;0;0;0;0;.00nan;0;0
13538;-1;497;0;0;0;0;.00nan;0;0
13538;-1;504;72;30;2;28;.933;3600000;0
13538;-1;504;0;0;0;0;.00nan;0;0
13538;142810;497;58;29;3;26;.897;3560000;0
13540;197409;502;0;0;0;0;.00nan;0;0
13540;66271;495;0;0;0;0;.00nan;0;0
13540;148508;495;41;26;5;21;.808;3649000;0
13540;152624;502;48;26;4;22;.846;3649000;0
13542;187813;499;77;42;4;38;.905;3600000;0
13542;6603;2591;78;27;1;26;.963;3600000;0
13542;174898;2591;0;0;0;0;.00nan;0;0
13542;175593;499;0;0;0;0;.00nan;0;0
13544;177356;4636;0;0;0;0;.00nan;0;0
13544;81085;496;0;0;0;0;.00nan;0;0
13544;148503;4636;89;31;1;30;.968;3600000;0
13544;148573;496;48;15;2;13;.867;3567000;0
13546;1756;500;70;25;1;24;.960;3600000;0
13546;49674;498;0;0;0;0;.00nan;0;0
13546;63707;500;0;0;0;0;.00nan;0;0
13546;148691;498;100;31;0;31;1.000;3600000;0
13548;1061;505;75;31;2;29;.935;3559000;0
13548;167480;503;0;0;0;0;.00nan;0;0
13548;170536;503;83;27;1;26;.963;3600000;0
13548;43730;505;0;0;0;0;.00nan;0;0
13550;6603;2591;67;24;2;22;.917;3583000;0
13550;-1;497;0;0;0;0;.00nan;0;0
13550;174898;2591;0;0;0;0;.00nan;0;0
13550;142810;497;75;23;1;22;.957;3600000;0
13552;177356;4636;0;0;0;0;.00nan;0;0
13552;197409;502;0;0;0;0;.00nan;0;0
13552;148503;4636;53;42;6;36;.857;3600000;0
13552;152624;502;69;24;2;22;.917;3600000;0
13554;-1;504;0;0;0;0;.00nan;0;0
13554;-1;504;76;23;1;22;.957;3600000;0
13554;49674;498;0;0;0;0;.00nan;0;0
13554;148691;498;50;38;5;33;.868;3600000;0
13556;187813;499;84;28;1;27;.964;3600000;0
13556;167480;503;0;0;0;0;.00nan;0;0
13556;170536;503;90;31;2;29;.935;3570000;0
13556;175593;499;0;0;0;0;.00nan;0;0
13558;1061;505;76;24;1;23;.958;3600000;0
13558;43730;505;0;0;0;0;.00nan;0;0
13558;81085;496;0;0;0;0;.00nan;0;0
13558;148573;496;64;25;2;23;.920;3600000;0
13560;1756;500;98;44;2;42;.955;3556000;0
13560;63707;500;0;0;0;0;.00nan;0;0
13560;66271;495;90;37;1;36;.973;3600000;0
13560;148508;495;0;0;0;0;.00nan;0;0
13562;197409;502;62;30;3;27;.900;3545000;0
13562;66271;495;0;0;0;0;.00nan;0;0
13562;148508;495;91;33;2;31;.939;3600000;0
13562;152624;502;0;0;0;0;.00nan;0;0
13564;167480;503;94;32;1;31;.969;3900000;0
13564;170536;503;0;0;0;0;.00nan;0;0
13564;81085;496;86;21;1;20;.952;3900000;0
13564;148573;496;0;0;0;0;.00nan;0;0
13566;1061;505;0;0;0;0;.00nan;0;0
13566;1756;500;0;0;0;0;.00nan;0;0
13566;43730;505;76;35;2;33;.943;3900000;0
13566;63707;500;90;34;2;32;.941;3900000;0
13568;-1;497;62;47;4;43;.915;3752000;0
13568;49674;498;67;30;3;27;.900;3736000;0
13568;142810;497;0;0;0;0;.00nan;0;0
13568;148691;498;0;0;0;0;.00nan;0;0
13570;187813;499;0;0;0;0;.00nan;0;0
13570;177356;4636;53;21;3;18;.857;3600000;0
13570;175593;499;70;22;1;21;.955;3600000;0
13570;148503;4636;0;0;0;0;.00nan;0;0
13572;6603;2591;0;0;0;0;.00nan;0;0
13572;174898;2591;72;29;2;27;.931;3553000;0
13572;-1;504;80;28;1;27;.964;3600000;0
13572;-1;504;0;0;0;0;.00nan;0;0
20114;6603;2591;87;30;1;29;.967;3600000;0
20114;174898;2591;0;0;0;0;.00nan;0;0
20114;81085;496;76;26;2;24;.923;3600000;0
20114;148573;496;0;0;0;0;.00nan;0;0
20115;-1;504;0;0;0;0;.00nan;0;0
20115;-1;504;70;47;5;42;.894;3600000;0
20115;180188;502;0;0;0;0;.00nan;0;0
20115;152624;502;69;20;1;19;.950;3600000;0
20116;6603;2591;93;42;1;41;.976;6278000;0
20116;174898;2591;0;0;0;0;.00nan;0;0
20116;81085;496;85;44;2;42;.955;6278000;0
20116;148573;496;0;0;0;0;.00nan;0;0
20117;-1;504;58;33;4;29;.879;3600000;0
20117;-1;504;0;0;0;0;.00nan;0;0
20117;180188;502;0;0;0;0;.00nan;0;0
20117;152624;502;71;21;1;20;.952;3600000;0
20118;6603;2591;96;36;2;34;.944;3600000;0
20118;174898;2591;0;0;0;0;.00nan;0;0
20118;81085;496;64;29;3;26;.897;3544000;0
20118;148573;496;0;0;0;0;.00nan;0;0
20119;-1;504;65;22;2;20;.909;3542000;0
20119;-1;504;0;0;0;0;.00nan;0;0
20119;180188;502;0;0;0;0;.00nan;0;0
20119;152624;502;100;31;0;31;1.000;3600000;0
20120;6603;2591;94;43;1;42;.977;6059000;0
20120;174898;2591;0;0;0;0;.00nan;0;0
20120;81085;496;100;36;0;36;1.000;6059000;0
20120;148573;496;0;0;0;0;.00nan;0;0
20121;-1;504;72;35;2;33;.943;3542000;0
20121;-1;504;0;0;0;0;.00nan;0;0
20121;180188;502;0;0;0;0;.00nan;0;0
20121;152624;502;100;25;0;25;1.000;3600000;0
210;6603;2591;56;29;3;26;.897;3564000;0
210;174898;2591;0;0;0;0;.00nan;0;0
210;81085;496;70;30;2;28;.933;3600000;0
210;148573;496;0;0;0;0;.00nan;0;0
265;6603;2591;81;27;1;26;.963;3569000;0
265;174898;2591;0;0;0;0;.00nan;0;0
265;81085;496;100;21;0;21;1.000;3600000;0
265;148573;496;0;0;0;0;.00nan;0;0
392;6603;2591;91;26;1;25;.962;3600000;0
392;174898;2591;0;0;0;0;.00nan;0;0
392;81085;496;64;29;3;26;.897;3576000;0
392;148573;496;0;0;0;0;.00nan;0;0
484;6603;2591;97;43;1;42;.977;4647000;0
484;174898;2591;0;0;0;0;.00nan;0;0
484;180188;502;0;0;0;0;.00nan;0;0
484;152624;502;85;25;2;23;.920;4647000;0
485;6603;2591;78;39;3;36;.923;3581000;0
485;174898;2591;0;0;0;0;.00nan;0;0
485;180188;502;0;0;0;0;.00nan;0;0
485;152624;502;72;18;1;17;.944;3600000;0
486;6603;2591;68;30;3;27;.900;3622000;0
486;174898;2591;0;0;0;0;.00nan;0;0
486;180188;502;0;0;0;0;.00nan;0;0
486;152624;502;91;32;2;30;.938;3622000;0
487;6603;2591;92;61;2;59;.967;5249000;0
487;174898;2591;0;0;0;0;.00nan;0;0
487;180188;502;0;0;0;0;.00nan;0;0
487;152624;502;100;48;1;47;.979;5249000;0
679;6603;2591;100;34;0;34;1.000;3600000;0
679;174898;2591;0;0;0;0;.00nan;0;0
679;180188;502;0;0;0;0;.00nan;0;0
679;152624;502;59;26;3;23;.885;3600000;0
708;6603;2591;70;46;5;41;.891;3600000;0
708;174898;2591;0;0;0;0;.00nan;0;0
708;180188;502;0;0;0;0;.00nan;0;0
708;152624;502;99;20;0;20;1.000;3600000;0
13573;17711;551;72;19;1;18;.947;3600000;0
13573;26308;551;0;0;0;0;.00nan;0;0
13573;49864;549;31;36;6;30;.833;3600000;0
13573;72108;549;0;0;0;0;.00nan;0;0
13574;6389;545;50;26;3;23;.885;3558000;0
13574;59933;547;75;34;2;32;.941;3600000;0
13574;67683;545;0;0;0;0;.00nan;0;0
13574;150345;547;0;0;0;0;.00nan;0;0
13575;3165;546;41;32;6;26;.813;3018000;0
13575;32347;543;64;31;4;27;.871;3600000;0
13575;71660;546;44;11;2;9;.818;582000;0
13575;152201;543;0;0;0;0;.00nan;0;0
13576;3165;546;72;27;2;25;.926;3600000;0
13576;162979;548;0;0;0;0;.00nan;0;0
13576;71660;546;0;0;0;0;.00nan;0;0
13576;160650;548;52;39;6;33;.846;3600000;0
13577;6389;545;31;8;3;5;.625;468000;0
13577;32347;543;64;15;1;14;.933;3600000;0
13577;67683;545;72;36;3;33;.917;3132000;0
13577;152201;543;0;0;0;0;.00nan;0;0
13578;3279;550;0;0;0;0;.00nan;0;0
13578;6541;550;56;39;5;34;.872;3600000;0
13578;17711;551;85;31;2;29;.935;3600000;0
13578;26308;551;0;0;0;0;.00nan;0;0
13579;167061;2190;100;31;0;31;1.000;3600000;0
13579;172303;2190;0;0;0;0;.00nan;0;0
13579;49864;549;82;38;3;35;.921;3600000;0
13579;72108;549;0;0;0;0;.00nan;0;0
13580;162979;548;99;41;1;40;.976;3600000;0
13580;59933;547;55;20;2;18;.900;3565000;0
13580;150345;547;0;0;0;0;.00nan;0;0
13580;160650;548;0;0;0;0;.00nan;0;0
13581;162979;548;88;38;2;36;.947;3543000;0
13581;17711;551;64;13;1;12;.923;3600000;0
13581;26308;551;0;0;0;0;.00nan;0;0
13581;160650;548;0;0;0;0;.00nan;0;0
13582;167061;2190;17;7;4;3;.429;321000;0
13582;172303;2190;59;12;1;11;.917;3279000;0
13582;32347;543;91;26;0;26;1.000;3600000;0
13582;152201;543;0;0;0;0;.00nan;0;0
13583;6389;545;0;0;0;0;.00nan;0;0
13583;49864;549;68;34;3;31;.912;3579000;0
13583;67683;545;74;30;2;28;.933;3600000;0
13583;72108;549;0;0;0;0;.00nan;0;0
13584;3165;546;49;8;1;7;.875;392000;0
13584;59933;547;56;21;2;19;.905;3600000;0
13584;71660;546;66;54;7;47;.870;3208000;0
13584;150345;547;0;0;0;0;.00nan;0;0
13585;6389;545;70;24;2;22;.917;3600000;0
13585;17711;551;53;28;4;24;.857;3531000;0
13585;26308;551;0;0;0;0;.00nan;0;0
13585;67683;545;0;0;0;0;.00nan;0;0
13586;3165;546;57;29;5;24;.828;3900000;0
13586;49864;549;51;35;5;30;.857;3900000;0
13586;71660;546;0;0;0;0;.00nan;0;0
13586;72108;549;0;0;0;0;.00nan;0;0
13587;3279;550;71;15;0;15;1.000;1523000;0
13587;6541;550;34;30;6;24;.800;2077000;0
13587;32347;543;62;18;2;16;.889;3600000;0
13587;152201;543;0;0;0;0;.00nan;0;0
13588;3279;550;65;41;3;38;.927;3900000;0
13588;6389;545;64;34;3;31;.912;3900000;0
13588;6541;550;0;0;0;0;.00nan;0;0
13588;67683;545;0;0;0;0;.00nan;0;0
13589;162979;548;81;43;3;40;.930;3600000;0
13589;32347;543;65;21;2;19;.905;3600000;0
13589;152201;543;0;0;0;0;.00nan;0;0
13589;160650;548;0;0;0;0;.00nan;0;0
13590;3165;546;0;0;0;0;.00nan;0;0
13590;17711;551;0;0;0;0;.00nan;0;0
13590;26308;551;89;17;0;17;1.000;3600000;0
13590;71660;546;55;56;8;48;.857;3600000;0
13591;167061;2190;98;25;0;25;1.000;3600000;0
13591;172303;2190;0;0;0;0;.00nan;0;0
13591;59933;547;0;0;0;0;.00nan;0;0
13591;150345;547;66;26;3;23;.885;3600000;0
13592;162979;548;98;40;2;38;.950;3558000;0
13592;49864;549;0;0;0;0;.00nan;0;0
13592;72108;549;80;22;1;21;.955;3600000;0
13592;160650;548;0;0;0;0;.00nan;0;0
13593;3165;546;99;23;0;23;1.000;3600000;0
13593;3279;550;0;0;0;0;.00nan;0;0
13593;6541;550;98;39;1;38;.974;3558000;0
13593;71660;546;0;0;0;0;.00nan;0;0
13594;167061;2190;71;28;2;26;.929;3600000;0
13594;6389;545;63;29;4;25;.862;3582000;0
13594;172303;2190;0;0;0;0;.00nan;0;0
13594;67683;545;0;0;0;0;.00nan;0;0
13595;17711;551;0;0;0;0;.00nan;0;0
13595;26308;551;77;18;1;17;.944;3600000;0
13595;59933;547;29;30;6;24;.800;2973000;0
13595;150345;547;50;7;1;6;.857;627000;0
13596;167061;2190;69;42;4;38;.905;3598000;0
13596;172303;2190;0;0;0;0;.00nan;0;0
13596;17711;551;49;17;2;15;.882;3600000;0
13596;26308;551;0;0;0;0;.00nan;0;0
13597;162979;548;100;48;4;44;.917;3600000;0
13597;6389;545;44;29;5;24;.828;3541000;0
13597;67683;545;0;0;0;0;.00nan;0;0
13597;160650;548;0;0;0;0;.00nan;0;0
13598;32347;543;55;18;2;16;.889;3600000;0
13598;49864;549;71;51;6;45;.882;3600000;0
13598;72108;549;0;0;0;0;.00nan;0;0
13598;152201;543;0;0;0;0;.00nan;0;0
13599;3279;550;0;0;0;0;.00nan;0;0
13599;6541;550;99;45;1;44;.978;3600000;0
13599;59933;547;26;19;5;14;.737;2079000;0
13599;150345;547;37;13;3;10;.769;1521000;0
13600;167061;2190;26;16;4;12;.750;1858000;0
13600;162979;548;62;41;5;36;.878;3556000;0
13600;172303;2190;78;17;0;17;1.000;1742000;0
13600;160650;548;0;0;0;0;.00nan;0;0
13601;3279;550;0;0;0;0;.00nan;0;0
13601;6541;550;70;26;2;24;.923;3600000;0
13601;49864;549;29;22;5;17;.773;3600000;0
13601;72108;549;0;0;0;0;.00nan;0;0
13602;3165;546;57;39;5;34;.872;3600000;0
13602;6389;545;90;24;1;23;.958;3600000;0
13602;67683;545;0;0;0;0;.00nan;0;0
13602;71660;546;0;0;0;0;.00nan;0;0
13603;3279;550;55;22;3;19;.864;3560000;0
13603;162979;548;88;34;2;32;.941;3600000;0
13603;6541;550;0;0;0;0;.00nan;0;0
13603;160650;548;0;0;0;0;.00nan;0;0
13604;3165;546;72;42;4;38;.905;3600000;0
13604;167061;2190;0;0;0;0;.00nan;0;0
13604;172303;2190;60;25;3;22;.880;3600000;0
13604;71660;546;0;0;0;0;.00nan;0;0
13605;17711;551;0;0;0;0;.00nan;0;0
13605;26308;551;45;21;4;17;.810;3544000;0
13605;32347;543;72;35;3;32;.914;3600000;0
13605;152201;543;0;0;0;0;.00nan;0;0
13606;49864;549;67;20;1;19;.950;3600000;0
13606;59933;547;75;30;2;28;.933;3581000;0
13606;72108;549;0;0;0;0;.00nan;0;0
13606;150345;547;0;0;0;0;.00nan;0;0
13607;3279;550;0;0;0;0;.00nan;0;0
13607;167061;2190;73;26;2;24;.923;3833000;0
13607;6541;550;80;33;1;32;.970;3833000;0
13607;172303;2190;0;0;0;0;.00nan;0;0
13608;162979;548;81;43;5;38;.884;3595000;0
13608;32347;543;59;18;3;15;.833;3600000;0
13608;152201;543;0;0;0;0;.00nan;0;0
13608;160650;548;0;0;0;0;.00nan;0;0
13609;17711;551;57;29;4;25;.862;3550000;0
13609;26308;551;0;0;0;0;.00nan;0;0
13609;59933;547;0;0;0;0;.00nan;0;0
13609;150345;547;69;29;3;26;.897;3600000;0
13610;3279;550;0;0;0;0;.00nan;0;0
13610;6541;550;88;36;2;34;.944;3600000;0
13610;32347;543;64;36;3;33;.917;3558000;0
13610;152201;543;0;0;0;0;.00nan;0;0
13611;167061;2190;95;32;1;31;.969;3600000;0
13611;6389;545;66;31;3;28;.903;3560000;0
13611;172303;2190;0;0;0;0;.00nan;0;0
13611;67683;545;0;0;0;0;.00nan;0;0
13612;3165;546;0;0;0;0;.00nan;0;0
13612;49864;549;76;26;2;24;.923;3600000;0
13612;71660;546;65;29;3;26;.897;3596000;0
13612;72108;549;0;0;0;0;.00nan;0;0
13613;162979;548;58;35;3;32;.914;3900000;0
13613;6389;545;69;33;3;30;.909;3900000;0
13613;67683;545;0;0;0;0;.00nan;0;0
13613;160650;548;0;0;0;0;.00nan;0;0
13614;167061;2190;85;29;1;28;.966;3600000;0
13614;172303;2190;0;0;0;0;.00nan;0;0
13614;59933;547;0;0;0;0;.00nan;0;0
13614;150345;547;65;31;3;28;.903;3549000;0
13615;3279;550;0;0;0;0;.00nan;0;0
13615;6541;550;65;42;5;37;.881;3600000;0
13615;17711;551;0;0;0;0;.00nan;0;0
13615;26308;551;73;16;1;15;.938;3600000;0
13616;3165;546;83;47;3;44;.936;3600000;0
13616;32347;543;0;0;0;0;.00nan;0;0
13616;71660;546;0;0;0;0;.00nan;0;0
13616;152201;543;88;17;0;17;1.000;3600000;0
13617;3165;546;69;43;5;38;.884;3600000;0
13617;3279;550;0;0;0;0;.00nan;0;0
13617;6541;550;83;23;1;22;.957;3600000;0
13617;71660;546;0;0;0;0;.00nan;0;0
13618;32347;543;0;0;0;0;.00nan;0;0
13618;59933;547;27;21;6;15;.714;1036000;0
13618;150345;547;38;21;4;17;.810;2564000;0
13618;152201;543;47;26;4;22;.846;3600000;0
13619;167061;2190;54;28;4;24;.857;3551000;0
13619;172303;2190;0;0;0;0;.00nan;0;0
13619;49864;549;77;24;2;22;.917;3600000;0
13619;72108;549;0;0;0;0;.00nan;0;0
13620;3165;546;92;59;5;54;.915;3600000;0
13620;6389;545;57;2;0;2;1.000;305000;0
13620;67683;545;44;22;4;18;.818;3295000;0
13620;71660;546;0;0;0;0;.00nan;0;0
13621;162979;548;49;45;6;39;.867;3600000;0
13621;17711;551;67;16;1;15;.938;3600000;0
13621;26308;551;0;0;0;0;.00nan;0;0
13621;160650;548;0;0;0;0;.00nan;0;0
13622;162979;548;0;0;0;0;.00nan;0;0
13622;59933;547;62;27;3;24;.889;3726000;0
13622;150345;547;0;0;0;0;.00nan;0;0
13622;160650;548;78;34;2;32;.941;3726000;0
13623;3279;550;0;0;0;0;.00nan;0;0
13623;6389;545;55;29;4;25;.862;3900000;0
13623;6541;550;52;30;4;26;.867;3900000;0
13623;67683;545;0;0;0;0;.00nan;0;0
13624;17711;551;0;0;0;0;.00nan;0;0
13624;26308;551;45;21;4;17;.810;3536000;0
13624;49864;549;86;35;2;33;.943;3600000;0
13624;72108;549;0;0;0;0;.00nan;0;0
13625;3165;546;32;10;3;7;.700;484000;0
13625;167061;2190;67;20;1;19;.950;3600000;0
13625;172303;2190;0;0;0;0;.00nan;0;0
13625;71660;546;51;28;4;24;.857;3116000;0
13626;32347;543;100;28;0;28;1.000;3600000;0
13626;59933;547;61;42;5;37;.881;3600000;0
13626;150345;547;0;0;0;0;.00nan;0;0
13626;152201;543;0;0;0;0;.00nan;0;0
13627;167061;2190;48;17;3;14;.824;3600000;0
13627;162979;548;59;34;4;30;.882;3600000;0
13627;172303;2190;0;0;0;0;.00nan;0;0
13627;160650;548;0;0;0;0;.00nan;0;0
13628;6389;545;76;24;2;22;.917;3600000;0
13628;49864;549;55;25;3;22;.880;3569000;0
13628;67683;545;0;0;0;0;.00nan;0;0
13628;72108;549;0;0;0;0;.00nan;0;0
13629;3165;546;60;40;5;35;.875;3600000;0
13629;17711;551;0;0;0;0;.00nan;0;0
13629;26308;551;90;32;1;31;.969;3600000;0
13629;71660;546;0;0;0;0;.00nan;0;0
13630;167061;2190;71;31;3;28;.903;3600000;0
13630;172303;2190;0;0;0;0;.00nan;0;0
13630;32347;543;31;15;4;11;.733;868000;0
13630;152201;543;55;18;2;16;.889;2732000;0
13631;49864;549;94;41;1;40;.976;3600000;0
13631;59933;547;42;34;5;29;.853;3600000;0
13631;72108;549;0;0;0;0;.00nan;0;0
13631;150345;547;0;0;0;0;.00nan;0;0
13632;3279;550;0;0;0;0;.00nan;0;0
13632;162979;548;86;25;1;24;.960;3600000;0
13632;6541;550;66;31;3;28;.903;3575000;0
13632;160650;548;0;0;0;0;.00nan;0;0
13633;3165;546;0;0;0;0;.00nan;0;0
13633;162979;548;81;40;3;37;.925;3551000;0
13633;71660;546;77;20;1;19;.950;3600000;0
13633;160650;548;0;0;0;0;.00nan;0;0
13634;3279;550;0;0;0;0;.00nan;0;0
13634;6541;550;56;24;3;21;.875;3600000;0
13634;59933;547;100;32;0;32;1.000;3600000;0
13634;150345;547;0;0;0;0;.00nan;0;0
13635;6389;545;100;45;2;43;.956;3600000;0
13635;17711;551;27;18;5;13;.722;3600000;0
13635;26308;551;0;0;0;0;.00nan;0;0
13635;67683;545;0;0;0;0;.00nan;0;0
13636;32347;543;75;30;2;28;.933;3600000;0
13636;49864;549;0;0;0;0;.00nan;0;0
13636;72108;549;74;48;5;43;.896;3600000;0
13636;152201;543;0;0;0;0;.00nan;0;0
13637;3279;550;0;0;0;0;.00nan;0;0
13637;167061;2190;67;29;3;26;.897;3600000;0
13637;6541;550;44;26;4;22;.846;3588000;0
13637;172303;2190;0;0;0;0;.00nan;0;0
13638;17711;551;62;36;5;31;.861;3600000;0
13638;26308;551;0;0;0;0;.00nan;0;0
13638;32347;543;0;0;0;0;.00nan;0;0
13638;152201;543;83;34;2;32;.941;3600000;0
13639;6389;545;100;34;1;33;.971;3900000;0
13639;59933;547;87;29;1;28;.966;3900000;0
13639;67683;545;0;0;0;0;.00nan;0;0
13639;150345;547;0;0;0;0;.00nan;0;0
13640;162979;548;0;0;0;0;.00nan;0;0
13640;49864;549;55;25;3;22;.880;3552000;0
13640;72108;549;0;0;0;0;.00nan;0;0
13640;160650;548;84;34;1;33;.971;3600000;0
13641;167061;2190;75;34;2;32;.941;3600000;0
13641;172303;2190;0;0;0;0;.00nan;0;0
13641;17711;551;0;0;0;0;.00nan;0;0
13641;26308;551;75;31;3;28;.903;3553000;0
13642;6389;545;46;37;6;31;.838;3344000;0
13642;32347;543;100;24;0;24;1.000;3600000;0
13642;67683;545;50;1;0;1;1.000;256000;0
13642;152201;543;0;0;0;0;.00nan;0;0
13643;3279;550;0;0;0;0;.00nan;0;0
13643;6541;550;66;16;1;15;.938;3600000;0
13643;49864;549;0;0;0;0;.00nan;0;0
13643;72108;549;63;40;5;35;.875;3600000;0
13644;3165;546;51;34;5;29;.853;3561000;0
13644;59933;547;0;0;0;0;.00nan;0;0
13644;71660;546;0;0;0;0;.00nan;0;0
13644;150345;547;49;27;4;23;.852;3600000;0
13645;167061;2190;93;35;2;33;.943;3890000;0
13645;172303;2190;0;0;0;0;.00nan;0;0
13645;17711;551;0;0;0;0;.00nan;0;0
13645;26308;551;82;19;1;18;.947;3890000;0
13646;3165;546;0;0;0;0;.00nan;0;0
13646;59933;547;64;24;2;22;.917;3600000;0
13646;71660;546;54;34;5;29;.853;3600000;0
13646;150345;547;0;0;0;0;.00nan;0;0
13647;3279;550;0;0;0;0;.00nan;0;0
13647;6541;550;86;36;1;35;.972;3600000;0
13647;49864;549;82;41;3;38;.927;3514000;0
13647;72108;549;0;0;0;0;.00nan;0;0
13648;6389;545;85;37;2;35;.946;3585000;0
13648;32347;543;61;15;1;14;.933;3600000;0
13648;67683;545;0;0;0;0;.00nan;0;0
13648;152201;543;0;0;0;0;.00nan;0;0
13649;3279;550;0;0;0;0;.00nan;0;0
13649;167061;2190;0;0;0;0;.00nan;0;0
13649;6541;550;99;51;3;48;.941;3600000;0
13649;172303;2190;54;28;4;24;.857;3544000;0
13650;162979;548;68;39;4;35;.897;3600000;0
13650;49864;549;41;27;5;22;.815;3588000;0
13650;72108;549;0;0;0;0;.00nan;0;0
13650;160650;548;0;0;0;0;.00nan;0;0
13651;3165;546;94;40;1;39;.975;3600000;0
13651;6389;545;62;29;4;25;.862;3600000;0
13651;67683;545;0;0;0;0;.00nan;0;0
13651;71660;546;0;0;0;0;.00nan;0;0
13652;32347;543;81;30;2;28;.933;3591000;0
13652;59933;547;92;41;1;40;.976;3600000;0
13652;150345;547;0;0;0;0;.00nan;0;0
13652;152201;543;0;0;0;0;.00nan;0;0
13653;3165;546;75;35;3;32;.914;3581000;0
13653;3279;550;84;32;2;30;.938;3600000;0
13653;6541;550;0;0;0;0;.00nan;0;0
13653;71660;546;0;0;0;0;.00nan;0;0
13654;162979;548;61;41;6;35;.854;3035000;0
13654;17711;551;60;24;3;21;.875;3600000;0
13654;26308;551;0;0;0;0;.00nan;0;0
13654;160650;548;58;8;0;8;1.000;565000;0
13655;32347;543;0;0;0;0;.00nan;0;0
13655;49864;549;22;25;6;19;.760;1727000;0
13655;72108;549;60;22;2;20;.909;1873000;0
13655;152201;543;60;32;3;29;.906;3600000;0
13656;3279;550;45;12;2;10;.833;1470000;0
13656;6389;545;0;0;0;0;.00nan;0;0
13656;6541;550;46;28;5;23;.821;2130000;0
13656;67683;545;79;37;3;34;.919;3600000;0
13657;162979;548;90;45;2;43;.956;3600000;0
13657;32347;543;41;24;4;20;.833;3546000;0
13657;152201;543;0;0;0;0;.00nan;0;0
13657;160650;548;0;0;0;0;.00nan;0;0
13658;3165;546;80;43;4;39;.907;3573000;0
13658;167061;2190;61;23;3;20;.870;3600000;0
13658;172303;2190;0;0;0;0;.00nan;0;0
13658;71660;546;0;0;0;0;.00nan;0;0
13659;17711;551;65;17;1;16;.941;3600000;0
13659;26308;551;0;0;0;0;.00nan;0;0
13659;59933;547;53;43;6;37;.860;3600000;0
13659;150345;547;0;0;0;0;.00nan;0;0
13660;167061;2190;95;20;0;20;1.000;3600000;0
13660;172303;2190;0;0;0;0;.00nan;0;0
13660;49864;549;85;40;2;38;.950;3576000;0
13660;72108;549;0;0;0;0;.00nan;0;0
13661;3165;546;56;30;4;26;.867;3600000;0
13661;17711;551;0;0;0;0;.00nan;0;0
13661;26308;551;62;27;3;24;.889;3600000;0
13661;71660;546;0;0;0;0;.00nan;0;0
13662;162979;548;36;34;6;28;.824;3197000;0
13662;59933;547;58;20;3;17;.850;3600000;0
13662;150345;547;0;0;0;0;.00nan;0;0
13662;160650;548;51;2;0;2;1.000;403000;0
13663;3279;550;0;0;0;0;.00nan;0;0
13663;6541;550;70;35;3;32;.914;3600000;0
13663;32347;543;49;14;2;12;.857;3600000;0
13663;152201;543;0;0;0;0;.00nan;0;0
13664;167061;2190;61;29;2;27;.931;3570000;0
13664;172303;2190;0;0;0;0;.00nan;0;0
13664;32347;543;0;0;0;0;.00nan;0;0
13664;152201;543;69;18;1;17;.944;3600000;0
13665;3165;546;91;39;1;38;.974;3600000;0
13665;162979;548;87;32;2;30;.938;3583000;0
13665;71660;546;0;0;0;0;.00nan;0;0
13665;160650;548;0;0;0;0;.00nan;0;0
13666;6389;545;26;6;3;3;.500;479000;0
13666;17711;551;90;30;2;28;.933;3600000;0
13666;26308;551;0;0;0;0;.00nan;0;0
13666;67683;545;42;30;5;25;.833;3121000;0
13667;3279;550;0;0;0;0;.00nan;0;0
13667;6541;550;84;38;3;35;.921;3524000;0
13667;59933;547;85;22;1;21;.955;3600000;0
13667;150345;547;0;0;0;0;.00nan;0;0
13668;3279;550;94;48;2;46;.958;3873000;0
13668;6541;550;0;0;0;0;.00nan;0;0
13668;17711;551;84;24;1;23;.958;3873000;0
13668;26308;551;0;0;0;0;.00nan;0;0
13669;162979;548;81;32;2;30;.938;3533000;0
13669;6389;545;97;26;0;26;1.000;3600000;0
13669;67683;545;0;0;0;0;.00nan;0;0
13669;160650;548;0;0;0;0;.00nan;0;0
13670;49864;549;0;0;0;0;.00nan;0;0
13670;59933;547;64;32;3;29;.906;3680000;0
13670;72108;549;60;27;4;23;.852;3680000;0
13670;150345;547;0;0;0;0;.00nan;0;0
13671;3165;546;79;35;3;32;.914;3600000;0
13671;32347;543;99;38;1;37;.974;3600000;0
13671;71660;546;0;0;0;0;.00nan;0;0
13671;152201;543;0;0;0;0;.00nan;0;0
13672;167061;2190;53;32;4;28;.875;3562000;0
13672;172303;2190;0;0;0;0;.00nan;0;0
13672;59933;547;91;41;2;39;.951;3600000;0
13672;150345;547;0;0;0;0;.00nan;0;0
13673;6389;545;48;25;4;21;.840;3900000;0
13673;32347;543;49;28;4;24;.857;3900000;0
13673;67683;545;0;0;0;0;.00nan;0;0
13673;152201;543;0;0;0;0;.00nan;0;0
13674;3165;546;67;34;3;31;.912;3596000;0
13674;59933;547;0;0;0;0;.00nan;0;0
13674;71660;546;0;0;0;0;.00nan;0;0
13674;150345;547;64;19;2;17;.895;3600000;0
13675;167061;2190;32;16;4;12;.750;3900000;0
13675;162979;548;68;42;4;38;.905;3900000;0
13675;172303;2190;0;0;0;0;.00nan;0;0
13675;160650;548;0;0;0;0;.00nan;0;0
13676;17711;551;78;26;2;24;.923;3600000;0
13676;26308;551;0;0;0;0;.00nan;0;0
13676;49864;549;78;49;5;44;.898;3600000;0
13676;72108;549;0;0;0;0;.00nan;0;0
13677;6389;545;44;37;5;32;.865;3900000;0
13677;59933;547;45;29;5;24;.828;3900000;0
13677;67683;545;0;0;0;0;.00nan;0;0
13677;150345;547;0;0;0;0;.00nan;0;0
13678;3279;550;0;0;0;0;.00nan;0;0
13678;162979;548;75;35;3;32;.914;3600000;0
13678;6541;550;100;24;0;24;1.000;3600000;0
13678;160650;548;0;0;0;0;.00nan;0;0
13679;167061;2190;76;20;1;19;.950;3600000;0
13679;6389;545;82;52;4;48;.923;3600000;0
13679;172303;2190;0;0;0;0;.00nan;0;0
13679;67683;545;0;0;0;0;.00nan;0;0
13680;17711;551;0;0;0;0;.00nan;0;0
13680;26308;551;67;22;2;20;.909;3600000;0
13680;32347;543;79;42;3;39;.929;3586000;0
13680;152201;543;0;0;0;0;.00nan;0;0
13681;3165;546;71;24;2;22;.917;3600000;0
13681;49864;549;63;31;3;28;.903;3558000;0
13681;71660;546;0;0;0;0;.00nan;0;0
13681;72108;549;0;0;0;0;.00nan;0;0
13682;6389;545;66;29;3;26;.897;3600000;0
13682;32347;543;71;31;4;27;.871;3543000;0
13682;67683;545;0;0;0;0;.00nan;0;0
13682;152201;543;0;0;0;0;.00nan;0;0
13683;17711;551;0;0;0;0;.00nan;0;0
13683;26308;551;86;13;0;13;1.000;3600000;0
13683;59933;547;70;42;5;37;.881;3600000;0
13683;150345;547;0;0;0;0;.00nan;0;0
13684;3165;546;30;34;7;27;.794;3291000;0
13684;167061;2190;52;27;3;24;.889;3600000;0
13684;172303;2190;0;0;0;0;.00nan;0;0
13684;71660;546;51;2;0;2;1.000;309000;0
13685;32347;543;0;0;0;0;.00nan;0;0
13685;59933;547;100;43;0;43;1.000;3900000;0
13685;150345;547;0;0;0;0;.00nan;0;0
13685;152201;543;94;29;0;29;1.000;3900000;0
13686;3279;550;0;0;0;0;.00nan;0;0
13686;6541;550;87;39;3;36;.923;3531000;0
13686;17711;551;70;17;1;16;.941;3600000;0
13686;26308;551;0;0;0;0;.00nan;0;0
13687;3279;550;0;0;0;0;.00nan;0;0
13687;6389;545;80;33;2;31;.939;3600000;0
13687;6541;550;77;37;3;34;.919;3551000;0
13687;67683;545;0;0;0;0;.00nan;0;0
13688;3165;546;88;42;3;39;.929;3567000;0
13688;17711;551;0;0;0;0;.00nan;0;0
13688;26308;551;57;12;1;11;.917;3600000;0
13688;71660;546;0;0;0;0;.00nan;0;0
13689;162979;548;70;41;4;37;.902;3565000;0
13689;32347;543;0;0;0;0;.00nan;0;0
13689;152201;543;55;19;2;17;.895;3600000;0
13689;160650;548;0;0;0;0;.00nan;0;0
13690;49864;549;81;34;2;32;.941;3600000;0
13690;59933;547;85;30;1;29;.967;3600000;0
13690;72108;549;0;0;0;0;.00nan;0;0
13690;150345;547;0;0;0;0;.00nan;0;0
13691;167061;2190;100;46;3;43;.935;3900000;0
13691;172303;2190;0;0;0;0;.00nan;0;0
13691;59933;547;54;25;3;22;.880;3900000;0
13691;150345;547;0;0;0;0;.00nan;0;0
13692;3279;550;0;0;0;0;.00nan;0;0
13692;6541;550;100;26;0;26;1.000;3600000;0
13692;49864;549;76;25;2;23;.920;3540000;0
13692;72108;549;0;0;0;0;.00nan;0;0
13693;3279;550;0;0;0;0;.00nan;0;0
13693;162979;548;86;30;1;29;.967;3900000;0
13693;6541;550;78;26;1;25;.962;3900000;0
13693;160650;548;0;0;0;0;.00nan;0;0
13694;3279;550;0;0;0;0;.00nan;0;0
13694;6541;550;65;46;5;41;.891;3600000;0
13694;32347;543;100;18;0;18;1.000;3600000;0
13694;152201;543;0;0;0;0;.00nan;0;0
13695;167061;2190;20;30;7;23;.767;3120000;0
13695;172303;2190;51;2;0;2;1.000;480000;0
13695;49864;549;80;41;3;38;.927;3600000;0
13695;72108;549;0;0;0;0;.00nan;0;0
13696;6389;545;72;12;0;12;1.000;732000;0
13696;17711;551;0;0;0;0;.00nan;0;0
13696;26308;551;47;30;5;25;.833;3600000;0
13696;67683;545;18;24;6;18;.750;2868000;0
13697;3165;546;0;0;0;0;.00nan;0;0
13697;162979;548;33;9;3;6;.667;546000;0
13697;71660;546;67;19;1;18;.947;3600000;0
13697;160650;548;67;22;2;20;.909;3054000;0
13698;167061;2190;64;34;4;30;.882;3547000;0
13698;172303;2190;0;0;0;0;.00nan;0;0
13698;49864;549;0;0;0;0;.00nan;0;0
13698;72108;549;73;36;3;33;.917;3600000;0
13699;162979;548;0;0;0;0;.00nan;0;0
13699;6389;545;82;31;2;29;.935;3598000;0
13699;67683;545;0;0;0;0;.00nan;0;0
13699;160650;548;84;25;1;24;.960;3600000;0
13700;3165;546;54;29;4;25;.862;3514000;0
13700;49864;549;85;38;2;36;.947;3600000;0
13700;71660;546;0;0;0;0;.00nan;0;0
13700;72108;549;0;0;0;0;.00nan;0;0
13701;167061;2190;85;42;2;40;.952;3600000;0
13701;172303;2190;0;0;0;0;.00nan;0;0
13701;17711;551;76;20;1;19;.950;3600000;0
13701;26308;551;0;0;0;0;.00nan;0;0
13702;162979;548;80;27;1;26;.963;3600000;0
13702;49864;549;29;35;7;28;.800;2358000;0
13702;72108;549;69;10;0;10;1.000;1242000;0
13702;160650;548;0;0;0;0;.00nan;0;0
13703;167061;2190;0;0;0;0;.00nan;0;0
13703;6389;545;48;30;4;26;.867;3600000;0
13703;172303;2190;92;19;0;19;1.000;3600000;0
13703;67683;545;0;0;0;0;.00nan;0;0
13704;17711;551;0;0;0;0;.00nan;0;0
13704;26308;551;64;24;2;22;.917;3600000;0
13704;32347;543;87;40;3;37;.925;3600000;0
13704;152201;543;0;0;0;0;.00nan;0;0
13705;3165;546;100;40;1;39;.975;3900000;0
13705;59933;547;88;32;1;31;.969;3900000;0
13705;71660;546;0;0;0;0;.00nan;0;0
13705;150345;547;0;0;0;0;.00nan;0;0
13706;3279;550;0;0;0;0;.00nan;0;0
13706;6541;550;62;22;2;20;.909;3600000;0
13706;59933;547;50;44;6;38;.864;3600000;0
13706;150345;547;0;0;0;0;.00nan;0;0
13707;167061;2190;0;0;0;0;.00nan;0;0
13707;162979;548;75;29;2;27;.931;3535000;0
13707;172303;2190;90;17;0;17;1.000;3600000;0
13707;160650;548;0;0;0;0;.00nan;0;0
13708;17711;551;78;11;0;11;1.000;3600000;0
13708;26308;551;0;0;0;0;.00nan;0;0
13708;49864;549;54;49;7;42;.857;3214000;0
13708;72108;549;35;4;2;2;.500;386000;0
13709;3165;546;97;51;2;49;.961;3572000;0
13709;32347;543;0;0;0;0;.00nan;0;0
13709;71660;546;0;0;0;0;.00nan;0;0
13709;152201;543;95;18;0;18;1.000;3600000;0
13710;3279;550;0;0;0;0;.00nan;0;0
13710;167061;2190;0;0;0;0;.00nan;0;0
13710;6541;550;98;62;3;59;.952;3543000;0
13710;172303;2190;67;18;2;16;.889;3600000;0
13711;162979;548;81;42;3;39;.929;3584000;0
13711;59933;547;79;24;1;23;.958;3600000;0
13711;150345;547;0;0;0;0;.00nan;0;0
13711;160650;548;0;0;0;0;.00nan;0;0
13712;6389;545;84;27;1;26;.963;3578000;0
13712;49864;549;100;38;0;38;1.000;3600000;0
13712;67683;545;0;0;0;0;.00nan;0;0
13712;72108;549;0;0;0;0;.00nan;0;0
13713;3165;546;71;51;6;45;.882;3159000;0
13713;32347;543;0;0;0;0;.00nan;0;0
13713;71660;546;43;4;1;3;.750;441000;0
13713;152201;543;83;15;0;15;1.000;3600000;0
13714;3279;550;0;0;0;0;.00nan;0;0
13714;167061;2190;69;25;2;23;.920;3600000;0
13714;6541;550;54;41;5;36;.878;3600000;0
13714;172303;2190;0;0;0;0;.00nan;0;0
13715;17711;551;100;24;0;24;1.000;3600000;0
13715;26308;551;0;0;0;0;.00nan;0;0
13715;32347;543;72;14;0;14;1.000;1224000;0
13715;152201;543;34;18;4;14;.778;2376000;0
13716;6389;545;0;0;0;0;.00nan;0;0
13716;49864;549;32;38;7;31;.816;3892000;0
13716;67683;545;26;27;6;21;.778;3865000;0
13716;72108;549;0;0;0;0;.00nan;0;0
13717;162979;548;76;11;0;11;1.000;1231000;0
13717;59933;547;0;0;0;0;.00nan;0;0
13717;150345;547;85;27;1;26;.963;3600000;0
13717;160650;548;41;30;5;25;.833;2369000;0
13718;32347;543;86;17;0;17;1.000;3600000;0
13718;49864;549;0;0;0;0;.00nan;0;0
13718;72108;549;85;47;3;44;.936;3600000;0
13718;152201;543;0;0;0;0;.00nan;0;0
13719;167061;2190;70;25;1;24;.960;3600000;0
13719;172303;2190;0;0;0;0;.00nan;0;0
13719;32347;543;50;27;4;23;.852;3600000;0
13719;152201;543;0;0;0;0;.00nan;0;0
13720;162979;548;0;0;0;0;.00nan;0;0
13720;17711;551;100;25;0;25;1.000;3600000;0
13720;26308;551;0;0;0;0;.00nan;0;0
13720;160650;548;46;43;6;37;.860;3600000;0
13721;3165;546;71;39;5;34;.872;3600000;0
13721;3279;550;0;0;0;0;.00nan;0;0
13721;6541;550;90;31;1;30;.968;3600000;0
13721;71660;546;0;0;0;0;.00nan;0;0
13722;6389;545;87;22;1;21;.955;3600000;0
13722;59933;547;80;40;3;37;.925;3527000;0
13722;67683;545;0;0;0;0;.00nan;0;0
13722;150345;547;0;0;0;0;.00nan;0;0
13723;3165;546;80;37;2;35;.946;3553000;0
13723;3279;550;96;33;1;32;.970;3600000;0
13723;6541;550;0;0;0;0;.00nan;0;0
13723;71660;546;0;0;0;0;.00nan;0;0
13724;6389;545;53;23;3;20;.870;3600000;0
13724;49864;549;85;29;1;28;.966;3600000;0
13724;67683;545;0;0;0;0;.00nan;0;0
13724;72108;549;0;0;0;0;.00nan;0;0
13725;167061;2190;54;26;3;23;.885;3900000;0
13725;162979;548;0;0;0;0;.00nan;0;0
13725;172303;2190;0;0;0;0;.00nan;0;0
13725;160650;548;73;38;3;35;.921;3900000;0
13726;3279;550;0;0;0;0;.00nan;0;0
13726;6541;550;55;36;5;31;.861;3540000;0
13726;17711;551;57;23;3;20;.870;3600000;0
13726;26308;551;0;0;0;0;.00nan;0;0
13727;162979;548;100;32;0;32;1.000;3600000;0
13727;6389;545;77;24;1;23;.958;3592000;0
13727;67683;545;0;0;0;0;.00nan;0;0
13727;160650;548;0;0;0;0;.00nan;0;0
13728;3165;546;100;47;3;44;.936;3900000;0
13728;167061;2190;66;30;3;27;.900;3900000;0
13728;172303;2190;0;0;0;0;.00nan;0;0
13728;71660;546;0;0;0;0;.00nan;0;0
13729;49864;549;78;41;4;37;.902;3900000;0
13729;59933;547;61;33;4;29;.879;3900000;0
13729;72108;549;0;0;0;0;.00nan;0;0
13729;150345;547;0;0;0;0;.00nan;0;0
13730;3279;550;0;0;0;0;.00nan;0;0
13730;6541;550;100;39;1;38;.974;3600000;0
13730;32347;543;0;0;0;0;.00nan;0;0
13730;152201;543;58;24;3;21;.875;3556000;0
13731;162979;548;88;52;4;48;.923;3600000;0
13731;17711;551;90;24;0;24;1.000;3600000;0
13731;26308;551;0;0;0;0;.00nan;0;0
13731;160650;548;0;0;0;0;.00nan;0;0
13732;3165;546;95;36;1;35;.972;3900000;0
13732;6389;545;100;31;1;30;.968;3900000;0
13732;67683;545;0;0;0;0;.00nan;0;0
13732;71660;546;0;0;0;0;.00nan;0;0
13733;32347;543;0;0;0;0;.00nan;0;0
13733;59933;547;90;36;1;35;.972;3600000;0
13733;150345;547;0;0;0;0;.00nan;0;0
13733;152201;543;78;29;2;27;.931;3591000;0
13734;17711;551;70;21;2;19;.905;3600000;0
13734;26308;551;0;0;0;0;.00nan;0;0
13734;59933;547;92;45;3;42;.933;3558000;0
13734;150345;547;0;0;0;0;.00nan;0;0
13735;3165;546;93;48;3;45;.938;3886000;0
13735;6389;545;66;23;2;21;.913;3886000;0
13735;67683;545;0;0;0;0;.00nan;0;0
13735;71660;546;0;0;0;0;.00nan;0;0
13736;32347;543;74;23;2;21;.913;3900000;0
13736;49864;549;67;37;2;35;.946;3900000;0
13736;72108;549;0;0;0;0;.00nan;0;0
13736;152201;543;0;0;0;0;.00nan;0;0
13737;3279;550;0;0;0;0;.00nan;0;0
13737;6541;550;72;30;2;28;.933;3600000;0
13737;49864;549;68;36;3;33;.917;3586000;0
13737;72108;549;0;0;0;0;.00nan;0;0
13738;3165;546;96;41;1;40;.976;3600000;0
13738;162979;548;0;0;0;0;.00nan;0;0
13738;71660;546;0;0;0;0;.00nan;0;0
13738;160650;548;55;26;3;23;.885;3594000;0
13739;6389;545;14;5;4;1;.200;565000;0
13739;17711;551;0;0;0;0;.00nan;0;0
13739;26308;551;53;27;4;23;.852;3600000;0
13739;67683;545;77;37;3;34;.919;3035000;0
13740;167061;2190;54;22;2;20;.909;3557000;0
13740;172303;2190;0;0;0;0;.00nan;0;0
13740;59933;547;100;42;1;41;.976;3600000;0
13740;150345;547;0;0;0;0;.00nan;0;0
13741;3279;550;0;0;0;0;.00nan;0;0
13741;162979;548;76;27;2;25;.926;3600000;0
13741;6541;550;66;28;3;25;.893;3560000;0
13741;160650;548;0;0;0;0;.00nan;0;0
13742;6389;545;59;33;4;29;.879;3587000;0
13742;59933;547;56;24;3;21;.875;3600000;0
13742;67683;545;0;0;0;0;.00nan;0;0
13742;150345;547;0;0;0;0;.00nan;0;0
13743;17711;551;54;31;5;26;.839;3568000;0
13743;26308;551;0;0;0;0;.00nan;0;0
13743;49864;549;0;0;0;0;.00nan;0;0
13743;72108;549;68;35;3;32;.914;3600000;0
13744;167061;2190;86;26;1;25;.962;3823000;0
13744;172303;2190;0;0;0;0;.00nan;0;0
13744;32347;543;0;0;0;0;.00nan;0;0
13744;152201;543;71;25;2;23;.920;3823000;0
13745;167061;2190;0;0;0;0;.00nan;0;0
13745;172303;2190;43;22;4;18;.818;3600000;0
13745;17711;551;85;28;1;27;.964;3600000;0
13745;26308;551;0;0;0;0;.00nan;0;0
13746;162979;548;73;44;4;40;.909;3600000;0
13746;32347;543;93;18;0;18;1.000;3600000;0
13746;152201;543;0;0;0;0;.00nan;0;0
13746;160650;548;0;0;0;0;.00nan;0;0
13747;3165;546;94;30;1;29;.967;3600000;0
13747;49864;549;60;30;3;27;.900;3589000;0
13747;71660;546;0;0;0;0;.00nan;0;0
13747;72108;549;0;0;0;0;.00nan;0;0
13748;3279;550;0;0;0;0;.00nan;0;0
13748;6541;550;100;34;1;33;.971;3641000;0
13748;59933;547;0;0;0;0;.00nan;0;0
13748;150345;547;59;20;2;18;.900;3641000;0
13749;3279;550;0;0;0;0;.00nan;0;0
13749;6389;545;0;0;0;0;.00nan;0;0
13749;6541;550;98;39;1;38;.974;3900000;0
13749;67683;545;89;33;1;32;.970;3900000;0
13750;162979;548;82;28;1;27;.964;3600000;0
13750;49864;549;75;28;2;26;.929;3571000;0
13750;72108;549;0;0;0;0;.00nan;0;0
13750;160650;548;0;0;0;0;.00nan;0;0
13751;3165;546;0;0;0;0;.00nan;0;0
13751;17711;551;79;10;0;10;1.000;3600000;0
13751;26308;551;0;0;0;0;.00nan;0;0
13751;71660;546;78;47;4;43;.915;3600000;0
13752;3279;550;0;0;0;0;.00nan;0;0
13752;6541;550;86;28;1;27;.964;3900000;0
13752;59933;547;92;30;1;29;.967;3900000;0
13752;150345;547;0;0;0;0;.00nan;0;0
13753;6389;545;42;25;4;21;.840;3542000;0
13753;49864;549;76;37;3;34;.919;3600000;0
13753;67683;545;0;0;0;0;.00nan;0;0
13753;72108;549;0;0;0;0;.00nan;0;0
13754;162979;548;75;46;4;42;.913;3600000;0
13754;32347;543;59;9;1;8;.889;3600000;0
13754;152201;543;0;0;0;0;.00nan;0;0
13754;160650;548;0;0;0;0;.00nan;0;0
13755;3165;546;95;37;1;36;.973;3600000;0
13755;167061;2190;60;27;3;24;.889;3530000;0
13755;172303;2190;0;0;0;0;.00nan;0;0
13755;71660;546;0;0;0;0;.00nan;0;0
13756;3279;550;0;0;0;0;.00nan;0;0
13756;6389;545;51;25;3;22;.880;3900000;0
13756;6541;550;100;49;3;46;.939;3900000;0
13756;67683;545;0;0;0;0;.00nan;0;0
13757;162979;548;0;0;0;0;.00nan;0;0
13757;49864;549;86;29;1;28;.966;3600000;0
13757;72108;549;0;0;0;0;.00nan;0;0
13757;160650;548;75;37;3;34;.919;3555000;0
13758;167061;2190;70;36;3;33;.917;3600000;0
13758;172303;2190;0;0;0;0;.00nan;0;0
13758;59933;547;100;34;0;34;1.000;3600000;0
13758;150345;547;0;0;0;0;.00nan;0;0
13759;17711;551;75;31;2;29;.935;3598000;0
13759;26308;551;0;0;0;0;.00nan;0;0
13759;32347;543;93;23;0;23;1.000;3600000;0
13759;152201;543;0;0;0;0;.00nan;0;0
13760;167061;2190;100;24;0;24;1.000;3600000;0
13760;162979;548;45;40;6;34;.850;3220000;0
13760;172303;2190;0;0;0;0;.00nan;0;0
13760;160650;548;54;5;0;5;1.000;380000;0
13761;3279;550;0;0;0;0;.00nan;0;0
13761;6541;550;75;46;4;42;.913;3600000;0
13761;17711;551;61;22;2;20;.909;3600000;0
13761;26308;551;0;0;0;0;.00nan;0;0
13762;6389;545;78;33;3;30;.909;3600000;0
13762;32347;543;51;27;5;22;.815;3540000;0
13762;67683;545;0;0;0;0;.00nan;0;0
13762;152201;543;0;0;0;0;.00nan;0;0
13763;3165;546;54;24;3;21;.875;3583000;0
13763;59933;547;88;27;1;26;.963;3600000;0
13763;71660;546;0;0;0;0;.00nan;0;0
13763;150345;547;0;0;0;0;.00nan;0;0
13764;3279;550;0;0;0;0;.00nan;0;0
13764;162979;548;0;0;0;0;.00nan;0;0
13764;6541;550;47;29;5;24;.828;3591000;0
13764;160650;548;82;35;2;33;.943;3600000;0
13765;167061;2190;80;23;1;22;.957;3600000;0
13765;6389;545;50;39;6;33;.846;3600000;0
13765;172303;2190;0;0;0;0;.00nan;0;0
13765;67683;545;0;0;0;0;.00nan;0;0
13766;3165;546;81;39;3;36;.923;3900000;0
13766;49864;549;100;39;3;36;.923;3900000;0
13766;71660;546;0;0;0;0;.00nan;0;0
13766;72108;549;0;0;0;0;.00nan;0;0
13767;17711;551;100;27;0;27;1.000;3600000;0
13767;26308;551;0;0;0;0;.00nan;0;0
13767;59933;547;29;5;3;2;.400;197000;0
13767;150345;547;78;35;2;33;.943;3403000;0
13768;3279;550;81;34;3;31;.912;3600000;0
13768;167061;2190;44;21;4;17;.810;3548000;0
13768;6541;550;0;0;0;0;.00nan;0;0
13768;172303;2190;0;0;0;0;.00nan;0;0
13769;162979;548;80;31;1;30;.968;3600000;0
13769;59933;547;60;28;4;24;.857;3600000;0
13769;150345;547;0;0;0;0;.00nan;0;0
13769;160650;548;0;0;0;0;.00nan;0;0
13770;3165;546;46;36;5;31;.861;2102000;0
13770;17711;551;42;14;3;11;.786;3600000;0
13770;26308;551;0;0;0;0;.00nan;0;0
13770;71660;546;53;17;2;15;.882;1498000;0
13771;32347;543;34;13;3;10;.769;3600000;0
13771;49864;549;100;45;0;45;1.000;3600000;0
13771;72108;549;0;0;0;0;.00nan;0;0
13771;152201;543;0;0;0;0;.00nan;0;0
13772;167061;2190;53;30;4;26;.867;3570000;0
13772;6389;545;68;28;3;25;.893;3600000;0
13772;172303;2190;0;0;0;0;.00nan;0;0
13772;67683;545;0;0;0;0;.00nan;0;0
13773;3165;546;72;29;2;27;.931;3566000;0
13773;162979;548;0;0;0;0;.00nan;0;0
13773;71660;546;0;0;0;0;.00nan;0;0
13773;160650;548;84;27;1;26;.963;3600000;0
13774;6389;545;0;0;0;0;.00nan;0;0
13774;17711;551;60;25;4;21;.840;3600000;0
13774;26308;551;0;0;0;0;.00nan;0;0
13774;67683;545;72;43;5;38;.884;3600000;0
13775;3279;550;0;0;0;0;.00nan;0;0
13775;6541;550;84;29;2;27;.931;3600000;0
13775;49864;549;62;26;3;23;.885;3600000;0
13775;72108;549;0;0;0;0;.00nan;0;0
13776;32347;543;99;23;0;23;1.000;3600000;0
13776;59933;547;63;29;2;27;.931;3569000;0
13776;150345;547;0;0;0;0;.00nan;0;0
13776;152201;543;0;0;0;0;.00nan;0;0
13777;162979;548;0;0;0;0;.00nan;0;0
13777;6389;545;75;18;1;17;.944;3600000;0
13777;67683;545;0;0;0;0;.00nan;0;0
13777;160650;548;87;39;2;37;.949;3600000;0
13778;167061;2190;69;44;4;40;.909;3600000;0
13778;172303;2190;0;0;0;0;.00nan;0;0
13778;17711;551;0;0;0;0;.00nan;0;0
13778;26308;551;55;16;2;14;.875;3600000;0
13779;3165;546;26;26;6;20;.769;2512000;0
13779;32347;543;61;23;2;21;.913;3600000;0
13779;71660;546;63;10;0;10;1.000;1088000;0
13779;152201;543;0;0;0;0;.00nan;0;0
13780;49864;549;83;32;2;30;.938;3600000;0
13780;59933;547;35;32;7;25;.781;3147000;0
13780;72108;549;0;0;0;0;.00nan;0;0
13780;150345;547;61;8;0;8;1.000;453000;0
13781;3279;550;0;0;0;0;.00nan;0;0
13781;6541;550;99;47;2;45;.957;3600000;0
13781;32347;543;68;25;3;22;.880;3548000;0
13781;152201;543;0;0;0;0;.00nan;0;0
13782;167061;2190;52;15;2;13;.867;3600000;0
13782;172303;2190;0;0;0;0;.00nan;0;0
13782;49864;549;53;34;5;29;.853;3600000;0
13782;72108;549;0;0;0;0;.00nan;0;0
13783;162979;548;0;0;0;0;.00nan;0;0
13783;17711;551;71;23;1;22;.957;3600000;0
13783;26308;551;0;0;0;0;.00nan;0;0
13783;160650;548;85;52;4;48;.923;3600000;0
13784;3165;546;67;37;4;33;.892;3600000;0
13784;6389;545;75;23;1;22;.957;3600000;0
13784;67683;545;0;0;0;0;.00nan;0;0
13784;71660;546;0;0;0;0;.00nan;0;0
13785;17711;551;59;22;3;19;.864;3600000;0
13785;26308;551;0;0;0;0;.00nan;0;0
13785;49864;549;0;0;0;0;.00nan;0;0
13785;72108;549;73;60;7;53;.883;3600000;0
13786;167061;2190;72;36;4;32;.889;3726000;0
13786;172303;2190;0;0;0;0;.00nan;0;0
13786;32347;543;60;26;3;23;.885;3726000;0
13786;152201;543;0;0;0;0;.00nan;0;0
13787;3165;546;92;18;0;18;1.000;1812000;0
13787;3279;550;0;0;0;0;.00nan;0;0
13787;6541;550;32;27;6;21;.778;3600000;0
13787;71660;546;43;22;4;18;.818;1788000;0
13788;6389;545;45;32;5;27;.844;3900000;0
13788;59933;547;59;17;1;16;.941;2703000;0
13788;67683;545;0;0;0;0;.00nan;0;0
13788;150345;547;35;17;4;13;.765;1197000;0
13790;167061;2190;60;31;4;27;.871;3600000;0
13790;6389;545;77;26;1;25;.962;3600000;0
13790;6650;2190;0;0;0;0;.00nan;0;0
13790;67683;545;0;0;0;0;.00nan;0;0
13792;3165;546;62;40;5;35;.875;3600000;0
13792;32347;543;76;22;1;21;.955;3600000;0
13792;71660;546;0;0;0;0;.00nan;0;0
13792;152201;543;0;0;0;0;.00nan;0;0
13794;162979;548;68;40;4;36;.900;3600000;0
13794;6541;550;80;21;1;20;.952;3600000;0
13794;53895;550;0;0;0;0;.00nan;0;0
13794;160650;548;0;0;0;0;.00nan;0;0
13796;17711;551;65;14;1;13;.929;3642000;0
13796;26308;551;0;0;0;0;.00nan;0;0
13796;49864;549;88;38;2;36;.947;3642000;0
13796;72108;549;0;0;0;0;.00nan;0;0
13798;162979;548;42;28;6;22;.786;3129000;0
13798;49864;549;100;27;0;27;1.000;3600000;0
13798;72108;549;0;0;0;0;.00nan;0;0
13798;160650;548;37;7;2;5;.714;471000;0
13800;6541;550;70;28;3;25;.893;3525000;0
13800;32347;543;87;30;1;29;.967;3600000;0
13800;53895;550;0;0;0;0;.00nan;0;0
13800;152201;543;0;0;0;0;.00nan;0;0
13802;167061;2190;71;26;2;24;.923;3600000;0
13802;6650;2190;0;0;0;0;.00nan;0;0
13802;59933;547;0;0;0;0;.00nan;0;0
13802;150345;547;57;31;4;27;.871;3600000;0
13804;6389;545;89;29;1;28;.966;3600000;0
13804;17711;551;0;0;0;0;.00nan;0;0
13804;26308;551;64;25;2;23;.920;3600000;0
13804;67683;545;0;0;0;0;.00nan;0;0
13806;3165;546;100;43;0;43;1.000;3600000;0
13806;32347;543;0;0;0;0;.00nan;0;0
13806;71660;546;0;0;0;0;.00nan;0;0
13806;152201;543;71;20;1;19;.950;3577000;0
13808;6541;550;54;4;0;4;1.000;418000;0
13808;53895;550;33;33;6;27;.818;3182000;0
13808;59933;547;16;31;7;24;.774;3543000;0
13808;150345;547;0;0;0;0;.00nan;0;0
13810;167061;2190;0;0;0;0;.00nan;0;0
13810;162979;548;0;0;0;0;.00nan;0;0
13810;6650;2190;79;21;1;20;.952;3900000;0
13810;160650;548;98;45;1;44;.978;3900000;0
13812;6389;545;0;0;0;0;.00nan;0;0
13812;17711;551;96;18;0;18;1.000;3600000;0
13812;26308;551;0;0;0;0;.00nan;0;0
13812;67683;545;89;39;2;37;.949;3584000;0
13814;32347;543;89;27;1;26;.963;3600000;0
13814;59933;547;89;44;3;41;.932;3529000;0
13814;150345;547;0;0;0;0;.00nan;0;0
13814;152201;543;0;0;0;0;.00nan;0;0
13816;3165;546;70;43;5;38;.884;3600000;0
13816;17711;551;53;16;2;14;.875;3600000;0
13816;26308;551;0;0;0;0;.00nan;0;0
13816;71660;546;0;0;0;0;.00nan;0;0
13818;167061;2190;65;33;3;30;.909;3591000;0
13818;6389;545;95;37;2;35;.946;3600000;0
13818;6650;2190;0;0;0;0;.00nan;0;0
13818;67683;545;0;0;0;0;.00nan;0;0
13820;162979;548;76;33;3;30;.909;3900000;0
13820;6541;550;74;30;3;27;.900;3900000;0
13820;53895;550;0;0;0;0;.00nan;0;0
13820;160650;548;0;0;0;0;.00nan;0;0
13822;3165;546;45;20;4;16;.800;3518000;0
13822;6541;550;0;0;0;0;.00nan;0;0
13822;53895;550;62;22;2;20;.909;3600000;0
13822;71660;546;0;0;0;0;.00nan;0;0
13824;6389;545;0;0;0;0;.00nan;0;0
13824;17711;551;0;0;0;0;.00nan;0;0
13824;26308;551;70;20;1;19;.950;3600000;0
13824;67683;545;83;39;2;37;.949;3600000;0
13826;162979;548;0;0;0;0;.00nan;0;0
13826;49864;549;47;18;3;15;.833;3545000;0
13826;72108;549;0;0;0;0;.00nan;0;0
13826;160650;548;91;32;2;30;.938;3600000;0
13828;167061;2190;0;0;0;0;.00nan;0;0
13828;6650;2190;69;24;1;23;.958;3600000;0
13828;32347;543;0;0;0;0;.00nan;0;0
13828;152201;543;62;30;4;26;.867;3600000;0
13830;6389;545;70;24;2;22;.917;3600000;0
13830;6541;550;32;30;6;24;.800;2921000;0
13830;53895;550;52;3;0;3;1.000;679000;0
13830;67683;545;0;0;0;0;.00nan;0;0
13832;17711;551;80;27;1;26;.963;3600000;0
13832;26308;551;0;0;0;0;.00nan;0;0
13832;32347;543;72;29;2;27;.931;3599000;0
13832;152201;543;0;0;0;0;.00nan;0;0
13834;167061;2190;88;40;2;38;.950;3900000;0
13834;6650;2190;0;0;0;0;.00nan;0;0
13834;49864;549;66;26;2;24;.923;3900000;0
13834;72108;549;0;0;0;0;.00nan;0;0
13836;3165;546;0;0;0;0;.00nan;0;0
13836;162979;548;0;0;0;0;.00nan;0;0
13836;71660;546;84;32;2;30;.938;3600000;0
13836;160650;548;65;24;3;21;.875;3600000;0
13838;17711;551;0;0;0;0;.00nan;0;0
13838;26308;551;79;21;1;20;.952;3562000;0
13838;59933;547;100;43;0;43;1.000;3600000;0
13838;150345;547;0;0;0;0;.00nan;0;0
13840;6541;550;0;0;0;0;.00nan;0;0
13840;49864;549;0;0;0;0;.00nan;0;0
13840;53895;550;100;31;0;31;1.000;3600000;0
13840;72108;549;47;31;5;26;.839;3600000;0
13842;3165;546;40;26;4;22;.846;3663000;0
13842;162979;548;79;35;3;32;.914;3663000;0
13842;71660;546;0;0;0;0;.00nan;0;0
13842;160650;548;0;0;0;0;.00nan;0;0
13844;167061;2190;0;0;0;0;.00nan;0;0
13844;6650;2190;52;41;6;35;.854;3645000;0
13844;32347;543;0;0;0;0;.00nan;0;0
13844;152201;543;38;26;5;21;.808;3645000;0
143;162979;548;90;41;1;40;.976;3571000;0
143;17711;551;100;15;0;15;1.000;3600000;0
143;26308;551;0;0;0;0;.00nan;0;0
143;160650;548;0;0;0;0;.00nan;0;0
144;32347;543;38;28;5;23;.821;3600000;0
144;49864;549;100;39;0;39;1.000;3600000;0
144;72108;549;0;0;0;0;.00nan;0;0
144;152201;543;0;0;0;0;.00nan;0;0
145;167061;2190;74;20;1;19;.950;3600000;0
145;6389;545;47;32;5;27;.844;3600000;0
145;172303;2190;0;0;0;0;.00nan;0;0
145;67683;545;0;0;0;0;.00nan;0;0
146;3279;550;0;0;0;0;.00nan;0;0
146;6541;550;78;23;1;22;.957;3600000;0
146;59933;547;53;45;6;39;.867;3600000;0
146;150345;547;0;0;0;0;.00nan;0;0
147;162979;548;94;54;3;51;.944;4179000;0
147;17711;551;61;22;2;20;.909;4179000;0
147;26308;551;0;0;0;0;.00nan;0;0
147;160650;548;0;0;0;0;.00nan;0;0
148;32347;543;50;20;3;17;.850;3600000;0
148;49864;549;97;54;4;50;.926;3545000;0
148;72108;549;0;0;0;0;.00nan;0;0
148;152201;543;0;0;0;0;.00nan;0;0
149;167061;2190;74;29;2;27;.931;3578000;0
149;6389;545;82;26;1;25;.962;3600000;0
149;172303;2190;0;0;0;0;.00nan;0;0
149;67683;545;0;0;0;0;.00nan;0;0
150;3279;550;0;0;0;0;.00nan;0;0
150;6541;550;100;40;1;39;.975;3600000;0
150;59933;547;21;3;3;0;.000;577000;0
150;150345;547;55;17;2;15;.882;3023000;0
151;162979;548;87;31;2;29;.935;4101000;0
151;17711;551;69;26;1;25;.962;4101000;0
151;26308;551;0;0;0;0;.00nan;0;0
151;160650;548;0;0;0;0;.00nan;0;0
152;32347;543;100;17;0;17;1.000;3600000;0
152;49864;549;80;44;3;41;.932;3600000;0
152;72108;549;0;0;0;0;.00nan;0;0
152;152201;543;0;0;0;0;.00nan;0;0
153;167061;2190;60;27;3;24;.889;3518000;0
153;6389;545;79;30;1;29;.967;3600000;0
153;172303;2190;0;0;0;0;.00nan;0;0
153;67683;545;0;0;0;0;.00nan;0;0
154;3279;550;0;0;0;0;.00nan;0;0
154;6541;550;74;46;3;43;.935;5472000;0
154;59933;547;100;54;2;52;.963;5472000;0
154;150345;547;0;0;0;0;.00nan;0;0
155;162979;548;83;50;4;46;.920;3600000;0
155;17711;551;67;17;1;16;.941;3600000;0
155;26308;551;0;0;0;0;.00nan;0;0
155;160650;548;0;0;0;0;.00nan;0;0
156;32347;543;71;25;3;22;.880;3734000;0
156;49864;549;78;36;4;32;.889;3734000;0
156;72108;549;0;0;0;0;.00nan;0;0
156;152201;543;0;0;0;0;.00nan;0;0
157;167061;2190;77;10;0;10;1.000;3600000;0
157;6389;545;70;39;4;35;.897;3600000;0
157;172303;2190;0;0;0;0;.00nan;0;0
157;67683;545;0;0;0;0;.00nan;0;0
158;3279;550;0;0;0;0;.00nan;0;0
158;6541;550;84;32;1;31;.969;3600000;0
158;59933;547;49;50;6;44;.880;3600000;0
158;150345;547;0;0;0;0;.00nan;0;0
551;32347;543;86;27;1;26;.963;3600000;0
551;49864;549;40;22;4;18;.818;3600000;0
551;72108;549;0;0;0;0;.00nan;0;0
551;152201;543;0;0;0;0;.00nan;0;0
552;167061;2190;76;24;1;23;.958;3600000;0
552;6389;545;73;30;2;28;.933;3568000;0
552;172303;2190;0;0;0;0;.00nan;0;0
552;67683;545;0;0;0;0;.00nan;0;0
553;3279;550;0;0;0;0;.00nan;0;0
553;6541;550;52;23;3;20;.870;3574000;0
553;59933;547;81;39;2;37;.949;3600000;0
553;150345;547;0;0;0;0;.00nan;0;0
593;167061;2190;79;24;1;23;.958;3600000;0
593;6389;545;69;40;4;36;.900;3600000;0
593;172303;2190;0;0;0;0;.00nan;0;0
593;67683;545;0;0;0;0;.00nan;0;0
594;3279;550;0;0;0;0;.00nan;0;0
594;6541;550;66;31;4;27;.871;4704000;0
594;59933;547;54;41;5;36;.878;4704000;0
594;150345;547;0;0;0;0;.00nan;0;0
641;3279;550;0;0;0;0;.00nan;0;0
641;6541;550;81;53;6;47;.887;3600000;0
641;17711;551;56;19;3;16;.842;3600000;0
641;26308;551;0;0;0;0;.00nan;0;0
642;167061;2190;66;31;3;28;.903;3600000;0
642;172303;2190;0;0;0;0;.00nan;0;0
642;32347;543;61;17;2;15;.882;3600000;0
642;152201;543;0;0;0;0;.00nan;0;0
643;3279;550;0;0;0;0;.00nan;0;0
643;6541;550;95;47;3;44;.936;3600000;0
643;17711;551;67;19;1;18;.947;3600000;0
643;26308;551;0;0;0;0;.00nan;0;0
644;167061;2190;62;44;5;39;.886;3600000;0
644;172303;2190;0;0;0;0;.00nan;0;0
644;32347;543;68;19;1;18;.947;3600000;0
644;152201;543;0;0;0;0;.00nan;0;0
645;3279;550;0;0;0;0;.00nan;0;0
645;6541;550;97;38;3;35;.921;3600000;0
645;17711;551;40;30;5;25;.833;3553000;0
645;26308;551;0;0;0;0;.00nan;0;0
646;167061;2190;56;18;2;16;.889;3600000;0
646;172303;2190;0;0;0;0;.00nan;0;0
646;32347;543;77;44;4;40;.909;3599000;0
646;152201;543;0;0;0;0;.00nan;0;0
647;3279;550;0;0;0;0;.00nan;0;0
647;6541;550;73;40;3;37;.925;3588000;0
647;17711;551;63;21;2;19;.905;3600000;0
647;26308;551;0;0;0;0;.00nan;0;0
648;167061;2190;38;22;4;18;.818;3585000;0
648;172303;2190;0;0;0;0;.00nan;0;0
648;32347;543;94;41;2;39;.951;3600000;0
648;152201;543;0;0;0;0;.00nan;0;0
933;3279;550;51;23;3;20;.870;1663000;0
933;6541;550;29;27;6;21;.778;1937000;0
933;17711;551;80;29;2;27;.931;3600000;0
933;26308;551;0;0;0;0;.00nan;0;0
934;167061;2190;26;12;4;8;.667;683000;0
934;172303;2190;54;23;3;20;.870;2917000;0
934;32347;543;56;21;3;18;.857;3600000;0
934;152201;543;0;0;0;0;.00nan;0;0
962;17711;551;75;25;3;22;.880;3730000;0
962;26308;551;0;0;0;0;.00nan;0;0
962;32347;543;96;39;2;37;.949;3730000;0
962;152201;543;0;0;0;0;.00nan;0;0
963;3279;550;0;0;0;0;.00nan;0;0
963;167061;2190;100;25;0;25;1.000;3600000;0
963;6541;550;72;44;4;40;.909;3600000;0
963;172303;2190;0;0;0;0;.00nan;0;0
964;17711;551;95;29;1;28;.966;3600000;0
964;26308;551;0;0;0;0;.00nan;0;0
964;32347;543;85;28;2;26;.929;3568000;0
964;152201;543;0;0;0;0;.00nan;0;0
965;3279;550;0;0;0;0;.00nan;0;0
965;167061;2190;99;25;0;25;1.000;3600000;0
965;6541;550;97;47;3;44;.936;3600000;0
965;172303;2190;0;0;0;0;.00nan;0;0
966;17711;551;57;18;2;16;.889;3600000;0
966;26308;551;0;0;0;0;.00nan;0;0
966;32347;543;54;31;4;27;.871;3521000;0
966;152201;543;0;0;0;0;.00nan;0;0
967;3279;550;0;0;0;0;.00nan;0;0
967;167061;2190;49;27;4;23;.852;3564000;0
967;6541;550;96;46;3;43;.935;3600000;0
967;172303;2190;0;0;0;0;.00nan;0;0
968;17711;551;86;30;2;28;.933;3556000;0
968;26308;551;0;0;0;0;.00nan;0;0
968;32347;543;78;28;1;27;.964;3600000;0
968;152201;543;0;0;0;0;.00nan;0;0
969;3279;550;0;0;0;0;.00nan;0;0
969;167061;2190;64;25;3;22;.880;3557000;0
969;6541;550;71;29;2;27;.931;3600000;0
969;172303;2190;0;0;0;0;.00nan;0;0
1097;17711;551;78;21;1;20;.952;3600000;0
1097;26308;551;0;0;0;0;.00nan;0;0
1097;32347;543;64;40;4;36;.900;3600000;0
1097;152201;543;0;0;0;0;.00nan;0;0
1098;3279;550;0;0;0;0;.00nan;0;0
1098;167061;2190;83;29;1;28;.966;3600000;0
1098;6541;550;67;40;4;36;.900;3600000;0
1098;172303;2190;0;0;0;0;.00nan;0;0
1193;17711;551;43;20;4;16;.800;3600000;0
1193;26308;551;0;0;0;0;.00nan;0;0
1193;32347;543;100;34;0;34;1.000;3600000;0
1193;152201;543;0;0;0;0;.00nan;0;0
1194;3279;550;0;0;0;0;.00nan;0;0
1194;167061;2190;100;34;2;32;.941;3600000;0
1194;6541;550;70;45;4;41;.911;3540000;0
1194;172303;2190;0;0;0;0;.00nan;0;0
1248;17711;551;73;36;3;33;.917;4698000;0
1248;26308;551;0;0;0;0;.00nan;0;0
1248;32347;543;93;51;4;47;.922;4698000;0
1248;152201;543;0;0;0;0;.00nan;0;0
13845;15564;452;40;31;5;26;.839;3543000;0
13845;22349;452;0;0;0;0;.00nan;0;0
13845;75464;460;0;0;0;0;.00nan;0;0
13845;92283;460;53;29;4;25;.862;3600000;0
13846;172714;457;0;0;0;0;.00nan;0;0
13846;15564;452;59;33;3;30;.909;3900000;0
13846;22349;452;0;0;0;0;.00nan;0;0
13846;53830;457;68;28;3;25;.893;3900000;0
13847;172079;1086;0;0;0;0;.00nan;0;0
13847;172723;1086;34;58;9;49;.845;3573000;0
13847;181071;459;8;19;7;12;.632;3315000;0
13847;85947;459;41;1;1;0;.000;285000;0
13848;2153;4337;0;0;0;0;.00nan;0;0
13848;167492;4337;30;26;6;20;.769;3600000;0
13848;9216;2579;95;36;2;34;.944;3600000;0
13848;15558;2579;0;0;0;0;.00nan;0;0
13849;182561;456;48;28;5;23;.821;3600000;0
13849;193012;455;73;30;2;28;.933;3600000;0
13849;175530;455;0;0;0;0;.00nan;0;0
13849;141635;456;0;0;0;0;.00nan;0;0
13850;187783;458;61;37;4;33;.892;3562000;0
13850;172079;1086;0;0;0;0;.00nan;0;0
13850;10565;458;0;0;0;0;.00nan;0;0
13850;172723;1086;74;28;2;26;.929;3600000;0
13851;193012;455;0;0;0;0;.00nan;0;0
13851;175530;455;85;28;2;26;.929;3600000;0
13851;75464;460;0;0;0;0;.00nan;0;0
13851;92283;460;42;27;4;23;.852;3582000;0
13852;15564;452;55;28;4;24;.857;3550000;0
13852;22349;452;0;0;0;0;.00nan;0;0
13852;75464;460;76;37;3;34;.919;3600000;0
13852;92283;460;0;0;0;0;.00nan;0;0
13853;2153;4337;59;4;0;4;1.000;300000;0
13853;182561;456;79;36;3;33;.917;3600000;0
13853;167492;4337;20;23;6;17;.739;3300000;0
13853;141635;456;0;0;0;0;.00nan;0;0
13854;15564;452;0;0;0;0;.00nan;0;0
13854;22349;452;65;35;4;31;.886;3600000;0
13854;75464;460;0;0;0;0;.00nan;0;0
13854;92283;460;49;35;5;30;.857;3578000;0
13855;193012;455;0;0;0;0;.00nan;0;0
13855;172714;457;0;0;0;0;.00nan;0;0
13855;175530;455;64;30;3;27;.900;3543000;0
13855;53830;457;82;37;2;35;.946;3600000;0
13856;9216;2579;0;0;0;0;.00nan;0;0
13856;10794;459;0;0;0;0;.00nan;0;0
13856;15558;2579;39;27;5;22;.815;3548000;0
13856;85947;459;59;32;4;28;.875;3600000;0
13857;187783;458;42;31;5;26;.839;3600000;0
13857;9216;2579;0;0;0;0;.00nan;0;0
13857;10565;458;0;0;0;0;.00nan;0;0
13857;15558;2579;57;13;1;12;.923;3600000;0
13858;182561;456;0;0;0;0;.00nan;0;0
13858;172714;457;39;24;5;19;.792;3533000;0
13858;53830;457;0;0;0;0;.00nan;0;0
13858;141635;456;77;35;3;32;.914;3600000;0
13859;2153;4337;0;0;0;0;.00nan;0;0
13859;167492;4337;13;35;8;27;.771;3600000;0
13859;15564;452;47;23;4;19;.826;3600000;0
13859;22349;452;0;0;0;0;.00nan;0;0
13860;187783;458;39;35;6;29;.829;3600000;0
13860;10565;458;0;0;0;0;.00nan;0;0
13860;10794;459;0;0;0;0;.00nan;0;0
13860;85947;459;87;29;2;27;.931;3600000;0
13861;2153;4337;21;34;7;27;.794;2299000;0
13861;167492;4337;44;12;2;10;.833;1301000;0
13861;15564;452;0;0;0;0;.00nan;0;0
13861;22349;452;29;22;5;17;.773;3600000;0
13862;172714;457;51;24;4;20;.833;1432000;0
13862;10794;459;0;0;0;0;.00nan;0;0
13862;53830;457;30;29;6;23;.793;2168000;0
13862;85947;459;45;12;2;10;.833;3600000;0
13863;9216;2579;0;0;0;0;.00nan;0;0
13863;15558;2579;41;23;4;19;.826;3600000;0
13863;75464;460;58;38;5;33;.868;3554000;0
13863;92283;460;0;0;0;0;.00nan;0;0
13864;182561;456;28;32;7;25;.781;1842000;0
13864;172079;1086;0;0;0;0;.00nan;0;0
13864;172723;1086;29;29;6;23;.793;3600000;0
13864;141635;456;65;21;2;19;.905;1758000;0
13865;187783;458;35;35;6;29;.829;3600000;0
13865;172714;457;0;0;0;0;.00nan;0;0
13865;10565;458;0;0;0;0;.00nan;0;0
13865;53830;457;78;30;3;27;.900;3600000;0
13866;2153;4337;0;0;0;0;.00nan;0;0
13866;167492;4337;51;28;4;24;.857;3563000;0
13866;75464;460;0;0;0;0;.00nan;0;0
13866;92283;460;46;19;3;16;.842;3600000;0
13867;182561;456;30;36;7;29;.806;2281000;0
13867;193012;455;0;0;0;0;.00nan;0;0
13867;175530;455;72;28;1;27;.964;3600000;0
13867;141635;456;75;26;1;25;.962;1319000;0
13868;2153;4337;30;47;9;38;.809;3221000;0
13868;167492;4337;53;5;0;5;1.000;379000;0
13868;75464;460;59;22;3;19;.864;3600000;0
13868;92283;460;0;0;0;0;.00nan;0;0
13869;172079;1086;0;0;0;0;.00nan;0;0
13869;172714;457;41;41;6;35;.854;3600000;0
13869;172723;1086;50;23;3;20;.870;3600000;0
13869;53830;457;0;0;0;0;.00nan;0;0
13870;172079;1086;74;37;3;34;.919;3600000;0
13870;172723;1086;0;0;0;0;.00nan;0;0
13870;15564;452;42;22;4;18;.818;3542000;0
13870;22349;452;0;0;0;0;.00nan;0;0
13871;187783;458;38;37;6;31;.838;3544000;0
13871;9216;2579;56;31;5;26;.839;3600000;0
13871;10565;458;0;0;0;0;.00nan;0;0
13871;15558;2579;0;0;0;0;.00nan;0;0
13872;182561;456;38;6;2;4;.667;445000;0
13872;10794;459;0;0;0;0;.00nan;0;0
13872;85947;459;61;32;4;28;.875;3600000;0
13872;141635;456;37;33;6;27;.818;3155000;0
13873;187783;458;26;7;3;4;.571;350000;0
13873;9216;2579;0;0;0;0;.00nan;0;0
13873;10565;458;47;39;6;33;.846;3250000;0
13873;15558;2579;40;21;4;17;.810;3600000;0
13874;193012;455;0;0;0;0;.00nan;0;0
13874;10794;459;0;0;0;0;.00nan;0;0
13874;175530;455;54;30;4;26;.867;3600000;0
13874;85947;459;55;33;5;28;.848;3575000;0
13875;172714;457;36;7;2;5;.714;1486000;0
13875;15564;452;83;27;1;26;.963;3600000;0
13875;22349;452;0;0;0;0;.00nan;0;0
13875;53830;457;18;18;6;12;.667;2114000;0
13876;2153;4337;69;38;3;35;.921;2354000;0
13876;193012;455;0;0;0;0;.00nan;0;0
13876;167492;4337;9;16;6;10;.625;1246000;0
13876;175530;455;31;32;6;26;.813;3600000;0
13877;10794;459;0;0;0;0;.00nan;0;0
13877;75464;460;0;0;0;0;.00nan;0;0
13877;85947;459;58;29;4;25;.862;3600000;0
13877;92283;460;16;41;8;33;.805;3600000;0
13878;172079;1086;64;36;4;32;.889;3541000;0
13878;9216;2579;79;37;2;35;.946;3600000;0
13878;172723;1086;0;0;0;0;.00nan;0;0
13878;15558;2579;0;0;0;0;.00nan;0;0
13879;187783;458;75;22;1;21;.955;1378000;0
13879;10565;458;8;17;6;11;.647;2222000;0
13879;75464;460;32;14;4;10;.714;3600000;0
13879;92283;460;0;0;0;0;.00nan;0;0
13880;182561;456;46;37;5;32;.865;3600000;0
13880;15564;452;87;33;1;32;.970;3600000;0
13880;22349;452;0;0;0;0;.00nan;0;0
13880;141635;456;0;0;0;0;.00nan;0;0
13881;9216;2579;0;0;0;0;.00nan;0;0
13881;15558;2579;21;28;6;22;.786;3588000;0
13881;75464;460;0;0;0;0;.00nan;0;0
13881;92283;460;47;32;5;27;.844;3600000;0
13882;182561;456;33;34;6;28;.824;3600000;0
13882;10794;459;0;0;0;0;.00nan;0;0
13882;85947;459;75;33;3;30;.909;3600000;0
13882;141635;456;0;0;0;0;.00nan;0;0
13883;172079;1086;60;6;0;6;1.000;853000;0
13883;172723;1086;14;22;6;16;.727;2747000;0
13883;15564;452;49;28;5;23;.821;3600000;0
13883;22349;452;0;0;0;0;.00nan;0;0
13884;161695;455;0;0;0;0;.00nan;0;0
13884;193012;455;37;25;5;20;.800;3535000;0
13884;172714;457;0;0;0;0;.00nan;0;0
13884;53830;457;86;43;3;40;.930;3600000;0
13885;182561;456;0;0;0;0;.00nan;0;0
13885;187783;458;35;33;6;27;.818;2993000;0
13885;10565;458;44;5;1;4;.800;562000;0
13885;141635;456;23;26;6;20;.769;3600000;0
13886;187783;458;10;17;6;11;.647;2479000;0
13886;10565;458;47;7;1;6;.857;1121000;0
13886;10794;459;0;0;0;0;.00nan;0;0
13886;85947;459;71;25;3;22;.880;3600000;0
13887;2153;4337;0;0;0;0;.00nan;0;0
13887;167492;4337;58;17;2;15;.882;3600000;0
13887;10794;459;0;0;0;0;.00nan;0;0
13887;85947;459;32;32;6;26;.813;3600000;0
13888;182561;456;1;20;7;13;.650;1955000;0
13888;172714;457;0;0;0;0;.00nan;0;0
13888;53830;457;44;31;5;26;.839;3600000;0
13888;141635;456;16;27;7;20;.741;1645000;0
13889;187783;458;52;26;3;23;.885;2863000;0
13889;9216;2579;47;21;4;17;.810;3600000;0
13889;10565;458;18;10;4;6;.600;737000;0
13889;15558;2579;0;0;0;0;.00nan;0;0
13890;172079;1086;0;0;0;0;.00nan;0;0
13890;172723;1086;47;28;4;24;.857;3600000;0
13890;75464;460;40;34;6;28;.824;3336000;0
13890;92283;460;41;2;1;1;.500;264000;0
13891;161695;455;0;0;0;0;.00nan;0;0
13891;193012;455;46;30;4;26;.867;3600000;0
13891;15564;452;46;33;5;28;.848;3565000;0
13891;22349;452;0;0;0;0;.00nan;0;0
13892;9216;2579;0;0;0;0;.00nan;0;0
13892;10794;459;0;0;0;0;.00nan;0;0
13892;15558;2579;36;23;4;19;.826;3600000;0
13892;85947;459;48;35;5;30;.857;3595000;0
13893;172714;457;0;0;0;0;.00nan;0;0
13893;53830;457;44;23;4;19;.826;3600000;0
13893;75464;460;0;0;0;0;.00nan;0;0
13893;92283;460;57;37;5;32;.865;3600000;0
13894;161695;455;42;17;3;14;.824;1620000;0
13894;193012;455;13;20;6;14;.700;1980000;0
13894;10794;459;0;0;0;0;.00nan;0;0
13894;85947;459;70;31;3;28;.903;3600000;0
13895;2153;4337;79;36;2;34;.944;3600000;0
13895;172079;1086;69;39;4;35;.897;3549000;0
13895;167492;4337;0;0;0;0;.00nan;0;0
13895;172723;1086;0;0;0;0;.00nan;0;0
13896;9216;2579;0;0;0;0;.00nan;0;0
13896;15558;2579;78;42;4;38;.905;3552000;0
13896;15564;452;62;30;3;27;.900;3600000;0
13896;22349;452;0;0;0;0;.00nan;0;0
13897;161695;455;68;18;1;17;.944;3600000;0
13897;187783;458;33;38;7;31;.816;3247000;0
13897;193012;455;0;0;0;0;.00nan;0;0
13897;10565;458;60;7;0;7;1.000;353000;0
13898;2153;4337;0;0;0;0;.00nan;0;0
13898;182561;456;33;29;6;23;.793;3600000;0
13898;167492;4337;66;25;3;22;.880;3600000;0
13898;141635;456;0;0;0;0;.00nan;0;0
13899;172714;457;35;36;6;30;.833;3249000;0
13899;53830;457;37;3;2;1;.333;436000;0
13899;75464;460;11;16;6;10;.625;2295000;0
13899;92283;460;62;12;1;11;.917;1389000;0
13900;2153;4337;20;10;4;6;.600;1061000;0
13900;167492;4337;76;19;0;19;1.000;2539000;0
13900;15564;452;16;18;6;12;.667;3576000;0
13900;22349;452;0;0;0;0;.00nan;0;0
13901;10794;459;0;0;0;0;.00nan;0;0
13901;75464;460;39;1;1;0;.000;409000;0
13901;85947;459;67;28;3;25;.893;3600000;0
13901;92283;460;39;32;5;27;.844;3191000;0
13902;187783;458;31;26;5;21;.808;3563000;0
13902;172714;457;0;0;0;0;.00nan;0;0
13902;10565;458;0;0;0;0;.00nan;0;0
13902;53830;457;67;30;3;27;.900;3600000;0
13903;172079;1086;1;26;9;17;.654;3321000;0
13903;9216;2579;58;27;4;23;.852;3600000;0
13903;172723;1086;50;1;0;1;1.000;279000;0
13903;15558;2579;0;0;0;0;.00nan;0;0
13904;187783;458;0;0;0;0;.00nan;0;0
13904;172079;1086;0;0;0;0;.00nan;0;0
13904;10565;458;90;46;3;43;.935;3600000;0
13904;172723;1086;19;20;6;14;.700;3600000;0
13905;182561;456;46;25;4;21;.840;3600000;0
13905;9216;2579;0;0;0;0;.00nan;0;0
13905;15558;2579;43;24;5;19;.792;3556000;0
13905;141635;456;0;0;0;0;.00nan;0;0
13906;2153;4337;49;21;4;17;.810;3600000;0
13906;167492;4337;0;0;0;0;.00nan;0;0
13906;15564;452;66;10;0;10;1.000;1892000;0
13906;22349;452;25;20;6;14;.700;1680000;0
13907;161695;455;0;0;0;0;.00nan;0;0
13907;193012;455;73;26;1;25;.962;3600000;0
13907;10794;459;40;28;5;23;.821;2820000;0
13907;85947;459;37;17;4;13;.765;780000;0
13908;10794;459;0;0;0;0;.00nan;0;0
13908;15564;452;18;6;4;2;.333;853000;0
13908;22349;452;83;21;0;21;1.000;3047000;0
13908;85947;459;57;34;4;30;.882;3900000;0
13909;2153;4337;0;0;0;0;.00nan;0;0
13909;167492;4337;23;28;6;22;.786;3580000;0
13909;75464;460;0;0;0;0;.00nan;0;0
13909;92283;460;45;27;4;23;.852;3600000;0
13910;172079;1086;88;26;1;25;.962;3600000;0
13910;172714;457;0;0;0;0;.00nan;0;0
13910;172723;1086;0;0;0;0;.00nan;0;0
13910;53830;457;60;41;5;36;.878;3600000;0
13911;161695;455;0;0;0;0;.00nan;0;0
13911;193012;455;59;26;3;23;.885;3600000;0
13911;9216;2579;24;31;6;25;.806;3600000;0
13911;15558;2579;0;0;0;0;.00nan;0;0
13912;172714;457;19;10;4;6;.600;868000;0
13912;10794;459;0;0;0;0;.00nan;0;0
13912;53830;457;43;13;2;11;.846;2732000;0
13912;85947;459;68;21;2;19;.905;3600000;0
13913;172079;1086;57;10;1;9;.900;1691000;0
13913;172723;1086;9;18;6;12;.667;1828000;0
13913;15564;452;66;42;5;37;.881;3600000;0
13913;22349;452;0;0;0;0;.00nan;0;0
13914;2153;4337;31;27;6;21;.778;3585000;0
13914;167492;4337;0;0;0;0;.00nan;0;0
13914;75464;460;56;32;5;27;.844;3600000;0
13914;92283;460;0;0;0;0;.00nan;0;0
13915;182561;456;60;36;4;32;.889;3600000;0
13915;9216;2579;0;0;0;0;.00nan;0;0
13915;15558;2579;7;12;6;6;.500;3573000;0
13915;141635;456;0;0;0;0;.00nan;0;0
13916;187783;458;15;6;4;2;.333;548000;0
13916;10565;458;62;49;6;43;.878;3052000;0
13916;10794;459;0;0;0;0;.00nan;0;0
13916;85947;459;45;17;3;14;.824;3600000;0
13917;182561;456;58;24;3;21;.875;3600000;0
13917;75464;460;0;0;0;0;.00nan;0;0
13917;92283;460;76;39;2;37;.949;3600000;0
13917;141635;456;0;0;0;0;.00nan;0;0
13918;10794;459;0;0;0;0;.00nan;0;0
13918;15564;452;34;26;5;21;.808;2212000;0
13918;22349;452;48;12;2;10;.833;1388000;0
13918;85947;459;72;31;3;28;.903;3600000;0
13919;2153;4337;53;4;0;4;1.000;253000;0
13919;172079;1086;0;0;0;0;.00nan;0;0
13919;167492;4337;39;40;7;33;.825;3347000;0
13919;172723;1086;67;22;1;21;.955;3600000;0
13920;9216;2579;67;28;3;25;.893;3900000;0
13920;172714;457;0;0;0;0;.00nan;0;0
13920;15558;2579;0;0;0;0;.00nan;0;0
13920;53830;457;54;18;3;15;.833;3900000;0
13921;187783;458;0;0;0;0;.00nan;0;0
13921;10565;458;29;47;8;39;.830;3600000;0
13921;15564;452;57;20;2;18;.900;3600000;0
13921;22349;452;0;0;0;0;.00nan;0;0
13922;161695;455;26;22;5;17;.773;3554000;0
13922;2153;4337;76;41;4;37;.902;3600000;0
13922;193012;455;0;0;0;0;.00nan;0;0
13922;167492;4337;0;0;0;0;.00nan;0;0
13923;187783;458;82;43;3;40;.930;3758000;0
13923;10565;458;0;0;0;0;.00nan;0;0
13923;15564;452;32;16;4;12;.750;3775000;0
13923;22349;452;0;0;0;0;.00nan;0;0
13924;2153;4337;0;0;0;0;.00nan;0;0
13924;167492;4337;23;34;7;27;.794;3600000;0
13924;9216;2579;48;24;3;21;.875;3600000;0
13924;15558;2579;0;0;0;0;.00nan;0;0
13925;172714;457;0;0;0;0;.00nan;0;0
13925;53830;457;85;27;1;26;.963;3600000;0
13925;75464;460;51;49;7;42;.857;3600000;0
13925;92283;460;0;0;0;0;.00nan;0;0
13926;161695;455;0;0;0;0;.00nan;0;0
13926;193012;455;51;23;2;21;.913;3568000;0
13926;172079;1086;0;0;0;0;.00nan;0;0
13926;172723;1086;91;35;1;34;.971;3600000;0
13927;182561;456;4;27;8;19;.704;2869000;0
13927;10794;459;0;0;0;0;.00nan;0;0
13927;85947;459;48;23;4;19;.826;3600000;0
13927;141635;456;57;9;1;8;.889;731000;0
13928;161695;455;21;31;7;24;.774;3600000;0
13928;193012;455;0;0;0;0;.00nan;0;0
13928;15564;452;67;31;3;28;.903;3600000;0
13928;22349;452;0;0;0;0;.00nan;0;0
13929;172079;1086;35;33;6;27;.818;3349000;0
13929;172723;1086;47;2;1;1;.500;251000;0
13929;10794;459;0;0;0;0;.00nan;0;0
13929;85947;459;1;33;11;22;.667;3600000;0
13930;172714;457;32;27;6;21;.778;3900000;0
13930;53830;457;0;0;0;0;.00nan;0;0
13930;75464;460;0;0;0;0;.00nan;0;0
13930;92283;460;28;32;6;26;.813;3900000;0
13931;182561;456;0;0;0;0;.00nan;0;0
13931;187783;458;81;30;2;28;.933;3600000;0
13931;10565;458;0;0;0;0;.00nan;0;0
13931;141635;456;41;24;5;19;.792;3600000;0
13932;187783;458;44;31;5;26;.839;3595000;0
13932;10565;458;0;0;0;0;.00nan;0;0
13932;75464;460;0;0;0;0;.00nan;0;0
13932;92283;460;56;31;4;27;.871;3600000;0
13933;2153;4337;0;0;0;0;.00nan;0;0
13933;167492;4337;69;38;3;35;.921;3596000;0
13933;172714;457;0;0;0;0;.00nan;0;0
13933;53830;457;86;32;1;31;.969;3600000;0
13934;9216;2579;0;0;0;0;.00nan;0;0
13934;10794;459;0;0;0;0;.00nan;0;0
13934;15558;2579;33;17;4;13;.765;3610000;0
13934;85947;459;71;31;3;28;.903;3610000;0
13935;161695;455;0;0;0;0;.00nan;0;0
13935;193012;455;66;25;2;23;.920;3600000;0
13935;172079;1086;45;5;1;4;.800;826000;0
13935;172723;1086;42;47;7;40;.851;2774000;0
13936;2153;4337;61;38;4;34;.895;3600000;0
13936;167492;4337;0;0;0;0;.00nan;0;0
13936;172714;457;30;11;3;8;.727;534000;0
13936;53830;457;63;25;2;23;.920;3040000;0
13937;9216;2579;27;17;5;12;.706;2236000;0
13937;10794;459;0;0;0;0;.00nan;0;0
13937;15558;2579;62;12;1;11;.917;1297000;0
13937;85947;459;65;41;4;37;.902;3600000;0
13938;161695;455;0;0;0;0;.00nan;0;0
13938;187783;458;53;18;2;16;.889;2478000;0
13938;193012;455;68;11;1;10;.909;3600000;0
13938;10565;458;31;19;4;15;.789;1122000;0
13939;161695;455;0;0;0;0;.00nan;0;0
13939;182561;456;55;25;3;22;.880;3538000;0
13939;193012;455;79;26;1;25;.962;3600000;0
13939;141635;456;0;0;0;0;.00nan;0;0
13940;2153;4337;92;41;3;38;.927;3575000;0
13940;172079;1086;0;0;0;0;.00nan;0;0
13940;167492;4337;0;0;0;0;.00nan;0;0
13940;172723;1086;65;25;2;23;.920;3600000;0
13941;9216;2579;0;0;0;0;.00nan;0;0
13941;172714;457;0;0;0;0;.00nan;0;0
13941;15558;2579;80;51;4;47;.922;3900000;0
13941;53830;457;55;26;4;22;.846;3900000;0
13942;182561;456;0;0;0;0;.00nan;0;0
13942;187783;458;0;0;0;0;.00nan;0;0
13942;10565;458;37;25;5;20;.800;3600000;0
13942;141635;456;22;25;6;19;.760;3551000;0
13943;2153;4337;0;0;0;0;.00nan;0;0
13943;172079;1086;45;22;4;18;.818;3900000;0
13943;167492;4337;74;40;4;36;.900;3900000;0
13943;172723;1086;0;0;0;0;.00nan;0;0
13944;161695;455;0;0;0;0;.00nan;0;0
13944;187783;458;36;63;10;53;.841;3600000;0
13944;193012;455;73;12;0;12;1.000;3600000;0
13944;10565;458;0;0;0;0;.00nan;0;0
13945;187783;458;0;0;0;0;.00nan;0;0
13945;10565;458;38;36;6;30;.833;3600000;0
13945;10794;459;65;17;1;16;.941;3600000;0
13945;85947;459;0;0;0;0;.00nan;0;0
13946;172079;1086;52;27;3;24;.889;3600000;0
13946;172723;1086;0;0;0;0;.00nan;0;0
13946;75464;460;23;29;6;23;.793;3009000;0
13946;92283;460;35;4;2;2;.500;591000;0
13947;172714;457;0;0;0;0;.00nan;0;0
13947;15564;452;13;12;5;7;.583;1863000;0
13947;22349;452;43;19;3;16;.842;1711000;0
13947;53830;457;56;37;6;31;.838;3600000;0
13948;182561;456;42;34;6;28;.824;3518000;0
13948;10794;459;0;0;0;0;.00nan;0;0
13948;85947;459;51;26;4;22;.846;3600000;0
13948;141635;456;0;0;0;0;.00nan;0;0
13949;161695;455;30;27;6;21;.778;3016000;0
13949;193005;455;51;4;0;4;1.000;584000;0
13949;9216;2579;0;0;0;0;.00nan;0;0
13949;15558;2579;73;33;3;30;.909;3600000;0
13950;182561;456;63;8;0;8;1.000;1193000;0
13950;187783;458;0;0;0;0;.00nan;0;0
13950;10565;458;25;21;6;15;.714;3600000;0
13950;141635;456;14;23;7;16;.696;2369000;0
13951;172079;1086;31;9;3;6;.667;1604000;0
13951;172723;1086;30;26;5;21;.808;1996000;0
13951;75464;460;0;0;0;0;.00nan;0;0
13951;92283;460;62;22;2;20;.909;3600000;0
13952;161695;455;0;0;0;0;.00nan;0;0
13952;193005;455;61;21;2;19;.905;3600000;0
13952;9216;2579;46;36;5;31;.861;3600000;0
13952;15558;2579;0;0;0;0;.00nan;0;0
13953;9216;2579;51;2;0;2;1.000;591000;0
13953;15558;2579;13;20;6;14;.700;2930000;0
13953;15564;452;0;0;0;0;.00nan;0;0
13953;22349;452;54;28;4;24;.857;3600000;0
13954;161695;455;20;8;4;4;.500;917000;0
13954;182561;456;63;31;3;28;.903;3600000;0
13954;193005;455;56;17;2;15;.882;2683000;0
13954;141635;456;0;0;0;0;.00nan;0;0
13955;182561;456;0;0;0;0;.00nan;0;0
13955;15564;452;10;18;6;12;.667;3600000;0
13955;22349;452;0;0;0;0;.00nan;0;0
13955;141635;456;85;34;2;32;.941;3600000;0
13956;2153;4337;86;42;2;40;.952;3900000;0
13956;167492;4337;0;0;0;0;.00nan;0;0
13956;10794;459;0;0;0;0;.00nan;0;0
13956;85947;459;83;26;2;24;.923;3900000;0
13957;172079;1086;45;25;5;20;.800;3600000;0
13957;172714;457;0;0;0;0;.00nan;0;0
13957;172723;1086;0;0;0;0;.00nan;0;0
13957;53830;457;55;43;6;37;.860;3600000;0
13958;2153;4337;0;0;0;0;.00nan;0;0
13958;187783;458;24;34;7;27;.794;3600000;0
13958;167492;4337;85;28;1;27;.964;3600000;0
13958;10565;458;0;0;0;0;.00nan;0;0
13959;172079;1086;0;0;0;0;.00nan;0;0
13959;172723;1086;64;31;3;28;.903;3811000;0
13959;75464;460;0;0;0;0;.00nan;0;0
13959;92283;460;74;31;2;29;.935;3811000;0
13960;161695;455;0;0;0;0;.00nan;0;0
13960;193005;455;41;35;5;30;.857;3600000;0
13960;9216;2579;42;37;6;31;.838;3600000;0
13960;15558;2579;0;0;0;0;.00nan;0;0
13961;15564;452;72;23;2;21;.913;3600000;0
13961;22349;452;0;0;0;0;.00nan;0;0
13961;75464;460;0;0;0;0;.00nan;0;0
13961;92283;460;51;32;5;27;.844;3600000;0
13962;182561;456;61;38;4;34;.895;3527000;0
13962;172079;1086;0;0;0;0;.00nan;0;0
13962;172723;1086;62;22;2;20;.909;3600000;0
13962;141635;456;0;0;0;0;.00nan;0;0
13963;2153;4337;0;0;0;0;.00nan;0;0
13963;167492;4337;46;27;5;22;.815;3600000;0
13963;172714;457;0;0;0;0;.00nan;0;0
13963;53830;457;51;34;6;28;.824;3600000;0
13964;172079;1086;48;32;6;26;.813;3576000;0
13964;172723;1086;0;0;0;0;.00nan;0;0
13964;15564;452;38;30;5;25;.833;3600000;0
13964;22349;452;0;0;0;0;.00nan;0;0
13965;161695;455;0;0;0;0;.00nan;0;0
13965;193012;455;25;23;6;17;.739;3600000;0
13965;10794;459;0;0;0;0;.00nan;0;0
13965;85947;459;95;57;3;54;.947;3600000;0
13966;161695;455;59;25;3;22;.880;3812000;0
13966;187783;458;59;23;2;21;.913;3812000;0
13966;193012;455;0;0;0;0;.00nan;0;0
13966;10565;458;0;0;0;0;.00nan;0;0
13967;2153;4337;24;5;3;2;.400;523000;0
13967;167492;4337;51;14;2;12;.857;3377000;0
13967;172714;457;37;30;5;25;.833;3900000;0
13967;53830;457;0;0;0;0;.00nan;0;0
13968;182561;456;56;40;5;35;.875;3600000;0
13968;75464;460;0;0;0;0;.00nan;0;0
13968;92283;460;72;24;1;23;.958;3600000;0
13968;141635;456;0;0;0;0;.00nan;0;0
13969;2153;4337;53;10;1;9;.900;404000;0
13969;187783;458;76;35;4;31;.886;3600000;0
13969;167492;4337;45;27;4;23;.852;3184000;0
13969;10565;458;0;0;0;0;.00nan;0;0
13970;161695;455;0;0;0;0;.00nan;0;0
13970;193012;455;71;24;2;22;.917;3600000;0
13970;75464;460;33;37;7;30;.811;3600000;0
13970;92283;460;0;0;0;0;.00nan;0;0
13971;172714;457;0;0;0;0;.00nan;0;0
13971;15564;452;43;38;5;33;.868;3900000;0
13971;22349;452;0;0;0;0;.00nan;0;0
13971;53830;457;51;26;5;21;.808;3900000;0
13972;172079;1086;92;29;2;27;.931;3600000;0
13972;172714;457;28;24;5;19;.792;2335000;0
13972;172723;1086;0;0;0;0;.00nan;0;0
13972;53830;457;64;15;1;14;.933;1265000;0
13973;182561;456;77;40;3;37;.925;3900000;0
13973;9216;2579;0;0;0;0;.00nan;0;0
13973;15558;2579;72;25;3;22;.880;3900000;0
13973;141635;456;0;0;0;0;.00nan;0;0
13974;182561;456;51;44;6;38;.864;3561000;0
13974;9216;2579;23;10;4;6;.600;3600000;0
13974;15558;2579;0;0;0;0;.00nan;0;0
13974;141635;456;0;0;0;0;.00nan;0;0
13976;182561;456;32;33;7;26;.788;3600000;0
13976;172079;1086;85;34;2;32;.941;3600000;0
13976;172723;1086;0;0;0;0;.00nan;0;0
13976;141635;456;0;0;0;0;.00nan;0;0
13978;187783;458;45;27;4;23;.852;3042000;0
13978;164913;458;20;9;4;5;.556;558000;0
13978;181071;459;0;0;0;0;.00nan;0;0
13978;85947;459;68;25;3;22;.880;3600000;0
13980;193012;455;0;0;0;0;.00nan;0;0
13980;172714;457;0;0;0;0;.00nan;0;0
13980;175530;455;65;27;3;24;.889;3900000;0
13980;53830;457;67;24;3;21;.875;3900000;0
13982;15564;452;42;21;4;17;.810;3600000;0
13982;22349;452;0;0;0;0;.00nan;0;0
13982;75464;460;32;28;5;23;.821;3599000;0
13982;92283;460;0;0;0;0;.00nan;0;0
13984;2153;4337;0;0;0;0;.00nan;0;0
13984;167492;4337;66;33;3;30;.909;3600000;0
13984;9216;2579;0;0;0;0;.00nan;0;0
13984;15558;2579;33;20;4;16;.800;3572000;0
13986;182561;456;0;0;0;0;.00nan;0;0
13986;187783;458;0;0;0;0;.00nan;0;0
13986;164913;458;65;28;3;25;.893;3600000;0
13986;141635;456;40;27;5;22;.815;3522000;0
13988;172714;457;0;0;0;0;.00nan;0;0
13988;181071;459;20;30;7;23;.767;3600000;0
13988;53830;457;23;22;6;16;.727;3600000;0
13988;85947;459;0;0;0;0;.00nan;0;0
13990;2153;4337;0;0;0;0;.00nan;0;0
13990;167492;4337;79;29;2;27;.931;3600000;0
13990;75464;460;0;0;0;0;.00nan;0;0
13990;92283;460;39;18;3;15;.833;3585000;0
13992;193012;455;0;0;0;0;.00nan;0;0
13992;15564;452;81;27;1;26;.963;3600000;0
13992;22349;452;0;0;0;0;.00nan;0;0
13992;175530;455;67;38;3;35;.921;3515000;0
13994;172079;1086;39;28;5;23;.821;3588000;0
13994;9216;2579;0;0;0;0;.00nan;0;0
13994;172723;1086;0;0;0;0;.00nan;0;0
13994;15558;2579;55;21;3;18;.857;3600000;0
13996;2153;4337;30;40;7;33;.825;3600000;0
13996;167492;4337;0;0;0;0;.00nan;0;0
13996;181071;459;0;0;0;0;.00nan;0;0
13996;85947;459;57;25;4;21;.840;3600000;0
13998;193012;455;43;3;1;2;.667;543000;0
13998;175530;455;27;31;6;25;.806;3057000;0
13998;75464;460;63;25;3;22;.880;3600000;0
13998;92283;460;0;0;0;0;.00nan;0;0
14000;187783;458;42;26;4;22;.846;3546000;0
14000;172714;457;42;16;3;13;.813;3600000;0
14000;164913;458;0;0;0;0;.00nan;0;0
14000;53830;457;0;0;0;0;.00nan;0;0
14002;182561;456;10;27;7;20;.741;2528000;0
14002;172079;1086;0;0;0;0;.00nan;0;0
14002;172723;1086;79;34;3;31;.912;3600000;0
14002;141635;456;53;4;0;4;1.000;1072000;0
14004;9216;2579;66;27;2;25;.926;3600000;0
14004;15558;2579;0;0;0;0;.00nan;0;0
14004;15564;452;62;9;0;9;1.000;1287000;0
14004;22349;452;42;26;5;21;.808;2313000;0
14006;15564;452;53;24;4;20;.833;3600000;0
14006;22349;452;0;0;0;0;.00nan;0;0
14006;75464;460;0;0;0;0;.00nan;0;0
14006;92283;460;33;24;5;19;.792;3548000;0
14008;2153;4337;50;1;0;1;1.000;501000;0
14008;172079;1086;52;33;4;29;.879;3600000;0
14008;167492;4337;28;26;6;20;.769;3014000;0
14008;172723;1086;0;0;0;0;.00nan;0;0
14010;187783;458;0;0;0;0;.00nan;0;0
14010;172714;457;0;0;0;0;.00nan;0;0
14010;164913;458;34;26;5;21;.808;3600000;0
14010;53830;457;48;22;3;19;.864;3600000;0
14012;193012;455;70;14;0;14;1.000;1278000;0
14012;175530;455;62;32;4;28;.875;2322000;0
14012;181071;459;44;17;3;14;.824;3600000;0
14012;85947;459;0;0;0;0;.00nan;0;0
14014;182561;456;39;27;4;23;.852;3524000;0
14014;9216;2579;0;0;0;0;.00nan;0;0
14014;15558;2579;61;25;2;23;.920;3600000;0
14014;141635;456;0;0;0;0;.00nan;0;0
19936;161695;455;0;0;0;0;.00nan;0;0
19936;193012;455;51;28;4;24;.857;3600000;0
19936;75464;460;0;0;0;0;.00nan;0;0
19936;92283;460;52;36;5;31;.861;3600000;0
19937;9216;2579;0;0;0;0;.00nan;0;0
19937;15558;2579;58;32;4;28;.875;4195000;0
19937;15564;452;50;23;3;20;.870;4195000;0
19937;22349;452;0;0;0;0;.00nan;0;0
19963;161695;455;0;0;0;0;.00nan;0;0
19963;193012;455;42;26;4;22;.846;3600000;0
19963;10794;459;0;0;0;0;.00nan;0;0
19963;85947;459;84;28;1;27;.964;3600000;0
19964;172079;1086;0;0;0;0;.00nan;0;0
19964;172723;1086;83;27;1;26;.963;3600000;0
19964;15564;452;62;29;3;26;.897;3600000;0
19964;22349;452;0;0;0;0;.00nan;0;0
20024;172079;1086;0;0;0;0;.00nan;0;0
20024;172723;1086;34;29;6;23;.793;3600000;0
20024;10794;459;0;0;0;0;.00nan;0;0
20024;85947;459;51;24;4;20;.833;3600000;0
14015;-1;165;0;0;0;0;.00nan;0;0
14015;-1;165;35;20;4;16;.800;3544000;0
14015;175651;4715;91;51;3;48;.941;3600000;0
14015;181874;4715;0;0;0;0;.00nan;0;0
14016;166423;4919;0;0;0;0;.00nan;0;0
14016;175658;4919;36;23;4;19;.826;3585000;0
14016;175712;4998;0;0;0;0;.00nan;0;0
14016;85228;4998;68;30;2;28;.933;3600000;0
14017;-1;165;0;0;0;0;.00nan;0;0
14017;-1;165;64;27;3;24;.889;3600000;0
14017;175651;4715;63;45;5;40;.889;3600000;0
14017;181874;4715;0;0;0;0;.00nan;0;0
14018;166423;4919;53;10;1;9;.900;1027000;0
14018;175658;4919;37;36;6;30;.833;3173000;0
14018;175712;4998;43;6;1;5;.833;1271000;0
14018;85228;4998;29;29;6;23;.793;2929000;0
14019;187391;4246;0;0;0;0;.00nan;0;0
14019;59231;4714;100;29;0;29;1.000;3600000;0
14019;91413;4714;0;0;0;0;.00nan;0;0
14019;161129;4246;65;34;3;31;.912;3600000;0
14020;-1;165;74;36;3;33;.917;3600000;0
14020;-1;165;0;0;0;0;.00nan;0;0
14020;175712;4998;0;0;0;0;.00nan;0;0
14020;85228;4998;73;44;4;40;.909;3590000;0
14021;180731;4991;66;24;2;22;.917;3600000;0
14021;182097;4992;0;0;0;0;.00nan;0;0
14021;86151;4992;36;38;6;32;.842;3600000;0
14021;161128;4991;0;0;0;0;.00nan;0;0
14022;166423;4919;0;0;0;0;.00nan;0;0
14022;175651;4715;45;32;5;27;.844;3600000;0
14022;175658;4919;86;34;2;32;.941;3600000;0
14022;181874;4715;0;0;0;0;.00nan;0;0
14023;187391;4246;56;30;4;26;.867;3614000;0
14023;59231;4714;54;38;5;33;.868;3614000;0
14023;91413;4714;0;0;0;0;.00nan;0;0
14023;161129;4246;0;0;0;0;.00nan;0;0
14024;166423;4919;49;30;4;26;.867;3600000;0
14024;175651;4715;0;0;0;0;.00nan;0;0
14024;175658;4919;0;0;0;0;.00nan;0;0
14024;181874;4715;78;25;1;24;.960;3600000;0
14025;-1;165;0;0;0;0;.00nan;0;0
14025;-1;165;72;25;1;24;.960;3600000;0
14025;175712;4998;42;31;5;26;.839;3600000;0
14025;85228;4998;0;0;0;0;.00nan;0;0
14026;180731;4991;53;35;5;30;.857;3600000;0
14026;182097;4992;0;0;0;0;.00nan;0;0
14026;86151;4992;82;36;2;34;.944;3600000;0
14026;161128;4991;0;0;0;0;.00nan;0;0
14027;-1;165;57;27;3;24;.889;3815000;0
14027;-1;165;0;0;0;0;.00nan;0;0
14027;175651;4715;82;50;4;46;.920;3815000;0
14027;181874;4715;0;0;0;0;.00nan;0;0
14028;161583;4839;59;20;2;18;.900;3600000;0
14028;-1;4997;0;0;0;0;.00nan;0;0
14028;-1;4839;0;0;0;0;.00nan;0;0
14028;78820;4997;33;30;6;24;.800;3600000;0
14029;-1;165;0;0;0;0;.00nan;0;0
14029;-1;165;46;30;5;25;.833;3918000;0
14029;175651;4715;0;0;0;0;.00nan;0;0
14029;181874;4715;55;30;4;26;.867;3918000;0
14030;180731;4991;78;26;2;24;.923;3600000;0
14030;187391;4246;61;30;3;27;.900;3545000;0
14030;161128;4991;0;0;0;0;.00nan;0;0
14030;161129;4246;0;0;0;0;.00nan;0;0
14031;175712;4998;0;0;0;0;.00nan;0;0
14031;181341;1368;51;29;4;25;.862;3972000;0
14031;55660;1368;0;0;0;0;.00nan;0;0
14031;85228;4998;76;44;3;41;.932;3972000;0
14032;182097;4992;0;0;0;0;.00nan;0;0
14032;59231;4714;77;26;2;24;.923;3600000;0
14032;86151;4992;74;34;3;31;.912;3567000;0
14032;91413;4714;0;0;0;0;.00nan;0;0
14033;161583;4839;52;34;4;30;.882;3567000;0
14033;-1;4997;0;0;0;0;.00nan;0;0
14033;-1;4839;0;0;0;0;.00nan;0;0
14033;78820;4997;72;24;2;22;.917;3600000;0
14034;182097;4992;24;6;3;3;.500;307000;0
14034;59231;4714;0;0;0;0;.00nan;0;0
14034;86151;4992;60;38;5;33;.868;3293000;0
14034;91413;4714;51;24;4;20;.833;3600000;0
14035;175712;4998;46;51;7;44;.863;3588000;0
14035;181341;1368;45;26;5;21;.808;3600000;0
14035;55660;1368;0;0;0;0;.00nan;0;0
14035;85228;4998;0;0;0;0;.00nan;0;0
14036;180731;4991;0;0;0;0;.00nan;0;0
14036;187391;4246;20;32;7;25;.781;3600000;0
14036;161128;4991;65;27;3;24;.889;3600000;0
14036;161129;4246;0;0;0;0;.00nan;0;0
14037;166423;4919;0;0;0;0;.00nan;0;0
14037;-1;165;75;45;5;40;.889;3600000;0
14037;-1;165;0;0;0;0;.00nan;0;0
14037;175658;4919;85;32;2;30;.938;3600000;0
14038;161583;4839;0;0;0;0;.00nan;0;0
14038;-1;4997;25;24;6;18;.750;2526000;0
14038;-1;4839;51;42;6;36;.857;3600000;0
14038;78820;4997;24;14;4;10;.714;1074000;0
14039;175651;4715;46;44;7;37;.841;3600000;0
14039;181874;4715;0;0;0;0;.00nan;0;0
14039;59231;4714;0;0;0;0;.00nan;0;0
14039;91413;4714;67;19;2;17;.895;3600000;0
14040;181341;1368;23;25;6;19;.760;3600000;0
14040;182097;4992;0;0;0;0;.00nan;0;0
14040;55660;1368;0;0;0;0;.00nan;0;0
14040;86151;4992;71;21;2;19;.905;3600000;0
14041;166423;4919;0;0;0;0;.00nan;0;0
14041;175658;4919;68;25;2;23;.920;3600000;0
14041;175712;4998;0;0;0;0;.00nan;0;0
14041;85228;4998;69;29;3;26;.897;3600000;0
14042;-1;4997;0;0;0;0;.00nan;0;0
14042;180731;4991;71;28;3;25;.893;3600000;0
14042;78820;4997;44;26;4;22;.846;3571000;0
14042;161128;4991;0;0;0;0;.00nan;0;0
14043;181341;1368;0;0;0;0;.00nan;0;0
14043;182097;4992;43;4;1;3;.750;339000;0
14043;55660;1368;66;21;2;19;.905;3600000;0
14043;86151;4992;55;55;8;47;.855;3261000;0
14044;175651;4715;76;47;4;43;.915;3567000;0
14044;181874;4715;0;0;0;0;.00nan;0;0
14044;59231;4714;42;16;3;13;.813;3600000;0
14044;91413;4714;0;0;0;0;.00nan;0;0
14045;-1;165;0;0;0;0;.00nan;0;0
14045;-1;165;6;24;8;16;.667;3600000;0
14045;175712;4998;1;30;9;21;.700;3559000;0
14045;85228;4998;0;0;0;0;.00nan;0;0
14046;161583;4839;76;37;3;34;.919;3558000;0
14046;-1;4997;0;0;0;0;.00nan;0;0
14046;-1;4839;0;0;0;0;.00nan;0;0
14046;78820;4997;72;28;2;26;.929;3600000;0
14047;-1;165;53;4;0;4;1.000;399000;0
14047;-1;165;19;23;6;17;.739;3201000;0
14047;181341;1368;75;30;3;27;.900;3600000;0
14047;55660;1368;0;0;0;0;.00nan;0;0
14048;166423;4919;0;0;0;0;.00nan;0;0
14048;175651;4715;34;34;6;28;.824;3600000;0
14048;175658;4919;57;30;5;25;.833;3600000;0
14048;181874;4715;0;0;0;0;.00nan;0;0
14049;180731;4991;68;39;4;35;.897;3600000;0
14049;182097;4992;0;0;0;0;.00nan;0;0
14049;86151;4992;66;38;5;33;.868;3576000;0
14049;161128;4991;0;0;0;0;.00nan;0;0
14050;187391;4246;31;10;3;7;.700;789000;0
14050;59231;4714;66;44;5;39;.886;3600000;0
14050;91413;4714;0;0;0;0;.00nan;0;0
14050;161129;4246;29;30;6;24;.800;2811000;0
14051;161583;4839;0;0;0;0;.00nan;0;0
14051;-1;4997;92;18;0;18;1.000;3600000;0
14051;-1;4839;57;19;2;17;.895;3578000;0
14051;78820;4997;0;0;0;0;.00nan;0;0
14052;187391;4246;41;34;6;28;.824;3089000;0
14052;59231;4714;54;7;1;6;.857;954000;0
14052;91413;4714;38;29;6;23;.793;2960000;0
14052;161129;4246;46;15;2;13;.867;825000;0
14053;175651;4715;0;0;0;0;.00nan;0;0
14053;175712;4998;0;0;0;0;.00nan;0;0
14053;181874;4715;90;39;2;37;.949;3600000;0
14053;85228;4998;71;31;4;27;.871;3513000;0
14054;-1;165;89;34;2;32;.941;3561000;0
14054;-1;165;0;0;0;0;.00nan;0;0
14054;181341;1368;0;0;0;0;.00nan;0;0
14054;55660;1368;74;21;1;20;.952;3600000;0
14055;180731;4991;0;0;0;0;.00nan;0;0
14055;182097;4992;0;0;0;0;.00nan;0;0
14055;86151;4992;49;28;4;24;.857;4028000;0
14055;161128;4991;52;29;5;24;.828;4028000;0
14056;-1;165;0;0;0;0;.00nan;0;0
14056;-1;165;55;26;3;23;.885;3600000;0
14056;175651;4715;80;50;5;45;.900;3562000;0
14056;181874;4715;0;0;0;0;.00nan;0;0
14057;166423;4919;0;0;0;0;.00nan;0;0
14057;175658;4919;28;24;5;19;.792;3600000;0
14057;175712;4998;0;0;0;0;.00nan;0;0
14057;85228;4998;51;41;6;35;.854;3600000;0
14058;161583;4839;78;27;2;25;.926;3600000;0
14058;-1;4839;0;0;0;0;.00nan;0;0
14058;180731;4991;59;27;4;23;.852;3527000;0
14058;161128;4991;0;0;0;0;.00nan;0;0
14059;181341;1368;61;25;3;22;.880;3600000;0
14059;182097;4992;0;0;0;0;.00nan;0;0
14059;55660;1368;0;0;0;0;.00nan;0;0
14059;86151;4992;50;36;5;31;.861;3523000;0
14060;-1;4997;67;48;5;43;.896;4105000;0
14060;187391;4246;30;27;6;21;.778;4105000;0
14060;78820;4997;0;0;0;0;.00nan;0;0
14060;161129;4246;0;0;0;0;.00nan;0;0
14061;175651;4715;0;0;0;0;.00nan;0;0
14061;175712;4998;0;0;0;0;.00nan;0;0
14061;181874;4715;26;31;6;25;.806;3581000;0
14061;85228;4998;51;35;5;30;.857;3600000;0
14062;181341;1368;54;4;0;4;1.000;622000;0
14062;182097;4992;0;0;0;0;.00nan;0;0
14062;55660;1368;40;34;6;28;.824;2973000;0
14062;86151;4992;49;28;5;23;.821;3600000;0
14063;166423;4919;31;30;6;24;.800;2341000;0
14063;-1;165;88;21;0;21;1.000;3600000;0
14063;-1;165;0;0;0;0;.00nan;0;0
14063;175658;4919;48;14;2;12;.857;1259000;0
14064;-1;4997;0;0;0;0;.00nan;0;0
14064;187391;4246;0;0;0;0;.00nan;0;0
14064;78820;4997;53;24;3;21;.875;3518000;0
14064;161129;4246;77;29;1;28;.966;3600000;0
14065;161583;4839;0;0;0;0;.00nan;0;0
14065;-1;4839;68;33;3;30;.909;3600000;0
14065;180731;4991;0;0;0;0;.00nan;0;0
14065;161128;4991;87;18;0;18;1.000;3600000;0
14066;-1;165;62;29;3;26;.897;3600000;0
14066;-1;165;0;0;0;0;.00nan;0;0
14066;175712;4998;36;7;2;5;.714;827000;0
14066;85228;4998;40;36;6;30;.833;2773000;0
14067;166423;4919;0;0;0;0;.00nan;0;0
14067;175658;4919;57;28;3;25;.893;3878000;0
14067;59231;4714;64;36;4;32;.889;3878000;0
14067;91413;4714;0;0;0;0;.00nan;0;0
14068;-1;4997;0;0;0;0;.00nan;0;0
14068;180731;4991;50;9;1;8;.889;599000;0
14068;78820;4997;67;23;2;21;.913;3600000;0
14068;161128;4991;33;32;6;26;.813;3001000;0
14069;175651;4715;52;36;4;32;.889;3600000;0
14069;181874;4715;0;0;0;0;.00nan;0;0
14069;59231;4714;85;29;1;28;.966;3600000;0
14069;91413;4714;0;0;0;0;.00nan;0;0
14070;-1;165;0;0;0;0;.00nan;0;0
14070;-1;165;78;21;1;20;.952;3600000;0
14070;175712;4998;0;0;0;0;.00nan;0;0
14070;85228;4998;67;32;4;28;.875;3600000;0
14071;161583;4839;64;31;3;28;.903;3600000;0
14071;-1;4839;0;0;0;0;.00nan;0;0
14071;181341;1368;46;43;7;36;.837;3358000;0
14071;55660;1368;50;1;0;1;1.000;242000;0
14072;180731;4991;62;36;5;31;.861;3600000;0
14072;187391;4246;0;0;0;0;.00nan;0;0
14072;161128;4991;0;0;0;0;.00nan;0;0
14072;161129;4246;45;40;6;34;.850;3600000;0
14073;-1;4997;18;10;4;6;.600;814000;0
14073;182097;4992;0;0;0;0;.00nan;0;0
14073;78820;4997;64;20;2;18;.900;2726000;0
14073;86151;4992;49;24;4;20;.833;3600000;0
14074;161583;4839;0;0;0;0;.00nan;0;0
14074;-1;4839;44;36;6;30;.833;3600000;0
14074;181341;1368;0;0;0;0;.00nan;0;0
14074;55660;1368;67;24;2;22;.917;3600000;0
14075;175651;4715;80;40;3;37;.925;3600000;0
14075;181874;4715;0;0;0;0;.00nan;0;0
14075;59231;4714;0;0;0;0;.00nan;0;0
14075;91413;4714;59;34;4;30;.882;3581000;0
14076;-1;165;55;20;2;18;.900;3600000;0
14076;-1;165;0;0;0;0;.00nan;0;0
14076;175712;4998;41;28;5;23;.821;3600000;0
14076;85228;4998;0;0;0;0;.00nan;0;0
14077;-1;4997;23;22;6;16;.727;3892000;0
14077;182097;4992;0;0;0;0;.00nan;0;0
14077;78820;4997;0;0;0;0;.00nan;0;0
14077;86151;4992;42;27;5;22;.815;3892000;0
14078;180731;4991;0;0;0;0;.00nan;0;0
14078;187391;4246;55;30;4;26;.867;3571000;0
14078;161128;4991;68;28;3;25;.893;3600000;0
14078;161129;4246;0;0;0;0;.00nan;0;0
14079;-1;165;0;0;0;0;.00nan;0;0
14079;-1;165;86;28;2;26;.929;3600000;0
14079;175651;4715;55;38;5;33;.868;3600000;0
14079;181874;4715;0;0;0;0;.00nan;0;0
14080;161583;4839;96;42;3;39;.929;4200000;0
14080;-1;4839;0;0;0;0;.00nan;0;0
14080;182097;4992;0;0;0;0;.00nan;0;0
14080;86151;4992;77;36;3;33;.917;4200000;0
14081;175712;4998;0;0;0;0;.00nan;0;0
14081;59231;4714;77;34;2;32;.941;3600000;0
14081;85228;4998;59;33;4;29;.879;3525000;0
14081;91413;4714;0;0;0;0;.00nan;0;0
14082;181341;1368;53;30;4;26;.867;3600000;0
14082;187391;4246;0;0;0;0;.00nan;0;0
14082;55660;1368;0;0;0;0;.00nan;0;0
14082;161129;4246;72;43;5;38;.884;3571000;0
14083;-1;4997;0;0;0;0;.00nan;0;0
14083;180731;4991;70;29;3;26;.897;3600000;0
14083;78820;4997;82;39;4;35;.897;3552000;0
14083;161128;4991;0;0;0;0;.00nan;0;0
14084;181341;1368;0;0;0;0;.00nan;0;0
14084;187391;4246;0;0;0;0;.00nan;0;0
14084;55660;1368;69;34;3;31;.912;3600000;0
14084;161129;4246;19;31;7;24;.774;3600000;0
14085;166423;4919;0;0;0;0;.00nan;0;0
14085;175651;4715;0;0;0;0;.00nan;0;0
14085;175658;4919;88;40;2;38;.950;3600000;0
14085;181874;4715;70;33;3;30;.909;3600000;0
14086;161583;4839;0;0;0;0;.00nan;0;0
14086;-1;4839;97;52;3;49;.942;4200000;0
14086;182097;4992;40;17;3;14;.824;4200000;0
14086;86151;4992;0;0;0;0;.00nan;0;0
14087;175712;4998;66;30;3;27;.900;3555000;0
14087;59231;4714;0;0;0;0;.00nan;0;0
14087;85228;4998;0;0;0;0;.00nan;0;0
14087;91413;4714;94;40;2;38;.950;3600000;0
14088;-1;4997;79;30;1;29;.967;3571000;0
14088;180731;4991;0;0;0;0;.00nan;0;0
14088;78820;4997;0;0;0;0;.00nan;0;0
14088;161128;4991;100;28;0;28;1.000;3600000;0
14089;181341;1368;41;25;5;20;.800;3600000;0
14089;187391;4246;37;38;6;32;.842;3334000;0
14089;55660;1368;0;0;0;0;.00nan;0;0
14089;161129;4246;48;0;0;0;.00nan;248000;0
14090;166423;4919;70;19;1;18;.947;3600000;0
14090;175658;4919;0;0;0;0;.00nan;0;0
14090;59231;4714;71;38;4;34;.895;3600000;0
14090;91413;4714;0;0;0;0;.00nan;0;0
14091;187391;4246;0;0;0;0;.00nan;0;0
14091;59231;4714;80;35;3;32;.914;3600000;0
14091;91413;4714;0;0;0;0;.00nan;0;0
14091;161129;4246;48;32;4;28;.875;3548000;0
14092;166423;4919;50;18;2;16;.889;1609000;0
14092;175651;4715;70;29;3;26;.897;3600000;0
14092;175658;4919;23;15;5;10;.667;1991000;0
14092;181874;4715;0;0;0;0;.00nan;0;0
14093;161583;4839;84;31;2;29;.935;4200000;0
14093;-1;4839;0;0;0;0;.00nan;0;0
14093;180731;4991;0;0;0;0;.00nan;0;0
14093;161128;4991;95;45;2;43;.956;4200000;0
14094;-1;165;60;32;4;28;.875;3551000;0
14094;-1;165;0;0;0;0;.00nan;0;0
14094;181341;1368;82;35;3;32;.914;3600000;0
14094;55660;1368;0;0;0;0;.00nan;0;0
14095;-1;4997;0;0;0;0;.00nan;0;0
14095;182097;4992;0;0;0;0;.00nan;0;0
14095;78820;4997;69;29;3;26;.897;3564000;0
14095;86151;4992;71;25;2;23;.920;3600000;0
14096;-1;165;0;0;0;0;.00nan;0;0
14096;-1;165;90;22;0;22;1.000;3600000;0
14096;181341;1368;0;0;0;0;.00nan;0;0
14096;55660;1368;93;38;1;37;.974;3595000;0
14097;187391;4246;66;25;3;22;.880;3600000;0
14097;59231;4714;41;9;2;7;.778;1441000;0
14097;91413;4714;37;27;5;22;.815;2159000;0
14097;161129;4246;0;0;0;0;.00nan;0;0
14098;161583;4839;0;0;0;0;.00nan;0;0
14098;-1;4839;74;29;2;27;.931;3600000;0
14098;180731;4991;42;24;4;20;.833;3571000;0
14098;161128;4991;0;0;0;0;.00nan;0;0
14099;166423;4919;0;0;0;0;.00nan;0;0
14099;175658;4919;48;24;4;20;.833;3580000;0
14099;175712;4998;0;0;0;0;.00nan;0;0
14099;85228;4998;76;35;3;32;.914;3600000;0
14100;-1;4997;78;31;2;29;.935;3600000;0
14100;182097;4992;24;28;6;22;.786;2866000;0
14100;78820;4997;0;0;0;0;.00nan;0;0
14100;86151;4992;58;6;0;6;1.000;734000;0
14101;-1;4997;0;0;0;0;.00nan;0;0
14101;180731;4991;45;41;6;35;.854;3600000;0
14101;78820;4997;87;34;3;31;.912;3600000;0
14101;161128;4991;0;0;0;0;.00nan;0;0
14102;-1;165;0;0;0;0;.00nan;0;0
14102;-1;165;72;37;3;34;.919;4200000;0
14102;175712;4998;0;0;0;0;.00nan;0;0
14102;85228;4998;63;38;3;35;.921;4200000;0
14103;166423;4919;0;0;0;0;.00nan;0;0
14103;175651;4715;60;33;4;29;.879;3600000;0
14103;175658;4919;89;31;1;30;.968;3600000;0
14103;181874;4715;0;0;0;0;.00nan;0;0
14104;181341;1368;27;26;6;20;.769;3600000;0
14104;55660;1368;0;0;0;0;.00nan;0;0
14104;59231;4714;47;42;7;35;.833;3594000;0
14104;91413;4714;0;0;0;0;.00nan;0;0
14105;161583;4839;68;35;3;32;.914;4200000;0
14105;-1;4839;0;0;0;0;.00nan;0;0
14105;180731;4991;0;0;0;0;.00nan;0;0
14105;161128;4991;64;31;3;28;.903;4200000;0
14106;-1;4997;37;26;6;20;.769;3600000;0
14106;182097;4992;52;11;1;10;.909;549000;0
14106;78820;4997;0;0;0;0;.00nan;0;0
14106;86151;4992;28;35;7;28;.800;3051000;0
14107;181341;1368;84;41;3;38;.927;3600000;0
14107;187391;4246;0;0;0;0;.00nan;0;0
14107;55660;1368;0;0;0;0;.00nan;0;0
14107;161129;4246;49;32;4;28;.875;3544000;0
14108;175651;4715;0;0;0;0;.00nan;0;0
14108;175712;4998;49;13;2;11;.846;3553000;0
14108;181874;4715;94;39;1;38;.974;3600000;0
14108;85228;4998;0;0;0;0;.00nan;0;0
14109;166423;4919;64;44;4;40;.909;3600000;0
14109;-1;165;38;26;5;21;.808;3545000;0
14109;-1;165;0;0;0;0;.00nan;0;0
14109;175658;4919;0;0;0;0;.00nan;0;0
14110;161583;4839;0;0;0;0;.00nan;0;0
14110;-1;4839;28;33;7;26;.788;3608000;0
14110;182097;4992;0;0;0;0;.00nan;0;0
14110;86151;4992;36;35;6;29;.829;3553000;0
14111;-1;4997;0;0;0;0;.00nan;0;0
14111;180731;4991;56;35;5;30;.857;3314000;0
14111;78820;4997;53;42;6;36;.857;4011000;0
14111;161128;4991;59;7;0;7;1.000;697000;0
14112;166423;4919;0;0;0;0;.00nan;0;0
14112;-1;165;0;0;0;0;.00nan;0;0
14112;-1;165;85;32;2;30;.938;3600000;0
14112;175658;4919;77;44;5;39;.886;3600000;0
14113;181341;1368;57;34;5;29;.853;3600000;0
14113;182097;4992;23;11;4;7;.636;1628000;0
14113;55660;1368;0;0;0;0;.00nan;0;0
14113;86151;4992;24;23;6;17;.739;1972000;0
14114;175712;4998;57;11;1;10;.909;593000;0
14114;187391;4246;81;27;2;25;.926;3600000;0
14114;85228;4998;37;35;6;29;.829;3007000;0
14114;161129;4246;0;0;0;0;.00nan;0;0
14115;175651;4715;47;28;4;24;.857;3600000;0
14115;181874;4715;0;0;0;0;.00nan;0;0
14115;59231;4714;67;25;2;23;.920;3600000;0
14115;91413;4714;0;0;0;0;.00nan;0;0
14116;161583;4839;49;40;6;34;.850;3548000;0
14116;-1;4839;0;0;0;0;.00nan;0;0
14116;181341;1368;0;0;0;0;.00nan;0;0
14116;55660;1368;55;26;4;22;.846;3600000;0
14117;175651;4715;0;0;0;0;.00nan;0;0
14117;181874;4715;28;39;7;32;.821;3600000;0
14117;59231;4714;0;0;0;0;.00nan;0;0
14117;91413;4714;77;45;4;41;.911;3600000;0
14118;175712;4998;76;52;5;47;.904;3600000;0
14118;187391;4246;62;34;4;30;.882;3600000;0
14118;85228;4998;0;0;0;0;.00nan;0;0
14118;161129;4246;0;0;0;0;.00nan;0;0
14119;166423;4919;42;35;6;29;.829;3566000;0
14119;-1;165;58;35;4;31;.886;3600000;0
14119;-1;165;0;0;0;0;.00nan;0;0
14119;175658;4919;0;0;0;0;.00nan;0;0
14120;-1;4997;0;0;0;0;.00nan;0;0
14120;180731;4991;0;0;0;0;.00nan;0;0
14120;78820;4997;46;32;5;27;.844;3641000;0
14120;161128;4991;62;45;6;39;.867;3641000;0
14121;187391;4246;21;16;5;11;.688;2068000;0
14121;59231;4714;55;28;4;24;.857;3600000;0
14121;91413;4714;0;0;0;0;.00nan;0;0
14121;161129;4246;36;13;3;10;.769;1532000;0
14122;-1;165;0;0;0;0;.00nan;0;0
14122;-1;165;54;24;3;21;.875;3600000;0
14122;175651;4715;63;39;5;34;.872;3563000;0
14122;181874;4715;0;0;0;0;.00nan;0;0
14123;166423;4919;66;18;1;17;.944;1554000;0
14123;175658;4919;1;21;7;14;.667;2046000;0
14123;175712;4998;0;0;0;0;.00nan;0;0
14123;85228;4998;90;42;3;39;.929;3600000;0
14124;161583;4839;81;31;2;29;.935;3600000;0
14124;-1;4839;0;0;0;0;.00nan;0;0
14124;181341;1368;54;28;3;25;.893;3600000;0
14124;55660;1368;0;0;0;0;.00nan;0;0
14125;-1;4997;40;12;3;9;.750;2737000;0
14125;180731;4991;68;37;4;33;.892;3600000;0
14125;78820;4997;33;20;4;16;.800;863000;0
14125;161128;4991;0;0;0;0;.00nan;0;0
14126;161583;4839;0;0;0;0;.00nan;0;0
14126;-1;4839;82;30;2;28;.933;4200000;0
14126;181341;1368;0;0;0;0;.00nan;0;0
14126;55660;1368;90;30;2;28;.933;4200000;0
14127;-1;165;31;37;7;30;.811;3600000;0
14127;-1;165;0;0;0;0;.00nan;0;0
14127;175712;4998;49;29;4;25;.862;3600000;0
14127;85228;4998;0;0;0;0;.00nan;0;0
14128;187391;4246;0;0;0;0;.00nan;0;0
14128;59231;4714;0;0;0;0;.00nan;0;0
14128;91413;4714;80;25;1;24;.960;3600000;0
14128;161129;4246;41;33;5;28;.848;3600000;0
14129;166423;4919;0;0;0;0;.00nan;0;0
14129;175651;4715;0;0;0;0;.00nan;0;0
14129;175658;4919;81;15;0;15;1.000;3600000;0
14129;181874;4715;85;35;1;34;.971;3600000;0
14130;-1;4997;59;5;0;5;1.000;1233000;0
14130;180731;4991;63;19;2;17;.895;1528000;0
14130;78820;4997;28;25;6;19;.760;2367000;0
14130;161128;4991;48;34;5;29;.853;2072000;0
14131;187391;4246;33;30;6;24;.800;3137000;0
14131;59231;4714;65;39;5;34;.872;3600000;0
14131;91413;4714;0;0;0;0;.00nan;0;0
14131;161129;4246;50;3;0;3;1.000;421000;0
14132;161583;4839;67;36;4;32;.889;3600000;0
14132;-1;4839;0;0;0;0;.00nan;0;0
14132;181341;1368;34;33;7;26;.788;3565000;0
14132;55660;1368;0;0;0;0;.00nan;0;0
14133;-1;165;0;0;0;0;.00nan;0;0
14133;-1;165;62;19;2;17;.895;3600000;0
14133;175712;4998;0;0;0;0;.00nan;0;0
14133;85228;4998;48;49;7;42;.857;3600000;0
14134;166423;4919;0;0;0;0;.00nan;0;0
14134;175651;4715;82;46;4;42;.913;3575000;0
14134;175658;4919;58;26;3;23;.885;3600000;0
14134;181874;4715;0;0;0;0;.00nan;0;0
14135;180731;4991;84;37;2;35;.946;3638000;0
14135;187391;4246;0;0;0;0;.00nan;0;0
14135;161128;4991;0;0;0;0;.00nan;0;0
14135;161129;4246;69;30;3;27;.900;3638000;0
14136;180731;4991;0;0;0;0;.00nan;0;0
14136;187391;4246;67;43;4;39;.907;3581000;0
14136;161128;4991;69;33;3;30;.909;3600000;0
14136;161129;4246;0;0;0;0;.00nan;0;0
14137;175651;4715;36;36;6;30;.833;3530000;0
14137;175712;4998;0;0;0;0;.00nan;0;0
14137;181874;4715;0;0;0;0;.00nan;0;0
14137;85228;4998;44;30;5;25;.833;3600000;0
14138;166423;4919;0;0;0;0;.00nan;0;0
14138;175658;4919;79;24;2;22;.917;3600000;0
14138;59231;4714;70;42;5;37;.881;3600000;0
14138;91413;4714;0;0;0;0;.00nan;0;0
14139;161583;4839;0;0;0;0;.00nan;0;0
14139;-1;4839;63;20;2;18;.900;3600000;0
14139;182097;4992;0;0;0;0;.00nan;0;0
14139;86151;4992;55;37;4;33;.892;3539000;0
14140;181341;1368;68;40;5;35;.875;3600000;0
14140;187391;4246;61;31;3;28;.903;3600000;0
14140;55660;1368;0;0;0;0;.00nan;0;0
14140;161129;4246;0;0;0;0;.00nan;0;0
14141;-1;4997;0;0;0;0;.00nan;0;0
14141;180731;4991;81;39;3;36;.923;3568000;0
14141;78820;4997;66;28;2;26;.929;3600000;0
14141;161128;4991;0;0;0;0;.00nan;0;0
14142;181341;1368;0;0;0;0;.00nan;0;0
14142;187391;4246;52;4;0;4;1.000;623000;0
14142;55660;1368;54;18;3;15;.833;3600000;0
14142;161129;4246;15;37;8;29;.784;2977000;0
14143;-1;165;57;21;3;18;.857;3600000;0
14143;-1;165;0;0;0;0;.00nan;0;0
14143;59231;4714;54;30;4;26;.867;3556000;0
14143;91413;4714;0;0;0;0;.00nan;0;0
14144;161583;4839;85;33;3;30;.909;3600000;0
14144;-1;4839;0;0;0;0;.00nan;0;0
14144;182097;4992;0;0;0;0;.00nan;0;0
14144;86151;4992;48;26;4;22;.846;3600000;0
14145;166423;4919;74;23;1;22;.957;3600000;0
14145;175658;4919;0;0;0;0;.00nan;0;0
14145;175712;4998;0;0;0;0;.00nan;0;0
14145;85228;4998;50;18;3;15;.833;3553000;0
14146;-1;4997;74;29;3;26;.897;3600000;0
14146;180731;4991;79;23;1;22;.957;2465000;0
14146;78820;4997;0;0;0;0;.00nan;0;0
14146;161128;4991;42;17;4;13;.765;1065000;0
14147;180731;4991;76;29;2;27;.931;3546000;0
14147;182097;4992;0;0;0;0;.00nan;0;0
14147;86151;4992;66;15;1;14;.933;3600000;0
14147;161128;4991;0;0;0;0;.00nan;0;0
14148;181341;1368;77;30;2;28;.933;3600000;0
14148;182097;4992;0;0;0;0;.00nan;0;0
14148;55660;1368;0;0;0;0;.00nan;0;0
14148;86151;4992;66;40;5;35;.875;3600000;0
14149;166423;4919;0;0;0;0;.00nan;0;0
14149;175658;4919;70;29;2;27;.931;3600000;0
14149;187391;4246;0;0;0;0;.00nan;0;0
14149;161129;4246;34;26;5;21;.808;3600000;0
14150;-1;165;0;0;0;0;.00nan;0;0
14150;-1;165;34;29;5;24;.828;3600000;0
14150;175712;4998;0;0;0;0;.00nan;0;0
14150;85228;4998;87;31;2;29;.935;3600000;0
14151;182097;4992;65;23;2;21;.913;3570000;0
14151;59231;4714;100;28;0;28;1.000;3600000;0
14151;86151;4992;0;0;0;0;.00nan;0;0
14151;91413;4714;0;0;0;0;.00nan;0;0
14152;161583;4839;54;23;3;20;.870;3600000;0
14152;175651;4715;1;25;8;17;.680;3600000;0
14152;-1;4839;0;0;0;0;.00nan;0;0
14152;181874;4715;0;0;0;0;.00nan;0;0
14153;-1;4997;0;0;0;0;.00nan;0;0
14153;180731;4991;100;33;0;33;1.000;3600000;0
14153;78820;4997;60;30;4;26;.867;3600000;0
14153;161128;4991;0;0;0;0;.00nan;0;0
14154;166423;4919;0;0;0;0;.00nan;0;0
14154;175658;4919;41;37;6;31;.838;3537000;0
14154;187391;4246;49;30;5;25;.833;3600000;0
14154;161129;4246;0;0;0;0;.00nan;0;0
14155;-1;165;96;26;0;26;1.000;3600000;0
14155;-1;165;0;0;0;0;.00nan;0;0
14155;175712;4998;48;24;5;19;.792;3600000;0
14155;85228;4998;0;0;0;0;.00nan;0;0
14156;182097;4992;0;0;0;0;.00nan;0;0
14156;59231;4714;72;40;4;36;.900;3573000;0
14156;86151;4992;84;35;2;33;.943;3600000;0
14156;91413;4714;0;0;0;0;.00nan;0;0
14157;161583;4839;0;0;0;0;.00nan;0;0
14157;175651;4715;21;31;7;24;.774;3627000;0
14157;-1;4839;34;28;6;22;.786;3627000;0
14157;181874;4715;0;0;0;0;.00nan;0;0
14158;-1;4997;46;30;5;25;.833;3547000;0
14158;180731;4991;57;30;4;26;.867;3600000;0
14158;78820;4997;0;0;0;0;.00nan;0;0
14158;161128;4991;0;0;0;0;.00nan;0;0
14159;166423;4919;84;20;1;19;.950;3600000;0
14159;175658;4919;0;0;0;0;.00nan;0;0
14159;187391;4246;55;17;2;15;.882;2415000;0
14159;161129;4246;13;6;4;2;.333;1185000;0
14160;-1;165;0;0;0;0;.00nan;0;0
14160;-1;165;83;27;1;26;.963;3600000;0
14160;175712;4998;0;0;0;0;.00nan;0;0
14160;85228;4998;62;29;3;26;.897;3565000;0
14161;166423;4919;0;0;0;0;.00nan;0;0
14161;175651;4715;29;20;4;16;.800;781000;0
14161;175658;4919;65;35;4;31;.886;3600000;0
14161;181874;4715;74;24;2;22;.917;2776000;0
14162;161583;4839;43;31;5;26;.839;3600000;0
14162;-1;4839;0;0;0;0;.00nan;0;0
14162;182097;4992;0;0;0;0;.00nan;0;0
14162;86151;4992;73;28;2;26;.929;3600000;0
14163;187391;4246;63;52;7;45;.865;4199000;0
14163;59231;4714;25;32;7;25;.781;4200000;0
14163;91413;4714;0;0;0;0;.00nan;0;0
14163;161129;4246;0;0;0;0;.00nan;0;0
14164;180731;4991;73;21;1;20;.952;3600000;0
14164;181341;1368;51;28;4;24;.857;3600000;0
14164;55660;1368;0;0;0;0;.00nan;0;0
14164;161128;4991;0;0;0;0;.00nan;0;0
14165;180731;4991;54;22;3;19;.864;2807000;0
14165;181341;1368;0;0;0;0;.00nan;0;0
14165;55660;1368;83;35;3;32;.914;3600000;0
14165;161128;4991;15;6;4;2;.333;793000;0
14166;161583;4839;0;0;0;0;.00nan;0;0
14166;-1;4839;20;16;5;11;.688;3578000;0
14166;182097;4992;0;0;0;0;.00nan;0;0
14166;86151;4992;80;35;3;32;.914;3600000;0
14167;-1;165;36;23;5;18;.783;3586000;0
14167;-1;165;0;0;0;0;.00nan;0;0
14167;175712;4998;70;37;3;34;.919;3600000;0
14167;85228;4998;0;0;0;0;.00nan;0;0
14168;166423;4919;0;0;0;0;.00nan;0;0
14168;175651;4715;24;25;6;19;.760;1708000;0
14168;175658;4919;28;20;5;15;.750;3600000;0
14168;181874;4715;66;20;1;19;.950;1885000;0
14169;187391;4246;0;0;0;0;.00nan;0;0
14169;59231;4714;99;48;1;47;.979;3600000;0
14169;91413;4714;0;0;0;0;.00nan;0;0
14169;161129;4246;48;20;3;17;.850;3592000;0
14170;175651;4715;0;0;0;0;.00nan;0;0
14170;181874;4715;98;31;1;30;.968;3600000;0
14170;187391;4246;46;29;5;24;.828;3600000;0
14170;161129;4246;0;0;0;0;.00nan;0;0
14171;175651;4715;96;49;3;46;.939;3561000;0
14171;181874;4715;0;0;0;0;.00nan;0;0
14171;187391;4246;0;0;0;0;.00nan;0;0
14171;161129;4246;56;14;2;12;.857;3600000;0
14172;166423;4919;0;0;0;0;.00nan;0;0
14172;-1;165;0;0;0;0;.00nan;0;0
14172;-1;165;54;27;3;24;.889;3541000;0
14172;175658;4919;89;34;2;32;.941;3600000;0
14173;182097;4992;0;0;0;0;.00nan;0;0
14173;59231;4714;53;28;5;23;.821;3558000;0
14173;86151;4992;51;28;4;24;.857;3600000;0
14173;91413;4714;0;0;0;0;.00nan;0;0
14174;161583;4839;0;0;0;0;.00nan;0;0
14174;-1;4997;0;0;0;0;.00nan;0;0
14174;-1;4839;23;35;7;28;.800;3600000;0
14174;78820;4997;56;27;4;23;.852;3600000;0
14175;180731;4991;55;30;4;26;.867;3600000;0
14175;181341;1368;38;39;7;32;.821;3600000;0
14175;55660;1368;0;0;0;0;.00nan;0;0
14175;161128;4991;0;0;0;0;.00nan;0;0
14176;182097;4992;43;3;1;2;.667;381000;0
14176;59231;4714;60;26;3;23;.885;3600000;0
14176;86151;4992;31;34;7;27;.794;3219000;0
14176;91413;4714;0;0;0;0;.00nan;0;0
14177;166423;4919;0;0;0;0;.00nan;0;0
14177;175658;4919;84;23;1;22;.957;3600000;0
14177;175712;4998;0;0;0;0;.00nan;0;0
14177;85228;4998;34;26;5;21;.808;3600000;0
14178;-1;165;45;26;4;22;.846;3600000;0
14178;-1;165;0;0;0;0;.00nan;0;0
14178;175651;4715;0;0;0;0;.00nan;0;0
14178;181874;4715;75;35;3;32;.914;3600000;0
14179;161583;4839;82;37;3;34;.919;4200000;0
14179;-1;4997;54;26;3;23;.885;4200000;0
14179;-1;4839;0;0;0;0;.00nan;0;0
14179;78820;4997;0;0;0;0;.00nan;0;0
14180;180731;4991;0;0;0;0;.00nan;0;0
14180;181341;1368;0;0;0;0;.00nan;0;0
14180;55660;1368;97;20;0;20;1.000;3600000;0
14180;161128;4991;74;26;2;24;.923;3523000;0
14181;182097;4992;0;0;0;0;.00nan;0;0
14181;59231;4714;0;0;0;0;.00nan;0;0
14181;86151;4992;45;21;3;18;.857;3559000;0
14181;91413;4714;79;28;2;26;.929;3600000;0
14182;-1;165;0;0;0;0;.00nan;0;0
14182;-1;165;64;26;3;23;.885;3600000;0
14182;59231;4714;70;34;4;30;.882;3600000;0
14182;91413;4714;0;0;0;0;.00nan;0;0
14183;175651;4715;32;31;6;25;.806;2828000;0
14183;181874;4715;43;5;1;4;.800;772000;0
14183;187391;4246;85;26;1;25;.962;3600000;0
14183;161129;4246;0;0;0;0;.00nan;0;0
14184;-1;4997;0;0;0;0;.00nan;0;0
14184;182097;4992;0;0;0;0;.00nan;0;0
14184;78820;4997;75;39;4;35;.897;3876000;0
14184;86151;4992;48;30;5;25;.833;3876000;0
14185;175712;4998;0;0;0;0;.00nan;0;0
14185;181341;1368;0;0;0;0;.00nan;0;0
14185;55660;1368;66;19;2;17;.895;3600000;0
14185;85228;4998;23;34;7;27;.794;3600000;0
14186;161583;4839;0;0;0;0;.00nan;0;0
14186;-1;4839;91;32;1;31;.969;3600000;0
14186;180731;4991;28;21;5;16;.762;3600000;0
14186;161128;4991;0;0;0;0;.00nan;0;0
14187;175712;4998;90;37;2;35;.946;3600000;0
14187;181341;1368;58;27;4;23;.852;3543000;0
14187;55660;1368;0;0;0;0;.00nan;0;0
14187;85228;4998;0;0;0;0;.00nan;0;0
14188;-1;4997;55;36;5;31;.861;3600000;0
14188;182097;4992;0;0;0;0;.00nan;0;0
14188;78820;4997;0;0;0;0;.00nan;0;0
14188;86151;4992;83;25;2;23;.920;3600000;0
14189;175651;4715;0;0;0;0;.00nan;0;0
14189;181874;4715;66;31;3;28;.903;3600000;0
14189;187391;4246;0;0;0;0;.00nan;0;0
14189;161129;4246;54;30;4;26;.867;3600000;0
14190;161583;4839;53;24;3;21;.875;3600000;0
14190;-1;4839;0;0;0;0;.00nan;0;0
14190;180731;4991;57;7;0;7;1.000;731000;0
14190;161128;4991;43;35;6;29;.829;2869000;0
14191;166423;4919;0;0;0;0;.00nan;0;0
14191;175658;4919;72;18;1;17;.944;3650000;0
14191;59231;4714;87;31;2;29;.935;3650000;0
14191;91413;4714;0;0;0;0;.00nan;0;0
14192;-1;4997;55;3;0;3;1.000;611000;0
14192;182097;4992;39;23;4;19;.826;3600000;0
14192;78820;4997;35;35;6;29;.829;2902000;0
14192;86151;4992;0;0;0;0;.00nan;0;0
14193;166423;4919;0;0;0;0;.00nan;0;0
14193;175658;4919;88;28;1;27;.964;3600000;0
14193;37897;4714;0;0;0;0;.00nan;0;0
14193;59231;4714;73;36;4;32;.889;3600000;0
14194;161583;4839;0;0;0;0;.00nan;0;0
14194;-1;4839;64;42;5;37;.881;3600000;0
14194;181341;1368;0;0;0;0;.00nan;0;0
14194;55660;1368;100;33;1;32;.970;3600000;0
14195;175651;4715;74;42;4;38;.905;3550000;0
14195;175712;4998;0;0;0;0;.00nan;0;0
14195;181874;4715;0;0;0;0;.00nan;0;0
14195;85228;4998;59;23;3;20;.870;3600000;0
14196;166423;4919;0;0;0;0;.00nan;0;0
14196;175658;4919;60;35;4;31;.886;3540000;0
14196;187391;4246;52;18;2;16;.889;3600000;0
14196;161129;4246;0;0;0;0;.00nan;0;0
14197;161583;4839;90;32;1;31;.969;3600000;0
14197;-1;4997;0;0;0;0;.00nan;0;0
14197;-1;4839;0;0;0;0;.00nan;0;0
14197;78820;4997;25;29;7;22;.759;3600000;0
14198;-1;165;37;25;5;20;.800;3676000;0
14198;-1;165;0;0;0;0;.00nan;0;0
14198;37897;4714;0;0;0;0;.00nan;0;0
14198;59231;4714;66;33;4;29;.879;3676000;0
14199;-1;165;0;0;0;0;.00nan;0;0
14199;-1;165;47;27;4;23;.852;3568000;0
14199;37897;4714;0;0;0;0;.00nan;0;0
14199;59231;4714;70;31;3;28;.903;3600000;0
14200;166423;4919;43;16;3;13;.813;2708000;0
14200;175658;4919;25;10;4;6;.600;892000;0
14200;187391;4246;0;0;0;0;.00nan;0;0
14200;161129;4246;60;43;5;38;.884;3600000;0
14201;175651;4715;0;0;0;0;.00nan;0;0
14201;175712;4998;47;12;2;10;.833;3600000;0
14201;181874;4715;83;54;4;50;.926;3565000;0
14201;85228;4998;0;0;0;0;.00nan;0;0
14202;181341;1368;97;43;1;42;.977;3600000;0
14202;182097;4992;0;0;0;0;.00nan;0;0
14202;55660;1368;0;0;0;0;.00nan;0;0
14202;86151;4992;88;32;2;30;.938;3593000;0
14203;161583;4839;0;0;0;0;.00nan;0;0
14203;-1;4839;95;35;1;34;.971;4200000;0
14203;180731;4991;92;28;1;27;.964;4200000;0
14203;161128;4991;0;0;0;0;.00nan;0;0
14204;-1;165;57;19;2;17;.895;3600000;0
14204;-1;165;0;0;0;0;.00nan;0;0
14204;175651;4715;64;38;4;34;.895;3584000;0
14204;181874;4715;0;0;0;0;.00nan;0;0
14205;-1;165;0;0;0;0;.00nan;0;0
14205;-1;165;56;16;2;14;.875;3600000;0
14205;175651;4715;0;0;0;0;.00nan;0;0
14205;181874;4715;49;31;5;26;.839;3600000;0
14206;181341;1368;57;21;3;18;.857;3600000;0
14206;182097;4992;0;0;0;0;.00nan;0;0
14206;55660;1368;0;0;0;0;.00nan;0;0
14206;86151;4992;32;37;7;30;.811;3600000;0
14207;37897;4714;0;0;0;0;.00nan;0;0
14207;187391;4246;77;29;1;28;.966;3600000;0
14207;59231;4714;72;48;5;43;.896;3600000;0
14207;161129;4246;0;0;0;0;.00nan;0;0
14208;175651;4715;54;44;6;38;.864;3600000;0
14208;181874;4715;0;0;0;0;.00nan;0;0
14208;182097;4992;0;0;0;0;.00nan;0;0
14208;86151;4992;86;28;2;26;.929;3600000;0
14209;166423;4919;0;0;0;0;.00nan;0;0
14209;175658;4919;61;23;3;20;.870;3600000;0
14209;175712;4998;0;0;0;0;.00nan;0;0
14209;85228;4998;43;40;6;34;.850;3600000;0
14210;161583;4839;58;29;4;25;.862;3547000;0
14210;-1;4997;0;0;0;0;.00nan;0;0
14210;-1;4839;0;0;0;0;.00nan;0;0
14210;78820;4997;62;29;3;26;.897;3600000;0
14211;180731;4991;42;48;8;40;.833;3600000;0
14211;181341;1368;0;0;0;0;.00nan;0;0
14211;55660;1368;76;26;2;24;.923;3600000;0
14211;161128;4991;0;0;0;0;.00nan;0;0
14212;37897;4714;0;0;0;0;.00nan;0;0
14212;187391;4246;0;0;0;0;.00nan;0;0
14212;59231;4714;65;23;2;21;.913;3600000;0
14212;161129;4246;66;35;3;32;.914;3544000;0
14213;175651;4715;0;0;0;0;.00nan;0;0
14213;181874;4715;44;45;7;38;.844;3600000;0
14213;182097;4992;0;0;0;0;.00nan;0;0
14213;86151;4992;37;16;3;13;.813;3600000;0
14214;161583;4839;0;0;0;0;.00nan;0;0
14214;-1;4997;29;31;7;24;.774;3600000;0
14214;-1;4839;57;29;3;26;.897;3600000;0
14214;78820;4997;0;0;0;0;.00nan;0;0
14215;166423;4919;0;0;0;0;.00nan;0;0
14215;175658;4919;72;15;1;14;.933;3600000;0
14215;175712;4998;83;31;2;29;.935;3600000;0
14215;85228;4998;0;0;0;0;.00nan;0;0
14216;180731;4991;0;0;0;0;.00nan;0;0
14216;181341;1368;62;19;2;17;.895;3600000;0
14216;55660;1368;0;0;0;0;.00nan;0;0
14216;161128;4991;71;47;5;42;.894;3600000;0
14217;166423;4919;0;0;0;0;.00nan;0;0
14217;175658;4919;69;28;2;26;.929;3620000;0
14217;175712;4998;0;0;0;0;.00nan;0;0
14217;85228;4998;69;25;3;22;.880;3620000;0
14218;166423;4919;0;0;0;0;.00nan;0;0
14218;-1;165;22;22;6;16;.727;3293000;0
14218;-1;165;50;1;0;1;1.000;307000;0
14218;175658;4919;69;37;4;33;.892;3600000;0
14219;175651;4715;0;0;0;0;.00nan;0;0
14219;175712;4998;0;0;0;0;.00nan;0;0
14219;181874;4715;100;36;1;35;.972;3600000;0
14219;85228;4998;70;26;2;24;.923;3571000;0
14220;180731;4991;59;25;3;22;.880;3600000;0
14220;182097;4992;0;0;0;0;.00nan;0;0
14220;86151;4992;95;22;0;22;1.000;3600000;0
14220;161128;4991;0;0;0;0;.00nan;0;0
14221;-1;4997;0;0;0;0;.00nan;0;0
14221;181341;1368;0;0;0;0;.00nan;0;0
14221;55660;1368;31;25;5;20;.800;3569000;0
14221;78820;4997;59;27;3;24;.889;3600000;0
14222;161583;4839;68;39;4;35;.897;3600000;0
14222;-1;4839;0;0;0;0;.00nan;0;0
14222;37897;4714;50;1;0;1;1.000;620000;0
14222;59231;4714;32;30;6;24;.800;2950000;0
14223;180731;4991;0;0;0;0;.00nan;0;0
14223;181341;1368;87;37;3;34;.919;3600000;0
14223;55660;1368;0;0;0;0;.00nan;0;0
14223;161128;4991;55;29;4;25;.862;3600000;0
14224;161583;4839;39;8;2;6;.750;577000;0
14224;-1;4839;23;30;6;24;.800;3023000;0
14224;37897;4714;0;0;0;0;.00nan;0;0
14224;59231;4714;88;23;1;22;.957;3600000;0
14225;166423;4919;0;0;0;0;.00nan;0;0
14225;-1;165;0;0;0;0;.00nan;0;0
14225;-1;165;72;20;1;19;.950;3600000;0
14225;175658;4919;64;26;2;24;.923;3597000;0
14226;175651;4715;73;41;3;38;.927;3558000;0
14226;175712;4998;44;11;2;9;.818;3600000;0
14226;181874;4715;0;0;0;0;.00nan;0;0
14226;85228;4998;0;0;0;0;.00nan;0;0
14227;-1;4997;70;22;1;21;.955;3600000;0
14227;182097;4992;0;0;0;0;.00nan;0;0
14227;78820;4997;0;0;0;0;.00nan;0;0
14227;86151;4992;50;31;5;26;.839;3600000;0
14228;161583;4839;86;34;2;32;.941;3600000;0
14228;-1;4839;0;0;0;0;.00nan;0;0
14228;37897;4714;0;0;0;0;.00nan;0;0
14228;59231;4714;63;30;3;27;.900;3600000;0
14229;-1;165;0;0;0;0;.00nan;0;0
14229;-1;165;56;27;4;23;.852;3600000;0
14229;175712;4998;30;16;4;12;.750;1127000;0
14229;85228;4998;31;21;6;15;.714;2473000;0
14230;-1;4997;0;0;0;0;.00nan;0;0
14230;182097;4992;42;19;3;16;.842;3627000;0
14230;78820;4997;59;33;4;29;.879;3627000;0
14230;86151;4992;0;0;0;0;.00nan;0;0
14231;-1;4997;62;36;5;31;.861;3718000;0
14231;181341;1368;60;35;4;31;.886;3718000;0
14231;55660;1368;0;0;0;0;.00nan;0;0
14231;78820;4997;0;0;0;0;.00nan;0;0
14232;166423;4919;0;0;0;0;.00nan;0;0
14232;175651;4715;40;28;4;24;.857;2108000;0
14232;175658;4919;38;30;5;25;.833;3591000;0
14232;161128;4715;72;16;0;16;1.000;1492000;0
14233;175712;4998;0;0;0;0;.00nan;0;0
14233;187391;4246;34;37;6;31;.838;3293000;0
14233;85228;4998;54;23;2;21;.913;3600000;0
14233;161129;4246;53;5;0;5;1.000;307000;0
14234;37897;4714;69;37;4;33;.892;3600000;0
14234;182097;4992;0;0;0;0;.00nan;0;0
14234;59231;4714;0;0;0;0;.00nan;0;0
14234;86151;4992;95;22;0;22;1.000;3600000;0
14235;161583;4839;52;23;3;20;.870;3544000;0
14235;-1;4839;0;0;0;0;.00nan;0;0
14235;180731;4991;83;30;2;28;.933;3600000;0
14235;85984;4991;0;0;0;0;.00nan;0;0
14236;-1;4997;0;0;0;0;.00nan;0;0
14236;181341;1368;0;0;0;0;.00nan;0;0
14236;55660;1368;63;28;3;25;.893;3600000;0
14236;78820;4997;38;28;5;23;.821;3568000;0
14237;37897;4714;0;0;0;0;.00nan;0;0
14237;182097;4992;0;0;0;0;.00nan;0;0
14237;59231;4714;65;31;3;28;.903;3555000;0
14237;86151;4992;76;33;2;31;.939;3600000;0
14238;166423;4919;71;36;3;33;.917;3563000;0
14238;175651;4715;0;0;0;0;.00nan;0;0
14238;175658;4919;0;0;0;0;.00nan;0;0
14238;161128;4715;71;19;1;18;.947;3600000;0
14239;175712;4998;0;0;0;0;.00nan;0;0
14239;187391;4246;100;26;0;26;1.000;3600000;0
14239;85228;4998;60;19;2;17;.895;3559000;0
14239;161129;4246;0;0;0;0;.00nan;0;0
14240;-1;4997;70;33;3;30;.909;3600000;0
14240;181341;1368;69;30;4;26;.867;3556000;0
14240;55660;1368;0;0;0;0;.00nan;0;0
14240;78820;4997;0;0;0;0;.00nan;0;0
14241;175712;4998;71;51;5;46;.902;3600000;0
14241;187391;4246;59;20;2;18;.900;3600000;0
14241;85228;4998;0;0;0;0;.00nan;0;0
14241;161129;4246;0;0;0;0;.00nan;0;0
14242;166423;4919;0;0;0;0;.00nan;0;0
14242;-1;165;8;20;7;13;.650;3600000;0
14242;-1;165;0;0;0;0;.00nan;0;0
14242;175658;4919;91;32;1;31;.969;3600000;0
14243;161583;4839;0;0;0;0;.00nan;0;0
14243;-1;4839;83;17;0;17;1.000;3600000;0
14243;181341;1368;54;29;4;25;.862;3600000;0
14243;55660;1368;0;0;0;0;.00nan;0;0
14244;-1;165;0;0;0;0;.00nan;0;0
14244;-1;165;83;25;1;24;.960;3600000;0
14244;175651;4715;0;0;0;0;.00nan;0;0
14244;161128;4715;93;41;3;38;.927;3600000;0
14245;182097;4992;0;0;0;0;.00nan;0;0
14245;187391;4246;0;0;0;0;.00nan;0;0
14245;86151;4992;57;47;6;41;.872;4180000;0
14245;161129;4246;69;41;6;35;.854;4200000;0
14246;166423;4919;0;0;0;0;.00nan;0;0
14246;175658;4919;40;15;3;12;.800;3600000;0
14246;37897;4714;0;0;0;0;.00nan;0;0
14246;59231;4714;52;41;6;35;.854;3600000;0
14247;-1;4997;0;0;0;0;.00nan;0;0
14247;180731;4991;56;36;5;31;.861;3600000;0
14247;78820;4997;100;31;0;31;1.000;3600000;0
14247;85984;4991;0;0;0;0;.00nan;0;0
14248;-1;4997;0;0;0;0;.00nan;0;0
14248;181341;1368;0;0;0;0;.00nan;0;0
14248;55660;1368;46;30;5;25;.833;3600000;0
14248;78820;4997;97;42;2;40;.952;3600000;0
14249;166423;4919;52;32;5;27;.844;3537000;0
14249;175658;4919;0;0;0;0;.00nan;0;0
14249;37897;4714;70;31;3;28;.903;3600000;0
14249;59231;4714;0;0;0;0;.00nan;0;0
14250;-1;165;48;21;3;18;.857;4200000;0
14250;-1;165;0;0;0;0;.00nan;0;0
14250;175712;4998;0;0;0;0;.00nan;0;0
14250;85228;4998;93;38;3;35;.921;4200000;0
14251;182097;4992;57;37;5;32;.865;3600000;0
14251;187391;4246;57;20;2;18;.900;3600000;0
14251;86151;4992;0;0;0;0;.00nan;0;0
14251;161129;4246;0;0;0;0;.00nan;0;0
14252;161583;4839;75;22;1;21;.955;3600000;0
14252;-1;4839;0;0;0;0;.00nan;0;0
14252;180731;4991;0;0;0;0;.00nan;0;0
14252;85984;4991;38;27;5;22;.815;3600000;0
14253;37897;4714;0;0;0;0;.00nan;0;0
14253;182097;4992;0;0;0;0;.00nan;0;0
14253;59231;4714;72;38;3;35;.921;3922000;0
14253;86151;4992;59;32;4;28;.875;3922000;0
14254;-1;4997;32;37;7;30;.811;3600000;0
14254;181341;1368;80;28;2;26;.929;3600000;0
14254;55660;1368;0;0;0;0;.00nan;0;0
14254;78820;4997;0;0;0;0;.00nan;0;0
14255;166423;4919;0;0;0;0;.00nan;0;0
14255;175658;4919;48;35;5;30;.857;3541000;0
14255;187391;4246;0;0;0;0;.00nan;0;0
14255;161129;4246;51;23;3;20;.870;3600000;0
14256;161583;4839;0;0;0;0;.00nan;0;0
14256;-1;4839;47;39;6;33;.846;3600000;0
14256;180731;4991;7;21;7;14;.667;2130000;0
14256;85984;4991;47;8;1;7;.875;1399000;0
14257;-1;165;0;0;0;0;.00nan;0;0
14257;-1;165;63;34;3;31;.912;3563000;0
14257;180731;4991;62;20;2;18;.900;3600000;0
14257;85984;4991;0;0;0;0;.00nan;0;0
14258;37897;4714;0;0;0;0;.00nan;0;0
14258;187391;4246;0;0;0;0;.00nan;0;0
14258;59231;4714;60;32;4;28;.875;3542000;0
14258;161129;4246;68;27;2;25;.926;3600000;0
14259;175651;4715;60;29;3;26;.897;3543000;0
14259;175712;4998;0;0;0;0;.00nan;0;0
14259;85228;4998;96;37;2;35;.946;3600000;0
14259;161128;4715;0;0;0;0;.00nan;0;0
14260;181341;1368;68;46;5;41;.891;3913000;0
14260;182097;4992;0;0;0;0;.00nan;0;0
14260;55660;1368;0;0;0;0;.00nan;0;0
14260;86151;4992;71;40;4;36;.900;3913000;0
14261;161583;4839;71;48;5;43;.896;3578000;0
14261;-1;4997;0;0;0;0;.00nan;0;0
14261;-1;4839;0;0;0;0;.00nan;0;0
14261;78820;4997;48;23;4;19;.826;3600000;0
14262;37897;4714;45;24;4;20;.833;2179000;0
14262;187391;4246;59;23;3;20;.870;3600000;0
14262;59231;4714;51;8;1;7;.875;1342000;0
14262;161129;4246;0;0;0;0;.00nan;0;0
14263;181341;1368;0;0;0;0;.00nan;0;0
14263;182097;4992;29;24;5;19;.792;3600000;0
14263;55660;1368;96;34;2;32;.941;3600000;0
14263;86151;4992;0;0;0;0;.00nan;0;0
14264;161583;4839;0;0;0;0;.00nan;0;0
14264;-1;4997;58;40;4;36;.900;3600000;0
14264;-1;4839;57;24;3;21;.875;3600000;0
14264;78820;4997;0;0;0;0;.00nan;0;0
14265;-1;165;94;20;0;20;1.000;3600000;0
14265;-1;165;0;0;0;0;.00nan;0;0
14265;180731;4991;42;32;6;26;.813;2319000;0
14265;85984;4991;52;7;1;6;.857;1281000;0
14266;166423;4919;0;0;0;0;.00nan;0;0
14266;175658;4919;53;30;5;25;.833;3600000;0
14266;175712;4998;0;0;0;0;.00nan;0;0
14266;85228;4998;73;36;3;33;.917;3600000;0
14267;37897;4714;0;0;0;0;.00nan;0;0
14267;187391;4246;0;0;0;0;.00nan;0;0
14267;59231;4714;55;30;4;26;.867;3600000;0
14267;161129;4246;37;38;7;31;.816;3600000;0
14268;166423;4919;68;30;3;27;.900;3600000;0
14268;-1;165;0;0;0;0;.00nan;0;0
14268;-1;165;50;30;4;26;.867;3564000;0
14268;175658;4919;0;0;0;0;.00nan;0;0
14269;161583;4839;69;28;3;25;.893;3600000;0
14269;-1;4997;0;0;0;0;.00nan;0;0
14269;-1;4839;0;0;0;0;.00nan;0;0
14269;78820;4997;47;35;6;29;.829;3600000;0
14270;175651;4715;70;23;2;21;.913;3600000;0
14270;175712;4998;58;8;0;8;1.000;725000;0
14270;85228;4998;23;25;6;19;.760;2875000;0
14270;161128;4715;0;0;0;0;.00nan;0;0
14271;181341;1368;76;41;4;37;.902;3600000;0
14271;182097;4992;0;0;0;0;.00nan;0;0
14271;55660;1368;0;0;0;0;.00nan;0;0
14271;86151;4992;79;21;1;20;.952;3600000;0
14272;166423;4919;0;0;0;0;.00nan;0;0
14272;-1;165;47;17;3;14;.824;3600000;0
14272;-1;165;0;0;0;0;.00nan;0;0
14272;175658;4919;65;37;5;32;.865;3600000;0
14273;175651;4715;23;4;3;1;.250;478000;0
14273;187391;4246;79;31;2;29;.935;3600000;0
14273;161128;4715;43;16;3;13;.813;3122000;0
14273;161129;4246;0;0;0;0;.00nan;0;0
14274;175712;4998;0;0;0;0;.00nan;0;0
14274;182097;4992;0;0;0;0;.00nan;0;0
14274;85228;4998;70;22;1;21;.955;3600000;0
14274;86151;4992;66;33;3;30;.909;3515000;0
14275;-1;4997;0;0;0;0;.00nan;0;0
14275;181341;1368;33;28;5;23;.821;3569000;0
14275;55660;1368;0;0;0;0;.00nan;0;0
14275;78820;4997;82;41;3;38;.927;3600000;0
14276;161583;4839;0;0;0;0;.00nan;0;0
14276;-1;4839;57;22;2;20;.909;3600000;0
14276;37897;4714;0;0;0;0;.00nan;0;0
14276;59231;4714;59;39;5;34;.872;3600000;0
14277;-1;4997;66;36;3;33;.917;3600000;0
14277;181341;1368;45;35;4;31;.886;3549000;0
14277;55660;1368;0;0;0;0;.00nan;0;0
14277;78820;4997;0;0;0;0;.00nan;0;0
14278;175651;4715;42;36;6;30;.833;3600000;0
14278;187391;4246;0;0;0;0;.00nan;0;0
14278;161128;4715;0;0;0;0;.00nan;0;0
14278;161129;4246;96;26;0;26;1.000;3600000;0
14279;175712;4998;0;0;0;0;.00nan;0;0
14279;182097;4992;40;22;4;18;.818;3618000;0
14279;85228;4998;56;27;3;24;.889;3618000;0
14279;86151;4992;0;0;0;0;.00nan;0;0
14280;161583;4839;53;29;4;25;.862;3600000;0
14280;-1;4839;0;0;0;0;.00nan;0;0
14280;37897;4714;32;28;6;22;.786;1835000;0
14280;59231;4714;42;15;3;12;.800;1765000;0
14281;166423;4919;63;50;5;45;.900;3600000;0
14281;-1;165;0;0;0;0;.00nan;0;0
14281;-1;165;96;19;0;19;1.000;3600000;0
14281;175658;4919;0;0;0;0;.00nan;0;0
14282;166423;4919;0;0;0;0;.00nan;0;0
14282;-1;165;0;0;0;0;.00nan;0;0
14282;-1;165;86;17;0;17;1.000;3600000;0
14282;175658;4919;54;25;3;22;.880;3600000;0
14283;161583;4839;0;0;0;0;.00nan;0;0
14283;-1;4839;53;21;3;18;.857;3600000;0
14283;37897;4714;0;0;0;0;.00nan;0;0
14283;59231;4714;30;25;6;19;.760;3600000;0
14284;161583;4839;39;21;4;17;.810;3638000;0
14284;-1;4839;0;0;0;0;.00nan;0;0
14284;187391;4246;68;30;3;27;.900;3678000;0
14284;161129;4246;0;0;0;0;.00nan;0;0
14285;-1;4997;0;0;0;0;.00nan;0;0
14285;180731;4991;0;0;0;0;.00nan;0;0
14285;78820;4997;76;26;2;24;.923;3600000;0
14285;85984;4991;88;40;3;37;.925;3600000;0
14286;-1;165;0;0;0;0;.00nan;0;0
14286;-1;165;67;24;2;22;.917;3600000;0
14286;187391;4246;0;0;0;0;.00nan;0;0
14286;161129;4246;68;29;3;26;.897;3590000;0
14287;166423;4919;0;0;0;0;.00nan;0;0
14287;175658;4919;78;20;1;19;.950;3600000;0
14287;175712;4998;0;0;0;0;.00nan;0;0
14287;85228;4998;64;29;3;26;.897;3554000;0
14288;161583;4839;0;0;0;0;.00nan;0;0
14288;-1;4839;78;39;3;36;.923;3600000;0
14288;37897;4714;0;0;0;0;.00nan;0;0
14288;59231;4714;63;36;4;32;.889;3549000;0
14289;181341;1368;67;32;5;27;.844;3600000;0
14289;182097;4992;0;0;0;0;.00nan;0;0
14289;55660;1368;0;0;0;0;.00nan;0;0
14289;86151;4992;47;27;4;23;.852;3600000;0
14290;-1;4997;66;26;2;24;.923;3600000;0
14290;180731;4991;0;0;0;0;.00nan;0;0
14290;78820;4997;0;0;0;0;.00nan;0;0
14290;85984;4991;40;29;5;24;.828;3600000;0
14291;-1;165;84;29;2;27;.931;3600000;0
14291;-1;165;0;0;0;0;.00nan;0;0
14291;37897;4714;47;39;6;33;.846;3600000;0
14291;59231;4714;0;0;0;0;.00nan;0;0
14292;166423;4919;36;13;3;10;.769;3600000;0
14292;175651;4715;63;20;1;19;.950;1212000;0
14292;175658;4919;0;0;0;0;.00nan;0;0
14292;161128;4715;24;34;7;27;.794;2388000;0
14293;181341;1368;59;30;3;27;.900;3600000;0
14293;182097;4992;30;21;5;16;.762;1863000;0
14293;55660;1368;0;0;0;0;.00nan;0;0
14293;86151;4992;49;14;2;12;.857;1737000;0
14294;161583;4839;56;34;6;28;.824;3761000;0
14294;-1;4839;0;0;0;0;.00nan;0;0
14294;187391;4246;50;33;5;28;.848;3761000;0
14294;161129;4246;0;0;0;0;.00nan;0;0
14295;-1;4997;0;0;0;0;.00nan;0;0
14295;180731;4991;0;0;0;0;.00nan;0;0
14295;78820;4997;27;17;5;12;.706;3623000;0
14295;85984;4991;78;37;4;33;.892;3623000;0
14296;175651;4715;89;36;3;33;.917;4200000;0
14296;175712;4998;0;0;0;0;.00nan;0;0
14296;85228;4998;53;24;3;21;.875;4200000;0
14296;161128;4715;0;0;0;0;.00nan;0;0
14297;-1;4997;84;28;2;26;.929;3600000;0
14297;180731;4991;0;0;0;0;.00nan;0;0
14297;78820;4997;0;0;0;0;.00nan;0;0
14297;85984;4991;53;29;5;24;.828;3600000;0
14298;-1;165;47;34;6;28;.824;3174000;0
14298;-1;165;50;1;0;1;1.000;390000;0
14298;175651;4715;0;0;0;0;.00nan;0;0
14298;161128;4715;53;31;4;27;.871;3600000;0
14299;-1;165;0;0;0;0;.00nan;0;0
14299;-1;165;43;30;5;25;.833;3600000;0
14299;175712;4998;57;7;1;6;.857;1237000;0
14299;85228;4998;18;24;6;18;.750;2319000;0
14300;166423;4919;0;0;0;0;.00nan;0;0
14300;175651;4715;53;39;6;33;.846;3600000;0
14300;175658;4919;59;23;3;20;.870;3600000;0
14300;161128;4715;0;0;0;0;.00nan;0;0
14301;161583;4839;0;0;0;0;.00nan;0;0
14301;-1;4839;50;32;4;28;.875;3721000;0
14301;182097;4992;0;0;0;0;.00nan;0;0
14301;86151;4992;40;26;5;21;.808;3721000;0
14302;180731;4991;0;0;0;0;.00nan;0;0
14302;181341;1368;64;29;3;26;.897;3600000;0
14302;55660;1368;0;0;0;0;.00nan;0;0
14302;85984;4991;82;48;5;43;.896;3536000;0
14303;-1;4997;0;0;0;0;.00nan;0;0
14303;187391;4246;34;16;4;12;.750;3668000;0
14303;78820;4997;64;39;5;34;.872;3668000;0
14303;161129;4246;0;0;0;0;.00nan;0;0
14304;-1;165;79;26;2;24;.923;4200000;0
14304;-1;165;0;0;0;0;.00nan;0;0
14304;175712;4998;0;0;0;0;.00nan;0;0
14304;85228;4998;86;34;2;32;.941;4200000;0
14305;161583;4839;100;44;1;43;.977;4200000;0
14305;-1;4839;0;0;0;0;.00nan;0;0
14305;182097;4992;0;0;0;0;.00nan;0;0
14305;86151;4992;94;39;1;38;.974;4200000;0
14306;166423;4919;56;16;2;14;.875;3600000;0
14306;175651;4715;0;0;0;0;.00nan;0;0
14306;175658;4919;0;0;0;0;.00nan;0;0
14306;161128;4715;43;29;5;24;.828;3600000;0
14307;-1;4997;44;33;5;28;.848;3576000;0
14307;187391;4246;0;0;0;0;.00nan;0;0
14307;78820;4997;0;0;0;0;.00nan;0;0
14307;161129;4246;65;25;3;22;.880;3600000;0
14308;180731;4991;0;0;0;0;.00nan;0;0
14308;181341;1368;58;31;4;27;.871;3552000;0
14308;55660;1368;0;0;0;0;.00nan;0;0
14308;85984;4991;82;33;3;30;.909;3600000;0
14309;175651;4715;86;34;2;32;.941;3537000;0
14309;175712;4998;92;22;0;22;1.000;3600000;0
14309;85228;4998;0;0;0;0;.00nan;0;0
14309;161128;4715;0;0;0;0;.00nan;0;0
14310;161583;4839;0;0;0;0;.00nan;0;0
14310;-1;4839;53;32;5;27;.844;3600000;0
14310;180731;4991;0;0;0;0;.00nan;0;0
14310;85984;4991;79;31;2;29;.935;3600000;0
14311;161583;4839;48;34;5;29;.853;3600000;0
14311;-1;4839;0;0;0;0;.00nan;0;0
14311;181341;1368;54;34;4;30;.882;3600000;0
14311;55660;1368;0;0;0;0;.00nan;0;0
14312;-1;4997;79;31;2;29;.935;4200000;0
14312;180731;4991;0;0;0;0;.00nan;0;0
14312;78820;4997;0;0;0;0;.00nan;0;0
14312;85984;4991;89;32;2;30;.938;4200000;0
14313;37897;4714;0;0;0;0;.00nan;0;0
14313;187391;4246;0;0;0;0;.00nan;0;0
14313;59231;4714;81;37;3;34;.919;3547000;0
14313;161129;4246;89;27;1;26;.963;3600000;0
14314;166423;4919;0;0;0;0;.00nan;0;0
14314;175658;4919;42;30;5;25;.833;3594000;0
14314;182097;4992;0;0;0;0;.00nan;0;0
14314;86151;4992;64;26;3;23;.885;3600000;0
14315;-1;165;0;0;0;0;.00nan;0;0
14315;-1;165;66;19;2;17;.895;3600000;0
14315;175712;4998;34;15;4;11;.733;1020000;0
14315;85228;4998;64;29;3;26;.897;2580000;0
14316;161583;4839;47;6;1;5;.833;921000;0
14316;-1;4839;8;25;7;18;.720;2679000;0
14316;181341;1368;62;25;3;22;.880;3600000;0
14316;55660;1368;0;0;0;0;.00nan;0;0
14317;-1;4997;0;0;0;0;.00nan;0;0
14317;180731;4991;49;1;0;1;1.000;320000;0
14317;78820;4997;36;19;4;15;.789;3600000;0
14317;85984;4991;32;34;7;27;.794;3280000;0
14318;37897;4714;0;0;0;0;.00nan;0;0
14318;187391;4246;85;48;4;44;.917;3665000;0
14318;59231;4714;69;29;3;26;.897;3665000;0
14318;161129;4246;0;0;0;0;.00nan;0;0
14319;166423;4919;100;43;2;41;.953;3600000;0
14319;175658;4919;0;0;0;0;.00nan;0;0
14319;182097;4992;0;0;0;0;.00nan;0;0
14319;86151;4992;26;26;6;20;.769;3600000;0
14320;-1;165;13;21;6;15;.714;1934000;0
14320;-1;165;46;10;2;8;.800;1798000;0
14320;175651;4715;37;46;7;39;.848;3732000;0
14320;161128;4715;0;0;0;0;.00nan;0;0
14321;161583;4839;65;28;3;25;.893;3670000;0
14321;-1;4839;0;0;0;0;.00nan;0;0
14321;181341;1368;81;29;2;27;.931;3670000;0
14321;55660;1368;0;0;0;0;.00nan;0;0
14322;-1;4997;68;49;5;44;.898;3549000;0
14322;180731;4991;0;0;0;0;.00nan;0;0
14322;78820;4997;0;0;0;0;.00nan;0;0
14322;85984;4991;67;28;3;25;.893;3600000;0
14324;166423;4919;0;0;0;0;.00nan;0;0
14324;175658;4919;63;26;3;23;.885;3600000;0
14324;180731;4991;74;21;1;20;.952;1428000;0
14324;57100;4991;31;30;6;24;.800;2172000;0
14326;181341;1368;87;23;0;23;1.000;3600000;0
14326;55660;1368;0;0;0;0;.00nan;0;0
14326;91413;4714;75;36;3;33;.917;3600000;0
14326;161128;4714;0;0;0;0;.00nan;0;0
14328;218;165;49;32;6;26;.813;2484000;0
14328;-1;165;71;20;1;19;.950;1116000;0
14328;182097;4992;32;3;2;1;.333;1402000;0
14328;86151;4992;27;26;6;20;.769;2141000;0
14330;-1;4997;0;0;0;0;.00nan;0;0
14330;187391;4246;61;25;3;22;.880;3930000;0
14330;78820;4997;84;45;4;41;.911;3930000;0
14330;161129;4246;0;0;0;0;.00nan;0;0
14332;161583;4839;77;25;2;23;.920;3600000;0
14332;175712;4998;0;0;0;0;.00nan;0;0
14332;-1;4839;0;0;0;0;.00nan;0;0
14332;85228;4998;42;28;5;23;.821;3600000;0
1268;-1;4997;0;0;0;0;.00nan;0;0
1268;181341;1368;75;24;2;22;.917;3600000;0
1268;55660;1368;0;0;0;0;.00nan;0;0
1268;78820;4997;57;37;5;32;.865;3600000;0
1269;161583;4839;61;24;3;21;.875;3537000;0
1269;-1;4839;0;0;0;0;.00nan;0;0
1269;37897;4714;0;0;0;0;.00nan;0;0
1269;59231;4714;71;23;1;22;.957;3600000;0
1270;-1;165;0;0;0;0;.00nan;0;0
1270;-1;165;62;26;3;23;.885;3600000;0
1270;182097;4992;0;0;0;0;.00nan;0;0
1270;86151;4992;56;38;5;33;.868;3528000;0
1271;166423;4919;0;0;0;0;.00nan;0;0
1271;175658;4919;60;28;3;25;.893;3599000;0
1271;175712;4998;0;0;0;0;.00nan;0;0
1271;85228;4998;60;18;2;16;.889;3600000;0
1272;-1;4997;0;0;0;0;.00nan;0;0
1272;181341;1368;65;25;2;23;.920;3600000;0
1272;55660;1368;0;0;0;0;.00nan;0;0
1272;78820;4997;91;29;1;28;.966;3600000;0
1273;161583;4839;57;18;2;16;.889;3600000;0
1273;-1;4839;0;0;0;0;.00nan;0;0
1273;37897;4714;0;0;0;0;.00nan;0;0
1273;59231;4714;78;35;3;32;.914;3570000;0
1274;-1;165;0;0;0;0;.00nan;0;0
1274;-1;165;68;28;3;25;.893;3600000;0
1274;182097;4992;0;0;0;0;.00nan;0;0
1274;86151;4992;87;45;4;41;.911;3558000;0
1275;166423;4919;0;0;0;0;.00nan;0;0
1275;175658;4919;32;25;5;20;.800;3600000;0
1275;175712;4998;0;0;0;0;.00nan;0;0
1275;85228;4998;99;26;0;26;1.000;3600000;0
1381;-1;4997;0;0;0;0;.00nan;0;0
1381;181341;1368;49;32;4;28;.875;3886000;0
1381;55660;1368;0;0;0;0;.00nan;0;0
1381;78820;4997;58;39;5;34;.872;3886000;0
14333;161535;167;0;0;0;0;.00nan;0;0
14333;85633;170;54;21;3;18;.857;3900000;0
14333;87164;167;78;30;3;27;.900;3900000;0
14333;91212;170;0;0;0;0;.00nan;0;0
14334;173918;174;30;30;7;23;.767;3600000;0
14334;37786;3916;27;7;3;4;.571;457000;0
14334;57564;174;0;0;0;0;.00nan;0;0
14334;64736;3916;67;18;1;17;.944;3143000;0
14335;165532;175;0;0;0;0;.00nan;0;0
14335;14191;169;0;0;0;0;.00nan;0;0
14335;36675;175;73;28;3;25;.893;3900000;0
14335;85354;169;63;31;3;28;.903;3900000;0
14336;37786;3916;0;0;0;0;.00nan;0;0
14336;59592;171;0;0;0;0;.00nan;0;0
14336;64736;3916;97;53;2;51;.962;3900000;0
14336;91414;171;69;21;2;19;.905;3900000;0
14337;501;4247;0;0;0;0;.00nan;0;0
14337;173918;174;0;0;0;0;.00nan;0;0
14337;57564;174;41;32;6;26;.813;3600000;0
14337;78479;4247;61;27;3;24;.889;3600000;0
14338;165532;175;60;34;3;31;.912;3600000;0
14338;14191;169;90;32;1;31;.969;3600000;0
14338;36675;175;0;0;0;0;.00nan;0;0
14338;85354;169;0;0;0;0;.00nan;0;0
14339;2136;1527;0;0;0;0;.00nan;0;0
14339;176060;172;65;46;6;40;.870;3555000;0
14339;65125;172;0;0;0;0;.00nan;0;0
14339;85709;1527;31;20;5;15;.750;3600000;0
14340;161535;167;0;0;0;0;.00nan;0;0
14340;44561;170;0;0;0;0;.00nan;0;0
14340;87164;167;86;36;2;34;.944;3600000;0
14340;91212;170;42;40;6;34;.850;3600000;0
14341;165532;175;79;45;5;40;.889;3600000;0
14341;36675;175;0;0;0;0;.00nan;0;0
14341;37786;3916;0;0;0;0;.00nan;0;0
14341;64736;3916;72;23;1;22;.957;3600000;0
14342;501;4247;0;0;0;0;.00nan;0;0
14342;176060;172;99;28;0;28;1.000;3600000;0
14342;65125;172;0;0;0;0;.00nan;0;0
14342;78479;4247;68;40;4;36;.900;3600000;0
14343;161535;167;0;0;0;0;.00nan;0;0
14343;14191;169;42;32;5;27;.844;3600000;0
14343;85354;169;0;0;0;0;.00nan;0;0
14343;87164;167;48;27;4;23;.852;3600000;0
14344;173918;174;0;0;0;0;.00nan;0;0
14344;57564;174;61;41;5;36;.878;3563000;0
14344;59592;171;58;22;3;19;.864;3600000;0
14344;91414;171;0;0;0;0;.00nan;0;0
14345;2136;1527;0;0;0;0;.00nan;0;0
14345;44561;170;0;0;0;0;.00nan;0;0
14345;85709;1527;100;25;0;25;1.000;3600000;0
14345;91212;170;83;34;2;32;.941;3583000;0
14346;161535;167;65;25;2;23;.920;3600000;0
14346;14191;169;43;33;5;28;.848;3600000;0
14346;85354;169;0;0;0;0;.00nan;0;0
14346;87164;167;0;0;0;0;.00nan;0;0
14347;173918;174;0;0;0;0;.00nan;0;0
14347;57564;174;54;30;4;26;.867;3525000;0
14347;59592;171;76;27;2;25;.926;3600000;0
14347;91414;171;0;0;0;0;.00nan;0;0
14348;165532;175;83;28;1;27;.964;3600000;0
14348;36675;175;0;0;0;0;.00nan;0;0
14348;37786;3916;0;0;0;0;.00nan;0;0
14348;64736;3916;44;38;5;33;.868;3600000;0
14349;2136;1527;0;0;0;0;.00nan;0;0
14349;44561;170;70;24;1;23;.958;3600000;0
14349;85709;1527;82;34;2;32;.941;3581000;0
14349;91212;170;0;0;0;0;.00nan;0;0
14350;2136;1527;29;28;6;22;.786;2972000;0
14350;176060;172;65;27;3;24;.889;3600000;0
14350;65125;172;0;0;0;0;.00nan;0;0
14350;85709;1527;53;3;0;3;1.000;628000;0
14351;173918;174;37;26;5;21;.808;3600000;0
14351;37786;3916;0;0;0;0;.00nan;0;0
14351;57564;174;0;0;0;0;.00nan;0;0
14351;64736;3916;98;40;2;38;.950;3600000;0
14352;161535;167;0;0;0;0;.00nan;0;0
14352;165532;175;69;34;3;31;.912;3549000;0
14352;36675;175;0;0;0;0;.00nan;0;0
14352;87164;167;62;24;2;22;.917;3600000;0
14353;501;4247;0;0;0;0;.00nan;0;0
14353;14191;169;54;24;3;21;.875;3579000;0
14353;78479;4247;95;39;1;38;.974;3600000;0
14353;85354;169;0;0;0;0;.00nan;0;0
14354;44561;170;0;0;0;0;.00nan;0;0
14354;59592;171;27;42;8;34;.810;2798000;0
14354;91212;170;58;27;4;23;.852;3600000;0
14354;91414;171;44;4;1;3;.750;802000;0
14355;2136;1527;0;0;0;0;.00nan;0;0
14355;176060;172;27;27;6;21;.778;3600000;0
14355;65125;172;0;0;0;0;.00nan;0;0
14355;85709;1527;99;42;2;40;.952;3600000;0
14356;173918;174;0;0;0;0;.00nan;0;0
14356;37786;3916;54;31;3;28;.903;3900000;0
14356;57564;174;68;27;3;24;.889;3900000;0
14356;64736;3916;0;0;0;0;.00nan;0;0
14357;161535;167;74;30;2;28;.933;3585000;0
14357;165532;175;0;0;0;0;.00nan;0;0
14357;36675;175;84;35;1;34;.971;3600000;0
14357;87164;167;0;0;0;0;.00nan;0;0
14358;501;4247;50;29;4;25;.862;3600000;0
14358;14191;169;0;0;0;0;.00nan;0;0
14358;78479;4247;0;0;0;0;.00nan;0;0
14358;85354;169;83;18;0;18;1.000;3600000;0
14359;44561;170;70;23;2;21;.913;3600000;0
14359;59592;171;73;35;3;32;.914;3121000;0
14359;91212;170;0;0;0;0;.00nan;0;0
14359;91414;171;32;9;3;6;.667;479000;0
14360;161535;167;0;0;0;0;.00nan;0;0
14360;59592;171;51;32;4;28;.875;3600000;0
14360;87164;167;78;23;1;22;.957;3600000;0
14360;91414;171;0;0;0;0;.00nan;0;0
14361;165532;175;0;0;0;0;.00nan;0;0
14361;173918;174;0;0;0;0;.00nan;0;0
14361;36675;175;87;37;3;34;.919;3600000;0
14361;57564;174;53;37;5;32;.865;3511000;0
14362;37786;3916;0;0;0;0;.00nan;0;0
14362;59592;171;57;39;6;33;.846;3600000;0
14362;64736;3916;63;23;3;20;.870;3600000;0
14362;91414;171;0;0;0;0;.00nan;0;0
14363;501;4247;0;0;0;0;.00nan;0;0
14363;176060;172;84;33;1;32;.970;3600000;0
14363;65125;172;0;0;0;0;.00nan;0;0
14363;78479;4247;75;40;4;36;.900;3600000;0
14364;161535;167;0;0;0;0;.00nan;0;0
14364;2136;1527;0;0;0;0;.00nan;0;0
14364;85709;1527;62;21;2;19;.905;3600000;0
14364;87164;167;17;28;7;21;.750;3600000;0
14365;165532;175;80;30;2;28;.933;3600000;0
14365;36675;175;0;0;0;0;.00nan;0;0
14365;59592;171;0;0;0;0;.00nan;0;0
14365;91414;171;65;40;4;36;.900;3513000;0
14366;14191;169;0;0;0;0;.00nan;0;0
14366;37786;3916;65;27;3;24;.889;3600000;0
14366;64736;3916;0;0;0;0;.00nan;0;0
14366;85354;169;100;24;0;24;1.000;3600000;0
14367;173918;174;73;24;1;23;.958;3600000;0
14367;44561;170;0;0;0;0;.00nan;0;0
14367;57564;174;0;0;0;0;.00nan;0;0
14367;91212;170;100;30;0;30;1.000;3600000;0
14368;161535;167;34;28;5;23;.821;3600000;0
14368;2136;1527;0;0;0;0;.00nan;0;0
14368;85709;1527;88;40;2;38;.950;3600000;0
14368;87164;167;0;0;0;0;.00nan;0;0
14369;501;4247;21;26;7;19;.731;3600000;0
14369;173918;174;0;0;0;0;.00nan;0;0
14369;57564;174;100;23;0;23;1.000;3600000;0
14369;78479;4247;0;0;0;0;.00nan;0;0
14370;165532;175;0;0;0;0;.00nan;0;0
14370;36675;175;83;39;2;37;.949;3600000;0
14370;59592;171;89;25;1;24;.960;3600000;0
14370;91414;171;0;0;0;0;.00nan;0;0
14371;14191;169;80;34;2;32;.941;3900000;0
14371;44561;170;0;0;0;0;.00nan;0;0
14371;85354;169;0;0;0;0;.00nan;0;0
14371;91212;170;58;24;2;22;.917;3900000;0
14372;501;4247;0;0;0;0;.00nan;0;0
14372;176060;172;62;28;3;25;.893;3600000;0
14372;65125;172;0;0;0;0;.00nan;0;0
14372;78479;4247;72;28;2;26;.929;3600000;0
14373;161535;167;0;0;0;0;.00nan;0;0
14373;165532;175;75;39;3;36;.923;3600000;0
14373;36675;175;0;0;0;0;.00nan;0;0
14373;87164;167;65;27;2;25;.926;3600000;0
14374;501;4247;0;0;0;0;.00nan;0;0
14374;165532;175;0;0;0;0;.00nan;0;0
14374;36675;175;37;27;5;22;.815;3600000;0
14374;78479;4247;70;32;2;30;.938;3600000;0
14375;161535;167;59;24;3;21;.875;3600000;0
14375;173918;174;55;12;1;11;.917;915000;0
14375;57564;174;43;40;6;34;.850;2685000;0
14375;87164;167;0;0;0;0;.00nan;0;0
14376;59592;171;68;20;1;19;.950;3900000;0
14376;64736;3916;100;53;1;52;.981;3900000;0
14376;77955;3916;0;0;0;0;.00nan;0;0
14376;91414;171;0;0;0;0;.00nan;0;0
14377;176060;172;0;0;0;0;.00nan;0;0
14377;44561;170;0;0;0;0;.00nan;0;0
14377;65125;172;51;25;3;22;.880;3568000;0
14377;91212;170;91;35;2;33;.943;3600000;0
14378;161535;167;0;0;0;0;.00nan;0;0
14378;173918;174;41;36;6;30;.833;3600000;0
14378;57564;174;0;0;0;0;.00nan;0;0
14378;87164;167;72;27;2;25;.926;3600000;0
14379;165532;175;63;26;3;23;.885;3900000;0
14379;36675;175;0;0;0;0;.00nan;0;0
14379;64736;3916;0;0;0;0;.00nan;0;0
14379;77955;3916;70;31;3;28;.903;3900000;0
14380;14191;169;50;0;0;0;.00nan;294000;0
14380;59592;171;0;0;0;0;.00nan;0;0
14380;85354;169;40;21;4;17;.810;3306000;0
14380;91414;171;64;40;5;35;.875;3593000;0
14381;501;4247;33;28;6;22;.786;3089000;0
14381;57155;1527;80;23;1;22;.957;3600000;0
14381;78479;4247;53;2;0;2;1.000;511000;0
14381;85709;1527;0;0;0;0;.00nan;0;0
14382;176060;172;89;49;4;45;.918;3562000;0
14382;44561;170;67;28;3;25;.893;3600000;0
14382;65125;172;0;0;0;0;.00nan;0;0
14382;91212;170;0;0;0;0;.00nan;0;0
14383;59592;171;71;28;2;26;.929;3600000;0
14383;64736;3916;64;11;0;11;1.000;1166000;0
14383;77955;3916;54;28;4;24;.857;2348000;0
14383;91414;171;0;0;0;0;.00nan;0;0
14384;501;4247;0;0;0;0;.00nan;0;0
14384;57155;1527;0;0;0;0;.00nan;0;0
14384;78479;4247;100;30;0;30;1.000;3600000;0
14384;85709;1527;60;21;2;19;.905;3546000;0
14385;173918;174;0;0;0;0;.00nan;0;0
14385;44561;170;51;10;1;9;.900;1158000;0
14385;57564;174;71;27;2;25;.926;3600000;0
14385;91212;170;28;28;6;22;.786;2442000;0
14386;161535;167;89;30;1;29;.967;3900000;0
14386;14191;169;87;26;1;25;.962;3900000;0
14386;85354;169;0;0;0;0;.00nan;0;0
14386;87164;167;0;0;0;0;.00nan;0;0
14387;165532;175;52;21;3;18;.857;3018000;0
14387;176060;172;54;26;3;23;.885;3600000;0
14387;36675;175;29;9;3;6;.667;582000;0
14387;65125;172;0;0;0;0;.00nan;0;0
14388;173918;174;100;37;0;37;1.000;3600000;0
14388;176060;172;0;0;0;0;.00nan;0;0
14388;57564;174;0;0;0;0;.00nan;0;0
14388;65125;172;77;21;1;20;.952;3545000;0
14389;501;4247;0;0;0;0;.00nan;0;0
14389;57155;1527;71;16;1;15;.938;3600000;0
14389;78479;4247;70;47;5;42;.894;3600000;0
14389;85709;1527;0;0;0;0;.00nan;0;0
14390;161535;167;66;23;2;21;.913;3569000;0
14390;44561;170;0;0;0;0;.00nan;0;0
14390;87164;167;0;0;0;0;.00nan;0;0
14390;91212;170;84;29;1;28;.966;3600000;0
14391;165532;175;82;32;2;30;.938;3592000;0
14391;14191;169;0;0;0;0;.00nan;0;0
14391;36675;175;0;0;0;0;.00nan;0;0
14391;85354;169;73;22;1;21;.955;3600000;0
14392;59592;171;49;34;5;29;.853;3600000;0
14392;64736;3916;0;0;0;0;.00nan;0;0
14392;77955;3916;88;47;4;43;.915;3600000;0
14392;91414;171;0;0;0;0;.00nan;0;0
14393;173918;174;65;25;2;23;.920;3600000;0
14393;176060;172;78;29;1;28;.966;3600000;0
14393;57564;174;0;0;0;0;.00nan;0;0
14393;65125;172;0;0;0;0;.00nan;0;0
14394;501;4247;0;0;0;0;.00nan;0;0
14394;57155;1527;0;0;0;0;.00nan;0;0
14394;78479;4247;94;38;2;36;.947;3900000;0
14394;85709;1527;84;25;2;23;.920;3900000;0
14395;165532;175;0;0;0;0;.00nan;0;0
14395;14191;169;78;28;2;26;.929;3600000;0
14395;36675;175;49;19;3;16;.842;3600000;0
14395;85354;169;0;0;0;0;.00nan;0;0
14396;14191;169;0;0;0;0;.00nan;0;0
14396;59592;171;96;42;3;39;.929;3900000;0
14396;85354;169;74;32;3;29;.906;3900000;0
14396;91414;171;0;0;0;0;.00nan;0;0
14397;14191;169;89;31;1;30;.968;3600000;0
14397;64736;3916;44;17;3;14;.824;3026000;0
14397;77955;3916;30;12;3;9;.750;574000;0
14397;85354;169;0;0;0;0;.00nan;0;0
14398;176060;172;74;27;2;25;.926;3900000;0
14398;59592;171;81;37;2;35;.946;3900000;0
14398;65125;172;0;0;0;0;.00nan;0;0
14398;91414;171;0;0;0;0;.00nan;0;0
14399;501;4247;0;0;0;0;.00nan;0;0
14399;44561;170;0;0;0;0;.00nan;0;0
14399;78479;4247;35;31;5;26;.839;3600000;0
14399;91212;170;58;19;2;17;.895;3600000;0
14400;14191;169;0;0;0;0;.00nan;0;0
14400;64736;3916;0;0;0;0;.00nan;0;0
14400;77955;3916;41;22;4;18;.818;3548000;0
14400;85354;169;91;38;2;36;.947;3600000;0
14401;161535;167;31;19;4;15;.789;3549000;0
14401;173918;174;76;33;2;31;.939;3600000;0
14401;57564;174;0;0;0;0;.00nan;0;0
14401;87164;167;0;0;0;0;.00nan;0;0
14402;176060;172;52;4;0;4;1.000;382000;0
14402;59592;171;0;0;0;0;.00nan;0;0
14402;65125;172;63;51;7;44;.863;3218000;0
14402;91414;171;81;27;1;26;.963;3600000;0
14403;501;4247;82;38;2;36;.947;3600000;0
14403;44561;170;49;35;5;30;.857;3600000;0
14403;78479;4247;0;0;0;0;.00nan;0;0
14403;91212;170;0;0;0;0;.00nan;0;0
14404;161535;167;0;0;0;0;.00nan;0;0
14404;173918;174;0;0;0;0;.00nan;0;0
14404;57564;174;66;32;3;29;.906;3900000;0
14404;87164;167;85;38;3;35;.921;3900000;0
14405;501;4247;0;0;0;0;.00nan;0;0
14405;176060;172;58;35;4;31;.886;3600000;0
14405;65125;172;0;0;0;0;.00nan;0;0
14405;78479;4247;96;31;1;30;.968;3600000;0
14406;173918;174;39;30;5;25;.833;3600000;0
14406;57564;174;0;0;0;0;.00nan;0;0
14406;64736;3916;0;0;0;0;.00nan;0;0
14406;77955;3916;100;28;0;28;1.000;3600000;0
14407;165532;175;72;43;3;40;.930;3600000;0
14407;14191;169;74;26;2;24;.923;3600000;0
14407;36675;175;0;0;0;0;.00nan;0;0
14407;85354;169;0;0;0;0;.00nan;0;0
14408;57155;1527;53;32;4;28;.875;3600000;0
14408;59592;171;100;42;2;40;.952;3600000;0
14408;85709;1527;0;0;0;0;.00nan;0;0
14408;91414;171;0;0;0;0;.00nan;0;0
14409;161535;167;0;0;0;0;.00nan;0;0
14409;44561;170;0;0;0;0;.00nan;0;0
14409;87164;167;100;41;1;40;.976;3600000;0
14409;91212;170;72;29;2;27;.931;3558000;0
14410;173918;174;0;0;0;0;.00nan;0;0
14410;57564;174;91;46;3;43;.935;3590000;0
14410;64736;3916;0;0;0;0;.00nan;0;0
14410;77955;3916;71;23;1;22;.957;3600000;0
14411;165532;175;0;0;0;0;.00nan;0;0
14411;14191;169;0;0;0;0;.00nan;0;0
14411;36675;175;37;28;6;22;.786;3600000;0
14411;85354;169;93;24;1;23;.958;3600000;0
14412;57155;1527;0;0;0;0;.00nan;0;0
14412;59592;171;0;0;0;0;.00nan;0;0
14412;85709;1527;55;34;4;30;.882;3580000;0
14412;91414;171;87;35;2;33;.943;3600000;0
14413;501;4247;0;0;0;0;.00nan;0;0
14413;176060;172;0;0;0;0;.00nan;0;0
14413;65125;172;67;28;3;25;.893;3548000;0
14413;78479;4247;82;31;2;29;.935;3600000;0
14414;161535;167;73;46;4;42;.913;3858000;0
14414;44561;170;77;40;4;36;.900;3900000;0
14414;87164;167;0;0;0;0;.00nan;0;0
14414;91212;170;0;0;0;0;.00nan;0;0
14415;176060;172;76;31;2;29;.935;3600000;0
14415;57155;1527;60;12;0;12;1.000;1264000;0
14415;65125;172;0;0;0;0;.00nan;0;0
14415;85709;1527;37;32;6;26;.813;2336000;0
14416;161535;167;58;33;4;29;.879;3600000;0
14416;64736;3916;0;0;0;0;.00nan;0;0
14416;77955;3916;83;33;2;31;.939;3600000;0
14416;87164;167;0;0;0;0;.00nan;0;0
14417;501;4247;0;0;0;0;.00nan;0;0
14417;173918;174;0;0;0;0;.00nan;0;0
14417;57564;174;61;30;3;27;.900;3553000;0
14417;78479;4247;64;25;2;23;.920;3600000;0
14418;176060;172;0;0;0;0;.00nan;0;0
14418;57155;1527;0;0;0;0;.00nan;0;0
14418;65125;172;100;43;2;41;.953;3900000;0
14418;85709;1527;81;31;2;29;.935;3900000;0
14419;165532;175;52;38;5;33;.868;3565000;0
14419;36675;175;0;0;0;0;.00nan;0;0
14419;44561;170;34;12;3;9;.750;3600000;0
14419;91212;170;0;0;0;0;.00nan;0;0
14420;44561;170;0;0;0;0;.00nan;0;0
14420;64736;3916;73;30;3;27;.900;3600000;0
14420;77955;3916;0;0;0;0;.00nan;0;0
14420;91212;170;54;33;4;29;.879;3544000;0
14421;161535;167;76;14;0;14;1.000;1301000;0
14421;14191;169;69;28;3;25;.893;3600000;0
14421;85354;169;0;0;0;0;.00nan;0;0
14421;87164;167;32;22;5;17;.773;2226000;0
14422;173918;174;73;31;2;29;.935;3600000;0
14422;57564;174;0;0;0;0;.00nan;0;0
14422;59592;171;54;20;3;17;.850;3576000;0
14422;91414;171;0;0;0;0;.00nan;0;0
14423;501;4247;78;25;2;23;.920;3600000;0
14423;176060;172;61;37;4;33;.892;3519000;0
14423;65125;172;0;0;0;0;.00nan;0;0
14423;78479;4247;0;0;0;0;.00nan;0;0
14424;165532;175;0;0;0;0;.00nan;0;0
14424;36675;175;99;41;2;39;.951;3600000;0
14424;57155;1527;74;35;3;32;.914;3599000;0
14424;85709;1527;0;0;0;0;.00nan;0;0
14425;57155;1527;79;23;1;22;.957;3600000;0
14425;64736;3916;0;0;0;0;.00nan;0;0
14425;77955;3916;58;22;2;20;.909;3561000;0
14425;85709;1527;0;0;0;0;.00nan;0;0
14426;165532;175;74;34;3;31;.912;3585000;0
14426;36675;175;0;0;0;0;.00nan;0;0
14426;64736;3916;85;26;1;25;.962;3600000;0
14426;77955;3916;0;0;0;0;.00nan;0;0
14427;501;4247;0;0;0;0;.00nan;0;0
14427;176060;172;65;24;2;22;.917;3542000;0
14427;65125;172;0;0;0;0;.00nan;0;0
14427;78479;4247;87;33;1;32;.970;3600000;0
14428;14191;169;85;36;2;34;.944;3600000;0
14428;59592;171;54;32;4;28;.875;3528000;0
14428;85354;169;0;0;0;0;.00nan;0;0
14428;91414;171;0;0;0;0;.00nan;0;0
14429;173918;174;99;27;0;27;1.000;3600000;0
14429;57155;1527;0;0;0;0;.00nan;0;0
14429;57564;174;0;0;0;0;.00nan;0;0
14429;85709;1527;64;27;2;25;.926;3514000;0
14430;161535;167;62;23;3;20;.870;3569000;0
14430;44561;170;0;0;0;0;.00nan;0;0
14430;87164;167;0;0;0;0;.00nan;0;0
14430;91212;170;68;21;1;20;.952;3600000;0
14431;173918;174;80;35;2;33;.943;3600000;0
14431;57564;174;0;0;0;0;.00nan;0;0
14431;64736;3916;0;0;0;0;.00nan;0;0
14431;77955;3916;28;19;5;14;.737;3600000;0
14432;501;4247;0;0;0;0;.00nan;0;0
14432;176060;172;0;0;0;0;.00nan;0;0
14432;65125;172;59;26;3;23;.885;3600000;0
14432;78479;4247;78;33;2;31;.939;3600000;0
14433;161535;167;0;0;0;0;.00nan;0;0
14433;44561;170;70;25;2;23;.920;3730000;0
14433;87164;167;60;30;3;27;.900;3730000;0
14433;91212;170;0;0;0;0;.00nan;0;0
14434;14191;169;0;0;0;0;.00nan;0;0
14434;59592;171;0;0;0;0;.00nan;0;0
14434;85354;169;75;43;4;39;.907;3600000;0
14434;91414;171;59;41;5;36;.878;3546000;0
14435;165532;175;100;47;2;45;.957;3900000;0
14435;36675;175;0;0;0;0;.00nan;0;0
14435;57155;1527;86;34;2;32;.941;3900000;0
14435;85709;1527;0;0;0;0;.00nan;0;0
14436;59592;171;92;45;4;41;.911;3892000;0
14436;64736;3916;0;0;0;0;.00nan;0;0
14436;77955;3916;62;29;3;26;.897;3892000;0
14436;91414;171;0;0;0;0;.00nan;0;0
14437;501;4247;0;0;0;0;.00nan;0;0
14437;173918;174;98;19;0;19;1.000;3600000;0
14437;57564;174;0;0;0;0;.00nan;0;0
14437;78479;4247;97;43;2;41;.953;3533000;0
14438;176060;172;89;45;3;42;.933;3600000;0
14438;57155;1527;0;0;0;0;.00nan;0;0
14438;65125;172;0;0;0;0;.00nan;0;0
14438;85709;1527;36;25;5;20;.800;3562000;0
14439;165532;175;84;28;2;26;.929;3600000;0
14439;36675;175;0;0;0;0;.00nan;0;0
14439;44561;170;24;18;5;13;.722;2144000;0
14439;91212;170;45;16;3;13;.813;1456000;0
14440;501;4247;0;0;0;0;.00nan;0;0
14440;57155;1527;0;0;0;0;.00nan;0;0
14440;78479;4247;66;42;4;38;.905;3568000;0
14440;85709;1527;65;18;2;16;.889;3600000;0
14441;161535;167;65;26;4;22;.846;3900000;0
14441;165532;175;59;38;4;34;.895;3900000;0
14441;36675;175;0;0;0;0;.00nan;0;0
14441;87164;167;0;0;0;0;.00nan;0;0
14442;173918;174;14;23;6;17;.739;2787000;0
14442;44561;170;75;43;4;39;.907;3600000;0
14442;57564;174;60;7;0;7;1.000;758000;0
14442;91212;170;0;0;0;0;.00nan;0;0
14443;14191;169;70;21;2;19;.905;3900000;0
14443;176060;172;98;42;2;40;.952;3900000;0
14443;65125;172;0;0;0;0;.00nan;0;0
14443;85354;169;0;0;0;0;.00nan;0;0
14444;59592;171;100;43;2;41;.953;3600000;0
14444;64736;3916;0;0;0;0;.00nan;0;0
14444;77955;3916;54;33;4;29;.879;3525000;0
14444;91414;171;0;0;0;0;.00nan;0;0
14445;59592;171;0;0;0;0;.00nan;0;0
14445;64736;3916;52;34;6;28;.824;3600000;0
14445;77955;3916;0;0;0;0;.00nan;0;0
14445;91414;171;82;28;1;27;.964;3600000;0
14446;501;4247;0;0;0;0;.00nan;0;0
14446;57155;1527;98;21;0;21;1.000;3600000;0
14446;78479;4247;54;24;3;21;.875;3600000;0
14446;85709;1527;0;0;0;0;.00nan;0;0
14447;173918;174;0;0;0;0;.00nan;0;0
14447;44561;170;0;0;0;0;.00nan;0;0
14447;57564;174;52;50;7;43;.860;3600000;0
14447;91212;170;58;20;2;18;.900;3600000;0
14448;161535;167;0;0;0;0;.00nan;0;0
14448;165532;175;0;0;0;0;.00nan;0;0
14448;36675;175;61;39;4;35;.897;3565000;0
14448;87164;167;84;39;3;36;.923;3600000;0
14449;14191;169;0;0;0;0;.00nan;0;0
14449;176060;172;0;0;0;0;.00nan;0;0
14449;65125;172;97;44;2;42;.955;3565000;0
14449;85354;169;100;31;0;31;1.000;3600000;0
14450;165532;175;66;26;2;24;.923;3581000;0
14450;36675;175;0;0;0;0;.00nan;0;0
14450;44561;170;84;24;1;23;.958;3600000;0
14450;91212;170;0;0;0;0;.00nan;0;0
14451;501;4247;78;23;1;22;.957;3600000;0
14451;14191;169;80;28;2;26;.929;3600000;0
14451;78479;4247;0;0;0;0;.00nan;0;0
14451;85354;169;0;0;0;0;.00nan;0;0
14452;176060;172;100;23;0;23;1.000;3600000;0
14452;57155;1527;64;40;4;36;.900;3600000;0
14452;65125;172;0;0;0;0;.00nan;0;0
14452;85709;1527;0;0;0;0;.00nan;0;0
14453;176060;172;91;33;2;31;.939;3600000;0
14453;59592;171;78;39;3;36;.923;3552000;0
14453;65125;172;0;0;0;0;.00nan;0;0
14453;91414;171;0;0;0;0;.00nan;0;0
14454;44561;170;58;9;0;9;1.000;752000;0
14454;64736;3916;0;0;0;0;.00nan;0;0
14454;77955;3916;79;33;2;31;.939;3600000;0
14454;91212;170;32;30;6;24;.800;2848000;0
14455;161535;167;68;17;1;16;.941;3600000;0
14455;165532;175;70;39;4;35;.897;3600000;0
14455;36675;175;0;0;0;0;.00nan;0;0
14455;87164;167;0;0;0;0;.00nan;0;0
14456;14191;169;48;21;3;18;.857;3515000;0
14456;59592;171;98;33;1;32;.970;3600000;0
14456;85354;169;0;0;0;0;.00nan;0;0
14456;91414;171;0;0;0;0;.00nan;0;0
14457;173918;174;90;34;2;32;.941;3565000;0
14457;176060;172;0;0;0;0;.00nan;0;0
14457;57564;174;0;0;0;0;.00nan;0;0
14457;65125;172;75;23;1;22;.957;3600000;0
14458;501;4247;0;0;0;0;.00nan;0;0
14458;57155;1527;45;19;3;16;.842;3600000;0
14458;78479;4247;96;22;0;22;1.000;3600000;0
14458;85709;1527;0;0;0;0;.00nan;0;0
14459;165532;175;61;10;0;10;1.000;859000;0
14459;36675;175;38;34;6;28;.824;2741000;0
14459;44561;170;65;20;1;19;.950;3600000;0
14459;91212;170;0;0;0;0;.00nan;0;0
14460;161535;167;0;0;0;0;.00nan;0;0
14460;14191;169;0;0;0;0;.00nan;0;0
14460;85354;169;47;28;4;24;.857;3546000;0
14460;87164;167;54;25;3;22;.880;3600000;0
14461;59592;171;0;0;0;0;.00nan;0;0
14461;64736;3916;63;39;4;35;.897;3559000;0
14461;77955;3916;0;0;0;0;.00nan;0;0
14461;91414;171;64;27;3;24;.889;3600000;0
14462;173918;174;0;0;0;0;.00nan;0;0
14462;176060;172;67;29;3;26;.897;3900000;0
14462;57564;174;65;29;3;26;.897;3900000;0
14462;65125;172;0;0;0;0;.00nan;0;0
14463;501;4247;0;0;0;0;.00nan;0;0
14463;57155;1527;0;0;0;0;.00nan;0;0
14463;78479;4247;67;33;3;30;.909;3581000;0
14463;85709;1527;61;25;2;23;.920;3600000;0
14464;501;4247;0;0;0;0;.00nan;0;0
14464;165532;175;52;25;3;22;.880;3572000;0
14464;36675;175;0;0;0;0;.00nan;0;0
14464;78479;4247;92;40;2;38;.950;3600000;0
14465;161535;167;0;0;0;0;.00nan;0;0
14465;14191;169;72;25;2;23;.920;3600000;0
14465;85354;169;0;0;0;0;.00nan;0;0
14465;87164;167;70;40;4;36;.900;3529000;0
14466;173918;174;0;0;0;0;.00nan;0;0
14466;176060;172;99;39;1;38;.974;3600000;0
14466;57564;174;69;30;3;27;.900;3590000;0
14466;65125;172;0;0;0;0;.00nan;0;0
14467;57155;1527;79;29;2;27;.931;3900000;0
14467;64736;3916;0;0;0;0;.00nan;0;0
14467;77955;3916;84;34;2;32;.941;3900000;0
14467;85709;1527;0;0;0;0;.00nan;0;0
14468;44561;170;0;0;0;0;.00nan;0;0
14468;59592;171;82;30;1;29;.967;3600000;0
14468;91212;170;80;36;2;34;.944;3580000;0
14468;91414;171;0;0;0;0;.00nan;0;0
14469;501;4247;0;0;0;0;.00nan;0;0
14469;165532;175;0;0;0;0;.00nan;0;0
14469;36675;175;75;30;2;28;.933;3600000;0
14469;78479;4247;64;37;4;33;.892;3589000;0
14470;161535;167;85;32;3;29;.906;3600000;0
14470;14191;169;0;0;0;0;.00nan;0;0
14470;85354;169;51;29;4;25;.862;3556000;0
14470;87164;167;0;0;0;0;.00nan;0;0
14471;173918;174;87;44;2;42;.955;3576000;0
14471;176060;172;0;0;0;0;.00nan;0;0
14471;57564;174;0;0;0;0;.00nan;0;0
14471;65125;172;84;30;1;29;.967;3600000;0
14472;57155;1527;0;0;0;0;.00nan;0;0
14472;64736;3916;70;35;3;32;.914;3900000;0
14472;77955;3916;0;0;0;0;.00nan;0;0
14472;85709;1527;71;31;3;28;.903;3900000;0
14473;44561;170;71;29;3;26;.897;3900000;0
14473;59592;171;92;42;3;39;.929;3900000;0
14473;91212;170;0;0;0;0;.00nan;0;0
14473;91414;171;0;0;0;0;.00nan;0;0
14474;173918;174;0;0;0;0;.00nan;0;0
14474;176060;172;62;42;5;37;.881;3600000;0
14474;57564;174;83;14;0;14;1.000;3600000;0
14474;65125;172;0;0;0;0;.00nan;0;0
14475;165532;175;0;0;0;0;.00nan;0;0
14475;36675;175;75;44;5;39;.886;3600000;0
14475;64736;3916;0;0;0;0;.00nan;0;0
14475;77955;3916;71;27;2;25;.926;3600000;0
14476;14191;169;66;38;4;34;.895;3583000;0
14476;57155;1527;0;0;0;0;.00nan;0;0
14476;85354;169;0;0;0;0;.00nan;0;0
14476;85709;1527;46;22;3;19;.864;3600000;0
14477;14191;169;80;35;3;32;.914;3600000;0
14477;44561;170;0;0;0;0;.00nan;0;0
14477;85354;169;0;0;0;0;.00nan;0;0
14477;91212;170;51;35;5;30;.857;3600000;0
14478;161535;167;0;0;0;0;.00nan;0;0
14478;64736;3916;0;0;0;0;.00nan;0;0
14478;77955;3916;81;29;1;28;.966;3600000;0
14478;87164;167;97;40;2;38;.950;3567000;0
14479;501;4247;0;0;0;0;.00nan;0;0
14479;176060;172;64;28;3;25;.893;3600000;0
14479;65125;172;0;0;0;0;.00nan;0;0
14479;78479;4247;38;36;6;30;.833;3600000;0
14480;173918;174;0;0;0;0;.00nan;0;0
14480;57564;174;50;34;5;29;.853;3600000;0
14480;59592;171;87;37;2;35;.946;3600000;0
14480;91414;171;0;0;0;0;.00nan;0;0
14481;165532;175;33;36;6;30;.833;2012000;0
14481;36675;175;52;9;1;8;.889;1588000;0
14481;57155;1527;49;13;2;11;.846;3600000;0
14481;85709;1527;0;0;0;0;.00nan;0;0
14482;14191;169;0;0;0;0;.00nan;0;0
14482;44561;170;86;34;3;31;.912;3560000;0
14482;85354;169;92;36;2;34;.944;3600000;0
14482;91212;170;0;0;0;0;.00nan;0;0
14483;161535;167;90;29;1;28;.966;3600000;0
14483;64736;3916;90;35;2;33;.943;3600000;0
14483;77955;3916;0;0;0;0;.00nan;0;0
14483;87164;167;0;0;0;0;.00nan;0;0
14484;165532;175;67;34;3;31;.912;3600000;0
14484;36675;175;0;0;0;0;.00nan;0;0
14484;57155;1527;0;0;0;0;.00nan;0;0
14484;85709;1527;94;24;0;24;1.000;3600000;0
14485;14191;169;98;46;1;45;.978;3900000;0
14485;59592;171;87;22;1;21;.955;3900000;0
14485;85354;169;0;0;0;0;.00nan;0;0
14485;91414;171;0;0;0;0;.00nan;0;0
14486;501;4247;71;29;2;27;.931;3652000;0
14486;176060;172;70;35;3;32;.914;3652000;0
14486;65125;172;0;0;0;0;.00nan;0;0
14486;78479;4247;0;0;0;0;.00nan;0;0
14487;173918;174;55;27;3;24;.889;3600000;0
14487;44561;170;0;0;0;0;.00nan;0;0
14487;57564;174;0;0;0;0;.00nan;0;0
14487;91212;170;73;26;2;24;.923;3600000;0
14488;161535;167;0;0;0;0;.00nan;0;0
14488;64736;3916;0;0;0;0;.00nan;0;0
14488;77955;3916;92;42;2;40;.952;3541000;0
14488;87164;167;80;24;1;23;.958;3600000;0
14489;501;4247;0;0;0;0;.00nan;0;0
14489;64736;3916;0;0;0;0;.00nan;0;0
14489;77955;3916;78;41;3;38;.927;3570000;0
14489;78479;4247;97;46;1;45;.978;3600000;0
14490;161535;167;78;25;1;24;.960;3900000;0
14490;173918;174;0;0;0;0;.00nan;0;0
14490;57564;174;79;25;1;24;.960;3900000;0
14490;87164;167;0;0;0;0;.00nan;0;0
14491;14191;169;77;36;4;32;.889;3900000;0
14491;57155;1527;0;0;0;0;.00nan;0;0
14491;85354;169;0;0;0;0;.00nan;0;0
14491;85709;1527;49;24;4;20;.833;3900000;0
14492;44561;170;0;0;0;0;.00nan;0;0
14492;59592;171;19;31;7;24;.774;3528000;0
14492;91212;170;51;35;5;30;.857;3600000;0
14492;91414;171;0;0;0;0;.00nan;0;0
14493;165532;175;0;0;0;0;.00nan;0;0
14493;176060;172;18;16;5;11;.688;1135000;0
14493;36675;175;58;19;2;17;.895;3600000;0
14493;65125;172;33;30;6;24;.800;2465000;0
14494;501;4247;0;0;0;0;.00nan;0;0
14494;64736;3916;54;28;5;23;.821;3545000;0
14494;77955;3916;0;0;0;0;.00nan;0;0
14494;78479;4247;75;34;3;31;.912;3600000;0
14495;161535;167;0;0;0;0;.00nan;0;0
14495;173918;174;33;33;6;27;.818;3111000;0
14495;57564;174;53;3;0;3;1.000;489000;0
14495;87164;167;53;32;5;27;.844;3600000;0
14496;14191;169;0;0;0;0;.00nan;0;0
14496;57155;1527;52;20;3;17;.850;3843000;0
14496;85354;169;47;30;4;26;.867;3843000;0
14496;85709;1527;0;0;0;0;.00nan;0;0
14497;44561;170;80;43;3;40;.930;3900000;0
14497;59592;171;80;28;3;25;.893;3900000;0
14497;91212;170;0;0;0;0;.00nan;0;0
14497;91414;171;0;0;0;0;.00nan;0;0
14498;165532;175;79;34;2;32;.941;3600000;0
14498;176060;172;69;34;3;31;.912;3583000;0
14498;36675;175;0;0;0;0;.00nan;0;0
14498;65125;172;0;0;0;0;.00nan;0;0
14499;14191;169;100;28;0;28;1.000;3600000;0
14499;64736;3916;0;0;0;0;.00nan;0;0
14499;77955;3916;71;28;2;26;.929;3600000;0
14499;85354;169;0;0;0;0;.00nan;0;0
14500;501;4247;0;0;0;0;.00nan;0;0
14500;57155;1527;0;0;0;0;.00nan;0;0
14500;78479;4247;54;42;5;37;.881;3600000;0
14500;85709;1527;64;22;2;20;.909;3600000;0
14501;176060;172;72;28;2;26;.929;3600000;0
14501;44561;170;61;12;1;11;.917;1383000;0
14501;65125;172;0;0;0;0;.00nan;0;0
14501;91212;170;45;25;5;20;.800;2217000;0
14502;59592;171;60;29;4;25;.862;3600000;0
14502;64736;3916;93;30;1;29;.967;3600000;0
14502;77955;3916;0;0;0;0;.00nan;0;0
14502;91414;171;0;0;0;0;.00nan;0;0
14503;173918;174;0;0;0;0;.00nan;0;0
14503;57155;1527;44;16;3;13;.813;3600000;0
14503;57564;174;39;33;6;27;.818;3600000;0
14503;85709;1527;0;0;0;0;.00nan;0;0
14504;501;4247;97;43;2;41;.953;3900000;0
14504;165532;175;74;29;2;27;.931;3900000;0
14504;36675;175;0;0;0;0;.00nan;0;0
14504;78479;4247;0;0;0;0;.00nan;0;0
14505;161535;167;81;37;3;34;.919;3900000;0
14505;176060;172;0;0;0;0;.00nan;0;0
14505;65125;172;68;32;3;29;.906;3900000;0
14505;87164;167;0;0;0;0;.00nan;0;0
14506;14191;169;85;33;2;31;.939;3600000;0
14506;44561;170;10;19;6;13;.684;2147000;0
14506;85354;169;0;0;0;0;.00nan;0;0
14506;91212;170;73;17;0;17;1.000;1453000;0
14507;173918;174;76;24;1;23;.958;3600000;0
14507;57155;1527;0;0;0;0;.00nan;0;0
14507;57564;174;0;0;0;0;.00nan;0;0
14507;85709;1527;53;29;4;25;.862;3600000;0
14508;501;4247;0;0;0;0;.00nan;0;0
14508;165532;175;0;0;0;0;.00nan;0;0
14508;36675;175;94;19;0;19;1.000;3600000;0
14508;78479;4247;60;44;6;38;.864;3600000;0
14509;14191;169;67;12;0;12;1.000;1112000;0
14509;59592;171;48;28;5;23;.821;3600000;0
14509;85354;169;29;50;8;42;.840;2488000;0
14509;91414;171;0;0;0;0;.00nan;0;0
14510;161535;167;0;0;0;0;.00nan;0;0
14510;176060;172;72;24;2;22;.917;3600000;0
14510;65125;172;0;0;0;0;.00nan;0;0
14510;87164;167;46;21;3;18;.857;3545000;0
14511;44561;170;76;38;3;35;.921;3597000;0
14511;64736;3916;0;0;0;0;.00nan;0;0
14511;77955;3916;69;25;2;23;.920;3600000;0
14511;91212;170;0;0;0;0;.00nan;0;0
14512;501;4247;0;0;0;0;.00nan;0;0
14512;64736;3916;0;0;0;0;.00nan;0;0
14512;77955;3916;61;16;1;15;.938;3600000;0
14512;78479;4247;56;32;4;28;.875;3600000;0
14513;161535;167;0;0;0;0;.00nan;0;0
14513;165532;175;0;0;0;0;.00nan;0;0
14513;36675;175;59;25;3;22;.880;3541000;0
14513;87164;167;86;35;2;33;.943;3600000;0
14514;14191;169;70;21;1;20;.952;3600000;0
14514;44561;170;91;42;2;40;.952;3600000;0
14514;85354;169;0;0;0;0;.00nan;0;0
14514;91212;170;0;0;0;0;.00nan;0;0
14515;173918;174;0;0;0;0;.00nan;0;0
14515;57564;174;65;43;5;38;.884;3524000;0
14515;59592;171;81;41;3;38;.927;3600000;0
14515;91414;171;0;0;0;0;.00nan;0;0
14516;176060;172;74;37;3;34;.919;3600000;0
14516;57155;1527;58;31;4;27;.871;3547000;0
14516;65125;172;0;0;0;0;.00nan;0;0
14516;85709;1527;0;0;0;0;.00nan;0;0
14517;501;4247;76;31;2;29;.935;3600000;0
14517;64736;3916;63;27;3;24;.889;3590000;0
14517;77955;3916;0;0;0;0;.00nan;0;0
14517;78479;4247;0;0;0;0;.00nan;0;0
14518;165532;175;72;44;4;40;.909;3582000;0
14518;36675;175;0;0;0;0;.00nan;0;0
14518;44561;170;0;0;0;0;.00nan;0;0
14518;91212;170;66;25;2;23;.920;3600000;0
14519;161535;167;70;26;2;24;.923;3600000;0
14519;14191;169;83;39;3;36;.923;3588000;0
14519;85354;169;0;0;0;0;.00nan;0;0
14519;87164;167;0;0;0;0;.00nan;0;0
14520;173918;174;38;20;4;16;.800;2376000;0
14520;57564;174;65;9;0;9;1.000;1224000;0
14520;59592;171;52;39;6;33;.846;3146000;0
14520;91414;171;48;6;1;5;.833;454000;0
14521;176060;172;0;0;0;0;.00nan;0;0
14521;57155;1527;0;0;0;0;.00nan;0;0
14521;65125;172;90;39;2;37;.949;3600000;0
14521;85709;1527;38;32;5;27;.844;3600000;0
14522;501;4247;0;0;0;0;.00nan;0;0
14522;57155;1527;83;21;1;20;.952;3600000;0
14522;78479;4247;62;25;2;23;.920;3592000;0
14522;85709;1527;0;0;0;0;.00nan;0;0
14523;501;4247;0;0;0;0;.00nan;0;0
14523;44561;170;0;0;0;0;.00nan;0;0
14523;78479;4247;56;35;4;31;.886;3563000;0
14523;91212;170;70;28;2;26;.929;3600000;0
14524;161535;167;0;0;0;0;.00nan;0;0
14524;176060;172;0;0;0;0;.00nan;0;0
14524;65125;172;29;39;8;31;.795;3600000;0
14524;87164;167;86;31;2;29;.935;3600000;0
14525;173918;174;0;0;0;0;.00nan;0;0
14525;57564;174;78;32;2;30;.938;3600000;0
14525;64736;3916;0;0;0;0;.00nan;0;0
14525;77955;3916;99;22;0;22;1.000;3600000;0
14526;165532;175;0;0;0;0;.00nan;0;0
14526;14191;169;72;20;1;19;.950;3600000;0
14526;36675;175;56;28;3;25;.893;3514000;0
14526;85354;169;0;0;0;0;.00nan;0;0
14527;57155;1527;70;28;2;26;.929;3600000;0
14527;59592;171;82;39;3;36;.923;3600000;0
14527;85709;1527;0;0;0;0;.00nan;0;0
14527;91414;171;0;0;0;0;.00nan;0;0
14528;501;4247;87;33;2;31;.939;3592000;0
14528;44561;170;68;23;1;22;.957;3600000;0
14528;78479;4247;0;0;0;0;.00nan;0;0
14528;91212;170;0;0;0;0;.00nan;0;0
14529;161535;167;39;20;4;16;.800;3600000;0
14529;176060;172;78;27;2;25;.926;3600000;0
14529;65125;172;0;0;0;0;.00nan;0;0
14529;87164;167;0;0;0;0;.00nan;0;0
14530;173918;174;37;31;6;25;.806;3600000;0
14530;57564;174;0;0;0;0;.00nan;0;0
14530;64736;3916;84;29;1;28;.966;3600000;0
14530;77955;3916;0;0;0;0;.00nan;0;0
14531;165532;175;100;39;1;38;.974;3600000;0
14531;14191;169;0;0;0;0;.00nan;0;0
14531;36675;175;0;0;0;0;.00nan;0;0
14531;85354;169;79;32;2;30;.938;3567000;0
14532;57155;1527;0;0;0;0;.00nan;0;0
14532;59592;171;0;0;0;0;.00nan;0;0
14532;85709;1527;100;38;1;37;.974;3900000;0
14532;91414;171;87;28;1;27;.964;3900000;0
14533;161535;167;0;0;0;0;.00nan;0;0
14533;176060;172;0;0;0;0;.00nan;0;0
14533;65125;172;48;26;4;22;.846;3630000;0
14533;87164;167;81;38;3;35;.921;3630000;0
14534;165532;175;0;0;0;0;.00nan;0;0
14534;173918;174;0;0;0;0;.00nan;0;0
14534;36675;175;92;35;1;34;.971;3600000;0
14534;57564;174;43;24;4;20;.833;3600000;0
14535;57155;1527;100;46;2;44;.957;3600000;0
14535;59592;171;51;19;3;16;.842;3547000;0
14535;85709;1527;0;0;0;0;.00nan;0;0
14535;91414;171;0;0;0;0;.00nan;0;0
14536;501;4247;0;0;0;0;.00nan;0;0
14536;64736;3916;0;0;0;0;.00nan;0;0
14536;77955;3916;74;26;2;24;.923;3600000;0
14536;78479;4247;90;46;3;43;.935;3600000;0
14537;14191;169;77;30;2;28;.933;3900000;0
14537;44561;170;0;0;0;0;.00nan;0;0
14537;85354;169;0;0;0;0;.00nan;0;0
14537;91212;170;70;27;2;25;.926;3900000;0
14538;14191;169;0;0;0;0;.00nan;0;0
14538;64736;3916;0;0;0;0;.00nan;0;0
14538;77955;3916;94;36;3;33;.917;3900000;0
14538;85354;169;71;38;3;35;.921;3900000;0
14539;501;4247;0;0;0;0;.00nan;0;0
14539;176060;172;65;35;4;31;.886;3593000;0
14539;65125;172;0;0;0;0;.00nan;0;0
14539;78479;4247;71;35;3;32;.914;3600000;0
14540;165532;175;63;29;3;26;.897;3600000;0
14540;36675;175;0;0;0;0;.00nan;0;0
14540;59592;171;34;20;4;16;.800;3578000;0
14540;91414;171;0;0;0;0;.00nan;0;0
14541;161535;167;0;0;0;0;.00nan;0;0
14541;57155;1527;77;25;2;23;.920;3600000;0
14541;85709;1527;0;0;0;0;.00nan;0;0
14541;87164;167;67;45;6;39;.867;3600000;0
14542;173918;174;85;32;2;30;.938;3900000;0
14542;44561;170;0;0;0;0;.00nan;0;0
14542;57564;174;0;0;0;0;.00nan;0;0
14542;91212;170;100;53;2;51;.962;3900000;0
14543;14191;169;71;30;2;28;.933;3567000;0
14543;64736;3916;99;36;1;35;.972;3600000;0
14543;77955;3916;0;0;0;0;.00nan;0;0
14543;85354;169;0;0;0;0;.00nan;0;0
14544;165532;175;0;0;0;0;.00nan;0;0
14544;36675;175;76;29;2;27;.931;3600000;0
14544;59592;171;59;27;3;24;.889;3561000;0
14544;91414;171;0;0;0;0;.00nan;0;0
14545;501;4247;71;34;2;32;.941;3519000;0
14545;176060;172;0;0;0;0;.00nan;0;0
14545;65125;172;100;24;0;24;1.000;3600000;0
14545;78479;4247;0;0;0;0;.00nan;0;0
14546;161535;167;97;48;3;45;.938;3900000;0
14546;57155;1527;0;0;0;0;.00nan;0;0
14546;85709;1527;66;26;3;23;.885;3900000;0
14546;87164;167;0;0;0;0;.00nan;0;0
14547;173918;174;0;0;0;0;.00nan;0;0
14547;44561;170;80;30;2;28;.933;3600000;0
14547;57564;174;42;32;5;27;.844;3600000;0
14547;91212;170;0;0;0;0;.00nan;0;0
14548;161535;167;0;0;0;0;.00nan;0;0
14548;57155;1527;57;25;3;22;.880;3545000;0
14548;85709;1527;0;0;0;0;.00nan;0;0
14548;87164;167;76;33;2;31;.939;3600000;0
14549;165532;175;47;34;5;29;.853;3600000;0
14549;173918;174;98;49;2;47;.959;3600000;0
14549;36675;175;0;0;0;0;.00nan;0;0
14549;57564;174;0;0;0;0;.00nan;0;0
14550;176060;172;53;38;5;33;.868;3600000;0
14550;64736;3916;0;0;0;0;.00nan;0;0
14550;65125;172;0;0;0;0;.00nan;0;0
14550;77955;3916;73;31;2;29;.935;3600000;0
14551;161535;167;64;31;3;28;.903;3900000;0
14551;59592;171;89;40;3;37;.925;3900000;0
14551;87164;167;0;0;0;0;.00nan;0;0
14551;91414;171;0;0;0;0;.00nan;0;0
14552;14191;169;81;30;2;28;.933;3600000;0
14552;173918;174;93;39;1;38;.974;3600000;0
14552;57564;174;0;0;0;0;.00nan;0;0
14552;85354;169;0;0;0;0;.00nan;0;0
14553;165532;175;0;0;0;0;.00nan;0;0
14553;36675;175;60;26;2;24;.923;3565000;0
14553;44561;170;0;0;0;0;.00nan;0;0
14553;91212;170;100;27;1;26;.963;3600000;0
14554;501;4247;0;0;0;0;.00nan;0;0
14554;57155;1527;0;0;0;0;.00nan;0;0
14554;78479;4247;70;24;2;22;.917;3900000;0
14554;85709;1527;82;34;2;32;.941;3900000;0
14555;176060;172;0;0;0;0;.00nan;0;0
14555;64736;3916;56;32;4;28;.875;3568000;0
14555;65125;172;89;37;2;35;.946;3600000;0
14555;77955;3916;0;0;0;0;.00nan;0;0
14556;161535;167;0;0;0;0;.00nan;0;0
14556;59592;171;0;0;0;0;.00nan;0;0
14556;87164;167;59;40;4;36;.900;3570000;0
14556;91414;171;69;25;3;22;.880;3600000;0
14557;165532;175;75;33;3;30;.909;3814000;0
14557;36675;175;0;0;0;0;.00nan;0;0
14557;44561;170;59;30;4;26;.867;3814000;0
14557;91212;170;0;0;0;0;.00nan;0;0
14558;14191;169;0;0;0;0;.00nan;0;0
14558;173918;174;97;27;1;26;.963;3600000;0
14558;57564;174;0;0;0;0;.00nan;0;0
14558;85354;169;51;35;4;31;.886;3600000;0
14559;501;4247;68;60;7;53;.883;3600000;0
14559;57155;1527;75;27;2;25;.926;3600000;0
14559;78479;4247;0;0;0;0;.00nan;0;0
14559;85709;1527;0;0;0;0;.00nan;0;0
14560;501;4247;0;0;0;0;.00nan;0;0
14560;173918;174;59;34;3;31;.912;3550000;0
14560;57564;174;0;0;0;0;.00nan;0;0
14560;78479;4247;97;49;2;47;.959;3600000;0
14561;161535;167;68;33;3;30;.909;3600000;0
14561;64736;3916;0;0;0;0;.00nan;0;0
14561;77955;3916;67;26;2;24;.923;3600000;0
14561;87164;167;0;0;0;0;.00nan;0;0
14562;14191;169;53;17;2;15;.882;3543000;0
14562;57155;1527;73;28;1;27;.964;3600000;0
14562;85354;169;0;0;0;0;.00nan;0;0
14562;85709;1527;0;0;0;0;.00nan;0;0
14563;176060;172;62;23;2;21;.913;3600000;0
14563;59592;171;63;37;4;33;.892;3600000;0
14563;65125;172;0;0;0;0;.00nan;0;0
14563;91414;171;0;0;0;0;.00nan;0;0
14564;165532;175;70;35;3;32;.914;3574000;0
14564;36675;175;0;0;0;0;.00nan;0;0
14564;44561;170;0;0;0;0;.00nan;0;0
14564;91212;170;73;28;2;26;.929;3600000;0
14565;501;4247;23;30;7;23;.767;3600000;0
14565;173918;174;66;23;2;21;.913;3600000;0
14565;57564;174;0;0;0;0;.00nan;0;0
14565;78479;4247;0;0;0;0;.00nan;0;0
14566;161535;167;0;0;0;0;.00nan;0;0
14566;64736;3916;64;22;2;20;.909;3600000;0
14566;77955;3916;0;0;0;0;.00nan;0;0
14566;87164;167;92;34;1;33;.971;3600000;0
14567;14191;169;0;0;0;0;.00nan;0;0
14567;57155;1527;0;0;0;0;.00nan;0;0
14567;85354;169;50;40;5;35;.875;3600000;0
14567;85709;1527;86;24;1;23;.958;3600000;0
14568;176060;172;0;0;0;0;.00nan;0;0
14568;59592;171;0;0;0;0;.00nan;0;0
14568;65125;172;58;32;3;29;.906;3600000;0
14568;91414;171;35;30;5;25;.833;3600000;0
14569;165532;175;0;0;0;0;.00nan;0;0
14569;36675;175;75;34;3;31;.912;3600000;0
14569;44561;170;63;27;2;25;.926;3600000;0
14569;91212;170;0;0;0;0;.00nan;0;0
14570;501;4247;0;0;0;0;.00nan;0;0
14570;59592;171;97;20;0;20;1.000;3600000;0
14570;78479;4247;39;41;8;33;.805;3600000;0
14570;91414;171;0;0;0;0;.00nan;0;0
14571;161535;167;76;32;2;30;.938;3600000;0
14571;44561;170;44;4;1;3;.750;1303000;0
14571;87164;167;0;0;0;0;.00nan;0;0
14571;91212;170;29;24;5;19;.792;2297000;0
14572;501;4247;0;0;0;0;.00nan;0;0
14572;14191;169;77;32;2;30;.938;3600000;0
14572;78479;4247;54;24;3;21;.875;3600000;0
14572;85354;169;0;0;0;0;.00nan;0;0
14573;161535;167;0;0;0;0;.00nan;0;0
14573;165532;175;64;26;2;24;.923;3600000;0
14573;36675;175;0;0;0;0;.00nan;0;0
14573;87164;167;40;25;4;21;.840;3571000;0
14574;173918;174;26;8;3;5;.625;481000;0
14574;57564;174;68;29;2;27;.931;3119000;0
14574;59592;171;65;27;3;24;.889;3600000;0
14574;91414;171;0;0;0;0;.00nan;0;0
14575;176060;172;100;44;2;42;.955;3900000;0
14575;57155;1527;80;32;2;30;.938;3900000;0
14575;65125;172;0;0;0;0;.00nan;0;0
14575;85709;1527;0;0;0;0;.00nan;0;0
14576;44561;170;73;34;3;31;.912;3586000;0
14576;64736;3916;0;0;0;0;.00nan;0;0
14576;77955;3916;76;25;2;23;.920;3600000;0
14576;91212;170;0;0;0;0;.00nan;0;0
14577;501;4247;74;25;1;24;.960;3900000;0
14577;14191;169;0;0;0;0;.00nan;0;0
14577;78479;4247;0;0;0;0;.00nan;0;0
14577;85354;169;100;37;1;36;.973;3900000;0
14578;173918;174;78;33;2;31;.939;3600000;0
14578;57564;174;0;0;0;0;.00nan;0;0
14578;59592;171;0;0;0;0;.00nan;0;0
14578;91414;171;68;32;3;29;.906;3600000;0
14579;161535;167;65;20;2;18;.900;3600000;0
14579;165532;175;0;0;0;0;.00nan;0;0
14579;36675;175;45;35;7;28;.800;3600000;0
14579;87164;167;0;0;0;0;.00nan;0;0
14580;176060;172;0;0;0;0;.00nan;0;0
14580;57155;1527;0;0;0;0;.00nan;0;0
14580;65125;172;79;26;1;25;.962;3600000;0
14580;85709;1527;94;38;2;36;.947;3583000;0
14581;44561;170;39;1;1;0;.000;441000;0
14581;64736;3916;69;29;3;26;.897;3600000;0
14581;77955;3916;0;0;0;0;.00nan;0;0
14581;91212;170;46;51;9;42;.824;3159000;0
14582;161535;167;54;23;4;19;.826;3545000;0
14582;64736;3916;0;0;0;0;.00nan;0;0
14582;77955;3916;71;38;3;35;.921;3600000;0
14582;87164;167;0;0;0;0;.00nan;0;0
14583;165532;175;34;29;5;24;.828;3600000;0
14583;173918;174;0;0;0;0;.00nan;0;0
14583;36675;175;0;0;0;0;.00nan;0;0
14583;57564;174;74;21;1;20;.952;3600000;0
14584;14191;169;89;24;1;23;.958;3600000;0
14584;59592;171;40;29;5;24;.828;3600000;0
14584;85354;169;0;0;0;0;.00nan;0;0
14584;91414;171;0;0;0;0;.00nan;0;0
14585;501;4247;0;0;0;0;.00nan;0;0
14585;176060;172;62;47;5;42;.894;3600000;0
14585;65125;172;0;0;0;0;.00nan;0;0
14585;78479;4247;83;28;1;27;.964;3600000;0
14586;44561;170;0;0;0;0;.00nan;0;0
14586;57155;1527;72;20;1;19;.950;1779000;0
14586;85709;1527;1;20;8;12;.600;1821000;0
14586;91212;170;100;30;0;30;1.000;3600000;0
14587;165532;175;0;0;0;0;.00nan;0;0
14587;36675;175;73;43;4;39;.907;3600000;0
14587;64736;3916;0;0;0;0;.00nan;0;0
14587;77955;3916;97;26;0;26;1.000;3600000;0
14588;161535;167;0;0;0;0;.00nan;0;0
14588;173918;174;77;36;3;33;.917;3600000;0
14588;57564;174;0;0;0;0;.00nan;0;0
14588;87164;167;42;24;4;20;.833;3600000;0
14589;14191;169;0;0;0;0;.00nan;0;0
14589;59592;171;0;0;0;0;.00nan;0;0
14589;85354;169;79;32;2;30;.938;3873000;0
14589;91414;171;77;36;3;33;.917;3873000;0
14590;501;4247;49;25;3;22;.880;3546000;0
14590;176060;172;0;0;0;0;.00nan;0;0
14590;65125;172;70;24;2;22;.917;3600000;0
14590;78479;4247;0;0;0;0;.00nan;0;0
14591;44561;170;0;0;0;0;.00nan;0;0
14591;57155;1527;0;0;0;0;.00nan;0;0
14591;85709;1527;78;22;1;21;.955;3599000;0
14591;91212;170;100;30;0;30;1.000;3600000;0
14592;501;4247;46;26;4;22;.846;3072000;0
14592;59592;171;78;33;2;31;.939;3600000;0
14592;78479;4247;23;11;4;7;.636;528000;0
14592;91414;171;0;0;0;0;.00nan;0;0
14593;161535;167;70;44;5;39;.886;3600000;0
14593;44561;170;0;0;0;0;.00nan;0;0
14593;87164;167;0;0;0;0;.00nan;0;0
14593;91212;170;54;18;3;15;.833;3600000;0
14594;165532;175;52;25;4;21;.840;3600000;0
14594;173918;174;38;35;6;29;.829;3600000;0
14594;36675;175;0;0;0;0;.00nan;0;0
14594;57564;174;0;0;0;0;.00nan;0;0
14595;14191;169;93;36;1;35;.972;3600000;0
14595;64736;3916;59;3;0;3;1.000;933000;0
14595;77955;3916;17;30;7;23;.767;2667000;0
14595;85354;169;0;0;0;0;.00nan;0;0
14596;176060;172;47;31;5;26;.839;3600000;0
14596;57155;1527;49;29;4;25;.862;3600000;0
14596;65125;172;0;0;0;0;.00nan;0;0
14596;85709;1527;0;0;0;0;.00nan;0;0
14597;501;4247;0;0;0;0;.00nan;0;0
14597;59592;171;0;0;0;0;.00nan;0;0
14597;78479;4247;42;31;5;26;.839;3559000;0
14597;91414;171;50;21;3;18;.857;3600000;0
14598;161535;167;0;0;0;0;.00nan;0;0
14598;44561;170;74;37;3;34;.919;3585000;0
14598;87164;167;89;20;1;19;.950;3600000;0
14598;91212;170;0;0;0;0;.00nan;0;0
14599;165532;175;0;0;0;0;.00nan;0;0
14599;173918;174;0;0;0;0;.00nan;0;0
14599;36675;175;56;19;2;17;.895;3549000;0
14599;57564;174;73;26;1;25;.962;3600000;0
14600;14191;169;0;0;0;0;.00nan;0;0
14600;64736;3916;100;32;0;32;1.000;3600000;0
14600;77955;3916;0;0;0;0;.00nan;0;0
14600;85354;169;98;42;1;41;.976;3577000;0
14601;176060;172;70;33;3;30;.909;3237000;0
14601;57155;1527;0;0;0;0;.00nan;0;0
14601;65125;172;17;8;4;4;.500;363000;0
14601;85709;1527;46;18;3;15;.833;3600000;0
14602;14191;169;86;41;3;38;.927;3600000;0
14602;59592;171;52;23;4;19;.826;3576000;0
14602;85354;169;0;0;0;0;.00nan;0;0
14602;91414;171;0;0;0;0;.00nan;0;0
14603;501;4247;0;0;0;0;.00nan;0;0
14603;64736;3916;95;19;0;19;1.000;3600000;0
14603;77955;3916;0;0;0;0;.00nan;0;0
14603;78479;4247;73;28;2;26;.929;3583000;0
14604;165532;175;58;33;4;29;.879;3558000;0
14604;36675;175;0;0;0;0;.00nan;0;0
14604;44561;170;0;0;0;0;.00nan;0;0
14604;91212;170;65;24;3;21;.875;3600000;0
14605;14191;169;78;34;3;31;.912;3900000;0
14605;173918;174;0;0;0;0;.00nan;0;0
14605;57564;174;46;17;3;14;.824;3900000;0
14605;85354;169;0;0;0;0;.00nan;0;0
14606;161535;167;92;38;2;36;.947;3900000;0
14606;59592;171;74;28;2;26;.929;3900000;0
14606;87164;167;0;0;0;0;.00nan;0;0
14606;91414;171;0;0;0;0;.00nan;0;0
14607;176060;172;98;42;2;40;.952;3547000;0
14607;57155;1527;75;22;1;21;.955;3600000;0
14607;65125;172;0;0;0;0;.00nan;0;0
14607;85709;1527;0;0;0;0;.00nan;0;0
14608;501;4247;71;41;3;38;.927;3665000;0
14608;64736;3916;83;31;2;29;.935;3665000;0
14608;77955;3916;0;0;0;0;.00nan;0;0
14608;78479;4247;0;0;0;0;.00nan;0;0
14609;14191;169;0;0;0;0;.00nan;0;0
14609;173918;174;71;24;1;23;.958;3600000;0
14609;57564;174;0;0;0;0;.00nan;0;0
14609;85354;169;50;30;4;26;.867;3600000;0
14610;161535;167;19;8;4;4;.500;382000;0
14610;59592;171;0;0;0;0;.00nan;0;0
14610;87164;167;34;27;6;21;.778;3218000;0
14610;91414;171;63;22;2;20;.909;3600000;0
14611;176060;172;0;0;0;0;.00nan;0;0
14611;57155;1527;0;0;0;0;.00nan;0;0
14611;65125;172;48;22;3;19;.864;3567000;0
14611;85709;1527;73;26;2;24;.923;3600000;0
14612;165532;175;0;0;0;0;.00nan;0;0
14612;36675;175;91;38;2;36;.947;3600000;0
14612;44561;170;0;0;0;0;.00nan;0;0
14612;91212;170;37;29;5;24;.828;3600000;0
14614;37786;3916;0;0;0;0;.00nan;0;0
14614;59592;171;67;16;1;15;.938;3600000;0
14614;64736;3916;79;30;2;28;.933;3548000;0
14614;91414;171;0;0;0;0;.00nan;0;0
14616;2136;1527;0;0;0;0;.00nan;0;0
14616;14191;169;0;0;0;0;.00nan;0;0
14616;85354;169;100;37;0;37;1.000;3600000;0
14616;85709;1527;27;28;6;22;.786;3600000;0
14618;161535;167;0;0;0;0;.00nan;0;0
14618;176060;172;59;25;3;22;.880;3600000;0
14618;65125;172;0;0;0;0;.00nan;0;0
14618;87164;167;34;30;6;24;.800;3600000;0
14620;165532;175;60;23;2;21;.913;3600000;0
14620;173918;174;57;27;4;23;.852;3532000;0
14620;36675;175;0;0;0;0;.00nan;0;0
14620;57564;174;0;0;0;0;.00nan;0;0
14622;36719;4247;0;0;0;0;.00nan;0;0
14622;78479;4247;44;29;4;25;.862;3525000;0
14622;85633;170;0;0;0;0;.00nan;0;0
14622;91212;170;71;28;2;26;.929;3600000;0
1099;501;4247;65;25;2;23;.920;3352000;0
1099;57155;1527;0;0;0;0;.00nan;0;0
1099;78479;4247;21;3;3;0;.000;174000;0
1099;85709;1527;77;33;3;30;.909;3600000;0
1100;59592;171;96;40;2;38;.950;3600000;0
1100;64736;3916;0;0;0;0;.00nan;0;0
1100;77955;3916;62;28;3;25;.893;3557000;0
1100;91414;171;0;0;0;0;.00nan;0;0
1101;14191;169;77;32;3;29;.906;3710000;0
1101;176060;172;75;30;2;28;.933;3710000;0
1101;65125;172;0;0;0;0;.00nan;0;0
1101;85354;169;0;0;0;0;.00nan;0;0
1102;161535;167;64;27;2;25;.926;3600000;0
1102;44561;170;37;8;2;6;.750;1269000;0
1102;87164;167;0;0;0;0;.00nan;0;0
1102;91212;170;37;25;6;19;.760;2331000;0
1103;501;4247;0;0;0;0;.00nan;0;0
1103;57155;1527;0;0;0;0;.00nan;0;0
1103;78479;4247;79;42;4;38;.905;3600000;0
1103;85709;1527;100;27;0;27;1.000;3600000;0
1104;59592;171;52;28;4;24;.857;4179000;0
1104;64736;3916;0;0;0;0;.00nan;0;0
1104;77955;3916;73;39;3;36;.923;4179000;0
1104;91414;171;0;0;0;0;.00nan;0;0
1105;14191;169;96;34;2;32;.941;3600000;0
1105;176060;172;71;37;4;33;.892;3534000;0
1105;65125;172;0;0;0;0;.00nan;0;0
1105;85354;169;0;0;0;0;.00nan;0;0
1106;161535;167;91;30;1;29;.967;3600000;0
1106;44561;170;0;0;0;0;.00nan;0;0
1106;87164;167;0;0;0;0;.00nan;0;0
1106;91212;170;72;36;3;33;.917;3595000;0
1241;59592;171;91;33;1;32;.970;3600000;0
1241;64736;3916;0;0;0;0;.00nan;0;0
1241;77955;3916;70;27;2;25;.926;3551000;0
1241;91414;171;0;0;0;0;.00nan;0;0
1242;14191;169;86;32;2;30;.938;3600000;0
1242;176060;172;22;28;6;22;.786;3600000;0
1242;65125;172;0;0;0;0;.00nan;0;0
1242;85354;169;0;0;0;0;.00nan;0;0
1276;57155;1527;0;0;0;0;.00nan;0;0
1276;59592;171;81;27;1;26;.963;3600000;0
1276;85709;1527;57;33;4;29;.879;3600000;0
1276;91414;171;0;0;0;0;.00nan;0;0
1277;161535;167;65;26;3;23;.885;4215000;0
1277;14191;169;77;44;4;40;.909;4215000;0
1277;85354;169;0;0;0;0;.00nan;0;0
1277;87164;167;0;0;0;0;.00nan;0;0
1278;57155;1527;0;0;0;0;.00nan;0;0
1278;59592;171;57;35;4;31;.886;3600000;0
1278;85709;1527;75;25;1;24;.960;3600000;0
1278;91414;171;0;0;0;0;.00nan;0;0
1279;161535;167;68;31;3;28;.903;3600000;0
1279;14191;169;44;28;5;23;.821;3600000;0
1279;85354;169;0;0;0;0;.00nan;0;0
1279;87164;167;0;0;0;0;.00nan;0;0
14623;173519;441;0;0;0;0;.00nan;0;0
14623;-1;441;55;29;4;25;.862;3543000;0
14623;174386;428;43;18;3;15;.833;3600000;0
14623;86531;428;0;0;0;0;.00nan;0;0
14624;171930;422;0;0;0;0;.00nan;0;0
14624;166767;422;85;25;1;24;.960;3600000;0
14624;174164;4849;29;33;7;26;.788;3600000;0
14624;179691;4849;0;0;0;0;.00nan;0;0
14625;168360;444;0;0;0;0;.00nan;0;0
14625;168855;444;36;23;4;19;.826;3600000;0
14625;178841;419;75;17;1;16;.941;3600000;0
14625;-1;419;0;0;0;0;.00nan;0;0
14626;171930;422;0;0;0;0;.00nan;0;0
14626;166767;422;48;12;2;10;.833;3600000;0
14626;174164;4849;75;40;3;37;.925;3598000;0
14626;179691;4849;0;0;0;0;.00nan;0;0
14627;168360;444;83;34;1;33;.971;3600000;0
14627;168855;444;0;0;0;0;.00nan;0;0
14627;178841;419;68;27;2;25;.926;3559000;0
14627;-1;419;0;0;0;0;.00nan;0;0
14628;179143;423;88;35;2;33;.943;3546000;0
14628;176808;418;0;0;0;0;.00nan;0;0
14628;180965;418;74;24;1;23;.958;3600000;0
14628;85649;423;0;0;0;0;.00nan;0;0
14629;178743;449;0;0;0;0;.00nan;0;0
14629;179071;420;0;0;0;0;.00nan;0;0
14629;74980;420;97;36;1;35;.972;4186000;0
14629;141530;449;80;32;2;30;.938;4186000;0
14630;179143;423;52;38;5;33;.868;3600000;0
14630;176808;418;0;0;0;0;.00nan;0;0
14630;180965;418;76;19;1;18;.947;3600000;0
14630;85649;423;0;0;0;0;.00nan;0;0
14631;178743;449;36;29;6;23;.793;3600000;0
14631;179071;420;0;0;0;0;.00nan;0;0
14631;74980;420;93;39;2;37;.949;3600000;0
14631;141530;449;0;0;0;0;.00nan;0;0
14632;183783;415;36;32;6;26;.813;3982000;0
14632;-1;413;51;8;1;7;.875;1651000;0
14632;-1;413;51;27;4;23;.852;2331000;0
14632;94557;415;0;0;0;0;.00nan;0;0
14633;163228;429;100;27;0;27;1.000;3600000;0
14633;-1;443;98;40;2;38;.950;3530000;0
14633;-1;429;0;0;0;0;.00nan;0;0
14633;170928;443;0;0;0;0;.00nan;0;0
14634;-1;433;80;25;1;24;.960;3600000;0
14634;170499;427;2;22;7;15;.682;1896000;0
14634;-1;433;0;0;0;0;.00nan;0;0
14634;149863;427;44;19;3;16;.842;1704000;0
14635;163177;425;0;0;0;0;.00nan;0;0
14635;-1;425;56;25;3;22;.880;4200000;0
14635;86579;434;52;24;3;21;.875;4200000;0
14635;152650;434;0;0;0;0;.00nan;0;0
14636;174420;439;57;12;2;10;.833;3600000;0
14636;181100;442;58;44;6;38;.864;3600000;0
14636;182210;439;0;0;0;0;.00nan;0;0
14636;-1;442;0;0;0;0;.00nan;0;0
14637;177106;412;0;0;0;0;.00nan;0;0
14637;168206;414;0;0;0;0;.00nan;0;0
14637;181346;414;36;38;7;31;.816;3600000;0
14637;-1;412;66;20;1;19;.950;3600000;0
14638;179071;420;0;0;0;0;.00nan;0;0
14638;176808;418;0;0;0;0;.00nan;0;0
14638;180965;418;49;20;3;17;.850;3600000;0
14638;74980;420;79;41;4;37;.902;3553000;0
14639;170886;440;0;0;0;0;.00nan;0;0
14639;176077;440;60;23;2;21;.913;3574000;0
14639;182006;436;86;28;1;27;.964;3600000;0
14639;141294;436;0;0;0;0;.00nan;0;0
14640;174164;4849;0;0;0;0;.00nan;0;0
14640;174241;421;72;26;2;24;.923;3600000;0
14640;179691;4849;80;46;4;42;.913;3531000;0
14640;74680;421;0;0;0;0;.00nan;0;0
14641;170499;427;75;23;1;22;.957;3600000;0
14641;173954;438;65;38;3;35;.921;3579000;0
14641;78492;438;0;0;0;0;.00nan;0;0
14641;149863;427;0;0;0;0;.00nan;0;0
14642;165751;435;0;0;0;0;.00nan;0;0
14642;170878;430;68;32;3;29;.906;3600000;0
14642;-1;430;0;0;0;0;.00nan;0;0
14642;91448;435;75;45;5;40;.889;3580000;0
14643;178743;449;60;21;2;19;.905;3600000;0
14643;179143;423;52;30;3;27;.900;3553000;0
14643;85649;423;0;0;0;0;.00nan;0;0
14643;141530;449;0;0;0;0;.00nan;0;0
14644;178890;417;0;0;0;0;.00nan;0;0
14644;175989;410;0;0;0;0;.00nan;0;0
14644;78864;410;91;32;1;31;.969;3543000;0
14644;85050;417;100;41;0;41;1.000;3600000;0
14645;171930;422;80;21;1;20;.952;3600000;0
14645;166767;422;0;0;0;0;.00nan;0;0
14645;168360;444;46;30;5;25;.833;3600000;0
14645;168855;444;0;0;0;0;.00nan;0;0
14646;179478;432;81;26;1;25;.962;3600000;0
14646;182093;432;0;0;0;0;.00nan;0;0
14646;85987;426;74;40;4;36;.900;3600000;0
14646;86226;426;0;0;0;0;.00nan;0;0
14647;173575;437;0;0;0;0;.00nan;0;0
14647;171517;431;0;0;0;0;.00nan;0;0
14647;182225;431;68;31;3;28;.903;3600000;0
14647;139865;437;67;34;4;30;.882;3551000;0
14648;177155;411;54;14;2;12;.857;3600000;0
14648;183783;415;48;28;4;24;.857;3594000;0
14648;94557;415;0;0;0;0;.00nan;0;0
14648;141459;411;0;0;0;0;.00nan;0;0
14649;163177;425;45;6;1;5;.833;1206000;0
14649;163228;429;63;18;2;16;.889;3600000;0
14649;-1;429;0;0;0;0;.00nan;0;0
14649;-1;425;41;26;4;22;.846;2394000;0
14650;170886;440;0;0;0;0;.00nan;0;0
14650;176077;440;33;8;3;5;.625;3551000;0
14650;182006;436;100;44;1;43;.977;3600000;0
14650;141294;436;0;0;0;0;.00nan;0;0
14651;174164;4849;48;31;4;27;.871;3600000;0
14651;174241;421;98;20;0;20;1.000;3600000;0
14651;179691;4849;0;0;0;0;.00nan;0;0
14651;74680;421;0;0;0;0;.00nan;0;0
14652;165751;435;50;8;1;7;.875;853000;0
14652;173954;438;0;0;0;0;.00nan;0;0
14652;78492;438;53;29;4;25;.862;3600000;0
14652;91448;435;24;26;6;20;.769;2747000;0
14653;168206;414;77;38;3;35;.921;3703000;0
14653;178890;417;0;0;0;0;.00nan;0;0
14653;181346;414;0;0;0;0;.00nan;0;0
14653;85050;417;73;30;2;28;.933;3703000;0
14654;181100;442;50;30;4;26;.867;3548000;0
14654;-1;442;0;0;0;0;.00nan;0;0
14654;85987;426;0;0;0;0;.00nan;0;0
14654;86226;426;55;27;3;24;.889;3600000;0
14655;179071;420;43;40;6;34;.850;2649000;0
14655;176808;418;94;26;0;26;1.000;3600000;0
14655;180965;418;0;0;0;0;.00nan;0;0
14655;74980;420;62;16;1;15;.938;951000;0
14656;178743;449;0;0;0;0;.00nan;0;0
14656;179143;423;0;0;0;0;.00nan;0;0
14656;85649;423;99;29;0;29;1.000;3600000;0
14656;141530;449;33;17;4;13;.765;3600000;0
14657;171930;422;0;0;0;0;.00nan;0;0
14657;166767;422;49;15;3;12;.800;3600000;0
14657;168360;444;51;28;4;24;.857;3525000;0
14657;168855;444;0;0;0;0;.00nan;0;0
14658;177106;412;0;0;0;0;.00nan;0;0
14658;175989;410;0;0;0;0;.00nan;0;0
14658;-1;412;93;21;0;21;1.000;3600000;0
14658;78864;410;77;33;2;31;.939;3600000;0
14659;173575;437;0;0;0;0;.00nan;0;0
14659;179478;432;0;0;0;0;.00nan;0;0
14659;182093;432;70;20;1;19;.950;3600000;0
14659;139865;437;74;40;4;36;.900;3600000;0
14660;177155;411;100;33;0;33;1.000;3600000;0
14660;-1;413;0;0;0;0;.00nan;0;0
14660;-1;413;64;27;2;25;.926;3523000;0
14660;141459;411;0;0;0;0;.00nan;0;0
14661;171517;431;0;0;0;0;.00nan;0;0
14661;174420;439;0;0;0;0;.00nan;0;0
14661;182210;439;49;21;2;19;.905;3600000;0
14661;182225;431;86;52;4;48;.923;3557000;0
14662;170499;427;0;0;0;0;.00nan;0;0
14662;86579;434;41;18;4;14;.778;3600000;0
14662;149863;427;90;34;1;33;.971;3600000;0
14662;152650;434;0;0;0;0;.00nan;0;0
14663;179478;432;0;0;0;0;.00nan;0;0
14663;181100;442;0;0;0;0;.00nan;0;0
14663;182093;432;78;23;1;22;.957;3600000;0
14663;-1;442;39;23;4;19;.826;3600000;0
14664;-1;413;82;43;4;39;.907;4200000;0
14664;175989;410;0;0;0;0;.00nan;0;0
14664;-1;413;0;0;0;0;.00nan;0;0
14664;78864;410;61;27;4;23;.852;4187000;0
14665;174386;428;79;34;2;32;.941;3600000;0
14665;182006;436;46;29;4;25;.862;3556000;0
14665;86531;428;0;0;0;0;.00nan;0;0
14665;141294;436;0;0;0;0;.00nan;0;0
14666;171517;431;0;0;0;0;.00nan;0;0
14666;179478;432;0;0;0;0;.00nan;0;0
14666;182093;432;49;30;4;26;.867;3565000;0
14666;182225;431;65;34;3;31;.912;3600000;0
14667;165751;435;100;54;3;51;.944;3600000;0
14667;86579;434;51;23;4;19;.826;3551000;0
14667;91448;435;0;0;0;0;.00nan;0;0
14667;152650;434;0;0;0;0;.00nan;0;0
14668;168206;414;66;24;2;22;.917;3600000;0
14668;-1;413;0;0;0;0;.00nan;0;0
14668;181346;414;0;0;0;0;.00nan;0;0
14668;-1;413;47;20;3;17;.850;3600000;0
14669;174164;4849;72;34;3;31;.912;3600000;0
14669;176808;418;41;23;4;19;.826;3543000;0
14669;179691;4849;0;0;0;0;.00nan;0;0
14669;180965;418;0;0;0;0;.00nan;0;0
14670;163228;429;91;40;1;39;.975;4200000;0
14670;-1;429;0;0;0;0;.00nan;0;0
14670;170499;427;89;32;1;31;.969;4200000;0
14670;149863;427;0;0;0;0;.00nan;0;0
14671;170886;440;31;17;4;13;.765;3600000;0
14671;174420;439;0;0;0;0;.00nan;0;0
14671;176077;440;0;0;0;0;.00nan;0;0
14671;182210;439;91;36;1;35;.972;3600000;0
14672;171930;422;0;0;0;0;.00nan;0;0
14672;166767;422;79;15;0;15;1.000;3600000;0
14672;179071;420;49;1;0;1;1.000;327000;0
14672;74980;420;57;48;6;42;.875;3273000;0
14673;177106;412;0;0;0;0;.00nan;0;0
14673;183783;415;82;32;2;30;.938;3600000;0
14673;-1;412;96;27;0;27;1.000;3600000;0
14673;94557;415;0;0;0;0;.00nan;0;0
14674;163177;425;73;26;1;25;.962;3600000;0
14674;170878;430;74;39;3;36;.923;3590000;0
14674;-1;425;0;0;0;0;.00nan;0;0
14674;-1;430;0;0;0;0;.00nan;0;0
14675;-1;443;78;21;1;20;.952;3600000;0
14675;173954;438;73;31;2;29;.935;3564000;0
14675;170928;443;0;0;0;0;.00nan;0;0
14675;78492;438;0;0;0;0;.00nan;0;0
14676;179143;423;0;0;0;0;.00nan;0;0
14676;174241;421;65;24;1;23;.958;4200000;0
14676;74680;421;0;0;0;0;.00nan;0;0
14676;85649;423;92;33;1;32;.970;4200000;0
14677;178743;449;78;30;2;28;.933;3674000;0
14677;178841;419;63;25;3;22;.880;3674000;0
14677;-1;419;0;0;0;0;.00nan;0;0
14677;141530;449;0;0;0;0;.00nan;0;0
14678;177155;411;46;23;4;19;.826;3600000;0
14678;178890;417;73;28;2;26;.929;2909000;0
14678;85050;417;26;10;4;6;.600;670000;0
14678;141459;411;0;0;0;0;.00nan;0;0
14679;182006;436;0;0;0;0;.00nan;0;0
14679;85987;426;0;0;0;0;.00nan;0;0
14679;86226;426;75;19;1;18;.947;3600000;0
14679;141294;436;38;20;3;17;.850;3526000;0
14680;173519;441;0;0;0;0;.00nan;0;0
14680;173575;437;59;26;3;23;.885;3564000;0
14680;-1;441;99;38;2;36;.947;3600000;0
14680;139865;437;0;0;0;0;.00nan;0;0
14681;171930;422;87;17;0;17;1.000;3600000;0
14681;166767;422;0;0;0;0;.00nan;0;0
14681;179071;420;80;31;2;29;.935;3524000;0
14681;74980;420;0;0;0;0;.00nan;0;0
14682;174386;428;67;23;2;21;.913;3600000;0
14682;181100;442;27;17;4;13;.765;1164000;0
14682;-1;442;47;32;4;28;.875;2436000;0
14682;86531;428;0;0;0;0;.00nan;0;0
14683;170886;440;0;0;0;0;.00nan;0;0
14683;174420;439;0;0;0;0;.00nan;0;0
14683;176077;440;65;27;2;25;.926;3569000;0
14683;182210;439;87;27;1;26;.963;3600000;0
14684;-1;433;31;32;6;26;.813;2987000;0
14684;-1;433;51;2;0;2;1.000;613000;0
14684;86579;434;95;38;1;37;.974;3600000;0
14684;152650;434;0;0;0;0;.00nan;0;0
14685;183783;415;0;0;0;0;.00nan;0;0
14685;178890;417;0;0;0;0;.00nan;0;0
14685;85050;417;79;41;4;37;.902;3600000;0
14685;94557;415;100;25;0;25;1.000;3600000;0
14686;174164;4849;0;0;0;0;.00nan;0;0
14686;176808;418;0;0;0;0;.00nan;0;0
14686;179691;4849;76;29;2;27;.931;3600000;0
14686;180965;418;58;30;3;27;.900;3568000;0
14687;163177;425;0;0;0;0;.00nan;0;0
14687;173954;438;0;0;0;0;.00nan;0;0
14687;-1;425;66;14;1;13;.929;3600000;0
14687;78492;438;89;52;3;49;.942;3546000;0
14688;-1;443;0;0;0;0;.00nan;0;0
14688;170878;430;44;22;3;19;.864;2707000;0
14688;170928;443;55;16;2;14;.875;3600000;0
14688;-1;430;28;14;4;10;.714;893000;0
14689;168206;414;79;35;2;33;.943;3600000;0
14689;175989;410;0;0;0;0;.00nan;0;0
14689;181346;414;0;0;0;0;.00nan;0;0
14689;78864;410;75;30;3;27;.900;3600000;0
14690;179143;423;89;52;3;49;.942;3546000;0
14690;174241;421;0;0;0;0;.00nan;0;0
14690;74680;421;84;26;2;24;.923;3600000;0
14690;85649;423;0;0;0;0;.00nan;0;0
14691;178743;449;0;0;0;0;.00nan;0;0
14691;178841;419;0;0;0;0;.00nan;0;0
14691;-1;419;100;30;0;30;1.000;3600000;0
14691;141530;449;79;35;2;33;.943;3530000;0
14692;177106;412;0;0;0;0;.00nan;0;0
14692;177155;411;0;0;0;0;.00nan;0;0
14692;-1;412;57;28;3;25;.893;3544000;0
14692;141459;411;71;23;2;21;.913;3600000;0
14693;163228;429;0;0;0;0;.00nan;0;0
14693;165751;435;0;0;0;0;.00nan;0;0
14693;-1;429;83;29;1;28;.966;3600000;0
14693;91448;435;60;27;3;24;.889;3578000;0
14694;173519;441;34;24;5;19;.792;3600000;0
14694;173575;437;0;0;0;0;.00nan;0;0
14694;-1;441;0;0;0;0;.00nan;0;0
14694;139865;437;70;30;3;27;.900;3600000;0
14695;177106;412;0;0;0;0;.00nan;0;0
14695;178890;417;73;34;3;31;.912;4059000;0
14695;-1;412;73;40;4;36;.900;4059000;0
14695;85050;417;0;0;0;0;.00nan;0;0
14696;165751;435;57;28;3;25;.893;3600000;0
14696;-1;433;0;0;0;0;.00nan;0;0
14696;-1;433;79;17;1;16;.941;3600000;0
14696;91448;435;0;0;0;0;.00nan;0;0
14697;171517;431;0;0;0;0;.00nan;0;0
14697;182225;431;37;24;4;20;.833;3574000;0
14697;85987;426;0;0;0;0;.00nan;0;0
14697;86226;426;75;33;2;31;.939;3600000;0
14698;178743;449;0;0;0;0;.00nan;0;0
14698;174241;421;70;21;1;20;.952;3600000;0
14698;74680;421;0;0;0;0;.00nan;0;0
14698;141530;449;39;30;6;24;.800;3600000;0
14699;179478;432;34;31;6;25;.806;3558000;0
14699;182093;432;0;0;0;0;.00nan;0;0
14699;85987;426;63;37;4;33;.892;3600000;0
14699;86226;426;0;0;0;0;.00nan;0;0
14700;177155;411;100;22;0;22;1.000;3600000;0
14700;168206;414;51;27;3;24;.889;3600000;0
14700;181346;414;0;0;0;0;.00nan;0;0
14700;141459;411;0;0;0;0;.00nan;0;0
14701;179071;420;0;0;0;0;.00nan;0;0
14701;174164;4849;86;34;2;32;.941;3600000;0
14701;179691;4849;0;0;0;0;.00nan;0;0
14701;74980;420;54;23;3;20;.870;3588000;0
14702;163177;425;0;0;0;0;.00nan;0;0
14702;-1;425;58;22;2;20;.909;3600000;0
14702;182006;436;66;28;3;25;.893;3551000;0
14702;141294;436;0;0;0;0;.00nan;0;0
14703;173954;438;69;45;3;42;.933;4200000;0
14703;174420;439;0;0;0;0;.00nan;0;0
14703;182210;439;82;34;3;31;.912;4200000;0
14703;78492;438;0;0;0;0;.00nan;0;0
14704;-1;443;88;29;1;28;.966;3560000;0
14704;170928;443;0;0;0;0;.00nan;0;0
14704;174386;428;0;0;0;0;.00nan;0;0
14704;86531;428;100;32;0;32;1.000;3600000;0
14705;171930;422;57;22;3;19;.864;3636000;0
14705;166767;422;0;0;0;0;.00nan;0;0
14705;178841;419;0;0;0;0;.00nan;0;0
14705;-1;419;51;29;4;25;.862;3636000;0
14706;165751;435;0;0;0;0;.00nan;0;0
14706;-1;433;75;28;1;27;.964;3600000;0
14706;-1;433;0;0;0;0;.00nan;0;0
14706;91448;435;69;35;3;32;.914;3556000;0
14707;163228;429;54;25;3;22;.880;3600000;0
14707;-1;429;0;0;0;0;.00nan;0;0
14707;173519;441;0;0;0;0;.00nan;0;0
14707;-1;441;37;33;6;27;.818;3600000;0
14708;170878;430;63;17;2;15;.882;3600000;0
14708;181100;442;73;32;3;29;.906;3565000;0
14708;-1;442;0;0;0;0;.00nan;0;0
14708;-1;430;0;0;0;0;.00nan;0;0
14709;183783;415;0;0;0;0;.00nan;0;0
14709;175989;410;0;0;0;0;.00nan;0;0
14709;78864;410;61;25;3;22;.880;3566000;0
14709;94557;415;96;37;1;36;.973;3600000;0
14710;168360;444;0;0;0;0;.00nan;0;0
14710;168855;444;69;30;3;27;.900;3600000;0
14710;179143;423;61;36;4;32;.889;3543000;0
14710;85649;423;0;0;0;0;.00nan;0;0
14711;170499;427;70;34;3;31;.912;3600000;0
14711;179478;432;0;0;0;0;.00nan;0;0
14711;182093;432;65;21;2;19;.905;3600000;0
14711;149863;427;0;0;0;0;.00nan;0;0
14712;178890;417;0;0;0;0;.00nan;0;0
14712;-1;413;66;50;6;44;.880;3600000;0
14712;-1;413;0;0;0;0;.00nan;0;0
14712;85050;417;67;27;3;24;.889;3600000;0
14713;168206;414;0;0;0;0;.00nan;0;0
14713;183783;415;100;36;1;35;.972;3600000;0
14713;181346;414;52;17;2;15;.882;3545000;0
14713;94557;415;0;0;0;0;.00nan;0;0
14714;-1;443;0;0;0;0;.00nan;0;0
14714;170928;443;50;24;4;20;.833;3600000;0
14714;182006;436;0;0;0;0;.00nan;0;0
14714;141294;436;52;23;3;20;.870;3600000;0
14715;179071;420;51;22;3;19;.864;3561000;0
14715;174164;4849;0;0;0;0;.00nan;0;0
14715;179691;4849;55;18;2;16;.889;3600000;0
14715;74980;420;0;0;0;0;.00nan;0;0
14716;173954;438;0;0;0;0;.00nan;0;0
14716;181100;442;0;0;0;0;.00nan;0;0
14716;-1;442;62;29;3;26;.897;4062000;0
14716;78492;438;87;34;2;32;.941;4062000;0
14717;163177;425;85;25;1;24;.960;3600000;0
14717;174386;428;100;30;0;30;1.000;3600000;0
14717;-1;425;0;0;0;0;.00nan;0;0
14717;86531;428;0;0;0;0;.00nan;0;0
14718;170886;440;79;22;1;21;.955;3600000;0
14718;176077;440;0;0;0;0;.00nan;0;0
14718;86579;434;74;34;3;31;.912;3529000;0
14718;152650;434;0;0;0;0;.00nan;0;0
14719;171930;422;0;0;0;0;.00nan;0;0
14719;166767;422;85;19;0;19;1.000;3600000;0
14719;178841;419;48;25;4;21;.840;3600000;0
14719;-1;419;0;0;0;0;.00nan;0;0
14720;173519;441;70;39;3;36;.923;3569000;0
14720;170499;427;52;16;2;14;.875;3600000;0
14720;-1;441;0;0;0;0;.00nan;0;0
14720;149863;427;0;0;0;0;.00nan;0;0
14721;170878;430;0;0;0;0;.00nan;0;0
14721;174420;439;67;15;1;14;.933;3600000;0
14721;182210;439;0;0;0;0;.00nan;0;0
14721;-1;430;73;41;4;37;.902;3600000;0
14722;168360;444;68;20;2;18;.900;3600000;0
14722;168855;444;0;0;0;0;.00nan;0;0
14722;179143;423;0;0;0;0;.00nan;0;0
14722;85649;423;75;38;3;35;.921;3600000;0
14723;177155;411;42;25;4;21;.840;3561000;0
14723;175989;410;82;35;2;33;.943;3600000;0
14723;78864;410;0;0;0;0;.00nan;0;0
14723;141459;411;0;0;0;0;.00nan;0;0
14724;178743;449;0;0;0;0;.00nan;0;0
14724;174241;421;46;19;3;16;.842;3600000;0
14724;74680;421;0;0;0;0;.00nan;0;0
14724;141530;449;100;39;0;39;1.000;3600000;0
14725;177106;412;0;0;0;0;.00nan;0;0
14725;-1;413;0;0;0;0;.00nan;0;0
14725;-1;413;68;46;5;41;.891;3600000;0
14725;-1;412;73;19;1;18;.947;3600000;0
14726;177106;412;86;36;2;34;.944;3600000;0
14726;178890;417;0;0;0;0;.00nan;0;0
14726;-1;412;0;0;0;0;.00nan;0;0
14726;85050;417;52;27;4;23;.852;3600000;0
14727;163228;429;83;28;1;27;.964;3600000;0
14727;-1;429;0;0;0;0;.00nan;0;0
14727;181100;442;68;26;2;24;.923;3548000;0
14727;-1;442;0;0;0;0;.00nan;0;0
14728;170499;427;0;0;0;0;.00nan;0;0
14728;174386;428;66;14;1;13;.929;3600000;0
14728;86531;428;0;0;0;0;.00nan;0;0
14728;149863;427;95;41;2;39;.951;3544000;0
14729;171930;422;0;0;0;0;.00nan;0;0
14729;166767;422;56;21;2;19;.905;3600000;0
14729;178743;449;0;0;0;0;.00nan;0;0
14729;141530;449;67;56;7;49;.875;3600000;0
14730;178841;419;63;24;2;22;.917;3600000;0
14730;176808;418;0;0;0;0;.00nan;0;0
14730;-1;419;0;0;0;0;.00nan;0;0
14730;180965;418;73;34;3;31;.912;3598000;0
14731;-1;433;97;32;1;31;.969;3600000;0
14731;182006;436;60;22;3;19;.864;3600000;0
14731;-1;433;0;0;0;0;.00nan;0;0
14731;141294;436;0;0;0;0;.00nan;0;0
14732;183783;415;51;33;4;29;.879;3600000;0
14732;175989;410;0;0;0;0;.00nan;0;0
14732;78864;410;50;33;5;28;.848;3594000;0
14732;94557;415;0;0;0;0;.00nan;0;0
14733;163228;429;0;0;0;0;.00nan;0;0
14733;-1;429;89;40;1;39;.975;4200000;0
14733;86579;434;73;15;1;14;.933;4200000;0
14733;152650;434;0;0;0;0;.00nan;0;0
14734;163177;425;0;0;0;0;.00nan;0;0
14734;165751;435;83;43;3;40;.930;3560000;0
14734;-1;425;69;16;1;15;.938;3600000;0
14734;91448;435;0;0;0;0;.00nan;0;0
14735;-1;443;56;22;3;19;.864;3600000;0
14735;170928;443;0;0;0;0;.00nan;0;0
14735;171517;431;0;0;0;0;.00nan;0;0
14735;182225;431;22;19;5;14;.737;3561000;0
14736;168360;444;61;31;4;27;.871;3600000;0
14736;168855;444;0;0;0;0;.00nan;0;0
14736;174241;421;67;15;1;14;.933;3600000;0
14736;74680;421;0;0;0;0;.00nan;0;0
14737;170886;440;0;0;0;0;.00nan;0;0
14737;179478;432;0;0;0;0;.00nan;0;0
14737;176077;440;78;31;2;29;.935;3568000;0
14737;182093;432;100;37;1;36;.973;3600000;0
14738;177155;411;64;27;2;25;.926;3600000;0
14738;168206;414;14;21;6;15;.714;1813000;0
14738;181346;414;77;24;1;23;.958;1787000;0
14738;141459;411;0;0;0;0;.00nan;0;0
14739;178890;417;0;0;0;0;.00nan;0;0
14739;-1;413;0;0;0;0;.00nan;0;0
14739;-1;413;52;39;5;34;.872;3600000;0
14739;85050;417;67;26;2;24;.923;3600000;0
14740;173519;441;0;0;0;0;.00nan;0;0
14740;-1;441;75;49;4;45;.918;3600000;0
14740;174420;439;0;0;0;0;.00nan;0;0
14740;182210;439;56;12;1;11;.917;3600000;0
14741;173954;438;0;0;0;0;.00nan;0;0
14741;78492;438;69;18;1;17;.944;3600000;0
14741;85987;426;0;0;0;0;.00nan;0;0
14741;86226;426;58;35;4;31;.886;3600000;0
14742;173575;437;0;0;0;0;.00nan;0;0
14742;170878;430;63;31;3;28;.903;4200000;0
14742;-1;430;0;0;0;0;.00nan;0;0
14742;139865;437;75;35;3;32;.914;4200000;0
14743;170499;427;71;20;1;19;.950;3600000;0
14743;182006;436;0;0;0;0;.00nan;0;0
14743;141294;436;85;33;2;31;.939;3566000;0
14743;149863;427;0;0;0;0;.00nan;0;0
14744;173519;441;79;43;3;40;.930;3562000;0
14744;-1;441;0;0;0;0;.00nan;0;0
14744;181100;442;0;0;0;0;.00nan;0;0
14744;-1;442;67;21;2;19;.905;3600000;0
14745;171930;422;95;21;0;21;1.000;3600000;0
14745;166767;422;0;0;0;0;.00nan;0;0
14745;178743;449;0;0;0;0;.00nan;0;0
14745;141530;449;69;30;2;28;.933;3559000;0
14746;178841;419;0;0;0;0;.00nan;0;0
14746;176808;418;78;32;2;30;.938;3600000;0
14746;-1;419;61;32;3;29;.906;3570000;0
14746;180965;418;0;0;0;0;.00nan;0;0
14747;-1;433;0;0;0;0;.00nan;0;0
14747;174386;428;0;0;0;0;.00nan;0;0
14747;-1;433;68;26;2;24;.923;3600000;0
14747;86531;428;47;27;4;23;.852;3536000;0
14748;168206;414;56;29;4;25;.862;3522000;0
14748;183783;415;0;0;0;0;.00nan;0;0
14748;181346;414;0;0;0;0;.00nan;0;0
14748;94557;415;87;30;2;28;.933;3600000;0
14749;174420;439;27;20;4;16;.800;4200000;0
14749;182210;439;0;0;0;0;.00nan;0;0
14749;86579;434;79;43;4;39;.907;4200000;0
14749;152650;434;0;0;0;0;.00nan;0;0
14750;163177;425;96;35;2;33;.943;3538000;0
14750;171517;431;100;37;0;37;1.000;3600000;0
14750;-1;425;0;0;0;0;.00nan;0;0
14750;182225;431;0;0;0;0;.00nan;0;0
14751;165751;435;0;0;0;0;.00nan;0;0
14751;-1;443;0;0;0;0;.00nan;0;0
14751;170928;443;87;29;1;28;.966;3600000;0
14751;91448;435;45;31;4;27;.871;3600000;0
14752;168360;444;0;0;0;0;.00nan;0;0
14752;168855;444;95;49;3;46;.939;4200000;0
14752;174241;421;72;35;3;32;.914;4200000;0
14752;74680;421;0;0;0;0;.00nan;0;0
14753;170886;440;40;16;3;13;.813;3547000;0
14753;179478;432;79;23;1;22;.957;3600000;0
14753;176077;440;0;0;0;0;.00nan;0;0
14753;182093;432;0;0;0;0;.00nan;0;0
14754;177155;411;0;0;0;0;.00nan;0;0
14754;175989;410;90;35;1;34;.971;3600000;0
14754;78864;410;0;0;0;0;.00nan;0;0
14754;141459;411;62;25;2;23;.920;3561000;0
14755;177106;412;64;9;0;9;1.000;1378000;0
14755;-1;413;87;38;2;36;.947;3600000;0
14755;-1;413;0;0;0;0;.00nan;0;0
14755;-1;412;44;18;4;14;.778;2183000;0
14756;170878;430;0;0;0;0;.00nan;0;0
14756;-1;430;58;29;3;26;.897;3600000;0
14756;85987;426;100;28;0;28;1.000;3600000;0
14756;86226;426;0;0;0;0;.00nan;0;0
14757;173575;437;22;11;4;7;.636;833000;0
14757;173954;438;64;28;2;26;.929;3600000;0
14757;78492;438;0;0;0;0;.00nan;0;0
14757;139865;437;93;29;0;29;1.000;2743000;0
14758;183783;415;48;19;3;16;.842;3600000;0
14758;-1;413;48;33;5;28;.848;3600000;0
14758;-1;413;0;0;0;0;.00nan;0;0
14758;94557;415;0;0;0;0;.00nan;0;0
14759;-1;443;90;50;3;47;.940;3600000;0
14759;170928;443;0;0;0;0;.00nan;0;0
14759;86579;434;54;11;1;10;.909;3600000;0
14759;152650;434;0;0;0;0;.00nan;0;0
14760;165751;435;65;35;4;31;.886;3600000;0
14760;170499;427;0;0;0;0;.00nan;0;0
14760;91448;435;0;0;0;0;.00nan;0;0
14760;149863;427;64;27;2;25;.926;3600000;0
14761;163228;429;57;34;4;30;.882;3554000;0
14761;-1;429;0;0;0;0;.00nan;0;0
14761;174420;439;0;0;0;0;.00nan;0;0
14761;182210;439;53;25;3;22;.880;3600000;0
14762;171517;431;74;29;2;27;.931;3600000;0
14762;181100;442;70;32;3;29;.906;3589000;0
14762;182225;431;0;0;0;0;.00nan;0;0
14762;-1;442;0;0;0;0;.00nan;0;0
14763;178841;419;59;26;3;23;.885;3600000;0
14763;174241;421;49;29;5;24;.828;3600000;0
14763;-1;419;0;0;0;0;.00nan;0;0
14763;74680;421;0;0;0;0;.00nan;0;0
14764;177106;412;0;0;0;0;.00nan;0;0
14764;168206;414;52;33;4;29;.879;3600000;0
14764;181346;414;0;0;0;0;.00nan;0;0
14764;-1;412;37;22;5;17;.773;3600000;0
14765;168360;444;75;23;1;22;.957;3600000;0
14765;168855;444;0;0;0;0;.00nan;0;0
14765;179071;420;0;0;0;0;.00nan;0;0
14765;74980;420;87;35;2;33;.943;3600000;0
14766;173575;437;0;0;0;0;.00nan;0;0
14766;182006;436;57;30;3;27;.900;3600000;0
14766;139865;437;82;34;2;32;.941;3600000;0
14766;141294;436;0;0;0;0;.00nan;0;0
14767;174386;428;76;32;3;29;.906;3600000;0
14767;86531;428;0;0;0;0;.00nan;0;0
14767;86579;434;40;34;5;29;.853;3559000;0
14767;152650;434;0;0;0;0;.00nan;0;0
14768;170886;440;0;0;0;0;.00nan;0;0
14768;176077;440;52;10;1;9;.900;3600000;0
14768;85987;426;0;0;0;0;.00nan;0;0
14768;86226;426;98;44;2;42;.955;3547000;0
14769;178841;419;59;18;2;16;.889;2594000;0
14769;174241;421;72;25;2;23;.920;3600000;0
14769;-1;419;23;11;4;7;.636;1006000;0
14769;74680;421;0;0;0;0;.00nan;0;0
14770;178743;449;0;0;0;0;.00nan;0;0
14770;176808;418;0;0;0;0;.00nan;0;0
14770;180965;418;56;23;3;20;.870;3598000;0
14770;141530;449;88;37;2;35;.946;3600000;0
14771;173954;438;84;30;1;29;.967;4200000;0
14771;170878;430;83;30;1;29;.967;4200000;0
14771;-1;430;0;0;0;0;.00nan;0;0
14771;78492;438;0;0;0;0;.00nan;0;0
14772;163177;425;0;0;0;0;.00nan;0;0
14772;173519;441;0;0;0;0;.00nan;0;0
14772;-1;441;98;46;1;45;.978;3600000;0
14772;-1;425;88;16;0;16;1.000;3600000;0
14773;174164;4849;96;27;0;27;1.000;3600000;0
14773;179143;423;57;25;2;23;.920;3564000;0
14773;179691;4849;0;0;0;0;.00nan;0;0
14773;85649;423;0;0;0;0;.00nan;0;0
14774;-1;443;78;45;4;41;.911;3557000;0
14774;-1;433;62;20;2;18;.900;3600000;0
14774;170928;443;0;0;0;0;.00nan;0;0
14774;-1;433;0;0;0;0;.00nan;0;0
14775;178890;417;0;0;0;0;.00nan;0;0
14775;175989;410;0;0;0;0;.00nan;0;0
14775;78864;410;1;30;9;21;.700;3600000;0
14775;85050;417;75;23;1;22;.957;3600000;0
14776;179478;432;0;0;0;0;.00nan;0;0
14776;181100;442;0;0;0;0;.00nan;0;0
14776;182093;432;63;25;2;23;.920;3600000;0
14776;-1;442;43;30;5;25;.833;3600000;0
14777;177155;411;61;42;5;37;.881;3600000;0
14777;183783;415;62;16;1;15;.938;3600000;0
14777;94557;415;0;0;0;0;.00nan;0;0
14777;141459;411;0;0;0;0;.00nan;0;0
14778;168206;414;0;0;0;0;.00nan;0;0
14778;178890;417;48;29;4;25;.862;4200000;0
14778;181346;414;95;53;4;49;.925;4200000;0
14778;85050;417;0;0;0;0;.00nan;0;0
14779;168360;444;0;0;0;0;.00nan;0;0
14779;168855;444;77;27;2;25;.926;3600000;0
14779;179071;420;57;29;3;26;.897;3585000;0
14779;74980;420;0;0;0;0;.00nan;0;0
14780;182006;436;0;0;0;0;.00nan;0;0
14780;86579;434;87;16;0;16;1.000;3600000;0
14780;141294;436;51;33;5;28;.848;3600000;0
14780;152650;434;0;0;0;0;.00nan;0;0
14781;173954;438;0;0;0;0;.00nan;0;0
14781;170878;430;0;0;0;0;.00nan;0;0
14781;-1;430;92;27;1;26;.963;3800000;0
14781;78492;438;79;29;2;27;.931;3800000;0
14782;173575;437;28;14;4;10;.714;1080000;0
14782;174386;428;0;0;0;0;.00nan;0;0
14782;86531;428;89;12;0;12;1.000;3600000;0
14782;139865;437;52;24;3;21;.875;2520000;0
14783;170886;440;51;15;2;13;.867;3600000;0
14783;176077;440;0;0;0;0;.00nan;0;0
14783;85987;426;89;49;3;46;.939;3600000;0
14783;86226;426;0;0;0;0;.00nan;0;0
14784;178743;449;88;33;1;32;.970;4200000;0
14784;176808;418;82;28;1;27;.964;4200000;0
14784;180965;418;0;0;0;0;.00nan;0;0
14784;141530;449;0;0;0;0;.00nan;0;0
14785;163177;425;0;0;0;0;.00nan;0;0
14785;-1;433;0;0;0;0;.00nan;0;0
14785;-1;425;59;14;1;13;.929;3600000;0
14785;-1;433;42;34;5;29;.853;3600000;0
14786;174164;4849;80;39;3;36;.923;3600000;0
14786;179143;423;0;0;0;0;.00nan;0;0
14786;179691;4849;0;0;0;0;.00nan;0;0
14786;85649;423;92;31;1;30;.968;3600000;0
14787;-1;443;0;0;0;0;.00nan;0;0
14787;173519;441;0;0;0;0;.00nan;0;0
14787;170928;443;72;27;2;25;.926;3600000;0
14787;-1;441;44;17;3;14;.824;3551000;0
14788;177106;412;70;29;2;27;.931;3600000;0
14788;175989;410;58;31;4;27;.871;3560000;0
14788;-1;412;0;0;0;0;.00nan;0;0
14788;78864;410;0;0;0;0;.00nan;0;0
14789;163228;429;75;32;3;29;.906;3600000;0
14789;-1;429;0;0;0;0;.00nan;0;0
14789;171517;431;0;0;0;0;.00nan;0;0
14789;182225;431;61;36;4;32;.889;3576000;0
14790;177155;411;0;0;0;0;.00nan;0;0
14790;-1;413;0;0;0;0;.00nan;0;0
14790;-1;413;74;39;4;35;.897;3590000;0
14790;141459;411;61;21;2;19;.905;3600000;0
14791;174420;439;0;0;0;0;.00nan;0;0
14791;179478;432;78;33;2;31;.939;3550000;0
14791;182093;432;0;0;0;0;.00nan;0;0
14791;182210;439;68;17;1;16;.941;3600000;0
14792;165751;435;0;0;0;0;.00nan;0;0
14792;170499;427;79;30;3;27;.900;3600000;0
14792;91448;435;96;20;0;20;1.000;3600000;0
14792;149863;427;0;0;0;0;.00nan;0;0
14793;-1;413;57;35;4;31;.886;3599000;0
14793;175989;410;0;0;0;0;.00nan;0;0
14793;-1;413;0;0;0;0;.00nan;0;0
14793;78864;410;64;24;3;21;.875;3600000;0
14794;165751;435;0;0;0;0;.00nan;0;0
14794;-1;433;100;20;0;20;1.000;3600000;0
14794;-1;433;0;0;0;0;.00nan;0;0
14794;91448;435;63;47;5;42;.894;3600000;0
14795;174386;428;84;25;1;24;.960;3600000;0
14795;181100;442;49;14;2;12;.857;3551000;0
14795;-1;442;0;0;0;0;.00nan;0;0
14795;86531;428;0;0;0;0;.00nan;0;0
14796;173519;441;0;0;0;0;.00nan;0;0
14796;170886;440;0;0;0;0;.00nan;0;0
14796;-1;441;94;49;1;48;.980;3662000;0
14796;176077;440;84;12;0;12;1.000;3662000;0
14797;163228;429;88;31;2;29;.935;3616000;0
14797;-1;429;0;0;0;0;.00nan;0;0
14797;179478;432;0;0;0;0;.00nan;0;0
14797;182093;432;47;23;3;20;.870;3616000;0
14798;168206;414;69;21;1;20;.952;3600000;0
14798;-1;413;0;0;0;0;.00nan;0;0
14798;181346;414;0;0;0;0;.00nan;0;0
14798;-1;413;80;34;2;32;.941;3600000;0
14799;-1;443;93;41;2;39;.951;4200000;0
14799;173954;438;62;21;2;19;.905;4200000;0
14799;170928;443;0;0;0;0;.00nan;0;0
14799;78492;438;0;0;0;0;.00nan;0;0
14800;177155;411;100;33;0;33;1.000;3600000;0
14800;178890;417;0;0;0;0;.00nan;0;0
14800;85050;417;48;21;3;18;.857;3600000;0
14800;141459;411;0;0;0;0;.00nan;0;0
14801;171517;431;0;0;0;0;.00nan;0;0
14801;174386;428;0;0;0;0;.00nan;0;0
14801;182225;431;47;31;4;27;.871;3600000;0
14801;86531;428;81;33;1;32;.970;3600000;0
14802;179071;420;66;33;3;30;.909;3571000;0
14802;176808;418;0;0;0;0;.00nan;0;0
14802;180965;418;68;25;2;23;.920;3600000;0
14802;74980;420;0;0;0;0;.00nan;0;0
14803;173519;441;0;0;0;0;.00nan;0;0
14803;170886;440;0;0;0;0;.00nan;0;0
14803;-1;441;44;34;5;29;.853;3600000;0
14803;176077;440;70;19;1;18;.947;3600000;0
14804;163177;425;0;0;0;0;.00nan;0;0
14804;170878;430;51;28;4;24;.857;3600000;0
14804;-1;425;93;30;1;29;.967;3600000;0
14804;-1;430;0;0;0;0;.00nan;0;0
14805;178841;419;65;18;2;16;.889;3600000;0
14805;179143;423;76;40;3;37;.925;3600000;0
14805;-1;419;0;0;0;0;.00nan;0;0
14805;85649;423;0;0;0;0;.00nan;0;0
14806;168360;444;0;0;0;0;.00nan;0;0
14806;168855;444;63;16;1;15;.938;3600000;0
14806;174164;4849;87;37;2;35;.946;3547000;0
14806;179691;4849;0;0;0;0;.00nan;0;0
14807;177106;412;0;0;0;0;.00nan;0;0
14807;183783;415;100;43;0;43;1.000;3600000;0
14807;-1;412;53;26;3;23;.885;3600000;0
14807;94557;415;0;0;0;0;.00nan;0;0
14808;171930;422;35;26;5;21;.808;3546000;0
14808;166767;422;0;0;0;0;.00nan;0;0
14808;174241;421;40;22;4;18;.818;3600000;0
14808;74680;421;0;0;0;0;.00nan;0;0
14809;174420;439;0;0;0;0;.00nan;0;0
14809;182006;436;56;26;4;22;.846;3600000;0
14809;182210;439;65;26;2;24;.923;3600000;0
14809;141294;436;0;0;0;0;.00nan;0;0
14810;170499;427;0;0;0;0;.00nan;0;0
14810;85987;426;0;0;0;0;.00nan;0;0
14810;86226;426;80;24;1;23;.958;3600000;0
14810;149863;427;49;19;2;17;.895;3544000;0
14811;173575;437;0;0;0;0;.00nan;0;0
14811;86579;434;54;11;1;10;.909;3600000;0
14811;139865;437;97;44;2;42;.955;3569000;0
14811;152650;434;0;0;0;0;.00nan;0;0
14812;179071;420;0;0;0;0;.00nan;0;0
14812;176808;418;100;38;1;37;.974;4200000;0
14812;180965;418;0;0;0;0;.00nan;0;0
14812;74980;420;88;32;1;31;.969;4200000;0
14813;163177;425;56;19;2;17;.895;3600000;0
14813;173954;438;0;0;0;0;.00nan;0;0
14813;-1;425;0;0;0;0;.00nan;0;0
14813;78492;438;64;36;4;32;.889;3541000;0
14814;183783;415;69;28;2;26;.929;3600000;0
14814;178890;417;48;35;5;30;.857;3600000;0
14814;85050;417;0;0;0;0;.00nan;0;0
14814;94557;415;0;0;0;0;.00nan;0;0
14815;163228;429;68;31;2;29;.935;3586000;0
14815;-1;429;0;0;0;0;.00nan;0;0
14815;-1;433;77;11;0;11;1.000;3600000;0
14815;-1;433;0;0;0;0;.00nan;0;0
14816;-1;443;0;0;0;0;.00nan;0;0
14816;170878;430;0;0;0;0;.00nan;0;0
14816;170928;443;73;29;2;27;.931;3589000;0
14816;-1;430;80;24;1;23;.958;3600000;0
14817;178841;419;0;0;0;0;.00nan;0;0
14817;179143;423;0;0;0;0;.00nan;0;0
14817;-1;419;98;36;1;35;.972;3600000;0
14817;85649;423;76;34;2;32;.941;3573000;0
14818;168206;414;0;0;0;0;.00nan;0;0
14818;175989;410;0;0;0;0;.00nan;0;0
14818;181346;414;41;32;5;27;.844;3600000;0
14818;78864;410;88;28;1;27;.964;3600000;0
14819;168360;444;92;34;1;33;.971;3600000;0
14819;168855;444;0;0;0;0;.00nan;0;0
14819;174164;4849;30;15;4;11;.733;1770000;0
14819;179691;4849;54;12;1;11;.917;1830000;0
14820;177106;412;99;48;2;46;.958;3600000;0
14820;177155;411;58;23;3;20;.870;3544000;0
14820;-1;412;0;0;0;0;.00nan;0;0
14820;141459;411;0;0;0;0;.00nan;0;0
14821;171517;431;0;0;0;0;.00nan;0;0
14821;174420;439;49;21;3;18;.857;3600000;0
14821;182210;439;0;0;0;0;.00nan;0;0
14821;182225;431;43;31;5;26;.839;3572000;0
14822;171930;422;0;0;0;0;.00nan;0;0
14822;166767;422;55;32;4;28;.875;3600000;0
14822;174241;421;48;19;3;16;.842;1228000;0
14822;74680;421;15;26;7;19;.731;2372000;0
14823;165751;435;71;36;3;33;.917;3573000;0
14823;179478;432;0;0;0;0;.00nan;0;0
14823;182093;432;62;24;2;22;.917;3600000;0
14823;91448;435;0;0;0;0;.00nan;0;0
14824;85987;426;87;34;1;33;.971;3551000;0
14824;86226;426;0;0;0;0;.00nan;0;0
14824;86579;434;80;13;0;13;1.000;3600000;0
14824;152650;434;0;0;0;0;.00nan;0;0
14825;173575;437;64;30;3;27;.900;3600000;0
14825;170499;427;18;27;6;21;.778;2850000;0
14825;139865;437;0;0;0;0;.00nan;0;0
14825;149863;427;55;3;0;3;1.000;750000;0
14826;181100;442;75;30;3;27;.900;3600000;0
14826;182006;436;0;0;0;0;.00nan;0;0
14826;-1;442;0;0;0;0;.00nan;0;0
14826;141294;436;59;13;1;12;.923;3600000;0
14827;177106;412;0;0;0;0;.00nan;0;0
14827;178890;417;0;0;0;0;.00nan;0;0
14827;-1;412;92;37;2;35;.946;3600000;0
14827;85050;417;51;23;3;20;.870;3600000;0
14828;163177;425;0;0;0;0;.00nan;0;0
14828;-1;443;93;52;4;48;.923;3600000;0
14828;170928;443;0;0;0;0;.00nan;0;0
14828;-1;425;80;21;1;20;.952;3600000;0
14829;163228;429;71;43;4;39;.907;3600000;0
14829;-1;429;0;0;0;0;.00nan;0;0
14829;86579;434;68;17;1;16;.941;3600000;0
14829;152650;434;0;0;0;0;.00nan;0;0
14830;174386;428;53;20;3;17;.850;3600000;0
14830;179478;432;100;34;0;34;1.000;3600000;0
14830;182093;432;0;0;0;0;.00nan;0;0
14830;86531;428;0;0;0;0;.00nan;0;0
14831;170878;430;83;26;1;25;.962;3600000;0
14831;171517;431;0;0;0;0;.00nan;0;0
14831;182225;431;72;37;3;34;.919;3544000;0
14831;-1;430;0;0;0;0;.00nan;0;0
14832;179071;420;0;0;0;0;.00nan;0;0
14832;179143;423;75;35;3;32;.914;3600000;0
14832;74980;420;98;25;0;25;1.000;3600000;0
14832;85649;423;0;0;0;0;.00nan;0;0
14833;174386;428;0;0;0;0;.00nan;0;0
14833;182006;436;71;27;2;25;.926;3600000;0
14833;86531;428;78;34;3;31;.912;3600000;0
14833;141294;436;0;0;0;0;.00nan;0;0
14834;178841;419;92;20;0;20;1.000;3600000;0
14834;174164;4849;95;34;1;33;.971;3589000;0
14834;179691;4849;0;0;0;0;.00nan;0;0
14834;-1;419;0;0;0;0;.00nan;0;0
14835;-1;433;100;22;0;22;1.000;3600000;0
14835;181100;442;0;0;0;0;.00nan;0;0
14835;-1;442;98;56;2;54;.964;3520000;0
14835;-1;433;0;0;0;0;.00nan;0;0
14836;171930;422;0;0;0;0;.00nan;0;0
14836;166767;422;99;20;0;20;1.000;3600000;0
14836;176808;418;0;0;0;0;.00nan;0;0
14836;180965;418;97;47;1;46;.979;3576000;0
14837;183783;415;77;38;3;35;.921;3600000;0
14837;175989;410;0;0;0;0;.00nan;0;0
14837;78864;410;30;23;5;18;.783;3519000;0
14837;94557;415;0;0;0;0;.00nan;0;0
14838;173519;441;0;0;0;0;.00nan;0;0
14838;170878;430;0;0;0;0;.00nan;0;0
14838;-1;441;66;29;2;27;.931;3592000;0
14838;-1;430;77;19;1;18;.947;3600000;0
14839;163177;425;0;0;0;0;.00nan;0;0
14839;-1;443;80;45;4;41;.911;3535000;0
14839;170928;443;0;0;0;0;.00nan;0;0
14839;-1;425;45;17;3;14;.824;3600000;0
14840;177106;412;0;0;0;0;.00nan;0;0
14840;-1;413;66;38;4;34;.895;3592000;0
14840;-1;413;0;0;0;0;.00nan;0;0
14840;-1;412;58;26;3;23;.885;3600000;0
14841;173954;438;88;35;2;33;.943;3600000;0
14841;171517;431;0;0;0;0;.00nan;0;0
14841;182225;431;78;28;1;27;.964;3600000;0
14841;78492;438;0;0;0;0;.00nan;0;0
14842;168360;444;0;0;0;0;.00nan;0;0
14842;168855;444;89;19;0;19;1.000;3600000;0
14842;178743;449;0;0;0;0;.00nan;0;0
14842;141530;449;48;19;3;16;.842;3600000;0
14843;177155;411;52;18;2;16;.889;3600000;0
14843;168206;414;53;34;5;29;.853;3600000;0
14843;181346;414;0;0;0;0;.00nan;0;0
14843;141459;411;0;0;0;0;.00nan;0;0
14844;165751;435;88;43;3;40;.930;3587000;0
14844;174420;439;0;0;0;0;.00nan;0;0
14844;182210;439;71;25;2;23;.920;3600000;0
14844;91448;435;0;0;0;0;.00nan;0;0
14845;173575;437;0;0;0;0;.00nan;0;0
14845;85987;426;0;0;0;0;.00nan;0;0
14845;86226;426;88;19;0;19;1.000;3600000;0
14845;139865;437;80;21;1;20;.952;3555000;0
14846;163228;429;46;37;6;31;.838;3600000;0
14846;-1;429;0;0;0;0;.00nan;0;0
14846;170886;440;82;17;0;17;1.000;3600000;0
14846;176077;440;0;0;0;0;.00nan;0;0
14847;179071;420;0;0;0;0;.00nan;0;0
14847;179143;423;0;0;0;0;.00nan;0;0
14847;74980;420;84;27;1;26;.963;3600000;0
14847;85649;423;32;29;6;23;.793;3600000;0
14848;178841;419;67;22;1;21;.955;4200000;0
14848;174164;4849;0;0;0;0;.00nan;0;0
14848;179691;4849;99;43;1;42;.977;4200000;0
14848;-1;419;0;0;0;0;.00nan;0;0
14849;170499;427;0;0;0;0;.00nan;0;0
14849;170886;440;74;20;1;19;.950;3600000;0
14849;176077;440;0;0;0;0;.00nan;0;0
14849;149863;427;58;33;4;29;.879;3600000;0
14850;178890;417;0;0;0;0;.00nan;0;0
14850;-1;413;0;0;0;0;.00nan;0;0
14850;-1;413;65;39;5;34;.872;3558000;0
14850;85050;417;56;24;3;21;.875;3600000;0
14851;165751;435;0;0;0;0;.00nan;0;0
14851;181100;442;52;27;5;22;.815;3600000;0
14851;-1;442;0;0;0;0;.00nan;0;0
14851;91448;435;75;22;1;21;.955;3600000;0
14852;168206;414;0;0;0;0;.00nan;0;0
14852;183783;415;0;0;0;0;.00nan;0;0
14852;181346;414;87;41;2;39;.951;3600000;0
14852;94557;415;96;39;1;38;.974;3600000;0
14853;171930;422;0;0;0;0;.00nan;0;0
14853;166767;422;30;17;4;13;.765;3600000;0
14853;176808;418;57;42;6;36;.857;3591000;0
14853;180965;418;0;0;0;0;.00nan;0;0
14854;173519;441;89;36;2;34;.944;3554000;0
14854;173954;438;0;0;0;0;.00nan;0;0
14854;-1;441;0;0;0;0;.00nan;0;0
14854;78492;438;81;20;1;19;.950;3600000;0
14855;179478;432;41;22;4;18;.818;3565000;0
14855;182006;436;0;0;0;0;.00nan;0;0
14855;182093;432;0;0;0;0;.00nan;0;0
14855;141294;436;82;40;3;37;.925;3600000;0
14856;168360;444;55;25;3;22;.880;3569000;0
14856;168855;444;0;0;0;0;.00nan;0;0
14856;178743;449;85;27;1;26;.963;3600000;0
14856;141530;449;0;0;0;0;.00nan;0;0
14857;177155;411;0;0;0;0;.00nan;0;0
14857;175989;410;0;0;0;0;.00nan;0;0
14857;78864;410;70;43;5;38;.884;3600000;0
14857;141459;411;67;20;2;18;.900;3600000;0
14858;-1;433;73;39;4;35;.897;3600000;0
14858;174420;439;37;29;5;24;.828;3545000;0
14858;182210;439;0;0;0;0;.00nan;0;0
14858;-1;433;0;0;0;0;.00nan;0;0
14859;173575;437;60;25;2;23;.920;3600000;0
14859;85987;426;0;0;0;0;.00nan;0;0
14859;86226;426;100;28;0;28;1.000;3600000;0
14859;139865;437;0;0;0;0;.00nan;0;0
14860;-1;443;44;21;3;18;.857;3596000;0
14860;170928;443;0;0;0;0;.00nan;0;0
14860;86579;434;55;14;2;12;.857;3600000;0
14860;152650;434;0;0;0;0;.00nan;0;0
14861;183783;415;80;28;1;27;.964;3600000;0
14861;-1;413;70;28;2;26;.929;3570000;0
14861;-1;413;0;0;0;0;.00nan;0;0
14861;94557;415;0;0;0;0;.00nan;0;0
14862;168206;414;57;30;3;27;.900;3585000;0
14862;178890;417;0;0;0;0;.00nan;0;0
14862;181346;414;0;0;0;0;.00nan;0;0
14862;85050;417;76;24;1;23;.958;3600000;0
14863;171517;431;0;0;0;0;.00nan;0;0
14863;179478;432;74;22;1;21;.955;3600000;0
14863;182093;432;0;0;0;0;.00nan;0;0
14863;182225;431;86;40;2;38;.950;3576000;0
14864;-1;433;0;0;0;0;.00nan;0;0
14864;170499;427;0;0;0;0;.00nan;0;0
14864;-1;433;63;19;2;17;.895;3527000;0
14864;149863;427;100;34;0;34;1.000;3600000;0
14865;171517;431;0;0;0;0;.00nan;0;0
14865;182006;436;70;27;2;25;.926;3600000;0
14865;182225;431;43;32;5;27;.844;3600000;0
14865;141294;436;0;0;0;0;.00nan;0;0
14866;178743;449;0;0;0;0;.00nan;0;0
14866;174164;4849;34;24;5;19;.792;3581000;0
14866;179691;4849;0;0;0;0;.00nan;0;0
14866;141530;449;44;26;4;22;.846;3600000;0
14867;178890;417;72;35;3;32;.914;3600000;0
14867;175989;410;0;0;0;0;.00nan;0;0
14867;78864;410;74;26;2;24;.923;3600000;0
14867;85050;417;0;0;0;0;.00nan;0;0
14868;165751;435;35;33;6;27;.818;2172000;0
14868;170886;440;0;0;0;0;.00nan;0;0
14868;176077;440;68;20;1;19;.950;3600000;0
14868;91448;435;46;17;2;15;.882;1428000;0
14869;173519;441;0;0;0;0;.00nan;0;0
14869;-1;441;67;25;3;22;.880;3550000;0
14869;181100;442;0;0;0;0;.00nan;0;0
14869;-1;442;74;19;1;18;.947;3600000;0
14870;178841;419;50;18;2;16;.889;3600000;0
14870;179071;420;0;0;0;0;.00nan;0;0
14870;-1;419;0;0;0;0;.00nan;0;0
14870;74980;420;89;26;1;25;.962;3600000;0
14871;174241;421;62;29;3;26;.897;3549000;0
14871;176808;418;0;0;0;0;.00nan;0;0
14871;180965;418;81;32;2;30;.938;3600000;0
14871;74680;421;0;0;0;0;.00nan;0;0
14872;173954;438;64;52;6;46;.885;3600000;0
14872;78492;438;0;0;0;0;.00nan;0;0
14872;86579;434;67;21;1;20;.952;3600000;0
14872;152650;434;0;0;0;0;.00nan;0;0
14873;163177;425;0;0;0;0;.00nan;0;0
14873;173575;437;0;0;0;0;.00nan;0;0
14873;-1;425;51;15;2;13;.867;3600000;0
14873;139865;437;63;34;4;30;.882;3537000;0
14874;171930;422;91;19;0;19;1.000;3600000;0
14874;166767;422;0;0;0;0;.00nan;0;0
14874;179143;423;30;17;4;13;.765;1902000;0
14874;85649;423;46;21;3;18;.857;1698000;0
14875;-1;443;79;38;3;35;.921;3600000;0
14875;170928;443;0;0;0;0;.00nan;0;0
14875;85987;426;0;0;0;0;.00nan;0;0
14875;86226;426;74;8;0;8;1.000;3600000;0
14876;177106;412;0;0;0;0;.00nan;0;0
14876;168206;414;76;34;3;31;.912;3141000;0
14876;181346;414;27;7;3;4;.571;459000;0
14876;-1;412;84;33;2;31;.939;3600000;0
14877;177155;411;77;23;1;22;.957;3600000;0
14877;-1;413;0;0;0;0;.00nan;0;0
14877;-1;413;59;38;5;33;.868;3600000;0
14877;141459;411;0;0;0;0;.00nan;0;0
14878;174386;428;92;39;2;37;.949;3600000;0
14878;174420;439;0;0;0;0;.00nan;0;0
14878;182210;439;61;26;3;23;.885;3573000;0
14878;86531;428;0;0;0;0;.00nan;0;0
14879;163228;429;0;0;0;0;.00nan;0;0
14879;-1;429;71;25;2;23;.920;3600000;0
14879;170878;430;66;28;3;25;.893;3579000;0
14879;-1;430;0;0;0;0;.00nan;0;0
14880;178743;449;66;23;2;21;.913;3600000;0
14880;174164;4849;0;0;0;0;.00nan;0;0
14880;179691;4849;65;32;3;29;.906;3600000;0
14880;141530;449;0;0;0;0;.00nan;0;0
14881;-1;433;67;43;6;37;.860;3600000;0
14881;170886;440;80;28;1;27;.964;3600000;0
14881;176077;440;0;0;0;0;.00nan;0;0
14881;-1;433;0;0;0;0;.00nan;0;0
14882;181100;442;72;25;1;24;.960;3600000;0
14882;182006;436;0;0;0;0;.00nan;0;0
14882;-1;442;0;0;0;0;.00nan;0;0
14882;141294;436;67;26;2;24;.923;3576000;0
14883;178841;419;0;0;0;0;.00nan;0;0
14883;179071;420;81;35;3;32;.914;3600000;0
14883;-1;419;59;30;4;26;.867;3579000;0
14883;74980;420;0;0;0;0;.00nan;0;0
14884;177155;411;0;0;0;0;.00nan;0;0
14884;183783;415;84;29;2;27;.931;3600000;0
14884;94557;415;0;0;0;0;.00nan;0;0
14884;141459;411;63;26;3;23;.885;3548000;0
14885;174241;421;21;25;6;19;.760;2904000;0
14885;176808;418;29;24;5;19;.792;2192000;0
14885;180965;418;61;13;1;12;.923;1694000;0
14885;74680;421;48;6;1;5;.833;982000;0
14886;170499;427;0;0;0;0;.00nan;0;0
14886;86579;434;21;22;6;16;.727;3217000;0
14886;149863;427;88;37;2;35;.946;3600000;0
14886;152650;434;48;0;0;0;.00nan;383000;0
14887;163177;425;84;27;1;26;.963;3600000;0
14887;-1;425;0;0;0;0;.00nan;0;0
14887;85987;426;0;0;0;0;.00nan;0;0
14887;86226;426;48;28;4;24;.857;3600000;0
14888;171930;422;47;15;2;13;.867;3600000;0
14888;166767;422;0;0;0;0;.00nan;0;0
14888;179143;423;59;34;4;30;.882;3515000;0
14888;85649;423;0;0;0;0;.00nan;0;0
14889;-1;443;0;0;0;0;.00nan;0;0
14889;173575;437;41;25;4;21;.840;3544000;0
14889;170928;443;73;38;3;35;.921;3600000;0
14889;139865;437;0;0;0;0;.00nan;0;0
14890;177106;412;77;36;2;34;.944;3600000;0
14890;175989;410;46;39;6;33;.846;3600000;0
14890;-1;412;0;0;0;0;.00nan;0;0
14890;78864;410;0;0;0;0;.00nan;0;0
14891;174386;428;97;35;1;34;.971;3600000;0
14891;179478;432;0;0;0;0;.00nan;0;0
14891;182093;432;53;18;2;16;.889;3551000;0
14891;86531;428;0;0;0;0;.00nan;0;0
14892;173519;441;73;56;4;52;.929;3600000;0
14892;-1;441;0;0;0;0;.00nan;0;0
14892;174420;439;73;11;0;11;1.000;3600000;0
14892;182210;439;0;0;0;0;.00nan;0;0
14893;163228;429;77;27;1;26;.963;3600000;0
14893;-1;429;0;0;0;0;.00nan;0;0
14893;173954;438;0;0;0;0;.00nan;0;0
14893;78492;438;62;22;2;20;.909;3600000;0
14894;173519;441;0;0;0;0;.00nan;0;0
14894;-1;441;88;33;2;31;.939;3528000;0
14894;174386;428;93;20;0;20;1.000;3600000;0
14894;86531;428;0;0;0;0;.00nan;0;0
14895;-1;413;74;30;2;28;.933;3600000;0
14895;175989;410;0;0;0;0;.00nan;0;0
14895;-1;413;0;0;0;0;.00nan;0;0
14895;78864;410;76;43;4;39;.907;3589000;0
14896;177106;412;0;0;0;0;.00nan;0;0
14896;183783;415;85;37;2;35;.946;3590000;0
14896;-1;412;91;27;1;26;.963;3600000;0
14896;94557;415;0;0;0;0;.00nan;0;0
14897;181100;442;90;41;2;39;.951;3600000;0
14897;-1;442;0;0;0;0;.00nan;0;0
14897;86579;434;67;18;1;17;.944;3600000;0
14897;152650;434;0;0;0;0;.00nan;0;0
14898;168206;414;92;35;1;34;.971;3692000;0
14898;175989;410;0;0;0;0;.00nan;0;0
14898;181346;414;0;0;0;0;.00nan;0;0
14898;78864;410;80;31;2;29;.935;3692000;0
14899;171930;422;0;0;0;0;.00nan;0;0
14899;166767;422;71;21;1;20;.952;3600000;0
14899;179071;420;0;0;0;0;.00nan;0;0
14899;74980;420;80;55;6;49;.891;3600000;0
14900;173954;438;100;31;0;31;1.000;3600000;0
14900;174386;428;81;24;1;23;.958;3578000;0
14900;78492;438;0;0;0;0;.00nan;0;0
14900;86531;428;0;0;0;0;.00nan;0;0
14901;170499;427;40;22;4;18;.818;3600000;0
14901;181100;442;0;0;0;0;.00nan;0;0
14901;-1;442;58;41;6;35;.854;3600000;0
14901;149863;427;0;0;0;0;.00nan;0;0
14902;183783;415;56;37;5;32;.865;3600000;0
14902;178890;417;0;0;0;0;.00nan;0;0
14902;85050;417;68;25;2;23;.920;3600000;0
14902;94557;415;0;0;0;0;.00nan;0;0
14903;163177;425;0;0;0;0;.00nan;0;0
14903;-1;433;0;0;0;0;.00nan;0;0
14903;-1;425;93;22;0;22;1.000;3600000;0
14903;-1;433;79;41;5;36;.878;3600000;0
14904;170878;430;0;0;0;0;.00nan;0;0
14904;182006;436;68;29;2;27;.931;3600000;0
14904;-1;430;55;28;3;25;.893;3600000;0
14904;141294;436;0;0;0;0;.00nan;0;0
14905;168360;444;0;0;0;0;.00nan;0;0
14905;168855;444;58;28;3;25;.893;3538000;0
14905;176808;418;0;0;0;0;.00nan;0;0
14905;180965;418;72;24;1;23;.958;3600000;0
14906;177106;412;0;0;0;0;.00nan;0;0
14906;177155;411;51;25;4;21;.840;3600000;0
14906;-1;412;52;28;5;23;.821;3600000;0
14906;141459;411;0;0;0;0;.00nan;0;0
14907;174420;439;73;19;1;18;.947;3600000;0
14907;179478;432;0;0;0;0;.00nan;0;0
14907;182093;432;74;33;3;30;.909;3562000;0
14907;182210;439;0;0;0;0;.00nan;0;0
14908;170886;440;0;0;0;0;.00nan;0;0
14908;171517;431;0;0;0;0;.00nan;0;0
14908;176077;440;51;14;2;12;.857;3600000;0
14908;182225;431;88;56;4;52;.929;3600000;0
14909;174164;4849;49;27;4;23;.852;3538000;0
14909;174241;421;69;18;2;16;.889;3600000;0
14909;179691;4849;0;0;0;0;.00nan;0;0
14909;74680;421;0;0;0;0;.00nan;0;0
14910;178743;449;0;0;0;0;.00nan;0;0
14910;179143;423;75;37;3;34;.919;3548000;0
14910;85649;423;0;0;0;0;.00nan;0;0
14910;141530;449;75;33;2;31;.939;3600000;0
14911;165751;435;100;35;0;35;1.000;3600000;0
14911;-1;443;13;19;6;13;.684;2870000;0
14911;170928;443;38;7;2;5;.714;730000;0
14911;91448;435;0;0;0;0;.00nan;0;0
14912;173575;437;0;0;0;0;.00nan;0;0
14912;85987;426;44;26;4;22;.846;3758000;0
14912;86226;426;0;0;0;0;.00nan;0;0
14912;139865;437;77;45;5;40;.889;3758000;0
14913;173954;438;75;23;1;22;.957;3600000;0
14913;182006;436;0;0;0;0;.00nan;0;0
14913;78492;438;0;0;0;0;.00nan;0;0
14913;141294;436;69;25;2;23;.920;3585000;0
14914;170499;427;0;0;0;0;.00nan;0;0
14914;174420;439;0;0;0;0;.00nan;0;0
14914;182210;439;57;28;3;25;.893;3569000;0
14914;149863;427;96;33;1;32;.970;3600000;0
14915;177155;411;53;25;3;22;.880;3562000;0
14915;178890;417;88;35;2;33;.943;3600000;0
14915;85050;417;0;0;0;0;.00nan;0;0
14915;141459;411;0;0;0;0;.00nan;0;0
14916;171930;422;80;11;0;11;1.000;3600000;0
14916;166767;422;0;0;0;0;.00nan;0;0
14916;179071;420;88;39;2;37;.949;3554000;0
14916;74980;420;0;0;0;0;.00nan;0;0
14917;-1;443;0;0;0;0;.00nan;0;0
14917;-1;433;67;18;1;17;.944;3600000;0
14917;170928;443;86;43;3;40;.930;3526000;0
14917;-1;433;0;0;0;0;.00nan;0;0
14918;173519;441;0;0;0;0;.00nan;0;0
14918;-1;441;71;41;4;37;.902;3600000;0
14918;86579;434;0;0;0;0;.00nan;0;0
14918;152650;434;82;14;0;14;1.000;3600000;0
14919;170878;430;48;27;5;22;.815;3600000;0
14919;174386;428;77;30;2;28;.933;3600000;0
14919;-1;430;0;0;0;0;.00nan;0;0
14919;86531;428;0;0;0;0;.00nan;0;0
14920;168360;444;100;39;0;39;1.000;3600000;0
14920;168855;444;0;0;0;0;.00nan;0;0
14920;176808;418;51;33;4;29;.879;3600000;0
14920;180965;418;0;0;0;0;.00nan;0;0
14921;170886;440;19;13;5;8;.615;3600000;0
14921;171517;431;65;23;2;21;.913;3600000;0
14921;176077;440;0;0;0;0;.00nan;0;0
14921;182225;431;0;0;0;0;.00nan;0;0
14922;174164;4849;0;0;0;0;.00nan;0;0
14922;174241;421;0;0;0;0;.00nan;0;0
14922;179691;4849;100;52;1;51;.981;3600000;0
14922;74680;421;37;15;3;12;.800;3514000;0
14923;178743;449;93;30;1;29;.967;3600000;0
14923;179143;423;0;0;0;0;.00nan;0;0
14923;85649;423;42;18;3;15;.833;3553000;0
14923;141530;449;0;0;0;0;.00nan;0;0
14924;168206;414;0;0;0;0;.00nan;0;0
14924;-1;413;0;0;0;0;.00nan;0;0
14924;181346;414;89;35;2;33;.943;3600000;0
14924;-1;413;57;29;4;25;.862;3555000;0
14925;163177;425;0;0;0;0;.00nan;0;0
14925;165751;435;58;34;4;30;.882;3600000;0
14925;-1;425;56;21;3;18;.857;3600000;0
14925;91448;435;0;0;0;0;.00nan;0;0
14926;163228;429;91;28;1;27;.964;3600000;0
14926;-1;429;0;0;0;0;.00nan;0;0
14926;85987;426;0;0;0;0;.00nan;0;0
14926;86226;426;46;39;5;34;.872;3600000;0
14927;163228;429;0;0;0;0;.00nan;0;0
14927;-1;429;64;24;2;22;.917;3600000;0
14927;173575;437;0;0;0;0;.00nan;0;0
14927;139865;437;57;36;4;32;.889;3568000;0
14928;-1;433;91;22;0;22;1.000;3600000;0
14928;170878;430;0;0;0;0;.00nan;0;0
14928;-1;430;74;36;3;33;.917;3600000;0
14928;-1;433;0;0;0;0;.00nan;0;0
14929;168206;414;60;42;4;38;.905;3600000;0
14929;175989;410;0;0;0;0;.00nan;0;0
14929;181346;414;0;0;0;0;.00nan;0;0
14929;78864;410;64;17;1;16;.941;3600000;0
14930;173954;438;55;25;3;22;.880;3600000;0
14930;170878;430;72;44;4;40;.909;3562000;0
14930;-1;430;0;0;0;0;.00nan;0;0
14930;78492;438;0;0;0;0;.00nan;0;0
14931;171517;431;0;0;0;0;.00nan;0;0
14931;182006;436;59;20;2;18;.900;3600000;0
14931;182225;431;60;31;3;28;.903;3571000;0
14931;141294;436;0;0;0;0;.00nan;0;0
14932;179071;420;0;0;0;0;.00nan;0;0
14932;174241;421;53;23;3;20;.870;3600000;0
14932;74680;421;0;0;0;0;.00nan;0;0
14932;74980;420;100;30;0;30;1.000;3600000;0
14933;171930;422;41;21;4;17;.810;3600000;0
14933;166767;422;0;0;0;0;.00nan;0;0
14933;174164;4849;28;29;6;23;.793;3600000;0
14933;179691;4849;0;0;0;0;.00nan;0;0
14934;163228;429;70;30;3;27;.900;3654000;0
14934;-1;429;0;0;0;0;.00nan;0;0
14934;174386;428;67;40;4;36;.900;3654000;0
14934;86531;428;0;0;0;0;.00nan;0;0
14935;163177;425;0;0;0;0;.00nan;0;0
14935;170886;440;0;0;0;0;.00nan;0;0
14935;176077;440;47;27;4;23;.852;3564000;0
14935;-1;425;67;30;3;27;.900;3600000;0
14936;178743;449;0;0;0;0;.00nan;0;0
14936;178841;419;79;32;2;30;.938;4116000;0
14936;-1;419;0;0;0;0;.00nan;0;0
14936;141530;449;94;42;3;39;.929;4116000;0
14937;-1;433;91;39;1;38;.974;4200000;0
14937;-1;433;0;0;0;0;.00nan;0;0
14937;85987;426;0;0;0;0;.00nan;0;0
14937;86226;426;97;47;1;46;.979;4200000;0
14938;183783;415;100;24;0;24;1.000;3600000;0
14938;178890;417;0;0;0;0;.00nan;0;0
14938;85050;417;56;30;4;26;.867;3600000;0
14938;94557;415;0;0;0;0;.00nan;0;0
14939;173519;441;0;0;0;0;.00nan;0;0
14939;-1;441;52;37;5;32;.865;3600000;0
14939;179478;432;42;21;4;17;.810;3600000;0
14939;182093;432;0;0;0;0;.00nan;0;0
14940;170499;427;45;23;4;19;.826;3600000;0
14940;171517;431;72;21;1;20;.952;3600000;0
14940;182225;431;0;0;0;0;.00nan;0;0
14940;149863;427;0;0;0;0;.00nan;0;0
14941;177106;412;0;0;0;0;.00nan;0;0
14941;177155;411;100;33;1;32;.970;3600000;0
14941;-1;412;63;26;2;24;.923;3584000;0
14941;141459;411;0;0;0;0;.00nan;0;0
14942;-1;413;0;0;0;0;.00nan;0;0
14942;175989;410;0;0;0;0;.00nan;0;0
14942;-1;413;74;29;2;27;.931;3600000;0
14942;78864;410;48;25;5;20;.800;3600000;0
14943;165751;435;8;42;9;33;.786;3600000;0
14943;173575;437;0;0;0;0;.00nan;0;0
14943;91448;435;0;0;0;0;.00nan;0;0
14943;139865;437;100;24;0;24;1.000;3600000;0
14944;174420;439;0;0;0;0;.00nan;0;0
14944;181100;442;58;9;0;9;1.000;501000;0
14944;182210;439;56;10;1;9;.900;3600000;0
14944;-1;442;54;49;7;42;.857;3099000;0
14945;179071;420;0;0;0;0;.00nan;0;0
14945;174241;421;86;30;2;28;.933;3600000;0
14945;74680;421;0;0;0;0;.00nan;0;0
14945;74980;420;72;34;3;31;.912;3600000;0
14946;174386;428;79;36;3;33;.917;3600000;0
14946;182006;436;47;27;5;22;.815;3535000;0
14946;86531;428;0;0;0;0;.00nan;0;0
14946;141294;436;0;0;0;0;.00nan;0;0
14947;173954;438;78;36;3;33;.917;3600000;0
14947;78492;438;0;0;0;0;.00nan;0;0
14947;86579;434;0;0;0;0;.00nan;0;0
14947;152650;434;47;32;5;27;.844;3528000;0
14948;-1;443;52;38;5;33;.868;3600000;0
14948;170886;440;77;18;1;17;.944;3600000;0
14948;170928;443;0;0;0;0;.00nan;0;0
14948;176077;440;0;0;0;0;.00nan;0;0
14949;171930;422;0;0;0;0;.00nan;0;0
14949;166767;422;69;18;1;17;.944;3600000;0
14949;174164;4849;0;0;0;0;.00nan;0;0
14949;179691;4849;77;49;4;45;.918;3600000;0
14950;178743;449;97;44;2;42;.955;3548000;0
14950;178841;419;77;23;1;22;.957;3600000;0
14950;-1;419;0;0;0;0;.00nan;0;0
14950;141530;449;0;0;0;0;.00nan;0;0
14951;-1;433;0;0;0;0;.00nan;0;0
14951;173575;437;0;0;0;0;.00nan;0;0
14951;-1;433;91;37;1;36;.973;3600000;0
14951;139865;437;73;32;3;29;.906;3600000;0
14952;177106;412;72;21;1;20;.952;3600000;0
14952;183783;415;36;35;6;29;.829;3600000;0
14952;-1;412;0;0;0;0;.00nan;0;0
14952;94557;415;0;0;0;0;.00nan;0;0
14953;173519;441;56;39;5;34;.872;3528000;0
14953;-1;441;0;0;0;0;.00nan;0;0
14953;179478;432;0;0;0;0;.00nan;0;0
14953;182093;432;56;25;3;22;.880;3600000;0
14954;168360;444;56;20;2;18;.900;3600000;0
14954;168855;444;0;0;0;0;.00nan;0;0
14954;179143;423;73;38;3;35;.921;3543000;0
14954;85649;423;0;0;0;0;.00nan;0;0
14955;177155;411;0;0;0;0;.00nan;0;0
14955;178890;417;70;36;4;32;.889;3669000;0
14955;85050;417;0;0;0;0;.00nan;0;0
14955;141459;411;72;34;3;31;.912;3669000;0
14956;168206;414;88;16;0;16;1.000;3600000;0
14956;-1;413;59;45;6;39;.867;3600000;0
14956;181346;414;0;0;0;0;.00nan;0;0
14956;-1;413;0;0;0;0;.00nan;0;0
14957;165751;435;0;0;0;0;.00nan;0;0
14957;85987;426;76;31;2;29;.935;3600000;0
14957;86226;426;0;0;0;0;.00nan;0;0
14957;91448;435;52;42;5;37;.881;3580000;0
14958;163228;429;0;0;0;0;.00nan;0;0
14958;-1;429;79;15;0;15;1.000;3600000;0
14958;170499;427;0;0;0;0;.00nan;0;0
14958;149863;427;64;30;3;27;.900;3600000;0
14959;170878;430;0;0;0;0;.00nan;0;0
14959;-1;430;61;39;4;35;.897;3600000;0
14959;86579;434;75;19;1;18;.947;3600000;0
14959;152650;434;0;0;0;0;.00nan;0;0
14960;168360;444;0;0;0;0;.00nan;0;0
14960;168855;444;78;22;1;21;.955;3600000;0
14960;179143;423;0;0;0;0;.00nan;0;0
14960;85649;423;55;28;3;25;.893;3588000;0
14961;177106;412;0;0;0;0;.00nan;0;0
14961;178890;417;91;34;1;33;.971;3600000;0
14961;-1;412;61;28;3;25;.893;3581000;0
14961;85050;417;0;0;0;0;.00nan;0;0
14962;163228;429;0;0;0;0;.00nan;0;0
14962;-1;429;75;24;1;23;.958;3600000;0
14962;182006;436;48;26;4;22;.846;3600000;0
14962;141294;436;0;0;0;0;.00nan;0;0
14963;163228;429;72;39;3;36;.923;3573000;0
14963;-1;429;0;0;0;0;.00nan;0;0
14963;86579;434;56;13;1;12;.923;3600000;0
14963;152650;434;0;0;0;0;.00nan;0;0
14964;170499;427;71;20;1;19;.950;3600000;0
14964;170878;430;67;26;2;24;.923;3573000;0
14964;-1;430;0;0;0;0;.00nan;0;0
14964;149863;427;0;0;0;0;.00nan;0;0
14965;168206;414;83;26;1;25;.962;3600000;0
14965;183783;415;60;24;3;21;.875;3545000;0
14965;181346;414;0;0;0;0;.00nan;0;0
14965;94557;415;0;0;0;0;.00nan;0;0
14966;179071;420;0;0;0;0;.00nan;0;0
14966;174164;4849;71;36;3;33;.917;3845000;0
14966;179691;4849;0;0;0;0;.00nan;0;0
14966;74980;420;75;38;4;34;.895;3845000;0
14967;178890;417;55;39;5;34;.872;3600000;0
14967;-1;413;0;0;0;0;.00nan;0;0
14967;-1;413;38;41;6;35;.854;3600000;0
14967;85050;417;0;0;0;0;.00nan;0;0
14968;165751;435;40;40;6;34;.850;3600000;0
14968;174386;428;78;27;1;26;.963;3600000;0
14968;86531;428;0;0;0;0;.00nan;0;0
14968;91448;435;0;0;0;0;.00nan;0;0
14969;170886;440;0;0;0;0;.00nan;0;0
14969;176077;440;67;21;1;20;.952;3600000;0
14969;181100;442;64;21;3;18;.857;1077000;0
14969;-1;442;30;32;6;26;.813;2523000;0
14970;178841;419;57;39;5;34;.872;3600000;0
14970;176808;418;0;0;0;0;.00nan;0;0
14970;-1;419;0;0;0;0;.00nan;0;0
14970;180965;418;73;23;1;22;.957;3600000;0
14971;177155;411;66;18;1;17;.944;3600000;0
14971;175989;410;0;0;0;0;.00nan;0;0
14971;78864;410;41;29;5;24;.828;3600000;0
14971;141459;411;0;0;0;0;.00nan;0;0
14972;-1;433;97;25;0;25;1.000;3600000;0
14972;179478;432;69;34;3;31;.912;3600000;0
14972;182093;432;0;0;0;0;.00nan;0;0
14972;-1;433;0;0;0;0;.00nan;0;0
14973;168360;444;0;0;0;0;.00nan;0;0
14973;168855;444;42;27;4;23;.852;3599000;0
14973;174241;421;78;37;3;34;.919;3600000;0
14973;74680;421;0;0;0;0;.00nan;0;0
14974;171930;422;0;0;0;0;.00nan;0;0
14974;166767;422;40;27;5;22;.815;3600000;0
14974;178743;449;55;26;3;23;.885;2800000;0
14974;141530;449;29;13;4;9;.692;800000;0
14975;173519;441;0;0;0;0;.00nan;0;0
14975;-1;441;71;24;2;22;.917;3758000;0
14975;85987;426;0;0;0;0;.00nan;0;0
14975;86226;426;59;15;1;14;.933;3758000;0
14976;173575;437;0;0;0;0;.00nan;0;0
14976;171517;431;0;0;0;0;.00nan;0;0
14976;182225;431;33;21;4;17;.810;3563000;0
14976;139865;437;100;52;2;50;.962;3600000;0
14977;177155;411;0;0;0;0;.00nan;0;0
14977;168206;414;0;0;0;0;.00nan;0;0
14977;181346;414;80;41;3;38;.927;3600000;0
14977;141459;411;42;19;4;15;.789;3550000;0
14978;179071;420;77;30;2;28;.933;4200000;0
14978;174164;4849;0;0;0;0;.00nan;0;0
14978;179691;4849;56;23;2;21;.913;4200000;0
14978;74980;420;0;0;0;0;.00nan;0;0
14979;165751;435;0;0;0;0;.00nan;0;0
14979;182006;436;72;22;1;21;.955;3600000;0
14979;91448;435;59;35;5;30;.857;3600000;0
14979;141294;436;0;0;0;0;.00nan;0;0
14980;170499;427;57;25;3;22;.880;3600000;0
14980;173954;438;44;29;5;24;.828;3575000;0
14980;78492;438;0;0;0;0;.00nan;0;0
14980;149863;427;0;0;0;0;.00nan;0;0
14981;174386;428;0;0;0;0;.00nan;0;0
14981;174420;439;0;0;0;0;.00nan;0;0
14981;182210;439;81;28;1;27;.964;4104000;0
14981;86531;428;74;28;2;26;.929;4104000;0
14982;170886;440;0;0;0;0;.00nan;0;0
14982;176077;440;44;18;3;15;.833;3530000;0
14982;181100;442;100;43;1;42;.977;3600000;0
14982;-1;442;0;0;0;0;.00nan;0;0
14983;178841;419;57;25;3;22;.880;3600000;0
14983;176808;418;31;27;5;22;.815;3541000;0
14983;-1;419;0;0;0;0;.00nan;0;0
14983;180965;418;0;0;0;0;.00nan;0;0
14984;170878;430;62;38;4;34;.895;3524000;0
14984;-1;430;0;0;0;0;.00nan;0;0
14984;86579;434;56;21;2;19;.905;3600000;0
14984;152650;434;0;0;0;0;.00nan;0;0
14985;163177;425;0;0;0;0;.00nan;0;0
14985;-1;443;68;46;4;42;.913;3600000;0
14985;170928;443;0;0;0;0;.00nan;0;0
14985;-1;425;56;18;2;16;.889;3600000;0
14986;183783;415;96;40;2;38;.950;3600000;0
14986;175989;410;84;26;1;25;.962;3600000;0
14986;78864;410;0;0;0;0;.00nan;0;0
14986;94557;415;0;0;0;0;.00nan;0;0
14987;177106;412;0;0;0;0;.00nan;0;0
14987;-1;413;85;46;4;42;.913;3600000;0
14987;-1;413;0;0;0;0;.00nan;0;0
14987;-1;412;11;11;5;6;.545;3571000;0
14988;-1;433;63;30;3;27;.900;3600000;0
14988;171517;431;45;27;4;23;.852;3570000;0
14988;182225;431;0;0;0;0;.00nan;0;0
14988;-1;433;0;0;0;0;.00nan;0;0
14989;168360;444;100;51;4;47;.922;3819000;0
14989;168855;444;0;0;0;0;.00nan;0;0
14989;174241;421;49;35;5;30;.857;3819000;0
14989;74680;421;0;0;0;0;.00nan;0;0
14990;171930;422;42;15;3;12;.800;3600000;0
14990;166767;422;0;0;0;0;.00nan;0;0
14990;178743;449;0;0;0;0;.00nan;0;0
14990;141530;449;59;37;5;32;.865;3598000;0
14991;173519;441;72;33;3;30;.909;3600000;0
14991;-1;441;0;0;0;0;.00nan;0;0
14991;85987;426;27;18;5;13;.722;3566000;0
14991;86226;426;0;0;0;0;.00nan;0;0
14992;173575;437;0;0;0;0;.00nan;0;0
14992;179478;432;0;0;0;0;.00nan;0;0
14992;182093;432;75;24;2;22;.917;3600000;0
14992;139865;437;77;45;4;41;.911;3588000;0
14993;183783;415;85;19;0;19;1.000;3600000;0
14993;-1;413;0;0;0;0;.00nan;0;0
14993;-1;413;50;22;3;19;.864;3600000;0
14993;94557;415;0;0;0;0;.00nan;0;0
14994;182006;436;79;36;3;33;.917;4200000;0
14994;85987;426;0;0;0;0;.00nan;0;0
14994;86226;426;49;28;3;25;.893;4200000;0
14994;141294;436;0;0;0;0;.00nan;0;0
14995;-1;443;87;44;3;41;.932;4200000;0
14995;170499;427;0;0;0;0;.00nan;0;0
14995;170928;443;0;0;0;0;.00nan;0;0
14995;149863;427;61;23;2;21;.913;4200000;0
14996;170886;440;82;26;1;25;.962;3600000;0
14996;174386;428;70;30;2;28;.933;3545000;0
14996;176077;440;0;0;0;0;.00nan;0;0
14996;86531;428;0;0;0;0;.00nan;0;0
14997;171517;431;0;0;0;0;.00nan;0;0
14997;181100;442;58;30;4;26;.867;3582000;0
14997;182225;431;65;20;2;18;.900;3600000;0
14997;-1;442;0;0;0;0;.00nan;0;0
14998;178743;449;51;2;0;2;1.000;259000;0
14998;174241;421;79;20;1;19;.950;3600000;0
14998;74680;421;0;0;0;0;.00nan;0;0
14998;141530;449;7;36;9;27;.750;3341000;0
14999;163228;429;0;0;0;0;.00nan;0;0
14999;-1;429;69;17;1;16;.941;3600000;0
14999;173954;438;71;35;4;31;.886;3600000;0
14999;78492;438;0;0;0;0;.00nan;0;0
15000;168206;414;34;33;6;27;.818;3600000;0
15000;178890;417;58;27;3;24;.889;3600000;0
15000;181346;414;0;0;0;0;.00nan;0;0
15000;85050;417;0;0;0;0;.00nan;0;0
15001;170886;440;0;0;0;0;.00nan;0;0
15001;174386;428;50;41;6;35;.854;3600000;0
15001;176077;440;58;13;1;12;.923;3600000;0
15001;86531;428;0;0;0;0;.00nan;0;0
15002;171930;422;0;0;0;0;.00nan;0;0
15002;166767;422;72;36;3;33;.917;3600000;0
15002;168360;444;55;32;4;28;.875;3552000;0
15002;168855;444;0;0;0;0;.00nan;0;0
15003;178841;419;68;22;1;21;.955;3600000;0
15003;174164;4849;48;37;5;32;.865;3600000;0
15003;179691;4849;0;0;0;0;.00nan;0;0
15003;-1;419;0;0;0;0;.00nan;0;0
15004;-1;433;75;42;4;38;.905;3577000;0
15004;170878;430;0;0;0;0;.00nan;0;0
15004;-1;430;82;32;2;30;.938;3600000;0
15004;-1;433;0;0;0;0;.00nan;0;0
15005;163177;425;0;0;0;0;.00nan;0;0
15005;179478;432;71;24;1;23;.958;3600000;0
15005;-1;425;48;32;5;27;.844;3600000;0
15005;182093;432;0;0;0;0;.00nan;0;0
15006;179143;423;79;22;1;21;.955;3600000;0
15006;176808;418;0;0;0;0;.00nan;0;0
15006;180965;418;66;31;3;28;.903;3567000;0
15006;85649;423;0;0;0;0;.00nan;0;0
15007;177106;412;59;28;3;25;.893;3600000;0
15007;175989;410;0;0;0;0;.00nan;0;0
15007;-1;412;0;0;0;0;.00nan;0;0
15007;78864;410;42;40;6;34;.850;3600000;0
15008;178743;449;100;42;0;42;1.000;3600000;0
15008;174241;421;28;23;5;18;.783;3600000;0
15008;74680;421;0;0;0;0;.00nan;0;0
15008;141530;449;0;0;0;0;.00nan;0;0
15009;177155;411;48;16;3;13;.813;3702000;0
15009;183783;415;79;29;2;27;.931;3702000;0
15009;94557;415;0;0;0;0;.00nan;0;0
15009;141459;411;0;0;0;0;.00nan;0;0
15010;165751;435;69;32;3;29;.906;3744000;0
15010;173519;441;0;0;0;0;.00nan;0;0
15010;-1;441;59;34;4;30;.882;3744000;0
15010;91448;435;0;0;0;0;.00nan;0;0
15011;173575;437;0;0;0;0;.00nan;0;0
15011;174420;439;0;0;0;0;.00nan;0;0
15011;182210;439;79;32;2;30;.938;3600000;0
15011;139865;437;45;24;4;20;.833;3600000;0
15012;177106;412;0;0;0;0;.00nan;0;0
15012;168206;414;0;0;0;0;.00nan;0;0
15012;181346;414;83;35;3;32;.914;3701000;0
15012;-1;412;78;31;2;29;.935;3701000;0
15013;174420;439;0;0;0;0;.00nan;0;0
15013;182006;436;0;0;0;0;.00nan;0;0
15013;182210;439;78;30;2;28;.933;4175000;0
15013;141294;436;84;46;3;43;.935;4175000;0
15014;163177;425;0;0;0;0;.00nan;0;0
15014;170499;427;67;37;4;33;.892;3983000;0
15014;-1;425;51;21;3;18;.857;3983000;0
15014;149863;427;0;0;0;0;.00nan;0;0
15015;173575;437;46;25;4;21;.840;3573000;0
15015;181100;442;0;0;0;0;.00nan;0;0
15015;-1;442;88;40;3;37;.925;3600000;0
15015;139865;437;0;0;0;0;.00nan;0;0
15016;171930;422;87;22;0;22;1.000;3600000;0
15016;166767;422;0;0;0;0;.00nan;0;0
15016;168360;444;0;0;0;0;.00nan;0;0
15016;168855;444;90;35;1;34;.971;3573000;0
15017;178841;419;0;0;0;0;.00nan;0;0
15017;174164;4849;0;0;0;0;.00nan;0;0
15017;179691;4849;42;28;4;24;.857;3600000;0
15017;-1;419;88;20;0;20;1.000;3600000;0
15018;173519;441;68;38;4;34;.895;3600000;0
15018;-1;433;0;0;0;0;.00nan;0;0
15018;-1;441;0;0;0;0;.00nan;0;0
15018;-1;433;68;26;2;24;.923;3600000;0
15019;171517;431;0;0;0;0;.00nan;0;0
15019;182225;431;64;36;4;32;.889;3600000;0
15019;86579;434;69;17;1;16;.941;3600000;0
15019;152650;434;0;0;0;0;.00nan;0;0
15020;163228;429;69;19;1;18;.947;3600000;0
15020;-1;429;0;0;0;0;.00nan;0;0
15020;170878;430;68;29;2;27;.931;3545000;0
15020;-1;430;0;0;0;0;.00nan;0;0
15021;179143;423;39;1;1;0;.000;281000;0
15021;176808;418;48;14;3;11;.786;3600000;0
15021;180965;418;0;0;0;0;.00nan;0;0
15021;85649;423;57;40;6;34;.850;3319000;0
15022;-1;443;81;23;1;22;.957;3600000;0
15022;170928;443;0;0;0;0;.00nan;0;0
15022;179478;432;0;0;0;0;.00nan;0;0
15022;182093;432;32;31;6;25;.806;3600000;0
15023;178890;417;0;0;0;0;.00nan;0;0
15023;175989;410;71;31;2;29;.935;3547000;0
15023;78864;410;0;0;0;0;.00nan;0;0
15023;85050;417;91;30;1;29;.967;3600000;0
15024;177155;411;59;25;3;22;.880;3986000;0
15024;-1;413;86;42;4;38;.905;3986000;0
15024;-1;413;0;0;0;0;.00nan;0;0
15024;141459;411;0;0;0;0;.00nan;0;0
15025;174420;439;0;0;0;0;.00nan;0;0
15025;181100;442;0;0;0;0;.00nan;0;0
15025;182210;439;50;16;2;14;.875;4200000;0
15025;-1;442;100;50;2;48;.960;4200000;0
15026;177106;412;0;0;0;0;.00nan;0;0
15026;178890;417;90;39;2;37;.949;3600000;0
15026;-1;412;72;25;1;24;.960;3600000;0
15026;85050;417;0;0;0;0;.00nan;0;0
15027;173954;438;70;20;1;19;.950;4020000;0
15027;179478;432;94;32;2;30;.938;4020000;0
15027;182093;432;0;0;0;0;.00nan;0;0
15027;78492;438;0;0;0;0;.00nan;0;0
15028;-1;443;71;19;1;18;.947;3600000;0
15028;170499;427;63;35;3;32;.914;3568000;0
15028;170928;443;0;0;0;0;.00nan;0;0
15028;149863;427;0;0;0;0;.00nan;0;0
15029;171930;422;68;16;1;15;.938;3600000;0
15029;166767;422;0;0;0;0;.00nan;0;0
15029;179143;423;32;24;5;19;.792;2087000;0
15029;85649;423;54;12;1;11;.917;1513000;0
15030;168206;414;66;32;2;30;.938;3562000;0
15030;183783;415;83;28;1;27;.964;3600000;0
15030;181346;414;0;0;0;0;.00nan;0;0
15030;94557;415;0;0;0;0;.00nan;0;0
15031;174164;4849;48;39;6;33;.846;3600000;0
15031;176808;418;0;0;0;0;.00nan;0;0
15031;179691;4849;0;0;0;0;.00nan;0;0
15031;180965;418;67;16;1;15;.938;3600000;0
15032;173519;441;0;0;0;0;.00nan;0;0
15032;171517;431;0;0;0;0;.00nan;0;0
15032;-1;441;59;34;4;30;.882;3600000;0
15032;182225;431;98;24;0;24;1.000;3600000;0
15033;165751;435;55;37;5;32;.865;2502000;0
15033;86579;434;55;11;1;10;.909;3600000;0
15033;91448;435;37;16;4;12;.750;1098000;0
15033;152650;434;0;0;0;0;.00nan;0;0
15034;170878;430;0;0;0;0;.00nan;0;0
15034;170886;440;58;17;2;15;.882;3600000;0
15034;176077;440;0;0;0;0;.00nan;0;0
15034;-1;430;81;41;4;37;.902;3577000;0
15035;163177;425;0;0;0;0;.00nan;0;0
15035;170499;427;0;0;0;0;.00nan;0;0
15035;-1;425;77;22;1;21;.955;3600000;0
15035;149863;427;78;45;4;41;.911;3600000;0
15036;168360;444;41;20;4;16;.800;3512000;0
15036;168855;444;0;0;0;0;.00nan;0;0
15036;179071;420;0;0;0;0;.00nan;0;0
15036;74980;420;80;38;2;36;.947;3600000;0
15037;178841;419;0;0;0;0;.00nan;0;0
15037;174241;421;34;24;5;19;.792;3600000;0
15037;-1;419;100;37;1;36;.973;3600000;0
15037;74680;421;0;0;0;0;.00nan;0;0
15038;177155;411;78;22;1;21;.955;3600000;0
15038;175989;410;0;0;0;0;.00nan;0;0
15038;78864;410;88;42;3;39;.929;3591000;0
15038;141459;411;0;0;0;0;.00nan;0;0
15039;177106;412;0;0;0;0;.00nan;0;0
15039;-1;413;32;5;2;3;.600;710000;0
15039;-1;413;32;26;6;20;.769;2853000;0
15039;-1;412;33;34;6;28;.824;3600000;0
15040;181100;442;33;37;6;31;.838;3600000;0
15040;-1;442;0;0;0;0;.00nan;0;0
15040;85987;426;0;0;0;0;.00nan;0;0
15040;86226;426;71;19;1;18;.947;3600000;0
15041;173575;437;0;0;0;0;.00nan;0;0
15041;174386;428;51;28;4;24;.857;3600000;0
15041;86531;428;0;0;0;0;.00nan;0;0
15041;139865;437;90;36;2;34;.944;3600000;0
15042;163228;429;83;24;1;23;.958;3600000;0
15042;-1;429;0;0;0;0;.00nan;0;0
15042;-1;433;28;26;6;20;.769;2945000;0
15042;-1;433;49;7;1;6;.857;655000;0
15043;174164;4849;0;0;0;0;.00nan;0;0
15043;176808;418;64;21;2;19;.905;3600000;0
15043;179691;4849;52;26;3;23;.885;3600000;0
15043;180965;418;0;0;0;0;.00nan;0;0
15044;173954;438;86;42;3;39;.929;3814000;0
15044;170886;440;0;0;0;0;.00nan;0;0
15044;176077;440;43;24;4;20;.833;3814000;0
15044;78492;438;0;0;0;0;.00nan;0;0
15045;171930;422;0;0;0;0;.00nan;0;0
15045;166767;422;60;15;1;14;.933;3600000;0
15045;179143;423;36;48;7;41;.854;3312000;0
15045;85649;423;50;1;0;1;1.000;288000;0
15046;183783;415;57;20;2;18;.900;3643000;0
15046;175989;410;0;0;0;0;.00nan;0;0
15046;78864;410;68;32;3;29;.906;3643000;0
15046;94557;415;0;0;0;0;.00nan;0;0
15047;173519;441;100;26;0;26;1.000;3600000;0
15047;171517;431;0;0;0;0;.00nan;0;0
15047;-1;441;0;0;0;0;.00nan;0;0
15047;182225;431;41;16;3;13;.813;3600000;0
15048;-1;433;0;0;0;0;.00nan;0;0
15048;-1;433;97;37;1;36;.973;3600000;0
15048;86579;434;52;13;2;11;.846;3583000;0
15048;152650;434;0;0;0;0;.00nan;0;0
15049;168360;444;0;0;0;0;.00nan;0;0
15049;168855;444;44;28;5;23;.821;3600000;0
15049;179071;420;0;0;0;0;.00nan;0;0
15049;74980;420;88;38;2;36;.947;3600000;0
15050;170878;430;49;30;4;26;.867;4175000;0
15050;179478;432;0;0;0;0;.00nan;0;0
15050;182093;432;58;24;3;21;.875;4175000;0
15050;-1;430;0;0;0;0;.00nan;0;0
15051;178841;419;100;36;1;35;.972;3600000;0
15051;174241;421;56;27;3;24;.889;3600000;0
15051;-1;419;0;0;0;0;.00nan;0;0
15051;74680;421;0;0;0;0;.00nan;0;0
15052;177155;411;0;0;0;0;.00nan;0;0
15052;168206;414;0;0;0;0;.00nan;0;0
15052;181346;414;62;33;3;30;.909;3600000;0
15052;141459;411;60;14;1;13;.929;3600000;0
15053;178890;417;0;0;0;0;.00nan;0;0
15053;-1;413;98;35;1;34;.971;3600000;0
15053;-1;413;0;0;0;0;.00nan;0;0
15053;85050;417;34;20;4;16;.800;3600000;0
15054;174420;439;0;0;0;0;.00nan;0;0
15054;182210;439;55;17;2;15;.882;3600000;0
15054;85987;426;65;35;4;31;.886;3600000;0
15054;86226;426;0;0;0;0;.00nan;0;0
15055;173575;437;0;0;0;0;.00nan;0;0
15055;182006;436;43;25;4;21;.840;3600000;0
15055;139865;437;99;33;1;32;.970;3600000;0
15055;141294;436;0;0;0;0;.00nan;0;0
15056;163228;429;0;0;0;0;.00nan;0;0
15056;165751;435;0;0;0;0;.00nan;0;0
15056;-1;429;58;18;2;16;.889;3600000;0
15056;91448;435;30;33;6;27;.818;3600000;0
15057;168206;414;82;26;1;25;.962;3600000;0
15057;175989;410;0;0;0;0;.00nan;0;0
15057;181346;414;0;0;0;0;.00nan;0;0
15057;78864;410;73;23;2;21;.913;3600000;0
15058;-1;433;50;28;4;24;.857;3804000;0
15058;170499;427;64;44;5;39;.886;3804000;0
15058;-1;433;0;0;0;0;.00nan;0;0
15058;149863;427;0;0;0;0;.00nan;0;0
15059;163177;425;0;0;0;0;.00nan;0;0
15059;163228;429;0;0;0;0;.00nan;0;0
15059;-1;429;88;38;1;37;.974;4200000;0
15059;-1;425;70;25;1;24;.960;4200000;0
15060;171517;431;0;0;0;0;.00nan;0;0
15060;182225;431;66;30;3;27;.900;3524000;0
15060;85987;426;0;0;0;0;.00nan;0;0
15060;86226;426;99;43;1;42;.977;3600000;0
15061;179478;432;35;30;5;25;.833;3600000;0
15061;182093;432;0;0;0;0;.00nan;0;0
15061;86579;434;53;20;3;17;.850;3600000;0
15061;152650;434;0;0;0;0;.00nan;0;0
15062;178743;449;77;23;1;22;.957;3600000;0
15062;179071;420;0;0;0;0;.00nan;0;0
15062;74980;420;53;34;5;29;.853;3600000;0
15062;141530;449;0;0;0;0;.00nan;0;0
15063;183783;415;100;36;1;35;.972;3600000;0
15063;178890;417;70;28;2;26;.929;3557000;0
15063;85050;417;0;0;0;0;.00nan;0;0
15063;94557;415;0;0;0;0;.00nan;0;0
15064;173575;437;0;0;0;0;.00nan;0;0
15064;170886;440;87;19;1;18;.947;3600000;0
15064;176077;440;0;0;0;0;.00nan;0;0
15064;139865;437;55;42;6;36;.857;3600000;0
15065;-1;443;53;26;4;22;.846;3565000;0
15065;170928;443;0;0;0;0;.00nan;0;0
15065;181100;442;0;0;0;0;.00nan;0;0
15065;-1;442;91;39;2;37;.949;3600000;0
15066;171930;422;0;0;0;0;.00nan;0;0
15066;166767;422;83;32;2;30;.938;3767000;0
15066;178841;419;72;39;3;36;.923;3767000;0
15066;-1;419;0;0;0;0;.00nan;0;0
15067;168360;444;51;22;3;19;.864;3547000;0
15067;168855;444;0;0;0;0;.00nan;0;0
15067;176808;418;0;0;0;0;.00nan;0;0
15067;180965;418;72;30;2;28;.933;3600000;0
15068;173519;441;75;43;3;40;.930;3512000;0
15068;-1;441;0;0;0;0;.00nan;0;0
15068;182006;436;61;17;1;16;.941;3600000;0
15068;141294;436;0;0;0;0;.00nan;0;0
15069;179143;423;54;27;3;24;.889;3600000;0
15069;174241;421;100;21;0;21;1.000;3600000;0
15069;74680;421;0;0;0;0;.00nan;0;0
15069;85649;423;0;0;0;0;.00nan;0;0
15070;-1;413;0;0;0;0;.00nan;0;0
15070;175989;410;0;0;0;0;.00nan;0;0
15070;-1;413;100;49;1;48;.980;4200000;0
15070;78864;410;65;15;1;14;.933;4200000;0
15071;177106;412;70;27;2;25;.926;3600000;0
15071;177155;411;68;34;4;30;.882;3598000;0
15071;-1;412;0;0;0;0;.00nan;0;0
15071;141459;411;0;0;0;0;.00nan;0;0
15072;171517;431;0;0;0;0;.00nan;0;0
15072;179478;432;0;0;0;0;.00nan;0;0
15072;182093;432;65;27;2;25;.926;3566000;0
15072;182225;431;75;27;1;26;.963;3600000;0
15073;165751;435;83;35;2;33;.943;3716000;0
15073;173954;438;66;18;1;17;.944;3716000;0
15073;78492;438;0;0;0;0;.00nan;0;0
15073;91448;435;0;0;0;0;.00nan;0;0
15074;163177;425;0;0;0;0;.00nan;0;0
15074;174420;439;85;35;2;33;.943;4200000;0
15074;-1;425;80;36;2;34;.944;4200000;0
15074;182210;439;0;0;0;0;.00nan;0;0
15075;174386;428;71;29;2;27;.931;4200000;0
15075;85987;426;0;0;0;0;.00nan;0;0
15075;86226;426;74;24;2;22;.917;4200000;0
15075;86531;428;0;0;0;0;.00nan;0;0
15076;168206;414;100;37;0;37;1.000;3600000;0
15076;-1;413;61;39;4;35;.897;3600000;0
15076;181346;414;0;0;0;0;.00nan;0;0
15076;-1;413;0;0;0;0;.00nan;0;0
15077;178743;449;0;0;0;0;.00nan;0;0
15077;179071;420;56;23;3;20;.870;4200000;0
15077;74980;420;0;0;0;0;.00nan;0;0
15077;141530;449;79;38;3;35;.921;4200000;0
15078;170499;427;79;23;1;22;.957;3600000;0
15078;170878;430;0;0;0;0;.00nan;0;0
15078;-1;430;68;25;2;23;.920;3546000;0
15078;149863;427;0;0;0;0;.00nan;0;0
15079;177155;411;77;28;2;26;.929;3600000;0
15079;178890;417;0;0;0;0;.00nan;0;0
15079;85050;417;88;48;3;45;.938;3556000;0
15079;141459;411;0;0;0;0;.00nan;0;0
15080;173575;437;0;0;0;0;.00nan;0;0
15080;170886;440;0;0;0;0;.00nan;0;0
15080;176077;440;65;16;1;15;.938;3600000;0
15080;139865;437;83;48;4;44;.917;3600000;0
15081;163177;425;0;0;0;0;.00nan;0;0
15081;-1;425;76;27;2;25;.926;4045000;0
15081;181100;442;73;33;3;30;.909;4045000;0
15081;-1;442;0;0;0;0;.00nan;0;0
15082;171930;422;81;25;1;24;.960;3600000;0
15082;166767;422;0;0;0;0;.00nan;0;0
15082;178841;419;0;0;0;0;.00nan;0;0
15082;-1;419;54;31;4;27;.871;3600000;0
15083;-1;433;74;23;2;21;.913;3544000;0
15083;173954;438;0;0;0;0;.00nan;0;0
15083;-1;433;0;0;0;0;.00nan;0;0
15083;78492;438;90;33;1;32;.970;3600000;0
15084;168360;444;0;0;0;0;.00nan;0;0
15084;168855;444;100;25;0;25;1.000;3600000;0
15084;176808;418;0;0;0;0;.00nan;0;0
15084;180965;418;66;21;1;20;.952;3590000;0
15085;173519;441;60;12;1;11;.917;1675000;0
15085;-1;441;31;19;4;15;.789;1925000;0
15085;182006;436;0;0;0;0;.00nan;0;0
15085;141294;436;74;23;1;22;.957;3600000;0
15086;179143;423;0;0;0;0;.00nan;0;0
15086;174241;421;40;21;4;17;.810;3600000;0
15086;74680;421;0;0;0;0;.00nan;0;0
15086;85649;423;54;41;5;36;.878;3600000;0
15087;177106;412;0;0;0;0;.00nan;0;0
15087;183783;415;0;0;0;0;.00nan;0;0
15087;-1;412;98;25;0;25;1.000;3600000;0
15087;94557;415;65;37;4;33;.892;3600000;0
15088;171517;431;77;20;1;19;.950;3585000;0
15088;174386;428;98;22;0;22;1.000;3600000;0
15088;182225;431;0;0;0;0;.00nan;0;0
15088;86531;428;0;0;0;0;.00nan;0;0
15089;-1;443;89;32;2;30;.938;3600000;0
15089;170928;443;0;0;0;0;.00nan;0;0
15089;174420;439;0;0;0;0;.00nan;0;0
15089;182210;439;88;21;1;20;.952;3600000;0
15090;163228;429;0;0;0;0;.00nan;0;0
15090;-1;429;76;27;1;26;.963;3600000;0
15090;86579;434;61;28;4;24;.857;3600000;0
15090;152650;434;0;0;0;0;.00nan;0;0
15091;165751;435;64;40;6;34;.850;3600000;0
15091;170878;430;100;34;0;34;1.000;3600000;0
15091;-1;430;0;0;0;0;.00nan;0;0
15091;91448;435;0;0;0;0;.00nan;0;0
15092;177155;411;58;26;3;23;.885;3629000;0
15092;183783;415;67;36;4;32;.889;3629000;0
15092;94557;415;0;0;0;0;.00nan;0;0
15092;141459;411;0;0;0;0;.00nan;0;0
15093;165751;435;0;0;0;0;.00nan;0;0
15093;170499;427;76;25;1;24;.960;3600000;0
15093;91448;435;56;23;2;21;.913;3552000;0
15093;149863;427;0;0;0;0;.00nan;0;0
15094;174386;428;49;18;3;15;.833;3600000;0
15094;85987;426;0;0;0;0;.00nan;0;0
15094;86226;426;100;23;0;23;1.000;3600000;0
15094;86531;428;0;0;0;0;.00nan;0;0
15095;173954;438;63;33;4;29;.879;3563000;0
15095;170878;430;87;43;3;40;.930;3600000;0
15095;-1;430;0;0;0;0;.00nan;0;0
15095;78492;438;0;0;0;0;.00nan;0;0
15096;163177;425;0;0;0;0;.00nan;0;0
15096;-1;443;0;0;0;0;.00nan;0;0
15096;170928;443;74;46;4;42;.913;3593000;0
15096;-1;425;51;25;3;22;.880;3600000;0
15097;168206;414;36;29;5;24;.828;3565000;0
15097;178890;417;59;27;3;24;.889;3600000;0
15097;181346;414;0;0;0;0;.00nan;0;0
15097;85050;417;0;0;0;0;.00nan;0;0
15098;179478;432;0;0;0;0;.00nan;0;0
15098;182006;436;64;29;2;27;.931;4200000;0
15098;182093;432;76;34;2;32;.941;4200000;0
15098;141294;436;0;0;0;0;.00nan;0;0
15099;174164;4849;87;35;2;33;.943;3845000;0
15099;179143;423;65;30;3;27;.900;3845000;0
15099;179691;4849;0;0;0;0;.00nan;0;0
15099;85649;423;0;0;0;0;.00nan;0;0
15100;173519;441;0;0;0;0;.00nan;0;0
15100;170886;440;83;16;0;16;1.000;3600000;0
15100;-1;441;64;44;6;38;.864;3600000;0
15100;176077;440;0;0;0;0;.00nan;0;0
15101;177106;412;0;0;0;0;.00nan;0;0
15101;175989;410;0;0;0;0;.00nan;0;0
15101;-1;412;38;23;5;18;.783;3600000;0
15101;78864;410;95;31;1;30;.968;3600000;0
15102;168360;444;45;35;5;30;.857;3600000;0
15102;168855;444;0;0;0;0;.00nan;0;0
15102;178841;419;28;26;6;20;.769;3202000;0
15102;-1;419;41;2;1;1;.500;314000;0
15103;179071;420;0;0;0;0;.00nan;0;0
15103;174241;421;66;16;1;15;.938;3600000;0
15103;74680;421;0;0;0;0;.00nan;0;0
15103;74980;420;65;34;4;30;.882;3600000;0
15104;178743;449;78;46;5;41;.891;3600000;0
15104;176808;418;0;0;0;0;.00nan;0;0
15104;180965;418;75;28;2;26;.929;3600000;0
15104;141530;449;0;0;0;0;.00nan;0;0
15105;183783;415;87;16;0;16;1.000;4200000;0
15105;-1;413;0;0;0;0;.00nan;0;0
15105;-1;413;98;25;0;25;1.000;4200000;0
15105;94557;415;0;0;0;0;.00nan;0;0
15106;165751;435;86;34;2;32;.941;3877000;0
15106;171517;431;0;0;0;0;.00nan;0;0
15106;182225;431;81;22;1;21;.955;3877000;0
15106;91448;435;0;0;0;0;.00nan;0;0
15107;174420;439;0;0;0;0;.00nan;0;0
15107;182210;439;52;22;3;19;.864;3600000;0
15107;85987;426;0;0;0;0;.00nan;0;0
15107;86226;426;56;39;5;34;.872;3600000;0
15108;173575;437;78;18;1;17;.944;3600000;0
15108;181100;442;0;0;0;0;.00nan;0;0
15108;-1;442;69;44;4;40;.909;3600000;0
15108;139865;437;0;0;0;0;.00nan;0;0
15109;174164;4849;0;0;0;0;.00nan;0;0
15109;179143;423;0;0;0;0;.00nan;0;0
15109;179691;4849;100;26;0;26;1.000;3600000;0
15109;85649;423;74;42;4;38;.905;3600000;0
15110;-1;433;50;42;5;37;.881;3600000;0
15110;173954;438;79;23;1;22;.957;3600000;0
15110;-1;433;0;0;0;0;.00nan;0;0
15110;78492;438;0;0;0;0;.00nan;0;0
15111;178890;417;0;0;0;0;.00nan;0;0
15111;175989;410;38;27;5;22;.815;3600000;0
15111;78864;410;0;0;0;0;.00nan;0;0
15111;85050;417;71;21;1;20;.952;3600000;0
15112;163177;425;58;26;3;23;.885;3600000;0
15112;-1;425;0;0;0;0;.00nan;0;0
15112;86579;434;54;33;4;29;.879;3557000;0
15112;152650;434;0;0;0;0;.00nan;0;0
15113;163228;429;0;0;0;0;.00nan;0;0
15113;-1;443;99;31;1;30;.968;3600000;0
15113;-1;429;70;33;4;29;.879;3600000;0
15113;170928;443;0;0;0;0;.00nan;0;0
15114;168360;444;0;0;0;0;.00nan;0;0
15114;168855;444;60;34;3;31;.912;3567000;0
15114;178841;419;0;0;0;0;.00nan;0;0
15114;-1;419;88;33;2;31;.939;3600000;0
15115;177106;412;64;25;2;23;.920;3600000;0
15115;168206;414;0;0;0;0;.00nan;0;0
15115;181346;414;94;41;3;38;.927;3576000;0
15115;-1;412;0;0;0;0;.00nan;0;0
15116;179071;420;67;44;5;39;.886;3600000;0
15116;174241;421;94;22;0;22;1.000;3600000;0
15116;74680;421;0;0;0;0;.00nan;0;0
15116;74980;420;0;0;0;0;.00nan;0;0
15117;178743;449;0;0;0;0;.00nan;0;0
15117;176808;418;0;0;0;0;.00nan;0;0
15117;180965;418;71;18;1;17;.944;3600000;0
15117;141530;449;79;30;2;28;.933;3575000;0
15118;177155;411;68;34;3;31;.912;3739000;0
15118;-1;413;0;0;0;0;.00nan;0;0
15118;-1;413;93;50;4;46;.920;3739000;0
15118;141459;411;0;0;0;0;.00nan;0;0
15119;173575;437;49;14;2;12;.857;1547000;0
15119;174420;439;0;0;0;0;.00nan;0;0
15119;182210;439;65;22;2;20;.909;3600000;0
15119;139865;437;33;26;5;21;.808;2053000;0
15121;177106;412;61;28;3;25;.893;3625000;0
15121;183783;415;72;26;2;24;.923;3625000;0
15121;-1;412;0;0;0;0;.00nan;0;0
15121;94557;415;0;0;0;0;.00nan;0;0
15123;178743;449;56;35;4;31;.886;4200000;0
15123;176808;418;0;0;0;0;.00nan;0;0
15123;180965;418;57;36;4;32;.889;4200000;0
15123;141530;449;0;0;0;0;.00nan;0;0
15125;171930;422;62;26;3;23;.885;3557000;0
15125;166767;422;0;0;0;0;.00nan;0;0
15125;168360;444;78;27;1;26;.963;3600000;0
15125;168855;444;0;0;0;0;.00nan;0;0
15127;177155;411;61;28;3;25;.893;3600000;0
15127;179071;420;0;0;0;0;.00nan;0;0
15127;74980;420;62;51;6;45;.882;3600000;0
15127;141459;411;0;0;0;0;.00nan;0;0
15129;163228;429;64;39;4;35;.897;3600000;0
15129;168206;414;60;16;1;15;.938;3600000;0
15129;-1;429;0;0;0;0;.00nan;0;0
15129;181346;414;0;0;0;0;.00nan;0;0
15131;179143;423;66;45;6;39;.867;3600000;0
15131;174386;428;63;16;1;15;.938;3600000;0
15131;85649;423;0;0;0;0;.00nan;0;0
15131;86531;428;0;0;0;0;.00nan;0;0
15133;173519;441;0;0;0;0;.00nan;0;0
15133;-1;441;91;41;2;39;.951;3583000;0
15133;86579;434;62;15;1;14;.933;3600000;0
15133;152650;434;0;0;0;0;.00nan;0;0
15135;170499;427;98;50;3;47;.940;3600000;0
15135;170886;440;86;14;0;14;1.000;3600000;0
15135;176077;440;0;0;0;0;.00nan;0;0
15135;149863;427;0;0;0;0;.00nan;0;0
15137;-1;443;41;30;5;25;.833;3600000;0
15137;-1;433;90;32;1;31;.969;3600000;0
15137;170928;443;0;0;0;0;.00nan;0;0
15137;-1;433;0;0;0;0;.00nan;0;0
15139;178890;417;0;0;0;0;.00nan;0;0
15139;182006;436;75;31;2;29;.935;3600000;0
15139;85050;417;66;33;3;30;.909;3600000;0
15139;141294;436;0;0;0;0;.00nan;0;0
15141;174164;4849;100;24;0;24;1.000;3600000;0
15141;171517;431;0;0;0;0;.00nan;0;0
15141;179691;4849;0;0;0;0;.00nan;0;0
15141;182225;431;87;37;2;35;.946;3550000;0
15143;165751;435;98;47;3;44;.936;3546000;0
15143;173954;438;74;25;2;23;.920;3600000;0
15143;78492;438;0;0;0;0;.00nan;0;0
15143;91448;435;0;0;0;0;.00nan;0;0
15145;179478;432;66;28;2;26;.929;3583000;0
15145;181100;442;87;30;1;29;.967;3600000;0
15145;182093;432;0;0;0;0;.00nan;0;0
15145;-1;442;0;0;0;0;.00nan;0;0
15147;178841;419;74;37;4;33;.892;3528000;0
15147;174420;439;0;0;0;0;.00nan;0;0
15147;-1;419;0;0;0;0;.00nan;0;0
15147;182210;439;86;30;2;28;.933;3600000;0
15149;179103;425;0;0;0;0;.00nan;0;0
15149;-1;425;85;14;0;14;1.000;3600000;0
15149;85987;426;89;51;4;47;.922;3600000;0
15149;86226;426;0;0;0;0;.00nan;0;0
15151;174241;421;58;17;2;15;.882;3600000;0
15151;-1;413;0;0;0;0;.00nan;0;0
15151;-1;413;78;39;4;35;.897;3593000;0
15151;74680;421;0;0;0;0;.00nan;0;0
15153;173575;437;0;0;0;0;.00nan;0;0
15153;170878;430;68;22;2;20;.909;3600000;0
15153;-1;430;0;0;0;0;.00nan;0;0
15153;139865;437;72;36;3;33;.917;3555000;0
15155;168360;444;0;0;0;0;.00nan;0;0
15155;168855;444;81;20;1;19;.950;3600000;0
15155;174386;428;63;46;5;41;.891;3600000;0
15155;86531;428;0;0;0;0;.00nan;0;0
15157;165751;435;0;0;0;0;.00nan;0;0
15157;174241;421;69;23;2;21;.913;3600000;0
15157;74680;421;0;0;0;0;.00nan;0;0
15157;91448;435;81;45;4;41;.911;3592000;0
15159;177155;411;57;28;3;25;.893;3564000;0
15159;170878;430;81;36;2;34;.944;3600000;0
15159;-1;430;0;0;0;0;.00nan;0;0
15159;141459;411;0;0;0;0;.00nan;0;0
15161;170886;440;49;12;2;10;.833;3600000;0
15161;175989;410;0;0;0;0;.00nan;0;0
15161;176077;440;0;0;0;0;.00nan;0;0
15161;78864;410;67;58;6;52;.897;3600000;0
15163;178743;449;0;0;0;0;.00nan;0;0
15163;179143;423;56;42;5;37;.881;3547000;0
15163;85649;423;0;0;0;0;.00nan;0;0
15163;141530;449;41;20;4;16;.800;3600000;0
15165;170499;427;90;27;1;26;.963;3761000;0
15165;86579;434;82;31;2;29;.935;3761000;0
15165;149863;427;0;0;0;0;.00nan;0;0
15165;152650;434;0;0;0;0;.00nan;0;0
15167;183783;415;82;33;2;31;.939;3567000;0
15167;85987;426;0;0;0;0;.00nan;0;0
15167;86226;426;85;32;1;31;.969;3600000;0
15167;94557;415;0;0;0;0;.00nan;0;0
15169;-1;433;61;6;0;6;1.000;767000;0
15169;176808;418;0;0;0;0;.00nan;0;0
15169;180965;418;67;27;3;24;.889;3600000;0
15169;-1;433;47;41;6;35;.854;2833000;0
15171;173519;441;0;0;0;0;.00nan;0;0
15171;178890;417;0;0;0;0;.00nan;0;0
15171;-1;441;73;31;2;29;.935;3600000;0
15171;85050;417;76;21;1;20;.952;3600000;0
15173;171930;422;0;0;0;0;.00nan;0;0
15173;166767;422;79;34;2;32;.941;3554000;0
15173;163228;429;0;0;0;0;.00nan;0;0
15173;-1;429;100;32;0;32;1.000;3600000;0
15175;163177;425;0;0;0;0;.00nan;0;0
15175;173575;437;71;37;3;34;.919;3600000;0
15175;-1;425;73;21;2;19;.905;3600000;0
15175;139865;437;0;0;0;0;.00nan;0;0
15177;177106;412;0;0;0;0;.00nan;0;0
15177;179071;420;46;41;6;35;.854;2715000;0
15177;-1;412;41;27;5;22;.815;3600000;0
15177;74980;420;48;8;1;7;.875;869000;0
15179;168206;414;30;17;4;13;.765;926000;0
15179;181100;442;97;34;1;33;.971;3600000;0
15179;181346;414;84;21;0;21;1.000;2674000;0
15179;-1;442;0;0;0;0;.00nan;0;0
15181;-1;443;58;43;5;38;.884;3600000;0
15181;170928;443;0;0;0;0;.00nan;0;0
15181;182006;436;64;25;2;23;.920;3600000;0
15181;141294;436;0;0;0;0;.00nan;0;0
15183;178841;419;58;20;2;18;.900;3600000;0
15183;-1;413;72;36;4;32;.889;3522000;0
15183;-1;419;0;0;0;0;.00nan;0;0
15183;-1;413;0;0;0;0;.00nan;0;0
15185;173954;438;81;30;1;29;.967;4200000;0
15185;171517;431;0;0;0;0;.00nan;0;0
15185;182225;431;83;30;1;29;.967;4200000;0
15185;78492;438;0;0;0;0;.00nan;0;0
15187;174164;4849;57;40;5;35;.875;3600000;0
15187;174420;439;0;0;0;0;.00nan;0;0
15187;179691;4849;0;0;0;0;.00nan;0;0
15187;182210;439;48;13;2;11;.846;3600000;0
15189;171930;422;70;32;3;29;.906;3596000;0
15189;166767;422;0;0;0;0;.00nan;0;0
15189;86579;434;61;15;1;14;.933;3600000;0
15189;152650;434;0;0;0;0;.00nan;0;0
15191;177155;411;0;0;0;0;.00nan;0;0
15191;170878;430;41;2;1;1;.500;530000;0
15191;-1;430;27;38;7;31;.816;3070000;0
15191;141459;411;72;26;2;24;.923;3600000;0
15193;-1;433;66;25;2;23;.920;3569000;0
15193;171517;431;88;33;1;32;.970;3600000;0
15193;182225;431;0;0;0;0;.00nan;0;0
15193;-1;433;0;0;0;0;.00nan;0;0
15195;-1;443;0;0;0;0;.00nan;0;0
15195;173954;438;0;0;0;0;.00nan;0;0
15195;170928;443;65;36;4;32;.889;3600000;0
15195;78492;438;67;11;1;10;.909;3600000;0
15197;177106;412;41;24;3;21;.875;4200000;0
15197;-1;412;0;0;0;0;.00nan;0;0
15197;85987;426;84;39;3;36;.923;4200000;0
15197;86226;426;0;0;0;0;.00nan;0;0
15199;-1;413;0;0;0;0;.00nan;0;0
15199;179478;432;0;0;0;0;.00nan;0;0
15199;182093;432;28;19;5;14;.737;3583000;0
15199;-1;413;93;43;3;40;.930;3600000;0
15201;170886;440;0;0;0;0;.00nan;0;0
15201;174164;4849;0;0;0;0;.00nan;0;0
15201;176077;440;50;17;2;15;.882;3919000;0
15201;179691;4849;78;43;3;40;.930;3919000;0
15203;173575;437;83;35;2;33;.943;3388000;0
15203;181100;442;38;20;4;16;.800;2697000;0
15203;-1;442;18;8;4;4;.500;903000;0
15203;139865;437;25;6;3;3;.500;212000;0
15205;170499;427;0;0;0;0;.00nan;0;0
15205;174420;439;64;18;2;16;.889;4200000;0
15205;182210;439;0;0;0;0;.00nan;0;0
15205;149863;427;94;45;2;43;.956;4200000;0
15207;163228;429;0;0;0;0;.00nan;0;0
15207;183783;415;0;0;0;0;.00nan;0;0
15207;-1;429;87;21;0;21;1.000;3600000;0
15207;94557;415;76;31;2;29;.935;3577000;0
15209;163177;425;51;7;1;6;.857;3600000;0
15209;179071;420;0;0;0;0;.00nan;0;0
15209;-1;425;0;0;0;0;.00nan;0;0
15209;74980;420;89;57;4;53;.930;3600000;0
15211;165751;435;97;23;0;23;1.000;3600000;0
15211;178743;449;71;32;3;29;.906;3600000;0
15211;91448;435;0;0;0;0;.00nan;0;0
15211;141530;449;0;0;0;0;.00nan;0;0
15213;168360;444;49;43;5;38;.884;3546000;0
15213;168855;444;0;0;0;0;.00nan;0;0
15213;174241;421;0;0;0;0;.00nan;0;0
15213;74680;421;59;22;3;19;.864;3600000;0
15215;168206;414;71;23;1;22;.957;3600000;0
15215;179143;423;0;0;0;0;.00nan;0;0
15215;181346;414;0;0;0;0;.00nan;0;0
15215;85649;423;72;35;3;32;.914;3567000;0
15217;178841;419;0;0;0;0;.00nan;0;0
15217;176808;418;52;37;5;32;.865;3600000;0
15217;-1;419;70;18;1;17;.944;3600000;0
15217;180965;418;0;0;0;0;.00nan;0;0
15219;174386;428;0;0;0;0;.00nan;0;0
15219;182006;436;0;0;0;0;.00nan;0;0
15219;86531;428;80;25;1;24;.960;3600000;0
15219;141294;436;57;20;3;17;.850;3528000;0
15221;173519;441;71;41;4;37;.902;3600000;0
15221;178890;417;71;23;2;21;.913;3600000;0
15221;-1;441;0;0;0;0;.00nan;0;0
15221;85050;417;0;0;0;0;.00nan;0;0
15223;170499;427;85;15;0;15;1.000;3600000;0
15223;174164;4849;80;39;2;37;.949;3594000;0
15223;179691;4849;0;0;0;0;.00nan;0;0
15223;149863;427;0;0;0;0;.00nan;0;0
15225;-1;433;0;0;0;0;.00nan;0;0
15225;-1;433;58;36;4;32;.889;3600000;0
15225;86579;434;89;29;1;28;.966;3600000;0
15225;152650;434;0;0;0;0;.00nan;0;0
15227;173519;441;0;0;0;0;.00nan;0;0
15227;178890;417;0;0;0;0;.00nan;0;0
15227;-1;441;73;30;2;28;.933;3600000;0
15227;85050;417;83;23;1;22;.957;3600000;0
15229;-1;443;87;29;1;28;.966;3600000;0
15229;170928;443;0;0;0;0;.00nan;0;0
15229;179071;420;0;0;0;0;.00nan;0;0
15229;74980;420;89;37;2;35;.946;3553000;0
15231;173575;437;65;39;4;35;.897;3600000;0
15231;171517;431;0;0;0;0;.00nan;0;0
15231;182225;431;100;34;0;34;1.000;3600000;0
15231;139865;437;0;0;0;0;.00nan;0;0
15233;165751;435;33;16;4;12;.750;1164000;0
15233;182006;436;68;20;1;19;.950;3600000;0
15233;91448;435;56;19;2;17;.895;2436000;0
15233;141294;436;0;0;0;0;.00nan;0;0
15235;170886;440;0;0;0;0;.00nan;0;0
15235;-1;413;0;0;0;0;.00nan;0;0
15235;176077;440;82;23;1;22;.957;3600000;0
15235;-1;413;55;43;5;38;.884;3600000;0
15237;179478;432;0;0;0;0;.00nan;0;0
15237;176808;418;0;0;0;0;.00nan;0;0
15237;180965;418;60;22;2;20;.909;3567000;0
15237;182093;432;92;38;1;37;.974;3600000;0
15239;178841;419;77;20;1;19;.950;3600000;0
15239;179143;423;24;5;3;2;.400;91000;0
15239;-1;419;0;0;0;0;.00nan;0;0
15239;85649;423;97;39;0;39;1.000;3426000;0
15241;177106;412;0;0;0;0;.00nan;0;0
15241;174420;439;0;0;0;0;.00nan;0;0
15241;182210;439;72;23;2;21;.913;3600000;0
15241;-1;412;48;32;4;28;.875;3599000;0
15243;178743;449;0;0;0;0;.00nan;0;0
15243;170878;430;68;39;5;34;.872;3870000;0
15243;-1;430;0;0;0;0;.00nan;0;0
15243;141530;449;70;42;4;38;.905;3870000;0
15245;173954;438;67;25;1;24;.960;3600000;0
15245;181100;442;0;0;0;0;.00nan;0;0
15245;-1;442;68;39;4;35;.897;3600000;0
15245;78492;438;0;0;0;0;.00nan;0;0
15247;171930;422;0;0;0;0;.00nan;0;0
15247;166767;422;68;22;3;19;.864;3552000;0
15247;168360;444;93;38;1;37;.974;3600000;0
15247;168855;444;0;0;0;0;.00nan;0;0
15249;163177;425;0;0;0;0;.00nan;0;0
15249;168206;414;28;14;4;10;.714;1081000;0
15249;-1;425;74;22;1;21;.955;3600000;0
15249;181346;414;35;14;3;11;.786;2519000;0
15251;183783;415;91;33;1;32;.970;3570000;0
15251;175989;410;0;0;0;0;.00nan;0;0
15251;78864;410;100;29;0;29;1.000;3600000;0
15251;94557;415;0;0;0;0;.00nan;0;0
15253;163228;429;0;0;0;0;.00nan;0;0
15253;-1;429;64;33;4;29;.879;3544000;0
15253;85987;426;0;0;0;0;.00nan;0;0
15253;86226;426;54;20;3;17;.850;3600000;0
15255;177155;411;28;30;6;24;.800;3600000;0
15255;174386;428;89;25;1;24;.960;3600000;0
15255;86531;428;0;0;0;0;.00nan;0;0
15255;141459;411;0;0;0;0;.00nan;0;0
15256;3256;891;0;0;0;0;.00nan;0;0
15256;162945;885;83;44;4;40;.909;3600000;0
15256;62279;885;0;0;0;0;.00nan;0;0
15256;76885;891;41;25;5;20;.800;3567000;0
15257;1712;880;0;0;0;0;.00nan;0;0
15257;168842;880;72;29;3;26;.897;3900000;0
15257;62287;978;0;0;0;0;.00nan;0;0
15257;81096;978;65;34;3;31;.912;3900000;0
15258;196005;966;0;0;0;0;.00nan;0;0
15258;44405;966;62;28;3;25;.893;3900000;0
15258;62530;983;80;32;3;29;.906;3900000;0
15258;141978;983;0;0;0;0;.00nan;0;0
15259;5354;894;0;0;0;0;.00nan;0;0
15259;11670;957;75;28;2;26;.929;3900000;0
15259;65823;957;0;0;0;0;.00nan;0;0
15259;146386;894;89;34;2;32;.941;3900000;0
15260;7624;874;0;0;0;0;.00nan;0;0
15260;37414;879;82;26;2;24;.923;3600000;0
15260;147567;874;53;40;5;35;.875;3561000;0
15260;148956;879;0;0;0;0;.00nan;0;0
15261;20645;1415;0;0;0;0;.00nan;0;0
15261;23251;994;0;0;0;0;.00nan;0;0
15261;28831;1415;67;24;3;21;.875;3569000;0
15261;57426;994;86;33;2;31;.939;3600000;0
15262;46905;945;0;0;0;0;.00nan;0;0
15262;70099;890;0;0;0;0;.00nan;0;0
15262;146684;945;79;42;3;39;.929;3545000;0
15262;157295;890;80;38;2;36;.947;3600000;0
15263;162945;885;68;31;3;28;.903;3590000;0
15263;46905;945;0;0;0;0;.00nan;0;0
15263;62279;885;0;0;0;0;.00nan;0;0
15263;146684;945;63;16;1;15;.938;3600000;0
15264;11670;957;74;34;3;31;.912;3900000;0
15264;62287;978;0;0;0;0;.00nan;0;0
15264;65823;957;0;0;0;0;.00nan;0;0
15264;81096;978;75;39;3;36;.923;3900000;0
15265;7624;874;0;0;0;0;.00nan;0;0
15265;23251;994;0;0;0;0;.00nan;0;0
15265;57426;994;68;38;4;34;.895;3680000;0
15265;147567;874;64;29;3;26;.897;3680000;0
15266;5354;894;64;18;1;17;.944;2595000;0
15266;62530;983;86;30;2;28;.933;3600000;0
15266;141978;983;0;0;0;0;.00nan;0;0
15266;146386;894;23;12;4;8;.667;1005000;0
15267;1712;880;0;0;0;0;.00nan;0;0
15267;168842;880;49;30;5;25;.833;3600000;0
15267;196005;966;0;0;0;0;.00nan;0;0
15267;44405;966;61;20;2;18;.900;3600000;0
15268;3256;891;0;0;0;0;.00nan;0;0
15268;37414;879;61;25;2;23;.920;3583000;0
15268;76885;891;91;31;1;30;.968;3600000;0
15268;148956;879;0;0;0;0;.00nan;0;0
15269;20645;1415;76;23;1;22;.957;3600000;0
15269;28831;1415;0;0;0;0;.00nan;0;0
15269;70099;890;62;22;2;20;.909;3600000;0
15269;157295;890;0;0;0;0;.00nan;0;0
15270;7624;874;66;16;1;15;.938;3600000;0
15270;62287;978;0;0;0;0;.00nan;0;0
15270;81096;978;66;26;2;24;.923;3600000;0
15270;147567;874;0;0;0;0;.00nan;0;0
15271;3256;891;0;0;0;0;.00nan;0;0
15271;62530;983;0;0;0;0;.00nan;0;0
15271;76885;891;89;24;1;23;.958;3900000;0
15271;141978;983;76;23;1;22;.957;3900000;0
15272;20645;1415;74;24;1;23;.958;3600000;0
15272;28831;1415;0;0;0;0;.00nan;0;0
15272;46905;945;54;36;5;31;.861;3600000;0
15272;146684;945;0;0;0;0;.00nan;0;0
15273;1712;880;0;0;0;0;.00nan;0;0
15273;5354;894;67;31;2;29;.935;3579000;0
15273;168842;880;74;18;1;17;.944;3600000;0
15273;146386;894;0;0;0;0;.00nan;0;0
15274;196005;966;0;0;0;0;.00nan;0;0
15274;37414;879;71;22;1;21;.955;3600000;0
15274;44405;966;63;35;4;31;.886;3600000;0
15274;148956;879;0;0;0;0;.00nan;0;0
15275;11670;957;72;23;1;22;.957;3600000;0
15275;65823;957;0;0;0;0;.00nan;0;0
15275;70099;890;52;38;5;33;.868;3600000;0
15275;157295;890;0;0;0;0;.00nan;0;0
15276;162945;885;70;29;2;27;.931;3600000;0
15276;23251;994;0;0;0;0;.00nan;0;0
15276;57426;994;100;24;0;24;1.000;3600000;0
15276;62279;885;0;0;0;0;.00nan;0;0
15277;20645;1415;0;0;0;0;.00nan;0;0
15277;28831;1415;62;33;3;30;.909;3600000;0
15277;46905;945;0;0;0;0;.00nan;0;0
15277;146684;945;76;29;2;27;.931;3600000;0
15278;1712;880;0;0;0;0;.00nan;0;0
15278;5354;894;0;0;0;0;.00nan;0;0
15278;168842;880;67;18;1;17;.944;3600000;0
15278;146386;894;42;32;5;27;.844;3600000;0
15279;1712;880;0;0;0;0;.00nan;0;0
15279;168842;880;64;45;4;41;.911;3600000;0
15279;20645;1415;0;0;0;0;.00nan;0;0
15279;28831;1415;64;18;1;17;.944;3600000;0
15280;7624;874;0;0;0;0;.00nan;0;0
15280;196005;966;0;0;0;0;.00nan;0;0
15280;44405;966;87;35;1;34;.971;3600000;0
15280;147567;874;57;20;2;18;.900;3600000;0
15281;62530;983;47;28;4;24;.857;3900000;0
15281;70099;890;63;29;4;25;.862;3900000;0
15281;141978;983;0;0;0;0;.00nan;0;0
15281;157295;890;0;0;0;0;.00nan;0;0
15282;23251;994;0;0;0;0;.00nan;0;0
15282;57426;994;53;28;4;24;.857;3551000;0
15282;62287;978;0;0;0;0;.00nan;0;0
15282;81096;978;67;35;3;32;.914;3600000;0
15283;5354;894;89;37;2;35;.946;3600000;0
15283;162945;885;59;24;3;21;.875;3576000;0
15283;62279;885;0;0;0;0;.00nan;0;0
15283;146386;894;0;0;0;0;.00nan;0;0
15284;37414;879;0;0;0;0;.00nan;0;0
15284;46905;945;0;0;0;0;.00nan;0;0
15284;146684;945;85;45;3;42;.933;3741000;0
15284;148956;879;56;21;2;19;.905;3695000;0
15285;162945;885;0;0;0;0;.00nan;0;0
15285;11670;957;43;36;6;30;.833;3600000;0
15285;62279;885;67;21;2;19;.905;3600000;0
15285;65823;957;0;0;0;0;.00nan;0;0
15286;5354;894;0;0;0;0;.00nan;0;0
15286;62287;978;0;0;0;0;.00nan;0;0
15286;81096;978;63;30;4;26;.867;3854000;0
15286;146386;894;47;31;5;26;.839;3854000;0
15287;7624;874;100;22;0;22;1.000;3600000;0
15287;46905;945;74;31;2;29;.935;3528000;0
15287;146684;945;0;0;0;0;.00nan;0;0
15287;147567;874;0;0;0;0;.00nan;0;0
15288;37414;879;44;23;4;19;.826;3600000;0
15288;62530;983;54;4;0;4;1.000;369000;0
15288;141978;983;53;45;7;38;.844;3231000;0
15288;148956;879;0;0;0;0;.00nan;0;0
15289;1712;880;62;37;5;32;.865;3600000;0
15289;168842;880;0;0;0;0;.00nan;0;0
15289;70099;890;100;27;0;27;1.000;3600000;0
15289;157295;890;0;0;0;0;.00nan;0;0
15290;23251;994;0;0;0;0;.00nan;0;0
15290;196005;966;0;0;0;0;.00nan;0;0
15290;44405;966;64;15;1;14;.933;3568000;0
15290;57426;994;100;38;0;38;1.000;3600000;0
15291;3256;891;0;0;0;0;.00nan;0;0
15291;20645;1415;0;0;0;0;.00nan;0;0
15291;28831;1415;66;20;1;19;.950;3600000;0
15291;76885;891;86;45;3;42;.933;3567000;0
15292;5354;894;0;0;0;0;.00nan;0;0
15292;196005;966;86;19;0;19;1.000;3600000;0
15292;44405;966;0;0;0;0;.00nan;0;0
15292;146386;894;65;33;4;29;.879;3600000;0
15293;162945;885;65;32;3;29;.906;3583000;0
15293;176765;874;0;0;0;0;.00nan;0;0
15293;62279;885;0;0;0;0;.00nan;0;0
15293;63107;874;76;29;2;27;.931;3600000;0
15294;3256;891;0;0;0;0;.00nan;0;0
15294;62287;978;0;0;0;0;.00nan;0;0
15294;76885;891;61;21;2;19;.905;3900000;0
15294;81096;978;100;50;2;48;.960;3900000;0
15295;37414;879;100;23;0;23;1.000;3600000;0
15295;70099;890;47;34;5;29;.853;3600000;0
15295;148956;879;0;0;0;0;.00nan;0;0
15295;157295;890;0;0;0;0;.00nan;0;0
15296;1712;880;0;0;0;0;.00nan;0;0
15296;168842;880;76;42;3;39;.929;3600000;0
15296;23251;994;0;0;0;0;.00nan;0;0
15296;57426;994;42;23;4;19;.826;3574000;0
15297;11670;957;36;24;5;19;.792;3580000;0
15297;46905;945;0;0;0;0;.00nan;0;0
15297;65823;957;0;0;0;0;.00nan;0;0
15297;146684;945;75;34;3;31;.912;3600000;0
15298;20645;1415;0;0;0;0;.00nan;0;0
15298;28831;1415;57;28;4;24;.857;3887000;0
15298;62530;983;70;41;4;37;.902;3900000;0
15298;141978;983;0;0;0;0;.00nan;0;0
15299;20645;1415;0;0;0;0;.00nan;0;0
15299;28831;1415;47;28;4;24;.857;3558000;0
15299;62287;978;0;0;0;0;.00nan;0;0
15299;81096;978;58;25;3;22;.880;3600000;0
15300;23251;994;71;32;3;29;.906;3600000;0
15300;46905;945;0;0;0;0;.00nan;0;0
15300;57426;994;0;0;0;0;.00nan;0;0
15300;146684;945;52;31;4;27;.871;3557000;0
15301;176765;874;0;0;0;0;.00nan;0;0
15301;62530;983;85;50;5;45;.900;3540000;0
15301;63107;874;37;12;3;9;.750;3600000;0
15301;141978;983;0;0;0;0;.00nan;0;0
15302;3256;891;0;0;0;0;.00nan;0;0
15302;5354;894;83;42;2;40;.952;3600000;0
15302;76885;891;49;26;4;22;.846;3519000;0
15302;146386;894;0;0;0;0;.00nan;0;0
15303;1712;880;0;0;0;0;.00nan;0;0
15303;11670;957;73;37;3;34;.919;3550000;0
15303;168842;880;62;15;2;13;.867;3600000;0
15303;65823;957;0;0;0;0;.00nan;0;0
15304;162945;885;87;41;3;38;.927;3600000;0
15304;37414;879;65;35;4;31;.886;3600000;0
15304;62279;885;0;0;0;0;.00nan;0;0
15304;148956;879;0;0;0;0;.00nan;0;0
15305;196005;966;61;27;2;25;.926;3554000;0
15305;44405;966;0;0;0;0;.00nan;0;0
15305;70099;890;89;34;1;33;.971;3600000;0
15305;157295;890;0;0;0;0;.00nan;0;0
15306;3256;891;0;0;0;0;.00nan;0;0
15306;11670;957;91;43;1;42;.977;3600000;0
15306;65823;957;0;0;0;0;.00nan;0;0
15306;76885;891;53;21;2;19;.905;3535000;0
15307;162945;885;0;0;0;0;.00nan;0;0
15307;62279;885;85;32;1;31;.969;3900000;0
15307;62287;978;0;0;0;0;.00nan;0;0
15307;81096;978;86;31;1;30;.968;3900000;0
15308;18104;891;0;0;0;0;.00nan;0;0
15308;70099;890;65;30;3;27;.900;3600000;0
15308;76885;891;71;22;2;20;.909;3600000;0
15308;157295;890;0;0;0;0;.00nan;0;0
15309;5354;894;93;34;2;32;.941;3600000;0
15309;46905;945;56;27;3;24;.889;3582000;0
15309;146386;894;0;0;0;0;.00nan;0;0
15309;146684;945;0;0;0;0;.00nan;0;0
15310;23251;994;0;0;0;0;.00nan;0;0
15310;57426;994;65;34;4;30;.882;3585000;0
15310;62530;983;0;0;0;0;.00nan;0;0
15310;141978;983;75;30;2;28;.933;3600000;0
15311;1712;880;0;0;0;0;.00nan;0;0
15311;168842;880;86;44;3;41;.932;3600000;0
15311;176765;874;0;0;0;0;.00nan;0;0
15311;63107;874;41;22;4;18;.818;3556000;0
15312;11670;957;83;25;1;24;.960;3600000;0
15312;196005;966;0;0;0;0;.00nan;0;0
15312;44405;966;56;27;3;24;.889;3546000;0
15312;65823;957;0;0;0;0;.00nan;0;0
15313;7037;1415;66;31;3;28;.903;3513000;0
15313;28831;1415;0;0;0;0;.00nan;0;0
15313;37414;879;81;24;1;23;.958;3600000;0
15313;148956;879;0;0;0;0;.00nan;0;0
15314;162945;885;86;26;2;24;.923;3600000;0
15314;62279;885;0;0;0;0;.00nan;0;0
15314;62530;983;95;51;3;48;.941;3587000;0
15314;141978;983;0;0;0;0;.00nan;0;0
15315;5354;894;0;0;0;0;.00nan;0;0
15315;176765;874;89;15;0;15;1.000;3600000;0
15315;63107;874;0;0;0;0;.00nan;0;0
15315;146386;894;72;38;3;35;.921;3600000;0
15316;46905;945;70;34;3;31;.912;3600000;0
15316;62287;978;0;0;0;0;.00nan;0;0
15316;81096;978;79;29;2;27;.931;3600000;0
15316;146684;945;0;0;0;0;.00nan;0;0
15317;1712;880;83;39;2;37;.949;3600000;0
15317;18104;891;0;0;0;0;.00nan;0;0
15317;168842;880;0;0;0;0;.00nan;0;0
15317;76885;891;55;32;4;28;.875;3546000;0
15318;11670;957;82;46;4;42;.913;3600000;0
15318;37414;879;44;36;5;31;.861;3567000;0
15318;65823;957;0;0;0;0;.00nan;0;0
15318;148956;879;0;0;0;0;.00nan;0;0
15319;7037;1415;76;27;1;26;.963;3551000;0
15319;28831;1415;0;0;0;0;.00nan;0;0
15319;196005;966;0;0;0;0;.00nan;0;0
15319;44405;966;100;29;0;29;1.000;3600000;0
15320;23251;994;0;0;0;0;.00nan;0;0
15320;57426;994;87;27;1;26;.963;3600000;0
15320;70099;890;58;33;4;29;.879;3565000;0
15320;157295;890;0;0;0;0;.00nan;0;0
15321;11670;957;44;22;4;18;.818;3600000;0
15321;62530;983;51;34;5;29;.853;3585000;0
15321;65823;957;0;0;0;0;.00nan;0;0
15321;141978;983;0;0;0;0;.00nan;0;0
15322;11670;957;0;0;0;0;.00nan;0;0
15322;62530;983;0;0;0;0;.00nan;0;0
15322;65823;957;95;22;0;22;1.000;3600000;0
15322;141978;983;97;43;2;41;.953;3600000;0
15323;7037;1415;0;0;0;0;.00nan;0;0
15323;28831;1415;81;47;3;44;.936;3600000;0
15323;176765;874;45;25;4;21;.840;3597000;0
15323;63107;874;0;0;0;0;.00nan;0;0
15324;196005;966;0;0;0;0;.00nan;0;0
15324;44405;966;78;20;1;19;.950;3600000;0
15324;62287;978;0;0;0;0;.00nan;0;0
15324;81096;978;60;29;3;26;.897;3557000;0
15325;162945;885;0;0;0;0;.00nan;0;0
15325;62279;885;71;28;2;26;.929;3600000;0
15325;70099;890;0;0;0;0;.00nan;0;0
15325;157295;890;56;32;4;28;.875;3551000;0
15326;1712;880;0;0;0;0;.00nan;0;0
15326;168842;880;77;30;2;28;.933;3600000;0
15326;46905;945;0;0;0;0;.00nan;0;0
15326;146684;945;74;44;3;41;.932;3559000;0
15327;18104;891;0;0;0;0;.00nan;0;0
15327;23251;994;0;0;0;0;.00nan;0;0
15327;57426;994;56;31;4;27;.871;3523000;0
15327;76885;891;65;20;2;18;.900;3600000;0
15328;5354;894;76;36;3;33;.917;3600000;0
15328;37414;879;45;24;4;20;.833;3566000;0
15328;146386;894;0;0;0;0;.00nan;0;0
15328;148956;879;0;0;0;0;.00nan;0;0
15329;162945;885;0;0;0;0;.00nan;0;0
15329;196005;966;0;0;0;0;.00nan;0;0
15329;44405;966;72;21;2;19;.905;3600000;0
15329;62279;885;58;28;3;25;.893;3575000;0
15330;176765;874;0;0;0;0;.00nan;0;0
15330;63107;874;25;20;5;15;.750;3589000;0
15330;70099;890;55;28;4;24;.857;3600000;0
15330;157295;890;0;0;0;0;.00nan;0;0
15331;11670;957;0;0;0;0;.00nan;0;0
15331;23251;994;0;0;0;0;.00nan;0;0
15331;57426;994;64;26;3;23;.885;3534000;0
15331;65823;957;100;35;1;34;.971;3600000;0
15332;37414;879;0;0;0;0;.00nan;0;0
15332;62287;978;45;6;1;5;.833;567000;0
15332;81096;978;34;31;6;25;.806;3033000;0
15332;148956;879;50;29;4;25;.862;3600000;0
15333;5354;894;0;0;0;0;.00nan;0;0
15333;7037;1415;0;0;0;0;.00nan;0;0
15333;28831;1415;53;28;4;24;.857;3611000;0
15333;146386;894;69;30;3;27;.900;3611000;0
15334;18104;891;0;0;0;0;.00nan;0;0
15334;46905;945;0;0;0;0;.00nan;0;0
15334;76885;891;51;26;4;22;.846;3600000;0
15334;146684;945;61;43;5;38;.884;3600000;0
15335;1712;880;0;0;0;0;.00nan;0;0
15335;168842;880;63;29;3;26;.897;3900000;0
15335;62530;983;100;45;3;42;.933;3877000;0
15335;141978;983;0;0;0;0;.00nan;0;0
15336;162945;885;100;30;0;30;1.000;3600000;0
15336;7037;1415;0;0;0;0;.00nan;0;0
15336;28831;1415;60;25;3;22;.880;3600000;0
15336;62279;885;0;0;0;0;.00nan;0;0
15337;11670;957;84;41;4;37;.902;3600000;0
15337;176765;874;77;21;1;20;.952;3600000;0
15337;63107;874;0;0;0;0;.00nan;0;0
15337;65823;957;0;0;0;0;.00nan;0;0
15338;62287;978;63;37;3;34;.919;3900000;0
15338;70099;890;73;38;3;35;.921;3900000;0
15338;81096;978;0;0;0;0;.00nan;0;0
15338;157295;890;0;0;0;0;.00nan;0;0
15339;46905;945;75;17;1;16;.941;3600000;0
15339;62530;983;88;37;2;35;.946;3544000;0
15339;141978;983;0;0;0;0;.00nan;0;0
15339;146684;945;0;0;0;0;.00nan;0;0
15340;5354;894;79;38;3;35;.921;3567000;0
15340;23251;994;0;0;0;0;.00nan;0;0
15340;57426;994;82;24;1;23;.958;3600000;0
15340;146386;894;0;0;0;0;.00nan;0;0
15341;18104;891;0;0;0;0;.00nan;0;0
15341;196005;966;0;0;0;0;.00nan;0;0
15341;44405;966;68;25;2;23;.920;3600000;0
15341;76885;891;54;38;5;33;.868;3600000;0
15342;1712;880;0;0;0;0;.00nan;0;0
15342;168842;880;100;28;0;28;1.000;3600000;0
15342;37414;879;38;31;5;26;.839;3600000;0
15342;148956;879;0;0;0;0;.00nan;0;0
15343;18104;891;0;0;0;0;.00nan;0;0
15343;176765;874;0;0;0;0;.00nan;0;0
15343;63107;874;83;24;1;23;.958;3600000;0
15343;76885;891;76;26;2;24;.923;3547000;0
15344;5354;894;0;0;0;0;.00nan;0;0
15344;70099;890;70;28;3;25;.893;3900000;0
15344;146386;894;79;32;3;29;.906;3900000;0
15344;157295;890;0;0;0;0;.00nan;0;0
15345;196005;966;0;0;0;0;.00nan;0;0
15345;44405;966;60;20;2;18;.900;3540000;0
15345;46905;945;95;26;0;26;1.000;3600000;0
15345;146684;945;0;0;0;0;.00nan;0;0
15346;23251;994;0;0;0;0;.00nan;0;0
15346;37414;879;62;44;6;38;.864;3105000;0
15346;57426;994;62;23;2;21;.913;3600000;0
15346;148956;879;47;5;1;4;.800;495000;0
15347;62287;978;0;0;0;0;.00nan;0;0
15347;62530;983;0;0;0;0;.00nan;0;0
15347;81096;978;78;32;2;30;.938;3600000;0
15347;141978;983;56;28;4;24;.857;3600000;0
15348;1712;880;0;0;0;0;.00nan;0;0
15348;162945;885;71;23;1;22;.957;3600000;0
15348;168842;880;57;19;2;17;.895;3600000;0
15348;62279;885;0;0;0;0;.00nan;0;0
15349;7037;1415;100;28;0;28;1.000;3600000;0
15349;11670;957;87;37;4;33;.892;3600000;0
15349;28831;1415;0;0;0;0;.00nan;0;0
15349;65823;957;0;0;0;0;.00nan;0;0
15350;18104;891;81;27;2;25;.926;3600000;0
15350;62530;983;28;26;6;20;.769;2473000;0
15350;76885;891;0;0;0;0;.00nan;0;0
15350;141978;983;55;11;1;10;.909;1127000;0
15351;162945;885;51;10;1;9;.900;1243000;0
15351;37414;879;59;19;2;17;.895;3600000;0
15351;62279;885;35;25;5;20;.800;2357000;0
15351;148956;879;0;0;0;0;.00nan;0;0
15352;11670;957;73;23;1;22;.957;3560000;0
15352;62287;978;0;0;0;0;.00nan;0;0
15352;65823;957;0;0;0;0;.00nan;0;0
15352;81096;978;91;18;0;18;1.000;3600000;0
15353;7037;1415;51;32;5;27;.844;3600000;0
15353;23251;994;0;0;0;0;.00nan;0;0
15353;28831;1415;0;0;0;0;.00nan;0;0
15353;57426;994;98;34;1;33;.971;3600000;0
15354;5354;894;81;24;1;23;.958;3600000;0
15354;46905;945;81;34;2;32;.941;3571000;0
15354;146386;894;0;0;0;0;.00nan;0;0
15354;146684;945;0;0;0;0;.00nan;0;0
15355;1712;880;0;0;0;0;.00nan;0;0
15355;168842;880;83;42;3;39;.929;3594000;0
15355;196005;966;0;0;0;0;.00nan;0;0
15355;44405;966;63;18;2;16;.889;3600000;0
15356;11670;957;60;22;3;19;.864;3600000;0
15356;65823;957;0;0;0;0;.00nan;0;0
15356;70099;890;63;48;5;43;.896;3554000;0
15356;157295;890;0;0;0;0;.00nan;0;0
15357;7037;1415;0;0;0;0;.00nan;0;0
15357;28831;1415;40;22;4;18;.818;3573000;0
15357;46905;945;0;0;0;0;.00nan;0;0
15357;146684;945;93;39;3;36;.923;3600000;0
15358;162945;885;68;20;2;18;.900;3600000;0
15358;176765;874;52;21;3;18;.857;3600000;0
15358;62279;885;0;0;0;0;.00nan;0;0
15358;63107;874;0;0;0;0;.00nan;0;0
15359;37414;879;63;26;3;23;.885;3600000;0
15359;62287;978;0;0;0;0;.00nan;0;0
15359;81096;978;91;21;0;21;1.000;3600000;0
15359;148956;879;0;0;0;0;.00nan;0;0
15360;62287;978;0;0;0;0;.00nan;0;0
15360;62530;983;100;40;0;40;1.000;3600000;0
15360;81096;978;80;30;2;28;.933;3515000;0
15360;141978;983;0;0;0;0;.00nan;0;0
15361;11670;957;54;31;4;27;.871;3691000;0
15361;18104;891;0;0;0;0;.00nan;0;0
15361;65823;957;0;0;0;0;.00nan;0;0
15361;76885;891;73;35;3;32;.914;3691000;0
15362;46905;945;78;27;2;25;.926;3600000;0
15362;70099;890;69;30;3;27;.900;3573000;0
15362;146684;945;0;0;0;0;.00nan;0;0
15362;157295;890;0;0;0;0;.00nan;0;0
15363;1712;880;88;16;0;16;1.000;3600000;0
15363;5354;894;0;0;0;0;.00nan;0;0
15363;168842;880;0;0;0;0;.00nan;0;0
15363;146386;894;62;37;4;33;.892;3600000;0
15364;7037;1415;0;0;0;0;.00nan;0;0
15364;28831;1415;59;36;4;32;.889;3726000;0
15364;196005;966;0;0;0;0;.00nan;0;0
15364;44405;966;84;32;3;29;.906;3726000;0
15365;23251;994;0;0;0;0;.00nan;0;0
15365;37414;879;69;29;2;27;.931;3600000;0
15365;57426;994;66;41;4;37;.902;3562000;0
15365;148956;879;0;0;0;0;.00nan;0;0
15366;176765;874;0;0;0;0;.00nan;0;0
15366;37414;879;69;33;3;30;.909;3513000;0
15366;63107;874;66;15;1;14;.933;3600000;0
15366;148956;879;0;0;0;0;.00nan;0;0
15367;162945;885;75;30;2;28;.933;3900000;0
15367;23251;994;0;0;0;0;.00nan;0;0
15367;57426;994;86;38;2;36;.947;3900000;0
15367;62279;885;0;0;0;0;.00nan;0;0
15368;46905;945;0;0;0;0;.00nan;0;0
15368;62530;983;82;41;3;38;.927;3600000;0
15368;141978;983;0;0;0;0;.00nan;0;0
15368;146684;945;67;18;1;17;.944;3600000;0
15369;5354;894;66;28;4;24;.857;3600000;0
15369;62287;978;0;0;0;0;.00nan;0;0
15369;81096;978;71;25;2;23;.920;3600000;0
15369;146386;894;0;0;0;0;.00nan;0;0
15370;11670;957;0;0;0;0;.00nan;0;0
15370;196005;966;0;0;0;0;.00nan;0;0
15370;44405;966;100;29;0;29;1.000;3600000;0
15370;65823;957;64;30;3;27;.900;3600000;0
15371;7037;1415;0;0;0;0;.00nan;0;0
15371;18104;891;0;0;0;0;.00nan;0;0
15371;28831;1415;78;25;2;23;.920;3600000;0
15371;76885;891;59;25;3;22;.880;3586000;0
15372;11670;957;68;27;2;25;.926;3600000;0
15372;196005;966;0;0;0;0;.00nan;0;0
15372;44405;966;91;29;1;28;.966;3600000;0
15372;65823;957;0;0;0;0;.00nan;0;0
15373;46905;945;57;22;2;20;.909;3600000;0
15373;62287;978;0;0;0;0;.00nan;0;0
15373;81096;978;63;26;3;23;.885;3600000;0
15373;146684;945;0;0;0;0;.00nan;0;0
15374;1712;880;83;40;3;37;.925;3585000;0
15374;7037;1415;0;0;0;0;.00nan;0;0
15374;168842;880;0;0;0;0;.00nan;0;0
15374;28831;1415;72;21;1;20;.952;3600000;0
15375;23251;994;0;0;0;0;.00nan;0;0
15375;176765;874;100;23;0;23;1.000;3600000;0
15375;57426;994;89;32;1;31;.969;3586000;0
15375;63107;874;0;0;0;0;.00nan;0;0
15376;18104;891;0;0;0;0;.00nan;0;0
15376;196005;966;0;0;0;0;.00nan;0;0
15376;44405;966;75;10;0;10;1.000;3600000;0
15376;76885;891;75;29;2;27;.931;3556000;0
15377;62287;978;0;0;0;0;.00nan;0;0
15377;70099;890;74;21;2;19;.905;3900000;0
15377;81096;978;74;27;2;25;.926;3900000;0
15377;157295;890;0;0;0;0;.00nan;0;0
15378;162945;885;56;17;2;15;.882;3600000;0
15378;46905;945;0;0;0;0;.00nan;0;0
15378;62279;885;0;0;0;0;.00nan;0;0
15378;146684;945;58;34;4;30;.882;3600000;0
15379;5354;894;0;0;0;0;.00nan;0;0
15379;11670;957;75;29;2;27;.931;3600000;0
15379;65823;957;0;0;0;0;.00nan;0;0
15379;146386;894;52;25;4;21;.840;3548000;0
15380;37414;879;0;0;0;0;.00nan;0;0
15380;62530;983;39;36;6;30;.833;3600000;0
15380;141978;983;0;0;0;0;.00nan;0;0
15380;148956;879;61;24;3;21;.875;3600000;0
15381;196005;966;0;0;0;0;.00nan;0;0
15381;44405;966;84;23;1;22;.957;3600000;0
15381;70099;890;76;29;2;27;.931;3600000;0
15381;157295;890;0;0;0;0;.00nan;0;0
15382;176765;874;0;0;0;0;.00nan;0;0
15382;62287;978;0;0;0;0;.00nan;0;0
15382;63107;874;73;38;4;34;.895;3587000;0
15382;81096;978;65;33;3;30;.909;3600000;0
15383;37414;879;58;27;3;24;.889;3561000;0
15383;46905;945;0;0;0;0;.00nan;0;0
15383;146684;945;95;31;1;30;.968;3600000;0
15383;148956;879;0;0;0;0;.00nan;0;0
15384;11670;957;52;24;4;20;.833;3559000;0
15384;23251;994;0;0;0;0;.00nan;0;0
15384;57426;994;58;27;3;24;.889;3600000;0
15384;65823;957;0;0;0;0;.00nan;0;0
15385;1712;880;0;0;0;0;.00nan;0;0
15385;168842;880;91;34;2;32;.941;3900000;0
15385;62530;983;0;0;0;0;.00nan;0;0
15385;141978;983;87;40;2;38;.950;3900000;0
15386;5354;894;83;42;3;39;.929;3518000;0
15386;7037;1415;0;0;0;0;.00nan;0;0
15386;28831;1415;53;12;1;11;.917;3600000;0
15386;146386;894;0;0;0;0;.00nan;0;0
15387;162945;885;49;2;0;2;1.000;284000;0
15387;18104;891;0;0;0;0;.00nan;0;0
15387;62279;885;19;25;6;19;.760;3316000;0
15387;76885;891;49;19;3;16;.842;3600000;0
15388;1712;880;0;0;0;0;.00nan;0;0
15388;168842;880;66;26;3;23;.885;3600000;0
15388;62287;978;49;1;0;1;1.000;245000;0
15388;81096;978;45;41;7;34;.829;3355000;0
15389;196005;966;0;0;0;0;.00nan;0;0
15389;37414;879;82;37;2;35;.946;3600000;0
15389;44405;966;54;25;3;22;.880;3575000;0
15389;148956;879;0;0;0;0;.00nan;0;0
15390;176765;874;60;16;1;15;.938;3600000;0
15390;62530;983;81;45;4;41;.911;3600000;0
15390;63107;874;0;0;0;0;.00nan;0;0
15390;141978;983;0;0;0;0;.00nan;0;0
15391;5354;894;0;0;0;0;.00nan;0;0
15391;18104;891;100;28;0;28;1.000;3600000;0
15391;76885;891;0;0;0;0;.00nan;0;0
15391;146386;894;77;35;3;32;.914;3600000;0
15392;23251;994;0;0;0;0;.00nan;0;0
15392;57426;994;67;18;1;17;.944;3600000;0
15392;70099;890;0;0;0;0;.00nan;0;0
15392;157295;890;81;37;2;35;.946;3566000;0
15393;162945;885;38;23;5;18;.783;3600000;0
15393;11670;957;53;32;4;28;.875;3198000;0
15393;62279;885;0;0;0;0;.00nan;0;0
15393;65823;957;22;7;4;3;.429;402000;0
15394;23251;994;0;0;0;0;.00nan;0;0
15394;57426;994;93;38;2;36;.947;3900000;0
15394;62287;978;0;0;0;0;.00nan;0;0
15394;81096;978;78;29;2;27;.931;3900000;0
15395;18104;891;70;19;1;18;.947;3600000;0
15395;46905;945;62;40;4;36;.900;3600000;0
15395;76885;891;0;0;0;0;.00nan;0;0
15395;146684;945;0;0;0;0;.00nan;0;0
15396;162945;885;44;17;3;14;.824;3600000;0
15396;62279;885;0;0;0;0;.00nan;0;0
15396;62530;983;53;43;6;37;.860;2978000;0
15396;141978;983;62;8;0;8;1.000;622000;0
15397;5354;894;0;0;0;0;.00nan;0;0
15397;196005;966;0;0;0;0;.00nan;0;0
15397;44405;966;58;24;3;21;.875;3757000;0
15397;146386;894;73;44;4;40;.909;3757000;0
15398;1712;880;0;0;0;0;.00nan;0;0
15398;168842;880;62;34;4;30;.882;3600000;0
15398;37414;879;87;16;0;16;1.000;3600000;0
15398;148956;879;0;0;0;0;.00nan;0;0
15399;7037;1415;0;0;0;0;.00nan;0;0
15399;28831;1415;80;27;1;26;.963;3600000;0
15399;176765;874;0;0;0;0;.00nan;0;0
15399;63107;874;65;34;3;31;.912;3600000;0
15400;5354;894;87;28;1;27;.964;3900000;0
15400;162945;885;0;0;0;0;.00nan;0;0
15400;62279;885;81;25;1;24;.960;3900000;0
15400;146386;894;0;0;0;0;.00nan;0;0
15401;176765;874;0;0;0;0;.00nan;0;0
15401;46905;945;0;0;0;0;.00nan;0;0
15401;63107;874;83;28;1;27;.964;3600000;0
15401;146684;945;43;41;6;35;.854;3600000;0
15402;1712;880;0;0;0;0;.00nan;0;0
15402;18104;891;0;0;0;0;.00nan;0;0
15402;168842;880;75;28;1;27;.964;3600000;0
15402;76885;891;94;24;0;24;1.000;3600000;0
15403;23251;994;83;44;4;40;.909;3600000;0
15403;57426;994;0;0;0;0;.00nan;0;0
15403;62530;983;50;31;5;26;.839;3586000;0
15403;141978;983;0;0;0;0;.00nan;0;0
15404;7037;1415;0;0;0;0;.00nan;0;0
15404;11670;957;0;0;0;0;.00nan;0;0
15404;28831;1415;66;37;4;33;.892;3523000;0
15404;65823;957;77;28;2;26;.929;3600000;0
15405;37414;879;57;30;4;26;.867;3600000;0
15405;70099;890;94;34;1;33;.971;3600000;0
15405;148956;879;0;0;0;0;.00nan;0;0
15405;157295;890;0;0;0;0;.00nan;0;0
15406;196005;966;73;24;2;22;.917;3600000;0
15406;44405;966;0;0;0;0;.00nan;0;0
15406;62287;978;0;0;0;0;.00nan;0;0
15406;81096;978;71;27;3;24;.889;3559000;0
15407;176765;874;64;15;1;14;.933;3600000;0
15407;63107;874;0;0;0;0;.00nan;0;0
15407;70099;890;88;41;2;39;.951;3600000;0
15407;157295;890;0;0;0;0;.00nan;0;0
15408;162945;885;95;31;1;30;.968;3600000;0
15408;196005;966;0;0;0;0;.00nan;0;0
15408;44405;966;83;33;2;31;.939;3600000;0
15408;62279;885;0;0;0;0;.00nan;0;0
15409;18104;891;0;0;0;0;.00nan;0;0
15409;37414;879;75;35;3;32;.914;3727000;0
15409;76885;891;68;39;4;35;.897;3727000;0
15409;148956;879;0;0;0;0;.00nan;0;0
15410;23251;994;0;0;0;0;.00nan;0;0
15410;46905;945;73;26;1;25;.962;3600000;0
15410;57426;994;75;28;2;26;.929;3555000;0
15410;146684;945;0;0;0;0;.00nan;0;0
15411;62530;983;96;42;2;40;.952;3600000;0
15411;70099;890;40;26;4;22;.846;3515000;0
15411;141978;983;0;0;0;0;.00nan;0;0
15411;157295;890;0;0;0;0;.00nan;0;0
15412;5354;894;0;0;0;0;.00nan;0;0
15412;176765;874;59;13;2;11;.846;3600000;0
15412;63107;874;0;0;0;0;.00nan;0;0
15412;146386;894;60;44;5;39;.886;3600000;0
15413;1712;880;67;30;3;27;.900;3600000;0
15413;11670;957;0;0;0;0;.00nan;0;0
15413;168842;880;0;0;0;0;.00nan;0;0
15413;65823;957;42;26;5;21;.808;3574000;0
15414;7037;1415;0;0;0;0;.00nan;0;0
15414;28831;1415;60;21;2;19;.905;3556000;0
15414;62287;978;0;0;0;0;.00nan;0;0
15414;81096;978;84;29;1;28;.966;3600000;0
15415;162945;885;71;40;4;36;.900;3600000;0
15415;176765;874;0;0;0;0;.00nan;0;0
15415;62279;885;0;0;0;0;.00nan;0;0
15415;63107;874;87;24;1;23;.958;3600000;0
15416;18104;891;0;0;0;0;.00nan;0;0
15416;62287;978;84;40;3;37;.925;3600000;0
15416;76885;891;86;29;1;28;.966;3600000;0
15416;81096;978;0;0;0;0;.00nan;0;0
15417;7037;1415;0;0;0;0;.00nan;0;0
15417;28831;1415;67;20;1;19;.950;3600000;0
15417;70099;890;68;39;3;36;.923;3544000;0
15417;157295;890;0;0;0;0;.00nan;0;0
15418;11670;957;0;0;0;0;.00nan;0;0
15418;46905;945;0;0;0;0;.00nan;0;0
15418;65823;957;56;18;2;16;.889;3547000;0
15418;146684;945;95;32;1;31;.969;3600000;0
15419;1712;880;0;0;0;0;.00nan;0;0
15419;168842;880;74;28;2;26;.929;3600000;0
15419;23251;994;0;0;0;0;.00nan;0;0
15419;57426;994;64;36;4;32;.889;3524000;0
15420;196005;966;0;0;0;0;.00nan;0;0
15420;44405;966;72;18;1;17;.944;3600000;0
15420;62530;983;49;38;6;32;.842;3600000;0
15420;141978;983;0;0;0;0;.00nan;0;0
15421;5354;894;85;46;4;42;.913;3551000;0
15421;37414;879;0;0;0;0;.00nan;0;0
15421;146386;894;0;0;0;0;.00nan;0;0
15421;148956;879;65;26;3;23;.885;3600000;0
15422;1712;880;0;0;0;0;.00nan;0;0
15422;168842;880;97;44;2;42;.955;3899000;0
15422;176765;874;54;17;2;15;.882;3900000;0
15422;63107;874;0;0;0;0;.00nan;0;0
15423;162945;885;74;18;1;17;.944;3600000;0
15423;62279;885;0;0;0;0;.00nan;0;0
15423;62287;978;0;0;0;0;.00nan;0;0
15423;81096;978;98;47;3;44;.936;3600000;0
15424;18104;891;0;0;0;0;.00nan;0;0
15424;70099;890;78;39;2;37;.949;3573000;0
15424;76885;891;98;23;0;23;1.000;3600000;0
15424;157295;890;0;0;0;0;.00nan;0;0
15425;5354;894;0;0;0;0;.00nan;0;0
15425;23251;994;56;21;2;19;.905;3243000;0
15425;57426;994;22;4;3;1;.250;357000;0
15425;146386;894;82;30;1;29;.967;3600000;0
15426;196005;966;0;0;0;0;.00nan;0;0
15426;44405;966;60;21;2;19;.905;3600000;0
15426;46905;945;66;41;4;37;.902;3572000;0
15426;146684;945;0;0;0;0;.00nan;0;0
15427;7037;1415;0;0;0;0;.00nan;0;0
15427;28831;1415;43;12;3;9;.750;3878000;0
15427;37414;879;92;41;4;37;.902;3878000;0
15427;148956;879;0;0;0;0;.00nan;0;0
15428;1712;880;0;0;0;0;.00nan;0;0
15428;162945;885;0;0;0;0;.00nan;0;0
15428;168842;880;48;34;5;29;.853;3796000;0
15428;62279;885;36;31;6;25;.806;3796000;0
15429;18104;891;0;0;0;0;.00nan;0;0
15429;176765;874;0;0;0;0;.00nan;0;0
15429;63107;874;75;31;2;29;.935;3600000;0
15429;76885;891;48;21;3;18;.857;3570000;0
15430;46905;945;0;0;0;0;.00nan;0;0
15430;62287;978;0;0;0;0;.00nan;0;0
15430;81096;978;93;39;2;37;.949;3600000;0
15430;146684;945;57;36;5;31;.861;3600000;0
15431;23251;994;0;0;0;0;.00nan;0;0
15431;196005;966;0;0;0;0;.00nan;0;0
15431;44405;966;100;29;0;29;1.000;3600000;0
15431;57426;994;96;41;2;39;.951;3600000;0
15432;7037;1415;0;0;0;0;.00nan;0;0
15432;28831;1415;62;23;2;21;.913;3600000;0
15432;62530;983;69;32;4;28;.875;3556000;0
15432;141978;983;0;0;0;0;.00nan;0;0
15433;5354;894;78;31;2;29;.935;3600000;0
15433;70099;890;58;37;5;32;.865;3600000;0
15433;146386;894;0;0;0;0;.00nan;0;0
15433;157295;890;0;0;0;0;.00nan;0;0
15434;11670;957;83;35;2;33;.943;3588000;0
15434;37414;879;0;0;0;0;.00nan;0;0
15434;65823;957;0;0;0;0;.00nan;0;0
15434;148956;879;93;36;1;35;.972;3600000;0
15435;162945;885;86;32;1;31;.969;3600000;0
15435;62279;885;0;0;0;0;.00nan;0;0
15435;62530;983;96;41;2;39;.951;3600000;0
15435;141978;983;0;0;0;0;.00nan;0;0
15436;176765;874;61;9;0;9;1.000;1800000;0
15436;196005;966;0;0;0;0;.00nan;0;0
15436;44405;966;78;18;1;17;.944;3600000;0
15436;63107;874;12;13;5;8;.615;1800000;0
15437;7037;1415;0;0;0;0;.00nan;0;0
15437;28831;1415;59;21;2;19;.905;3900000;0
15437;70099;890;89;39;2;37;.949;3900000;0
15437;157295;890;0;0;0;0;.00nan;0;0
15438;5354;894;0;0;0;0;.00nan;0;0
15438;11670;957;19;8;4;4;.500;803000;0
15438;65823;957;50;26;4;22;.846;2797000;0
15438;146386;894;48;34;5;29;.853;3600000;0
15439;18104;891;77;26;1;25;.962;3600000;0
15439;23251;994;0;0;0;0;.00nan;0;0
15439;57426;994;78;31;2;29;.935;3558000;0
15439;76885;891;0;0;0;0;.00nan;0;0
15440;1712;880;85;29;1;28;.966;3600000;0
15440;168842;880;0;0;0;0;.00nan;0;0
15440;46905;945;0;0;0;0;.00nan;0;0
15440;146684;945;49;28;4;24;.857;3600000;0
15441;18104;891;0;0;0;0;.00nan;0;0
15441;176765;874;73;23;1;22;.957;3600000;0
15441;63107;874;0;0;0;0;.00nan;0;0
15441;76885;891;75;34;2;32;.941;3550000;0
15442;5354;894;75;37;3;34;.919;3600000;0
15442;62287;978;0;0;0;0;.00nan;0;0
15442;81096;978;57;34;4;30;.882;3574000;0
15442;146386;894;0;0;0;0;.00nan;0;0
15443;23251;994;0;0;0;0;.00nan;0;0
15443;57426;994;71;31;3;28;.903;3868000;0
15443;70099;890;85;36;2;34;.944;3868000;0
15443;157295;890;0;0;0;0;.00nan;0;0
15444;1712;880;0;0;0;0;.00nan;0;0
15444;162945;885;96;38;1;37;.974;3600000;0
15444;168842;880;73;35;3;32;.914;3513000;0
15444;62279;885;0;0;0;0;.00nan;0;0
15445;37414;879;38;26;5;21;.808;3600000;0
15445;62530;983;75;29;2;27;.931;3600000;0
15445;141978;983;0;0;0;0;.00nan;0;0
15445;148956;879;0;0;0;0;.00nan;0;0
15446;162945;885;72;21;1;20;.952;3600000;0
15446;62279;885;0;0;0;0;.00nan;0;0
15446;70099;890;79;41;3;38;.927;3560000;0
15446;157295;890;0;0;0;0;.00nan;0;0
15447;1712;880;0;0;0;0;.00nan;0;0
15447;18104;891;0;0;0;0;.00nan;0;0
15447;168842;880;99;40;2;38;.950;3600000;0
15447;76885;891;60;36;5;31;.861;3600000;0
15448;23251;994;0;0;0;0;.00nan;0;0
15448;37414;879;0;0;0;0;.00nan;0;0
15448;57426;994;74;26;3;23;.885;3600000;0
15448;148956;879;23;25;6;19;.760;3600000;0
15449;46905;945;49;36;4;32;.889;3600000;0
15449;62530;983;0;0;0;0;.00nan;0;0
15449;141978;983;100;31;0;31;1.000;3600000;0
15449;146684;945;0;0;0;0;.00nan;0;0
15450;5354;894;0;0;0;0;.00nan;0;0
15450;7037;1415;0;0;0;0;.00nan;0;0
15450;28831;1415;63;30;3;27;.900;3576000;0
15450;146386;894;97;37;1;36;.973;3600000;0
15451;196005;966;0;0;0;0;.00nan;0;0
15451;44405;966;80;18;1;17;.944;3600000;0
15451;62287;978;0;0;0;0;.00nan;0;0
15451;81096;978;54;40;6;34;.850;3600000;0
15452;23251;994;0;0;0;0;.00nan;0;0
15452;57426;994;62;27;3;24;.889;3711000;0
15452;62287;978;0;0;0;0;.00nan;0;0
15452;81096;978;76;25;2;23;.920;3711000;0
15453;196005;966;0;0;0;0;.00nan;0;0
15453;44405;966;82;41;3;38;.927;3600000;0
15453;70099;890;40;34;6;28;.824;3335000;0
15453;157295;890;53;2;0;2;1.000;265000;0
15454;5354;894;48;36;6;30;.833;3540000;0
15454;46905;945;0;0;0;0;.00nan;0;0
15454;146386;894;0;0;0;0;.00nan;0;0
15454;146684;945;59;32;4;28;.875;3600000;0
15455;1712;880;0;0;0;0;.00nan;0;0
15455;168842;880;78;22;1;21;.955;3600000;0
15455;62530;983;0;0;0;0;.00nan;0;0
15455;141978;983;75;31;2;29;.935;3575000;0
15456;11670;957;75;37;3;34;.919;3189000;0
15456;176765;874;0;0;0;0;.00nan;0;0
15456;63107;874;74;19;1;18;.947;3600000;0
15456;65823;957;31;11;3;8;.727;411000;0
15457;162945;885;25;7;3;4;.571;377000;0
15457;37414;879;54;35;5;30;.857;3600000;0
15457;62279;885;61;24;3;21;.875;3223000;0
15457;148956;879;0;0;0;0;.00nan;0;0
15458;7037;1415;0;0;0;0;.00nan;0;0
15458;18104;891;0;0;0;0;.00nan;0;0
15458;28831;1415;58;34;4;30;.882;3600000;0
15458;76885;891;23;19;5;14;.737;3543000;0
15459;11670;957;0;0;0;0;.00nan;0;0
15459;176765;874;91;20;0;20;1.000;3600000;0
15459;63107;874;0;0;0;0;.00nan;0;0
15459;65823;957;22;50;9;41;.820;3600000;0
15460;1712;880;0;0;0;0;.00nan;0;0
15460;168842;880;54;22;3;19;.864;3600000;0
15460;70099;890;0;0;0;0;.00nan;0;0
15460;157295;890;64;37;4;33;.892;3568000;0
15461;162945;885;84;35;2;33;.943;3600000;0
15461;46905;945;0;0;0;0;.00nan;0;0
15461;62279;885;0;0;0;0;.00nan;0;0
15461;146684;945;32;34;6;28;.824;3600000;0
15462;176765;874;0;0;0;0;.00nan;0;0
15462;37414;879;0;0;0;0;.00nan;0;0
15462;63107;874;68;28;3;25;.893;3600000;0
15462;148956;879;51;38;5;33;.868;3600000;0
15463;18104;891;0;0;0;0;.00nan;0;0
15463;62530;983;100;38;0;38;1.000;3600000;0
15463;76885;891;62;30;3;27;.900;3600000;0
15463;141978;983;0;0;0;0;.00nan;0;0
15464;5354;894;0;0;0;0;.00nan;0;0
15464;70099;890;81;32;2;30;.938;3544000;0
15464;146386;894;72;23;1;22;.957;3600000;0
15464;157295;890;0;0;0;0;.00nan;0;0
15465;1712;880;49;1;0;1;1.000;273000;0
15465;168842;880;53;46;6;40;.870;3327000;0
15465;196005;966;0;0;0;0;.00nan;0;0
15465;44405;966;70;16;1;15;.938;3600000;0
15466;11670;957;0;0;0;0;.00nan;0;0
15466;62287;978;0;0;0;0;.00nan;0;0
15466;65823;957;69;22;1;21;.955;3651000;0
15466;81096;978;79;32;2;30;.938;3650000;0
15467;20645;1415;0;0;0;0;.00nan;0;0
15467;23251;994;0;0;0;0;.00nan;0;0
15467;28831;1415;59;28;3;25;.893;3900000;0
15467;57426;994;100;51;3;48;.941;3863000;0
15468;37414;879;61;17;2;15;.882;3600000;0
15468;46905;945;66;34;3;31;.912;3550000;0
15468;146684;945;0;0;0;0;.00nan;0;0
15468;148956;879;0;0;0;0;.00nan;0;0
15469;20645;1415;69;25;2;23;.920;3001000;0
15469;28831;1415;34;13;3;10;.769;599000;0
15469;70099;890;70;29;2;27;.931;3600000;0
15469;157295;890;0;0;0;0;.00nan;0;0
15470;162945;885;100;32;1;31;.969;3600000;0
15470;11670;957;0;0;0;0;.00nan;0;0
15470;62279;885;0;0;0;0;.00nan;0;0
15470;65823;957;41;37;7;30;.811;3600000;0
15471;1712;880;0;0;0;0;.00nan;0;0
15471;168842;880;63;33;3;30;.909;3547000;0
15471;176765;874;57;15;2;13;.867;3600000;0
15471;63107;874;0;0;0;0;.00nan;0;0
15472;20645;1415;0;0;0;0;.00nan;0;0
15472;28831;1415;100;33;0;33;1.000;3600000;0
15472;62287;978;86;35;1;34;.971;3595000;0
15472;81096;978;0;0;0;0;.00nan;0;0
15473;18104;891;0;0;0;0;.00nan;0;0
15473;23251;994;0;0;0;0;.00nan;0;0
15473;57426;994;75;26;2;24;.923;3600000;0
15473;76885;891;54;33;5;28;.848;3600000;0
15474;62530;983;62;31;3;28;.903;3900000;0
15474;70099;890;56;27;3;24;.889;3900000;0
15474;141978;983;0;0;0;0;.00nan;0;0
15474;157295;890;0;0;0;0;.00nan;0;0
15475;5354;894;69;46;5;41;.891;3600000;0
15475;196005;966;0;0;0;0;.00nan;0;0
15475;44405;966;72;22;1;21;.955;3600000;0
15475;146386;894;0;0;0;0;.00nan;0;0
15476;162945;885;84;35;2;33;.943;3600000;0
15476;18104;891;0;0;0;0;.00nan;0;0
15476;62279;885;0;0;0;0;.00nan;0;0
15476;76885;891;77;34;3;31;.912;3542000;0
15477;46905;945;98;27;0;27;1.000;3600000;0
15477;62287;978;0;0;0;0;.00nan;0;0
15477;81096;978;55;21;2;19;.905;3538000;0
15477;146684;945;0;0;0;0;.00nan;0;0
15478;5354;894;0;0;0;0;.00nan;0;0
15478;62530;983;82;36;2;34;.944;3600000;0
15478;141978;983;0;0;0;0;.00nan;0;0
15478;146386;894;79;23;1;22;.957;3600000;0
15479;1712;880;52;14;2;12;.857;1615000;0
15479;168842;880;17;19;6;13;.684;1985000;0
15479;37414;879;0;0;0;0;.00nan;0;0
15479;148956;879;91;36;2;34;.944;3600000;0
15480;11670;957;76;34;3;31;.912;3528000;0
15480;23251;994;0;0;0;0;.00nan;0;0
15480;57426;994;87;33;1;32;.970;3600000;0
15480;65823;957;0;0;0;0;.00nan;0;0
15481;20645;1415;0;0;0;0;.00nan;0;0
15481;28831;1415;34;24;5;19;.792;3600000;0
15481;196005;966;0;0;0;0;.00nan;0;0
15481;44405;966;76;27;2;25;.926;3600000;0
15482;176765;874;0;0;0;0;.00nan;0;0
15482;63107;874;70;23;2;21;.913;3600000;0
15482;70099;890;64;39;5;34;.872;3600000;0
15482;157295;890;0;0;0;0;.00nan;0;0
15483;5354;894;64;28;3;25;.893;3546000;0
15483;46905;945;60;18;2;16;.889;3600000;0
15483;146386;894;0;0;0;0;.00nan;0;0
15483;146684;945;0;0;0;0;.00nan;0;0
15484;779;966;0;0;0;0;.00nan;0;0
15484;162945;885;64;23;2;21;.913;3600000;0
15484;196005;966;61;28;3;25;.893;3544000;0
15484;62279;885;0;0;0;0;.00nan;0;0
15485;62287;978;0;0;0;0;.00nan;0;0
15485;70099;890;41;28;4;24;.857;3600000;0
15485;81096;978;81;33;2;31;.939;3600000;0
15485;157295;890;0;0;0;0;.00nan;0;0
15486;18104;891;0;0;0;0;.00nan;0;0
15486;37414;879;0;0;0;0;.00nan;0;0
15486;76885;891;90;40;2;38;.950;3600000;0
15486;148956;879;31;19;4;15;.789;3530000;0
15487;23251;994;0;0;0;0;.00nan;0;0
15487;46905;945;0;0;0;0;.00nan;0;0
15487;57426;994;83;26;1;25;.962;3600000;0
15487;146684;945;80;35;2;33;.943;3580000;0
15488;176765;874;100;31;0;31;1.000;3600000;0
15488;62530;983;92;38;2;36;.947;3590000;0
15488;63107;874;0;0;0;0;.00nan;0;0
15488;141978;983;0;0;0;0;.00nan;0;0
15489;11670;957;47;33;5;28;.848;3600000;0
15489;20645;1415;0;0;0;0;.00nan;0;0
15489;28831;1415;76;32;2;30;.938;3600000;0
15489;65823;957;0;0;0;0;.00nan;0;0
15490;176765;874;0;0;0;0;.00nan;0;0
15490;62287;978;0;0;0;0;.00nan;0;0
15490;63107;874;45;30;5;25;.833;3521000;0
15490;81096;978;90;52;3;49;.942;3600000;0
15491;1712;880;0;0;0;0;.00nan;0;0
15491;168842;880;100;41;1;40;.976;3900000;0
15491;23251;994;0;0;0;0;.00nan;0;0
15491;57426;994;71;25;1;24;.960;3900000;0
15492;5354;894;0;0;0;0;.00nan;0;0
15492;62530;983;0;0;0;0;.00nan;0;0
15492;141978;983;69;38;4;34;.895;3889000;0
15492;146386;894;84;43;3;40;.930;3889000;0
15493;779;966;59;19;2;17;.895;3600000;0
15493;18104;891;0;0;0;0;.00nan;0;0
15493;196005;966;0;0;0;0;.00nan;0;0
15493;76885;891;56;42;6;36;.857;3600000;0
15494;11670;957;0;0;0;0;.00nan;0;0
15494;46905;945;54;28;3;25;.893;3524000;0
15494;65823;957;100;42;1;41;.976;3600000;0
15494;146684;945;0;0;0;0;.00nan;0;0
15495;20645;1415;0;0;0;0;.00nan;0;0
15495;28831;1415;83;39;3;36;.923;3630000;0
15495;37414;879;0;0;0;0;.00nan;0;0
15495;148956;879;60;35;4;31;.886;3630000;0
15496;1712;880;39;28;5;23;.821;3600000;0
15496;168842;880;0;0;0;0;.00nan;0;0
15496;20645;1415;77;34;2;32;.941;3600000;0
15496;28831;1415;0;0;0;0;.00nan;0;0
15497;162945;885;74;26;2;24;.923;3900000;0
15497;62279;885;0;0;0;0;.00nan;0;0
15497;70099;890;0;0;0;0;.00nan;0;0
15497;157295;890;99;45;2;43;.956;3900000;0
15498;5354;894;99;42;2;40;.952;3600000;0
15498;18104;891;42;23;4;19;.826;3586000;0
15498;76885;891;0;0;0;0;.00nan;0;0
15498;146386;894;0;0;0;0;.00nan;0;0
15499;162945;885;38;10;3;7;.700;3515000;0
15499;23251;994;0;0;0;0;.00nan;0;0
15499;57426;994;99;43;1;42;.977;3600000;0
15499;62279;885;0;0;0;0;.00nan;0;0
15500;46905;945;0;0;0;0;.00nan;0;0
15500;70099;890;97;26;1;25;.962;3600000;0
15500;146684;945;71;29;2;27;.931;3544000;0
15500;157295;890;0;0;0;0;.00nan;0;0
15501;1712;880;0;0;0;0;.00nan;0;0
15501;168842;880;85;29;1;28;.966;3600000;0
15501;62287;978;0;0;0;0;.00nan;0;0
15501;81096;978;89;52;4;48;.923;3600000;0
15502;779;966;64;35;3;32;.914;3900000;0
15502;176765;874;90;37;3;34;.919;3900000;0
15502;196005;966;0;0;0;0;.00nan;0;0
15502;63107;874;0;0;0;0;.00nan;0;0
15503;11670;957;24;28;6;22;.786;2228000;0
15503;37414;879;0;0;0;0;.00nan;0;0
15503;65823;957;75;19;1;18;.947;1372000;0
15503;148956;879;80;30;2;28;.933;3600000;0
15504;20645;1415;0;0;0;0;.00nan;0;0
15504;28831;1415;54;35;5;30;.857;3600000;0
15504;62530;983;88;38;2;36;.947;3600000;0
15504;141978;983;0;0;0;0;.00nan;0;0
15505;18104;891;0;0;0;0;.00nan;0;0
15505;70099;890;74;20;1;19;.950;3600000;0
15505;76885;891;53;29;4;25;.862;3600000;0
15505;157295;890;0;0;0;0;.00nan;0;0
15506;20645;1415;0;0;0;0;.00nan;0;0
15506;28831;1415;48;28;4;24;.857;3577000;0
15506;176765;874;0;0;0;0;.00nan;0;0
15506;63107;874;58;28;3;25;.893;3600000;0
15507;37414;879;0;0;0;0;.00nan;0;0
15507;62287;978;0;0;0;0;.00nan;0;0
15507;81096;978;66;21;1;20;.952;3600000;0
15507;148956;879;78;37;3;34;.919;3590000;0
15508;23251;994;0;0;0;0;.00nan;0;0
15508;57426;994;71;20;1;19;.950;3600000;0
15508;62530;983;90;40;2;38;.950;3544000;0
15508;141978;983;0;0;0;0;.00nan;0;0
15509;5354;894;0;0;0;0;.00nan;0;0
15509;162945;885;70;25;2;23;.920;3900000;0
15509;62279;885;0;0;0;0;.00nan;0;0
15509;146386;894;91;41;2;39;.951;3900000;0
15510;1712;880;0;0;0;0;.00nan;0;0
15510;11670;957;0;0;0;0;.00nan;0;0
15510;168842;880;63;41;5;36;.878;3600000;0
15510;65823;957;100;42;2;40;.952;3600000;0
15511;779;966;52;17;2;15;.882;3600000;0
15511;196005;966;0;0;0;0;.00nan;0;0
15511;46905;945;48;31;4;27;.871;3563000;0
15511;146684;945;0;0;0;0;.00nan;0;0
15512;162945;885;0;0;0;0;.00nan;0;0
15512;62279;885;63;20;2;18;.900;3614000;0
15512;62287;978;0;0;0;0;.00nan;0;0
15512;81096;978;100;40;1;39;.975;3614000;0
15513;11670;957;0;0;0;0;.00nan;0;0
15513;65823;957;80;46;4;42;.913;3600000;0
15513;70099;890;100;30;0;30;1.000;3600000;0
15513;157295;890;0;0;0;0;.00nan;0;0
15514;5354;894;67;34;3;31;.912;3600000;0
15514;37414;879;0;0;0;0;.00nan;0;0
15514;146386;894;0;0;0;0;.00nan;0;0
15514;148956;879;95;18;0;18;1.000;3600000;0
15515;23251;994;0;0;0;0;.00nan;0;0
15515;176765;874;98;22;0;22;1.000;3600000;0
15515;57426;994;94;53;5;48;.906;3600000;0
15515;63107;874;0;0;0;0;.00nan;0;0
15516;18104;891;0;0;0;0;.00nan;0;0
15516;46905;945;0;0;0;0;.00nan;0;0
15516;76885;891;88;30;2;28;.933;3600000;0
15516;146684;945;54;29;4;25;.862;3549000;0
15517;779;966;69;24;2;22;.917;3600000;0
15517;196005;966;0;0;0;0;.00nan;0;0
15517;62530;983;76;41;3;38;.927;3600000;0
15517;141978;983;0;0;0;0;.00nan;0;0
15518;18104;891;0;0;0;0;.00nan;0;0
15518;62287;978;59;34;4;30;.882;3900000;0
15518;76885;891;50;26;4;22;.846;3900000;0
15518;81096;978;0;0;0;0;.00nan;0;0
15519;37414;879;0;0;0;0;.00nan;0;0
15519;70099;890;73;39;4;35;.897;3668000;0
15519;148956;879;53;27;3;24;.889;3653000;0
15519;157295;890;0;0;0;0;.00nan;0;0
15520;1712;880;0;0;0;0;.00nan;0;0
15520;168842;880;78;26;2;24;.923;3600000;0
15520;46905;945;0;0;0;0;.00nan;0;0
15520;146684;945;65;35;4;31;.886;3600000;0
15521;5354;894;0;0;0;0;.00nan;0;0
15521;176765;874;0;0;0;0;.00nan;0;0
15521;63107;874;88;29;1;28;.966;3600000;0
15521;146386;894;79;40;3;37;.925;3576000;0
15522;779;966;70;25;1;24;.960;3600000;0
15522;23251;994;66;19;1;18;.947;1500000;0
15522;196005;966;0;0;0;0;.00nan;0;0
15522;57426;994;36;33;6;27;.818;2100000;0
15523;162945;885;91;32;1;31;.969;3600000;0
15523;20645;1415;0;0;0;0;.00nan;0;0
15523;28831;1415;64;33;4;29;.879;3600000;0
15523;62279;885;0;0;0;0;.00nan;0;0
15524;162945;885;24;12;4;8;.667;1095000;0
15524;7037;1415;0;0;0;0;.00nan;0;0
15524;28831;1415;86;24;1;23;.958;3600000;0
15524;62279;885;54;31;4;27;.871;2505000;0
15525;176765;874;63;14;1;13;.929;3600000;0
15525;46905;945;58;32;4;28;.875;3600000;0
15525;63107;874;0;0;0;0;.00nan;0;0
15525;146684;945;0;0;0;0;.00nan;0;0
15526;11670;957;68;36;4;32;.889;3600000;0
15526;18104;891;0;0;0;0;.00nan;0;0
15526;65823;957;0;0;0;0;.00nan;0;0
15526;76885;891;36;26;5;21;.808;3548000;0
15527;5354;894;0;0;0;0;.00nan;0;0
15527;23251;994;94;34;1;33;.971;3600000;0
15527;57426;994;0;0;0;0;.00nan;0;0
15527;146386;894;87;36;2;34;.944;3557000;0
15528;62287;978;0;0;0;0;.00nan;0;0
15528;62530;983;84;47;4;43;.915;3514000;0
15528;81096;978;68;24;2;22;.917;3600000;0
15528;141978;983;0;0;0;0;.00nan;0;0
15529;1712;880;0;0;0;0;.00nan;0;0
15529;168842;880;45;34;5;29;.853;3600000;0
15529;70099;890;94;34;2;32;.941;3600000;0
15529;157295;890;0;0;0;0;.00nan;0;0
15530;779;966;76;9;0;9;1.000;3600000;0
15530;196005;966;0;0;0;0;.00nan;0;0
15530;37414;879;98;44;1;43;.977;3556000;0
15530;148956;879;0;0;0;0;.00nan;0;0
15531;779;966;59;24;2;22;.917;3600000;0
15531;196005;966;0;0;0;0;.00nan;0;0
15531;37414;879;0;0;0;0;.00nan;0;0
15531;148956;879;68;33;3;30;.909;3600000;0
15532;11670;957;0;0;0;0;.00nan;0;0
15532;65823;957;53;34;4;30;.882;3900000;0
15532;70099;890;84;42;4;38;.905;3900000;0
15532;157295;890;0;0;0;0;.00nan;0;0
15533;162945;885;65;18;1;17;.944;3600000;0
15533;62279;885;0;0;0;0;.00nan;0;0
15533;62530;983;45;40;6;34;.850;3600000;0
15533;141978;983;0;0;0;0;.00nan;0;0
15534;1712;880;81;30;2;28;.933;3581000;0
15534;168842;880;0;0;0;0;.00nan;0;0
15534;176765;874;0;0;0;0;.00nan;0;0
15534;63107;874;88;29;1;28;.966;3600000;0
15535;23251;994;0;0;0;0;.00nan;0;0
15535;57426;994;84;30;1;29;.967;3600000;0
15535;62287;978;0;0;0;0;.00nan;0;0
15535;81096;978;79;32;2;30;.938;3551000;0
15536;18104;891;0;0;0;0;.00nan;0;0
15536;46905;945;0;0;0;0;.00nan;0;0
15536;76885;891;58;26;3;23;.885;3900000;0
15536;146684;945;67;30;3;27;.900;3858000;0
15537;5354;894;75;42;4;38;.905;3600000;0
15537;7037;1415;78;15;1;14;.933;3600000;0
15537;28831;1415;0;0;0;0;.00nan;0;0
15537;146386;894;0;0;0;0;.00nan;0;0
15538;1712;880;0;0;0;0;.00nan;0;0
15538;162945;885;71;35;3;32;.914;3600000;0
15538;168842;880;64;37;4;33;.892;3560000;0
15538;62279;885;0;0;0;0;.00nan;0;0
15539;779;966;73;40;4;36;.900;3575000;0
15539;196005;966;0;0;0;0;.00nan;0;0
15539;62287;978;0;0;0;0;.00nan;0;0
15539;81096;978;93;44;2;42;.955;3600000;0
15540;18104;891;0;0;0;0;.00nan;0;0
15540;70099;890;100;43;2;41;.953;3600000;0
15540;76885;891;75;35;3;32;.914;3594000;0
15540;157295;890;0;0;0;0;.00nan;0;0
15541;176765;874;67;18;1;17;.944;3600000;0
15541;46905;945;0;0;0;0;.00nan;0;0
15541;63107;874;0;0;0;0;.00nan;0;0
15541;146684;945;89;51;4;47;.922;3600000;0
15542;5354;894;0;0;0;0;.00nan;0;0
15542;62530;983;53;34;5;29;.853;3600000;0
15542;141978;983;0;0;0;0;.00nan;0;0
15542;146386;894;100;26;0;26;1.000;3600000;0
15543;7037;1415;0;0;0;0;.00nan;0;0
15543;11670;957;76;43;4;39;.907;3554000;0
15543;28831;1415;54;22;3;19;.864;3600000;0
15543;65823;957;0;0;0;0;.00nan;0;0
15544;23251;994;0;0;0;0;.00nan;0;0
15544;37414;879;88;29;1;28;.966;3600000;0
15544;57426;994;57;32;4;28;.875;3600000;0
15544;148956;879;0;0;0;0;.00nan;0;0
15545;5354;894;0;0;0;0;.00nan;0;0
15545;176765;874;0;0;0;0;.00nan;0;0
15545;63107;874;87;17;0;17;1.000;3600000;0
15545;146386;894;75;33;2;31;.939;3585000;0
15546;62287;978;0;0;0;0;.00nan;0;0
15546;70099;890;99;40;2;38;.950;3600000;0
15546;81096;978;50;19;3;16;.842;3553000;0
15546;157295;890;0;0;0;0;.00nan;0;0
15547;11670;957;63;32;3;29;.906;3600000;0
15547;23251;994;0;0;0;0;.00nan;0;0
15547;57426;994;98;24;0;24;1.000;3600000;0
15547;65823;957;0;0;0;0;.00nan;0;0
15548;14873;891;0;0;0;0;.00nan;0;0
15548;62530;983;29;28;6;22;.786;1738000;0
15548;76885;891;47;28;4;24;.857;3600000;0
15548;141978;983;78;17;0;17;1.000;1815000;0
15549;1712;880;0;0;0;0;.00nan;0;0
15549;168842;880;53;18;3;15;.833;3546000;0
15549;46905;945;0;0;0;0;.00nan;0;0
15549;146684;945;89;39;2;37;.949;3600000;0
15550;779;966;0;0;0;0;.00nan;0;0
15550;162945;885;44;17;3;14;.824;3557000;0
15550;196005;966;80;32;2;30;.938;3600000;0
15550;62279;885;0;0;0;0;.00nan;0;0
15551;7037;1415;0;0;0;0;.00nan;0;0
15551;28831;1415;92;41;2;39;.951;3600000;0
15551;37414;879;66;23;3;20;.870;3551000;0
15551;148956;879;0;0;0;0;.00nan;0;0
15552;14873;891;0;0;0;0;.00nan;0;0
15552;176765;874;0;0;0;0;.00nan;0;0
15552;63107;874;77;33;3;30;.909;3591000;0
15552;76885;891;82;32;2;30;.938;3600000;0
15553;1712;880;52;25;3;22;.880;3600000;0
15553;168842;880;0;0;0;0;.00nan;0;0
15553;62530;983;67;23;2;21;.913;3600000;0
15553;141978;983;0;0;0;0;.00nan;0;0
15554;5354;894;82;28;3;25;.893;3621000;0
15554;37414;879;0;0;0;0;.00nan;0;0
15554;146386;894;0;0;0;0;.00nan;0;0
15554;148956;879;74;27;2;25;.926;3621000;0
15555;162945;885;58;23;3;20;.870;3900000;0
15555;11670;957;95;52;3;49;.942;3900000;0
15555;62279;885;0;0;0;0;.00nan;0;0
15555;65823;957;0;0;0;0;.00nan;0;0
15556;779;966;65;21;2;19;.905;3600000;0
15556;23251;994;0;0;0;0;.00nan;0;0
15556;196005;966;0;0;0;0;.00nan;0;0
15556;57426;994;72;34;3;31;.912;3572000;0
15557;176765;874;79;26;2;24;.923;3662000;0
15557;62530;983;80;41;3;38;.927;3662000;0
15557;63107;874;0;0;0;0;.00nan;0;0
15557;141978;983;0;0;0;0;.00nan;0;0
15558;779;966;79;30;2;28;.933;3600000;0
15558;18104;891;0;0;0;0;.00nan;0;0
15558;196005;966;0;0;0;0;.00nan;0;0
15558;76885;891;59;31;4;27;.871;3585000;0
15559;5354;894;63;24;3;21;.875;3600000;0
15559;70099;890;51;38;6;32;.842;3600000;0
15559;146386;894;0;0;0;0;.00nan;0;0
15559;157295;890;0;0;0;0;.00nan;0;0
15560;11670;957;79;26;2;24;.923;3600000;0
15560;46905;945;37;38;6;32;.842;2525000;0
15560;65823;957;0;0;0;0;.00nan;0;0
15560;146684;945;67;15;0;15;1.000;1075000;0
15561;1712;880;0;0;0;0;.00nan;0;0
15561;168842;880;100;36;0;36;1.000;3600000;0
15561;23251;994;0;0;0;0;.00nan;0;0
15561;57426;994;51;30;4;26;.867;3600000;0
15562;37414;879;69;8;0;8;1.000;3600000;0
15562;62287;978;0;0;0;0;.00nan;0;0
15562;81096;978;98;51;3;48;.941;3600000;0
15562;148956;879;0;0;0;0;.00nan;0;0
15563;162945;885;84;45;3;42;.933;3600000;0
15563;7037;1415;0;0;0;0;.00nan;0;0
15563;28831;1415;91;38;2;36;.947;3600000;0
15563;62279;885;0;0;0;0;.00nan;0;0
15564;162945;885;59;14;1;13;.929;3600000;0
15564;62279;885;0;0;0;0;.00nan;0;0
15564;70099;890;79;36;3;33;.917;3561000;0
15564;157295;890;0;0;0;0;.00nan;0;0
15565;176765;874;0;0;0;0;.00nan;0;0
15565;62287;978;81;22;0;22;1.000;2403000;0
15565;63107;874;77;18;1;17;.944;3600000;0
15565;81096;978;42;21;4;17;.810;1197000;0
15566;23251;994;0;0;0;0;.00nan;0;0
15566;46905;945;0;0;0;0;.00nan;0;0
15566;57426;994;53;28;4;24;.857;3900000;0
15566;146684;945;34;22;4;18;.818;3900000;0
15567;11670;957;59;32;4;28;.875;3524000;0
15567;62530;983;76;33;2;31;.939;3600000;0
15567;65823;957;0;0;0;0;.00nan;0;0
15567;141978;983;0;0;0;0;.00nan;0;0
15568;5354;894;0;0;0;0;.00nan;0;0
15568;18104;891;0;0;0;0;.00nan;0;0
15568;76885;891;100;40;0;40;1.000;3600000;0
15568;146386;894;52;39;5;34;.872;3600000;0
15569;779;966;51;24;3;21;.875;3642000;0
15569;7037;1415;0;0;0;0;.00nan;0;0
15569;28831;1415;71;39;4;35;.897;3642000;0
15569;196005;966;0;0;0;0;.00nan;0;0
15570;1712;880;0;0;0;0;.00nan;0;0
15570;168842;880;55;23;3;20;.870;3573000;0
15570;37414;879;86;27;2;25;.926;3600000;0
15570;148956;879;0;0;0;0;.00nan;0;0
15571;11670;957;0;0;0;0;.00nan;0;0
15571;62530;983;0;0;0;0;.00nan;0;0
15571;65823;957;61;16;1;15;.938;3600000;0
15571;141978;983;67;45;5;40;.889;3600000;0
15572;11670;957;65;40;5;35;.875;3600000;0
15572;37414;879;84;25;1;24;.960;3600000;0
15572;65823;957;0;0;0;0;.00nan;0;0
15572;148956;879;0;0;0;0;.00nan;0;0
15573;779;966;67;39;4;35;.897;3549000;0
15573;176765;874;70;26;2;24;.923;3600000;0
15573;196005;966;0;0;0;0;.00nan;0;0
15573;63107;874;0;0;0;0;.00nan;0;0
15574;162945;885;44;19;3;16;.842;3600000;0
15574;62279;885;0;0;0;0;.00nan;0;0
15574;62287;978;0;0;0;0;.00nan;0;0
15574;81096;978;69;41;5;36;.878;3581000;0
15575;62530;983;45;32;5;27;.844;3600000;0
15575;70099;890;84;27;1;26;.963;3600000;0
15575;141978;983;0;0;0;0;.00nan;0;0
15575;157295;890;0;0;0;0;.00nan;0;0
15576;7037;1415;0;0;0;0;.00nan;0;0
15576;23251;994;0;0;0;0;.00nan;0;0
15576;28831;1415;79;29;2;27;.931;3600000;0
15576;57426;994;34;19;4;15;.789;3517000;0
15577;1712;880;0;0;0;0;.00nan;0;0
15577;18104;891;0;0;0;0;.00nan;0;0
15577;168842;880;54;22;3;19;.864;3635000;0
15577;76885;891;100;38;2;36;.947;3635000;0
15578;37414;879;74;23;1;22;.957;3600000;0
15578;46905;945;0;0;0;0;.00nan;0;0
15578;146684;945;63;31;3;28;.903;3571000;0
15578;148956;879;0;0;0;0;.00nan;0;0
15579;5354;894;70;38;3;35;.921;3558000;0
15579;162945;885;80;30;2;28;.933;3600000;0
15579;62279;885;0;0;0;0;.00nan;0;0
15579;146386;894;0;0;0;0;.00nan;0;0
15580;18104;891;0;0;0;0;.00nan;0;0
15580;62287;978;0;0;0;0;.00nan;0;0
15580;76885;891;74;24;2;22;.917;3600000;0
15580;81096;978;80;39;3;36;.923;3600000;0
15581;23251;994;0;0;0;0;.00nan;0;0
15581;57426;994;52;30;4;26;.867;3566000;0
15581;62530;983;86;35;2;33;.943;3600000;0
15581;141978;983;0;0;0;0;.00nan;0;0
15582;1712;880;0;0;0;0;.00nan;0;0
15582;11670;957;0;0;0;0;.00nan;0;0
15582;168842;880;92;23;1;22;.957;3900000;0
15582;65823;957;91;30;1;29;.967;3900000;0
15583;7037;1415;0;0;0;0;.00nan;0;0
15583;28831;1415;82;35;2;33;.943;3600000;0
15583;176765;874;0;0;0;0;.00nan;0;0
15583;63107;874;67;39;5;34;.872;3600000;0
15584;779;966;66;25;2;23;.920;3600000;0
15584;196005;966;0;0;0;0;.00nan;0;0
15584;70099;890;48;37;6;31;.838;3600000;0
15584;157295;890;0;0;0;0;.00nan;0;0
15585;1712;880;100;27;0;27;1.000;3600000;0
15585;168842;880;0;0;0;0;.00nan;0;0
15585;62287;978;61;23;2;21;.913;3557000;0
15585;81096;978;0;0;0;0;.00nan;0;0
15586;162945;885;99;47;2;45;.957;3900000;0
15586;18104;891;0;0;0;0;.00nan;0;0
15586;62279;885;0;0;0;0;.00nan;0;0
15586;76885;891;69;26;2;24;.923;3900000;0
15587;11670;957;91;38;2;36;.947;3900000;0
15587;176765;874;79;27;2;25;.926;3899000;0
15587;63107;874;0;0;0;0;.00nan;0;0
15587;65823;957;0;0;0;0;.00nan;0;0
15588;7037;1415;0;0;0;0;.00nan;0;0
15588;28831;1415;86;41;3;38;.927;3600000;0
15588;62530;983;94;48;2;46;.958;3600000;0
15588;141978;983;0;0;0;0;.00nan;0;0
15589;5354;894;0;0;0;0;.00nan;0;0
15589;23251;994;54;16;2;14;.875;2356000;0
15589;57426;994;25;14;4;10;.714;1169000;0
15589;146386;894;60;35;4;31;.886;3600000;0
15590;779;966;60;13;1;12;.923;3600000;0
15590;196005;966;0;0;0;0;.00nan;0;0
15590;46905;945;0;0;0;0;.00nan;0;0
15590;146684;945;53;30;4;26;.867;3600000;0
15591;46905;945;0;0;0;0;.00nan;0;0
15591;70099;890;0;0;0;0;.00nan;0;0
15591;146684;945;61;36;3;33;.917;3600000;0
15591;157295;890;76;22;1;21;.955;3600000;0
15592;162945;885;47;15;3;12;.800;3543000;0
15592;23251;994;90;33;2;31;.939;3600000;0
15592;57426;994;0;0;0;0;.00nan;0;0
15592;62279;885;0;0;0;0;.00nan;0;0
15593;779;966;78;29;2;27;.931;3900000;0
15593;196005;966;0;0;0;0;.00nan;0;0
15593;62530;983;100;39;2;37;.949;3900000;0
15593;141978;983;0;0;0;0;.00nan;0;0
15594;1712;880;0;0;0;0;.00nan;0;0
15594;5354;894;0;0;0;0;.00nan;0;0
15594;168842;880;73;27;1;26;.963;3600000;0
15594;146386;894;54;39;6;33;.846;3600000;0
15595;11670;957;52;34;5;29;.853;2998000;0
15595;18104;891;0;0;0;0;.00nan;0;0
15595;65823;957;44;4;1;3;.750;602000;0
15595;76885;891;73;28;2;26;.929;3600000;0
15596;176765;874;0;0;0;0;.00nan;0;0
15596;37414;879;99;41;1;40;.976;3600000;0
15596;63107;874;45;27;4;23;.852;3579000;0
15596;148956;879;0;0;0;0;.00nan;0;0
15597;7037;1415;0;0;0;0;.00nan;0;0
15597;28831;1415;82;24;1;23;.958;3600000;0
15597;62287;978;0;0;0;0;.00nan;0;0
15597;81096;978;67;33;3;30;.909;3515000;0
15598;162945;885;35;29;6;23;.793;2032000;0
15598;37414;879;70;43;4;39;.907;3600000;0
15598;62279;885;53;17;2;15;.882;1568000;0
15598;148956;879;0;0;0;0;.00nan;0;0
15599;176765;874;41;15;3;12;.800;3600000;0
15599;63107;874;0;0;0;0;.00nan;0;0
15599;70099;890;55;46;6;40;.870;3600000;0
15599;157295;890;0;0;0;0;.00nan;0;0
15600;11670;957;58;27;3;24;.889;3708000;0
15600;62287;978;0;0;0;0;.00nan;0;0
15600;65823;957;0;0;0;0;.00nan;0;0
15600;81096;978;68;31;4;27;.871;3708000;0
15601;18104;891;0;0;0;0;.00nan;0;0
15601;23251;994;0;0;0;0;.00nan;0;0
15601;57426;994;55;28;3;25;.893;3900000;0
15601;76885;891;59;26;3;23;.885;3900000;0
15602;46905;945;0;0;0;0;.00nan;0;0
15602;62530;983;72;28;3;25;.893;3600000;0
15602;141978;983;0;0;0;0;.00nan;0;0
15602;146684;945;25;35;8;27;.771;3600000;0
15603;1712;880;0;0;0;0;.00nan;0;0
15603;7037;1415;0;0;0;0;.00nan;0;0
15603;168842;880;64;25;2;23;.920;3600000;0
15603;28831;1415;56;30;4;26;.867;3600000;0
15604;779;966;78;29;1;28;.966;3567000;0
15604;5354;894;100;37;0;37;1.000;3600000;0
15604;196005;966;0;0;0;0;.00nan;0;0
15604;146386;894;0;0;0;0;.00nan;0;0
15605;37414;879;0;0;0;0;.00nan;0;0
15605;70099;890;66;32;3;29;.906;3600000;0
15605;148956;879;48;25;4;21;.840;3547000;0
15605;157295;890;0;0;0;0;.00nan;0;0
15606;7037;1415;0;0;0;0;.00nan;0;0
15606;18104;891;0;0;0;0;.00nan;0;0
15606;28831;1415;71;19;1;18;.947;3600000;0
15606;76885;891;74;30;2;28;.933;3600000;0
15607;1712;880;0;0;0;0;.00nan;0;0
15607;168842;880;90;32;1;31;.969;3600000;0
15607;70099;890;80;33;3;30;.909;3574000;0
15607;157295;890;0;0;0;0;.00nan;0;0
15608;162945;885;50;26;4;22;.846;3600000;0
15608;46905;945;0;0;0;0;.00nan;0;0
15608;62279;885;0;0;0;0;.00nan;0;0
15608;146684;945;61;47;6;41;.872;3600000;0
15609;23251;994;0;0;0;0;.00nan;0;0
15609;176765;874;0;0;0;0;.00nan;0;0
15609;57426;994;92;45;3;42;.933;3600000;0
15609;63107;874;67;21;2;19;.905;3600000;0
15610;37414;879;89;38;2;36;.947;3900000;0
15610;62530;983;97;44;2;42;.955;3900000;0
15610;141978;983;0;0;0;0;.00nan;0;0
15610;148956;879;0;0;0;0;.00nan;0;0
15611;5354;894;86;29;2;27;.931;3600000;0
15611;62287;978;0;0;0;0;.00nan;0;0
15611;81096;978;51;27;4;23;.852;3517000;0
15611;146386;894;0;0;0;0;.00nan;0;0
15612;779;966;0;0;0;0;.00nan;0;0
15612;11670;957;58;32;4;28;.875;3584000;0
15612;196005;966;64;25;2;23;.920;3600000;0
15612;65823;957;0;0;0;0;.00nan;0;0
15613;162945;885;0;0;0;0;.00nan;0;0
15613;176765;874;60;28;4;24;.857;3869000;0
15613;62279;885;73;41;3;38;.927;3869000;0
15613;63107;874;0;0;0;0;.00nan;0;0
15614;62287;978;0;0;0;0;.00nan;0;0
15614;62530;983;76;28;2;26;.929;3900000;0
15614;81096;978;100;46;2;44;.957;3900000;0
15614;141978;983;0;0;0;0;.00nan;0;0
15615;23251;994;0;0;0;0;.00nan;0;0
15615;57426;994;73;20;1;19;.950;3600000;0
15615;70099;890;62;46;6;40;.870;3600000;0
15615;157295;890;0;0;0;0;.00nan;0;0
15616;779;966;59;28;4;24;.857;3849000;0
15616;1712;880;0;0;0;0;.00nan;0;0
15616;168842;880;78;38;3;35;.921;3849000;0
15616;196005;966;0;0;0;0;.00nan;0;0
15617;5354;894;0;0;0;0;.00nan;0;0
15617;11670;957;0;0;0;0;.00nan;0;0
15617;65823;957;98;24;0;24;1.000;3600000;0
15617;146386;894;80;30;2;28;.933;3575000;0
15618;18104;891;0;0;0;0;.00nan;0;0
15618;37414;879;97;42;2;40;.952;3900000;0
15618;76885;891;83;24;2;22;.917;3900000;0
15618;148956;879;0;0;0;0;.00nan;0;0
15619;7037;1415;0;0;0;0;.00nan;0;0
15619;28831;1415;36;29;5;24;.828;3555000;0
15619;46905;945;0;0;0;0;.00nan;0;0
15619;146684;945;68;39;4;35;.897;3600000;0
15621;46905;945;0;0;0;0;.00nan;0;0
15621;62530;983;0;0;0;0;.00nan;0;0
15621;141978;983;56;29;4;25;.862;3563000;0
15621;146684;945;81;33;2;31;.939;3600000;0
15623;1712;880;0;0;0;0;.00nan;0;0
15623;5354;894;0;0;0;0;.00nan;0;0
15623;168842;880;57;49;6;43;.878;3600000;0
15623;146386;894;70;20;1;19;.950;3600000;0
15625;11670;957;0;0;0;0;.00nan;0;0
15625;37414;879;100;27;0;27;1.000;3600000;0
15625;65823;957;87;31;1;30;.968;3548000;0
15625;148956;879;0;0;0;0;.00nan;0;0
15627;28831;1415;79;20;1;19;.950;3600000;0
15627;56306;1415;0;0;0;0;.00nan;0;0
15627;62287;978;43;45;7;38;.844;3600000;0
15627;81096;978;0;0;0;0;.00nan;0;0
15629;162945;885;73;37;3;34;.919;3600000;0
15629;44405;966;81;23;1;22;.957;3600000;0
15629;62279;885;0;0;0;0;.00nan;0;0
15629;154996;966;0;0;0;0;.00nan;0;0
15631;3256;891;41;16;3;13;.813;908000;0
15631;23251;994;0;0;0;0;.00nan;0;0
15631;57426;994;84;30;2;28;.933;3600000;0
15631;76885;891;16;28;7;21;.750;2692000;0
15633;7624;874;0;0;0;0;.00nan;0;0
15633;70099;890;70;39;3;36;.923;3600000;0
15633;147567;874;52;25;4;21;.840;3600000;0
15633;157295;890;0;0;0;0;.00nan;0;0
15635;3256;891;0;0;0;0;.00nan;0;0
15635;162945;885;0;0;0;0;.00nan;0;0
15635;62279;885;81;38;4;34;.895;3600000;0
15635;76885;891;66;36;5;31;.861;3543000;0
15637;62287;978;95;29;1;28;.966;3600000;0
15637;62530;983;79;35;3;32;.914;3600000;0
15637;81096;978;0;0;0;0;.00nan;0;0
15637;141978;983;0;0;0;0;.00nan;0;0
15639;37414;879;91;21;0;21;1.000;3600000;0
15639;70099;890;60;37;4;33;.892;3600000;0
15639;148956;879;0;0;0;0;.00nan;0;0
15639;157295;890;0;0;0;0;.00nan;0;0
15641;1712;880;0;0;0;0;.00nan;0;0
15641;7624;874;42;24;4;20;.833;3584000;0
15641;168842;880;72;32;3;29;.906;3600000;0
15641;147567;874;0;0;0;0;.00nan;0;0
15643;5354;894;0;0;0;0;.00nan;0;0
15643;44405;966;76;15;1;14;.933;3600000;0
15643;146386;894;98;49;2;47;.959;3546000;0
15643;154996;966;0;0;0;0;.00nan;0;0
15645;23251;994;0;0;0;0;.00nan;0;0
15645;46905;945;30;27;6;21;.778;2812000;0
15645;57426;994;57;12;1;11;.917;3600000;0
15645;146684;945;34;12;3;9;.750;788000;0
15647;11670;957;81;35;2;33;.943;3600000;0
15647;28831;1415;46;31;5;26;.839;3600000;0
15647;56306;1415;0;0;0;0;.00nan;0;0
15647;65823;957;0;0;0;0;.00nan;0;0
15649;162945;885;99;41;1;40;.976;3600000;0
15649;28831;1415;0;0;0;0;.00nan;0;0
15649;56306;1415;50;30;5;25;.833;3600000;0
15649;62279;885;0;0;0;0;.00nan;0;0
15651;11670;957;0;0;0;0;.00nan;0;0
15651;62287;978;0;0;0;0;.00nan;0;0
15651;65823;957;83;40;3;37;.925;3681000;0
15651;81096;978;55;29;4;25;.862;3681000;0
15653;3256;891;72;18;1;17;.944;3600000;0
15653;70099;890;0;0;0;0;.00nan;0;0
15653;76885;891;0;0;0;0;.00nan;0;0
15653;157295;890;55;32;4;28;.875;3600000;0
15655;23251;994;82;31;1;30;.968;3600000;0
15655;44405;966;48;20;3;17;.850;3556000;0
15655;57426;994;0;0;0;0;.00nan;0;0
15655;154996;966;0;0;0;0;.00nan;0;0
15657;1712;880;66;39;4;35;.897;3590000;0
15657;168842;880;0;0;0;0;.00nan;0;0
15657;46905;945;0;0;0;0;.00nan;0;0
15657;146684;945;65;24;2;22;.917;3600000;0
15659;7624;874;0;0;0;0;.00nan;0;0
15659;62530;983;0;0;0;0;.00nan;0;0
15659;141978;983;84;37;3;34;.919;3588000;0
15659;147567;874;72;18;1;17;.944;3600000;0
15661;5354;894;71;30;2;28;.933;3556000;0
15661;37414;879;100;25;0;25;1.000;3600000;0
15661;146386;894;0;0;0;0;.00nan;0;0
15661;148956;879;0;0;0;0;.00nan;0;0
15663;3256;891;0;0;0;0;.00nan;0;0
15663;5354;894;0;0;0;0;.00nan;0;0
15663;76885;891;57;26;3;23;.885;3522000;0
15663;146386;894;79;26;1;25;.962;3600000;0
15665;28831;1415;62;29;3;26;.897;3747000;0
15665;56306;1415;0;0;0;0;.00nan;0;0
15665;62287;978;0;0;0;0;.00nan;0;0
15665;81096;978;62;30;4;26;.867;3746000;0
15667;1712;880;0;0;0;0;.00nan;0;0
15667;168842;880;54;29;4;25;.862;3600000;0
15667;37414;879;26;24;6;18;.750;1615000;0
15667;148956;879;19;21;6;15;.714;1985000;0
15669;7624;874;63;28;3;25;.893;3600000;0
15669;11670;957;60;44;6;38;.864;3136000;0
15669;65823;957;55;5;0;5;1.000;464000;0
15669;147567;874;0;0;0;0;.00nan;0;0
15671;23251;994;0;0;0;0;.00nan;0;0
15671;46905;945;0;0;0;0;.00nan;0;0
15671;57426;994;49;21;4;17;.810;3600000;0
15671;146684;945;59;39;5;34;.872;3600000;0
15673;162945;885;55;7;0;7;1.000;606000;0
15673;62279;885;35;23;5;18;.783;3294000;0
15673;62530;983;71;48;5;43;.896;3900000;0
15673;141978;983;0;0;0;0;.00nan;0;0
15675;44405;966;71;22;2;20;.909;3600000;0
15675;70099;890;32;19;4;15;.789;1152000;0
15675;154996;966;0;0;0;0;.00nan;0;0
15675;157295;890;62;23;2;21;.913;2448000;0
15677;23251;994;61;25;3;22;.880;3600000;0
15677;28831;1415;0;0;0;0;.00nan;0;0
15677;56306;1415;50;35;5;30;.857;3583000;0
15677;57426;994;0;0;0;0;.00nan;0;0
15679;162945;885;40;29;5;24;.828;3600000;0
15679;11670;957;0;0;0;0;.00nan;0;0
15679;62279;885;0;0;0;0;.00nan;0;0
15679;65823;957;72;28;2;26;.929;3600000;0
15681;37414;879;74;28;2;26;.929;3600000;0
15681;44405;966;39;25;4;21;.840;3594000;0
15681;148956;879;0;0;0;0;.00nan;0;0
15681;154996;966;0;0;0;0;.00nan;0;0
15683;3256;891;78;27;2;25;.926;3600000;0
15683;62287;978;43;23;4;19;.826;1994000;0
15683;76885;891;0;0;0;0;.00nan;0;0
15683;81096;978;75;16;0;16;1.000;1553000;0
15685;5354;894;51;37;5;32;.865;3600000;0
15685;7624;874;50;1;0;1;1.000;278000;0
15685;146386;894;0;0;0;0;.00nan;0;0
15685;147567;874;23;25;6;19;.760;3265000;0
15687;62530;983;0;0;0;0;.00nan;0;0
15687;70099;890;45;20;4;16;.800;3900000;0
15687;141978;983;61;35;4;31;.886;3872000;0
15687;157295;890;0;0;0;0;.00nan;0;0
15689;1712;880;81;29;2;27;.931;3600000;0
15689;168842;880;0;0;0;0;.00nan;0;0
15689;46905;945;60;39;4;35;.897;3600000;0
15689;146684;945;0;0;0;0;.00nan;0;0
15691;196005;966;0;0;0;0;.00nan;0;0
15691;44405;966;69;18;1;17;.944;3600000;0
15691;70099;890;33;18;4;14;.778;1115000;0
15691;157295;890;64;24;2;22;.917;2485000;0
15693;5354;894;0;0;0;0;.00nan;0;0
15693;11670;957;87;45;3;42;.933;3900000;0
15693;65823;957;0;0;0;0;.00nan;0;0
15693;146386;894;66;35;3;32;.914;3900000;0
15695;20645;1415;0;0;0;0;.00nan;0;0
15695;28831;1415;45;15;3;12;.800;3900000;0
15695;62530;983;79;42;3;39;.929;3900000;0
15695;141978;983;0;0;0;0;.00nan;0;0
15697;46905;945;0;0;0;0;.00nan;0;0
15697;62287;978;0;0;0;0;.00nan;0;0
15697;81096;978;57;33;4;29;.879;3559000;0
15697;146684;945;81;35;2;33;.943;3600000;0
15699;7624;874;0;0;0;0;.00nan;0;0
15699;23251;994;0;0;0;0;.00nan;0;0
15699;57426;994;84;10;0;10;1.000;3600000;0
15699;147567;874;17;29;7;22;.759;3600000;0
15701;1712;880;0;0;0;0;.00nan;0;0
15701;162945;885;61;7;0;7;1.000;1564000;0
15701;168842;880;79;31;2;29;.935;3600000;0
15701;62279;885;34;25;5;20;.800;2036000;0
15703;3256;891;0;0;0;0;.00nan;0;0
15703;37414;879;70;14;0;14;1.000;1179000;0
15703;76885;891;68;32;3;29;.906;3600000;0
15703;148956;879;29;28;6;22;.786;2421000;0
15705;3256;891;0;0;0;0;.00nan;0;0
15705;20645;1415;65;31;3;28;.903;3900000;0
15705;28831;1415;0;0;0;0;.00nan;0;0
15705;76885;891;82;44;3;41;.932;3900000;0
15707;7624;874;74;28;2;26;.929;3600000;0
15707;70099;890;85;42;3;39;.929;3571000;0
15707;147567;874;0;0;0;0;.00nan;0;0
15707;157295;890;0;0;0;0;.00nan;0;0
15709;196005;966;41;20;4;16;.800;3600000;0
15709;44405;966;0;0;0;0;.00nan;0;0
15709;62287;978;71;49;6;43;.878;3568000;0
15709;81096;978;0;0;0;0;.00nan;0;0
15711;1712;880;57;26;3;23;.885;3573000;0
15711;168842;880;0;0;0;0;.00nan;0;0
15711;23251;994;0;0;0;0;.00nan;0;0
15711;57426;994;97;48;2;46;.958;3600000;0
15713;162945;885;86;37;2;35;.946;3600000;0
15713;37414;879;27;31;6;25;.806;3600000;0
15713;62279;885;0;0;0;0;.00nan;0;0
15713;148956;879;0;0;0;0;.00nan;0;0
15715;5354;894;76;29;2;27;.931;3577000;0
15715;62530;983;0;0;0;0;.00nan;0;0
15715;141978;983;91;28;1;27;.964;3600000;0
15715;146386;894;0;0;0;0;.00nan;0;0
15717;11670;957;0;0;0;0;.00nan;0;0
15717;46905;945;83;44;4;40;.909;3581000;0
15717;65823;957;69;32;3;29;.906;3600000;0
15717;146684;945;0;0;0;0;.00nan;0;0
272;23251;994;0;0;0;0;.00nan;0;0
272;57426;994;70;26;2;24;.923;3600000;0
272;62287;978;0;0;0;0;.00nan;0;0
272;81096;978;100;39;1;38;.974;3600000;0
273;5354;894;5;6;5;1;.167;686000;0
273;18104;891;0;0;0;0;.00nan;0;0
273;76885;891;56;23;3;20;.870;3600000;0
273;146386;894;69;39;5;34;.872;2914000;0
274;23251;994;0;0;0;0;.00nan;0;0
274;57426;994;57;20;3;17;.850;3600000;0
274;62287;978;0;0;0;0;.00nan;0;0
274;81096;978;70;36;4;32;.889;3600000;0
275;5354;894;0;0;0;0;.00nan;0;0
275;18104;891;0;0;0;0;.00nan;0;0
275;76885;891;74;26;2;24;.923;3547000;0
275;146386;894;86;24;1;23;.958;3600000;0
436;23251;994;0;0;0;0;.00nan;0;0
436;57426;994;72;27;2;25;.926;3600000;0
436;62287;978;0;0;0;0;.00nan;0;0
436;81096;978;65;42;5;37;.881;3600000;0
437;5354;894;0;0;0;0;.00nan;0;0
437;18104;891;0;0;0;0;.00nan;0;0
437;76885;891;73;21;1;20;.952;3600000;0
437;146386;894;81;29;2;27;.931;3584000;0
527;779;966;68;37;3;34;.919;4764000;0
527;18104;891;0;0;0;0;.00nan;0;0
527;196005;966;0;0;0;0;.00nan;0;0
527;76885;891;67;42;4;38;.905;4764000;0
528;1712;880;0;0;0;0;.00nan;0;0
528;162945;885;67;27;2;25;.926;4365000;0
528;168842;880;92;67;3;64;.955;4365000;0
528;62279;885;0;0;0;0;.00nan;0;0
529;7037;1415;0;0;0;0;.00nan;0;0
529;20645;1415;90;47;3;44;.936;4231000;0
529;37414;879;59;37;4;33;.892;4252000;0
529;148956;879;0;0;0;0;.00nan;0;0
530;23251;994;0;0;0;0;.00nan;0;0
530;176765;874;100;22;0;22;1.000;3600000;0
530;57426;994;94;35;1;34;.971;3574000;0
530;63107;874;0;0;0;0;.00nan;0;0
531;779;966;90;32;1;31;.969;3600000;0
531;18104;891;0;0;0;0;.00nan;0;0
531;196005;966;0;0;0;0;.00nan;0;0
531;76885;891;51;26;4;22;.846;3600000;0
532;1712;880;0;0;0;0;.00nan;0;0
532;162945;885;42;26;5;21;.808;3600000;0
532;168842;880;98;46;2;44;.957;3600000;0
532;62279;885;0;0;0;0;.00nan;0;0
533;7037;1415;61;27;3;24;.889;3545000;0
533;20645;1415;0;0;0;0;.00nan;0;0
533;37414;879;91;31;2;29;.935;3600000;0
533;148956;879;0;0;0;0;.00nan;0;0
534;23251;994;0;0;0;0;.00nan;0;0
534;176765;874;0;0;0;0;.00nan;0;0
534;57426;994;55;38;5;33;.868;3563000;0
534;63107;874;60;32;3;29;.906;3600000;0
535;779;966;98;62;2;60;.968;6675000;0
535;18104;891;0;0;0;0;.00nan;0;0
535;196005;966;0;0;0;0;.00nan;0;0
535;76885;891;92;56;3;53;.946;6675000;0
536;1712;880;71;12;0;12;1.000;1444000;0
536;162945;885;44;18;3;15;.833;3600000;0
536;168842;880;58;34;4;30;.882;2114000;0
536;62279;885;0;0;0;0;.00nan;0;0
537;7037;1415;66;35;4;31;.886;3600000;0
537;20645;1415;0;0;0;0;.00nan;0;0
537;37414;879;50;41;6;35;.854;3083000;0
537;148956;879;60;8;0;8;1.000;517000;0
538;23251;994;89;29;1;28;.966;2582000;0
538;176765;874;0;0;0;0;.00nan;0;0
538;57426;994;31;16;4;12;.750;1018000;0
538;63107;874;52;13;2;11;.846;3600000;0
539;779;966;92;73;4;69;.945;7633000;0
539;18104;891;0;0;0;0;.00nan;0;0
539;196005;966;0;0;0;0;.00nan;0;0
539;76885;891;73;49;3;46;.939;7633000;0
540;1712;880;77;27;2;25;.926;2552000;0
540;162945;885;80;20;1;19;.950;3600000;0
540;168842;880;22;12;4;8;.667;1048000;0
540;62279;885;0;0;0;0;.00nan;0;0
541;7037;1415;56;29;4;25;.862;3600000;0
541;20645;1415;0;0;0;0;.00nan;0;0
541;37414;879;56;39;5;34;.872;3533000;0
541;148956;879;0;0;0;0;.00nan;0;0
542;23251;994;0;0;0;0;.00nan;0;0
542;176765;874;0;0;0;0;.00nan;0;0
542;57426;994;64;37;4;33;.892;3600000;0
542;63107;874;98;21;0;21;1.000;3600000;0
680;779;966;70;32;3;29;.906;3600000;0
680;18104;891;0;0;0;0;.00nan;0;0
680;196005;966;0;0;0;0;.00nan;0;0
680;76885;891;93;20;0;20;1.000;3600000;0
681;1712;880;0;0;0;0;.00nan;0;0
681;162945;885;100;35;0;35;1.000;3600000;0
681;168842;880;98;42;2;40;.952;3547000;0
681;62279;885;0;0;0;0;.00nan;0;0
682;7037;1415;90;32;2;30;.938;3600000;0
682;20645;1415;0;0;0;0;.00nan;0;0
682;37414;879;67;30;3;27;.900;3600000;0
682;148956;879;0;0;0;0;.00nan;0;0
709;779;966;72;30;2;28;.933;3600000;0
709;18104;891;0;0;0;0;.00nan;0;0
709;196005;966;0;0;0;0;.00nan;0;0
709;76885;891;72;34;3;31;.912;3564000;0
879;779;966;82;57;4;53;.930;5311000;0
879;7037;1415;74;41;3;38;.927;5311000;0
879;20645;1415;0;0;0;0;.00nan;0;0
879;196005;966;0;0;0;0;.00nan;0;0
880;162945;885;59;29;3;26;.897;3546000;0
880;176765;874;0;0;0;0;.00nan;0;0
880;62279;885;0;0;0;0;.00nan;0;0
880;63107;874;72;19;1;18;.947;3600000;0
881;779;966;74;22;1;21;.955;3600000;0
881;7037;1415;67;25;2;23;.920;3560000;0
881;20645;1415;0;0;0;0;.00nan;0;0
881;196005;966;0;0;0;0;.00nan;0;0
882;162945;885;95;20;0;20;1.000;3600000;0
882;176765;874;0;0;0;0;.00nan;0;0
882;62279;885;0;0;0;0;.00nan;0;0
882;63107;874;54;25;3;22;.880;3600000;0
883;779;966;100;42;2;40;.952;3620000;0
883;7037;1415;72;33;3;30;.909;3620000;0
883;20645;1415;0;0;0;0;.00nan;0;0
883;196005;966;0;0;0;0;.00nan;0;0
884;162945;885;100;35;1;34;.971;3600000;0
884;176765;874;0;0;0;0;.00nan;0;0
884;62279;885;0;0;0;0;.00nan;0;0
884;63107;874;59;25;2;23;.920;3575000;0
885;779;966;49;31;5;26;.839;3600000;0
885;7037;1415;74;22;1;21;.955;3600000;0
885;20645;1415;0;0;0;0;.00nan;0;0
885;196005;966;0;0;0;0;.00nan;0;0
886;162945;885;100;31;0;31;1.000;3600000;0
886;176765;874;0;0;0;0;.00nan;0;0
886;62279;885;0;0;0;0;.00nan;0;0
886;63107;874;76;33;2;31;.939;3549000;0
1001;779;966;85;36;2;34;.944;4341000;0
1001;7037;1415;73;18;1;17;.944;4341000;0
1001;20645;1415;0;0;0;0;.00nan;0;0
1001;196005;966;0;0;0;0;.00nan;0;0
1002;162945;885;45;26;4;22;.846;3600000;0
1002;176765;874;0;0;0;0;.00nan;0;0
1002;62279;885;0;0;0;0;.00nan;0;0
1002;63107;874;100;30;0;30;1.000;3600000;0
1045;779;966;100;43;0;43;1.000;3600000;0
1045;7037;1415;70;19;1;18;.947;3600000;0
1045;20645;1415;0;0;0;0;.00nan;0;0
1045;196005;966;0;0;0;0;.00nan;0;0
1046;162945;885;100;24;0;24;1.000;3600000;0
1046;176765;874;0;0;0;0;.00nan;0;0
1046;62279;885;0;0;0;0;.00nan;0;0
1046;63107;874;85;28;1;27;.964;3557000;0
1084;779;966;47;31;5;26;.839;3600000;0
1084;7037;1415;100;29;0;29;1.000;3600000;0
1084;20645;1415;0;0;0;0;.00nan;0;0
1084;196005;966;0;0;0;0;.00nan;0;0
1133;162945;885;100;34;0;34;1.000;3600000;0
1133;7037;1415;47;31;5;26;.839;3600000;0
1133;20645;1415;0;0;0;0;.00nan;0;0
1133;62279;885;0;0;0;0;.00nan;0;0
1134;162945;885;73;29;2;27;.931;3600000;0
1134;7037;1415;73;38;4;34;.895;3542000;0
1134;20645;1415;0;0;0;0;.00nan;0;0
1134;62279;885;0;0;0;0;.00nan;0;0
1135;162945;885;77;18;1;17;.944;3600000;0
1135;7037;1415;98;45;3;42;.933;3521000;0
1135;20645;1415;0;0;0;0;.00nan;0;0
1135;62279;885;0;0;0;0;.00nan;0;0
1136;162945;885;97;46;2;44;.957;5444000;0
1136;7037;1415;88;46;3;43;.935;5480000;0
1136;20645;1415;0;0;0;0;.00nan;0;0
1136;62279;885;0;0;0;0;.00nan;0;0
15718;82087;768;0;0;0;0;.00nan;0;0
15718;82711;4924;0;0;0;0;.00nan;0;0
15718;86099;768;49;19;3;16;.842;3600000;0
15718;158630;4924;68;42;4;38;.905;3600000;0
15719;170543;4923;0;0;0;0;.00nan;0;0
15719;176686;4923;49;39;5;34;.872;3578000;0
15719;185775;772;67;24;3;21;.875;3600000;0
15719;94018;772;0;0;0;0;.00nan;0;0
15720;359;774;45;13;2;11;.846;3553000;0
15720;169615;4989;0;0;0;0;.00nan;0;0
15720;181910;774;0;0;0;0;.00nan;0;0
15720;76406;4989;100;28;0;28;1.000;3600000;0
15721;-1;766;80;29;1;28;.966;3600000;0
15721;169680;760;61;22;2;20;.909;3545000;0
15721;56037;760;0;0;0;0;.00nan;0;0
15721;91194;766;0;0;0;0;.00nan;0;0
15722;177124;2199;38;28;5;23;.821;3600000;0
15722;180990;1492;70;29;2;27;.931;3600000;0
15722;73639;1492;0;0;0;0;.00nan;0;0
15722;148576;2199;0;0;0;0;.00nan;0;0
15723;8504;746;85;23;1;22;.957;3900000;0
15723;-1;911;0;0;0;0;.00nan;0;0
15723;180177;911;90;31;1;30;.968;3900000;0
15723;49581;746;0;0;0;0;.00nan;0;0
15724;174894;762;76;25;2;23;.920;3600000;0
15724;148652;762;0;0;0;0;.00nan;0;0
15724;148904;1497;0;0;0;0;.00nan;0;0
15724;149191;1497;64;32;3;29;.906;3550000;0
15725;595;3913;78;24;1;23;.958;3600000;0
15725;197595;755;20;34;8;26;.765;3600000;0
15725;71485;755;0;0;0;0;.00nan;0;0
15725;82817;3913;0;0;0;0;.00nan;0;0
15726;6868;754;59;29;3;26;.897;3900000;0
15726;170547;769;89;41;3;38;.927;3900000;0
15726;45363;754;0;0;0;0;.00nan;0;0
15726;-1;769;0;0;0;0;.00nan;0;0
15727;67818;3721;77;24;1;23;.958;3585000;0
15727;82711;4924;0;0;0;0;.00nan;0;0
15727;149221;3721;0;0;0;0;.00nan;0;0
15727;158630;4924;100;26;0;26;1.000;3600000;0
15728;2140;1093;69;25;2;23;.920;3548000;0
15728;68233;1093;0;0;0;0;.00nan;0;0
15728;148829;2545;74;24;1;23;.958;3600000;0
15728;149112;2545;0;0;0;0;.00nan;0;0
15729;11614;775;72;26;2;24;.923;2416000;0
15729;82087;768;0;0;0;0;.00nan;0;0
15729;86099;768;93;22;0;22;1.000;3600000;0
15729;154296;775;24;14;4;10;.714;1184000;0
15730;164424;750;43;31;5;26;.839;3600000;0
15730;164521;750;0;0;0;0;.00nan;0;0
15730;66993;759;79;28;2;26;.929;3600000;0
15730;67446;759;0;0;0;0;.00nan;0;0
15731;177124;2199;70;32;3;29;.906;3600000;0
15731;170543;4923;43;34;5;29;.853;3586000;0
15731;176686;4923;0;0;0;0;.00nan;0;0
15731;148576;2199;0;0;0;0;.00nan;0;0
15732;595;3913;31;8;3;5;.625;506000;0
15732;180606;2197;0;0;0;0;.00nan;0;0
15732;82817;3913;86;24;0;24;1.000;3394000;0
15732;94508;2197;39;18;3;15;.833;3900000;0
15733;180990;1492;72;26;2;24;.923;3823000;0
15733;185775;772;83;29;1;28;.966;3823000;0
15733;73639;1492;0;0;0;0;.00nan;0;0
15733;94018;772;0;0;0;0;.00nan;0;0
15734;-1;911;0;0;0;0;.00nan;0;0
15734;174894;762;74;22;1;21;.955;3600000;0
15734;180177;911;71;32;3;29;.906;3600000;0
15734;148652;762;0;0;0;0;.00nan;0;0
15735;8504;746;88;21;0;21;1.000;3600000;0
15735;49581;746;0;0;0;0;.00nan;0;0
15735;148904;1497;0;0;0;0;.00nan;0;0
15735;149191;1497;27;35;7;28;.800;3600000;0
15736;504;3730;56;24;3;21;.875;3511000;0
15736;197595;755;0;0;0;0;.00nan;0;0
15736;71485;755;74;22;1;21;.955;3600000;0
15736;76628;3730;0;0;0;0;.00nan;0;0
15737;66993;759;81;13;0;13;1.000;3600000;0
15737;67446;759;0;0;0;0;.00nan;0;0
15737;91358;767;79;57;6;51;.895;3600000;0
15737;94107;767;0;0;0;0;.00nan;0;0
15738;67122;1503;0;0;0;0;.00nan;0;0
15738;68689;1503;65;19;2;17;.895;3900000;0
15738;82711;4924;0;0;0;0;.00nan;0;0
15738;158630;4924;76;28;2;26;.929;3900000;0
15739;2140;1093;63;19;2;17;.895;3900000;0
15739;63932;758;0;0;0;0;.00nan;0;0
15739;68233;1093;0;0;0;0;.00nan;0;0
15739;85395;758;88;41;2;39;.951;3900000;0
15740;11614;775;86;26;1;25;.962;3600000;0
15740;67818;3721;35;27;6;21;.778;2309000;0
15740;149221;3721;54;11;1;10;.909;1291000;0
15740;154296;775;0;0;0;0;.00nan;0;0
15741;164424;750;80;41;5;36;.878;3579000;0
15741;164521;750;0;0;0;0;.00nan;0;0
15741;82087;768;0;0;0;0;.00nan;0;0
15741;86099;768;77;31;3;28;.903;3600000;0
15742;504;3730;56;23;3;20;.870;3569000;0
15742;180606;2197;0;0;0;0;.00nan;0;0
15742;76628;3730;0;0;0;0;.00nan;0;0
15742;94508;2197;84;38;2;36;.947;3600000;0
15743;595;3913;72;34;3;31;.912;3600000;0
15743;-1;766;0;0;0;0;.00nan;0;0
15743;82817;3913;0;0;0;0;.00nan;0;0
15743;91194;766;88;36;2;34;.944;3600000;0
15744;359;774;83;26;2;24;.923;3600000;0
15744;-1;911;0;0;0;0;.00nan;0;0
15744;180177;911;51;32;5;27;.844;3600000;0
15744;181910;774;0;0;0;0;.00nan;0;0
15745;169615;4989;82;38;3;35;.921;3131000;0
15745;76406;4989;30;7;3;4;.571;469000;0
15745;148904;1497;0;0;0;0;.00nan;0;0
15745;149191;1497;72;27;2;25;.926;3600000;0
15746;170547;769;56;30;4;26;.867;3600000;0
15746;197595;755;50;37;6;31;.838;3283000;0
15746;-1;769;0;0;0;0;.00nan;0;0
15746;71485;755;53;3;0;3;1.000;293000;0
15747;82087;768;0;0;0;0;.00nan;0;0
15747;86099;768;61;11;2;9;.818;3600000;0
15747;91358;767;85;45;3;42;.933;3600000;0
15747;94107;767;0;0;0;0;.00nan;0;0
15748;63932;758;0;0;0;0;.00nan;0;0
15748;85395;758;80;29;2;27;.931;3600000;0
15748;148829;2545;73;30;3;27;.900;3564000;0
15748;149112;2545;0;0;0;0;.00nan;0;0
15749;66993;759;49;21;3;18;.857;3600000;0
15749;67446;759;0;0;0;0;.00nan;0;0
15749;82711;4924;0;0;0;0;.00nan;0;0
15749;158630;4924;64;42;4;38;.905;3542000;0
15750;11614;775;50;26;4;22;.846;3581000;0
15750;67122;1503;0;0;0;0;.00nan;0;0
15750;68689;1503;88;36;2;34;.944;3600000;0
15750;154296;775;0;0;0;0;.00nan;0;0
15751;164424;750;82;22;1;21;.955;3600000;0
15751;164521;750;0;0;0;0;.00nan;0;0
15751;67818;3721;68;35;3;32;.914;3529000;0
15751;149221;3721;0;0;0;0;.00nan;0;0
15752;177124;2199;0;0;0;0;.00nan;0;0
15752;8504;746;63;22;2;20;.909;3600000;0
15752;49581;746;0;0;0;0;.00nan;0;0
15752;148576;2199;73;37;3;34;.919;3553000;0
15753;170547;769;58;31;4;27;.871;3600000;0
15753;180606;2197;0;0;0;0;.00nan;0;0
15753;-1;769;0;0;0;0;.00nan;0;0
15753;94508;2197;91;32;1;31;.969;3600000;0
15754;504;3730;44;42;6;36;.857;2699000;0
15754;-1;766;0;0;0;0;.00nan;0;0
15754;76628;3730;54;7;1;6;.857;901000;0
15754;91194;766;87;18;0;18;1.000;3600000;0
15755;170543;4923;91;32;1;31;.969;3600000;0
15755;176686;4923;0;0;0;0;.00nan;0;0
15755;180990;1492;43;34;6;28;.824;3600000;0
15755;73639;1492;0;0;0;0;.00nan;0;0
15756;-1;911;0;0;0;0;.00nan;0;0
15756;169615;4989;0;0;0;0;.00nan;0;0
15756;180177;911;82;35;2;33;.943;3900000;0
15756;76406;4989;65;27;2;25;.926;3900000;0
15757;359;774;71;20;1;19;.950;3600000;0
15757;181910;774;0;0;0;0;.00nan;0;0
15757;148904;1497;0;0;0;0;.00nan;0;0
15757;149191;1497;61;36;4;32;.889;3600000;0
15758;595;3913;72;33;3;30;.909;3600000;0
15758;169680;760;0;0;0;0;.00nan;0;0
15758;56037;760;91;19;0;19;1.000;3600000;0
15758;82817;3913;0;0;0;0;.00nan;0;0
15759;6868;754;85;34;3;31;.912;3570000;0
15759;45363;754;0;0;0;0;.00nan;0;0
15759;197595;755;0;0;0;0;.00nan;0;0
15759;71485;755;76;31;2;29;.935;3600000;0
15760;67818;3721;75;28;2;26;.929;3600000;0
15760;91358;767;42;25;4;21;.840;3554000;0
15760;94107;767;0;0;0;0;.00nan;0;0
15760;149221;3721;0;0;0;0;.00nan;0;0
15761;11614;775;94;34;1;33;.971;3810000;0
15761;66993;759;60;19;2;17;.895;3810000;0
15761;67446;759;0;0;0;0;.00nan;0;0
15761;154296;775;0;0;0;0;.00nan;0;0
15762;164424;750;96;22;0;22;1.000;3600000;0
15762;164521;750;0;0;0;0;.00nan;0;0
15762;67122;1503;86;36;3;33;.917;3600000;0
15762;68689;1503;0;0;0;0;.00nan;0;0
15763;8504;746;70;21;1;20;.952;3600000;0
15763;185775;772;85;41;2;39;.951;3600000;0
15763;49581;746;0;0;0;0;.00nan;0;0
15763;94018;772;0;0;0;0;.00nan;0;0
15764;6868;754;66;38;5;33;.868;3600000;0
15764;180606;2197;0;0;0;0;.00nan;0;0
15764;45363;754;0;0;0;0;.00nan;0;0
15764;94508;2197;67;27;2;25;.926;3600000;0
15765;177124;2199;67;30;3;27;.900;3563000;0
15765;174894;762;0;0;0;0;.00nan;0;0
15765;148576;2199;0;0;0;0;.00nan;0;0
15765;148652;762;71;17;1;16;.941;3600000;0
15766;-1;766;0;0;0;0;.00nan;0;0
15766;170547;769;100;42;0;42;1.000;3600000;0
15766;-1;769;0;0;0;0;.00nan;0;0
15766;91194;766;42;23;4;19;.826;3600000;0
15767;504;3730;51;28;4;24;.857;3600000;0
15767;169680;760;0;0;0;0;.00nan;0;0
15767;56037;760;92;25;1;24;.960;3600000;0
15767;76628;3730;0;0;0;0;.00nan;0;0
15768;67122;1503;0;0;0;0;.00nan;0;0
15768;68689;1503;61;34;4;30;.882;3600000;0
15768;91358;767;87;29;1;28;.966;3600000;0
15768;94107;767;0;0;0;0;.00nan;0;0
15769;2140;1093;69;26;2;24;.923;3600000;0
15769;68233;1093;0;0;0;0;.00nan;0;0
15769;82711;4924;0;0;0;0;.00nan;0;0
15769;158630;4924;55;29;3;26;.897;3547000;0
15770;8504;746;91;30;2;28;.933;3600000;0
15770;180990;1492;29;31;6;25;.806;2833000;0
15770;49581;746;0;0;0;0;.00nan;0;0
15770;73639;1492;51;7;1;6;.857;767000;0
15771;177124;2199;25;7;3;4;.571;347000;0
15771;169615;4989;58;21;3;18;.857;3600000;0
15771;76406;4989;0;0;0;0;.00nan;0;0
15771;148576;2199;67;27;2;25;.926;3171000;0
15772;174894;762;45;26;4;22;.846;3600000;0
15772;185775;772;22;21;6;15;.714;3514000;0
15772;94018;772;0;0;0;0;.00nan;0;0
15772;148652;762;0;0;0;0;.00nan;0;0
15773;359;774;48;23;4;19;.826;3900000;0
15773;170543;4923;82;46;4;42;.913;3900000;0
15773;176686;4923;0;0;0;0;.00nan;0;0
15773;181910;774;0;0;0;0;.00nan;0;0
15774;6868;754;51;30;4;26;.867;3563000;0
15774;-1;766;84;40;2;38;.950;3600000;0
15774;45363;754;0;0;0;0;.00nan;0;0
15774;91194;766;0;0;0;0;.00nan;0;0
15775;197595;755;0;0;0;0;.00nan;0;0
15775;71485;755;63;40;5;35;.875;3600000;0
15775;82087;768;0;0;0;0;.00nan;0;0
15775;86099;768;80;25;1;24;.960;3600000;0
15776;169680;760;95;22;0;22;1.000;3600000;0
15776;170547;769;69;30;2;28;.933;3528000;0
15776;-1;769;0;0;0;0;.00nan;0;0
15776;56037;760;0;0;0;0;.00nan;0;0
15777;595;3913;0;0;0;0;.00nan;0;0
15777;82817;3913;81;32;2;30;.938;3600000;0
15777;148904;1497;0;0;0;0;.00nan;0;0
15777;149191;1497;97;41;3;38;.927;3543000;0
15778;82711;4924;0;0;0;0;.00nan;0;0
15778;148829;2545;0;0;0;0;.00nan;0;0
15778;149112;2545;53;23;3;20;.870;3600000;0
15778;158630;4924;54;37;5;32;.865;3555000;0
15779;2140;1093;79;20;1;19;.950;3600000;0
15779;11614;775;63;27;3;24;.889;3520000;0
15779;68233;1093;0;0;0;0;.00nan;0;0
15779;154296;775;0;0;0;0;.00nan;0;0
15780;8504;746;95;23;0;23;1.000;3600000;0
15780;170543;4923;0;0;0;0;.00nan;0;0
15780;176686;4923;53;29;4;25;.862;3600000;0
15780;49581;746;0;0;0;0;.00nan;0;0
15781;169615;4989;0;0;0;0;.00nan;0;0
15781;185775;772;64;16;2;14;.875;3600000;0
15781;76406;4989;85;49;4;45;.918;3600000;0
15781;94018;772;0;0;0;0;.00nan;0;0
15782;174894;762;51;24;3;21;.875;3600000;0
15782;180990;1492;46;42;6;36;.857;3600000;0
15782;73639;1492;0;0;0;0;.00nan;0;0
15782;148652;762;0;0;0;0;.00nan;0;0
15783;359;774;80;22;1;21;.955;3600000;0
15783;177124;2199;57;33;3;30;.909;3566000;0
15783;181910;774;0;0;0;0;.00nan;0;0
15783;148576;2199;0;0;0;0;.00nan;0;0
15784;180606;2197;0;0;0;0;.00nan;0;0
15784;82087;768;0;0;0;0;.00nan;0;0
15784;86099;768;93;22;0;22;1.000;3600000;0
15784;94508;2197;48;29;5;24;.828;3600000;0
15785;504;3730;68;34;4;30;.882;3545000;0
15785;76628;3730;0;0;0;0;.00nan;0;0
15785;148904;1497;0;0;0;0;.00nan;0;0
15785;149191;1497;60;16;2;14;.875;3600000;0
15786;6868;754;55;28;4;24;.857;3600000;0
15786;169680;760;63;28;3;25;.893;3600000;0
15786;45363;754;0;0;0;0;.00nan;0;0
15786;56037;760;0;0;0;0;.00nan;0;0
15787;595;3913;93;46;3;43;.935;3600000;0
15787;-1;911;0;0;0;0;.00nan;0;0
15787;180177;911;85;16;0;16;1.000;3600000;0
15787;82817;3913;0;0;0;0;.00nan;0;0
15788;197595;755;49;47;6;41;.872;3600000;0
15788;67818;3721;0;0;0;0;.00nan;0;0
15788;71485;755;0;0;0;0;.00nan;0;0
15788;149221;3721;60;19;2;17;.895;3600000;0
15789;11614;775;64;33;4;29;.879;3230000;0
15789;148829;2545;40;31;6;25;.806;3155000;0
15789;149112;2545;47;6;1;5;.833;397000;0
15789;154296;775;44;3;1;2;.667;370000;0
15790;63932;758;0;0;0;0;.00nan;0;0
15790;82711;4924;0;0;0;0;.00nan;0;0
15790;85395;758;64;37;5;32;.865;3600000;0
15790;158630;4924;57;20;2;18;.900;3600000;0
15791;2140;1093;85;29;1;28;.966;3600000;0
15791;164424;750;61;24;2;22;.917;3600000;0
15791;164521;750;0;0;0;0;.00nan;0;0
15791;68233;1093;0;0;0;0;.00nan;0;0
15792;169615;4989;0;0;0;0;.00nan;0;0
15792;180990;1492;72;10;0;10;1.000;3600000;0
15792;73639;1492;0;0;0;0;.00nan;0;0
15792;76406;4989;71;46;5;41;.891;3600000;0
15793;170547;769;67;31;4;27;.871;3600000;0
15793;-1;769;0;0;0;0;.00nan;0;0
15793;148904;1497;0;0;0;0;.00nan;0;0
15793;149191;1497;100;36;1;35;.972;3600000;0
15794;170543;4923;38;23;4;19;.826;3519000;0
15794;174894;762;80;30;2;28;.933;3600000;0
15794;176686;4923;0;0;0;0;.00nan;0;0
15794;148652;762;0;0;0;0;.00nan;0;0
15795;359;774;0;0;0;0;.00nan;0;0
15795;181910;774;100;29;0;29;1.000;3600000;0
15795;185775;772;0;0;0;0;.00nan;0;0
15795;57993;772;61;29;3;26;.897;3600000;0
15796;-1;766;72;27;2;25;.926;3600000;0
15796;82087;768;0;0;0;0;.00nan;0;0
15796;86099;768;66;13;1;12;.923;3600000;0
15796;91194;766;0;0;0;0;.00nan;0;0
15797;504;3730;71;36;3;33;.917;3600000;0
15797;-1;911;0;0;0;0;.00nan;0;0
15797;180177;911;77;10;0;10;1.000;3600000;0
15797;76628;3730;0;0;0;0;.00nan;0;0
15798;180606;2197;0;0;0;0;.00nan;0;0
15798;67818;3721;80;24;1;23;.958;3600000;0
15798;94508;2197;89;36;2;34;.944;3600000;0
15798;149221;3721;0;0;0;0;.00nan;0;0
15799;197595;755;0;0;0;0;.00nan;0;0
15799;66993;759;36;14;3;11;.786;3571000;0
15799;67446;759;0;0;0;0;.00nan;0;0
15799;71485;755;100;49;1;48;.980;3600000;0
15800;164424;750;45;44;6;38;.864;3600000;0
15800;164521;750;0;0;0;0;.00nan;0;0
15800;148829;2545;99;33;2;31;.939;3600000;0
15800;149112;2545;0;0;0;0;.00nan;0;0
15801;11614;775;59;21;2;19;.905;3600000;0
15801;63932;758;0;0;0;0;.00nan;0;0
15801;85395;758;31;33;6;27;.818;3600000;0
15801;154296;775;0;0;0;0;.00nan;0;0
15802;2140;1093;65;28;3;25;.893;3574000;0
15802;68233;1093;0;0;0;0;.00nan;0;0
15802;91358;767;77;23;1;22;.957;3600000;0
15802;94107;767;0;0;0;0;.00nan;0;0
15803;197595;755;84;34;2;32;.941;3900000;0
15803;67122;1503;88;28;2;26;.929;3900000;0
15803;68689;1503;0;0;0;0;.00nan;0;0
15803;71485;755;0;0;0;0;.00nan;0;0
15804;169615;4989;0;0;0;0;.00nan;0;0
15804;170543;4923;61;27;3;24;.889;3600000;0
15804;176686;4923;0;0;0;0;.00nan;0;0
15804;76406;4989;99;38;2;36;.947;3600000;0
15805;-1;911;0;0;0;0;.00nan;0;0
15805;170547;769;60;35;4;31;.886;3598000;0
15805;180177;911;69;19;2;17;.895;3600000;0
15805;-1;769;0;0;0;0;.00nan;0;0
15806;359;774;52;28;4;24;.857;3600000;0
15806;180990;1492;99;27;0;27;1.000;3600000;0
15806;181910;774;0;0;0;0;.00nan;0;0
15806;73639;1492;0;0;0;0;.00nan;0;0
15807;56037;760;0;0;0;0;.00nan;0;0
15807;82087;768;0;0;0;0;.00nan;0;0
15807;85489;760;69;56;6;50;.893;3600000;0
15807;86099;768;82;13;0;13;1.000;3600000;0
15808;-1;766;100;28;0;28;1.000;3600000;0
15808;67818;3721;83;25;1;24;.960;3597000;0
15808;91194;766;0;0;0;0;.00nan;0;0
15808;149221;3721;0;0;0;0;.00nan;0;0
15809;595;3913;97;23;0;23;1.000;3900000;0
15809;177124;2199;0;0;0;0;.00nan;0;0
15809;82817;3913;0;0;0;0;.00nan;0;0
15809;148576;2199;97;35;0;35;1.000;3900000;0
15810;6868;754;85;39;3;36;.923;3600000;0
15810;45363;754;0;0;0;0;.00nan;0;0
15810;148904;1497;0;0;0;0;.00nan;0;0
15810;149191;1497;51;28;4;24;.857;3589000;0
15811;180606;2197;0;0;0;0;.00nan;0;0
15811;66993;759;0;0;0;0;.00nan;0;0
15811;67446;759;53;18;3;15;.833;3600000;0
15811;94508;2197;54;33;4;29;.879;3576000;0
15812;91358;767;97;34;1;33;.971;3600000;0
15812;94107;767;0;0;0;0;.00nan;0;0
15812;148829;2545;84;23;1;22;.957;3040000;0
15812;149112;2545;29;8;3;5;.625;560000;0
15813;164424;750;60;29;3;26;.897;3600000;0
15813;164521;750;0;0;0;0;.00nan;0;0
15813;63932;758;0;0;0;0;.00nan;0;0
15813;85395;758;57;34;4;30;.882;3600000;0
15814;180606;2197;0;0;0;0;.00nan;0;0
15814;67122;1503;0;0;0;0;.00nan;0;0
15814;68689;1503;82;42;2;40;.952;3900000;0
15814;94508;2197;87;30;2;28;.933;3900000;0
15815;8504;746;90;32;2;30;.938;3600000;0
15815;174894;762;62;36;3;33;.917;3592000;0
15815;49581;746;0;0;0;0;.00nan;0;0
15815;148652;762;0;0;0;0;.00nan;0;0
15816;595;3913;79;24;1;23;.958;3577000;0
15816;185775;772;0;0;0;0;.00nan;0;0
15816;57993;772;92;22;0;22;1.000;3600000;0
15816;82817;3913;0;0;0;0;.00nan;0;0
15817;56037;760;0;0;0;0;.00nan;0;0
15817;67818;3721;0;0;0;0;.00nan;0;0
15817;85489;760;77;27;2;25;.926;3900000;0
15817;149221;3721;84;32;2;30;.938;3900000;0
15818;504;3730;100;26;0;26;1.000;3600000;0
15818;177124;2199;0;0;0;0;.00nan;0;0
15818;76628;3730;0;0;0;0;.00nan;0;0
15818;148576;2199;68;28;2;26;.929;3548000;0
15819;6868;754;0;0;0;0;.00nan;0;0
15819;-1;911;0;0;0;0;.00nan;0;0
15819;180177;911;70;26;2;24;.923;3560000;0
15819;45363;754;88;31;1;30;.968;3600000;0
15820;-1;766;43;39;6;33;.846;3066000;0
15820;66993;759;61;19;2;17;.895;3600000;0
15820;67446;759;0;0;0;0;.00nan;0;0
15820;91194;766;40;2;1;1;.500;534000;0
15821;63932;758;0;0;0;0;.00nan;0;0
15821;85395;758;68;27;2;25;.926;3600000;0
15821;91358;767;30;32;6;26;.813;3600000;0
15821;94107;767;0;0;0;0;.00nan;0;0
15822;-1;766;72;32;4;28;.875;3600000;0
15822;67122;1503;100;23;0;23;1.000;3600000;0
15822;68689;1503;0;0;0;0;.00nan;0;0
15822;91194;766;0;0;0;0;.00nan;0;0
15823;169615;4989;55;28;3;25;.893;3600000;0
15823;174894;762;99;38;2;36;.947;3600000;0
15823;76406;4989;0;0;0;0;.00nan;0;0
15823;148652;762;0;0;0;0;.00nan;0;0
15824;595;3913;50;23;4;19;.826;3900000;0
15824;170543;4923;0;0;0;0;.00nan;0;0
15824;176686;4923;77;41;4;37;.902;3900000;0
15824;82817;3913;0;0;0;0;.00nan;0;0
15825;359;774;65;35;4;31;.886;3600000;0
15825;8504;746;78;25;1;24;.960;3600000;0
15825;181910;774;0;0;0;0;.00nan;0;0
15825;49581;746;0;0;0;0;.00nan;0;0
15826;82087;768;0;0;0;0;.00nan;0;0
15826;86099;768;90;36;2;34;.944;3586000;0
15826;148904;1497;0;0;0;0;.00nan;0;0
15826;149191;1497;74;23;1;22;.957;3600000;0
15827;504;3730;50;26;4;22;.846;3563000;0
15827;185775;772;0;0;0;0;.00nan;0;0
15827;57993;772;63;25;2;23;.920;3600000;0
15827;76628;3730;0;0;0;0;.00nan;0;0
15828;2140;1093;80;30;2;28;.933;3653000;0
15828;197595;755;0;0;0;0;.00nan;0;0
15828;68233;1093;0;0;0;0;.00nan;0;0
15828;71485;755;78;17;1;16;.941;3653000;0
15829;177124;2199;0;0;0;0;.00nan;0;0
15829;170547;769;54;34;4;30;.882;3600000;0
15829;-1;769;0;0;0;0;.00nan;0;0
15829;148576;2199;76;25;2;23;.920;3600000;0
15830;56037;760;0;0;0;0;.00nan;0;0
15830;66993;759;77;16;1;15;.938;3900000;0
15830;67446;759;0;0;0;0;.00nan;0;0
15830;85489;760;89;33;1;32;.970;3900000;0
15831;11614;775;29;12;4;8;.667;1118000;0
15831;82711;4924;99;24;0;24;1.000;3600000;0
15831;154296;775;62;18;1;17;.944;2482000;0
15831;158630;4924;0;0;0;0;.00nan;0;0
15832;56037;760;0;0;0;0;.00nan;0;0
15832;67122;1503;0;0;0;0;.00nan;0;0
15832;68689;1503;55;35;4;31;.886;3900000;0
15832;85489;760;55;29;4;25;.862;3900000;0
15833;8504;746;95;17;0;17;1.000;3600000;0
15833;169615;4989;0;0;0;0;.00nan;0;0
15833;49581;746;0;0;0;0;.00nan;0;0
15833;76406;4989;92;43;3;40;.930;3600000;0
15834;504;3730;67;41;4;37;.902;3600000;0
15834;170543;4923;78;23;1;22;.957;3600000;0
15834;176686;4923;0;0;0;0;.00nan;0;0
15834;76628;3730;0;0;0;0;.00nan;0;0
15835;2140;1093;90;26;1;25;.962;3600000;0
15835;180606;2197;0;0;0;0;.00nan;0;0
15835;68233;1093;0;0;0;0;.00nan;0;0
15835;94508;2197;70;35;4;31;.886;3600000;0
15836;359;774;72;15;1;14;.933;3600000;0
15836;174894;762;23;25;6;19;.760;1974000;0
15836;181910;774;0;0;0;0;.00nan;0;0
15836;148652;762;54;18;2;16;.889;1626000;0
15837;595;3913;77;24;2;22;.917;3600000;0
15837;180990;1492;56;28;3;25;.893;3553000;0
15837;73639;1492;0;0;0;0;.00nan;0;0
15837;82817;3913;0;0;0;0;.00nan;0;0
15838;-1;911;0;0;0;0;.00nan;0;0
15838;180177;911;27;34;7;27;.794;3600000;0
15838;82087;768;0;0;0;0;.00nan;0;0
15838;86099;768;95;37;1;36;.973;3600000;0
15839;67818;3721;0;0;0;0;.00nan;0;0
15839;148904;1497;0;0;0;0;.00nan;0;0
15839;149191;1497;69;38;4;34;.895;3588000;0
15839;149221;3721;65;25;2;23;.920;3600000;0
15840;170547;769;84;46;4;42;.913;3809000;0
15840;185775;772;0;0;0;0;.00nan;0;0
15840;-1;769;0;0;0;0;.00nan;0;0
15840;57993;772;78;35;3;32;.914;3809000;0
15841;197595;755;23;13;4;9;.692;649000;0
15841;71485;755;78;28;1;27;.964;2867000;0
15841;148829;2545;65;25;3;22;.880;3600000;0
15841;149112;2545;0;0;0;0;.00nan;0;0
15842;177124;2199;40;21;4;17;.810;3600000;0
15842;6868;754;72;23;2;21;.913;3600000;0
15842;45363;754;0;0;0;0;.00nan;0;0
15842;148576;2199;0;0;0;0;.00nan;0;0
15843;164424;750;44;29;5;24;.828;3600000;0
15843;164521;750;0;0;0;0;.00nan;0;0
15843;82711;4924;95;34;1;33;.971;3600000;0
15843;158630;4924;0;0;0;0;.00nan;0;0
15844;170543;4923;0;0;0;0;.00nan;0;0
15844;170547;769;70;29;2;27;.931;3540000;0
15844;176686;4923;100;26;0;26;1.000;3600000;0
15844;-1;769;0;0;0;0;.00nan;0;0
15845;180606;2197;0;0;0;0;.00nan;0;0
15845;94508;2197;83;34;2;32;.941;3556000;0
15845;148829;2545;73;20;1;19;.950;3600000;0
15845;149112;2545;0;0;0;0;.00nan;0;0
15846;2140;1093;90;31;2;29;.935;3900000;0
15846;-1;766;87;30;2;28;.933;3900000;0
15846;68233;1093;0;0;0;0;.00nan;0;0
15846;91194;766;0;0;0;0;.00nan;0;0
15847;504;3730;96;34;1;33;.971;3600000;0
15847;180990;1492;42;25;4;21;.840;3600000;0
15847;73639;1492;0;0;0;0;.00nan;0;0
15847;76628;3730;0;0;0;0;.00nan;0;0
15848;-1;911;0;0;0;0;.00nan;0;0
15848;180177;911;70;28;2;26;.929;3808000;0
15848;67818;3721;71;32;3;29;.906;3808000;0
15848;149221;3721;0;0;0;0;.00nan;0;0
15849;66993;759;23;17;5;12;.706;3600000;0
15849;67446;759;0;0;0;0;.00nan;0;0
15849;148904;1497;67;15;1;14;.933;1036000;0
15849;149191;1497;14;18;6;12;.667;2517000;0
15850;6868;754;79;28;1;27;.964;3584000;0
15850;185775;772;0;0;0;0;.00nan;0;0
15850;45363;754;0;0;0;0;.00nan;0;0
15850;57993;772;92;22;0;22;1.000;3600000;0
15851;197595;755;87;24;1;23;.958;3600000;0
15851;63932;758;0;0;0;0;.00nan;0;0
15851;71485;755;0;0;0;0;.00nan;0;0
15851;85395;758;70;31;2;29;.935;3559000;0
15852;82711;4924;0;0;0;0;.00nan;0;0
15852;91358;767;94;22;0;22;1.000;3600000;0
15852;94107;767;0;0;0;0;.00nan;0;0
15852;158630;4924;61;34;3;31;.912;3600000;0
15853;164424;750;99;34;1;33;.971;3600000;0
15853;164521;750;0;0;0;0;.00nan;0;0
15853;11614;775;0;0;0;0;.00nan;0;0
15853;154296;775;65;27;2;25;.926;3552000;0
15854;6868;754;68;37;4;33;.892;3566000;0
15854;170543;4923;0;0;0;0;.00nan;0;0
15854;176686;4923;76;29;2;27;.931;3600000;0
15854;45363;754;0;0;0;0;.00nan;0;0
15855;180606;2197;54;3;0;3;1.000;353000;0
15855;63932;758;0;0;0;0;.00nan;0;0
15855;85395;758;52;23;3;20;.870;3600000;0
15855;94508;2197;40;40;7;33;.825;3247000;0
15856;-1;766;89;32;1;31;.969;3600000;0
15856;91194;766;0;0;0;0;.00nan;0;0
15856;148829;2545;52;23;3;20;.870;3584000;0
15856;149112;2545;0;0;0;0;.00nan;0;0
15857;170547;769;99;37;1;36;.973;3600000;0
15857;180990;1492;40;28;5;23;.821;3600000;0
15857;-1;769;0;0;0;0;.00nan;0;0
15857;73639;1492;0;0;0;0;.00nan;0;0
15858;177124;2199;0;0;0;0;.00nan;0;0
15858;82087;768;0;0;0;0;.00nan;0;0
15858;86099;768;98;21;0;21;1.000;3600000;0
15858;148576;2199;87;50;3;47;.940;3600000;0
15859;-1;911;0;0;0;0;.00nan;0;0
15859;180177;911;100;49;2;47;.959;3900000;0
15859;66993;759;54;18;2;16;.889;3900000;0
15859;67446;759;0;0;0;0;.00nan;0;0
15860;67122;1503;0;0;0;0;.00nan;0;0
15860;68689;1503;80;30;2;28;.933;3600000;0
15860;148904;1497;67;19;1;18;.947;3600000;0
15860;149191;1497;0;0;0;0;.00nan;0;0
15861;2140;1093;51;18;2;16;.889;3900000;0
15861;56037;760;85;42;2;40;.952;3900000;0
15861;68233;1093;0;0;0;0;.00nan;0;0
15861;85489;760;0;0;0;0;.00nan;0;0
15862;11614;775;93;17;0;17;1.000;3600000;0
15862;91358;767;57;20;2;18;.900;3515000;0
15862;94107;767;0;0;0;0;.00nan;0;0
15862;154296;775;0;0;0;0;.00nan;0;0
15863;-1;766;88;25;1;24;.960;3600000;0
15863;63932;758;0;0;0;0;.00nan;0;0
15863;85395;758;81;35;3;32;.914;3600000;0
15863;91194;766;0;0;0;0;.00nan;0;0
15864;6868;754;67;34;3;31;.912;3900000;0
15864;180990;1492;56;25;3;22;.880;3900000;0
15864;45363;754;0;0;0;0;.00nan;0;0
15864;73639;1492;0;0;0;0;.00nan;0;0
15865;185775;772;0;0;0;0;.00nan;0;0
15865;57993;772;46;32;5;27;.844;3578000;0
15865;82087;768;0;0;0;0;.00nan;0;0
15865;86099;768;49;21;3;18;.857;3600000;0
15866;-1;911;0;0;0;0;.00nan;0;0
15866;180177;911;86;16;0;16;1.000;3600000;0
15866;67122;1503;0;0;0;0;.00nan;0;0
15866;68689;1503;96;29;1;28;.966;3577000;0
15867;504;3730;70;33;3;30;.909;3570000;0
15867;174894;762;62;21;2;19;.905;3600000;0
15867;76628;3730;0;0;0;0;.00nan;0;0
15867;148652;762;0;0;0;0;.00nan;0;0
15868;56037;760;0;0;0;0;.00nan;0;0
15868;85489;760;88;30;2;28;.933;3600000;0
15868;148829;2545;65;16;1;15;.938;3600000;0
15868;149112;2545;0;0;0;0;.00nan;0;0
15869;595;3913;76;36;2;34;.944;3545000;0
15869;8504;746;85;27;1;26;.963;3600000;0
15869;49581;746;0;0;0;0;.00nan;0;0
15869;82817;3913;0;0;0;0;.00nan;0;0
15870;177124;2199;73;33;4;29;.879;3644000;0
15870;67818;3721;75;31;3;28;.903;3644000;0
15870;148576;2199;0;0;0;0;.00nan;0;0
15870;149221;3721;0;0;0;0;.00nan;0;0
15871;197595;755;91;36;1;35;.972;3600000;0
15871;71485;755;0;0;0;0;.00nan;0;0
15871;82711;4924;46;5;1;4;.800;1433000;0
15871;158630;4924;23;18;5;13;.722;2167000;0
15872;164424;750;73;27;2;25;.926;3600000;0
15872;164521;750;0;0;0;0;.00nan;0;0
15872;91358;767;43;25;4;21;.840;3600000;0
15872;94107;767;0;0;0;0;.00nan;0;0
15873;170547;769;100;39;1;38;.974;3900000;0
15873;174894;762;55;7;1;6;.857;3900000;0
15873;-1;769;0;0;0;0;.00nan;0;0
15873;148652;762;0;0;0;0;.00nan;0;0
15874;170543;4923;47;41;6;35;.854;3600000;0
15874;176686;4923;0;0;0;0;.00nan;0;0
15874;82087;768;61;22;2;20;.909;3600000;0
15874;86099;768;0;0;0;0;.00nan;0;0
15875;504;3730;63;37;4;33;.892;3600000;0
15875;8504;746;85;41;3;38;.927;3600000;0
15875;49581;746;0;0;0;0;.00nan;0;0
15875;76628;3730;0;0;0;0;.00nan;0;0
15876;56037;760;0;0;0;0;.00nan;0;0
15876;63932;758;0;0;0;0;.00nan;0;0
15876;85395;758;70;29;2;27;.931;3600000;0
15876;85489;760;49;30;4;26;.867;3543000;0
15877;359;774;59;32;4;28;.875;3518000;0
15877;595;3913;100;40;2;38;.950;3600000;0
15877;181910;774;0;0;0;0;.00nan;0;0
15877;82817;3913;0;0;0;0;.00nan;0;0
15878;185775;772;0;0;0;0;.00nan;0;0
15878;57993;772;74;46;4;42;.913;3900000;0
15878;67818;3721;0;0;0;0;.00nan;0;0
15878;149221;3721;52;26;4;22;.846;3900000;0
15879;177124;2199;0;0;0;0;.00nan;0;0
15879;66993;759;70;25;2;23;.920;3600000;0
15879;67446;759;0;0;0;0;.00nan;0;0
15879;148576;2199;56;51;7;44;.863;3600000;0
15880;180606;2197;0;0;0;0;.00nan;0;0
15880;82711;4924;98;29;2;27;.931;3900000;0
15880;94508;2197;66;27;2;25;.926;3900000;0
15880;158630;4924;0;0;0;0;.00nan;0;0
15881;2140;1093;0;0;0;0;.00nan;0;0
15881;68233;1093;58;23;3;20;.870;3600000;0
15881;148904;1497;0;0;0;0;.00nan;0;0
15881;149191;1497;75;41;4;37;.902;3558000;0
15882;11614;775;70;21;1;20;.952;3593000;0
15882;197595;755;0;0;0;0;.00nan;0;0
15882;71485;755;100;36;0;36;1.000;3600000;0
15882;154296;775;0;0;0;0;.00nan;0;0
15883;177124;2199;60;27;3;24;.889;3600000;0
15883;67122;1503;49;31;4;27;.871;3543000;0
15883;68689;1503;0;0;0;0;.00nan;0;0
15883;148576;2199;0;0;0;0;.00nan;0;0
15884;8504;746;40;22;4;18;.818;3600000;0
15884;170547;769;91;36;1;35;.972;3600000;0
15884;-1;769;0;0;0;0;.00nan;0;0
15884;49581;746;0;0;0;0;.00nan;0;0
15885;180990;1492;99;42;1;41;.976;3600000;0
15885;73639;1492;0;0;0;0;.00nan;0;0
15885;82087;768;0;0;0;0;.00nan;0;0
15885;86099;768;54;22;3;19;.864;3512000;0
15886;359;774;73;30;3;27;.900;3600000;0
15886;504;3730;0;0;0;0;.00nan;0;0
15886;181910;774;0;0;0;0;.00nan;0;0
15886;76628;3730;45;32;5;27;.844;3585000;0
15887;595;3913;73;29;3;26;.897;3600000;0
15887;169615;4989;0;0;0;0;.00nan;0;0
15887;76406;4989;36;22;5;17;.773;3541000;0
15887;82817;3913;0;0;0;0;.00nan;0;0
15888;170543;4923;0;0;0;0;.00nan;0;0
15888;176686;4923;93;51;4;47;.922;3574000;0
15888;67818;3721;62;18;2;16;.889;3600000;0
15888;149221;3721;0;0;0;0;.00nan;0;0
15889;6868;754;0;0;0;0;.00nan;0;0
15889;174894;762;87;31;2;29;.935;3900000;0
15889;45363;754;75;30;2;28;.933;3900000;0
15889;148652;762;0;0;0;0;.00nan;0;0
15890;185775;772;0;0;0;0;.00nan;0;0
15890;57993;772;57;27;3;24;.889;3600000;0
15890;66993;759;91;17;0;17;1.000;3600000;0
15890;67446;759;0;0;0;0;.00nan;0;0
15891;197595;755;0;0;0;0;.00nan;0;0
15891;71485;755;72;24;1;23;.958;3900000;0
15891;91358;767;0;0;0;0;.00nan;0;0
15891;94107;767;95;33;1;32;.970;3900000;0
15892;148829;2545;0;0;0;0;.00nan;0;0
15892;148904;1497;0;0;0;0;.00nan;0;0
15892;149112;2545;76;25;1;24;.960;3600000;0
15892;149191;1497;78;37;4;33;.892;3600000;0
15893;-1;766;56;15;2;13;.867;3600000;0
15893;82711;4924;53;3;0;3;1.000;529000;0
15893;91194;766;0;0;0;0;.00nan;0;0
15893;158630;4924;68;47;6;41;.872;3071000;0
15894;2140;1093;100;35;2;33;.943;3900000;0
15894;-1;911;0;0;0;0;.00nan;0;0
15894;180177;911;67;22;2;20;.909;3900000;0
15894;68233;1093;0;0;0;0;.00nan;0;0
15895;11614;775;0;0;0;0;.00nan;0;0
15895;180606;2197;0;0;0;0;.00nan;0;0
15895;94508;2197;98;49;4;45;.918;3586000;0
15895;154296;775;57;24;3;21;.875;3600000;0
15896;185775;772;0;0;0;0;.00nan;0;0
15896;57993;772;62;20;2;18;.900;3900000;0
15896;67122;1503;0;0;0;0;.00nan;0;0
15896;68689;1503;72;39;2;37;.949;3900000;0
15897;359;774;47;39;5;34;.872;3600000;0
15897;170547;769;93;41;1;40;.976;3600000;0
15897;181910;774;0;0;0;0;.00nan;0;0
15897;-1;769;0;0;0;0;.00nan;0;0
15898;504;3730;76;29;2;27;.931;3600000;0
15898;169615;4989;0;0;0;0;.00nan;0;0
15898;76406;4989;84;38;3;35;.921;3569000;0
15898;76628;3730;0;0;0;0;.00nan;0;0
15899;595;3913;62;28;3;25;.893;3571000;0
15899;174894;762;0;0;0;0;.00nan;0;0
15899;82817;3913;0;0;0;0;.00nan;0;0
15899;148652;762;90;31;2;29;.935;3600000;0
15900;180990;1492;76;49;4;45;.918;3600000;0
15900;67818;3721;0;0;0;0;.00nan;0;0
15900;73639;1492;0;0;0;0;.00nan;0;0
15900;149221;3721;91;31;1;30;.968;3600000;0
15901;6868;754;41;37;6;31;.838;3600000;0
15901;8504;746;71;18;1;17;.944;3600000;0
15901;201933;746;0;0;0;0;.00nan;0;0
15901;45363;754;0;0;0;0;.00nan;0;0
15902;170543;4923;48;43;7;36;.837;3178000;0
15902;176686;4923;60;6;0;6;1.000;422000;0
15902;66993;759;51;28;4;24;.857;3600000;0
15902;67446;759;0;0;0;0;.00nan;0;0
15903;180606;2197;0;0;0;0;.00nan;0;0
15903;91358;767;70;27;2;25;.926;3600000;0
15903;94107;767;0;0;0;0;.00nan;0;0
15903;94508;2197;73;40;3;37;.925;3595000;0
15904;-1;911;0;0;0;0;.00nan;0;0
15904;180177;911;68;31;4;27;.871;3665000;0
15904;148829;2545;0;0;0;0;.00nan;0;0
15904;149112;2545;42;26;5;21;.808;3665000;0
15905;56037;760;0;0;0;0;.00nan;0;0
15905;82711;4924;0;0;0;0;.00nan;0;0
15905;85489;760;56;26;3;23;.885;3580000;0
15905;158630;4924;87;30;2;28;.933;3600000;0
15906;63932;758;72;32;2;30;.938;3900000;0
15906;85395;758;0;0;0;0;.00nan;0;0
15906;148904;1497;0;0;0;0;.00nan;0;0
15906;149191;1497;79;30;2;28;.933;3900000;0
15907;11614;775;23;34;7;27;.794;3600000;0
15907;-1;766;74;29;2;27;.931;3600000;0
15907;91194;766;0;0;0;0;.00nan;0;0
15907;154296;775;0;0;0;0;.00nan;0;0
15908;164424;750;0;0;0;0;.00nan;0;0
15908;164521;750;72;23;2;21;.913;3900000;0
15908;197595;755;0;0;0;0;.00nan;0;0
15908;71485;755;65;28;2;26;.929;3900000;0
15909;170543;4923;0;0;0;0;.00nan;0;0
15909;176686;4923;100;30;0;30;1.000;3600000;0
15909;67122;1503;72;21;1;20;.952;3574000;0
15909;68689;1503;0;0;0;0;.00nan;0;0
15910;169615;4989;0;0;0;0;.00nan;0;0
15910;170547;769;0;0;0;0;.00nan;0;0
15910;-1;769;59;30;4;26;.867;3900000;0
15910;76406;4989;61;34;4;30;.882;3900000;0
15911;359;774;67;28;3;25;.893;3600000;0
15911;6868;754;37;20;4;16;.800;3551000;0
15911;181910;774;0;0;0;0;.00nan;0;0
15911;45363;754;0;0;0;0;.00nan;0;0
15912;180990;1492;63;41;5;36;.878;3586000;0
15912;66993;759;56;23;3;20;.870;3600000;0
15912;67446;759;0;0;0;0;.00nan;0;0
15912;73639;1492;0;0;0;0;.00nan;0;0
15913;-1;766;0;0;0;0;.00nan;0;0
15913;91194;766;70;32;3;29;.906;3543000;0
15913;91358;767;59;22;2;20;.909;3600000;0
15913;94107;767;0;0;0;0;.00nan;0;0
15914;-1;911;0;0;0;0;.00nan;0;0
15914;180177;911;52;20;2;18;.900;3600000;0
15914;63932;758;0;0;0;0;.00nan;0;0
15914;85395;758;81;46;3;43;.935;3600000;0
15915;11614;775;0;0;0;0;.00nan;0;0
15915;56037;760;0;0;0;0;.00nan;0;0
15915;85489;760;72;23;1;22;.957;3600000;0
15915;154296;775;69;24;2;22;.917;3554000;0
15916;164424;750;70;24;1;23;.958;3600000;0
15916;164521;750;0;0;0;0;.00nan;0;0
15916;180606;2197;0;0;0;0;.00nan;0;0
15916;94508;2197;89;32;2;30;.938;3600000;0
15917;177124;2199;0;0;0;0;.00nan;0;0
15917;2140;1093;95;35;1;34;.971;3600000;0
15917;68233;1093;0;0;0;0;.00nan;0;0
15917;148576;2199;69;23;2;21;.913;3572000;0
15918;180990;1492;100;32;1;31;.969;3600000;0
15918;67122;1503;49;28;4;24;.857;3600000;0
15918;68689;1503;0;0;0;0;.00nan;0;0
15918;73639;1492;0;0;0;0;.00nan;0;0
15919;8504;746;59;42;7;35;.833;3600000;0
15919;201933;746;0;0;0;0;.00nan;0;0
15919;67818;3721;0;0;0;0;.00nan;0;0
15919;149221;3721;74;28;2;26;.929;3600000;0
15920;6868;754;77;37;3;34;.919;3600000;0
15920;169615;4989;0;0;0;0;.00nan;0;0
15920;45363;754;0;0;0;0;.00nan;0;0
15920;76406;4989;100;24;0;24;1.000;3600000;0
15921;56037;760;0;0;0;0;.00nan;0;0
15921;85489;760;64;47;5;42;.894;3600000;0
15921;91358;767;88;16;0;16;1.000;3600000;0
15921;94107;767;0;0;0;0;.00nan;0;0
15922;82711;4924;0;0;0;0;.00nan;0;0
15922;148904;1497;0;0;0;0;.00nan;0;0
15922;149191;1497;72;26;2;24;.923;3579000;0
15922;158630;4924;79;26;1;25;.962;3600000;0
15923;2140;1093;23;16;6;10;.625;1914000;0
15923;185775;772;0;0;0;0;.00nan;0;0
15923;57993;772;68;20;1;19;.950;3600000;0
15923;68233;1093;54;11;1;10;.909;1686000;0
15924;164424;750;79;20;1;19;.950;3600000;0
15924;164521;750;0;0;0;0;.00nan;0;0
15924;-1;766;53;25;3;22;.880;3591000;0
15924;91194;766;0;0;0;0;.00nan;0;0
15925;177124;2199;59;28;3;25;.893;3553000;0
15925;148576;2199;0;0;0;0;.00nan;0;0
15925;148829;2545;59;18;2;16;.889;3600000;0
15925;149112;2545;0;0;0;0;.00nan;0;0
15926;8504;746;85;30;2;28;.933;3900000;0
15926;201933;746;0;0;0;0;.00nan;0;0
15926;82087;768;0;0;0;0;.00nan;0;0
15926;86099;768;83;32;2;30;.938;3900000;0
15927;174894;762;74;31;2;29;.935;3900000;0
15927;67818;3721;52;21;2;19;.905;3900000;0
15927;148652;762;0;0;0;0;.00nan;0;0
15927;149221;3721;0;0;0;0;.00nan;0;0
15928;359;774;59;25;3;22;.880;3562000;0
15928;181910;774;0;0;0;0;.00nan;0;0
15928;66993;759;67;24;2;22;.917;3600000;0
15928;67446;759;0;0;0;0;.00nan;0;0
15929;2140;1093;65;41;4;37;.902;3669000;0
15929;170543;4923;64;36;5;31;.861;3669000;0
15929;176686;4923;0;0;0;0;.00nan;0;0
15929;68233;1093;0;0;0;0;.00nan;0;0
15930;-1;911;0;0;0;0;.00nan;0;0
15930;180177;911;72;26;3;23;.885;3600000;0
15930;82711;4924;0;0;0;0;.00nan;0;0
15930;158630;4924;42;32;5;27;.844;3574000;0
15931;11614;775;0;0;0;0;.00nan;0;0
15931;148904;1497;82;32;2;30;.938;3900000;0
15931;149191;1497;0;0;0;0;.00nan;0;0
15931;154296;775;72;29;2;27;.931;3900000;0
15932;185775;772;0;0;0;0;.00nan;0;0
15932;57993;772;49;20;3;17;.850;3573000;0
15932;148829;2545;79;35;2;33;.943;3600000;0
15932;149112;2545;0;0;0;0;.00nan;0;0
15933;164424;750;50;28;4;24;.857;3550000;0
15933;164521;750;0;0;0;0;.00nan;0;0
15933;56037;760;0;0;0;0;.00nan;0;0
15933;85489;760;74;33;3;30;.909;3600000;0
15934;177124;2199;0;0;0;0;.00nan;0;0
15934;63932;758;0;0;0;0;.00nan;0;0
15934;85395;758;66;33;4;29;.879;3886000;0
15934;148576;2199;73;35;4;31;.886;3900000;0
15935;8504;746;66;27;3;24;.889;3563000;0
15935;201933;746;0;0;0;0;.00nan;0;0
15935;67122;1503;74;30;2;28;.933;3600000;0
15935;68689;1503;0;0;0;0;.00nan;0;0
15936;169615;4989;0;0;0;0;.00nan;0;0
15936;66993;759;71;15;1;14;.933;3600000;0
15936;67446;759;0;0;0;0;.00nan;0;0
15936;76406;4989;84;51;5;46;.902;3600000;0
15937;180606;2197;69;38;4;34;.895;3577000;0
15937;197595;755;0;0;0;0;.00nan;0;0
15937;71485;755;65;26;2;24;.923;3600000;0
15937;94508;2197;0;0;0;0;.00nan;0;0
15938;174894;762;97;32;1;31;.969;3600000;0
15938;82087;768;0;0;0;0;.00nan;0;0
15938;86099;768;64;28;3;25;.893;3571000;0
15938;148652;762;0;0;0;0;.00nan;0;0
15939;359;774;55;28;5;23;.821;3600000;0
15939;181910;774;0;0;0;0;.00nan;0;0
15939;67818;3721;76;25;1;24;.960;3600000;0
15939;149221;3721;0;0;0;0;.00nan;0;0
15940;504;3730;79;24;1;23;.958;3600000;0
15940;170547;769;57;34;4;30;.882;3600000;0
15940;-1;769;0;0;0;0;.00nan;0;0
15940;76628;3730;0;0;0;0;.00nan;0;0
15941;595;3913;67;34;3;31;.912;3600000;0
15941;6868;754;58;37;6;31;.838;3600000;0
15941;45363;754;0;0;0;0;.00nan;0;0
15941;82817;3913;0;0;0;0;.00nan;0;0
15942;170543;4923;0;0;0;0;.00nan;0;0
15942;176686;4923;63;28;3;25;.893;3600000;0
15942;148829;2545;43;20;4;16;.800;3570000;0
15942;149112;2545;0;0;0;0;.00nan;0;0
15943;2140;1093;65;25;2;23;.920;3600000;0
15943;180990;1492;43;22;4;18;.818;3546000;0
15943;68233;1093;0;0;0;0;.00nan;0;0
15943;73639;1492;0;0;0;0;.00nan;0;0
15944;11614;775;75;30;2;28;.933;3582000;0
15944;-1;911;0;0;0;0;.00nan;0;0
15944;180177;911;81;27;1;26;.963;3600000;0
15944;154296;775;0;0;0;0;.00nan;0;0
15945;91358;767;87;34;1;33;.971;3594000;0
15945;94107;767;0;0;0;0;.00nan;0;0
15945;148904;1497;0;0;0;0;.00nan;0;0
15945;149191;1497;100;26;0;26;1.000;3600000;0
15946;185775;772;0;0;0;0;.00nan;0;0
15946;57993;772;45;29;4;25;.862;3586000;0
15946;63932;758;0;0;0;0;.00nan;0;0
15946;85395;758;77;31;2;29;.935;3600000;0
15947;8504;746;67;37;3;34;.919;3555000;0
15947;201933;746;0;0;0;0;.00nan;0;0
15947;66993;759;100;36;1;35;.972;3600000;0
15947;67446;759;0;0;0;0;.00nan;0;0
15948;169615;4989;42;23;4;19;.826;3340000;0
15948;67818;3721;98;21;0;21;1.000;3600000;0
15948;76406;4989;50;2;0;2;1.000;260000;0
15948;149221;3721;0;0;0;0;.00nan;0;0
15949;174894;762;54;10;1;9;.900;3600000;0
15949;67122;1503;0;0;0;0;.00nan;0;0
15949;68689;1503;47;34;5;29;.853;3600000;0
15949;148652;762;0;0;0;0;.00nan;0;0
15950;359;774;76;27;1;26;.963;3600000;0
15950;181910;774;0;0;0;0;.00nan;0;0
15950;82087;768;0;0;0;0;.00nan;0;0
15950;86099;768;58;17;2;15;.882;3563000;0
15951;-1;766;48;15;2;13;.867;3600000;0
15951;197595;755;0;0;0;0;.00nan;0;0
15951;71485;755;70;30;3;27;.900;3580000;0
15951;91194;766;0;0;0;0;.00nan;0;0
15952;504;3730;58;41;5;36;.878;3600000;0
15952;6868;754;57;17;2;15;.882;3600000;0
15952;45363;754;0;0;0;0;.00nan;0;0
15952;76628;3730;0;0;0;0;.00nan;0;0
15953;595;3913;96;31;1;30;.968;3600000;0
15953;170547;769;81;35;2;33;.943;3600000;0
15953;-1;769;0;0;0;0;.00nan;0;0
15953;82817;3913;0;0;0;0;.00nan;0;0
15954;170543;4923;64;17;1;16;.941;3600000;0
15954;176686;4923;0;0;0;0;.00nan;0;0
15954;63932;758;0;0;0;0;.00nan;0;0
15954;85395;758;67;32;4;28;.875;3600000;0
15955;180990;1492;88;28;1;27;.964;3900000;0
15955;73639;1492;0;0;0;0;.00nan;0;0
15955;148829;2545;79;20;1;19;.950;3900000;0
15955;149112;2545;0;0;0;0;.00nan;0;0
15956;-1;911;0;0;0;0;.00nan;0;0
15956;180177;911;75;21;1;20;.952;3555000;0
15956;91358;767;100;30;0;30;1.000;3600000;0
15956;94107;767;0;0;0;0;.00nan;0;0
15957;164424;750;74;22;1;21;.955;3600000;0
15957;164521;750;0;0;0;0;.00nan;0;0
15957;148904;1497;0;0;0;0;.00nan;0;0
15957;149191;1497;35;19;4;15;.789;3600000;0
15958;169615;4989;0;0;0;0;.00nan;0;0
15958;76406;4989;98;44;2;42;.955;3600000;0
15958;82087;768;0;0;0;0;.00nan;0;0
15958;86099;768;76;21;1;20;.952;3600000;0
15959;174894;762;0;0;0;0;.00nan;0;0
15959;66993;759;100;25;0;25;1.000;3600000;0
15959;67446;759;0;0;0;0;.00nan;0;0
15959;148652;762;74;37;3;34;.919;3600000;0
15960;359;774;100;30;0;30;1.000;3600000;0
15960;181910;774;0;0;0;0;.00nan;0;0
15960;67122;1503;60;36;4;32;.889;3600000;0
15960;68689;1503;0;0;0;0;.00nan;0;0
15961;-1;766;0;0;0;0;.00nan;0;0
15961;180606;2197;0;0;0;0;.00nan;0;0
15961;91194;766;75;24;2;22;.917;3900000;0
15961;94508;2197;66;27;2;25;.926;3900000;0
15962;177124;2199;82;38;2;36;.947;3568000;0
15962;82711;4924;95;23;0;23;1.000;3600000;0
15962;148576;2199;0;0;0;0;.00nan;0;0
15962;158630;4924;0;0;0;0;.00nan;0;0
15963;197595;755;0;0;0;0;.00nan;0;0
15963;56037;760;69;21;1;20;.952;3600000;0
15963;71485;755;61;30;3;27;.900;3553000;0
15963;85489;760;0;0;0;0;.00nan;0;0
15964;180990;1492;74;20;1;19;.950;3600000;0
15964;63932;758;52;2;0;2;1.000;746000;0
15964;73639;1492;0;0;0;0;.00nan;0;0
15964;85395;758;24;32;7;25;.781;2854000;0
15965;164424;750;57;24;3;21;.875;3573000;0
15965;164521;750;0;0;0;0;.00nan;0;0
15965;-1;911;0;0;0;0;.00nan;0;0
15965;180177;911;78;27;2;25;.926;3600000;0
15966;169615;4989;0;0;0;0;.00nan;0;0
15966;67122;1503;0;0;0;0;.00nan;0;0
15966;68689;1503;55;19;2;17;.895;3618000;0
15966;76406;4989;62;26;3;23;.885;3618000;0
15967;185775;772;0;0;0;0;.00nan;0;0
15967;57993;772;92;38;1;37;.974;3600000;0
15967;82711;4924;74;35;3;32;.914;3555000;0
15967;158630;4924;0;0;0;0;.00nan;0;0
15968;180606;2197;0;0;0;0;.00nan;0;0
15968;56037;760;0;0;0;0;.00nan;0;0
15968;85489;760;64;20;2;18;.900;3648000;0
15968;94508;2197;100;33;1;32;.970;3648000;0
15969;2140;1093;0;0;0;0;.00nan;0;0
15969;8504;746;72;22;1;21;.955;3600000;0
15969;201933;746;0;0;0;0;.00nan;0;0
15969;68233;1093;51;29;4;25;.862;3600000;0
15970;177124;2199;0;0;0;0;.00nan;0;0
15970;11614;775;96;35;1;34;.971;3600000;0
15970;148576;2199;67;27;2;25;.926;3571000;0
15970;154296;775;0;0;0;0;.00nan;0;0
15971;504;3730;45;37;5;32;.865;3600000;0
15971;67818;3721;95;22;0;22;1.000;3600000;0
15971;76628;3730;0;0;0;0;.00nan;0;0
15971;149221;3721;0;0;0;0;.00nan;0;0
15972;177124;2199;0;0;0;0;.00nan;0;0
15972;91358;767;88;39;2;37;.949;3515000;0
15972;94107;767;0;0;0;0;.00nan;0;0
15972;148576;2199;96;22;0;22;1.000;3600000;0
15973;8504;746;47;27;5;22;.815;3600000;0
15973;201933;746;0;0;0;0;.00nan;0;0
15973;148829;2545;0;0;0;0;.00nan;0;0
15973;149112;2545;100;37;1;36;.973;3600000;0
15974;170543;4923;0;0;0;0;.00nan;0;0
15974;176686;4923;61;34;4;30;.882;3565000;0
15974;82711;4924;0;0;0;0;.00nan;0;0
15974;158630;4924;67;27;2;25;.926;3600000;0
15975;2140;1093;91;32;2;30;.938;3900000;0
15975;174894;762;61;16;2;14;.875;3900000;0
15975;68233;1093;0;0;0;0;.00nan;0;0
15975;148652;762;0;0;0;0;.00nan;0;0
15976;197595;755;76;46;4;42;.913;3543000;0
15976;71485;755;0;0;0;0;.00nan;0;0
15976;148904;1497;0;0;0;0;.00nan;0;0
15976;149191;1497;51;18;3;15;.833;3600000;0
15977;11614;775;0;0;0;0;.00nan;0;0
15977;185775;772;0;0;0;0;.00nan;0;0
15977;57993;772;72;22;1;21;.955;3600000;0
15977;154296;775;63;37;3;34;.919;3553000;0
15978;504;3730;67;26;2;24;.923;3600000;0
15978;76628;3730;0;0;0;0;.00nan;0;0
15978;82087;768;0;0;0;0;.00nan;0;0
15978;86099;768;48;23;3;20;.870;3600000;0
15979;595;3913;96;35;1;34;.971;3600000;0
15979;67818;3721;60;31;3;28;.903;3541000;0
15979;82817;3913;0;0;0;0;.00nan;0;0
15979;149221;3721;0;0;0;0;.00nan;0;0
15980;180606;2197;0;0;0;0;.00nan;0;0
15980;94508;2197;81;40;3;37;.925;3532000;0
15980;148904;1497;0;0;0;0;.00nan;0;0
15980;149191;1497;82;30;1;29;.967;3600000;0
15981;185775;772;0;0;0;0;.00nan;0;0
15981;57993;772;67;32;3;29;.906;3600000;0
15981;91358;767;100;31;1;30;.968;3600000;0
15981;94107;767;0;0;0;0;.00nan;0;0
15982;174894;762;0;0;0;0;.00nan;0;0
15982;148652;762;77;23;1;22;.957;3600000;0
15982;148829;2545;0;0;0;0;.00nan;0;0
15982;149112;2545;91;30;2;28;.933;3560000;0
15983;180990;1492;64;27;3;24;.889;3590000;0
15983;73639;1492;0;0;0;0;.00nan;0;0
15983;82711;4924;0;0;0;0;.00nan;0;0
15983;158630;4924;69;30;2;28;.933;3600000;0
15984;8504;746;77;15;0;15;1.000;3600000;0
15984;201933;746;0;0;0;0;.00nan;0;0
15984;63932;758;37;36;6;30;.833;2589000;0
15984;85395;758;47;10;2;8;.800;1011000;0
15985;2140;1093;61;30;3;27;.900;3600000;0
15985;169615;4989;58;5;0;5;1.000;2007000;0
15985;68233;1093;0;0;0;0;.00nan;0;0
15985;76406;4989;35;32;6;26;.813;1593000;0
15986;-1;911;0;0;0;0;.00nan;0;0
15986;180177;911;60;27;3;24;.889;3557000;0
15986;197595;755;0;0;0;0;.00nan;0;0
15986;71485;755;78;30;2;28;.933;3600000;0
15987;11614;775;0;0;0;0;.00nan;0;0
15987;170543;4923;71;39;3;36;.923;3900000;0
15987;176686;4923;0;0;0;0;.00nan;0;0
15987;154296;775;62;29;3;26;.897;3900000;0
15988;177124;2199;0;0;0;0;.00nan;0;0
15988;164424;750;0;0;0;0;.00nan;0;0
15988;164521;750;59;14;1;13;.929;3600000;0
15988;148576;2199;76;34;3;31;.912;3600000;0
15989;504;3730;80;43;5;38;.884;3600000;0
15989;67122;1503;72;26;2;24;.923;3600000;0
15989;68689;1503;0;0;0;0;.00nan;0;0
15989;76628;3730;0;0;0;0;.00nan;0;0
15990;595;3913;66;28;3;25;.893;3516000;0
15990;82087;768;0;0;0;0;.00nan;0;0
15990;82817;3913;0;0;0;0;.00nan;0;0
15990;86099;768;61;17;1;16;.941;3600000;0
15991;6868;754;93;43;3;40;.930;3600000;0
15991;45363;754;0;0;0;0;.00nan;0;0
15991;67818;3721;82;15;0;15;1.000;3600000;0
15991;149221;3721;0;0;0;0;.00nan;0;0
15992;170547;769;87;38;3;35;.921;3551000;0
15992;-1;769;0;0;0;0;.00nan;0;0
15992;66993;759;61;17;2;15;.882;3600000;0
15992;67446;759;0;0;0;0;.00nan;0;0
15993;-1;911;0;0;0;0;.00nan;0;0
15993;180177;911;47;22;3;19;.864;3545000;0
15993;180606;2197;0;0;0;0;.00nan;0;0
15993;94508;2197;71;26;2;24;.923;3600000;0
15994;170543;4923;66;34;4;30;.882;3900000;0
15994;176686;4923;0;0;0;0;.00nan;0;0
15994;91358;767;61;27;4;23;.852;3900000;0
15994;94107;767;0;0;0;0;.00nan;0;0
15995;169615;4989;0;0;0;0;.00nan;0;0
15995;76406;4989;33;30;6;24;.800;3600000;0
15995;148829;2545;75;32;2;30;.938;3600000;0
15995;149112;2545;0;0;0;0;.00nan;0;0
15996;56037;760;0;0;0;0;.00nan;0;0
15996;85489;760;73;41;4;37;.902;3600000;0
15996;148904;1497;0;0;0;0;.00nan;0;0
15996;149191;1497;71;16;1;15;.938;3600000;0
15997;174894;762;74;10;0;10;1.000;3600000;0
15997;63932;758;0;0;0;0;.00nan;0;0
15997;85395;758;62;25;2;23;.920;3545000;0
15997;148652;762;0;0;0;0;.00nan;0;0
15998;359;774;40;19;3;16;.842;3549000;0
15998;2140;1093;85;31;2;29;.935;3600000;0
15998;181910;774;0;0;0;0;.00nan;0;0
15998;68233;1093;0;0;0;0;.00nan;0;0
15999;11614;775;64;36;4;32;.889;3600000;0
15999;180990;1492;23;23;6;17;.739;3516000;0
15999;73639;1492;0;0;0;0;.00nan;0;0
15999;154296;775;0;0;0;0;.00nan;0;0
16000;164424;750;57;18;2;16;.889;3600000;0
16000;164521;750;0;0;0;0;.00nan;0;0
16000;185775;772;0;0;0;0;.00nan;0;0
16000;57993;772;93;32;1;31;.969;3600000;0
16001;595;3913;62;23;3;20;.870;3600000;0
16001;67122;1503;0;0;0;0;.00nan;0;0
16001;68689;1503;36;29;5;24;.828;3518000;0
16001;82817;3913;0;0;0;0;.00nan;0;0
16002;6868;754;74;47;5;42;.894;3600000;0
16002;45363;754;0;0;0;0;.00nan;0;0
16002;82087;768;0;0;0;0;.00nan;0;0
16002;86099;768;62;13;1;12;.923;3600000;0
16003;170547;769;57;34;4;30;.882;3600000;0
16003;-1;769;0;0;0;0;.00nan;0;0
16003;67818;3721;54;16;2;14;.875;3600000;0
16003;149221;3721;0;0;0;0;.00nan;0;0
16004;504;3730;83;34;2;32;.941;3578000;0
16004;66993;759;89;32;1;31;.969;3600000;0
16004;67446;759;0;0;0;0;.00nan;0;0
16004;76628;3730;0;0;0;0;.00nan;0;0
16005;180990;1492;75;32;3;29;.906;3600000;0
16005;73639;1492;0;0;0;0;.00nan;0;0
16005;91358;767;89;27;1;26;.963;3600000;0
16005;94107;767;0;0;0;0;.00nan;0;0
16006;359;774;46;39;6;33;.846;3600000;0
16006;181910;774;0;0;0;0;.00nan;0;0
16006;148829;2545;0;0;0;0;.00nan;0;0
16006;149112;2545;85;34;2;32;.941;3600000;0
16007;-1;766;75;26;2;24;.923;3600000;0
16007;91194;766;0;0;0;0;.00nan;0;0
16007;148904;1497;0;0;0;0;.00nan;0;0
16007;149191;1497;58;29;3;26;.897;3600000;0
16008;-1;911;0;0;0;0;.00nan;0;0
16008;180177;911;50;37;5;32;.865;3600000;0
16008;56037;760;0;0;0;0;.00nan;0;0
16008;85489;760;79;14;0;14;1.000;3600000;0
16009;169615;4989;0;0;0;0;.00nan;0;0
16009;63932;758;0;0;0;0;.00nan;0;0
16009;76406;4989;49;19;3;16;.842;3600000;0
16009;85395;758;73;41;4;37;.902;3567000;0
16010;164424;750;74;30;2;28;.933;3600000;0
16010;164521;750;0;0;0;0;.00nan;0;0
16010;170543;4923;0;0;0;0;.00nan;0;0
16010;176686;4923;69;36;4;32;.889;3590000;0
16011;6868;754;75;22;1;21;.955;3600000;0
16011;45363;754;0;0;0;0;.00nan;0;0
16011;67122;1503;0;0;0;0;.00nan;0;0
16011;68689;1503;92;33;2;31;.939;3562000;0
16012;170547;769;36;39;7;32;.821;3335000;0
16012;-1;769;39;1;1;0;.000;265000;0
16012;82087;768;0;0;0;0;.00nan;0;0
16012;86099;768;84;17;0;17;1.000;3600000;0
16013;595;3913;73;28;2;26;.929;3550000;0
16013;66993;759;74;20;1;19;.950;3600000;0
16013;67446;759;0;0;0;0;.00nan;0;0
16013;82817;3913;0;0;0;0;.00nan;0;0
16014;8504;746;74;21;1;20;.952;3600000;0
16014;11614;775;0;0;0;0;.00nan;0;0
16014;201933;746;0;0;0;0;.00nan;0;0
16014;154296;775;56;31;4;27;.871;3600000;0
16015;174894;762;39;28;5;23;.821;3600000;0
16015;82711;4924;100;35;1;34;.971;3600000;0
16015;148652;762;0;0;0;0;.00nan;0;0
16015;158630;4924;0;0;0;0;.00nan;0;0
16016;-1;911;0;0;0;0;.00nan;0;0
16016;-1;766;71;32;3;29;.906;3594000;0
16016;180177;911;82;27;1;26;.963;3600000;0
16016;91194;766;0;0;0;0;.00nan;0;0
16017;359;774;45;33;5;28;.848;3600000;0
16017;181910;774;0;0;0;0;.00nan;0;0
16017;63932;758;96;39;2;37;.949;3600000;0
16017;85395;758;0;0;0;0;.00nan;0;0
16018;164424;750;88;18;0;18;1.000;3600000;0
16018;164521;750;0;0;0;0;.00nan;0;0
16018;180990;1492;28;15;4;11;.733;2064000;0
16018;73639;1492;51;13;2;11;.846;1536000;0
16019;170547;769;100;41;0;41;1.000;3600000;0
16019;-1;769;0;0;0;0;.00nan;0;0
16019;67122;1503;88;29;1;28;.966;3600000;0
16019;68689;1503;0;0;0;0;.00nan;0;0
16020;67818;3721;97;48;1;47;.979;3900000;0
16020;82087;768;0;0;0;0;.00nan;0;0
16020;86099;768;88;26;1;25;.962;3900000;0
16020;149221;3721;0;0;0;0;.00nan;0;0
16021;180606;2197;0;0;0;0;.00nan;0;0
16021;185775;772;0;0;0;0;.00nan;0;0
16021;57993;772;52;16;2;14;.875;3600000;0
16021;94508;2197;75;34;3;31;.912;3600000;0
16022;177124;2199;0;0;0;0;.00nan;0;0
16022;197595;755;0;0;0;0;.00nan;0;0
16022;71485;755;83;29;1;28;.966;3600000;0
16022;148576;2199;64;22;2;20;.909;3600000;0
16023;6868;754;97;36;1;35;.972;3900000;0
16023;45363;754;0;0;0;0;.00nan;0;0
16023;66993;759;88;25;1;24;.960;3900000;0
16023;67446;759;0;0;0;0;.00nan;0;0
16024;8504;746;78;23;1;22;.957;3600000;0
16024;201933;746;0;0;0;0;.00nan;0;0
16024;82711;4924;0;0;0;0;.00nan;0;0
16024;158630;4924;69;27;2;25;.926;3562000;0
16025;11614;775;0;0;0;0;.00nan;0;0
16025;169615;4989;0;0;0;0;.00nan;0;0
16025;76406;4989;69;37;4;33;.892;3600000;0
16025;154296;775;29;27;5;22;.815;3600000;0
16026;174894;762;0;0;0;0;.00nan;0;0
16026;91358;767;82;27;1;26;.963;3600000;0
16026;94107;767;0;0;0;0;.00nan;0;0
16026;148652;762;68;23;2;21;.913;3575000;0
16027;504;3730;69;41;4;37;.902;3600000;0
16027;2140;1093;59;33;5;28;.848;3566000;0
16027;68233;1093;0;0;0;0;.00nan;0;0
16027;76628;3730;0;0;0;0;.00nan;0;0
16028;170543;4923;72;29;2;27;.931;3600000;0
16028;176686;4923;0;0;0;0;.00nan;0;0
16028;56037;760;0;0;0;0;.00nan;0;0
16028;85489;760;75;26;1;25;.962;3600000;0
16029;185775;772;27;24;5;19;.792;3545000;0
16029;197595;755;0;0;0;0;.00nan;0;0
16029;57993;772;0;0;0;0;.00nan;0;0
16029;71485;755;76;41;4;37;.902;3600000;0
16030;177124;2199;0;0;0;0;.00nan;0;0
16030;180606;2197;0;0;0;0;.00nan;0;0
16030;94508;2197;71;25;2;23;.920;3900000;0
16030;148576;2199;69;19;2;17;.895;3900000;0
16031;8504;746;12;21;6;15;.714;1702000;0
16031;201933;746;87;22;0;22;1.000;1898000;0
16031;91358;767;100;53;3;50;.943;3600000;0
16031;94107;767;0;0;0;0;.00nan;0;0
16032;169615;4989;0;0;0;0;.00nan;0;0
16032;76406;4989;84;30;2;28;.933;3757000;0
16032;82711;4924;0;0;0;0;.00nan;0;0
16032;158630;4924;66;33;3;30;.909;3750000;0
16033;164424;750;75;28;2;26;.929;3600000;0
16033;164521;750;0;0;0;0;.00nan;0;0
16033;174894;762;67;29;3;26;.897;3600000;0
16033;148652;762;0;0;0;0;.00nan;0;0
16034;359;774;0;0;0;0;.00nan;0;0
16034;11614;775;64;40;5;35;.875;3521000;0
16034;181910;774;49;27;4;23;.852;3600000;0
16034;154296;775;0;0;0;0;.00nan;0;0
16035;504;3730;100;32;0;32;1.000;3600000;0
16035;76628;3730;0;0;0;0;.00nan;0;0
16035;148829;2545;0;0;0;0;.00nan;0;0
16035;149112;2545;64;26;2;24;.923;3544000;0
16036;595;3913;0;0;0;0;.00nan;0;0
16036;2140;1093;30;29;6;23;.793;2989000;0
16036;68233;1093;52;4;0;4;1.000;611000;0
16036;82817;3913;71;20;1;19;.950;3600000;0
16037;170543;4923;0;0;0;0;.00nan;0;0
16037;176686;4923;89;16;0;16;1.000;3600000;0
16037;197595;755;32;3;2;1;.333;437000;0
16037;71485;755;52;37;5;32;.865;3163000;0
16038;180606;2197;0;0;0;0;.00nan;0;0
16038;180990;1492;86;22;0;22;1.000;3600000;0
16038;73639;1492;0;0;0;0;.00nan;0;0
16038;94508;2197;75;32;2;30;.938;3512000;0
16039;67122;1503;0;0;0;0;.00nan;0;0
16039;68689;1503;80;34;2;32;.941;3600000;0
16039;82087;768;0;0;0;0;.00nan;0;0
16039;86099;768;61;28;3;25;.893;3557000;0
16040;185775;772;0;0;0;0;.00nan;0;0
16040;56037;760;0;0;0;0;.00nan;0;0
16040;57993;772;69;27;2;25;.926;3556000;0
16040;85489;760;90;34;1;33;.971;3600000;0
16041;177124;2199;80;33;2;31;.939;3600000;0
16041;-1;766;0;0;0;0;.00nan;0;0
16041;91194;766;52;22;3;19;.864;3541000;0
16041;148576;2199;0;0;0;0;.00nan;0;0
16042;8504;746;84;27;1;26;.963;3600000;0
16042;164424;750;68;30;3;27;.900;3600000;0
16042;164521;750;0;0;0;0;.00nan;0;0
16042;201933;746;0;0;0;0;.00nan;0;0
16043;169615;4989;0;0;0;0;.00nan;0;0
16043;76406;4989;62;41;5;36;.878;3600000;0
16043;91358;767;100;32;0;32;1.000;3600000;0
16043;94107;767;0;0;0;0;.00nan;0;0
16044;11614;775;54;4;0;4;1.000;317000;0
16044;174894;762;0;0;0;0;.00nan;0;0
16044;148652;762;100;42;1;41;.976;3600000;0
16044;154296;775;9;27;7;20;.741;3283000;0
16045;359;774;39;28;5;23;.821;3862000;0
16045;181910;774;0;0;0;0;.00nan;0;0
16045;82711;4924;46;31;6;25;.806;3862000;0
16045;158630;4924;0;0;0;0;.00nan;0;0
16046;-1;911;81;28;1;27;.964;3600000;0
16046;180177;911;0;0;0;0;.00nan;0;0
16046;148904;1497;0;0;0;0;.00nan;0;0
16046;149191;1497;58;27;3;24;.889;3517000;0
16047;504;3730;69;23;1;22;.957;3600000;0
16047;63932;758;73;30;2;28;.933;3600000;0
16047;76628;3730;0;0;0;0;.00nan;0;0
16047;85395;758;0;0;0;0;.00nan;0;0
16048;595;3913;84;42;3;39;.929;3576000;0
16048;82817;3913;0;0;0;0;.00nan;0;0
16048;148829;2545;62;18;2;16;.889;3600000;0
16048;149112;2545;0;0;0;0;.00nan;0;0
16049;2140;1093;63;20;2;18;.900;3548000;0
16049;6868;754;0;0;0;0;.00nan;0;0
16049;45363;754;74;27;1;26;.963;3600000;0
16049;68233;1093;0;0;0;0;.00nan;0;0
16050;170543;4923;100;28;1;27;.964;3600000;0
16050;176686;4923;0;0;0;0;.00nan;0;0
16050;180606;2197;0;0;0;0;.00nan;0;0
16050;94508;2197;66;27;3;24;.889;3578000;0
16051;180990;1492;90;34;2;32;.941;3642000;0
16051;197595;755;0;0;0;0;.00nan;0;0
16051;71485;755;62;26;3;23;.885;3640000;0
16051;73639;1492;0;0;0;0;.00nan;0;0
16052;66993;759;99;26;0;26;1.000;3600000;0
16052;67446;759;0;0;0;0;.00nan;0;0
16052;82087;768;0;0;0;0;.00nan;0;0
16052;86099;768;71;22;1;21;.955;3600000;0
16053;-1;766;0;0;0;0;.00nan;0;0
16053;185775;772;0;0;0;0;.00nan;0;0
16053;57993;772;68;25;2;23;.920;3600000;0
16053;91194;766;78;38;3;35;.921;3600000;0
16054;67122;1503;65;40;4;36;.900;3600000;0
16054;67818;3721;0;0;0;0;.00nan;0;0
16054;68689;1503;0;0;0;0;.00nan;0;0
16054;149221;3721;62;17;2;15;.882;3600000;0
16055;177124;2199;0;0;0;0;.00nan;0;0
16055;56037;760;0;0;0;0;.00nan;0;0
16055;85489;760;59;20;3;17;.850;3595000;0
16055;148576;2199;100;44;2;42;.955;3600000;0
16056;164424;750;64;34;4;30;.882;3570000;0
16056;164521;750;0;0;0;0;.00nan;0;0
16056;169615;4989;0;0;0;0;.00nan;0;0
16056;76406;4989;64;30;3;27;.900;3600000;0
16057;2140;1093;64;29;3;26;.897;3600000;0
16057;170547;769;100;31;0;31;1.000;3600000;0
16057;-1;769;0;0;0;0;.00nan;0;0
16057;68233;1093;0;0;0;0;.00nan;0;0
16058;359;774;84;44;3;41;.932;3900000;0
16058;181910;774;0;0;0;0;.00nan;0;0
16058;91358;767;78;36;3;33;.917;3900000;0
16058;94107;767;0;0;0;0;.00nan;0;0
16059;595;3913;71;28;2;26;.929;3600000;0
16059;63932;758;0;0;0;0;.00nan;0;0
16059;82817;3913;0;0;0;0;.00nan;0;0
16059;85395;758;64;39;5;34;.872;3600000;0
16060;6868;754;72;39;4;35;.897;3600000;0
16060;45363;754;0;0;0;0;.00nan;0;0
16060;148829;2545;0;0;0;0;.00nan;0;0
16060;149112;2545;83;16;0;16;1.000;3600000;0
16061;-1;766;0;0;0;0;.00nan;0;0
16061;170543;4923;0;0;0;0;.00nan;0;0
16061;176686;4923;97;36;1;35;.972;3900000;0
16061;91194;766;83;29;1;28;.966;3900000;0
16062;180990;1492;0;0;0;0;.00nan;0;0
16062;56037;760;0;0;0;0;.00nan;0;0
16062;73639;1492;72;26;1;25;.962;3600000;0
16062;85489;760;73;26;2;24;.923;3556000;0
16063;66993;759;99;38;2;36;.947;3900000;0
16063;67446;759;0;0;0;0;.00nan;0;0
16063;67818;3721;81;37;2;35;.946;3900000;0
16063;149221;3721;0;0;0;0;.00nan;0;0
16064;170547;769;93;38;2;36;.947;3600000;0
16064;-1;769;0;0;0;0;.00nan;0;0
16064;148829;2545;0;0;0;0;.00nan;0;0
16064;149112;2545;52;27;4;23;.852;3600000;0
16065;359;774;73;34;3;31;.912;3600000;0
16065;164424;750;64;35;4;31;.886;3574000;0
16065;164521;750;0;0;0;0;.00nan;0;0
16065;181910;774;0;0;0;0;.00nan;0;0
16066;6868;754;83;24;1;23;.958;3600000;0
16066;45363;754;0;0;0;0;.00nan;0;0
16066;63932;758;0;0;0;0;.00nan;0;0
16066;85395;758;37;21;4;17;.810;3600000;0
16067;66993;759;70;27;1;26;.963;3600000;0
16067;67122;1503;0;0;0;0;.00nan;0;0
16067;67446;759;0;0;0;0;.00nan;0;0
16067;68689;1503;62;36;3;33;.917;3580000;0
16068;-1;766;59;32;3;29;.906;3900000;0
16068;180990;1492;74;28;3;25;.893;3900000;0
16068;73639;1492;0;0;0;0;.00nan;0;0
16068;91194;766;0;0;0;0;.00nan;0;0
16069;170547;769;65;24;2;22;.917;3600000;0
16069;-1;769;0;0;0;0;.00nan;0;0
16069;63932;758;0;0;0;0;.00nan;0;0
16069;85395;758;70;42;4;38;.905;3514000;0
16070;-1;911;0;0;0;0;.00nan;0;0
16070;180177;911;72;33;3;30;.909;3802000;0
16070;185775;772;0;0;0;0;.00nan;0;0
16070;57993;772;71;30;2;28;.933;3802000;0
16071;2140;1093;0;0;0;0;.00nan;0;0
16071;68233;1093;66;25;3;22;.880;3600000;0
16071;82087;768;0;0;0;0;.00nan;0;0
16071;86099;768;40;24;4;20;.833;3563000;0
16072;504;3730;64;32;3;29;.906;3538000;0
16072;11614;775;0;0;0;0;.00nan;0;0
16072;76628;3730;0;0;0;0;.00nan;0;0
16072;154296;775;75;22;1;21;.955;3600000;0
16073;8504;746;74;15;1;14;.933;3900000;0
16073;201933;746;0;0;0;0;.00nan;0;0
16073;180606;2197;100;37;1;36;.973;3900000;0
16073;94508;2197;0;0;0;0;.00nan;0;0
16074;169615;4989;0;0;0;0;.00nan;0;0
16074;56037;760;0;0;0;0;.00nan;0;0
16074;76406;4989;65;27;2;25;.926;3556000;0
16074;85489;760;100;26;0;26;1.000;3600000;0
16075;174894;762;67;19;1;18;.947;3547000;0
16075;197595;755;0;0;0;0;.00nan;0;0
16075;71485;755;100;33;0;33;1.000;3600000;0
16075;148652;762;0;0;0;0;.00nan;0;0
16076;595;3913;65;28;3;25;.893;3600000;0
16076;82817;3913;0;0;0;0;.00nan;0;0
16076;91358;767;0;0;0;0;.00nan;0;0
16076;94107;767;66;35;4;31;.886;3600000;0
16077;82087;768;0;0;0;0;.00nan;0;0
16077;86099;768;58;35;4;31;.886;3599000;0
16077;148829;2545;68;27;2;25;.926;3600000;0
16077;149112;2545;0;0;0;0;.00nan;0;0
16078;177124;2199;0;0;0;0;.00nan;0;0
16078;-1;911;0;0;0;0;.00nan;0;0
16078;180177;911;83;28;1;27;.964;3600000;0
16078;148576;2199;74;29;2;27;.931;3545000;0
16079;504;3730;79;34;3;31;.912;3573000;0
16079;76628;3730;0;0;0;0;.00nan;0;0
16079;82711;4924;0;0;0;0;.00nan;0;0
16079;158630;4924;74;27;2;25;.926;3600000;0
16080;185775;772;0;0;0;0;.00nan;0;0
16080;57993;772;53;31;5;26;.839;3600000;0
16080;148904;1497;99;42;1;41;.976;3600000;0
16080;149191;1497;0;0;0;0;.00nan;0;0
16081;2140;1093;56;37;5;32;.865;3600000;0
16081;67818;3721;69;18;1;17;.944;3600000;0
16081;68233;1093;0;0;0;0;.00nan;0;0
16081;149221;3721;0;0;0;0;.00nan;0;0
16082;6868;754;86;33;2;31;.939;3600000;0
16082;11614;775;97;37;1;36;.973;3600000;0
16082;45363;754;0;0;0;0;.00nan;0;0
16082;154296;775;0;0;0;0;.00nan;0;0
16083;174894;762;0;0;0;0;.00nan;0;0
16083;180606;2197;0;0;0;0;.00nan;0;0
16083;94508;2197;81;30;2;28;.933;3900000;0
16083;148652;762;70;28;2;26;.929;3900000;0
16084;-1;766;54;15;2;13;.867;3600000;0
16084;169615;4989;0;0;0;0;.00nan;0;0
16084;76406;4989;98;52;3;49;.942;3600000;0
16084;91194;766;0;0;0;0;.00nan;0;0
16085;8504;746;75;27;2;25;.926;3566000;0
16085;201933;746;0;0;0;0;.00nan;0;0
16085;56037;760;0;0;0;0;.00nan;0;0
16085;85489;760;80;30;2;28;.933;3600000;0
16086;359;774;69;25;2;23;.920;3562000;0
16086;181910;774;0;0;0;0;.00nan;0;0
16086;197595;755;0;0;0;0;.00nan;0;0
16086;71485;755;84;25;1;24;.960;3600000;0
16087;504;3730;96;38;1;37;.974;3600000;0
16087;76628;3730;0;0;0;0;.00nan;0;0
16087;91358;767;80;39;3;36;.923;3571000;0
16087;94107;767;0;0;0;0;.00nan;0;0
16088;67818;3721;47;23;3;20;.870;3900000;0
16088;148829;2545;0;0;0;0;.00nan;0;0
16088;149112;2545;83;43;3;40;.930;3900000;0
16088;149221;3721;0;0;0;0;.00nan;0;0
16089;-1;911;0;0;0;0;.00nan;0;0
16089;180177;911;38;34;6;28;.824;3600000;0
16089;180990;1492;68;23;1;22;.957;3600000;0
16089;73639;1492;0;0;0;0;.00nan;0;0
16090;6868;754;76;28;2;26;.929;3900000;0
16090;45363;754;0;0;0;0;.00nan;0;0
16090;82711;4924;0;0;0;0;.00nan;0;0
16090;158630;4924;90;42;2;40;.952;3900000;0
16091;177124;2199;64;40;5;35;.875;3600000;0
16091;148576;2199;0;0;0;0;.00nan;0;0
16091;148904;1497;0;0;0;0;.00nan;0;0
16091;149191;1497;80;28;2;26;.929;3600000;0
16092;63932;758;97;45;2;43;.956;3544000;0
16092;82087;768;0;0;0;0;.00nan;0;0
16092;85395;758;0;0;0;0;.00nan;0;0
16092;86099;768;77;19;1;18;.947;3600000;0
16093;2140;1093;66;21;2;19;.905;3600000;0
16093;67122;1503;69;31;3;28;.903;3600000;0
16093;68233;1093;0;0;0;0;.00nan;0;0
16093;68689;1503;0;0;0;0;.00nan;0;0
16094;11614;775;50;23;3;20;.870;3600000;0
16094;170547;769;93;51;4;47;.922;3524000;0
16094;-1;769;0;0;0;0;.00nan;0;0
16094;154296;775;0;0;0;0;.00nan;0;0
16095;595;3913;78;31;2;29;.935;3563000;0
16095;164424;750;100;26;0;26;1.000;3600000;0
16095;164521;750;0;0;0;0;.00nan;0;0
16095;82817;3913;0;0;0;0;.00nan;0;0
16096;359;774;95;20;0;20;1.000;3600000;0
16096;180606;2197;0;0;0;0;.00nan;0;0
16096;181910;774;0;0;0;0;.00nan;0;0
16096;94508;2197;85;38;2;36;.947;3531000;0
16097;8504;746;65;24;2;22;.917;3570000;0
16097;-1;766;100;36;0;36;1.000;3600000;0
16097;201933;746;0;0;0;0;.00nan;0;0
16097;91194;766;0;0;0;0;.00nan;0;0
16098;174894;762;78;23;1;22;.957;3600000;0
16098;56037;760;0;0;0;0;.00nan;0;0
16098;85489;760;43;26;4;22;.846;3600000;0
16098;148652;762;0;0;0;0;.00nan;0;0
16099;169615;4989;0;0;0;0;.00nan;0;0
16099;197595;755;0;0;0;0;.00nan;0;0
16099;71485;755;98;46;2;44;.957;3545000;0
16099;76406;4989;86;32;1;31;.969;3600000;0
16100;6868;754;97;46;3;43;.935;3562000;0
16100;45363;754;0;0;0;0;.00nan;0;0
16100;91358;767;63;18;1;17;.944;3600000;0
16100;94107;767;0;0;0;0;.00nan;0;0
16101;67122;1503;0;0;0;0;.00nan;0;0
16101;68689;1503;63;31;3;28;.903;3600000;0
16101;148829;2545;71;20;1;19;.950;3600000;0
16101;149112;2545;0;0;0;0;.00nan;0;0
16102;-1;911;0;0;0;0;.00nan;0;0
16102;170543;4923;58;26;2;24;.923;3577000;0
16102;176686;4923;0;0;0;0;.00nan;0;0
16102;180177;911;100;20;0;20;1.000;3600000;0
16103;170547;769;46;26;4;22;.846;3600000;0
16103;-1;769;0;0;0;0;.00nan;0;0
16103;82711;4924;0;0;0;0;.00nan;0;0
16103;158630;4924;95;25;0;25;1.000;3600000;0
16104;180990;1492;86;37;1;36;.973;3600000;0
16104;73639;1492;0;0;0;0;.00nan;0;0
16104;148904;1497;0;0;0;0;.00nan;0;0
16104;149191;1497;70;26;2;24;.923;3576000;0
16105;63932;758;0;0;0;0;.00nan;0;0
16105;67818;3721;72;15;1;14;.933;3600000;0
16105;85395;758;62;37;4;33;.892;3600000;0
16105;149221;3721;0;0;0;0;.00nan;0;0
16106;2140;1093;32;8;3;5;.625;559000;0
16106;66993;759;57;16;2;14;.875;3600000;0
16106;67446;759;0;0;0;0;.00nan;0;0
16106;68233;1093;67;34;3;31;.912;3041000;0
16107;595;3913;91;35;2;33;.943;3900000;0
16107;11614;775;0;0;0;0;.00nan;0;0
16107;82817;3913;0;0;0;0;.00nan;0;0
16107;154296;775;82;32;2;30;.938;3900000;0
16108;504;3730;22;23;6;17;.739;2955000;0
16108;164424;750;45;17;3;14;.824;3600000;0
16108;164521;750;0;0;0;0;.00nan;0;0
16108;76628;3730;64;10;0;10;1.000;645000;0
16109;169615;4989;0;0;0;0;.00nan;0;0
16109;180606;2197;55;38;5;33;.868;3600000;0
16109;76406;4989;73;19;1;18;.947;3600000;0
16109;94508;2197;0;0;0;0;.00nan;0;0
16110;-1;766;43;23;4;19;.826;3600000;0
16110;174894;762;40;30;5;25;.833;3592000;0
16110;91194;766;0;0;0;0;.00nan;0;0
16110;148652;762;0;0;0;0;.00nan;0;0
16111;359;774;65;31;3;28;.903;3812000;0
16111;181910;774;0;0;0;0;.00nan;0;0
16111;56037;760;0;0;0;0;.00nan;0;0
16111;85489;760;76;36;2;34;.944;3812000;0
16112;8504;746;53;12;2;10;.833;3600000;0
16112;201933;746;0;0;0;0;.00nan;0;0
16112;197595;755;70;41;4;37;.902;3536000;0
16112;71485;755;0;0;0;0;.00nan;0;0
16113;170547;769;99;26;0;26;1.000;3600000;0
16113;-1;769;0;0;0;0;.00nan;0;0
16113;91358;767;70;22;1;21;.955;3600000;0
16113;94107;767;0;0;0;0;.00nan;0;0
16114;66993;759;47;17;3;14;.824;3600000;0
16114;67446;759;0;0;0;0;.00nan;0;0
16114;148829;2545;67;36;4;32;.889;3567000;0
16114;149112;2545;0;0;0;0;.00nan;0;0
16115;595;3913;68;31;3;28;.903;3559000;0
16115;82711;4924;0;0;0;0;.00nan;0;0
16115;82817;3913;0;0;0;0;.00nan;0;0
16115;158630;4924;79;27;1;26;.963;3600000;0
16116;170543;4923;0;0;0;0;.00nan;0;0
16116;176686;4923;68;20;2;18;.900;3600000;0
16116;148904;1497;0;0;0;0;.00nan;0;0
16116;149191;1497;35;37;7;30;.811;3600000;0
16117;63932;758;0;0;0;0;.00nan;0;0
16117;67122;1503;0;0;0;0;.00nan;0;0
16117;68689;1503;66;33;3;30;.909;3600000;0
16117;85395;758;94;17;0;17;1.000;3600000;0
16118;6868;754;93;47;2;45;.957;3581000;0
16118;164424;750;84;29;1;28;.966;3600000;0
16118;164521;750;0;0;0;0;.00nan;0;0
16118;45363;754;0;0;0;0;.00nan;0;0
16119;359;774;39;29;5;24;.828;3600000;0
16119;-1;766;82;30;2;28;.933;3600000;0
16119;181910;774;0;0;0;0;.00nan;0;0
16119;91194;766;0;0;0;0;.00nan;0;0
16120;177124;2199;0;0;0;0;.00nan;0;0
16120;185775;772;0;0;0;0;.00nan;0;0
16120;57993;772;73;29;2;27;.931;3577000;0
16120;148576;2199;74;24;1;23;.958;3600000;0
16121;63932;758;0;0;0;0;.00nan;0;0
16121;66993;759;78;18;1;17;.944;3600000;0
16121;67446;759;0;0;0;0;.00nan;0;0
16121;85395;758;84;44;3;41;.932;3565000;0
16122;67818;3721;57;26;3;23;.885;3577000;0
16122;82087;768;0;0;0;0;.00nan;0;0
16122;86099;768;82;29;2;27;.931;3600000;0
16122;149221;3721;0;0;0;0;.00nan;0;0
16123;164424;750;56;29;4;25;.862;3562000;0
16123;164521;750;0;0;0;0;.00nan;0;0
16123;170547;769;56;29;3;26;.897;3600000;0
16123;-1;769;0;0;0;0;.00nan;0;0
16124;8504;746;94;18;0;18;1.000;3600000;0
16124;201933;746;0;0;0;0;.00nan;0;0
16124;180606;2197;0;0;0;0;.00nan;0;0
16124;94508;2197;56;32;4;28;.875;3600000;0
16125;169615;4989;0;0;0;0;.00nan;0;0
16125;56037;760;0;0;0;0;.00nan;0;0
16125;76406;4989;75;23;2;21;.913;3693000;0
16125;85489;760;93;33;1;32;.970;3693000;0
16126;-1;911;0;0;0;0;.00nan;0;0
16126;180177;911;80;36;3;33;.917;3600000;0
16126;180990;1492;43;25;4;21;.840;3600000;0
16126;73639;1492;0;0;0;0;.00nan;0;0
16127;67122;1503;61;24;2;22;.917;3600000;0
16127;68689;1503;0;0;0;0;.00nan;0;0
16127;148829;2545;51;20;3;17;.850;3545000;0
16127;149112;2545;0;0;0;0;.00nan;0;0
16128;504;3730;82;27;1;26;.963;3900000;0
16128;76628;3730;0;0;0;0;.00nan;0;0
16128;91358;767;80;32;1;31;.969;3900000;0
16128;94107;767;0;0;0;0;.00nan;0;0
16129;595;3913;71;25;3;22;.880;3615000;0
16129;11614;775;75;33;2;31;.939;3615000;0
16129;82817;3913;0;0;0;0;.00nan;0;0
16129;154296;775;0;0;0;0;.00nan;0;0
16130;2140;1093;63;18;1;17;.944;3600000;0
16130;67818;3721;0;0;0;0;.00nan;0;0
16130;68233;1093;0;0;0;0;.00nan;0;0
16130;149221;3721;30;34;6;28;.824;3600000;0
16131;6868;754;0;0;0;0;.00nan;0;0
16131;45363;754;65;24;2;22;.917;3900000;0
16131;82711;4924;0;0;0;0;.00nan;0;0
16131;158630;4924;75;26;2;24;.923;3900000;0
16132;8504;746;69;24;1;23;.958;3600000;0
16132;201933;746;0;0;0;0;.00nan;0;0
16132;197595;755;0;0;0;0;.00nan;0;0
16132;71485;755;91;39;2;37;.949;3600000;0
16133;169615;4989;84;36;3;33;.917;3628000;0
16133;180606;2197;48;25;4;21;.840;3628000;0
16133;76406;4989;0;0;0;0;.00nan;0;0
16133;94508;2197;0;0;0;0;.00nan;0;0
16134;-1;911;0;0;0;0;.00nan;0;0
16134;170543;4923;100;40;0;40;1.000;3600000;0
16134;176686;4923;0;0;0;0;.00nan;0;0
16134;180177;911;58;12;1;11;.917;3560000;0
16135;-1;766;69;35;4;31;.886;3900000;0
16135;174894;762;0;0;0;0;.00nan;0;0
16135;91194;766;0;0;0;0;.00nan;0;0
16135;148652;762;46;23;4;19;.826;3900000;0
16136;359;774;61;32;3;29;.906;3749000;0
16136;181910;774;0;0;0;0;.00nan;0;0
16136;56037;760;0;0;0;0;.00nan;0;0
16136;85489;760;85;43;2;41;.953;3749000;0
16137;180990;1492;65;24;3;21;.875;3600000;0
16137;73639;1492;0;0;0;0;.00nan;0;0
16137;148904;1497;0;0;0;0;.00nan;0;0
16137;149191;1497;77;42;4;38;.905;3584000;0
16138;63932;758;0;0;0;0;.00nan;0;0
16138;67122;1503;36;21;4;17;.810;3794000;0
16138;68689;1503;0;0;0;0;.00nan;0;0
16138;85395;758;52;33;5;28;.848;3794000;0
16139;170547;769;95;39;1;38;.974;3600000;0
16139;-1;769;0;0;0;0;.00nan;0;0
16139;82711;4924;0;0;0;0;.00nan;0;0
16139;158630;4924;67;37;3;34;.919;3546000;0
16140;2140;1093;94;43;3;40;.930;3600000;0
16140;68233;1093;0;0;0;0;.00nan;0;0
16140;82087;768;0;0;0;0;.00nan;0;0
16140;86099;768;98;26;0;26;1.000;3600000;0
16141;504;3730;90;32;1;31;.969;3900000;0
16141;164424;750;100;33;1;32;.970;3900000;0
16141;164521;750;0;0;0;0;.00nan;0;0
16141;76628;3730;0;0;0;0;.00nan;0;0
16142;595;3913;82;30;1;29;.967;3600000;0
16142;82817;3913;0;0;0;0;.00nan;0;0
16142;91358;767;53;20;3;17;.850;3573000;0
16142;94107;767;0;0;0;0;.00nan;0;0
16143;6868;754;100;31;0;31;1.000;3600000;0
16143;11614;775;60;30;4;26;.867;3600000;0
16143;45363;754;0;0;0;0;.00nan;0;0
16143;154296;775;0;0;0;0;.00nan;0;0
16144;66993;759;0;0;0;0;.00nan;0;0
16144;67446;759;83;27;1;26;.963;3600000;0
16144;148829;2545;84;39;3;36;.923;3600000;0
16144;149112;2545;0;0;0;0;.00nan;0;0
16145;8504;746;90;28;1;27;.964;3900000;0
16145;-1;766;96;37;1;36;.973;3900000;0
16145;201933;746;0;0;0;0;.00nan;0;0
16145;91194;766;0;0;0;0;.00nan;0;0
16146;169615;4989;0;0;0;0;.00nan;0;0
16146;197595;755;0;0;0;0;.00nan;0;0
16146;71485;755;57;27;3;24;.889;3517000;0
16146;76406;4989;71;22;1;21;.955;3600000;0
16147;170543;4923;84;28;1;27;.964;3600000;0
16147;176686;4923;0;0;0;0;.00nan;0;0
16147;148904;1497;0;0;0;0;.00nan;0;0
16147;149191;1497;63;37;4;33;.892;3600000;0
16148;174894;762;83;24;1;23;.958;3600000;0
16148;56037;760;0;0;0;0;.00nan;0;0
16148;85489;760;61;29;3;26;.897;3544000;0
16148;148652;762;0;0;0;0;.00nan;0;0
16149;359;774;71;26;2;24;.923;3600000;0
16149;180606;2197;0;0;0;0;.00nan;0;0
16149;181910;774;0;0;0;0;.00nan;0;0
16149;94508;2197;58;30;3;27;.900;3585000;0
16150;177124;2199;94;30;1;29;.967;2475000;0
16150;-1;911;0;0;0;0;.00nan;0;0
16150;180177;911;73;30;2;28;.933;3600000;0
16150;148576;2199;24;10;4;6;.600;1125000;0
16151;2140;1093;61;22;2;20;.909;3589000;0
16151;67122;1503;0;0;0;0;.00nan;0;0
16151;68233;1093;0;0;0;0;.00nan;0;0
16151;68689;1503;75;25;1;24;.960;3600000;0
16152;11614;775;58;34;5;29;.853;3600000;0
16152;170547;769;87;25;2;23;.920;3600000;0
16152;-1;769;0;0;0;0;.00nan;0;0
16152;154296;775;0;0;0;0;.00nan;0;0
16153;504;3730;76;24;1;23;.958;3600000;0
16153;76628;3730;0;0;0;0;.00nan;0;0
16153;82711;4924;0;0;0;0;.00nan;0;0
16153;158630;4924;64;38;4;34;.895;3600000;0
16154;595;3913;32;15;4;11;.733;3600000;0
16154;164424;750;95;35;1;34;.971;3600000;0
16154;164521;750;0;0;0;0;.00nan;0;0
16154;82817;3913;0;0;0;0;.00nan;0;0
16155;67818;3721;91;32;1;31;.969;3600000;0
16155;148829;2545;0;0;0;0;.00nan;0;0
16155;149112;2545;31;26;5;21;.808;3600000;0
16155;149221;3721;0;0;0;0;.00nan;0;0
16156;6868;754;87;42;3;39;.929;3878000;0
16156;45363;754;0;0;0;0;.00nan;0;0
16156;91358;767;61;32;3;29;.906;3900000;0
16156;94107;767;0;0;0;0;.00nan;0;0
16157;63932;758;0;0;0;0;.00nan;0;0
16157;66993;759;84;16;0;16;1.000;3600000;0
16157;67446;759;0;0;0;0;.00nan;0;0
16157;85395;758;90;41;2;39;.951;3600000;0
16158;8504;746;67;22;2;20;.909;3600000;0
16158;201933;746;0;0;0;0;.00nan;0;0
16158;56037;760;0;0;0;0;.00nan;0;0
16158;85489;760;90;40;3;37;.925;3578000;0
16159;-1;766;63;16;1;15;.938;3600000;0
16159;169615;4989;0;0;0;0;.00nan;0;0
16159;76406;4989;85;33;2;31;.939;3600000;0
16159;91194;766;0;0;0;0;.00nan;0;0
16160;174894;762;59;31;4;27;.871;3516000;0
16160;180606;2197;0;0;0;0;.00nan;0;0
16160;94508;2197;71;30;2;28;.933;3600000;0
16160;148652;762;0;0;0;0;.00nan;0;0
16161;359;774;86;28;1;27;.964;3600000;0
16161;181910;774;0;0;0;0;.00nan;0;0
16161;197595;755;0;0;0;0;.00nan;0;0
16161;71485;755;65;27;3;24;.889;3600000;0
16162;-1;911;57;4;0;4;1.000;1802000;0
16162;180177;911;7;14;6;8;.571;1798000;0
16162;185775;772;0;0;0;0;.00nan;0;0
16162;57993;772;98;26;0;26;1.000;3600000;0
16163;177124;2199;41;22;4;18;.818;3573000;0
16163;148576;2199;0;0;0;0;.00nan;0;0
16163;148904;1497;0;0;0;0;.00nan;0;0
16163;149191;1497;75;30;2;28;.933;3600000;0
16164;170547;769;88;57;2;55;.965;3600000;0
16164;-1;769;0;0;0;0;.00nan;0;0
16164;91358;767;63;15;1;14;.933;3600000;0
16164;94107;767;0;0;0;0;.00nan;0;0
16165;82087;768;0;0;0;0;.00nan;0;0
16165;86099;768;60;28;3;25;.893;3554000;0
16165;148829;2545;67;24;2;22;.917;3600000;0
16165;149112;2545;0;0;0;0;.00nan;0;0
16166;504;3730;98;42;2;40;.952;3551000;0
16166;11614;775;75;21;1;20;.952;3600000;0
16166;76628;3730;0;0;0;0;.00nan;0;0
16166;154296;775;0;0;0;0;.00nan;0;0
16167;595;3913;62;26;3;23;.885;3900000;0
16167;82711;4924;0;0;0;0;.00nan;0;0
16167;82817;3913;0;0;0;0;.00nan;0;0
16167;158630;4924;67;32;3;29;.906;3900000;0
16168;63932;758;0;0;0;0;.00nan;0;0
16168;67818;3721;80;26;1;25;.962;3600000;0
16168;85395;758;51;27;3;24;.889;3560000;0
16168;149221;3721;0;0;0;0;.00nan;0;0
16169;6868;754;97;46;1;45;.978;3900000;0
16169;164424;750;89;26;1;25;.962;3900000;0
16169;164521;750;0;0;0;0;.00nan;0;0
16169;45363;754;0;0;0;0;.00nan;0;0
16170;2140;1093;57;33;4;29;.879;3600000;0
16170;66993;759;50;14;2;12;.857;3600000;0
16170;67446;759;0;0;0;0;.00nan;0;0
16170;68233;1093;0;0;0;0;.00nan;0;0
16171;174894;762;0;0;0;0;.00nan;0;0
16171;197595;755;0;0;0;0;.00nan;0;0
16171;71485;755;93;36;1;35;.972;3900000;0
16171;148652;762;100;35;1;34;.971;3900000;0
16172;359;774;67;19;1;18;.947;3600000;0
16172;-1;766;82;37;3;34;.919;3564000;0
16172;181910;774;0;0;0;0;.00nan;0;0
16172;91194;766;0;0;0;0;.00nan;0;0
16173;185775;772;0;0;0;0;.00nan;0;0
16173;57993;772;77;21;1;20;.952;3600000;0
16173;148904;1497;0;0;0;0;.00nan;0;0
16173;149191;1497;97;41;2;39;.951;3574000;0
16174;164424;750;50;26;4;22;.846;3600000;0
16174;164521;750;0;0;0;0;.00nan;0;0
16174;170547;769;44;32;5;27;.844;3576000;0
16174;-1;769;0;0;0;0;.00nan;0;0
16175;63932;758;0;0;0;0;.00nan;0;0
16175;82087;768;0;0;0;0;.00nan;0;0
16175;85395;758;62;27;3;24;.889;3600000;0
16175;86099;768;59;21;2;19;.905;3600000;0
16176;66993;759;55;33;4;29;.879;3900000;0
16176;67122;1503;76;41;4;37;.902;3900000;0
16176;67446;759;0;0;0;0;.00nan;0;0
16176;68689;1503;0;0;0;0;.00nan;0;0
16177;180606;2197;0;0;0;0;.00nan;0;0
16177;180990;1492;93;30;1;29;.967;3900000;0
16177;73639;1492;0;0;0;0;.00nan;0;0
16177;94508;2197;93;33;1;32;.970;3900000;0
16178;170543;4923;63;39;5;34;.872;3600000;0
16178;176686;4923;0;0;0;0;.00nan;0;0
16178;56037;760;60;30;3;27;.900;3600000;0
16178;85489;760;0;0;0;0;.00nan;0;0
16179;169615;4989;0;0;0;0;.00nan;0;0
16179;76406;4989;59;26;3;23;.885;3600000;0
16179;91358;767;63;23;2;21;.913;3600000;0
16179;94107;767;0;0;0;0;.00nan;0;0
16180;6868;754;56;44;6;38;.864;3600000;0
16180;45363;754;0;0;0;0;.00nan;0;0
16180;148829;2545;0;0;0;0;.00nan;0;0
16180;149112;2545;62;23;2;21;.913;3600000;0
16181;504;3730;0;0;0;0;.00nan;0;0
16181;595;3913;78;29;2;27;.931;3543000;0
16181;76628;3730;83;29;1;28;.966;3600000;0
16181;82817;3913;0;0;0;0;.00nan;0;0
16182;8504;746;97;21;0;21;1.000;3600000;0
16182;201933;746;0;0;0;0;.00nan;0;0
16182;82711;4924;69;39;4;35;.897;3600000;0
16182;158630;4924;0;0;0;0;.00nan;0;0
16183;180606;2197;75;24;1;23;.958;3600000;0
16183;185775;772;0;0;0;0;.00nan;0;0
16183;57993;772;38;24;4;20;.833;3600000;0
16183;94508;2197;0;0;0;0;.00nan;0;0
16184;-1;766;52;35;4;31;.886;3596000;0
16184;170543;4923;0;0;0;0;.00nan;0;0
16184;176686;4923;85;36;3;33;.917;3600000;0
16184;91194;766;0;0;0;0;.00nan;0;0
16185;180990;1492;67;32;2;30;.938;3600000;0
16185;56037;760;0;0;0;0;.00nan;0;0
16185;73639;1492;0;0;0;0;.00nan;0;0
16185;85489;760;86;28;1;27;.964;3600000;0
16186;177124;2199;68;35;2;33;.943;3900000;0
16186;197595;755;0;0;0;0;.00nan;0;0
16186;71485;755;81;27;2;25;.926;3900000;0
16186;148576;2199;0;0;0;0;.00nan;0;0
16187;67122;1503;0;0;0;0;.00nan;0;0
16187;67818;3721;57;35;5;30;.857;3542000;0
16187;68689;1503;68;25;3;22;.880;3600000;0
16187;149221;3721;0;0;0;0;.00nan;0;0
16188;174894;762;61;17;2;15;.882;3600000;0
16188;91358;767;79;36;3;33;.917;3543000;0
16188;94107;767;0;0;0;0;.00nan;0;0
16188;148652;762;0;0;0;0;.00nan;0;0
16189;170547;769;69;37;4;33;.892;3600000;0
16189;-1;769;0;0;0;0;.00nan;0;0
16189;148829;2545;60;25;2;23;.920;3600000;0
16189;149112;2545;0;0;0;0;.00nan;0;0
16190;359;774;96;36;1;35;.972;3600000;0
16190;181910;774;0;0;0;0;.00nan;0;0
16190;82711;4924;0;0;0;0;.00nan;0;0
16190;158630;4924;38;32;5;27;.844;3600000;0
16191;6868;754;88;28;1;27;.964;3600000;0
16191;45363;754;0;0;0;0;.00nan;0;0
16191;63932;758;36;27;6;21;.778;3600000;0
16191;85395;758;0;0;0;0;.00nan;0;0
16192;8504;746;100;29;0;29;1.000;3600000;0
16192;11614;775;0;0;0;0;.00nan;0;0
16192;201933;746;0;0;0;0;.00nan;0;0
16192;154296;775;78;28;1;27;.964;3570000;0
16193;164424;750;0;0;0;0;.00nan;0;0
16193;164521;750;54;15;2;13;.867;3636000;0
16193;169615;4989;0;0;0;0;.00nan;0;0
16193;76406;4989;94;54;3;51;.944;3636000;0
16194;177124;2199;0;0;0;0;.00nan;0;0
16194;180606;2197;0;0;0;0;.00nan;0;0
16194;94508;2197;72;24;2;22;.917;3600000;0
16194;148576;2199;57;31;4;27;.871;3555000;0
16195;-1;766;86;37;1;36;.973;3600000;0
16195;180990;1492;67;28;2;26;.929;3551000;0
16195;73639;1492;0;0;0;0;.00nan;0;0
16195;91194;766;0;0;0;0;.00nan;0;0
16196;-1;911;0;0;0;0;.00nan;0;0
16196;180177;911;100;26;0;26;1.000;3600000;0
16196;148904;1497;58;19;2;17;.895;3527000;0
16196;149191;1497;0;0;0;0;.00nan;0;0
16197;185775;772;0;0;0;0;.00nan;0;0
16197;56037;760;0;0;0;0;.00nan;0;0
16197;57993;772;79;24;2;22;.917;3794000;0
16197;85489;760;95;35;1;34;.971;3794000;0
16198;170543;4923;51;24;4;20;.833;3578000;0
16198;176686;4923;0;0;0;0;.00nan;0;0
16198;197595;755;54;22;3;19;.864;3600000;0
16198;71485;755;0;0;0;0;.00nan;0;0
16199;67122;1503;45;17;3;14;.824;593000;0
16199;68689;1503;49;21;3;18;.857;3007000;0
16199;82087;768;0;0;0;0;.00nan;0;0
16199;86099;768;65;20;2;18;.900;3600000;0
16200;8504;746;68;25;2;23;.920;3600000;0
16200;201933;746;0;0;0;0;.00nan;0;0
16200;91358;767;89;47;3;44;.936;3593000;0
16200;94107;767;0;0;0;0;.00nan;0;0
16201;504;3730;58;41;5;36;.878;3762000;0
16201;76628;3730;0;0;0;0;.00nan;0;0
16201;148829;2545;0;0;0;0;.00nan;0;0
16201;149112;2545;50;28;4;24;.857;3762000;0
16202;169615;4989;0;0;0;0;.00nan;0;0
16202;76406;4989;88;43;3;40;.930;3600000;0
16202;82711;4924;0;0;0;0;.00nan;0;0
16202;158630;4924;84;15;0;15;1.000;3600000;0
16203;170547;769;66;27;3;24;.889;3549000;0
16203;-1;769;0;0;0;0;.00nan;0;0
16203;63932;758;0;0;0;0;.00nan;0;0
16203;85395;758;85;26;1;25;.962;3600000;0
16204;2140;1093;0;0;0;0;.00nan;0;0
16204;6868;754;90;32;2;30;.938;3600000;0
16204;45363;754;0;0;0;0;.00nan;0;0
16204;68233;1093;54;25;3;22;.880;3600000;0
16205;359;774;52;29;4;25;.862;3900000;0
16205;11614;775;56;29;4;25;.862;3899000;0
16205;181910;774;0;0;0;0;.00nan;0;0
16205;154296;775;0;0;0;0;.00nan;0;0
16206;164424;750;79;31;2;29;.935;3618000;0
16206;164521;750;0;0;0;0;.00nan;0;0
16206;174894;762;82;24;1;23;.958;3618000;0
16206;148652;762;0;0;0;0;.00nan;0;0
16207;66993;759;100;39;0;39;1.000;3600000;0
16207;67446;759;0;0;0;0;.00nan;0;0
16207;67818;3721;53;26;3;23;.885;3600000;0
16207;149221;3721;0;0;0;0;.00nan;0;0
16208;170543;4923;0;0;0;0;.00nan;0;0
16208;176686;4923;78;30;2;28;.933;3591000;0
16208;180606;2197;79;27;1;26;.963;3600000;0
16208;94508;2197;0;0;0;0;.00nan;0;0
16209;-1;766;65;22;2;20;.909;3600000;0
16209;185775;772;0;0;0;0;.00nan;0;0
16209;57993;772;43;27;4;23;.852;3514000;0
16209;91194;766;0;0;0;0;.00nan;0;0
16210;177124;2199;87;37;2;35;.946;3600000;0
16210;56037;760;0;0;0;0;.00nan;0;0
16210;85489;760;48;24;4;20;.833;3543000;0
16210;148576;2199;0;0;0;0;.00nan;0;0
16211;180990;1492;56;20;2;18;.900;3600000;0
16211;197595;755;0;0;0;0;.00nan;0;0
16211;71485;755;65;31;3;28;.903;3546000;0
16211;73639;1492;0;0;0;0;.00nan;0;0
16212;359;774;84;35;2;33;.943;3584000;0
16212;181910;774;0;0;0;0;.00nan;0;0
16212;91358;767;75;32;2;30;.938;3600000;0
16212;94107;767;0;0;0;0;.00nan;0;0
16213;595;3913;70;34;3;31;.912;3551000;0
16213;82817;3913;0;0;0;0;.00nan;0;0
16213;148829;2545;0;0;0;0;.00nan;0;0
16213;149112;2545;82;27;2;25;.926;3600000;0
16214;174894;762;58;24;3;21;.875;3568000;0
16214;82711;4924;0;0;0;0;.00nan;0;0
16214;148652;762;0;0;0;0;.00nan;0;0
16214;158630;4924;87;34;1;33;.971;3600000;0
16215;504;3730;76;25;2;23;.920;3900000;0
16215;63932;758;0;0;0;0;.00nan;0;0
16215;76628;3730;0;0;0;0;.00nan;0;0
16215;85395;758;73;29;2;27;.931;3900000;0
16216;2140;1093;100;36;1;35;.972;3600000;0
16216;170547;769;69;31;3;28;.903;3547000;0
16216;-1;769;0;0;0;0;.00nan;0;0
16216;68233;1093;0;0;0;0;.00nan;0;0
16217;11614;775;75;28;2;26;.929;3900000;0
16217;169615;4989;0;0;0;0;.00nan;0;0
16217;76406;4989;71;26;2;24;.923;3899000;0
16217;154296;775;0;0;0;0;.00nan;0;0
16218;8504;746;69;23;1;22;.957;3600000;0
16218;164424;750;79;37;2;35;.946;3571000;0
16218;164521;750;0;0;0;0;.00nan;0;0
16218;201933;746;0;0;0;0;.00nan;0;0
16219;66993;759;67;28;3;25;.893;3578000;0
16219;67446;759;0;0;0;0;.00nan;0;0
16219;82087;768;0;0;0;0;.00nan;0;0
16219;86099;768;82;36;2;34;.944;3600000;0
16220;177124;2199;0;0;0;0;.00nan;0;0
16220;-1;766;71;30;3;27;.900;3600000;0
16220;91194;766;0;0;0;0;.00nan;0;0
16220;148576;2199;77;25;1;24;.960;3600000;0
16221;185775;772;0;0;0;0;.00nan;0;0
16221;197595;755;0;0;0;0;.00nan;0;0
16221;57993;772;59;17;2;15;.882;3600000;0
16221;71485;755;67;34;3;31;.912;3566000;0
16222;595;3913;88;26;1;25;.962;3600000;0
16222;63932;758;0;0;0;0;.00nan;0;0
16222;82817;3913;0;0;0;0;.00nan;0;0
16222;85395;758;60;43;5;38;.884;3600000;0
16223;504;3730;84;33;2;31;.939;3570000;0
16223;2140;1093;81;23;1;22;.957;3600000;0
16223;68233;1093;0;0;0;0;.00nan;0;0
16223;76628;3730;0;0;0;0;.00nan;0;0
16224;11614;775;94;32;1;31;.969;3600000;0
16224;174894;762;61;31;3;28;.903;3519000;0
16224;148652;762;0;0;0;0;.00nan;0;0
16224;154296;775;0;0;0;0;.00nan;0;0
16225;359;774;66;18;1;17;.944;3600000;0
16225;164424;750;42;16;3;13;.813;3519000;0
16225;164521;750;0;0;0;0;.00nan;0;0
16225;181910;774;0;0;0;0;.00nan;0;0
16226;-1;911;0;0;0;0;.00nan;0;0
16226;180177;911;100;28;0;28;1.000;3600000;0
16226;56037;760;0;0;0;0;.00nan;0;0
16226;85489;760;78;29;1;28;.966;3565000;0
16227;180606;2197;87;45;3;42;.933;3900000;0
16227;94508;2197;0;0;0;0;.00nan;0;0
16227;148904;1497;0;0;0;0;.00nan;0;0
16227;149191;1497;73;29;3;26;.897;3900000;0
16228;169615;4989;0;0;0;0;.00nan;0;0
16228;76406;4989;65;16;1;15;.938;3600000;0
16228;148829;2545;62;13;1;12;.923;1484000;0
16228;149112;2545;24;22;5;17;.773;2116000;0
16229;170543;4923;100;30;0;30;1.000;3600000;0
16229;176686;4923;0;0;0;0;.00nan;0;0
16229;91358;767;57;23;3;20;.870;3600000;0
16229;94107;767;0;0;0;0;.00nan;0;0
16230;170547;769;80;31;2;29;.935;3900000;0
16230;-1;769;0;0;0;0;.00nan;0;0
16230;67122;1503;0;0;0;0;.00nan;0;0
16230;68689;1503;89;36;2;34;.944;3900000;0
16231;180990;1492;100;25;0;25;1.000;3600000;0
16231;73639;1492;0;0;0;0;.00nan;0;0
16231;82711;4924;0;0;0;0;.00nan;0;0
16231;158630;4924;69;28;2;26;.929;3562000;0
16232;595;3913;49;20;3;17;.850;3600000;0
16232;2140;1093;100;30;0;30;1.000;3600000;0
16232;68233;1093;0;0;0;0;.00nan;0;0
16232;82817;3913;0;0;0;0;.00nan;0;0
16233;6868;754;0;0;0;0;.00nan;0;0
16233;45363;754;76;46;4;42;.913;3600000;0
16233;66993;759;92;17;0;17;1.000;3600000;0
16233;67446;759;0;0;0;0;.00nan;0;0
16234;-1;911;0;0;0;0;.00nan;0;0
16234;180177;911;44;21;3;18;.857;3900000;0
16234;180606;2197;0;0;0;0;.00nan;0;0
16234;94508;2197;77;35;3;32;.914;3900000;0
16235;56037;760;0;0;0;0;.00nan;0;0
16235;85489;760;83;36;2;34;.944;3869000;0
16235;148904;1497;0;0;0;0;.00nan;0;0
16235;149191;1497;84;24;1;23;.958;3869000;0
16236;169615;4989;0;0;0;0;.00nan;0;0
16236;63932;758;0;0;0;0;.00nan;0;0
16236;76406;4989;67;30;4;26;.867;3600000;0
16236;85395;758;68;20;1;19;.950;3600000;0
16237;170543;4923;44;20;4;16;.800;3900000;0
16237;176686;4923;0;0;0;0;.00nan;0;0
16237;82711;4924;0;0;0;0;.00nan;0;0
16237;158630;4924;73;48;4;44;.917;3900000;0
16238;170547;769;62;36;4;32;.889;3551000;0
16238;-1;769;0;0;0;0;.00nan;0;0
16238;66993;759;50;18;2;16;.889;3600000;0
16238;67446;759;0;0;0;0;.00nan;0;0
16239;359;774;0;0;0;0;.00nan;0;0
16239;181910;774;52;16;2;14;.875;3600000;0
16239;148829;2545;0;0;0;0;.00nan;0;0
16239;149112;2545;58;31;4;27;.871;3558000;0
16240;164424;750;92;20;0;20;1.000;3600000;0
16240;164521;750;0;0;0;0;.00nan;0;0
16240;180990;1492;43;27;4;23;.852;3600000;0
16240;73639;1492;0;0;0;0;.00nan;0;0
16241;504;3730;88;39;3;36;.923;3554000;0
16241;67122;1503;0;0;0;0;.00nan;0;0
16241;68689;1503;73;22;1;21;.955;3600000;0
16241;76628;3730;0;0;0;0;.00nan;0;0
16242;185775;772;61;19;2;17;.895;3513000;0
16242;57993;772;0;0;0;0;.00nan;0;0
16242;91358;767;92;21;0;21;1.000;3600000;0
16242;94107;767;0;0;0;0;.00nan;0;0
16243;177124;2199;50;19;3;16;.842;3900000;0
16243;11614;775;56;26;3;23;.885;3900000;0
16243;148576;2199;0;0;0;0;.00nan;0;0
16243;154296;775;0;0;0;0;.00nan;0;0
16244;6868;754;60;25;3;22;.880;3600000;0
16244;45363;754;0;0;0;0;.00nan;0;0
16244;67818;3721;61;20;2;18;.900;3600000;0
16244;149221;3721;0;0;0;0;.00nan;0;0
16245;-1;911;0;0;0;0;.00nan;0;0
16245;-1;766;40;31;6;25;.806;2895000;0
16245;180177;911;78;21;1;20;.952;3600000;0
16245;91194;766;55;7;1;6;.857;705000;0
16246;197595;755;0;0;0;0;.00nan;0;0
16246;71485;755;89;35;2;33;.943;3512000;0
16246;148904;1497;0;0;0;0;.00nan;0;0
16246;149191;1497;100;26;0;26;1.000;3600000;0
16247;2140;1093;27;5;3;2;.400;571000;0
16247;169615;4989;56;30;4;26;.867;3900000;0
16247;68233;1093;74;25;1;24;.960;3329000;0
16247;76406;4989;0;0;0;0;.00nan;0;0
16248;164424;750;71;22;1;21;.955;3686000;0
16248;164521;750;0;0;0;0;.00nan;0;0
16248;170543;4923;0;0;0;0;.00nan;0;0
16248;176686;4923;72;29;2;27;.931;3686000;0
16249;170547;769;84;24;1;23;.958;3600000;0
16249;-1;769;0;0;0;0;.00nan;0;0
16249;67818;3721;88;20;0;20;1.000;3600000;0
16249;149221;3721;0;0;0;0;.00nan;0;0
16250;174894;762;0;0;0;0;.00nan;0;0
16250;148652;762;64;22;2;20;.909;3600000;0
16250;148829;2545;69;36;4;32;.889;3525000;0
16250;149112;2545;0;0;0;0;.00nan;0;0
16251;359;774;70;25;2;23;.920;3616000;0
16251;181910;774;0;0;0;0;.00nan;0;0
16251;63932;758;0;0;0;0;.00nan;0;0
16251;85395;758;87;32;1;31;.969;3616000;0
16252;11614;775;0;0;0;0;.00nan;0;0
16252;180990;1492;52;31;4;27;.871;3600000;0
16252;73639;1492;0;0;0;0;.00nan;0;0
16252;154296;775;99;36;1;35;.972;3600000;0
16253;504;3730;0;0;0;0;.00nan;0;0
16253;66993;759;79;24;1;23;.958;3900000;0
16253;67446;759;0;0;0;0;.00nan;0;0
16253;76628;3730;83;21;1;20;.952;3900000;0
16254;185775;772;0;0;0;0;.00nan;0;0
16254;57993;772;88;34;2;32;.941;3600000;0
16254;82711;4924;0;0;0;0;.00nan;0;0
16254;158630;4924;78;37;3;34;.919;3573000;0
16255;595;3913;0;0;0;0;.00nan;0;0
16255;67122;1503;0;0;0;0;.00nan;0;0
16255;68689;1503;74;35;3;32;.914;3594000;0
16255;82817;3913;79;25;1;24;.960;3600000;0
16256;177124;2199;0;0;0;0;.00nan;0;0
16256;91358;767;83;35;2;33;.943;3584000;0
16256;94107;767;0;0;0;0;.00nan;0;0
16256;148576;2199;84;16;0;16;1.000;3600000;0
16257;6868;754;89;26;1;25;.962;3600000;0
16257;45363;754;0;0;0;0;.00nan;0;0
16257;82087;768;0;0;0;0;.00nan;0;0
16257;86099;768;87;33;2;31;.939;3572000;0
16258;-1;911;0;0;0;0;.00nan;0;0
16258;180177;911;81;19;1;18;.947;3600000;0
16258;197595;755;0;0;0;0;.00nan;0;0
16258;71485;755;61;27;3;24;.889;3536000;0
16259;-1;766;99;25;0;25;1.000;3900000;0
16259;91194;766;0;0;0;0;.00nan;0;0
16259;148904;1497;0;0;0;0;.00nan;0;0
16259;149191;1497;92;29;0;29;1.000;3900000;0
16260;8504;746;63;16;1;15;.938;3600000;0
16260;201933;746;0;0;0;0;.00nan;0;0
16260;148829;2545;80;53;5;48;.906;3600000;0
16260;149112;2545;0;0;0;0;.00nan;0;0
16261;11614;775;59;32;4;28;.875;3600000;0
16261;170543;4923;30;23;5;18;.783;3578000;0
16261;176686;4923;0;0;0;0;.00nan;0;0
16261;154296;775;0;0;0;0;.00nan;0;0
16262;170547;769;0;0;0;0;.00nan;0;0
16262;-1;769;49;32;4;28;.875;3600000;0
16262;82087;768;0;0;0;0;.00nan;0;0
16262;86099;768;37;21;5;16;.762;3543000;0
16263;174894;762;23;4;3;1;.250;393000;0
16263;63932;758;0;0;0;0;.00nan;0;0
16263;85395;758;79;27;2;25;.926;3600000;0
16263;148652;762;64;18;1;17;.944;3149000;0
16264;359;774;68;34;3;31;.912;3600000;0
16264;2140;1093;76;26;2;24;.923;3600000;0
16264;181910;774;0;0;0;0;.00nan;0;0
16264;68233;1093;0;0;0;0;.00nan;0;0
16265;180990;1492;66;39;4;35;.897;3600000;0
16265;73639;1492;0;0;0;0;.00nan;0;0
16265;91358;767;66;19;1;18;.947;3600000;0
16265;94107;767;0;0;0;0;.00nan;0;0
16266;504;3730;69;44;4;40;.909;3600000;0
16266;67818;3721;100;26;0;26;1.000;3600000;0
16266;76628;3730;0;0;0;0;.00nan;0;0
16266;149221;3721;0;0;0;0;.00nan;0;0
16267;164424;750;43;26;5;21;.808;3600000;0
16267;164521;750;0;0;0;0;.00nan;0;0
16267;185775;772;0;0;0;0;.00nan;0;0
16267;57993;772;71;25;2;23;.920;3600000;0
16268;595;3913;82;39;3;36;.923;3900000;0
16268;66993;759;71;27;3;24;.889;3900000;0
16268;67446;759;0;0;0;0;.00nan;0;0
16268;82817;3913;0;0;0;0;.00nan;0;0
16269;177124;2199;0;0;0;0;.00nan;0;0
16269;82711;4924;0;0;0;0;.00nan;0;0
16269;148576;2199;96;23;0;23;1.000;3600000;0
16269;158630;4924;36;23;5;18;.783;3600000;0
16270;6868;754;94;39;3;36;.923;3900000;0
16270;45363;754;0;0;0;0;.00nan;0;0
16270;67122;1503;74;25;3;22;.880;3900000;0
16270;68689;1503;0;0;0;0;.00nan;0;0
16271;8504;746;73;11;0;11;1.000;3600000;0
16271;201933;746;0;0;0;0;.00nan;0;0
16271;63932;758;0;0;0;0;.00nan;0;0
16271;85395;758;71;40;4;36;.900;3600000;0
16272;2140;1093;78;28;2;26;.929;3566000;0
16272;174894;762;94;23;0;23;1.000;3600000;0
16272;68233;1093;0;0;0;0;.00nan;0;0
16272;148652;762;0;0;0;0;.00nan;0;0
16273;504;3730;62;36;4;32;.889;3600000;0
16273;76628;3730;0;0;0;0;.00nan;0;0
16273;82087;768;0;0;0;0;.00nan;0;0
16273;86099;768;61;11;1;10;.909;3600000;0
16274;11614;775;0;0;0;0;.00nan;0;0
16274;185775;772;0;0;0;0;.00nan;0;0
16274;57993;772;97;23;0;23;1.000;3600000;0
16274;154296;775;97;40;1;39;.975;3564000;0
16275;595;3913;81;29;1;28;.966;3600000;0
16275;67818;3721;53;23;3;20;.870;3514000;0
16275;82817;3913;0;0;0;0;.00nan;0;0
16275;149221;3721;0;0;0;0;.00nan;0;0
16276;177124;2199;0;0;0;0;.00nan;0;0
16276;164424;750;93;19;0;19;1.000;3600000;0
16276;164521;750;0;0;0;0;.00nan;0;0
16276;148576;2199;80;26;1;25;.962;3541000;0
16277;180606;2197;0;0;0;0;.00nan;0;0
16277;56037;760;0;0;0;0;.00nan;0;0
16277;85489;760;80;31;2;29;.935;3882000;0
16277;94508;2197;74;35;3;32;.914;3882000;0
16278;2140;1093;29;12;4;8;.667;776000;0
16278;8504;746;68;25;2;23;.920;3600000;0
16278;201933;746;0;0;0;0;.00nan;0;0
16278;68233;1093;44;22;4;18;.818;2824000;0
16279;-1;911;0;0;0;0;.00nan;0;0
16279;180177;911;83;36;2;34;.944;3600000;0
16279;91358;767;66;36;4;32;.889;3572000;0
16279;94107;767;0;0;0;0;.00nan;0;0
16280;180990;1492;48;28;4;24;.857;3571000;0
16280;73639;1492;0;0;0;0;.00nan;0;0
16280;148829;2545;57;22;3;19;.864;3600000;0
16280;149112;2545;0;0;0;0;.00nan;0;0
16281;595;3913;68;42;5;37;.881;3600000;0
16281;82087;768;0;0;0;0;.00nan;0;0
16281;82817;3913;0;0;0;0;.00nan;0;0
16281;86099;768;75;25;2;23;.920;3600000;0
16282;-1;766;67;31;3;28;.903;3600000;0
16282;180606;2197;54;41;5;36;.878;3579000;0
16282;91194;766;0;0;0;0;.00nan;0;0
16282;94508;2197;0;0;0;0;.00nan;0;0
16283;197595;755;86;33;2;31;.939;3535000;0
16283;56037;760;0;0;0;0;.00nan;0;0
16283;71485;755;0;0;0;0;.00nan;0;0
16283;85489;760;100;23;0;23;1.000;3600000;0
16284;359;774;98;41;2;39;.951;3900000;0
16284;181910;774;0;0;0;0;.00nan;0;0
16284;66993;759;67;19;2;17;.895;3887000;0
16284;67446;759;0;0;0;0;.00nan;0;0
16285;6868;754;88;42;3;39;.929;3600000;0
16285;170547;769;35;29;5;24;.828;3575000;0
16285;45363;754;0;0;0;0;.00nan;0;0
16285;-1;769;0;0;0;0;.00nan;0;0
16286;170543;4923;100;32;0;32;1.000;3600000;0
16286;176686;4923;0;0;0;0;.00nan;0;0
16286;148829;2545;59;15;1;14;.933;3549000;0
16286;149112;2545;0;0;0;0;.00nan;0;0
16287;180990;1492;59;16;1;15;.938;3600000;0
16287;63932;758;88;38;3;35;.921;3600000;0
16287;73639;1492;0;0;0;0;.00nan;0;0
16287;85395;758;0;0;0;0;.00nan;0;0
16288;164424;750;83;25;1;24;.960;3600000;0
16288;164521;750;0;0;0;0;.00nan;0;0
16288;-1;911;0;0;0;0;.00nan;0;0
16288;180177;911;60;27;3;24;.889;3600000;0
16289;359;774;87;47;3;44;.936;3600000;0
16289;181910;774;0;0;0;0;.00nan;0;0
16289;67122;1503;0;0;0;0;.00nan;0;0
16289;68689;1503;96;24;0;24;1.000;3600000;0
16290;-1;766;90;38;3;35;.921;3900000;0
16290;170530;755;0;0;0;0;.00nan;0;0
16290;71485;755;85;44;3;41;.932;3900000;0
16290;91194;766;0;0;0;0;.00nan;0;0
16291;177124;2199;57;23;3;20;.870;3645000;0
16291;185775;772;0;0;0;0;.00nan;0;0
16291;57993;772;81;29;2;27;.931;3645000;0
16291;148576;2199;0;0;0;0;.00nan;0;0
16292;169615;4989;0;0;0;0;.00nan;0;0
16292;66993;759;54;17;2;15;.882;3600000;0
16292;67446;759;0;0;0;0;.00nan;0;0
16292;76406;4989;71;39;4;35;.897;3550000;0
16293;8504;746;66;19;2;17;.895;3627000;0
16293;201933;746;0;0;0;0;.00nan;0;0
16293;82087;768;0;0;0;0;.00nan;0;0
16293;86099;768;78;39;3;36;.923;3627000;0
16294;170543;4923;68;25;2;23;.920;3600000;0
16294;176686;4923;0;0;0;0;.00nan;0;0
16294;63932;758;0;0;0;0;.00nan;0;0
16294;85395;758;43;36;6;30;.833;3600000;0
16295;2140;1093;0;0;0;0;.00nan;0;0
16295;180990;1492;42;27;5;22;.815;3600000;0
16295;68233;1093;62;27;3;24;.889;3600000;0
16295;73639;1492;0;0;0;0;.00nan;0;0
16296;504;3730;80;54;5;49;.907;3600000;0
16296;595;3913;58;22;3;19;.864;3600000;0
16296;76628;3730;0;0;0;0;.00nan;0;0
16296;82817;3913;0;0;0;0;.00nan;0;0
16297;174894;762;95;32;1;31;.969;3600000;0
16297;67818;3721;0;0;0;0;.00nan;0;0
16297;148652;762;0;0;0;0;.00nan;0;0
16297;149221;3721;69;33;3;30;.909;3542000;0
16298;11614;775;0;0;0;0;.00nan;0;0
16298;-1;911;0;0;0;0;.00nan;0;0
16298;180177;911;74;34;3;31;.912;3900000;0
16298;154296;775;74;35;3;32;.914;3900000;0
16299;164424;750;64;22;2;20;.909;3600000;0
16299;164521;750;0;0;0;0;.00nan;0;0
16299;148904;1497;0;0;0;0;.00nan;0;0
16299;149191;1497;100;36;1;35;.972;3600000;0
16300;169615;4989;0;0;0;0;.00nan;0;0
16300;67122;1503;0;0;0;0;.00nan;0;0
16300;68689;1503;56;36;4;32;.889;3592000;0
16300;76406;4989;76;31;3;28;.903;3600000;0
16301;-1;766;88;26;1;25;.962;3600000;0
16301;56037;760;0;0;0;0;.00nan;0;0
16301;85489;760;71;34;3;31;.912;3540000;0
16301;91194;766;0;0;0;0;.00nan;0;0
16302;170530;755;0;0;0;0;.00nan;0;0
16302;180606;2197;0;0;0;0;.00nan;0;0
16302;71485;755;46;27;4;23;.852;3600000;0
16302;94508;2197;94;45;3;42;.933;3600000;0
16303;91358;767;77;25;1;24;.960;3900000;0
16303;94107;767;0;0;0;0;.00nan;0;0
16303;148904;1497;0;0;0;0;.00nan;0;0
16303;149191;1497;96;35;1;34;.971;3900000;0
16304;174894;762;87;39;2;37;.949;3534000;0
16304;82087;768;0;0;0;0;.00nan;0;0
16304;86099;768;100;27;0;27;1.000;3600000;0
16304;148652;762;0;0;0;0;.00nan;0;0
16305;-1;911;0;0;0;0;.00nan;0;0
16305;180177;911;83;24;1;23;.958;3768000;0
16305;82711;4924;71;29;2;27;.931;3768000;0
16305;158630;4924;0;0;0;0;.00nan;0;0
16306;2140;1093;63;31;3;28;.903;3530000;0
16306;170543;4923;70;23;1;22;.957;3600000;0
16306;176686;4923;0;0;0;0;.00nan;0;0
16306;68233;1093;0;0;0;0;.00nan;0;0
16307;8504;746;84;34;2;32;.941;3600000;0
16307;201933;746;0;0;0;0;.00nan;0;0
16307;67818;3721;68;20;1;19;.950;3600000;0
16307;149221;3721;0;0;0;0;.00nan;0;0
16308;185775;772;0;0;0;0;.00nan;0;0
16308;57993;772;47;15;3;12;.800;3600000;0
16308;148829;2545;0;0;0;0;.00nan;0;0
16308;149112;2545;59;32;4;28;.875;3577000;0
16309;504;3730;59;30;4;26;.867;3555000;0
16309;170547;769;78;26;2;24;.923;3600000;0
16309;56037;769;0;0;0;0;.00nan;0;0
16309;76628;3730;0;0;0;0;.00nan;0;0
16310;595;3913;71;25;2;23;.920;3600000;0
16310;6868;754;58;28;4;24;.857;2303000;0
16310;197595;754;63;14;1;13;.929;1297000;0
16310;82817;3913;0;0;0;0;.00nan;0;0
16311;93756;2199;0;0;0;0;.00nan;0;0
16311;148576;2199;97;25;0;25;1.000;3600000;0
16311;148829;2545;0;0;0;0;.00nan;0;0
16311;149112;2545;81;33;2;31;.939;3577000;0
16312;359;774;45;45;6;39;.867;3515000;0
16312;181910;774;0;0;0;0;.00nan;0;0
16312;82087;768;0;0;0;0;.00nan;0;0
16312;86099;768;45;27;4;23;.852;3600000;0
16313;185775;772;0;0;0;0;.00nan;0;0
16313;57993;772;72;24;2;22;.917;3600000;0
16313;63932;758;0;0;0;0;.00nan;0;0
16313;85395;758;70;33;3;30;.909;3563000;0
16314;169615;4989;0;0;0;0;.00nan;0;0
16314;196715;3721;0;0;0;0;.00nan;0;0
16314;67818;3721;70;25;2;23;.920;3576000;0
16314;76406;4989;100;47;1;46;.979;3600000;0
16315;8504;746;71;28;2;26;.929;3600000;0
16315;201933;746;0;0;0;0;.00nan;0;0
16315;67122;1503;0;0;0;0;.00nan;0;0
16315;68689;1503;84;47;4;43;.915;3526000;0
16316;170543;4923;40;30;5;25;.833;3600000;0
16316;176686;4923;0;0;0;0;.00nan;0;0
16316;180990;1492;90;29;1;28;.966;3600000;0
16316;73639;1492;0;0;0;0;.00nan;0;0
16317;595;3913;99;37;2;35;.946;3600000;0
16317;170547;769;61;26;3;23;.885;3551000;0
16317;56037;769;0;0;0;0;.00nan;0;0
16317;82817;3913;0;0;0;0;.00nan;0;0
16318;164424;750;95;35;1;34;.971;3600000;0
16318;164521;750;0;0;0;0;.00nan;0;0
16318;-1;766;67;24;2;22;.917;3545000;0
16318;91194;766;0;0;0;0;.00nan;0;0
16319;177124;775;0;0;0;0;.00nan;0;0
16319;180606;1497;0;0;0;0;.00nan;0;0
16319;149191;1497;65;20;1;19;.950;3600000;0
16319;154296;775;81;33;2;31;.939;3582000;0
16320;504;3730;44;29;5;24;.828;3600000;0
16320;6868;754;0;0;0;0;.00nan;0;0
16320;197595;754;67;50;6;44;.880;3567000;0
16320;76628;3730;0;0;0;0;.00nan;0;0
16321;174894;762;61;37;5;32;.865;3600000;0
16321;66993;759;68;17;1;16;.941;3600000;0
16321;67446;759;0;0;0;0;.00nan;0;0
16321;148652;762;0;0;0;0;.00nan;0;0
16322;169615;4989;0;0;0;0;.00nan;0;0
16322;76406;4989;97;38;1;37;.974;3900000;0
16322;82087;768;0;0;0;0;.00nan;0;0
16322;86099;768;100;35;1;34;.971;3900000;0
16323;63932;758;96;35;2;33;.943;3600000;0
16323;85395;758;0;0;0;0;.00nan;0;0
16323;93756;2199;46;11;3;8;.727;1403000;0
16323;148576;2199;37;25;5;20;.800;2197000;0
16324;2140;1093;73;31;2;29;.935;3900000;0
16324;185775;772;0;0;0;0;.00nan;0;0
16324;57993;772;80;23;2;21;.913;3900000;0
16324;68233;1093;0;0;0;0;.00nan;0;0
16325;359;774;70;18;1;17;.944;3600000;0
16325;181910;774;0;0;0;0;.00nan;0;0
16325;196715;3721;0;0;0;0;.00nan;0;0
16325;67818;3721;67;27;3;24;.889;3527000;0
16326;174894;762;87;32;1;31;.969;3600000;0
16326;67122;1503;62;34;4;30;.882;3600000;0
16326;68689;1503;0;0;0;0;.00nan;0;0
16326;148652;762;0;0;0;0;.00nan;0;0
16327;-1;766;66;19;2;17;.895;3600000;0
16327;91194;766;0;0;0;0;.00nan;0;0
16327;91358;767;63;35;4;31;.886;3554000;0
16327;94107;767;0;0;0;0;.00nan;0;0
16328;180606;1497;0;0;0;0;.00nan;0;0
16328;82711;4924;0;0;0;0;.00nan;0;0
16328;149191;1497;91;33;1;32;.970;3900000;0
16328;158630;4924;81;25;1;24;.960;3900000;0
16329;164424;750;46;40;6;34;.850;3301000;0
16329;164521;750;53;4;0;4;1.000;299000;0
16329;169680;760;0;0;0;0;.00nan;0;0
16329;85489;760;74;29;2;27;.931;3600000;0
16330;8504;746;73;40;4;36;.900;3600000;0
16330;201933;746;0;0;0;0;.00nan;0;0
16330;66993;759;67;35;3;32;.914;3600000;0
16330;67446;759;0;0;0;0;.00nan;0;0
16331;2140;1093;67;25;2;23;.920;3600000;0
16331;68233;1093;0;0;0;0;.00nan;0;0
16331;93756;2199;0;0;0;0;.00nan;0;0
16331;148576;2199;72;36;4;32;.889;3591000;0
16332;164424;750;56;24;3;21;.875;3793000;0
16332;164521;750;0;0;0;0;.00nan;0;0
16332;11614;2197;66;35;4;31;.886;3793000;0
16332;94508;2197;0;0;0;0;.00nan;0;0
16333;177124;775;54;27;4;23;.852;3531000;0
16333;-1;766;82;28;2;26;.929;3600000;0
16333;91194;766;0;0;0;0;.00nan;0;0
16333;154296;775;0;0;0;0;.00nan;0;0
16334;-1;911;0;0;0;0;.00nan;0;0
16334;180177;911;100;35;1;34;.971;3600000;0
16334;148829;2545;59;32;4;28;.875;3600000;0
16334;149112;2545;0;0;0;0;.00nan;0;0
16335;169680;760;0;0;0;0;.00nan;0;0
16335;85489;760;91;29;0;29;1.000;3600000;0
16335;91358;767;47;24;3;21;.875;3600000;0
16335;94107;767;0;0;0;0;.00nan;0;0
16336;6868;754;0;0;0;0;.00nan;0;0
16336;169615;4989;0;0;0;0;.00nan;0;0
16336;197595;754;42;28;5;23;.821;3600000;0
16336;76406;4989;71;22;1;21;.955;3600000;0
16337;170543;4923;0;0;0;0;.00nan;0;0
16337;176686;4923;70;52;7;45;.865;3600000;0
16337;66993;759;80;26;2;24;.923;3600000;0
16337;67446;759;0;0;0;0;.00nan;0;0
16338;359;774;77;19;1;18;.947;3600000;0
16338;170547;769;74;39;4;35;.897;3600000;0
16338;181910;774;0;0;0;0;.00nan;0;0
16338;56037;769;0;0;0;0;.00nan;0;0
16339;180990;1492;33;31;6;25;.806;3596000;0
16339;67122;1503;0;0;0;0;.00nan;0;0
16339;68689;1503;54;39;5;34;.872;3600000;0
16339;73639;1492;0;0;0;0;.00nan;0;0
16340;196715;3721;0;0;0;0;.00nan;0;0
16340;185775;772;0;0;0;0;.00nan;0;0
16340;57993;772;88;22;0;22;1.000;3600000;0
16340;67818;3721;70;20;1;19;.950;3548000;0
16341;11614;2197;66;34;4;30;.882;3822000;0
16341;91358;767;59;24;3;21;.875;3822000;0
16341;94107;767;0;0;0;0;.00nan;0;0
16341;94508;2197;0;0;0;0;.00nan;0;0
16342;-1;766;86;29;1;28;.966;3900000;0
16342;82711;4924;0;0;0;0;.00nan;0;0
16342;91194;766;0;0;0;0;.00nan;0;0
16342;158630;4924;88;36;1;35;.972;3900000;0
16343;-1;911;0;0;0;0;.00nan;0;0
16343;180177;911;50;17;2;15;.882;3900000;0
16343;63932;758;0;0;0;0;.00nan;0;0
16343;85395;758;91;50;2;48;.960;3892000;0
16344;180606;1497;47;35;6;29;.829;3558000;0
16344;148829;2545;65;32;4;28;.875;3600000;0
16344;149112;2545;0;0;0;0;.00nan;0;0
16344;149191;1497;0;0;0;0;.00nan;0;0
16345;177124;775;0;0;0;0;.00nan;0;0
16345;169680;760;0;0;0;0;.00nan;0;0
16345;85489;760;87;26;1;25;.962;3600000;0
16345;154296;775;91;44;2;42;.955;3544000;0
16346;164424;750;92;26;1;25;.962;3600000;0
16346;164521;750;0;0;0;0;.00nan;0;0
16346;170530;755;0;0;0;0;.00nan;0;0
16346;71485;755;76;35;2;33;.943;3560000;0
16347;6868;754;0;0;0;0;.00nan;0;0
16347;8504;746;0;0;0;0;.00nan;0;0
16347;201933;746;77;23;1;22;.957;3600000;0
16347;197595;754;80;48;4;44;.917;3600000;0
16348;504;3730;49;24;3;21;.875;3532000;0
16348;169615;4989;0;0;0;0;.00nan;0;0
16348;76406;4989;96;31;1;30;.968;3600000;0
16348;76628;3730;0;0;0;0;.00nan;0;0
16349;170543;4923;26;14;4;10;.714;921000;0
16349;176686;4923;58;33;4;29;.879;2679000;0
16349;196715;3721;0;0;0;0;.00nan;0;0
16349;67818;3721;69;21;2;19;.905;3600000;0
16350;170547;769;82;36;2;34;.944;3562000;0
16350;174894;762;0;0;0;0;.00nan;0;0
16350;56037;769;0;0;0;0;.00nan;0;0
16350;148652;762;93;20;0;20;1.000;3600000;0
16351;359;774;95;36;2;34;.944;3600000;0
16351;595;3913;69;41;5;36;.878;3554000;0
16351;181910;774;0;0;0;0;.00nan;0;0
16351;82817;3913;0;0;0;0;.00nan;0;0
16352;3957;759;0;0;0;0;.00nan;0;0
16352;180990;1492;56;36;4;32;.889;3600000;0
16352;66993;759;72;19;1;18;.947;3600000;0
16352;67446;1492;0;0;0;0;.00nan;0;0
16353;185775;772;0;0;0;0;.00nan;0;0
16353;57993;772;91;33;1;32;.970;3900000;0
16353;82087;768;0;0;0;0;.00nan;0;0
16353;86099;768;77;20;1;19;.950;3898000;0
16354;67122;1503;0;0;0;0;.00nan;0;0
16354;68689;1503;100;36;0;36;1.000;3600000;0
16354;93756;2199;42;22;4;18;.818;3600000;0
16354;148576;2199;0;0;0;0;.00nan;0;0
16355;177124;775;0;0;0;0;.00nan;0;0
16355;11614;2197;0;0;0;0;.00nan;0;0
16355;180990;775;55;31;4;27;.871;3514000;0
16355;63932;2197;54;18;2;16;.889;3600000;0
16356;2140;1093;89;26;1;25;.962;3900000;0
16356;3199;911;0;0;0;0;.00nan;0;0
16356;180177;911;91;31;1;30;.968;3900000;0
16356;68233;1093;0;0;0;0;.00nan;0;0
16357;3256;758;0;0;0;0;.00nan;0;0
16357;170548;758;68;31;3;28;.903;3581000;0
16357;148576;1497;91;28;1;27;.964;3600000;0
16357;149191;1497;0;0;0;0;.00nan;0;0
16358;169680;760;0;0;0;0;.00nan;0;0
16358;82711;4924;0;0;0;0;.00nan;0;0
16358;85489;760;52;39;5;34;.872;3600000;0
16358;158630;4924;58;24;2;22;.917;3600000;0
16359;170530;755;0;0;0;0;.00nan;0;0
16359;71485;755;100;26;0;26;1.000;3600000;0
16359;91358;767;78;35;3;32;.914;3600000;0
16359;94107;767;0;0;0;0;.00nan;0;0
16360;8504;746;89;18;0;18;1.000;3600000;0
16360;170547;769;98;45;1;44;.978;3585000;0
16360;201933;746;0;0;0;0;.00nan;0;0
16360;56037;769;0;0;0;0;.00nan;0;0
16361;595;3913;55;18;2;16;.889;3900000;0
16361;-1;4989;90;37;2;35;.946;3900000;0
16361;169615;4989;0;0;0;0;.00nan;0;0
16361;82817;3913;0;0;0;0;.00nan;0;0
16362;3241;768;0;0;0;0;.00nan;0;0
16362;170543;4923;100;49;3;46;.939;3600000;0
16362;176686;4923;0;0;0;0;.00nan;0;0
16362;86099;768;43;20;4;16;.800;3590000;0
16363;359;762;67;16;1;15;.938;3600000;0
16363;197595;754;0;0;0;0;.00nan;0;0
16363;85395;754;82;42;3;39;.929;3545000;0
16363;154296;762;0;0;0;0;.00nan;0;0
16364;504;3730;60;37;4;33;.892;3564000;0
16364;181910;774;75;24;2;22;.917;3600000;0
16364;67294;774;0;0;0;0;.00nan;0;0
16364;76628;3730;0;0;0;0;.00nan;0;0
16365;196715;3721;0;0;0;0;.00nan;0;0
16365;67446;1492;90;35;1;34;.971;3900000;0
16365;67818;3721;74;22;1;21;.955;3900000;0
16365;73639;1492;0;0;0;0;.00nan;0;0
16366;185775;772;0;0;0;0;.00nan;0;0
16366;57993;772;100;27;0;27;1.000;3600000;0
16366;67122;1503;0;0;0;0;.00nan;0;0
16366;68689;1503;73;26;1;25;.962;3575000;0
16367;3957;759;0;0;0;0;.00nan;0;0
16367;66993;759;70;27;3;24;.889;3572000;0
16367;87758;2199;0;0;0;0;.00nan;0;0
16367;93756;2199;97;41;1;40;.976;3600000;0
16368;11614;2197;58;29;3;26;.897;3600000;0
16368;63932;2197;0;0;0;0;.00nan;0;0
16368;82711;4924;0;0;0;0;.00nan;0;0
16368;158630;4924;76;20;1;19;.950;3600000;0
16369;-1;766;37;33;6;27;.818;2381000;0
16369;91194;766;53;5;0;5;1.000;1187000;0
16369;148829;2545;42;3;1;2;.667;432000;0
16369;149112;2545;48;27;4;23;.852;3168000;0
16370;2140;1093;77;45;5;40;.889;3797000;0
16370;68233;1093;0;0;0;0;.00nan;0;0
16370;148576;1497;44;23;4;19;.826;3797000;0
16370;149191;1497;0;0;0;0;.00nan;0;0
16371;177124;775;0;0;0;0;.00nan;0;0
16371;170530;755;0;0;0;0;.00nan;0;0
16371;180990;775;89;21;0;21;1.000;3600000;0
16371;71485;755;77;25;1;24;.960;3546000;0
16372;595;3913;89;38;3;35;.921;3600000;0
16372;8504;746;57;19;2;17;.895;3600000;0
16372;201933;746;0;0;0;0;.00nan;0;0
16372;82817;3913;0;0;0;0;.00nan;0;0
16373;-1;4989;0;0;0;0;.00nan;0;0
16373;169615;4989;87;30;1;29;.967;3671000;0
16373;170547;769;81;33;2;31;.939;3671000;0
16373;56037;769;0;0;0;0;.00nan;0;0
16374;170543;4923;57;25;3;22;.880;3558000;0
16374;176686;4923;0;0;0;0;.00nan;0;0
16374;67122;1503;0;0;0;0;.00nan;0;0
16374;68689;1503;77;25;2;23;.920;3600000;0
16375;359;762;89;20;0;20;1.000;3600000;0
16375;504;3730;42;32;5;27;.844;3600000;0
16375;76628;3730;0;0;0;0;.00nan;0;0
16375;154296;762;0;0;0;0;.00nan;0;0
16376;181910;774;0;0;0;0;.00nan;0;0
16376;197595;754;0;0;0;0;.00nan;0;0
16376;67294;774;26;7;3;4;.571;3600000;0
16376;85395;754;98;60;4;56;.933;3600000;0
16377;3241;768;0;0;0;0;.00nan;0;0
16377;67446;1492;100;50;1;49;.980;3600000;0
16377;73639;1492;0;0;0;0;.00nan;0;0
16377;86099;768;42;24;4;20;.833;3600000;0
16378;3957;759;0;0;0;0;.00nan;0;0
16378;185775;772;0;0;0;0;.00nan;0;0
16378;57993;772;72;30;3;27;.900;3900000;0
16378;66993;759;64;26;3;23;.885;3900000;0
16379;196715;3721;0;0;0;0;.00nan;0;0
16379;67818;3721;73;26;2;24;.923;3900000;0
16379;87758;2199;0;0;0;0;.00nan;0;0
16379;93756;2199;84;34;2;32;.941;3900000;0
16380;169680;760;0;0;0;0;.00nan;0;0
16380;85489;760;71;32;3;29;.906;3600000;0
16380;148829;2545;0;0;0;0;.00nan;0;0
16380;149112;2545;100;25;0;25;1.000;3600000;0
16381;3256;758;0;0;0;0;.00nan;0;0
16381;-1;766;65;16;1;15;.938;3600000;0
16381;170548;758;81;33;2;31;.939;3600000;0
16381;91194;766;0;0;0;0;.00nan;0;0
16382;170530;755;77;38;3;35;.921;3563000;0
16382;71485;755;0;0;0;0;.00nan;0;0
16382;82711;4924;0;0;0;0;.00nan;0;0
16382;158630;4924;53;14;2;12;.857;3600000;0
16383;504;3730;90;45;2;43;.956;3600000;0
16383;8504;746;62;29;3;26;.897;3563000;0
16383;201933;746;0;0;0;0;.00nan;0;0
16383;76628;3730;0;0;0;0;.00nan;0;0
16384;359;762;83;31;2;29;.935;3600000;0
16384;595;3913;93;26;1;25;.962;3600000;0
16384;82817;3913;0;0;0;0;.00nan;0;0
16384;154296;762;0;0;0;0;.00nan;0;0
16385;164424;750;24;21;5;16;.762;2381000;0
16385;164521;750;56;11;1;10;.909;1519000;0
16385;91358;767;67;10;0;10;1.000;854000;0
16385;94107;767;46;35;6;29;.829;3046000;0
16386;3241;768;0;0;0;0;.00nan;0;0
16386;86099;768;73;27;2;25;.926;3600000;0
16386;87758;2199;0;0;0;0;.00nan;0;0
16386;93756;2199;82;50;5;45;.900;3600000;0
16387;11614;2197;83;38;2;36;.947;3519000;0
16387;63932;2197;0;0;0;0;.00nan;0;0
16387;148829;2545;0;0;0;0;.00nan;0;0
16387;149112;2545;88;17;0;17;1.000;3600000;0
16388;3256;758;75;41;3;38;.927;3551000;0
16388;169680;760;0;0;0;0;.00nan;0;0
16388;170548;758;0;0;0;0;.00nan;0;0
16388;85489;760;60;22;2;20;.909;3600000;0
16389;2140;1093;85;41;3;38;.927;3841000;0
16389;-1;766;72;23;2;21;.913;3841000;0
16389;68233;1093;0;0;0;0;.00nan;0;0
16389;91194;766;0;0;0;0;.00nan;0;0
16390;67122;1503;0;0;0;0;.00nan;0;0
16390;68689;1503;48;21;4;17;.810;3665000;0
16390;148576;1497;82;51;5;46;.902;3665000;0
16390;149191;1497;0;0;0;0;.00nan;0;0
16391;170547;769;64;24;2;22;.917;3600000;0
16391;56037;769;0;0;0;0;.00nan;0;0
16391;67446;1492;24;35;7;28;.800;2848000;0
16391;73639;1492;63;11;0;11;1.000;752000;0
16392;177124;775;0;0;0;0;.00nan;0;0
16392;164424;750;0;0;0;0;.00nan;0;0
16392;164521;750;100;23;0;23;1.000;3600000;0
16392;180990;775;91;37;1;36;.973;3600000;0
16393;170543;4923;49;31;5;26;.839;3809000;0
16393;176686;4923;0;0;0;0;.00nan;0;0
16393;197595;754;0;0;0;0;.00nan;0;0
16393;85395;754;67;40;4;36;.900;3809000;0
16394;3199;911;0;0;0;0;.00nan;0;0
16394;3957;759;0;0;0;0;.00nan;0;0
16394;180177;911;80;24;1;23;.958;3600000;0
16394;66993;759;55;17;2;15;.882;3564000;0
16395;170530;755;0;0;0;0;.00nan;0;0
16395;71485;755;62;35;4;31;.886;3600000;0
16395;148829;2545;0;0;0;0;.00nan;0;0
16395;149112;2545;77;15;0;15;1.000;3600000;0
16396;3256;758;0;0;0;0;.00nan;0;0
16396;11614;2197;77;30;2;28;.933;3900000;0
16396;170548;758;79;27;2;25;.926;3900000;0
16396;63932;2197;0;0;0;0;.00nan;0;0
16397;2140;1093;25;24;6;18;.750;2749000;0
16397;169680;760;97;29;0;29;1.000;3093000;0
16397;68233;1093;54;10;1;9;.900;851000;0
16397;85489;760;31;8;3;5;.625;507000;0
16398;3199;911;0;0;0;0;.00nan;0;0
16398;180177;911;54;37;5;32;.865;3600000;0
16398;67122;1503;71;28;2;26;.929;3600000;0
16398;68689;1503;0;0;0;0;.00nan;0;0
16399;170547;769;93;35;1;34;.971;3600000;0
16399;56037;769;0;0;0;0;.00nan;0;0
16399;87758;2199;0;0;0;0;.00nan;0;0
16399;93756;2199;53;27;3;24;.889;3516000;0
16400;177124;775;0;0;0;0;.00nan;0;0
16400;180990;775;94;42;2;40;.952;3570000;0
16400;91358;767;81;28;1;27;.964;3600000;0
16400;94107;767;0;0;0;0;.00nan;0;0
16401;504;3730;51;2;0;2;1.000;278000;0
16401;67446;1492;99;34;1;33;.971;3600000;0
16401;73639;1492;0;0;0;0;.00nan;0;0
16401;76628;3730;47;38;6;32;.842;3322000;0
16402;595;3913;37;18;4;14;.778;3600000;0
16402;170543;4923;100;37;1;36;.973;3600000;0
16402;176686;4923;0;0;0;0;.00nan;0;0
16402;82817;3913;0;0;0;0;.00nan;0;0
16403;164424;750;0;0;0;0;.00nan;0;0
16403;164521;750;36;31;6;25;.806;3569000;0
16403;82711;4924;0;0;0;0;.00nan;0;0
16403;158630;4924;40;23;4;19;.826;3600000;0
16404;192065;772;0;0;0;0;.00nan;0;0
16404;197595;754;0;0;0;0;.00nan;0;0
16404;57993;772;62;17;1;16;.941;3600000;0
16404;85395;754;79;31;2;29;.935;3550000;0
16405;3957;759;0;0;0;0;.00nan;0;0
16405;66993;759;61;31;3;28;.903;3900000;0
16405;148576;1497;94;53;3;50;.943;3900000;0
16405;149191;1497;0;0;0;0;.00nan;0;0
16406;8504;746;63;29;3;26;.897;3600000;0
16406;201933;746;0;0;0;0;.00nan;0;0
16406;181910;774;97;40;2;38;.950;3600000;0
16406;67294;774;0;0;0;0;.00nan;0;0
16407;359;762;0;0;0;0;.00nan;0;0
16407;-1;4989;0;0;0;0;.00nan;0;0
16407;169615;4989;65;36;5;31;.861;3557000;0
16407;154296;762;51;21;3;18;.857;3600000;0
16408;3256;758;0;0;0;0;.00nan;0;0
16408;170530;755;0;0;0;0;.00nan;0;0
16408;170548;758;51;15;2;13;.867;3549000;0
16408;71485;755;100;39;0;39;1.000;3600000;0
16409;2140;1093;0;0;0;0;.00nan;0;0
16409;11614;2197;56;6;0;6;1.000;1234000;0
16409;63932;2197;51;33;4;29;.879;2322000;0
16409;68233;1093;88;32;2;30;.938;3600000;0
16410;170547;769;91;48;3;45;.938;3900000;0
16410;192065;772;0;0;0;0;.00nan;0;0
16410;56037;769;0;0;0;0;.00nan;0;0
16410;57993;772;70;28;3;25;.893;3900000;0
16411;82711;4924;0;0;0;0;.00nan;0;0
16411;91358;767;81;30;2;28;.933;3900000;0
16411;94107;767;0;0;0;0;.00nan;0;0
16411;158630;4924;70;24;2;22;.917;3900000;0
16412;3199;911;0;0;0;0;.00nan;0;0
16412;3241;768;0;0;0;0;.00nan;0;0
16412;180177;911;81;44;4;40;.909;3518000;0
16412;86099;768;61;20;2;18;.900;3600000;0
16413;504;3730;84;35;2;33;.943;3600000;0
16413;170543;4923;0;0;0;0;.00nan;0;0
16413;176686;4923;98;38;1;37;.974;3600000;0
16413;76628;3730;0;0;0;0;.00nan;0;0
16414;595;3913;100;23;0;23;1.000;3600000;0
16414;67446;1492;82;38;2;36;.947;3600000;0
16414;73639;1492;0;0;0;0;.00nan;0;0
16414;82817;3913;0;0;0;0;.00nan;0;0
16415;196715;3721;71;20;1;19;.950;3600000;0
16415;67818;3721;0;0;0;0;.00nan;0;0
16415;148576;1497;82;44;4;40;.909;3600000;0
16415;149191;1497;0;0;0;0;.00nan;0;0
16416;197595;754;0;0;0;0;.00nan;0;0
16416;85395;754;99;41;2;39;.951;3673000;0
16416;87758;2199;0;0;0;0;.00nan;0;0
16416;93756;2199;60;26;3;23;.885;3673000;0
16417;8504;746;66;16;1;15;.938;3600000;0
16417;-1;4989;0;0;0;0;.00nan;0;0
16417;169615;4989;86;39;2;37;.949;3600000;0
16417;201933;746;0;0;0;0;.00nan;0;0
16418;359;762;76;32;3;29;.906;3900000;0
16418;181910;774;0;0;0;0;.00nan;0;0
16418;67294;774;67;31;3;28;.903;3900000;0
16418;154296;762;0;0;0;0;.00nan;0;0
16419;2140;1093;78;29;3;26;.897;3630000;0
16419;170530;755;0;0;0;0;.00nan;0;0
16419;68233;1093;0;0;0;0;.00nan;0;0
16419;71485;755;84;33;2;31;.939;3630000;0
16420;170543;4923;18;8;4;4;.500;998000;0
16420;170547;769;70;20;1;19;.950;3600000;0
16420;176686;4923;19;24;6;18;.750;2602000;0
16420;56037;769;0;0;0;0;.00nan;0;0
16421;3241;768;0;0;0;0;.00nan;0;0
16421;86099;768;84;34;2;32;.941;3600000;0
16421;148576;1497;80;28;1;27;.964;3600000;0
16421;149191;1497;0;0;0;0;.00nan;0;0
16422;504;3730;62;33;4;29;.879;3600000;0
16422;192065;772;0;0;0;0;.00nan;0;0
16422;57993;772;71;25;2;23;.920;3600000;0
16422;76628;3730;0;0;0;0;.00nan;0;0
16423;595;3913;81;23;1;22;.957;3600000;0
16423;82817;3913;0;0;0;0;.00nan;0;0
16423;87758;2199;0;0;0;0;.00nan;0;0
16423;93756;2199;53;24;3;21;.875;3600000;0
16424;3199;911;0;0;0;0;.00nan;0;0
16424;180177;911;78;42;5;37;.881;3600000;0
16424;196715;3721;0;0;0;0;.00nan;0;0
16424;67818;3721;57;13;1;12;.923;3600000;0
16425;177124;775;73;32;2;30;.938;3600000;0
16425;180990;775;0;0;0;0;.00nan;0;0
16425;82711;4924;0;0;0;0;.00nan;0;0
16425;158630;4924;99;36;1;35;.972;3600000;0
16426;197595;754;55;27;3;24;.889;3576000;0
16426;67446;1492;64;17;1;16;.941;3600000;0
16426;73639;1492;0;0;0;0;.00nan;0;0
16426;85395;754;0;0;0;0;.00nan;0;0
16427;164424;750;66;30;3;27;.900;3548000;0
16427;164521;750;0;0;0;0;.00nan;0;0
16427;148829;2545;0;0;0;0;.00nan;0;0
16427;149112;2545;99;38;2;36;.947;3600000;0
16428;-1;766;47;23;4;19;.826;3600000;0
16428;67122;1503;33;12;3;9;.750;1376000;0
16428;68689;1503;26;22;5;17;.773;2224000;0
16428;91194;766;0;0;0;0;.00nan;0;0
16429;504;3730;95;36;1;35;.972;3600000;0
16429;76628;3730;0;0;0;0;.00nan;0;0
16429;87758;2199;0;0;0;0;.00nan;0;0
16429;93756;2199;50;15;2;13;.867;3587000;0
16430;3957;759;0;0;0;0;.00nan;0;0
16430;169680;760;0;0;0;0;.00nan;0;0
16430;66993;759;66;19;1;18;.947;3600000;0
16430;85489;760;76;54;5;49;.907;3600000;0
16431;595;3913;95;36;0;36;1.000;3900000;0
16431;192065;772;0;0;0;0;.00nan;0;0
16431;57993;772;100;33;0;33;1.000;3900000;0
16431;82817;3913;0;0;0;0;.00nan;0;0
16432;359;762;82;37;3;34;.919;3593000;0
16432;8504;746;74;30;2;28;.933;3600000;0
16432;201933;746;0;0;0;0;.00nan;0;0
16432;154296;762;0;0;0;0;.00nan;0;0
16433;91358;767;80;27;2;25;.926;3900000;0
16433;94107;767;0;0;0;0;.00nan;0;0
16433;148829;2545;74;29;2;27;.931;3900000;0
16433;149112;2545;0;0;0;0;.00nan;0;0
16434;177124;775;0;0;0;0;.00nan;0;0
16434;3256;758;0;0;0;0;.00nan;0;0
16434;170548;758;57;27;3;24;.889;3567000;0
16434;180990;775;76;34;2;32;.941;3600000;0
16435;2140;1093;70;30;2;28;.933;3900000;0
16435;164424;750;63;21;2;19;.905;3898000;0
16435;164521;750;0;0;0;0;.00nan;0;0
16435;68233;1093;0;0;0;0;.00nan;0;0
16436;170543;4923;48;16;2;14;.875;3580000;0
16436;176686;4923;0;0;0;0;.00nan;0;0
16436;181910;774;79;26;1;25;.962;3600000;0
16436;67294;774;0;0;0;0;.00nan;0;0
16437;3957;759;0;0;0;0;.00nan;0;0
16437;11614;2197;45;41;7;34;.829;3600000;0
16437;63932;2197;0;0;0;0;.00nan;0;0
16437;66993;759;80;26;1;25;.962;3600000;0
16438;-1;766;66;40;4;36;.900;3600000;0
16438;196715;3721;0;0;0;0;.00nan;0;0
16438;67818;3721;76;23;1;22;.957;3600000;0
16438;91194;766;0;0;0;0;.00nan;0;0
16439;-1;4989;0;0;0;0;.00nan;0;0
16439;169615;4989;52;25;3;22;.880;3547000;0
16439;67446;1492;0;0;0;0;.00nan;0;0
16439;73639;1492;99;46;2;44;.957;3600000;0
16440;3199;911;0;0;0;0;.00nan;0;0
16440;180177;911;90;31;1;30;.968;3600000;0
16440;197595;754;0;0;0;0;.00nan;0;0
16440;85395;754;37;22;4;18;.818;3600000;0
16441;170547;769;69;34;4;30;.882;3900000;0
16441;56037;769;0;0;0;0;.00nan;0;0
16441;148576;1497;51;34;4;30;.882;3886000;0
16441;149191;1497;0;0;0;0;.00nan;0;0
16442;3241;768;0;0;0;0;.00nan;0;0
16442;169680;760;0;0;0;0;.00nan;0;0
16442;85489;760;49;33;5;28;.848;3600000;0
16442;86099;768;86;35;2;33;.943;3600000;0
16443;170530;755;0;0;0;0;.00nan;0;0
16443;67122;1503;0;0;0;0;.00nan;0;0
16443;68689;1503;76;28;2;26;.929;3843000;0
16443;71485;755;71;33;3;30;.909;3843000;0
16444;2140;1093;94;33;1;32;.970;3600000;0
16444;68233;1093;0;0;0;0;.00nan;0;0
16444;91358;767;58;19;2;17;.895;3559000;0
16444;94107;767;0;0;0;0;.00nan;0;0
16445;3256;758;0;0;0;0;.00nan;0;0
16445;170548;758;57;27;3;24;.889;3636000;0
16445;82711;4924;0;0;0;0;.00nan;0;0
16445;158630;4924;73;24;2;22;.917;3636000;0
16446;177124;775;0;0;0;0;.00nan;0;0
16446;180990;775;36;33;6;27;.818;3600000;0
16446;148829;2545;0;0;0;0;.00nan;0;0
16446;149112;2545;60;27;3;24;.889;3600000;0
16447;-1;4989;87;36;2;34;.944;3900000;0
16447;169615;4989;0;0;0;0;.00nan;0;0
16447;170543;4923;88;35;2;33;.943;3900000;0
16447;176686;4923;0;0;0;0;.00nan;0;0
16448;11614;2197;0;0;0;0;.00nan;0;0
16448;63932;2197;76;23;1;22;.957;3600000;0
16448;67122;1503;0;0;0;0;.00nan;0;0
16448;68689;1503;66;24;2;22;.917;3561000;0
16449;3241;768;0;0;0;0;.00nan;0;0
16449;-1;766;27;28;6;22;.786;2514000;0
16449;86099;768;79;35;3;32;.914;3600000;0
16449;91194;766;49;11;2;9;.818;1086000;0
16450;181910;774;0;0;0;0;.00nan;0;0
16450;67294;774;82;29;2;27;.931;3600000;0
16450;67446;1492;70;34;3;31;.912;3543000;0
16450;73639;1492;0;0;0;0;.00nan;0;0
16451;3199;911;0;0;0;0;.00nan;0;0
16451;170547;769;29;14;4;10;.714;1032000;0
16451;180177;911;60;44;5;39;.886;3600000;0
16451;56037;769;76;24;2;22;.917;2513000;0
16452;197595;754;0;0;0;0;.00nan;0;0
16452;85395;754;81;40;3;37;.925;3575000;0
16452;148576;1497;61;18;1;17;.944;3600000;0
16452;149191;1497;0;0;0;0;.00nan;0;0
16453;169680;760;0;0;0;0;.00nan;0;0
16453;196715;3721;0;0;0;0;.00nan;0;0
16453;67818;3721;65;28;3;25;.893;3600000;0
16453;85489;760;34;30;5;25;.833;3600000;0
16454;3957;759;0;0;0;0;.00nan;0;0
16454;170530;755;0;0;0;0;.00nan;0;0
16454;66993;759;78;22;1;21;.955;3600000;0
16454;71485;755;71;43;5;38;.884;3600000;0
16455;82711;4924;0;0;0;0;.00nan;0;0
16455;148829;2545;90;41;2;39;.951;3600000;0
16455;149112;2545;0;0;0;0;.00nan;0;0
16455;158630;4924;81;25;1;24;.960;3600000;0
16456;177124;775;84;41;4;37;.902;3784000;0
16456;2140;1093;68;35;3;32;.914;3766000;0
16456;180990;775;0;0;0;0;.00nan;0;0
16456;68233;1093;0;0;0;0;.00nan;0;0
16457;3256;758;64;48;6;42;.875;3600000;0
16457;164424;750;55;10;1;9;.900;3600000;0
16457;164521;750;0;0;0;0;.00nan;0;0
16457;170548;758;0;0;0;0;.00nan;0;0
16458;8504;746;96;16;0;16;1.000;3600000;0
16458;170543;4923;75;39;3;36;.923;3600000;0
16458;176686;4923;0;0;0;0;.00nan;0;0
16458;201933;746;0;0;0;0;.00nan;0;0
16459;11614;2197;0;0;0;0;.00nan;0;0
16459;196715;3721;0;0;0;0;.00nan;0;0
16459;63932;2197;55;27;3;24;.889;3600000;0
16459;67818;3721;74;18;1;17;.944;3600000;0
16460;3957;759;0;0;0;0;.00nan;0;0
16460;-1;766;68;40;4;36;.900;3600000;0
16460;66993;759;68;18;1;17;.944;3600000;0
16460;91194;766;0;0;0;0;.00nan;0;0
16461;359;762;69;35;3;32;.914;3654000;0
16461;67446;1492;79;41;4;37;.902;3669000;0
16461;73639;1492;0;0;0;0;.00nan;0;0
16461;154296;762;0;0;0;0;.00nan;0;0
16462;595;3913;66;24;2;22;.917;3600000;0
16462;3199;911;0;0;0;0;.00nan;0;0
16462;180177;911;69;38;4;34;.895;3600000;0
16462;82817;3913;0;0;0;0;.00nan;0;0
16463;504;3730;100;27;0;27;1.000;3600000;0
16463;76628;3730;0;0;0;0;.00nan;0;0
16463;148576;1497;53;31;4;27;.871;3600000;0
16463;149191;1497;0;0;0;0;.00nan;0;0
16464;-1;4989;83;46;3;43;.935;3600000;0
16464;169615;4989;0;0;0;0;.00nan;0;0
16464;192065;772;0;0;0;0;.00nan;0;0
16464;57993;772;85;15;0;15;1.000;3600000;0
16465;169680;760;0;0;0;0;.00nan;0;0
16465;67122;1503;100;22;0;22;1.000;3600000;0
16465;68689;1503;0;0;0;0;.00nan;0;0
16465;85489;760;70;25;2;23;.920;3517000;0
16466;3241;768;0;0;0;0;.00nan;0;0
16466;170530;755;0;0;0;0;.00nan;0;0
16466;71485;755;88;40;3;37;.925;3600000;0
16466;86099;768;49;22;4;18;.818;3542000;0
16467;181910;774;0;0;0;0;.00nan;0;0
16467;67294;774;50;30;5;25;.833;3600000;0
16467;87758;2199;50;43;7;36;.837;3600000;0
16467;93756;2199;0;0;0;0;.00nan;0;0
16468;3256;758;0;0;0;0;.00nan;0;0
16468;170548;758;66;31;3;28;.903;3540000;0
16468;91358;767;66;28;2;26;.929;3600000;0
16468;94107;767;0;0;0;0;.00nan;0;0
16469;2140;1093;32;12;3;9;.750;3600000;0
16469;68233;1093;0;0;0;0;.00nan;0;0
16469;82711;4924;57;33;4;29;.879;3577000;0
16469;158630;4924;0;0;0;0;.00nan;0;0
16470;359;762;89;42;3;39;.929;3600000;0
16470;170543;4923;66;20;1;19;.950;3600000;0
16470;176686;4923;0;0;0;0;.00nan;0;0
16470;154296;762;0;0;0;0;.00nan;0;0
16471;3241;768;0;0;0;0;.00nan;0;0
16471;11614;2197;0;0;0;0;.00nan;0;0
16471;63932;2197;96;51;3;48;.941;3512000;0
16471;86099;768;73;23;1;22;.957;3600000;0
16472;8504;746;82;27;2;25;.926;3600000;0
16472;201933;746;0;0;0;0;.00nan;0;0
16472;67446;1492;67;40;4;36;.900;3524000;0
16472;73639;1492;0;0;0;0;.00nan;0;0
16473;504;3730;98;41;1;40;.976;3600000;0
16473;3199;911;0;0;0;0;.00nan;0;0
16473;180177;911;55;21;3;18;.857;3554000;0
16473;76628;3730;0;0;0;0;.00nan;0;0
16474;595;3913;88;40;2;38;.950;3900000;0
16474;82817;3913;0;0;0;0;.00nan;0;0
16474;148576;1497;83;34;2;32;.941;3900000;0
16474;149191;1497;0;0;0;0;.00nan;0;0
16475;181910;774;73;33;3;30;.909;3561000;0
16475;192065;772;0;0;0;0;.00nan;0;0
16475;57993;772;74;21;1;20;.952;3600000;0
16475;67294;774;0;0;0;0;.00nan;0;0
16476;170530;755;36;20;4;16;.800;2383000;0
16476;196715;3721;0;0;0;0;.00nan;0;0
16476;67818;3721;43;26;5;21;.808;3600000;0
16476;71485;755;43;10;2;8;.800;1194000;0
16477;-1;4989;0;0;0;0;.00nan;0;0
16477;169615;4989;86;46;3;43;.935;3600000;0
16477;87758;2199;0;0;0;0;.00nan;0;0
16477;93756;2199;41;22;4;18;.818;3551000;0
16478;359;762;79;27;1;26;.963;3600000;0
16478;192065;772;0;0;0;0;.00nan;0;0
16478;57993;772;53;32;4;28;.875;3600000;0
16478;154296;762;0;0;0;0;.00nan;0;0
16479;8504;746;55;23;3;20;.870;3600000;0
16479;201933;746;0;0;0;0;.00nan;0;0
16479;87758;2199;0;0;0;0;.00nan;0;0
16479;93756;2199;58;34;4;30;.882;3553000;0
16480;67122;1503;76;31;2;29;.935;3900000;0
16480;68689;1503;0;0;0;0;.00nan;0;0
16480;82711;4924;0;0;0;0;.00nan;0;0
16480;158630;4924;75;29;2;27;.931;3900000;0
16481;3199;911;0;0;0;0;.00nan;0;0
16481;-1;4989;0;0;0;0;.00nan;0;0
16481;169615;4989;64;31;3;28;.903;3600000;0
16481;180177;911;37;21;4;17;.810;3579000;0
16482;11614;2197;84;49;4;45;.918;3900000;0
16482;170547;769;0;0;0;0;.00nan;0;0
16482;56037;769;41;18;4;14;.778;3900000;0
16482;63932;2197;0;0;0;0;.00nan;0;0
16483;181910;774;0;0;0;0;.00nan;0;0
16483;67294;774;36;27;5;22;.815;3543000;0
16483;148576;1497;88;51;4;47;.922;3600000;0
16483;149191;1497;0;0;0;0;.00nan;0;0
16484;3241;768;0;0;0;0;.00nan;0;0
16484;86099;768;43;26;4;22;.846;3595000;0
16484;91358;767;86;39;2;37;.949;3600000;0
16484;94107;767;0;0;0;0;.00nan;0;0
16485;504;3730;97;50;2;48;.960;3900000;0
16485;-1;766;92;34;2;32;.941;3900000;0
16485;76628;3730;0;0;0;0;.00nan;0;0
16485;91194;766;0;0;0;0;.00nan;0;0
16486;8504;746;67;24;2;22;.917;3600000;0
16486;201933;746;0;0;0;0;.00nan;0;0
16486;192065;772;0;0;0;0;.00nan;0;0
16486;57993;772;52;35;5;30;.857;3600000;0
16487;595;3913;99;32;2;30;.938;3600000;0
16487;169680;760;0;0;0;0;.00nan;0;0
16487;82817;3913;0;0;0;0;.00nan;0;0
16487;85489;760;87;43;4;39;.907;3564000;0
16488;164424;750;70;37;4;33;.892;3563000;0
16488;164521;750;0;0;0;0;.00nan;0;0
16488;196715;3721;0;0;0;0;.00nan;0;0
16488;67818;3721;82;29;2;27;.931;3600000;0
16489;359;762;94;40;2;38;.950;3600000;0
16489;87758;2199;0;0;0;0;.00nan;0;0
16489;93756;2199;56;26;3;23;.885;3561000;0
16489;154296;762;0;0;0;0;.00nan;0;0
16490;170530;755;0;0;0;0;.00nan;0;0
16490;197595;754;0;0;0;0;.00nan;0;0
16490;71485;755;36;29;5;24;.828;3516000;0
16490;85395;754;47;31;4;27;.871;3600000;0
16491;177124;775;54;3;0;3;1.000;317000;0
16491;3957;759;0;0;0;0;.00nan;0;0
16491;180990;775;37;36;6;30;.833;3283000;0
16491;66993;759;99;20;0;20;1.000;3600000;0
16492;3256;758;0;0;0;0;.00nan;0;0
16492;170548;758;82;33;2;31;.939;3543000;0
16492;148829;2545;0;0;0;0;.00nan;0;0
16492;149112;2545;60;16;1;15;.938;3600000;0
16493;177124;775;0;0;0;0;.00nan;0;0
16493;180990;775;30;42;7;35;.833;3600000;0
16493;67122;1503;0;0;0;0;.00nan;0;0
16493;68689;1503;100;34;0;34;1.000;3600000;0
16494;-1;4989;11;38;9;29;.763;2938000;0
16494;169615;4989;56;6;0;6;1.000;662000;0
16494;148576;1497;75;21;1;20;.952;3600000;0
16494;149191;1497;0;0;0;0;.00nan;0;0
16495;170530;755;0;0;0;0;.00nan;0;0
16495;170547;769;92;35;2;33;.943;3600000;0
16495;56037;769;0;0;0;0;.00nan;0;0
16495;71485;755;84;38;3;35;.921;3600000;0
16496;3199;911;36;7;2;5;.714;548000;0
16496;180177;911;38;33;6;27;.818;3052000;0
16496;181910;774;0;0;0;0;.00nan;0;0
16496;67294;774;85;29;1;28;.966;3600000;0
16497;3241;768;0;0;0;0;.00nan;0;0
16497;164424;750;93;48;1;47;.979;3580000;0
16497;164521;750;0;0;0;0;.00nan;0;0
16497;86099;768;100;30;0;30;1.000;3600000;0
16498;504;3730;100;29;0;29;1.000;3600000;0
16498;169680;760;0;0;0;0;.00nan;0;0
16498;76628;3730;0;0;0;0;.00nan;0;0
16498;85489;760;79;24;1;23;.958;3600000;0
16499;595;3913;95;44;2;42;.955;3577000;0
16499;-1;766;83;27;1;26;.963;3600000;0
16499;82817;3913;0;0;0;0;.00nan;0;0
16499;91194;766;0;0;0;0;.00nan;0;0
16500;196715;3721;51;25;4;21;.840;3644000;0
16500;67818;3721;0;0;0;0;.00nan;0;0
16500;91358;767;73;36;3;33;.917;3644000;0
16500;94107;767;0;0;0;0;.00nan;0;0
16501;11614;2197;0;0;0;0;.00nan;0;0
16501;197595;754;0;0;0;0;.00nan;0;0
16501;63932;2197;53;28;5;23;.821;3600000;0
16501;85395;754;41;37;7;30;.811;3595000;0
16502;3957;759;0;0;0;0;.00nan;0;0
16502;66993;759;56;10;1;9;.900;3600000;0
16502;82711;4924;0;0;0;0;.00nan;0;0
16502;158630;4924;89;47;3;44;.936;3600000;0
16503;2140;1093;80;26;2;24;.923;3600000;0
16503;3256;758;49;25;4;21;.840;3537000;0
16503;170548;758;0;0;0;0;.00nan;0;0
16503;68233;1093;0;0;0;0;.00nan;0;0
16504;164424;750;100;25;0;25;1.000;3600000;0
16504;164521;750;0;0;0;0;.00nan;0;0
16504;67122;1503;0;0;0;0;.00nan;0;0
16504;68689;1503;83;23;1;22;.957;3543000;0
16505;8504;746;54;14;2;12;.857;3646000;0
16505;201933;746;0;0;0;0;.00nan;0;0
16505;148576;1497;92;68;3;65;.956;3646000;0
16505;149191;1497;0;0;0;0;.00nan;0;0
16506;169680;760;0;0;0;0;.00nan;0;0
16506;170547;769;42;25;5;20;.800;3600000;0
16506;56037;769;0;0;0;0;.00nan;0;0
16506;85489;760;62;28;3;25;.893;3600000;0
16507;359;762;0;0;0;0;.00nan;0;0
16507;3199;911;0;0;0;0;.00nan;0;0
16507;180177;911;94;22;0;22;1.000;3780000;0
16507;154296;762;77;23;1;22;.957;3780000;0
16508;177124;775;0;0;0;0;.00nan;0;0
16508;3241;768;0;0;0;0;.00nan;0;0
16508;180990;775;98;45;3;42;.933;3600000;0
16508;86099;768;77;22;1;21;.955;3600000;0
16509;504;3730;54;26;3;23;.885;3900000;0
16509;170530;755;0;0;0;0;.00nan;0;0
16509;71485;755;76;30;3;27;.900;3900000;0
16509;76628;3730;0;0;0;0;.00nan;0;0
16510;192065;772;0;0;0;0;.00nan;0;0
16510;57993;772;57;17;2;15;.882;3724000;0
16510;67446;1492;77;36;3;33;.917;3724000;0
16510;73639;1492;0;0;0;0;.00nan;0;0
16511;595;3913;78;21;1;20;.952;3900000;0
16511;11614;2197;100;43;1;42;.977;3900000;0
16511;63932;2197;0;0;0;0;.00nan;0;0
16511;82817;3913;0;0;0;0;.00nan;0;0
16512;196715;3721;0;0;0;0;.00nan;0;0
16512;67818;3721;47;21;3;18;.857;3600000;0
16512;82711;4924;0;0;0;0;.00nan;0;0
16512;158630;4924;86;47;4;43;.915;3596000;0
16513;170543;4923;60;25;3;22;.880;3600000;0
16513;176686;4923;0;0;0;0;.00nan;0;0
16513;87758;2199;0;0;0;0;.00nan;0;0
16513;93756;2199;80;30;2;28;.933;3600000;0
16514;-1;766;72;26;2;24;.923;3600000;0
16514;197595;754;0;0;0;0;.00nan;0;0
16514;85395;754;61;42;5;37;.881;3600000;0
16514;91194;766;0;0;0;0;.00nan;0;0
16515;3957;759;0;0;0;0;.00nan;0;0
16515;66993;759;57;11;1;10;.909;3600000;0
16515;91358;767;80;47;3;44;.936;3548000;0
16515;94107;767;0;0;0;0;.00nan;0;0
16516;2140;1093;80;34;2;32;.941;3558000;0
16516;68233;1093;0;0;0;0;.00nan;0;0
16516;148829;2545;100;38;0;38;1.000;3600000;0
16516;149112;2545;0;0;0;0;.00nan;0;0
16517;67122;1503;0;0;0;0;.00nan;0;0
16517;68689;1503;60;36;4;32;.889;3600000;0
16517;91358;767;78;25;2;23;.920;3600000;0
16517;94107;767;0;0;0;0;.00nan;0;0
16518;3199;911;0;0;0;0;.00nan;0;0
16518;8504;746;88;24;1;23;.958;3600000;0
16518;180177;911;70;47;4;43;.915;3600000;0
16518;201933;746;0;0;0;0;.00nan;0;0
16519;-1;4989;0;0;0;0;.00nan;0;0
16519;169615;4989;72;36;3;33;.917;3559000;0
16519;181910;774;58;14;2;12;.857;3600000;0
16519;67294;774;0;0;0;0;.00nan;0;0
16520;-1;766;79;32;2;30;.938;3576000;0
16520;170547;769;100;23;0;23;1.000;3600000;0
16520;56037;769;0;0;0;0;.00nan;0;0
16520;91194;766;0;0;0;0;.00nan;0;0
16521;359;762;0;0;0;0;.00nan;0;0
16521;148576;1497;66;25;3;22;.880;3600000;0
16521;149191;1497;0;0;0;0;.00nan;0;0
16521;154296;762;39;30;5;25;.833;3566000;0
16522;3241;768;0;0;0;0;.00nan;0;0
16522;82711;4924;0;0;0;0;.00nan;0;0
16522;86099;768;85;24;1;23;.958;3900000;0
16522;158630;4924;83;32;1;31;.969;3900000;0
16523;504;3730;64;34;3;31;.912;3600000;0
16523;11614;2197;0;0;0;0;.00nan;0;0
16523;63932;2197;62;44;5;39;.886;3571000;0
16523;76628;3730;0;0;0;0;.00nan;0;0
16524;170543;4923;84;32;1;31;.969;3600000;0
16524;176686;4923;0;0;0;0;.00nan;0;0
16524;192065;772;0;0;0;0;.00nan;0;0
16524;57993;772;56;34;5;29;.853;3600000;0
16525;595;3913;50;17;2;15;.882;3600000;0
16525;170530;755;0;0;0;0;.00nan;0;0
16525;71485;755;58;32;5;27;.844;3600000;0
16525;82817;3913;0;0;0;0;.00nan;0;0
16526;177124;775;0;0;0;0;.00nan;0;0
16526;180990;775;82;17;0;17;1.000;3600000;0
16526;196715;3721;0;0;0;0;.00nan;0;0
16526;67818;3721;57;26;3;23;.885;3600000;0
16527;67446;1492;71;21;1;20;.952;3849000;0
16527;73639;1492;0;0;0;0;.00nan;0;0
16527;87758;2199;67;26;2;24;.923;3849000;0
16527;93756;2199;0;0;0;0;.00nan;0;0
16528;169680;760;0;0;0;0;.00nan;0;0
16528;197595;754;59;29;3;26;.897;3600000;0
16528;85395;754;0;0;0;0;.00nan;0;0
16528;85489;760;35;25;5;20;.800;3513000;0
16529;3957;759;0;0;0;0;.00nan;0;0
16529;164424;750;99;48;1;47;.979;3600000;0
16529;164521;750;0;0;0;0;.00nan;0;0
16529;66993;759;68;35;4;31;.886;3600000;0
16531;8504;746;90;32;1;31;.969;3600000;0
16531;185775;772;72;26;2;24;.923;3544000;0
16531;49581;746;0;0;0;0;.00nan;0;0
16531;94018;772;0;0;0;0;.00nan;0;0
16533;177124;2199;94;42;1;41;.976;3900000;0
16533;-1;766;88;29;1;28;.966;3900000;0
16533;91194;766;0;0;0;0;.00nan;0;0
16533;93756;2199;0;0;0;0;.00nan;0;0
16535;6868;754;80;54;5;49;.907;3600000;0
16535;45363;754;0;0;0;0;.00nan;0;0
16535;82087;768;0;0;0;0;.00nan;0;0
16535;86099;768;75;23;1;22;.957;3600000;0
16537;359;774;74;30;2;28;.933;3600000;0
16537;169615;4989;0;0;0;0;.00nan;0;0
16537;181910;774;0;0;0;0;.00nan;0;0
16537;76406;4989;50;42;6;36;.857;3600000;0
16539;11614;775;0;0;0;0;.00nan;0;0
16539;169680;760;78;23;1;22;.957;3600000;0
16539;56037;760;0;0;0;0;.00nan;0;0
16539;154296;775;58;28;3;25;.893;3523000;0
16541;197595;755;43;21;4;17;.810;3545000;0
16541;71485;755;0;0;0;0;.00nan;0;0
16541;148829;2545;83;32;3;29;.906;3600000;0
16541;149112;2545;0;0;0;0;.00nan;0;0
16543;180990;1492;76;39;3;36;.923;3519000;0
16543;67818;3721;0;0;0;0;.00nan;0;0
16543;73639;1492;0;0;0;0;.00nan;0;0
16543;149221;3721;89;27;1;26;.963;3600000;0
16545;174894;762;71;34;3;31;.912;3600000;0
16545;66993;759;46;27;4;23;.852;3600000;0
16545;67446;759;0;0;0;0;.00nan;0;0
16545;148652;762;0;0;0;0;.00nan;0;0
16547;-1;911;47;7;1;6;.857;1013000;0
16547;180177;911;21;23;6;17;.739;2587000;0
16547;67122;1503;84;44;3;41;.932;3600000;0
16547;68689;1503;0;0;0;0;.00nan;0;0
16549;180606;2197;0;0;0;0;.00nan;0;0
16549;91358;767;47;31;5;26;.839;3600000;0
16549;94107;767;0;0;0;0;.00nan;0;0
16549;94508;2197;99;23;0;23;1.000;3600000;0
16551;2140;1093;100;28;0;28;1.000;3600000;0
16551;170543;4923;79;26;1;25;.962;3600000;0
16551;176686;4923;0;0;0;0;.00nan;0;0
16551;68233;1093;0;0;0;0;.00nan;0;0
16553;595;3913;28;26;6;20;.769;2340000;0
16553;63932;758;0;0;0;0;.00nan;0;0
16553;82817;3913;51;9;1;8;.889;1260000;0
16553;85395;758;63;25;2;23;.920;3600000;0
16555;164424;750;81;13;0;13;1.000;3600000;0
16555;164521;750;0;0;0;0;.00nan;0;0
16555;170547;769;76;44;4;40;.909;3600000;0
16555;-1;769;0;0;0;0;.00nan;0;0
16557;504;3730;29;31;6;25;.806;2943000;0
16557;76628;3730;33;5;2;3;.600;657000;0
16557;148904;1497;0;0;0;0;.00nan;0;0
16557;149191;1497;57;28;3;25;.893;3600000;0
16559;359;774;47;19;3;16;.842;3600000;0
16559;11614;775;61;36;5;31;.861;3515000;0
16559;181910;774;0;0;0;0;.00nan;0;0
16559;154296;775;0;0;0;0;.00nan;0;0
16561;185775;772;97;40;2;38;.950;3900000;0
16561;94018;772;0;0;0;0;.00nan;0;0
16561;148904;1497;0;0;0;0;.00nan;0;0
16561;149191;1497;66;24;2;22;.917;3900000;0
16563;174894;762;0;0;0;0;.00nan;0;0
16563;82711;4924;0;0;0;0;.00nan;0;0
16563;148652;762;45;24;5;19;.792;3900000;0
16563;158630;4924;45;34;5;29;.853;3900000;0
16565;169615;4989;0;0;0;0;.00nan;0;0
16565;197595;755;93;42;2;40;.952;3600000;0
16565;71485;755;0;0;0;0;.00nan;0;0
16565;76406;4989;91;22;0;22;1.000;3600000;0
16567;2140;1093;43;24;4;20;.833;3600000;0
16567;68233;1093;0;0;0;0;.00nan;0;0
16567;82087;768;0;0;0;0;.00nan;0;0
16567;86099;768;76;22;1;21;.955;3600000;0
16569;177124;2199;0;0;0;0;.00nan;0;0
16569;-1;766;94;34;2;32;.941;3600000;0
16569;91194;766;0;0;0;0;.00nan;0;0
16569;93756;2199;62;27;3;24;.889;3600000;0
16571;595;3913;92;38;1;37;.974;3600000;0
16571;82817;3913;0;0;0;0;.00nan;0;0
16571;91358;767;30;28;6;22;.786;3600000;0
16571;94107;767;0;0;0;0;.00nan;0;0
16573;164424;750;53;22;3;19;.864;3900000;0
16573;164521;750;0;0;0;0;.00nan;0;0
16573;170543;4923;81;39;3;36;.923;3900000;0
16573;176686;4923;0;0;0;0;.00nan;0;0
16575;-1;911;0;0;0;0;.00nan;0;0
16575;180177;911;98;37;2;35;.946;3600000;0
16575;180606;2197;65;28;3;25;.893;3572000;0
16575;94508;2197;0;0;0;0;.00nan;0;0
16577;6868;754;65;24;2;22;.917;3600000;0
16577;45363;754;0;0;0;0;.00nan;0;0
16577;63932;758;0;0;0;0;.00nan;0;0
16577;85395;758;68;40;5;35;.875;3600000;0
16579;66993;759;81;26;1;25;.962;3600000;0
16579;67446;759;0;0;0;0;.00nan;0;0
16579;148829;2545;76;39;4;35;.897;3600000;0
16579;149112;2545;0;0;0;0;.00nan;0;0
16581;504;3730;85;27;1;26;.963;3600000;0
16581;169680;760;68;30;2;28;.933;3559000;0
16581;56037;760;0;0;0;0;.00nan;0;0
16581;76628;3730;0;0;0;0;.00nan;0;0
16583;170547;769;75;45;4;41;.911;3569000;0
16583;-1;769;0;0;0;0;.00nan;0;0
16583;67818;3721;0;0;0;0;.00nan;0;0
16583;149221;3721;58;16;2;14;.875;3600000;0
16585;180990;1492;34;29;5;24;.828;3207000;0
16585;67122;1503;57;30;4;26;.867;3600000;0
16585;68689;1503;0;0;0;0;.00nan;0;0
16585;73639;1492;48;0;0;0;.00nan;339000;0
16587;-1;766;0;0;0;0;.00nan;0;0
16587;82087;768;58;11;1;10;.909;3600000;0
16587;86099;768;0;0;0;0;.00nan;0;0
16587;91194;766;68;52;6;46;.885;3600000;0
16589;67818;3721;68;16;2;14;.875;3900000;0
16589;82711;4924;79;37;2;35;.946;3900000;0
16589;149221;3721;0;0;0;0;.00nan;0;0
16589;158630;4924;0;0;0;0;.00nan;0;0
16591;595;3913;0;0;0;0;.00nan;0;0
16591;82817;3913;93;43;2;41;.953;3600000;0
16591;148829;2545;0;0;0;0;.00nan;0;0
16591;149112;2545;92;23;0;23;1.000;3600000;0
16593;504;3730;0;0;0;0;.00nan;0;0
16593;66993;759;0;0;0;0;.00nan;0;0
16593;67446;759;83;14;0;14;1.000;3600000;0
16593;76628;3730;75;46;4;42;.913;3600000;0
16595;180606;2197;0;0;0;0;.00nan;0;0
16595;94508;2197;91;20;0;20;1.000;3600000;0
16595;148904;1497;78;29;1;28;.966;3582000;0
16595;149191;1497;0;0;0;0;.00nan;0;0
16597;180990;1492;0;0;0;0;.00nan;0;0
16597;185775;772;0;0;0;0;.00nan;0;0
16597;73639;1492;53;23;3;20;.870;3594000;0
16597;94018;772;70;27;2;25;.926;3600000;0
16599;359;774;0;0;0;0;.00nan;0;0
16599;169680;760;0;0;0;0;.00nan;0;0
16599;181910;774;49;26;4;22;.846;3559000;0
16599;56037;760;70;29;2;27;.931;3600000;0
16601;177124;2199;69;24;2;22;.917;3600000;0
16601;11614;775;0;0;0;0;.00nan;0;0
16601;93756;2199;0;0;0;0;.00nan;0;0
16601;154296;775;60;40;4;36;.900;3517000;0
16603;2140;1093;0;0;0;0;.00nan;0;0
16603;170547;769;0;0;0;0;.00nan;0;0
16603;-1;769;84;26;1;25;.962;3900000;0
16603;68233;1093;77;27;1;26;.963;3900000;0
16605;164424;750;0;0;0;0;.00nan;0;0
16605;164521;750;77;36;4;32;.889;3900000;0
16605;-1;911;51;26;4;22;.846;3900000;0
16605;180177;911;0;0;0;0;.00nan;0;0
16607;169615;4989;0;0;0;0;.00nan;0;0
16607;197595;755;0;0;0;0;.00nan;0;0
16607;71485;755;62;21;2;19;.905;3600000;0
16607;76406;4989;63;43;5;38;.884;3600000;0
16609;8504;746;52;24;3;21;.875;3600000;0
16609;170543;4923;0;0;0;0;.00nan;0;0
16609;176686;4923;41;35;6;29;.829;3600000;0
16609;49581;746;0;0;0;0;.00nan;0;0
16611;63932;758;61;37;4;33;.892;3661000;0
16611;85395;758;0;0;0;0;.00nan;0;0
16611;91358;767;0;0;0;0;.00nan;0;0
16611;94107;767;67;29;3;26;.897;3661000;0
16613;6868;754;0;0;0;0;.00nan;0;0
16613;174894;762;45;29;5;24;.828;3600000;0
16613;45363;754;100;27;0;27;1.000;3600000;0
16613;148652;762;0;0;0;0;.00nan;0;0
16615;504;3730;77;54;5;49;.907;3600000;0
16615;8504;746;88;21;0;21;1.000;3600000;0
16615;49581;746;0;0;0;0;.00nan;0;0
16615;76628;3730;0;0;0;0;.00nan;0;0
16617;185775;772;85;39;2;37;.949;3600000;0
16617;82711;4924;0;0;0;0;.00nan;0;0
16617;94018;772;0;0;0;0;.00nan;0;0
16617;158630;4924;79;24;1;23;.958;3600000;0
16619;180606;2197;42;30;5;25;.833;3600000;0
16619;94508;2197;0;0;0;0;.00nan;0;0
16619;148829;2545;0;0;0;0;.00nan;0;0
16619;149112;2545;84;32;2;30;.938;3600000;0
16621;2140;1093;70;51;6;45;.882;3600000;0
16621;68233;1093;0;0;0;0;.00nan;0;0
16621;82087;768;0;0;0;0;.00nan;0;0
16621;86099;768;68;28;3;25;.893;3600000;0
16623;359;774;25;21;6;15;.714;3049000;0
16623;180990;1492;84;42;3;39;.929;3600000;0
16623;181910;774;64;10;0;10;1.000;551000;0
16623;73639;1492;0;0;0;0;.00nan;0;0
16625;11614;775;65;27;3;24;.889;3900000;0
16625;91358;767;82;37;3;34;.919;3900000;0
16625;94107;767;0;0;0;0;.00nan;0;0
16625;154296;775;0;0;0;0;.00nan;0;0
16627;177124;2199;0;0;0;0;.00nan;0;0
16627;93756;2199;84;53;4;49;.925;3532000;0
16627;148904;1497;0;0;0;0;.00nan;0;0
16627;149191;1497;72;27;2;25;.926;3600000;0
16629;169615;4989;53;25;4;21;.840;3600000;0
16629;174894;762;0;0;0;0;.00nan;0;0
16629;76406;4989;0;0;0;0;.00nan;0;0
16629;148652;762;55;15;2;13;.867;3600000;0
16631;197595;755;0;0;0;0;.00nan;0;0
16631;67122;1503;80;34;2;32;.941;3521000;0
16631;68689;1503;0;0;0;0;.00nan;0;0
16631;71485;755;100;25;0;25;1.000;3600000;0
16633;-1;911;0;0;0;0;.00nan;0;0
16633;170547;769;90;41;3;38;.927;3600000;0
16633;180177;911;83;18;0;18;1.000;3600000;0
16633;-1;769;0;0;0;0;.00nan;0;0
16635;-1;766;45;44;6;38;.864;3600000;0
16635;169680;760;85;23;1;22;.957;3600000;0
16635;56037;760;0;0;0;0;.00nan;0;0
16635;91194;766;0;0;0;0;.00nan;0;0
16637;6868;754;0;0;0;0;.00nan;0;0
16637;45363;754;72;37;4;33;.892;3900000;0
16637;63932;758;0;0;0;0;.00nan;0;0
16637;85395;758;58;26;4;22;.846;3900000;0
16639;595;3913;89;45;2;43;.956;3549000;0
16639;164424;750;67;19;1;18;.947;3600000;0
16639;164521;750;0;0;0;0;.00nan;0;0
16639;82817;3913;0;0;0;0;.00nan;0;0
16641;170543;4923;36;36;6;30;.833;3530000;0
16641;176686;4923;0;0;0;0;.00nan;0;0
16641;67818;3721;0;0;0;0;.00nan;0;0
16641;149221;3721;43;18;4;14;.778;3600000;0
16643;177124;2199;35;11;3;8;.727;429000;0
16643;169680;760;0;0;0;0;.00nan;0;0
16643;56037;760;68;21;1;20;.952;3600000;0
16643;93756;2199;85;25;0;25;1.000;3137000;0
16645;66993;759;100;24;0;24;1.000;3600000;0
16645;67446;759;0;0;0;0;.00nan;0;0
16645;82087;768;0;0;0;0;.00nan;0;0
16645;86099;768;77;28;1;27;.964;3598000;0
16647;8504;746;0;0;0;0;.00nan;0;0
16647;185775;772;40;3;1;2;.667;534000;0
16647;49581;746;61;28;3;25;.893;3600000;0
16647;94018;772;42;39;7;32;.821;3066000;0
16649;-1;911;0;0;0;0;.00nan;0;0
16649;170547;769;48;0;0;0;.00nan;328000;0
16649;180177;911;56;24;3;21;.875;3600000;0
16649;-1;769;45;41;6;35;.854;3272000;0
16651;169615;4989;0;0;0;0;.00nan;0;0
16651;67818;3721;67;27;2;25;.926;3900000;0
16651;76406;4989;85;39;2;37;.949;3900000;0
16651;149221;3721;0;0;0;0;.00nan;0;0
16653;595;3913;0;0;0;0;.00nan;0;0
16653;2140;1093;0;0;0;0;.00nan;0;0
16653;68233;1093;77;30;2;28;.933;3900000;0
16653;82817;3913;78;28;2;26;.929;3900000;0
16655;174894;762;71;30;2;28;.933;3600000;0
16655;180606;2197;0;0;0;0;.00nan;0;0
16655;94508;2197;47;26;4;22;.846;3542000;0
16655;148652;762;0;0;0;0;.00nan;0;0
16657;180990;1492;0;0;0;0;.00nan;0;0
16657;63932;758;69;19;1;18;.947;3600000;0
16657;73639;1492;54;33;4;29;.879;3600000;0
16657;85395;758;0;0;0;0;.00nan;0;0
16659;504;3730;0;0;0;0;.00nan;0;0
16659;170543;4923;0;0;0;0;.00nan;0;0
16659;176686;4923;93;46;3;43;.935;3547000;0
16659;76628;3730;92;28;2;26;.929;3600000;0
16661;67122;1503;0;0;0;0;.00nan;0;0
16661;68689;1503;46;24;3;21;.875;3548000;0
16661;148904;1497;60;19;2;17;.895;3600000;0
16661;149191;1497;0;0;0;0;.00nan;0;0
16663;197595;755;0;0;0;0;.00nan;0;0
16663;71485;755;79;27;2;25;.926;3900000;0
16663;82711;4924;88;34;2;32;.941;3900000;0
16663;158630;4924;0;0;0;0;.00nan;0;0
16665;-1;766;0;0;0;0;.00nan;0;0
16665;91194;766;60;41;5;36;.878;3600000;0
16665;91358;767;0;0;0;0;.00nan;0;0
16665;94107;767;52;28;4;24;.857;3600000;0
16667;164424;750;0;0;0;0;.00nan;0;0
16667;164521;750;76;43;4;39;.907;3600000;0
16667;11614;775;0;0;0;0;.00nan;0;0
16667;154296;775;83;27;1;26;.963;3600000;0
16669;359;774;0;0;0;0;.00nan;0;0
16669;181910;774;74;44;5;39;.886;3600000;0
16669;148829;2545;71;21;1;20;.952;3600000;0
16669;149112;2545;0;0;0;0;.00nan;0;0
16671;170543;4923;50;41;7;34;.829;3600000;0
16671;176686;4923;0;0;0;0;.00nan;0;0
16671;82087;768;0;0;0;0;.00nan;0;0
16671;86099;768;100;26;0;26;1.000;3600000;0
16673;2140;1093;89;38;2;36;.947;3900000;0
16673;180606;2197;81;37;2;35;.946;3900000;0
16673;68233;1093;0;0;0;0;.00nan;0;0
16673;94508;2197;0;0;0;0;.00nan;0;0
16675;-1;766;82;29;1;28;.966;3600000;0
16675;67122;1503;56;23;3;20;.870;3518000;0
16675;68689;1503;0;0;0;0;.00nan;0;0
16675;91194;766;0;0;0;0;.00nan;0;0
16677;185775;772;94;27;0;27;1.000;3600000;0
16677;197595;755;71;27;2;25;.926;3580000;0
16677;71485;755;0;0;0;0;.00nan;0;0
16677;94018;772;0;0;0;0;.00nan;0;0
16679;595;3913;100;35;0;35;1.000;3600000;0
16679;-1;911;0;0;0;0;.00nan;0;0
16679;180177;911;58;16;2;14;.875;3532000;0
16679;82817;3913;0;0;0;0;.00nan;0;0
16681;63932;758;0;0;0;0;.00nan;0;0
16681;67818;3721;0;0;0;0;.00nan;0;0
16681;85395;758;95;40;1;39;.975;3900000;0
16681;149221;3721;86;22;1;21;.955;3900000;0
16683;6868;754;75;43;4;39;.907;3600000;0
16683;11614;775;86;32;1;31;.969;3600000;0
16683;45363;754;0;0;0;0;.00nan;0;0
16683;154296;775;0;0;0;0;.00nan;0;0
16685;170547;769;84;64;4;60;.938;3600000;0
16685;-1;769;0;0;0;0;.00nan;0;0
16685;66993;759;57;11;1;10;.909;3600000;0
16685;67446;759;0;0;0;0;.00nan;0;0
16687;164424;750;62;18;1;17;.944;3600000;0
16687;164521;750;0;0;0;0;.00nan;0;0
16687;180990;1492;78;37;4;33;.892;3600000;0
16687;73639;1492;0;0;0;0;.00nan;0;0
16689;174894;762;0;0;0;0;.00nan;0;0
16689;148652;762;53;27;4;23;.852;3600000;0
16689;148904;1497;0;0;0;0;.00nan;0;0
16689;149191;1497;57;30;3;27;.900;3600000;0
16691;177124;2199;0;0;0;0;.00nan;0;0
16691;169615;4989;0;0;0;0;.00nan;0;0
16691;76406;4989;64;38;4;34;.895;3569000;0
16691;93756;2199;83;33;3;30;.909;3600000;0
16693;169680;760;67;25;2;23;.920;3600000;0
16693;56037;760;0;0;0;0;.00nan;0;0
16693;148829;2545;0;0;0;0;.00nan;0;0
16693;149112;2545;95;25;1;24;.960;3600000;0
16695;359;774;82;39;2;37;.949;3583000;0
16695;8504;746;98;21;0;21;1.000;3600000;0
16695;181910;774;0;0;0;0;.00nan;0;0
16695;49581;746;0;0;0;0;.00nan;0;0
16697;504;3730;66;31;3;28;.903;3548000;0
16697;76628;3730;0;0;0;0;.00nan;0;0
16697;91358;767;61;20;2;18;.900;3600000;0
16697;94107;767;0;0;0;0;.00nan;0;0
16699;169615;4989;82;44;3;41;.932;3574000;0
16699;76406;4989;0;0;0;0;.00nan;0;0
16699;82087;768;0;0;0;0;.00nan;0;0
16699;86099;768;64;16;1;15;.938;3600000;0
16701;180606;2197;0;0;0;0;.00nan;0;0
16701;66993;759;0;0;0;0;.00nan;0;0
16701;67446;759;62;31;3;28;.903;3600000;0
16701;94508;2197;74;53;5;48;.906;3572000;0
16703;359;774;64;31;3;28;.903;3600000;0
16703;181910;774;0;0;0;0;.00nan;0;0
16703;148904;1497;58;35;4;31;.886;3599000;0
16703;149191;1497;0;0;0;0;.00nan;0;0
16705;504;3730;0;0;0;0;.00nan;0;0
16705;6868;754;0;0;0;0;.00nan;0;0
16705;45363;754;88;38;2;36;.947;3900000;0
16705;76628;3730;92;44;2;42;.955;3900000;0
16707;170543;4923;0;0;0;0;.00nan;0;0
16707;176686;4923;58;23;2;21;.913;3547000;0
16707;180990;1492;0;0;0;0;.00nan;0;0
16707;73639;1492;80;27;1;26;.963;3600000;0
16709;-1;911;88;49;4;45;.918;3717000;0
16709;180177;911;0;0;0;0;.00nan;0;0
16709;82711;4924;0;0;0;0;.00nan;0;0
16709;158630;4924;56;28;3;25;.893;3717000;0
16711;8504;746;57;18;3;15;.833;3600000;0
16711;49581;746;0;0;0;0;.00nan;0;0
16711;67818;3721;50;38;4;34;.895;3543000;0
16711;149221;3721;0;0;0;0;.00nan;0;0
16713;63932;758;89;33;2;31;.939;3723000;0
16713;85395;758;0;0;0;0;.00nan;0;0
16713;91358;767;0;0;0;0;.00nan;0;0
16713;94107;767;72;37;3;34;.919;3723000;0
16715;-1;766;0;0;0;0;.00nan;0;0
16715;174894;762;72;33;3;30;.909;3600000;0
16715;91194;766;60;49;6;43;.878;3600000;0
16715;148652;762;0;0;0;0;.00nan;0;0
16717;2140;1093;0;0;0;0;.00nan;0;0
16717;164424;750;0;0;0;0;.00nan;0;0
16717;164521;750;61;26;3;23;.885;3582000;0
16717;68233;1093;73;26;2;24;.923;3600000;0
16719;185775;772;100;26;0;26;1.000;3600000;0
16719;67122;1503;0;0;0;0;.00nan;0;0
16719;68689;1503;64;30;3;27;.900;3600000;0
16719;94018;772;0;0;0;0;.00nan;0;0
16721;11614;775;0;0;0;0;.00nan;0;0
16721;148829;2545;65;34;4;30;.882;3707000;0
16721;149112;2545;0;0;0;0;.00nan;0;0
16721;154296;775;71;29;3;26;.897;3707000;0
16723;170547;769;0;0;0;0;.00nan;0;0
16723;197595;755;0;0;0;0;.00nan;0;0
16723;-1;769;98;43;1;42;.977;3581000;0
16723;71485;755;97;25;0;25;1.000;3600000;0
16725;595;3913;70;35;2;33;.943;3600000;0
16725;177124;2199;70;21;1;20;.952;3600000;0
16725;82817;3913;0;0;0;0;.00nan;0;0
16725;93756;2199;0;0;0;0;.00nan;0;0
19987;3957;759;0;0;0;0;.00nan;0;0
19987;66993;759;91;34;2;32;.941;3600000;0
19987;148576;1497;66;31;3;28;.903;3568000;0
19987;149191;1497;0;0;0;0;.00nan;0;0
19988;8504;746;77;29;2;27;.931;3600000;0
19988;201933;746;0;0;0;0;.00nan;0;0
19988;91358;767;29;14;4;10;.714;752000;0
19988;94107;767;89;39;2;37;.949;2848000;0
19989;595;3913;40;26;5;21;.808;3598000;0
19989;3241;768;0;0;0;0;.00nan;0;0
19989;82817;3913;0;0;0;0;.00nan;0;0
19989;86099;768;77;40;4;36;.900;3600000;0
19990;196715;3721;0;0;0;0;.00nan;0;0
19990;67818;3721;53;18;3;15;.833;3600000;0
19990;82711;4924;0;0;0;0;.00nan;0;0
19990;158630;4924;65;48;6;42;.875;3600000;0
19991;3199;911;0;0;0;0;.00nan;0;0
19991;180177;911;69;19;1;18;.947;3600000;0
19991;192065;772;0;0;0;0;.00nan;0;0
19991;57993;772;100;36;0;36;1.000;3600000;0
19992;359;762;75;28;2;26;.929;3600000;0
19992;2140;1093;40;28;5;23;.821;3600000;0
19992;68233;1093;0;0;0;0;.00nan;0;0
19992;154296;762;0;0;0;0;.00nan;0;0
19993;164424;750;51;28;4;24;.857;3619000;0
19993;164521;750;0;0;0;0;.00nan;0;0
19993;-1;766;71;34;3;31;.912;3619000;0
19993;91194;766;0;0;0;0;.00nan;0;0
19994;181910;774;0;0;0;0;.00nan;0;0
19994;67294;774;99;34;1;33;.971;3822000;0
19994;148829;2545;0;0;0;0;.00nan;0;0
19994;149112;2545;84;29;2;27;.931;3822000;0
19995;3957;759;0;0;0;0;.00nan;0;0
19995;66993;759;72;32;3;29;.906;3600000;0
19995;148576;1497;59;39;4;35;.897;3576000;0
19995;149191;1497;0;0;0;0;.00nan;0;0
19996;8504;746;73;19;1;18;.947;3600000;0
19996;201933;746;0;0;0;0;.00nan;0;0
19996;91358;767;35;31;6;25;.806;2307000;0
19996;94107;767;63;19;1;18;.947;1293000;0
19997;595;3913;75;34;2;32;.941;3600000;0
19997;3241;768;0;0;0;0;.00nan;0;0
19997;82817;3913;0;0;0;0;.00nan;0;0
19997;86099;768;82;24;1;23;.958;3600000;0
19998;196715;3721;0;0;0;0;.00nan;0;0
19998;67818;3721;35;24;5;19;.792;3541000;0
19998;82711;4924;0;0;0;0;.00nan;0;0
19998;158630;4924;97;41;3;38;.927;3600000;0
19999;3199;911;0;0;0;0;.00nan;0;0
19999;180177;911;68;33;3;30;.909;3600000;0
19999;192065;772;0;0;0;0;.00nan;0;0
19999;57993;772;58;41;5;36;.878;3600000;0
20000;359;762;60;23;2;21;.913;3546000;0
20000;2140;1093;69;17;1;16;.941;3600000;0
20000;68233;1093;0;0;0;0;.00nan;0;0
20000;154296;762;0;0;0;0;.00nan;0;0
20001;164424;750;77;30;3;27;.900;3717000;0
20001;164521;750;0;0;0;0;.00nan;0;0
20001;-1;766;62;24;2;22;.917;3717000;0
20001;91194;766;0;0;0;0;.00nan;0;0
20002;181910;774;0;0;0;0;.00nan;0;0
20002;67294;774;71;22;1;21;.955;3600000;0
20002;148829;2545;65;44;5;39;.886;3600000;0
20002;149112;2545;0;0;0;0;.00nan;0;0
20003;3957;759;0;0;0;0;.00nan;0;0
20003;66993;759;96;21;0;21;1.000;3600000;0
20003;148576;1497;98;42;2;40;.952;3540000;0
20003;149191;1497;0;0;0;0;.00nan;0;0
20004;8504;746;73;20;1;19;.950;3600000;0
20004;201933;746;0;0;0;0;.00nan;0;0
20004;91358;767;33;32;6;26;.813;3600000;0
20004;94107;767;0;0;0;0;.00nan;0;0
20005;595;3913;83;26;1;25;.962;3600000;0
20005;3241;768;0;0;0;0;.00nan;0;0
20005;82817;3913;0;0;0;0;.00nan;0;0
20005;86099;768;78;25;2;23;.920;3572000;0
20006;196715;3721;0;0;0;0;.00nan;0;0
20006;67818;3721;55;38;4;34;.895;3600000;0
20006;82711;4924;0;0;0;0;.00nan;0;0
20006;158630;4924;51;38;6;32;.842;3600000;0
20007;3199;911;0;0;0;0;.00nan;0;0
20007;180177;911;61;21;2;19;.905;3600000;0
20007;192065;772;0;0;0;0;.00nan;0;0
20007;57993;772;50;25;3;22;.880;3600000;0
20008;359;762;46;43;6;37;.860;3600000;0
20008;2140;1093;83;29;1;28;.966;3600000;0
20008;68233;1093;0;0;0;0;.00nan;0;0
20008;154296;762;0;0;0;0;.00nan;0;0
20009;164424;750;89;38;2;36;.947;3600000;0
20009;164521;750;0;0;0;0;.00nan;0;0
20009;-1;766;54;30;4;26;.867;3513000;0
20009;91194;766;0;0;0;0;.00nan;0;0
20010;181910;774;0;0;0;0;.00nan;0;0
20010;67294;774;53;29;4;25;.862;3556000;0
20010;148829;2545;65;35;3;32;.914;3600000;0
20010;149112;2545;0;0;0;0;.00nan;0;0
20011;3957;759;0;0;0;0;.00nan;0;0
20011;66993;759;54;17;2;15;.882;3600000;0
20011;148576;1497;72;55;6;49;.891;3600000;0
20011;149191;1497;0;0;0;0;.00nan;0;0
20012;8504;746;76;19;1;18;.947;3600000;0
20012;201933;746;0;0;0;0;.00nan;0;0
20012;91358;767;86;43;3;40;.930;3599000;0
20012;94107;767;0;0;0;0;.00nan;0;0
20013;595;3913;97;43;1;42;.977;3600000;0
20013;3241;768;0;0;0;0;.00nan;0;0
20013;82817;3913;0;0;0;0;.00nan;0;0
20013;86099;768;72;24;2;22;.917;3580000;0
20014;196715;3721;0;0;0;0;.00nan;0;0
20014;67818;3721;90;20;0;20;1.000;3600000;0
20014;82711;4924;0;0;0;0;.00nan;0;0
20014;158630;4924;75;35;2;33;.943;3527000;0
20015;3199;911;0;0;0;0;.00nan;0;0
20015;180177;911;48;25;4;21;.840;3600000;0
20015;192065;772;0;0;0;0;.00nan;0;0
20015;57993;772;92;22;0;22;1.000;3600000;0
20016;359;762;96;37;1;36;.973;3600000;0
20016;2140;1093;91;17;0;17;1.000;3600000;0
20016;68233;1093;0;0;0;0;.00nan;0;0
20016;154296;762;0;0;0;0;.00nan;0;0
20017;164424;750;71;29;3;26;.897;3600000;0
20017;164521;750;0;0;0;0;.00nan;0;0
20017;-1;766;42;30;5;25;.833;3547000;0
20017;91194;766;0;0;0;0;.00nan;0;0
20018;181910;774;0;0;0;0;.00nan;0;0
20018;67294;774;93;30;1;29;.967;3600000;0
20018;148829;2545;78;38;3;35;.921;3538000;0
20018;149112;2545;0;0;0;0;.00nan;0;0
23;595;3913;72;38;4;34;.895;3674000;0
23;3241;768;0;0;0;0;.00nan;0;0
23;82817;3913;0;0;0;0;.00nan;0;0
23;86099;768;52;20;3;17;.850;3674000;0
24;196715;3721;0;0;0;0;.00nan;0;0
24;67818;3721;54;22;3;19;.864;3580000;0
24;82711;4924;0;0;0;0;.00nan;0;0
24;158630;4924;74;25;1;24;.960;3600000;0
25;3199;911;0;0;0;0;.00nan;0;0
25;180177;911;72;23;1;22;.957;3600000;0
25;192065;772;0;0;0;0;.00nan;0;0
25;57993;772;58;29;3;26;.897;3520000;0
26;359;762;84;31;2;29;.935;3589000;0
26;2140;1093;77;27;1;26;.963;3600000;0
26;68233;1093;0;0;0;0;.00nan;0;0
26;154296;762;0;0;0;0;.00nan;0;0
27;164424;750;72;26;2;24;.923;3600000;0
27;164521;750;0;0;0;0;.00nan;0;0
27;-1;766;65;29;3;26;.897;3570000;0
27;91194;766;0;0;0;0;.00nan;0;0
28;181910;774;0;0;0;0;.00nan;0;0
28;67294;774;40;22;5;17;.773;4046000;0
28;148829;2545;63;39;4;35;.897;4046000;0
28;149112;2545;0;0;0;0;.00nan;0;0
64;595;3913;70;25;2;23;.920;3600000;0
64;3241;768;0;0;0;0;.00nan;0;0
64;82817;3913;0;0;0;0;.00nan;0;0
64;86099;768;38;26;5;21;.808;3600000;0
65;196715;3721;0;0;0;0;.00nan;0;0
65;67818;3721;100;35;0;35;1.000;3600000;0
65;82711;4924;0;0;0;0;.00nan;0;0
65;158630;4924;71;39;4;35;.897;3600000;0
66;3199;911;0;0;0;0;.00nan;0;0
66;180177;911;49;19;3;16;.842;3590000;0
66;192065;772;0;0;0;0;.00nan;0;0
66;57993;772;82;25;1;24;.960;3600000;0
67;164424;750;28;7;3;4;.571;495000;0
67;164521;750;49;26;4;22;.846;3105000;0
67;-1;766;96;20;0;20;1.000;3600000;0
67;91194;766;0;0;0;0;.00nan;0;0
68;181910;774;0;0;0;0;.00nan;0;0
68;67294;774;90;29;1;28;.966;3560000;0
68;148829;2545;100;35;0;35;1.000;3600000;0
68;149112;2545;0;0;0;0;.00nan;0;0
119;595;3913;99;41;1;40;.976;3600000;0
119;3241;768;0;0;0;0;.00nan;0;0
119;82817;3913;0;0;0;0;.00nan;0;0
119;86099;768;69;31;3;28;.903;3556000;0
120;3199;911;0;0;0;0;.00nan;0;0
120;180177;911;100;37;1;36;.973;4384000;0
120;192065;772;0;0;0;0;.00nan;0;0
120;57993;772;71;24;2;22;.917;4384000;0
121;164424;750;84;32;2;30;.938;4315000;0
121;164521;750;0;0;0;0;.00nan;0;0
121;-1;766;87;49;3;46;.939;4315000;0
121;91194;766;0;0;0;0;.00nan;0;0
122;181910;774;0;0;0;0;.00nan;0;0
122;67294;774;45;10;2;8;.800;3600000;0
122;148829;2545;85;43;3;40;.930;3600000;0
122;149112;2545;0;0;0;0;.00nan;0;0
159;595;3913;79;43;3;40;.930;3578000;0
159;3957;759;0;0;0;0;.00nan;0;0
159;66993;759;93;31;2;29;.935;3600000;0
159;82817;3913;0;0;0;0;.00nan;0;0
160;2140;1093;43;27;4;23;.852;3550000;0
160;196715;3721;0;0;0;0;.00nan;0;0
160;67818;3721;77;28;2;26;.929;3600000;0
160;68233;1093;0;0;0;0;.00nan;0;0
161;164424;750;62;32;4;28;.875;3600000;0
161;164521;750;0;0;0;0;.00nan;0;0
161;181910;774;0;0;0;0;.00nan;0;0
161;67294;774;92;30;1;29;.967;3600000;0
162;3199;911;0;0;0;0;.00nan;0;0
162;8504;746;100;24;0;24;1.000;3600000;0
162;180177;911;73;45;4;41;.911;3600000;0
162;201933;746;0;0;0;0;.00nan;0;0
163;595;3913;57;42;5;37;.881;3689000;0
163;3957;759;0;0;0;0;.00nan;0;0
163;66993;759;52;25;4;21;.840;3702000;0
163;82817;3913;0;0;0;0;.00nan;0;0
164;2140;1093;86;28;1;27;.964;3600000;0
164;196715;3721;0;0;0;0;.00nan;0;0
164;67818;3721;64;23;2;21;.913;3600000;0
164;68233;1093;0;0;0;0;.00nan;0;0
165;164424;750;94;41;2;39;.951;3600000;0
165;164521;750;0;0;0;0;.00nan;0;0
165;181910;774;0;0;0;0;.00nan;0;0
165;67294;774;70;21;1;20;.952;3600000;0
166;3199;911;0;0;0;0;.00nan;0;0
166;8504;746;60;11;1;10;.909;3555000;0
166;180177;911;100;35;0;35;1.000;3600000;0
166;201933;746;0;0;0;0;.00nan;0;0
167;595;3913;81;41;3;38;.927;3545000;0
167;3957;759;0;0;0;0;.00nan;0;0
167;66993;759;66;25;2;23;.920;3600000;0
167;82817;3913;0;0;0;0;.00nan;0;0
168;2140;1093;57;17;3;14;.824;3598000;0
168;196715;3721;0;0;0;0;.00nan;0;0
168;67818;3721;72;27;2;25;.926;3600000;0
168;68233;1093;0;0;0;0;.00nan;0;0
169;164424;750;79;28;2;26;.929;3666000;0
169;164521;750;0;0;0;0;.00nan;0;0
169;181910;774;0;0;0;0;.00nan;0;0
169;67294;774;73;24;1;23;.958;3666000;0
170;3199;911;0;0;0;0;.00nan;0;0
170;8504;746;64;21;2;19;.905;3786000;0
170;180177;911;64;28;3;25;.893;3786000;0
170;201933;746;0;0;0;0;.00nan;0;0
171;595;3913;10;17;6;11;.647;2604000;0
171;3957;759;0;0;0;0;.00nan;0;0
171;66993;759;88;38;2;36;.947;3600000;0
171;82817;3913;44;12;2;10;.833;996000;0
172;2140;1093;84;28;2;26;.929;5161000;0
172;196715;3721;0;0;0;0;.00nan;0;0
172;67818;3721;72;29;1;28;.966;5161000;0
172;68233;1093;0;0;0;0;.00nan;0;0
173;164424;750;100;29;0;29;1.000;3600000;0
173;164521;750;0;0;0;0;.00nan;0;0
173;181910;774;0;0;0;0;.00nan;0;0
173;67294;774;70;27;2;25;.926;3553000;0
174;3199;911;0;0;0;0;.00nan;0;0
174;8504;746;42;26;5;21;.808;3685000;0
174;180177;911;61;35;4;31;.886;3655000;0
174;201933;746;0;0;0;0;.00nan;0;0
589;2140;1093;100;27;0;27;1.000;3600000;0
589;196715;3721;0;0;0;0;.00nan;0;0
589;67818;3721;81;34;2;32;.941;3581000;0
589;68233;1093;0;0;0;0;.00nan;0;0
590;164424;750;100;48;0;48;1.000;3600000;0
590;164521;750;0;0;0;0;.00nan;0;0
590;181910;774;0;0;0;0;.00nan;0;0
590;67294;774;89;30;1;29;.967;3590000;0
591;3199;911;43;10;2;8;.800;1121000;0
591;8504;746;39;16;3;13;.813;3600000;0
591;180177;911;36;28;6;22;.786;2479000;0
591;201933;746;0;0;0;0;.00nan;0;0
611;2140;1093;63;22;2;20;.909;3571000;0
611;196715;3721;0;0;0;0;.00nan;0;0
611;67818;3721;88;36;1;35;.972;3600000;0
611;68233;1093;0;0;0;0;.00nan;0;0
612;164424;750;93;51;2;49;.961;4611000;0
612;164521;750;0;0;0;0;.00nan;0;0
612;181910;774;0;0;0;0;.00nan;0;0
612;67294;774;80;24;1;23;.958;4611000;0
613;3199;911;0;0;0;0;.00nan;0;0
613;8504;746;75;26;2;24;.923;3600000;0
613;180177;911;77;44;5;39;.886;3600000;0
613;201933;746;0;0;0;0;.00nan;0;0
658;3957;759;0;0;0;0;.00nan;0;0
658;181910;774;0;0;0;0;.00nan;0;0
658;66993;759;68;27;2;25;.926;3600000;0
658;67294;774;60;25;3;22;.880;3554000;0
659;8504;746;73;33;3;30;.909;3578000;0
659;201933;746;0;0;0;0;.00nan;0;0
659;196715;3721;0;0;0;0;.00nan;0;0
659;67818;3721;85;27;2;25;.926;3600000;0
660;3957;759;0;0;0;0;.00nan;0;0
660;181910;774;0;0;0;0;.00nan;0;0
660;66993;759;90;40;2;38;.950;3596000;0
660;67294;774;81;28;1;27;.964;3600000;0
661;8504;746;93;25;1;24;.960;3600000;0
661;201933;746;0;0;0;0;.00nan;0;0
661;196715;3721;0;0;0;0;.00nan;0;0
661;67818;3721;79;33;2;31;.939;3563000;0
662;3957;759;0;0;0;0;.00nan;0;0
662;181910;774;57;6;0;6;1.000;362000;0
662;66993;759;59;35;5;30;.857;3600000;0
662;67294;774;29;27;6;21;.778;3196000;0
663;8504;746;61;20;2;18;.900;3582000;0
663;201933;746;0;0;0;0;.00nan;0;0
663;196715;3721;0;0;0;0;.00nan;0;0
663;67818;3721;94;31;1;30;.968;3600000;0
664;3957;759;0;0;0;0;.00nan;0;0
664;181910;774;83;38;3;35;.921;3561000;0
664;66993;759;91;31;2;29;.935;3600000;0
664;67294;774;0;0;0;0;.00nan;0;0
665;8504;746;78;37;3;34;.919;4101000;0
665;201933;746;0;0;0;0;.00nan;0;0
665;196715;3721;0;0;0;0;.00nan;0;0
665;67818;3721;73;27;2;25;.926;4101000;0
970;3957;759;0;0;0;0;.00nan;0;0
970;181910;774;91;37;2;35;.946;3551000;0
970;66993;759;94;31;1;30;.968;3600000;0
970;67294;774;0;0;0;0;.00nan;0;0
971;8504;746;50;23;3;20;.870;3565000;0
971;201933;746;0;0;0;0;.00nan;0;0
971;196715;3721;0;0;0;0;.00nan;0;0
971;67818;3721;78;32;2;30;.938;3600000;0
979;3957;759;0;0;0;0;.00nan;0;0
979;196715;3721;0;0;0;0;.00nan;0;0
979;66993;759;96;24;0;24;1.000;3600000;0
979;67818;3721;59;31;4;27;.871;3600000;0
980;3957;759;0;0;0;0;.00nan;0;0
980;196715;3721;0;0;0;0;.00nan;0;0
980;66993;759;65;21;2;19;.905;3600000;0
980;67818;3721;45;29;4;25;.862;3552000;0
981;3957;759;0;0;0;0;.00nan;0;0
981;196715;3721;0;0;0;0;.00nan;0;0
981;66993;759;100;25;0;25;1.000;3600000;0
981;67818;3721;82;32;2;30;.938;3579000;0
982;3957;759;0;0;0;0;.00nan;0;0
982;196715;3721;0;0;0;0;.00nan;0;0
982;66993;759;87;26;1;25;.962;3600000;0
982;67818;3721;73;39;3;36;.923;3600000;0
16726;177156;1925;76;22;1;21;.955;3600000;0
16726;7412;585;40;18;3;15;.833;1742000;0
16726;35052;585;21;23;6;17;.739;1858000;0
16726;155943;1925;0;0;0;0;.00nan;0;0
16727;13041;2277;69;27;2;25;.926;3600000;0
16727;14783;1927;0;0;0;0;.00nan;0;0
16727;67614;2277;0;0;0;0;.00nan;0;0
16727;86344;1927;64;38;5;33;.868;3600000;0
16728;11925;567;90;20;0;20;1.000;3600000;0
16728;55285;1928;0;0;0;0;.00nan;0;0
16728;85749;567;0;0;0;0;.00nan;0;0
16728;155769;1928;63;28;3;25;.893;3600000;0
16729;177156;1925;69;20;1;19;.950;3600000;0
16729;185744;1918;67;29;2;27;.931;3568000;0
16729;67625;1918;0;0;0;0;.00nan;0;0
16729;155943;1925;0;0;0;0;.00nan;0;0
16730;320;580;74;37;3;34;.919;3582000;0
16730;11438;2557;0;0;0;0;.00nan;0;0
16730;11851;580;0;0;0;0;.00nan;0;0
16730;19954;2557;91;29;1;28;.966;3600000;0
16731;165150;1922;51;2;0;2;1.000;511000;0
16731;185220;583;68;28;2;26;.929;3600000;0
16731;-1;583;0;0;0;0;.00nan;0;0
16731;142583;1922;20;22;6;16;.727;3089000;0
16732;483;586;86;38;3;35;.921;3517000;0
16732;13033;586;0;0;0;0;.00nan;0;0
16732;34168;563;0;0;0;0;.00nan;0;0
16732;141419;563;76;22;1;21;.955;3600000;0
16733;165150;1922;0;0;0;0;.00nan;0;0
16733;55285;1928;0;0;0;0;.00nan;0;0
16733;142583;1922;73;30;3;27;.900;3600000;0
16733;155769;1928;56;35;4;31;.886;3550000;0
16734;483;586;45;35;5;30;.857;3600000;0
16734;13033;586;0;0;0;0;.00nan;0;0
16734;185220;583;60;22;2;20;.909;3600000;0
16734;-1;583;0;0;0;0;.00nan;0;0
16735;7412;585;0;0;0;0;.00nan;0;0
16735;34168;563;0;0;0;0;.00nan;0;0
16735;35052;585;92;25;0;25;1.000;3600000;0
16735;141419;563;64;34;4;30;.882;3600000;0
16736;11438;2557;0;0;0;0;.00nan;0;0
16736;13041;2277;0;0;0;0;.00nan;0;0
16736;19954;2557;55;26;4;22;.846;3600000;0
16736;67614;2277;44;34;5;29;.853;3548000;0
16737;11925;567;0;0;0;0;.00nan;0;0
16737;14783;1927;0;0;0;0;.00nan;0;0
16737;85749;567;100;29;0;29;1.000;3600000;0
16737;86344;1927;86;41;2;39;.951;3600000;0
16738;13041;2277;0;0;0;0;.00nan;0;0
16738;55285;1928;100;36;0;36;1.000;3600000;0
16738;67614;2277;52;36;5;31;.861;3600000;0
16738;155769;1928;0;0;0;0;.00nan;0;0
16739;320;580;0;0;0;0;.00nan;0;0
16739;177156;1925;100;32;0;32;1.000;3600000;0
16739;11851;580;47;27;5;22;.815;3600000;0
16739;155943;1925;0;0;0;0;.00nan;0;0
16740;483;586;0;0;0;0;.00nan;0;0
16740;7412;585;0;0;0;0;.00nan;0;0
16740;13033;586;66;23;1;22;.957;3600000;0
16740;35052;585;70;34;3;31;.912;3600000;0
16741;11438;2557;0;0;0;0;.00nan;0;0
16741;19954;2557;82;28;1;27;.964;3600000;0
16741;185744;1918;65;23;2;21;.913;3550000;0
16741;67625;1918;0;0;0;0;.00nan;0;0
16742;14783;1927;0;0;0;0;.00nan;0;0
16742;185220;583;61;30;3;27;.900;3518000;0
16742;-1;583;0;0;0;0;.00nan;0;0
16742;86344;1927;87;33;1;32;.970;3600000;0
16743;483;586;95;40;2;38;.950;3900000;0
16743;13033;586;0;0;0;0;.00nan;0;0
16743;13041;2277;0;0;0;0;.00nan;0;0
16743;67614;2277;66;24;2;22;.917;3900000;0
16744;11925;567;0;0;0;0;.00nan;0;0
16744;185744;1918;73;35;3;32;.914;3561000;0
16744;67625;1918;0;0;0;0;.00nan;0;0
16744;85749;567;68;18;1;17;.944;3600000;0
16745;320;580;0;0;0;0;.00nan;0;0
16745;11851;580;74;31;2;29;.935;3600000;0
16745;55285;1928;0;0;0;0;.00nan;0;0
16745;155769;1928;40;24;4;20;.833;3577000;0
16746;177156;1925;33;27;5;22;.815;3600000;0
16746;165150;1922;0;0;0;0;.00nan;0;0
16746;142583;1922;79;24;1;23;.958;3600000;0
16746;155943;1925;0;0;0;0;.00nan;0;0
16747;7412;585;39;31;5;26;.839;3600000;0
16747;14783;1927;62;19;2;17;.895;3600000;0
16747;35052;585;0;0;0;0;.00nan;0;0
16747;86344;1927;0;0;0;0;.00nan;0;0
16748;13041;2277;71;30;2;28;.933;3544000;0
16748;185744;1918;0;0;0;0;.00nan;0;0
16748;67614;2277;0;0;0;0;.00nan;0;0
16748;67625;1918;76;25;1;24;.960;3600000;0
16749;483;586;0;0;0;0;.00nan;0;0
16749;11925;567;0;0;0;0;.00nan;0;0
16749;13033;586;89;35;2;33;.943;3539000;0
16749;85749;567;93;22;0;22;1.000;3600000;0
16750;177156;1925;0;0;0;0;.00nan;0;0
16750;14783;1927;0;0;0;0;.00nan;0;0
16750;86344;1927;86;29;1;28;.966;3600000;0
16750;155943;1925;61;21;2;19;.905;3562000;0
16751;320;580;0;0;0;0;.00nan;0;0
16751;11851;580;72;44;4;40;.909;3552000;0
16751;185220;583;0;0;0;0;.00nan;0;0
16751;-1;583;78;31;3;28;.903;3600000;0
16752;11438;2557;0;0;0;0;.00nan;0;0
16752;19954;2557;69;19;1;18;.947;3600000;0
16752;55285;1928;59;24;3;21;.875;3589000;0
16752;155769;1928;0;0;0;0;.00nan;0;0
16753;165150;1922;56;34;4;30;.882;3600000;0
16753;34168;563;0;0;0;0;.00nan;0;0
16753;141419;563;68;25;2;23;.920;3600000;0
16753;142583;1922;0;0;0;0;.00nan;0;0
16754;11925;567;0;0;0;0;.00nan;0;0
16754;13041;2277;50;2;0;2;1.000;259000;0
16754;67614;2277;41;39;7;32;.821;3341000;0
16754;85749;567;84;26;1;25;.962;3600000;0
16755;185744;1918;60;26;3;23;.885;3600000;0
16755;55285;1928;0;0;0;0;.00nan;0;0
16755;67625;1918;0;0;0;0;.00nan;0;0
16755;155769;1928;19;18;5;13;.722;3574000;0
16756;11925;567;0;0;0;0;.00nan;0;0
16756;55285;1928;0;0;0;0;.00nan;0;0
16756;85749;567;64;17;1;16;.941;3600000;0
16756;155769;1928;80;29;2;27;.931;3575000;0
16757;7412;585;0;0;0;0;.00nan;0;0
16757;13041;2277;68;21;2;19;.905;3600000;0
16757;35052;585;25;28;6;22;.786;3600000;0
16757;67614;2277;0;0;0;0;.00nan;0;0
16758;177156;1925;100;32;0;32;1.000;3600000;0
16758;185220;583;59;23;2;21;.913;3600000;0
16758;-1;583;0;0;0;0;.00nan;0;0
16758;155943;1925;0;0;0;0;.00nan;0;0
16759;320;580;0;0;0;0;.00nan;0;0
16759;11851;580;62;28;3;25;.893;3900000;0
16759;185744;1918;59;32;3;29;.906;3900000;0
16759;67625;1918;0;0;0;0;.00nan;0;0
16760;165150;1922;0;0;0;0;.00nan;0;0
16760;34168;563;48;7;1;6;.857;1135000;0
16760;141419;563;1;20;8;12;.600;2465000;0
16760;142583;1922;65;41;5;36;.878;3600000;0
16761;11438;2557;0;0;0;0;.00nan;0;0
16761;14783;1927;0;0;0;0;.00nan;0;0
16761;19954;2557;32;27;5;22;.815;3523000;0
16761;86344;1927;61;32;3;29;.906;3600000;0
16762;483;586;75;25;1;24;.960;3600000;0
16762;13033;586;0;0;0;0;.00nan;0;0
16762;185220;583;0;0;0;0;.00nan;0;0
16762;-1;583;64;33;4;29;.879;3600000;0
16763;11438;2557;45;28;4;24;.857;3600000;0
16763;19954;2557;0;0;0;0;.00nan;0;0
16763;55285;1928;64;18;1;17;.944;3600000;0
16763;155769;1928;0;0;0;0;.00nan;0;0
16764;7412;585;37;10;3;7;.700;612000;0
16764;11925;567;40;8;2;6;.750;3600000;0
16764;35052;585;30;30;6;24;.800;2988000;0
16764;85749;567;0;0;0;0;.00nan;0;0
16765;320;580;57;34;4;30;.882;3600000;0
16765;11851;580;0;0;0;0;.00nan;0;0
16765;165150;1922;47;30;5;25;.833;3600000;0
16765;142583;1922;0;0;0;0;.00nan;0;0
16766;177156;1925;75;37;3;34;.919;3600000;0
16766;34168;563;0;0;0;0;.00nan;0;0
16766;141419;563;37;26;4;22;.846;3595000;0
16766;155943;1925;0;0;0;0;.00nan;0;0
16767;320;580;56;14;2;12;.857;3878000;0
16767;7412;585;0;0;0;0;.00nan;0;0
16767;11851;580;0;0;0;0;.00nan;0;0
16767;35052;585;95;38;1;37;.974;3878000;0
16768;11438;2557;0;0;0;0;.00nan;0;0
16768;11925;567;0;0;0;0;.00nan;0;0
16768;19954;2557;56;44;7;37;.841;3600000;0
16768;85749;567;44;22;4;18;.818;3600000;0
16769;483;586;74;27;2;25;.926;3600000;0
16769;13033;586;0;0;0;0;.00nan;0;0
16769;185744;1918;30;15;4;11;.733;1084000;0
16769;67625;1918;49;15;2;13;.867;2516000;0
16770;14783;1927;0;0;0;0;.00nan;0;0
16770;55285;1928;0;0;0;0;.00nan;0;0
16770;86344;1927;65;33;3;30;.909;3542000;0
16770;155769;1928;77;27;2;25;.926;3600000;0
16771;320;580;54;20;2;18;.900;2617000;0
16771;11851;580;21;10;4;6;.600;952000;0
16771;13041;2277;0;0;0;0;.00nan;0;0
16771;67614;2277;36;26;5;21;.808;3600000;0
16772;483;586;0;0;0;0;.00nan;0;0
16772;13033;586;60;22;2;20;.909;3600000;0
16772;55285;1928;0;0;0;0;.00nan;0;0
16772;155769;1928;49;31;4;27;.871;3600000;0
16773;177156;1925;69;43;5;38;.884;3600000;0
16773;11925;567;0;0;0;0;.00nan;0;0
16773;85749;567;65;15;1;14;.933;3600000;0
16773;155943;1925;0;0;0;0;.00nan;0;0
16774;7412;585;55;16;2;14;.875;1539000;0
16774;185220;583;52;24;3;21;.875;3600000;0
16774;35052;585;22;20;5;15;.750;2061000;0
16774;-1;583;0;0;0;0;.00nan;0;0
16775;11438;2557;0;0;0;0;.00nan;0;0
16775;165150;1922;0;0;0;0;.00nan;0;0
16775;19954;2557;57;29;3;26;.897;3570000;0
16775;142583;1922;72;25;2;23;.920;3600000;0
16776;14783;1927;0;0;0;0;.00nan;0;0
16776;185744;1918;0;0;0;0;.00nan;0;0
16776;67625;1918;80;24;2;22;.917;3600000;0
16776;86344;1927;76;48;4;44;.917;3576000;0
16777;483;586;91;40;3;37;.925;3713000;0
16777;13033;586;0;0;0;0;.00nan;0;0
16777;34168;563;0;0;0;0;.00nan;0;0
16777;141419;563;57;29;4;25;.862;3713000;0
16778;177156;1925;0;0;0;0;.00nan;0;0
16778;13041;2277;55;12;1;11;.917;3600000;0
16778;67614;2277;0;0;0;0;.00nan;0;0
16778;155943;1925;84;56;4;52;.929;3600000;0
16779;320;580;0;0;0;0;.00nan;0;0
16779;11438;2557;89;38;1;37;.974;3600000;0
16779;11851;580;61;32;3;29;.906;3583000;0
16779;19954;2557;0;0;0;0;.00nan;0;0
16780;185220;583;57;15;1;14;.933;3600000;0
16780;-1;583;0;0;0;0;.00nan;0;0
16780;185744;1918;63;33;3;30;.909;3535000;0
16780;67625;1918;0;0;0;0;.00nan;0;0
16781;320;580;57;34;4;30;.882;3600000;0
16781;11851;580;0;0;0;0;.00nan;0;0
16781;11925;567;0;0;0;0;.00nan;0;0
16781;85749;567;98;22;0;22;1.000;3600000;0
16782;483;586;77;28;3;25;.893;3600000;0
16782;7412;585;0;0;0;0;.00nan;0;0
16782;13033;586;0;0;0;0;.00nan;0;0
16782;35052;585;57;31;4;27;.871;3555000;0
16783;320;580;0;0;0;0;.00nan;0;0
16783;11851;580;38;31;6;25;.806;3600000;0
16783;55285;1928;0;0;0;0;.00nan;0;0
16783;155769;1928;88;37;2;35;.946;3600000;0
16784;13041;2277;0;0;0;0;.00nan;0;0
16784;185220;583;35;30;6;24;.800;3286000;0
16784;-1;583;49;1;0;1;1.000;314000;0
16784;67614;2277;87;37;2;35;.946;3600000;0
16785;19954;2557;0;0;0;0;.00nan;0;0
16785;34168;563;0;0;0;0;.00nan;0;0
16785;56048;2557;87;28;1;27;.964;3600000;0
16785;141419;563;77;28;2;26;.929;3552000;0
16786;177156;1925;47;31;5;26;.839;3600000;0
16786;14783;1927;0;0;0;0;.00nan;0;0
16786;86344;1927;76;40;4;36;.900;3600000;0
16786;155943;1925;0;0;0;0;.00nan;0;0
16787;483;586;0;0;0;0;.00nan;0;0
16787;13033;586;65;40;4;36;.900;3563000;0
16787;185744;1918;62;25;3;22;.880;3600000;0
16787;67625;1918;0;0;0;0;.00nan;0;0
16788;11925;567;0;0;0;0;.00nan;0;0
16788;34168;563;49;1;0;1;1.000;298000;0
16788;85749;567;89;18;0;18;1.000;3600000;0
16788;141419;563;28;30;6;24;.800;3302000;0
16789;320;580;80;34;2;32;.941;3600000;0
16789;11851;580;0;0;0;0;.00nan;0;0
16789;165150;1922;0;0;0;0;.00nan;0;0
16789;142583;1922;82;17;0;17;1.000;3600000;0
16790;7412;585;0;0;0;0;.00nan;0;0
16790;13041;2277;75;28;2;26;.929;3600000;0
16790;35052;585;61;28;3;25;.893;3581000;0
16790;67614;2277;0;0;0;0;.00nan;0;0
16791;177156;1925;0;0;0;0;.00nan;0;0
16791;14783;1927;40;25;5;20;.800;3900000;0
16791;86344;1927;0;0;0;0;.00nan;0;0
16791;155943;1925;47;36;5;31;.861;3900000;0
16792;320;580;0;0;0;0;.00nan;0;0
16792;11851;580;43;34;5;29;.853;3581000;0
16792;185220;583;57;27;3;24;.889;3600000;0
16792;-1;583;0;0;0;0;.00nan;0;0
16793;7412;585;0;0;0;0;.00nan;0;0
16793;35052;585;57;30;4;26;.867;3600000;0
16793;185744;1918;55;27;3;24;.889;3600000;0
16793;67625;1918;0;0;0;0;.00nan;0;0
16794;19954;2557;0;0;0;0;.00nan;0;0
16794;185220;583;0;0;0;0;.00nan;0;0
16794;-1;583;61;30;4;26;.867;3560000;0
16794;56048;2557;69;31;3;28;.903;3600000;0
16795;13041;2277;0;0;0;0;.00nan;0;0
16795;55285;1928;0;0;0;0;.00nan;0;0
16795;67614;2277;71;17;1;16;.941;3600000;0
16795;155769;1928;31;29;6;23;.793;3600000;0
16796;320;580;0;0;0;0;.00nan;0;0
16796;483;586;89;21;0;21;1.000;3600000;0
16796;11851;580;82;34;2;32;.941;3573000;0
16796;13033;586;0;0;0;0;.00nan;0;0
16797;7412;585;0;0;0;0;.00nan;0;0
16797;35052;585;93;41;2;39;.951;3565000;0
16797;55285;1928;77;21;1;20;.952;3600000;0
16797;155769;1928;0;0;0;0;.00nan;0;0
16798;11925;567;0;0;0;0;.00nan;0;0
16798;165150;1922;0;0;0;0;.00nan;0;0
16798;85749;567;63;23;2;21;.913;3600000;0
16798;142583;1922;63;27;3;24;.889;3600000;0
16799;34168;563;0;0;0;0;.00nan;0;0
16799;185220;583;63;24;3;21;.875;3900000;0
16799;-1;583;0;0;0;0;.00nan;0;0
16799;141419;563;70;37;3;34;.919;3900000;0
16800;14783;1927;0;0;0;0;.00nan;0;0
16800;185744;1918;44;32;4;28;.875;3553000;0
16800;67625;1918;0;0;0;0;.00nan;0;0
16800;86344;1927;46;20;3;17;.850;3600000;0
16801;13041;2277;0;0;0;0;.00nan;0;0
16801;185744;1918;0;0;0;0;.00nan;0;0
16801;67614;2277;70;27;2;25;.926;3600000;0
16801;67625;1918;55;28;4;24;.857;3529000;0
16802;483;586;82;21;1;20;.952;3600000;0
16802;177156;1925;76;43;3;40;.930;3587000;0
16802;13033;586;0;0;0;0;.00nan;0;0
16802;155943;1925;0;0;0;0;.00nan;0;0
16803;7412;585;59;26;2;24;.923;3571000;0
16803;165150;1922;0;0;0;0;.00nan;0;0
16803;35052;585;0;0;0;0;.00nan;0;0
16803;142583;1922;77;26;1;25;.962;3600000;0
16804;11925;567;0;0;0;0;.00nan;0;0
16804;19954;2557;50;7;1;6;.857;1027000;0
16804;56048;2557;22;30;6;24;.800;2573000;0
16804;85749;567;76;28;2;26;.929;3600000;0
16805;320;580;53;29;4;25;.862;3600000;0
16805;11851;580;0;0;0;0;.00nan;0;0
16805;34168;563;0;0;0;0;.00nan;0;0
16805;141419;563;81;33;1;32;.970;3600000;0
16806;11925;567;0;0;0;0;.00nan;0;0
16806;19954;2557;0;0;0;0;.00nan;0;0
16806;56048;2557;84;31;3;28;.903;3563000;0
16806;85749;567;72;30;2;28;.933;3600000;0
16807;177156;1925;96;40;2;38;.950;3600000;0
16807;34168;563;0;0;0;0;.00nan;0;0
16807;141419;563;50;29;4;25;.862;3559000;0
16807;155943;1925;0;0;0;0;.00nan;0;0
16808;7412;585;52;3;0;3;1.000;266000;0
16808;35052;585;39;38;6;32;.842;3334000;0
16808;55285;1928;0;0;0;0;.00nan;0;0
16808;155769;1928;94;20;0;20;1.000;3600000;0
16809;185220;583;72;20;1;19;.950;3600000;0
16809;-1;583;0;0;0;0;.00nan;0;0
16809;55285;1928;0;0;0;0;.00nan;0;0
16809;155769;1928;80;34;2;32;.941;3572000;0
16810;14783;1927;0;0;0;0;.00nan;0;0
16810;34168;563;0;0;0;0;.00nan;0;0
16810;86344;1927;35;22;4;18;.818;3565000;0
16810;141419;563;81;37;3;34;.919;3600000;0
16811;483;586;83;33;2;31;.939;3600000;0
16811;13033;586;0;0;0;0;.00nan;0;0
16811;14783;1927;0;0;0;0;.00nan;0;0
16811;86344;1927;43;27;5;22;.815;3600000;0
16812;11925;567;0;0;0;0;.00nan;0;0
16812;185220;583;0;0;0;0;.00nan;0;0
16812;-1;583;81;33;3;30;.909;3598000;0
16812;85749;567;84;36;2;34;.944;3600000;0
16813;320;580;0;0;0;0;.00nan;0;0
16813;7412;585;0;0;0;0;.00nan;0;0
16813;11851;580;60;23;2;21;.913;3600000;0
16813;35052;585;81;48;4;44;.917;3534000;0
16814;165150;1922;0;0;0;0;.00nan;0;0
16814;13041;2277;0;0;0;0;.00nan;0;0
16814;67614;2277;80;30;2;28;.933;3900000;0
16814;142583;1922;49;19;2;17;.895;3900000;0
16815;177156;1925;83;27;1;26;.963;3600000;0
16815;185744;1918;29;7;3;4;.571;437000;0
16815;67625;1918;68;24;2;22;.917;3163000;0
16815;155943;1925;0;0;0;0;.00nan;0;0
16816;177156;1925;63;28;3;25;.893;3560000;0
16816;55285;1928;0;0;0;0;.00nan;0;0
16816;155769;1928;84;28;1;27;.964;3600000;0
16816;155943;1925;0;0;0;0;.00nan;0;0
16817;165150;1922;0;0;0;0;.00nan;0;0
16817;13041;2277;59;34;4;30;.882;3520000;0
16817;67614;2277;0;0;0;0;.00nan;0;0
16817;142583;1922;69;19;2;17;.895;3600000;0
16818;7412;585;34;10;3;7;.700;588000;0
16818;19954;2557;0;0;0;0;.00nan;0;0
16818;35052;585;57;31;4;27;.871;3012000;0
16818;56048;2557;100;30;0;30;1.000;3600000;0
16819;320;580;48;31;5;26;.839;3600000;0
16819;11851;580;0;0;0;0;.00nan;0;0
16819;185744;1918;87;27;1;26;.963;3600000;0
16819;67625;1918;0;0;0;0;.00nan;0;0
16820;11925;567;0;0;0;0;.00nan;0;0
16820;34168;563;0;0;0;0;.00nan;0;0
16820;85749;567;45;26;4;22;.846;3557000;0
16820;141419;563;69;27;2;25;.926;3600000;0
16821;34168;563;0;0;0;0;.00nan;0;0
16821;185744;1918;66;19;1;18;.947;3600000;0
16821;67625;1918;0;0;0;0;.00nan;0;0
16821;141419;563;61;25;2;23;.920;3598000;0
16822;483;586;43;33;5;28;.848;3900000;0
16822;165150;1922;0;0;0;0;.00nan;0;0
16822;13033;586;0;0;0;0;.00nan;0;0
16822;142583;1922;57;37;5;32;.865;3900000;0
16823;11925;567;0;0;0;0;.00nan;0;0
16823;14783;1927;0;0;0;0;.00nan;0;0
16823;85749;567;79;16;1;15;.938;3900000;0
16823;86344;1927;82;33;1;32;.970;3900000;0
16824;13041;2277;0;0;0;0;.00nan;0;0
16824;19954;2557;0;0;0;0;.00nan;0;0
16824;56048;2557;100;34;1;33;.971;3600000;0
16824;67614;2277;40;25;5;20;.800;3600000;0
16825;177156;1925;97;29;1;28;.966;3600000;0
16825;7412;585;0;0;0;0;.00nan;0;0
16825;35052;585;79;35;2;33;.943;3580000;0
16825;155943;1925;0;0;0;0;.00nan;0;0
16826;165150;1922;0;0;0;0;.00nan;0;0
16826;185220;583;58;35;4;31;.886;3559000;0
16826;-1;583;0;0;0;0;.00nan;0;0
16826;142583;1922;57;25;3;22;.880;3600000;0
16827;483;586;46;18;3;15;.833;3559000;0
16827;13033;586;0;0;0;0;.00nan;0;0
16827;19954;2557;0;0;0;0;.00nan;0;0
16827;56048;2557;88;29;1;28;.966;3600000;0
16828;34168;563;0;0;0;0;.00nan;0;0
16828;55285;1928;0;0;0;0;.00nan;0;0
16828;141419;563;60;31;4;27;.871;3595000;0
16828;155769;1928;60;27;3;24;.889;3600000;0
16829;11925;567;51;34;5;29;.853;3600000;0
16829;185744;1918;19;30;7;23;.767;2938000;0
16829;67625;1918;48;7;1;6;.857;662000;0
16829;85749;567;0;0;0;0;.00nan;0;0
16830;320;580;0;0;0;0;.00nan;0;0
16830;483;586;0;0;0;0;.00nan;0;0
16830;11851;580;52;23;3;20;.870;3600000;0
16830;13033;586;53;28;4;24;.857;3522000;0
16831;165150;1922;0;0;0;0;.00nan;0;0
16831;55285;1928;35;29;6;23;.793;3600000;0
16831;142583;1922;62;17;2;15;.882;3600000;0
16831;155769;1928;0;0;0;0;.00nan;0;0
16832;13041;2277;0;0;0;0;.00nan;0;0
16832;14783;1927;0;0;0;0;.00nan;0;0
16832;67614;2277;57;34;5;29;.853;3564000;0
16832;86344;1927;66;29;3;26;.897;3600000;0
16833;13041;2277;0;0;0;0;.00nan;0;0
16833;19954;2557;0;0;0;0;.00nan;0;0
16833;56048;2557;50;25;3;22;.880;3600000;0
16833;67614;2277;41;27;4;23;.852;3586000;0
16834;320;580;0;0;0;0;.00nan;0;0
16834;11851;580;68;23;2;21;.913;3600000;0
16834;34168;563;0;0;0;0;.00nan;0;0
16834;141419;563;76;33;3;30;.909;3594000;0
16835;165150;1922;0;0;0;0;.00nan;0;0
16835;185744;1918;65;26;2;24;.923;3900000;0
16835;67625;1918;0;0;0;0;.00nan;0;0
16835;142583;1922;96;33;2;31;.939;3900000;0
16836;177156;1925;81;29;2;27;.931;3900000;0
16836;19954;2557;0;0;0;0;.00nan;0;0
16836;56048;2557;98;44;2;42;.955;3900000;0
16836;155943;1925;0;0;0;0;.00nan;0;0
16837;185744;1918;43;26;4;22;.846;3600000;0
16837;55285;1928;0;0;0;0;.00nan;0;0
16837;67625;1918;0;0;0;0;.00nan;0;0
16837;155769;1928;42;31;5;26;.839;3580000;0
16838;320;580;0;0;0;0;.00nan;0;0
16838;11851;580;64;34;4;30;.882;3600000;0
16838;13041;2277;69;34;3;31;.912;3600000;0
16838;67614;2277;0;0;0;0;.00nan;0;0
16839;11925;567;0;0;0;0;.00nan;0;0
16839;185220;583;80;40;3;37;.925;3742000;0
16839;-1;583;0;0;0;0;.00nan;0;0
16839;85749;567;42;11;2;9;.818;3742000;0
16840;177156;1925;16;28;7;21;.750;2964000;0
16840;165150;1922;0;0;0;0;.00nan;0;0
16840;142583;1922;63;20;2;18;.900;3600000;0
16840;155943;1925;56;7;0;7;1.000;636000;0
16841;483;586;75;29;2;27;.931;3600000;0
16841;13033;586;0;0;0;0;.00nan;0;0
16841;14783;1927;0;0;0;0;.00nan;0;0
16841;86344;1927;38;33;6;27;.818;3600000;0
16842;19954;2557;0;0;0;0;.00nan;0;0
16842;34168;563;0;0;0;0;.00nan;0;0
16842;56048;2557;50;37;5;32;.865;3900000;0
16842;141419;563;34;25;5;20;.800;3900000;0
16843;13041;2277;0;0;0;0;.00nan;0;0
16843;185220;583;0;0;0;0;.00nan;0;0
16843;-1;583;84;38;2;36;.947;3600000;0
16843;67614;2277;73;41;3;38;.927;3556000;0
16844;320;580;90;56;4;52;.929;3600000;0
16844;11851;580;0;0;0;0;.00nan;0;0
16844;11925;567;73;22;1;21;.955;3600000;0
16844;85749;567;0;0;0;0;.00nan;0;0
16845;165150;1922;67;24;2;22;.917;3600000;0
16845;55285;1928;58;37;5;32;.865;3600000;0
16845;142583;1922;0;0;0;0;.00nan;0;0
16845;155769;1928;0;0;0;0;.00nan;0;0
16846;483;586;0;0;0;0;.00nan;0;0
16846;13033;586;76;37;2;35;.946;3663000;0
16846;14783;1927;0;0;0;0;.00nan;0;0
16846;86344;1927;54;24;3;21;.875;3663000;0
16847;7412;585;0;0;0;0;.00nan;0;0
16847;34168;563;53;28;3;25;.893;3547000;0
16847;35052;585;95;33;1;32;.970;3600000;0
16847;141419;563;0;0;0;0;.00nan;0;0
16848;483;586;42;32;6;26;.813;3600000;0
16848;13033;586;0;0;0;0;.00nan;0;0
16848;185220;583;78;26;1;25;.962;3600000;0
16848;-1;583;0;0;0;0;.00nan;0;0
16849;185220;583;0;0;0;0;.00nan;0;0
16849;-1;583;71;33;3;30;.909;3520000;0
16849;185744;1918;96;40;1;39;.975;3600000;0
16849;67625;1918;0;0;0;0;.00nan;0;0
16850;14783;1927;0;0;0;0;.00nan;0;0
16850;19954;2557;0;0;0;0;.00nan;0;0
16850;56048;2557;91;38;2;36;.947;3600000;0
16850;86344;1927;32;26;5;21;.808;3600000;0
16851;13041;2277;69;24;2;22;.917;3600000;0
16851;185744;1918;0;0;0;0;.00nan;0;0
16851;67614;2277;0;0;0;0;.00nan;0;0
16851;67625;1918;59;25;3;22;.880;3547000;0
16852;483;586;54;37;5;32;.865;3600000;0
16852;11925;567;0;0;0;0;.00nan;0;0
16852;13033;586;0;0;0;0;.00nan;0;0
16852;85749;567;85;31;1;30;.968;3600000;0
16853;7412;585;0;0;0;0;.00nan;0;0
16853;35052;585;59;39;4;35;.897;3600000;0
16853;55285;1928;0;0;0;0;.00nan;0;0
16853;155769;1928;61;20;2;18;.900;3600000;0
16854;177156;1925;28;11;4;7;.636;1945000;0
16854;13041;2277;0;0;0;0;.00nan;0;0
16854;67614;2277;57;24;4;20;.833;3600000;0
16854;155943;1925;57;17;2;15;.882;1655000;0
16855;320;580;0;0;0;0;.00nan;0;0
16855;11851;580;90;46;3;43;.935;3900000;0
16855;14783;1927;0;0;0;0;.00nan;0;0
16855;86344;1927;70;34;3;31;.912;3900000;0
16856;165150;1922;0;0;0;0;.00nan;0;0
16856;19954;2557;0;0;0;0;.00nan;0;0
16856;56048;2557;61;23;2;21;.913;3578000;0
16856;142583;1922;90;18;0;18;1.000;3600000;0
16857;34168;563;0;0;0;0;.00nan;0;0
16857;185220;583;0;0;0;0;.00nan;0;0
16857;-1;583;60;29;3;26;.897;3600000;0
16857;141419;563;53;31;5;26;.839;3600000;0
16858;177156;1925;30;10;3;7;.700;556000;0
16858;11925;567;0;0;0;0;.00nan;0;0
16858;85749;567;68;23;2;21;.913;3600000;0
16858;155943;1925;54;28;4;24;.857;3044000;0
16859;320;580;93;20;0;20;1.000;3600000;0
16859;11851;580;0;0;0;0;.00nan;0;0
16859;14783;1927;84;26;1;25;.962;3543000;0
16859;86344;1927;0;0;0;0;.00nan;0;0
16860;7412;585;38;29;5;24;.828;1703000;0
16860;165150;1922;0;0;0;0;.00nan;0;0
16860;35052;585;59;21;2;19;.905;1897000;0
16860;142583;1922;90;19;0;19;1.000;3600000;0
16861;34168;563;63;22;2;20;.909;3600000;0
16861;185744;1918;61;27;3;24;.889;3600000;0
16861;67625;1918;0;0;0;0;.00nan;0;0
16861;141419;563;0;0;0;0;.00nan;0;0
16862;165150;1922;0;0;0;0;.00nan;0;0
16862;185220;583;0;0;0;0;.00nan;0;0
16862;-1;583;58;34;4;30;.882;3600000;0
16862;142583;1922;90;29;1;28;.966;3600000;0
16863;185220;583;51;24;4;20;.833;3667000;0
16863;-1;583;0;0;0;0;.00nan;0;0
16863;185744;1918;65;30;3;27;.900;3667000;0
16863;67625;1918;0;0;0;0;.00nan;0;0
16864;483;586;78;28;2;26;.929;3600000;0
16864;13033;586;0;0;0;0;.00nan;0;0
16864;19954;2557;0;0;0;0;.00nan;0;0
16864;56048;2557;53;31;4;27;.871;3571000;0
16865;13041;2277;0;0;0;0;.00nan;0;0
16865;55285;1928;0;0;0;0;.00nan;0;0
16865;67614;2277;71;21;1;20;.952;3717000;0
16865;155769;1928;73;29;2;27;.931;3717000;0
16866;320;580;81;19;1;18;.947;3600000;0
16866;177156;1925;57;37;4;33;.892;3600000;0
16866;11851;580;0;0;0;0;.00nan;0;0
16866;155943;1925;0;0;0;0;.00nan;0;0
16867;7412;585;59;10;0;10;1.000;1376000;0
16867;165150;1922;0;0;0;0;.00nan;0;0
16867;35052;585;27;29;6;23;.793;2224000;0
16867;142583;1922;61;26;3;23;.885;3600000;0
16868;14783;1927;0;0;0;0;.00nan;0;0
16868;34168;563;0;0;0;0;.00nan;0;0
16868;86344;1927;97;48;3;45;.938;3600000;0
16868;141419;563;83;23;1;22;.957;3600000;0
16869;11925;567;0;0;0;0;.00nan;0;0
16869;55285;1928;71;34;4;30;.882;3600000;0
16869;85749;567;59;12;1;11;.917;3600000;0
16869;155769;1928;0;0;0;0;.00nan;0;0
16870;320;580;0;0;0;0;.00nan;0;0
16870;11851;580;100;42;0;42;1.000;3600000;0
16870;185220;583;0;0;0;0;.00nan;0;0
16870;-1;583;35;34;6;28;.824;3600000;0
16871;483;586;0;0;0;0;.00nan;0;0
16871;165150;1922;0;0;0;0;.00nan;0;0
16871;13033;586;47;34;5;29;.853;3578000;0
16871;142583;1922;69;37;4;33;.892;3600000;0
16872;19954;2557;0;0;0;0;.00nan;0;0
16872;185744;1918;100;23;0;23;1.000;3600000;0
16872;56048;2557;41;34;5;29;.853;3600000;0
16872;67625;1918;0;0;0;0;.00nan;0;0
16873;14783;1927;37;5;2;3;.600;366000;0
16873;34168;563;20;29;7;22;.759;3658000;0
16873;86344;1927;53;42;6;36;.857;3292000;0
16873;141419;563;0;0;0;0;.00nan;0;0
16874;320;580;0;0;0;0;.00nan;0;0
16874;7412;585;0;0;0;0;.00nan;0;0
16874;11851;580;100;29;0;29;1.000;3600000;0
16874;35052;585;60;35;4;31;.886;3600000;0
16875;177156;1925;80;33;2;31;.939;3600000;0
16875;185744;1918;46;29;5;24;.828;3600000;0
16875;67625;1918;0;0;0;0;.00nan;0;0
16875;155943;1925;0;0;0;0;.00nan;0;0
16876;165150;1922;0;0;0;0;.00nan;0;0
16876;19954;2557;67;37;4;33;.892;3574000;0
16876;56048;2557;0;0;0;0;.00nan;0;0
16876;142583;1922;89;31;2;29;.935;3600000;0
16877;177156;1925;0;0;0;0;.00nan;0;0
16877;14783;1927;0;0;0;0;.00nan;0;0
16877;86344;1927;32;25;5;20;.800;3896000;0
16877;155943;1925;57;49;6;43;.878;3896000;0
16878;11925;567;0;0;0;0;.00nan;0;0
16878;34168;563;0;0;0;0;.00nan;0;0
16878;85749;567;98;18;0;18;1.000;3600000;0
16878;141419;563;82;38;2;36;.947;3569000;0
16879;483;586;100;30;0;30;1.000;3600000;0
16879;13033;586;0;0;0;0;.00nan;0;0
16879;13041;2277;61;33;4;29;.879;3600000;0
16879;67614;2277;0;0;0;0;.00nan;0;0
16880;320;580;0;0;0;0;.00nan;0;0
16880;11851;580;51;24;4;20;.833;3600000;0
16880;55285;1928;0;0;0;0;.00nan;0;0
16880;155769;1928;62;26;3;23;.885;3600000;0
16881;19954;2557;0;0;0;0;.00nan;0;0
16881;185220;583;0;0;0;0;.00nan;0;0
16881;-1;583;100;33;0;33;1.000;3600000;0
16881;56048;2557;44;27;4;23;.852;3600000;0
16882;7412;585;0;0;0;0;.00nan;0;0
16882;14783;1927;0;0;0;0;.00nan;0;0
16882;35052;585;52;32;4;28;.875;3536000;0
16882;86344;1927;87;31;2;29;.935;3600000;0
16883;11925;567;0;0;0;0;.00nan;0;0
16883;185744;1918;0;0;0;0;.00nan;0;0
16883;67625;1918;80;48;5;43;.896;3600000;0
16883;85749;567;75;10;0;10;1.000;3600000;0
16884;483;586;0;0;0;0;.00nan;0;0
16884;177156;1925;76;27;2;25;.926;3600000;0
16884;13033;586;65;30;3;27;.900;3600000;0
16884;155943;1925;0;0;0;0;.00nan;0;0
16885;14783;1927;0;0;0;0;.00nan;0;0
16885;185220;583;70;36;3;33;.917;3886000;0
16885;-1;583;0;0;0;0;.00nan;0;0
16885;86344;1927;71;44;4;40;.909;3864000;0
16886;320;580;37;30;6;24;.800;2692000;0
16886;11851;580;65;11;0;11;1.000;908000;0
16886;165150;1922;0;0;0;0;.00nan;0;0
16886;142583;1922;91;19;0;19;1.000;3600000;0
16887;7412;585;66;39;4;35;.897;3552000;0
16887;19954;2557;0;0;0;0;.00nan;0;0
16887;35052;585;0;0;0;0;.00nan;0;0
16887;56048;2557;72;31;3;28;.903;3600000;0
16888;13041;2277;0;0;0;0;.00nan;0;0
16888;34168;563;0;0;0;0;.00nan;0;0
16888;67614;2277;56;24;3;21;.875;3600000;0
16888;141419;563;91;34;1;33;.971;3600000;0
16889;177156;1925;81;45;3;42;.933;3900000;0
16889;185220;583;0;0;0;0;.00nan;0;0
16889;-1;583;54;20;3;17;.850;3900000;0
16889;155943;1925;0;0;0;0;.00nan;0;0
16890;483;586;35;34;6;28;.824;3600000;0
16890;13033;586;0;0;0;0;.00nan;0;0
16890;34168;563;0;0;0;0;.00nan;0;0
16890;141419;563;78;27;2;25;.926;3600000;0
16891;7412;585;0;0;0;0;.00nan;0;0
16891;185220;583;0;0;0;0;.00nan;0;0
16891;35052;585;48;41;7;34;.829;3600000;0
16891;-1;583;40;25;4;21;.840;3600000;0
16892;14783;1927;0;0;0;0;.00nan;0;0
16892;55285;1928;0;0;0;0;.00nan;0;0
16892;86344;1927;55;29;4;25;.862;3517000;0
16892;155769;1928;68;29;2;27;.931;3600000;0
16893;11925;567;0;0;0;0;.00nan;0;0
16893;13041;2277;51;26;4;22;.846;3668000;0
16893;67614;2277;0;0;0;0;.00nan;0;0
16893;85749;567;49;22;3;19;.864;3668000;0
16894;7412;585;44;35;6;29;.829;3098000;0
16894;185220;583;56;24;3;21;.875;3600000;0
16894;35052;585;57;7;0;7;1.000;502000;0
16894;-1;583;0;0;0;0;.00nan;0;0
16895;320;580;0;0;0;0;.00nan;0;0
16895;11851;580;78;24;2;22;.917;3600000;0
16895;19954;2557;0;0;0;0;.00nan;0;0
16895;56048;2557;40;33;6;27;.818;3600000;0
16896;165150;1922;0;0;0;0;.00nan;0;0
16896;185744;1918;71;33;3;30;.909;3548000;0
16896;67625;1918;0;0;0;0;.00nan;0;0
16896;142583;1922;60;14;1;13;.929;3600000;0
16897;177156;1925;69;22;1;21;.955;3600000;0
16897;34168;563;0;0;0;0;.00nan;0;0
16897;141419;563;33;37;7;30;.811;3600000;0
16897;155943;1925;0;0;0;0;.00nan;0;0
16898;11925;567;54;22;3;19;.864;3600000;0
16898;13041;2277;0;0;0;0;.00nan;0;0
16898;67614;2277;42;43;7;36;.837;3600000;0
16898;85749;567;0;0;0;0;.00nan;0;0
16899;483;586;41;25;4;21;.840;3600000;0
16899;177156;1925;70;43;5;38;.884;3543000;0
16899;13033;586;0;0;0;0;.00nan;0;0
16899;155943;1925;0;0;0;0;.00nan;0;0
16900;320;580;75;27;2;25;.926;3600000;0
16900;11851;580;0;0;0;0;.00nan;0;0
16900;19954;2557;0;0;0;0;.00nan;0;0
16900;56048;2557;38;30;5;25;.833;3600000;0
16901;165150;1922;0;0;0;0;.00nan;0;0
16901;185744;1918;0;0;0;0;.00nan;0;0
16901;67625;1918;90;34;1;33;.971;3900000;0
16901;142583;1922;88;24;1;23;.958;3900000;0
16902;14783;1927;0;0;0;0;.00nan;0;0
16902;55285;1928;100;28;0;28;1.000;3600000;0
16902;86344;1927;87;29;1;28;.966;3558000;0
16902;155769;1928;0;0;0;0;.00nan;0;0
16903;165150;1922;0;0;0;0;.00nan;0;0
16903;34168;563;0;0;0;0;.00nan;0;0
16903;141419;563;59;36;4;32;.889;3552000;0
16903;142583;1922;70;29;3;26;.897;3600000;0
16904;177156;1925;50;40;6;34;.850;2590000;0
16904;11925;567;0;0;0;0;.00nan;0;0
16904;85749;567;44;19;3;16;.842;3600000;0
16904;155943;1925;49;7;1;6;.857;1010000;0
16905;34168;563;0;0;0;0;.00nan;0;0
16905;55285;1928;69;29;4;25;.862;3600000;0
16905;141419;563;52;47;6;41;.872;3578000;0
16905;155769;1928;0;0;0;0;.00nan;0;0
16906;13041;2277;64;43;4;39;.907;3600000;0
16906;185220;583;0;0;0;0;.00nan;0;0
16906;-1;583;86;30;2;28;.933;3600000;0
16906;67614;2277;0;0;0;0;.00nan;0;0
16907;7412;585;0;0;0;0;.00nan;0;0
16907;11925;567;0;0;0;0;.00nan;0;0
16907;35052;585;79;31;2;29;.935;3900000;0
16907;85749;567;58;22;2;20;.909;3900000;0
16908;19954;2557;0;0;0;0;.00nan;0;0
16908;185744;1918;73;22;1;21;.955;3600000;0
16908;56048;2557;65;45;4;41;.911;3600000;0
16908;67625;1918;0;0;0;0;.00nan;0;0
16909;320;580;0;0;0;0;.00nan;0;0
16909;11851;580;42;14;3;11;.786;3587000;0
16909;14783;1927;0;0;0;0;.00nan;0;0
16909;86344;1927;85;38;2;36;.947;3600000;0
16910;483;586;91;35;1;34;.971;3600000;0
16910;13033;586;0;0;0;0;.00nan;0;0
16910;55285;1928;0;0;0;0;.00nan;0;0
16910;155769;1928;93;18;0;18;1.000;3600000;0
16911;165150;1922;0;0;0;0;.00nan;0;0
16911;19954;2557;0;0;0;0;.00nan;0;0
16911;56048;2557;58;31;4;27;.871;3600000;0
16911;142583;1922;67;27;3;24;.889;3600000;0
16912;7412;585;0;0;0;0;.00nan;0;0
16912;13041;2277;0;0;0;0;.00nan;0;0
16912;35052;585;73;32;3;29;.906;3572000;0
16912;67614;2277;57;18;2;16;.889;3600000;0
16913;320;580;73;27;2;25;.926;3900000;0
16913;11851;580;0;0;0;0;.00nan;0;0
16913;14783;1927;75;30;2;28;.933;3897000;0
16913;86344;1927;0;0;0;0;.00nan;0;0
16914;165150;1922;0;0;0;0;.00nan;0;0
16914;13041;2277;0;0;0;0;.00nan;0;0
16914;67614;2277;88;37;2;35;.946;3600000;0
16914;142583;1922;64;27;3;24;.889;3545000;0
16915;320;580;0;0;0;0;.00nan;0;0
16915;11851;580;98;23;0;23;1.000;3600000;0
16915;55285;1928;0;0;0;0;.00nan;0;0
16915;155769;1928;43;33;5;28;.848;3600000;0
16916;11925;567;0;0;0;0;.00nan;0;0
16916;165150;1922;80;27;1;26;.963;3900000;0
16916;85749;567;87;26;1;25;.962;3900000;0
16916;142583;1922;0;0;0;0;.00nan;0;0
16917;483;586;66;18;1;17;.944;3600000;0
16917;7412;585;0;0;0;0;.00nan;0;0
16917;13033;586;0;0;0;0;.00nan;0;0
16917;35052;585;71;36;4;32;.889;3600000;0
16918;19954;2557;0;0;0;0;.00nan;0;0
16918;55285;1928;0;0;0;0;.00nan;0;0
16918;56048;2557;43;35;5;30;.857;3600000;0
16918;155769;1928;60;20;2;18;.900;3600000;0
16919;7412;585;0;0;0;0;.00nan;0;0
16919;35052;585;50;39;6;33;.846;3582000;0
16919;185744;1918;36;20;4;16;.800;3600000;0
16919;67625;1918;0;0;0;0;.00nan;0;0
16920;13041;2277;53;23;3;20;.870;3600000;0
16920;185220;583;0;0;0;0;.00nan;0;0
16920;-1;583;73;25;2;23;.920;3600000;0
16920;67614;2277;0;0;0;0;.00nan;0;0
16921;177156;1925;98;53;3;50;.943;3600000;0
16921;11925;567;0;0;0;0;.00nan;0;0
16921;85749;567;51;14;2;12;.857;3600000;0
16921;155943;1925;0;0;0;0;.00nan;0;0
16922;165150;1922;0;0;0;0;.00nan;0;0
16922;14783;1927;55;4;0;4;1.000;575000;0
16922;86344;1927;24;30;6;24;.800;3025000;0
16922;142583;1922;50;18;3;15;.833;3600000;0
16923;320;580;0;0;0;0;.00nan;0;0
16923;11851;580;87;26;1;25;.962;3600000;0
16923;34168;563;0;0;0;0;.00nan;0;0
16923;141419;563;62;34;4;30;.882;3600000;0
16924;320;580;60;29;3;26;.897;3600000;0
16924;483;586;0;0;0;0;.00nan;0;0
16924;11851;580;0;0;0;0;.00nan;0;0
16924;13033;586;99;26;0;26;1.000;3600000;0
16925;185220;583;61;23;2;21;.913;3600000;0
16925;-1;583;0;0;0;0;.00nan;0;0
16925;55285;1928;0;0;0;0;.00nan;0;0
16925;155769;1928;93;61;4;57;.934;3600000;0
16926;13041;2277;0;0;0;0;.00nan;0;0
16926;14783;1927;54;39;5;34;.872;3600000;0
16926;67614;2277;88;17;0;17;1.000;3600000;0
16926;86344;1927;0;0;0;0;.00nan;0;0
16927;7412;585;40;2;1;1;.500;400000;0
16927;34168;563;0;0;0;0;.00nan;0;0
16927;35052;585;39;33;6;27;.818;3200000;0
16927;141419;563;65;19;1;18;.947;3600000;0
16928;177156;1925;0;0;0;0;.00nan;0;0
16928;19954;2557;0;0;0;0;.00nan;0;0
16928;56048;2557;41;22;4;18;.818;3851000;0
16928;155943;1925;75;39;3;36;.923;3851000;0
16929;177156;1925;46;26;4;22;.846;3600000;0
16929;55285;1928;0;0;0;0;.00nan;0;0
16929;155769;1928;100;21;0;21;1.000;3600000;0
16929;155943;1925;0;0;0;0;.00nan;0;0
16930;34168;563;0;0;0;0;.00nan;0;0
16930;185744;1918;41;30;5;25;.833;3593000;0
16930;67625;1918;0;0;0;0;.00nan;0;0
16930;141419;563;78;35;3;32;.914;3600000;0
16931;320;580;0;0;0;0;.00nan;0;0
16931;11851;580;85;30;1;29;.967;3600000;0
16931;13041;2277;0;0;0;0;.00nan;0;0
16931;67614;2277;72;32;3;29;.906;3590000;0
16932;7412;585;0;0;0;0;.00nan;0;0
16932;35052;585;92;37;1;36;.973;3600000;0
16932;55285;1928;0;0;0;0;.00nan;0;0
16932;155769;1928;74;30;2;28;.933;3600000;0
16933;11925;567;0;0;0;0;.00nan;0;0
16933;14783;1927;0;0;0;0;.00nan;0;0
16933;85749;567;53;16;2;14;.875;3600000;0
16933;86344;1927;65;37;4;33;.892;3584000;0
16934;34168;563;0;0;0;0;.00nan;0;0
16934;55285;1928;0;0;0;0;.00nan;0;0
16934;141419;563;76;24;1;23;.958;3600000;0
16934;155769;1928;49;25;4;21;.840;3600000;0
16935;483;586;0;0;0;0;.00nan;0;0
16935;13033;586;76;31;2;29;.935;3837000;0
16935;13041;2277;75;31;3;28;.903;3883000;0
16935;67614;2277;0;0;0;0;.00nan;0;0
16936;165150;1922;0;0;0;0;.00nan;0;0
16936;185220;583;0;0;0;0;.00nan;0;0
16936;-1;583;93;53;4;49;.925;3581000;0
16936;142583;1922;66;19;2;17;.895;3600000;0
16937;320;580;0;0;0;0;.00nan;0;0
16937;7412;585;0;0;0;0;.00nan;0;0
16937;11851;580;68;19;1;18;.947;3600000;0
16937;35052;585;39;32;6;26;.813;3600000;0
16938;14783;1927;31;30;6;24;.800;2373000;0
16938;185744;1918;46;23;4;19;.826;3600000;0
16938;67625;1918;0;0;0;0;.00nan;0;0
16938;86344;1927;56;11;1;10;.909;1227000;0
16939;13041;2277;0;0;0;0;.00nan;0;0
16939;34168;563;0;0;0;0;.00nan;0;0
16939;67614;2277;89;35;2;33;.943;3544000;0
16939;141419;563;91;29;1;28;.966;3600000;0
16940;483;586;76;34;3;31;.912;3576000;0
16940;11925;567;0;0;0;0;.00nan;0;0
16940;13033;586;0;0;0;0;.00nan;0;0
16940;85749;567;67;21;2;19;.905;3600000;0
16941;177156;1925;58;32;5;27;.844;3600000;0
16941;185220;583;48;28;4;24;.857;3600000;0
16941;-1;583;0;0;0;0;.00nan;0;0
16941;155943;1925;0;0;0;0;.00nan;0;0
16942;165150;1922;0;0;0;0;.00nan;0;0
16942;14783;1927;47;41;6;35;.854;3436000;0
16942;86344;1927;22;4;3;1;.250;164000;0
16942;142583;1922;87;13;0;13;1.000;3600000;0
16943;7412;585;0;0;0;0;.00nan;0;0
16943;19954;2557;0;0;0;0;.00nan;0;0
16943;35052;585;67;31;3;28;.903;3600000;0
16943;56048;2557;56;34;4;30;.882;3585000;0
16944;14783;1927;0;0;0;0;.00nan;0;0
16944;55285;1928;0;0;0;0;.00nan;0;0
16944;86344;1927;72;28;2;26;.929;3733000;0
16944;155769;1928;88;35;1;34;.971;3733000;0
16945;177156;1925;47;26;4;22;.846;3584000;0
16945;190423;1918;60;20;2;18;.900;3600000;0
16945;185744;1918;0;0;0;0;.00nan;0;0
16945;155943;1925;0;0;0;0;.00nan;0;0
16946;483;586;34;21;4;17;.810;2618000;0
16946;13033;586;31;14;4;10;.714;982000;0
16946;34168;563;0;0;0;0;.00nan;0;0
16946;141419;563;52;22;3;19;.864;3600000;0
16947;11925;567;0;0;0;0;.00nan;0;0
16947;185220;583;0;0;0;0;.00nan;0;0
16947;-1;583;53;29;4;25;.862;3520000;0
16947;85749;567;81;34;2;32;.941;3600000;0
16948;483;586;63;30;3;27;.900;3600000;0
16948;11925;567;0;0;0;0;.00nan;0;0
16948;13033;586;0;0;0;0;.00nan;0;0
16948;85749;567;98;23;0;23;1.000;3600000;0
16949;190423;1918;0;0;0;0;.00nan;0;0
16949;185744;1918;71;28;2;26;.929;3600000;0
16949;55285;1928;0;0;0;0;.00nan;0;0
16949;155769;1928;70;35;4;31;.886;3545000;0
16950;13041;2277;0;0;0;0;.00nan;0;0
16950;34168;563;0;0;0;0;.00nan;0;0
16950;67614;2277;74;25;2;23;.920;3600000;0
16950;141419;563;48;23;3;20;.870;3545000;0
16951;320;580;0;0;0;0;.00nan;0;0
16951;177156;1925;80;48;4;44;.917;3565000;0
16951;11851;580;59;27;3;24;.889;3600000;0
16951;155943;1925;0;0;0;0;.00nan;0;0
16952;7412;585;83;31;1;30;.968;3600000;0
16952;185220;583;62;34;5;29;.853;3600000;0
16952;35052;585;0;0;0;0;.00nan;0;0
16952;-1;583;0;0;0;0;.00nan;0;0
16953;165150;1922;0;0;0;0;.00nan;0;0
16953;14783;1927;0;0;0;0;.00nan;0;0
16953;86344;1927;40;38;5;33;.868;3600000;0
16953;142583;1922;48;24;4;20;.833;3600000;0
16954;483;586;0;0;0;0;.00nan;0;0
16954;13033;586;74;24;1;23;.958;3600000;0
16954;55285;1928;0;0;0;0;.00nan;0;0
16954;155769;1928;47;26;4;22;.846;3600000;0
16955;165150;1922;0;0;0;0;.00nan;0;0
16955;13041;2277;34;31;6;25;.806;3600000;0
16955;67614;2277;0;0;0;0;.00nan;0;0
16955;142583;1922;95;18;0;18;1.000;3600000;0
16956;177156;1925;0;0;0;0;.00nan;0;0
16956;7412;585;0;0;0;0;.00nan;0;0
16956;35052;585;66;29;2;27;.931;3550000;0
16956;155943;1925;91;36;1;35;.972;3600000;0
16957;19954;2557;0;0;0;0;.00nan;0;0
16957;34168;563;0;0;0;0;.00nan;0;0
16957;56048;2557;58;16;2;14;.875;3600000;0
16957;141419;563;51;42;6;36;.857;3600000;0
16958;14783;1927;56;34;5;29;.853;3600000;0
16958;190423;1918;89;36;2;34;.944;3600000;0
16958;185744;1918;0;0;0;0;.00nan;0;0
16958;86344;1927;0;0;0;0;.00nan;0;0
16959;190423;1918;0;0;0;0;.00nan;0;0
16959;185220;583;0;0;0;0;.00nan;0;0
16959;-1;583;97;36;1;35;.972;3900000;0
16959;185744;1918;79;19;1;18;.947;3900000;0
16960;483;586;86;45;4;41;.911;3600000;0
16960;177156;1925;49;32;5;27;.844;3563000;0
16960;13033;586;0;0;0;0;.00nan;0;0
16960;155943;1925;0;0;0;0;.00nan;0;0
16961;320;580;0;0;0;0;.00nan;0;0
16961;11851;580;91;48;2;46;.958;3900000;0
16961;11925;567;0;0;0;0;.00nan;0;0
16961;85749;567;69;23;2;21;.913;3900000;0
16962;13041;2277;0;0;0;0;.00nan;0;0
16962;190423;1918;0;0;0;0;.00nan;0;0
16962;185744;1918;72;30;2;28;.933;3569000;0
16962;67614;2277;72;20;1;19;.950;3600000;0
16963;177156;1925;53;39;5;34;.872;3781000;0
16963;13041;2277;56;37;4;33;.892;3763000;0
16963;67614;2277;0;0;0;0;.00nan;0;0
16963;155943;1925;0;0;0;0;.00nan;0;0
16964;185220;583;55;22;2;20;.909;3600000;0
16964;-1;583;0;0;0;0;.00nan;0;0
16964;55285;1928;0;0;0;0;.00nan;0;0
16964;155769;1928;77;35;3;32;.914;3568000;0
16965;483;586;97;50;4;46;.920;3579000;0
16965;165150;1922;0;0;0;0;.00nan;0;0
16965;13033;586;0;0;0;0;.00nan;0;0
16965;142583;1922;69;25;2;23;.920;3600000;0
16966;7412;585;0;0;0;0;.00nan;0;0
16966;14783;1927;0;0;0;0;.00nan;0;0
16966;35052;585;93;33;2;31;.939;3600000;0
16966;86344;1927;45;19;3;16;.842;3598000;0
16967;19954;2557;0;0;0;0;.00nan;0;0
16967;34168;563;0;0;0;0;.00nan;0;0
16967;56048;2557;55;22;3;19;.864;3600000;0
16967;141419;563;24;18;5;13;.722;3576000;0
16968;483;586;0;0;0;0;.00nan;0;0
16968;13033;586;76;27;2;25;.926;3600000;0
16968;19954;2557;0;0;0;0;.00nan;0;0
16968;56048;2557;68;29;3;26;.897;3544000;0
16969;11925;567;0;0;0;0;.00nan;0;0
16969;165150;1922;62;36;4;32;.889;3600000;0
16969;85749;567;29;28;7;21;.750;3600000;0
16969;142583;1922;0;0;0;0;.00nan;0;0
16970;177156;1925;0;0;0;0;.00nan;0;0
16970;55285;1928;64;17;1;16;.941;3600000;0
16970;155769;1928;0;0;0;0;.00nan;0;0
16970;155943;1925;62;46;5;41;.891;3600000;0
16971;34168;563;0;0;0;0;.00nan;0;0
16971;185220;583;0;0;0;0;.00nan;0;0
16971;-1;583;73;19;1;18;.947;3600000;0
16971;141419;563;62;20;2;18;.900;3544000;0
16972;320;580;0;0;0;0;.00nan;0;0
16972;11851;580;28;17;5;12;.706;3560000;0
16972;190423;1918;0;0;0;0;.00nan;0;0
16972;185744;1918;75;42;4;38;.905;3600000;0
16973;7412;585;21;11;4;7;.636;1127000;0
16973;14783;1927;73;26;1;25;.962;3600000;0
16973;35052;585;60;24;3;21;.875;2473000;0
16973;86344;1927;0;0;0;0;.00nan;0;0
16974;320;580;0;0;0;0;.00nan;0;0
16974;11851;580;59;19;2;17;.895;3600000;0
16974;13041;2277;0;0;0;0;.00nan;0;0
16974;67614;2277;57;34;5;29;.853;3600000;0
16975;320;580;0;0;0;0;.00nan;0;0
16975;11851;580;72;38;4;34;.895;3600000;0
16975;11925;567;0;0;0;0;.00nan;0;0
16975;85749;567;71;21;1;20;.952;3600000;0
16976;7412;585;0;0;0;0;.00nan;0;0
16976;190423;1918;0;0;0;0;.00nan;0;0
16976;35052;585;60;43;5;38;.884;3520000;0
16976;185744;1918;56;27;3;24;.889;3600000;0
16977;165150;1922;0;0;0;0;.00nan;0;0
16977;14783;1927;0;0;0;0;.00nan;0;0
16977;86344;1927;73;36;3;33;.917;3562000;0
16977;142583;1922;67;22;2;20;.909;3600000;0
16978;483;586;82;13;0;13;1.000;3600000;0
16978;13033;586;0;0;0;0;.00nan;0;0
16978;14783;1927;43;38;6;32;.842;3600000;0
16978;86344;1927;0;0;0;0;.00nan;0;0
16979;177156;1925;83;34;2;32;.941;3557000;0
16979;55285;1928;0;0;0;0;.00nan;0;0
16979;155769;1928;70;22;1;21;.955;3600000;0
16979;155943;1925;0;0;0;0;.00nan;0;0
16980;7412;585;0;0;0;0;.00nan;0;0
16980;13041;2277;0;0;0;0;.00nan;0;0
16980;35052;585;96;41;1;40;.976;3600000;0
16980;67614;2277;66;28;3;25;.893;3513000;0
16981;19954;2557;54;5;0;5;1.000;243000;0
16981;185220;583;48;22;3;19;.864;3600000;0
16981;-1;583;0;0;0;0;.00nan;0;0
16981;56048;2557;33;30;6;24;.800;3357000;0
16982;190423;1918;0;0;0;0;.00nan;0;0
16982;34168;563;0;0;0;0;.00nan;0;0
16982;185744;1918;70;40;4;36;.900;3600000;0
16982;141419;563;48;36;5;31;.861;3572000;0
16983;177156;1925;53;22;3;19;.864;3560000;0
16983;13041;2277;70;28;2;26;.929;3600000;0
16983;67614;2277;0;0;0;0;.00nan;0;0
16983;155943;1925;0;0;0;0;.00nan;0;0
16984;7412;585;55;43;6;37;.860;3327000;0
16984;11925;567;0;0;0;0;.00nan;0;0
16984;35052;585;49;1;0;1;1.000;233000;0
16984;85749;567;50;26;4;22;.846;3600000;0
16985;320;580;46;8;2;6;.750;3600000;0
16985;11851;580;0;0;0;0;.00nan;0;0
16985;185220;583;78;50;5;45;.900;3600000;0
16985;-1;583;0;0;0;0;.00nan;0;0
16986;483;586;71;29;3;26;.897;3536000;0
16986;13033;586;0;0;0;0;.00nan;0;0
16986;190423;1918;65;17;1;16;.941;3600000;0
16986;185744;1918;0;0;0;0;.00nan;0;0
16987;14783;1927;0;0;0;0;.00nan;0;0
16987;34168;563;56;27;4;23;.852;3600000;0
16987;86344;1927;70;48;5;43;.896;3587000;0
16987;141419;563;0;0;0;0;.00nan;0;0
16988;19954;2557;0;0;0;0;.00nan;0;0
16988;190423;1918;0;0;0;0;.00nan;0;0
16988;185744;1918;68;28;2;26;.929;3600000;0
16988;56048;2557;77;35;3;32;.914;3600000;0
16989;7412;585;0;0;0;0;.00nan;0;0
16989;165150;1922;0;0;0;0;.00nan;0;0
16989;35052;585;74;40;4;36;.900;3560000;0
16989;142583;1922;76;27;2;25;.926;3600000;0
16990;13041;2277;89;26;1;25;.962;3600000;0
16990;55285;1928;0;0;0;0;.00nan;0;0
16990;67614;2277;0;0;0;0;.00nan;0;0
16990;155769;1928;47;31;5;26;.839;3600000;0
16991;11925;567;0;0;0;0;.00nan;0;0
16991;19954;2557;0;0;0;0;.00nan;0;0
16991;56048;2557;61;36;5;31;.861;3513000;0
16991;85749;567;63;23;3;20;.870;3600000;0
16992;320;580;0;0;0;0;.00nan;0;0
16992;483;586;0;0;0;0;.00nan;0;0
16992;11851;580;100;25;0;25;1.000;3600000;0
16992;13033;586;56;48;6;42;.875;3600000;0
16993;177156;1925;78;35;2;33;.943;3590000;0
16993;165150;1922;0;0;0;0;.00nan;0;0
16993;142583;1922;62;15;1;14;.933;3600000;0
16993;155943;1925;0;0;0;0;.00nan;0;0
16994;7412;585;0;0;0;0;.00nan;0;0
16994;190423;1918;0;0;0;0;.00nan;0;0
16994;35052;585;91;39;2;37;.949;3600000;0
16994;185744;1918;38;15;3;12;.800;3590000;0
16995;14783;1927;0;0;0;0;.00nan;0;0
16995;185220;583;64;22;2;20;.909;3600000;0
16995;-1;583;0;0;0;0;.00nan;0;0
16995;86344;1927;47;27;4;23;.852;3600000;0
16996;165150;1922;36;21;4;17;.810;3555000;0
16996;55285;1928;0;0;0;0;.00nan;0;0
16996;142583;1922;0;0;0;0;.00nan;0;0
16996;155769;1928;87;43;3;40;.930;3600000;0
16997;11925;567;0;0;0;0;.00nan;0;0
16997;13041;2277;93;42;2;40;.952;3531000;0
16997;67614;2277;0;0;0;0;.00nan;0;0
16997;85749;567;88;16;0;16;1.000;3600000;0
16998;177156;1925;71;24;1;23;.958;3569000;0
16998;34168;563;0;0;0;0;.00nan;0;0
16998;141419;563;94;23;0;23;1.000;3600000;0
16998;155943;1925;0;0;0;0;.00nan;0;0
16999;483;586;88;18;0;18;1.000;3600000;0
16999;13033;586;0;0;0;0;.00nan;0;0
16999;19954;2557;59;40;5;35;.875;3600000;0
16999;56048;2557;0;0;0;0;.00nan;0;0
17000;14783;1927;80;30;2;28;.933;3597000;0
17000;185220;583;0;0;0;0;.00nan;0;0
17000;-1;583;77;25;1;24;.960;3600000;0
17000;86344;1927;0;0;0;0;.00nan;0;0
17001;165150;1922;0;0;0;0;.00nan;0;0
17001;34168;563;57;5;0;5;1.000;500000;0
17001;141419;563;35;34;6;28;.824;3100000;0
17001;142583;1922;53;9;1;8;.889;3600000;0
17002;11925;567;0;0;0;0;.00nan;0;0
17002;34168;563;0;0;0;0;.00nan;0;0
17002;85749;567;52;13;2;11;.846;3600000;0
17002;141419;563;88;49;3;46;.939;3600000;0
17003;483;586;51;43;7;36;.837;3600000;0
17003;13033;586;0;0;0;0;.00nan;0;0
17003;185220;583;62;30;3;27;.900;3600000;0
17003;-1;583;0;0;0;0;.00nan;0;0
17004;177156;1925;57;37;4;33;.892;3587000;0
17004;19954;2557;0;0;0;0;.00nan;0;0
17004;56048;2557;68;28;2;26;.929;3600000;0
17004;155943;1925;0;0;0;0;.00nan;0;0
17005;320;580;0;0;0;0;.00nan;0;0
17005;11851;580;74;25;2;23;.920;3787000;0
17005;190423;1918;0;0;0;0;.00nan;0;0
17005;185744;1918;81;37;3;34;.919;3787000;0
17006;483;586;99;27;0;27;1.000;3600000;0
17006;13033;586;0;0;0;0;.00nan;0;0
17006;13041;2277;29;7;3;4;.571;482000;0
17006;67614;2277;64;22;2;20;.909;3118000;0
17007;19954;2557;0;0;0;0;.00nan;0;0
17007;55285;1928;0;0;0;0;.00nan;0;0
17007;56048;2557;63;24;3;21;.875;3600000;0
17007;155769;1928;68;34;4;30;.882;3534000;0
17008;11925;567;0;0;0;0;.00nan;0;0
17008;185220;583;25;29;6;23;.793;2821000;0
17008;-1;583;42;13;2;11;.846;779000;0
17008;85749;567;60;23;2;21;.913;3600000;0
17009;320;580;0;0;0;0;.00nan;0;0
17009;177156;1925;72;33;3;30;.909;3558000;0
17009;11851;580;72;25;2;23;.920;3600000;0
17009;155943;1925;0;0;0;0;.00nan;0;0
17010;483;586;80;23;1;22;.957;3600000;0
17010;13033;586;0;0;0;0;.00nan;0;0
17010;190423;1918;0;0;0;0;.00nan;0;0
17010;185744;1918;70;27;2;25;.926;3600000;0
17011;185220;583;0;0;0;0;.00nan;0;0
17011;-1;583;67;27;2;25;.926;3764000;0
17011;55285;1928;67;26;3;23;.885;3764000;0
17011;155769;1928;0;0;0;0;.00nan;0;0
17012;177156;1925;0;0;0;0;.00nan;0;0
17012;7412;585;0;0;0;0;.00nan;0;0
17012;35052;585;57;44;5;39;.886;3600000;0
17012;155943;1925;70;26;1;25;.962;3600000;0
17013;11925;567;0;0;0;0;.00nan;0;0
17013;165150;1922;0;0;0;0;.00nan;0;0
17013;85749;567;99;40;1;39;.975;3600000;0
17013;142583;1922;36;28;5;23;.821;3600000;0
17014;14783;1927;0;0;0;0;.00nan;0;0
17014;19954;2557;0;0;0;0;.00nan;0;0
17014;56048;2557;76;26;2;24;.923;3600000;0
17014;86344;1927;48;19;3;16;.842;3580000;0
17015;13041;2277;54;33;4;29;.879;3554000;0
17015;34168;563;0;0;0;0;.00nan;0;0
17015;67614;2277;0;0;0;0;.00nan;0;0
17015;141419;563;76;28;2;26;.929;3600000;0
17016;7412;585;0;0;0;0;.00nan;0;0
17016;34168;563;0;0;0;0;.00nan;0;0
17016;35052;585;60;39;4;35;.897;3526000;0
17016;141419;563;55;22;3;19;.864;3600000;0
17017;7412;585;44;26;4;22;.846;3600000;0
17017;19954;2557;0;0;0;0;.00nan;0;0
17017;35052;585;0;0;0;0;.00nan;0;0
17017;56048;2557;75;20;1;19;.950;3600000;0
17018;19954;2557;0;0;0;0;.00nan;0;0
17018;185220;583;20;8;4;4;.500;1051000;0
17018;-1;583;67;23;1;22;.957;2520000;0
17018;56048;2557;55;20;3;17;.850;3600000;0
17019;483;586;53;39;5;34;.872;3600000;0
17019;165150;1922;0;0;0;0;.00nan;0;0
17019;13033;586;0;0;0;0;.00nan;0;0
17019;142583;1922;57;13;1;12;.923;3600000;0
17020;177156;1925;66;40;4;36;.900;3600000;0
17020;19954;2557;30;24;5;19;.792;3572000;0
17020;56048;2557;0;0;0;0;.00nan;0;0
17020;155943;1925;0;0;0;0;.00nan;0;0
17021;11925;567;0;0;0;0;.00nan;0;0
17021;190423;1918;0;0;0;0;.00nan;0;0
17021;185744;1918;86;51;3;48;.941;3900000;0
17021;85749;567;57;30;3;27;.900;3900000;0
17022;13041;2277;0;0;0;0;.00nan;0;0
17022;14783;1927;0;0;0;0;.00nan;0;0
17022;67614;2277;61;24;3;21;.875;3900000;0
17022;86344;1927;86;38;3;35;.921;3900000;0
17023;34168;563;0;0;0;0;.00nan;0;0
17023;55285;1928;0;0;0;0;.00nan;0;0
17023;141419;563;83;40;3;37;.925;3600000;0
17023;155769;1928;42;35;6;29;.829;3600000;0
17024;483;586;73;26;2;24;.923;3900000;0
17024;13033;586;0;0;0;0;.00nan;0;0
17024;55285;1928;0;0;0;0;.00nan;0;0
17024;155769;1928;69;30;2;28;.933;3900000;0
17025;177156;1925;62;43;5;38;.884;3600000;0
17025;185220;583;50;18;2;16;.889;3600000;0
17025;-1;583;0;0;0;0;.00nan;0;0
17025;155943;1925;0;0;0;0;.00nan;0;0
17026;320;580;0;0;0;0;.00nan;0;0
17026;11851;580;69;21;2;19;.905;3600000;0
17026;34168;563;33;4;2;2;.500;810000;0
17026;141419;563;23;28;6;22;.786;2790000;0
17027;165150;1922;0;0;0;0;.00nan;0;0
17027;190423;1918;81;40;3;37;.925;3600000;0
17027;185744;1918;0;0;0;0;.00nan;0;0
17027;142583;1922;97;20;0;20;1.000;3600000;0
17028;7412;585;0;0;0;0;.00nan;0;0
17028;11925;567;60;20;2;18;.900;3600000;0
17028;35052;585;69;41;4;37;.902;3567000;0
17028;85749;567;0;0;0;0;.00nan;0;0
17029;11925;567;0;0;0;0;.00nan;0;0
17029;55285;1928;0;0;0;0;.00nan;0;0
17029;85749;567;88;21;1;20;.952;3600000;0
17029;155769;1928;87;36;2;34;.944;3586000;0
17030;177156;1925;91;34;2;32;.941;3600000;0
17030;165150;1922;0;0;0;0;.00nan;0;0
17030;142583;1922;33;16;4;12;.750;3515000;0
17030;155943;1925;0;0;0;0;.00nan;0;0
17031;14783;1927;0;0;0;0;.00nan;0;0
17031;19954;2557;0;0;0;0;.00nan;0;0
17031;56048;2557;88;43;3;40;.930;3570000;0
17031;86344;1927;69;21;1;20;.952;3600000;0
17032;483;586;79;23;1;22;.957;3600000;0
17032;7412;585;55;16;1;15;.938;1257000;0
17032;13033;586;0;0;0;0;.00nan;0;0
17032;35052;585;54;31;4;27;.871;2343000;0
17033;13041;2277;58;25;3;22;.880;3549000;0
17033;19954;2557;0;0;0;0;.00nan;0;0
17033;56048;2557;74;26;2;24;.923;3600000;0
17033;67614;2277;0;0;0;0;.00nan;0;0
17034;11925;567;0;0;0;0;.00nan;0;0
17034;14783;1927;100;48;2;46;.958;3600000;0
17034;85749;567;67;29;3;26;.897;3551000;0
17034;86344;1927;0;0;0;0;.00nan;0;0
17035;320;580;0;0;0;0;.00nan;0;0
17035;11851;580;59;33;4;29;.879;3600000;0
17035;165150;1922;0;0;0;0;.00nan;0;0
17035;142583;1922;100;20;0;20;1.000;3600000;0
17036;190423;1918;0;0;0;0;.00nan;0;0
17036;185744;1918;42;27;5;22;.815;3600000;0
17036;55285;1928;0;0;0;0;.00nan;0;0
17036;155769;1928;94;20;0;20;1.000;3600000;0
17037;34168;563;0;0;0;0;.00nan;0;0
17037;185220;583;55;24;3;21;.875;3600000;0
17037;-1;583;0;0;0;0;.00nan;0;0
17037;141419;563;77;28;2;26;.929;3600000;0
17039;483;586;89;30;1;29;.967;3600000;0
17039;13033;586;0;0;0;0;.00nan;0;0
17039;14783;1927;0;0;0;0;.00nan;0;0
17039;86344;1927;75;35;3;32;.914;3553000;0
17041;11438;2557;43;29;5;24;.828;3582000;0
17041;13041;2277;0;0;0;0;.00nan;0;0
17041;19954;2557;0;0;0;0;.00nan;0;0
17041;67614;2277;58;28;4;24;.857;3600000;0
17043;177156;1925;71;46;4;42;.913;3600000;0
17043;185220;583;83;14;0;14;1.000;3600000;0
17043;-1;583;0;0;0;0;.00nan;0;0
17043;155943;1925;0;0;0;0;.00nan;0;0
17045;11925;567;100;23;0;23;1.000;3600000;0
17045;34168;563;0;0;0;0;.00nan;0;0
17045;85749;567;0;0;0;0;.00nan;0;0
17045;141419;563;74;28;2;26;.929;3555000;0
17047;185744;1918;59;21;2;19;.905;3900000;0
17047;55285;1928;0;0;0;0;.00nan;0;0
17047;67625;1918;0;0;0;0;.00nan;0;0
17047;155769;1928;95;42;2;40;.952;3900000;0
17049;320;580;0;0;0;0;.00nan;0;0
17049;11851;580;80;30;3;27;.900;3900000;0
17049;165150;1922;0;0;0;0;.00nan;0;0
17049;142583;1922;75;33;3;30;.909;3900000;0
17051;7412;585;0;0;0;0;.00nan;0;0
17051;14783;1927;44;36;5;31;.861;3600000;0
17051;35052;585;91;36;2;34;.944;3600000;0
17051;86344;1927;0;0;0;0;.00nan;0;0
17053;165150;1922;54;26;4;22;.846;3600000;0
17053;55285;1928;27;36;7;29;.806;3290000;0
17053;142583;1922;0;0;0;0;.00nan;0;0
17053;155769;1928;53;3;0;3;1.000;310000;0
17055;13041;2277;90;30;1;29;.967;3600000;0
17055;185744;1918;0;0;0;0;.00nan;0;0
17055;67614;2277;0;0;0;0;.00nan;0;0
17055;67625;1918;62;28;3;25;.893;3600000;0
17057;320;580;83;30;2;28;.933;3600000;0
17057;11851;580;0;0;0;0;.00nan;0;0
17057;34168;563;52;30;4;26;.867;3546000;0
17057;141419;563;0;0;0;0;.00nan;0;0
17059;483;586;0;0;0;0;.00nan;0;0
17059;11925;567;63;24;2;22;.917;3600000;0
17059;13033;586;38;33;7;26;.788;3600000;0
17059;85749;567;0;0;0;0;.00nan;0;0
17061;177156;1925;0;0;0;0;.00nan;0;0
17061;11438;2557;53;3;0;3;1.000;584000;0
17061;19954;2557;32;30;6;24;.800;3016000;0
17061;155943;1925;62;26;3;23;.885;3600000;0
17063;11438;2557;0;0;0;0;.00nan;0;0
17063;19954;2557;92;52;4;48;.923;3600000;0
17063;185220;583;69;20;2;18;.900;3600000;0
17063;-1;583;0;0;0;0;.00nan;0;0
17065;483;586;70;41;4;37;.902;3600000;0
17065;11925;567;82;22;1;21;.955;3600000;0
17065;13033;586;0;0;0;0;.00nan;0;0
17065;85749;567;0;0;0;0;.00nan;0;0
17067;320;580;0;0;0;0;.00nan;0;0
17067;11851;580;74;40;3;37;.925;3598000;0
17067;34168;563;0;0;0;0;.00nan;0;0
17067;141419;563;82;26;1;25;.962;3600000;0
17069;177156;1925;92;56;2;54;.964;3900000;0
17069;185744;1918;72;25;2;23;.920;3900000;0
17069;67625;1918;0;0;0;0;.00nan;0;0
17069;155943;1925;0;0;0;0;.00nan;0;0
17071;13041;2277;0;0;0;0;.00nan;0;0
17071;14783;1927;0;0;0;0;.00nan;0;0
17071;67614;2277;48;37;6;31;.838;3564000;0
17071;86344;1927;66;39;5;34;.872;3600000;0
17073;7412;585;0;0;0;0;.00nan;0;0
17073;165150;1922;0;0;0;0;.00nan;0;0
17073;35052;585;68;39;4;35;.897;3883000;0
17073;142583;1922;61;29;4;25;.862;3900000;0
17075;11925;567;0;0;0;0;.00nan;0;0
17075;55285;1928;0;0;0;0;.00nan;0;0
17075;85749;567;58;13;1;12;.923;3600000;0
17075;155769;1928;85;41;2;39;.951;3587000;0
17077;11438;2557;86;30;1;29;.967;3600000;0
17077;19954;2557;0;0;0;0;.00nan;0;0
17077;185220;583;0;0;0;0;.00nan;0;0
17077;-1;583;51;21;3;18;.857;3515000;0
17079;177156;1925;0;0;0;0;.00nan;0;0
17079;7412;585;45;21;4;17;.810;2283000;0
17079;35052;585;70;10;0;10;1.000;1617000;0
17079;155943;1925;47;22;4;18;.818;3900000;0
17081;165150;1922;96;22;0;22;1.000;3600000;0
17081;14783;1927;62;40;4;36;.900;3600000;0
17081;86344;1927;0;0;0;0;.00nan;0;0
17081;142583;1922;0;0;0;0;.00nan;0;0
17083;320;580;100;37;0;37;1.000;3600000;0
17083;483;586;0;0;0;0;.00nan;0;0
17083;11851;580;0;0;0;0;.00nan;0;0
17083;13033;586;49;18;3;15;.833;3600000;0
17085;13041;2277;44;29;4;25;.862;3600000;0
17085;34168;563;100;29;0;29;1.000;3600000;0
17085;67614;2277;0;0;0;0;.00nan;0;0
17085;141419;563;0;0;0;0;.00nan;0;0
17087;7412;585;0;0;0;0;.00nan;0;0
17087;14783;1927;0;0;0;0;.00nan;0;0
17087;35052;585;61;37;4;33;.892;3843000;0
17087;86344;1927;35;25;5;20;.800;3843000;0
17089;11438;2557;0;0;0;0;.00nan;0;0
17089;11925;567;100;21;0;21;1.000;3900000;0
17089;19954;2557;98;30;0;30;1.000;3900000;0
17089;85749;567;0;0;0;0;.00nan;0;0
17091;13041;2277;0;0;0;0;.00nan;0;0
17091;185744;1918;56;35;4;31;.886;3801000;0
17091;67614;2277;75;36;3;33;.917;3801000;0
17091;67625;1918;0;0;0;0;.00nan;0;0
17093;320;580;43;19;3;16;.842;3555000;0
17093;11851;580;0;0;0;0;.00nan;0;0
17093;34168;563;79;32;2;30;.938;3600000;0
17093;141419;563;0;0;0;0;.00nan;0;0
17095;165150;1922;50;32;5;27;.844;3572000;0
17095;185220;583;56;19;3;16;.842;3600000;0
17095;-1;583;0;0;0;0;.00nan;0;0
17095;142583;1922;0;0;0;0;.00nan;0;0
17097;177156;1925;100;36;0;36;1.000;3600000;0
17097;55285;1928;0;0;0;0;.00nan;0;0
17097;155769;1928;65;16;1;15;.938;3550000;0
17097;155943;1925;0;0;0;0;.00nan;0;0
17099;11438;2557;0;0;0;0;.00nan;0;0
17099;13041;2277;71;29;3;26;.897;3600000;0
17099;19954;2557;59;35;4;31;.886;3549000;0
17099;67614;2277;0;0;0;0;.00nan;0;0
17101;177156;1925;42;35;6;29;.829;3069000;0
17101;185744;1918;0;0;0;0;.00nan;0;0
17101;67625;1918;50;9;1;8;.889;3600000;0
17101;155943;1925;53;10;1;9;.900;531000;0
17103;11925;567;90;34;2;32;.941;3600000;0
17103;185220;583;0;0;0;0;.00nan;0;0
17103;-1;583;53;34;4;30;.882;3600000;0
17103;85749;567;0;0;0;0;.00nan;0;0
17105;14783;1927;50;29;4;25;.862;3600000;0
17105;34168;563;0;0;0;0;.00nan;0;0
17105;86344;1927;0;0;0;0;.00nan;0;0
17105;141419;563;89;23;0;23;1.000;3600000;0
17107;483;586;23;19;5;14;.737;3600000;0
17107;7412;585;91;28;1;27;.964;3600000;0
17107;13033;586;0;0;0;0;.00nan;0;0
17107;35052;585;0;0;0;0;.00nan;0;0
17109;320;580;0;0;0;0;.00nan;0;0
17109;11851;580;71;19;1;18;.947;3600000;0
17109;55285;1928;66;22;2;20;.909;3577000;0
17109;155769;1928;0;0;0;0;.00nan;0;0
17111;11925;567;66;30;2;28;.933;3746000;0
17111;55285;1928;0;0;0;0;.00nan;0;0
17111;85749;567;0;0;0;0;.00nan;0;0
17111;155769;1928;66;19;1;18;.947;3746000;0
17113;11438;2557;91;35;1;34;.971;3600000;0
17113;13041;2277;0;0;0;0;.00nan;0;0
17113;19954;2557;0;0;0;0;.00nan;0;0
17113;67614;2277;50;24;4;20;.833;3600000;0
17115;165150;1922;70;19;1;18;.947;3600000;0
17115;14783;1927;0;0;0;0;.00nan;0;0
17115;86344;1927;91;40;2;38;.950;3600000;0
17115;142583;1922;0;0;0;0;.00nan;0;0
17117;483;586;58;27;3;24;.889;3552000;0
17117;177156;1925;75;31;2;29;.935;3600000;0
17117;13033;586;0;0;0;0;.00nan;0;0
17117;155943;1925;0;0;0;0;.00nan;0;0
17119;7412;585;0;0;0;0;.00nan;0;0
17119;34168;563;0;0;0;0;.00nan;0;0
17119;35052;585;80;37;2;35;.946;3577000;0
17119;141419;563;95;21;0;21;1.000;3600000;0
17121;320;580;86;48;3;45;.938;3578000;0
17121;11851;580;0;0;0;0;.00nan;0;0
17121;185744;1918;59;12;1;11;.917;3600000;0
17121;67625;1918;0;0;0;0;.00nan;0;0
211;13041;2277;0;0;0;0;.00nan;0;0
211;19954;2557;0;0;0;0;.00nan;0;0
211;56048;2557;59;16;2;14;.875;3551000;0
211;67614;2277;100;38;1;37;.974;3600000;0
212;34168;563;0;0;0;0;.00nan;0;0
212;55285;1928;0;0;0;0;.00nan;0;0
212;141419;563;86;26;1;25;.962;3600000;0
212;155769;1928;50;33;5;28;.848;3600000;0
213;13041;2277;0;0;0;0;.00nan;0;0
213;19954;2557;0;0;0;0;.00nan;0;0
213;56048;2557;65;30;3;27;.900;3600000;0
213;67614;2277;80;17;0;17;1.000;3600000;0
214;34168;563;0;0;0;0;.00nan;0;0
214;55285;1928;0;0;0;0;.00nan;0;0
214;141419;563;74;34;2;32;.941;3600000;0
214;155769;1928;71;34;3;31;.912;3545000;0
394;11925;567;0;0;0;0;.00nan;0;0
394;13041;2277;0;0;0;0;.00nan;0;0
394;67614;2277;55;37;5;32;.865;3600000;0
394;85749;567;99;27;0;27;1.000;3600000;0
395;190423;1918;0;0;0;0;.00nan;0;0
395;185220;583;91;19;0;19;1.000;3600000;0
395;-1;583;0;0;0;0;.00nan;0;0
395;185744;1918;29;30;6;24;.800;3600000;0
396;320;580;0;0;0;0;.00nan;0;0
396;483;586;79;37;3;34;.919;3552000;0
396;11851;580;81;27;2;25;.926;3600000;0
396;13033;586;0;0;0;0;.00nan;0;0
397;165150;1922;0;0;0;0;.00nan;0;0
397;34168;563;62;6;0;6;1.000;777000;0
397;141419;563;44;36;6;30;.833;2823000;0
397;142583;1922;64;15;1;14;.933;3600000;0
398;11925;567;0;0;0;0;.00nan;0;0
398;13041;2277;0;0;0;0;.00nan;0;0
398;67614;2277;56;41;5;36;.878;3600000;0
398;85749;567;45;22;4;18;.818;3600000;0
399;190423;1918;57;29;3;26;.897;2672000;0
399;185220;583;69;21;1;20;.952;3600000;0
399;-1;583;0;0;0;0;.00nan;0;0
399;185744;1918;25;11;4;7;.636;928000;0
400;320;580;0;0;0;0;.00nan;0;0
400;483;586;51;17;3;14;.824;3600000;0
400;11851;580;89;32;2;30;.938;3600000;0
400;13033;586;0;0;0;0;.00nan;0;0
401;165150;1922;0;0;0;0;.00nan;0;0
401;34168;563;0;0;0;0;.00nan;0;0
401;141419;563;60;41;5;36;.878;3600000;0
401;142583;1922;64;14;1;13;.929;3600000;0
402;11925;567;0;0;0;0;.00nan;0;0
402;13041;2277;89;38;3;35;.921;3189000;0
402;67614;2277;28;6;3;3;.500;411000;0
402;85749;567;69;8;0;8;1.000;3600000;0
403;190423;1918;0;0;0;0;.00nan;0;0
403;185220;583;51;31;4;27;.871;3600000;0
403;-1;583;0;0;0;0;.00nan;0;0
403;185744;1918;49;33;5;28;.848;3600000;0
404;320;580;0;0;0;0;.00nan;0;0
404;483;586;74;33;3;30;.909;3600000;0
404;11851;580;83;25;2;23;.920;3600000;0
404;13033;586;0;0;0;0;.00nan;0;0
405;165150;1922;0;0;0;0;.00nan;0;0
405;34168;563;0;0;0;0;.00nan;0;0
405;141419;563;38;26;5;21;.808;3600000;0
405;142583;1922;65;21;2;19;.905;3600000;0
649;320;580;0;0;0;0;.00nan;0;0
649;11851;580;60;31;4;27;.871;3576000;0
649;11925;567;0;0;0;0;.00nan;0;0
649;85749;567;59;24;3;21;.875;3600000;0
650;165150;1922;0;0;0;0;.00nan;0;0
650;185220;583;75;37;3;34;.919;3889000;0
650;-1;583;0;0;0;0;.00nan;0;0
650;142583;1922;68;24;2;22;.917;3889000;0
651;320;580;0;0;0;0;.00nan;0;0
651;11851;580;93;53;3;50;.943;3597000;0
651;11925;567;0;0;0;0;.00nan;0;0
651;85749;567;62;16;1;15;.938;3600000;0
652;165150;1922;0;0;0;0;.00nan;0;0
652;185220;583;63;30;3;27;.900;3848000;0
652;-1;583;0;0;0;0;.00nan;0;0
652;142583;1922;66;19;2;17;.895;3848000;0
653;320;580;0;0;0;0;.00nan;0;0
653;11851;580;98;35;1;34;.971;3548000;0
653;11925;567;0;0;0;0;.00nan;0;0
653;85749;567;93;23;0;23;1.000;3600000;0
654;165150;1922;0;0;0;0;.00nan;0;0
654;185220;583;72;30;2;28;.933;3600000;0
654;-1;583;0;0;0;0;.00nan;0;0
654;142583;1922;73;37;4;33;.892;3540000;0
919;165150;1922;0;0;0;0;.00nan;0;0
919;185220;583;60;28;4;24;.857;3600000;0
919;-1;583;0;0;0;0;.00nan;0;0
919;142583;1922;100;35;0;35;1.000;3600000;0
940;320;580;0;0;0;0;.00nan;0;0
940;11851;580;84;37;2;35;.946;4670000;0
940;185220;583;83;30;1;29;.967;4670000;0
940;-1;583;0;0;0;0;.00nan;0;0
941;11925;567;0;0;0;0;.00nan;0;0
941;165150;1922;0;0;0;0;.00nan;0;0
941;85749;567;54;28;3;25;.893;4161000;0
941;142583;1922;72;34;4;30;.882;4161000;0
942;11925;567;0;0;0;0;.00nan;0;0
942;165150;1922;0;0;0;0;.00nan;0;0
942;85749;567;58;35;4;31;.886;3566000;0
942;142583;1922;77;39;3;36;.923;3600000;0
943;11925;567;0;0;0;0;.00nan;0;0
943;165150;1922;0;0;0;0;.00nan;0;0
943;85749;567;74;24;2;22;.917;3937000;0
943;142583;1922;73;38;3;35;.921;3937000;0
944;11925;567;78;24;1;23;.958;3476000;0
944;165150;1922;0;0;0;0;.00nan;0;0
944;85749;567;31;9;3;6;.667;419000;0
944;142583;1922;41;31;5;26;.839;3895000;0
1107;11925;567;0;0;0;0;.00nan;0;0
1107;165150;1922;0;0;0;0;.00nan;0;0
1107;85749;567;94;38;2;36;.947;3600000;0
1107;142583;1922;42;19;3;16;.842;3543000;0
17122;20122;646;57;24;3;21;.875;3600000;0
17122;-1;646;0;0;0;0;.00nan;0;0
17122;160906;5088;0;0;0;0;.00nan;0;0
17122;161336;5088;61;32;4;28;.875;3569000;0
17123;168926;638;59;19;2;17;.895;3600000;0
17123;-1;1809;0;0;0;0;.00nan;0;0
17123;51328;1809;78;38;3;35;.921;3552000;0
17123;55209;638;0;0;0;0;.00nan;0;0
17124;180053;1836;0;0;0;0;.00nan;0;0
17124;190508;4538;0;0;0;0;.00nan;0;0
17124;-1;1836;71;28;2;26;.929;3600000;0
17124;145038;4538;80;42;3;39;.929;3553000;0
17125;11104;633;0;0;0;0;.00nan;0;0
17125;-1;1825;0;0;0;0;.00nan;0;0
17125;174806;1825;88;30;1;29;.967;3600000;0
17125;-1;633;44;33;5;28;.848;3600000;0
17126;1838;644;0;0;0;0;.00nan;0;0
17126;-1;632;0;0;0;0;.00nan;0;0
17126;18965;632;100;20;0;20;1.000;3600000;0
17126;61683;644;63;33;3;30;.909;3600000;0
17127;182891;635;0;0;0;0;.00nan;0;0
17127;9455;1838;75;31;2;29;.935;3600000;0
17127;174017;1838;0;0;0;0;.00nan;0;0
17127;-1;635;46;28;5;23;.821;3600000;0
17128;-1;648;74;32;3;29;.906;3600000;0
17128;-1;648;0;0;0;0;.00nan;0;0
17128;156632;626;70;20;1;19;.950;3600000;0
17128;160907;626;0;0;0;0;.00nan;0;0
17129;9455;1838;60;31;3;28;.903;4217000;0
17129;174017;1838;0;0;0;0;.00nan;0;0
17129;-1;1809;0;0;0;0;.00nan;0;0
17129;51328;1809;55;31;4;27;.871;4217000;0
17130;-1;632;0;0;0;0;.00nan;0;0
17130;18965;632;81;26;2;24;.923;3913000;0
17130;20122;646;97;36;1;35;.972;3913000;0
17130;-1;646;0;0;0;0;.00nan;0;0
17131;11104;633;64;30;4;26;.867;3600000;0
17131;190508;4538;0;0;0;0;.00nan;0;0
17131;-1;633;0;0;0;0;.00nan;0;0
17131;145038;4538;87;30;1;29;.967;3600000;0
17132;57172;5088;46;36;5;31;.861;3600000;0
17132;156632;626;42;17;3;14;.824;3600000;0
17132;160907;626;0;0;0;0;.00nan;0;0
17132;161336;5088;0;0;0;0;.00nan;0;0
17133;182891;635;0;0;0;0;.00nan;0;0
17133;-1;648;66;34;4;30;.882;3961000;0
17133;-1;635;91;54;3;51;.944;3961000;0
17133;-1;648;0;0;0;0;.00nan;0;0
17134;1838;644;0;0;0;0;.00nan;0;0
17134;180053;1836;0;0;0;0;.00nan;0;0
17134;-1;1836;71;51;5;46;.902;5127000;0
17134;61683;644;85;53;4;49;.925;5127000;0
17135;168926;638;72;39;5;34;.872;3600000;0
17135;-1;1825;59;23;2;21;.913;2573000;0
17135;174806;1825;18;8;4;4;.500;995000;0
17135;55209;638;0;0;0;0;.00nan;0;0
17136;9455;1838;43;23;4;19;.826;3586000;0
17136;20122;646;90;42;3;39;.929;3600000;0
17136;174017;1838;0;0;0;0;.00nan;0;0
17136;-1;646;0;0;0;0;.00nan;0;0
17137;11104;633;39;22;4;18;.818;3600000;0
17137;-1;1809;0;0;0;0;.00nan;0;0
17137;-1;633;0;0;0;0;.00nan;0;0
17137;51328;1809;26;27;6;21;.778;3583000;0
17138;190508;4538;0;0;0;0;.00nan;0;0
17138;57172;5088;29;31;6;25;.806;3257000;0
17138;145038;4538;80;26;2;24;.923;3600000;0
17138;161336;5088;56;4;0;4;1.000;343000;0
17139;-1;1825;0;0;0;0;.00nan;0;0
17139;174806;1825;84;36;3;33;.917;3600000;0
17139;180053;1836;0;0;0;0;.00nan;0;0
17139;-1;1836;30;16;4;12;.750;3547000;0
17140;1838;644;0;0;0;0;.00nan;0;0
17140;-1;648;92;54;3;51;.944;4684000;0
17140;-1;648;0;0;0;0;.00nan;0;0
17140;61683;644;71;29;2;27;.931;4684000;0
17141;182891;635;0;0;0;0;.00nan;0;0
17141;168926;638;52;28;4;24;.857;5391000;0
17141;-1;635;83;56;5;51;.911;5391000;0
17141;55209;638;0;0;0;0;.00nan;0;0
17142;-1;632;0;0;0;0;.00nan;0;0
17142;18965;632;69;16;1;15;.938;3600000;0
17142;156632;626;63;27;3;24;.889;3600000;0
17142;160907;626;0;0;0;0;.00nan;0;0
17143;9455;1838;46;33;6;27;.818;3600000;0
17143;174017;1838;0;0;0;0;.00nan;0;0
17143;190508;4538;51;2;0;2;1.000;189000;0
17143;145038;4538;23;37;8;29;.784;3340000;0
17144;182891;635;0;0;0;0;.00nan;0;0
17144;-1;632;0;0;0;0;.00nan;0;0
17144;18965;632;63;19;2;17;.895;3600000;0
17144;-1;635;48;32;4;28;.875;3512000;0
17145;11104;633;0;0;0;0;.00nan;0;0
17145;-1;633;70;33;3;30;.909;3600000;0
17145;156632;626;41;35;6;29;.829;3600000;0
17145;160907;626;0;0;0;0;.00nan;0;0
17146;-1;1825;0;0;0;0;.00nan;0;0
17146;174806;1825;64;36;4;32;.889;3790000;0
17146;57172;5088;63;25;3;22;.880;3790000;0
17146;161336;5088;0;0;0;0;.00nan;0;0
17147;20122;646;88;19;0;19;1.000;3600000;0
17147;-1;648;52;36;5;31;.861;3600000;0
17147;-1;646;0;0;0;0;.00nan;0;0
17147;-1;648;0;0;0;0;.00nan;0;0
17148;1838;644;45;6;1;5;.833;1377000;0
17148;168926;638;62;32;3;29;.906;3600000;0
17148;55209;638;0;0;0;0;.00nan;0;0
17148;61683;644;30;19;5;14;.737;2223000;0
17149;-1;1809;0;0;0;0;.00nan;0;0
17149;180053;1836;0;0;0;0;.00nan;0;0
17149;-1;1836;56;26;3;23;.885;3600000;0
17149;51328;1809;46;37;6;31;.838;3600000;0
17150;9455;1838;0;0;0;0;.00nan;0;0
17150;-1;632;0;0;0;0;.00nan;0;0
17150;18965;632;68;30;3;27;.900;3600000;0
17150;174017;1838;88;48;4;44;.917;3586000;0
17151;20122;646;51;31;4;27;.871;3600000;0
17151;180053;1836;54;4;0;4;1.000;784000;0
17151;-1;1836;55;46;7;39;.848;2816000;0
17151;-1;646;0;0;0;0;.00nan;0;0
17152;1838;644;85;17;1;16;.941;3600000;0
17152;-1;1809;0;0;0;0;.00nan;0;0
17152;51328;1809;59;25;3;22;.880;3527000;0
17152;61683;644;0;0;0;0;.00nan;0;0
17153;-1;648;66;22;2;20;.909;3553000;0
17153;190508;4538;0;0;0;0;.00nan;0;0
17153;-1;648;0;0;0;0;.00nan;0;0
17153;145038;4538;92;31;1;30;.968;3600000;0
17154;182891;635;0;0;0;0;.00nan;0;0
17154;11104;633;66;22;2;20;.909;3600000;0
17154;-1;635;72;42;4;38;.905;3599000;0
17154;-1;633;0;0;0;0;.00nan;0;0
17155;-1;1825;0;0;0;0;.00nan;0;0
17155;174806;1825;62;30;3;27;.900;4151000;0
17155;156632;626;53;26;4;22;.846;4151000;0
17155;160907;626;0;0;0;0;.00nan;0;0
17156;168926;638;63;29;3;26;.897;3600000;0
17156;55209;638;0;0;0;0;.00nan;0;0
17156;57172;5088;42;26;4;22;.846;3598000;0
17156;161336;5088;0;0;0;0;.00nan;0;0
17157;-1;632;0;0;0;0;.00nan;0;0
17157;18965;632;96;18;0;18;1.000;3600000;0
17157;190508;4538;0;0;0;0;.00nan;0;0
17157;145038;4538;78;35;3;32;.914;3600000;0
17158;20122;646;69;31;3;28;.903;3559000;0
17158;-1;1825;0;0;0;0;.00nan;0;0
17158;174806;1825;79;24;1;23;.958;3600000;0
17158;-1;646;0;0;0;0;.00nan;0;0
17159;9455;1838;80;56;5;51;.911;3600000;0
17159;11104;633;0;0;0;0;.00nan;0;0
17159;174017;1838;0;0;0;0;.00nan;0;0
17159;-1;633;83;17;0;17;1.000;3600000;0
17160;-1;1809;0;0;0;0;.00nan;0;0
17160;51328;1809;71;26;1;25;.962;4404000;0
17160;57172;5088;0;0;0;0;.00nan;0;0
17160;161336;5088;60;20;2;18;.900;4404000;0
17161;1838;644;0;0;0;0;.00nan;0;0
17161;61683;644;71;18;1;17;.944;3549000;0
17161;156632;626;93;25;0;25;1.000;3600000;0
17161;160907;626;0;0;0;0;.00nan;0;0
17162;168926;638;25;23;6;17;.739;3600000;0
17162;-1;648;50;32;5;27;.844;3600000;0
17162;-1;648;0;0;0;0;.00nan;0;0
17162;55209;638;0;0;0;0;.00nan;0;0
17163;182891;635;0;0;0;0;.00nan;0;0
17163;-1;635;88;34;1;33;.971;3600000;0
17163;180053;1836;0;0;0;0;.00nan;0;0
17163;-1;1836;66;26;2;24;.923;3543000;0
17164;9455;1838;61;32;3;29;.906;3579000;0
17164;174017;1838;0;0;0;0;.00nan;0;0
17164;-1;648;85;27;2;25;.926;3600000;0
17164;-1;648;0;0;0;0;.00nan;0;0
17165;-1;1825;0;0;0;0;.00nan;0;0
17165;174806;1825;64;34;4;30;.882;3600000;0
17165;-1;1809;92;31;1;30;.968;3600000;0
17165;51328;1809;0;0;0;0;.00nan;0;0
17166;1838;644;0;0;0;0;.00nan;0;0
17166;190508;4538;59;35;4;31;.886;3943000;0
17166;61683;644;82;42;3;39;.929;3943000;0
17166;145038;4538;0;0;0;0;.00nan;0;0
17167;11104;633;0;0;0;0;.00nan;0;0
17167;-1;633;71;32;3;29;.906;3600000;0
17167;57172;5088;77;35;4;31;.886;3585000;0
17167;161336;5088;0;0;0;0;.00nan;0;0
17168;182891;635;0;0;0;0;.00nan;0;0
17168;-1;635;65;18;1;17;.944;3600000;0
17168;156632;626;94;46;4;42;.913;3600000;0
17168;160907;626;0;0;0;0;.00nan;0;0
17169;-1;632;0;0;0;0;.00nan;0;0
17169;18965;632;73;34;3;31;.912;3600000;0
17169;180053;1836;0;0;0;0;.00nan;0;0
17169;-1;1836;61;37;5;32;.865;3514000;0
17170;168926;638;87;40;3;37;.925;3600000;0
17170;20122;646;79;41;4;37;.902;3585000;0
17170;-1;646;0;0;0;0;.00nan;0;0
17170;55209;638;0;0;0;0;.00nan;0;0
17171;9455;1838;58;43;5;38;.884;3939000;0
17171;174017;1838;0;0;0;0;.00nan;0;0
17171;180053;1836;0;0;0;0;.00nan;0;0
17171;-1;1836;58;35;4;31;.886;3989000;0
17172;20122;646;55;30;4;26;.867;3594000;0
17172;-1;646;0;0;0;0;.00nan;0;0
17172;156632;626;87;37;2;35;.946;3600000;0
17172;160907;626;0;0;0;0;.00nan;0;0
17173;-1;1809;0;0;0;0;.00nan;0;0
17173;190508;4538;0;0;0;0;.00nan;0;0
17173;51328;1809;67;34;3;31;.912;3600000;0
17173;145038;4538;47;23;4;19;.826;3551000;0
17174;1838;644;99;45;1;44;.978;4134000;0
17174;11104;633;0;0;0;0;.00nan;0;0
17174;-1;633;83;31;2;29;.935;4134000;0
17174;61683;644;0;0;0;0;.00nan;0;0
17175;-1;648;70;38;3;35;.921;3525000;0
17175;-1;648;0;0;0;0;.00nan;0;0
17175;57172;5088;77;19;1;18;.947;3600000;0
17175;161336;5088;0;0;0;0;.00nan;0;0
17176;182891;635;0;0;0;0;.00nan;0;0
17176;-1;635;62;40;5;35;.875;3574000;0
17176;-1;1825;0;0;0;0;.00nan;0;0
17176;174806;1825;55;33;4;29;.879;3600000;0
17177;-1;632;0;0;0;0;.00nan;0;0
17177;18965;632;85;28;1;27;.964;3600000;0
17177;168926;638;76;28;2;26;.929;3542000;0
17177;55209;638;0;0;0;0;.00nan;0;0
17178;-1;632;0;0;0;0;.00nan;0;0
17178;18965;632;55;18;2;16;.889;3600000;0
17178;57172;5088;86;50;4;46;.920;3570000;0
17178;161336;5088;0;0;0;0;.00nan;0;0
17179;182891;635;0;0;0;0;.00nan;0;0
17179;-1;635;92;31;1;30;.968;3600000;0
17179;190508;4538;0;0;0;0;.00nan;0;0
17179;145038;4538;71;27;2;25;.926;3600000;0
17180;9455;1838;55;37;4;33;.892;3535000;0
17180;174017;1838;0;0;0;0;.00nan;0;0
17180;-1;1825;84;31;2;29;.935;3600000;0
17180;174806;1825;0;0;0;0;.00nan;0;0
17181;1838;644;56;26;4;22;.846;3600000;0
17181;20122;646;57;39;5;34;.872;3580000;0
17181;-1;646;0;0;0;0;.00nan;0;0
17181;61683;644;0;0;0;0;.00nan;0;0
17182;11104;633;0;0;0;0;.00nan;0;0
17182;-1;648;0;0;0;0;.00nan;0;0
17182;-1;633;54;15;2;13;.867;3600000;0
17182;-1;648;46;34;4;30;.882;3536000;0
17183;168926;638;73;33;3;30;.909;3600000;0
17183;180053;1836;3;17;7;10;.588;2358000;0
17183;-1;1836;45;5;1;4;.800;1242000;0
17183;55209;638;0;0;0;0;.00nan;0;0
17184;-1;1809;0;0;0;0;.00nan;0;0
17184;51328;1809;62;36;4;32;.889;3600000;0
17184;156632;626;62;27;3;24;.889;3600000;0
17184;160907;626;0;0;0;0;.00nan;0;0
17185;180053;1836;0;0;0;0;.00nan;0;0
17185;190508;4538;0;0;0;0;.00nan;0;0
17185;-1;1836;59;33;3;30;.909;3587000;0
17185;145038;4538;63;20;2;18;.900;3600000;0
17186;9455;1838;0;0;0;0;.00nan;0;0
17186;174017;1838;70;38;3;35;.921;3600000;0
17186;156632;626;53;38;5;33;.868;3529000;0
17186;160907;626;0;0;0;0;.00nan;0;0
17187;20122;646;60;34;4;30;.882;3910000;0
17187;190508;4538;0;0;0;0;.00nan;0;0
17187;-1;646;0;0;0;0;.00nan;0;0
17187;145038;4538;46;33;5;28;.848;3910000;0
17188;1838;644;66;19;1;18;.947;3600000;0
17188;-1;1825;0;0;0;0;.00nan;0;0
17188;174806;1825;40;39;6;33;.846;3600000;0
17188;61683;644;0;0;0;0;.00nan;0;0
17189;11104;633;0;0;0;0;.00nan;0;0
17189;168926;638;67;29;3;26;.897;3570000;0
17189;-1;633;85;34;2;32;.941;3600000;0
17189;55209;638;0;0;0;0;.00nan;0;0
17190;180053;1836;0;0;0;0;.00nan;0;0
17190;-1;1836;84;26;1;25;.962;3600000;0
17190;57172;5088;76;39;3;36;.923;3583000;0
17190;161336;5088;0;0;0;0;.00nan;0;0
17191;-1;632;0;0;0;0;.00nan;0;0
17191;18965;632;53;19;2;17;.895;3600000;0
17191;-1;648;70;38;3;35;.921;3600000;0
17191;-1;648;0;0;0;0;.00nan;0;0
17192;182891;635;0;0;0;0;.00nan;0;0
17192;-1;635;52;25;3;22;.880;3600000;0
17192;-1;1809;0;0;0;0;.00nan;0;0
17192;51328;1809;33;37;7;30;.811;3600000;0
17193;182891;635;0;0;0;0;.00nan;0;0
17193;20122;646;0;0;0;0;.00nan;0;0
17193;-1;635;52;37;5;32;.865;3841000;0
17193;-1;646;42;39;6;33;.846;3841000;0
17194;-1;632;0;0;0;0;.00nan;0;0
17194;18965;632;77;29;2;27;.931;3600000;0
17194;-1;1825;0;0;0;0;.00nan;0;0
17194;174806;1825;72;63;6;57;.905;3600000;0
17195;-1;648;79;23;1;22;.957;3600000;0
17195;-1;1809;0;0;0;0;.00nan;0;0
17195;-1;648;0;0;0;0;.00nan;0;0
17195;51328;1809;82;40;3;37;.925;3548000;0
17196;1838;644;0;0;0;0;.00nan;0;0
17196;57172;5088;61;43;6;37;.860;3024000;0
17196;61683;644;63;17;1;16;.941;3600000;0
17196;161336;5088;44;6;1;5;.833;576000;0
17197;11104;633;0;0;0;0;.00nan;0;0
17197;180053;1836;0;0;0;0;.00nan;0;0
17197;-1;633;61;33;4;29;.879;3826000;0
17197;-1;1836;69;38;3;35;.921;3826000;0
17198;190508;4538;0;0;0;0;.00nan;0;0
17198;145038;4538;65;29;3;26;.897;3545000;0
17198;156632;626;78;31;2;29;.935;3600000;0
17198;160907;626;0;0;0;0;.00nan;0;0
17199;9455;1838;76;39;3;36;.923;3600000;0
17199;168926;638;97;24;0;24;1.000;3600000;0
17199;174017;1838;0;0;0;0;.00nan;0;0
17199;55209;638;0;0;0;0;.00nan;0;0
17200;11104;633;0;0;0;0;.00nan;0;0
17200;20122;646;96;39;1;38;.974;3600000;0
17200;-1;633;48;23;3;20;.870;3517000;0
17200;-1;646;0;0;0;0;.00nan;0;0
17201;-1;632;0;0;0;0;.00nan;0;0
17201;18965;632;63;22;2;20;.909;3680000;0
17201;-1;1809;0;0;0;0;.00nan;0;0
17201;51328;1809;89;41;3;38;.927;3680000;0
17202;168926;638;74;43;4;39;.907;3600000;0
17202;190508;4538;0;0;0;0;.00nan;0;0
17202;55209;638;0;0;0;0;.00nan;0;0
17202;145038;4538;87;30;1;29;.967;3600000;0
17203;-1;648;70;30;3;27;.900;3564000;0
17203;-1;1825;0;0;0;0;.00nan;0;0
17203;174806;1825;71;29;2;27;.931;3600000;0
17203;-1;648;0;0;0;0;.00nan;0;0
17204;182891;635;0;0;0;0;.00nan;0;0
17204;-1;635;69;26;2;24;.923;3600000;0
17204;57172;5088;78;37;3;34;.919;3562000;0
17204;85132;5088;0;0;0;0;.00nan;0;0
17205;1838;644;55;19;2;17;.895;3600000;0
17205;9455;1838;36;39;8;31;.795;3600000;0
17205;174017;1838;0;0;0;0;.00nan;0;0
17205;61683;644;0;0;0;0;.00nan;0;0
17206;180053;1836;0;0;0;0;.00nan;0;0
17206;-1;1836;88;30;1;29;.967;3633000;0
17206;156632;626;67;21;2;19;.905;3633000;0
17206;160907;626;0;0;0;0;.00nan;0;0
17207;182891;635;0;0;0;0;.00nan;0;0
17207;9455;1838;0;0;0;0;.00nan;0;0
17207;174017;1838;48;26;4;22;.846;3600000;0
17207;-1;635;89;19;0;19;1.000;3600000;0
17208;1838;644;58;32;5;27;.844;2281000;0
17208;-1;632;0;0;0;0;.00nan;0;0
17208;18965;632;66;32;4;28;.875;3600000;0
17208;61683;644;64;16;1;15;.938;1319000;0
17209;11104;633;0;0;0;0;.00nan;0;0
17209;-1;1825;0;0;0;0;.00nan;0;0
17209;174806;1825;95;51;3;48;.941;3530000;0
17209;-1;633;84;20;1;19;.950;3600000;0
17210;20122;646;50;38;5;33;.868;3986000;0
17210;-1;646;0;0;0;0;.00nan;0;0
17210;57172;5088;57;35;4;31;.886;3986000;0
17210;85132;5088;0;0;0;0;.00nan;0;0
17211;-1;648;48;25;4;21;.840;3600000;0
17211;-1;648;0;0;0;0;.00nan;0;0
17211;156632;626;88;33;1;32;.970;3600000;0
17211;160907;626;0;0;0;0;.00nan;0;0
17212;168926;638;47;16;2;14;.875;3600000;0
17212;-1;1809;0;0;0;0;.00nan;0;0
17212;51328;1809;78;45;3;42;.933;3600000;0
17212;55209;638;0;0;0;0;.00nan;0;0
17213;9455;1838;100;30;0;30;1.000;3600000;0
17213;20122;646;75;49;5;44;.898;3600000;0
17213;174017;1838;0;0;0;0;.00nan;0;0
17213;-1;646;0;0;0;0;.00nan;0;0
17214;-1;632;0;0;0;0;.00nan;0;0
17214;18965;632;80;24;1;23;.958;3600000;0
17214;156632;626;61;33;3;30;.909;3540000;0
17214;160907;626;0;0;0;0;.00nan;0;0
17215;11104;633;0;0;0;0;.00nan;0;0
17215;-1;1809;0;0;0;0;.00nan;0;0
17215;-1;633;67;19;1;18;.947;3600000;0
17215;51328;1809;96;56;4;52;.929;3600000;0
17216;190508;4538;0;0;0;0;.00nan;0;0
17216;57172;5088;30;30;6;24;.800;2174000;0
17216;85132;5088;58;7;0;7;1.000;1426000;0
17216;145038;4538;64;24;3;21;.875;3600000;0
17217;1838;644;98;31;1;30;.968;4310000;0
17217;-1;648;75;32;2;30;.938;4310000;0
17217;-1;648;0;0;0;0;.00nan;0;0
17217;61683;644;0;0;0;0;.00nan;0;0
17218;-1;1825;45;6;1;5;.833;318000;0
17218;174806;1825;41;37;6;31;.838;3282000;0
17218;180053;1836;67;25;2;23;.920;3600000;0
17218;-1;1836;0;0;0;0;.00nan;0;0
17219;182891;635;0;0;0;0;.00nan;0;0
17219;168926;638;77;25;1;24;.960;3600000;0
17219;-1;635;85;42;3;39;.929;3573000;0
17219;55209;638;0;0;0;0;.00nan;0;0
17220;20122;646;80;34;2;32;.941;3588000;0
17220;-1;648;86;27;1;26;.963;3600000;0
17220;-1;646;0;0;0;0;.00nan;0;0
17220;-1;648;0;0;0;0;.00nan;0;0
17221;-1;1809;0;0;0;0;.00nan;0;0
17221;180053;1836;0;0;0;0;.00nan;0;0
17221;-1;1836;14;24;7;17;.708;3600000;0
17221;51328;1809;63;31;4;27;.871;3600000;0
17222;9455;1838;71;54;5;49;.907;3600000;0
17222;174017;1838;0;0;0;0;.00nan;0;0
17222;190508;4538;70;26;2;24;.923;3600000;0
17222;145038;4538;0;0;0;0;.00nan;0;0
17223;-1;1825;0;0;0;0;.00nan;0;0
17223;174806;1825;45;31;4;27;.871;3600000;0
17223;57172;5088;23;30;7;23;.767;2946000;0
17223;85132;5088;52;3;0;3;1.000;654000;0
17224;1838;644;80;35;2;33;.943;3600000;0
17224;168926;638;29;24;6;18;.750;3600000;0
17224;55209;638;0;0;0;0;.00nan;0;0
17224;61683;644;0;0;0;0;.00nan;0;0
17225;182891;635;0;0;0;0;.00nan;0;0
17225;-1;632;0;0;0;0;.00nan;0;0
17225;18965;632;64;19;2;17;.895;3600000;0
17225;-1;635;53;38;5;33;.868;3600000;0
17226;11104;633;0;0;0;0;.00nan;0;0
17226;-1;633;91;23;1;22;.957;3594000;0
17226;156632;626;100;20;0;20;1.000;3600000;0
17226;160907;626;0;0;0;0;.00nan;0;0
17227;20122;646;42;24;5;19;.792;3577000;0
17227;-1;1809;0;0;0;0;.00nan;0;0
17227;-1;646;0;0;0;0;.00nan;0;0
17227;51328;1809;57;33;4;29;.879;3600000;0
17228;9455;1838;68;43;5;38;.884;3600000;0
17228;-1;632;0;0;0;0;.00nan;0;0
17228;18965;632;80;20;1;19;.950;3600000;0
17228;174017;1838;0;0;0;0;.00nan;0;0
17229;-1;1825;98;41;1;40;.976;3600000;0
17229;174806;1825;0;0;0;0;.00nan;0;0
17229;156632;626;39;24;4;20;.833;3585000;0
17229;160907;626;0;0;0;0;.00nan;0;0
17230;182891;635;46;15;2;13;.867;1714000;0
17230;11104;633;0;0;0;0;.00nan;0;0
17230;-1;635;37;32;6;26;.813;1886000;0
17230;-1;633;65;24;2;22;.917;3600000;0
17231;168926;638;79;30;2;28;.933;3600000;0
17231;55209;638;0;0;0;0;.00nan;0;0
17231;57172;5088;54;30;4;26;.867;3559000;0
17231;85132;5088;0;0;0;0;.00nan;0;0
17232;1838;644;36;21;5;16;.762;3600000;0
17232;-1;1809;52;3;0;3;1.000;547000;0
17232;51328;1809;40;35;6;29;.829;3053000;0
17232;61683;644;0;0;0;0;.00nan;0;0
17233;-1;648;66;29;3;26;.897;3600000;0
17233;190508;4538;0;0;0;0;.00nan;0;0
17233;-1;648;0;0;0;0;.00nan;0;0
17233;145038;4538;65;38;4;34;.895;3546000;0
17234;20122;646;66;29;3;26;.897;3536000;0
17234;180053;1836;0;0;0;0;.00nan;0;0
17234;-1;1836;99;45;1;44;.978;3600000;0
17234;-1;646;0;0;0;0;.00nan;0;0
17235;9455;1838;54;25;3;22;.880;3543000;0
17235;11104;633;0;0;0;0;.00nan;0;0
17235;174017;1838;0;0;0;0;.00nan;0;0
17235;-1;633;81;26;1;25;.962;3600000;0
17236;20122;646;77;21;1;20;.952;3600000;0
17236;-1;1825;0;0;0;0;.00nan;0;0
17236;174806;1825;77;33;2;31;.939;3548000;0
17236;-1;646;0;0;0;0;.00nan;0;0
17237;-1;1809;42;47;7;40;.851;3600000;0
17237;51328;1809;0;0;0;0;.00nan;0;0
17237;57172;5088;58;14;1;13;.929;3600000;0
17237;85132;5088;0;0;0;0;.00nan;0;0
17238;-1;632;0;0;0;0;.00nan;0;0
17238;18965;632;67;21;2;19;.905;3600000;0
17238;190508;4538;34;42;7;35;.833;3600000;0
17238;145038;4538;0;0;0;0;.00nan;0;0
17239;182891;635;72;27;2;25;.926;3600000;0
17239;-1;635;0;0;0;0;.00nan;0;0
17239;180053;1836;0;0;0;0;.00nan;0;0
17239;-1;1836;58;27;3;24;.889;3547000;0
17240;1838;644;54;25;3;22;.880;3600000;0
17240;61683;644;0;0;0;0;.00nan;0;0
17240;156632;626;60;40;4;36;.900;3571000;0
17240;160907;626;0;0;0;0;.00nan;0;0
17241;168926;638;0;0;0;0;.00nan;0;0
17241;-1;648;54;23;3;20;.870;3545000;0
17241;-1;648;0;0;0;0;.00nan;0;0
17241;55209;638;67;20;2;18;.900;3600000;0
17242;168926;638;100;43;0;43;1.000;3714000;0
17242;20122;646;89;31;1;30;.968;3714000;0
17242;-1;646;0;0;0;0;.00nan;0;0
17242;55209;638;0;0;0;0;.00nan;0;0
17243;-1;632;0;0;0;0;.00nan;0;0
17243;18965;632;51;28;4;24;.857;3526000;0
17243;180053;1836;0;0;0;0;.00nan;0;0
17243;-1;1836;77;36;3;33;.917;3600000;0
17244;11104;633;0;0;0;0;.00nan;0;0
17244;-1;633;60;23;2;21;.913;3600000;0
17244;57172;5088;65;41;4;37;.902;3513000;0
17244;85132;5088;0;0;0;0;.00nan;0;0
17245;1838;644;0;0;0;0;.00nan;0;0
17245;190508;4538;0;0;0;0;.00nan;0;0
17245;61683;644;18;33;7;26;.788;3600000;0
17245;145038;4538;62;30;4;26;.867;3600000;0
17246;9455;1838;80;42;3;39;.929;3600000;0
17246;174017;1838;0;0;0;0;.00nan;0;0
17246;-1;648;100;22;0;22;1.000;3600000;0
17246;-1;648;0;0;0;0;.00nan;0;0
17247;182891;635;0;0;0;0;.00nan;0;0
17247;-1;635;100;26;0;26;1.000;3600000;0
17247;156632;626;81;31;2;29;.935;3515000;0
17247;160907;626;0;0;0;0;.00nan;0;0
17248;9455;1838;0;0;0;0;.00nan;0;0
17248;174017;1838;54;30;4;26;.867;3641000;0
17248;57172;5088;74;30;3;27;.900;3641000;0
17248;85132;5088;0;0;0;0;.00nan;0;0
17249;20122;646;74;24;2;22;.917;3600000;0
17249;-1;1809;49;2;0;2;1.000;430000;0
17249;-1;646;0;0;0;0;.00nan;0;0
17249;51328;1809;41;36;6;30;.833;3170000;0
17250;-1;1825;0;0;0;0;.00nan;0;0
17250;174806;1825;76;40;3;37;.925;3515000;0
17250;190508;4538;0;0;0;0;.00nan;0;0
17250;145038;4538;79;26;1;25;.962;3600000;0
17251;11104;633;0;0;0;0;.00nan;0;0
17251;-1;632;0;0;0;0;.00nan;0;0
17251;18965;632;58;21;2;19;.905;3600000;0
17251;-1;633;100;43;1;42;.977;3600000;0
17252;1838;644;68;20;2;18;.900;3600000;0
17252;182891;635;0;0;0;0;.00nan;0;0
17252;-1;635;57;35;4;31;.886;3556000;0
17252;61683;644;0;0;0;0;.00nan;0;0
17253;-1;648;62;48;5;43;.896;3600000;0
17253;180053;1836;0;0;0;0;.00nan;0;0
17253;-1;1836;80;30;1;29;.967;3600000;0
17253;-1;648;0;0;0;0;.00nan;0;0
17254;168926;638;60;27;4;23;.852;3343000;0
17254;55209;638;54;3;0;3;1.000;296000;0
17254;156632;626;44;26;5;21;.808;3639000;0
17254;160907;626;0;0;0;0;.00nan;0;0
17255;-1;1825;0;0;0;0;.00nan;0;0
17255;174806;1825;53;31;4;27;.871;3600000;0
17255;-1;1809;0;0;0;0;.00nan;0;0
17255;51328;1809;83;25;1;24;.960;3600000;0
17256;-1;648;95;28;1;27;.964;3600000;0
17256;190508;4538;62;34;4;30;.882;3600000;0
17256;-1;648;0;0;0;0;.00nan;0;0
17256;145038;4538;0;0;0;0;.00nan;0;0
17257;-1;632;0;0;0;0;.00nan;0;0
17257;18965;632;62;20;2;18;.900;3600000;0
17257;168926;638;70;38;3;35;.921;3543000;0
17257;55209;638;0;0;0;0;.00nan;0;0
17258;-1;1809;0;0;0;0;.00nan;0;0
17258;190508;4538;0;0;0;0;.00nan;0;0
17258;51328;1809;59;33;4;29;.879;3550000;0
17258;145038;4538;44;19;3;16;.842;3600000;0
17259;182891;635;0;0;0;0;.00nan;0;0
17259;-1;635;61;36;3;33;.917;3551000;0
17259;-1;1825;100;36;1;35;.972;3600000;0
17259;174806;1825;0;0;0;0;.00nan;0;0
17260;1838;644;0;0;0;0;.00nan;0;0
17260;11104;633;0;0;0;0;.00nan;0;0
17260;-1;633;80;26;1;25;.962;3600000;0
17260;61683;644;75;31;2;29;.935;3600000;0
17261;-1;648;81;37;2;35;.946;3600000;0
17261;-1;648;0;0;0;0;.00nan;0;0
17261;57172;5088;76;37;3;34;.919;3567000;0
17261;85132;5088;0;0;0;0;.00nan;0;0
17262;9455;1838;90;45;3;42;.933;3600000;0
17262;174017;1838;0;0;0;0;.00nan;0;0
17262;180053;1836;0;0;0;0;.00nan;0;0
17262;-1;1836;48;34;5;29;.853;3533000;0
17263;20122;646;63;25;2;23;.920;3600000;0
17263;-1;646;0;0;0;0;.00nan;0;0
17263;156632;626;68;35;4;31;.886;3537000;0
17263;160907;626;0;0;0;0;.00nan;0;0
17264;9455;1838;28;8;3;5;.625;254000;0
17264;174017;1838;57;30;4;26;.867;3346000;0
17264;-1;1825;0;0;0;0;.00nan;0;0
17264;174806;1825;58;26;3;23;.885;3600000;0
17265;1838;644;82;25;1;24;.960;3600000;0
17265;20122;646;75;35;2;33;.943;3549000;0
17265;-1;646;0;0;0;0;.00nan;0;0
17265;61683;644;0;0;0;0;.00nan;0;0
17266;-1;1809;66;45;4;41;.911;3600000;0
17266;51328;1809;0;0;0;0;.00nan;0;0
17266;156632;626;60;20;2;18;.900;3600000;0
17266;160907;626;0;0;0;0;.00nan;0;0
17267;11104;633;0;0;0;0;.00nan;0;0
17267;-1;648;58;34;4;30;.882;3557000;0
17267;-1;633;56;19;3;16;.842;3600000;0
17267;-1;648;0;0;0;0;.00nan;0;0
17268;-1;632;0;0;0;0;.00nan;0;0
17268;18965;632;100;29;0;29;1.000;3600000;0
17268;57172;5088;71;41;4;37;.902;3600000;0
17268;85132;5088;0;0;0;0;.00nan;0;0
17269;182891;635;0;0;0;0;.00nan;0;0
17269;-1;635;89;43;2;41;.953;3560000;0
17269;190508;4538;0;0;0;0;.00nan;0;0
17269;145038;4538;100;33;0;33;1.000;3600000;0
17270;168926;638;13;18;6;12;.667;2626000;0
17270;180053;1836;0;0;0;0;.00nan;0;0
17270;-1;1836;76;32;2;30;.938;3600000;0
17270;55209;638;43;4;1;3;.750;974000;0
17271;11104;633;0;0;0;0;.00nan;0;0
17271;-1;632;0;0;0;0;.00nan;0;0
17271;18965;632;57;21;2;19;.905;3600000;0
17271;-1;633;51;40;5;35;.875;3600000;0
17272;-1;1825;0;0;0;0;.00nan;0;0
17272;174806;1825;63;34;3;31;.912;3600000;0
17272;190508;4538;0;0;0;0;.00nan;0;0
17272;145038;4538;58;32;4;28;.875;3591000;0
17273;9455;1838;64;32;4;28;.875;3600000;0
17273;174017;1838;0;0;0;0;.00nan;0;0
17273;57172;5088;71;34;3;31;.912;3600000;0
17273;85132;5088;0;0;0;0;.00nan;0;0
17274;1838;644;84;40;3;37;.925;4726000;0
17274;182891;635;0;0;0;0;.00nan;0;0
17274;-1;635;100;54;2;52;.963;4726000;0
17274;61683;644;0;0;0;0;.00nan;0;0
17275;-1;648;63;21;2;19;.905;3838000;0
17275;180053;1836;0;0;0;0;.00nan;0;0
17275;-1;1836;67;32;3;29;.906;3838000;0
17275;-1;648;0;0;0;0;.00nan;0;0
17276;168926;638;26;28;6;22;.786;3600000;0
17276;55209;638;0;0;0;0;.00nan;0;0
17276;156632;626;56;32;5;27;.844;3600000;0
17276;160907;626;0;0;0;0;.00nan;0;0
17277;20122;646;30;26;6;20;.769;2917000;0
17277;190508;4538;0;0;0;0;.00nan;0;0
17277;-1;646;35;6;2;4;.667;610000;0
17277;145038;4538;44;38;6;32;.842;3600000;0
17278;-1;632;0;0;0;0;.00nan;0;0
17278;18965;632;72;21;1;20;.952;5010000;0
17278;-1;648;94;66;2;64;.970;5010000;0
17278;-1;648;0;0;0;0;.00nan;0;0
17279;182891;635;0;0;0;0;.00nan;0;0
17279;-1;635;42;24;4;20;.833;3576000;0
17279;-1;1809;0;0;0;0;.00nan;0;0
17279;51328;1809;63;29;3;26;.897;3600000;0
17280;1838;644;46;19;4;15;.789;3600000;0
17280;-1;1825;38;39;6;33;.846;3286000;0
17280;174806;1825;30;9;3;6;.667;314000;0
17280;61683;644;0;0;0;0;.00nan;0;0
17281;180053;1836;0;0;0;0;.00nan;0;0
17281;-1;1836;69;18;1;17;.944;3600000;0
17281;57172;5088;57;26;3;23;.885;3595000;0
17281;85132;5088;0;0;0;0;.00nan;0;0
17282;9455;1838;51;41;6;35;.854;3600000;0
17282;174017;1838;0;0;0;0;.00nan;0;0
17282;156632;626;70;25;2;23;.920;3600000;0
17282;160907;626;0;0;0;0;.00nan;0;0
17283;11104;633;0;0;0;0;.00nan;0;0
17283;168926;638;72;22;1;21;.955;3573000;0
17283;-1;633;86;16;0;16;1.000;3600000;0
17283;55209;638;0;0;0;0;.00nan;0;0
17284;9455;1838;0;0;0;0;.00nan;0;0
17284;168926;638;100;40;0;40;1.000;3600000;0
17284;174017;1838;86;34;2;32;.941;3517000;0
17284;55209;638;0;0;0;0;.00nan;0;0
17285;190508;4538;19;26;6;20;.769;2804000;0
17285;145038;4538;50;8;1;7;.875;796000;0
17285;156632;626;41;31;5;26;.839;3340000;0
17285;160907;626;51;1;0;1;1.000;260000;0
17286;-1;632;0;0;0;0;.00nan;0;0
17286;18965;632;48;20;3;17;.850;3600000;0
17286;-1;1825;56;8;1;7;.875;793000;0
17286;174806;1825;28;31;6;25;.806;2807000;0
17287;11104;633;0;0;0;0;.00nan;0;0
17287;180053;1836;52;8;1;7;.875;627000;0
17287;-1;633;51;18;3;15;.833;3600000;0
17287;-1;1836;20;25;6;19;.760;2973000;0
17288;1838;644;58;21;2;19;.905;3600000;0
17288;57172;5088;0;0;0;0;.00nan;0;0
17288;61683;644;0;0;0;0;.00nan;0;0
17288;85132;5088;50;35;4;31;.886;3527000;0
17289;-1;648;21;25;6;19;.760;3013000;0
17289;-1;1809;38;30;5;25;.833;3600000;0
17289;-1;648;50;1;0;1;1.000;552000;0
17289;51328;1809;0;0;0;0;.00nan;0;0
17290;182891;635;0;0;0;0;.00nan;0;0
17290;20122;646;21;28;7;21;.750;2793000;0
17290;-1;635;50;34;5;29;.853;3600000;0
17290;-1;646;50;8;1;7;.875;807000;0
17291;1838;644;57;25;4;21;.840;5314000;0
17291;9455;1838;67;31;3;28;.903;5314000;0
17291;174017;1838;0;0;0;0;.00nan;0;0
17291;61683;644;0;0;0;0;.00nan;0;0
17292;-1;632;0;0;0;0;.00nan;0;0
17292;18965;632;75;10;0;10;1.000;3600000;0
17292;-1;1809;0;0;0;0;.00nan;0;0
17292;51328;1809;98;57;3;54;.947;3600000;0
17293;11104;633;0;0;0;0;.00nan;0;0
17293;20122;646;95;36;1;35;.972;3600000;0
17293;-1;633;75;29;2;27;.931;3549000;0
17293;-1;646;0;0;0;0;.00nan;0;0
17294;-1;648;57;34;4;30;.882;3595000;0
17294;-1;1825;0;0;0;0;.00nan;0;0
17294;174806;1825;82;38;3;35;.921;3600000;0
17294;-1;648;0;0;0;0;.00nan;0;0
17295;182891;635;0;0;0;0;.00nan;0;0
17295;-1;635;72;43;4;39;.907;3574000;0
17295;57172;5088;83;28;2;26;.929;3600000;0
17295;85132;5088;0;0;0;0;.00nan;0;0
17296;180053;1836;75;27;2;25;.926;3600000;0
17296;-1;1836;0;0;0;0;.00nan;0;0
17296;156632;626;59;42;5;37;.881;3600000;0
17296;160907;626;0;0;0;0;.00nan;0;0
17297;168926;638;55;20;3;17;.850;3600000;0
17297;190508;4538;62;15;1;14;.933;1422000;0
17297;55209;638;0;0;0;0;.00nan;0;0
17297;145038;4538;42;35;6;29;.829;2178000;0
17298;-1;632;0;0;0;0;.00nan;0;0
17298;18965;632;90;27;1;26;.963;3600000;0
17298;20122;646;0;0;0;0;.00nan;0;0
17298;-1;646;70;24;2;22;.917;3600000;0
17299;9455;1838;55;34;4;30;.882;3600000;0
17299;174017;1838;0;0;0;0;.00nan;0;0
17299;-1;1809;0;0;0;0;.00nan;0;0
17299;51328;1809;87;28;1;27;.964;3600000;0
17300;11104;633;0;0;0;0;.00nan;0;0
17300;190508;4538;0;0;0;0;.00nan;0;0
17300;-1;633;74;23;1;22;.957;3600000;0
17300;145038;4538;76;34;2;32;.941;3555000;0
17301;168926;638;44;19;3;16;.842;3600000;0
17301;-1;1825;61;39;4;35;.897;3562000;0
17301;174806;1825;0;0;0;0;.00nan;0;0
17301;55209;638;0;0;0;0;.00nan;0;0
17302;1838;644;0;0;0;0;.00nan;0;0
17302;180053;1836;0;0;0;0;.00nan;0;0
17302;-1;1836;62;31;3;28;.903;3552000;0
17302;61683;644;72;30;2;28;.933;3600000;0
17303;182891;635;0;0;0;0;.00nan;0;0
17303;-1;648;33;33;6;27;.818;3600000;0
17303;-1;635;76;29;2;27;.931;3600000;0
17303;-1;648;0;0;0;0;.00nan;0;0
17304;57172;5088;47;28;4;24;.857;3874000;0
17304;85132;5088;0;0;0;0;.00nan;0;0
17304;156632;626;48;30;5;25;.833;3874000;0
17304;160907;626;0;0;0;0;.00nan;0;0
17305;9455;1838;0;0;0;0;.00nan;0;0
17305;174017;1838;55;23;3;20;.870;3568000;0
17305;-1;1809;0;0;0;0;.00nan;0;0
17305;51328;1809;85;36;2;34;.944;3600000;0
17306;-1;632;0;0;0;0;.00nan;0;0
17306;18965;632;63;19;2;17;.895;3600000;0
17306;20122;646;89;48;4;44;.917;3553000;0
17306;-1;646;0;0;0;0;.00nan;0;0
17307;11104;633;0;0;0;0;.00nan;0;0
17307;190508;4538;0;0;0;0;.00nan;0;0
17307;-1;633;58;24;2;22;.917;3544000;0
17307;145038;4538;94;34;1;33;.971;3600000;0
17308;57172;5088;0;0;0;0;.00nan;0;0
17308;85132;5088;42;40;6;34;.850;3600000;0
17308;156632;626;53;17;2;15;.882;3600000;0
17308;160907;626;0;0;0;0;.00nan;0;0
17309;182891;635;0;0;0;0;.00nan;0;0
17309;-1;648;0;0;0;0;.00nan;0;0
17309;-1;635;70;26;2;24;.923;3600000;0
17309;-1;648;27;24;5;19;.792;3600000;0
17310;1838;644;88;54;4;50;.926;3600000;0
17310;180053;1836;0;0;0;0;.00nan;0;0
17310;-1;1836;31;23;5;18;.783;3540000;0
17310;61683;644;0;0;0;0;.00nan;0;0
17311;168926;638;50;31;4;27;.871;3600000;0
17311;-1;1825;0;0;0;0;.00nan;0;0
17311;174806;1825;62;41;5;36;.878;3563000;0
17311;55209;638;0;0;0;0;.00nan;0;0
17312;20122;646;48;40;5;35;.875;5363000;0
17312;-1;646;0;0;0;0;.00nan;0;0
17312;57172;5088;64;56;6;50;.893;5418000;0
17312;85132;5088;0;0;0;0;.00nan;0;0
17313;168926;638;63;19;2;17;.895;3600000;0
17313;-1;1809;0;0;0;0;.00nan;0;0
17313;51328;1809;62;39;4;35;.897;3545000;0
17313;55209;638;0;0;0;0;.00nan;0;0
17314;180053;1836;0;0;0;0;.00nan;0;0
17314;190508;4538;85;32;1;31;.969;3600000;0
17314;-1;1836;42;25;4;21;.840;3600000;0
17314;145038;4538;0;0;0;0;.00nan;0;0
17315;11104;633;0;0;0;0;.00nan;0;0
17315;-1;1825;0;0;0;0;.00nan;0;0
17315;174806;1825;80;38;3;35;.921;3517000;0
17315;-1;633;84;29;1;28;.966;3600000;0
17316;1838;644;37;34;6;28;.824;3635000;0
17316;-1;632;0;0;0;0;.00nan;0;0
17316;18965;632;53;34;5;29;.853;3635000;0
17316;61683;644;0;0;0;0;.00nan;0;0
17317;182891;635;60;36;5;31;.861;3566000;0
17317;9455;1838;68;28;3;25;.893;3600000;0
17317;174017;1838;0;0;0;0;.00nan;0;0
17317;-1;635;0;0;0;0;.00nan;0;0
17318;-1;648;71;35;3;32;.914;3600000;0
17318;-1;648;0;0;0;0;.00nan;0;0
17318;156632;626;0;0;0;0;.00nan;0;0
17318;160907;626;85;34;2;32;.941;3600000;0
17319;9455;1838;59;20;2;18;.900;3565000;0
17319;174017;1838;0;0;0;0;.00nan;0;0
17319;190508;4538;0;0;0;0;.00nan;0;0
17319;145038;4538;75;19;1;18;.947;3600000;0
17320;182891;635;0;0;0;0;.00nan;0;0
17320;-1;632;0;0;0;0;.00nan;0;0
17320;18965;632;77;20;1;19;.950;3600000;0
17320;-1;635;64;34;4;30;.882;3600000;0
17321;11104;633;0;0;0;0;.00nan;0;0
17321;-1;633;53;23;3;20;.870;3951000;0
17321;156632;626;71;36;4;32;.889;3978000;0
17321;160907;626;0;0;0;0;.00nan;0;0
17322;-1;1825;0;0;0;0;.00nan;0;0
17322;174806;1825;70;34;3;31;.912;3545000;0
17322;57172;5088;85;30;1;29;.967;3600000;0
17322;85132;5088;0;0;0;0;.00nan;0;0
17323;20122;646;76;23;1;22;.957;3600000;0
17323;-1;648;66;34;3;31;.912;3513000;0
17323;-1;646;0;0;0;0;.00nan;0;0
17323;-1;648;0;0;0;0;.00nan;0;0
17324;-1;1809;0;0;0;0;.00nan;0;0
17324;180053;1836;0;0;0;0;.00nan;0;0
17324;-1;1836;74;19;1;18;.947;3600000;0
17324;51328;1809;62;25;2;23;.920;3546000;0
17325;1838;644;62;37;4;33;.892;3594000;0
17325;168926;638;67;28;3;25;.893;3600000;0
17325;55209;638;0;0;0;0;.00nan;0;0
17325;61683;644;0;0;0;0;.00nan;0;0
17326;9455;1838;0;0;0;0;.00nan;0;0
17326;20122;646;55;25;4;21;.840;3592000;0
17326;174017;1838;69;29;2;27;.931;3600000;0
17326;-1;646;0;0;0;0;.00nan;0;0
17327;11104;633;0;0;0;0;.00nan;0;0
17327;-1;1809;0;0;0;0;.00nan;0;0
17327;-1;633;61;20;2;18;.900;3600000;0
17327;51328;1809;72;43;5;38;.884;3600000;0
17328;190508;4538;79;21;1;20;.952;3600000;0
17328;57172;5088;67;23;2;21;.913;3578000;0
17328;85132;5088;0;0;0;0;.00nan;0;0
17328;145038;4538;0;0;0;0;.00nan;0;0
17329;-1;1825;0;0;0;0;.00nan;0;0
17329;174806;1825;60;29;3;26;.897;3525000;0
17329;180053;1836;0;0;0;0;.00nan;0;0
17329;-1;1836;84;40;2;38;.950;3600000;0
17330;1838;644;59;28;3;25;.893;3600000;0
17330;3821;648;53;21;2;19;.905;2463000;0
17330;-1;648;42;21;4;17;.810;1137000;0
17330;61683;644;0;0;0;0;.00nan;0;0
17331;182891;635;0;0;0;0;.00nan;0;0
17331;168926;638;65;21;2;19;.905;3600000;0
17331;-1;635;45;32;5;27;.844;3600000;0
17331;55209;638;0;0;0;0;.00nan;0;0
17332;-1;632;0;0;0;0;.00nan;0;0
17332;18965;632;89;19;0;19;1.000;3600000;0
17332;156632;626;80;34;3;31;.912;3600000;0
17332;160907;626;0;0;0;0;.00nan;0;0
17333;-1;632;0;0;0;0;.00nan;0;0
17333;18965;632;40;25;5;20;.800;3766000;0
17333;190508;4538;0;0;0;0;.00nan;0;0
17333;145038;4538;64;33;4;29;.879;3766000;0
17334;20122;646;67;23;2;21;.913;3953000;0
17334;-1;1825;0;0;0;0;.00nan;0;0
17334;174806;1825;80;41;3;38;.927;3953000;0
17334;-1;646;0;0;0;0;.00nan;0;0
17335;9455;1838;0;0;0;0;.00nan;0;0
17335;11104;633;0;0;0;0;.00nan;0;0
17335;174017;1838;63;53;6;47;.887;3600000;0
17335;-1;633;52;20;2;18;.900;3600000;0
17336;-1;1809;0;0;0;0;.00nan;0;0
17336;51328;1809;64;33;3;30;.909;4684000;0
17336;57172;5088;47;34;4;30;.882;4684000;0
17336;85132;5088;0;0;0;0;.00nan;0;0
17337;1838;644;0;0;0;0;.00nan;0;0
17337;61683;644;68;27;2;25;.926;3600000;0
17337;156632;626;52;30;3;27;.900;3555000;0
17337;160907;626;0;0;0;0;.00nan;0;0
17338;3821;648;85;34;2;32;.941;3544000;0
17338;168926;638;77;21;1;20;.952;3600000;0
17338;-1;648;0;0;0;0;.00nan;0;0
17338;55209;638;0;0;0;0;.00nan;0;0
17339;182891;635;58;6;0;6;1.000;328000;0
17339;-1;635;36;32;6;26;.813;3220000;0
17339;180053;1836;0;0;0;0;.00nan;0;0
17339;-1;1836;49;32;5;27;.844;3600000;0
17340;9455;1838;0;0;0;0;.00nan;0;0
17340;-1;632;0;0;0;0;.00nan;0;0
17340;18965;632;77;16;0;16;1.000;3600000;0
17340;174017;1838;70;34;3;31;.912;3600000;0
17341;20122;646;61;40;5;35;.875;3600000;0
17341;180053;1836;0;0;0;0;.00nan;0;0
17341;-1;1836;91;31;1;30;.968;3600000;0
17341;-1;646;0;0;0;0;.00nan;0;0
17342;1838;644;83;23;1;22;.957;3600000;0
17342;-1;1809;58;36;5;31;.861;3600000;0
17342;51328;1809;0;0;0;0;.00nan;0;0
17342;61683;644;0;0;0;0;.00nan;0;0
17343;3821;648;0;0;0;0;.00nan;0;0
17343;-1;648;50;20;3;17;.850;3547000;0
17343;190508;4538;89;39;2;37;.949;3600000;0
17343;145038;4538;0;0;0;0;.00nan;0;0
17344;182891;635;0;0;0;0;.00nan;0;0
17344;11104;633;0;0;0;0;.00nan;0;0
17344;-1;635;70;32;4;28;.875;3600000;0
17344;-1;633;74;29;2;27;.931;3600000;0
17345;-1;1825;0;0;0;0;.00nan;0;0
17345;174806;1825;52;38;6;32;.842;3600000;0
17345;156632;626;78;20;1;19;.950;3600000;0
17345;160907;626;0;0;0;0;.00nan;0;0
17346;168926;638;83;18;0;18;1.000;3600000;0
17346;55209;638;0;0;0;0;.00nan;0;0
17346;57172;5088;28;31;6;25;.806;3600000;0
17346;85132;5088;0;0;0;0;.00nan;0;0
17347;-1;632;0;0;0;0;.00nan;0;0
17347;18965;632;60;23;2;21;.913;3600000;0
17347;57172;5088;83;48;3;45;.938;3581000;0
17347;85132;5088;0;0;0;0;.00nan;0;0
17348;182891;635;0;0;0;0;.00nan;0;0
17348;-1;635;37;26;5;21;.808;3600000;0
17348;190508;4538;0;0;0;0;.00nan;0;0
17348;145038;4538;70;28;2;26;.929;3600000;0
17349;9455;1838;94;31;1;30;.968;3600000;0
17349;174017;1838;0;0;0;0;.00nan;0;0
17349;-1;1825;68;37;5;32;.865;3600000;0
17349;174806;1825;0;0;0;0;.00nan;0;0
17350;1838;644;76;24;1;23;.958;3600000;0
17350;20122;646;69;28;3;25;.893;3522000;0
17350;-1;646;0;0;0;0;.00nan;0;0
17350;61683;644;0;0;0;0;.00nan;0;0
17351;3821;648;0;0;0;0;.00nan;0;0
17351;11104;633;0;0;0;0;.00nan;0;0
17351;-1;648;77;32;2;30;.938;3600000;0
17351;-1;633;77;40;3;37;.925;3563000;0
17352;168926;638;79;37;3;34;.919;4707000;0
17352;180053;1836;79;50;4;46;.920;4679000;0
17352;-1;1836;0;0;0;0;.00nan;0;0
17352;55209;638;0;0;0;0;.00nan;0;0
17353;-1;1809;0;0;0;0;.00nan;0;0
17353;51328;1809;93;86;4;82;.953;8494000;0
17353;156632;626;72;40;3;37;.925;8494000;0
17353;160907;626;0;0;0;0;.00nan;0;0
17354;20122;646;72;33;3;30;.909;3546000;0
17354;-1;1809;0;0;0;0;.00nan;0;0
17354;-1;646;0;0;0;0;.00nan;0;0
17354;51328;1809;57;20;2;18;.900;3600000;0
17355;11104;633;0;0;0;0;.00nan;0;0
17355;-1;632;47;28;4;24;.857;3600000;0
17355;18965;632;0;0;0;0;.00nan;0;0
17355;-1;633;100;40;0;40;1.000;3600000;0
17356;-1;1825;0;0;0;0;.00nan;0;0
17356;174806;1825;56;34;6;28;.824;3579000;0
17356;190508;4538;52;27;4;23;.852;3600000;0
17356;145038;4538;0;0;0;0;.00nan;0;0
17357;9455;1838;74;26;1;25;.962;3600000;0
17357;174017;1838;0;0;0;0;.00nan;0;0
17357;57172;5088;0;0;0;0;.00nan;0;0
17357;85132;5088;36;35;6;29;.829;3600000;0
17358;1838;644;31;26;5;21;.808;3555000;0
17358;182891;635;0;0;0;0;.00nan;0;0
17358;-1;635;84;53;4;49;.925;3600000;0
17358;61683;644;0;0;0;0;.00nan;0;0
17359;3821;648;0;0;0;0;.00nan;0;0
17359;-1;648;78;32;2;30;.938;3600000;0
17359;180053;1836;0;0;0;0;.00nan;0;0
17359;-1;1836;55;18;3;15;.833;3600000;0
17360;168926;638;96;32;2;30;.938;3600000;0
17360;55209;638;0;0;0;0;.00nan;0;0
17360;156632;626;51;31;4;27;.871;3565000;0
17360;160907;626;0;0;0;0;.00nan;0;0
17361;3821;648;0;0;0;0;.00nan;0;0
17361;9455;1838;0;0;0;0;.00nan;0;0
17361;174017;1838;66;29;3;26;.897;3545000;0
17361;-1;648;69;32;2;30;.938;3600000;0
17362;-1;1825;0;0;0;0;.00nan;0;0
17362;174806;1825;92;22;0;22;1.000;3600000;0
17362;-1;1809;52;2;0;2;1.000;652000;0
17362;51328;1809;35;32;6;26;.813;2948000;0
17363;1838;644;100;22;0;22;1.000;3600000;0
17363;190508;4538;0;0;0;0;.00nan;0;0
17363;61683;644;0;0;0;0;.00nan;0;0
17363;145038;4538;56;32;4;28;.875;3600000;0
17364;11104;633;0;0;0;0;.00nan;0;0
17364;-1;633;85;25;1;24;.960;3600000;0
17364;57172;5088;55;36;4;32;.889;3600000;0
17364;85132;5088;0;0;0;0;.00nan;0;0
17365;182891;635;0;0;0;0;.00nan;0;0
17365;-1;635;69;40;5;35;.875;3733000;0
17365;156632;626;17;21;6;15;.714;3733000;0
17365;160907;626;0;0;0;0;.00nan;0;0
17366;-1;632;0;0;0;0;.00nan;0;0
17366;18965;632;51;33;5;28;.848;3600000;0
17366;180053;1836;0;0;0;0;.00nan;0;0
17366;-1;1836;80;27;1;26;.963;3600000;0
17367;168926;638;0;0;0;0;.00nan;0;0
17367;20122;646;88;43;3;40;.930;3600000;0
17367;-1;646;0;0;0;0;.00nan;0;0
17367;55209;638;95;26;0;26;1.000;3600000;0
17368;9455;1838;67;32;3;29;.906;3582000;0
17368;174017;1838;0;0;0;0;.00nan;0;0
17368;180053;1836;0;0;0;0;.00nan;0;0
17368;-1;1836;84;33;1;32;.970;3600000;0
17369;182891;635;60;8;0;8;1.000;801000;0
17369;20122;646;75;32;2;30;.938;3600000;0
17369;-1;635;26;27;6;21;.778;2799000;0
17369;-1;646;0;0;0;0;.00nan;0;0
17370;-1;632;0;0;0;0;.00nan;0;0
17370;18965;632;52;22;3;19;.864;3574000;0
17370;-1;1825;0;0;0;0;.00nan;0;0
17370;174806;1825;90;39;2;37;.949;3600000;0
17371;3821;648;0;0;0;0;.00nan;0;0
17371;-1;648;54;24;3;21;.875;3569000;0
17371;-1;1809;85;35;2;33;.943;3600000;0
17371;51328;1809;0;0;0;0;.00nan;0;0
17372;1838;644;58;26;3;23;.885;3600000;0
17372;57172;5088;56;38;5;33;.868;3593000;0
17372;61683;644;0;0;0;0;.00nan;0;0
17372;85132;5088;0;0;0;0;.00nan;0;0
17373;11104;633;0;0;0;0;.00nan;0;0
17373;180053;1836;82;36;2;34;.944;3549000;0
17373;-1;633;100;28;0;28;1.000;3600000;0
17373;-1;1836;0;0;0;0;.00nan;0;0
17374;190508;4538;70;27;2;25;.926;3600000;0
17374;145038;4538;0;0;0;0;.00nan;0;0
17374;156632;626;41;33;6;27;.818;3600000;0
17374;160907;626;0;0;0;0;.00nan;0;0
17375;9455;1838;60;41;5;36;.878;3600000;0
17375;168926;638;0;0;0;0;.00nan;0;0
17375;174017;1838;0;0;0;0;.00nan;0;0
17375;55209;638;82;31;2;29;.935;3600000;0
17376;9455;1838;25;23;6;17;.739;3297000;0
17376;174017;1838;45;4;1;3;.750;303000;0
17376;156632;626;62;30;3;27;.900;3600000;0
17376;160907;626;0;0;0;0;.00nan;0;0
17377;20122;646;62;22;2;20;.909;3600000;0
17377;190508;4538;0;0;0;0;.00nan;0;0
17377;-1;646;0;0;0;0;.00nan;0;0
17377;145038;4538;55;23;3;20;.870;3600000;0
17378;1838;644;77;25;1;24;.960;3600000;0
17378;-1;1825;0;0;0;0;.00nan;0;0
17378;174806;1825;82;43;3;40;.930;3539000;0
17378;61683;644;0;0;0;0;.00nan;0;0
17379;11104;633;0;0;0;0;.00nan;0;0
17379;168926;638;100;26;0;26;1.000;3600000;0
17379;-1;633;72;32;2;30;.938;3514000;0
17379;55209;638;0;0;0;0;.00nan;0;0
17380;180053;1836;0;0;0;0;.00nan;0;0
17380;-1;1836;64;15;1;14;.933;3600000;0
17380;57172;5088;75;35;3;32;.914;3568000;0
17380;85132;5088;0;0;0;0;.00nan;0;0
17381;3821;648;0;0;0;0;.00nan;0;0
17381;-1;632;0;0;0;0;.00nan;0;0
17381;18965;632;76;19;1;18;.947;3600000;0
17381;-1;648;72;33;2;31;.939;3543000;0
17382;182891;635;86;35;1;34;.971;3600000;0
17382;-1;635;0;0;0;0;.00nan;0;0
17382;-1;1809;0;0;0;0;.00nan;0;0
17382;51328;1809;92;40;2;38;.950;3557000;0
17383;20122;646;67;30;3;27;.900;3600000;0
17383;-1;646;0;0;0;0;.00nan;0;0
17383;156632;626;54;34;4;30;.882;3600000;0
17383;160907;626;0;0;0;0;.00nan;0;0
17384;-1;1809;0;0;0;0;.00nan;0;0
17384;190508;4538;56;19;2;17;.895;3600000;0
17384;51328;1809;46;28;4;24;.857;3591000;0
17384;145038;4538;0;0;0;0;.00nan;0;0
17385;1838;644;64;26;3;23;.885;3600000;0
17385;11104;633;0;0;0;0;.00nan;0;0
17385;-1;633;76;60;5;55;.917;3585000;0
17385;61683;644;0;0;0;0;.00nan;0;0
17386;3821;648;0;0;0;0;.00nan;0;0
17386;-1;648;47;21;3;18;.857;4417000;0
17386;57172;5088;63;46;4;42;.913;4417000;0
17386;85132;5088;0;0;0;0;.00nan;0;0
17387;182891;635;0;0;0;0;.00nan;0;0
17387;-1;635;63;30;3;27;.900;3525000;0
17387;-1;1825;0;0;0;0;.00nan;0;0
17387;174806;1825;73;23;1;22;.957;3600000;0
17388;-1;632;0;0;0;0;.00nan;0;0
17388;18965;632;48;20;3;17;.850;3518000;0
17388;168926;638;95;35;1;34;.971;3600000;0
17388;55209;638;0;0;0;0;.00nan;0;0
17389;182891;635;0;0;0;0;.00nan;0;0
17389;9455;1838;0;0;0;0;.00nan;0;0
17389;174017;1838;61;39;4;35;.897;3583000;0
17389;-1;635;64;30;3;27;.900;3600000;0
17390;1838;644;53;35;5;30;.857;3600000;0
17390;-1;632;0;0;0;0;.00nan;0;0
17390;18965;632;81;20;1;19;.950;3600000;0
17390;61683;644;0;0;0;0;.00nan;0;0
17391;11104;633;0;0;0;0;.00nan;0;0
17391;-1;1825;0;0;0;0;.00nan;0;0
17391;174806;1825;80;48;4;44;.917;3514000;0
17391;-1;633;62;20;2;18;.900;3600000;0
17392;20122;646;77;35;3;32;.914;4273000;0
17392;-1;646;0;0;0;0;.00nan;0;0
17392;57172;5088;64;41;4;37;.902;4273000;0
17392;85132;5088;0;0;0;0;.00nan;0;0
17393;3821;648;69;27;3;24;.889;3600000;0
17393;-1;648;0;0;0;0;.00nan;0;0
17393;156632;626;37;28;6;22;.786;3129000;0
17393;160907;626;47;6;1;5;.833;471000;0
17394;180053;1836;0;0;0;0;.00nan;0;0
17394;190508;4538;0;0;0;0;.00nan;0;0
17394;-1;1836;72;27;3;24;.889;3600000;0
17394;145038;4538;60;40;5;35;.875;3592000;0
17395;168926;638;63;15;2;13;.867;3600000;0
17395;-1;1809;0;0;0;0;.00nan;0;0
17395;51328;1809;53;36;5;31;.861;3600000;0
17395;55209;638;0;0;0;0;.00nan;0;0
17396;11104;633;0;0;0;0;.00nan;0;0
17396;20122;646;84;38;2;36;.947;3570000;0
17396;-1;633;97;24;0;24;1.000;3600000;0
17396;-1;646;0;0;0;0;.00nan;0;0
17397;-1;632;0;0;0;0;.00nan;0;0
17397;18965;632;61;23;2;21;.913;3600000;0
17397;-1;1809;0;0;0;0;.00nan;0;0
17397;51328;1809;69;33;3;30;.909;3589000;0
17398;168926;638;70;31;3;28;.903;3937000;0
17398;190508;4538;0;0;0;0;.00nan;0;0
17398;55209;638;0;0;0;0;.00nan;0;0
17398;145038;4538;74;41;4;37;.902;3937000;0
17399;3821;648;0;0;0;0;.00nan;0;0
17399;-1;648;62;19;2;17;.895;3600000;0
17399;-1;1825;52;42;6;36;.857;3600000;0
17399;174806;1825;0;0;0;0;.00nan;0;0
17400;1838;644;0;0;0;0;.00nan;0;0
17400;9455;1838;38;34;6;28;.824;3005000;0
17400;174017;1838;39;9;2;7;.778;595000;0
17400;61683;644;100;23;0;23;1.000;3600000;0
17401;182891;635;0;0;0;0;.00nan;0;0
17401;-1;635;46;39;5;34;.872;3592000;0
17401;57172;5088;66;25;3;22;.880;3600000;0
17401;85132;5088;0;0;0;0;.00nan;0;0
17402;180053;1836;0;0;0;0;.00nan;0;0
17402;-1;1836;50;27;4;23;.852;3513000;0
17402;156632;626;0;0;0;0;.00nan;0;0
17402;160907;626;100;44;2;42;.955;3600000;0
17403;3821;648;0;0;0;0;.00nan;0;0
17403;20122;646;98;33;1;32;.970;3600000;0
17403;-1;648;80;34;2;32;.941;3561000;0
17403;-1;646;0;0;0;0;.00nan;0;0
17404;-1;1809;0;0;0;0;.00nan;0;0
17404;180053;1836;42;31;5;26;.839;3600000;0
17404;-1;1836;0;0;0;0;.00nan;0;0
17404;51328;1809;100;39;1;38;.974;3600000;0
17405;9455;1838;63;39;4;35;.897;4356000;0
17405;174017;1838;0;0;0;0;.00nan;0;0
17405;190508;4538;50;24;3;21;.875;4356000;0
17405;145038;4538;0;0;0;0;.00nan;0;0
17406;-1;1825;0;0;0;0;.00nan;0;0
17406;174806;1825;77;17;0;17;1.000;3600000;0
17406;57172;5088;91;36;1;35;.972;3551000;0
17406;85132;5088;0;0;0;0;.00nan;0;0
17407;1838;644;0;0;0;0;.00nan;0;0
17407;168926;638;96;21;0;21;1.000;3600000;0
17407;55209;638;0;0;0;0;.00nan;0;0
17407;61683;644;80;40;3;37;.925;3600000;0
17408;182891;635;0;0;0;0;.00nan;0;0
17408;-1;632;0;0;0;0;.00nan;0;0
17408;18965;632;93;40;3;37;.925;5165000;0
17408;-1;635;82;41;2;39;.951;5165000;0
17409;11104;633;0;0;0;0;.00nan;0;0
17409;-1;633;54;21;3;18;.857;3556000;0
17409;156632;626;76;26;1;25;.962;3600000;0
17409;160907;626;0;0;0;0;.00nan;0;0
17410;9455;1838;0;0;0;0;.00nan;0;0
17410;20122;646;34;26;5;21;.808;3600000;0
17410;174017;1838;82;26;1;25;.962;3600000;0
17410;-1;646;0;0;0;0;.00nan;0;0
17411;-1;632;0;0;0;0;.00nan;0;0
17411;18965;632;60;24;2;22;.917;3600000;0
17411;156632;626;54;31;3;28;.903;3586000;0
17411;160907;626;0;0;0;0;.00nan;0;0
17412;11104;633;0;0;0;0;.00nan;0;0
17412;-1;1809;0;0;0;0;.00nan;0;0
17412;-1;633;51;22;3;19;.864;3600000;0
17412;51328;1809;53;37;5;32;.865;3595000;0
17413;190508;4538;0;0;0;0;.00nan;0;0
17413;57172;5088;0;0;0;0;.00nan;0;0
17413;85132;5088;100;27;0;27;1.000;3600000;0
17413;145038;4538;56;19;2;17;.895;3560000;0
17414;1838;644;55;26;3;23;.885;3600000;0
17414;3821;648;0;0;0;0;.00nan;0;0
17414;-1;648;67;42;4;38;.905;3540000;0
17414;61683;644;0;0;0;0;.00nan;0;0
17415;-1;1825;52;16;2;14;.875;894000;0
17415;174806;1825;17;20;6;14;.700;2706000;0
17415;180053;1836;60;19;3;16;.842;3600000;0
17415;-1;1836;0;0;0;0;.00nan;0;0
17416;182891;635;0;0;0;0;.00nan;0;0
17416;168926;638;50;24;4;20;.833;3600000;0
17416;-1;635;100;39;0;39;1.000;3600000;0
17416;55209;638;0;0;0;0;.00nan;0;0
17417;9455;1838;64;36;4;32;.889;3600000;0
17417;-1;632;0;0;0;0;.00nan;0;0
17417;18965;632;54;15;3;12;.800;3600000;0
17417;174017;1838;0;0;0;0;.00nan;0;0
17418;-1;1825;0;0;0;0;.00nan;0;0
17418;174806;1825;82;30;1;29;.967;3600000;0
17418;156632;626;75;33;2;31;.939;3578000;0
17418;160907;626;0;0;0;0;.00nan;0;0
17419;182891;635;0;0;0;0;.00nan;0;0
17419;11104;633;0;0;0;0;.00nan;0;0
17419;-1;635;64;44;5;39;.886;3600000;0
17419;-1;633;61;24;2;22;.917;3600000;0
17420;168926;638;79;27;2;25;.926;3600000;0
17420;55209;638;0;0;0;0;.00nan;0;0
17420;57172;5088;0;0;0;0;.00nan;0;0
17420;85132;5088;77;40;3;37;.925;3544000;0
17421;1838;644;94;24;1;23;.958;3600000;0
17421;-1;1809;0;0;0;0;.00nan;0;0
17421;51328;1809;70;53;6;47;.887;3600000;0
17421;61683;644;0;0;0;0;.00nan;0;0
17422;20122;646;74;20;2;18;.900;3600000;0
17422;180053;1836;0;0;0;0;.00nan;0;0
17422;-1;1836;46;38;5;33;.868;3600000;0
17422;-1;646;0;0;0;0;.00nan;0;0
17423;9455;1838;50;33;4;29;.879;3581000;0
17423;174017;1838;0;0;0;0;.00nan;0;0
17423;57172;5088;61;22;2;20;.909;3600000;0
17423;85132;5088;0;0;0;0;.00nan;0;0
17424;20122;646;94;22;0;22;1.000;3600000;0
17424;-1;1809;58;34;4;30;.882;3600000;0
17424;-1;646;0;0;0;0;.00nan;0;0
17424;51328;1809;0;0;0;0;.00nan;0;0
17425;-1;1825;0;0;0;0;.00nan;0;0
17425;174806;1825;61;38;4;34;.895;3600000;0
17425;190508;4538;69;24;1;23;.958;3600000;0
17425;145038;4538;0;0;0;0;.00nan;0;0
17426;11104;633;0;0;0;0;.00nan;0;0
17426;-1;632;0;0;0;0;.00nan;0;0
17426;18965;632;97;21;0;21;1.000;3600000;0
17426;-1;633;57;34;3;31;.912;3600000;0
17427;1838;644;0;0;0;0;.00nan;0;0
17427;182891;635;0;0;0;0;.00nan;0;0
17427;-1;635;58;34;4;30;.882;3583000;0
17427;61683;644;53;18;3;15;.833;3600000;0
17428;3821;648;0;0;0;0;.00nan;0;0
17428;-1;648;53;37;5;32;.865;3600000;0
17428;180053;1836;0;0;0;0;.00nan;0;0
17428;-1;1836;70;21;2;19;.905;3600000;0
17429;168926;638;0;0;0;0;.00nan;0;0
17429;55209;638;46;35;5;30;.857;3600000;0
17429;156632;626;93;32;1;31;.969;3600000;0
17429;160907;626;0;0;0;0;.00nan;0;0
17430;168926;638;58;36;4;32;.889;3600000;0
17430;20122;646;82;23;1;22;.957;3600000;0
17430;-1;646;0;0;0;0;.00nan;0;0
17430;55209;638;0;0;0;0;.00nan;0;0
17431;-1;632;0;0;0;0;.00nan;0;0
17431;18965;632;92;29;2;27;.931;3600000;0
17431;180053;1836;49;1;0;1;1.000;507000;0
17431;-1;1836;56;50;7;43;.860;3093000;0
17432;-1;1825;63;24;2;22;.917;3600000;0
17432;174806;1825;0;0;0;0;.00nan;0;0
17432;-1;1809;0;0;0;0;.00nan;0;0
17432;51328;1809;40;23;4;19;.826;3583000;0
17433;11104;633;0;0;0;0;.00nan;0;0
17433;-1;633;70;22;1;21;.955;3600000;0
17433;57172;5088;100;35;0;35;1.000;3600000;0
17433;85132;5088;0;0;0;0;.00nan;0;0
17434;1838;644;0;0;0;0;.00nan;0;0
17434;190508;4538;0;0;0;0;.00nan;0;0
17434;61683;644;75;23;2;21;.913;3600000;0
17434;145038;4538;81;37;3;34;.919;3544000;0
17435;3821;648;0;0;0;0;.00nan;0;0
17435;9455;1838;85;42;3;39;.929;3622000;0
17435;174017;1838;0;0;0;0;.00nan;0;0
17435;-1;648;46;11;2;9;.818;3609000;0
17436;182891;635;0;0;0;0;.00nan;0;0
17436;-1;635;48;36;5;31;.861;3600000;0
17436;156632;626;81;37;2;35;.946;3600000;0
17436;160907;626;0;0;0;0;.00nan;0;0
17437;9455;1838;0;0;0;0;.00nan;0;0
17437;174017;1838;77;26;1;25;.962;3600000;0
17437;-1;1825;0;0;0;0;.00nan;0;0
17437;174806;1825;89;40;3;37;.925;3559000;0
17438;1838;644;0;0;0;0;.00nan;0;0
17438;20122;646;87;34;2;32;.941;3582000;0
17438;-1;646;0;0;0;0;.00nan;0;0
17438;61683;644;86;26;1;25;.962;3600000;0
17439;3821;648;53;4;0;4;1.000;653000;0
17439;11104;633;0;0;0;0;.00nan;0;0
17439;-1;648;37;45;7;38;.844;2947000;0
17439;-1;633;70;19;2;17;.895;3600000;0
17440;-1;632;0;0;0;0;.00nan;0;0
17440;18965;632;91;17;0;17;1.000;3600000;0
17440;57172;5088;17;7;4;3;.429;757000;0
17440;85132;5088;86;28;1;27;.964;2843000;0
17441;182891;635;0;0;0;0;.00nan;0;0
17441;-1;635;54;33;5;28;.848;3572000;0
17441;190508;4538;77;38;3;35;.921;3600000;0
17441;145038;4538;0;0;0;0;.00nan;0;0
17442;168926;638;71;18;1;17;.944;3600000;0
17442;180053;1836;0;0;0;0;.00nan;0;0
17442;-1;1836;86;42;3;39;.929;3578000;0
17442;55209;638;0;0;0;0;.00nan;0;0
17443;-1;632;0;0;0;0;.00nan;0;0
17443;18965;632;100;27;0;27;1.000;3600000;0
17443;168926;638;17;24;6;18;.750;2755000;0
17443;55209;638;46;5;1;4;.800;845000;0
17444;-1;1809;0;0;0;0;.00nan;0;0
17444;190508;4538;0;0;0;0;.00nan;0;0
17444;51328;1809;72;37;3;34;.919;3600000;0
17444;145038;4538;93;21;0;21;1.000;3600000;0
17445;182891;635;0;0;0;0;.00nan;0;0
17445;-1;635;62;35;4;31;.886;3600000;0
17445;-1;1825;0;0;0;0;.00nan;0;0
17445;174806;1825;31;28;6;22;.786;3516000;0
17446;1838;644;0;0;0;0;.00nan;0;0
17446;11104;633;0;0;0;0;.00nan;0;0
17446;-1;633;62;29;3;26;.897;3600000;0
17446;61683;644;55;30;4;26;.867;3554000;0
17447;3821;648;0;0;0;0;.00nan;0;0
17447;-1;648;51;25;4;21;.840;3600000;0
17447;57172;5088;3;28;8;20;.714;3123000;0
17447;85132;5088;57;5;0;5;1.000;477000;0
17448;9455;1838;55;23;4;19;.826;3600000;0
17448;174017;1838;0;0;0;0;.00nan;0;0
17448;180053;1836;0;0;0;0;.00nan;0;0
17448;-1;1836;38;29;5;24;.828;3545000;0
17449;20122;646;80;31;3;28;.903;3600000;0
17449;-1;646;0;0;0;0;.00nan;0;0
17449;156632;626;45;26;4;22;.846;3589000;0
17449;160907;626;0;0;0;0;.00nan;0;0
17450;-1;1809;0;0;0;0;.00nan;0;0
17450;51328;1809;89;38;2;36;.947;3583000;0
17450;156632;626;79;25;1;24;.960;3600000;0
17450;160907;626;0;0;0;0;.00nan;0;0
17451;9455;1838;59;42;5;37;.881;3567000;0
17451;11104;633;0;0;0;0;.00nan;0;0
17451;174017;1838;0;0;0;0;.00nan;0;0
17451;-1;633;42;22;4;18;.818;3600000;0
17452;20122;646;0;0;0;0;.00nan;0;0
17452;-1;1825;0;0;0;0;.00nan;0;0
17452;174806;1825;67;29;2;27;.931;3600000;0
17452;-1;646;40;25;5;20;.800;3600000;0
17453;-1;1809;52;32;4;28;.875;3588000;0
17453;51328;1809;0;0;0;0;.00nan;0;0
17453;57172;5088;56;26;3;23;.885;3600000;0
17453;85132;5088;0;0;0;0;.00nan;0;0
17454;-1;632;0;0;0;0;.00nan;0;0
17454;18965;632;93;22;0;22;1.000;3600000;0
17454;190508;4538;0;0;0;0;.00nan;0;0
17454;145038;4538;67;48;5;43;.896;3600000;0
17455;182891;635;0;0;0;0;.00nan;0;0
17455;-1;635;55;37;5;32;.865;3600000;0
17455;180053;1836;0;0;0;0;.00nan;0;0
17455;-1;1836;80;26;1;25;.962;3600000;0
17456;1838;644;0;0;0;0;.00nan;0;0
17456;61683;644;95;23;0;23;1.000;3600000;0
17456;156632;626;63;25;3;22;.880;3600000;0
17456;160907;626;0;0;0;0;.00nan;0;0
17457;3821;648;0;0;0;0;.00nan;0;0
17457;168926;638;97;28;0;28;1.000;3600000;0
17457;-1;648;51;27;4;23;.852;3600000;0
17457;55209;638;0;0;0;0;.00nan;0;0
17458;9455;1838;62;21;2;19;.905;3600000;0
17458;168926;638;52;23;3;20;.870;3563000;0
17458;174017;1838;0;0;0;0;.00nan;0;0
17458;55209;638;0;0;0;0;.00nan;0;0
17459;190508;4538;56;24;3;21;.875;3600000;0
17459;145038;4538;0;0;0;0;.00nan;0;0
17459;156632;626;45;38;5;33;.868;3520000;0
17459;160907;626;0;0;0;0;.00nan;0;0
17460;-1;632;0;0;0;0;.00nan;0;0
17460;18965;632;46;12;2;10;.833;3600000;0
17460;-1;1825;0;0;0;0;.00nan;0;0
17460;174806;1825;82;45;3;42;.933;3580000;0
17461;11104;633;0;0;0;0;.00nan;0;0
17461;180053;1836;0;0;0;0;.00nan;0;0
17461;-1;633;41;33;6;27;.818;3599000;0
17461;-1;1836;66;41;4;37;.902;3600000;0
17462;1838;644;0;0;0;0;.00nan;0;0
17462;57172;5088;55;25;3;22;.880;3600000;0
17462;61683;644;82;14;0;14;1.000;3600000;0
17462;85132;5088;0;0;0;0;.00nan;0;0
17463;3821;648;57;15;3;12;.800;3570000;0
17463;-1;648;0;0;0;0;.00nan;0;0
17463;-1;1809;0;0;0;0;.00nan;0;0
17463;51328;1809;86;32;2;30;.938;3600000;0
17464;182891;635;47;6;1;5;.833;1356000;0
17464;20122;646;82;30;1;29;.967;3600000;0
17464;-1;635;40;24;4;20;.833;2244000;0
17464;-1;646;0;0;0;0;.00nan;0;0
17465;20122;646;62;28;3;25;.893;3600000;0
17465;190508;4538;0;0;0;0;.00nan;0;0
17465;-1;646;0;0;0;0;.00nan;0;0
17465;145038;4538;70;26;2;24;.923;3600000;0
17466;3821;648;0;0;0;0;.00nan;0;0
17466;-1;632;0;0;0;0;.00nan;0;0
17466;18965;632;62;31;3;28;.903;6487000;0
17466;-1;648;99;90;2;88;.978;6487000;0
17467;182891;635;0;0;0;0;.00nan;0;0
17467;-1;635;65;15;1;14;.933;3600000;0
17467;-1;1809;0;0;0;0;.00nan;0;0
17467;51328;1809;64;35;4;31;.886;3600000;0
17468;1838;644;0;0;0;0;.00nan;0;0
17468;-1;1825;0;0;0;0;.00nan;0;0
17468;174806;1825;66;34;3;31;.912;3600000;0
17468;61683;644;88;19;0;19;1.000;3600000;0
17469;180053;1836;0;0;0;0;.00nan;0;0
17469;-1;1836;54;20;3;17;.850;3600000;0
17469;57172;5088;73;49;5;44;.898;3581000;0
17469;85132;5088;0;0;0;0;.00nan;0;0
17470;9455;1838;70;28;3;25;.893;3600000;0
17470;174017;1838;0;0;0;0;.00nan;0;0
17470;156632;626;0;0;0;0;.00nan;0;0
17470;160907;626;72;40;4;36;.900;3542000;0
17471;11104;633;0;0;0;0;.00nan;0;0
17471;168926;638;66;37;4;33;.892;4125000;0
17471;-1;633;55;29;3;26;.897;4125000;0
17471;55209;638;0;0;0;0;.00nan;0;0
17472;-1;632;0;0;0;0;.00nan;0;0
17472;18965;632;40;22;4;18;.818;3600000;0
17472;20122;646;79;26;1;25;.962;3600000;0
17472;-1;646;0;0;0;0;.00nan;0;0
17473;9455;1838;91;28;2;26;.929;3600000;0
17473;174017;1838;0;0;0;0;.00nan;0;0
17473;-1;1809;0;0;0;0;.00nan;0;0
17473;51328;1809;79;41;3;38;.927;3584000;0
17474;11104;633;0;0;0;0;.00nan;0;0
17474;190508;4538;88;30;1;29;.967;3600000;0
17474;-1;633;42;28;5;23;.821;3600000;0
17474;145038;4538;0;0;0;0;.00nan;0;0
17475;168926;638;43;14;3;11;.786;3600000;0
17475;-1;1825;62;17;1;16;.941;970000;0
17475;174806;1825;36;29;6;23;.793;2630000;0
17475;55209;638;0;0;0;0;.00nan;0;0
17476;1838;644;0;0;0;0;.00nan;0;0
17476;180053;1836;0;0;0;0;.00nan;0;0
17476;-1;1836;55;26;3;23;.885;3600000;0
17476;61683;644;100;35;0;35;1.000;3600000;0
17477;3821;648;0;0;0;0;.00nan;0;0
17477;182891;635;51;33;5;28;.848;4171000;0
17477;-1;648;42;36;6;30;.833;4171000;0
17477;-1;635;0;0;0;0;.00nan;0;0
17478;57172;5088;71;31;3;28;.903;3600000;0
17478;85132;5088;0;0;0;0;.00nan;0;0
17478;156632;626;61;22;2;20;.909;3600000;0
17478;160907;626;0;0;0;0;.00nan;0;0
17479;1838;644;0;0;0;0;.00nan;0;0
17479;9455;1838;88;41;3;38;.927;3807000;0
17479;174017;1838;0;0;0;0;.00nan;0;0
17479;61683;644;81;28;2;26;.929;3807000;0
17480;-1;632;0;0;0;0;.00nan;0;0
17480;18965;632;48;18;3;15;.833;3513000;0
17480;-1;1809;0;0;0;0;.00nan;0;0
17480;51328;1809;82;27;1;26;.963;3600000;0
17481;11104;633;0;0;0;0;.00nan;0;0
17481;20122;646;67;40;4;36;.900;3556000;0
17481;-1;633;56;23;3;20;.870;3600000;0
17481;-1;646;0;0;0;0;.00nan;0;0
17482;182891;635;34;33;6;27;.818;3134000;0
17482;-1;635;27;9;3;6;.667;466000;0
17482;57172;5088;68;34;3;31;.912;3600000;0
17482;85132;5088;0;0;0;0;.00nan;0;0
17483;3821;648;69;29;3;26;.897;3600000;0
17483;-1;648;0;0;0;0;.00nan;0;0
17483;-1;1825;0;0;0;0;.00nan;0;0
17483;174806;1825;55;42;5;37;.881;3600000;0
17484;180053;1836;54;40;5;35;.875;4706000;0
17484;-1;1836;0;0;0;0;.00nan;0;0
17484;156632;626;76;44;4;40;.909;4706000;0
17484;160907;626;0;0;0;0;.00nan;0;0
17485;168926;638;100;23;0;23;1.000;3600000;0
17485;190508;4538;0;0;0;0;.00nan;0;0
17485;55209;638;0;0;0;0;.00nan;0;0
17485;145038;4538;57;37;5;32;.865;3600000;0
17487;1838;644;68;27;2;25;.926;3841000;0
17487;9455;1838;87;41;3;38;.927;3819000;0
17487;174017;1838;0;0;0;0;.00nan;0;0
17487;61683;644;0;0;0;0;.00nan;0;0
17489;-1;1809;39;1;1;0;.000;424000;0
17489;180053;1836;0;0;0;0;.00nan;0;0
17489;-1;1836;77;22;1;21;.955;3600000;0
17489;51328;1809;35;24;5;19;.792;3176000;0
17491;168926;638;81;37;3;34;.919;3600000;0
17491;190508;4538;42;21;4;17;.810;3574000;0
17491;55209;638;0;0;0;0;.00nan;0;0
17491;145038;4538;0;0;0;0;.00nan;0;0
17493;-1;632;0;0;0;0;.00nan;0;0
17493;18965;632;71;24;2;22;.917;3600000;0
17493;-1;1825;0;0;0;0;.00nan;0;0
17493;174806;1825;53;42;6;36;.857;3600000;0
17495;182891;635;0;0;0;0;.00nan;0;0
17495;11104;633;0;0;0;0;.00nan;0;0
17495;-1;635;35;33;6;27;.818;3600000;0
17495;-1;633;67;37;4;33;.892;3600000;0
17497;-1;648;63;25;3;22;.880;3600000;0
17497;-1;648;0;0;0;0;.00nan;0;0
17497;156632;626;54;32;4;28;.875;3586000;0
17497;160907;626;0;0;0;0;.00nan;0;0
17499;20122;646;52;27;4;23;.852;3670000;0
17499;-1;646;0;0;0;0;.00nan;0;0
17499;160906;5088;0;0;0;0;.00nan;0;0
17499;161336;5088;96;47;3;44;.936;3670000;0
17501;-1;648;65;16;1;15;.938;3600000;0
17501;-1;1809;0;0;0;0;.00nan;0;0
17501;-1;648;0;0;0;0;.00nan;0;0
17501;51328;1809;74;32;3;29;.906;3577000;0
17503;168926;638;60;21;2;19;.905;3600000;0
17503;55209;638;0;0;0;0;.00nan;0;0
17503;156632;626;22;35;7;28;.800;3010000;0
17503;160907;626;54;5;0;5;1.000;590000;0
17505;20122;646;56;27;3;24;.889;3573000;0
17505;-1;1825;0;0;0;0;.00nan;0;0
17505;174806;1825;79;34;2;32;.941;3600000;0
17505;-1;646;0;0;0;0;.00nan;0;0
17507;11104;633;0;0;0;0;.00nan;0;0
17507;190508;4538;44;24;4;20;.833;3300000;0
17507;-1;633;79;36;3;33;.917;3600000;0
17507;145038;4538;30;8;3;5;.625;300000;0
17509;180053;1836;0;0;0;0;.00nan;0;0
17509;-1;1836;61;23;2;21;.913;3600000;0
17509;160906;5088;75;45;4;41;.911;3286000;0
17509;161336;5088;25;5;3;2;.400;314000;0
17511;1838;644;64;18;1;17;.944;3600000;0
17511;9455;1838;89;46;3;43;.935;3600000;0
17511;174017;1838;0;0;0;0;.00nan;0;0
17511;61683;644;0;0;0;0;.00nan;0;0
17513;182891;635;0;0;0;0;.00nan;0;0
17513;-1;632;0;0;0;0;.00nan;0;0
17513;18965;632;100;23;0;23;1.000;3600000;0
17513;-1;635;50;35;5;30;.857;3600000;0
17515;182891;635;56;41;5;36;.878;3600000;0
17515;-1;632;0;0;0;0;.00nan;0;0
17515;18965;632;70;21;1;20;.952;3600000;0
17515;-1;635;0;0;0;0;.00nan;0;0
17517;-1;1809;75;38;5;33;.868;3600000;0
17517;190508;4538;0;0;0;0;.00nan;0;0
17517;51328;1809;0;0;0;0;.00nan;0;0
17517;145038;4538;84;16;0;16;1.000;3600000;0
17519;1838;644;0;0;0;0;.00nan;0;0
17519;20122;646;0;0;0;0;.00nan;0;0
17519;-1;646;42;32;5;27;.844;3600000;0
17519;61683;644;91;21;0;21;1.000;3600000;0
17521;9455;1838;0;0;0;0;.00nan;0;0
17521;174017;1838;70;27;2;25;.926;3600000;0
17521;160906;5088;0;0;0;0;.00nan;0;0
17521;161336;5088;48;26;4;22;.846;3572000;0
17523;168926;638;0;0;0;0;.00nan;0;0
17523;-1;1825;69;31;2;29;.935;3600000;0
17523;174806;1825;0;0;0;0;.00nan;0;0
17523;55209;638;100;31;0;31;1.000;3600000;0
17525;180053;1836;88;37;2;35;.946;3600000;0
17525;-1;1836;0;0;0;0;.00nan;0;0
17525;156632;626;0;0;0;0;.00nan;0;0
17525;160907;626;40;32;5;27;.844;3600000;0
17527;11104;633;41;25;5;20;.800;3590000;0
17527;-1;648;0;0;0;0;.00nan;0;0
17527;-1;633;0;0;0;0;.00nan;0;0
17527;-1;648;69;35;4;31;.886;3600000;0
17529;9455;1838;52;42;6;36;.857;3600000;0
17529;174017;1838;0;0;0;0;.00nan;0;0
17529;180053;1836;0;0;0;0;.00nan;0;0
17529;-1;1836;96;22;0;22;1.000;3600000;0
17531;-1;1809;0;0;0;0;.00nan;0;0
17531;51328;1809;76;29;2;27;.931;3951000;0
17531;160906;5088;0;0;0;0;.00nan;0;0
17531;161336;5088;67;28;3;25;.893;3951000;0
17533;11104;633;0;0;0;0;.00nan;0;0
17533;20122;646;99;36;1;35;.972;3600000;0
17533;-1;633;55;21;2;19;.905;3557000;0
17533;-1;646;0;0;0;0;.00nan;0;0
17535;182891;635;0;0;0;0;.00nan;0;0
17535;-1;648;65;27;2;25;.926;3600000;0
17535;-1;635;84;26;1;25;.962;3600000;0
17535;-1;648;0;0;0;0;.00nan;0;0
17537;168926;638;0;0;0;0;.00nan;0;0
17537;190508;4538;0;0;0;0;.00nan;0;0
17537;55209;638;41;26;4;22;.846;3516000;0
17537;145038;4538;77;33;2;31;.939;3600000;0
17539;1838;644;0;0;0;0;.00nan;0;0
17539;-1;632;0;0;0;0;.00nan;0;0
17539;18965;632;73;39;4;35;.897;6494000;0
17539;61683;644;67;57;5;52;.912;6494000;0
17541;-1;1825;0;0;0;0;.00nan;0;0
17541;174806;1825;68;55;5;50;.909;3600000;0
17541;156632;626;76;26;2;24;.923;3600000;0
17541;160907;626;0;0;0;0;.00nan;0;0
17543;-1;1825;66;41;5;36;.878;3600000;0
17543;174806;1825;0;0;0;0;.00nan;0;0
17543;190508;4538;39;32;6;26;.813;3332000;0
17543;145038;4538;49;1;0;1;1.000;220000;0
17545;168926;638;78;42;4;38;.905;3600000;0
17545;180053;1836;80;21;1;20;.952;3600000;0
17545;-1;1836;0;0;0;0;.00nan;0;0
17545;55209;638;0;0;0;0;.00nan;0;0
17547;1838;644;43;30;5;25;.833;2052000;0
17547;-1;632;74;24;1;23;.958;3600000;0
17547;18965;632;0;0;0;0;.00nan;0;0
17547;61683;644;59;23;2;21;.913;1548000;0
17549;182891;635;73;32;2;30;.938;3600000;0
17549;9455;1838;0;0;0;0;.00nan;0;0
17549;174017;1838;52;29;4;25;.862;3586000;0
17549;-1;635;0;0;0;0;.00nan;0;0
17551;20122;646;0;0;0;0;.00nan;0;0
17551;-1;646;76;32;2;30;.938;3838000;0
17551;160906;5088;78;36;3;33;.917;3838000;0
17551;161336;5088;0;0;0;0;.00nan;0;0
17553;-1;648;0;0;0;0;.00nan;0;0
17553;-1;648;91;51;3;48;.941;3583000;0
17553;156632;626;0;0;0;0;.00nan;0;0
17553;160907;626;63;21;2;19;.905;3600000;0
17555;11104;633;79;20;1;19;.950;3600000;0
17555;-1;1809;45;41;6;35;.854;3600000;0
17555;-1;633;0;0;0;0;.00nan;0;0
17555;51328;1809;0;0;0;0;.00nan;0;0
17557;1838;644;0;0;0;0;.00nan;0;0
17557;-1;1825;0;0;0;0;.00nan;0;0
17557;174806;1825;68;27;2;25;.926;3568000;0
17557;61683;644;89;33;1;32;.970;3600000;0
17559;-1;632;0;0;0;0;.00nan;0;0
17559;18965;632;74;19;1;18;.947;3600000;0
17559;160906;5088;50;15;2;13;.867;1200000;0
17559;161336;5088;26;20;5;15;.750;2400000;0
17561;182891;635;0;0;0;0;.00nan;0;0
17561;-1;648;20;25;6;19;.760;1957000;0
17561;-1;635;48;22;4;18;.818;3600000;0
17561;-1;648;52;9;1;8;.889;1643000;0
17563;11104;633;0;0;0;0;.00nan;0;0
17563;168926;638;68;25;2;23;.920;3600000;0
17563;-1;633;55;36;5;31;.861;3600000;0
17563;55209;638;0;0;0;0;.00nan;0;0
17565;-1;1809;0;0;0;0;.00nan;0;0
17565;190508;4538;0;0;0;0;.00nan;0;0
17565;51328;1809;66;36;4;32;.889;3600000;0
17565;145038;4538;91;21;0;21;1.000;3600000;0
17567;180053;1836;0;0;0;0;.00nan;0;0
17567;-1;1836;84;27;1;26;.963;3600000;0
17567;156632;626;75;33;3;30;.909;3533000;0
17567;160907;626;0;0;0;0;.00nan;0;0
17569;9455;1838;61;36;4;32;.889;4595000;0
17569;20122;646;55;36;5;31;.861;4562000;0
17569;174017;1838;0;0;0;0;.00nan;0;0
17569;-1;646;0;0;0;0;.00nan;0;0
17571;190508;4538;0;0;0;0;.00nan;0;0
17571;145038;4538;66;28;3;25;.893;3600000;0
17571;156632;626;49;19;3;16;.842;3138000;0
17571;160907;626;25;7;3;4;.571;462000;0
17573;182891;635;100;59;3;56;.949;3600000;0
17573;168926;638;0;0;0;0;.00nan;0;0
17573;-1;635;0;0;0;0;.00nan;0;0
17573;55209;638;48;30;4;26;.867;3560000;0
17575;1838;644;64;21;2;19;.905;3600000;0
17575;-1;648;83;28;1;27;.964;3600000;0
17575;-1;648;0;0;0;0;.00nan;0;0
17575;61683;644;0;0;0;0;.00nan;0;0
17577;-1;1809;58;32;4;28;.875;3561000;0
17577;51328;1809;0;0;0;0;.00nan;0;0
17577;160906;5088;55;27;3;24;.889;3600000;0
17577;161336;5088;0;0;0;0;.00nan;0;0
17579;20122;646;0;0;0;0;.00nan;0;0
17579;-1;1825;60;36;4;32;.889;3600000;0
17579;174806;1825;0;0;0;0;.00nan;0;0
17579;-1;646;40;36;6;30;.833;3554000;0
17581;9455;1838;49;10;2;8;.800;1399000;0
17581;11104;633;88;18;0;18;1.000;3600000;0
17581;174017;1838;43;27;5;22;.815;2201000;0
17581;-1;633;0;0;0;0;.00nan;0;0
17583;-1;632;62;33;4;29;.879;3600000;0
17583;18965;632;0;0;0;0;.00nan;0;0
17583;180053;1836;73;23;1;22;.957;3600000;0
17583;-1;1836;0;0;0;0;.00nan;0;0
123;-1;1825;0;0;0;0;.00nan;0;0
123;174806;1825;35;33;6;27;.818;3670000;0
123;156632;626;37;19;4;15;.789;2152000;0
123;160907;626;51;6;1;5;.833;1518000;0
124;182891;635;0;0;0;0;.00nan;0;0
124;20122;646;98;25;0;25;1.000;3600000;0
124;-1;635;98;37;1;36;.973;3555000;0
124;-1;646;0;0;0;0;.00nan;0;0
125;-1;1825;0;0;0;0;.00nan;0;0
125;174806;1825;51;21;3;18;.857;3559000;0
125;156632;626;66;25;2;23;.920;3600000;0
125;160907;626;0;0;0;0;.00nan;0;0
126;182891;635;0;0;0;0;.00nan;0;0
126;20122;646;50;30;4;26;.867;3600000;0
126;-1;635;93;39;1;38;.974;3600000;0
126;-1;646;0;0;0;0;.00nan;0;0
200;182891;635;0;0;0;0;.00nan;0;0
200;20122;646;57;18;2;16;.889;3600000;0
200;-1;635;74;37;3;34;.919;3579000;0
200;-1;646;0;0;0;0;.00nan;0;0
276;-1;632;0;0;0;0;.00nan;0;0
276;18965;632;57;24;3;21;.875;3600000;0
276;20122;646;35;24;5;19;.792;3600000;0
276;-1;646;0;0;0;0;.00nan;0;0
277;168926;638;99;31;1;30;.968;3600000;0
277;180053;1836;0;0;0;0;.00nan;0;0
277;-1;1836;83;39;2;37;.949;3599000;0
277;55209;638;0;0;0;0;.00nan;0;0
278;11104;633;0;0;0;0;.00nan;0;0
278;190508;4538;58;34;4;30;.882;3586000;0
278;-1;633;73;27;2;25;.926;3600000;0
278;145038;4538;0;0;0;0;.00nan;0;0
279;1838;644;0;0;0;0;.00nan;0;0
279;61683;644;73;28;3;25;.893;3558000;0
279;156632;626;80;31;2;29;.935;3600000;0
279;160907;626;0;0;0;0;.00nan;0;0
280;-1;632;0;0;0;0;.00nan;0;0
280;18965;632;73;20;1;19;.950;3600000;0
280;20122;646;51;35;5;30;.857;3600000;0
280;-1;646;0;0;0;0;.00nan;0;0
281;168926;638;47;18;4;14;.778;3828000;0
281;180053;1836;0;0;0;0;.00nan;0;0
281;-1;1836;61;28;3;25;.893;3828000;0
281;55209;638;0;0;0;0;.00nan;0;0
282;11104;633;0;0;0;0;.00nan;0;0
282;190508;4538;54;57;7;50;.877;3600000;0
282;-1;633;65;22;2;20;.909;3600000;0
282;145038;4538;0;0;0;0;.00nan;0;0
283;1838;644;0;0;0;0;.00nan;0;0
283;61683;644;72;29;3;26;.897;3893000;0
283;156632;626;80;32;2;30;.938;3893000;0
283;160907;626;0;0;0;0;.00nan;0;0
284;-1;632;0;0;0;0;.00nan;0;0
284;18965;632;61;29;3;26;.897;3600000;0
284;20122;646;73;39;4;35;.897;3550000;0
284;-1;646;0;0;0;0;.00nan;0;0
285;168926;638;82;33;2;31;.939;4031000;0
285;180053;1836;0;0;0;0;.00nan;0;0
285;-1;1836;83;29;1;28;.966;4031000;0
285;55209;638;0;0;0;0;.00nan;0;0
286;11104;633;0;0;0;0;.00nan;0;0
286;190508;4538;42;44;7;37;.841;3600000;0
286;-1;633;60;34;4;30;.882;3600000;0
286;145038;4538;0;0;0;0;.00nan;0;0
287;1838;644;0;0;0;0;.00nan;0;0
287;61683;644;86;34;2;32;.941;3600000;0
287;156632;626;69;32;3;29;.906;3546000;0
287;160907;626;0;0;0;0;.00nan;0;0
288;-1;632;0;0;0;0;.00nan;0;0
288;18965;632;66;26;3;23;.885;4200000;0
288;20122;646;92;44;3;41;.932;4200000;0
288;-1;646;0;0;0;0;.00nan;0;0
289;168926;638;99;39;1;38;.974;3600000;0
289;180053;1836;0;0;0;0;.00nan;0;0
289;-1;1836;50;24;3;21;.875;3536000;0
289;55209;638;0;0;0;0;.00nan;0;0
290;11104;633;0;0;0;0;.00nan;0;0
290;190508;4538;78;31;2;29;.935;3600000;0
290;-1;633;60;32;4;28;.875;3600000;0
290;145038;4538;0;0;0;0;.00nan;0;0
291;1838;644;0;0;0;0;.00nan;0;0
291;61683;644;61;28;2;26;.929;4200000;0
291;156632;626;67;23;2;21;.913;4200000;0
291;160907;626;0;0;0;0;.00nan;0;0
597;168926;638;90;36;2;34;.944;3600000;0
597;180053;1836;0;0;0;0;.00nan;0;0
597;-1;1836;51;30;4;26;.867;3531000;0
597;55209;638;0;0;0;0;.00nan;0;0
598;11104;633;0;0;0;0;.00nan;0;0
598;190508;4538;82;39;3;36;.923;3549000;0
598;-1;633;64;25;2;23;.920;3600000;0
598;145038;4538;0;0;0;0;.00nan;0;0
599;1838;644;0;0;0;0;.00nan;0;0
599;61683;644;79;30;2;28;.933;3600000;0
599;156632;626;22;11;4;7;.636;1076000;0
599;160907;626;42;19;4;15;.789;2524000;0
655;168926;638;78;36;3;33;.917;3600000;0
655;180053;1836;0;0;0;0;.00nan;0;0
655;-1;1836;41;37;6;31;.838;3600000;0
655;55209;638;0;0;0;0;.00nan;0;0
656;1838;644;0;0;0;0;.00nan;0;0
656;61683;644;66;22;2;20;.909;3600000;0
656;156632;626;44;32;5;27;.844;3600000;0
656;160907;626;0;0;0;0;.00nan;0;0
683;1838;644;0;0;0;0;.00nan;0;0
683;61683;644;50;38;5;33;.868;3581000;0
683;156632;626;72;32;3;29;.906;3600000;0
683;160907;626;0;0;0;0;.00nan;0;0
710;-1;632;0;0;0;0;.00nan;0;0
710;18965;632;75;16;1;15;.938;3600000;0
710;156632;626;47;34;6;28;.824;2722000;0
710;160907;626;46;13;2;11;.846;878000;0
711;11104;633;0;0;0;0;.00nan;0;0
711;168926;638;26;31;6;25;.806;2917000;0
711;-1;633;58;31;4;27;.871;3600000;0
711;55209;638;53;5;0;5;1.000;637000;0
712;-1;632;0;0;0;0;.00nan;0;0
712;18965;632;87;17;0;17;1.000;3600000;0
712;156632;626;72;48;5;43;.896;3600000;0
712;160907;626;0;0;0;0;.00nan;0;0
713;11104;633;0;0;0;0;.00nan;0;0
713;168926;638;74;22;1;21;.955;3600000;0
713;-1;633;82;35;2;33;.943;3549000;0
713;55209;638;0;0;0;0;.00nan;0;0
714;-1;632;0;0;0;0;.00nan;0;0
714;18965;632;61;18;2;16;.889;3600000;0
714;156632;626;72;33;3;30;.909;3600000;0
714;160907;626;0;0;0;0;.00nan;0;0
715;11104;633;0;0;0;0;.00nan;0;0
715;168926;638;28;7;3;4;.571;311000;0
715;-1;633;52;11;1;10;.909;3600000;0
715;55209;638;59;24;3;21;.875;3289000;0
716;-1;632;0;0;0;0;.00nan;0;0
716;18965;632;70;12;1;11;.917;3600000;0
716;156632;626;14;6;4;2;.333;579000;0
716;160907;626;98;44;1;43;.977;3021000;0
717;11104;633;0;0;0;0;.00nan;0;0
717;168926;638;60;28;3;25;.893;3600000;0
717;-1;633;54;35;4;31;.886;3563000;0
717;55209;638;0;0;0;0;.00nan;0;0
975;11104;633;0;0;0;0;.00nan;0;0
975;168926;638;74;34;3;31;.912;3588000;0
975;-1;633;76;22;1;21;.955;3600000;0
975;55209;638;0;0;0;0;.00nan;0;0
1003;11104;633;0;0;0;0;.00nan;0;0
1003;168926;638;56;29;3;26;.897;3844000;0
1003;-1;633;70;32;2;30;.938;3844000;0
1003;55209;638;0;0;0;0;.00nan;0;0
1047;11104;633;0;0;0;0;.00nan;0;0
1047;-1;632;0;0;0;0;.00nan;0;0
1047;18965;632;84;21;1;20;.952;3600000;0
1047;-1;633;72;31;3;28;.903;3532000;0
1048;11104;633;0;0;0;0;.00nan;0;0
1048;-1;632;0;0;0;0;.00nan;0;0
1048;18965;632;70;20;1;19;.950;3600000;0
1048;-1;633;85;56;5;51;.911;3600000;0
1049;11104;633;0;0;0;0;.00nan;0;0
1049;-1;632;0;0;0;0;.00nan;0;0
1049;18965;632;53;22;3;19;.864;3600000;0
1049;-1;633;78;45;4;41;.911;3584000;0
1050;11104;633;0;0;0;0;.00nan;0;0
1050;-1;632;0;0;0;0;.00nan;0;0
1050;18965;632;42;34;5;29;.853;3879000;0
1050;-1;633;49;26;4;22;.846;3879000;0
1211;11104;633;0;0;0;0;.00nan;0;0
1211;-1;632;0;0;0;0;.00nan;0;0
1211;18965;632;85;25;1;24;.960;3600000;0
1211;-1;633;46;19;3;16;.842;3579000;0
17584;34325;844;52;28;4;24;.857;3900000;0
17584;47728;2517;0;0;0;0;.00nan;0;0
17584;47736;2517;82;47;4;43;.915;3900000;0
17584;54885;844;0;0;0;0;.00nan;0;0
17585;31439;835;0;0;0;0;.00nan;0;0
17585;47742;845;54;28;4;24;.857;3561000;0
17585;78920;835;76;35;2;33;.943;3600000;0
17585;154162;845;0;0;0;0;.00nan;0;0
17586;5565;843;0;0;0;0;.00nan;0;0
17586;30696;2508;0;0;0;0;.00nan;0;0
17586;47982;2508;78;32;2;30;.938;3600000;0
17586;89874;843;53;24;4;20;.833;3572000;0
17587;5573;2488;74;17;1;16;.941;1218000;0
17587;-1;846;95;21;0;21;1.000;3600000;0
17587;47769;2488;45;39;6;33;.846;2382000;0
17587;47864;846;0;0;0;0;.00nan;0;0
17588;13715;841;0;0;0;0;.00nan;0;0
17588;16588;2493;0;0;0;0;.00nan;0;0
17588;47754;841;91;32;1;31;.969;3600000;0
17588;62975;2493;24;35;7;28;.800;3600000;0
17589;30696;2508;59;38;4;34;.895;3600000;0
17589;34325;844;45;33;5;28;.848;3600000;0
17589;47982;2508;0;0;0;0;.00nan;0;0
17589;54885;844;0;0;0;0;.00nan;0;0
17590;5565;843;79;37;3;34;.919;3600000;0
17590;31439;835;0;0;0;0;.00nan;0;0
17590;78920;835;81;23;1;22;.957;3600000;0
17590;89874;843;0;0;0;0;.00nan;0;0
17591;13715;841;0;0;0;0;.00nan;0;0
17591;47728;2517;0;0;0;0;.00nan;0;0
17591;47736;2517;58;25;3;22;.880;3600000;0
17591;47754;841;100;34;0;34;1.000;3600000;0
17592;16588;2493;0;0;0;0;.00nan;0;0
17592;47791;846;0;0;0;0;.00nan;0;0
17592;47864;846;61;32;4;28;.875;3600000;0
17592;62975;2493;51;30;5;25;.833;3600000;0
17593;5573;2488;49;37;5;32;.865;3570000;0
17593;47742;845;0;0;0;0;.00nan;0;0
17593;47769;2488;0;0;0;0;.00nan;0;0
17593;154162;845;65;32;3;29;.906;3600000;0
17594;16588;2493;93;38;1;37;.974;3576000;0
17594;31439;835;100;29;0;29;1.000;3600000;0
17594;62975;2493;0;0;0;0;.00nan;0;0
17594;78920;835;0;0;0;0;.00nan;0;0
17595;5573;2488;58;25;3;22;.880;3594000;0
17595;30696;2508;87;39;2;37;.949;3600000;0
17595;47769;2488;0;0;0;0;.00nan;0;0
17595;47982;2508;0;0;0;0;.00nan;0;0
17596;5565;843;66;40;4;36;.900;3584000;0
17596;47742;845;0;0;0;0;.00nan;0;0
17596;89874;843;0;0;0;0;.00nan;0;0
17596;154162;845;68;20;2;18;.900;3600000;0
17597;13715;841;0;0;0;0;.00nan;0;0
17597;34325;844;66;19;2;17;.895;3900000;0
17597;47754;841;95;45;2;43;.956;3900000;0
17597;54885;844;0;0;0;0;.00nan;0;0
17598;47728;2517;0;0;0;0;.00nan;0;0
17598;47736;2517;90;51;3;48;.941;3584000;0
17598;47791;846;91;34;2;32;.941;3600000;0
17598;47864;846;0;0;0;0;.00nan;0;0
17599;30696;2508;49;27;3;24;.889;3592000;0
17599;47728;2517;0;0;0;0;.00nan;0;0
17599;47736;2517;95;37;2;35;.946;3600000;0
17599;47982;2508;0;0;0;0;.00nan;0;0
17600;31439;835;0;0;0;0;.00nan;0;0
17600;47791;846;81;24;1;23;.958;3600000;0
17600;47864;846;0;0;0;0;.00nan;0;0
17600;78920;835;83;49;4;45;.918;3600000;0
17601;13715;841;0;0;0;0;.00nan;0;0
17601;47742;845;0;0;0;0;.00nan;0;0
17601;47754;841;67;37;4;33;.892;3600000;0
17601;154162;845;89;34;1;33;.971;3600000;0
17602;5565;843;26;31;6;25;.806;3600000;0
17602;5573;2488;85;26;1;25;.962;3600000;0
17602;47769;2488;0;0;0;0;.00nan;0;0
17602;89874;843;0;0;0;0;.00nan;0;0
17603;16588;2493;0;0;0;0;.00nan;0;0
17603;34325;844;66;34;3;31;.912;3805000;0
17603;54885;844;0;0;0;0;.00nan;0;0
17603;62975;2493;54;33;4;29;.879;3805000;0
17604;31439;835;0;0;0;0;.00nan;0;0
17604;47728;2517;0;0;0;0;.00nan;0;0
17604;47736;2517;77;30;3;27;.900;3600000;0
17604;78920;835;68;31;4;27;.871;3600000;0
17605;34325;844;88;38;2;36;.947;3600000;0
17605;47742;845;0;0;0;0;.00nan;0;0
17605;54885;844;0;0;0;0;.00nan;0;0
17605;154162;845;56;25;3;22;.880;3598000;0
17606;30696;2508;54;4;0;4;1.000;305000;0
17606;47791;846;90;39;2;37;.949;3600000;0
17606;47864;846;0;0;0;0;.00nan;0;0
17606;47982;2508;60;48;6;42;.875;3295000;0
17607;5573;2488;66;30;3;27;.900;3600000;0
17607;13715;841;0;0;0;0;.00nan;0;0
17607;47754;841;100;35;0;35;1.000;3600000;0
17607;47769;2488;0;0;0;0;.00nan;0;0
17608;5565;843;73;35;3;32;.914;3900000;0
17608;16588;2493;83;37;3;34;.919;3900000;0
17608;62975;2493;0;0;0;0;.00nan;0;0
17608;89874;843;0;0;0;0;.00nan;0;0
17609;5573;2488;100;35;1;34;.971;3600000;0
17609;31439;835;0;0;0;0;.00nan;0;0
17609;47769;2488;0;0;0;0;.00nan;0;0
17609;78920;835;70;30;3;27;.900;3573000;0
17610;5565;843;69;32;3;29;.906;3600000;0
17610;47728;2517;0;0;0;0;.00nan;0;0
17610;47736;2517;100;26;0;26;1.000;3600000;0
17610;89874;843;0;0;0;0;.00nan;0;0
17611;13715;841;0;0;0;0;.00nan;0;0
17611;30696;2508;75;29;2;27;.931;3600000;0
17611;47754;841;57;41;5;36;.878;3600000;0
17611;47982;2508;0;0;0;0;.00nan;0;0
17612;34325;844;0;0;0;0;.00nan;0;0
17612;47791;846;0;0;0;0;.00nan;0;0
17612;47864;846;100;22;0;22;1.000;3600000;0
17612;54885;844;77;40;3;37;.925;3600000;0
17613;5565;843;75;33;2;31;.939;3537000;0
17613;34325;844;100;38;0;38;1.000;3600000;0
17613;54885;844;0;0;0;0;.00nan;0;0
17613;89874;843;0;0;0;0;.00nan;0;0
17614;47728;2517;0;0;0;0;.00nan;0;0
17614;47736;2517;56;44;6;38;.864;3600000;0
17614;47742;845;61;24;2;22;.917;3600000;0
17614;154162;845;0;0;0;0;.00nan;0;0
17615;30696;2508;100;41;0;41;1.000;3600000;0
17615;31439;835;37;22;4;18;.818;3600000;0
17615;47982;2508;0;0;0;0;.00nan;0;0
17615;78920;835;0;0;0;0;.00nan;0;0
17616;13715;841;98;41;1;40;.976;3600000;0
17616;47754;841;0;0;0;0;.00nan;0;0
17616;47791;846;55;20;3;17;.850;3544000;0
17616;47864;846;0;0;0;0;.00nan;0;0
17617;5573;2488;75;24;2;22;.917;3600000;0
17617;16588;2493;0;0;0;0;.00nan;0;0
17617;47769;2488;0;0;0;0;.00nan;0;0
17617;62975;2493;56;32;4;28;.875;3563000;0
17618;13715;841;0;0;0;0;.00nan;0;0
17618;31439;835;0;0;0;0;.00nan;0;0
17618;47754;841;89;29;1;28;.966;3600000;0
17618;78920;835;66;25;2;23;.920;3600000;0
17619;30696;2508;58;59;7;52;.881;3600000;0
17619;47742;845;44;24;4;20;.833;3600000;0
17619;47982;2508;0;0;0;0;.00nan;0;0
17619;154162;845;0;0;0;0;.00nan;0;0
17620;5573;2488;64;34;3;31;.912;3600000;0
17620;34325;844;92;22;0;22;1.000;3600000;0
17620;47769;2488;0;0;0;0;.00nan;0;0
17620;54885;844;0;0;0;0;.00nan;0;0
17621;16588;2493;80;23;2;21;.913;3600000;0
17621;47728;2517;0;0;0;0;.00nan;0;0
17621;47736;2517;79;42;4;38;.905;3600000;0
17621;62975;2493;0;0;0;0;.00nan;0;0
17622;31439;835;34;42;7;35;.833;3600000;0
17622;34325;844;100;29;0;29;1.000;3600000;0
17622;54885;844;0;0;0;0;.00nan;0;0
17622;78920;835;0;0;0;0;.00nan;0;0
17623;16588;2493;49;4;1;3;.750;520000;0
17623;30696;2508;24;5;3;2;.400;511000;0
17623;47982;2508;72;37;3;34;.919;3153000;0
17623;62975;2493;37;32;6;26;.813;3144000;0
17624;5565;843;65;44;5;39;.886;3600000;0
17624;13715;841;0;0;0;0;.00nan;0;0
17624;47754;841;74;22;1;21;.955;3600000;0
17624;89874;843;0;0;0;0;.00nan;0;0
17625;47742;845;0;0;0;0;.00nan;0;0
17625;47791;846;0;0;0;0;.00nan;0;0
17625;47864;846;93;17;0;17;1.000;3600000;0
17625;154162;845;71;36;3;33;.917;3600000;0
17626;32404;2517;73;29;3;26;.897;3577000;0
17626;34325;844;66;22;2;20;.909;3600000;0
17626;47736;2517;0;0;0;0;.00nan;0;0
17626;54885;844;0;0;0;0;.00nan;0;0
17627;5565;843;83;34;2;32;.941;3600000;0
17627;30696;2508;66;29;3;26;.897;3572000;0
17627;47982;2508;0;0;0;0;.00nan;0;0
17627;89874;843;0;0;0;0;.00nan;0;0
17628;13715;841;0;0;0;0;.00nan;0;0
17628;16588;2493;0;0;0;0;.00nan;0;0
17628;47754;841;46;28;4;24;.857;3552000;0
17628;62975;2493;90;38;3;35;.921;3600000;0
17629;5573;2488;62;27;3;24;.889;3600000;0
17629;47769;2488;0;0;0;0;.00nan;0;0
17629;47791;846;42;23;4;19;.826;3600000;0
17629;47864;846;0;0;0;0;.00nan;0;0
17630;31439;835;0;0;0;0;.00nan;0;0
17630;47742;845;0;0;0;0;.00nan;0;0
17630;78920;835;86;37;2;35;.946;3600000;0
17630;154162;845;52;33;5;28;.848;3600000;0
17631;5573;2488;39;22;4;18;.818;3600000;0
17631;32404;2517;86;35;1;34;.971;3600000;0
17631;47736;2517;0;0;0;0;.00nan;0;0
17631;47769;2488;0;0;0;0;.00nan;0;0
17632;5565;843;99;45;1;44;.978;3600000;0
17632;31439;835;0;0;0;0;.00nan;0;0
17632;78920;835;63;29;4;25;.862;3600000;0
17632;89874;843;0;0;0;0;.00nan;0;0
17633;30696;2508;50;41;6;35;.854;3600000;0
17633;34325;844;69;19;1;18;.947;3600000;0
17633;47982;2508;0;0;0;0;.00nan;0;0
17633;54885;844;0;0;0;0;.00nan;0;0
17634;5573;2488;50;35;5;30;.857;3559000;0
17634;47742;845;0;0;0;0;.00nan;0;0
17634;47769;2488;0;0;0;0;.00nan;0;0
17634;154162;845;58;24;3;21;.875;3600000;0
17635;16588;2493;74;44;4;40;.909;3600000;0
17635;47791;846;0;0;0;0;.00nan;0;0
17635;47864;846;69;16;1;15;.938;3600000;0
17635;62975;2493;0;0;0;0;.00nan;0;0
17636;13715;841;0;0;0;0;.00nan;0;0
17636;32404;2517;86;35;3;32;.914;3576000;0
17636;47736;2517;0;0;0;0;.00nan;0;0
17636;47754;841;74;23;1;22;.957;3600000;0
17637;32404;2517;35;16;4;12;.750;953000;0
17637;47736;2517;74;26;1;25;.962;2647000;0
17637;47791;846;100;26;0;26;1.000;3600000;0
17637;47864;846;0;0;0;0;.00nan;0;0
17638;5565;843;100;40;0;40;1.000;3600000;0
17638;47742;845;69;19;1;18;.947;3553000;0
17638;89874;843;0;0;0;0;.00nan;0;0
17638;154162;845;0;0;0;0;.00nan;0;0
17639;5573;2488;83;19;0;19;1.000;3600000;0
17639;30696;2508;91;47;3;44;.936;3600000;0
17639;47769;2488;0;0;0;0;.00nan;0;0
17639;47982;2508;0;0;0;0;.00nan;0;0
17640;16588;2493;0;0;0;0;.00nan;0;0
17640;31439;835;0;0;0;0;.00nan;0;0
17640;62975;2493;93;48;3;45;.938;3900000;0
17640;78920;835;57;27;3;24;.889;3900000;0
17641;31439;835;0;0;0;0;.00nan;0;0
17641;32404;2517;65;45;5;40;.889;3600000;0
17641;47736;2517;0;0;0;0;.00nan;0;0
17641;78920;835;98;26;0;26;1.000;3600000;0
17642;5565;843;79;35;3;32;.914;3540000;0
17642;16588;2493;0;0;0;0;.00nan;0;0
17642;62975;2493;93;40;1;39;.975;3600000;0
17642;89874;843;0;0;0;0;.00nan;0;0
17643;5573;2488;68;22;1;21;.955;3600000;0
17643;13715;841;54;35;4;31;.886;3075000;0
17643;47754;841;27;8;3;5;.625;525000;0
17643;47769;2488;0;0;0;0;.00nan;0;0
17644;30696;2508;60;39;5;34;.872;3547000;0
17644;47791;846;59;26;3;23;.885;3600000;0
17644;47864;846;0;0;0;0;.00nan;0;0
17644;47982;2508;0;0;0;0;.00nan;0;0
17645;34325;844;45;23;4;19;.826;3575000;0
17645;47742;845;0;0;0;0;.00nan;0;0
17645;54885;844;0;0;0;0;.00nan;0;0
17645;154162;845;92;37;2;35;.946;3600000;0
17646;5565;843;60;30;4;26;.867;3891000;0
17646;32404;2517;48;22;3;19;.864;3891000;0
17646;47736;2517;0;0;0;0;.00nan;0;0
17646;89874;843;0;0;0;0;.00nan;0;0
17647;13715;841;0;0;0;0;.00nan;0;0
17647;30696;2508;53;32;4;28;.875;3600000;0
17647;47754;841;93;46;3;43;.935;3600000;0
17647;47982;2508;0;0;0;0;.00nan;0;0
17648;5573;2488;0;0;0;0;.00nan;0;0
17648;31439;835;0;0;0;0;.00nan;0;0
17648;47769;2488;63;32;3;29;.906;3600000;0
17648;78920;835;58;31;4;27;.871;3561000;0
17649;16588;2493;38;43;7;36;.837;2756000;0
17649;47742;845;57;17;2;15;.882;3600000;0
17649;62975;2493;28;9;3;6;.667;844000;0
17649;154162;845;0;0;0;0;.00nan;0;0
17650;30696;2508;57;32;4;28;.875;3600000;0
17650;31439;835;40;2;1;1;.500;350000;0
17650;47982;2508;0;0;0;0;.00nan;0;0
17650;78920;835;33;34;6;28;.824;3250000;0
17651;5565;843;99;51;2;49;.961;3600000;0
17651;34325;844;43;22;4;18;.818;3578000;0
17651;54885;844;0;0;0;0;.00nan;0;0
17651;89874;843;0;0;0;0;.00nan;0;0
17652;13715;841;0;0;0;0;.00nan;0;0
17652;47754;841;43;38;6;32;.842;3600000;0
17652;47791;846;0;0;0;0;.00nan;0;0
17652;47864;846;69;22;2;20;.909;3600000;0
17653;32404;2517;98;43;2;41;.953;3586000;0
17653;47736;2517;0;0;0;0;.00nan;0;0
17653;47742;845;0;0;0;0;.00nan;0;0
17653;154162;845;90;33;1;32;.970;3600000;0
17654;5573;2488;61;28;4;24;.857;3547000;0
17654;16588;2493;0;0;0;0;.00nan;0;0
17654;47769;2488;0;0;0;0;.00nan;0;0
17654;62975;2493;74;24;2;22;.917;3600000;0
17655;16588;2493;0;0;0;0;.00nan;0;0
17655;32404;2517;80;26;1;25;.962;3600000;0
17655;47736;2517;0;0;0;0;.00nan;0;0
17655;62975;2493;62;24;3;21;.875;3562000;0
17656;30696;2508;0;0;0;0;.00nan;0;0
17656;47742;845;0;0;0;0;.00nan;0;0
17656;47982;2508;100;54;2;52;.963;3600000;0
17656;154162;845;53;25;3;22;.880;3553000;0
17657;13715;841;0;0;0;0;.00nan;0;0
17657;31439;835;0;0;0;0;.00nan;0;0
17657;47754;841;51;29;4;25;.862;3600000;0
17657;78920;835;61;25;3;22;.880;3600000;0
17658;5565;843;76;55;5;50;.909;3513000;0
17658;47791;846;62;24;3;21;.875;3600000;0
17658;47864;846;0;0;0;0;.00nan;0;0
17658;89874;843;0;0;0;0;.00nan;0;0
17659;5573;2488;83;31;2;29;.935;3900000;0
17659;34325;844;80;34;2;32;.941;3893000;0
17659;47769;2488;0;0;0;0;.00nan;0;0
17659;54885;844;0;0;0;0;.00nan;0;0
17660;31439;835;0;0;0;0;.00nan;0;0
17660;34325;844;89;29;1;28;.966;3900000;0
17660;54885;844;0;0;0;0;.00nan;0;0
17660;78920;835;87;36;1;35;.972;3900000;0
17661;5565;843;79;33;2;31;.939;3761000;0
17661;13715;841;0;0;0;0;.00nan;0;0
17661;47754;841;66;31;3;28;.903;3761000;0
17661;89874;843;0;0;0;0;.00nan;0;0
17662;47742;845;36;30;5;25;.833;3600000;0
17662;47791;846;99;43;1;42;.977;3600000;0
17662;47864;846;0;0;0;0;.00nan;0;0
17662;154162;845;0;0;0;0;.00nan;0;0
17663;5573;2488;83;34;2;32;.941;3546000;0
17663;32404;2517;99;32;1;31;.969;3600000;0
17663;47736;2517;0;0;0;0;.00nan;0;0
17663;47769;2488;0;0;0;0;.00nan;0;0
17664;16588;2493;61;40;4;36;.900;3900000;0
17664;30696;2508;59;30;4;26;.867;3900000;0
17664;47982;2508;0;0;0;0;.00nan;0;0
17664;62975;2493;0;0;0;0;.00nan;0;0
17665;16588;2493;0;0;0;0;.00nan;0;0
17665;34325;844;45;20;4;16;.800;3835000;0
17665;54885;844;0;0;0;0;.00nan;0;0
17665;62975;2493;85;44;3;41;.932;3835000;0
17666;30696;2508;74;28;1;27;.964;3600000;0
17666;32404;2517;63;35;4;31;.886;3600000;0
17666;47736;2517;0;0;0;0;.00nan;0;0
17666;47982;2508;0;0;0;0;.00nan;0;0
17667;5565;843;54;34;5;29;.853;3600000;0
17667;5573;2488;100;43;1;42;.977;3600000;0
17667;47769;2488;0;0;0;0;.00nan;0;0
17667;89874;843;0;0;0;0;.00nan;0;0
17668;13715;841;99;58;4;54;.931;3600000;0
17668;47742;845;0;0;0;0;.00nan;0;0
17668;47754;841;0;0;0;0;.00nan;0;0
17668;154162;845;26;25;6;19;.760;3522000;0
17669;31439;835;0;0;0;0;.00nan;0;0
17669;47791;846;0;0;0;0;.00nan;0;0
17669;47864;846;94;25;0;25;1.000;3600000;0
17669;78920;835;80;43;2;41;.953;3587000;0
17670;16588;2493;0;0;0;0;.00nan;0;0
17670;32404;2517;0;0;0;0;.00nan;0;0
17670;47736;2517;56;22;3;19;.864;3600000;0
17670;62975;2493;49;27;4;23;.852;3600000;0
17671;5565;843;47;34;5;29;.853;3600000;0
17671;32404;2517;96;36;2;34;.944;3600000;0
17671;47736;2517;0;0;0;0;.00nan;0;0
17671;89874;843;0;0;0;0;.00nan;0;0
17672;5573;2488;46;38;6;32;.842;3597000;0
17672;31439;835;0;0;0;0;.00nan;0;0
17672;47769;2488;0;0;0;0;.00nan;0;0
17672;78920;835;46;29;5;24;.828;3600000;0
17673;30696;2508;39;6;2;4;.667;398000;0
17673;34325;844;62;22;2;20;.909;3600000;0
17673;47982;2508;32;34;6;28;.824;3202000;0
17673;54885;844;0;0;0;0;.00nan;0;0
17674;13715;841;0;0;0;0;.00nan;0;0
17674;47754;841;95;61;5;56;.918;3900000;0
17674;47791;846;0;0;0;0;.00nan;0;0
17674;47864;846;38;32;5;27;.844;3900000;0
17675;16588;2493;62;14;1;13;.929;1265000;0
17675;47742;845;0;0;0;0;.00nan;0;0
17675;62975;2493;38;33;6;27;.818;2335000;0
17675;154162;845;69;21;1;20;.952;3600000;0
17676;13715;841;0;0;0;0;.00nan;0;0
17676;34325;844;85;19;0;19;1.000;3600000;0
17676;47754;841;84;35;2;33;.943;3564000;0
17676;54885;844;0;0;0;0;.00nan;0;0
17677;5565;843;0;0;0;0;.00nan;0;0
17677;31439;835;0;0;0;0;.00nan;0;0
17677;78920;835;71;23;2;21;.913;3600000;0
17677;89874;843;90;41;3;38;.927;3600000;0
17678;30696;2508;92;46;3;43;.935;3600000;0
17678;47791;846;100;44;0;44;1.000;3600000;0
17678;47864;846;0;0;0;0;.00nan;0;0
17678;47982;2508;0;0;0;0;.00nan;0;0
17679;5573;2488;28;8;3;5;.625;338000;0
17679;47742;845;0;0;0;0;.00nan;0;0
17679;47769;2488;65;44;4;40;.909;3562000;0
17679;154162;845;36;33;7;26;.788;3900000;0
17680;13715;841;0;0;0;0;.00nan;0;0
17680;16588;2493;0;0;0;0;.00nan;0;0
17680;47754;841;57;32;5;27;.844;3600000;0
17680;62975;2493;84;31;1;30;.968;3600000;0
17681;34325;844;100;27;0;27;1.000;3600000;0
17681;47791;846;66;22;2;20;.909;3530000;0
17681;47864;846;0;0;0;0;.00nan;0;0
17681;54885;844;0;0;0;0;.00nan;0;0
17682;30696;2508;65;31;3;28;.903;3900000;0
17682;31439;835;0;0;0;0;.00nan;0;0
17682;47982;2508;0;0;0;0;.00nan;0;0
17682;78920;835;73;33;3;30;.909;3900000;0
17683;5573;2488;96;36;1;35;.972;3600000;0
17683;13715;841;0;0;0;0;.00nan;0;0
17683;47754;841;37;19;4;15;.789;3600000;0
17683;47769;2488;0;0;0;0;.00nan;0;0
17684;32404;2517;82;35;2;33;.943;3574000;0
17684;47736;2517;0;0;0;0;.00nan;0;0
17684;47742;845;83;24;1;23;.958;3600000;0
17684;154162;845;0;0;0;0;.00nan;0;0
17685;5565;843;65;32;3;29;.906;3600000;0
17685;16588;2493;0;0;0;0;.00nan;0;0
17685;62975;2493;100;27;0;27;1.000;3600000;0
17685;89874;843;0;0;0;0;.00nan;0;0
17686;5573;2488;28;29;6;23;.793;2972000;0
17686;34325;844;88;39;3;36;.923;3600000;0
17686;47769;2488;50;4;1;3;.750;628000;0
17686;54885;844;0;0;0;0;.00nan;0;0
17687;30696;2508;80;27;1;26;.963;3600000;0
17687;32404;2517;65;29;3;26;.897;3579000;0
17687;47736;2517;0;0;0;0;.00nan;0;0
17687;47982;2508;0;0;0;0;.00nan;0;0
17688;31439;835;79;38;3;35;.921;3600000;0
17688;47742;845;61;34;4;30;.882;3600000;0
17688;78920;835;0;0;0;0;.00nan;0;0
17688;154162;845;0;0;0;0;.00nan;0;0
17689;5565;843;92;51;4;47;.922;3900000;0
17689;13715;841;0;0;0;0;.00nan;0;0
17689;47754;841;50;32;4;28;.875;3900000;0
17689;89874;843;0;0;0;0;.00nan;0;0
17690;16588;2493;0;0;0;0;.00nan;0;0
17690;47791;846;100;28;0;28;1.000;3600000;0
17690;47864;846;0;0;0;0;.00nan;0;0
17690;62975;2493;88;45;2;43;.956;3600000;0
17691;31439;835;0;0;0;0;.00nan;0;0
17691;34325;844;57;12;1;11;.917;3600000;0
17691;54885;844;0;0;0;0;.00nan;0;0
17691;78920;835;50;31;4;27;.871;3600000;0
17692;13715;841;0;0;0;0;.00nan;0;0
17692;30696;2508;0;0;0;0;.00nan;0;0
17692;47754;841;73;29;2;27;.931;3600000;0
17692;47982;2508;70;41;4;37;.902;3566000;0
17693;5565;843;67;43;5;38;.884;3899000;0
17693;47742;845;0;0;0;0;.00nan;0;0
17693;89874;843;0;0;0;0;.00nan;0;0
17693;154162;845;60;30;4;26;.867;3899000;0
17694;5573;2488;0;0;0;0;.00nan;0;0
17694;47769;2488;63;33;3;30;.909;3598000;0
17694;47791;846;73;25;2;23;.920;3600000;0
17694;47864;846;0;0;0;0;.00nan;0;0
17695;16588;2493;0;0;0;0;.00nan;0;0
17695;32404;2517;50;33;5;28;.848;3600000;0
17695;47736;2517;0;0;0;0;.00nan;0;0
17695;62975;2493;91;38;2;36;.947;3600000;0
17696;5565;843;31;8;3;5;.625;591000;0
17696;47791;846;0;0;0;0;.00nan;0;0
17696;47864;846;6;15;6;9;.600;3542000;0
17696;89874;843;100;41;2;39;.951;3009000;0
17697;16588;2493;0;0;0;0;.00nan;0;0
17697;34325;844;84;16;0;16;1.000;3600000;0
17697;54885;844;0;0;0;0;.00nan;0;0
17697;62975;2493;66;45;5;40;.889;3600000;0
17698;31439;835;0;0;0;0;.00nan;0;0
17698;32404;2517;0;0;0;0;.00nan;0;0
17698;47736;2517;53;28;4;24;.857;3596000;0
17698;78920;835;80;30;2;28;.933;3600000;0
17699;5573;2488;71;36;5;31;.861;3600000;0
17699;30696;2508;0;0;0;0;.00nan;0;0
17699;47769;2488;0;0;0;0;.00nan;0;0
17699;47982;2508;50;27;4;23;.852;3600000;0
17700;5565;843;72;40;4;36;.900;3575000;0
17700;47791;846;58;23;3;20;.870;3600000;0
17700;47864;846;0;0;0;0;.00nan;0;0
17700;89874;843;0;0;0;0;.00nan;0;0
17701;13715;841;37;7;2;5;.714;1451000;0
17701;47742;845;0;0;0;0;.00nan;0;0
17701;47754;841;45;25;4;21;.840;2149000;0
17701;154162;845;73;28;2;26;.929;3600000;0
17702;16588;2493;0;0;0;0;.00nan;0;0
17702;31439;835;0;0;0;0;.00nan;0;0
17702;62975;2493;82;39;3;36;.923;3600000;0
17702;78920;835;39;25;4;21;.840;3544000;0
17703;5565;843;0;0;0;0;.00nan;0;0
17703;30696;2508;96;40;2;38;.950;3900000;0
17703;47982;2508;0;0;0;0;.00nan;0;0
17703;89874;843;95;42;2;40;.952;3900000;0
17704;13715;841;0;0;0;0;.00nan;0;0
17704;34325;844;57;17;2;15;.882;3600000;0
17704;47754;841;54;35;5;30;.857;3600000;0
17704;54885;844;0;0;0;0;.00nan;0;0
17705;47742;845;0;0;0;0;.00nan;0;0
17705;47791;846;70;31;2;29;.935;3600000;0
17705;47864;846;0;0;0;0;.00nan;0;0
17705;154162;845;60;38;4;34;.895;3514000;0
17706;5573;2488;78;32;2;30;.938;3600000;0
17706;32404;2517;21;25;6;19;.760;2904000;0
17706;47736;2517;44;5;1;4;.800;696000;0
17706;47769;2488;0;0;0;0;.00nan;0;0
17707;31439;835;0;0;0;0;.00nan;0;0
17707;47791;846;82;24;2;22;.917;3600000;0
17707;47864;846;0;0;0;0;.00nan;0;0
17707;78920;835;72;30;3;27;.900;3600000;0
17708;5565;843;93;44;2;42;.955;3600000;0
17708;5573;2488;0;0;0;0;.00nan;0;0
17708;47769;2488;71;34;3;31;.912;3550000;0
17708;89874;843;0;0;0;0;.00nan;0;0
17709;34325;844;91;36;2;34;.944;3900000;0
17709;47742;845;63;24;2;22;.917;3900000;0
17709;54885;844;0;0;0;0;.00nan;0;0
17709;154162;845;0;0;0;0;.00nan;0;0
17710;16588;2493;58;29;3;26;.897;3543000;0
17710;30696;2508;0;0;0;0;.00nan;0;0
17710;47982;2508;75;27;2;25;.926;3600000;0
17710;62975;2493;0;0;0;0;.00nan;0;0
17711;13715;841;0;0;0;0;.00nan;0;0
17711;32404;2517;38;35;6;29;.829;3600000;0
17711;47736;2517;0;0;0;0;.00nan;0;0
17711;47754;841;94;24;0;24;1.000;3600000;0
17712;5565;843;68;31;3;28;.903;3600000;0
17712;34325;844;0;0;0;0;.00nan;0;0
17712;54885;844;58;31;4;27;.871;3547000;0
17712;89874;843;0;0;0;0;.00nan;0;0
17713;30696;2508;89;40;1;39;.975;3547000;0
17713;47742;845;88;22;0;22;1.000;3600000;0
17713;47982;2508;0;0;0;0;.00nan;0;0
17713;154162;845;0;0;0;0;.00nan;0;0
17714;13715;841;0;0;0;0;.00nan;0;0
17714;31439;835;67;14;0;14;1.000;539000;0
17714;47754;841;100;46;1;45;.978;3600000;0
17714;78920;835;16;20;6;14;.700;3061000;0
17715;32404;2517;29;41;8;33;.805;3600000;0
17715;47736;2517;0;0;0;0;.00nan;0;0
17715;47791;846;68;27;3;24;.889;3600000;0
17715;47864;846;0;0;0;0;.00nan;0;0
17716;5573;2488;80;24;1;23;.958;3600000;0
17716;16588;2493;0;0;0;0;.00nan;0;0
17716;47769;2488;0;0;0;0;.00nan;0;0
17716;62975;2493;55;26;4;22;.846;3600000;0
17717;5565;843;60;27;3;24;.889;3600000;0
17717;5573;2488;0;0;0;0;.00nan;0;0
17717;47769;2488;54;31;4;27;.871;3600000;0
17717;89874;843;0;0;0;0;.00nan;0;0
17718;32404;2517;0;0;0;0;.00nan;0;0
17718;47736;2517;67;30;2;28;.933;3600000;0
17718;47742;845;18;20;6;14;.700;3600000;0
17718;154162;845;0;0;0;0;.00nan;0;0
17719;13715;841;0;0;0;0;.00nan;0;0
17719;31439;835;0;0;0;0;.00nan;0;0
17719;47754;841;77;36;3;33;.917;3652000;0
17719;78920;835;84;36;2;34;.944;3652000;0
17720;30696;2508;0;0;0;0;.00nan;0;0
17720;34325;844;93;22;0;22;1.000;3600000;0
17720;47982;2508;68;46;5;41;.891;3600000;0
17720;54885;844;0;0;0;0;.00nan;0;0
17721;16588;2493;0;0;0;0;.00nan;0;0
17721;47791;846;59;26;4;22;.846;3600000;0
17721;47864;846;0;0;0;0;.00nan;0;0
17721;62975;2493;97;34;1;33;.971;3600000;0
17722;32404;2517;86;33;2;31;.939;3807000;0
17722;34325;844;78;22;1;21;.955;3807000;0
17722;47736;2517;0;0;0;0;.00nan;0;0
17722;54885;844;0;0;0;0;.00nan;0;0
17723;5565;843;99;31;1;30;.968;3600000;0
17723;16588;2493;0;0;0;0;.00nan;0;0
17723;62975;2493;81;34;2;32;.941;3600000;0
17723;89874;843;0;0;0;0;.00nan;0;0
17724;5573;2488;0;0;0;0;.00nan;0;0
17724;13715;841;96;32;1;31;.969;3900000;0
17724;47754;841;0;0;0;0;.00nan;0;0
17724;47769;2488;84;31;1;30;.968;3900000;0
17725;31439;835;0;0;0;0;.00nan;0;0
17725;47791;846;67;28;3;25;.893;3600000;0
17725;47864;846;0;0;0;0;.00nan;0;0
17725;78920;835;62;43;5;38;.884;3562000;0
17726;30696;2508;0;0;0;0;.00nan;0;0
17726;47742;845;0;0;0;0;.00nan;0;0
17726;47982;2508;99;36;1;35;.972;3900000;0
17726;154162;845;76;28;1;27;.964;3900000;0
17727;34325;844;73;38;4;34;.895;3874000;0
17727;47791;846;43;27;4;23;.852;3900000;0
17727;47864;846;0;0;0;0;.00nan;0;0
17727;54885;844;0;0;0;0;.00nan;0;0
17728;31439;835;0;0;0;0;.00nan;0;0
17728;47742;845;65;37;4;33;.892;3900000;0
17728;78920;835;79;42;4;38;.905;3900000;0
17728;154162;845;0;0;0;0;.00nan;0;0
17729;16588;2493;0;0;0;0;.00nan;0;0
17729;34325;844;100;43;1;42;.977;3600000;0
17729;54885;844;0;0;0;0;.00nan;0;0
17729;62975;2493;83;39;3;36;.923;3600000;0
17730;5573;2488;49;31;5;26;.839;3771000;0
17730;30696;2508;43;25;4;21;.840;3771000;0
17730;47769;2488;0;0;0;0;.00nan;0;0
17730;47982;2508;0;0;0;0;.00nan;0;0
17731;13715;841;0;0;0;0;.00nan;0;0
17731;32404;2517;83;31;2;29;.935;3599000;0
17731;47736;2517;0;0;0;0;.00nan;0;0
17731;47754;841;100;37;0;37;1.000;3600000;0
17732;5565;843;76;42;4;38;.905;3600000;0
17732;47791;846;66;16;1;15;.938;3600000;0
17732;47864;846;0;0;0;0;.00nan;0;0
17732;89874;843;0;0;0;0;.00nan;0;0
17733;32404;2517;0;0;0;0;.00nan;0;0
17733;47736;2517;79;37;4;33;.892;3600000;0
17733;47791;846;100;35;0;35;1.000;3600000;0
17733;47864;846;0;0;0;0;.00nan;0;0
17734;30696;2508;23;3;3;0;.000;438000;0
17734;31439;835;35;23;4;19;.826;2990000;0
17734;47982;2508;63;28;3;25;.893;3162000;0
17734;78920;835;20;8;4;4;.500;597000;0
17735;5565;843;0;0;0;0;.00nan;0;0
17735;47742;845;57;22;2;20;.909;3600000;0
17735;89874;843;59;33;3;30;.909;3600000;0
17735;154162;845;0;0;0;0;.00nan;0;0
17736;5573;2488;0;0;0;0;.00nan;0;0
17736;34325;844;81;28;1;27;.964;3900000;0
17736;47769;2488;84;25;1;24;.960;3900000;0
17736;54885;844;0;0;0;0;.00nan;0;0
17737;13715;841;0;0;0;0;.00nan;0;0
17737;16588;2493;0;0;0;0;.00nan;0;0
17737;47754;841;40;28;4;24;.857;3545000;0
17737;62975;2493;68;31;3;28;.903;3600000;0
17738;31439;835;0;0;0;0;.00nan;0;0
17738;34325;844;69;17;1;16;.941;3550000;0
17738;54885;844;0;0;0;0;.00nan;0;0
17738;78920;835;100;30;0;30;1.000;3600000;0
17739;30696;2508;0;0;0;0;.00nan;0;0
17739;32404;2517;59;21;3;18;.857;3747000;0
17739;47736;2517;0;0;0;0;.00nan;0;0
17739;47982;2508;74;31;2;29;.935;3747000;0
17740;5565;843;75;28;3;25;.893;3900000;0
17740;13715;841;0;0;0;0;.00nan;0;0
17740;47754;841;77;31;3;28;.903;3900000;0
17740;89874;843;0;0;0;0;.00nan;0;0
17741;5573;2488;80;50;5;45;.900;3550000;0
17741;47769;2488;0;0;0;0;.00nan;0;0
17741;47791;846;52;16;3;13;.813;3600000;0
17741;47864;846;0;0;0;0;.00nan;0;0
17742;16588;2493;0;0;0;0;.00nan;0;0
17742;47742;845;0;0;0;0;.00nan;0;0
17742;62975;2493;91;30;1;29;.967;3600000;0
17742;154162;845;58;28;3;25;.893;3557000;0
17743;34325;844;0;0;0;0;.00nan;0;0
17743;47791;846;82;25;1;24;.960;3600000;0
17743;47864;846;0;0;0;0;.00nan;0;0
17743;54885;844;45;33;5;28;.848;3600000;0
17744;5565;843;94;29;1;28;.966;3600000;0
17744;30696;2508;91;38;2;36;.947;3582000;0
17744;47982;2508;0;0;0;0;.00nan;0;0
17744;89874;843;0;0;0;0;.00nan;0;0
17745;13715;841;0;0;0;0;.00nan;0;0
17745;47742;845;65;41;4;37;.902;3600000;0
17745;47754;841;39;39;6;33;.846;3514000;0
17745;154162;845;0;0;0;0;.00nan;0;0
17746;5573;2488;0;0;0;0;.00nan;0;0
17746;32404;2517;63;30;3;27;.900;3600000;0
17746;47736;2517;0;0;0;0;.00nan;0;0
17746;47769;2488;55;37;4;33;.892;3576000;0
17747;16588;2493;0;0;0;0;.00nan;0;0
17747;31439;835;0;0;0;0;.00nan;0;0
17747;62975;2493;44;23;4;19;.826;3600000;0
17747;78920;835;88;23;1;22;.957;3600000;0
17748;5565;843;0;0;0;0;.00nan;0;0
17748;32404;2517;0;0;0;0;.00nan;0;0
17748;47736;2517;81;24;1;23;.958;3600000;0
17748;89874;843;61;35;4;31;.886;3600000;0
17749;5573;2488;0;0;0;0;.00nan;0;0
17749;31439;835;0;0;0;0;.00nan;0;0
17749;47769;2488;35;22;4;18;.818;3574000;0
17749;78920;835;74;38;3;35;.921;3600000;0
17750;16588;2493;0;0;0;0;.00nan;0;0
17750;30696;2508;0;0;0;0;.00nan;0;0
17750;47982;2508;72;29;3;26;.897;3600000;0
17750;62975;2493;71;40;4;36;.900;3558000;0
17751;13715;841;0;0;0;0;.00nan;0;0
17751;47754;841;83;45;3;42;.933;3587000;0
17751;47791;846;0;0;0;0;.00nan;0;0
17751;47864;846;89;32;1;31;.969;3600000;0
17752;34325;844;72;27;2;25;.926;3600000;0
17752;47742;845;0;0;0;0;.00nan;0;0
17752;54885;844;0;0;0;0;.00nan;0;0
17752;154162;845;100;35;0;35;1.000;3600000;0
17753;13715;841;0;0;0;0;.00nan;0;0
17753;34325;844;79;32;3;29;.906;3658000;0
17753;47754;841;94;45;2;43;.956;3658000;0
17753;54885;844;0;0;0;0;.00nan;0;0
17754;30696;2508;28;31;6;25;.806;2200000;0
17754;47791;846;82;27;2;25;.926;3600000;0
17754;47864;846;0;0;0;0;.00nan;0;0
17754;47982;2508;56;12;1;11;.917;1400000;0
17755;5573;2488;59;27;3;24;.889;3533000;0
17755;47742;845;0;0;0;0;.00nan;0;0
17755;47769;2488;0;0;0;0;.00nan;0;0
17755;154162;845;93;31;1;30;.968;3600000;0
17756;16588;2493;88;44;2;42;.955;3542000;0
17756;32404;2517;78;25;1;24;.960;3600000;0
17756;47736;2517;0;0;0;0;.00nan;0;0
17756;62975;2493;0;0;0;0;.00nan;0;0
17757;32404;2517;44;40;6;34;.850;3566000;0
17757;34325;844;59;27;5;22;.815;3600000;0
17757;47736;2517;0;0;0;0;.00nan;0;0
17757;54885;844;0;0;0;0;.00nan;0;0
17758;5565;843;74;34;3;31;.912;3537000;0
17758;31439;835;0;0;0;0;.00nan;0;0
17758;78920;835;66;20;1;19;.950;3600000;0
17758;89874;843;0;0;0;0;.00nan;0;0
17759;31439;835;0;0;0;0;.00nan;0;0
17759;32404;2517;46;20;3;17;.850;3600000;0
17759;47736;2517;0;0;0;0;.00nan;0;0
17759;78920;835;56;32;4;28;.875;3595000;0
17760;5565;843;67;33;4;29;.879;3661000;0
17760;34325;844;61;28;3;25;.893;3661000;0
17760;54885;844;0;0;0;0;.00nan;0;0
17760;89874;843;0;0;0;0;.00nan;0;0
17761;13715;841;0;0;0;0;.00nan;0;0
17761;30696;2508;0;0;0;0;.00nan;0;0
17761;47754;841;82;29;1;28;.966;3600000;0
17761;47982;2508;75;34;2;32;.941;3549000;0
17762;47742;845;0;0;0;0;.00nan;0;0
17762;47791;846;71;26;2;24;.923;3600000;0
17762;47864;846;0;0;0;0;.00nan;0;0
17762;154162;845;47;31;5;26;.839;3600000;0
17763;5573;2488;0;0;0;0;.00nan;0;0
17763;16588;2493;0;0;0;0;.00nan;0;0
17763;47769;2488;57;29;4;25;.862;3547000;0
17763;62975;2493;77;40;3;37;.925;3600000;0
17764;30696;2508;67;19;2;17;.895;3600000;0
17764;34325;844;0;0;0;0;.00nan;0;0
17764;47982;2508;0;0;0;0;.00nan;0;0
17764;54885;844;67;36;4;32;.889;3561000;0
17765;5565;843;62;42;5;37;.881;3600000;0
17765;5573;2488;0;0;0;0;.00nan;0;0
17765;47769;2488;69;17;1;16;.941;3600000;0
17765;89874;843;0;0;0;0;.00nan;0;0
17766;13715;841;0;0;0;0;.00nan;0;0
17766;31439;835;0;0;0;0;.00nan;0;0
17766;47754;841;82;26;1;25;.962;3600000;0
17766;78920;835;84;31;2;29;.935;3600000;0
17767;16588;2493;57;48;6;42;.875;3600000;0
17767;47791;846;78;18;1;17;.944;3600000;0
17767;47864;846;0;0;0;0;.00nan;0;0
17767;62975;2493;0;0;0;0;.00nan;0;0
17768;32404;2517;28;6;3;3;.500;513000;0
17768;47736;2517;43;35;5;30;.857;3087000;0
17768;47742;845;0;0;0;0;.00nan;0;0
17768;154162;845;72;30;2;28;.933;3600000;0
17769;16588;2493;0;0;0;0;.00nan;0;0
17769;47742;845;70;21;1;20;.952;3600000;0
17769;62975;2493;98;50;2;48;.960;3561000;0
17769;154162;845;0;0;0;0;.00nan;0;0
17770;31439;835;0;0;0;0;.00nan;0;0
17770;47791;846;72;22;1;21;.955;3600000;0
17770;47864;846;0;0;0;0;.00nan;0;0
17770;78920;835;95;56;3;53;.946;3569000;0
17771;30696;2508;0;0;0;0;.00nan;0;0
17771;47742;845;0;0;0;0;.00nan;0;0
17771;47982;2508;55;38;5;33;.868;3578000;0
17771;154162;845;66;27;3;24;.889;3600000;0
17772;5573;2488;63;27;2;25;.926;3600000;0
17772;13715;841;0;0;0;0;.00nan;0;0
17772;47754;841;40;24;4;20;.833;3537000;0
17772;47769;2488;0;0;0;0;.00nan;0;0
17773;5565;843;78;29;2;27;.931;3600000;0
17773;16588;2493;55;26;3;23;.885;3544000;0
17773;62975;2493;0;0;0;0;.00nan;0;0
17773;89874;843;0;0;0;0;.00nan;0;0
17774;32404;2517;0;0;0;0;.00nan;0;0
17774;34325;844;58;27;4;23;.852;3900000;0
17774;47736;2517;77;42;4;38;.905;3900000;0
17774;54885;844;0;0;0;0;.00nan;0;0
17775;5565;843;71;37;4;33;.892;3593000;0
17775;31439;835;0;0;0;0;.00nan;0;0
17775;78920;835;58;22;3;19;.864;3600000;0
17775;89874;843;0;0;0;0;.00nan;0;0
17776;13715;841;0;0;0;0;.00nan;0;0
17776;34325;844;69;41;4;37;.902;3600000;0
17776;47754;841;61;41;5;36;.878;3544000;0
17776;54885;844;0;0;0;0;.00nan;0;0
17777;30696;2508;64;35;4;31;.886;3600000;0
17777;47791;846;54;24;3;21;.875;3600000;0
17777;47864;846;0;0;0;0;.00nan;0;0
17777;47982;2508;0;0;0;0;.00nan;0;0
17778;5573;2488;0;0;0;0;.00nan;0;0
17778;47742;845;0;0;0;0;.00nan;0;0
17778;47769;2488;73;30;2;28;.933;3600000;0
17778;154162;845;72;18;1;17;.944;3600000;0
17779;5565;843;71;50;4;46;.920;3600000;0
17779;34325;844;67;29;3;26;.897;3600000;0
17779;54885;844;0;0;0;0;.00nan;0;0
17779;89874;843;0;0;0;0;.00nan;0;0
17780;31439;835;0;0;0;0;.00nan;0;0
17780;32404;2517;85;33;3;30;.909;3900000;0
17780;47736;2517;0;0;0;0;.00nan;0;0
17780;78920;835;91;46;3;43;.935;3900000;0
17781;13715;841;0;0;0;0;.00nan;0;0
17781;30696;2508;0;0;0;0;.00nan;0;0
17781;47754;841;74;35;3;32;.914;3600000;0
17781;47982;2508;37;23;4;19;.826;3575000;0
17782;47742;845;72;33;2;31;.939;3600000;0
17782;47791;846;93;34;1;33;.971;3600000;0
17782;47864;846;0;0;0;0;.00nan;0;0
17782;154162;845;0;0;0;0;.00nan;0;0
17783;5573;2488;66;25;2;23;.920;3600000;0
17783;16588;2493;0;0;0;0;.00nan;0;0
17783;47769;2488;0;0;0;0;.00nan;0;0
17783;62975;2493;47;33;5;28;.848;3600000;0
17784;13715;841;0;0;0;0;.00nan;0;0
17784;32404;2517;83;30;1;29;.967;3600000;0
17784;47736;2517;0;0;0;0;.00nan;0;0
17784;47754;841;71;28;2;26;.929;3600000;0
17785;31439;835;69;34;3;31;.912;3900000;0
17785;47742;845;0;0;0;0;.00nan;0;0
17785;78920;835;0;0;0;0;.00nan;0;0
17785;154162;845;72;30;3;27;.900;3900000;0
17786;5565;843;0;0;0;0;.00nan;0;0
17786;47791;846;43;22;5;17;.773;3547000;0
17786;47864;846;0;0;0;0;.00nan;0;0
17786;89874;843;96;43;3;40;.930;3600000;0
17787;5573;2488;0;0;0;0;.00nan;0;0
17787;30696;2508;70;27;2;25;.926;3600000;0
17787;47769;2488;39;33;5;28;.848;3600000;0
17787;47982;2508;0;0;0;0;.00nan;0;0
17788;16588;2493;63;48;6;42;.875;3600000;0
17788;34325;844;57;16;2;14;.875;3600000;0
17788;54885;844;0;0;0;0;.00nan;0;0
17788;62975;2493;0;0;0;0;.00nan;0;0
17789;5573;2488;0;0;0;0;.00nan;0;0
17789;34325;844;80;31;2;29;.935;3600000;0
17789;47769;2488;55;41;5;36;.878;3600000;0
17789;54885;844;0;0;0;0;.00nan;0;0
17790;30696;2508;0;0;0;0;.00nan;0;0
17790;31439;835;0;0;0;0;.00nan;0;0
17790;47982;2508;56;23;3;20;.870;3900000;0
17790;78920;835;79;32;3;29;.906;3900000;0
17791;13715;841;0;0;0;0;.00nan;0;0
17791;16588;2493;0;0;0;0;.00nan;0;0
17791;47754;841;94;24;0;24;1.000;3600000;0
17791;62975;2493;95;30;1;29;.967;3600000;0
17792;32404;2517;81;53;4;49;.925;3561000;0
17792;47736;2517;0;0;0;0;.00nan;0;0
17792;47791;846;0;0;0;0;.00nan;0;0
17792;47864;846;58;21;3;18;.857;3600000;0
17793;5565;843;60;44;6;38;.864;3600000;0
17793;47742;845;0;0;0;0;.00nan;0;0
17793;89874;843;0;0;0;0;.00nan;0;0
17793;154162;845;51;16;2;14;.875;3600000;0
17794;30696;2508;97;38;1;37;.974;3600000;0
17794;32404;2517;0;0;0;0;.00nan;0;0
17794;47736;2517;53;37;5;32;.865;3600000;0
17794;47982;2508;0;0;0;0;.00nan;0;0
17795;31439;835;0;0;0;0;.00nan;0;0
17795;34325;844;80;37;2;35;.946;3600000;0
17795;54885;844;0;0;0;0;.00nan;0;0
17795;78920;835;67;31;3;28;.903;3561000;0
17796;5565;843;92;45;3;42;.933;3900000;0
17796;13715;841;0;0;0;0;.00nan;0;0
17796;47754;841;55;21;3;18;.857;3900000;0
17796;89874;843;0;0;0;0;.00nan;0;0
17797;5573;2488;51;31;4;27;.871;3900000;0
17797;47769;2488;0;0;0;0;.00nan;0;0
17797;47791;846;51;27;4;23;.852;3900000;0
17797;47864;846;0;0;0;0;.00nan;0;0
17798;16588;2493;0;0;0;0;.00nan;0;0
17798;47742;845;68;34;3;31;.912;3600000;0
17798;62975;2493;63;40;5;35;.875;3563000;0
17798;154162;845;0;0;0;0;.00nan;0;0
17799;5573;2488;81;37;3;34;.919;3600000;0
17799;32404;2517;100;25;0;25;1.000;3600000;0
17799;47736;2517;0;0;0;0;.00nan;0;0
17799;47769;2488;0;0;0;0;.00nan;0;0
17800;16588;2493;0;0;0;0;.00nan;0;0
17800;31439;835;0;0;0;0;.00nan;0;0
17800;62975;2493;81;27;1;26;.963;3600000;0
17800;78920;835;46;27;4;23;.852;3600000;0
17801;5565;843;76;33;2;31;.939;3900000;0
17801;30696;2508;0;0;0;0;.00nan;0;0
17801;47982;2508;74;23;2;21;.913;3900000;0
17801;89874;843;0;0;0;0;.00nan;0;0
17802;34325;844;89;36;2;34;.944;3651000;0
17802;47791;846;52;22;3;19;.864;3651000;0
17802;47864;846;0;0;0;0;.00nan;0;0
17802;54885;844;0;0;0;0;.00nan;0;0
17803;13715;841;0;0;0;0;.00nan;0;0
17803;47742;845;0;0;0;0;.00nan;0;0
17803;47754;841;83;29;2;27;.931;3600000;0
17803;154162;845;72;34;3;31;.912;3600000;0
17804;34325;844;62;29;3;26;.897;3900000;0
17804;47742;845;0;0;0;0;.00nan;0;0
17804;54885;844;0;0;0;0;.00nan;0;0
17804;154162;845;69;31;3;28;.903;3900000;0
17805;5565;843;0;0;0;0;.00nan;0;0
17805;47728;2517;0;0;0;0;.00nan;0;0
17805;47736;2517;39;19;4;15;.789;3600000;0
17805;89874;843;62;39;5;34;.872;3559000;0
17806;13715;841;0;0;0;0;.00nan;0;0
17806;47754;841;99;58;4;54;.931;3900000;0
17806;47791;846;59;29;4;25;.862;3900000;0
17806;47864;846;0;0;0;0;.00nan;0;0
17807;5573;2488;0;0;0;0;.00nan;0;0
17807;31439;835;0;0;0;0;.00nan;0;0
17807;47769;2488;75;38;3;35;.921;3600000;0
17807;78920;835;100;25;0;25;1.000;3600000;0
17808;16588;2493;64;34;4;30;.882;3581000;0
17808;30696;2508;0;0;0;0;.00nan;0;0
17808;47982;2508;53;15;2;13;.867;3600000;0
17808;62975;2493;0;0;0;0;.00nan;0;0
17810;5565;843;0;0;0;0;.00nan;0;0
17810;47742;845;0;0;0;0;.00nan;0;0
17810;89874;843;91;63;5;58;.921;3600000;0
17810;154162;845;62;13;1;12;.923;3600000;0
17812;16588;2493;0;0;0;0;.00nan;0;0
17812;31439;835;0;0;0;0;.00nan;0;0
17812;62975;2493;54;33;4;29;.879;3600000;0
17812;78920;835;72;30;2;28;.933;3600000;0
17814;5573;2488;45;24;3;21;.875;3900000;0
17814;34325;844;74;30;3;27;.900;3900000;0
17814;47769;2488;0;0;0;0;.00nan;0;0
17814;47982;844;0;0;0;0;.00nan;0;0
17816;47728;2517;0;0;0;0;.00nan;0;0
17816;47736;2517;56;27;3;24;.889;3600000;0
17816;47754;841;52;34;4;30;.882;3600000;0
17816;47864;841;0;0;0;0;.00nan;0;0
17818;13715;846;0;0;0;0;.00nan;0;0
17818;30696;2508;64;18;2;16;.889;3600000;0
17818;-1;846;52;21;3;18;.857;3564000;0
17818;48010;2508;0;0;0;0;.00nan;0;0
17820;5565;843;80;38;3;35;.921;3900000;0
17820;34325;844;60;24;3;21;.875;3900000;0
17820;54885;844;0;0;0;0;.00nan;0;0
17820;89874;843;0;0;0;0;.00nan;0;0
17822;30696;2508;0;0;0;0;.00nan;0;0
17822;47742;845;38;21;4;17;.810;3600000;0
17822;47982;2508;63;43;5;38;.884;3543000;0
17822;154162;845;0;0;0;0;.00nan;0;0
17824;5573;2488;0;0;0;0;.00nan;0;0
17824;13715;841;0;0;0;0;.00nan;0;0
17824;47754;841;84;33;2;31;.939;3600000;0
17824;47769;2488;70;40;4;36;.900;3516000;0
17826;31439;835;96;22;0;22;1.000;3600000;0
17826;47728;2517;61;33;4;29;.879;3600000;0
17826;47736;2517;0;0;0;0;.00nan;0;0
17826;78920;835;0;0;0;0;.00nan;0;0
17828;16588;2493;43;31;5;26;.839;3520000;0
17828;-1;846;61;25;3;22;.880;3600000;0
17828;47864;846;0;0;0;0;.00nan;0;0
17828;62975;2493;0;0;0;0;.00nan;0;0
17830;31439;835;100;36;0;36;1.000;3600000;0
17830;-1;846;0;0;0;0;.00nan;0;0
17830;47864;846;40;30;5;25;.833;3600000;0
17830;78920;835;0;0;0;0;.00nan;0;0
17832;16588;2493;64;16;1;15;.938;1287000;0
17832;34325;844;84;17;0;17;1.000;3600000;0
17832;54885;844;0;0;0;0;.00nan;0;0
17832;62975;2493;21;16;5;11;.688;2313000;0
17834;5565;843;84;53;4;49;.925;3539000;0
17834;47742;845;0;0;0;0;.00nan;0;0
17834;89874;843;0;0;0;0;.00nan;0;0
17834;154162;845;74;27;2;25;.926;3600000;0
17836;5573;2488;65;16;1;15;.938;3600000;0
17836;47728;2517;0;0;0;0;.00nan;0;0
17836;47736;2517;67;37;4;33;.892;3600000;0
17836;47769;2488;0;0;0;0;.00nan;0;0
17838;13715;841;0;0;0;0;.00nan;0;0
17838;30696;2508;84;16;0;16;1.000;3600000;0
17838;47754;841;75;40;4;36;.900;3600000;0
17838;47982;2508;0;0;0;0;.00nan;0;0
17840;5573;2488;0;0;0;0;.00nan;0;0
17840;47728;2517;80;28;2;26;.929;3600000;0
17840;47736;2517;0;0;0;0;.00nan;0;0
17840;47769;2488;46;32;5;27;.844;3600000;0
17842;16588;2493;78;44;4;40;.909;3600000;0
17842;34325;844;60;24;3;21;.875;3600000;0
17842;54885;844;0;0;0;0;.00nan;0;0
17842;62975;2493;0;0;0;0;.00nan;0;0
17844;30696;2508;94;48;3;45;.938;3600000;0
17844;47742;845;54;37;4;33;.892;3579000;0
17844;47982;2508;0;0;0;0;.00nan;0;0
17844;154162;845;0;0;0;0;.00nan;0;0
17846;5565;843;0;0;0;0;.00nan;0;0
17846;-1;846;58;27;4;23;.852;3600000;0
17846;47864;846;0;0;0;0;.00nan;0;0
17846;89874;843;98;39;1;38;.974;3600000;0
17848;13715;841;0;0;0;0;.00nan;0;0
17848;31439;835;74;36;3;33;.917;3900000;0
17848;47754;841;81;36;3;33;.917;3900000;0
17848;78920;835;0;0;0;0;.00nan;0;0
17850;13715;841;0;0;0;0;.00nan;0;0
17850;34325;844;0;0;0;0;.00nan;0;0
17850;47754;841;78;43;4;39;.907;3656000;0
17850;54885;844;70;31;3;28;.903;3656000;0
17852;5565;843;81;46;3;43;.935;3866000;0
17852;47742;845;0;0;0;0;.00nan;0;0
17852;89874;843;0;0;0;0;.00nan;0;0
17852;154162;845;59;19;2;17;.895;3866000;0
17854;16588;2493;0;0;0;0;.00nan;0;0
17854;30696;2508;75;36;3;33;.917;3600000;0
17854;47982;2508;0;0;0;0;.00nan;0;0
17854;62975;2493;74;23;1;22;.957;3600000;0
17856;31439;835;0;0;0;0;.00nan;0;0
17856;-1;846;70;22;1;21;.955;3600000;0
17856;47864;846;0;0;0;0;.00nan;0;0
17856;78920;835;66;28;3;25;.893;3564000;0
17858;5573;2488;0;0;0;0;.00nan;0;0
17858;47728;2517;0;0;0;0;.00nan;0;0
17858;47736;2517;87;21;0;21;1.000;3600000;0
17858;47769;2488;57;15;1;14;.933;3576000;0
17860;5573;2488;70;24;2;22;.917;3849000;0
17860;34325;844;70;25;1;24;.960;3849000;0
17860;47769;2488;0;0;0;0;.00nan;0;0
17860;54885;844;0;0;0;0;.00nan;0;0
17862;-1;846;0;0;0;0;.00nan;0;0
17862;47742;845;88;32;2;30;.938;3600000;0
17862;47864;846;53;34;4;30;.882;3556000;0
17862;154162;845;0;0;0;0;.00nan;0;0
17864;13715;841;85;49;3;46;.939;3524000;0
17864;47728;2517;75;21;1;20;.952;3600000;0
17864;47736;2517;0;0;0;0;.00nan;0;0
17864;47754;841;0;0;0;0;.00nan;0;0
17866;16588;2493;99;20;0;20;1.000;3600000;0
17866;30696;2508;0;0;0;0;.00nan;0;0
17866;47982;2508;90;31;1;30;.968;3600000;0
17866;62975;2493;0;0;0;0;.00nan;0;0
17868;5565;843;0;0;0;0;.00nan;0;0
17868;31439;835;48;26;4;22;.846;3600000;0
17868;78920;835;0;0;0;0;.00nan;0;0
17868;89874;843;100;31;0;31;1.000;3600000;0
17870;16588;2493;62;23;2;21;.913;3600000;0
17870;31439;835;73;37;3;34;.919;3564000;0
17870;62975;2493;0;0;0;0;.00nan;0;0
17870;78920;835;0;0;0;0;.00nan;0;0
17872;5573;2488;0;0;0;0;.00nan;0;0
17872;34325;844;51;27;4;23;.852;3600000;0
17872;47769;2488;55;40;5;35;.875;3556000;0
17872;54885;844;0;0;0;0;.00nan;0;0
17874;5565;843;0;0;0;0;.00nan;0;0
17874;30696;2508;46;33;5;28;.848;3544000;0
17874;47982;2508;0;0;0;0;.00nan;0;0
17874;89874;843;65;31;4;27;.871;3600000;0
17876;-1;846;44;27;4;23;.852;3572000;0
17876;47728;2517;0;0;0;0;.00nan;0;0
17876;47736;2517;54;20;3;17;.850;3600000;0
17876;47864;846;0;0;0;0;.00nan;0;0
17878;13715;841;0;0;0;0;.00nan;0;0
17878;47742;845;0;0;0;0;.00nan;0;0
17878;47754;841;90;35;2;33;.943;3572000;0
17878;154162;845;84;27;1;26;.963;3600000;0
19810;5565;843;28;14;4;10;.714;1164000;0
19810;47791;846;64;23;3;20;.870;3600000;0
19810;47864;846;0;0;0;0;.00nan;0;0
19810;89874;843;93;34;2;32;.941;2436000;0
19811;34325;844;33;24;5;19;.792;3955000;0
19811;47728;2517;0;0;0;0;.00nan;0;0
19811;47736;2517;69;42;4;38;.905;3955000;0
19811;54885;844;0;0;0;0;.00nan;0;0
19812;31439;835;0;0;0;0;.00nan;0;0
19812;47742;845;89;27;1;26;.963;3600000;0
19812;78920;835;98;50;2;48;.960;3543000;0
19812;154162;845;0;0;0;0;.00nan;0;0
19813;13715;841;0;0;0;0;.00nan;0;0
19813;30696;2508;51;30;4;26;.867;3552000;0
19813;47754;841;64;36;3;33;.917;3600000;0
19813;47982;2508;0;0;0;0;.00nan;0;0
19814;5565;843;53;45;6;39;.867;3600000;0
19814;47791;846;80;25;1;24;.960;3600000;0
19814;47864;846;0;0;0;0;.00nan;0;0
19814;89874;843;0;0;0;0;.00nan;0;0
19815;34325;844;56;17;2;15;.882;3600000;0
19815;47728;2517;0;0;0;0;.00nan;0;0
19815;47736;2517;56;31;4;27;.871;3539000;0
19815;54885;844;0;0;0;0;.00nan;0;0
19816;31439;835;0;0;0;0;.00nan;0;0
19816;47742;845;0;0;0;0;.00nan;0;0
19816;78920;835;54;34;5;29;.853;3600000;0
19816;154162;845;56;19;2;17;.895;3600000;0
19817;13715;841;0;0;0;0;.00nan;0;0
19817;30696;2508;40;27;4;23;.852;3573000;0
19817;47754;841;91;35;2;33;.943;3600000;0
19817;47982;2508;0;0;0;0;.00nan;0;0
19818;5565;843;87;59;4;55;.932;5756000;0
19818;47791;846;42;34;5;29;.853;5756000;0
19818;47864;846;0;0;0;0;.00nan;0;0
19818;89874;843;0;0;0;0;.00nan;0;0
19819;34325;844;91;32;1;31;.969;3695000;0
19819;47728;2517;0;0;0;0;.00nan;0;0
19819;47736;2517;81;30;2;28;.933;3695000;0
19819;54885;844;0;0;0;0;.00nan;0;0
19820;31439;835;0;0;0;0;.00nan;0;0
19820;47742;845;0;0;0;0;.00nan;0;0
19820;78920;835;79;22;1;21;.955;3600000;0
19820;154162;845;67;30;2;28;.933;3549000;0
19821;13715;841;0;0;0;0;.00nan;0;0
19821;30696;2508;60;30;4;26;.867;3600000;0
19821;47754;841;71;24;1;23;.958;3600000;0
19821;47982;2508;0;0;0;0;.00nan;0;0
19822;5565;843;85;47;4;43;.915;3600000;0
19822;47791;846;60;16;1;15;.938;3600000;0
19822;47864;846;0;0;0;0;.00nan;0;0
19822;89874;843;0;0;0;0;.00nan;0;0
19823;34325;844;70;47;5;42;.894;3600000;0
19823;47728;2517;0;0;0;0;.00nan;0;0
19823;47736;2517;76;28;2;26;.929;3600000;0
19823;54885;844;0;0;0;0;.00nan;0;0
19824;31439;835;0;0;0;0;.00nan;0;0
19824;47742;845;0;0;0;0;.00nan;0;0
19824;78920;835;58;37;5;32;.865;3600000;0
19824;154162;845;73;20;1;19;.950;3600000;0
19825;13715;841;0;0;0;0;.00nan;0;0
19825;30696;2508;63;44;5;39;.886;3557000;0
19825;47754;841;61;32;4;28;.875;3600000;0
19825;47982;2508;0;0;0;0;.00nan;0;0
19895;5565;843;63;40;5;35;.875;3600000;0
19895;47791;846;50;21;3;18;.857;3600000;0
19895;47864;846;0;0;0;0;.00nan;0;0
19895;89874;843;0;0;0;0;.00nan;0;0
19896;34325;844;71;28;3;25;.893;3565000;0
19896;47728;2517;0;0;0;0;.00nan;0;0
19896;47736;2517;89;33;2;31;.939;3600000;0
19896;54885;844;0;0;0;0;.00nan;0;0
19897;31439;835;0;0;0;0;.00nan;0;0
19897;47742;845;0;0;0;0;.00nan;0;0
19897;78920;835;70;36;3;33;.917;4221000;0
19897;154162;845;50;31;4;27;.871;4221000;0
19934;34325;844;87;51;3;48;.941;6319000;0
19934;47728;2517;0;0;0;0;.00nan;0;0
19934;47736;2517;97;59;2;57;.966;6319000;0
19934;54885;844;0;0;0;0;.00nan;0;0
19935;31439;835;0;0;0;0;.00nan;0;0
19935;47742;845;0;0;0;0;.00nan;0;0
19935;78920;835;65;33;3;30;.909;3600000;0
19935;154162;845;29;24;5;19;.792;3574000;0
19962;31439;835;0;0;0;0;.00nan;0;0
19962;47742;845;0;0;0;0;.00nan;0;0
19962;78920;835;90;43;1;42;.977;3600000;0
19962;154162;845;75;29;2;27;.931;3552000;0
19971;47728;2517;0;0;0;0;.00nan;0;0
19971;47736;2517;92;57;1;56;.982;4769000;0
19971;47791;846;83;13;0;13;1.000;4769000;0
19971;47864;846;0;0;0;0;.00nan;0;0
19972;13715;841;84;18;0;18;1.000;2902000;0
19972;31439;835;0;0;0;0;.00nan;0;0
19972;47754;841;20;9;4;5;.556;698000;0
19972;78920;835;43;30;5;25;.833;3583000;0
19973;47728;2517;0;0;0;0;.00nan;0;0
19973;47736;2517;93;48;4;44;.917;3600000;0
19973;47791;846;80;24;1;23;.958;3600000;0
19973;47864;846;0;0;0;0;.00nan;0;0
19974;13715;841;0;0;0;0;.00nan;0;0
19974;31439;835;0;0;0;0;.00nan;0;0
19974;47754;841;67;30;3;27;.900;3615000;0
19974;78920;835;58;34;4;30;.882;3615000;0
19975;47728;2517;0;0;0;0;.00nan;0;0
19975;47736;2517;75;44;4;40;.909;3869000;0
19975;47791;846;49;28;5;23;.821;3869000;0
19975;47864;846;0;0;0;0;.00nan;0;0
19976;13715;841;41;8;2;6;.750;406000;0
19976;31439;835;0;0;0;0;.00nan;0;0
19976;47754;841;43;35;5;30;.857;3194000;0
19976;78920;835;56;19;2;17;.895;3600000;0
19977;47728;2517;87;21;0;21;1.000;1432000;0
19977;47736;2517;39;29;5;24;.828;2168000;0
19977;47791;846;61;24;2;22;.917;3600000;0
19977;47864;846;0;0;0;0;.00nan;0;0
19978;13715;841;0;0;0;0;.00nan;0;0
19978;31439;835;0;0;0;0;.00nan;0;0
19978;47754;841;59;29;3;26;.897;4176000;0
19978;78920;835;68;46;4;42;.913;4176000;0
20075;47728;2517;0;0;0;0;.00nan;0;0
20075;47736;2517;45;29;5;24;.828;3600000;0
20075;47791;846;48;24;4;20;.833;3600000;0
20075;47864;846;0;0;0;0;.00nan;0;0
20076;13715;841;0;0;0;0;.00nan;0;0
20076;31439;835;86;21;0;21;1.000;2484000;0
20076;47754;841;91;31;1;30;.968;3600000;0
20076;78920;835;22;11;4;7;.636;1116000;0
20110;13715;841;0;0;0;0;.00nan;0;0
20110;47754;841;83;31;1;30;.968;3600000;0
20110;47791;846;62;37;4;33;.892;3600000;0
20110;47864;846;0;0;0;0;.00nan;0;0
20111;13715;841;0;0;0;0;.00nan;0;0
20111;47754;841;69;31;3;28;.903;3567000;0
20111;47791;846;58;13;1;12;.923;3600000;0
20111;47864;846;0;0;0;0;.00nan;0;0
20112;13715;841;0;0;0;0;.00nan;0;0
20112;47754;841;76;32;2;30;.938;3600000;0
20112;47791;846;56;24;4;20;.833;3568000;0
20112;47864;846;0;0;0;0;.00nan;0;0
20113;13715;841;0;0;0;0;.00nan;0;0
20113;47754;841;80;51;4;47;.922;3817000;0
20113;47791;846;61;26;3;23;.885;3849000;0
20113;47864;846;0;0;0;0;.00nan;0;0
142;13715;841;0;0;0;0;.00nan;0;0
142;47754;841;66;39;4;35;.897;3600000;0
142;47791;846;80;13;0;13;1.000;3600000;0
142;47864;846;0;0;0;0;.00nan;0;0
201;13715;841;0;0;0;0;.00nan;0;0
201;47754;841;93;43;2;41;.953;3600000;0
201;47791;846;50;24;4;20;.833;3543000;0
201;47864;846;0;0;0;0;.00nan;0;0
292;13715;841;0;0;0;0;.00nan;0;0
292;47754;841;91;36;2;34;.944;3600000;0
292;47791;846;49;21;3;18;.857;3600000;0
292;47864;846;0;0;0;0;.00nan;0;0
17879;179830;1475;67;28;3;25;.893;3600000;0
17879;54290;1477;0;0;0;0;.00nan;0;0
17879;54658;1475;0;0;0;0;.00nan;0;0
17879;143256;1477;50;28;4;24;.857;3573000;0
17880;9373;1854;100;25;0;25;1.000;3600000;0
17880;46912;2173;67;21;2;19;.905;3600000;0
17880;53889;2173;0;0;0;0;.00nan;0;0
17880;155664;1854;0;0;0;0;.00nan;0;0
17881;8073;521;0;0;0;0;.00nan;0;0
17881;22413;2193;0;0;0;0;.00nan;0;0
17881;63830;521;67;51;6;45;.882;3600000;0
17881;143191;2193;63;12;1;11;.917;3600000;0
17882;4618;523;0;0;0;0;.00nan;0;0
17882;56058;523;63;18;2;16;.889;3600000;0
17882;56231;1861;81;44;5;39;.886;3600000;0
17882;89998;1861;0;0;0;0;.00nan;0;0
17883;177504;1869;56;34;4;30;.882;3600000;0
17883;13613;1871;0;0;0;0;.00nan;0;0
17883;63402;1871;70;24;1;23;.958;3600000;0
17883;84287;1869;0;0;0;0;.00nan;0;0
17884;68627;4962;54;25;3;22;.880;3600000;0
17884;73973;517;0;0;0;0;.00nan;0;0
17884;147264;517;53;31;4;27;.871;3552000;0
17884;152464;4962;0;0;0;0;.00nan;0;0
17885;177519;3922;75;34;2;32;.941;3600000;0
17885;172279;3922;0;0;0;0;.00nan;0;0
17885;8035;522;61;27;3;24;.889;3552000;0
17885;143523;522;0;0;0;0;.00nan;0;0
17886;8035;522;0;0;0;0;.00nan;0;0
17886;179830;1475;75;35;4;31;.886;3598000;0
17886;54658;1475;0;0;0;0;.00nan;0;0
17886;143523;522;63;23;2;21;.913;3600000;0
17887;22413;2193;0;0;0;0;.00nan;0;0
17887;56231;1861;0;0;0;0;.00nan;0;0
17887;89998;1861;86;43;3;40;.930;3521000;0
17887;143191;2193;84;23;1;22;.957;3600000;0
17888;177504;1869;56;38;5;33;.868;3600000;0
17888;8073;521;0;0;0;0;.00nan;0;0
17888;63830;521;43;17;3;14;.824;3600000;0
17888;84287;1869;0;0;0;0;.00nan;0;0
17889;9373;1854;34;10;3;7;.700;498000;0
17889;86283;517;45;17;3;14;.824;3600000;0
17889;147264;517;0;0;0;0;.00nan;0;0
17889;155664;1854;69;35;3;32;.914;3102000;0
17890;177519;3922;83;31;2;29;.935;3600000;0
17890;172279;3922;0;0;0;0;.00nan;0;0
17890;46912;2173;49;32;5;27;.844;3600000;0
17890;53889;2173;0;0;0;0;.00nan;0;0
17891;54290;1477;0;0;0;0;.00nan;0;0
17891;143256;1477;80;14;0;14;1.000;3600000;0
17891;152464;4962;0;0;0;0;.00nan;0;0
17891;159851;4962;63;35;3;32;.914;3600000;0
17892;4618;523;0;0;0;0;.00nan;0;0
17892;13613;1871;0;0;0;0;.00nan;0;0
17892;56058;523;44;22;3;19;.864;3543000;0
17892;63402;1871;90;42;2;40;.952;3600000;0
17893;8073;521;0;0;0;0;.00nan;0;0
17893;179830;1475;0;0;0;0;.00nan;0;0
17893;54658;1475;60;24;3;21;.875;3576000;0
17893;63830;521;92;39;2;37;.949;3600000;0
17894;8035;522;0;0;0;0;.00nan;0;0
17894;9373;1854;98;40;1;39;.975;3600000;0
17894;143523;522;88;17;0;17;1.000;3600000;0
17894;155664;1854;0;0;0;0;.00nan;0;0
17895;22413;2193;64;22;2;20;.909;3600000;0
17895;54290;1477;0;0;0;0;.00nan;0;0
17895;143191;2193;0;0;0;0;.00nan;0;0
17895;143256;1477;82;39;3;36;.923;3600000;0
17896;4618;523;100;24;0;24;1.000;3600000;0
17896;46912;2173;70;54;6;48;.889;3600000;0
17896;53889;2173;0;0;0;0;.00nan;0;0
17896;56058;523;0;0;0;0;.00nan;0;0
17897;177504;1869;0;0;0;0;.00nan;0;0
17897;84287;1869;95;26;1;25;.962;3790000;0
17897;86283;517;81;29;2;27;.931;3790000;0
17897;147264;517;0;0;0;0;.00nan;0;0
17898;13613;1871;0;0;0;0;.00nan;0;0
17898;56231;1861;77;36;3;33;.917;3517000;0
17898;63402;1871;64;18;1;17;.944;3600000;0
17898;89998;1861;0;0;0;0;.00nan;0;0
17899;177519;3922;62;26;2;24;.923;3900000;0
17899;172279;3922;0;0;0;0;.00nan;0;0
17899;152464;4962;0;0;0;0;.00nan;0;0
17899;159851;4962;71;27;2;25;.926;3900000;0
17900;8035;522;0;0;0;0;.00nan;0;0
17900;13613;1871;0;0;0;0;.00nan;0;0
17900;63402;1871;61;13;1;12;.923;3600000;0
17900;143523;522;81;48;4;44;.917;3600000;0
17901;177504;1869;61;25;3;22;.880;3599000;0
17901;56231;1861;64;23;2;21;.913;3600000;0
17901;84287;1869;0;0;0;0;.00nan;0;0
17901;89998;1861;0;0;0;0;.00nan;0;0
17902;8073;521;81;33;2;31;.939;3600000;0
17902;9373;1854;42;31;6;25;.806;3600000;0
17902;63830;521;0;0;0;0;.00nan;0;0
17902;155664;1854;0;0;0;0;.00nan;0;0
17903;4618;523;0;0;0;0;.00nan;0;0
17903;56058;523;76;24;2;22;.917;3600000;0
17903;86283;517;52;36;4;32;.889;3555000;0
17903;147264;517;0;0;0;0;.00nan;0;0
17904;22413;2193;0;0;0;0;.00nan;0;0
17904;46912;2173;66;37;3;34;.919;3900000;0
17904;53889;2173;0;0;0;0;.00nan;0;0
17904;143191;2193;55;25;3;22;.880;3900000;0
17905;177519;3922;58;37;4;33;.892;3600000;0
17905;172279;3922;0;0;0;0;.00nan;0;0
17905;54290;1477;0;0;0;0;.00nan;0;0
17905;143256;1477;79;25;1;24;.960;3600000;0
17906;179830;1475;73;19;1;18;.947;3678000;0
17906;54658;1475;0;0;0;0;.00nan;0;0
17906;152464;4962;94;44;2;42;.955;3678000;0
17906;159851;4962;0;0;0;0;.00nan;0;0
17907;179830;1475;0;0;0;0;.00nan;0;0
17907;46912;2173;89;32;2;30;.938;3900000;0
17907;53889;2173;0;0;0;0;.00nan;0;0
17907;54658;1475;73;27;2;25;.926;3900000;0
17908;177519;3922;65;21;2;19;.905;3900000;0
17908;172279;3922;0;0;0;0;.00nan;0;0
17908;9373;1854;85;32;2;30;.938;3900000;0
17908;155664;1854;0;0;0;0;.00nan;0;0
17909;8073;521;0;0;0;0;.00nan;0;0
17909;56231;1861;88;27;1;26;.963;3600000;0
17909;63830;521;58;30;3;27;.900;3535000;0
17909;89998;1861;0;0;0;0;.00nan;0;0
17910;22413;2193;59;13;1;12;.923;3600000;0
17910;143191;2193;0;0;0;0;.00nan;0;0
17910;152464;4962;0;0;0;0;.00nan;0;0
17910;159851;4962;79;32;2;30;.938;3600000;0
17911;4618;523;73;31;2;29;.935;3900000;0
17911;54290;1477;0;0;0;0;.00nan;0;0
17911;56058;523;0;0;0;0;.00nan;0;0
17911;143256;1477;96;40;2;38;.950;3900000;0
17912;177504;1869;100;37;0;37;1.000;3600000;0
17912;8035;522;83;19;0;19;1.000;2991000;0
17912;84287;1869;0;0;0;0;.00nan;0;0
17912;143523;522;21;10;4;6;.600;609000;0
17913;13613;1871;0;0;0;0;.00nan;0;0
17913;63402;1871;82;31;2;29;.935;3900000;0
17913;86283;517;92;41;2;39;.951;3900000;0
17913;147264;517;0;0;0;0;.00nan;0;0
17914;8035;522;0;0;0;0;.00nan;0;0
17914;22413;2193;0;0;0;0;.00nan;0;0
17914;143191;2193;50;31;4;27;.871;3550000;0
17914;143523;522;68;26;3;23;.885;3600000;0
17915;4618;523;0;0;0;0;.00nan;0;0
17915;8073;521;0;0;0;0;.00nan;0;0
17915;56058;523;76;21;1;20;.952;3600000;0
17915;63830;521;98;48;2;46;.958;3600000;0
17916;56231;1861;56;37;5;32;.865;3600000;0
17916;86283;517;82;26;1;25;.962;3600000;0
17916;89998;1861;0;0;0;0;.00nan;0;0
17916;147264;517;0;0;0;0;.00nan;0;0
17917;13613;1871;0;0;0;0;.00nan;0;0
17917;46912;2173;74;44;5;39;.886;3600000;0
17917;53889;2173;0;0;0;0;.00nan;0;0
17917;63402;1871;93;21;0;21;1.000;3600000;0
17918;177504;1869;67;42;4;38;.905;3545000;0
17918;54290;1477;0;0;0;0;.00nan;0;0
17918;84287;1869;0;0;0;0;.00nan;0;0
17918;143256;1477;58;16;2;14;.875;3600000;0
17919;9373;1854;90;27;1;26;.963;3600000;0
17919;152464;4962;0;0;0;0;.00nan;0;0
17919;155664;1854;0;0;0;0;.00nan;0;0
17919;159851;4962;85;29;2;27;.931;3583000;0
17920;177519;3922;0;0;0;0;.00nan;0;0
17920;172279;3922;30;20;4;16;.800;3551000;0
17920;179830;1475;67;21;2;19;.905;3600000;0
17920;54658;1475;0;0;0;0;.00nan;0;0
17921;9373;1854;95;46;2;44;.957;3517000;0
17921;54290;1477;0;0;0;0;.00nan;0;0
17921;143256;1477;72;7;0;7;1.000;3600000;0
17921;155664;1854;0;0;0;0;.00nan;0;0
17922;8035;522;0;0;0;0;.00nan;0;0
17922;56231;1861;59;39;4;35;.897;3592000;0
17922;89998;1861;0;0;0;0;.00nan;0;0
17922;143523;522;74;28;2;26;.929;3600000;0
17923;46912;2173;81;39;3;36;.923;3600000;0
17923;53889;2173;0;0;0;0;.00nan;0;0
17923;86283;517;98;16;0;16;1.000;3600000;0
17923;147264;517;0;0;0;0;.00nan;0;0
17924;22413;2193;50;13;2;11;.846;3600000;0
17924;179830;1475;43;44;7;37;.841;3600000;0
17924;54658;1475;0;0;0;0;.00nan;0;0
17924;143191;2193;0;0;0;0;.00nan;0;0
17925;4618;523;62;19;2;17;.895;3600000;0
17925;56058;523;0;0;0;0;.00nan;0;0
17925;152464;4962;0;0;0;0;.00nan;0;0
17925;159851;4962;76;43;4;39;.907;3586000;0
17926;177504;1869;0;0;0;0;.00nan;0;0
17926;177519;3922;68;36;3;33;.917;3587000;0
17926;172279;3922;0;0;0;0;.00nan;0;0
17926;84287;1869;69;25;2;23;.920;3600000;0
17927;8073;521;0;0;0;0;.00nan;0;0
17927;13613;1871;0;0;0;0;.00nan;0;0
17927;63402;1871;47;29;5;24;.828;3776000;0
17927;63830;521;67;52;6;46;.885;3776000;0
17928;9373;1854;98;43;2;41;.953;3577000;0
17928;179830;1475;0;0;0;0;.00nan;0;0
17928;54658;1475;65;15;1;14;.933;3600000;0
17928;155664;1854;0;0;0;0;.00nan;0;0
17929;4618;523;0;0;0;0;.00nan;0;0
17929;8035;522;61;41;5;36;.878;3600000;0
17929;56058;523;72;30;2;28;.933;3600000;0
17929;143523;522;0;0;0;0;.00nan;0;0
17930;8073;521;94;52;4;48;.923;3599000;0
17930;63830;521;0;0;0;0;.00nan;0;0
17930;86283;517;52;20;3;17;.850;3600000;0
17930;147264;517;0;0;0;0;.00nan;0;0
17931;46912;2173;0;0;0;0;.00nan;0;0
17931;53889;2173;66;28;3;25;.893;3655000;0
17931;56231;1861;0;0;0;0;.00nan;0;0
17931;89998;1861;63;23;2;21;.913;3655000;0
17932;13613;1871;0;0;0;0;.00nan;0;0
17932;54290;1477;0;0;0;0;.00nan;0;0
17932;63402;1871;80;35;3;32;.914;3674000;0
17932;143256;1477;100;38;2;36;.947;3674000;0
17933;177504;1869;77;32;2;30;.938;3600000;0
17933;84287;1869;0;0;0;0;.00nan;0;0
17933;152464;4962;46;32;4;28;.875;3525000;0
17933;159851;4962;0;0;0;0;.00nan;0;0
17934;177519;3922;41;33;5;28;.848;3513000;0
17934;172279;3922;0;0;0;0;.00nan;0;0
17934;22413;2193;0;0;0;0;.00nan;0;0
17934;143191;2193;58;27;3;24;.889;3600000;0
17935;9373;1854;0;0;0;0;.00nan;0;0
17935;22413;2193;49;11;2;9;.818;3600000;0
17935;143191;2193;0;0;0;0;.00nan;0;0
17935;155664;1854;86;46;3;43;.935;3600000;0
17936;54290;1477;0;0;0;0;.00nan;0;0
17936;56231;1861;0;0;0;0;.00nan;0;0
17936;89998;1861;91;41;2;39;.951;3572000;0
17936;143256;1477;92;28;1;27;.964;3600000;0
17937;8035;522;0;0;0;0;.00nan;0;0
17937;86283;517;0;0;0;0;.00nan;0;0
17937;143523;522;54;37;5;32;.865;3600000;0
17937;147264;517;62;15;1;14;.933;3600000;0
17938;8073;521;0;0;0;0;.00nan;0;0
17938;46912;2173;77;33;2;31;.939;3600000;0
17938;53889;2173;0;0;0;0;.00nan;0;0
17938;63830;521;58;26;3;23;.885;3570000;0
17939;4618;523;73;32;3;29;.906;3600000;0
17939;177519;3922;68;39;4;35;.897;3600000;0
17939;172279;3922;0;0;0;0;.00nan;0;0
17939;56058;523;0;0;0;0;.00nan;0;0
17940;177504;1869;83;31;1;30;.968;3600000;0
17940;179830;1475;37;27;5;22;.815;3600000;0
17940;54658;1475;0;0;0;0;.00nan;0;0
17940;84287;1869;0;0;0;0;.00nan;0;0
17941;13613;1871;0;0;0;0;.00nan;0;0
17941;63402;1871;77;23;1;22;.957;3600000;0
17941;68627;4962;0;0;0;0;.00nan;0;0
17941;152464;4962;49;40;5;35;.875;3600000;0
17942;13613;1871;0;0;0;0;.00nan;0;0
17942;179830;1475;0;0;0;0;.00nan;0;0
17942;54658;1475;86;45;3;42;.933;3592000;0
17942;63402;1871;64;26;2;24;.923;3600000;0
17943;8035;522;0;0;0;0;.00nan;0;0
17943;8073;521;0;0;0;0;.00nan;0;0
17943;63830;521;80;34;2;32;.941;3597000;0
17943;143523;522;72;19;1;18;.947;3600000;0
17944;177504;1869;87;24;1;23;.958;3600000;0
17944;9373;1854;81;32;2;30;.938;3544000;0
17944;84287;1869;0;0;0;0;.00nan;0;0
17944;155664;1854;0;0;0;0;.00nan;0;0
17945;4618;523;0;0;0;0;.00nan;0;0
17945;22413;2193;51;6;1;5;.833;1040000;0
17945;56058;523;49;27;4;23;.852;3600000;0
17945;143191;2193;31;29;6;23;.793;2560000;0
17946;46912;2173;57;41;5;36;.878;3600000;0
17946;53889;2173;0;0;0;0;.00nan;0;0
17946;54290;1477;0;0;0;0;.00nan;0;0
17946;143256;1477;99;22;0;22;1.000;3600000;0
17947;56231;1861;0;0;0;0;.00nan;0;0
17947;68627;4962;67;34;3;31;.912;3520000;0
17947;89998;1861;79;22;1;21;.955;3600000;0
17947;152464;4962;0;0;0;0;.00nan;0;0
17948;177519;3922;81;39;3;36;.923;3600000;0
17948;172279;3922;0;0;0;0;.00nan;0;0
17948;86283;517;57;31;4;27;.871;3552000;0
17948;147264;517;0;0;0;0;.00nan;0;0
17949;9373;1854;85;42;4;38;.905;3600000;0
17949;56231;1861;0;0;0;0;.00nan;0;0
17949;89998;1861;66;18;1;17;.944;3600000;0
17949;155664;1854;0;0;0;0;.00nan;0;0
17950;8073;521;0;0;0;0;.00nan;0;0
17950;63830;521;60;19;2;17;.895;3600000;0
17950;68627;4962;0;0;0;0;.00nan;0;0
17950;152464;4962;49;29;4;25;.862;3536000;0
17951;54290;1477;0;0;0;0;.00nan;0;0
17951;86283;517;81;28;1;27;.964;3600000;0
17951;143256;1477;63;24;2;22;.917;3600000;0
17951;147264;517;0;0;0;0;.00nan;0;0
17952;8035;522;0;0;0;0;.00nan;0;0
17952;46912;2173;70;34;4;30;.882;3600000;0
17952;53889;2173;0;0;0;0;.00nan;0;0
17952;143523;522;45;30;5;25;.833;3564000;0
17953;4618;523;0;0;0;0;.00nan;0;0
17953;179830;1475;0;0;0;0;.00nan;0;0
17953;54658;1475;65;40;4;36;.900;3600000;0
17953;56058;523;89;19;0;19;1.000;3600000;0
17954;177504;1869;75;40;3;37;.925;3585000;0
17954;22413;2193;89;31;1;30;.968;3600000;0
17954;84287;1869;0;0;0;0;.00nan;0;0
17954;143191;2193;0;0;0;0;.00nan;0;0
17955;177519;3922;63;35;4;31;.886;3581000;0
17955;172279;3922;0;0;0;0;.00nan;0;0
17955;13613;1871;0;0;0;0;.00nan;0;0
17955;63402;1871;97;36;2;34;.944;3600000;0
17956;179830;1475;74;30;3;27;.900;3575000;0
17956;54658;1475;0;0;0;0;.00nan;0;0
17956;56231;1861;0;0;0;0;.00nan;0;0
17956;89998;1861;86;28;1;27;.964;3600000;0
17957;9373;1854;70;37;4;33;.892;3600000;0
17957;13613;1871;0;0;0;0;.00nan;0;0
17957;63402;1871;88;29;1;28;.966;3600000;0
17957;155664;1854;0;0;0;0;.00nan;0;0
17958;22413;2193;0;0;0;0;.00nan;0;0
17958;86283;517;72;34;3;31;.912;3567000;0
17958;143191;2193;73;26;2;24;.923;3600000;0
17958;147264;517;0;0;0;0;.00nan;0;0
17959;8035;522;0;0;0;0;.00nan;0;0
17959;54290;1477;0;0;0;0;.00nan;0;0
17959;143256;1477;73;21;1;20;.952;3900000;0
17959;143523;522;80;22;1;21;.955;3900000;0
17960;4618;523;0;0;0;0;.00nan;0;0
17960;177504;1869;0;0;0;0;.00nan;0;0
17960;56058;523;56;23;3;20;.870;3547000;0
17960;84287;1869;76;36;2;34;.944;3600000;0
17961;46912;2173;76;21;1;20;.952;3600000;0
17961;53889;2173;0;0;0;0;.00nan;0;0
17961;68627;4962;86;38;2;36;.947;3546000;0
17961;152464;4962;0;0;0;0;.00nan;0;0
17962;177519;3922;62;23;2;21;.913;3600000;0
17962;172279;3922;0;0;0;0;.00nan;0;0
17962;8073;521;0;0;0;0;.00nan;0;0
17962;63830;521;74;21;1;20;.952;3600000;0
17963;8035;522;50;19;3;16;.842;3600000;0
17963;68627;4962;0;0;0;0;.00nan;0;0
17963;143523;522;0;0;0;0;.00nan;0;0
17963;152464;4962;88;42;2;40;.952;3600000;0
17964;177519;3922;43;15;3;12;.800;3600000;0
17964;172279;3922;0;0;0;0;.00nan;0;0
17964;56231;1861;0;0;0;0;.00nan;0;0
17964;89998;1861;59;30;4;26;.867;3547000;0
17965;8073;521;98;41;1;40;.976;3600000;0
17965;54290;1477;0;0;0;0;.00nan;0;0
17965;63830;521;0;0;0;0;.00nan;0;0
17965;143256;1477;95;38;2;36;.947;3599000;0
17966;164913;517;0;0;0;0;.00nan;0;0
17966;179830;1475;97;51;2;49;.961;3570000;0
17966;54658;1475;0;0;0;0;.00nan;0;0
17966;86283;517;98;21;0;21;1.000;3600000;0
17967;177504;1869;0;0;0;0;.00nan;0;0
17967;46912;2173;0;0;0;0;.00nan;0;0
17967;53889;2173;77;30;2;28;.933;3600000;0
17967;84287;1869;66;21;1;20;.952;3600000;0
17968;4618;523;0;0;0;0;.00nan;0;0
17968;9373;1854;90;40;2;38;.950;3600000;0
17968;56058;523;59;14;1;13;.929;3600000;0
17968;155664;1854;0;0;0;0;.00nan;0;0
17969;22413;2193;51;19;2;17;.895;3553000;0
17969;55495;1871;0;0;0;0;.00nan;0;0
17969;63402;1871;96;33;1;32;.970;3600000;0
17969;143191;2193;0;0;0;0;.00nan;0;0
17970;177519;3922;46;22;3;19;.864;3548000;0
17970;172279;3922;0;0;0;0;.00nan;0;0
17970;8035;522;0;0;0;0;.00nan;0;0
17970;143523;522;63;22;2;20;.909;3600000;0
17971;4618;523;0;0;0;0;.00nan;0;0
17971;56058;523;87;41;2;39;.951;3900000;0
17971;56231;1861;0;0;0;0;.00nan;0;0
17971;89998;1861;100;51;2;49;.961;3900000;0
17972;8073;521;0;0;0;0;.00nan;0;0
17972;22413;2193;0;0;0;0;.00nan;0;0
17972;63830;521;45;28;4;24;.857;3600000;0
17972;143191;2193;86;40;2;38;.950;3600000;0
17973;164913;517;0;0;0;0;.00nan;0;0
17973;68627;4962;0;0;0;0;.00nan;0;0
17973;86283;517;73;21;1;20;.952;3600000;0
17973;152464;4962;89;50;3;47;.940;3548000;0
17974;9373;1854;68;36;4;32;.889;3600000;0
17974;46912;2173;97;21;0;21;1.000;3600000;0
17974;53889;2173;0;0;0;0;.00nan;0;0
17974;155664;1854;0;0;0;0;.00nan;0;0
17975;179830;1475;43;35;6;29;.829;3330000;0
17975;54290;1477;0;0;0;0;.00nan;0;0
17975;54658;1475;61;6;0;6;1.000;270000;0
17975;143256;1477;71;20;1;19;.950;3600000;0
17976;177504;1869;0;0;0;0;.00nan;0;0
17976;55495;1871;0;0;0;0;.00nan;0;0
17976;63402;1871;67;24;2;22;.917;3600000;0
17976;84287;1869;54;25;3;22;.880;3560000;0
17977;8035;522;0;0;0;0;.00nan;0;0
17977;179830;1475;0;0;0;0;.00nan;0;0
17977;54658;1475;69;29;3;26;.897;3600000;0
17977;143523;522;51;24;4;20;.833;3572000;0
17978;9373;1854;0;0;0;0;.00nan;0;0
17978;164913;517;0;0;0;0;.00nan;0;0
17978;86283;517;81;22;1;21;.955;3600000;0
17978;155664;1854;85;46;3;43;.935;3588000;0
17979;22413;2193;87;16;0;16;1.000;3600000;0
17979;56231;1861;0;0;0;0;.00nan;0;0
17979;89998;1861;83;56;6;50;.893;3600000;0
17979;143191;2193;0;0;0;0;.00nan;0;0
17980;4618;523;70;24;1;23;.958;3600000;0
17980;55495;1871;0;0;0;0;.00nan;0;0
17980;56058;523;0;0;0;0;.00nan;0;0
17980;63402;1871;91;36;2;34;.944;3591000;0
17981;177504;1869;0;0;0;0;.00nan;0;0
17981;8073;521;81;35;2;33;.943;3600000;0
17981;63830;521;0;0;0;0;.00nan;0;0
17981;84287;1869;63;18;1;17;.944;3600000;0
17982;54290;1477;0;0;0;0;.00nan;0;0
17982;68627;4962;24;21;5;16;.762;1249000;0
17982;143256;1477;56;11;1;10;.909;3600000;0
17982;152464;4962;64;49;5;44;.898;2351000;0
17983;177519;3922;72;35;3;32;.914;3900000;0
17983;172279;3922;0;0;0;0;.00nan;0;0
17983;46912;2173;64;27;3;24;.889;3900000;0
17983;53889;2173;0;0;0;0;.00nan;0;0
17984;8035;522;0;0;0;0;.00nan;0;0
17984;9373;1854;55;39;5;34;.872;3600000;0
17984;143523;522;85;12;0;12;1.000;3600000;0
17984;155664;1854;0;0;0;0;.00nan;0;0
17985;55495;1871;0;0;0;0;.00nan;0;0
17985;56231;1861;0;0;0;0;.00nan;0;0
17985;63402;1871;55;16;3;13;.813;3900000;0
17985;89998;1861;96;58;3;55;.948;3900000;0
17986;8073;521;85;44;3;41;.932;3806000;0
17986;179830;1475;0;0;0;0;.00nan;0;0
17986;54658;1475;74;28;2;26;.929;3859000;0
17986;63830;521;0;0;0;0;.00nan;0;0
17987;177504;1869;0;0;0;0;.00nan;0;0
17987;164913;517;0;0;0;0;.00nan;0;0
17987;84287;1869;72;29;2;27;.931;3600000;0
17987;86283;517;48;26;4;22;.846;3568000;0
17988;4618;523;0;0;0;0;.00nan;0;0
17988;46912;2173;57;46;5;41;.891;3600000;0
17988;53889;2173;0;0;0;0;.00nan;0;0
17988;56058;523;100;25;0;25;1.000;3600000;0
17989;22413;2193;0;0;0;0;.00nan;0;0
17989;54290;1477;0;0;0;0;.00nan;0;0
17989;143191;2193;59;28;4;24;.857;3600000;0
17989;143256;1477;100;41;1;40;.976;3600000;0
17990;177519;3922;54;26;3;23;.885;3600000;0
17990;172279;3922;0;0;0;0;.00nan;0;0
17990;68627;4962;0;0;0;0;.00nan;0;0
17990;152464;4962;67;44;4;40;.909;3544000;0
17991;179830;1475;0;0;0;0;.00nan;0;0
17991;54658;1475;70;19;1;18;.947;3600000;0
17991;68627;4962;0;0;0;0;.00nan;0;0
17991;152464;4962;36;34;5;29;.853;3600000;0
17992;8073;521;58;24;3;21;.875;3584000;0
17992;9373;1854;91;36;2;34;.944;3600000;0
17992;63830;521;0;0;0;0;.00nan;0;0
17992;155664;1854;0;0;0;0;.00nan;0;0
17993;22413;2193;38;20;4;16;.800;3900000;0
17993;46912;2173;72;33;4;29;.879;3900000;0
17993;53889;2173;0;0;0;0;.00nan;0;0
17993;143191;2193;0;0;0;0;.00nan;0;0
17994;4618;523;0;0;0;0;.00nan;0;0
17994;164913;517;0;0;0;0;.00nan;0;0
17994;56058;523;87;31;2;29;.935;3600000;0
17994;86283;517;87;42;3;39;.929;3600000;0
17995;177504;1869;0;0;0;0;.00nan;0;0
17995;56231;1861;0;0;0;0;.00nan;0;0
17995;84287;1869;38;20;5;15;.750;3900000;0
17995;89998;1861;51;32;5;27;.844;3900000;0
17996;8035;522;0;0;0;0;.00nan;0;0
17996;55495;1871;0;0;0;0;.00nan;0;0
17996;63402;1871;68;24;2;22;.917;3600000;0
17996;143523;522;39;29;5;24;.828;3600000;0
17997;177519;3922;0;0;0;0;.00nan;0;0
17997;172279;3922;55;32;5;27;.844;3600000;0
17997;54290;1477;0;0;0;0;.00nan;0;0
17997;143256;1477;68;20;2;18;.900;3600000;0
17998;177504;1869;69;27;3;24;.889;3600000;0
17998;8035;522;49;34;5;29;.853;3536000;0
17998;84287;1869;0;0;0;0;.00nan;0;0
17998;143523;522;0;0;0;0;.00nan;0;0
17999;8073;521;70;25;2;23;.920;3805000;0
17999;56231;1861;0;0;0;0;.00nan;0;0
17999;63830;521;0;0;0;0;.00nan;0;0
17999;89998;1861;100;47;1;46;.979;3805000;0
18000;164913;517;63;40;6;34;.850;3900000;0
18000;55495;1871;0;0;0;0;.00nan;0;0
18000;63402;1871;29;31;6;25;.806;3900000;0
18000;86283;517;0;0;0;0;.00nan;0;0
18001;179830;1475;34;21;4;17;.810;3556000;0
18001;46912;2173;79;43;3;40;.930;3600000;0
18001;53889;2173;0;0;0;0;.00nan;0;0
18001;54658;1475;0;0;0;0;.00nan;0;0
18002;4618;523;0;0;0;0;.00nan;0;0
18002;54290;1477;0;0;0;0;.00nan;0;0
18002;56058;523;76;30;3;27;.900;3850000;0
18002;143256;1477;66;33;3;30;.909;3900000;0
18003;22413;2193;0;0;0;0;.00nan;0;0
18003;68627;4962;60;61;8;53;.869;3600000;0
18003;143191;2193;50;12;2;10;.833;3600000;0
18003;152464;4962;0;0;0;0;.00nan;0;0
18004;177519;3922;69;16;1;15;.938;3600000;0
18004;172279;3922;0;0;0;0;.00nan;0;0
18004;9373;1854;60;43;6;37;.860;3600000;0
18004;155664;1854;0;0;0;0;.00nan;0;0
18005;177519;3922;96;19;0;19;1.000;3600000;0
18005;172279;3922;0;0;0;0;.00nan;0;0
18005;179830;1475;0;0;0;0;.00nan;0;0
18005;54658;1475;54;29;4;25;.862;3600000;0
18006;9373;1854;64;28;3;25;.893;3577000;0
18006;68627;4962;0;0;0;0;.00nan;0;0
18006;152464;4962;65;28;2;26;.929;3600000;0
18006;155664;1854;0;0;0;0;.00nan;0;0
18007;164913;517;0;0;0;0;.00nan;0;0
18007;56231;1861;0;0;0;0;.00nan;0;0
18007;86283;517;89;15;0;15;1.000;3600000;0
18007;89998;1861;97;37;1;36;.973;3544000;0
18008;8035;522;0;0;0;0;.00nan;0;0
18008;22413;2193;68;38;5;33;.868;3600000;0
18008;143191;2193;0;0;0;0;.00nan;0;0
18008;143523;522;66;36;4;32;.889;3600000;0
18009;4618;523;0;0;0;0;.00nan;0;0
18009;8073;521;58;50;6;44;.880;3600000;0
18009;56058;523;55;15;2;13;.867;3600000;0
18009;63830;521;0;0;0;0;.00nan;0;0
18010;177504;1869;0;0;0;0;.00nan;0;0
18010;54290;1477;0;0;0;0;.00nan;0;0
18010;84287;1869;63;21;2;19;.905;3600000;0
18010;143256;1477;97;35;1;34;.971;3600000;0
18011;46912;2173;70;46;4;42;.913;3600000;0
18011;53889;2173;0;0;0;0;.00nan;0;0
18011;55495;1871;0;0;0;0;.00nan;0;0
18011;63402;1871;86;28;1;27;.964;3600000;0
18012;22413;2193;0;0;0;0;.00nan;0;0
18012;179830;1475;57;23;2;21;.913;3560000;0
18012;54658;1475;0;0;0;0;.00nan;0;0
18012;143191;2193;67;20;1;19;.950;3600000;0
18013;8035;522;0;0;0;0;.00nan;0;0
18013;56231;1861;0;0;0;0;.00nan;0;0
18013;89998;1861;37;30;5;25;.833;3600000;0
18013;143523;522;73;26;2;24;.923;3600000;0
18014;8073;521;0;0;0;0;.00nan;0;0
18014;13613;1871;39;17;3;14;.824;3542000;0
18014;55495;1871;0;0;0;0;.00nan;0;0
18014;63830;521;71;23;1;22;.957;3600000;0
18015;164913;517;0;0;0;0;.00nan;0;0
18015;46912;2173;25;11;4;7;.636;570000;0
18015;53889;2173;97;33;1;32;.970;3030000;0
18015;86283;517;57;21;2;19;.905;3600000;0
18016;9373;1854;98;38;2;36;.947;3600000;0
18016;54290;1477;0;0;0;0;.00nan;0;0
18016;143256;1477;57;28;3;25;.893;3549000;0
18016;155664;1854;0;0;0;0;.00nan;0;0
18017;4618;523;0;0;0;0;.00nan;0;0
18017;56058;523;78;14;0;14;1.000;3600000;0
18017;68627;4962;0;0;0;0;.00nan;0;0
18017;152464;4962;88;39;3;36;.923;3600000;0
18018;177504;1869;79;33;2;31;.939;3565000;0
18018;177519;3922;83;16;0;16;1.000;3600000;0
18018;172279;3922;0;0;0;0;.00nan;0;0
18018;84287;1869;0;0;0;0;.00nan;0;0
18019;9373;1854;78;43;5;38;.884;3572000;0
18019;179830;1475;49;22;3;19;.864;3600000;0
18019;54658;1475;0;0;0;0;.00nan;0;0
18019;155664;1854;0;0;0;0;.00nan;0;0
18020;46912;2173;54;16;2;14;.875;3600000;0
18020;53889;2173;0;0;0;0;.00nan;0;0
18020;56231;1861;0;0;0;0;.00nan;0;0
18020;89998;1861;57;34;4;30;.882;3588000;0
18021;8073;521;0;0;0;0;.00nan;0;0
18021;164913;517;0;0;0;0;.00nan;0;0
18021;63830;521;55;30;4;26;.867;3542000;0
18021;86283;517;68;20;2;18;.900;3600000;0
18022;177519;3922;100;27;0;27;1.000;3600000;0
18022;172279;3922;0;0;0;0;.00nan;0;0
18022;22413;2193;0;0;0;0;.00nan;0;0
18022;143191;2193;87;28;1;27;.964;3575000;0
18023;4618;523;0;0;0;0;.00nan;0;0
18023;8035;522;0;0;0;0;.00nan;0;0
18023;56058;523;67;27;3;24;.889;3572000;0
18023;143523;522;82;32;2;30;.938;3600000;0
18024;177504;1869;73;19;1;18;.947;3600000;0
18024;68627;4962;0;0;0;0;.00nan;0;0
18024;84287;1869;0;0;0;0;.00nan;0;0
18024;152464;4962;33;33;6;27;.818;3600000;0
18025;54290;1477;0;0;0;0;.00nan;0;0
18025;55495;1871;46;19;3;16;.842;2634000;0
18025;63402;1871;22;11;4;7;.636;966000;0
18025;143256;1477;75;27;2;25;.926;3600000;0
18026;177504;1869;0;0;0;0;.00nan;0;0
18026;179830;1475;0;0;0;0;.00nan;0;0
18026;54658;1475;74;34;2;32;.941;3600000;0
18026;84287;1869;66;30;3;27;.900;3552000;0
18027;8035;522;0;0;0;0;.00nan;0;0
18027;164913;517;0;0;0;0;.00nan;0;0
18027;86283;517;83;30;1;29;.967;3600000;0
18027;143523;522;82;41;3;38;.927;3600000;0
18028;8073;521;0;0;0;0;.00nan;0;0
18028;46912;2173;73;26;1;25;.962;3600000;0
18028;53889;2173;0;0;0;0;.00nan;0;0
18028;63830;521;47;26;4;22;.846;3600000;0
18029;9373;1854;97;36;1;35;.972;3900000;0
18029;22413;2193;83;24;1;23;.958;3900000;0
18029;143191;2193;0;0;0;0;.00nan;0;0
18029;155664;1854;0;0;0;0;.00nan;0;0
18030;54290;1477;0;0;0;0;.00nan;0;0
18030;56231;1861;0;0;0;0;.00nan;0;0
18030;89998;1861;80;33;3;30;.909;3600000;0
18030;143256;1477;99;22;0;22;1.000;3600000;0
18031;55495;1871;0;0;0;0;.00nan;0;0
18031;63402;1871;100;31;0;31;1.000;3600000;0
18031;68627;4962;67;32;3;29;.906;3600000;0
18031;152464;4962;0;0;0;0;.00nan;0;0
18032;4618;523;0;0;0;0;.00nan;0;0
18032;177519;3922;86;40;3;37;.925;3600000;0
18032;172279;3922;0;0;0;0;.00nan;0;0
18032;56058;523;48;30;4;26;.867;3600000;0
18033;56231;1861;0;0;0;0;.00nan;0;0
18033;68627;4962;0;0;0;0;.00nan;0;0
18033;89998;1861;72;25;2;23;.920;3600000;0
18033;152464;4962;82;31;3;28;.903;3558000;0
18034;8035;522;0;0;0;0;.00nan;0;0
18034;8073;521;60;29;2;27;.931;3900000;0
18034;63830;521;0;0;0;0;.00nan;0;0
18034;143523;522;74;28;2;26;.929;3900000;0
18035;177519;3922;39;30;5;25;.833;3600000;0
18035;172279;3922;0;0;0;0;.00nan;0;0
18035;164913;517;0;0;0;0;.00nan;0;0
18035;86283;517;67;25;2;23;.920;3600000;0
18036;46912;2173;0;0;0;0;.00nan;0;0
18036;53889;2173;65;29;3;26;.897;3600000;0
18036;54290;1477;0;0;0;0;.00nan;0;0
18036;143256;1477;88;36;2;34;.944;3600000;0
18037;4618;523;50;29;5;24;.828;3600000;0
18037;22413;2193;0;0;0;0;.00nan;0;0
18037;56058;523;0;0;0;0;.00nan;0;0
18037;143191;2193;100;38;0;38;1.000;3600000;0
18038;177504;1869;63;23;2;21;.913;3900000;0
18038;9373;1854;87;37;2;35;.946;3900000;0
18038;84287;1869;0;0;0;0;.00nan;0;0
18038;155664;1854;0;0;0;0;.00nan;0;0
18039;179830;1475;92;41;2;39;.951;3564000;0
18039;54658;1475;0;0;0;0;.00nan;0;0
18039;55495;1871;0;0;0;0;.00nan;0;0
18039;63402;1871;68;21;1;20;.952;3600000;0
18040;4618;523;0;0;0;0;.00nan;0;0
18040;179830;1475;0;0;0;0;.00nan;0;0
18040;54658;1475;67;35;5;30;.857;3600000;0
18040;56058;523;63;20;2;18;.900;3600000;0
18041;8035;522;0;0;0;0;.00nan;0;0
18041;46912;2173;60;31;3;28;.903;3513000;0
18041;53889;2173;0;0;0;0;.00nan;0;0
18041;143523;522;87;28;1;27;.964;3600000;0
18042;9373;1854;75;26;2;24;.923;3600000;0
18042;56231;1861;0;0;0;0;.00nan;0;0
18042;89998;1861;67;24;3;21;.875;3568000;0
18042;155664;1854;0;0;0;0;.00nan;0;0
18043;177504;1869;0;0;0;0;.00nan;0;0
18043;22413;2193;0;0;0;0;.00nan;0;0
18043;84287;1869;95;35;1;34;.971;3600000;0
18043;143191;2193;100;25;0;25;1.000;3600000;0
18044;164913;517;0;0;0;0;.00nan;0;0
18044;54290;1477;0;0;0;0;.00nan;0;0
18044;86283;517;37;28;5;23;.821;3600000;0
18044;143256;1477;100;27;0;27;1.000;3600000;0
18045;8073;521;0;0;0;0;.00nan;0;0
18045;63830;521;68;25;3;22;.880;3600000;0
18045;68627;4962;0;0;0;0;.00nan;0;0
18045;152464;4962;71;45;4;41;.911;3545000;0
18046;177519;3922;90;27;0;27;1.000;3600000;0
18046;172279;3922;0;0;0;0;.00nan;0;0
18046;55495;1871;0;0;0;0;.00nan;0;0
18046;63402;1871;60;34;5;29;.853;3600000;0
18047;8035;522;100;27;0;27;1.000;3600000;0
18047;54290;1477;0;0;0;0;.00nan;0;0
18047;143256;1477;79;42;4;38;.905;3600000;0
18047;143523;522;0;0;0;0;.00nan;0;0
18048;179830;1475;61;29;3;26;.897;3552000;0
18048;54658;1475;0;0;0;0;.00nan;0;0
18048;56231;1861;0;0;0;0;.00nan;0;0
18048;89998;1861;67;23;2;21;.913;3600000;0
18049;177519;3922;99;24;0;24;1.000;3600000;0
18049;172279;3922;0;0;0;0;.00nan;0;0
18049;8073;521;76;27;2;25;.926;3521000;0
18049;63830;521;0;0;0;0;.00nan;0;0
18050;164913;517;44;35;6;29;.829;2862000;0
18050;22413;2193;0;0;0;0;.00nan;0;0
18050;86283;517;66;8;0;8;1.000;738000;0
18050;143191;2193;100;31;0;31;1.000;3600000;0
18051;46912;2173;77;23;1;22;.957;3600000;0
18051;53889;2173;0;0;0;0;.00nan;0;0
18051;68627;4962;0;0;0;0;.00nan;0;0
18051;152464;4962;76;37;3;34;.919;3586000;0
18052;4618;523;0;0;0;0;.00nan;0;0
18052;177504;1869;81;38;3;35;.921;3748000;0
18052;56058;523;61;20;2;18;.900;3748000;0
18052;84287;1869;0;0;0;0;.00nan;0;0
18053;9373;1854;89;59;2;57;.966;3718000;0
18053;55495;1871;46;7;1;6;.857;3718000;0
18053;63402;1871;0;0;0;0;.00nan;0;0
18053;155664;1854;0;0;0;0;.00nan;0;0
18054;164913;517;0;0;0;0;.00nan;0;0
18054;179830;1475;0;0;0;0;.00nan;0;0
18054;54658;1475;54;42;5;37;.881;3600000;0
18054;86283;517;79;23;1;22;.957;3600000;0
18055;4618;523;0;0;0;0;.00nan;0;0
18055;9373;1854;97;53;3;50;.943;3554000;0
18055;56058;523;65;19;1;18;.947;3600000;0
18055;155664;1854;0;0;0;0;.00nan;0;0
18056;22413;2193;0;0;0;0;.00nan;0;0
18056;55495;1871;0;0;0;0;.00nan;0;0
18056;63402;1871;69;29;3;26;.897;3569000;0
18056;143191;2193;89;32;1;31;.969;3600000;0
18057;8073;521;0;0;0;0;.00nan;0;0
18057;54290;1477;0;0;0;0;.00nan;0;0
18057;63830;521;48;14;2;12;.857;3568000;0
18057;143256;1477;83;33;1;32;.970;3600000;0
18058;177504;1869;78;31;2;29;.935;3600000;0
18058;46912;2173;64;32;4;28;.875;3587000;0
18058;53889;2173;0;0;0;0;.00nan;0;0
18058;84287;1869;0;0;0;0;.00nan;0;0
18059;8035;522;79;13;0;13;1.000;3600000;0
18059;68627;4962;0;0;0;0;.00nan;0;0
18059;143523;522;0;0;0;0;.00nan;0;0
18059;152464;4962;52;36;6;30;.833;3600000;0
18060;177519;3922;72;25;3;22;.880;3600000;0
18060;172279;3922;0;0;0;0;.00nan;0;0
18060;56231;1861;0;0;0;0;.00nan;0;0
18060;89998;1861;73;43;5;38;.884;3544000;0
18061;179830;1475;72;30;2;28;.933;3596000;0
18061;54290;1477;0;0;0;0;.00nan;0;0
18061;54658;1475;0;0;0;0;.00nan;0;0
18061;143256;1477;95;33;1;32;.970;3600000;0
18062;9373;1854;0;0;0;0;.00nan;0;0
18062;46912;2173;55;27;3;24;.889;3600000;0
18062;53889;2173;0;0;0;0;.00nan;0;0
18062;155664;1854;42;27;4;23;.852;3600000;0
18063;8073;521;100;47;1;46;.979;3600000;0
18063;22413;2193;47;14;2;12;.857;3593000;0
18063;63830;521;0;0;0;0;.00nan;0;0
18063;143191;2193;0;0;0;0;.00nan;0;0
18064;4618;523;0;0;0;0;.00nan;0;0
18064;56058;523;70;17;1;16;.941;3600000;0
18064;56231;1861;0;0;0;0;.00nan;0;0
18064;89998;1861;86;56;6;50;.893;3600000;0
18065;177504;1869;0;0;0;0;.00nan;0;0
18065;55495;1871;0;0;0;0;.00nan;0;0
18065;63402;1871;60;32;4;28;.875;3600000;0
18065;84287;1869;100;33;0;33;1.000;3600000;0
18066;164913;517;0;0;0;0;.00nan;0;0
18066;68627;4962;91;41;2;39;.951;3565000;0
18066;86283;517;97;23;0;23;1.000;3600000;0
18066;152464;4962;0;0;0;0;.00nan;0;0
18067;177519;3922;0;0;0;0;.00nan;0;0
18067;172279;3922;47;24;3;21;.875;3593000;0
18067;8035;522;60;17;2;15;.882;3600000;0
18067;143523;522;0;0;0;0;.00nan;0;0
18068;8035;522;0;0;0;0;.00nan;0;0
18068;179830;1475;79;26;1;25;.962;3600000;0
18068;54658;1475;0;0;0;0;.00nan;0;0
18068;143523;522;74;38;3;35;.921;3543000;0
18069;22413;2193;0;0;0;0;.00nan;0;0
18069;56231;1861;0;0;0;0;.00nan;0;0
18069;89998;1861;100;44;2;42;.955;3600000;0
18069;143191;2193;46;25;4;21;.840;3567000;0
18070;177504;1869;0;0;0;0;.00nan;0;0
18070;8073;521;100;34;0;34;1.000;3600000;0
18070;63830;521;0;0;0;0;.00nan;0;0
18070;84287;1869;61;23;2;21;.913;3515000;0
18071;9373;1854;86;47;3;44;.936;3600000;0
18071;164913;517;0;0;0;0;.00nan;0;0
18071;86283;517;66;16;1;15;.938;3600000;0
18071;155664;1854;0;0;0;0;.00nan;0;0
18072;177519;3922;78;32;2;30;.938;3592000;0
18072;172279;3922;0;0;0;0;.00nan;0;0
18072;46912;2173;69;20;1;19;.950;3600000;0
18072;53889;2173;0;0;0;0;.00nan;0;0
18073;54290;1477;0;0;0;0;.00nan;0;0
18073;68627;4962;0;0;0;0;.00nan;0;0
18073;143256;1477;47;15;3;12;.800;3562000;0
18073;152464;4962;93;38;2;36;.947;3600000;0
18074;4618;523;0;0;0;0;.00nan;0;0
18074;55495;1871;0;0;0;0;.00nan;0;0
18074;56058;523;65;24;2;22;.917;3600000;0
18074;63402;1871;68;41;4;37;.902;3560000;0
18075;8073;521;62;14;1;13;.929;3900000;0
18075;179830;1475;0;0;0;0;.00nan;0;0
18075;54658;1475;74;28;1;27;.964;3900000;0
18075;63830;521;0;0;0;0;.00nan;0;0
18076;8035;522;0;0;0;0;.00nan;0;0
18076;9373;1854;56;33;4;29;.879;3600000;0
18076;143523;522;75;17;1;16;.941;3600000;0
18076;155664;1854;0;0;0;0;.00nan;0;0
18077;22413;2193;0;0;0;0;.00nan;0;0
18077;54290;1477;0;0;0;0;.00nan;0;0
18077;143191;2193;74;26;2;24;.923;3600000;0
18077;143256;1477;47;29;4;25;.862;3578000;0
18078;4618;523;0;0;0;0;.00nan;0;0
18078;46912;2173;97;44;3;41;.932;3600000;0
18078;53889;2173;0;0;0;0;.00nan;0;0
18078;56058;523;80;12;0;12;1.000;3600000;0
18079;177504;1869;74;31;2;29;.935;3600000;0
18079;164913;517;0;0;0;0;.00nan;0;0
18079;84287;1869;0;0;0;0;.00nan;0;0
18079;86283;517;56;34;4;30;.882;3600000;0
18080;55495;1871;0;0;0;0;.00nan;0;0
18080;56231;1861;0;0;0;0;.00nan;0;0
18080;63402;1871;78;30;3;27;.900;3900000;0
18080;89998;1861;86;34;3;31;.912;3900000;0
18081;177519;3922;65;24;2;22;.917;3600000;0
18081;172279;3922;0;0;0;0;.00nan;0;0
18081;68627;4962;59;32;4;28;.875;3552000;0
18081;152464;4962;0;0;0;0;.00nan;0;0
18082;8035;522;0;0;0;0;.00nan;0;0
18082;55495;1871;0;0;0;0;.00nan;0;0
18082;63402;1871;38;21;5;16;.762;3590000;0
18082;143523;522;76;27;2;25;.926;3600000;0
18083;177504;1869;0;0;0;0;.00nan;0;0
18083;56231;1861;0;0;0;0;.00nan;0;0
18083;84287;1869;60;30;4;26;.867;3557000;0
18083;89998;1861;38;14;3;11;.786;3600000;0
18084;8073;521;71;19;1;18;.947;3600000;0
18084;9373;1854;57;28;3;25;.893;3553000;0
18084;63830;521;0;0;0;0;.00nan;0;0
18084;155664;1854;0;0;0;0;.00nan;0;0
18085;4618;523;0;0;0;0;.00nan;0;0
18085;164913;517;100;37;0;37;1.000;3600000;0
18085;56058;523;32;21;5;16;.762;3600000;0
18085;86283;517;0;0;0;0;.00nan;0;0
18086;22413;2193;0;0;0;0;.00nan;0;0
18086;46912;2173;83;39;2;37;.949;3900000;0
18086;53889;2173;0;0;0;0;.00nan;0;0
18086;143191;2193;69;27;2;25;.926;3900000;0
18087;177519;3922;43;19;3;16;.842;3799000;0
18087;172279;3922;0;0;0;0;.00nan;0;0
18087;54290;1477;0;0;0;0;.00nan;0;0
18087;143256;1477;52;29;4;25;.862;3799000;0
18088;179830;1475;0;0;0;0;.00nan;0;0
18088;54658;1475;37;12;3;9;.750;3600000;0
18088;68627;4962;0;0;0;0;.00nan;0;0
18088;152464;4962;69;47;4;43;.915;3562000;0
18089;179830;1475;86;30;2;28;.933;3600000;0
18089;46912;2173;37;29;5;24;.828;3600000;0
18089;53889;2173;0;0;0;0;.00nan;0;0
18089;54658;1475;0;0;0;0;.00nan;0;0
18090;177519;3922;89;21;0;21;1.000;3900000;0
18090;172279;3922;0;0;0;0;.00nan;0;0
18090;9373;1854;100;35;0;35;1.000;3900000;0
18090;155664;1854;0;0;0;0;.00nan;0;0
18091;8073;521;0;0;0;0;.00nan;0;0
18091;56231;1861;0;0;0;0;.00nan;0;0
18091;63830;521;59;32;4;28;.875;3570000;0
18091;89998;1861;62;26;3;23;.885;3600000;0
18092;22413;2193;0;0;0;0;.00nan;0;0
18092;68627;4962;0;0;0;0;.00nan;0;0
18092;143191;2193;92;15;0;15;1.000;3600000;0
18092;152464;4962;86;47;3;44;.936;3600000;0
18093;4618;523;58;20;2;18;.900;3600000;0
18093;54290;1477;0;0;0;0;.00nan;0;0
18093;56058;523;0;0;0;0;.00nan;0;0
18093;143256;1477;50;36;5;31;.861;3600000;0
18094;177504;1869;83;39;3;36;.923;3600000;0
18094;8035;522;0;0;0;0;.00nan;0;0
18094;84287;1869;0;0;0;0;.00nan;0;0
18094;143523;522;76;26;2;24;.923;3600000;0
18095;164913;517;62;33;4;29;.879;3600000;0
18095;55495;1871;0;0;0;0;.00nan;0;0
18095;63402;1871;91;35;1;34;.971;3600000;0
18095;86283;517;0;0;0;0;.00nan;0;0
18096;8035;522;61;26;2;24;.923;3600000;0
18096;22413;2193;0;0;0;0;.00nan;0;0
18096;143191;2193;53;32;5;27;.844;3600000;0
18096;143523;522;0;0;0;0;.00nan;0;0
18097;4618;523;0;0;0;0;.00nan;0;0
18097;8073;521;87;42;2;40;.952;3600000;0
18097;56058;523;25;18;5;13;.722;3600000;0
18097;63830;521;0;0;0;0;.00nan;0;0
18098;164913;517;0;0;0;0;.00nan;0;0
18098;56231;1861;47;8;1;7;.875;872000;0
18098;86283;517;58;22;2;20;.909;3600000;0
18098;89998;1861;6;28;8;20;.714;2728000;0
18099;46912;2173;49;37;5;32;.865;3600000;0
18099;53889;2173;0;0;0;0;.00nan;0;0
18099;55495;1871;0;0;0;0;.00nan;0;0
18099;63402;1871;100;26;0;26;1.000;3600000;0
18100;177504;1869;58;27;4;23;.852;3600000;0
18100;54290;1477;0;0;0;0;.00nan;0;0
18100;84287;1869;0;0;0;0;.00nan;0;0
18100;143256;1477;87;31;1;30;.968;3600000;0
18101;9373;1854;33;28;5;23;.821;3600000;0
18101;68627;4962;0;0;0;0;.00nan;0;0
18101;152464;4962;100;27;0;27;1.000;3600000;0
18101;155664;1854;0;0;0;0;.00nan;0;0
18102;177519;3922;62;19;2;17;.895;3600000;0
18102;172279;3922;0;0;0;0;.00nan;0;0
18102;179830;1475;63;23;3;20;.870;3600000;0
18102;54658;1475;0;0;0;0;.00nan;0;0
18103;9373;1854;91;50;3;47;.940;3581000;0
18103;54290;1477;0;0;0;0;.00nan;0;0
18103;143256;1477;52;20;2;18;.900;3600000;0
18103;155664;1854;0;0;0;0;.00nan;0;0
18104;8035;522;0;0;0;0;.00nan;0;0
18104;56231;1861;0;0;0;0;.00nan;0;0
18104;89998;1861;65;29;3;26;.897;3600000;0
18104;143523;522;40;28;5;23;.821;3514000;0
18105;164913;517;0;0;0;0;.00nan;0;0
18105;46912;2173;98;54;3;51;.944;3900000;0
18105;53889;2173;0;0;0;0;.00nan;0;0
18105;86283;517;65;29;3;26;.897;3900000;0
18106;22413;2193;40;16;3;13;.813;3538000;0
18106;179830;1475;0;0;0;0;.00nan;0;0
18106;54658;1475;90;40;2;38;.950;3600000;0
18106;143191;2193;0;0;0;0;.00nan;0;0
18107;4618;523;0;0;0;0;.00nan;0;0
18107;56058;523;80;11;0;11;1.000;3600000;0
18107;68627;4962;0;0;0;0;.00nan;0;0
18107;152464;4962;86;47;3;44;.936;3600000;0
18108;177504;1869;0;0;0;0;.00nan;0;0
18108;177519;3922;63;27;3;24;.889;3807000;0
18108;172279;3922;0;0;0;0;.00nan;0;0
18108;84287;1869;60;32;4;28;.875;3807000;0
18109;8073;521;0;0;0;0;.00nan;0;0
18109;55495;1871;0;0;0;0;.00nan;0;0
18109;63402;1871;69;28;2;26;.929;3600000;0
18109;63830;521;75;36;3;33;.917;3572000;0
18110;9373;1854;72;28;2;26;.929;3600000;0
18110;179830;1475;0;0;0;0;.00nan;0;0
18110;54658;1475;42;18;3;15;.833;3600000;0
18110;155664;1854;0;0;0;0;.00nan;0;0
18111;4618;523;66;18;1;17;.944;3600000;0
18111;8035;522;0;0;0;0;.00nan;0;0
18111;56058;523;0;0;0;0;.00nan;0;0
18111;143523;522;67;49;6;43;.878;3600000;0
18112;8073;521;54;23;3;20;.870;3543000;0
18112;164913;517;0;0;0;0;.00nan;0;0
18112;63830;521;0;0;0;0;.00nan;0;0
18112;86283;517;77;21;1;20;.952;3600000;0
18113;46912;2173;70;25;1;24;.960;3600000;0
18113;53889;2173;0;0;0;0;.00nan;0;0
18113;56231;1861;0;0;0;0;.00nan;0;0
18113;89998;1861;94;37;2;35;.946;3581000;0
18114;13613;1871;0;0;0;0;.00nan;0;0
18114;54290;1477;0;0;0;0;.00nan;0;0
18114;63402;1871;60;35;4;31;.886;3567000;0
18114;143256;1477;68;26;2;24;.923;3600000;0
18115;177504;1869;52;12;2;10;.833;3600000;0
18115;68627;4962;85;45;3;42;.933;3567000;0
18115;84287;1869;0;0;0;0;.00nan;0;0
18115;152464;4962;0;0;0;0;.00nan;0;0
18116;177519;3922;75;21;1;20;.952;3600000;0
18116;172279;3922;0;0;0;0;.00nan;0;0
18116;22413;2193;0;0;0;0;.00nan;0;0
18116;143191;2193;75;30;2;28;.933;3560000;0
18117;9373;1854;99;35;2;33;.943;3600000;0
18117;22413;2193;0;0;0;0;.00nan;0;0
18117;143191;2193;53;23;3;20;.870;3543000;0
18117;155664;1854;0;0;0;0;.00nan;0;0
18118;54290;1477;0;0;0;0;.00nan;0;0
18118;56231;1861;0;0;0;0;.00nan;0;0
18118;89998;1861;68;37;4;33;.892;3586000;0
18118;143256;1477;83;28;2;26;.929;3600000;0
18119;8035;522;0;0;0;0;.00nan;0;0
18119;164913;517;0;0;0;0;.00nan;0;0
18119;86283;517;70;38;4;34;.895;3600000;0
18119;143523;522;46;29;5;24;.828;3572000;0
18120;8073;521;67;25;3;22;.880;2868000;0
18120;46912;2173;73;36;3;33;.917;3600000;0
18120;53889;2173;0;0;0;0;.00nan;0;0
18120;63830;521;15;6;4;2;.333;732000;0
18121;4618;523;72;23;1;22;.957;3600000;0
18121;177519;3922;64;37;4;33;.892;3600000;0
18121;172279;3922;0;0;0;0;.00nan;0;0
18121;56058;523;0;0;0;0;.00nan;0;0
18122;177504;1869;93;46;4;42;.913;3875000;0
18122;179830;1475;55;39;4;35;.897;3900000;0
18122;54658;1475;0;0;0;0;.00nan;0;0
18122;84287;1869;0;0;0;0;.00nan;0;0
18123;13613;1871;0;0;0;0;.00nan;0;0
18123;63402;1871;68;16;1;15;.938;3600000;0
18123;68627;4962;0;0;0;0;.00nan;0;0
18123;152464;4962;63;43;4;39;.907;3600000;0
18124;13613;1871;0;0;0;0;.00nan;0;0
18124;179830;1475;0;0;0;0;.00nan;0;0
18124;54658;1475;31;32;6;26;.813;3600000;0
18124;63402;1871;55;19;3;16;.842;3600000;0
18125;8035;522;75;35;3;32;.914;3563000;0
18125;8073;521;62;22;2;20;.909;3600000;0
18125;63830;521;0;0;0;0;.00nan;0;0
18125;143523;522;0;0;0;0;.00nan;0;0
18126;177504;1869;90;24;1;23;.958;3600000;0
18126;9373;1854;56;35;5;30;.857;3600000;0
18126;84287;1869;0;0;0;0;.00nan;0;0
18126;155664;1854;0;0;0;0;.00nan;0;0
18127;4618;523;32;28;6;22;.786;1918000;0
18127;22413;2193;0;0;0;0;.00nan;0;0
18127;56058;523;64;10;0;10;1.000;1682000;0
18127;143191;2193;82;36;3;33;.917;3600000;0
18128;46912;2173;74;32;2;30;.938;3900000;0
18128;53889;2173;0;0;0;0;.00nan;0;0
18128;54290;1477;0;0;0;0;.00nan;0;0
18128;143256;1477;68;23;2;21;.913;3900000;0
18129;56231;1861;0;0;0;0;.00nan;0;0
18129;68627;4962;0;0;0;0;.00nan;0;0
18129;89998;1861;76;21;1;20;.952;3600000;0
18129;152464;4962;76;34;2;32;.941;3600000;0
18130;177519;3922;64;28;3;25;.893;3557000;0
18130;172279;3922;0;0;0;0;.00nan;0;0
18130;164913;517;0;0;0;0;.00nan;0;0
18130;86283;517;73;30;2;28;.933;3600000;0
18131;9373;1854;75;38;4;34;.895;3600000;0
18131;56231;1861;0;0;0;0;.00nan;0;0
18131;89998;1861;66;28;3;25;.893;3600000;0
18131;155664;1854;0;0;0;0;.00nan;0;0
18132;8073;521;0;0;0;0;.00nan;0;0
18132;63830;521;63;15;1;14;.933;3600000;0
18132;68627;4962;0;0;0;0;.00nan;0;0
18132;152464;4962;62;29;3;26;.897;3513000;0
18133;164913;517;0;0;0;0;.00nan;0;0
18133;54290;1477;0;0;0;0;.00nan;0;0
18133;86283;517;84;27;1;26;.963;3600000;0
18133;143256;1477;61;32;3;29;.906;3534000;0
18134;8035;522;0;0;0;0;.00nan;0;0
18134;46912;2173;62;21;2;19;.905;3847000;0
18134;53889;2173;0;0;0;0;.00nan;0;0
18134;143523;522;84;34;1;33;.971;3854000;0
18135;4618;523;52;21;3;18;.857;3600000;0
18135;179830;1475;62;41;4;37;.902;3600000;0
18135;54658;1475;0;0;0;0;.00nan;0;0
18135;56058;523;0;0;0;0;.00nan;0;0
18136;177504;1869;0;0;0;0;.00nan;0;0
18136;22413;2193;0;0;0;0;.00nan;0;0
18136;84287;1869;78;33;2;31;.939;3542000;0
18136;143191;2193;89;26;1;25;.962;3600000;0
18137;177519;3922;67;31;3;28;.903;3590000;0
18137;172279;3922;0;0;0;0;.00nan;0;0
18137;13613;1871;0;0;0;0;.00nan;0;0
18137;63402;1871;78;33;2;31;.939;3600000;0
18138;179830;1475;0;0;0;0;.00nan;0;0
18138;54658;1475;88;31;1;30;.968;3600000;0
18138;56231;1861;0;0;0;0;.00nan;0;0
18138;89998;1861;50;23;4;19;.826;3600000;0
18139;9373;1854;49;1;0;1;1.000;281000;0
18139;13613;1871;0;0;0;0;.00nan;0;0
18139;63402;1871;55;20;2;18;.900;3600000;0
18139;155664;1854;39;37;6;31;.838;3319000;0
18140;164913;517;0;0;0;0;.00nan;0;0
18140;22413;2193;0;0;0;0;.00nan;0;0
18140;86283;517;69;31;3;28;.903;3531000;0
18140;143191;2193;95;33;1;32;.970;3600000;0
18141;8035;522;0;0;0;0;.00nan;0;0
18141;54290;1477;0;0;0;0;.00nan;0;0
18141;143256;1477;96;34;2;32;.941;3600000;0
18141;143523;522;92;30;1;29;.967;3600000;0
18142;4618;523;54;24;3;21;.875;3556000;0
18142;177504;1869;91;33;2;31;.939;3600000;0
18142;56058;523;0;0;0;0;.00nan;0;0
18142;84287;1869;0;0;0;0;.00nan;0;0
18143;46912;2173;44;19;3;16;.842;3600000;0
18143;53889;2173;0;0;0;0;.00nan;0;0
18143;68627;4962;33;5;2;3;.600;922000;0
18143;152464;4962;30;32;6;26;.813;2678000;0
18144;177519;3922;58;26;3;23;.885;3554000;0
18144;172279;3922;0;0;0;0;.00nan;0;0
18144;8073;521;75;27;2;25;.926;3600000;0
18144;63830;521;0;0;0;0;.00nan;0;0
18145;8035;522;62;27;3;24;.889;3600000;0
18145;68627;4962;56;33;4;29;.879;2811000;0
18145;143523;522;0;0;0;0;.00nan;0;0
18145;152464;4962;33;15;4;11;.733;789000;0
18146;177519;3922;87;32;1;31;.969;3600000;0
18146;172279;3922;0;0;0;0;.00nan;0;0
18146;56231;1861;0;0;0;0;.00nan;0;0
18146;89998;1861;68;30;3;27;.900;3596000;0
18147;8073;521;0;0;0;0;.00nan;0;0
18147;54290;1477;0;0;0;0;.00nan;0;0
18147;63830;521;84;27;2;25;.926;3541000;0
18147;143256;1477;92;21;0;21;1.000;3600000;0
18148;164913;517;0;0;0;0;.00nan;0;0
18148;179830;1475;75;32;2;30;.938;3568000;0
18148;54658;1475;0;0;0;0;.00nan;0;0
18148;86283;517;72;20;1;19;.950;3600000;0
18149;177504;1869;72;31;3;28;.903;3600000;0
18149;46912;2173;46;32;5;27;.844;3561000;0
18149;53889;2173;0;0;0;0;.00nan;0;0
18149;84287;1869;0;0;0;0;.00nan;0;0
18150;4618;523;73;9;0;9;1.000;3600000;0
18150;9373;1854;90;52;4;48;.923;3600000;0
18150;56058;523;0;0;0;0;.00nan;0;0
18150;155664;1854;0;0;0;0;.00nan;0;0
18151;13613;1871;0;0;0;0;.00nan;0;0
18151;22413;2193;51;8;1;7;.875;1190000;0
18151;63402;1871;53;29;4;25;.862;3600000;0
18151;143191;2193;19;17;6;11;.647;2410000;0
18152;177519;3922;100;25;0;25;1.000;3600000;0
18152;172279;3922;0;0;0;0;.00nan;0;0
18152;8035;522;0;0;0;0;.00nan;0;0
18152;143523;522;90;35;2;33;.943;3545000;0
18153;4618;523;100;25;0;25;1.000;3600000;0
18153;56058;523;0;0;0;0;.00nan;0;0
18153;56231;1861;0;0;0;0;.00nan;0;0
18153;89998;1861;95;37;1;36;.973;3584000;0
18154;8073;521;0;0;0;0;.00nan;0;0
18154;22413;2193;0;0;0;0;.00nan;0;0
18154;63830;521;66;24;2;22;.917;3543000;0
18154;143191;2193;78;25;1;24;.960;3600000;0
18155;164913;517;0;0;0;0;.00nan;0;0
18155;68627;4962;0;0;0;0;.00nan;0;0
18155;86283;517;39;17;3;14;.824;3569000;0
18155;152464;4962;99;45;2;43;.956;3600000;0
18156;9373;1854;99;45;1;44;.978;3600000;0
18156;46912;2173;65;26;2;24;.923;3545000;0
18156;53889;2173;0;0;0;0;.00nan;0;0
18156;155664;1854;0;0;0;0;.00nan;0;0
18157;179830;1475;74;33;2;31;.939;3600000;0
18157;54290;1477;0;0;0;0;.00nan;0;0
18157;54658;1475;0;0;0;0;.00nan;0;0
18157;143256;1477;69;17;1;16;.941;3600000;0
18158;177504;1869;69;22;2;20;.909;3600000;0
18158;13613;1871;0;0;0;0;.00nan;0;0
18158;63402;1871;54;25;3;22;.880;3560000;0
18158;84287;1869;0;0;0;0;.00nan;0;0
18159;8035;522;0;0;0;0;.00nan;0;0
18159;179830;1475;0;0;0;0;.00nan;0;0
18159;54658;1475;76;38;3;35;.921;3900000;0
18159;143523;522;72;29;3;26;.897;3900000;0
18160;9373;1854;58;49;6;43;.878;3600000;0
18160;164913;517;0;0;0;0;.00nan;0;0
18160;86283;517;65;13;1;12;.923;3600000;0
18160;155664;1854;0;0;0;0;.00nan;0;0
18161;22413;2193;59;13;1;12;.923;3600000;0
18161;56231;1861;0;0;0;0;.00nan;0;0
18161;89998;1861;73;46;4;42;.913;3600000;0
18161;143191;2193;0;0;0;0;.00nan;0;0
18162;4618;523;80;33;3;30;.909;3600000;0
18162;13613;1871;0;0;0;0;.00nan;0;0
18162;56058;523;0;0;0;0;.00nan;0;0
18162;63402;1871;65;37;4;33;.892;3560000;0
18163;177504;1869;77;24;1;23;.958;3600000;0
18163;8073;521;72;26;2;24;.923;3561000;0
18163;63830;521;0;0;0;0;.00nan;0;0
18163;84287;1869;0;0;0;0;.00nan;0;0
18164;54290;1477;0;0;0;0;.00nan;0;0
18164;68627;4962;55;33;4;29;.879;3600000;0
18164;143256;1477;80;15;0;15;1.000;3600000;0
18164;152464;4962;0;0;0;0;.00nan;0;0
18165;177519;3922;93;29;1;28;.966;3600000;0
18165;172279;3922;0;0;0;0;.00nan;0;0
18165;46912;2173;59;29;3;26;.897;3583000;0
18165;53889;2173;0;0;0;0;.00nan;0;0
18166;8035;522;0;0;0;0;.00nan;0;0
18166;9373;1854;98;49;2;47;.959;3560000;0
18166;143523;522;62;14;1;13;.929;3600000;0
18166;155664;1854;0;0;0;0;.00nan;0;0
18167;13613;1871;0;0;0;0;.00nan;0;0
18167;56231;1861;0;0;0;0;.00nan;0;0
18167;63402;1871;67;41;4;37;.902;3515000;0
18167;89998;1861;65;21;2;19;.905;3600000;0
18168;8073;521;0;0;0;0;.00nan;0;0
18168;179830;1475;73;37;3;34;.919;3600000;0
18168;54658;1475;0;0;0;0;.00nan;0;0
18168;63830;521;55;35;4;31;.886;3558000;0
18169;177504;1869;68;29;3;26;.897;3600000;0
18169;164913;517;0;0;0;0;.00nan;0;0
18169;84287;1869;0;0;0;0;.00nan;0;0
18169;86283;517;70;36;4;32;.889;3583000;0
18170;4618;523;45;13;2;11;.846;3594000;0
18170;46912;2173;100;35;1;34;.971;3600000;0
18170;53889;2173;0;0;0;0;.00nan;0;0
18170;56058;523;0;0;0;0;.00nan;0;0
18171;22413;2193;0;0;0;0;.00nan;0;0
18171;54290;1477;0;0;0;0;.00nan;0;0
18171;143191;2193;63;17;1;16;.941;3600000;0
18171;143256;1477;71;31;3;28;.903;3550000;0
18172;177519;3922;85;15;0;15;1.000;3600000;0
18172;172279;3922;0;0;0;0;.00nan;0;0
18172;68627;4962;0;0;0;0;.00nan;0;0
18172;152464;4962;78;31;1;30;.968;3575000;0
18173;179830;1475;0;0;0;0;.00nan;0;0
18173;54658;1475;74;28;2;26;.929;3600000;0
18173;68627;4962;56;18;2;16;.889;3117000;0
18173;152464;4962;27;9;3;6;.667;483000;0
18174;8073;521;0;0;0;0;.00nan;0;0
18174;9373;1854;72;45;5;40;.889;3567000;0
18174;63830;521;43;16;3;13;.813;3600000;0
18174;155664;1854;0;0;0;0;.00nan;0;0
18175;22413;2193;0;0;0;0;.00nan;0;0
18175;46912;2173;32;42;7;35;.833;3600000;0
18175;53889;2173;0;0;0;0;.00nan;0;0
18175;143191;2193;87;16;0;16;1.000;3600000;0
18176;4618;523;76;34;3;31;.912;3600000;0
18176;164913;517;0;0;0;0;.00nan;0;0
18176;56058;523;0;0;0;0;.00nan;0;0
18176;86283;517;67;44;5;39;.886;3563000;0
18177;177504;1869;0;0;0;0;.00nan;0;0
18177;56231;1861;0;0;0;0;.00nan;0;0
18177;84287;1869;65;16;1;15;.938;3600000;0
18177;89998;1861;55;30;4;26;.867;3600000;0
18178;8035;522;0;0;0;0;.00nan;0;0
18178;13613;1871;73;29;2;27;.931;3600000;0
18178;63402;1871;0;0;0;0;.00nan;0;0
18178;143523;522;23;26;6;20;.769;3600000;0
18179;177519;3922;100;23;0;23;1.000;3600000;0
18179;172279;3922;0;0;0;0;.00nan;0;0
18179;54290;1477;0;0;0;0;.00nan;0;0
18179;143256;1477;75;20;1;19;.950;3544000;0
18180;177504;1869;76;25;2;23;.920;3600000;0
18180;8035;522;0;0;0;0;.00nan;0;0
18180;84287;1869;0;0;0;0;.00nan;0;0
18180;143523;522;43;23;4;19;.826;3535000;0
18181;8073;521;49;32;4;28;.875;3556000;0
18181;56231;1861;0;0;0;0;.00nan;0;0
18181;63830;521;0;0;0;0;.00nan;0;0
18181;89998;1861;76;33;2;31;.939;3600000;0
18182;164913;517;0;0;0;0;.00nan;0;0
18182;13613;1871;0;0;0;0;.00nan;0;0
18182;63402;1871;51;36;5;31;.861;3600000;0
18182;86283;517;54;31;4;27;.871;3600000;0
18183;179830;1475;71;32;3;29;.906;3600000;0
18183;46912;2173;47;27;4;23;.852;3600000;0
18183;53889;2173;0;0;0;0;.00nan;0;0
18183;54658;1475;0;0;0;0;.00nan;0;0
18184;4618;523;66;24;2;22;.917;3600000;0
18184;54290;1477;0;0;0;0;.00nan;0;0
18184;56058;523;0;0;0;0;.00nan;0;0
18184;143256;1477;81;49;4;45;.918;3527000;0
18185;22413;2193;0;0;0;0;.00nan;0;0
18185;68627;4962;0;0;0;0;.00nan;0;0
18185;143191;2193;53;14;2;12;.857;3550000;0
18185;152464;4962;94;40;1;39;.975;3600000;0
18186;177519;3922;60;20;2;18;.900;3545000;0
18186;172279;3922;0;0;0;0;.00nan;0;0
18186;9373;1854;98;37;1;36;.973;3600000;0
18186;155664;1854;0;0;0;0;.00nan;0;0
18187;177519;3922;78;30;2;28;.933;3600000;0
18187;172279;3922;0;0;0;0;.00nan;0;0
18187;179830;1475;0;0;0;0;.00nan;0;0
18187;54658;1475;70;24;1;23;.958;3600000;0
18188;9373;1854;88;41;1;40;.976;3900000;0
18188;68627;4962;0;0;0;0;.00nan;0;0
18188;152464;4962;81;24;1;23;.958;3900000;0
18188;155664;1854;0;0;0;0;.00nan;0;0
18189;164913;517;0;0;0;0;.00nan;0;0
18189;56231;1861;0;0;0;0;.00nan;0;0
18189;86283;517;100;24;0;24;1.000;3900000;0
18189;89998;1861;97;38;0;38;1.000;3900000;0
18190;8035;522;0;0;0;0;.00nan;0;0
18190;22413;2193;54;26;3;23;.885;3576000;0
18190;143191;2193;0;0;0;0;.00nan;0;0
18190;143523;522;71;22;2;20;.909;3600000;0
18191;4618;523;0;0;0;0;.00nan;0;0
18191;8073;521;48;34;5;29;.853;3600000;0
18191;56058;523;52;28;4;24;.857;3600000;0
18191;63830;521;0;0;0;0;.00nan;0;0
18192;177504;1869;32;11;3;8;.727;399000;0
18192;54290;1477;0;0;0;0;.00nan;0;0
18192;84287;1869;83;25;1;24;.960;3501000;0
18192;143256;1477;52;25;4;21;.840;3900000;0
18193;13613;1871;0;0;0;0;.00nan;0;0
18193;46912;2173;75;41;3;38;.927;3580000;0
18193;53889;2173;0;0;0;0;.00nan;0;0
18193;63402;1871;46;14;2;12;.857;3600000;0
18194;22413;2193;0;0;0;0;.00nan;0;0
18194;179830;1475;64;39;5;34;.872;3600000;0
18194;54658;1475;0;0;0;0;.00nan;0;0
18194;143191;2193;71;25;2;23;.920;3600000;0
18195;8035;522;43;25;4;21;.840;3564000;0
18195;56231;1861;0;0;0;0;.00nan;0;0
18195;89998;1861;67;21;2;19;.905;3600000;0
18195;143523;522;0;0;0;0;.00nan;0;0
18196;8073;521;0;0;0;0;.00nan;0;0
18196;13613;1871;0;0;0;0;.00nan;0;0
18196;63402;1871;61;27;3;24;.889;3600000;0
18196;63830;521;69;37;4;33;.892;3588000;0
18197;164913;517;0;0;0;0;.00nan;0;0
18197;46912;2173;0;0;0;0;.00nan;0;0
18197;53889;2173;95;45;2;43;.956;3543000;0
18197;86283;517;71;22;1;21;.955;3600000;0
18198;9373;1854;59;26;3;23;.885;3600000;0
18198;54290;1477;0;0;0;0;.00nan;0;0
18198;143256;1477;69;30;4;26;.867;3571000;0
18198;155664;1854;0;0;0;0;.00nan;0;0
18199;4618;523;0;0;0;0;.00nan;0;0
18199;56058;523;57;20;3;17;.850;3600000;0
18199;68627;4962;66;40;4;36;.900;3584000;0
18199;152464;4962;0;0;0;0;.00nan;0;0
18200;177504;1869;70;41;5;36;.878;3542000;0
18200;177519;3922;80;32;3;29;.906;3600000;0
18200;172279;3922;0;0;0;0;.00nan;0;0
18200;84287;1869;0;0;0;0;.00nan;0;0
18201;9373;1854;82;29;2;27;.931;3900000;0
18201;179830;1475;0;0;0;0;.00nan;0;0
18201;54658;1475;59;24;2;22;.917;3900000;0
18201;155664;1854;0;0;0;0;.00nan;0;0
18202;46912;2173;100;23;0;23;1.000;3600000;0
18202;53889;2173;0;0;0;0;.00nan;0;0
18202;56231;1861;0;0;0;0;.00nan;0;0
18202;89998;1861;62;23;3;20;.870;3600000;0
18203;8073;521;73;34;3;31;.912;3564000;0
18203;164913;517;75;34;2;32;.941;3600000;0
18203;63830;521;0;0;0;0;.00nan;0;0
18203;86283;517;0;0;0;0;.00nan;0;0
18204;177519;3922;89;27;1;26;.963;3900000;0
18204;172279;3922;0;0;0;0;.00nan;0;0
18204;22413;2193;0;0;0;0;.00nan;0;0
18204;143191;2193;54;17;1;16;.941;3900000;0
18205;4618;523;42;11;2;9;.818;3600000;0
18205;8035;522;0;0;0;0;.00nan;0;0
18205;56058;523;0;0;0;0;.00nan;0;0
18205;143523;522;98;62;5;57;.919;3600000;0
18206;177504;1869;70;28;2;26;.929;3545000;0
18206;68627;4962;0;0;0;0;.00nan;0;0
18206;84287;1869;0;0;0;0;.00nan;0;0
18206;152464;4962;73;25;1;24;.960;3600000;0
18207;13613;1871;0;0;0;0;.00nan;0;0
18207;54290;1477;0;0;0;0;.00nan;0;0
18207;63402;1871;23;24;6;18;.750;3600000;0
18207;143256;1477;99;36;2;34;.944;3600000;0
18208;177504;1869;70;41;4;37;.902;3600000;0
18208;179830;1475;47;21;3;18;.857;3600000;0
18208;54658;1475;0;0;0;0;.00nan;0;0
18208;84287;1869;0;0;0;0;.00nan;0;0
18209;8035;522;0;0;0;0;.00nan;0;0
18209;164913;517;0;0;0;0;.00nan;0;0
18209;86283;517;85;28;1;27;.964;3600000;0
18209;143523;522;73;27;2;25;.926;3542000;0
18210;8073;521;0;0;0;0;.00nan;0;0
18210;46912;2173;72;40;3;37;.925;3576000;0
18210;53889;2173;0;0;0;0;.00nan;0;0
18210;63830;521;67;20;2;18;.900;3600000;0
18211;9373;1854;59;53;8;45;.849;3149000;0
18211;22413;2193;52;15;2;13;.867;3600000;0
18211;143191;2193;0;0;0;0;.00nan;0;0
18211;155664;1854;52;3;0;3;1.000;451000;0
18212;55495;1871;0;0;0;0;.00nan;0;0
18212;63402;1871;69;25;2;23;.920;3600000;0
18212;68627;4962;0;0;0;0;.00nan;0;0
18212;152464;4962;69;37;3;34;.919;3600000;0
18213;4618;523;0;0;0;0;.00nan;0;0
18213;177519;3922;63;24;2;22;.917;3850000;0
18213;172279;3922;0;0;0;0;.00nan;0;0
18213;56058;523;92;34;1;33;.971;3850000;0
18214;54290;1477;0;0;0;0;.00nan;0;0
18214;56231;1861;0;0;0;0;.00nan;0;0
18214;89998;1861;73;34;3;31;.912;3600000;0
18214;143256;1477;55;18;2;16;.889;3600000;0
18215;56231;1861;0;0;0;0;.00nan;0;0
18215;68627;4962;0;0;0;0;.00nan;0;0
18215;89998;1861;60;33;4;29;.879;3600000;0
18215;152464;4962;86;29;1;28;.966;3600000;0
18216;8035;522;0;0;0;0;.00nan;0;0
18216;8073;521;0;0;0;0;.00nan;0;0
18216;63830;521;88;40;3;37;.925;3600000;0
18216;143523;522;54;17;2;15;.882;3600000;0
18217;177519;3922;79;32;1;31;.969;3600000;0
18217;172279;3922;0;0;0;0;.00nan;0;0
18217;164913;517;0;0;0;0;.00nan;0;0
18217;86283;517;63;22;2;20;.909;3600000;0
18218;46912;2173;47;29;4;25;.862;3600000;0
18218;53889;2173;0;0;0;0;.00nan;0;0
18218;54290;1477;0;0;0;0;.00nan;0;0
18218;143256;1477;77;25;1;24;.960;3600000;0
18219;4618;523;76;29;2;27;.931;3600000;0
18219;22413;2193;67;44;5;39;.886;3600000;0
18219;56058;523;0;0;0;0;.00nan;0;0
18219;143191;2193;0;0;0;0;.00nan;0;0
18220;177504;1869;64;28;3;25;.893;3900000;0
18220;9373;1854;75;35;3;32;.914;3900000;0
18220;84287;1869;0;0;0;0;.00nan;0;0
18220;155664;1854;0;0;0;0;.00nan;0;0
18221;179830;1475;0;0;0;0;.00nan;0;0
18221;54658;1475;71;35;3;32;.914;3900000;0
18221;55495;1871;0;0;0;0;.00nan;0;0
18221;63402;1871;84;32;3;29;.906;3900000;0
18222;4618;523;0;0;0;0;.00nan;0;0
18222;179830;1475;79;31;2;29;.935;3600000;0
18222;54658;1475;0;0;0;0;.00nan;0;0
18222;56058;523;50;21;3;18;.857;3555000;0
18223;8035;522;41;23;4;19;.826;3600000;0
18223;46912;2173;78;24;1;23;.958;3600000;0
18223;53889;2173;0;0;0;0;.00nan;0;0
18223;143523;522;0;0;0;0;.00nan;0;0
18224;9373;1854;47;35;5;30;.857;3600000;0
18224;56231;1861;0;0;0;0;.00nan;0;0
18224;89998;1861;84;29;2;27;.931;3600000;0
18224;155664;1854;0;0;0;0;.00nan;0;0
18225;177504;1869;41;33;5;28;.848;3600000;0
18225;22413;2193;0;0;0;0;.00nan;0;0
18225;84287;1869;0;0;0;0;.00nan;0;0
18225;143191;2193;70;30;4;26;.867;3600000;0
18226;164913;517;0;0;0;0;.00nan;0;0
18226;54290;1477;0;0;0;0;.00nan;0;0
18226;86283;517;76;26;3;23;.885;3900000;0
18226;143256;1477;85;36;3;33;.917;3900000;0
18227;8073;521;0;0;0;0;.00nan;0;0
18227;63830;521;76;30;2;28;.933;3544000;0
18227;68627;4962;87;31;1;30;.968;3600000;0
18227;152464;4962;0;0;0;0;.00nan;0;0
18228;177519;3922;56;37;5;32;.865;3517000;0
18228;172279;3922;0;0;0;0;.00nan;0;0
18228;55495;1871;0;0;0;0;.00nan;0;0
18228;63402;1871;65;29;3;26;.897;3600000;0
18229;8035;522;0;0;0;0;.00nan;0;0
18229;54290;1477;0;0;0;0;.00nan;0;0
18229;143256;1477;84;38;2;36;.947;3900000;0
18229;143523;522;80;34;2;32;.941;3900000;0
18230;179830;1475;0;0;0;0;.00nan;0;0
18230;54658;1475;54;25;3;22;.880;3600000;0
18230;56231;1861;0;0;0;0;.00nan;0;0
18230;89998;1861;100;31;0;31;1.000;3600000;0
18231;177519;3922;76;42;3;39;.929;3600000;0
18231;172279;3922;0;0;0;0;.00nan;0;0
18231;8073;521;39;27;5;22;.815;3541000;0
18231;63830;521;0;0;0;0;.00nan;0;0
18232;164913;517;0;0;0;0;.00nan;0;0
18232;22413;2193;0;0;0;0;.00nan;0;0
18232;86283;517;100;51;3;48;.941;3900000;0
18232;143191;2193;80;36;3;33;.917;3900000;0
18233;46912;2173;48;31;5;26;.839;3600000;0
18233;53889;2173;0;0;0;0;.00nan;0;0
18233;68627;4962;0;0;0;0;.00nan;0;0
18233;152464;4962;72;27;3;24;.889;3600000;0
18234;4618;523;91;19;0;19;1.000;3600000;0
18234;177504;1869;60;30;3;27;.900;3600000;0
18234;56058;523;0;0;0;0;.00nan;0;0
18234;84287;1869;0;0;0;0;.00nan;0;0
18235;9373;1854;35;35;6;29;.829;3577000;0
18235;55495;1871;0;0;0;0;.00nan;0;0
18235;63402;1871;42;22;4;18;.818;3600000;0
18235;155664;1854;0;0;0;0;.00nan;0;0
18236;164913;517;0;0;0;0;.00nan;0;0
18236;179830;1475;100;36;0;36;1.000;3600000;0
18236;54658;1475;0;0;0;0;.00nan;0;0
18236;86283;517;75;29;2;27;.931;3544000;0
18237;4618;523;48;14;2;12;.857;3511000;0
18237;9373;1854;100;31;0;31;1.000;3600000;0
18237;56058;523;0;0;0;0;.00nan;0;0
18237;155664;1854;0;0;0;0;.00nan;0;0
18238;22413;2193;0;0;0;0;.00nan;0;0
18238;55495;1871;0;0;0;0;.00nan;0;0
18238;63402;1871;78;17;1;16;.941;3600000;0
18238;143191;2193;33;32;6;26;.813;3600000;0
18239;8073;521;0;0;0;0;.00nan;0;0
18239;54290;1477;56;27;4;23;.852;3600000;0
18239;63830;521;12;27;7;20;.741;3600000;0
18239;143256;1477;0;0;0;0;.00nan;0;0
18240;177504;1869;0;0;0;0;.00nan;0;0
18240;46912;2173;100;33;0;33;1.000;3600000;0
18240;53889;2173;0;0;0;0;.00nan;0;0
18240;84287;1869;75;35;2;33;.943;3530000;0
18241;8035;522;0;0;0;0;.00nan;0;0
18241;68627;4962;0;0;0;0;.00nan;0;0
18241;143523;522;67;20;2;18;.900;3600000;0
18241;152464;4962;67;55;6;49;.891;3600000;0
18242;177519;3922;0;0;0;0;.00nan;0;0
18242;172279;3922;55;20;2;18;.900;3587000;0
18242;56231;1861;0;0;0;0;.00nan;0;0
18242;89998;1861;86;28;1;27;.964;3600000;0
18244;177519;3922;43;19;3;16;.842;3600000;0
18244;172279;3922;0;0;0;0;.00nan;0;0
18244;8073;521;54;3;0;3;1.000;240000;0
18244;63830;521;47;43;6;37;.860;3360000;0
18246;22413;2193;0;0;0;0;.00nan;0;0
18246;56231;1861;0;0;0;0;.00nan;0;0
18246;89998;1861;20;47;10;37;.787;3600000;0
18246;143191;2193;70;21;1;20;.952;3600000;0
18248;4618;523;34;19;4;15;.789;3600000;0
18248;56058;523;0;0;0;0;.00nan;0;0
18248;73973;517;42;32;5;27;.844;3579000;0
18248;147264;517;0;0;0;0;.00nan;0;0
18250;8035;522;0;0;0;0;.00nan;0;0
18250;13613;1871;0;0;0;0;.00nan;0;0
18250;63402;1871;69;25;1;24;.960;3600000;0
18250;143523;522;88;45;3;42;.933;3558000;0
18252;177504;1869;0;0;0;0;.00nan;0;0
18252;9373;1854;76;39;3;36;.923;3900000;0
18252;84287;1869;73;33;3;30;.909;3900000;0
18252;155664;1854;0;0;0;0;.00nan;0;0
18254;179830;1475;71;29;2;27;.931;3600000;0
18254;54658;1475;0;0;0;0;.00nan;0;0
18254;68627;4962;0;0;0;0;.00nan;0;0
18254;152464;4962;72;23;1;22;.957;3600000;0
18256;46912;2173;85;38;2;36;.947;3600000;0
18256;53889;2173;0;0;0;0;.00nan;0;0
18256;54290;1477;0;0;0;0;.00nan;0;0
18256;143256;1477;52;23;3;20;.870;3587000;0
18258;13613;1871;59;26;3;23;.885;3600000;0
18258;22413;2193;62;18;2;16;.889;3600000;0
18258;63402;1871;0;0;0;0;.00nan;0;0
18258;143191;2193;0;0;0;0;.00nan;0;0
18260;8035;522;52;25;3;22;.880;3600000;0
18260;68627;4962;42;46;7;39;.848;3600000;0
18260;143523;522;0;0;0;0;.00nan;0;0
18260;152464;4962;0;0;0;0;.00nan;0;0
18262;4618;523;0;0;0;0;.00nan;0;0
18262;46912;2173;0;0;0;0;.00nan;0;0
18262;53889;2173;81;28;2;26;.929;3574000;0
18262;56058;523;95;16;0;16;1.000;3600000;0
18264;177519;3922;0;0;0;0;.00nan;0;0
18264;172279;3922;84;28;1;27;.964;3600000;0
18264;56231;1861;43;29;5;24;.828;3600000;0
18264;89998;1861;0;0;0;0;.00nan;0;0
18266;179830;1475;0;0;0;0;.00nan;0;0
18266;54658;1475;60;37;4;33;.892;3525000;0
18266;73973;517;0;0;0;0;.00nan;0;0
18266;147264;517;58;20;2;18;.900;3600000;0
18268;8073;521;64;18;1;17;.944;3600000;0
18268;9373;1854;0;0;0;0;.00nan;0;0
18268;63830;521;0;0;0;0;.00nan;0;0
18268;155664;1854;60;38;5;33;.868;3600000;0
18270;177504;1869;100;37;1;36;.973;3600000;0
18270;54290;1477;56;25;3;22;.880;3600000;0
18270;84287;1869;0;0;0;0;.00nan;0;0
18270;143256;1477;0;0;0;0;.00nan;0;0
18272;22413;2193;0;0;0;0;.00nan;0;0
18272;68627;4962;92;47;3;44;.936;3579000;0
18272;143191;2193;66;23;2;21;.913;3600000;0
18272;152464;4962;0;0;0;0;.00nan;0;0
18274;4618;523;0;0;0;0;.00nan;0;0
18274;177504;1869;28;15;4;11;.733;2244000;0
18274;56058;523;40;16;3;13;.813;3600000;0
18274;84287;1869;63;15;1;14;.933;1334000;0
18276;8073;521;0;0;0;0;.00nan;0;0
18276;54290;1477;0;0;0;0;.00nan;0;0
18276;63830;521;91;35;1;34;.971;3600000;0
18276;143256;1477;69;27;2;25;.926;3590000;0
18278;9373;1854;76;36;3;33;.917;3600000;0
18278;46912;2173;43;25;4;21;.840;3572000;0
18278;53889;2173;0;0;0;0;.00nan;0;0
18278;155664;1854;0;0;0;0;.00nan;0;0
18280;8035;522;0;0;0;0;.00nan;0;0
18280;179830;1475;84;35;2;33;.943;3714000;0
18280;54658;1475;0;0;0;0;.00nan;0;0
18280;143523;522;72;19;1;18;.947;3714000;0
18282;177519;3922;54;32;3;29;.906;3600000;0
18282;172279;3922;0;0;0;0;.00nan;0;0
18282;73973;517;93;19;0;19;1.000;3600000;0
18282;147264;517;0;0;0;0;.00nan;0;0
18284;13613;1871;0;0;0;0;.00nan;0;0
18284;56231;1861;0;0;0;0;.00nan;0;0
18284;63402;1871;87;18;0;18;1.000;3600000;0
18284;89998;1861;70;41;5;36;.878;3600000;0
18286;8073;521;84;31;2;29;.935;3744000;0
18286;63830;521;0;0;0;0;.00nan;0;0
18286;68627;4962;0;0;0;0;.00nan;0;0
18286;152464;4962;86;32;3;29;.906;3744000;0
18288;4618;523;54;28;4;24;.857;3600000;0
18288;22413;2193;73;43;5;38;.884;3548000;0
18288;56058;523;0;0;0;0;.00nan;0;0
18288;143191;2193;0;0;0;0;.00nan;0;0
18290;179830;1475;0;0;0;0;.00nan;0;0
18290;54658;1475;77;28;2;26;.929;3600000;0
18290;73973;517;20;32;7;25;.781;3208000;0
18290;147264;517;50;1;0;1;1.000;392000;0
18292;9373;1854;0;0;0;0;.00nan;0;0
18292;54290;1477;38;19;4;15;.789;3600000;0
18292;143256;1477;0;0;0;0;.00nan;0;0
18292;155664;1854;92;46;3;43;.935;3600000;0
18294;177504;1869;0;0;0;0;.00nan;0;0
18294;56231;1861;28;19;5;14;.737;2164000;0
18294;84287;1869;93;33;1;32;.970;3600000;0
18294;89998;1861;58;13;1;12;.923;1436000;0
18296;177519;3922;0;0;0;0;.00nan;0;0
18296;172279;3922;79;31;2;29;.935;3600000;0
18296;8035;522;57;27;4;23;.852;3544000;0
18296;143523;522;0;0;0;0;.00nan;0;0
18298;13613;1871;0;0;0;0;.00nan;0;0
18298;46912;2173;0;0;0;0;.00nan;0;0
18298;53889;2173;94;48;2;46;.958;3600000;0
18298;63402;1871;33;21;5;16;.762;3600000;0
18300;177504;1869;0;0;0;0;.00nan;0;0
18300;56231;1861;0;0;0;0;.00nan;0;0
18300;84287;1869;79;34;2;32;.941;3600000;0
18300;89998;1861;67;33;3;30;.909;3569000;0
18302;8035;522;0;0;0;0;.00nan;0;0
18302;46912;2173;98;43;2;41;.953;3600000;0
18302;53889;2173;0;0;0;0;.00nan;0;0
18302;143523;522;61;28;3;25;.893;3579000;0
18304;4618;523;0;0;0;0;.00nan;0;0
18304;9373;1854;91;65;5;60;.923;3600000;0
18304;56058;523;53;11;2;9;.818;3600000;0
18304;155664;1854;0;0;0;0;.00nan;0;0
18306;8073;521;0;0;0;0;.00nan;0;0
18306;63830;521;83;33;2;31;.939;3608000;0
18306;68627;4962;78;24;1;23;.958;3608000;0
18306;152464;4962;0;0;0;0;.00nan;0;0
18308;22413;2193;0;0;0;0;.00nan;0;0
18308;73973;517;0;0;0;0;.00nan;0;0
18308;143191;2193;70;29;3;26;.897;3600000;0
18308;147264;517;81;42;4;38;.905;3600000;0
18310;179830;1475;33;31;6;25;.806;3600000;0
18310;54290;1477;0;0;0;0;.00nan;0;0
18310;54658;1475;0;0;0;0;.00nan;0;0
18310;143256;1477;82;13;0;13;1.000;3600000;0
18312;177519;3922;59;36;4;32;.889;3600000;0
18312;172279;3922;0;0;0;0;.00nan;0;0
18312;13613;1871;0;0;0;0;.00nan;0;0
18312;63402;1871;88;16;0;16;1.000;3600000;0
18314;8073;521;0;0;0;0;.00nan;0;0
18314;13613;1871;0;0;0;0;.00nan;0;0
18314;63402;1871;66;30;3;27;.900;3558000;0
18314;63830;521;88;38;2;36;.947;3600000;0
18316;4618;523;0;0;0;0;.00nan;0;0
18316;177504;1869;0;0;0;0;.00nan;0;0
18316;56058;523;61;23;3;20;.870;3535000;0
18316;84287;1869;85;35;1;34;.971;3600000;0
18318;46912;2173;51;30;5;25;.833;3600000;0
18318;53889;2173;0;0;0;0;.00nan;0;0
18318;56231;1861;54;25;4;21;.840;3600000;0
18318;89998;1861;0;0;0;0;.00nan;0;0
18320;68627;4962;84;32;2;30;.938;3600000;0
18320;73973;517;43;17;3;14;.824;3544000;0
18320;147264;517;0;0;0;0;.00nan;0;0
18320;152464;4962;0;0;0;0;.00nan;0;0
18322;9373;1854;75;40;3;37;.925;3519000;0
18322;22413;2193;52;10;1;9;.900;3600000;0
18322;143191;2193;0;0;0;0;.00nan;0;0
18322;155664;1854;0;0;0;0;.00nan;0;0
18324;177519;3922;65;39;5;34;.872;3521000;0
18324;172279;3922;0;0;0;0;.00nan;0;0
18324;179830;1475;56;23;3;20;.870;3600000;0
18324;54658;1475;0;0;0;0;.00nan;0;0
18326;8035;522;0;0;0;0;.00nan;0;0
18326;54290;1477;61;6;0;6;1.000;830000;0
18326;143256;1477;13;18;6;12;.667;2690000;0
18326;143523;522;52;25;4;21;.840;3600000;0
18328;177504;1869;76;42;4;38;.905;3576000;0
18328;13613;1871;82;28;2;26;.929;3600000;0
18328;63402;1871;0;0;0;0;.00nan;0;0
18328;84287;1869;0;0;0;0;.00nan;0;0
18330;177519;3922;0;0;0;0;.00nan;0;0
18330;172279;3922;77;29;2;27;.931;3861000;0
18330;8073;521;88;37;1;36;.973;3861000;0
18330;63830;521;0;0;0;0;.00nan;0;0
18332;4618;523;88;37;2;35;.946;3600000;0
18332;56058;523;0;0;0;0;.00nan;0;0
18332;73973;517;0;0;0;0;.00nan;0;0
18332;147264;517;44;31;4;27;.871;3562000;0
18334;8035;522;0;0;0;0;.00nan;0;0
18334;9373;1854;0;0;0;0;.00nan;0;0
18334;143523;522;72;19;2;17;.895;3600000;0
18334;155664;1854;91;54;4;50;.926;3523000;0
18336;179830;1475;0;0;0;0;.00nan;0;0
18336;54658;1475;44;25;5;20;.800;3524000;0
18336;68627;4962;0;0;0;0;.00nan;0;0
18336;152464;4962;89;43;3;40;.930;3600000;0
18338;46912;2173;0;0;0;0;.00nan;0;0
18338;53889;2173;43;29;5;24;.828;3600000;0
18338;56231;1861;0;0;0;0;.00nan;0;0
18338;89998;1861;95;33;1;32;.970;3600000;0
18340;22413;2193;0;0;0;0;.00nan;0;0
18340;54290;1477;54;30;5;25;.833;3555000;0
18340;143191;2193;59;27;3;24;.889;3600000;0
18340;143256;1477;0;0;0;0;.00nan;0;0
69;4618;523;0;0;0;0;.00nan;0;0
69;177504;1869;39;34;6;28;.824;3151000;0
69;56058;523;40;17;4;13;.765;3600000;0
69;84287;1869;46;4;1;3;.750;429000;0
70;8035;522;0;0;0;0;.00nan;0;0
70;55495;1871;0;0;0;0;.00nan;0;0
70;63402;1871;80;18;0;18;1.000;3600000;0
70;143523;522;74;35;3;32;.914;3600000;0
71;177519;3922;37;29;5;24;.828;3600000;0
71;172279;3922;0;0;0;0;.00nan;0;0
71;164913;517;0;0;0;0;.00nan;0;0
71;86283;517;87;16;0;16;1.000;3600000;0
72;22413;2193;0;0;0;0;.00nan;0;0
72;54290;1477;0;0;0;0;.00nan;0;0
72;143191;2193;81;34;2;32;.941;3600000;0
72;143256;1477;52;29;4;25;.862;3552000;0
73;4618;523;64;20;1;19;.950;3600000;0
73;177504;1869;62;37;5;32;.865;3600000;0
73;56058;523;0;0;0;0;.00nan;0;0
73;84287;1869;0;0;0;0;.00nan;0;0
74;8035;522;0;0;0;0;.00nan;0;0
74;55495;1871;0;0;0;0;.00nan;0;0
74;63402;1871;43;27;5;22;.815;3600000;0
74;143523;522;63;22;2;20;.909;3600000;0
75;177519;3922;61;34;4;30;.882;3600000;0
75;172279;3922;0;0;0;0;.00nan;0;0
75;164913;517;0;0;0;0;.00nan;0;0
75;86283;517;68;24;2;22;.917;3600000;0
76;22413;2193;0;0;0;0;.00nan;0;0
76;54290;1477;0;0;0;0;.00nan;0;0
76;143191;2193;67;15;1;14;.933;3600000;0
76;143256;1477;76;34;3;31;.912;3555000;0
77;4618;523;50;27;4;23;.852;3821000;0
77;177504;1869;55;34;5;29;.853;3821000;0
77;56058;523;0;0;0;0;.00nan;0;0
77;84287;1869;0;0;0;0;.00nan;0;0
78;8035;522;0;0;0;0;.00nan;0;0
78;55495;1871;0;0;0;0;.00nan;0;0
78;63402;1871;70;28;3;25;.893;3625000;0
78;143523;522;71;27;2;25;.926;3625000;0
79;177519;3922;63;28;3;25;.893;3590000;0
79;172279;3922;0;0;0;0;.00nan;0;0
79;164913;517;0;0;0;0;.00nan;0;0
79;86283;517;71;22;2;20;.909;3600000;0
80;22413;2193;0;0;0;0;.00nan;0;0
80;54290;1477;62;21;3;18;.857;3006000;0
80;143191;2193;61;14;2;12;.857;3600000;0
80;143256;1477;25;13;4;9;.692;594000;0
293;8035;522;0;0;0;0;.00nan;0;0
293;55495;1871;0;0;0;0;.00nan;0;0
293;63402;1871;100;36;1;35;.972;3600000;0
293;143523;522;67;30;3;27;.900;3517000;0
406;8035;522;0;0;0;0;.00nan;0;0
406;55495;1871;0;0;0;0;.00nan;0;0
406;63402;1871;100;25;0;25;1.000;3600000;0
406;143523;522;38;22;4;18;.818;3600000;0
494;4618;523;80;22;1;21;.955;3600000;0
494;22413;2193;0;0;0;0;.00nan;0;0
494;56058;523;0;0;0;0;.00nan;0;0
494;143191;2193;55;43;6;37;.860;3600000;0
495;164913;517;0;0;0;0;.00nan;0;0
495;55495;1871;0;0;0;0;.00nan;0;0
495;63402;1871;83;38;4;34;.895;3600000;0
495;86283;517;96;34;1;33;.971;3600000;0
496;4618;523;63;25;2;23;.920;3600000;0
496;22413;2193;0;0;0;0;.00nan;0;0
496;56058;523;0;0;0;0;.00nan;0;0
496;143191;2193;52;30;4;26;.867;3585000;0
497;164913;517;0;0;0;0;.00nan;0;0
497;55495;1871;0;0;0;0;.00nan;0;0
497;63402;1871;65;35;3;32;.914;3568000;0
497;86283;517;66;18;1;17;.944;3600000;0
498;4618;523;74;34;3;31;.912;5308000;0
498;22413;2193;0;0;0;0;.00nan;0;0
498;56058;523;0;0;0;0;.00nan;0;0
498;143191;2193;73;36;2;34;.944;5308000;0
499;164913;517;0;0;0;0;.00nan;0;0
499;55495;1871;0;0;0;0;.00nan;0;0
499;63402;1871;47;24;3;21;.875;3600000;0
499;86283;517;100;36;0;36;1.000;3600000;0
500;4618;523;62;21;2;19;.905;3600000;0
500;22413;2193;0;0;0;0;.00nan;0;0
500;56058;523;0;0;0;0;.00nan;0;0
500;143191;2193;51;44;5;39;.886;3600000;0
501;164913;517;0;0;0;0;.00nan;0;0
501;55495;1871;0;0;0;0;.00nan;0;0
501;63402;1871;54;26;4;22;.846;3596000;0
501;86283;517;54;24;3;21;.875;3600000;0
685;4618;523;94;20;0;20;1.000;3600000;0
685;22413;2193;0;0;0;0;.00nan;0;0
685;56058;523;0;0;0;0;.00nan;0;0
685;143191;2193;84;31;2;29;.935;3567000;0
719;4618;523;95;19;0;19;1.000;3600000;0
719;164913;517;0;0;0;0;.00nan;0;0
719;56058;523;0;0;0;0;.00nan;0;0
719;86283;517;79;40;4;36;.900;3600000;0
720;4618;523;74;27;3;24;.889;3600000;0
720;164913;517;0;0;0;0;.00nan;0;0
720;56058;523;0;0;0;0;.00nan;0;0
720;86283;517;48;27;4;23;.852;3543000;0
721;4618;523;45;18;3;15;.833;3561000;0
721;164913;517;0;0;0;0;.00nan;0;0
721;56058;523;0;0;0;0;.00nan;0;0
721;86283;517;68;23;2;21;.913;3600000;0
722;4618;523;54;32;4;28;.875;2390000;0
722;164913;517;0;0;0;0;.00nan;0;0
722;56058;523;58;11;1;10;.909;1210000;0
722;86283;517;76;20;1;19;.950;3600000;0
976;4618;523;0;0;0;0;.00nan;0;0
976;164913;517;0;0;0;0;.00nan;0;0
976;56058;523;74;30;2;28;.933;3562000;0
976;86283;517;89;30;1;29;.967;3600000;0
1004;4618;523;0;0;0;0;.00nan;0;0
1004;164913;517;0;0;0;0;.00nan;0;0
1004;56058;523;51;28;4;24;.857;4088000;0
1004;86283;517;64;33;3;30;.909;4088000;0
18341;13065;1920;0;0;0;0;.00nan;0;0
18341;40087;1923;0;0;0;0;.00nan;0;0
18341;40088;1923;77;23;1;22;.957;3600000;0
18341;61999;1920;64;41;4;37;.902;3600000;0
18342;11352;1931;0;0;0;0;.00nan;0;0
18342;19010;1931;46;35;5;30;.857;3600000;0
18342;20196;2287;0;0;0;0;.00nan;0;0
18342;169478;2287;72;20;1;19;.950;3600000;0
18343;170037;4794;70;28;2;26;.929;3600000;0
18343;67454;1933;0;0;0;0;.00nan;0;0
18343;155945;1933;76;48;4;44;.917;3600000;0
18343;161069;4794;0;0;0;0;.00nan;0;0
18344;11687;1934;91;41;1;40;.976;3600000;0
18344;56653;1934;0;0;0;0;.00nan;0;0
18344;143879;1930;0;0;0;0;.00nan;0;0
18344;155917;1930;38;20;4;16;.800;3600000;0
18345;185240;2259;43;23;4;19;.826;3600000;0
18345;50683;579;47;41;6;35;.854;3192000;0
18345;56155;2259;0;0;0;0;.00nan;0;0
18345;89930;579;44;3;1;2;.667;372000;0
18346;50683;579;74;25;1;24;.960;3600000;0
18346;67454;1933;0;0;0;0;.00nan;0;0
18346;89930;579;0;0;0;0;.00nan;0;0
18346;155945;1933;83;45;4;41;.911;3600000;0
18347;19473;582;89;33;2;31;.939;3600000;0
18347;20196;2287;61;26;3;23;.885;3551000;0
18347;169478;2287;0;0;0;0;.00nan;0;0
18347;32255;582;0;0;0;0;.00nan;0;0
18348;11352;1931;70;33;3;30;.909;3600000;0
18348;14259;584;0;0;0;0;.00nan;0;0
18348;56480;584;47;23;4;19;.826;3559000;0
18348;161180;1931;0;0;0;0;.00nan;0;0
18349;170037;4794;0;0;0;0;.00nan;0;0
18349;185240;2259;78;25;1;24;.960;3600000;0
18349;56155;2259;0;0;0;0;.00nan;0;0
18349;161069;4794;86;52;4;48;.923;3600000;0
18350;14259;584;0;0;0;0;.00nan;0;0
18350;-1;1934;52;43;6;37;.860;2896000;0
18350;56480;584;48;22;3;19;.864;3600000;0
18350;56653;1934;44;4;1;3;.750;704000;0
18351;-1;1934;98;41;1;40;.976;3600000;0
18351;19473;582;0;0;0;0;.00nan;0;0
18351;32255;582;32;25;5;20;.800;3600000;0
18351;56653;1934;0;0;0;0;.00nan;0;0
18352;67454;1933;0;0;0;0;.00nan;0;0
18352;143879;1930;72;22;2;20;.909;3600000;0
18352;155917;1930;0;0;0;0;.00nan;0;0
18352;155945;1933;30;30;6;24;.800;3600000;0
18353;40087;1923;0;0;0;0;.00nan;0;0
18353;40088;1923;72;31;3;28;.903;3600000;0
18353;67454;1933;34;45;8;37;.822;3600000;0
18353;155945;1933;0;0;0;0;.00nan;0;0
18354;14259;584;0;0;0;0;.00nan;0;0
18354;19473;582;0;0;0;0;.00nan;0;0
18354;32255;582;35;35;7;28;.800;3600000;0
18354;56480;584;55;20;3;17;.850;3600000;0
18355;170037;4794;0;0;0;0;.00nan;0;0
18355;143879;1930;57;25;3;22;.880;3900000;0
18355;155917;1930;0;0;0;0;.00nan;0;0
18355;161069;4794;83;39;3;36;.923;3900000;0
18356;11352;1931;51;10;1;9;.900;865000;0
18356;185240;2259;67;21;2;19;.905;3600000;0
18356;56155;2259;0;0;0;0;.00nan;0;0
18356;161180;1931;28;38;7;31;.816;2735000;0
18357;20196;2287;68;27;3;24;.889;3600000;0
18357;169478;2287;0;0;0;0;.00nan;0;0
18357;50683;579;40;34;6;28;.824;2767000;0
18357;89930;579;39;11;2;9;.818;833000;0
18358;13065;1920;88;34;2;32;.941;3900000;0
18358;20196;2287;0;0;0;0;.00nan;0;0
18358;169478;2287;75;31;2;29;.935;3900000;0
18358;61999;1920;0;0;0;0;.00nan;0;0
18359;11352;1931;0;0;0;0;.00nan;0;0
18359;14259;584;21;20;6;14;.700;3741000;0
18359;56480;584;0;0;0;0;.00nan;0;0
18359;161180;1931;60;43;5;38;.884;3741000;0
18360;14259;584;60;28;3;25;.893;3600000;0
18360;170037;4794;52;30;4;26;.867;2157000;0
18360;56480;584;0;0;0;0;.00nan;0;0
18360;161069;4794;7;22;7;15;.682;1443000;0
18361;13065;1920;40;19;4;15;.789;3600000;0
18361;50683;579;35;31;5;26;.839;3592000;0
18361;61999;1920;0;0;0;0;.00nan;0;0
18361;89930;579;0;0;0;0;.00nan;0;0
18362;185240;2259;55;25;3;22;.880;3600000;0
18362;56155;2259;0;0;0;0;.00nan;0;0
18362;67454;1933;69;47;5;42;.894;3583000;0
18362;155945;1933;0;0;0;0;.00nan;0;0
18363;19473;582;0;0;0;0;.00nan;0;0
18363;32255;582;42;46;7;39;.848;3600000;0
18363;143879;1930;72;23;2;21;.913;3600000;0
18363;155917;1930;0;0;0;0;.00nan;0;0
18364;20196;2287;0;0;0;0;.00nan;0;0
18364;169478;2287;43;25;4;21;.840;3600000;0
18364;40087;1923;100;31;0;31;1.000;3600000;0
18364;40088;1923;0;0;0;0;.00nan;0;0
18365;19473;582;33;35;6;29;.829;3600000;0
18365;32255;582;0;0;0;0;.00nan;0;0
18365;67454;1933;0;0;0;0;.00nan;0;0
18365;155945;1933;68;31;3;28;.903;3600000;0
18366;170037;4794;32;36;7;29;.806;3580000;0
18366;50683;579;0;0;0;0;.00nan;0;0
18366;89930;579;21;20;5;15;.750;3600000;0
18366;161069;4794;0;0;0;0;.00nan;0;0
18367;-1;1934;0;0;0;0;.00nan;0;0
18367;185240;2259;0;0;0;0;.00nan;0;0
18367;56155;2259;65;32;3;29;.906;3600000;0
18367;56653;1934;56;31;5;26;.839;3600000;0
18368;11352;1931;0;0;0;0;.00nan;0;0
18368;40087;1923;0;0;0;0;.00nan;0;0
18368;40088;1923;66;31;3;28;.903;3552000;0
18368;161180;1931;83;33;2;31;.939;3600000;0
18369;40087;1923;63;20;2;18;.900;3600000;0
18369;40088;1923;0;0;0;0;.00nan;0;0
18369;50683;579;55;30;3;27;.900;3600000;0
18369;89930;579;0;0;0;0;.00nan;0;0
18370;20196;2287;71;21;1;20;.952;3600000;0
18370;169478;2287;0;0;0;0;.00nan;0;0
18370;67454;1933;79;31;2;29;.935;2889000;0
18370;155945;1933;20;10;4;6;.600;711000;0
18371;185240;2259;47;29;4;25;.862;3565000;0
18371;56155;2259;0;0;0;0;.00nan;0;0
18371;143879;1930;0;0;0;0;.00nan;0;0
18371;155917;1930;80;37;3;34;.919;3600000;0
18372;185240;2259;0;0;0;0;.00nan;0;0
18372;40087;1923;0;0;0;0;.00nan;0;0
18372;40088;1923;79;37;3;34;.919;3600000;0
18372;56155;2259;76;45;4;41;.911;3600000;0
18373;19473;582;70;11;0;11;1.000;2181000;0
18373;170037;4794;0;0;0;0;.00nan;0;0
18373;32255;582;44;26;4;22;.846;1719000;0
18373;161069;4794;50;30;4;26;.867;3900000;0
18374;11352;1931;0;0;0;0;.00nan;0;0
18374;67454;1933;61;16;1;15;.938;1139000;0
18374;155945;1933;32;31;6;25;.806;2461000;0
18374;161180;1931;70;29;2;27;.931;3600000;0
18375;13065;1920;56;34;5;29;.853;3600000;0
18375;-1;1934;72;18;1;17;.944;3600000;0
18375;56653;1934;0;0;0;0;.00nan;0;0
18375;61999;1920;0;0;0;0;.00nan;0;0
18376;50683;579;0;0;0;0;.00nan;0;0
18376;89930;579;98;42;2;40;.952;3600000;0
18376;143879;1930;44;26;4;22;.846;3600000;0
18376;155917;1930;0;0;0;0;.00nan;0;0
18377;13065;1920;0;0;0;0;.00nan;0;0
18377;14259;584;0;0;0;0;.00nan;0;0
18377;56480;584;66;24;3;21;.875;3600000;0
18377;61999;1920;27;31;6;25;.806;3600000;0
18378;13065;1920;50;34;4;30;.882;3600000;0
18378;170037;4794;40;42;6;36;.857;3600000;0
18378;61999;1920;0;0;0;0;.00nan;0;0
18378;161069;4794;0;0;0;0;.00nan;0;0
18379;20196;2287;0;0;0;0;.00nan;0;0
18379;169478;2287;66;36;4;32;.889;3559000;0
18379;185240;2259;63;32;3;29;.906;3600000;0
18379;56155;2259;0;0;0;0;.00nan;0;0
18380;-1;1934;59;36;4;32;.889;3600000;0
18380;19473;582;0;0;0;0;.00nan;0;0
18380;32255;582;34;27;5;22;.815;3600000;0
18380;56653;1934;0;0;0;0;.00nan;0;0
18381;11352;1931;0;0;0;0;.00nan;0;0
18381;143879;1930;0;0;0;0;.00nan;0;0
18381;155917;1930;89;32;1;31;.969;3600000;0
18381;161180;1931;64;28;3;25;.893;3563000;0
18382;14259;584;0;0;0;0;.00nan;0;0
18382;170037;4794;0;0;0;0;.00nan;0;0
18382;56480;584;56;28;4;24;.857;3600000;0
18382;161069;4794;35;44;8;36;.818;3600000;0
18383;11352;1931;75;35;4;31;.886;3900000;0
18383;185240;2259;0;0;0;0;.00nan;0;0
18383;56155;2259;67;35;4;31;.886;3900000;0
18383;161180;1931;0;0;0;0;.00nan;0;0
18384;-1;1934;0;0;0;0;.00nan;0;0
18384;50683;579;31;16;4;12;.750;3555000;0
18384;56653;1934;89;43;3;40;.930;3600000;0
18384;89930;579;0;0;0;0;.00nan;0;0
18385;40087;1923;33;33;6;27;.818;3600000;0
18385;40088;1923;0;0;0;0;.00nan;0;0
18385;143879;1930;66;30;3;27;.900;3600000;0
18385;155917;1930;0;0;0;0;.00nan;0;0
18386;13065;1920;32;24;5;19;.792;3600000;0
18386;61999;1920;0;0;0;0;.00nan;0;0
18386;67454;1933;67;37;4;33;.892;3600000;0
18386;155945;1933;0;0;0;0;.00nan;0;0
18387;19473;582;77;30;2;28;.933;3600000;0
18387;32255;582;0;0;0;0;.00nan;0;0
18387;40087;1923;0;0;0;0;.00nan;0;0
18387;40088;1923;54;31;5;26;.839;3600000;0
18388;14259;584;59;26;3;23;.885;3600000;0
18388;50683;579;58;4;0;4;1.000;362000;0
18388;56480;584;0;0;0;0;.00nan;0;0
18388;89930;579;61;46;6;40;.870;3238000;0
18389;11352;1931;47;5;1;4;.800;832000;0
18389;40087;1923;78;25;2;23;.920;3600000;0
18389;40088;1923;0;0;0;0;.00nan;0;0
18389;161180;1931;29;25;6;19;.760;2768000;0
18390;13065;1920;0;0;0;0;.00nan;0;0
18390;61999;1920;39;18;4;14;.778;3600000;0
18390;67454;1933;48;11;1;10;.909;718000;0
18390;155945;1933;48;51;7;44;.863;2882000;0
18391;20196;2287;0;0;0;0;.00nan;0;0
18391;169478;2287;49;34;5;29;.853;3900000;0
18391;185240;2259;35;25;5;20;.800;3900000;0
18391;56155;2259;0;0;0;0;.00nan;0;0
18392;19473;582;50;24;4;20;.833;2550000;0
18392;32255;582;32;15;4;11;.733;1050000;0
18392;50683;579;66;29;3;26;.897;3600000;0
18392;89930;579;0;0;0;0;.00nan;0;0
18393;170037;4794;49;33;5;28;.848;3514000;0
18393;143879;1930;0;0;0;0;.00nan;0;0
18393;155917;1930;85;34;3;31;.912;3600000;0
18393;161069;4794;0;0;0;0;.00nan;0;0
18394;13065;1920;70;47;5;42;.894;3735000;0
18394;19473;582;0;0;0;0;.00nan;0;0
18394;32255;582;35;21;4;17;.810;3735000;0
18394;61999;1920;0;0;0;0;.00nan;0;0
18395;14259;584;0;0;0;0;.00nan;0;0
18395;20196;2287;90;27;1;26;.963;3900000;0
18395;169478;2287;0;0;0;0;.00nan;0;0
18395;56480;584;80;28;1;27;.964;3900000;0
18396;170037;4794;62;37;5;32;.865;3600000;0
18396;40087;1923;0;0;0;0;.00nan;0;0
18396;40088;1923;77;31;2;29;.935;3600000;0
18396;161069;4794;0;0;0;0;.00nan;0;0
18397;11352;1931;0;0;0;0;.00nan;0;0
18397;20196;2287;68;21;2;19;.905;3600000;0
18397;169478;2287;0;0;0;0;.00nan;0;0
18397;161180;1931;44;19;3;16;.842;3556000;0
18398;13065;1920;87;32;2;30;.938;3489000;0
18398;-1;1934;55;35;5;30;.857;3900000;0
18398;56653;1934;0;0;0;0;.00nan;0;0
18398;61999;1920;26;5;3;2;.400;411000;0
18399;67454;1933;42;15;3;12;.800;1257000;0
18399;143879;1930;60;21;2;19;.905;3600000;0
18399;155917;1930;0;0;0;0;.00nan;0;0
18399;155945;1933;31;26;6;20;.769;2343000;0
18400;19473;582;0;0;0;0;.00nan;0;0
18400;170037;4794;0;0;0;0;.00nan;0;0
18400;32255;582;100;26;0;26;1.000;3600000;0
18400;161069;4794;41;41;7;34;.829;3600000;0
18401;11352;1931;0;0;0;0;.00nan;0;0
18401;50683;579;47;26;4;22;.846;3587000;0
18401;89930;579;0;0;0;0;.00nan;0;0
18401;161180;1931;78;42;3;39;.929;3600000;0
18402;-1;1934;0;0;0;0;.00nan;0;0
18402;40087;1923;44;26;4;22;.846;3600000;0
18402;40088;1923;0;0;0;0;.00nan;0;0
18402;56653;1934;77;43;5;38;.884;3573000;0
18403;20196;2287;0;0;0;0;.00nan;0;0
18403;169478;2287;62;30;3;27;.900;3600000;0
18403;50683;579;0;0;0;0;.00nan;0;0
18403;89930;579;56;37;4;33;.892;3574000;0
18404;40087;1923;64;10;0;10;1.000;565000;0
18404;40088;1923;21;28;7;21;.750;3035000;0
18404;50683;579;49;22;4;18;.818;3600000;0
18404;89930;579;0;0;0;0;.00nan;0;0
18405;19473;582;28;23;6;17;.739;2885000;0
18405;32255;582;60;3;0;3;1.000;715000;0
18405;143879;1930;22;27;6;21;.778;3235000;0
18405;155917;1930;41;2;1;1;.500;313000;0
18406;13065;1920;72;27;2;25;.926;3600000;0
18406;170037;4794;56;33;4;29;.879;3581000;0
18406;61999;1920;0;0;0;0;.00nan;0;0
18406;161069;4794;0;0;0;0;.00nan;0;0
18407;13065;1920;0;0;0;0;.00nan;0;0
18407;14259;584;0;0;0;0;.00nan;0;0
18407;56480;584;81;25;1;24;.960;3600000;0
18407;61999;1920;87;50;4;46;.920;3600000;0
18408;-1;1934;77;41;5;36;.878;3582000;0
18408;56653;1934;0;0;0;0;.00nan;0;0
18408;67454;1933;55;25;4;21;.840;3600000;0
18408;155945;1933;0;0;0;0;.00nan;0;0
18409;11352;1931;51;2;0;2;1.000;494000;0
18409;19473;582;41;26;5;21;.808;3600000;0
18409;32255;582;0;0;0;0;.00nan;0;0
18409;161180;1931;36;34;6;28;.824;3106000;0
18410;185240;2259;24;27;6;21;.778;2552000;0
18410;50683;579;0;0;0;0;.00nan;0;0
18410;56155;2259;56;15;2;13;.867;1048000;0
18410;89930;579;85;28;1;27;.964;3600000;0
18411;-1;1934;0;0;0;0;.00nan;0;0
18411;40087;1923;44;19;3;16;.842;3600000;0
18411;40088;1923;0;0;0;0;.00nan;0;0
18411;56653;1934;89;63;5;58;.921;3531000;0
18412;20196;2287;87;31;2;29;.935;3600000;0
18412;169478;2287;0;0;0;0;.00nan;0;0
18412;143879;1930;0;0;0;0;.00nan;0;0
18412;155917;1930;57;41;6;35;.854;3600000;0
18413;170037;4794;100;29;0;29;1.000;3600000;0
18413;67454;1933;70;35;4;31;.886;3600000;0
18413;155945;1933;0;0;0;0;.00nan;0;0
18413;161069;4794;0;0;0;0;.00nan;0;0
18414;13065;1920;0;0;0;0;.00nan;0;0
18414;61999;1920;47;36;6;30;.833;3600000;0
18414;143879;1930;0;0;0;0;.00nan;0;0
18414;155917;1930;84;31;3;28;.903;3600000;0
18415;20196;2287;0;0;0;0;.00nan;0;0
18415;169478;2287;57;28;4;24;.857;3600000;0
18415;170037;4794;25;7;3;4;.571;553000;0
18415;161069;4794;47;34;5;29;.853;3047000;0
18416;11352;1931;0;0;0;0;.00nan;0;0
18416;-1;1934;65;37;4;33;.892;3615000;0
18416;56653;1934;0;0;0;0;.00nan;0;0
18416;161180;1931;59;26;3;23;.885;3615000;0
18417;19473;582;63;39;5;34;.872;3600000;0
18417;32255;582;0;0;0;0;.00nan;0;0
18417;185240;2259;71;17;1;16;.941;3600000;0
18417;56155;2259;0;0;0;0;.00nan;0;0
18418;14259;584;0;0;0;0;.00nan;0;0
18418;50683;579;0;0;0;0;.00nan;0;0
18418;56480;584;40;31;5;26;.839;3560000;0
18418;89930;579;65;29;3;26;.897;3600000;0
18419;40087;1923;0;0;0;0;.00nan;0;0
18419;40088;1923;36;26;5;21;.808;3587000;0
18419;143879;1930;83;26;3;23;.885;3600000;0
18419;155917;1930;0;0;0;0;.00nan;0;0
18420;20196;2287;95;22;0;22;1.000;3600000;0
18420;169478;2287;0;0;0;0;.00nan;0;0
18420;67454;1933;66;35;3;32;.914;3600000;0
18420;155945;1933;0;0;0;0;.00nan;0;0
18421;14259;584;100;31;0;31;1.000;3600000;0
18421;19473;582;43;53;8;45;.849;3600000;0
18421;32255;582;0;0;0;0;.00nan;0;0
18421;56480;584;0;0;0;0;.00nan;0;0
18422;185240;2259;87;36;2;34;.944;3600000;0
18422;56155;2259;0;0;0;0;.00nan;0;0
18422;143879;1930;0;0;0;0;.00nan;0;0
18422;155917;1930;68;29;3;26;.897;3600000;0
18423;14259;584;33;28;6;22;.786;3234000;0
18423;40087;1923;43;30;6;24;.800;2497000;0
18423;40088;1923;42;10;2;8;.800;1018000;0
18423;56480;584;52;1;0;1;1.000;366000;0
18424;20196;2287;80;27;2;25;.926;3600000;0
18424;169478;2287;0;0;0;0;.00nan;0;0
18424;170037;4794;75;42;3;39;.929;3545000;0
18424;161069;4794;0;0;0;0;.00nan;0;0
18425;19473;582;67;38;4;34;.895;3559000;0
18425;32255;582;0;0;0;0;.00nan;0;0
18425;185240;2259;0;0;0;0;.00nan;0;0
18425;56155;2259;66;26;3;23;.885;3600000;0
18426;-1;1934;76;30;2;28;.933;3600000;0
18426;56653;1934;0;0;0;0;.00nan;0;0
18426;67454;1933;0;0;0;0;.00nan;0;0
18426;155945;1933;71;42;4;38;.905;3535000;0
18427;14259;584;0;0;0;0;.00nan;0;0
18427;56480;584;48;16;3;13;.813;3600000;0
18427;67454;1933;90;66;6;60;.909;3600000;0
18427;155945;1933;0;0;0;0;.00nan;0;0
18428;11352;1931;0;0;0;0;.00nan;0;0
18428;170037;4794;0;0;0;0;.00nan;0;0
18428;161069;4794;55;39;6;33;.846;3600000;0
18428;161180;1931;84;11;0;11;1.000;3600000;0
18429;14259;584;0;0;0;0;.00nan;0;0
18429;185240;2259;80;41;3;38;.927;3600000;0
18429;56155;2259;0;0;0;0;.00nan;0;0
18429;56480;584;41;32;5;27;.844;3555000;0
18430;20196;2287;34;33;7;26;.788;3600000;0
18430;169478;2287;0;0;0;0;.00nan;0;0
18430;40087;1923;0;0;0;0;.00nan;0;0
18430;40088;1923;88;35;2;33;.943;3600000;0
18431;13065;1920;93;35;2;33;.943;3600000;0
18431;185240;2259;10;20;6;14;.700;3198000;0
18431;56155;2259;51;2;0;2;1.000;402000;0
18431;61999;1920;0;0;0;0;.00nan;0;0
18432;11352;1931;53;27;3;24;.889;2514000;0
18432;50683;579;41;16;3;13;.813;3600000;0
18432;89930;579;0;0;0;0;.00nan;0;0
18432;161180;1931;30;16;4;12;.750;1086000;0
18433;11352;1931;47;20;3;17;.850;2658000;0
18433;13065;1920;0;0;0;0;.00nan;0;0
18433;61999;1920;60;27;3;24;.889;3600000;0
18433;161180;1931;18;8;4;4;.500;942000;0
18434;19473;582;93;33;2;31;.939;3600000;0
18434;32255;582;0;0;0;0;.00nan;0;0
18434;67454;1933;69;41;4;37;.902;3569000;0
18434;155945;1933;0;0;0;0;.00nan;0;0
18435;14259;584;0;0;0;0;.00nan;0;0
18435;56480;584;41;36;6;30;.833;3600000;0
18435;143879;1930;90;36;1;35;.972;3600000;0
18435;155917;1930;0;0;0;0;.00nan;0;0
18436;-1;1934;72;35;4;31;.886;3561000;0
18436;170037;4794;89;40;2;38;.950;3600000;0
18436;56653;1934;0;0;0;0;.00nan;0;0
18436;161069;4794;0;0;0;0;.00nan;0;0
18437;13065;1920;52;32;5;27;.844;3600000;0
18437;40087;1923;48;0;0;0;.00nan;676000;0
18437;40088;1923;17;21;6;15;.714;2871000;0
18437;61999;1920;0;0;0;0;.00nan;0;0
18438;-1;1934;28;22;5;17;.773;3561000;0
18438;170037;4794;65;28;3;25;.893;3600000;0
18438;56653;1934;0;0;0;0;.00nan;0;0
18438;161069;4794;0;0;0;0;.00nan;0;0
18439;11352;1931;28;14;4;10;.714;1135000;0
18439;143879;1930;100;24;0;24;1.000;3600000;0
18439;155917;1930;0;0;0;0;.00nan;0;0
18439;161180;1931;62;14;1;13;.929;2465000;0
18440;19473;582;80;39;3;36;.923;3600000;0
18440;20196;2287;0;0;0;0;.00nan;0;0
18440;169478;2287;61;27;2;25;.926;3600000;0
18440;32255;582;0;0;0;0;.00nan;0;0
18441;14259;584;0;0;0;0;.00nan;0;0
18441;-1;1934;0;0;0;0;.00nan;0;0
18441;56480;584;78;24;1;23;.958;3600000;0
18441;56653;1934;63;44;5;39;.886;3600000;0
18442;185240;2259;96;25;1;24;.960;3600000;0
18442;56155;2259;0;0;0;0;.00nan;0;0
18442;67454;1933;15;13;5;8;.615;1428000;0
18442;155945;1933;40;30;6;24;.800;2172000;0
18443;170037;4794;0;0;0;0;.00nan;0;0
18443;50683;579;82;30;2;28;.933;3600000;0
18443;89930;579;0;0;0;0;.00nan;0;0
18443;161069;4794;89;50;3;47;.940;3600000;0
18444;14259;584;68;22;2;20;.909;3600000;0
18444;40087;1923;94;35;1;34;.971;3600000;0
18444;40088;1923;0;0;0;0;.00nan;0;0
18444;56480;584;0;0;0;0;.00nan;0;0
18445;11352;1931;0;0;0;0;.00nan;0;0
18445;19473;582;49;33;5;28;.848;3588000;0
18445;32255;582;0;0;0;0;.00nan;0;0
18445;161180;1931;70;30;3;27;.900;3600000;0
18446;185240;2259;77;31;2;29;.935;3600000;0
18446;40087;1923;80;40;3;37;.925;3556000;0
18446;40088;1923;0;0;0;0;.00nan;0;0
18446;56155;2259;0;0;0;0;.00nan;0;0
18447;-1;1934;77;45;4;41;.911;3600000;0
18447;56653;1934;0;0;0;0;.00nan;0;0
18447;143879;1930;57;36;5;31;.861;3600000;0
18447;155917;1930;0;0;0;0;.00nan;0;0
18448;170037;4794;88;39;2;37;.949;3600000;0
18448;40087;1923;0;0;0;0;.00nan;0;0
18448;40088;1923;58;30;4;26;.867;3528000;0
18448;161069;4794;0;0;0;0;.00nan;0;0
18449;13065;1920;0;0;0;0;.00nan;0;0
18449;19473;582;0;0;0;0;.00nan;0;0
18449;32255;582;99;34;2;32;.941;3600000;0
18449;61999;1920;68;29;3;26;.897;3569000;0
18450;-1;1934;0;0;0;0;.00nan;0;0
18450;20196;2287;55;29;4;25;.862;3600000;0
18450;169478;2287;0;0;0;0;.00nan;0;0
18450;56653;1934;70;46;5;41;.891;3600000;0
18451;14259;584;0;0;0;0;.00nan;0;0
18451;185240;2259;89;51;4;47;.922;3900000;0
18451;56155;2259;0;0;0;0;.00nan;0;0
18451;56480;584;52;26;4;22;.846;3900000;0
18452;50683;579;65;32;3;29;.906;3800000;0
18452;67454;1933;0;0;0;0;.00nan;0;0
18452;89930;579;0;0;0;0;.00nan;0;0
18452;155945;1933;57;31;4;27;.871;3800000;0
18453;14259;584;23;37;8;29;.784;3600000;0
18453;20196;2287;0;0;0;0;.00nan;0;0
18453;169478;2287;33;43;7;36;.837;3600000;0
18453;56480;584;0;0;0;0;.00nan;0;0
18454;13065;1920;10;16;6;10;.625;1666000;0
18454;61999;1920;64;23;2;21;.913;1934000;0
18454;143879;1930;0;0;0;0;.00nan;0;0
18454;155917;1930;72;34;3;31;.912;3600000;0
18455;13065;1920;60;15;1;14;.933;1552000;0
18455;50683;579;0;0;0;0;.00nan;0;0
18455;61999;1920;19;17;6;11;.647;2048000;0
18455;89930;579;75;37;3;34;.919;3600000;0
18456;14259;584;0;0;0;0;.00nan;0;0
18456;56480;584;96;34;1;33;.971;3600000;0
18456;143879;1930;0;0;0;0;.00nan;0;0
18456;155917;1930;68;46;4;42;.913;3600000;0
18457;19473;582;60;30;3;27;.900;3600000;0
18457;32255;582;0;0;0;0;.00nan;0;0
18457;40087;1923;48;0;0;0;.00nan;522000;0
18457;40088;1923;26;32;7;25;.781;3078000;0
18458;20196;2287;60;23;3;20;.870;3600000;0
18458;169478;2287;0;0;0;0;.00nan;0;0
18458;143879;1930;46;26;4;22;.846;3600000;0
18458;155917;1930;0;0;0;0;.00nan;0;0
18459;11352;1931;0;0;0;0;.00nan;0;0
18459;67454;1933;64;40;5;35;.875;3600000;0
18459;155945;1933;0;0;0;0;.00nan;0;0
18459;161180;1931;82;26;1;25;.962;3600000;0
18460;-1;1934;65;32;3;29;.906;3600000;0
18460;185240;2259;57;20;2;18;.900;3600000;0
18460;56155;2259;0;0;0;0;.00nan;0;0
18460;56653;1934;0;0;0;0;.00nan;0;0
18461;13065;1920;56;33;4;29;.879;3551000;0
18461;185240;2259;0;0;0;0;.00nan;0;0
18461;56155;2259;70;29;3;26;.897;3600000;0
18461;61999;1920;0;0;0;0;.00nan;0;0
18462;11352;1931;60;35;4;31;.886;3600000;0
18462;170037;4794;61;9;0;9;1.000;1135000;0
18462;161069;4794;41;38;6;32;.842;2452000;0
18462;161180;1931;0;0;0;0;.00nan;0;0
18463;-1;1934;51;40;5;35;.875;3568000;0
18463;50683;579;69;29;3;26;.897;3600000;0
18463;56653;1934;0;0;0;0;.00nan;0;0
18463;89930;579;0;0;0;0;.00nan;0;0
18464;40087;1923;65;29;3;26;.897;3600000;0
18464;40088;1923;0;0;0;0;.00nan;0;0
18464;67454;1933;0;0;0;0;.00nan;0;0
18464;155945;1933;64;35;4;31;.886;3600000;0
18465;170037;4794;0;0;0;0;.00nan;0;0
18465;185240;2259;48;34;5;29;.853;3600000;0
18465;56155;2259;0;0;0;0;.00nan;0;0
18465;161069;4794;54;28;4;24;.857;3600000;0
18466;-1;1934;76;43;3;40;.930;3900000;0
18466;20196;2287;0;0;0;0;.00nan;0;0
18466;169478;2287;54;21;3;18;.857;3900000;0
18466;56653;1934;0;0;0;0;.00nan;0;0
18467;19473;582;50;36;5;31;.861;3538000;0
18467;32255;582;0;0;0;0;.00nan;0;0
18467;50683;579;0;0;0;0;.00nan;0;0
18467;89930;579;46;17;3;14;.824;3600000;0
18468;11352;1931;0;0;0;0;.00nan;0;0
18468;13065;1920;80;42;3;39;.929;3600000;0
18468;61999;1920;0;0;0;0;.00nan;0;0
18468;161180;1931;43;24;4;20;.833;3557000;0
18469;13065;1920;0;0;0;0;.00nan;0;0
18469;20196;2287;28;19;5;14;.737;3124000;0
18469;169478;2287;55;4;0;4;1.000;530000;0
18469;61999;1920;43;35;6;29;.829;3654000;0
18470;14259;584;0;0;0;0;.00nan;0;0
18470;56480;584;46;20;4;16;.800;3600000;0
18470;67454;1933;0;0;0;0;.00nan;0;0
18470;155945;1933;79;62;6;56;.903;3577000;0
18471;11352;1931;59;24;3;21;.875;3600000;0
18471;-1;1934;57;27;3;24;.889;3036000;0
18471;56653;1934;28;6;3;3;.500;564000;0
18471;161180;1931;0;0;0;0;.00nan;0;0
18472;50683;579;64;32;4;28;.875;3677000;0
18472;89930;579;0;0;0;0;.00nan;0;0
18472;143879;1930;0;0;0;0;.00nan;0;0
18472;155917;1930;55;27;3;24;.889;3677000;0
18473;13065;1920;53;21;2;19;.905;3779000;0
18473;40087;1923;0;0;0;0;.00nan;0;0
18473;40088;1923;50;22;3;19;.864;3779000;0
18473;61999;1920;0;0;0;0;.00nan;0;0
18474;170037;4794;0;0;0;0;.00nan;0;0
18474;67454;1933;48;5;1;4;.800;411000;0
18474;155945;1933;34;36;6;30;.833;3189000;0
18474;161069;4794;75;39;3;36;.923;3600000;0
18475;185240;2259;84;38;3;35;.921;3600000;0
18475;50683;579;0;0;0;0;.00nan;0;0
18475;56155;2259;0;0;0;0;.00nan;0;0
18475;89930;579;41;38;6;32;.842;3600000;0
18476;40087;1923;33;19;4;15;.789;3600000;0
18476;40088;1923;0;0;0;0;.00nan;0;0
18476;67454;1933;70;14;0;14;1.000;1483000;0
18476;155945;1933;63;45;6;39;.867;2108000;0
18477;11352;1931;0;0;0;0;.00nan;0;0
18477;20196;2287;85;32;2;30;.938;3600000;0
18477;169478;2287;0;0;0;0;.00nan;0;0
18477;161180;1931;50;29;4;25;.862;3526000;0
18478;-1;1934;45;32;5;27;.844;3600000;0
18478;19473;582;0;0;0;0;.00nan;0;0
18478;32255;582;26;31;6;25;.806;3600000;0
18478;56653;1934;0;0;0;0;.00nan;0;0
18479;170037;4794;0;0;0;0;.00nan;0;0
18479;50683;579;61;31;3;28;.903;3600000;0
18479;89930;579;0;0;0;0;.00nan;0;0
18479;161069;4794;53;47;6;41;.872;3600000;0
18480;19473;582;64;44;5;39;.886;3600000;0
18480;20196;2287;0;0;0;0;.00nan;0;0
18480;169478;2287;45;21;3;18;.857;3600000;0
18480;32255;582;0;0;0;0;.00nan;0;0
18481;13065;1920;0;0;0;0;.00nan;0;0
18481;170037;4794;48;5;1;4;.800;811000;0
18481;61999;1920;80;32;3;29;.906;3600000;0
18481;161069;4794;41;34;6;28;.824;2789000;0
18482;14259;584;0;0;0;0;.00nan;0;0
18482;56480;584;50;28;4;24;.857;3567000;0
18482;143879;1930;63;33;3;30;.909;3600000;0
18482;155917;1930;0;0;0;0;.00nan;0;0
18483;185240;2259;44;22;4;18;.818;3600000;0
18483;40087;1923;0;0;0;0;.00nan;0;0
18483;40088;1923;42;29;5;24;.828;3573000;0
18483;56155;2259;0;0;0;0;.00nan;0;0
18484;185240;2259;0;0;0;0;.00nan;0;0
18484;56155;2259;68;24;2;22;.917;3900000;0
18484;67454;1933;95;56;2;54;.964;3900000;0
18484;155945;1933;0;0;0;0;.00nan;0;0
18485;14259;584;65;26;2;24;.923;3600000;0
18485;-1;1934;73;36;3;33;.917;3544000;0
18485;56480;584;0;0;0;0;.00nan;0;0
18485;56653;1934;0;0;0;0;.00nan;0;0
18486;11352;1931;0;0;0;0;.00nan;0;0
18486;143879;1930;0;0;0;0;.00nan;0;0
18486;155917;1930;59;34;4;30;.882;3544000;0
18486;161180;1931;79;28;2;26;.929;3600000;0
18487;13065;1920;59;38;4;34;.895;3600000;0
18487;50683;579;0;0;0;0;.00nan;0;0
18487;61999;1920;0;0;0;0;.00nan;0;0
18487;89930;579;51;22;3;19;.864;3600000;0
18488;11352;1931;40;8;2;6;.750;959000;0
18488;20196;2287;0;0;0;0;.00nan;0;0
18488;169478;2287;79;29;1;28;.966;3600000;0
18488;161180;1931;27;27;6;21;.778;2641000;0
18489;170037;4794;0;0;0;0;.00nan;0;0
18489;185240;2259;85;42;3;39;.929;3600000;0
18489;56155;2259;0;0;0;0;.00nan;0;0
18489;161069;4794;45;34;5;29;.853;3565000;0
18490;-1;1934;100;28;0;28;1.000;3600000;0
18490;56653;1934;0;0;0;0;.00nan;0;0
18490;143879;1930;50;29;4;25;.862;3600000;0
18490;155917;1930;0;0;0;0;.00nan;0;0
18491;14259;584;0;0;0;0;.00nan;0;0
18491;19473;582;76;33;2;31;.939;3600000;0
18491;32255;582;0;0;0;0;.00nan;0;0
18491;56480;584;63;15;1;14;.933;3600000;0
18492;170037;4794;72;43;4;39;.907;3600000;0
18492;40087;1923;84;16;0;16;1.000;3600000;0
18492;40088;1923;0;0;0;0;.00nan;0;0
18492;161069;4794;0;0;0;0;.00nan;0;0
18493;11352;1931;0;0;0;0;.00nan;0;0
18493;-1;1934;44;23;4;19;.826;3530000;0
18493;56653;1934;0;0;0;0;.00nan;0;0
18493;161180;1931;84;33;2;31;.939;3600000;0
18494;185240;2259;1;18;7;11;.611;1271000;0
18494;50683;579;0;0;0;0;.00nan;0;0
18494;56155;2259;30;27;5;22;.815;2329000;0
18494;89930;579;39;27;5;22;.815;3600000;0
18495;13065;1920;0;0;0;0;.00nan;0;0
18495;61999;1920;59;36;4;32;.889;3568000;0
18495;67454;1933;60;26;3;23;.885;3600000;0
18495;155945;1933;0;0;0;0;.00nan;0;0
18496;14259;584;71;22;1;21;.955;3600000;0
18496;20196;2287;0;0;0;0;.00nan;0;0
18496;169478;2287;49;25;3;22;.880;3554000;0
18496;56480;584;0;0;0;0;.00nan;0;0
18497;19473;582;0;0;0;0;.00nan;0;0
18497;32255;582;69;26;2;24;.923;3600000;0
18497;143879;1930;0;0;0;0;.00nan;0;0
18497;155917;1930;34;24;4;20;.833;3568000;0
18498;13065;1920;21;28;7;21;.750;3600000;0
18498;40087;1923;0;0;0;0;.00nan;0;0
18498;40088;1923;67;33;3;30;.909;3600000;0
18498;61999;1920;0;0;0;0;.00nan;0;0
18499;170037;4794;0;0;0;0;.00nan;0;0
18499;67454;1933;84;28;1;27;.964;3600000;0
18499;155945;1933;0;0;0;0;.00nan;0;0
18499;161069;4794;35;30;5;25;.833;3600000;0
18500;11352;1931;0;0;0;0;.00nan;0;0
18500;19473;582;0;0;0;0;.00nan;0;0
18500;32255;582;56;26;3;23;.885;3560000;0
18500;161180;1931;87;37;2;35;.946;3600000;0
18501;-1;1934;64;32;4;28;.875;3600000;0
18501;56653;1934;0;0;0;0;.00nan;0;0
18501;143879;1930;34;25;5;20;.800;3572000;0
18501;155917;1930;0;0;0;0;.00nan;0;0
18502;40087;1923;20;17;5;12;.706;973000;0
18502;40088;1923;57;30;4;26;.867;2627000;0
18502;50683;579;52;19;3;16;.842;3600000;0
18502;89930;579;0;0;0;0;.00nan;0;0
18503;13065;1920;0;0;0;0;.00nan;0;0
18503;185240;2259;82;38;4;34;.895;3900000;0
18503;56155;2259;0;0;0;0;.00nan;0;0
18503;61999;1920;63;40;4;36;.900;3900000;0
18504;50683;579;0;0;0;0;.00nan;0;0
18504;67454;1933;0;0;0;0;.00nan;0;0
18504;89930;579;92;33;2;31;.939;3600000;0
18504;155945;1933;57;41;6;35;.854;3600000;0
18505;11352;1931;69;42;5;37;.881;3587000;0
18505;14259;584;60;22;2;20;.909;3600000;0
18505;56480;584;0;0;0;0;.00nan;0;0
18505;161180;1931;0;0;0;0;.00nan;0;0
18506;-1;1934;64;15;0;15;1.000;1569000;0
18506;20196;2287;0;0;0;0;.00nan;0;0
18506;169478;2287;61;20;3;17;.850;3600000;0
18506;56653;1934;36;33;6;27;.818;2031000;0
18507;20196;2287;61;23;2;21;.913;3600000;0
18507;169478;2287;0;0;0;0;.00nan;0;0
18507;143879;1930;0;0;0;0;.00nan;0;0
18507;155917;1930;75;26;3;23;.885;3559000;0
18508;14259;584;7;21;7;14;.667;3113000;0
18508;19473;582;0;0;0;0;.00nan;0;0
18508;32255;582;45;42;6;36;.857;3600000;0
18508;56480;584;22;5;3;2;.400;487000;0
18510;20196;2287;0;0;0;0;.00nan;0;0
18510;169478;2287;65;28;3;25;.893;3600000;0
18510;40087;1923;0;0;0;0;.00nan;0;0
18510;40088;1923;56;38;5;33;.868;3600000;0
18512;11687;1934;0;0;0;0;.00nan;0;0
18512;13065;1920;47;28;4;24;.857;3600000;0
18512;56653;1934;53;36;6;30;.833;3600000;0
18512;61999;1920;0;0;0;0;.00nan;0;0
18514;11352;1931;21;27;6;21;.778;2799000;0
18514;19010;1931;52;2;0;2;1.000;788000;0
18514;170037;4794;0;0;0;0;.00nan;0;0
18514;161069;4794;61;39;5;34;.872;3600000;0
18516;185240;2259;40;27;5;22;.815;3800000;0
18516;50683;579;73;44;4;40;.909;3790000;0
18516;56155;2259;0;0;0;0;.00nan;0;0
18516;89930;579;0;0;0;0;.00nan;0;0
18518;14259;584;47;33;5;28;.848;3547000;0
18518;56480;584;0;0;0;0;.00nan;0;0
18518;67454;1933;0;0;0;0;.00nan;0;0
18518;155945;1933;76;44;4;40;.909;3600000;0
18520;19473;582;0;0;0;0;.00nan;0;0
18520;32255;582;79;32;3;29;.906;3600000;0
18520;143879;1930;0;0;0;0;.00nan;0;0
18520;155917;1930;50;32;4;28;.875;3554000;0
18522;19473;582;57;31;4;27;.871;3600000;0
18522;32255;582;0;0;0;0;.00nan;0;0
18522;50683;579;0;0;0;0;.00nan;0;0
18522;89930;579;56;40;5;35;.875;3597000;0
18524;67454;1933;84;24;1;23;.958;3722000;0
18524;143879;1930;92;37;2;35;.946;3722000;0
18524;155917;1930;0;0;0;0;.00nan;0;0
18524;155945;1933;0;0;0;0;.00nan;0;0
18526;11687;1934;61;33;4;29;.879;3600000;0
18526;185240;2259;57;23;3;20;.870;2698000;0
18526;56155;2259;11;12;5;7;.583;902000;0
18526;56653;1934;0;0;0;0;.00nan;0;0
18528;20196;2287;68;31;3;28;.903;3600000;0
18528;169478;2287;0;0;0;0;.00nan;0;0
18528;40087;1923;69;23;2;21;.913;3600000;0
18528;40088;1923;0;0;0;0;.00nan;0;0
18530;14259;584;0;0;0;0;.00nan;0;0
18530;170037;4794;62;44;5;39;.886;3600000;0
18530;56480;584;77;28;2;26;.929;3600000;0
18530;161069;4794;0;0;0;0;.00nan;0;0
18532;11352;1931;0;0;0;0;.00nan;0;0
18532;13065;1920;0;0;0;0;.00nan;0;0
18532;19010;1931;63;31;5;26;.839;3574000;0
18532;61999;1920;58;32;4;28;.875;3600000;0
18534;11352;1931;21;22;6;16;.727;2683000;0
18534;11687;1934;0;0;0;0;.00nan;0;0
18534;19010;1931;55;11;1;10;.909;951000;0
18534;56653;1934;13;29;8;21;.724;3638000;0
18536;13065;1920;0;0;0;0;.00nan;0;0
18536;61999;1920;41;30;5;25;.833;3600000;0
18536;143879;1930;0;0;0;0;.00nan;0;0
18536;155917;1930;74;30;2;28;.933;3600000;0
18538;19473;582;55;8;1;7;.875;493000;0
18538;20196;2287;0;0;0;0;.00nan;0;0
18538;169478;2287;49;26;4;22;.846;3600000;0
18538;32255;582;25;33;8;25;.758;3107000;0
18540;14259;584;0;0;0;0;.00nan;0;0
18540;50683;579;72;41;5;36;.878;3557000;0
18540;56480;584;58;25;3;22;.880;3600000;0
18540;89930;579;0;0;0;0;.00nan;0;0
18542;185240;2259;12;27;7;20;.741;3600000;0
18542;40087;1923;0;0;0;0;.00nan;0;0
18542;40088;1923;50;36;5;31;.861;3600000;0
18542;56155;2259;0;0;0;0;.00nan;0;0
18544;170037;4794;0;0;0;0;.00nan;0;0
18544;67454;1933;0;0;0;0;.00nan;0;0
18544;155945;1933;75;39;4;35;.897;3900000;0
18544;161069;4794;59;40;4;36;.900;3900000;0
18546;11352;1931;0;0;0;0;.00nan;0;0
18546;19010;1931;52;39;6;33;.846;3548000;0
18546;170037;4794;80;42;4;38;.905;3600000;0
18546;161069;4794;0;0;0;0;.00nan;0;0
18548;40087;1923;44;25;4;21;.840;3536000;0
18548;40088;1923;0;0;0;0;.00nan;0;0
18548;67454;1933;79;37;3;34;.919;3600000;0
18548;155945;1933;0;0;0;0;.00nan;0;0
18550;14259;584;39;30;5;25;.833;3600000;0
18550;50683;579;34;16;4;12;.750;1574000;0
18550;56480;584;0;0;0;0;.00nan;0;0
18550;89930;579;10;21;6;15;.714;2026000;0
18552;11687;1934;60;22;2;20;.909;3600000;0
18552;56653;1934;0;0;0;0;.00nan;0;0
18552;143879;1930;57;32;4;28;.875;3553000;0
18552;155917;1930;0;0;0;0;.00nan;0;0
18554;13065;1920;49;22;3;19;.864;3600000;0
18554;19473;582;47;28;4;24;.857;3600000;0
18554;32255;582;0;0;0;0;.00nan;0;0
18554;61999;1920;0;0;0;0;.00nan;0;0
18556;20196;2287;74;28;2;26;.929;3600000;0
18556;169478;2287;0;0;0;0;.00nan;0;0
18556;185240;2259;0;0;0;0;.00nan;0;0
18556;56155;2259;90;27;1;26;.963;3600000;0
19826;20196;2287;0;0;0;0;.00nan;0;0
19826;169478;2287;78;31;2;29;.935;3590000;0
19826;143879;1930;75;24;1;23;.958;3600000;0
19826;155917;1930;0;0;0;0;.00nan;0;0
19827;185240;2259;97;34;1;33;.971;3900000;0
19827;40087;1923;0;0;0;0;.00nan;0;0
19827;40088;1923;97;33;1;32;.970;3900000;0
19827;56155;2259;0;0;0;0;.00nan;0;0
19828;14259;584;76;27;2;25;.926;3600000;0
19828;50683;579;30;11;3;8;.727;595000;0
19828;56480;584;0;0;0;0;.00nan;0;0
19828;89930;579;53;30;5;25;.833;3005000;0
19829;20196;2287;76;30;3;27;.900;3600000;0
19829;169478;2287;0;0;0;0;.00nan;0;0
19829;40087;1923;62;34;4;30;.882;3547000;0
19829;40088;1923;0;0;0;0;.00nan;0;0
19830;50683;579;79;31;1;30;.968;3600000;0
19830;89930;579;0;0;0;0;.00nan;0;0
19830;143879;1930;0;0;0;0;.00nan;0;0
19830;155917;1930;48;23;4;19;.826;3600000;0
19831;14259;584;0;0;0;0;.00nan;0;0
19831;185240;2259;67;37;4;33;.892;3565000;0
19831;56155;2259;0;0;0;0;.00nan;0;0
19831;56480;584;69;34;3;31;.912;3600000;0
19832;20196;2287;0;0;0;0;.00nan;0;0
19832;169478;2287;34;37;6;31;.838;3600000;0
19832;50683;579;44;19;3;16;.842;3600000;0
19832;89930;579;0;0;0;0;.00nan;0;0
19833;14259;584;61;24;2;22;.917;3600000;0
19833;40087;1923;55;15;2;13;.867;1899000;0
19833;40088;1923;13;24;7;17;.708;1701000;0
19833;56480;584;0;0;0;0;.00nan;0;0
19834;185240;2259;74;31;3;28;.903;3530000;0
19834;56155;2259;0;0;0;0;.00nan;0;0
19834;143879;1930;81;25;1;24;.960;3600000;0
19834;155917;1930;0;0;0;0;.00nan;0;0
19835;14259;584;87;29;2;27;.931;3900000;0
19835;20196;2287;0;0;0;0;.00nan;0;0
19835;169478;2287;55;18;2;16;.889;3900000;0
19835;56480;584;0;0;0;0;.00nan;0;0
19836;185240;2259;48;41;6;35;.854;3517000;0
19836;50683;579;0;0;0;0;.00nan;0;0
19836;56155;2259;0;0;0;0;.00nan;0;0
19836;89930;579;70;38;4;34;.895;3600000;0
19837;40087;1923;40;30;5;25;.833;3582000;0
19837;40088;1923;0;0;0;0;.00nan;0;0
19837;143879;1930;0;0;0;0;.00nan;0;0
19837;155917;1930;65;38;4;34;.895;3600000;0
19838;20196;2287;76;34;4;30;.882;3600000;0
19838;169478;2287;0;0;0;0;.00nan;0;0
19838;185240;2259;44;32;6;26;.813;2578000;0
19838;56155;2259;4;7;5;2;.286;1022000;0
19839;14259;584;56;23;3;20;.870;3581000;0
19839;56480;584;0;0;0;0;.00nan;0;0
19839;143879;1930;72;28;2;26;.929;3600000;0
19839;155917;1930;0;0;0;0;.00nan;0;0
19840;40087;1923;0;0;0;0;.00nan;0;0
19840;40088;1923;37;37;6;31;.838;3600000;0
19840;50683;579;63;21;2;19;.905;3600000;0
19840;89930;579;0;0;0;0;.00nan;0;0
19841;20196;2287;0;0;0;0;.00nan;0;0
19841;169478;2287;100;32;0;32;1.000;3600000;0
19841;143879;1930;0;0;0;0;.00nan;0;0
19841;155917;1930;77;28;2;26;.929;3567000;0
19842;185240;2259;56;32;4;28;.875;3600000;0
19842;40087;1923;16;21;6;15;.714;2315000;0
19842;40088;1923;44;11;2;9;.818;1285000;0
19842;56155;2259;0;0;0;0;.00nan;0;0
19843;14259;584;0;0;0;0;.00nan;0;0
19843;50683;579;0;0;0;0;.00nan;0;0
19843;56480;584;52;35;4;31;.886;3835000;0
19843;89930;579;58;35;5;30;.857;3835000;0
19844;20196;2287;0;0;0;0;.00nan;0;0
19844;169478;2287;20;26;6;20;.769;3517000;0
19844;40087;1923;0;0;0;0;.00nan;0;0
19844;40088;1923;54;28;4;24;.857;3600000;0
19845;50683;579;0;0;0;0;.00nan;0;0
19845;89930;579;51;24;4;20;.833;3562000;0
19845;143879;1930;74;30;3;27;.900;3600000;0
19845;155917;1930;0;0;0;0;.00nan;0;0
19846;14259;584;0;0;0;0;.00nan;0;0
19846;185240;2259;50;39;6;33;.846;3014000;0
19846;56155;2259;64;15;1;14;.933;586000;0
19846;56480;584;61;28;3;25;.893;3600000;0
19847;20196;2287;0;0;0;0;.00nan;0;0
19847;169478;2287;70;49;5;44;.898;3600000;0
19847;50683;579;52;33;4;29;.879;3600000;0
19847;89930;579;0;0;0;0;.00nan;0;0
19848;14259;584;44;28;4;24;.857;3600000;0
19848;40087;1923;96;59;5;54;.915;3584000;0
19848;40088;1923;0;0;0;0;.00nan;0;0
19848;56480;584;0;0;0;0;.00nan;0;0
19849;185240;2259;27;30;6;24;.800;3600000;0
19849;56155;2259;0;0;0;0;.00nan;0;0
19849;143879;1930;0;0;0;0;.00nan;0;0
19849;155917;1930;86;37;3;34;.919;3600000;0
19850;14259;584;0;0;0;0;.00nan;0;0
19850;20196;2287;0;0;0;0;.00nan;0;0
19850;169478;2287;48;18;3;15;.833;3600000;0
19850;56480;584;49;32;4;28;.875;3543000;0
19851;185240;2259;0;0;0;0;.00nan;0;0
19851;50683;579;36;25;5;20;.800;3600000;0
19851;56155;2259;76;45;4;41;.911;3600000;0
19851;89930;579;0;0;0;0;.00nan;0;0
19852;40087;1923;0;0;0;0;.00nan;0;0
19852;40088;1923;40;38;6;32;.842;3600000;0
19852;143879;1930;43;14;3;11;.786;3600000;0
19852;155917;1930;0;0;0;0;.00nan;0;0
19853;20196;2287;0;0;0;0;.00nan;0;0
19853;169478;2287;58;30;4;26;.867;3600000;0
19853;185240;2259;29;8;3;5;.625;442000;0
19853;56155;2259;42;27;4;23;.852;3158000;0
19854;14259;584;0;0;0;0;.00nan;0;0
19854;56480;584;66;19;2;17;.895;3600000;0
19854;143879;1930;67;29;3;26;.897;2787000;0
19854;155917;1930;19;15;5;10;.667;813000;0
19855;40087;1923;91;37;2;35;.946;3600000;0
19855;40088;1923;0;0;0;0;.00nan;0;0
19855;50683;579;0;0;0;0;.00nan;0;0
19855;89930;579;45;22;4;18;.818;3600000;0
19856;11352;1931;0;0;0;0;.00nan;0;0
19856;67454;1933;91;42;2;40;.952;3600000;0
19856;155945;1933;0;0;0;0;.00nan;0;0
19856;161180;1931;54;25;3;22;.880;3556000;0
19857;13065;1920;1;25;9;16;.640;3600000;0
19857;170037;4794;0;0;0;0;.00nan;0;0
19857;61999;1920;0;0;0;0;.00nan;0;0
19857;161069;4794;90;50;4;46;.920;3600000;0
19858;-1;1934;37;23;5;18;.783;3600000;0
19858;19473;582;50;40;6;34;.850;3575000;0
19858;32255;582;0;0;0;0;.00nan;0;0
19858;56653;1934;0;0;0;0;.00nan;0;0
19859;11352;1931;0;0;0;0;.00nan;0;0
19859;170037;4794;0;0;0;0;.00nan;0;0
19859;161069;4794;14;26;7;19;.731;3600000;0
19859;161180;1931;57;34;4;30;.882;3600000;0
19860;-1;1934;43;35;5;30;.857;3587000;0
19860;56653;1934;0;0;0;0;.00nan;0;0
19860;67454;1933;85;33;2;31;.939;3600000;0
19860;155945;1933;0;0;0;0;.00nan;0;0
19861;13065;1920;0;0;0;0;.00nan;0;0
19861;19473;582;0;0;0;0;.00nan;0;0
19861;32255;582;52;23;3;20;.870;3580000;0
19861;61999;1920;77;21;1;20;.952;3600000;0
19862;11352;1931;0;0;0;0;.00nan;0;0
19862;-1;1934;0;0;0;0;.00nan;0;0
19862;185775;1934;83;41;3;38;.927;3600000;0
19862;161180;1931;54;28;4;24;.857;3591000;0
19863;19473;582;67;23;2;21;.913;3600000;0
19863;170037;4794;0;0;0;0;.00nan;0;0
19863;32255;582;0;0;0;0;.00nan;0;0
19863;161069;4794;62;39;6;33;.846;3600000;0
19864;13065;1920;82;41;3;38;.927;3600000;0
19864;61999;1920;0;0;0;0;.00nan;0;0
19864;67454;1933;0;0;0;0;.00nan;0;0
19864;155945;1933;25;24;6;18;.750;3600000;0
19865;11352;1931;0;0;0;0;.00nan;0;0
19865;19473;582;0;0;0;0;.00nan;0;0
19865;32255;582;94;25;0;25;1.000;3600000;0
19865;161180;1931;62;37;4;33;.892;3600000;0
19866;13065;1920;51;10;1;9;.900;1030000;0
19866;-1;1934;0;0;0;0;.00nan;0;0
19866;185775;1934;67;23;2;21;.913;3600000;0
19866;61999;1920;30;28;6;22;.786;2570000;0
19867;170037;4794;0;0;0;0;.00nan;0;0
19867;67454;1933;60;43;5;38;.884;3900000;0
19867;155945;1933;0;0;0;0;.00nan;0;0
19867;161069;4794;57;35;5;30;.857;3897000;0
19868;11352;1931;0;0;0;0;.00nan;0;0
19868;13065;1920;63;30;3;27;.900;3570000;0
19868;61999;1920;0;0;0;0;.00nan;0;0
19868;161180;1931;79;35;2;33;.943;3600000;0
19869;19473;582;50;25;3;22;.880;3545000;0
19869;32255;582;0;0;0;0;.00nan;0;0
19869;67454;1933;0;0;0;0;.00nan;0;0
19869;155945;1933;88;36;2;34;.944;3600000;0
19870;-1;1934;0;0;0;0;.00nan;0;0
19870;170037;4794;58;32;4;28;.875;3586000;0
19870;185775;1934;81;30;2;28;.933;3600000;0
19870;161069;4794;0;0;0;0;.00nan;0;0
19871;11352;1931;0;0;0;0;.00nan;0;0
19871;67454;1933;95;37;2;35;.946;3565000;0
19871;155945;1933;0;0;0;0;.00nan;0;0
19871;161180;1931;100;37;1;36;.973;3600000;0
19872;13065;1920;0;0;0;0;.00nan;0;0
19872;170037;4794;0;0;0;0;.00nan;0;0
19872;61999;1920;42;40;7;33;.825;3572000;0
19872;161069;4794;41;38;6;32;.842;3600000;0
19873;-1;1934;0;0;0;0;.00nan;0;0
19873;19473;582;0;0;0;0;.00nan;0;0
19873;32255;582;75;24;1;23;.958;3600000;0
19873;185775;1934;37;41;8;33;.805;3600000;0
19874;11352;1931;0;0;0;0;.00nan;0;0
19874;170037;4794;0;0;0;0;.00nan;0;0
19874;161069;4794;100;50;1;49;.980;3600000;0
19874;161180;1931;47;23;4;19;.826;3600000;0
19875;-1;1934;0;0;0;0;.00nan;0;0
19875;185775;1934;67;33;3;30;.909;3600000;0
19875;67454;1933;62;22;2;20;.909;3128000;0
19875;155945;1933;30;10;3;7;.700;457000;0
19876;13065;1920;62;31;3;28;.903;3659000;0
19876;19473;582;54;28;4;24;.857;3659000;0
19876;32255;582;0;0;0;0;.00nan;0;0
19876;61999;1920;0;0;0;0;.00nan;0;0
19877;11352;1931;0;0;0;0;.00nan;0;0
19877;-1;1934;0;0;0;0;.00nan;0;0
19877;185775;1934;71;30;3;27;.900;3600000;0
19877;161180;1931;62;41;5;36;.878;3573000;0
19878;19473;582;0;0;0;0;.00nan;0;0
19878;170037;4794;0;0;0;0;.00nan;0;0
19878;32255;582;36;30;6;24;.800;3600000;0
19878;161069;4794;90;47;3;44;.936;3600000;0
19879;13065;1920;0;0;0;0;.00nan;0;0
19879;61999;1920;65;27;3;24;.889;3600000;0
19879;67454;1933;26;31;7;24;.774;3341000;0
19879;155945;1933;50;2;0;2;1.000;259000;0
19880;11352;1931;49;2;0;2;1.000;503000;0
19880;19473;582;42;22;4;18;.818;3600000;0
19880;32255;582;0;0;0;0;.00nan;0;0
19880;161180;1931;37;29;6;23;.793;3069000;0
19881;13065;1920;74;39;3;36;.923;3900000;0
19881;-1;1934;0;0;0;0;.00nan;0;0
19881;185775;1934;79;36;3;33;.917;3900000;0
19881;61999;1920;0;0;0;0;.00nan;0;0
19882;170037;4794;0;0;0;0;.00nan;0;0
19882;67454;1933;0;0;0;0;.00nan;0;0
19882;155945;1933;89;50;4;46;.920;3851000;0
19882;161069;4794;63;31;3;28;.903;3851000;0
19883;11352;1931;0;0;0;0;.00nan;0;0
19883;13065;1920;0;0;0;0;.00nan;0;0
19883;61999;1920;85;39;3;36;.923;3716000;0
19883;161180;1931;85;38;2;36;.947;3716000;0
19884;19473;582;0;0;0;0;.00nan;0;0
19884;32255;582;54;21;3;18;.857;3513000;0
19884;67454;1933;99;44;1;43;.977;3600000;0
19884;155945;1933;0;0;0;0;.00nan;0;0
19885;-1;1934;0;0;0;0;.00nan;0;0
19885;170037;4794;0;0;0;0;.00nan;0;0
19885;185775;1934;63;30;3;27;.900;3600000;0
19885;161069;4794;86;43;4;39;.907;3600000;0
362;11352;1931;0;0;0;0;.00nan;0;0
362;20196;2287;0;0;0;0;.00nan;0;0
362;169478;2287;97;29;1;28;.966;3600000;0
362;161180;1931;47;21;3;18;.857;3519000;0
363;14259;584;0;0;0;0;.00nan;0;0
363;-1;1934;47;43;6;37;.860;2564000;0
363;185775;1934;48;15;2;13;.867;1036000;0
363;56480;584;59;25;3;22;.880;3600000;0
364;40087;1923;56;44;6;38;.864;3600000;0
364;40088;1923;0;0;0;0;.00nan;0;0
364;50683;579;51;20;3;17;.850;3600000;0
364;89930;579;0;0;0;0;.00nan;0;0
365;185240;2259;33;31;6;25;.806;3600000;0
365;56155;2259;0;0;0;0;.00nan;0;0
365;143879;1930;54;25;3;22;.880;3600000;0
365;155917;1930;0;0;0;0;.00nan;0;0
366;11352;1931;0;0;0;0;.00nan;0;0
366;20196;2287;0;0;0;0;.00nan;0;0
366;169478;2287;62;22;2;20;.909;3600000;0
366;161180;1931;85;47;3;44;.936;3600000;0
367;14259;584;0;0;0;0;.00nan;0;0
367;-1;1934;0;0;0;0;.00nan;0;0
367;185775;1934;82;34;2;32;.941;3711000;0
367;56480;584;72;24;3;21;.875;3711000;0
368;40087;1923;0;0;0;0;.00nan;0;0
368;40088;1923;87;41;3;38;.927;3600000;0
368;50683;579;71;9;0;9;1.000;3600000;0
368;89930;579;0;0;0;0;.00nan;0;0
369;185240;2259;43;21;4;17;.810;3600000;0
369;56155;2259;0;0;0;0;.00nan;0;0
369;143879;1930;70;28;3;25;.893;3600000;0
369;155917;1930;0;0;0;0;.00nan;0;0
370;11352;1931;0;0;0;0;.00nan;0;0
370;20196;2287;0;0;0;0;.00nan;0;0
370;169478;2287;83;33;2;31;.939;3600000;0
370;161180;1931;71;36;4;32;.889;3590000;0
371;14259;584;0;0;0;0;.00nan;0;0
371;-1;1934;0;0;0;0;.00nan;0;0
371;185775;1934;87;50;3;47;.940;3600000;0
371;56480;584;39;24;5;19;.792;3558000;0
372;40087;1923;0;0;0;0;.00nan;0;0
372;40088;1923;71;34;4;30;.882;3666000;0
372;50683;579;59;25;3;22;.880;3666000;0
372;89930;579;0;0;0;0;.00nan;0;0
373;185240;2259;67;38;4;34;.895;3600000;0
373;56155;2259;0;0;0;0;.00nan;0;0
373;143879;1930;75;21;1;20;.952;3600000;0
373;155917;1930;0;0;0;0;.00nan;0;0
666;14259;584;0;0;0;0;.00nan;0;0
666;-1;1934;0;0;0;0;.00nan;0;0
666;185775;1934;100;27;0;27;1.000;3600000;0
666;56480;584;61;31;3;28;.903;3600000;0
686;20196;2287;0;0;0;0;.00nan;0;0
686;169478;2287;34;23;5;18;.783;3600000;0
686;143879;1930;63;27;3;24;.889;3600000;0
686;155917;1930;0;0;0;0;.00nan;0;0
687;-1;1934;0;0;0;0;.00nan;0;0
687;185775;1934;54;65;6;59;.908;5293000;0
687;50683;579;17;34;7;27;.794;5300000;0
687;89930;579;0;0;0;0;.00nan;0;0
688;20196;2287;0;0;0;0;.00nan;0;0
688;169478;2287;42;19;3;16;.842;3549000;0
688;143879;1930;79;38;2;36;.947;3600000;0
688;155917;1930;0;0;0;0;.00nan;0;0
689;-1;1934;0;0;0;0;.00nan;0;0
689;185775;1934;67;25;2;23;.920;3642000;0
689;50683;579;62;16;1;15;.938;3642000;0
689;89930;579;0;0;0;0;.00nan;0;0
690;20196;2287;0;0;0;0;.00nan;0;0
690;169478;2287;69;21;3;18;.857;3600000;0
690;143879;1930;57;38;5;33;.868;3600000;0
690;155917;1930;0;0;0;0;.00nan;0;0
691;-1;1934;0;0;0;0;.00nan;0;0
691;185775;1934;55;61;7;54;.885;3600000;0
691;50683;579;52;15;2;13;.867;3600000;0
691;89930;579;0;0;0;0;.00nan;0;0
983;20196;2287;0;0;0;0;.00nan;0;0
983;169478;2287;99;41;1;40;.976;3803000;0
983;143879;1930;83;39;2;37;.949;3803000;0
983;155917;1930;0;0;0;0;.00nan;0;0
984;-1;1934;0;0;0;0;.00nan;0;0
984;185775;1934;50;34;6;28;.824;3600000;0
984;50683;579;7;20;7;13;.650;3552000;0
984;89930;579;0;0;0;0;.00nan;0;0
1025;20196;2287;0;0;0;0;.00nan;0;0
1025;169478;2287;91;20;0;20;1.000;3600000;0
1025;143879;1930;55;33;4;29;.879;3600000;0
1025;155917;1930;0;0;0;0;.00nan;0;0
1026;-1;1934;0;0;0;0;.00nan;0;0
1026;185775;1934;88;48;3;45;.938;3556000;0
1026;50683;579;61;15;1;14;.933;3600000;0
1026;89930;579;0;0;0;0;.00nan;0;0
1070;20196;2287;0;0;0;0;.00nan;0;0
1070;169478;2287;77;30;2;28;.933;3600000;0
1070;50683;579;71;32;3;29;.906;3549000;0
1070;89930;579;0;0;0;0;.00nan;0;0
1071;20196;2287;0;0;0;0;.00nan;0;0
1071;169478;2287;100;38;2;36;.947;3600000;0
1071;50683;579;48;18;3;15;.833;3592000;0
1071;89930;579;0;0;0;0;.00nan;0;0
1072;20196;2287;0;0;0;0;.00nan;0;0
1072;169478;2287;78;47;4;43;.915;3587000;0
1072;50683;579;65;28;3;25;.893;3600000;0
1072;89930;579;0;0;0;0;.00nan;0;0
1280;20196;2287;44;4;1;3;.750;421000;0
1280;169478;2287;23;32;7;25;.781;3179000;0
1280;50683;579;64;40;4;36;.900;3600000;0
1280;89930;579;0;0;0;0;.00nan;0;0
1325;20196;2287;0;0;0;0;.00nan;0;0
1325;169478;2287;67;45;5;40;.889;3600000;0
1325;50683;579;37;27;6;21;.778;3549000;0
1325;89930;579;0;0;0;0;.00nan;0;0
18557;163361;2164;69;23;1;22;.957;3551000;0
18557;177771;2163;98;24;0;24;1.000;3600000;0
18557;22144;2164;0;0;0;0;.00nan;0;0
18557;181051;2163;0;0;0;0;.00nan;0;0
18558;6998;2161;99;35;1;34;.971;3600000;0
18558;-1;4840;87;36;2;34;.944;3597000;0
18558;-1;4840;0;0;0;0;.00nan;0;0
18558;161081;2161;0;0;0;0;.00nan;0;0
18559;21607;2162;25;31;6;25;.806;2024000;0
18559;22316;2162;51;21;2;19;.905;1576000;0
18559;48586;2158;0;0;0;0;.00nan;0;0
18559;75764;2158;89;20;0;20;1.000;3600000;0
18560;163361;2164;99;47;3;44;.936;3900000;0
18560;177771;2163;58;22;3;19;.864;3900000;0
18560;22144;2164;0;0;0;0;.00nan;0;0
18560;181051;2163;0;0;0;0;.00nan;0;0
18561;6998;2161;0;0;0;0;.00nan;0;0
18561;-1;4840;85;17;0;17;1.000;3600000;0
18561;-1;4840;0;0;0;0;.00nan;0;0
18561;161081;2161;64;40;4;36;.900;3600000;0
18562;19346;2158;0;0;0;0;.00nan;0;0
18562;21607;2162;82;58;5;53;.914;3600000;0
18562;22316;2162;0;0;0;0;.00nan;0;0
18562;75764;2158;100;24;0;24;1.000;3600000;0
18563;6998;2161;0;0;0;0;.00nan;0;0
18563;19346;2158;25;6;3;3;.500;3521000;0
18563;75764;2158;0;0;0;0;.00nan;0;0
18563;161081;2161;99;59;1;58;.983;3600000;0
18564;163361;2164;63;46;5;41;.891;3600000;0
18564;22144;2164;0;0;0;0;.00nan;0;0
18564;-1;4840;85;36;2;34;.944;3600000;0
18564;-1;4840;0;0;0;0;.00nan;0;0
18565;177771;2163;63;22;2;20;.909;3600000;0
18565;21607;2162;91;47;3;44;.936;3600000;0
18565;22316;2162;0;0;0;0;.00nan;0;0
18565;181051;2163;0;0;0;0;.00nan;0;0
18566;6998;2161;0;0;0;0;.00nan;0;0
18566;19346;2158;61;16;1;15;.938;3600000;0
18566;75764;2158;0;0;0;0;.00nan;0;0
18566;161081;2161;72;55;5;50;.909;3600000;0
18567;163361;2164;0;0;0;0;.00nan;0;0
18567;22144;2164;52;31;4;27;.871;3900000;0
18567;-1;4840;62;29;4;25;.862;3900000;0
18567;-1;4840;0;0;0;0;.00nan;0;0
18568;177771;2163;0;0;0;0;.00nan;0;0
18568;21607;2162;0;0;0;0;.00nan;0;0
18568;22316;2162;87;28;1;27;.964;3600000;0
18568;181051;2163;40;32;5;27;.844;3600000;0
18569;177771;2163;88;44;2;42;.955;3566000;0
18569;19346;2158;88;19;0;19;1.000;3600000;0
18569;181051;2163;0;0;0;0;.00nan;0;0
18569;75764;2158;0;0;0;0;.00nan;0;0
18570;21607;2162;76;24;1;23;.958;3900000;0
18570;22316;2162;0;0;0;0;.00nan;0;0
18570;-1;4840;73;24;1;23;.958;3900000;0
18570;-1;4840;0;0;0;0;.00nan;0;0
18571;177771;2163;20;22;6;16;.727;1691000;0
18571;19346;2158;67;17;1;16;.941;3600000;0
18571;181051;2163;82;22;0;22;1.000;1909000;0
18571;75764;2158;0;0;0;0;.00nan;0;0
18572;21607;2162;0;0;0;0;.00nan;0;0
18572;22316;2162;72;24;2;22;.917;3600000;0
18572;-1;4840;0;0;0;0;.00nan;0;0
18572;-1;4840;84;51;3;48;.941;3576000;0
18573;6998;2161;0;0;0;0;.00nan;0;0
18573;21607;2162;0;0;0;0;.00nan;0;0
18573;22316;2162;62;35;4;31;.886;3594000;0
18573;161081;2161;68;31;3;28;.903;3600000;0
18574;177771;2163;59;50;6;44;.880;3600000;0
18574;19346;2158;0;0;0;0;.00nan;0;0
18574;181051;2163;0;0;0;0;.00nan;0;0
18574;75764;2158;80;12;0;12;1.000;3600000;0
18575;6998;2161;71;38;3;35;.921;3548000;0
18575;21607;2162;86;33;2;31;.939;3600000;0
18575;22316;2162;0;0;0;0;.00nan;0;0
18575;161081;2161;0;0;0;0;.00nan;0;0
18576;177771;2163;0;0;0;0;.00nan;0;0
18576;19346;2158;87;13;0;13;1.000;3600000;0
18576;181051;2163;95;50;4;46;.920;3600000;0
18576;75764;2158;0;0;0;0;.00nan;0;0
18577;6998;2161;0;0;0;0;.00nan;0;0
18577;163361;2164;70;26;2;24;.923;3600000;0
18577;22144;2164;0;0;0;0;.00nan;0;0
18577;161081;2161;51;29;4;25;.862;3523000;0
18578;19346;2158;70;20;1;19;.950;3600000;0
18578;-1;4840;89;50;4;46;.920;3600000;0
18578;-1;4840;0;0;0;0;.00nan;0;0
18578;75764;2158;0;0;0;0;.00nan;0;0
18579;177771;2163;100;26;0;26;1.000;3600000;0
18579;21607;2162;66;38;4;34;.895;3600000;0
18579;22316;2162;0;0;0;0;.00nan;0;0
18579;181051;2163;0;0;0;0;.00nan;0;0
18580;6998;2161;96;36;1;35;.972;3600000;0
18580;163361;2164;0;0;0;0;.00nan;0;0
18580;22144;2164;44;24;4;20;.833;3600000;0
18580;161081;2161;0;0;0;0;.00nan;0;0
18581;19346;2158;0;0;0;0;.00nan;0;0
18581;-1;4840;0;0;0;0;.00nan;0;0
18581;-1;4840;85;54;5;49;.907;3600000;0
18581;75764;2158;90;14;0;14;1.000;3600000;0
18582;177771;2163;58;26;3;23;.885;3739000;0
18582;21607;2162;0;0;0;0;.00nan;0;0
18582;22316;2162;67;38;4;34;.895;3739000;0
18582;181051;2163;0;0;0;0;.00nan;0;0
18583;6998;2161;60;50;6;44;.880;2520000;0
18583;19346;2158;0;0;0;0;.00nan;0;0
18583;75764;2158;51;9;1;8;.889;3600000;0
18583;161081;2161;34;21;4;17;.810;1080000;0
18584;21607;2162;0;0;0;0;.00nan;0;0
18584;22316;2162;89;29;2;27;.931;3600000;0
18584;-1;4840;68;39;4;35;.897;3600000;0
18584;-1;4840;0;0;0;0;.00nan;0;0
18585;163361;2164;94;38;2;36;.947;3600000;0
18585;177771;2163;55;40;5;35;.875;3578000;0
18585;22144;2164;0;0;0;0;.00nan;0;0
18585;181051;2163;0;0;0;0;.00nan;0;0
18586;6998;2161;0;0;0;0;.00nan;0;0
18586;19346;2158;0;0;0;0;.00nan;0;0
18586;75764;2158;45;17;3;14;.824;3600000;0
18586;161081;2161;76;53;4;49;.925;3596000;0
18587;21607;2162;41;38;6;32;.842;3600000;0
18587;22316;2162;0;0;0;0;.00nan;0;0
18587;-1;4840;90;33;1;32;.970;3600000;0
18587;-1;4840;0;0;0;0;.00nan;0;0
18588;163361;2164;0;0;0;0;.00nan;0;0
18588;177771;2163;0;0;0;0;.00nan;0;0
18588;22144;2164;77;24;2;22;.917;3546000;0
18588;181051;2163;87;32;1;31;.969;3600000;0
18589;163361;2164;98;46;3;43;.935;3600000;0
18589;19346;2158;0;0;0;0;.00nan;0;0
18589;22144;2164;0;0;0;0;.00nan;0;0
18589;75764;2158;79;9;0;9;1.000;3600000;0
18590;6998;2161;66;30;3;27;.900;3600000;0
18590;21607;2162;45;28;4;24;.857;3542000;0
18590;22316;2162;0;0;0;0;.00nan;0;0
18590;161081;2161;0;0;0;0;.00nan;0;0
18591;177771;2163;55;22;3;19;.864;3600000;0
18591;-1;4840;75;52;6;46;.885;3600000;0
18591;-1;4840;0;0;0;0;.00nan;0;0
18591;181051;2163;0;0;0;0;.00nan;0;0
18592;163361;2164;98;73;4;69;.945;3600000;0
18592;19346;2158;0;0;0;0;.00nan;0;0
18592;22144;2164;0;0;0;0;.00nan;0;0
18592;75764;2158;88;19;0;19;1.000;3600000;0
18593;6998;2161;0;0;0;0;.00nan;0;0
18593;21607;2162;0;0;0;0;.00nan;0;0
18593;22316;2162;44;28;4;24;.857;3528000;0
18593;161081;2161;81;36;2;34;.944;3600000;0
18594;177771;2163;40;21;4;17;.810;3544000;0
18594;-1;4840;65;34;3;31;.912;3600000;0
18594;-1;4840;0;0;0;0;.00nan;0;0
18594;181051;2163;0;0;0;0;.00nan;0;0
18595;163361;2164;90;36;1;35;.972;3600000;0
18595;21607;2162;38;21;4;17;.810;3600000;0
18595;22144;2164;0;0;0;0;.00nan;0;0
18595;22316;2162;0;0;0;0;.00nan;0;0
18596;6998;2161;0;0;0;0;.00nan;0;0
18596;177771;2163;67;17;1;16;.941;3600000;0
18596;181051;2163;0;0;0;0;.00nan;0;0
18596;161081;2161;81;46;3;43;.935;3522000;0
18597;19346;2158;0;0;0;0;.00nan;0;0
18597;-1;4840;75;63;6;57;.905;2826000;0
18597;-1;4840;54;17;2;15;.882;774000;0
18597;75764;2158;88;15;0;15;1.000;3600000;0
18598;163361;2164;53;21;3;18;.857;3695000;0
18598;21607;2162;0;0;0;0;.00nan;0;0
18598;22144;2164;0;0;0;0;.00nan;0;0
18598;22316;2162;88;35;2;33;.943;3695000;0
18599;6998;2161;38;28;5;23;.821;3600000;0
18599;177771;2163;0;0;0;0;.00nan;0;0
18599;181051;2163;70;27;2;25;.926;3600000;0
18599;161081;2161;0;0;0;0;.00nan;0;0
18600;19346;2158;0;0;0;0;.00nan;0;0
18600;-1;4840;43;4;1;3;.750;330000;0
18600;-1;4840;47;49;7;42;.857;3270000;0
18600;75764;2158;58;13;1;12;.923;3600000;0
18601;163361;2164;88;35;2;33;.943;3600000;0
18601;22144;2164;0;0;0;0;.00nan;0;0
18601;-1;4840;70;35;3;32;.914;3575000;0
18601;-1;4840;0;0;0;0;.00nan;0;0
18602;19346;2158;0;0;0;0;.00nan;0;0
18602;21607;2162;87;44;2;42;.955;3600000;0
18602;22316;2162;0;0;0;0;.00nan;0;0
18602;75764;2158;62;11;1;10;.909;3600000;0
18603;6998;2161;0;0;0;0;.00nan;0;0
18603;177771;2163;39;40;6;34;.850;3304000;0
18603;181051;2163;30;2;2;0;.000;296000;0
18603;161081;2161;78;47;4;43;.915;3600000;0
18604;163361;2164;79;26;1;25;.962;3600000;0
18604;22144;2164;0;0;0;0;.00nan;0;0
18604;-1;4840;0;0;0;0;.00nan;0;0
18604;-1;4840;63;30;3;27;.900;3583000;0
18605;19346;2158;0;0;0;0;.00nan;0;0
18605;21607;2162;0;0;0;0;.00nan;0;0
18605;22316;2162;76;50;4;46;.920;3600000;0
18605;75764;2158;88;12;0;12;1.000;3600000;0
18606;6998;2161;73;38;4;34;.895;3900000;0
18606;177771;2163;0;0;0;0;.00nan;0;0
18606;181051;2163;67;40;4;36;.900;3900000;0
18606;161081;2161;0;0;0;0;.00nan;0;0
18607;6998;2161;49;28;3;25;.893;3007000;0
18607;-1;4840;76;24;1;23;.958;3600000;0
18607;-1;4840;0;0;0;0;.00nan;0;0
18607;161081;2161;22;4;3;1;.250;593000;0
18608;163361;2164;58;21;3;18;.857;3600000;0
18608;21607;2162;27;23;5;18;.783;3545000;0
18608;22144;2164;0;0;0;0;.00nan;0;0
18608;22316;2162;0;0;0;0;.00nan;0;0
18609;6998;2161;0;0;0;0;.00nan;0;0
18609;-1;4840;0;0;0;0;.00nan;0;0
18609;-1;4840;81;36;3;33;.917;3513000;0
18609;161081;2161;100;38;1;37;.974;3600000;0
18610;163361;2164;51;36;5;31;.861;3600000;0
18610;21607;2162;0;0;0;0;.00nan;0;0
18610;22144;2164;0;0;0;0;.00nan;0;0
18610;22316;2162;29;30;6;24;.800;3555000;0
18611;6998;2161;0;0;0;0;.00nan;0;0
18611;163361;2164;51;28;4;24;.857;3580000;0
18611;22144;2164;0;0;0;0;.00nan;0;0
18611;161081;2161;55;24;3;21;.875;3600000;0
18612;177771;2163;74;34;3;31;.912;3600000;0
18612;-1;4840;70;41;4;37;.902;3600000;0
18612;-1;4840;0;0;0;0;.00nan;0;0
18612;181051;2163;0;0;0;0;.00nan;0;0
18613;6998;2161;54;38;5;33;.868;3600000;0
18613;163361;2164;62;29;3;26;.897;3600000;0
18613;22144;2164;0;0;0;0;.00nan;0;0
18613;161081;2161;0;0;0;0;.00nan;0;0
18614;177771;2163;0;0;0;0;.00nan;0;0
18614;-1;4840;36;19;4;15;.789;1136000;0
18614;-1;4840;67;17;1;16;.941;2445000;0
18614;181051;2163;66;38;4;34;.895;3600000;0
18615;163361;2164;47;41;6;35;.854;2784000;0
18615;19346;2158;0;0;0;0;.00nan;0;0
18615;22144;2164;53;16;2;14;.875;816000;0
18615;75764;2158;56;18;2;16;.889;3600000;0
18616;21607;2162;100;45;1;44;.978;3891000;0
18616;22316;2162;0;0;0;0;.00nan;0;0
18616;-1;4840;87;33;1;32;.970;3900000;0
18616;-1;4840;0;0;0;0;.00nan;0;0
18617;6998;2161;0;0;0;0;.00nan;0;0
18617;177771;2163;78;33;2;31;.939;3585000;0
18617;181051;2163;0;0;0;0;.00nan;0;0
18617;161081;2161;87;33;1;32;.970;3600000;0
18618;163361;2164;85;63;6;57;.905;3600000;0
18618;19346;2158;54;10;1;9;.900;3600000;0
18618;22144;2164;0;0;0;0;.00nan;0;0
18618;75764;2158;0;0;0;0;.00nan;0;0
18619;21607;2162;48;0;0;0;.00nan;238000;0
18619;22316;2162;41;36;6;30;.833;3314000;0
18619;-1;4840;75;42;5;37;.881;3600000;0
18619;-1;4840;0;0;0;0;.00nan;0;0
18620;6998;2161;99;37;1;36;.973;3600000;0
18620;177771;2163;0;0;0;0;.00nan;0;0
18620;181051;2163;39;18;3;15;.833;3554000;0
18620;161081;2161;0;0;0;0;.00nan;0;0
18621;177771;2163;53;48;7;41;.854;2787000;0
18621;19346;2158;0;0;0;0;.00nan;0;0
18621;181051;2163;61;15;1;14;.933;813000;0
18621;75764;2158;73;20;1;19;.950;3600000;0
18622;163361;2164;66;34;3;31;.912;3600000;0
18622;21607;2162;65;34;4;30;.882;3576000;0
18622;22144;2164;0;0;0;0;.00nan;0;0
18622;22316;2162;0;0;0;0;.00nan;0;0
18623;177771;2163;98;45;1;44;.978;3078000;0
18623;19346;2158;0;0;0;0;.00nan;0;0
18623;181051;2163;30;10;3;7;.700;449000;0
18623;75764;2158;64;20;2;18;.900;3600000;0
18624;163361;2164;66;42;5;37;.881;3732000;0
18624;21607;2162;0;0;0;0;.00nan;0;0
18624;22144;2164;0;0;0;0;.00nan;0;0
18624;22316;2162;57;26;4;22;.846;3732000;0
18625;163361;2164;88;64;5;59;.922;3600000;0
18625;19346;2158;0;0;0;0;.00nan;0;0
18625;22144;2164;0;0;0;0;.00nan;0;0
18625;75764;2158;64;13;1;12;.923;3600000;0
18626;6998;2161;0;0;0;0;.00nan;0;0
18626;21607;2162;68;39;3;36;.923;3551000;0
18626;22316;2162;0;0;0;0;.00nan;0;0
18626;161081;2161;97;35;1;34;.971;3600000;0
18627;177771;2163;91;37;1;36;.973;3600000;0
18627;-1;4840;68;30;3;27;.900;3559000;0
18627;-1;4840;0;0;0;0;.00nan;0;0
18627;181051;2163;0;0;0;0;.00nan;0;0
18628;163361;2164;0;0;0;0;.00nan;0;0
18628;19346;2158;0;0;0;0;.00nan;0;0
18628;22144;2164;90;63;4;59;.937;3600000;0
18628;75764;2158;92;17;0;17;1.000;3600000;0
18629;6998;2161;41;39;7;32;.821;3600000;0
18629;21607;2162;0;0;0;0;.00nan;0;0
18629;22316;2162;64;18;1;17;.944;3600000;0
18629;161081;2161;0;0;0;0;.00nan;0;0
18630;177771;2163;77;32;2;30;.938;3865000;0
18630;-1;4840;0;0;0;0;.00nan;0;0
18630;-1;4840;96;50;2;48;.960;3900000;0
18630;181051;2163;0;0;0;0;.00nan;0;0
18631;6998;2161;0;0;0;0;.00nan;0;0
18631;163361;2164;80;29;2;27;.931;3683000;0
18631;22144;2164;0;0;0;0;.00nan;0;0
18631;161081;2161;67;26;3;23;.885;3683000;0
18632;19346;2158;0;0;0;0;.00nan;0;0
18632;-1;4840;29;13;4;9;.692;801000;0
18632;-1;4840;84;35;1;34;.971;2799000;0
18632;75764;2158;62;18;2;16;.889;3600000;0
18633;177771;2163;93;28;1;27;.964;3900000;0
18633;21607;2162;100;38;1;37;.974;3900000;0
18633;22316;2162;0;0;0;0;.00nan;0;0
18633;181051;2163;0;0;0;0;.00nan;0;0
18634;6998;2161;92;37;1;36;.973;3600000;0
18634;163361;2164;0;0;0;0;.00nan;0;0
18634;22144;2164;54;22;3;19;.864;3524000;0
18634;161081;2161;0;0;0;0;.00nan;0;0
18635;19346;2158;0;0;0;0;.00nan;0;0
18635;-1;4840;89;75;6;69;.920;3600000;0
18635;-1;4840;0;0;0;0;.00nan;0;0
18635;75764;2158;58;11;1;10;.909;3600000;0
18636;177771;2163;61;33;4;29;.879;3568000;0
18636;21607;2162;0;0;0;0;.00nan;0;0
18636;22316;2162;82;41;3;38;.927;3600000;0
18636;181051;2163;0;0;0;0;.00nan;0;0
18637;163361;2164;82;36;2;34;.944;3600000;0
18637;22144;2164;0;0;0;0;.00nan;0;0
18637;-1;4840;53;20;3;17;.850;3545000;0
18637;-1;4840;0;0;0;0;.00nan;0;0
18638;6998;2161;0;0;0;0;.00nan;0;0
18638;177771;2163;56;21;3;18;.857;3552000;0
18638;181051;2163;0;0;0;0;.00nan;0;0
18638;161081;2161;73;36;2;34;.944;3600000;0
18639;19346;2158;0;0;0;0;.00nan;0;0
18639;21607;2162;39;27;4;23;.852;1678000;0
18639;22316;2162;69;29;3;26;.897;1922000;0
18639;75764;2158;61;17;2;15;.882;3600000;0
18640;163361;2164;0;0;0;0;.00nan;0;0
18640;22144;2164;81;27;1;26;.963;3600000;0
18640;-1;4840;0;0;0;0;.00nan;0;0
18640;-1;4840;81;34;2;32;.941;3600000;0
18641;6998;2161;71;31;2;29;.935;3600000;0
18641;177771;2163;0;0;0;0;.00nan;0;0
18641;181051;2163;99;40;1;39;.975;3600000;0
18641;161081;2161;0;0;0;0;.00nan;0;0
18642;19346;2158;45;20;3;17;.850;3819000;0
18642;21607;2162;94;68;4;64;.941;3819000;0
18642;22316;2162;0;0;0;0;.00nan;0;0
18642;75764;2158;0;0;0;0;.00nan;0;0
18643;6998;2161;0;0;0;0;.00nan;0;0
18643;163361;2164;59;27;3;24;.889;3585000;0
18643;22144;2164;0;0;0;0;.00nan;0;0
18643;161081;2161;76;32;2;30;.938;3600000;0
18644;19346;2158;0;0;0;0;.00nan;0;0
18644;21607;2162;83;54;5;49;.907;3600000;0
18644;22316;2162;0;0;0;0;.00nan;0;0
18644;75764;2158;56;8;1;7;.875;3600000;0
18645;177771;2163;39;27;5;22;.815;3542000;0
18645;-1;4840;81;45;3;42;.933;3600000;0
18645;-1;4840;0;0;0;0;.00nan;0;0
18645;181051;2163;0;0;0;0;.00nan;0;0
18646;6998;2161;65;24;2;22;.917;3600000;0
18646;163361;2164;0;0;0;0;.00nan;0;0
18646;22144;2164;47;27;4;23;.852;3579000;0
18646;161081;2161;0;0;0;0;.00nan;0;0
18647;19346;2158;62;11;1;10;.909;3600000;0
18647;21607;2162;63;20;1;19;.950;1109000;0
18647;22316;2162;47;52;7;45;.865;2491000;0
18647;75764;2158;0;0;0;0;.00nan;0;0
18648;177771;2163;0;0;0;0;.00nan;0;0
18648;-1;4840;0;0;0;0;.00nan;0;0
18648;-1;4840;77;38;2;36;.947;3900000;0
18648;181051;2163;82;29;2;27;.931;3900000;0
18649;6998;2161;0;0;0;0;.00nan;0;0
18649;19346;2158;78;12;0;12;1.000;3600000;0
18649;75764;2158;0;0;0;0;.00nan;0;0
18649;161081;2161;90;73;6;67;.918;3600000;0
18650;21607;2162;40;27;5;22;.815;3178000;0
18650;22316;2162;51;2;0;2;1.000;366000;0
18650;-1;4840;62;28;3;25;.893;3600000;0
18650;-1;4840;0;0;0;0;.00nan;0;0
18651;163361;2164;93;40;1;39;.975;3600000;0
18651;177771;2163;86;37;2;35;.946;3600000;0
18651;22144;2164;0;0;0;0;.00nan;0;0
18651;181051;2163;0;0;0;0;.00nan;0;0
18652;6998;2161;63;49;6;43;.878;3600000;0
18652;19346;2158;58;9;1;8;.889;3600000;0
18652;75764;2158;0;0;0;0;.00nan;0;0
18652;161081;2161;0;0;0;0;.00nan;0;0
18653;21607;2162;0;0;0;0;.00nan;0;0
18653;22316;2162;55;28;3;25;.893;3578000;0
18653;-1;4840;0;0;0;0;.00nan;0;0
18653;-1;4840;79;23;1;22;.957;3600000;0
18654;163361;2164;0;0;0;0;.00nan;0;0
18654;177771;2163;0;0;0;0;.00nan;0;0
18654;22144;2164;60;36;4;32;.889;3884000;0
18654;181051;2163;71;36;4;32;.889;3900000;0
18655;163361;2164;85;49;3;46;.939;3600000;0
18655;19346;2158;0;0;0;0;.00nan;0;0
18655;22144;2164;0;0;0;0;.00nan;0;0
18655;75764;2158;45;22;4;18;.818;3569000;0
18656;6998;2161;0;0;0;0;.00nan;0;0
18656;-1;4840;42;24;4;20;.833;3558000;0
18656;-1;4840;0;0;0;0;.00nan;0;0
18656;161081;2161;65;32;3;29;.906;3600000;0
18657;163361;2164;45;37;6;31;.838;2639000;0
18657;19346;2158;0;0;0;0;.00nan;0;0
18657;22144;2164;52;8;1;7;.875;961000;0
18657;75764;2158;80;8;0;8;1.000;3600000;0
18658;6998;2161;77;34;3;31;.912;3900000;0
18658;-1;4840;58;29;3;26;.897;3900000;0
18658;-1;4840;0;0;0;0;.00nan;0;0
18658;161081;2161;0;0;0;0;.00nan;0;0
18659;163361;2164;65;35;3;32;.914;3600000;0
18659;177771;2163;85;30;1;29;.967;3600000;0
18659;22144;2164;0;0;0;0;.00nan;0;0
18659;181051;2163;0;0;0;0;.00nan;0;0
18660;19346;2158;0;0;0;0;.00nan;0;0
18660;-1;4840;95;58;3;55;.948;3600000;0
18660;-1;4840;0;0;0;0;.00nan;0;0
18660;75764;2158;48;9;2;7;.778;3600000;0
18661;6998;2161;0;0;0;0;.00nan;0;0
18661;21607;2162;100;19;0;19;1.000;3600000;0
18661;22316;2162;0;0;0;0;.00nan;0;0
18661;161081;2161;85;32;1;31;.969;3574000;0
18662;163361;2164;87;35;2;33;.943;3600000;0
18662;177771;2163;0;0;0;0;.00nan;0;0
18662;22144;2164;0;0;0;0;.00nan;0;0
18662;181051;2163;43;25;4;21;.840;3565000;0
18663;19346;2158;0;0;0;0;.00nan;0;0
18663;-1;4840;0;0;0;0;.00nan;0;0
18663;-1;4840;100;42;2;40;.952;3718000;0
18663;75764;2158;41;15;3;12;.800;3718000;0
18664;6998;2161;58;33;4;29;.879;3545000;0
18664;21607;2162;63;25;2;23;.920;3600000;0
18664;22316;2162;0;0;0;0;.00nan;0;0
18664;161081;2161;0;0;0;0;.00nan;0;0
18665;6998;2161;98;74;1;73;.986;3600000;0
18665;19346;2158;0;0;0;0;.00nan;0;0
18665;75764;2158;81;14;0;14;1.000;3600000;0
18665;161081;2161;0;0;0;0;.00nan;0;0
18666;163361;2164;77;24;1;23;.958;3600000;0
18666;22144;2164;0;0;0;0;.00nan;0;0
18666;-1;4840;82;44;4;40;.909;3600000;0
18666;-1;4840;0;0;0;0;.00nan;0;0
18667;177771;2163;22;33;7;26;.788;2397000;0
18667;21607;2162;69;24;1;23;.958;3600000;0
18667;22316;2162;0;0;0;0;.00nan;0;0
18667;181051;2163;57;5;0;5;1.000;1203000;0
18668;6998;2161;73;50;5;45;.900;3100000;0
18668;19346;2158;0;0;0;0;.00nan;0;0
18668;75764;2158;80;9;0;9;1.000;3600000;0
18668;161081;2161;27;7;3;4;.571;500000;0
18669;163361;2164;49;30;4;26;.867;3531000;0
18669;22144;2164;0;0;0;0;.00nan;0;0
18669;-1;4840;88;43;2;41;.953;3600000;0
18669;-1;4840;0;0;0;0;.00nan;0;0
18670;177771;2163;92;21;0;21;1.000;3600000;0
18670;21607;2162;0;0;0;0;.00nan;0;0
18670;22316;2162;55;33;4;29;.879;3600000;0
18670;181051;2163;0;0;0;0;.00nan;0;0
18671;163361;2164;82;30;1;29;.967;3600000;0
18671;21607;2162;43;27;4;23;.852;3600000;0
18671;22144;2164;0;0;0;0;.00nan;0;0
18671;22316;2162;0;0;0;0;.00nan;0;0
18672;6998;2161;90;42;3;39;.929;3900000;0
18672;-1;4840;68;32;3;29;.906;3900000;0
18672;-1;4840;0;0;0;0;.00nan;0;0
18672;161081;2161;0;0;0;0;.00nan;0;0
18673;177771;2163;58;42;5;37;.881;3600000;0
18673;19346;2158;76;27;1;26;.963;3600000;0
18673;181051;2163;0;0;0;0;.00nan;0;0
18673;75764;2158;0;0;0;0;.00nan;0;0
18674;163361;2164;67;35;3;32;.914;3600000;0
18674;21607;2162;0;0;0;0;.00nan;0;0
18674;22144;2164;0;0;0;0;.00nan;0;0
18674;22316;2162;45;25;4;21;.840;3548000;0
18675;6998;2161;0;0;0;0;.00nan;0;0
18675;-1;4840;0;0;0;0;.00nan;0;0
18675;-1;4840;100;35;0;35;1.000;3600000;0
18675;161081;2161;98;49;2;47;.959;3542000;0
18676;177771;2163;0;0;0;0;.00nan;0;0
18676;19346;2158;59;17;1;16;.941;3600000;0
18676;181051;2163;69;47;4;43;.915;3600000;0
18676;75764;2158;0;0;0;0;.00nan;0;0
18678;163361;2164;96;70;5;65;.929;3600000;0
18678;22144;2164;0;0;0;0;.00nan;0;0
18678;48586;2158;0;0;0;0;.00nan;0;0
18678;75764;2158;60;16;1;15;.938;3600000;0
18680;6998;2161;55;28;3;25;.893;3567000;0
18680;-1;4840;84;27;1;26;.963;3600000;0
18680;-1;4840;0;0;0;0;.00nan;0;0
18680;161081;2161;0;0;0;0;.00nan;0;0
18682;177771;2163;92;43;3;40;.930;3600000;0
18682;21607;2162;65;47;5;42;.894;3592000;0
18682;22316;2162;0;0;0;0;.00nan;0;0
18682;181051;2163;0;0;0;0;.00nan;0;0
18684;6998;2161;0;0;0;0;.00nan;0;0
18684;21607;2162;0;0;0;0;.00nan;0;0
18684;22316;2162;66;34;4;30;.882;3600000;0
18684;161081;2161;33;35;6;29;.829;3544000;0
18686;177771;2163;0;0;0;0;.00nan;0;0
18686;-1;4840;41;31;4;27;.871;3551000;0
18686;-1;4840;0;0;0;0;.00nan;0;0
18686;181051;2163;61;22;2;20;.909;3600000;0
18688;163361;2164;69;44;5;39;.886;3600000;0
18688;22144;2164;0;0;0;0;.00nan;0;0
18688;48586;2158;71;21;1;20;.952;3600000;0
18688;75764;2158;0;0;0;0;.00nan;0;0
18690;6998;2161;0;0;0;0;.00nan;0;0
18690;-1;4840;61;18;2;16;.889;3900000;0
18690;-1;4840;0;0;0;0;.00nan;0;0
18690;161081;2161;77;36;2;34;.944;3900000;0
18692;163361;2164;77;32;2;30;.938;3555000;0
18692;177771;2163;100;28;0;28;1.000;3600000;0
18692;22144;2164;0;0;0;0;.00nan;0;0
18692;181051;2163;0;0;0;0;.00nan;0;0
18694;21607;2162;48;43;7;36;.837;3600000;0
18694;22316;2162;0;0;0;0;.00nan;0;0
18694;48586;2158;0;0;0;0;.00nan;0;0
18694;75764;2158;73;24;2;22;.917;3600000;0
18696;-1;4840;63;61;7;54;.885;3600000;0
18696;-1;4840;0;0;0;0;.00nan;0;0
18696;48586;2158;53;14;1;13;.929;3600000;0
18696;75764;2158;0;0;0;0;.00nan;0;0
18698;177771;2163;81;34;2;32;.941;3600000;0
18698;21607;2162;0;0;0;0;.00nan;0;0
18698;22316;2162;55;28;3;25;.893;3573000;0
18698;181051;2163;0;0;0;0;.00nan;0;0
18700;6998;2161;93;43;2;41;.953;3858000;0
18700;163361;2164;78;35;3;32;.914;3858000;0
18700;22144;2164;0;0;0;0;.00nan;0;0
18700;161081;2161;0;0;0;0;.00nan;0;0
18702;163361;2164;35;20;4;16;.800;1149000;0
18702;22144;2164;86;32;1;31;.969;2451000;0
18702;48586;2158;0;0;0;0;.00nan;0;0
18702;75764;2158;63;19;2;17;.895;3600000;0
18704;6998;2161;0;0;0;0;.00nan;0;0
18704;-1;4840;0;0;0;0;.00nan;0;0
18704;-1;4840;71;32;2;30;.938;3542000;0
18704;161081;2161;99;34;1;33;.971;3600000;0
18706;177771;2163;0;0;0;0;.00nan;0;0
18706;21607;2162;76;31;2;29;.935;3824000;0
18706;22316;2162;0;0;0;0;.00nan;0;0
18706;181051;2163;80;45;3;42;.933;3824000;0
18708;6998;2161;99;47;1;46;.979;3900000;0
18708;21607;2162;0;0;0;0;.00nan;0;0
18708;22316;2162;65;19;1;18;.947;3900000;0
18708;161081;2161;0;0;0;0;.00nan;0;0
18710;-1;4840;87;55;5;50;.909;3600000;0
18710;-1;4840;0;0;0;0;.00nan;0;0
18710;48586;2158;72;18;1;17;.944;3600000;0
18710;75764;2158;0;0;0;0;.00nan;0;0
18712;163361;2164;86;41;3;38;.927;3590000;0
18712;177771;2163;72;22;1;21;.955;3600000;0
18712;22144;2164;0;0;0;0;.00nan;0;0
18712;181051;2163;0;0;0;0;.00nan;0;0
888;177771;2163;97;56;4;52;.929;3600000;0
888;19346;2158;0;0;0;0;.00nan;0;0
888;181051;2163;0;0;0;0;.00nan;0;0
888;75764;2158;70;17;1;16;.941;3600000;0
889;6998;2161;60;29;3;26;.897;3545000;0
889;163361;2164;88;35;2;33;.943;3600000;0
889;22144;2164;0;0;0;0;.00nan;0;0
889;161081;2161;0;0;0;0;.00nan;0;0
890;177771;2163;88;54;4;50;.926;3600000;0
890;19346;2158;78;10;0;10;1.000;3600000;0
890;181051;2163;0;0;0;0;.00nan;0;0
890;75764;2158;0;0;0;0;.00nan;0;0
891;6998;2161;0;0;0;0;.00nan;0;0
891;163361;2164;100;38;1;37;.974;4402000;0
891;22144;2164;0;0;0;0;.00nan;0;0
891;161081;2161;94;42;2;40;.952;4402000;0
1051;163361;2164;19;21;6;15;.714;1026000;0
1051;19346;2158;67;16;1;15;.938;3600000;0
1051;22144;2164;98;45;2;43;.956;2574000;0
1051;75764;2158;0;0;0;0;.00nan;0;0
1052;163361;2164;77;47;4;43;.915;3600000;0
1052;19346;2158;59;11;1;10;.909;3600000;0
1052;22144;2164;0;0;0;0;.00nan;0;0
1052;75764;2158;0;0;0;0;.00nan;0;0
1053;163361;2164;67;58;7;51;.879;3600000;0
1053;19346;2158;34;13;3;10;.769;3600000;0
1053;22144;2164;0;0;0;0;.00nan;0;0
1053;75764;2158;0;0;0;0;.00nan;0;0
18713;162846;3798;0;0;0;0;.00nan;0;0
18713;44141;3798;78;35;2;33;.943;3600000;0
18713;57340;3795;0;0;0;0;.00nan;0;0
18713;78845;3795;91;41;3;38;.927;3547000;0
18714;168001;3800;0;0;0;0;.00nan;0;0
18714;37070;3796;82;29;1;28;.966;3900000;0
18714;57390;3800;76;22;1;21;.955;3900000;0
18714;58856;3796;0;0;0;0;.00nan;0;0
18715;37638;3797;61;41;6;35;.854;3341000;0
18715;57340;3795;0;0;0;0;.00nan;0;0
18715;59153;3797;51;2;0;2;1.000;246000;0
18715;78845;3795;45;31;5;26;.839;3600000;0
18716;162846;3798;53;3;0;3;1.000;238000;0
18716;44134;4635;42;31;5;26;.839;3600000;0
18716;44141;3798;36;34;6;28;.824;3360000;0
18716;161023;4635;0;0;0;0;.00nan;0;0
18717;37070;3796;30;27;6;21;.778;2691000;0
18717;44134;4635;17;9;4;5;.556;1046000;0
18717;58856;3796;60;6;0;6;1.000;909000;0
18717;161023;4635;43;18;3;15;.833;2530000;0
18718;37638;3797;40;12;3;9;.750;560000;0
18718;57340;3800;59;13;1;12;.923;1318000;0
18718;57390;3800;53;23;4;19;.826;2282000;0
18718;59153;3797;23;21;5;16;.762;3040000;0
18719;168001;3795;0;0;0;0;.00nan;0;0
18719;37070;3796;74;24;1;23;.958;3600000;0
18719;58856;3796;0;0;0;0;.00nan;0;0
18719;78845;3795;47;32;5;27;.844;3600000;0
18720;162846;3798;0;0;0;0;.00nan;0;0
18720;44134;4635;0;0;0;0;.00nan;0;0
18720;44141;3798;67;21;2;19;.905;3600000;0
18720;161023;4635;56;30;4;26;.867;3584000;0
18721;37638;3797;53;39;5;34;.872;3584000;0
18721;44134;4635;53;23;3;20;.870;3600000;0
18721;59153;3797;0;0;0;0;.00nan;0;0
18721;161023;4635;0;0;0;0;.00nan;0;0
18722;162846;3798;0;0;0;0;.00nan;0;0
18722;44141;3798;71;33;4;29;.879;3844000;0
18722;57340;3800;0;0;0;0;.00nan;0;0
18722;57390;3800;69;47;4;43;.915;3900000;0
18723;168001;3795;45;28;5;23;.821;3570000;0
18723;37070;3796;61;30;3;27;.900;3600000;0
18723;58856;3796;0;0;0;0;.00nan;0;0
18723;78845;3795;0;0;0;0;.00nan;0;0
18724;44134;4635;44;21;4;17;.810;3600000;0
18724;57340;3800;0;0;0;0;.00nan;0;0
18724;57390;3800;100;32;0;32;1.000;3600000;0
18724;161023;4635;0;0;0;0;.00nan;0;0
18725;37467;3798;66;22;2;20;.909;3900000;0
18725;37638;3797;94;30;2;28;.933;3900000;0
18725;44141;3798;0;0;0;0;.00nan;0;0
18725;59153;3797;0;0;0;0;.00nan;0;0
18726;37070;3796;0;0;0;0;.00nan;0;0
18726;57340;3800;0;0;0;0;.00nan;0;0
18726;57390;3800;47;37;6;31;.838;3600000;0
18726;58856;3796;72;28;2;26;.929;3600000;0
18727;37467;3798;0;0;0;0;.00nan;0;0
18727;37638;3797;66;10;0;10;1.000;718000;0
18727;44141;3798;56;30;5;25;.833;3600000;0
18727;59153;3797;47;39;6;33;.846;2882000;0
18728;168001;3795;74;28;2;26;.929;3600000;0
18728;44134;4635;0;0;0;0;.00nan;0;0
18728;78845;3795;0;0;0;0;.00nan;0;0
18728;161023;4635;60;25;3;22;.880;3555000;0
18729;37070;3796;76;35;3;32;.914;3600000;0
18729;37467;3798;0;0;0;0;.00nan;0;0
18729;44141;3798;80;22;1;21;.955;3600000;0
18729;58856;3796;0;0;0;0;.00nan;0;0
18730;44134;4635;94;25;0;25;1.000;3600000;0
18730;57340;3800;0;0;0;0;.00nan;0;0
18730;57390;3800;67;38;4;34;.895;3600000;0
18730;161023;4635;0;0;0;0;.00nan;0;0
18731;168001;3795;73;21;1;20;.952;3600000;0
18731;37638;3797;52;31;4;27;.871;3600000;0
18731;59153;3797;0;0;0;0;.00nan;0;0
18731;78845;3795;0;0;0;0;.00nan;0;0
18732;37467;3798;51;27;4;23;.852;3600000;0
18732;37638;3797;0;0;0;0;.00nan;0;0
18732;44141;3798;0;0;0;0;.00nan;0;0
18732;59153;3797;57;38;5;33;.868;3560000;0
18733;37070;3796;88;33;1;32;.970;3600000;0
18733;37638;3797;52;43;6;37;.860;3064000;0
18733;58856;3796;0;0;0;0;.00nan;0;0
18733;59153;3797;49;1;0;1;1.000;536000;0
18734;168001;3795;69;38;4;34;.895;3600000;0
18734;44134;4635;61;16;1;15;.938;3600000;0
18734;78845;3795;0;0;0;0;.00nan;0;0
18734;161023;4635;0;0;0;0;.00nan;0;0
18735;37467;3798;0;0;0;0;.00nan;0;0
18735;44141;3798;66;16;1;15;.938;3600000;0
18735;57340;3800;0;0;0;0;.00nan;0;0
18735;57390;3800;55;34;5;29;.853;3600000;0
18736;37070;3796;0;0;0;0;.00nan;0;0
18736;57340;3800;52;34;5;29;.853;3557000;0
18736;57390;3800;0;0;0;0;.00nan;0;0
18736;58856;3796;55;26;3;23;.885;3600000;0
18737;37070;3796;59;38;4;34;.895;3567000;0
18737;44134;4635;56;17;2;15;.882;3600000;0
18737;58856;3796;0;0;0;0;.00nan;0;0
18737;161023;4635;0;0;0;0;.00nan;0;0
18738;37638;3797;100;34;0;34;1.000;3600000;0
18738;57340;3800;0;0;0;0;.00nan;0;0
18738;57390;3800;65;29;3;26;.897;3600000;0
18738;59153;3797;0;0;0;0;.00nan;0;0
18739;168001;3795;99;51;2;49;.961;3600000;0
18739;37467;3798;0;0;0;0;.00nan;0;0
18739;44141;3798;57;26;3;23;.885;3561000;0
18739;78845;3795;0;0;0;0;.00nan;0;0
18740;37638;3797;68;35;4;31;.886;3600000;0
18740;44134;4635;71;20;1;19;.950;3600000;0
18740;59153;3797;0;0;0;0;.00nan;0;0
18740;161023;4635;0;0;0;0;.00nan;0;0
18741;168001;3795;63;25;3;22;.880;3600000;0
18741;57340;3800;0;0;0;0;.00nan;0;0
18741;57390;3800;68;42;4;38;.905;3574000;0
18741;78845;3795;0;0;0;0;.00nan;0;0
18742;37070;3796;54;36;5;31;.861;3585000;0
18742;37467;3798;0;0;0;0;.00nan;0;0
18742;44141;3798;61;31;4;27;.871;3600000;0
18742;58856;3796;0;0;0;0;.00nan;0;0
18743;37467;3798;39;38;6;32;.842;3544000;0
18743;37638;3797;45;32;5;27;.844;3600000;0
18743;44141;3798;0;0;0;0;.00nan;0;0
18743;59153;3797;0;0;0;0;.00nan;0;0
18744;37070;3796;0;0;0;0;.00nan;0;0
18744;44134;4635;58;19;2;17;.895;3600000;0
18744;58856;3796;85;43;4;39;.907;3600000;0
18744;161023;4635;0;0;0;0;.00nan;0;0
18745;37070;3796;66;22;2;20;.909;3600000;0
18745;37638;3797;88;55;3;52;.945;3591000;0
18745;58856;3796;0;0;0;0;.00nan;0;0
18745;59153;3797;0;0;0;0;.00nan;0;0
18746;168001;3795;47;32;5;27;.844;3574000;0
18746;57340;3800;0;0;0;0;.00nan;0;0
18746;57390;3800;48;18;3;15;.833;3600000;0
18746;78845;3795;0;0;0;0;.00nan;0;0
18747;37467;3798;41;33;5;28;.848;3598000;0
18747;44134;4635;53;34;4;30;.882;3600000;0
18747;44141;3798;0;0;0;0;.00nan;0;0
18747;161023;4635;0;0;0;0;.00nan;0;0
18748;37070;3796;0;0;0;0;.00nan;0;0
18748;57340;3800;0;0;0;0;.00nan;0;0
18748;57390;3800;76;36;4;32;.889;3583000;0
18748;58856;3796;53;23;3;20;.870;3600000;0
18749;37467;3798;73;26;3;23;.885;3587000;0
18749;37638;3797;91;31;1;30;.968;3600000;0
18749;44141;3798;0;0;0;0;.00nan;0;0
18749;59153;3797;0;0;0;0;.00nan;0;0
18750;44134;4635;69;20;1;19;.950;3600000;0
18750;57340;3800;0;0;0;0;.00nan;0;0
18750;57390;3800;71;29;2;27;.931;3557000;0
18750;161023;4635;0;0;0;0;.00nan;0;0
18751;168001;3795;68;33;3;30;.909;3900000;0
18751;37070;3796;84;32;3;29;.906;3900000;0
18751;58856;3796;0;0;0;0;.00nan;0;0
18751;78845;3795;0;0;0;0;.00nan;0;0
18752;37638;3797;30;12;4;8;.667;971000;0
18752;44134;4635;74;21;1;20;.952;3036000;0
18752;59153;3797;33;29;6;23;.793;2629000;0
18752;161023;4635;24;4;3;1;.250;564000;0
18753;168001;3795;0;0;0;0;.00nan;0;0
18753;57340;3800;0;0;0;0;.00nan;0;0
18753;57390;3800;68;28;3;25;.893;3600000;0
18753;78845;3795;80;14;0;14;1.000;3600000;0
18754;37070;3796;70;22;2;20;.909;3600000;0
18754;37638;3797;46;34;5;29;.853;3600000;0
18754;58856;3796;0;0;0;0;.00nan;0;0
18754;59153;3797;0;0;0;0;.00nan;0;0
18755;37467;3798;0;0;0;0;.00nan;0;0
18755;44141;3798;74;26;2;24;.923;3900000;0
18755;57340;3800;60;23;2;21;.913;3900000;0
18755;57390;3800;0;0;0;0;.00nan;0;0
18756;168001;3795;0;0;0;0;.00nan;0;0
18756;44134;4635;73;20;1;19;.950;3600000;0
18756;78845;3795;56;53;7;46;.868;3600000;0
18756;161023;4635;0;0;0;0;.00nan;0;0
18757;168001;3795;94;33;1;32;.970;3600000;0
18757;37467;3798;0;0;0;0;.00nan;0;0
18757;44141;3798;57;23;3;20;.870;3536000;0
18757;78845;3795;0;0;0;0;.00nan;0;0
18758;168001;3795;75;39;4;35;.897;3600000;0
18758;37638;3797;62;39;5;34;.872;3555000;0
18758;59153;3797;0;0;0;0;.00nan;0;0
18758;78845;3795;0;0;0;0;.00nan;0;0
18759;37070;3796;100;47;1;46;.979;3600000;0
18759;37467;3798;48;29;4;25;.862;3600000;0
18759;44141;3798;0;0;0;0;.00nan;0;0
18759;58856;3796;0;0;0;0;.00nan;0;0
18760;44134;4635;77;14;0;14;1.000;3600000;0
18760;57340;3800;0;0;0;0;.00nan;0;0
18760;57390;3800;61;40;5;35;.875;3600000;0
18760;161023;4635;0;0;0;0;.00nan;0;0
18761;37070;3796;54;3;0;3;1.000;442000;0
18761;57340;3800;73;39;4;35;.897;3600000;0
18761;57390;3800;0;0;0;0;.00nan;0;0
18761;58856;3796;9;22;7;15;.682;3158000;0
18762;37638;3797;0;0;0;0;.00nan;0;0
18762;44134;4635;96;19;0;19;1.000;3600000;0
18762;59153;3797;48;36;5;31;.861;3600000;0
18762;161023;4635;0;0;0;0;.00nan;0;0
18763;37070;3796;40;37;6;31;.838;3600000;0
18763;44134;4635;59;30;3;27;.900;3600000;0
18763;58856;3796;0;0;0;0;.00nan;0;0
18763;161023;4635;0;0;0;0;.00nan;0;0
18764;37638;3797;74;26;2;24;.923;3900000;0
18764;57340;3800;0;0;0;0;.00nan;0;0
18764;57390;3800;65;19;2;17;.895;3900000;0
18764;59153;3797;0;0;0;0;.00nan;0;0
18765;168001;3795;100;44;2;42;.955;3600000;0
18765;37467;3798;0;0;0;0;.00nan;0;0
18765;44141;3798;65;31;3;28;.903;3600000;0
18765;78845;3795;0;0;0;0;.00nan;0;0
18766;168001;3795;52;2;0;2;1.000;447000;0
18766;37070;3796;0;0;0;0;.00nan;0;0
18766;58856;3796;88;33;2;31;.939;3600000;0
18766;78845;3795;33;29;6;23;.793;3153000;0
18767;37638;3797;0;0;0;0;.00nan;0;0
18767;44134;4635;42;27;4;23;.852;3600000;0
18767;59153;3797;82;26;1;25;.962;3600000;0
18767;161023;4635;0;0;0;0;.00nan;0;0
18768;37638;3797;25;32;7;25;.781;3269000;0
18768;57340;3800;0;0;0;0;.00nan;0;0
18768;57390;3800;83;26;1;25;.962;3600000;0
18768;59153;3797;50;1;0;1;1.000;331000;0
18769;168001;3795;99;35;1;34;.971;3900000;0
18769;44134;4635;79;24;1;23;.958;3900000;0
18769;78845;3795;0;0;0;0;.00nan;0;0
18769;161023;4635;0;0;0;0;.00nan;0;0
18770;37070;3796;70;45;5;40;.889;3600000;0
18770;37467;3798;0;0;0;0;.00nan;0;0
18770;44141;3798;51;38;6;32;.842;3567000;0
18770;58856;3796;0;0;0;0;.00nan;0;0
18771;37070;3796;0;0;0;0;.00nan;0;0
18771;44134;4635;0;0;0;0;.00nan;0;0
18771;58856;3796;80;26;1;25;.962;3666000;0
18771;161023;4635;69;30;2;28;.933;3666000;0
18772;168001;3795;34;26;5;21;.808;3600000;0
18772;37467;3798;0;0;0;0;.00nan;0;0
18772;44141;3798;23;35;7;28;.800;3517000;0
18772;78845;3795;0;0;0;0;.00nan;0;0
18773;37070;3796;46;31;5;26;.839;3570000;0
18773;37638;3797;66;38;4;34;.895;3600000;0
18773;58856;3796;0;0;0;0;.00nan;0;0
18773;59153;3797;0;0;0;0;.00nan;0;0
18774;168001;3795;70;38;4;34;.895;3600000;0
18774;57340;3800;0;0;0;0;.00nan;0;0
18774;57390;3800;83;30;1;29;.967;3600000;0
18774;78845;3795;0;0;0;0;.00nan;0;0
18775;37467;3798;81;54;5;49;.907;3600000;0
18775;44134;4635;74;19;1;18;.947;3600000;0
18775;44141;3798;0;0;0;0;.00nan;0;0
18775;161023;4635;0;0;0;0;.00nan;0;0
18776;44134;4635;0;0;0;0;.00nan;0;0
18776;57340;3800;60;12;1;11;.917;776000;0
18776;57390;3800;23;24;6;18;.750;2993000;0
18776;161023;4635;46;34;6;28;.824;3784000;0
18777;-1;3800;26;40;8;32;.800;3600000;0
18777;37638;3797;74;34;2;32;.941;3600000;0
18777;57340;3800;0;0;0;0;.00nan;0;0
18777;59153;3797;0;0;0;0;.00nan;0;0
18778;168001;3795;47;45;7;38;.844;3600000;0
18778;37467;3798;0;0;0;0;.00nan;0;0
18778;44141;3798;78;28;2;26;.929;3600000;0
18778;57390;3795;0;0;0;0;.00nan;0;0
18779;37070;3796;61;31;4;27;.871;3590000;0
18779;44134;4635;64;27;3;24;.889;3600000;0
18779;58856;3796;0;0;0;0;.00nan;0;0
18779;161023;4635;0;0;0;0;.00nan;0;0
18780;168001;3795;0;0;0;0;.00nan;0;0
18780;-1;3800;89;44;3;41;.932;3600000;0
18780;57340;3800;0;0;0;0;.00nan;0;0
18780;57390;3795;36;22;5;17;.773;3517000;0
18781;37070;3796;21;10;4;6;.600;1110000;0
18781;44134;4635;59;20;2;18;.900;3600000;0
18781;58856;3796;38;20;4;16;.800;2490000;0
18781;161023;4635;0;0;0;0;.00nan;0;0
18782;168001;3795;0;0;0;0;.00nan;0;0
18782;37638;3797;90;31;1;30;.968;3600000;0
18782;57390;3795;61;26;3;23;.885;3522000;0
18782;59153;3797;0;0;0;0;.00nan;0;0
18783;-1;3800;0;0;0;0;.00nan;0;0
18783;37467;3798;0;0;0;0;.00nan;0;0
18783;44141;3798;72;37;4;33;.892;3600000;0
18783;64734;3800;52;34;5;29;.853;3578000;0
18784;37638;3797;71;41;4;37;.902;3566000;0
18784;57338;3796;69;25;2;23;.920;3600000;0
18784;58856;3796;0;0;0;0;.00nan;0;0
18784;59153;3797;0;0;0;0;.00nan;0;0
18785;37070;3800;0;0;0;0;.00nan;0;0
18785;37467;3798;0;0;0;0;.00nan;0;0
18785;44141;3798;100;37;1;36;.973;3900000;0
18785;64734;3800;89;38;1;37;.974;3900000;0
18786;44134;4635;81;27;1;26;.963;3600000;0
18786;57390;3795;91;38;2;36;.947;3582000;0
18786;78845;3795;0;0;0;0;.00nan;0;0
18786;161023;4635;0;0;0;0;.00nan;0;0
18787;37638;3797;32;31;6;25;.806;2139000;0
18787;44134;4635;65;16;1;15;.938;3600000;0
18787;59153;3797;56;20;2;18;.900;1461000;0
18787;161023;4635;0;0;0;0;.00nan;0;0
18788;37070;3800;94;33;2;31;.939;3600000;0
18788;57390;3795;64;29;3;26;.897;3545000;0
18788;64734;3800;0;0;0;0;.00nan;0;0
18788;78845;3795;0;0;0;0;.00nan;0;0
18789;37467;3798;0;0;0;0;.00nan;0;0
18789;44141;3798;55;31;4;27;.871;3600000;0
18789;57338;3796;45;36;6;30;.833;3312000;0
18789;58856;3796;53;3;0;3;1.000;288000;0
18790;37467;3798;0;0;0;0;.00nan;0;0
18790;44141;3798;49;23;4;19;.826;3600000;0
18790;57390;3795;59;44;6;38;.864;3574000;0
18790;78845;3795;0;0;0;0;.00nan;0;0
18791;37467;3798;66;31;3;28;.903;3541000;0
18791;37638;3797;0;0;0;0;.00nan;0;0
18791;44141;3798;0;0;0;0;.00nan;0;0
18791;59153;3797;70;23;2;21;.913;3600000;0
18792;37070;3800;100;30;0;30;1.000;3600000;0
18792;44134;4635;73;16;1;15;.938;3547000;0
18792;64734;3800;0;0;0;0;.00nan;0;0
18792;161023;4635;0;0;0;0;.00nan;0;0
18793;37638;3797;60;39;5;34;.872;3600000;0
18793;57390;3795;89;34;2;32;.941;3600000;0
18793;59153;3797;0;0;0;0;.00nan;0;0
18793;78845;3795;0;0;0;0;.00nan;0;0
18794;57338;3796;69;38;5;33;.868;3548000;0
18794;57390;3795;59;35;4;31;.886;3600000;0
18794;58856;3796;0;0;0;0;.00nan;0;0
18794;78845;3795;0;0;0;0;.00nan;0;0
18795;-1;3796;0;0;0;0;.00nan;0;0
18795;37638;3797;72;24;2;22;.917;3600000;0
18795;57338;3796;45;31;4;27;.871;3528000;0
18795;59153;3797;0;0;0;0;.00nan;0;0
18796;44134;4635;38;20;4;16;.800;3600000;0
18796;57390;3795;50;49;7;42;.857;3600000;0
18796;78845;3795;0;0;0;0;.00nan;0;0
18796;161023;4635;0;0;0;0;.00nan;0;0
18797;37070;3800;59;31;4;27;.871;3599000;0
18797;37467;3798;0;0;0;0;.00nan;0;0
18797;44141;3798;58;30;3;27;.900;3600000;0
18797;64734;3800;0;0;0;0;.00nan;0;0
18798;37070;3800;80;43;3;40;.930;3900000;0
18798;37467;3798;55;23;3;20;.870;3885000;0
18798;44141;3798;0;0;0;0;.00nan;0;0
18798;64734;3800;0;0;0;0;.00nan;0;0
18799;37638;3797;0;0;0;0;.00nan;0;0
18799;44134;4635;61;23;2;21;.913;3600000;0
18799;59153;3797;67;45;5;40;.889;3600000;0
18799;161023;4635;0;0;0;0;.00nan;0;0
18800;-1;3796;0;0;0;0;.00nan;0;0
18800;37638;3797;58;32;4;28;.875;3592000;0
18800;57338;3796;85;44;2;42;.955;3600000;0
18800;59153;3797;0;0;0;0;.00nan;0;0
18801;37070;3800;0;0;0;0;.00nan;0;0
18801;57390;3795;86;34;2;32;.941;3674000;0
18801;64734;3800;88;36;3;33;.917;3674000;0
18801;78845;3795;0;0;0;0;.00nan;0;0
18802;37467;3798;48;0;0;0;.00nan;442000;0
18802;44134;4635;41;23;4;19;.826;3600000;0
18802;44141;3798;49;42;6;36;.857;3072000;0
18802;161023;4635;0;0;0;0;.00nan;0;0
18803;37638;3797;0;0;0;0;.00nan;0;0
18803;57390;3795;0;0;0;0;.00nan;0;0
18803;59153;3797;64;37;4;33;.892;3739000;0
18803;78845;3795;57;39;5;34;.872;3739000;0
18804;-1;3796;59;41;4;37;.902;3600000;0
18804;37070;3800;66;46;5;41;.891;3543000;0
18804;57338;3796;0;0;0;0;.00nan;0;0
18804;64734;3800;0;0;0;0;.00nan;0;0
18805;37467;3798;49;36;5;31;.861;3600000;0
18805;44134;4635;0;0;0;0;.00nan;0;0
18805;44141;3798;0;0;0;0;.00nan;0;0
18805;161023;4635;71;32;2;30;.938;3600000;0
18806;-1;3796;0;0;0;0;.00nan;0;0
18806;37467;3798;0;0;0;0;.00nan;0;0
18806;44141;3798;82;39;3;36;.923;3600000;0
18806;57338;3796;51;30;5;25;.833;3532000;0
18807;37638;3797;50;30;5;25;.833;2236000;0
18807;44134;4635;55;13;2;11;.846;3600000;0
18807;59153;3797;59;16;2;14;.875;1364000;0
18807;161023;4635;0;0;0;0;.00nan;0;0
18808;37467;3798;71;23;1;22;.957;3600000;0
18808;44141;3798;0;0;0;0;.00nan;0;0
18808;57390;3795;87;30;2;28;.933;3586000;0
18808;78845;3795;0;0;0;0;.00nan;0;0
18809;-1;3796;96;33;1;32;.970;3900000;0
18809;37070;3800;100;40;1;39;.975;3900000;0
18809;57338;3796;0;0;0;0;.00nan;0;0
18809;64734;3800;0;0;0;0;.00nan;0;0
18810;-1;3796;0;0;0;0;.00nan;0;0
18810;57338;3796;26;32;7;25;.781;3600000;0
18810;57390;3795;56;29;4;25;.862;3600000;0
18810;78845;3795;0;0;0;0;.00nan;0;0
18811;37467;3798;0;0;0;0;.00nan;0;0
18811;44134;4635;73;23;1;22;.957;3600000;0
18811;44141;3798;54;40;5;35;.875;3600000;0
18811;161023;4635;0;0;0;0;.00nan;0;0
18812;37070;3800;74;30;2;28;.933;3548000;0
18812;37638;3797;92;36;1;35;.972;3600000;0
18812;59153;3797;0;0;0;0;.00nan;0;0
18812;64734;3800;0;0;0;0;.00nan;0;0
18813;-1;3796;54;16;2;14;.875;3600000;0
18813;57338;3796;0;0;0;0;.00nan;0;0
18813;57390;3795;0;0;0;0;.00nan;0;0
18813;78845;3795;68;41;5;36;.878;3600000;0
18814;37070;3800;0;0;0;0;.00nan;0;0
18814;37638;3797;42;20;4;16;.800;3600000;0
18814;59153;3797;0;0;0;0;.00nan;0;0
18814;64734;3800;54;40;6;34;.850;3555000;0
18815;-1;3796;0;0;0;0;.00nan;0;0
18815;37070;3800;89;23;0;23;1.000;3600000;0
18815;57338;3796;31;27;5;22;.815;3600000;0
18815;64734;3800;0;0;0;0;.00nan;0;0
18816;44134;4635;52;19;3;16;.842;3900000;0
18816;57390;3795;94;41;3;38;.927;3900000;0
18816;78845;3795;0;0;0;0;.00nan;0;0
18816;161023;4635;0;0;0;0;.00nan;0;0
18817;37467;3798;78;21;1;20;.952;2572000;0
18817;37638;3797;57;32;4;28;.875;3600000;0
18817;44141;3798;33;17;4;13;.765;1028000;0
18817;59153;3797;0;0;0;0;.00nan;0;0
18818;-1;3796;69;30;3;27;.900;3600000;0
18818;37467;3798;0;0;0;0;.00nan;0;0
18818;44141;3798;74;41;4;37;.902;3592000;0
18818;57338;3796;0;0;0;0;.00nan;0;0
18819;37070;3800;72;36;5;31;.861;3547000;0
18819;44134;4635;0;0;0;0;.00nan;0;0
18819;64734;3800;0;0;0;0;.00nan;0;0
18819;161023;4635;58;25;4;21;.840;3600000;0
18820;37638;3797;0;0;0;0;.00nan;0;0
18820;57390;3795;0;0;0;0;.00nan;0;0
18820;59153;3797;39;36;7;29;.806;3600000;0
18820;78845;3795;70;20;1;19;.950;3600000;0
18822;37070;3796;49;33;6;27;.818;3867000;0
18822;44134;4635;50;32;5;27;.844;3867000;0
18822;58856;3796;0;0;0;0;.00nan;0;0
18822;161023;4635;0;0;0;0;.00nan;0;0
18824;37638;3797;59;36;4;32;.889;3900000;0
18824;57340;3795;0;0;0;0;.00nan;0;0
18824;59153;3797;0;0;0;0;.00nan;0;0
18824;78845;3795;75;39;4;35;.897;3900000;0
18826;162846;3798;0;0;0;0;.00nan;0;0
18826;168001;3800;0;0;0;0;.00nan;0;0
18826;44141;3798;80;22;1;21;.955;3600000;0
18826;57390;3800;70;27;2;25;.926;3584000;0
18828;162846;3798;17;23;6;17;.739;3543000;0
18828;168001;3800;67;50;5;45;.900;3600000;0
18828;44141;3798;0;0;0;0;.00nan;0;0
18828;57390;3800;0;0;0;0;.00nan;0;0
18830;37070;3796;0;0;0;0;.00nan;0;0
18830;44134;4635;0;0;0;0;.00nan;0;0
18830;58856;3796;71;28;2;26;.929;3600000;0
18830;161023;4635;54;25;3;22;.880;3520000;0
18832;37638;3797;0;0;0;0;.00nan;0;0
18832;57340;3795;68;33;3;30;.909;3563000;0
18832;59153;3797;91;33;1;32;.970;3600000;0
18832;78845;3795;0;0;0;0;.00nan;0;0
18834;37638;3797;53;50;6;44;.880;3600000;0
18834;57340;3795;0;0;0;0;.00nan;0;0
18834;59153;3797;0;0;0;0;.00nan;0;0
18834;78845;3795;61;20;2;18;.900;3600000;0
18836;162846;3798;0;0;0;0;.00nan;0;0
18836;37070;3796;54;46;6;40;.870;3600000;0
18836;44141;3798;75;28;2;26;.929;3600000;0
18836;58856;3796;0;0;0;0;.00nan;0;0
18838;168001;3800;53;10;1;9;.900;1302000;0
18838;44134;4635;47;17;3;14;.824;3600000;0
18838;57390;3800;75;39;4;35;.897;2235000;0
18838;161023;4635;0;0;0;0;.00nan;0;0
18840;37638;3797;73;35;3;32;.914;3555000;0
18840;44134;4635;70;22;1;21;.955;3600000;0
18840;59153;3797;0;0;0;0;.00nan;0;0
18840;161023;4635;0;0;0;0;.00nan;0;0
18842;37070;3796;84;26;1;25;.962;3600000;0
18842;57340;3795;0;0;0;0;.00nan;0;0
18842;58856;3796;0;0;0;0;.00nan;0;0
18842;78845;3795;68;28;3;25;.893;3562000;0
18844;162846;3798;0;0;0;0;.00nan;0;0
18844;168001;3800;0;0;0;0;.00nan;0;0
18844;44141;3798;68;30;3;27;.900;3600000;0
18844;57390;3800;49;22;4;18;.818;3582000;0
18846;37070;3796;0;0;0;0;.00nan;0;0
18846;57340;3795;59;36;5;31;.861;3600000;0
18846;58856;3796;70;22;2;20;.909;3600000;0
18846;78845;3795;0;0;0;0;.00nan;0;0
18848;168001;3800;49;32;4;28;.875;3600000;0
18848;44134;4635;0;0;0;0;.00nan;0;0
18848;57390;3800;0;0;0;0;.00nan;0;0
18848;161023;4635;51;32;5;27;.844;3575000;0
18850;162846;3798;37;25;5;20;.800;3600000;0
18850;37638;3797;0;0;0;0;.00nan;0;0
18850;44141;3798;0;0;0;0;.00nan;0;0
18850;59153;3797;51;43;6;37;.860;3575000;0
18852;168001;3800;0;0;0;0;.00nan;0;0
18852;57340;3795;0;0;0;0;.00nan;0;0
18852;57390;3800;49;29;5;24;.828;3900000;0
18852;78845;3795;43;33;5;28;.848;3900000;0
18854;162846;3798;0;0;0;0;.00nan;0;0
18854;37638;3797;33;23;5;18;.783;1689000;0
18854;44141;3798;48;26;4;22;.846;3600000;0
18854;59153;3797;97;26;0;26;1.000;1911000;0
18856;37070;3796;64;34;3;31;.912;3600000;0
18856;44134;4635;78;30;2;28;.933;3600000;0
18856;58856;3796;0;0;0;0;.00nan;0;0
18856;161023;4635;0;0;0;0;.00nan;0;0
600;37467;3798;0;0;0;0;.00nan;0;0
600;37638;3797;91;29;1;28;.966;3600000;0
600;44141;3798;85;34;2;32;.941;3551000;0
600;59153;3797;0;0;0;0;.00nan;0;0
601;37070;3800;48;22;3;19;.864;3580000;0
601;57390;3795;63;22;2;20;.909;3600000;0
601;64734;3800;0;0;0;0;.00nan;0;0
601;78845;3795;0;0;0;0;.00nan;0;0
602;37467;3798;0;0;0;0;.00nan;0;0
602;37638;3797;79;32;2;30;.938;3582000;0
602;44141;3798;92;22;0;22;1.000;3600000;0
602;59153;3797;0;0;0;0;.00nan;0;0
603;37070;3800;49;33;6;27;.818;2512000;0
603;57390;3795;47;13;2;11;.846;3600000;0
603;64734;3800;56;4;0;4;1.000;1088000;0
603;78845;3795;0;0;0;0;.00nan;0;0
604;37467;3798;0;0;0;0;.00nan;0;0
604;37638;3797;73;37;3;34;.919;3600000;0
604;44141;3798;85;30;1;29;.967;3600000;0
604;59153;3797;0;0;0;0;.00nan;0;0
605;37070;3800;0;0;0;0;.00nan;0;0
605;57390;3795;79;38;2;36;.947;5614000;0
605;64734;3800;92;45;3;42;.933;5614000;0
605;78845;3795;0;0;0;0;.00nan;0;0
606;37467;3798;0;0;0;0;.00nan;0;0
606;37638;3797;54;32;5;27;.844;3600000;0
606;44141;3798;54;21;2;19;.905;3600000;0
606;59153;3797;0;0;0;0;.00nan;0;0
607;37070;3800;36;27;5;22;.815;3600000;0
607;57390;3795;97;36;2;34;.944;3600000;0
607;64734;3800;0;0;0;0;.00nan;0;0
607;78845;3795;0;0;0;0;.00nan;0;0
896;37467;3798;0;0;0;0;.00nan;0;0
896;37638;3797;29;14;4;10;.714;740000;0
896;44141;3798;79;34;2;32;.941;3600000;0
896;59153;3797;60;32;4;28;.875;2860000;0
920;44134;4635;60;13;1;12;.923;3600000;0
920;57390;3795;90;45;3;42;.933;3552000;0
920;78845;3795;0;0;0;0;.00nan;0;0
920;161023;4635;0;0;0;0;.00nan;0;0
921;-1;3796;0;0;0;0;.00nan;0;0
921;37467;3798;0;0;0;0;.00nan;0;0
921;44141;3798;37;32;6;26;.813;3595000;0
921;57338;3796;81;35;2;33;.943;3600000;0
922;44134;4635;79;28;2;26;.929;3600000;0
922;57390;3795;59;40;5;35;.875;3600000;0
922;78845;3795;0;0;0;0;.00nan;0;0
922;161023;4635;0;0;0;0;.00nan;0;0
923;-1;3796;0;0;0;0;.00nan;0;0
923;37467;3798;0;0;0;0;.00nan;0;0
923;44141;3798;35;25;5;20;.800;3584000;0
923;57338;3796;64;30;3;27;.900;3600000;0
924;44134;4635;32;20;4;16;.800;3565000;0
924;57390;3795;99;47;3;44;.936;3600000;0
924;78845;3795;0;0;0;0;.00nan;0;0
924;161023;4635;0;0;0;0;.00nan;0;0
925;-1;3796;0;0;0;0;.00nan;0;0
925;37467;3798;0;0;0;0;.00nan;0;0
925;44141;3798;45;21;4;17;.810;3600000;0
925;57338;3796;27;35;7;28;.800;3600000;0
926;44134;4635;79;22;1;21;.955;3600000;0
926;57390;3795;85;35;3;32;.914;3600000;0
926;78845;3795;0;0;0;0;.00nan;0;0
926;161023;4635;0;0;0;0;.00nan;0;0
927;-1;3796;0;0;0;0;.00nan;0;0
927;37467;3798;0;0;0;0;.00nan;0;0
927;44141;3798;68;33;3;30;.909;3600000;0
927;57338;3796;44;34;6;28;.824;3600000;0
1073;44134;4635;85;13;0;13;1.000;3600000;0
1073;57390;3795;29;14;4;10;.714;1007000;0
1073;78845;3795;45;29;5;24;.828;2593000;0
1073;161023;4635;0;0;0;0;.00nan;0;0
1074;-1;3796;0;0;0;0;.00nan;0;0
1074;37467;3798;0;0;0;0;.00nan;0;0
1074;44141;3798;59;37;5;32;.865;3600000;0
1074;57338;3796;57;40;6;34;.850;3576000;0
1108;-1;3796;0;0;0;0;.00nan;0;0
1108;37467;3798;0;0;0;0;.00nan;0;0
1108;44141;3798;70;29;2;27;.931;4233000;0
1108;57338;3796;84;46;3;43;.935;4240000;0
1179;37467;3798;0;0;0;0;.00nan;0;0
1179;44134;4635;23;6;3;3;.500;575000;0
1179;44141;3798;62;37;4;33;.892;3600000;0
1179;161023;4635;45;29;4;25;.862;3025000;0
1180;37467;3798;0;0;0;0;.00nan;0;0
1180;44134;4635;77;30;2;28;.933;3600000;0
1180;44141;3798;78;38;3;35;.921;3600000;0
1180;161023;4635;0;0;0;0;.00nan;0;0
1181;37467;3798;0;0;0;0;.00nan;0;0
1181;44134;4635;85;34;2;32;.941;3600000;0
1181;44141;3798;59;41;5;36;.878;3580000;0
1181;161023;4635;0;0;0;0;.00nan;0;0
1182;37467;3798;0;0;0;0;.00nan;0;0
1182;44134;4635;76;26;2;24;.923;3600000;0
1182;44141;3798;47;32;5;27;.844;3600000;0
1182;161023;4635;0;0;0;0;.00nan;0;0
1349;37467;3798;0;0;0;0;.00nan;0;0
1349;44134;4635;63;18;1;17;.944;3600000;0
1349;44141;3798;53;43;6;37;.860;3600000;0
1349;161023;4635;0;0;0;0;.00nan;0;0
18857;11751;1427;62;36;4;32;.889;3552000;0
18857;185124;1427;0;0;0;0;.00nan;0;0
18857;81691;1440;69;31;3;28;.903;3600000;0
18857;143100;1440;0;0;0;0;.00nan;0;0
18858;11751;1427;59;28;3;25;.893;3600000;0
18858;185124;1427;0;0;0;0;.00nan;0;0
18858;46781;1429;85;30;2;28;.933;3600000;0
18858;-1;1429;0;0;0;0;.00nan;0;0
18859;5923;4742;30;54;10;44;.815;3600000;0
18859;17596;1443;45;15;3;12;.800;3600000;0
18859;181269;1443;0;0;0;0;.00nan;0;0
18859;36946;4742;0;0;0;0;.00nan;0;0
18860;1765;1430;0;0;0;0;.00nan;0;0
18860;3517;4961;0;0;0;0;.00nan;0;0
18860;-1;4961;99;37;1;36;.973;3600000;0
18860;32819;1430;69;26;2;24;.923;3549000;0
18861;9524;1453;55;4;0;4;1.000;532000;0
18861;165030;1453;4;23;7;16;.696;3068000;0
18861;62884;1425;70;31;3;28;.903;3600000;0
18861;68961;1425;0;0;0;0;.00nan;0;0
18862;4379;1422;60;22;3;19;.864;3600000;0
18862;185123;1422;0;0;0;0;.00nan;0;0
18862;-1;1426;0;0;0;0;.00nan;0;0
18862;149981;1426;56;43;6;37;.860;3600000;0
18863;4379;1422;56;18;2;16;.889;3600000;0
18863;185123;1422;0;0;0;0;.00nan;0;0
18863;81691;1440;32;32;7;25;.781;1665000;0
18863;143100;1440;42;21;4;17;.810;1935000;0
18864;5923;4742;36;18;4;14;.778;1106000;0
18864;17596;1443;0;0;0;0;.00nan;0;0
18864;181269;1443;75;9;0;9;1.000;3600000;0
18864;36946;4742;64;37;4;33;.892;2494000;0
18865;3517;4961;0;0;0;0;.00nan;0;0
18865;9524;1453;0;0;0;0;.00nan;0;0
18865;165030;1453;23;20;5;15;.750;3600000;0
18865;-1;4961;95;37;1;36;.973;3600000;0
18866;1765;1430;0;0;0;0;.00nan;0;0
18866;32819;1430;65;18;1;17;.944;3600000;0
18866;-1;1426;0;0;0;0;.00nan;0;0
18866;149981;1426;79;37;2;35;.946;3576000;0
18867;46781;1429;53;54;7;47;.870;3600000;0
18867;-1;1429;0;0;0;0;.00nan;0;0
18867;62884;1425;63;16;1;15;.938;3600000;0
18867;68961;1425;0;0;0;0;.00nan;0;0
18868;1765;1430;0;0;0;0;.00nan;0;0
18868;32819;1430;51;13;2;11;.846;3600000;0
18868;81691;1440;0;0;0;0;.00nan;0;0
18868;143100;1440;62;46;6;40;.870;3600000;0
18869;17596;1443;0;0;0;0;.00nan;0;0
18869;181269;1443;56;18;2;16;.889;3600000;0
18869;46781;1429;65;34;3;31;.912;3600000;0
18869;-1;1429;0;0;0;0;.00nan;0;0
18870;5923;4742;63;39;4;35;.897;3600000;0
18870;11751;1427;68;26;2;24;.923;3600000;0
18870;185124;1427;0;0;0;0;.00nan;0;0
18870;36946;4742;0;0;0;0;.00nan;0;0
18871;9524;1453;0;0;0;0;.00nan;0;0
18871;165030;1453;59;32;3;29;.906;3573000;0
18871;-1;1426;0;0;0;0;.00nan;0;0
18871;149981;1426;97;39;2;37;.949;3600000;0
18872;1765;1430;0;0;0;0;.00nan;0;0
18872;4379;1422;79;33;2;31;.939;3600000;0
18872;32819;1430;73;47;5;42;.894;3600000;0
18872;185123;1422;0;0;0;0;.00nan;0;0
18873;3517;4961;0;0;0;0;.00nan;0;0
18873;-1;4961;50;30;4;26;.867;3600000;0
18873;62884;1425;61;14;1;13;.929;3600000;0
18873;68961;1425;0;0;0;0;.00nan;0;0
18874;5923;4742;48;13;2;11;.846;1348000;0
18874;36946;4742;12;18;6;12;.667;2252000;0
18874;46781;1429;77;19;1;18;.947;3600000;0
18874;-1;1429;0;0;0;0;.00nan;0;0
18875;62884;1425;46;20;3;17;.850;3560000;0
18875;68961;1425;0;0;0;0;.00nan;0;0
18875;81691;1440;79;30;2;28;.933;3600000;0
18875;143100;1440;0;0;0;0;.00nan;0;0
18876;11751;1427;38;20;4;16;.800;806000;0
18876;17596;1443;0;0;0;0;.00nan;0;0
18876;185124;1427;72;59;5;54;.915;2794000;0
18876;181269;1443;42;13;3;10;.769;3600000;0
18877;3517;4961;0;0;0;0;.00nan;0;0
18877;4379;1422;74;24;1;23;.958;3600000;0
18877;-1;4961;52;43;6;37;.860;3600000;0
18877;185123;1422;0;0;0;0;.00nan;0;0
18878;9524;1453;61;27;3;24;.889;3600000;0
18878;165030;1453;0;0;0;0;.00nan;0;0
18878;-1;1426;0;0;0;0;.00nan;0;0
18878;149981;1426;66;43;5;38;.884;3574000;0
18879;17596;1443;46;12;3;9;.750;3600000;0
18879;181269;1443;0;0;0;0;.00nan;0;0
18879;-1;1426;66;17;1;16;.941;980000;0
18879;149981;1426;54;40;6;34;.850;2620000;0
18880;1765;1430;0;0;0;0;.00nan;0;0
18880;5923;4742;47;36;6;30;.833;3600000;0
18880;32819;1430;53;17;2;15;.882;3600000;0
18880;36946;4742;0;0;0;0;.00nan;0;0
18881;11751;1427;66;41;5;36;.878;3600000;0
18881;185124;1427;0;0;0;0;.00nan;0;0
18881;62884;1425;84;15;0;15;1.000;3600000;0
18881;68961;1425;0;0;0;0;.00nan;0;0
18882;4127;1453;78;23;1;22;.957;3600000;0
18882;165030;1453;0;0;0;0;.00nan;0;0
18882;46781;1429;43;30;5;25;.833;3600000;0
18882;-1;1429;0;0;0;0;.00nan;0;0
18883;3517;4961;0;0;0;0;.00nan;0;0
18883;4379;1422;100;24;0;24;1.000;3600000;0
18883;-1;4961;56;45;6;39;.867;3600000;0
18883;185123;1422;0;0;0;0;.00nan;0;0
18884;46781;1429;55;31;4;27;.871;3583000;0
18884;-1;1429;0;0;0;0;.00nan;0;0
18884;81691;1440;74;34;3;31;.912;3600000;0
18884;143100;1440;0;0;0;0;.00nan;0;0
18885;1765;1430;32;23;5;18;.783;3600000;0
18885;5923;4742;72;24;2;22;.917;1405000;0
18885;32819;1430;0;0;0;0;.00nan;0;0
18885;36946;4742;32;30;6;24;.800;2195000;0
18886;3517;4961;0;0;0;0;.00nan;0;0
18886;11751;1427;57;30;4;26;.867;3666000;0
18886;-1;4961;60;33;3;30;.909;3706000;0
18886;185124;1427;0;0;0;0;.00nan;0;0
18887;17596;1443;0;0;0;0;.00nan;0;0
18887;181269;1443;52;17;2;15;.882;3600000;0
18887;-1;1426;52;50;7;43;.860;3144000;0
18887;149981;1426;43;5;1;4;.800;456000;0
18888;4127;1453;60;28;4;24;.857;2446000;0
18888;165030;1453;43;22;4;18;.818;1124000;0
18888;62884;1425;7;20;7;13;.650;3600000;0
18888;68961;1425;0;0;0;0;.00nan;0;0
18889;3517;4961;0;0;0;0;.00nan;0;0
18889;-1;4961;49;32;5;27;.844;3558000;0
18889;46781;1429;41;23;4;19;.826;3600000;0
18889;-1;1429;0;0;0;0;.00nan;0;0
18890;11751;1427;58;37;4;33;.892;3600000;0
18890;185124;1427;0;0;0;0;.00nan;0;0
18890;81691;1440;100;36;1;35;.972;3600000;0
18890;143100;1440;0;0;0;0;.00nan;0;0
18891;1765;1430;0;0;0;0;.00nan;0;0
18891;17596;1443;0;0;0;0;.00nan;0;0
18891;32819;1430;82;41;2;39;.951;3900000;0
18891;181269;1443;75;22;1;21;.955;3900000;0
18892;-1;1426;0;0;0;0;.00nan;0;0
18892;62884;1425;63;22;2;20;.909;3518000;0
18892;68961;1425;0;0;0;0;.00nan;0;0
18892;149981;1426;100;44;0;44;1.000;3600000;0
18893;3517;4961;0;0;0;0;.00nan;0;0
18893;4127;1453;90;20;0;20;1.000;3600000;0
18893;165030;1453;0;0;0;0;.00nan;0;0
18893;-1;4961;47;35;5;30;.857;3600000;0
18894;4379;1422;81;26;1;25;.962;3600000;0
18894;5923;4742;50;47;7;40;.851;3600000;0
18894;185123;1422;0;0;0;0;.00nan;0;0
18894;36946;4742;0;0;0;0;.00nan;0;0
18895;4127;1453;39;31;6;25;.806;3600000;0
18895;165030;1453;0;0;0;0;.00nan;0;0
18895;46781;1429;61;15;1;14;.933;3600000;0
18895;-1;1429;0;0;0;0;.00nan;0;0
18896;1765;1430;0;0;0;0;.00nan;0;0
18896;17596;1443;59;20;2;18;.900;3600000;0
18896;32819;1430;73;53;5;48;.906;3600000;0
18896;181269;1443;0;0;0;0;.00nan;0;0
18897;5923;4742;0;0;0;0;.00nan;0;0
18897;36946;4742;56;34;4;30;.882;3576000;0
18897;-1;1426;0;0;0;0;.00nan;0;0
18897;149981;1426;82;35;2;33;.943;3600000;0
18898;4379;1422;51;24;4;20;.833;3600000;0
18898;11751;1427;0;0;0;0;.00nan;0;0
18898;185123;1422;0;0;0;0;.00nan;0;0
18898;185124;1427;51;37;6;31;.838;3511000;0
18899;62884;1425;0;0;0;0;.00nan;0;0
18899;68961;1425;67;22;2;20;.909;3600000;0
18899;81691;1440;91;29;0;29;1.000;2511000;0
18899;143100;1440;20;15;5;10;.667;1089000;0
18900;4379;1422;47;39;6;33;.846;3658000;0
18900;17596;1443;0;0;0;0;.00nan;0;0
18900;181269;1443;38;25;5;20;.800;3615000;0
18900;160027;1422;0;0;0;0;.00nan;0;0
18901;5923;4742;66;40;4;36;.900;3600000;0
18901;36946;4742;0;0;0;0;.00nan;0;0
18901;46781;1429;30;30;6;24;.800;3593000;0
18901;-1;1429;0;0;0;0;.00nan;0;0
18902;1765;1430;0;0;0;0;.00nan;0;0
18902;4127;1453;0;0;0;0;.00nan;0;0
18902;165030;1453;39;18;4;14;.778;3600000;0
18902;32819;1430;99;38;1;37;.974;3600000;0
18903;3517;4961;49;1;0;1;1.000;268000;0
18903;-1;4961;74;55;6;49;.891;3300000;0
18903;62884;1425;49;27;5;22;.815;3600000;0
18903;68961;1425;0;0;0;0;.00nan;0;0
18904;11751;1427;98;44;2;42;.955;3878000;0
18904;185124;1427;0;0;0;0;.00nan;0;0
18904;-1;1426;0;0;0;0;.00nan;0;0
18904;149981;1426;58;22;2;20;.909;3900000;0
18905;46781;1429;0;0;0;0;.00nan;0;0
18905;-1;1429;92;46;3;43;.935;3600000;0
18905;81691;1440;0;0;0;0;.00nan;0;0
18905;143100;1440;51;32;5;27;.844;3538000;0
18906;3517;4961;0;0;0;0;.00nan;0;0
18906;11751;1427;0;0;0;0;.00nan;0;0
18906;-1;4961;45;29;5;24;.828;3564000;0
18906;185124;1427;52;29;4;25;.862;3600000;0
18907;4127;1453;68;41;4;37;.902;3600000;0
18907;5923;4742;0;0;0;0;.00nan;0;0
18907;165030;1453;0;0;0;0;.00nan;0;0
18907;36946;4742;32;21;5;16;.762;3580000;0
18908;4379;1422;0;0;0;0;.00nan;0;0
18908;17596;1443;44;33;5;28;.848;3900000;0
18908;181269;1443;0;0;0;0;.00nan;0;0
18908;160027;1422;59;34;5;29;.853;3900000;0
18909;1765;1430;60;10;0;10;1.000;1227000;0
18909;32819;1430;45;29;6;23;.793;2373000;0
18909;62884;1425;91;14;0;14;1.000;3600000;0
18909;68961;1425;0;0;0;0;.00nan;0;0
18910;5923;4742;52;43;6;37;.860;3600000;0
18910;36946;4742;0;0;0;0;.00nan;0;0
18910;-1;1426;0;0;0;0;.00nan;0;0
18910;149981;1426;51;19;3;16;.842;3600000;0
18911;46781;1429;100;33;0;33;1.000;3600000;0
18911;-1;1426;46;22;4;18;.818;2546000;0
18911;-1;1429;0;0;0;0;.00nan;0;0
18911;149981;1426;36;19;4;15;.789;1054000;0
18912;3517;4961;0;0;0;0;.00nan;0;0
18912;-1;4961;86;55;4;51;.927;3600000;0
18912;17596;1443;0;0;0;0;.00nan;0;0
18912;181269;1443;77;9;0;9;1.000;3600000;0
18913;1765;1430;0;0;0;0;.00nan;0;0
18913;32819;1430;70;32;3;29;.906;3600000;0
18913;62884;1425;67;17;1;16;.941;3600000;0
18913;68961;1425;0;0;0;0;.00nan;0;0
18914;4127;1453;0;0;0;0;.00nan;0;0
18914;165030;1453;89;23;0;23;1.000;3600000;0
18914;81691;1440;47;46;7;39;.848;2953000;0
18914;143100;1440;53;3;0;3;1.000;647000;0
18915;4379;1422;69;25;2;23;.920;3600000;0
18915;11751;1427;50;30;5;25;.833;3600000;0
18915;185124;1427;0;0;0;0;.00nan;0;0
18915;160027;1422;0;0;0;0;.00nan;0;0
18916;4127;1453;0;0;0;0;.00nan;0;0
18916;165030;1453;49;33;5;28;.848;3600000;0
18916;81691;1440;50;23;3;20;.870;2355000;0
18916;143100;1440;29;16;4;12;.750;1175000;0
18917;5923;4742;68;43;5;38;.884;3547000;0
18917;36946;4742;0;0;0;0;.00nan;0;0
18917;62884;1425;56;18;3;15;.833;3600000;0
18917;68961;1425;0;0;0;0;.00nan;0;0
18918;1765;1430;0;0;0;0;.00nan;0;0
18918;11751;1427;36;35;6;29;.829;3600000;0
18918;32819;1430;100;26;0;26;1.000;3600000;0
18918;185124;1427;0;0;0;0;.00nan;0;0
18919;3517;4961;43;40;7;33;.825;1745000;0
18919;-1;4961;49;24;3;21;.875;1855000;0
18919;17596;1443;0;0;0;0;.00nan;0;0
18919;181269;1443;57;10;1;9;.900;3600000;0
18920;4379;1422;0;0;0;0;.00nan;0;0
18920;-1;1426;41;31;5;26;.839;1370000;0
18920;149981;1426;44;31;5;26;.839;2230000;0
18920;160027;1422;54;20;2;18;.900;3600000;0
18921;11751;1427;92;48;3;45;.938;3600000;0
18921;185124;1427;0;0;0;0;.00nan;0;0
18921;62884;1425;92;19;0;19;1.000;3600000;0
18921;68961;1425;0;0;0;0;.00nan;0;0
18922;17596;1443;0;0;0;0;.00nan;0;0
18922;181269;1443;46;11;3;8;.727;3600000;0
18922;81691;1440;42;43;7;36;.837;3200000;0
18922;143100;1440;50;9;1;8;.889;400000;0
18923;1765;1430;0;0;0;0;.00nan;0;0
18923;32819;1430;50;24;3;21;.875;3600000;0
18923;46781;1429;52;33;4;29;.879;3580000;0
18923;-1;1429;0;0;0;0;.00nan;0;0
18924;5923;4742;69;36;3;33;.917;3553000;0
18924;11751;1427;77;28;2;26;.929;3600000;0
18924;185124;1427;0;0;0;0;.00nan;0;0
18924;36946;4742;0;0;0;0;.00nan;0;0
18925;3517;4961;52;4;0;4;1.000;286000;0
18925;-1;4961;26;30;6;24;.800;3314000;0
18925;-1;1426;0;0;0;0;.00nan;0;0
18925;149981;1426;59;40;5;35;.875;3600000;0
18926;4127;1453;0;0;0;0;.00nan;0;0
18926;4379;1422;70;38;4;34;.895;3600000;0
18926;165030;1453;58;25;3;22;.880;3600000;0
18926;160027;1422;0;0;0;0;.00nan;0;0
18927;11751;1427;76;40;3;37;.925;3555000;0
18927;185124;1427;0;0;0;0;.00nan;0;0
18927;46781;1429;0;0;0;0;.00nan;0;0
18927;-1;1429;87;28;1;27;.964;3600000;0
18928;1765;1430;51;21;3;18;.857;3600000;0
18928;32819;1430;0;0;0;0;.00nan;0;0
18928;81691;1440;0;0;0;0;.00nan;0;0
18928;143100;1440;48;29;5;24;.828;3572000;0
18929;3517;4961;77;26;1;25;.962;3600000;0
18929;-1;4961;0;0;0;0;.00nan;0;0
18929;-1;1426;0;0;0;0;.00nan;0;0
18929;149981;1426;69;34;3;31;.912;3529000;0
18930;4127;1453;81;45;3;42;.933;3600000;0
18930;4379;1422;0;0;0;0;.00nan;0;0
18930;165030;1453;0;0;0;0;.00nan;0;0
18930;160027;1422;56;34;4;30;.882;3546000;0
18931;5923;4742;51;37;6;31;.838;2706000;0
18931;36946;4742;52;18;2;16;.889;894000;0
18931;62884;1425;59;16;2;14;.875;3600000;0
18931;68961;1425;0;0;0;0;.00nan;0;0
18932;1765;1430;0;0;0;0;.00nan;0;0
18932;4379;1422;93;20;0;20;1.000;3600000;0
18932;32819;1430;86;41;3;38;.927;3600000;0
18932;160027;1422;0;0;0;0;.00nan;0;0
18933;46781;1429;72;41;3;38;.927;3600000;0
18933;-1;1429;0;0;0;0;.00nan;0;0
18933;62884;1425;46;20;4;16;.800;3600000;0
18933;68961;1425;0;0;0;0;.00nan;0;0
18934;11751;1427;43;40;7;33;.825;3600000;0
18934;17596;1443;0;0;0;0;.00nan;0;0
18934;185124;1427;0;0;0;0;.00nan;0;0
18934;181269;1443;44;12;2;10;.833;3600000;0
18935;3517;4961;0;0;0;0;.00nan;0;0
18935;5923;4742;85;37;2;35;.946;3600000;0
18935;-1;4961;35;35;6;29;.829;3600000;0
18935;36946;4742;0;0;0;0;.00nan;0;0
18936;-1;1426;0;0;0;0;.00nan;0;0
18936;81691;1440;53;36;5;31;.861;3543000;0
18936;143100;1440;0;0;0;0;.00nan;0;0
18936;149981;1426;47;23;4;19;.826;3600000;0
18937;4127;1453;35;32;6;26;.813;2848000;0
18937;4379;1422;89;22;0;22;1.000;3600000;0
18937;165030;1453;65;10;0;10;1.000;752000;0
18937;160027;1422;0;0;0;0;.00nan;0;0
18938;17596;1443;64;12;1;11;.917;3600000;0
18938;181269;1443;0;0;0;0;.00nan;0;0
18938;81691;1440;48;36;5;31;.861;1981000;0
18938;143100;1440;51;27;4;23;.852;1619000;0
18939;3517;4961;43;28;4;24;.857;3046000;0
18939;5923;4742;0;0;0;0;.00nan;0;0
18939;-1;4961;31;11;3;8;.727;554000;0
18939;36946;4742;82;36;2;34;.944;3600000;0
18940;11751;1427;63;33;4;29;.879;3527000;0
18940;185124;1427;0;0;0;0;.00nan;0;0
18940;46781;1429;0;0;0;0;.00nan;0;0
18940;-1;1429;75;29;2;27;.931;3600000;0
18941;1765;1430;0;0;0;0;.00nan;0;0
18941;4127;1453;0;0;0;0;.00nan;0;0
18941;165030;1453;73;30;2;28;.933;3520000;0
18941;32819;1430;100;27;0;27;1.000;3600000;0
18942;-1;1426;18;20;6;14;.700;1324000;0
18942;62884;1425;0;0;0;0;.00nan;0;0
18942;68961;1425;44;21;4;17;.810;3600000;0
18942;149981;1426;39;44;7;37;.841;2276000;0
18943;181269;1443;48;31;5;26;.839;3600000;0
18943;62884;1425;37;30;6;24;.800;3551000;0
18943;68961;1425;0;0;0;0;.00nan;0;0
18943;83252;1443;0;0;0;0;.00nan;0;0
18944;5923;4742;74;42;5;37;.881;3600000;0
18944;175530;1429;45;21;4;17;.810;3600000;0
18944;36946;4742;0;0;0;0;.00nan;0;0
18944;46781;1429;0;0;0;0;.00nan;0;0
18945;1765;1430;0;0;0;0;.00nan;0;0
18945;11751;1427;23;26;6;20;.769;3600000;0
18945;32819;1430;57;17;3;14;.824;3600000;0
18945;185124;1427;0;0;0;0;.00nan;0;0
18946;4127;1453;73;36;4;32;.889;3756000;0
18946;165030;1453;0;0;0;0;.00nan;0;0
18946;-1;1426;0;0;0;0;.00nan;0;0
18946;149981;1426;57;22;3;19;.864;3756000;0
18947;4379;1422;78;29;1;28;.966;3600000;0
18947;81691;1440;87;31;2;29;.935;3600000;0
18947;143100;1440;0;0;0;0;.00nan;0;0
18947;160027;1422;0;0;0;0;.00nan;0;0
18948;1765;1430;0;0;0;0;.00nan;0;0
18948;175530;1429;63;16;0;16;1.000;1586000;0
18948;32819;1430;66;35;4;31;.886;3900000;0
18948;46781;1429;42;27;4;23;.852;2314000;0
18949;-1;1426;62;11;0;11;1.000;1286000;0
18949;81691;1440;66;8;0;8;1.000;863000;0
18949;143100;1440;30;25;6;19;.760;3037000;0
18949;149981;1426;25;28;6;22;.786;2614000;0
18950;4127;1453;0;0;0;0;.00nan;0;0
18950;11751;1427;62;33;4;29;.879;3544000;0
18950;165030;1453;80;36;3;33;.917;3600000;0
18950;185124;1427;0;0;0;0;.00nan;0;0
18951;3517;4961;0;0;0;0;.00nan;0;0
18951;4379;1422;0;0;0;0;.00nan;0;0
18951;-1;4961;95;51;3;48;.941;3600000;0
18951;160027;1422;31;22;4;18;.818;3600000;0
18952;181269;1443;0;0;0;0;.00nan;0;0
18952;62884;1425;0;0;0;0;.00nan;0;0
18952;68961;1425;55;32;4;28;.875;3557000;0
18952;83252;1443;72;27;3;24;.889;3600000;0
18953;181269;1443;0;0;0;0;.00nan;0;0
18953;-1;1426;0;0;0;0;.00nan;0;0
18953;83252;1443;45;20;3;17;.850;3600000;0
18953;149981;1426;68;53;7;46;.868;3600000;0
18954;5923;4742;55;36;5;31;.861;3600000;0
18954;36946;4742;0;0;0;0;.00nan;0;0
18954;81691;1440;90;32;1;31;.969;3600000;0
18954;143100;1440;0;0;0;0;.00nan;0;0
18955;1765;1430;0;0;0;0;.00nan;0;0
18955;3517;4961;0;0;0;0;.00nan;0;0
18955;-1;4961;40;34;6;28;.824;3600000;0
18955;32819;1430;73;23;1;22;.957;3600000;0
18956;4127;1453;79;33;2;31;.939;3600000;0
18956;11751;1427;47;30;5;25;.833;3600000;0
18956;165030;1453;0;0;0;0;.00nan;0;0
18956;185124;1427;0;0;0;0;.00nan;0;0
18957;4379;1422;100;22;0;22;1.000;3600000;0
18957;175530;1429;0;0;0;0;.00nan;0;0
18957;46781;1429;60;41;6;35;.854;3600000;0
18957;160027;1422;0;0;0;0;.00nan;0;0
18958;175530;1429;57;48;6;42;.875;3600000;0
18958;181269;1443;0;0;0;0;.00nan;0;0
18958;46781;1429;0;0;0;0;.00nan;0;0
18958;83252;1443;62;12;1;11;.917;3600000;0
18959;11751;1427;70;27;2;25;.926;3600000;0
18959;185124;1427;0;0;0;0;.00nan;0;0
18959;81691;1440;0;0;0;0;.00nan;0;0
18959;143100;1440;54;23;4;19;.826;3548000;0
18960;1765;1430;0;0;0;0;.00nan;0;0
18960;3517;4961;40;32;6;26;.813;3126000;0
18960;-1;4961;54;5;0;5;1.000;474000;0
18960;32819;1430;41;16;3;13;.813;3600000;0
18961;4127;1453;0;0;0;0;.00nan;0;0
18961;165030;1453;60;31;4;27;.871;3549000;0
18961;-1;1426;60;29;3;26;.897;3600000;0
18961;149981;1426;0;0;0;0;.00nan;0;0
18962;4379;1422;61;42;5;37;.881;3600000;0
18962;62884;1425;89;17;0;17;1.000;3600000;0
18962;68961;1425;0;0;0;0;.00nan;0;0
18962;160027;1422;0;0;0;0;.00nan;0;0
18963;4127;1453;25;11;4;7;.636;984000;0
18963;165030;1453;72;36;2;34;.944;2616000;0
18963;181269;1443;0;0;0;0;.00nan;0;0
18963;83252;1443;60;22;2;20;.909;3600000;0
18964;3517;4961;0;0;0;0;.00nan;0;0
18964;-1;4961;49;25;4;21;.840;3600000;0
18964;81691;1440;64;47;5;42;.894;3546000;0
18964;143100;1440;0;0;0;0;.00nan;0;0
18965;1765;1430;0;0;0;0;.00nan;0;0
18965;5923;4742;48;29;4;25;.862;3541000;0
18965;32819;1430;71;36;3;33;.917;3600000;0
18965;36946;4742;0;0;0;0;.00nan;0;0
18966;4379;1422;70;34;3;31;.912;3600000;0
18966;-1;1426;0;0;0;0;.00nan;0;0
18966;149981;1426;46;29;5;24;.828;3518000;0
18966;160027;1422;0;0;0;0;.00nan;0;0
18967;175530;1429;11;31;8;23;.742;3600000;0
18967;46781;1429;0;0;0;0;.00nan;0;0
18967;62884;1425;100;27;0;27;1.000;3600000;0
18967;68961;1425;0;0;0;0;.00nan;0;0
18968;4379;1422;73;18;1;17;.944;3600000;0
18968;175530;1429;0;0;0;0;.00nan;0;0
18968;46781;1429;55;38;6;32;.842;3600000;0
18968;160027;1422;0;0;0;0;.00nan;0;0
18969;1765;1430;0;0;0;0;.00nan;0;0
18969;5923;4742;0;0;0;0;.00nan;0;0
18969;32819;1430;83;30;2;28;.933;3600000;0
18969;36946;4742;40;28;5;23;.821;3600000;0
18970;11751;1427;63;25;3;22;.880;3600000;0
18970;185124;1427;0;0;0;0;.00nan;0;0
18970;-1;1426;0;0;0;0;.00nan;0;0
18970;149981;1426;59;39;5;34;.872;3600000;0
18971;3517;4961;0;0;0;0;.00nan;0;0
18971;-1;4961;59;12;1;11;.917;3600000;0
18971;81691;1440;37;35;6;29;.829;3305000;0
18971;143100;1440;42;9;2;7;.778;295000;0
18972;4127;1453;45;17;3;14;.824;900000;0
18972;165030;1453;62;44;6;38;.864;2700000;0
18972;181269;1443;0;0;0;0;.00nan;0;0
18972;83252;1443;95;12;0;12;1.000;3600000;0
18973;3517;4961;0;0;0;0;.00nan;0;0
18973;-1;4961;51;52;7;45;.865;3600000;0
18973;181269;1443;0;0;0;0;.00nan;0;0
18973;83252;1443;54;10;1;9;.900;3600000;0
18974;5923;4742;81;52;5;47;.904;3600000;0
18974;36946;4742;0;0;0;0;.00nan;0;0
18974;62884;1425;47;21;3;18;.857;3600000;0
18974;68961;1425;0;0;0;0;.00nan;0;0
18975;1765;1430;0;0;0;0;.00nan;0;0
18975;32819;1430;55;34;4;30;.882;3900000;0
18975;-1;1426;0;0;0;0;.00nan;0;0
18975;149981;1426;58;34;4;30;.882;3900000;0
18976;11751;1427;100;27;0;27;1.000;3600000;0
18976;185124;1427;0;0;0;0;.00nan;0;0
18976;81691;1440;74;40;4;36;.900;3600000;0
18976;143100;1440;0;0;0;0;.00nan;0;0
18977;4127;1453;0;0;0;0;.00nan;0;0
18977;4379;1422;46;35;5;30;.857;3736000;0
18977;165030;1453;45;39;6;33;.846;3736000;0
18977;160027;1422;0;0;0;0;.00nan;0;0
18978;5923;4742;0;0;0;0;.00nan;0;0
18978;175530;1429;84;28;1;27;.964;3600000;0
18978;36946;4742;72;42;4;38;.905;3600000;0
18978;46781;1429;0;0;0;0;.00nan;0;0
18979;1765;1430;0;0;0;0;.00nan;0;0
18979;32819;1430;46;19;3;16;.842;3600000;0
18979;81691;1440;0;0;0;0;.00nan;0;0
18979;143100;1440;68;37;4;33;.892;3581000;0
18980;3517;4961;0;0;0;0;.00nan;0;0
18980;-1;4961;58;42;5;37;.881;3600000;0
18980;181269;1443;0;0;0;0;.00nan;0;0
18980;83252;1443;79;13;0;13;1.000;3600000;0
18981;4379;1422;59;22;2;20;.909;3900000;0
18981;-1;1426;99;49;2;47;.959;3900000;0
18981;149981;1426;0;0;0;0;.00nan;0;0
18981;160027;1422;0;0;0;0;.00nan;0;0
18982;11751;1427;90;44;2;42;.955;3900000;0
18982;185124;1427;0;0;0;0;.00nan;0;0
18982;62884;1425;82;20;2;18;.900;3900000;0
18982;68961;1425;0;0;0;0;.00nan;0;0
18983;11751;1427;33;39;7;32;.821;3080000;0
18983;185124;1427;58;8;0;8;1.000;520000;0
18983;181269;1443;0;0;0;0;.00nan;0;0
18983;83252;1443;69;17;1;16;.941;3600000;0
18984;1765;1430;0;0;0;0;.00nan;0;0
18984;175530;1429;0;0;0;0;.00nan;0;0
18984;32819;1430;32;26;6;20;.769;3600000;0
18984;46781;1429;93;47;3;44;.936;3600000;0
18985;4379;1422;60;23;2;21;.913;3600000;0
18985;5923;4742;31;39;7;32;.821;3600000;0
18985;36946;4742;0;0;0;0;.00nan;0;0
18985;160027;1422;0;0;0;0;.00nan;0;0
18986;3517;4961;0;0;0;0;.00nan;0;0
18986;-1;4961;72;56;5;51;.911;3600000;0
18986;62884;1425;35;18;4;14;.778;3600000;0
18986;68961;1425;0;0;0;0;.00nan;0;0
18987;175530;1429;77;41;3;38;.927;3573000;0
18987;46781;1429;0;0;0;0;.00nan;0;0
18987;62884;1425;47;16;2;14;.875;3600000;0
18987;68961;1425;0;0;0;0;.00nan;0;0
18988;181269;1443;0;0;0;0;.00nan;0;0
18988;81691;1440;54;7;1;6;.857;326000;0
18988;83252;1443;56;17;2;15;.882;3600000;0
18988;143100;1440;72;53;6;47;.887;3274000;0
18989;4379;1422;71;27;2;25;.926;3600000;0
18989;5923;4742;0;0;0;0;.00nan;0;0
18989;36946;4742;88;58;3;55;.948;3567000;0
18989;160027;1422;0;0;0;0;.00nan;0;0
18990;4127;1453;55;4;0;4;1.000;565000;0
18990;11751;1427;0;0;0;0;.00nan;0;0
18990;165030;1453;18;24;6;18;.750;3035000;0
18990;185124;1427;53;23;3;20;.870;3600000;0
18991;3517;4961;0;0;0;0;.00nan;0;0
18991;-1;4961;32;20;5;15;.750;3600000;0
18991;-1;1426;0;0;0;0;.00nan;0;0
18991;149981;1426;86;33;2;31;.939;3600000;0
18992;5923;4742;92;36;2;34;.944;3600000;0
18992;36946;4742;0;0;0;0;.00nan;0;0
18992;81691;1440;25;38;8;30;.789;3600000;0
18992;143100;1440;0;0;0;0;.00nan;0;0
18993;1765;1430;71;39;4;35;.897;2482000;0
18993;32819;1430;38;18;4;14;.778;1118000;0
18993;181269;1443;0;0;0;0;.00nan;0;0
18993;83252;1443;75;9;0;9;1.000;3600000;0
18994;5923;4742;0;0;0;0;.00nan;0;0
18994;36946;4742;65;31;2;29;.935;3600000;0
18994;81691;1440;0;0;0;0;.00nan;0;0
18994;143100;1440;84;27;1;26;.963;3600000;0
18995;3517;4961;0;0;0;0;.00nan;0;0
18995;4127;1453;56;10;1;9;.900;1118000;0
18995;165030;1453;12;17;6;11;.647;2482000;0
18995;-1;4961;68;38;4;34;.895;3600000;0
18996;175530;1429;0;0;0;0;.00nan;0;0
18996;46781;1429;65;18;2;16;.889;3600000;0
18996;-1;1426;0;0;0;0;.00nan;0;0
18996;149981;1426;56;22;3;19;.864;3588000;0
18997;4379;1422;82;37;3;34;.919;3900000;0
18997;62884;1425;64;31;3;28;.903;3900000;0
18997;68961;1425;0;0;0;0;.00nan;0;0
18997;160027;1422;0;0;0;0;.00nan;0;0
18998;3517;4961;0;0;0;0;.00nan;0;0
18998;-1;4961;43;40;6;34;.850;3600000;0
18998;175530;1429;49;21;3;18;.857;3600000;0
18998;46781;1429;0;0;0;0;.00nan;0;0
18999;-1;1426;0;0;0;0;.00nan;0;0
18999;81691;1440;0;0;0;0;.00nan;0;0
18999;143100;1440;78;23;1;22;.957;3600000;0
18999;149981;1426;70;36;4;32;.889;3600000;0
19000;4127;1453;0;0;0;0;.00nan;0;0
19000;5923;4742;56;35;4;31;.886;3900000;0
19000;165030;1453;69;41;4;37;.902;3896000;0
19000;36946;4742;0;0;0;0;.00nan;0;0
19001;4379;1422;76;34;3;31;.912;3562000;0
19001;181269;1443;0;0;0;0;.00nan;0;0
19001;83252;1443;67;25;2;23;.920;3600000;0
19001;160027;1422;0;0;0;0;.00nan;0;0
19002;4379;1422;90;51;5;46;.902;3600000;0
19002;181269;1443;0;0;0;0;.00nan;0;0
19002;83252;1443;77;19;1;18;.947;3600000;0
19002;160027;1422;0;0;0;0;.00nan;0;0
19003;1765;1430;0;0;0;0;.00nan;0;0
19003;11751;1427;59;31;4;27;.871;3550000;0
19003;32819;1430;78;30;2;28;.933;3600000;0
19003;185124;1427;0;0;0;0;.00nan;0;0
19004;3517;4961;0;0;0;0;.00nan;0;0
19004;-1;4961;70;26;2;24;.923;3600000;0
19004;175530;1429;0;0;0;0;.00nan;0;0
19004;46781;1429;39;32;5;27;.844;3600000;0
19005;4127;1453;73;25;2;23;.920;3600000;0
19005;165030;1453;0;0;0;0;.00nan;0;0
19005;81691;1440;64;42;4;38;.905;3547000;0
19005;143100;1440;0;0;0;0;.00nan;0;0
19006;5923;4742;0;0;0;0;.00nan;0;0
19006;36946;4742;97;62;4;58;.935;3900000;0
19006;62884;1425;39;15;4;11;.733;3900000;0
19006;68961;1425;0;0;0;0;.00nan;0;0
19007;1765;1430;48;27;4;23;.852;3600000;0
19007;11751;1427;96;37;1;36;.973;3600000;0
19007;32819;1430;0;0;0;0;.00nan;0;0
19007;185124;1427;0;0;0;0;.00nan;0;0
19008;-1;1426;0;0;0;0;.00nan;0;0
19008;62884;1425;74;27;2;25;.926;3563000;0
19008;68961;1425;0;0;0;0;.00nan;0;0
19008;149981;1426;100;40;1;39;.975;3600000;0
19009;175530;1429;93;56;1;55;.982;3794000;0
19009;181269;1443;0;0;0;0;.00nan;0;0
19009;46781;1429;0;0;0;0;.00nan;0;0
19009;83252;1443;51;14;2;12;.857;3794000;0
19010;5923;4742;71;22;1;21;.955;3600000;0
19010;36946;4742;0;0;0;0;.00nan;0;0
19010;-1;1426;56;17;2;15;.882;3005000;0
19010;149981;1426;26;6;3;3;.500;595000;0
19011;3517;4961;0;0;0;0;.00nan;0;0
19011;11751;1427;77;28;2;26;.929;3600000;0
19011;-1;4961;38;38;6;32;.842;3600000;0
19011;185124;1427;0;0;0;0;.00nan;0;0
19012;4127;1453;64;40;4;36;.900;3600000;0
19012;165030;1453;0;0;0;0;.00nan;0;0
19012;62884;1425;54;16;2;14;.875;3600000;0
19012;68961;1425;0;0;0;0;.00nan;0;0
19013;1765;1430;75;25;1;24;.960;2524000;0
19013;4379;1422;30;32;6;26;.813;3592000;0
19013;32819;1430;46;18;4;14;.778;1076000;0
19013;160027;1422;0;0;0;0;.00nan;0;0
19014;175530;1429;0;0;0;0;.00nan;0;0
19014;181269;1443;0;0;0;0;.00nan;0;0
19014;46781;1429;73;46;5;41;.891;3600000;0
19014;83252;1443;56;10;1;9;.900;3600000;0
19015;5923;4742;0;0;0;0;.00nan;0;0
19015;36946;4742;60;24;2;22;.917;3600000;0
19015;-1;1426;49;1;0;1;1.000;430000;0
19015;149981;1426;36;40;6;34;.850;3170000;0
19016;4127;1453;67;22;1;21;.955;3600000;0
19016;165030;1453;0;0;0;0;.00nan;0;0
19016;81691;1440;63;31;3;28;.903;3530000;0
19016;143100;1440;0;0;0;0;.00nan;0;0
19017;1765;1430;0;0;0;0;.00nan;0;0
19017;4379;1422;64;26;3;23;.885;3600000;0
19017;32819;1430;56;35;4;31;.886;3527000;0
19017;160027;1422;0;0;0;0;.00nan;0;0
19018;3517;4961;41;15;3;12;.800;1635000;0
19018;11751;1427;83;27;1;26;.963;3600000;0
19018;-1;4961;10;17;6;11;.647;1965000;0
19018;185124;1427;0;0;0;0;.00nan;0;0
19019;5923;4742;70;43;4;39;.907;3900000;0
19019;11751;1427;64;35;4;31;.886;3900000;0
19019;185124;1427;0;0;0;0;.00nan;0;0
19019;36946;4742;0;0;0;0;.00nan;0;0
19020;1765;1430;0;0;0;0;.00nan;0;0
19020;32819;1430;46;38;6;32;.842;3544000;0
19020;-1;1426;0;0;0;0;.00nan;0;0
19020;149981;1426;60;36;4;32;.889;3600000;0
19021;4127;1453;88;45;3;42;.933;3572000;0
19021;165030;1453;0;0;0;0;.00nan;0;0
19021;181269;1443;0;0;0;0;.00nan;0;0
19021;83252;1443;70;17;1;16;.941;3600000;0
19022;3517;4961;0;0;0;0;.00nan;0;0
19022;4379;1422;16;21;6;15;.714;2528000;0
19022;-1;4961;79;45;4;41;.911;3600000;0
19022;160027;1422;59;5;0;5;1.000;998000;0
19023;62884;1425;41;12;3;9;.750;3772000;0
19023;68961;1425;0;0;0;0;.00nan;0;0
19023;81691;1440;83;48;4;44;.917;3772000;0
19023;143100;1440;0;0;0;0;.00nan;0;0
19024;4379;1422;59;32;4;28;.875;3573000;0
19024;175530;1429;82;39;3;36;.923;3600000;0
19024;46781;1429;0;0;0;0;.00nan;0;0
19024;160027;1422;0;0;0;0;.00nan;0;0
19025;62884;1425;77;23;1;22;.957;3600000;0
19025;68961;1425;0;0;0;0;.00nan;0;0
19025;81691;1440;0;0;0;0;.00nan;0;0
19025;143100;1440;75;44;4;40;.909;3600000;0
19026;5923;4742;0;0;0;0;.00nan;0;0
19026;11751;1427;0;0;0;0;.00nan;0;0
19026;185124;1427;67;24;2;22;.917;3600000;0
19026;36946;4742;91;45;4;41;.911;3562000;0
19027;3517;4961;61;10;0;10;1.000;1575000;0
19027;-1;4961;38;23;5;18;.783;1981000;0
19027;-1;1426;0;0;0;0;.00nan;0;0
19027;149981;1426;69;31;3;28;.903;3600000;0
19028;4127;1453;0;0;0;0;.00nan;0;0
19028;165030;1453;65;31;3;28;.903;3600000;0
19028;181269;1443;0;0;0;0;.00nan;0;0
19028;83252;1443;86;19;0;19;1.000;3600000;0
19029;4127;1453;50;20;3;17;.850;3600000;0
19029;5923;4742;27;35;7;28;.800;3600000;0
19029;165030;1453;0;0;0;0;.00nan;0;0
19029;36946;4742;0;0;0;0;.00nan;0;0
19030;4127;1453;0;0;0;0;.00nan;0;0
19030;165030;1453;71;48;6;42;.875;3600000;0
19030;181269;1443;0;0;0;0;.00nan;0;0
19030;83252;1443;62;15;1;14;.933;3600000;0
19031;1765;1430;0;0;0;0;.00nan;0;0
19031;32819;1430;67;41;4;37;.902;3600000;0
19031;62884;1425;73;24;2;22;.917;3600000;0
19031;68961;1425;0;0;0;0;.00nan;0;0
19032;3517;4961;0;0;0;0;.00nan;0;0
19032;-1;4961;77;27;1;26;.963;3600000;0
19032;81691;1440;27;10;4;6;.600;884000;0
19032;143100;1440;46;20;3;17;.850;2716000;0
19033;11751;1427;39;20;4;16;.800;2042000;0
19033;185124;1427;45;10;2;8;.800;1558000;0
19033;-1;1426;0;0;0;0;.00nan;0;0
19033;149981;1426;82;38;2;36;.947;3600000;0
19034;4379;1422;77;25;2;23;.920;3600000;0
19034;175530;1429;49;35;5;30;.857;3600000;0
19034;46781;1429;0;0;0;0;.00nan;0;0
19034;160027;1422;0;0;0;0;.00nan;0;0
19035;3517;4961;0;0;0;0;.00nan;0;0
19035;-1;4961;57;29;4;25;.862;3600000;0
19035;175530;1429;0;0;0;0;.00nan;0;0
19035;46781;1429;77;22;1;21;.955;3600000;0
19036;1765;1430;0;0;0;0;.00nan;0;0
19036;32819;1430;50;19;3;16;.842;3600000;0
19036;81691;1440;98;55;4;51;.927;3567000;0
19036;143100;1440;0;0;0;0;.00nan;0;0
19037;5923;4742;76;50;4;46;.920;3600000;0
19037;181269;1443;0;0;0;0;.00nan;0;0
19037;36946;4742;0;0;0;0;.00nan;0;0
19037;83252;1443;81;15;0;15;1.000;3600000;0
19038;4379;1422;14;26;7;19;.731;3342000;0
19038;11751;1427;36;16;4;12;.750;1127000;0
19038;185124;1427;52;20;2;18;.900;2473000;0
19038;160027;1422;48;0;0;0;.00nan;202000;0
19039;-1;1426;0;0;0;0;.00nan;0;0
19039;62884;1425;82;24;1;23;.958;3600000;0
19039;68961;1425;0;0;0;0;.00nan;0;0
19039;149981;1426;87;35;2;33;.943;3544000;0
19040;5923;4742;98;61;4;57;.934;3581000;0
19040;181269;1443;0;0;0;0;.00nan;0;0
19040;36946;4742;0;0;0;0;.00nan;0;0
19040;83252;1443;34;12;3;9;.750;3600000;0
19041;175530;1429;47;14;2;12;.857;3545000;0
19041;46781;1429;0;0;0;0;.00nan;0;0
19041;81691;1440;99;37;1;36;.973;3600000;0
19041;143100;1440;0;0;0;0;.00nan;0;0
19042;1765;1430;0;0;0;0;.00nan;0;0
19042;3517;4961;0;0;0;0;.00nan;0;0
19042;-1;4961;81;31;2;29;.935;3600000;0
19042;32819;1430;61;33;4;29;.879;3514000;0
19043;4127;1453;88;41;3;38;.927;3600000;0
19043;165030;1453;0;0;0;0;.00nan;0;0
19043;-1;1426;0;0;0;0;.00nan;0;0
19043;149981;1426;47;29;4;25;.862;3600000;0
19044;4379;1422;61;21;2;19;.905;3565000;0
19044;62884;1425;93;30;1;29;.967;3600000;0
19044;68961;1425;0;0;0;0;.00nan;0;0
19044;160027;1422;0;0;0;0;.00nan;0;0
19045;175530;1429;0;0;0;0;.00nan;0;0
19045;46781;1429;57;22;2;20;.909;3600000;0
19045;81691;1440;29;7;3;4;.571;693000;0
19045;143100;1440;59;43;6;37;.860;2907000;0
19046;11751;1427;60;46;6;40;.870;3600000;0
19046;185124;1427;0;0;0;0;.00nan;0;0
19046;181269;1443;0;0;0;0;.00nan;0;0
19046;83252;1443;46;11;2;9;.818;3600000;0
19047;1765;1430;69;23;2;21;.913;3354000;0
19047;3517;4961;0;0;0;0;.00nan;0;0
19047;-1;4961;45;34;5;29;.853;3900000;0
19047;32819;1430;36;12;3;9;.750;546000;0
19048;4127;1453;0;0;0;0;.00nan;0;0
19048;165030;1453;69;33;3;30;.909;3600000;0
19048;-1;1426;25;25;6;19;.760;2617000;0
19048;149981;1426;26;10;4;6;.600;983000;0
19049;4379;1422;67;38;4;34;.895;3600000;0
19049;62884;1425;88;28;1;27;.964;3600000;0
19049;68961;1425;0;0;0;0;.00nan;0;0
19049;160027;1422;0;0;0;0;.00nan;0;0
19050;1765;1430;0;0;0;0;.00nan;0;0
19050;5923;4742;52;28;4;24;.857;3600000;0
19050;32819;1430;38;29;5;24;.828;3590000;0
19050;36946;4742;0;0;0;0;.00nan;0;0
19051;1765;1430;53;34;5;29;.853;3740000;0
19051;11751;1427;55;33;4;29;.879;3740000;0
19051;32819;1430;0;0;0;0;.00nan;0;0
19051;185124;1427;0;0;0;0;.00nan;0;0
19052;-1;1426;0;0;0;0;.00nan;0;0
19052;81691;1440;61;36;4;32;.889;3579000;0
19052;143100;1440;0;0;0;0;.00nan;0;0
19052;149981;1426;45;16;3;13;.813;3600000;0
19053;4127;1453;85;51;4;47;.922;3900000;0
19053;4379;1422;0;0;0;0;.00nan;0;0
19053;165030;1453;0;0;0;0;.00nan;0;0
19053;160027;1422;62;40;4;36;.900;3900000;0
19054;175530;1429;55;34;4;30;.882;3600000;0
19054;46781;1429;0;0;0;0;.00nan;0;0
19054;62884;1425;67;20;1;19;.950;3600000;0
19054;68961;1425;0;0;0;0;.00nan;0;0
19055;175530;1429;0;0;0;0;.00nan;0;0
19055;46781;1429;69;42;4;38;.905;3558000;0
19055;62884;1425;50;16;2;14;.875;3600000;0
19055;68961;1425;0;0;0;0;.00nan;0;0
19056;4127;1453;0;0;0;0;.00nan;0;0
19056;165030;1453;50;52;7;45;.865;3600000;0
19056;181269;1443;79;12;0;12;1.000;3600000;0
19056;83252;1443;0;0;0;0;.00nan;0;0
19057;4379;1422;57;34;4;30;.882;3600000;0
19057;81691;1440;0;0;0;0;.00nan;0;0
19057;143100;1440;42;27;5;22;.815;3546000;0
19057;160027;1422;0;0;0;0;.00nan;0;0
19058;11751;1427;49;26;3;23;.885;3546000;0
19058;185124;1427;0;0;0;0;.00nan;0;0
19058;-1;1426;0;0;0;0;.00nan;0;0
19058;149981;1426;67;28;2;26;.929;3600000;0
19059;3517;4961;53;3;0;3;1.000;387000;0
19059;5923;4742;93;37;2;35;.946;3600000;0
19059;-1;4961;21;25;6;19;.760;3213000;0
19059;36946;4742;0;0;0;0;.00nan;0;0
19060;175530;1429;75;23;1;22;.957;3778000;0
19060;46781;1429;0;0;0;0;.00nan;0;0
19060;-1;1426;0;0;0;0;.00nan;0;0
19060;149981;1426;88;39;2;37;.949;3778000;0
19061;181269;1443;83;24;1;23;.958;3600000;0
19061;62884;1425;65;29;3;26;.897;3600000;0
19061;68961;1425;0;0;0;0;.00nan;0;0
19061;83252;1443;0;0;0;0;.00nan;0;0
19062;3517;4961;52;3;0;3;1.000;477000;0
19062;5923;4742;89;18;0;18;1.000;3600000;0
19062;-1;4961;25;27;6;21;.778;3123000;0
19062;36946;4742;0;0;0;0;.00nan;0;0
19063;1765;1430;0;0;0;0;.00nan;0;0
19063;4127;1453;79;35;3;32;.914;3900000;0
19063;165030;1453;0;0;0;0;.00nan;0;0
19063;32819;1430;67;31;3;28;.903;3900000;0
19064;4379;1422;0;0;0;0;.00nan;0;0
19064;11751;1427;71;35;4;31;.886;3581000;0
19064;185124;1427;0;0;0;0;.00nan;0;0
19064;160027;1422;78;37;3;34;.919;3600000;0
19065;181269;1443;0;0;0;0;.00nan;0;0
19065;81691;1440;98;61;3;58;.951;3562000;0
19065;83252;1443;56;7;1;6;.857;3600000;0
19065;143100;1440;0;0;0;0;.00nan;0;0
19066;1765;1430;0;0;0;0;.00nan;0;0
19066;11751;1427;53;24;3;21;.875;3552000;0
19066;32819;1430;78;29;2;27;.931;3600000;0
19066;185124;1427;0;0;0;0;.00nan;0;0
19067;3517;4961;69;28;2;26;.929;3600000;0
19067;4379;1422;50;29;4;25;.862;3515000;0
19067;-1;4961;0;0;0;0;.00nan;0;0
19067;160027;1422;0;0;0;0;.00nan;0;0
19068;175530;1429;67;7;0;7;1.000;1247000;0
19068;46781;1429;35;14;4;10;.714;2373000;0
19068;-1;1426;69;45;5;40;.889;3620000;0
19068;149981;1426;0;0;0;0;.00nan;0;0
19069;9524;1453;0;0;0;0;.00nan;0;0
19069;165030;1453;83;43;3;40;.930;3600000;0
19069;62884;1425;0;0;0;0;.00nan;0;0
19069;68961;1425;35;26;4;22;.846;3562000;0
19070;9524;1453;0;0;0;0;.00nan;0;0
19070;165030;1453;81;35;2;33;.943;3895000;0
19070;175530;1429;71;28;3;25;.893;3895000;0
19070;46781;1429;0;0;0;0;.00nan;0;0
19071;1765;1430;0;0;0;0;.00nan;0;0
19071;32819;1430;61;41;6;35;.854;3600000;0
19071;181269;1443;0;0;0;0;.00nan;0;0
19071;83252;1443;49;11;2;9;.818;3600000;0
19072;-1;1426;0;0;0;0;.00nan;0;0
19072;81691;1440;92;49;3;46;.939;3600000;0
19072;143100;1440;0;0;0;0;.00nan;0;0
19072;149981;1426;55;22;2;20;.909;3600000;0
19073;4379;1422;0;0;0;0;.00nan;0;0
19073;5923;4742;76;44;4;40;.909;3600000;0
19073;36946;4742;0;0;0;0;.00nan;0;0
19073;160027;1422;65;22;2;20;.909;3600000;0
19074;11751;1427;91;45;1;44;.978;3600000;0
19074;185124;1427;0;0;0;0;.00nan;0;0
19074;62884;1425;54;18;2;16;.889;3581000;0
19074;68961;1425;0;0;0;0;.00nan;0;0
19075;5923;4742;80;45;4;41;.911;3600000;0
19075;36946;4742;0;0;0;0;.00nan;0;0
19075;62884;1425;29;19;5;14;.737;3557000;0
19075;68961;1425;0;0;0;0;.00nan;0;0
19076;1765;1430;0;0;0;0;.00nan;0;0
19076;4379;1422;54;26;4;22;.846;3648000;0
19076;32819;1430;62;35;5;30;.857;3648000;0
19076;160027;1422;0;0;0;0;.00nan;0;0
19077;11751;1427;47;28;4;24;.857;3546000;0
19077;175530;1429;0;0;0;0;.00nan;0;0
19077;185124;1427;0;0;0;0;.00nan;0;0
19077;46781;1429;59;21;3;18;.857;3600000;0
19078;3517;4961;0;0;0;0;.00nan;0;0
19078;-1;4961;75;28;2;26;.929;3600000;0
19078;81691;1440;46;6;1;5;.833;392000;0
19078;143100;1440;13;36;8;28;.778;3208000;0
19079;181269;1443;76;23;1;22;.957;3600000;0
19079;-1;1426;62;51;5;46;.902;3600000;0
19079;83252;1443;0;0;0;0;.00nan;0;0
19079;149981;1426;0;0;0;0;.00nan;0;0
19080;-1;1426;0;0;0;0;.00nan;0;0
19080;81691;1440;0;0;0;0;.00nan;0;0
19080;143100;1440;83;44;4;40;.909;3600000;0
19080;149981;1426;90;19;0;19;1.000;3600000;0
19081;175530;1429;24;24;6;18;.750;2004000;0
19081;181269;1443;0;0;0;0;.00nan;0;0
19081;46781;1429;63;23;2;21;.913;1596000;0
19081;83252;1443;43;10;2;8;.800;3600000;0
19082;5923;4742;86;44;3;41;.932;3599000;0
19082;11751;1427;80;30;2;28;.933;3600000;0
19082;185124;1427;0;0;0;0;.00nan;0;0
19082;36946;4742;0;0;0;0;.00nan;0;0
19083;3517;4961;54;3;0;3;1.000;350000;0
19083;-1;4961;63;48;6;42;.875;3250000;0
19083;62884;1425;70;17;1;16;.941;3600000;0
19083;68961;1425;0;0;0;0;.00nan;0;0
19084;1765;1430;0;0;0;0;.00nan;0;0
19084;9524;1453;0;0;0;0;.00nan;0;0
19084;165030;1453;52;32;4;28;.875;3521000;0
19084;32819;1430;78;28;2;26;.929;3600000;0
19085;4379;1422;50;26;4;22;.846;3600000;0
19085;81691;1440;44;22;4;18;.818;2170000;0
19085;143100;1440;29;28;6;22;.786;1430000;0
19085;160027;1422;0;0;0;0;.00nan;0;0
19086;175530;1429;0;0;0;0;.00nan;0;0
19086;46781;1429;83;25;2;23;.920;3600000;0
19086;81691;1440;0;0;0;0;.00nan;0;0
19086;143100;1440;48;33;4;29;.879;3563000;0
19087;5923;4742;94;49;4;45;.918;3600000;0
19087;11751;1427;39;29;6;23;.793;2617000;0
19087;185124;1427;52;7;1;6;.857;983000;0
19087;36946;4742;0;0;0;0;.00nan;0;0
19088;3517;4961;0;0;0;0;.00nan;0;0
19088;-1;4961;60;51;6;45;.882;3600000;0
19088;-1;1426;0;0;0;0;.00nan;0;0
19088;149981;1426;59;29;3;26;.897;3600000;0
19089;1765;1430;0;0;0;0;.00nan;0;0
19089;9524;1453;81;32;2;30;.938;3900000;0
19089;165030;1453;0;0;0;0;.00nan;0;0
19089;32819;1430;77;28;2;26;.929;3900000;0
19090;181269;1443;58;20;2;18;.900;3600000;0
19090;62884;1425;76;49;5;44;.898;3600000;0
19090;68961;1425;0;0;0;0;.00nan;0;0
19090;83252;1443;0;0;0;0;.00nan;0;0
19091;5923;4742;62;45;7;38;.844;2775000;0
19091;181269;1443;0;0;0;0;.00nan;0;0
19091;36946;4742;56;12;2;10;.833;825000;0
19091;83252;1443;77;12;0;12;1.000;3600000;0
19092;1765;1430;0;0;0;0;.00nan;0;0
19092;32819;1430;100;28;0;28;1.000;3600000;0
19092;81691;1440;83;35;3;32;.914;3600000;0
19092;143100;1440;0;0;0;0;.00nan;0;0
19093;11751;1427;60;30;4;26;.867;3574000;0
19093;185124;1427;0;0;0;0;.00nan;0;0
19093;-1;1426;0;0;0;0;.00nan;0;0
19093;149981;1426;99;41;2;39;.951;3600000;0
19094;3517;4961;48;17;3;14;.824;1470000;0
19094;165030;1453;84;29;2;27;.931;3600000;0
19094;-1;4961;22;21;6;15;.714;2130000;0
19094;185136;1453;0;0;0;0;.00nan;0;0
19095;4379;1422;0;0;0;0;.00nan;0;0
19095;9524;1422;62;28;3;25;.893;3517000;0
19095;62884;1425;77;22;1;21;.955;3600000;0
19095;68961;1425;0;0;0;0;.00nan;0;0
19096;4379;1422;67;30;3;27;.900;3600000;0
19096;9524;1422;0;0;0;0;.00nan;0;0
19096;175530;1429;0;0;0;0;.00nan;0;0
19096;46781;1429;50;39;5;34;.872;3578000;0
19097;165030;1453;71;23;1;22;.957;3600000;0
19097;185136;1453;0;0;0;0;.00nan;0;0
19097;81691;1440;0;0;0;0;.00nan;0;0
19097;143100;1440;74;41;5;36;.878;3600000;0
19098;3517;4961;0;0;0;0;.00nan;0;0
19098;5923;4742;38;7;2;5;.714;790000;0
19098;-1;4961;33;33;7;26;.788;3600000;0
19098;36946;4742;34;32;6;26;.813;2753000;0
19099;11751;1427;0;0;0;0;.00nan;0;0
19099;185124;1427;70;39;3;36;.923;3562000;0
19099;181269;1443;0;0;0;0;.00nan;0;0
19099;83252;1443;64;10;1;9;.900;3600000;0
19100;1765;1430;0;0;0;0;.00nan;0;0
19100;32819;1430;80;45;4;41;.911;3600000;0
19100;62884;1425;54;16;2;14;.875;3600000;0
19100;68961;1425;0;0;0;0;.00nan;0;0
19101;181269;1443;0;0;0;0;.00nan;0;0
19101;-1;1426;0;0;0;0;.00nan;0;0
19101;83252;1443;64;16;1;15;.938;3600000;0
19101;149981;1426;85;36;2;34;.944;3576000;0
19102;3517;4961;0;0;0;0;.00nan;0;0
19102;-1;4961;81;18;0;18;1.000;3600000;0
19102;81691;1440;53;31;4;27;.871;3600000;0
19102;143100;1440;0;0;0;0;.00nan;0;0
19103;1765;1430;30;17;4;13;.765;1363000;0
19103;32819;1430;21;22;6;16;.727;2237000;0
19103;62884;1425;81;14;0;14;1.000;3600000;0
19103;68961;1425;0;0;0;0;.00nan;0;0
19104;5923;4742;22;4;3;1;.250;315000;0
19104;165030;1453;57;17;2;15;.882;3600000;0
19104;185136;1453;0;0;0;0;.00nan;0;0
19104;36946;4742;38;44;8;36;.818;3285000;0
19105;4379;1422;51;23;3;20;.870;3580000;0
19105;9524;1422;0;0;0;0;.00nan;0;0
19105;175530;1429;0;0;0;0;.00nan;0;0
19105;46781;1429;93;47;2;45;.957;3600000;0
19106;175530;1429;62;49;6;43;.878;3600000;0
19106;181269;1443;43;18;3;15;.833;3600000;0
19106;46781;1429;0;0;0;0;.00nan;0;0
19106;83252;1443;0;0;0;0;.00nan;0;0
19107;4379;1422;93;29;1;28;.966;3600000;0
19107;5923;4742;97;54;2;52;.963;3600000;0
19107;9524;1422;0;0;0;0;.00nan;0;0
19107;36946;4742;0;0;0;0;.00nan;0;0
19108;11751;1427;65;15;1;14;.933;3600000;0
19108;185124;1427;0;0;0;0;.00nan;0;0
19108;81691;1440;0;0;0;0;.00nan;0;0
19108;143100;1440;98;53;2;51;.962;3567000;0
19109;3517;4961;0;0;0;0;.00nan;0;0
19109;165030;1453;80;36;2;34;.944;3600000;0
19109;-1;4961;43;33;5;28;.848;3600000;0
19109;185136;1453;0;0;0;0;.00nan;0;0
19110;-1;1426;0;0;0;0;.00nan;0;0
19110;62884;1425;36;27;5;22;.815;3553000;0
19110;68961;1425;0;0;0;0;.00nan;0;0
19110;149981;1426;90;45;3;42;.933;3600000;0
19111;5923;4742;68;22;2;20;.909;3600000;0
19111;36946;4742;0;0;0;0;.00nan;0;0
19111;81691;1440;55;45;6;39;.867;3265000;0
19111;143100;1440;53;2;0;2;1.000;335000;0
19112;1765;1430;0;0;0;0;.00nan;0;0
19112;175530;1429;0;0;0;0;.00nan;0;0
19112;32819;1430;92;28;1;27;.964;3600000;0
19112;46781;1429;79;32;2;30;.938;3600000;0
19113;11751;1427;21;35;8;27;.771;3600000;0
19113;165030;1453;49;23;4;19;.826;3600000;0
19113;185124;1427;0;0;0;0;.00nan;0;0
19113;185136;1453;0;0;0;0;.00nan;0;0
19114;4379;1422;64;49;6;43;.878;3256000;0
19114;9524;1422;37;6;2;4;.667;344000;0
19114;181269;1443;0;0;0;0;.00nan;0;0
19114;83252;1443;57;16;2;14;.875;3600000;0
19115;3517;4961;53;3;0;3;1.000;329000;0
19115;-1;4961;54;47;6;41;.872;3271000;0
19115;62884;1425;35;11;3;8;.727;3600000;0
19115;68961;1425;0;0;0;0;.00nan;0;0
19116;1765;1430;0;0;0;0;.00nan;0;0
19116;175530;1429;65;35;3;32;.914;3600000;0
19116;32819;1430;50;30;4;26;.867;3552000;0
19116;46781;1429;0;0;0;0;.00nan;0;0
19117;5923;4742;0;0;0;0;.00nan;0;0
19117;36946;4742;43;32;5;27;.844;3588000;0
19117;81691;1440;0;0;0;0;.00nan;0;0
19117;143100;1440;93;51;4;47;.922;3600000;0
19118;11751;1427;66;36;4;32;.889;3600000;0
19118;165030;1453;28;13;4;9;.692;2117000;0
19118;185124;1427;0;0;0;0;.00nan;0;0
19118;185136;1453;37;16;3;13;.813;1483000;0
19119;3517;4961;0;0;0;0;.00nan;0;0
19119;-1;4961;59;39;6;33;.846;3600000;0
19119;181269;1443;0;0;0;0;.00nan;0;0
19119;83252;1443;77;9;0;9;1.000;3600000;0
19120;-1;1426;0;0;0;0;.00nan;0;0
19120;62884;1425;36;19;4;15;.789;3561000;0
19120;68961;1425;0;0;0;0;.00nan;0;0
19120;149981;1426;91;54;3;51;.944;3600000;0
19121;3517;4961;36;4;2;2;.500;702000;0
19121;-1;4961;28;30;6;24;.800;3198000;0
19121;175530;1429;46;14;2;12;.857;2050000;0
19121;46781;1429;18;21;6;15;.714;1850000;0
19122;181269;1443;0;0;0;0;.00nan;0;0
19122;81691;1440;58;5;0;5;1.000;292000;0
19122;83252;1443;59;9;1;8;.889;3600000;0
19122;143100;1440;82;69;7;62;.899;3308000;0
19123;1765;1430;0;0;0;0;.00nan;0;0
19123;5923;4742;45;44;7;37;.841;3600000;0
19123;32819;1430;76;28;2;26;.929;3600000;0
19123;36946;4742;0;0;0;0;.00nan;0;0
19124;11751;1427;98;43;1;42;.977;3600000;0
19124;185124;1427;0;0;0;0;.00nan;0;0
19124;62884;1425;66;20;2;18;.900;3548000;0
19124;68961;1425;0;0;0;0;.00nan;0;0
19125;165030;1453;76;24;1;23;.958;3600000;0
19125;175530;1429;0;0;0;0;.00nan;0;0
19125;185136;1453;0;0;0;0;.00nan;0;0
19125;46781;1429;60;34;4;30;.882;3600000;0
19126;4379;1422;93;36;2;34;.944;3600000;0
19126;9524;1422;0;0;0;0;.00nan;0;0
19126;-1;1426;0;0;0;0;.00nan;0;0
19126;149981;1426;48;31;5;26;.839;3600000;0
19127;4379;1422;0;0;0;0;.00nan;0;0
19127;9524;1422;71;26;3;23;.885;3900000;0
19127;81691;1440;72;43;3;40;.930;3900000;0
19127;143100;1440;0;0;0;0;.00nan;0;0
19128;5923;4742;0;0;0;0;.00nan;0;0
19128;175530;1429;87;35;2;33;.943;3600000;0
19128;36946;4742;100;37;1;36;.973;3600000;0
19128;46781;1429;0;0;0;0;.00nan;0;0
19129;3517;4961;0;0;0;0;.00nan;0;0
19129;11751;1427;74;34;3;31;.912;3600000;0
19129;-1;4961;38;21;4;17;.810;3547000;0
19129;185124;1427;0;0;0;0;.00nan;0;0
19130;1765;1430;53;3;0;3;1.000;429000;0
19130;32819;1430;1;30;9;21;.700;3171000;0
19130;-1;1426;0;0;0;0;.00nan;0;0
19130;149981;1426;66;34;4;30;.882;3600000;0
19131;165030;1453;72;35;3;32;.914;3600000;0
19131;185136;1453;0;0;0;0;.00nan;0;0
19131;62884;1425;75;29;2;27;.931;3600000;0
19131;68961;1425;0;0;0;0;.00nan;0;0
19132;4379;1422;23;30;7;23;.767;2348000;0
19132;9524;1422;42;16;3;13;.813;1252000;0
19132;181269;1443;0;0;0;0;.00nan;0;0
19132;83252;1443;80;19;1;18;.947;3600000;0
19133;11751;1427;65;21;2;19;.905;3632000;0
19133;185124;1427;0;0;0;0;.00nan;0;0
19133;81691;1440;0;0;0;0;.00nan;0;0
19133;143100;1440;70;39;3;36;.923;3632000;0
19134;3517;4961;0;0;0;0;.00nan;0;0
19134;-1;4961;77;32;2;30;.938;3600000;0
19134;175530;1429;0;0;0;0;.00nan;0;0
19134;46781;1429;86;42;3;39;.929;3550000;0
19135;5923;4742;54;28;4;24;.857;3600000;0
19135;36946;4742;0;0;0;0;.00nan;0;0
19135;-1;1426;56;13;1;12;.923;1730000;0
19135;149981;1426;14;33;8;25;.758;1870000;0
19136;165030;1453;81;33;2;31;.939;3600000;0
19136;185136;1453;0;0;0;0;.00nan;0;0
19136;62884;1425;52;26;4;22;.846;3582000;0
19136;68961;1425;0;0;0;0;.00nan;0;0
19137;1765;1430;0;0;0;0;.00nan;0;0
19137;4379;1422;52;34;5;29;.853;3893000;0
19137;9524;1422;0;0;0;0;.00nan;0;0
19137;32819;1430;66;44;5;39;.886;3900000;0
19138;165030;1453;14;20;6;14;.700;3189000;0
19138;175530;1429;78;41;4;37;.902;3600000;0
19138;185136;1453;56;4;0;4;1.000;378000;0
19138;46781;1429;0;0;0;0;.00nan;0;0
19139;5923;4742;0;0;0;0;.00nan;0;0
19139;36946;4742;72;35;3;32;.914;3798000;0
19139;-1;1426;0;0;0;0;.00nan;0;0
19139;149981;1426;59;32;4;28;.875;3798000;0
19140;1765;1430;23;28;7;21;.750;2301000;0
19140;32819;1430;48;8;1;7;.875;1299000;0
19140;181269;1443;0;0;0;0;.00nan;0;0
19140;83252;1443;43;19;4;15;.789;3600000;0
19141;3517;4961;0;0;0;0;.00nan;0;0
19141;11751;1427;68;26;3;23;.885;3900000;0
19141;-1;4961;63;30;3;27;.900;3900000;0
19141;185124;1427;0;0;0;0;.00nan;0;0
19142;62884;1425;0;0;0;0;.00nan;0;0
19142;68961;1425;93;9;0;9;1.000;3600000;0
19142;81691;1440;41;40;7;33;.825;3085000;0
19142;143100;1440;47;6;1;5;.833;515000;0
19143;5923;4742;19;34;8;26;.765;3600000;0
19143;165030;1453;43;25;4;21;.840;3600000;0
19143;185136;1453;0;0;0;0;.00nan;0;0
19143;36946;4742;0;0;0;0;.00nan;0;0
19144;11751;1427;70;30;2;28;.933;3600000;0
19144;175530;1429;32;33;6;27;.818;3109000;0
19144;185124;1427;0;0;0;0;.00nan;0;0
19144;46781;1429;54;4;0;4;1.000;491000;0
19145;181269;1443;0;0;0;0;.00nan;0;0
19145;62884;1425;71;18;0;18;1.000;1678000;0
19145;68961;1425;12;21;6;15;.714;1922000;0
19145;83252;1443;46;19;3;16;.842;3600000;0
19146;1765;1430;0;0;0;0;.00nan;0;0
19146;32819;1430;100;29;0;29;1.000;3600000;0
19146;-1;1426;0;0;0;0;.00nan;0;0
19146;149981;1426;26;15;5;10;.667;3600000;0
19147;165030;1453;0;0;0;0;.00nan;0;0
19147;185136;1453;27;18;5;13;.722;3555000;0
19147;81691;1440;0;0;0;0;.00nan;0;0
19147;143100;1440;81;39;3;36;.923;3600000;0
19148;3517;4961;0;0;0;0;.00nan;0;0
19148;4379;1422;37;26;4;22;.846;3600000;0
19148;9524;1422;0;0;0;0;.00nan;0;0
19148;-1;4961;99;47;1;46;.979;3600000;0
19149;5923;4742;43;20;3;17;.850;3557000;0
19149;36946;4742;0;0;0;0;.00nan;0;0
19149;81691;1440;99;45;2;43;.956;3600000;0
19149;143100;1440;0;0;0;0;.00nan;0;0
19150;4379;1422;0;0;0;0;.00nan;0;0
19150;9524;1422;51;31;5;26;.839;3600000;0
19150;11751;1427;26;28;6;22;.786;2070000;0
19150;185124;1427;46;20;3;17;.850;1530000;0
19151;1765;1430;0;0;0;0;.00nan;0;0
19151;3517;4961;0;0;0;0;.00nan;0;0
19151;-1;4961;45;31;5;26;.839;3532000;0
19151;32819;1430;91;39;3;36;.923;3600000;0
19152;175530;1429;0;0;0;0;.00nan;0;0
19152;46781;1429;91;37;1;36;.973;3600000;0
19152;-1;1426;0;0;0;0;.00nan;0;0
19152;149981;1426;53;39;5;34;.872;3600000;0
19153;181269;1443;0;0;0;0;.00nan;0;0
19153;62884;1425;98;42;3;39;.929;3900000;0
19153;68961;1425;0;0;0;0;.00nan;0;0
19153;83252;1443;55;30;3;27;.900;3900000;0
19155;9524;1453;0;0;0;0;.00nan;0;0
19155;165030;1453;64;34;3;31;.912;3563000;0
19155;62884;1425;50;15;2;13;.867;3600000;0
19155;68961;1425;0;0;0;0;.00nan;0;0
19157;4379;1422;65;25;2;23;.920;3600000;0
19157;46781;1422;0;0;0;0;.00nan;0;0
19157;81691;1440;53;29;5;24;.828;1953000;0
19157;143100;1440;49;30;4;26;.867;1647000;0
19159;1765;1430;0;0;0;0;.00nan;0;0
19159;5923;4742;43;33;5;28;.848;3600000;0
19159;32819;1430;74;20;1;19;.950;3600000;0
19159;36946;4742;0;0;0;0;.00nan;0;0
19161;-1;1426;0;0;0;0;.00nan;0;0
19161;-1;1429;33;18;4;14;.778;3598000;0
19161;149981;1426;91;51;3;48;.941;3600000;0
19161;157903;1429;0;0;0;0;.00nan;0;0
19163;3517;4961;0;0;0;0;.00nan;0;0
19163;-1;4961;75;48;5;43;.896;3600000;0
19163;17596;1443;71;18;2;16;.889;3600000;0
19163;181269;1443;0;0;0;0;.00nan;0;0
19165;11751;1427;76;26;2;24;.923;3600000;0
19165;185124;1427;0;0;0;0;.00nan;0;0
19165;-1;1429;41;36;6;30;.833;3600000;0
19165;157903;1429;0;0;0;0;.00nan;0;0
19167;3517;4961;0;0;0;0;.00nan;0;0
19167;-1;4961;59;40;5;35;.875;3600000;0
19167;81691;1440;69;38;4;34;.895;3600000;0
19167;143100;1440;0;0;0;0;.00nan;0;0
19169;4379;1422;62;22;2;20;.909;3900000;0
19169;9524;1453;73;32;2;30;.938;3900000;0
19169;165030;1453;0;0;0;0;.00nan;0;0
19169;46781;1422;0;0;0;0;.00nan;0;0
19171;17596;1443;0;0;0;0;.00nan;0;0
19171;181269;1443;55;16;2;14;.875;3600000;0
19171;62884;1425;73;37;3;34;.919;3590000;0
19171;68961;1425;0;0;0;0;.00nan;0;0
19173;1765;1430;0;0;0;0;.00nan;0;0
19173;5923;4742;0;0;0;0;.00nan;0;0
19173;32819;1430;70;19;1;18;.947;3600000;0
19173;36946;4742;92;44;2;42;.955;3578000;0
19175;9524;1453;0;0;0;0;.00nan;0;0
19175;165030;1453;64;19;2;17;.895;3600000;0
19175;81691;1440;0;0;0;0;.00nan;0;0
19175;143100;1440;22;42;8;34;.810;3600000;0
19177;1765;1430;24;27;6;21;.778;1743000;0
19177;32819;1430;60;16;2;14;.875;1828000;0
19177;62884;1425;42;33;6;27;.818;3600000;0
19177;68961;1425;0;0;0;0;.00nan;0;0
19179;3517;4961;0;0;0;0;.00nan;0;0
19179;-1;4961;20;37;8;29;.784;3600000;0
19179;-1;1429;0;0;0;0;.00nan;0;0
19179;157903;1429;84;34;3;31;.912;3600000;0
19181;5923;4742;66;39;5;34;.872;3565000;0
19181;11751;1427;69;34;3;31;.912;3600000;0
19181;185124;1427;0;0;0;0;.00nan;0;0
19181;36946;4742;0;0;0;0;.00nan;0;0
19183;17596;1443;88;14;0;14;1.000;3600000;0
19183;181269;1443;0;0;0;0;.00nan;0;0
19183;-1;1426;0;0;0;0;.00nan;0;0
19183;149981;1426;32;53;9;44;.830;3600000;0
19185;1765;1430;0;0;0;0;.00nan;0;0
19185;11751;1427;73;29;2;27;.931;3600000;0
19185;32819;1430;76;35;3;32;.914;3545000;0
19185;185124;1427;0;0;0;0;.00nan;0;0
19187;17596;1443;45;12;2;10;.833;3600000;0
19187;181269;1443;0;0;0;0;.00nan;0;0
19187;81691;1440;79;21;0;21;1.000;1821000;0
19187;143100;1440;22;23;6;17;.739;1779000;0
19189;3517;4961;0;0;0;0;.00nan;0;0
19189;5923;4742;51;22;4;18;.818;3600000;0
19189;-1;4961;96;37;1;36;.973;3600000;0
19189;36946;4742;0;0;0;0;.00nan;0;0
19191;9524;1453;95;24;0;24;1.000;3600000;0
19191;165030;1453;0;0;0;0;.00nan;0;0
19191;-1;1429;58;25;3;22;.880;3600000;0
19191;157903;1429;0;0;0;0;.00nan;0;0
19193;4379;1422;0;0;0;0;.00nan;0;0
19193;46781;1422;60;28;3;25;.893;3600000;0
19193;-1;1426;0;0;0;0;.00nan;0;0
19193;149981;1426;71;43;5;38;.884;3547000;0
19195;1765;1430;52;31;4;27;.871;3900000;0
19195;32819;1430;0;0;0;0;.00nan;0;0
19195;-1;1429;0;0;0;0;.00nan;0;0
19195;157903;1429;56;37;4;33;.892;3900000;0
19197;9524;1453;62;16;1;15;.938;3600000;0
19197;165030;1453;0;0;0;0;.00nan;0;0
19197;81691;1440;0;0;0;0;.00nan;0;0
19197;143100;1440;68;39;5;34;.872;3600000;0
19199;11751;1427;0;0;0;0;.00nan;0;0
19199;185124;1427;93;42;3;39;.929;3620000;0
19199;-1;1426;64;23;2;21;.913;3620000;0
19199;149981;1426;0;0;0;0;.00nan;0;0
19201;4379;1422;46;27;5;22;.815;3879000;0
19201;5923;4742;0;0;0;0;.00nan;0;0
19201;36946;4742;56;35;5;30;.857;3900000;0
19201;46781;1422;0;0;0;0;.00nan;0;0
19203;3517;4961;72;47;4;43;.915;2414000;0
19203;-1;4961;47;26;4;22;.846;1186000;0
19203;62884;1425;33;9;3;6;.667;3600000;0
19203;68961;1425;0;0;0;0;.00nan;0;0
19205;9524;1453;0;0;0;0;.00nan;0;0
19205;11751;1427;80;30;2;28;.933;3900000;0
19205;165030;1453;77;27;2;25;.926;3900000;0
19205;185124;1427;0;0;0;0;.00nan;0;0
19207;17596;1443;49;12;2;10;.833;3600000;0
19207;181269;1443;0;0;0;0;.00nan;0;0
19207;-1;1429;54;36;4;32;.889;2373000;0
19207;157903;1429;45;13;2;11;.846;1227000;0
19209;3517;4961;0;0;0;0;.00nan;0;0
19209;4379;1422;51;16;2;14;.875;3600000;0
19209;-1;4961;54;45;6;39;.867;3600000;0
19209;46781;1422;0;0;0;0;.00nan;0;0
19211;1765;1430;0;0;0;0;.00nan;0;0
19211;32819;1430;74;35;3;32;.914;3570000;0
19211;-1;1426;0;0;0;0;.00nan;0;0
19211;149981;1426;71;20;1;19;.950;3600000;0
19213;5923;4742;61;22;2;20;.909;3600000;0
19213;36946;4742;0;0;0;0;.00nan;0;0
19213;81691;1440;0;0;0;0;.00nan;0;0
19213;143100;1440;57;29;3;26;.897;3552000;0
19215;62884;1425;71;8;0;8;1.000;3600000;0
19215;68961;1425;0;0;0;0;.00nan;0;0
19215;81691;1440;25;14;4;10;.714;949000;0
19215;143100;1440;43;34;6;28;.824;2651000;0
19217;3517;4961;42;38;6;32;.842;2807000;0
19217;4379;1422;74;21;1;20;.952;3600000;0
19217;-1;4961;67;8;0;8;1.000;793000;0
19217;185123;1422;0;0;0;0;.00nan;0;0
19219;11751;1427;79;37;4;33;.892;3600000;0
19219;185124;1427;0;0;0;0;.00nan;0;0
19219;46781;1429;79;25;1;24;.960;3600000;0
19219;-1;1429;0;0;0;0;.00nan;0;0
19221;17596;1443;0;0;0;0;.00nan;0;0
19221;181269;1443;61;16;1;15;.938;3600000;0
19221;-1;1426;97;52;3;49;.942;3577000;0
19221;149981;1426;0;0;0;0;.00nan;0;0
19223;5923;4742;0;0;0;0;.00nan;0;0
19223;9524;1453;90;47;1;46;.979;3600000;0
19223;165030;1453;0;0;0;0;.00nan;0;0
19223;36946;4742;57;26;3;23;.885;3583000;0
985;11751;1427;50;41;6;35;.854;2665000;0
985;185124;1427;32;16;4;12;.750;935000;0
985;181269;1443;0;0;0;0;.00nan;0;0
985;83252;1443;77;9;0;9;1.000;3600000;0
986;-1;1426;0;0;0;0;.00nan;0;0
986;62884;1425;54;17;2;15;.882;3600000;0
986;68961;1425;0;0;0;0;.00nan;0;0
986;149981;1426;58;38;4;34;.895;3530000;0
987;4379;1422;56;12;1;11;.917;3600000;0
987;9524;1422;0;0;0;0;.00nan;0;0
987;175530;1429;0;0;0;0;.00nan;0;0
987;46781;1429;70;31;3;28;.903;3600000;0
988;1765;1430;0;0;0;0;.00nan;0;0
988;165030;1453;71;38;3;35;.921;3676000;0
988;32819;1430;36;17;4;13;.765;3676000;0
988;185136;1453;0;0;0;0;.00nan;0;0
1027;165030;1453;69;52;4;48;.923;3600000;0
1027;185136;1453;0;0;0;0;.00nan;0;0
1027;181269;1443;0;0;0;0;.00nan;0;0
1027;83252;1443;76;19;1;18;.947;3600000;0
1028;4379;1422;44;29;4;25;.862;3567000;0
1028;9524;1422;0;0;0;0;.00nan;0;0
1028;62884;1425;76;31;3;28;.903;3600000;0
1028;68961;1425;0;0;0;0;.00nan;0;0
1075;181269;1443;52;10;1;9;.900;2452000;0
1075;62884;1425;85;39;3;36;.923;3600000;0
1075;68961;1425;0;0;0;0;.00nan;0;0
1075;83252;1443;14;5;4;1;.200;1095000;0
