Game Id;PlayerId;TeamId;Game Rating;SA;GA;SV;SV%;TOI;PIM
0;13714;8;100;32;0;32;1.000;3600000;0
0;20432;28;0;0;0;0;.00nan;0;0
0;201174;28;66;32;3;29;.906;3600000;0
0;58830;8;0;0;0;0;.00nan;0;0
1;165723;32;83;36;3;33;.917;3549000;0
1;175912;14;74;26;2;24;.923;3600000;0
1;185034;14;0;0;0;0;.00nan;0;0
1;85727;32;0;0;0;0;.00nan;0;0
2;183859;23;0;0;0;0;.00nan;0;0
2;206789;30;0;0;0;0;.00nan;0;0
2;59540;23;73;29;2;27;.931;4200000;0
2;86697;30;82;44;2;42;.955;4200000;0
3;320;21;65;27;3;24;.889;3543000;0
3;3284;21;0;0;0;0;.00nan;0;0
3;183844;29;0;0;0;0;.00nan;0;0
3;195089;29;87;37;2;35;.946;3600000;0
4;166646;0;76;29;3;26;.897;3772000;0
4;189333;0;0;0;0;0;.00nan;0;0
4;139409;3;73;27;2;25;.926;3717000;0
4;148958;3;0;0;0;0;.00nan;0;0
5;171838;31;54;41;7;34;.829;3600000;0
5;165723;32;0;0;0;0;.00nan;0;0
5;85727;32;66;24;2;22;.917;3600000;0
5;149452;31;0;0;0;0;.00nan;0;0
6;192733;18;0;0;0;0;.00nan;0;0
6;173727;18;84;30;1;29;.967;3600000;0
6;205824;25;63;42;5;37;.881;3345000;0
6;201673;25;29;8;3;5;.625;255000;0
7;556;33;68;27;2;25;.926;3546000;0
7;788;27;75;22;1;21;.955;3600000;0
7;171304;27;0;0;0;0;.00nan;0;0
7;197038;33;0;0;0;0;.00nan;0;0
8;187537;19;0;0;0;0;.00nan;0;0
8;178384;19;89;61;3;58;.951;3600000;0
8;196090;4838;0;0;0;0;.00nan;0;0
8;179950;4838;76;25;2;23;.920;3600000;0
9;163471;34;0;0;0;0;.00nan;0;0
9;183904;34;61;24;3;21;.875;3600000;0
9;175092;9;36;5;2;3;.600;737000;0
9;190106;9;48;35;6;29;.829;2863000;0
10;3928;15;42;22;4;18;.818;3600000;0
10;178098;15;0;0;0;0;.00nan;0;0
10;173699;10;93;58;5;53;.914;3600000;0
10;90164;10;0;0;0;0;.00nan;0;0
11;676;24;0;0;0;0;.00nan;0;0
11;194416;17;0;0;0;0;.00nan;0;0
11;178413;17;72;35;4;31;.886;3600000;0
11;86192;24;59;38;5;33;.868;3562000;0
12;187578;26;28;7;3;4;.571;498000;0
12;184229;35;83;27;1;26;.963;3600000;0
12;179154;26;74;37;3;34;.919;3102000;0
12;147977;35;0;0;0;0;.00nan;0;0
13;187718;16;0;0;0;0;.00nan;0;0
13;170314;5;60;33;4;29;.879;3600000;0
13;201585;5;0;0;0;0;.00nan;0;0
13;50065;16;100;36;0;36;1.000;3600000;0
14;13714;8;81;31;3;28;.903;3587000;0
14;183859;23;0;0;0;0;.00nan;0;0
14;58830;8;0;0;0;0;.00nan;0;0
14;59540;23;60;22;2;20;.909;3600000;0
15;193854;11;0;0;0;0;.00nan;0;0
15;206789;30;0;0;0;0;.00nan;0;0
15;86697;30;61;44;6;38;.864;3600000;0
15;146862;11;68;23;2;21;.913;3600000;0
16;676;24;57;36;4;32;.889;4200000;0
16;174718;12;0;0;0;0;.00nan;0;0
16;85798;12;75;51;4;47;.922;4200000;0
16;86192;24;0;0;0;0;.00nan;0;0
17;166591;20;34;41;7;34;.829;2545000;0
17;183783;20;88;29;0;29;1.000;1055000;0
17;175912;14;67;15;1;14;.933;3600000;0
17;185034;14;0;0;0;0;.00nan;0;0
18;3928;15;0;0;0;0;.00nan;0;0
18;178098;15;81;27;1;26;.963;3600000;0
18;183844;29;67;29;2;27;.931;3580000;0
18;195089;29;0;0;0;0;.00nan;0;0
19;170314;5;41;28;5;23;.821;3600000;0
19;205824;25;100;41;0;41;1.000;3600000;0
19;201585;5;0;0;0;0;.00nan;0;0
19;201673;25;0;0;0;0;.00nan;0;0
20;171838;31;0;0;0;0;.00nan;0;0
20;13714;8;49;22;4;18;.818;2363000;0
20;58830;8;66;7;0;7;1.000;1237000;0
20;149452;31;32;33;6;27;.818;3538000;0
21;163471;34;0;0;0;0;.00nan;0;0
21;183904;34;93;21;0;21;1.000;3600000;0
21;173699;10;97;56;4;52;.929;3600000;0
21;90164;10;0;0;0;0;.00nan;0;0
22;194416;17;0;0;0;0;.00nan;0;0
22;178413;17;70;29;3;26;.897;3600000;0
22;20432;28;44;41;6;35;.854;3062000;0
22;201174;28;52;4;0;4;1.000;538000;0
23;165723;32;0;0;0;0;.00nan;0;0
23;85727;32;57;38;5;33;.868;3600000;0
23;139409;3;88;34;1;33;.971;3600000;0
23;148958;3;0;0;0;0;.00nan;0;0
24;192733;18;0;0;0;0;.00nan;0;0
24;173727;18;64;20;2;18;.900;3600000;0
24;175912;14;21;40;8;32;.800;3073000;0
24;185034;14;56;5;0;5;1.000;527000;0
25;166646;0;22;37;8;29;.784;3600000;0
25;187718;16;0;0;0;0;.00nan;0;0
25;189333;0;0;0;0;0;.00nan;0;0
25;50065;16;72;19;1;18;.947;3600000;0
26;175092;9;0;0;0;0;.00nan;0;0
26;190106;9;70;42;4;38;.905;3600000;0
26;196005;22;0;0;0;0;.00nan;0;0
26;143473;22;54;21;3;18;.857;3600000;0
27;183859;23;0;0;0;0;.00nan;0;0
27;184229;35;58;31;4;27;.871;3716000;0
27;59540;23;76;34;3;31;.912;3716000;0
27;147977;35;0;0;0;0;.00nan;0;0
28;187537;19;0;0;0;0;.00nan;0;0
28;178384;19;61;36;4;32;.889;3720000;0
28;196090;4838;0;0;0;0;.00nan;0;0
28;179950;4838;77;41;3;38;.927;3720000;0
29;556;33;99;41;1;40;.976;3600000;0
29;193854;11;0;0;0;0;.00nan;0;0
29;197038;33;0;0;0;0;.00nan;0;0
29;146862;11;42;31;5;26;.839;3600000;0
30;172340;4182;46;24;4;20;.833;3529000;0
30;206789;30;0;0;0;0;.00nan;0;0
30;86697;30;71;26;2;24;.923;3600000;0
30;140314;4182;0;0;0;0;.00nan;0;0
31;320;21;0;0;0;0;.00nan;0;0
31;788;27;59;32;3;29;.906;3545000;0
31;3284;21;76;26;2;24;.923;3600000;0
31;171304;27;0;0;0;0;.00nan;0;0
32;183844;29;0;0;0;0;.00nan;0;0
32;20432;28;59;33;4;29;.879;3546000;0
32;195089;29;48;20;3;17;.850;3600000;0
32;201174;28;0;0;0;0;.00nan;0;0
33;320;21;0;0;0;0;.00nan;0;0
33;3284;21;82;33;2;31;.939;3576000;0
33;172340;4182;89;32;1;31;.969;3600000;0
33;140314;4182;0;0;0;0;.00nan;0;0
34;194416;17;0;0;0;0;.00nan;0;0
34;178413;17;84;37;3;34;.919;3546000;0
34;173699;10;0;0;0;0;.00nan;0;0
34;90164;10;64;22;2;20;.909;3600000;0
35;676;24;75;35;3;32;.914;3600000;0
35;170314;5;90;16;0;16;1.000;3600000;0
35;201585;5;0;0;0;0;.00nan;0;0
35;86192;24;0;0;0;0;.00nan;0;0
36;163471;34;0;0;0;0;.00nan;0;0
36;183904;34;61;24;3;21;.875;3600000;0
36;174718;12;0;0;0;0;.00nan;0;0
36;85798;12;51;41;6;35;.854;3600000;0
37;166646;0;0;0;0;0;.00nan;0;0
37;165723;32;0;0;0;0;.00nan;0;0
37;189333;0;76;34;3;31;.912;3600000;0
37;85727;32;85;35;2;33;.943;3600000;0
38;192733;18;0;0;0;0;.00nan;0;0
38;166591;20;92;46;3;43;.935;3600000;0
38;183783;20;0;0;0;0;.00nan;0;0
38;173727;18;46;14;2;12;.857;3600000;0
39;20432;28;67;34;2;32;.941;4200000;0
39;201174;28;0;0;0;0;.00nan;0;0
39;175092;9;66;25;2;23;.920;4200000;0
39;190106;9;0;0;0;0;.00nan;0;0
40;187718;16;0;0;0;0;.00nan;0;0
40;50065;16;57;26;3;23;.885;4200000;0
40;139409;3;80;34;3;31;.912;4200000;0
40;148958;3;0;0;0;0;.00nan;0;0
41;187537;19;0;0;0;0;.00nan;0;0
41;3928;15;0;0;0;0;.00nan;0;0
41;178098;15;89;37;2;35;.946;3600000;0
41;178384;19;55;39;4;35;.897;3535000;0
42;174718;12;91;35;1;34;.971;3600000;0
42;196005;22;0;0;0;0;.00nan;0;0
42;85798;12;0;0;0;0;.00nan;0;0
42;143473;22;56;24;3;21;.875;3580000;0
43;13714;8;0;0;0;0;.00nan;0;0
43;196090;4838;0;0;0;0;.00nan;0;0
43;179950;4838;82;37;3;34;.919;3600000;0
43;58830;8;37;26;5;21;.808;3538000;0
44;788;27;0;0;0;0;.00nan;0;0
44;205824;25;0;0;0;0;.00nan;0;0
44;171304;27;48;33;5;28;.848;3542000;0
44;201673;25;56;31;4;27;.871;3600000;0
45;556;33;98;41;2;39;.951;3600000;0
45;183859;23;0;0;0;0;.00nan;0;0
45;197038;33;0;0;0;0;.00nan;0;0
45;59540;23;42;23;4;19;.826;3535000;0
46;320;21;0;0;0;0;.00nan;0;0
46;3284;21;82;45;4;41;.911;3583000;0
46;193854;11;0;0;0;0;.00nan;0;0
46;146862;11;80;34;2;32;.941;3600000;0
47;187578;26;0;0;0;0;.00nan;0;0
47;179154;26;40;33;6;27;.818;3600000;0
47;206789;30;0;0;0;0;.00nan;0;0
47;86697;30;64;34;3;31;.912;3600000;0
48;166591;20;65;42;5;37;.881;3600000;0
48;183783;20;0;0;0;0;.00nan;0;0
48;183844;29;76;28;2;26;.929;3600000;0
48;195089;29;0;0;0;0;.00nan;0;0
49;194416;17;0;0;0;0;.00nan;0;0
49;178413;17;100;40;0;40;1.000;3600000;0
49;175912;14;0;0;0;0;.00nan;0;0
49;185034;14;63;28;3;25;.893;3600000;0
50;192733;18;0;0;0;0;.00nan;0;0
50;173727;18;43;28;5;23;.821;3552000;0
50;175092;9;0;0;0;0;.00nan;0;0
50;190106;9;65;40;4;36;.900;3600000;0
51;166646;0;81;44;4;40;.909;3600000;0
51;189333;0;0;0;0;0;.00nan;0;0
51;170314;5;90;34;1;33;.971;3600000;0
51;201585;5;0;0;0;0;.00nan;0;0
52;163471;34;31;23;5;18;.783;3600000;0
52;13714;8;69;25;2;23;.920;3600000;0
52;183904;34;0;0;0;0;.00nan;0;0
52;58830;8;0;0;0;0;.00nan;0;0
53;3928;15;0;0;0;0;.00nan;0;0
53;178098;15;53;20;3;17;.850;3600000;0
53;196090;4838;0;0;0;0;.00nan;0;0
53;179950;4838;77;42;4;38;.905;3600000;0
54;187537;19;0;0;0;0;.00nan;0;0
54;178384;19;70;21;1;20;.952;3600000;0
54;20432;28;89;34;2;32;.941;3562000;0
54;201174;28;0;0;0;0;.00nan;0;0
55;788;27;65;22;3;19;.864;3640000;0
55;187718;16;0;0;0;0;.00nan;0;0
55;171304;27;0;0;0;0;.00nan;0;0
55;50065;16;82;28;2;26;.929;3640000;0
56;184229;35;78;21;1;20;.952;3600000;0
56;174718;12;0;0;0;0;.00nan;0;0
56;85798;12;61;31;3;28;.903;3556000;0
56;147977;35;0;0;0;0;.00nan;0;0
57;205824;25;33;26;5;21;.808;3568000;0
57;201673;25;0;0;0;0;.00nan;0;0
57;206789;30;0;0;0;0;.00nan;0;0
57;86697;30;75;45;4;41;.911;3600000;0
58;187578;26;0;0;0;0;.00nan;0;0
58;172340;4182;41;22;4;18;.818;3600000;0
58;179154;26;100;40;0;40;1.000;3600000;0
58;140314;4182;0;0;0;0;.00nan;0;0
59;320;21;0;0;0;0;.00nan;0;0
59;3284;21;69;23;2;21;.913;3564000;0
59;183859;23;0;0;0;0;.00nan;0;0
59;59540;23;98;30;1;29;.967;3600000;0
60;556;33;68;25;3;22;.880;3873000;0
60;165723;32;0;0;0;0;.00nan;0;0
60;197038;33;0;0;0;0;.00nan;0;0
60;85727;32;78;44;4;40;.909;3873000;0
61;171838;31;55;41;5;36;.878;3549000;0
61;193854;11;0;0;0;0;.00nan;0;0
61;146862;11;50;18;3;15;.833;3600000;0
61;149452;31;0;0;0;0;.00nan;0;0
62;192733;18;35;29;5;24;.828;3358000;0
62;173699;10;100;44;3;41;.932;3600000;0
62;173727;18;50;1;0;1;1.000;160000;0
62;90164;10;0;0;0;0;.00nan;0;0
63;676;24;83;45;3;42;.933;3600000;0
63;196005;22;0;0;0;0;.00nan;0;0
63;86192;24;0;0;0;0;.00nan;0;0
63;143473;22;76;17;1;16;.941;3600000;0
64;194416;17;0;0;0;0;.00nan;0;0
64;183844;29;100;39;0;39;1.000;3600000;0
64;178413;17;91;37;2;35;.946;3522000;0
64;195089;29;0;0;0;0;.00nan;0;0
65;172340;4182;46;25;4;21;.840;3579000;0
65;174718;12;0;0;0;0;.00nan;0;0
65;85798;12;100;50;3;47;.940;3600000;0
65;140314;4182;0;0;0;0;.00nan;0;0
66;175092;9;0;0;0;0;.00nan;0;0
66;190106;9;100;47;0;47;1.000;3600000;0
66;196005;22;79;31;2;29;.935;3524000;0
66;143473;22;0;0;0;0;.00nan;0;0
67;187537;19;0;0;0;0;.00nan;0;0
67;178384;19;37;31;5;26;.839;3600000;0
67;170314;5;84;37;2;35;.946;3600000;0
67;201585;5;0;0;0;0;.00nan;0;0
68;166591;20;62;34;4;30;.882;3600000;0
68;183783;20;0;0;0;0;.00nan;0;0
68;139409;3;87;25;1;24;.960;3600000;0
68;148958;3;0;0;0;0;.00nan;0;0
69;166646;0;84;40;2;38;.950;3547000;0
69;189333;0;0;0;0;0;.00nan;0;0
69;20432;28;0;0;0;0;.00nan;0;0
69;201174;28;72;22;1;21;.955;3600000;0
70;165723;32;88;48;3;45;.938;3600000;0
70;206789;30;0;0;0;0;.00nan;0;0
70;85727;32;0;0;0;0;.00nan;0;0
70;86697;30;83;35;2;33;.943;3600000;0
71;187578;26;0;0;0;0;.00nan;0;0
71;3928;15;0;0;0;0;.00nan;0;0
71;178098;15;53;25;3;22;.880;3575000;0
71;179154;26;94;44;2;42;.955;3600000;0
72;187718;16;67;31;2;29;.935;3600000;0
72;173699;10;0;0;0;0;.00nan;0;0
72;50065;16;0;0;0;0;.00nan;0;0
72;90164;10;88;38;3;35;.921;3557000;0
73;193854;11;0;0;0;0;.00nan;0;0
73;13714;8;35;24;5;19;.792;3556000;0
73;58830;8;0;0;0;0;.00nan;0;0
73;146862;11;40;22;4;18;.818;3600000;0
74;184229;35;49;35;5;30;.857;3525000;0
74;175912;14;43;23;4;19;.826;3600000;0
74;185034;14;0;0;0;0;.00nan;0;0
74;147977;35;0;0;0;0;.00nan;0;0
75;320;21;0;0;0;0;.00nan;0;0
75;556;33;61;16;2;14;.875;1745000;0
75;3284;21;46;24;4;20;.833;3600000;0
75;197038;33;19;22;6;16;.727;1855000;0
76;205824;25;63;30;3;27;.900;3570000;0
76;201673;25;0;0;0;0;.00nan;0;0
76;196090;4838;0;0;0;0;.00nan;0;0
76;179950;4838;92;38;2;36;.947;3600000;0
77;163471;34;0;0;0;0;.00nan;0;0
77;183859;23;80;35;2;33;.943;3561000;0
77;183904;34;97;32;1;31;.969;3600000;0
77;59540;23;0;0;0;0;.00nan;0;0
78;788;27;100;29;0;29;1.000;3600000;0
78;171838;31;0;0;0;0;.00nan;0;0
78;171304;27;0;0;0;0;.00nan;0;0
78;149452;31;78;28;3;25;.893;3600000;0
79;192733;18;0;0;0;0;.00nan;0;0
79;194416;17;92;53;4;49;.925;3600000;0
79;178413;17;0;0;0;0;.00nan;0;0
79;173727;18;70;25;2;23;.920;3600000;0
80;171838;31;72;31;3;28;.903;3524000;0
80;172340;4182;99;33;1;32;.970;3600000;0
80;140314;4182;0;0;0;0;.00nan;0;0
80;149452;31;0;0;0;0;.00nan;0;0
81;175092;9;0;0;0;0;.00nan;0;0
81;190106;9;56;17;2;15;.882;3547000;0
81;139409;3;99;42;1;41;.976;3600000;0
81;148958;3;0;0;0;0;.00nan;0;0
82;166591;20;74;23;2;21;.913;3600000;0
82;166646;0;0;0;0;0;.00nan;0;0
82;183783;20;0;0;0;0;.00nan;0;0
82;189333;0;90;38;3;35;.921;3600000;0
83;172340;4182;29;28;6;22;.786;2209000;0
83;173699;10;79;36;3;33;.917;3600000;0
83;90164;10;0;0;0;0;.00nan;0;0
83;140314;4182;45;11;2;9;.818;1391000;0
84;183844;29;55;17;2;15;.882;3600000;0
84;195089;29;0;0;0;0;.00nan;0;0
84;175092;9;73;46;5;41;.891;3600000;0
84;190106;9;0;0;0;0;.00nan;0;0
85;320;21;0;0;0;0;.00nan;0;0
85;3284;21;79;35;2;33;.943;4200000;0
85;20432;28;75;33;2;31;.939;4200000;0
85;201174;28;0;0;0;0;.00nan;0;0
86;676;24;68;30;2;28;.933;3546000;0
86;86192;24;0;0;0;0;.00nan;0;0
86;139409;3;0;0;0;0;.00nan;0;0
86;148958;3;99;47;1;46;.979;3600000;0
87;187578;26;0;0;0;0;.00nan;0;0
87;179154;26;92;36;2;34;.944;3770000;0
87;175912;14;0;0;0;0;.00nan;0;0
87;185034;14;52;22;3;19;.864;3770000;0
88;193854;11;0;0;0;0;.00nan;0;0
88;170314;5;0;0;0;0;.00nan;0;0
88;201585;5;91;37;2;35;.946;3600000;0
88;146862;11;53;18;3;15;.833;3600000;0
89;556;33;71;40;4;36;.900;3600000;0
89;196005;22;0;0;0;0;.00nan;0;0
89;197038;33;0;0;0;0;.00nan;0;0
89;143473;22;88;22;1;21;.955;3600000;0
90;194416;17;0;0;0;0;.00nan;0;0
90;178413;17;87;32;1;31;.969;3895000;0
90;183859;23;0;0;0;0;.00nan;0;0
90;59540;23;92;41;2;39;.951;3895000;0
91;171838;31;0;0;0;0;.00nan;0;0
91;165723;32;0;0;0;0;.00nan;0;0
91;85727;32;56;30;4;26;.867;3600000;0
91;149452;31;86;25;1;24;.960;3600000;0
92;184229;35;74;52;5;47;.904;3600000;0
92;205824;25;18;10;4;6;.600;1055000;0
92;201673;25;45;10;2;8;.800;2532000;0
92;147977;35;0;0;0;0;.00nan;0;0
93;187718;16;0;0;0;0;.00nan;0;0
93;196090;4838;0;0;0;0;.00nan;0;0
93;179950;4838;61;33;4;29;.879;3558000;0
93;50065;16;89;30;2;28;.933;3600000;0
94;187537;19;0;0;0;0;.00nan;0;0
94;13714;8;75;19;1;18;.947;3590000;0
94;178384;19;100;31;0;31;1.000;3600000;0
94;58830;8;0;0;0;0;.00nan;0;0
95;192733;18;0;0;0;0;.00nan;0;0
95;163471;34;0;0;0;0;.00nan;0;0
95;183904;34;67;16;1;15;.938;3600000;0
95;173727;18;79;46;4;42;.913;3600000;0
96;788;27;81;33;2;31;.939;3600000;0
96;171304;27;0;0;0;0;.00nan;0;0
96;174718;12;0;0;0;0;.00nan;0;0
96;85798;12;67;29;3;26;.897;3542000;0
97;3928;15;0;0;0;0;.00nan;0;0
97;178098;15;44;27;4;23;.852;3528000;0
97;206789;30;0;0;0;0;.00nan;0;0
97;86697;30;93;40;2;38;.950;3600000;0
98;676;24;0;0;0;0;.00nan;0;0
98;166591;20;0;0;0;0;.00nan;0;0
98;183783;20;76;48;3;45;.938;3538000;0
98;86192;24;82;22;1;21;.955;3600000;0
99;171838;31;90;36;2;34;.944;3592000;0
99;172340;4182;75;24;1;23;.958;3600000;0
99;140314;4182;0;0;0;0;.00nan;0;0
99;149452;31;0;0;0;0;.00nan;0;0
100;320;21;65;26;2;24;.923;3600000;0
100;3284;21;0;0;0;0;.00nan;0;0
100;183859;23;0;0;0;0;.00nan;0;0
100;59540;23;68;33;4;29;.879;3578000;0
101;194416;17;0;0;0;0;.00nan;0;0
101;178413;17;58;31;4;27;.871;3600000;0
101;205824;25;0;0;0;0;.00nan;0;0
101;201673;25;48;20;3;17;.850;3600000;0
102;173699;10;93;39;2;37;.949;3600000;0
102;90164;10;0;0;0;0;.00nan;0;0
102;139409;3;60;34;3;31;.912;3583000;0
102;148958;3;0;0;0;0;.00nan;0;0
103;187718;16;0;0;0;0;.00nan;0;0
103;3928;15;24;25;6;19;.760;3561000;0
103;178098;15;0;0;0;0;.00nan;0;0
103;50065;16;78;46;5;41;.891;3600000;0
104;556;33;85;44;4;40;.909;4067000;0
104;175912;14;63;30;3;27;.900;4067000;0
104;185034;14;0;0;0;0;.00nan;0;0
104;197038;33;0;0;0;0;.00nan;0;0
105;193854;11;0;0;0;0;.00nan;0;0
105;20432;28;51;34;5;29;.853;4200000;0
105;201174;28;0;0;0;0;.00nan;0;0
105;146862;11;44;27;5;22;.815;4200000;0
106;183844;29;74;41;3;38;.927;3600000;0
106;195089;29;0;0;0;0;.00nan;0;0
106;196005;22;0;0;0;0;.00nan;0;0
106;143473;22;60;13;1;12;.923;3600000;0
107;166646;0;92;38;2;36;.947;3652000;0
107;187578;26;0;0;0;0;.00nan;0;0
107;189333;0;0;0;0;0;.00nan;0;0
107;179154;26;76;24;1;23;.958;3652000;0
108;192733;18;46;18;3;15;.833;3600000;0
108;173727;18;0;0;0;0;.00nan;0;0
108;184229;35;65;36;4;32;.889;3548000;0
108;147977;35;0;0;0;0;.00nan;0;0
109;163471;34;0;0;0;0;.00nan;0;0
109;183904;34;53;21;3;18;.857;4200000;0
109;196090;4838;0;0;0;0;.00nan;0;0
109;179950;4838;77;39;3;36;.923;4200000;0
110;165723;32;73;28;3;25;.893;4184000;0
110;206789;30;0;0;0;0;.00nan;0;0
110;85727;32;0;0;0;0;.00nan;0;0
110;86697;30;87;37;3;34;.919;4200000;0
111;320;21;0;0;0;0;.00nan;0;0
111;3284;21;100;34;1;33;.971;3600000;0
111;193854;11;82;40;4;36;.900;3600000;0
111;146862;11;0;0;0;0;.00nan;0;0
112;676;24;72;25;2;23;.920;3600000;0
112;175092;9;97;42;3;39;.929;3569000;0
112;190106;9;0;0;0;0;.00nan;0;0
112;86192;24;0;0;0;0;.00nan;0;0
113;166591;20;100;44;2;42;.955;3600000;0
113;187718;16;33;18;4;14;.778;3579000;0
113;183783;20;0;0;0;0;.00nan;0;0
113;50065;16;0;0;0;0;.00nan;0;0
114;788;27;68;29;3;26;.897;3600000;0
114;171304;27;0;0;0;0;.00nan;0;0
114;174718;12;51;28;5;23;.821;3580000;0
114;85798;12;0;0;0;0;.00nan;0;0
115;187537;19;0;0;0;0;.00nan;0;0
115;178384;19;82;27;1;26;.963;3600000;0
115;184229;35;0;0;0;0;.00nan;0;0
115;147977;35;48;28;4;24;.857;3600000;0
116;3928;15;0;0;0;0;.00nan;0;0
116;172340;4182;96;63;3;60;.952;4200000;0
116;178098;15;61;24;3;21;.875;4200000;0
116;140314;4182;0;0;0;0;.00nan;0;0
117;183859;23;68;28;2;26;.929;4200000;0
117;170314;5;75;35;2;33;.943;4200000;0
117;201585;5;0;0;0;0;.00nan;0;0
117;59540;23;0;0;0;0;.00nan;0;0
118;171838;31;0;0;0;0;.00nan;0;0
118;194416;17;0;0;0;0;.00nan;0;0
118;178413;17;58;20;2;18;.900;3600000;0
118;149452;31;64;30;3;27;.900;3588000;0
119;173699;10;0;0;0;0;.00nan;0;0
119;196005;22;0;0;0;0;.00nan;0;0
119;90164;10;86;43;3;40;.930;4098000;0
119;143473;22;59;29;4;25;.862;4098000;0
120;205824;25;0;0;0;0;.00nan;0;0
120;201673;25;60;15;1;14;.933;3600000;0
120;139409;3;97;55;2;53;.964;3600000;0
120;148958;3;0;0;0;0;.00nan;0;0
121;166646;0;94;47;3;44;.936;3585000;0
121;13714;8;0;0;0;0;.00nan;0;0
121;189333;0;0;0;0;0;.00nan;0;0
121;58830;8;59;19;2;17;.895;3600000;0
122;183844;29;43;17;3;14;.824;3600000;0
122;195089;29;0;0;0;0;.00nan;0;0
122;175912;14;0;0;0;0;.00nan;0;0
122;185034;14;100;28;0;28;1.000;3600000;0
123;187537;19;87;39;3;36;.923;3600000;0
123;163471;34;0;0;0;0;.00nan;0;0
123;178384;19;0;0;0;0;.00nan;0;0
123;183904;34;69;25;2;23;.920;3600000;0
124;788;27;0;0;0;0;.00nan;0;0
124;171304;27;73;45;4;41;.911;3600000;0
124;206789;30;0;0;0;0;.00nan;0;0
124;86697;30;99;37;1;36;.973;3600000;0
125;556;33;51;32;4;28;.875;3600000;0
125;175092;9;0;0;0;0;.00nan;0;0
125;190106;9;81;32;1;31;.969;3600000;0
125;197038;33;0;0;0;0;.00nan;0;0
126;676;24;54;30;4;26;.867;3600000;0
126;187718;16;0;0;0;0;.00nan;0;0
126;50065;16;53;23;3;20;.870;3600000;0
126;86192;24;0;0;0;0;.00nan;0;0
127;166591;20;69;52;5;47;.904;3600000;0
127;193854;11;0;0;0;0;.00nan;0;0
127;183783;20;0;0;0;0;.00nan;0;0
127;146862;11;78;22;1;21;.955;3600000;0
128;192733;18;0;0;0;0;.00nan;0;0
128;173727;18;54;22;3;19;.864;3617000;0
128;196090;4838;0;0;0;0;.00nan;0;0
128;179950;4838;90;41;4;37;.902;3617000;0
129;171838;31;77;34;2;32;.941;3600000;0
129;170314;5;48;29;4;25;.862;3543000;0
129;201585;5;0;0;0;0;.00nan;0;0
129;149452;31;0;0;0;0;.00nan;0;0
130;320;21;0;0;0;0;.00nan;0;0
130;3284;21;92;31;1;30;.968;3600000;0
130;3928;15;79;29;2;27;.931;3549000;0
130;178098;15;0;0;0;0;.00nan;0;0
131;172340;4182;69;36;3;33;.917;3513000;0
131;175912;14;0;0;0;0;.00nan;0;0
131;185034;14;82;25;1;24;.960;3600000;0
131;140314;4182;0;0;0;0;.00nan;0;0
132;183859;23;0;0;0;0;.00nan;0;0
132;20432;28;0;0;0;0;.00nan;0;0
132;201174;28;69;28;2;26;.929;3600000;0
132;59540;23;48;19;3;16;.842;3578000;0
133;194416;17;0;0;0;0;.00nan;0;0
133;178413;17;93;36;2;34;.944;3595000;0
133;196005;22;0;0;0;0;.00nan;0;0
133;143473;22;74;21;1;20;.952;3600000;0
134;163471;34;73;29;2;27;.931;3600000;0
134;183904;34;0;0;0;0;.00nan;0;0
134;205824;25;48;27;4;23;.852;3550000;0
134;201673;25;0;0;0;0;.00nan;0;0
135;187578;26;0;0;0;0;.00nan;0;0
135;173699;10;39;26;5;21;.808;3600000;0
135;179154;26;84;31;2;29;.935;3600000;0
135;90164;10;0;0;0;0;.00nan;0;0
136;165723;32;72;23;2;21;.913;3600000;0
136;174718;12;0;0;0;0;.00nan;0;0
136;85727;32;0;0;0;0;.00nan;0;0
136;85798;12;73;33;3;30;.909;3549000;0
137;206789;30;70;34;4;30;.882;3516000;0
137;86697;30;0;0;0;0;.00nan;0;0
137;139409;3;95;33;2;31;.939;3600000;0
137;148958;3;0;0;0;0;.00nan;0;0
138;788;27;70;19;1;18;.947;3600000;0
138;166646;0;0;0;0;0;.00nan;0;0
138;189333;0;44;33;5;28;.848;3600000;0
138;171304;27;0;0;0;0;.00nan;0;0
139;187537;19;0;0;0;0;.00nan;0;0
139;13714;8;81;24;1;23;.958;3600000;0
139;178384;19;65;33;4;29;.879;3600000;0
139;58830;8;0;0;0;0;.00nan;0;0
140;3928;15;80;28;2;26;.929;3600000;0
140;178098;15;0;0;0;0;.00nan;0;0
140;175092;9;0;0;0;0;.00nan;0;0
140;190106;9;50;33;5;28;.848;3600000;0
141;192733;18;41;29;5;24;.828;3600000;0
141;187578;26;0;0;0;0;.00nan;0;0
141;173727;18;0;0;0;0;.00nan;0;0
141;179154;26;85;35;2;33;.943;3600000;0
142;556;33;73;45;4;41;.911;3596000;0
142;184229;35;71;32;3;29;.906;3600000;0
142;197038;33;0;0;0;0;.00nan;0;0
142;147977;35;0;0;0;0;.00nan;0;0
143;172340;4182;0;0;0;0;.00nan;0;0
143;174718;12;0;0;0;0;.00nan;0;0
143;85798;12;91;41;2;39;.951;3600000;0
143;140314;4182;34;21;4;17;.810;3574000;0
144;171838;31;75;28;2;26;.929;3544000;0
144;166646;0;76;25;1;24;.960;3600000;0
144;189333;0;0;0;0;0;.00nan;0;0
144;149452;31;0;0;0;0;.00nan;0;0
145;20432;28;86;46;4;42;.913;3544000;0
145;173699;10;0;0;0;0;.00nan;0;0
145;201174;28;0;0;0;0;.00nan;0;0
145;90164;10;72;22;2;20;.909;3600000;0
146;194416;17;0;0;0;0;.00nan;0;0
146;178413;17;32;22;5;17;.773;3547000;0
146;170314;5;78;37;4;33;.892;3600000;0
146;201585;5;0;0;0;0;.00nan;0;0
147;320;21;0;0;0;0;.00nan;0;0
147;3284;21;88;45;4;41;.911;3600000;0
147;163471;34;0;0;0;0;.00nan;0;0
147;183904;34;68;23;2;21;.913;3600000;0
148;788;27;0;0;0;0;.00nan;0;0
148;183844;29;0;0;0;0;.00nan;0;0
148;195089;29;79;36;2;34;.944;3600000;0
148;171304;27;42;35;5;30;.857;3600000;0
149;166591;20;79;40;3;37;.925;3600000;0
149;183783;20;0;0;0;0;.00nan;0;0
149;196005;22;0;0;0;0;.00nan;0;0
149;143473;22;46;21;4;17;.810;3552000;0
150;676;24;59;31;3;28;.903;3947000;0
150;187718;16;0;0;0;0;.00nan;0;0
150;50065;16;64;22;2;20;.909;3947000;0
150;86192;24;0;0;0;0;.00nan;0;0
151;187578;26;73;31;3;28;.903;4200000;0
151;179154;26;0;0;0;0;.00nan;0;0
151;196090;4838;48;24;3;21;.875;4200000;0
151;179950;4838;0;0;0;0;.00nan;0;0
152;174718;12;59;24;2;22;.917;3600000;0
152;85798;12;0;0;0;0;.00nan;0;0
152;139409;3;54;38;5;33;.868;3600000;0
152;148958;3;0;0;0;0;.00nan;0;0
153;13714;8;68;30;3;27;.900;3536000;0
153;183859;23;78;23;1;22;.957;3600000;0
153;58830;8;0;0;0;0;.00nan;0;0
153;59540;23;0;0;0;0;.00nan;0;0
154;205824;25;0;0;0;0;.00nan;0;0
154;201673;25;59;21;2;19;.905;3600000;0
154;206789;30;0;0;0;0;.00nan;0;0
154;86697;30;62;32;4;28;.875;3556000;0
155;187537;19;0;0;0;0;.00nan;0;0
155;193854;11;0;0;0;0;.00nan;0;0
155;178384;19;49;43;6;37;.860;4053000;0
155;146862;11;35;26;5;21;.808;4053000;0
156;3928;15;0;0;0;0;.00nan;0;0
156;178098;15;48;24;4;20;.833;3938000;0
156;175092;9;80;48;5;43;.896;3938000;0
156;190106;9;0;0;0;0;.00nan;0;0
157;676;24;0;0;0;0;.00nan;0;0
157;184229;35;81;32;2;30;.938;3600000;0
157;86192;24;68;40;4;36;.900;3600000;0
157;147977;35;0;0;0;0;.00nan;0;0
158;13714;8;79;40;4;36;.900;3600000;0
158;196090;4838;0;0;0;0;.00nan;0;0
158;179950;4838;61;30;3;27;.900;3600000;0
158;58830;8;0;0;0;0;.00nan;0;0
159;205824;25;44;7;2;5;.714;3600000;0
159;174718;12;0;0;0;0;.00nan;0;0
159;201673;25;0;0;0;0;.00nan;0;0
159;85798;12;70;49;5;44;.898;3600000;0
160;171838;31;63;31;3;28;.903;3584000;0
160;194416;17;0;0;0;0;.00nan;0;0
160;178413;17;88;39;2;37;.949;3600000;0
160;149452;31;0;0;0;0;.00nan;0;0
161;183844;29;79;27;1;26;.963;3600000;0
161;20432;28;84;33;2;31;.939;3586000;0
161;195089;29;0;0;0;0;.00nan;0;0
161;201174;28;0;0;0;0;.00nan;0;0
162;788;27;39;31;6;25;.806;3078000;0
162;3928;15;45;32;5;27;.844;3600000;0
162;178098;15;0;0;0;0;.00nan;0;0
162;171304;27;53;4;0;4;1.000;472000;0
163;184229;35;0;0;0;0;.00nan;0;0
163;139409;3;77;30;2;28;.933;3561000;0
163;147977;35;96;35;1;34;.971;3600000;0
163;148958;3;0;0;0;0;.00nan;0;0
164;166646;0;89;35;1;34;.971;3551000;0
164;189333;0;0;0;0;0;.00nan;0;0
164;175092;9;0;0;0;0;.00nan;0;0
164;190106;9;87;17;0;17;1.000;3600000;0
165;166591;20;0;0;0;0;.00nan;0;0
165;183783;20;47;42;6;36;.857;3600000;0
165;173699;10;0;0;0;0;.00nan;0;0
165;90164;10;58;24;3;21;.875;3600000;0
166;320;21;0;0;0;0;.00nan;0;0
166;3284;21;94;39;2;37;.949;3600000;0
166;196005;22;0;0;0;0;.00nan;0;0
166;143473;22;61;21;3;18;.857;3576000;0
167;165723;32;0;0;0;0;.00nan;0;0
167;170314;5;31;24;5;19;.792;3580000;0
167;201585;5;0;0;0;0;.00nan;0;0
167;85727;32;87;47;3;44;.936;3600000;0
168;187718;16;69;25;1;24;.960;3295000;0
168;163471;34;0;0;0;0;.00nan;0;0
168;183904;34;76;26;1;25;.962;3600000;0
168;50065;16;28;9;3;6;.667;305000;0
169;192733;18;0;0;0;0;.00nan;0;0
169;183859;23;0;0;0;0;.00nan;0;0
169;173727;18;46;11;2;9;.818;3600000;0
169;59540;23;78;46;4;42;.913;3592000;0
170;193854;11;0;0;0;0;.00nan;0;0
170;175912;14;0;0;0;0;.00nan;0;0
170;185034;14;66;28;2;26;.929;3559000;0
170;146862;11;100;29;1;28;.966;3600000;0
171;187537;19;0;0;0;0;.00nan;0;0
171;187578;26;0;0;0;0;.00nan;0;0
171;178384;19;63;23;2;21;.913;3526000;0
171;179154;26;100;27;0;27;1.000;3600000;0
172;556;33;100;42;1;41;.976;3682000;0
172;206789;30;0;0;0;0;.00nan;0;0
172;197038;33;0;0;0;0;.00nan;0;0
172;86697;30;70;21;2;19;.905;3682000;0
173;676;24;67;28;3;25;.893;3600000;0
173;165723;32;40;39;6;33;.846;2884000;0
173;85727;32;49;8;1;7;.875;716000;0
173;86192;24;0;0;0;0;.00nan;0;0
174;172340;4182;69;35;4;31;.886;3600000;0
174;206789;30;0;0;0;0;.00nan;0;0
174;86697;30;54;43;5;38;.884;3582000;0
174;140314;4182;0;0;0;0;.00nan;0;0
175;173699;10;71;43;4;39;.907;3932000;0
175;170314;5;0;0;0;0;.00nan;0;0
175;201585;5;38;23;5;18;.783;3932000;0
175;90164;10;0;0;0;0;.00nan;0;0
176;166646;0;0;0;0;0;.00nan;0;0
176;189333;0;65;19;1;18;.947;3974000;0
176;20432;28;80;29;2;27;.931;3974000;0
176;201174;28;0;0;0;0;.00nan;0;0
177;171838;31;0;0;0;0;.00nan;0;0
177;187578;26;0;0;0;0;.00nan;0;0
177;179154;26;69;25;2;23;.920;3600000;0
177;149452;31;74;35;3;32;.914;3553000;0
178;187537;19;0;0;0;0;.00nan;0;0
178;178384;19;73;32;2;30;.938;3600000;0
178;196090;4838;64;32;3;29;.906;3543000;0
178;179950;4838;0;0;0;0;.00nan;0;0
179;320;21;0;0;0;0;.00nan;0;0
179;3284;21;62;29;3;26;.897;3600000;0
179;175092;9;0;0;0;0;.00nan;0;0
179;190106;9;41;32;5;27;.844;3573000;0
180;20432;28;0;0;0;0;.00nan;0;0
180;201174;28;99;49;2;47;.959;4200000;0
180;139409;3;67;27;2;25;.926;4200000;0
180;148958;3;0;0;0;0;.00nan;0;0
181;187718;16;58;8;0;8;1.000;1143000;0
181;196005;22;0;0;0;0;.00nan;0;0
181;50065;16;38;32;6;26;.813;2457000;0
181;143473;22;58;18;2;16;.889;3600000;0
182;163471;34;0;0;0;0;.00nan;0;0
182;194416;17;0;0;0;0;.00nan;0;0
182;178413;17;78;31;2;29;.935;3600000;0
182;183904;34;56;14;1;13;.929;3600000;0
183;184229;35;100;33;1;32;.970;3600000;0
183;205824;25;54;23;3;20;.870;3513000;0
183;201673;25;0;0;0;0;.00nan;0;0
183;147977;35;0;0;0;0;.00nan;0;0
184;183859;23;0;0;0;0;.00nan;0;0
184;174718;12;75;17;0;17;1.000;1196000;0
184;59540;23;87;28;2;26;.929;3600000;0
184;85798;12;45;28;4;24;.857;2359000;0
185;192733;18;0;0;0;0;.00nan;0;0
185;13714;8;76;26;2;24;.923;3569000;0
185;173727;18;100;38;0;38;1.000;3600000;0
185;58830;8;0;0;0;0;.00nan;0;0
186;172340;4182;83;30;1;29;.967;3600000;0
186;175912;14;0;0;0;0;.00nan;0;0
186;185034;14;61;38;4;34;.895;3600000;0
186;140314;4182;0;0;0;0;.00nan;0;0
187;556;33;0;0;0;0;.00nan;0;0
187;676;24;89;46;3;43;.935;4035000;0
187;197038;33;64;41;4;37;.902;4035000;0
187;86192;24;0;0;0;0;.00nan;0;0
188;3928;15;0;0;0;0;.00nan;0;0
188;193854;11;0;0;0;0;.00nan;0;0
188;178098;15;50;32;5;27;.844;3552000;0
188;146862;11;56;29;4;25;.862;3600000;0
189;166646;0;95;42;3;39;.929;3587000;0
189;183844;29;65;16;1;15;.938;3600000;0
189;189333;0;0;0;0;0;.00nan;0;0
189;195089;29;0;0;0;0;.00nan;0;0
190;166591;20;90;41;3;38;.927;4200000;0
190;183783;20;0;0;0;0;.00nan;0;0
190;170314;5;61;38;3;35;.921;4200000;0
190;201585;5;0;0;0;0;.00nan;0;0
191;788;27;0;0;0;0;.00nan;0;0
191;171304;27;62;33;3;30;.909;3600000;0
191;206789;30;0;0;0;0;.00nan;0;0
191;86697;30;47;30;4;26;.867;3530000;0
192;171838;31;30;35;7;28;.800;3022000;0
192;196005;22;0;0;0;0;.00nan;0;0
192;143473;22;64;19;1;18;.947;3600000;0
192;149452;31;55;6;0;6;1.000;578000;0
193;187578;26;0;0;0;0;.00nan;0;0
193;173699;10;0;0;0;0;.00nan;0;0
193;179154;26;41;25;5;20;.800;3544000;0
193;90164;10;70;30;3;27;.900;3600000;0
194;194416;17;30;27;6;21;.778;3600000;0
194;178413;17;0;0;0;0;.00nan;0;0
194;139409;3;59;35;5;30;.857;3600000;0
194;148958;3;0;0;0;0;.00nan;0;0
195;187718;16;0;0;0;0;.00nan;0;0
195;163471;34;0;0;0;0;.00nan;0;0
195;183904;34;99;30;1;29;.967;3600000;0
195;50065;16;71;42;4;38;.905;3600000;0
196;187537;19;0;0;0;0;.00nan;0;0
196;178384;19;92;50;4;46;.920;3600000;0
196;183844;29;0;0;0;0;.00nan;0;0
196;195089;29;61;37;5;32;.865;3594000;0
197;165723;32;0;0;0;0;.00nan;0;0
197;20432;28;63;48;5;43;.896;4143000;0
197;201174;28;0;0;0;0;.00nan;0;0
197;85727;32;77;40;4;36;.900;4143000;0
198;184229;35;77;22;1;21;.955;3600000;0
198;174718;12;0;0;0;0;.00nan;0;0
198;85798;12;90;44;2;42;.955;3543000;0
198;147977;35;0;0;0;0;.00nan;0;0
199;13714;8;35;15;4;11;.733;1111000;0
199;205824;25;65;29;3;26;.897;3600000;0
199;201673;25;0;0;0;0;.00nan;0;0
199;58830;8;59;26;3;23;.885;2489000;0
200;556;33;92;44;4;40;.909;3834000;0
200;183859;23;0;0;0;0;.00nan;0;0
200;197038;33;0;0;0;0;.00nan;0;0
200;59540;23;51;20;3;17;.850;3834000;0
201;788;27;29;24;5;19;.792;3531000;0
201;171304;27;0;0;0;0;.00nan;0;0
201;175912;14;0;0;0;0;.00nan;0;0
201;185034;14;61;31;3;28;.903;3600000;0
202;193854;11;0;0;0;0;.00nan;0;0
202;196090;4838;49;37;5;32;.865;3600000;0
202;179950;4838;0;0;0;0;.00nan;0;0
202;146862;11;63;23;2;21;.913;3600000;0
203;187718;16;47;34;5;29;.853;3600000;0
203;175092;9;0;0;0;0;.00nan;0;0
203;190106;9;75;27;2;25;.926;3600000;0
203;50065;16;0;0;0;0;.00nan;0;0
204;320;21;0;0;0;0;.00nan;0;0
204;3284;21;74;25;2;23;.920;3982000;0
204;170314;5;81;43;3;40;.930;3982000;0
204;201585;5;0;0;0;0;.00nan;0;0
205;676;24;61;32;4;28;.875;3710000;0
205;166591;20;68;31;3;28;.903;3710000;0
205;183783;20;0;0;0;0;.00nan;0;0
205;86192;24;0;0;0;0;.00nan;0;0
206;192733;18;0;0;0;0;.00nan;0;0
206;166646;0;92;50;4;46;.920;3600000;0
206;189333;0;0;0;0;0;.00nan;0;0
206;173727;18;68;19;1;18;.947;3600000;0
207;3928;15;0;0;0;0;.00nan;0;0
207;172340;4182;80;45;4;41;.911;3600000;0
207;178098;15;86;17;0;17;1.000;3600000;0
207;140314;4182;0;0;0;0;.00nan;0;0
208;193854;11;87;37;2;35;.946;3600000;0
208;206789;30;0;0;0;0;.00nan;0;0
208;86697;30;92;41;3;38;.927;3561000;0
208;146862;11;0;0;0;0;.00nan;0;0
209;194416;17;0;0;0;0;.00nan;0;0
209;178413;17;80;30;1;29;.967;3600000;0
209;173699;10;51;29;4;25;.862;3600000;0
209;90164;10;0;0;0;0;.00nan;0;0
210;187578;26;0;0;0;0;.00nan;0;0
210;205824;25;0;0;0;0;.00nan;0;0
210;179154;26;51;44;7;37;.841;3600000;0
210;201673;25;49;10;2;8;.800;3600000;0
211;171838;31;0;0;0;0;.00nan;0;0
211;139409;3;0;0;0;0;.00nan;0;0
211;148958;3;100;27;0;27;1.000;3600000;0
211;149452;31;81;28;1;27;.964;3578000;0
212;192733;18;57;30;4;26;.867;3756000;0
212;183844;29;70;32;3;29;.906;3808000;0
212;173727;18;0;0;0;0;.00nan;0;0
212;195089;29;0;0;0;0;.00nan;0;0
213;320;21;59;20;2;18;.900;3600000;0
213;3284;21;0;0;0;0;.00nan;0;0
213;20432;28;0;0;0;0;.00nan;0;0
213;201174;28;69;41;5;36;.878;3600000;0
214;187537;19;0;0;0;0;.00nan;0;0
214;166646;0;74;37;4;33;.892;3600000;0
214;178384;19;85;33;2;31;.939;3600000;0
214;189333;0;0;0;0;0;.00nan;0;0
215;166591;20;0;0;0;0;.00nan;0;0
215;183783;20;96;39;1;38;.974;3600000;0
215;196005;22;91;21;0;21;1.000;3600000;0
215;143473;22;0;0;0;0;.00nan;0;0
216;175092;9;79;36;3;33;.917;3558000;0
216;175912;14;92;38;2;36;.947;3600000;0
216;190106;9;0;0;0;0;.00nan;0;0
216;185034;14;0;0;0;0;.00nan;0;0
217;13714;8;64;30;3;27;.900;3568000;0
217;174718;12;0;0;0;0;.00nan;0;0
217;58830;8;0;0;0;0;.00nan;0;0
217;85798;12;89;34;2;32;.941;3600000;0
218;556;33;51;29;4;25;.862;3562000;0
218;184229;35;43;19;3;16;.842;3600000;0
218;197038;33;0;0;0;0;.00nan;0;0
218;147977;35;0;0;0;0;.00nan;0;0
219;183859;23;0;0;0;0;.00nan;0;0
219;196090;4838;0;0;0;0;.00nan;0;0
219;179950;4838;47;22;3;19;.864;3600000;0
219;59540;23;85;20;0;20;1.000;3600000;0
220;788;27;0;0;0;0;.00nan;0;0
220;3928;15;0;0;0;0;.00nan;0;0
220;178098;15;50;23;4;19;.826;3600000;0
220;171304;27;56;37;5;32;.865;3567000;0
221;165723;32;0;0;0;0;.00nan;0;0
221;170314;5;78;24;1;23;.958;3600000;0
221;201585;5;0;0;0;0;.00nan;0;0
221;85727;32;58;25;2;23;.920;3599000;0
222;187578;26;46;29;4;25;.862;3568000;0
222;187718;16;0;0;0;0;.00nan;0;0
222;179154;26;0;0;0;0;.00nan;0;0
222;50065;16;80;38;3;35;.921;3600000;0
223;187537;19;26;32;7;25;.781;2989000;0
223;178384;19;44;6;1;5;.833;611000;0
223;139409;3;0;0;0;0;.00nan;0;0
223;148958;3;65;31;3;28;.903;3600000;0
224;163471;34;39;30;6;24;.800;3510000;0
224;183904;34;0;0;0;0;.00nan;0;0
224;173699;10;0;0;0;0;.00nan;0;0
224;90164;10;87;43;4;39;.907;3600000;0
225;172340;4182;74;45;4;41;.911;3579000;0
225;193854;11;0;0;0;0;.00nan;0;0
225;140314;4182;0;0;0;0;.00nan;0;0
225;146862;11;60;22;3;19;.864;3600000;0
226;196005;22;0;0;0;0;.00nan;0;0
226;196090;4838;48;0;0;0;.00nan;241000;0
226;179950;4838;37;42;6;36;.857;3359000;0
226;143473;22;65;20;2;18;.900;3600000;0
227;556;33;91;47;3;44;.936;3536000;0
227;183859;23;0;0;0;0;.00nan;0;0
227;197038;33;0;0;0;0;.00nan;0;0
227;59540;23;91;28;1;27;.964;3600000;0
228;171838;31;0;0;0;0;.00nan;0;0
228;175092;9;0;0;0;0;.00nan;0;0
228;190106;9;87;22;0;22;1.000;3600000;0
228;149452;31;84;37;3;34;.919;3600000;0
229;173699;10;91;45;2;43;.956;3600000;0
229;175912;14;60;40;4;36;.900;3551000;0
229;185034;14;0;0;0;0;.00nan;0;0
229;90164;10;0;0;0;0;.00nan;0;0
230;192733;18;0;0;0;0;.00nan;0;0
230;173727;18;74;29;2;27;.931;3600000;0
230;139409;3;31;5;3;2;.400;503000;0
230;148958;3;82;33;2;31;.939;3097000;0
231;166591;20;61;34;3;31;.912;3671000;0
231;183783;20;0;0;0;0;.00nan;0;0
231;206789;30;0;0;0;0;.00nan;0;0
231;86697;30;84;37;2;35;.946;3671000;0
232;187578;26;0;0;0;0;.00nan;0;0
232;179154;26;77;36;3;33;.917;3901000;0
232;174718;12;0;0;0;0;.00nan;0;0
232;85798;12;67;28;2;26;.929;3901000;0
233;172340;4182;100;29;0;29;1.000;3600000;0
233;13714;8;0;0;0;0;.00nan;0;0
233;58830;8;97;34;1;33;.971;3581000;0
233;140314;4182;0;0;0;0;.00nan;0;0
234;20432;28;0;0;0;0;.00nan;0;0
234;184229;35;53;22;3;19;.864;4200000;0
234;201174;28;90;64;3;61;.953;4200000;0
234;147977;35;0;0;0;0;.00nan;0;0
235;676;24;51;43;6;37;.860;3600000;0
235;205824;25;0;0;0;0;.00nan;0;0
235;201673;25;71;25;1;24;.960;3600000;0
235;86192;24;0;0;0;0;.00nan;0;0
236;193854;11;0;0;0;0;.00nan;0;0
236;170314;5;54;34;5;29;.853;3600000;0
236;201585;5;0;0;0;0;.00nan;0;0
236;146862;11;87;25;1;24;.960;3600000;0
237;320;21;0;0;0;0;.00nan;0;0
237;3284;21;55;35;5;30;.857;3571000;0
237;3928;15;0;0;0;0;.00nan;0;0
237;178098;15;67;25;2;23;.920;3600000;0
238;183859;23;0;0;0;0;.00nan;0;0
238;196090;4838;59;38;4;34;.895;3516000;0
238;179950;4838;0;0;0;0;.00nan;0;0
238;59540;23;67;25;2;23;.920;3600000;0
239;556;33;96;38;2;36;.947;4200000;0
239;172340;4182;76;31;2;29;.935;4200000;0
239;197038;33;0;0;0;0;.00nan;0;0
239;140314;4182;0;0;0;0;.00nan;0;0
240;187537;19;50;2;0;2;1.000;779000;0
240;178384;19;44;48;7;41;.854;2821000;0
240;196005;22;0;0;0;0;.00nan;0;0
240;143473;22;73;18;1;17;.944;3600000;0
241;194416;17;0;0;0;0;.00nan;0;0
241;183844;29;0;0;0;0;.00nan;0;0
241;178413;17;70;38;3;35;.921;3685000;0
241;195089;29;64;31;4;27;.871;3685000;0
242;173699;10;61;29;3;26;.897;3600000;0
242;174718;12;0;0;0;0;.00nan;0;0
242;85798;12;47;36;5;31;.861;3568000;0
242;90164;10;0;0;0;0;.00nan;0;0
243;206789;30;0;0;0;0;.00nan;0;0
243;86697;30;88;29;1;28;.966;3600000;0
243;139409;3;73;32;3;29;.906;3592000;0
243;148958;3;0;0;0;0;.00nan;0;0
244;676;24;98;33;1;32;.970;3600000;0
244;175912;14;40;22;4;18;.818;3600000;0
244;185034;14;0;0;0;0;.00nan;0;0
244;86192;24;0;0;0;0;.00nan;0;0
245;165723;32;0;0;0;0;.00nan;0;0
245;20432;28;0;0;0;0;.00nan;0;0
245;201174;28;55;23;3;20;.870;3600000;0
245;85727;32;96;36;2;34;.944;3600000;0
246;192733;18;0;0;0;0;.00nan;0;0
246;187537;19;83;49;4;45;.918;3600000;0
246;178384;19;0;0;0;0;.00nan;0;0
246;173727;18;56;26;3;23;.885;3600000;0
247;183859;23;58;37;4;33;.892;3582000;0
247;196005;22;73;27;2;25;.926;3600000;0
247;59540;23;0;0;0;0;.00nan;0;0
247;143473;22;0;0;0;0;.00nan;0;0
248;788;27;0;0;0;0;.00nan;0;0
248;170314;5;72;21;1;20;.952;3600000;0
248;171304;27;57;29;3;26;.897;3583000;0
248;201585;5;0;0;0;0;.00nan;0;0
249;193854;11;0;0;0;0;.00nan;0;0
249;184229;35;92;46;3;43;.935;3600000;0
249;146862;11;57;38;5;33;.868;3527000;0
249;147977;35;0;0;0;0;.00nan;0;0
250;166646;0;45;27;4;23;.852;3549000;0
250;194416;17;57;28;3;25;.893;3600000;0
250;178413;17;0;0;0;0;.00nan;0;0
250;189333;0;0;0;0;0;.00nan;0;0
251;205824;25;84;22;0;22;1.000;3600000;0
251;175092;9;0;0;0;0;.00nan;0;0
251;190106;9;62;32;4;28;.875;3600000;0
251;201673;25;0;0;0;0;.00nan;0;0
252;172340;4182;85;30;1;29;.967;3600000;0
252;170314;5;0;0;0;0;.00nan;0;0
252;201585;5;57;19;2;17;.895;3599000;0
252;140314;4182;0;0;0;0;.00nan;0;0
253;187718;16;63;20;1;19;.950;2657000;0
253;183844;29;50;19;3;16;.842;3600000;0
253;195089;29;0;0;0;0;.00nan;0;0
253;50065;16;27;12;4;8;.667;871000;0
254;3928;15;63;15;1;14;.933;3600000;0
254;178098;15;0;0;0;0;.00nan;0;0
254;206789;30;0;0;0;0;.00nan;0;0
254;86697;30;84;42;3;39;.929;3600000;0
255;13714;8;81;14;0;14;1.000;3600000;0
255;165723;32;0;0;0;0;.00nan;0;0
255;58830;8;0;0;0;0;.00nan;0;0
255;85727;32;50;34;4;30;.882;3600000;0
256;20432;28;0;0;0;0;.00nan;0;0
256;201174;28;61;51;7;44;.863;3600000;0
256;196090;4838;31;9;3;6;.667;1595000;0
256;179950;4838;15;22;6;16;.727;1972000;0
257;171838;31;70;26;2;24;.923;3600000;0
257;139409;3;54;33;5;28;.848;3600000;0
257;148958;3;0;0;0;0;.00nan;0;0
257;149452;31;0;0;0;0;.00nan;0;0
258;320;21;0;0;0;0;.00nan;0;0
258;3284;21;79;27;2;25;.926;3567000;0
258;175912;14;0;0;0;0;.00nan;0;0
258;185034;14;89;31;1;30;.968;3600000;0
259;192733;18;0;0;0;0;.00nan;0;0
259;173727;18;79;34;2;32;.941;3600000;0
259;196005;22;0;0;0;0;.00nan;0;0
259;143473;22;40;26;5;21;.808;3600000;0
260;676;24;0;0;0;0;.00nan;0;0
260;163471;34;0;0;0;0;.00nan;0;0
260;183904;34;58;12;1;11;.917;3600000;0
260;86192;24;74;39;4;35;.897;3600000;0
261;205824;25;58;25;3;22;.880;4200000;0
261;174718;12;0;0;0;0;.00nan;0;0
261;201673;25;0;0;0;0;.00nan;0;0
261;85798;12;72;33;3;30;.909;4200000;0
262;166591;20;89;33;2;31;.939;3600000;0
262;183783;20;0;0;0;0;.00nan;0;0
262;173699;10;66;10;0;10;1.000;1035000;0
262;90164;10;23;25;6;19;.760;2565000;0
263;556;33;23;36;7;29;.806;3600000;0
263;187578;26;0;0;0;0;.00nan;0;0
263;179154;26;100;31;0;31;1.000;3600000;0
263;197038;33;0;0;0;0;.00nan;0;0
264;187537;19;0;0;0;0;.00nan;0;0
264;178384;19;58;33;4;29;.879;3547000;0
264;183859;23;0;0;0;0;.00nan;0;0
264;59540;23;92;38;2;36;.947;3600000;0
265;788;27;0;0;0;0;.00nan;0;0
265;184229;35;80;38;4;34;.895;3600000;0
265;171304;27;100;33;0;33;1.000;3600000;0
265;147977;35;0;0;0;0;.00nan;0;0
266;166646;0;97;43;2;41;.953;3588000;0
266;187718;16;0;0;0;0;.00nan;0;0
266;189333;0;0;0;0;0;.00nan;0;0
266;50065;16;96;26;0;26;1.000;3600000;0
267;3928;15;0;0;0;0;.00nan;0;0
267;178098;15;83;24;1;23;.958;3600000;0
267;173699;10;80;53;3;50;.943;3600000;0
267;90164;10;0;0;0;0;.00nan;0;0
268;175912;14;87;34;2;32;.941;3600000;0
268;206789;30;0;0;0;0;.00nan;0;0
268;185034;14;0;0;0;0;.00nan;0;0
268;86697;30;69;34;3;31;.912;3600000;0
269;165723;32;92;42;3;39;.929;4156000;0
269;175092;9;0;0;0;0;.00nan;0;0
269;190106;9;66;25;2;23;.920;4156000;0
269;85727;32;0;0;0;0;.00nan;0;0
270;172340;4182;79;25;1;24;.960;3600000;0
270;184229;35;0;0;0;0;.00nan;0;0
270;140314;4182;0;0;0;0;.00nan;0;0
270;147977;35;51;27;3;24;.889;3520000;0
271;170314;5;83;44;3;41;.932;3600000;0
271;201585;5;0;0;0;0;.00nan;0;0
271;196090;4838;95;22;0;22;1.000;3600000;0
271;179950;4838;0;0;0;0;.00nan;0;0
272;171838;31;56;25;3;22;.880;3652000;0
272;20432;28;0;0;0;0;.00nan;0;0
272;201174;28;73;29;2;27;.931;3652000;0
272;149452;31;0;0;0;0;.00nan;0;0
273;187578;26;56;19;2;17;.895;1473000;0
273;163471;34;0;0;0;0;.00nan;0;0
273;183904;34;72;25;2;23;.920;3600000;0
273;179154;26;48;34;6;28;.824;2127000;0
274;556;33;70;39;4;35;.897;3600000;0
274;13714;8;33;20;5;15;.750;3588000;0
274;197038;33;0;0;0;0;.00nan;0;0
274;58830;8;0;0;0;0;.00nan;0;0
275;788;27;0;0;0;0;.00nan;0;0
275;171304;27;56;30;3;27;.900;3550000;0
275;174718;12;0;0;0;0;.00nan;0;0
275;85798;12;85;42;2;40;.952;3600000;0
276;192733;18;0;0;0;0;.00nan;0;0
276;183859;23;0;0;0;0;.00nan;0;0
276;173727;18;91;20;0;20;1.000;3600000;0
276;59540;23;79;35;4;31;.886;3600000;0
277;187537;19;0;0;0;0;.00nan;0;0
277;193854;11;0;0;0;0;.00nan;0;0
277;178384;19;78;28;2;26;.929;3600000;0
277;146862;11;71;31;3;28;.903;3568000;0
278;320;21;43;4;1;3;.750;1526000;0
278;3284;21;41;21;4;17;.810;2074000;0
278;196090;4838;82;39;2;37;.949;3600000;0
278;179950;4838;0;0;0;0;.00nan;0;0
279;165723;32;0;0;0;0;.00nan;0;0
279;173699;10;97;30;1;29;.967;3600000;0
279;85727;32;64;43;5;38;.884;3600000;0
279;90164;10;0;0;0;0;.00nan;0;0
280;676;24;71;46;5;41;.891;3600000;0
280;194416;17;0;0;0;0;.00nan;0;0
280;178413;17;79;25;2;23;.920;3600000;0
280;86192;24;0;0;0;0;.00nan;0;0
281;171838;31;0;0;0;0;.00nan;0;0
281;170314;5;89;36;1;35;.972;4124000;0
281;201585;5;0;0;0;0;.00nan;0;0
281;149452;31;70;31;2;29;.935;4118000;0
282;163471;34;0;0;0;0;.00nan;0;0
282;183904;34;72;37;3;34;.919;3719000;0
282;175912;14;0;0;0;0;.00nan;0;0
282;185034;14;60;25;2;23;.920;3719000;0
283;20432;28;78;60;6;54;.900;3600000;0
283;205824;25;58;14;1;13;.929;3600000;0
283;201174;28;0;0;0;0;.00nan;0;0
283;201673;25;0;0;0;0;.00nan;0;0
284;166591;20;79;24;2;22;.917;3596000;0
284;183783;20;0;0;0;0;.00nan;0;0
284;175092;9;0;0;0;0;.00nan;0;0
284;190106;9;93;29;1;28;.966;3600000;0
285;3928;15;0;0;0;0;.00nan;0;0
285;178098;15;41;23;4;19;.826;3600000;0
285;196005;22;0;0;0;0;.00nan;0;0
285;143473;22;63;17;1;16;.941;3600000;0
286;184229;35;86;17;0;17;1.000;3600000;0
286;174718;12;72;48;5;43;.896;3600000;0
286;85798;12;0;0;0;0;.00nan;0;0
286;147977;35;0;0;0;0;.00nan;0;0
287;192733;18;0;0;0;0;.00nan;0;0
287;13714;8;81;41;3;38;.927;3772000;0
287;173727;18;76;27;2;25;.926;3772000;0
287;58830;8;0;0;0;0;.00nan;0;0
288;187578;26;0;0;0;0;.00nan;0;0
288;179154;26;90;32;1;31;.969;3600000;0
288;206789;30;0;0;0;0;.00nan;0;0
288;86697;30;32;33;6;27;.818;3600000;0
289;172340;4182;67;20;2;18;.900;3600000;0
289;139409;3;74;44;4;40;.909;3562000;0
289;140314;4182;0;0;0;0;.00nan;0;0
289;148958;3;0;0;0;0;.00nan;0;0
290;556;33;0;0;0;0;.00nan;0;0
290;187537;19;0;0;0;0;.00nan;0;0
290;178384;19;97;46;2;44;.957;3587000;0
290;197038;33;94;32;1;31;.969;3600000;0
291;193854;11;0;0;0;0;.00nan;0;0
291;183859;23;56;6;0;6;1.000;567000;0
291;59540;23;29;22;6;16;.727;3033000;0
291;146862;11;84;28;1;27;.964;3600000;0
292;171838;31;72;47;4;43;.915;3982000;0
292;194416;17;0;0;0;0;.00nan;0;0
292;178413;17;63;23;3;20;.870;3982000;0
292;149452;31;0;0;0;0;.00nan;0;0
293;3928;15;0;0;0;0;.00nan;0;0
293;163471;34;85;16;0;16;1.000;1502000;0
293;178098;15;71;29;2;27;.931;3600000;0
293;183904;34;14;21;6;15;.714;2098000;0
294;166646;0;90;50;4;46;.920;3600000;0
294;165723;32;0;0;0;0;.00nan;0;0
294;189333;0;0;0;0;0;.00nan;0;0
294;85727;32;46;30;5;25;.833;3549000;0
295;676;24;56;33;4;29;.879;3600000;0
295;173699;10;63;44;5;39;.886;3592000;0
295;86192;24;0;0;0;0;.00nan;0;0
295;90164;10;0;0;0;0;.00nan;0;0
296;13714;8;87;38;2;36;.947;3600000;0
296;184229;35;51;30;4;26;.867;3586000;0
296;58830;8;0;0;0;0;.00nan;0;0
296;147977;35;0;0;0;0;.00nan;0;0
297;166591;20;83;28;1;27;.964;3600000;0
297;183783;20;0;0;0;0;.00nan;0;0
297;196090;4838;55;16;2;14;.875;3562000;0
297;179950;4838;0;0;0;0;.00nan;0;0
298;788;27;65;30;2;28;.933;3600000;0
298;172340;4182;73;16;1;15;.938;3600000;0
298;171304;27;0;0;0;0;.00nan;0;0
298;140314;4182;0;0;0;0;.00nan;0;0
299;193854;11;78;22;1;21;.955;3600000;0
299;139409;3;25;28;6;22;.786;3257000;0
299;146862;11;0;0;0;0;.00nan;0;0
299;148958;3;56;5;0;5;1.000;343000;0
300;175092;9;83;29;1;28;.966;3600000;0
300;175912;14;0;0;0;0;.00nan;0;0
300;190106;9;0;0;0;0;.00nan;0;0
300;185034;14;69;26;2;24;.923;3600000;0
301;183844;29;0;0;0;0;.00nan;0;0
301;195089;29;99;32;1;31;.969;3600000;0
301;196005;22;0;0;0;0;.00nan;0;0
301;143473;22;60;29;3;26;.897;3548000;0
302;320;21;0;0;0;0;.00nan;0;0
302;3284;21;62;26;3;23;.885;3600000;0
302;20432;28;79;50;4;46;.920;3550000;0
302;201174;28;0;0;0;0;.00nan;0;0
303;170314;5;83;30;1;29;.967;3600000;0
303;205824;25;28;9;3;6;.667;602000;0
303;201585;5;0;0;0;0;.00nan;0;0
303;201673;25;66;25;2;23;.920;2998000;0
304;192733;18;0;0;0;0;.00nan;0;0
304;187578;26;0;0;0;0;.00nan;0;0
304;173727;18;82;37;3;34;.919;4064000;0
304;179154;26;86;48;4;44;.917;4068000;0
305;556;33;78;39;3;36;.923;4200000;0
305;187718;16;0;0;0;0;.00nan;0;0
305;197038;33;0;0;0;0;.00nan;0;0
305;50065;16;80;36;3;33;.917;4200000;0
306;187537;19;0;0;0;0;.00nan;0;0
306;178384;19;71;23;2;21;.913;3600000;0
306;183859;23;55;13;1;12;.923;1410000;0
306;59540;23;31;29;6;23;.793;2190000;0
307;171838;31;0;0;0;0;.00nan;0;0
307;163471;34;87;14;0;14;1.000;3600000;0
307;183904;34;0;0;0;0;.00nan;0;0
307;149452;31;91;40;2;38;.950;3573000;0
308;788;27;0;0;0;0;.00nan;0;0
308;171304;27;49;31;4;27;.871;3600000;0
308;139409;3;74;36;3;33;.917;2524000;0
308;148958;3;28;17;4;13;.765;1076000;0
309;676;24;0;0;0;0;.00nan;0;0
309;175092;9;0;0;0;0;.00nan;0;0
309;190106;9;70;40;4;36;.900;3600000;0
309;86192;24;97;33;1;32;.970;3600000;0
310;166646;0;67;37;5;32;.865;3567000;0
310;189333;0;0;0;0;0;.00nan;0;0
310;175912;14;57;24;3;21;.875;3600000;0
310;185034;14;0;0;0;0;.00nan;0;0
311;3928;15;82;41;3;38;.927;3547000;0
311;178098;15;0;0;0;0;.00nan;0;0
311;196005;22;79;28;2;26;.929;3600000;0
311;143473;22;0;0;0;0;.00nan;0;0
312;192733;18;46;27;4;23;.852;3600000;0
312;556;33;0;0;0;0;.00nan;0;0
312;173727;18;0;0;0;0;.00nan;0;0
312;197038;33;77;26;1;25;.962;3600000;0
313;187537;19;44;27;5;22;.815;3709000;0
313;193854;11;0;0;0;0;.00nan;0;0
313;178384;19;0;0;0;0;.00nan;0;0
313;146862;11;51;34;6;28;.824;3709000;0
314;174718;12;61;20;2;18;.900;2847000;0
314;206789;30;0;0;0;0;.00nan;0;0
314;85798;12;31;14;4;10;.714;753000;0
314;86697;30;63;18;1;17;.944;3600000;0
315;187718;16;0;0;0;0;.00nan;0;0
315;194416;17;0;0;0;0;.00nan;0;0
315;178413;17;45;42;6;36;.857;3581000;0
315;50065;16;47;31;5;26;.839;3600000;0
316;165723;32;87;32;1;31;.969;3600000;0
316;184229;35;39;26;5;21;.808;3600000;0
316;85727;32;0;0;0;0;.00nan;0;0
316;147977;35;0;0;0;0;.00nan;0;0
317;320;21;0;0;0;0;.00nan;0;0
317;3284;21;64;29;3;26;.897;3600000;0
317;173699;10;0;0;0;0;.00nan;0;0
317;90164;10;58;33;4;29;.879;3544000;0
318;13714;8;99;58;2;56;.966;3600000;0
318;205824;25;51;10;1;9;.900;1736000;0
318;201673;25;19;22;6;16;.727;1864000;0
318;58830;8;0;0;0;0;.00nan;0;0
319;172340;4182;100;39;1;38;.974;3600000;0
319;196090;4838;73;31;2;29;.935;3553000;0
319;179950;4838;0;0;0;0;.00nan;0;0
319;140314;4182;0;0;0;0;.00nan;0;0
320;171838;31;80;34;3;31;.912;3600000;0
320;173699;10;100;30;0;30;1.000;3600000;0
320;90164;10;0;0;0;0;.00nan;0;0
320;149452;31;0;0;0;0;.00nan;0;0
321;163471;34;66;22;2;20;.909;3600000;0
321;183904;34;0;0;0;0;.00nan;0;0
321;175092;9;0;0;0;0;.00nan;0;0
321;190106;9;71;37;5;32;.865;3600000;0
322;183844;29;0;0;0;0;.00nan;0;0
322;170314;5;100;45;2;43;.956;4200000;0
322;195089;29;68;28;2;26;.929;4200000;0
322;201585;5;0;0;0;0;.00nan;0;0
323;556;33;100;29;0;29;1.000;3600000;0
323;20432;28;0;0;0;0;.00nan;0;0
323;201174;28;74;26;1;25;.962;3569000;0
323;197038;33;0;0;0;0;.00nan;0;0
324;192733;18;0;0;0;0;.00nan;0;0
324;173727;18;55;24;3;21;.875;3600000;0
324;206789;30;0;0;0;0;.00nan;0;0
324;86697;30;95;37;2;35;.946;3600000;0
325;3928;20;63;45;6;39;.867;3600000;0
325;193854;11;0;0;0;0;.00nan;0;0
325;205824;20;0;0;0;0;.00nan;0;0
325;146862;11;52;23;3;20;.870;3600000;0
326;676;24;72;41;4;37;.902;3553000;0
326;196005;22;0;0;0;0;.00nan;0;0
326;86192;24;0;0;0;0;.00nan;0;0
326;143473;22;62;19;2;17;.895;3600000;0
327;166591;15;87;26;1;25;.962;3600000;0
327;3284;21;87;46;3;43;.935;3600000;0
327;182116;21;0;0;0;0;.00nan;0;0
327;187362;15;0;0;0;0;.00nan;0;0
328;166646;0;80;38;3;35;.921;3553000;0
328;189333;0;0;0;0;0;.00nan;0;0
328;170314;5;0;0;0;0;.00nan;0;0
328;201585;5;74;23;2;21;.913;3600000;0
329;187718;16;0;0;0;0;.00nan;0;0
329;184229;35;61;25;2;23;.920;3600000;0
329;50065;16;42;25;5;20;.800;3600000;0
329;147977;35;0;0;0;0;.00nan;0;0
330;13714;8;84;34;2;32;.941;3565000;0
330;175912;14;0;0;0;0;.00nan;0;0
330;185034;14;88;31;1;30;.968;3600000;0
330;58830;8;0;0;0;0;.00nan;0;0
331;187578;26;0;0;0;0;.00nan;0;0
331;183783;25;0;0;0;0;.00nan;0;0
331;179154;26;94;43;3;40;.930;3691000;0
331;191813;25;75;24;2;22;.917;3691000;0
332;165723;32;0;0;0;0;.00nan;0;0
332;183859;23;0;0;0;0;.00nan;0;0
332;59540;23;84;27;1;26;.963;3600000;0
332;85727;32;70;41;4;37;.902;3600000;0
333;20432;28;61;36;5;31;.861;3513000;0
333;201174;28;0;0;0;0;.00nan;0;0
333;174718;12;0;0;0;0;.00nan;0;0
333;85798;12;52;24;3;21;.875;3600000;0
334;206789;30;0;0;0;0;.00nan;0;0
334;196090;4838;0;0;0;0;.00nan;0;0
334;185743;4838;74;35;3;32;.914;3562000;0
334;86697;30;70;23;1;22;.957;3600000;0
335;187537;19;0;0;0;0;.00nan;0;0
335;172340;4182;80;22;1;21;.955;3600000;0
335;178384;19;50;32;4;28;.875;3600000;0
335;140314;4182;0;0;0;0;.00nan;0;0
336;173699;10;26;26;6;20;.769;3069000;0
336;90164;10;50;1;0;1;1.000;482000;0
336;139409;3;54;34;5;29;.853;3600000;0
336;148958;3;0;0;0;0;.00nan;0;0
337;163471;34;69;43;4;39;.907;3531000;0
337;194416;17;0;0;0;0;.00nan;0;0
337;178413;17;71;25;3;22;.880;3600000;0
337;183904;34;0;0;0;0;.00nan;0;0
338;788;27;59;19;2;17;.895;3600000;0
338;3928;20;45;46;7;39;.848;2808000;0
338;205824;20;48;13;2;11;.846;792000;0
338;171304;27;0;0;0;0;.00nan;0;0
339;171838;31;73;28;2;26;.929;3585000;0
339;193854;11;0;0;0;0;.00nan;0;0
339;146862;11;99;24;0;24;1.000;3600000;0
339;149452;31;0;0;0;0;.00nan;0;0
340;3284;21;0;0;0;0;.00nan;0;0
340;196005;22;0;0;0;0;.00nan;0;0
340;182116;21;79;52;5;47;.904;3569000;0
340;143473;22;56;28;3;25;.893;3600000;0
341;165723;32;0;0;0;0;.00nan;0;0
341;194416;17;71;33;2;31;.939;3600000;0
341;178413;17;0;0;0;0;.00nan;0;0
341;85727;32;85;28;1;27;.964;3600000;0
342;170314;5;60;19;2;17;.895;3600000;0
342;201585;5;0;0;0;0;.00nan;0;0
342;139409;3;0;0;0;0;.00nan;0;0
342;148958;3;70;36;4;32;.889;3600000;0
343;676;24;47;46;7;39;.848;3600000;0
343;166591;15;72;32;3;29;.906;3125000;0
343;187362;15;32;2;2;0;.000;475000;0
343;86192;24;0;0;0;0;.00nan;0;0
344;20432;28;0;0;0;0;.00nan;0;0
344;201174;28;85;37;2;35;.946;3600000;0
344;175912;14;0;0;0;0;.00nan;0;0
344;185034;14;65;26;3;23;.885;3563000;0
345;166646;0;0;0;0;0;.00nan;0;0
345;183859;23;0;0;0;0;.00nan;0;0
345;189333;0;76;24;2;22;.917;3600000;0
345;59540;23;72;19;1;18;.947;3600000;0
346;187718;16;0;0;0;0;.00nan;0;0
346;13714;8;39;27;6;21;.778;3600000;0
346;50065;16;100;36;1;35;.972;3600000;0
346;58830;8;0;0;0;0;.00nan;0;0
347;184229;35;72;36;3;33;.917;3600000;0
347;175092;9;0;0;0;0;.00nan;0;0
347;190106;9;100;36;0;36;1.000;3600000;0
347;147977;35;0;0;0;0;.00nan;0;0
348;183783;25;0;0;0;0;.00nan;0;0
348;196090;4838;0;0;0;0;.00nan;0;0
348;185743;4838;92;56;3;53;.946;3554000;0
348;191813;25;67;26;2;24;.923;3600000;0
349;556;33;43;32;5;27;.844;3591000;0
349;174718;12;65;32;4;28;.875;3600000;0
349;197038;33;0;0;0;0;.00nan;0;0
349;85798;12;0;0;0;0;.00nan;0;0
350;192733;18;0;0;0;0;.00nan;0;0
350;187578;26;55;5;0;5;1.000;718000;0
350;173727;18;48;21;3;18;.857;3600000;0
350;179154;26;30;35;7;28;.800;2882000;0
351;3928;20;0;0;0;0;.00nan;0;0
351;172340;4182;0;0;0;0;.00nan;0;0
351;205824;20;69;25;2;23;.920;3600000;0
351;140314;4182;47;21;3;18;.857;3591000;0
352;187537;19;0;0;0;0;.00nan;0;0
352;178384;19;62;31;3;28;.903;3551000;0
352;206789;30;0;0;0;0;.00nan;0;0
352;86697;30;92;37;2;35;.946;3600000;0
353;183844;29;31;35;7;28;.800;3233000;0
353;173699;10;0;0;0;0;.00nan;0;0
353;195089;29;63;10;0;10;1.000;967000;0
353;90164;10;48;59;7;52;.881;4200000;0
354;676;24;0;0;0;0;.00nan;0;0
354;193854;11;0;0;0;0;.00nan;0;0
354;86192;24;93;44;2;42;.955;4200000;0
354;146862;11;73;28;2;26;.929;4200000;0
355;187578;26;89;31;1;30;.968;3600000;0
355;20432;28;84;35;2;33;.943;3550000;0
355;179154;26;0;0;0;0;.00nan;0;0
355;201174;28;0;0;0;0;.00nan;0;0
356;165723;32;0;0;0;0;.00nan;0;0
356;183783;25;0;0;0;0;.00nan;0;0
356;191813;25;39;22;5;17;.773;3547000;0
356;85727;32;99;51;4;47;.922;3600000;0
357;163471;34;61;29;4;25;.862;3640000;0
357;13714;8;75;38;3;35;.921;3640000;0
357;183904;34;0;0;0;0;.00nan;0;0
357;58830;8;0;0;0;0;.00nan;0;0
358;170314;5;82;41;3;38;.927;3600000;0
358;201585;5;0;0;0;0;.00nan;0;0
358;196005;22;0;0;0;0;.00nan;0;0
358;143473;22;80;27;1;26;.963;3600000;0
359;3284;21;0;0;0;0;.00nan;0;0
359;175092;9;0;0;0;0;.00nan;0;0
359;190106;9;53;40;5;35;.875;3600000;0
359;182116;21;51;21;4;17;.810;3600000;0
360;194416;17;0;0;0;0;.00nan;0;0
360;178413;17;72;20;1;19;.950;3600000;0
360;139409;3;98;39;2;37;.949;3559000;0
360;148958;3;0;0;0;0;.00nan;0;0
361;183844;29;0;0;0;0;.00nan;0;0
361;183859;23;0;0;0;0;.00nan;0;0
361;195089;29;32;26;5;21;.808;3600000;0
361;59540;23;72;21;1;20;.952;3600000;0
362;166591;15;99;25;0;25;1.000;3600000;0
362;175912;14;73;42;4;38;.905;3600000;0
362;185034;14;0;0;0;0;.00nan;0;0
362;187362;15;0;0;0;0;.00nan;0;0
363;171838;31;51;37;6;31;.838;3600000;0
363;166646;0;87;28;1;27;.964;3600000;0
363;189333;0;0;0;0;0;.00nan;0;0
363;149452;31;0;0;0;0;.00nan;0;0
364;184229;35;62;31;5;26;.839;3565000;0
364;174718;12;0;0;0;0;.00nan;0;0
364;85798;12;89;46;3;43;.935;3600000;0
364;147977;35;0;0;0;0;.00nan;0;0
365;556;33;77;39;3;36;.923;3598000;0
365;172340;4182;59;20;2;18;.900;3600000;0
365;197038;33;0;0;0;0;.00nan;0;0
365;140314;4182;0;0;0;0;.00nan;0;0
366;192733;18;0;0;0;0;.00nan;0;0
366;187537;19;0;0;0;0;.00nan;0;0
366;178384;19;84;41;3;38;.927;3563000;0
366;173727;18;76;24;1;23;.958;3600000;0
367;3928;20;97;30;1;29;.967;3600000;0
367;205824;20;0;0;0;0;.00nan;0;0
367;206789;30;81;37;2;35;.946;3600000;0
367;86697;30;0;0;0;0;.00nan;0;0
368;187718;16;57;24;2;22;.917;3600000;0
368;165723;32;73;31;3;28;.903;3558000;0
368;50065;16;0;0;0;0;.00nan;0;0
368;85727;32;0;0;0;0;.00nan;0;0
369;163471;34;0;0;0;0;.00nan;0;0
369;193854;11;0;0;0;0;.00nan;0;0
369;183904;34;66;27;2;25;.926;3600000;0
369;146862;11;97;46;3;43;.935;3600000;0
370;171838;31;0;0;0;0;.00nan;0;0
370;173699;10;58;21;2;19;.905;3600000;0
370;90164;10;0;0;0;0;.00nan;0;0
370;149452;31;100;49;1;48;.980;3600000;0
371;13714;8;0;0;0;0;.00nan;0;0
371;175092;9;20;39;8;31;.795;2853000;0
371;190106;9;62;12;0;12;1.000;747000;0
371;58830;8;72;29;3;26;.897;3600000;0
372;556;33;0;0;0;0;.00nan;0;0
372;788;27;49;21;3;18;.857;3537000;0
372;171304;27;0;0;0;0;.00nan;0;0
372;197038;33;91;35;1;34;.971;3600000;0
373;166591;15;81;23;1;22;.957;3600000;0
373;175912;14;78;42;3;39;.929;3600000;0
373;185034;14;0;0;0;0;.00nan;0;0
373;187362;15;0;0;0;0;.00nan;0;0
374;187578;26;0;0;0;0;.00nan;0;0
374;20432;28;0;0;0;0;.00nan;0;0
374;179154;26;49;27;4;23;.852;3578000;0
374;201174;28;83;39;3;36;.923;3600000;0
375;183859;23;0;0;0;0;.00nan;0;0
375;59540;23;100;33;1;32;.970;3600000;0
375;139409;3;80;36;2;34;.944;3546000;0
375;148958;3;0;0;0;0;.00nan;0;0
376;3284;21;0;0;0;0;.00nan;0;0
376;183783;25;0;0;0;0;.00nan;0;0
376;182116;21;55;51;7;44;.863;3600000;0
376;191813;25;57;23;3;20;.870;3600000;0
377;3928;20;83;48;4;44;.917;3600000;0
377;205824;20;0;0;0;0;.00nan;0;0
377;174718;12;25;14;4;10;.714;1179000;0
377;85798;12;39;24;4;20;.833;2421000;0
378;184229;35;68;27;3;24;.889;3549000;0
378;206789;30;0;0;0;0;.00nan;0;0
378;86697;30;98;38;1;37;.974;3600000;0
378;147977;35;0;0;0;0;.00nan;0;0
379;194416;17;0;0;0;0;.00nan;0;0
379;178413;17;71;32;2;30;.938;3550000;0
379;175092;9;0;0;0;0;.00nan;0;0
379;190106;9;88;30;1;29;.967;3600000;0
380;788;27;0;0;0;0;.00nan;0;0
380;173699;10;0;0;0;0;.00nan;0;0
380;171304;27;36;21;4;17;.810;3600000;0
380;90164;10;36;37;6;31;.838;3569000;0
381;163471;34;40;27;5;22;.815;3560000;0
381;183844;29;0;0;0;0;.00nan;0;0
381;183904;34;0;0;0;0;.00nan;0;0
381;195089;29;81;42;4;38;.905;3600000;0
382;193854;11;0;0;0;0;.00nan;0;0
382;196005;22;0;0;0;0;.00nan;0;0
382;143473;22;75;21;2;19;.905;3600000;0
382;146862;11;74;53;5;48;.906;3600000;0
383;13714;8;56;19;2;17;.895;3955000;0
383;165723;32;0;0;0;0;.00nan;0;0
383;58830;8;0;0;0;0;.00nan;0;0
383;85727;32;87;23;1;22;.957;3955000;0
384;192733;18;0;0;0;0;.00nan;0;0
384;187718;16;0;0;0;0;.00nan;0;0
384;173727;18;100;27;0;27;1.000;4078000;0
384;50065;16;89;35;1;34;.971;4078000;0
385;556;33;74;42;3;39;.929;3575000;0
385;172340;4182;77;24;1;23;.958;3600000;0
385;197038;33;0;0;0;0;.00nan;0;0
385;140314;4182;0;0;0;0;.00nan;0;0
386;676;24;64;28;3;25;.893;3600000;0
386;187537;19;0;0;0;0;.00nan;0;0
386;178384;19;55;25;4;21;.840;3592000;0
386;86192;24;0;0;0;0;.00nan;0;0
387;187578;26;0;0;0;0;.00nan;0;0
387;170314;5;40;39;6;33;.846;3525000;0
387;179154;26;64;35;4;31;.886;3600000;0
387;201585;5;0;0;0;0;.00nan;0;0
388;20432;28;66;42;5;37;.881;3600000;0
388;201174;28;0;0;0;0;.00nan;0;0
388;175912;14;96;37;1;36;.973;3600000;0
388;185034;14;0;0;0;0;.00nan;0;0
389;184229;35;95;36;2;34;.944;3600000;0
389;206789;30;0;0;0;0;.00nan;0;0
389;86697;30;21;25;6;19;.760;3600000;0
389;147977;35;0;0;0;0;.00nan;0;0
390;3284;21;0;0;0;0;.00nan;0;0
390;196090;4838;0;0;0;0;.00nan;0;0
390;182116;21;56;24;4;20;.833;3599000;0
390;185743;4838;69;26;3;23;.885;3600000;0
391;171838;31;86;27;1;26;.963;3600000;0
391;175092;9;47;20;3;17;.850;3515000;0
391;190106;9;0;0;0;0;.00nan;0;0
391;149452;31;0;0;0;0;.00nan;0;0
392;193854;11;0;0;0;0;.00nan;0;0
392;194416;17;0;0;0;0;.00nan;0;0
392;178413;17;46;32;5;27;.844;3545000;0
392;146862;11;69;29;3;26;.897;3600000;0
393;788;27;84;27;1;26;.963;3600000;0
393;171304;27;0;0;0;0;.00nan;0;0
393;139409;3;88;43;3;40;.930;3528000;0
393;148958;3;0;0;0;0;.00nan;0;0
394;166646;0;33;10;3;7;.700;469000;0
394;183844;29;0;0;0;0;.00nan;0;0
394;189333;0;86;38;2;36;.947;3089000;0
394;195089;29;51;19;3;16;.842;3600000;0
395;187578;26;65;31;4;27;.871;3600000;0
395;3928;20;82;29;2;27;.931;2963000;0
395;205824;20;19;8;4;4;.500;609000;0
395;179154;26;0;0;0;0;.00nan;0;0
396;173699;10;78;41;3;38;.927;3564000;0
396;196005;22;68;18;1;17;.944;3600000;0
396;90164;10;0;0;0;0;.00nan;0;0
396;143473;22;0;0;0;0;.00nan;0;0
397;13714;8;100;45;2;43;.956;4200000;0
397;20432;28;0;0;0;0;.00nan;0;0
397;201174;28;95;46;2;44;.957;4200000;0
397;58830;8;0;0;0;0;.00nan;0;0
398;172340;4182;100;26;0;26;1.000;3600000;0
398;165723;32;0;0;0;0;.00nan;0;0
398;85727;32;64;38;4;34;.895;3600000;0
398;140314;4182;0;0;0;0;.00nan;0;0
399;166591;15;0;0;0;0;.00nan;0;0
399;174718;12;0;0;0;0;.00nan;0;0
399;187362;15;75;19;1;18;.947;3600000;0
399;85798;12;61;41;5;36;.878;3600000;0
400;192733;18;0;0;0;0;.00nan;0;0
400;3284;21;0;0;0;0;.00nan;0;0
400;173727;18;53;19;3;16;.842;3600000;0
400;182116;21;36;22;4;18;.818;3591000;0
401;556;33;81;61;6;55;.902;3600000;0
401;183783;25;0;0;0;0;.00nan;0;0
401;197038;33;0;0;0;0;.00nan;0;0
401;191813;25;39;12;3;9;.750;3600000;0
402;676;24;70;32;3;29;.906;3546000;0
402;183859;23;0;0;0;0;.00nan;0;0
402;59540;23;62;19;2;17;.895;3600000;0
402;86192;24;0;0;0;0;.00nan;0;0
403;187537;19;0;0;0;0;.00nan;0;0
403;187718;16;0;0;0;0;.00nan;0;0
403;178384;19;63;30;3;27;.900;3600000;0
403;50065;16;92;29;1;28;.966;3600000;0
404;173699;10;51;30;4;26;.867;2546000;0
404;184229;35;67;30;3;27;.900;3600000;0
404;90164;10;25;11;4;7;.636;1054000;0
404;147977;35;0;0;0;0;.00nan;0;0
405;170314;5;61;33;4;29;.879;4200000;0
405;175912;14;70;34;4;30;.882;4200000;0
405;201585;5;0;0;0;0;.00nan;0;0
405;185034;14;0;0;0;0;.00nan;0;0
406;187718;16;0;0;0;0;.00nan;0;0
406;196090;4838;0;0;0;0;.00nan;0;0
406;185743;4838;100;32;0;32;1.000;3600000;0
406;50065;16;70;41;5;36;.878;3600000;0
407;171838;31;0;0;0;0;.00nan;0;0
407;174718;12;0;0;0;0;.00nan;0;0
407;85798;12;99;52;1;51;.981;3600000;0
407;149452;31;52;31;5;26;.839;3600000;0
408;192733;18;56;21;2;19;.905;3564000;0
408;676;24;100;43;1;42;.977;3600000;0
408;173727;18;0;0;0;0;.00nan;0;0
408;86192;24;0;0;0;0;.00nan;0;0
409;187578;26;0;0;0;0;.00nan;0;0
409;179154;26;88;29;1;28;.966;3600000;0
409;206789;30;0;0;0;0;.00nan;0;0
409;86697;30;64;31;3;28;.903;3524000;0
410;175092;9;70;26;2;24;.923;3574000;0
410;190106;9;0;0;0;0;.00nan;0;0
410;139409;3;87;32;1;31;.969;3600000;0
410;148958;3;0;0;0;0;.00nan;0;0
411;194416;17;0;0;0;0;.00nan;0;0
411;183844;29;0;0;0;0;.00nan;0;0
411;178413;17;56;40;5;35;.875;4200000;0
411;195089;29;53;32;5;27;.844;4200000;0
412;166646;0;0;0;0;0;.00nan;0;0
412;13714;8;71;25;2;23;.920;3600000;0
412;189333;0;57;26;3;23;.885;3594000;0
412;58830;8;0;0;0;0;.00nan;0;0
413;3928;20;78;52;5;47;.904;3519000;0
413;163471;34;56;20;3;17;.850;3600000;0
413;183904;34;0;0;0;0;.00nan;0;0
413;205824;20;0;0;0;0;.00nan;0;0
414;788;27;0;0;0;0;.00nan;0;0
414;171304;27;43;33;5;28;.848;3600000;0
414;196005;22;0;0;0;0;.00nan;0;0
414;143473;22;56;26;3;23;.885;3600000;0
415;165723;32;0;0;0;0;.00nan;0;0
415;184229;35;0;0;0;0;.00nan;0;0
415;85727;32;93;38;2;36;.947;3600000;0
415;147977;35;48;23;3;20;.870;3543000;0
416;556;33;80;33;2;31;.939;3663000;0
416;166591;15;74;25;1;24;.960;3626000;0
416;187362;15;0;0;0;0;.00nan;0;0
416;197038;33;0;0;0;0;.00nan;0;0
417;183859;23;0;0;0;0;.00nan;0;0
417;20432;28;82;36;3;33;.917;3546000;0
417;201174;28;0;0;0;0;.00nan;0;0
417;59540;23;87;34;2;32;.941;3600000;0
418;187537;19;47;39;6;33;.846;3600000;0
418;3284;21;0;0;0;0;.00nan;0;0
418;178384;19;0;0;0;0;.00nan;0;0
418;182116;21;100;29;0;29;1.000;3600000;0
419;173699;10;65;32;4;28;.875;3600000;0
419;170314;5;90;29;1;28;.966;3600000;0
419;201585;5;0;0;0;0;.00nan;0;0
419;90164;10;0;0;0;0;.00nan;0;0
420;676;24;0;0;0;0;.00nan;0;0
420;196090;4838;0;0;0;0;.00nan;0;0
420;185743;4838;78;22;1;21;.955;3600000;0
420;86192;24;70;43;5;38;.884;3600000;0
421;3928;20;0;0;0;0;.00nan;0;0
421;165723;32;85;42;2;40;.952;4200000;0
421;205824;20;77;39;2;37;.949;4200000;0
421;85727;32;0;0;0;0;.00nan;0;0
422;13714;8;0;0;0;0;.00nan;0;0
422;58830;8;72;22;1;21;.955;3600000;0
422;139409;3;0;0;0;0;.00nan;0;0
422;148958;3;97;49;3;46;.939;3582000;0
423;788;27;35;26;5;21;.808;3600000;0
423;163471;34;0;0;0;0;.00nan;0;0
423;183904;34;82;24;1;23;.958;3600000;0
423;171304;27;0;0;0;0;.00nan;0;0
424;172340;4182;84;40;3;37;.925;3600000;0
424;183783;25;0;0;0;0;.00nan;0;0
424;191813;25;71;21;1;20;.952;3600000;0
424;140314;4182;0;0;0;0;.00nan;0;0
425;187718;16;0;0;0;0;.00nan;0;0
425;183859;23;96;26;0;26;1.000;3600000;0
425;50065;16;46;32;5;27;.844;3600000;0
425;59540;23;0;0;0;0;.00nan;0;0
426;193854;11;0;0;0;0;.00nan;0;0
426;206789;30;76;24;1;23;.958;3600000;0
426;86697;30;0;0;0;0;.00nan;0;0
426;146862;11;67;37;4;33;.892;3600000;0
427;174718;12;0;0;0;0;.00nan;0;0
427;175092;9;78;30;2;28;.933;3600000;0
427;190106;9;0;0;0;0;.00nan;0;0
427;85798;12;82;37;3;34;.919;3600000;0
428;166646;0;75;46;6;40;.870;3600000;0
428;189333;0;0;0;0;0;.00nan;0;0
428;196005;22;0;0;0;0;.00nan;0;0
428;143473;22;64;15;1;14;.933;3600000;0
429;187578;26;0;0;0;0;.00nan;0;0
429;194416;17;0;0;0;0;.00nan;0;0
429;178413;17;51;21;3;18;.857;3600000;0
429;179154;26;59;39;5;34;.872;3585000;0
430;192733;18;0;0;0;0;.00nan;0;0
430;556;33;100;49;2;47;.959;3950000;0
430;173727;18;54;23;3;20;.870;3950000;0
430;197038;33;0;0;0;0;.00nan;0;0
431;166646;0;43;10;2;8;.800;705000;0
431;163471;34;65;11;1;10;.909;3600000;0
431;183904;34;0;0;0;0;.00nan;0;0
431;189333;0;38;41;6;35;.854;2895000;0
432;3284;21;0;0;0;0;.00nan;0;0
432;183844;29;99;39;2;37;.949;3600000;0
432;195089;29;0;0;0;0;.00nan;0;0
432;182116;21;79;45;4;41;.911;3577000;0
433;174718;12;78;26;1;25;.962;3600000;0
433;175912;14;73;26;2;24;.923;3568000;0
433;185034;14;0;0;0;0;.00nan;0;0
433;85798;12;0;0;0;0;.00nan;0;0
434;166591;15;68;28;2;26;.929;3600000;0
434;13714;8;64;39;5;34;.872;3600000;0
434;187362;15;0;0;0;0;.00nan;0;0
434;58830;8;0;0;0;0;.00nan;0;0
435;194416;17;92;35;1;34;.971;3600000;0
435;178413;17;0;0;0;0;.00nan;0;0
435;184229;35;57;36;4;32;.889;3600000;0
435;147977;35;0;0;0;0;.00nan;0;0
436;165723;32;0;0;0;0;.00nan;0;0
436;196090;4838;0;0;0;0;.00nan;0;0
436;185743;4838;42;25;4;21;.840;3751000;0
436;85727;32;47;31;5;26;.839;3751000;0
437;183859;23;53;38;5;33;.868;3600000;0
437;170314;5;66;18;2;16;.889;3600000;0
437;201585;5;0;0;0;0;.00nan;0;0
437;59540;23;0;0;0;0;.00nan;0;0
438;187537;19;0;0;0;0;.00nan;0;0
438;178384;19;70;26;3;23;.885;3600000;0
438;20432;28;0;0;0;0;.00nan;0;0
438;201174;28;61;36;4;32;.889;3544000;0
439;192733;18;78;28;2;26;.929;3600000;0
439;173727;18;0;0;0;0;.00nan;0;0
439;206789;30;0;0;0;0;.00nan;0;0
439;86697;30;60;33;4;29;.879;3582000;0
440;193854;11;0;0;0;0;.00nan;0;0
440;183783;25;0;0;0;0;.00nan;0;0
440;191813;25;47;13;2;11;.846;3551000;0
440;146862;11;100;45;1;44;.978;3600000;0
441;175912;14;75;25;2;23;.920;3567000;0
441;185034;14;0;0;0;0;.00nan;0;0
441;139409;3;90;29;1;28;.966;3600000;0
441;148958;3;0;0;0;0;.00nan;0;0
442;676;24;75;33;3;30;.909;3600000;0
442;171838;31;77;43;4;39;.907;3600000;0
442;86192;24;0;0;0;0;.00nan;0;0
442;149452;31;0;0;0;0;.00nan;0;0
443;172340;4182;100;42;1;41;.976;3600000;0
443;196005;22;0;0;0;0;.00nan;0;0
443;140314;4182;0;0;0;0;.00nan;0;0
443;143473;22;62;26;2;24;.923;3543000;0
444;556;33;100;40;1;39;.975;3600000;0
444;175092;9;0;0;0;0;.00nan;0;0
444;190106;9;77;32;2;30;.938;3600000;0
444;197038;33;0;0;0;0;.00nan;0;0
445;788;27;0;0;0;0;.00nan;0;0
445;183783;25;0;0;0;0;.00nan;0;0
445;171304;27;91;47;2;45;.957;3554000;0
445;191813;25;85;14;0;14;1.000;3600000;0
446;3284;21;0;0;0;0;.00nan;0;0
446;194416;17;0;0;0;0;.00nan;0;0
446;178413;17;52;26;4;22;.846;3574000;0
446;182116;21;100;41;2;39;.951;3600000;0
447;166591;15;66;23;3;20;.870;4200000;0
447;3928;20;94;53;3;50;.943;4200000;0
447;205824;20;0;0;0;0;.00nan;0;0
447;187362;15;0;0;0;0;.00nan;0;0
448;166646;0;93;49;4;45;.918;3600000;0
448;189333;0;0;0;0;0;.00nan;0;0
448;173699;10;0;0;0;0;.00nan;0;0
448;90164;10;44;31;5;26;.839;3546000;0
449;192733;18;0;0;0;0;.00nan;0;0
449;187718;16;0;0;0;0;.00nan;0;0
449;173727;18;71;22;2;20;.909;3600000;0
449;50065;16;58;34;4;30;.882;3550000;0
450;183844;29;0;0;0;0;.00nan;0;0
450;184229;35;83;30;1;29;.967;3600000;0
450;195089;29;42;26;4;22;.846;3600000;0
450;147977;35;0;0;0;0;.00nan;0;0
451;20432;28;72;32;3;29;.906;3988000;0
451;201174;28;0;0;0;0;.00nan;0;0
451;196090;4838;0;0;0;0;.00nan;0;0
451;185743;4838;76;39;4;35;.897;3988000;0
452;165723;32;35;50;9;41;.820;3138000;0
452;183859;23;0;0;0;0;.00nan;0;0
452;59540;23;95;19;0;19;1.000;3600000;0
452;85727;32;52;4;0;4;1.000;462000;0
453;187537;19;0;0;0;0;.00nan;0;0
453;178384;19;87;27;2;25;.926;3600000;0
453;170314;5;65;36;4;32;.889;3535000;0
453;201585;5;0;0;0;0;.00nan;0;0
454;3284;21;0;0;0;0;.00nan;0;0
454;13714;8;76;32;2;30;.938;4200000;0
454;182116;21;74;24;2;22;.917;4200000;0
454;58830;8;0;0;0;0;.00nan;0;0
455;172340;4182;36;31;6;25;.806;3600000;0
455;163471;34;82;32;2;30;.938;3600000;0
455;183904;34;0;0;0;0;.00nan;0;0
455;140314;4182;0;0;0;0;.00nan;0;0
456;171838;31;0;0;0;0;.00nan;0;0
456;196005;22;0;0;0;0;.00nan;0;0
456;143473;22;44;18;3;15;.833;3600000;0
456;149452;31;87;48;4;44;.917;3600000;0
457;187578;26;0;0;0;0;.00nan;0;0
457;183844;29;51;21;3;18;.857;3600000;0
457;195089;29;0;0;0;0;.00nan;0;0
457;179154;26;65;40;5;35;.875;3582000;0
458;193854;11;0;0;0;0;.00nan;0;0
458;174718;12;0;0;0;0;.00nan;0;0
458;85798;12;99;47;2;45;.957;3600000;0
458;146862;11;59;25;3;22;.880;3564000;0
459;175092;9;0;0;0;0;.00nan;0;0
459;190106;9;76;29;2;27;.931;3583000;0
459;206789;30;0;0;0;0;.00nan;0;0
459;86697;30;100;24;0;24;1.000;3600000;0
460;187537;19;0;0;0;0;.00nan;0;0
460;187718;16;0;0;0;0;.00nan;0;0
460;178384;19;60;22;2;20;.909;3600000;0
460;50065;16;68;46;6;40;.870;3600000;0
461;171838;31;81;46;4;42;.913;3574000;0
461;163471;34;0;0;0;0;.00nan;0;0
461;183904;34;75;31;2;29;.935;3600000;0
461;149452;31;0;0;0;0;.00nan;0;0
462;676;24;95;38;3;35;.921;3546000;0
462;173699;10;73;28;2;26;.929;3600000;0
462;86192;24;0;0;0;0;.00nan;0;0
462;90164;10;0;0;0;0;.00nan;0;0
463;196005;22;50;25;4;21;.840;3585000;0
463;139409;3;99;36;2;34;.944;3600000;0
463;143473;22;0;0;0;0;.00nan;0;0
463;148958;3;0;0;0;0;.00nan;0;0
464;166591;15;60;18;2;16;.889;3817000;0
464;194416;17;0;0;0;0;.00nan;0;0
464;178413;17;80;38;3;35;.921;3817000;0
464;187362;15;0;0;0;0;.00nan;0;0
465;166646;0;59;30;4;26;.867;4155000;0
465;189333;0;0;0;0;0;.00nan;0;0
465;175912;14;59;34;4;30;.882;4200000;0
465;185034;14;0;0;0;0;.00nan;0;0
466;556;33;28;29;6;23;.793;2379000;0
466;183783;25;74;25;2;23;.920;3600000;0
466;197038;33;58;25;3;22;.880;1221000;0
466;191813;25;0;0;0;0;.00nan;0;0
467;3928;20;91;48;3;45;.938;3600000;0
467;13714;8;0;0;0;0;.00nan;0;0
467;205824;20;0;0;0;0;.00nan;0;0
467;58830;8;84;18;0;18;1.000;3600000;0
468;187578;26;83;34;2;32;.941;3561000;0
468;184229;35;100;25;0;25;1.000;3600000;0
468;179154;26;0;0;0;0;.00nan;0;0
468;147977;35;0;0;0;0;.00nan;0;0
469;174718;12;66;26;2;24;.923;3600000;0
469;175092;9;99;48;1;47;.979;3600000;0
469;190106;9;0;0;0;0;.00nan;0;0
469;85798;12;0;0;0;0;.00nan;0;0
470;192733;18;0;0;0;0;.00nan;0;0
470;20432;28;87;41;3;38;.927;3596000;0
470;173727;18;50;14;2;12;.857;3600000;0
470;201174;28;0;0;0;0;.00nan;0;0
471;170314;5;66;23;2;21;.913;3571000;0
471;201585;5;0;0;0;0;.00nan;0;0
471;196090;4838;0;0;0;0;.00nan;0;0
471;185743;4838;91;33;1;32;.970;3600000;0
472;788;27;52;37;5;32;.865;3526000;0
472;183859;23;0;0;0;0;.00nan;0;0
472;171304;27;0;0;0;0;.00nan;0;0
472;59540;23;64;28;3;25;.893;3600000;0
473;187537;19;70;36;4;32;.889;3600000;0
473;165723;32;49;32;5;27;.844;3600000;0
473;178384;19;0;0;0;0;.00nan;0;0
473;85727;32;0;0;0;0;.00nan;0;0
474;3284;21;0;0;0;0;.00nan;0;0
474;3928;20;0;0;0;0;.00nan;0;0
474;205824;20;88;49;3;46;.939;3600000;0
474;182116;21;73;24;1;23;.958;3600000;0
475;676;24;0;0;0;0;.00nan;0;0
475;172340;4182;79;27;3;24;.889;4087000;0
475;86192;24;67;40;4;36;.900;4087000;0
475;140314;4182;0;0;0;0;.00nan;0;0
476;556;33;61;37;4;33;.892;3525000;0
476;193854;11;0;0;0;0;.00nan;0;0
476;197038;33;0;0;0;0;.00nan;0;0
476;146862;11;71;28;2;26;.929;3600000;0
477;183844;29;59;22;3;19;.864;3600000;0
477;195089;29;0;0;0;0;.00nan;0;0
477;206789;30;0;0;0;0;.00nan;0;0
477;86697;30;50;24;4;20;.833;3553000;0
478;172340;4182;65;26;3;23;.885;2477000;0
478;194416;17;0;0;0;0;.00nan;0;0
478;178413;17;90;30;1;29;.967;3600000;0
478;140314;4182;34;28;5;23;.821;1123000;0
479;187718;16;0;0;0;0;.00nan;0;0
479;175912;14;100;47;1;46;.979;4200000;0
479;185034;14;0;0;0;0;.00nan;0;0
479;50065;16;71;25;1;24;.960;4200000;0
480;183783;25;0;0;0;0;.00nan;0;0
480;191813;25;33;18;4;14;.778;3600000;0
480;139409;3;58;50;6;44;.880;2773000;0
480;148958;3;42;10;2;8;.800;827000;0
481;187578;26;0;0;0;0;.00nan;0;0
481;183859;23;0;0;0;0;.00nan;0;0
481;179154;26;78;24;1;23;.958;3600000;0
481;59540;23;81;32;2;30;.938;3541000;0
482;192733;18;0;0;0;0;.00nan;0;0
482;173727;18;59;31;4;27;.871;3600000;0
482;170314;5;100;38;0;38;1.000;3600000;0
482;201585;5;0;0;0;0;.00nan;0;0
483;171838;31;0;0;0;0;.00nan;0;0
483;187718;16;93;27;1;26;.963;3600000;0
483;50065;16;0;0;0;0;.00nan;0;0
483;149452;31;72;29;2;27;.931;3553000;0
484;173699;10;0;0;0;0;.00nan;0;0
484;175092;9;0;0;0;0;.00nan;0;0
484;190106;9;42;24;4;20;.833;3600000;0
484;90164;10;100;29;0;29;1.000;3600000;0
485;3284;21;0;0;0;0;.00nan;0;0
485;206789;30;0;0;0;0;.00nan;0;0
485;182116;21;55;25;4;21;.840;3600000;0
485;86697;30;96;35;1;34;.971;3600000;0
486;676;24;85;47;4;43;.915;3600000;0
486;166591;15;74;20;1;19;.950;3600000;0
486;187362;15;0;0;0;0;.00nan;0;0
486;86192;24;0;0;0;0;.00nan;0;0
487;20432;28;0;0;0;0;.00nan;0;0
487;184229;35;68;21;1;20;.952;3600000;0
487;201174;28;81;34;2;32;.941;3559000;0
487;147977;35;0;0;0;0;.00nan;0;0
488;166646;0;44;22;4;18;.818;951000;0
488;163471;34;60;19;3;16;.842;3600000;0
488;183904;34;0;0;0;0;.00nan;0;0
488;189333;0;26;28;6;22;.786;2649000;0
489;196005;22;0;0;0;0;.00nan;0;0
489;196090;4838;53;12;1;11;.917;874000;0
489;185743;4838;52;44;6;38;.864;2726000;0
489;143473;22;93;41;2;39;.951;3600000;0
490;187537;19;0;0;0;0;.00nan;0;0
490;13714;8;0;0;0;0;.00nan;0;0
490;178384;19;50;30;4;26;.867;3775000;0
490;58830;8;64;27;3;24;.889;3775000;0
491;556;33;86;28;2;26;.929;3600000;0
491;165723;32;0;0;0;0;.00nan;0;0
491;197038;33;0;0;0;0;.00nan;0;0
491;85727;32;51;22;3;19;.864;3557000;0
492;183844;29;0;0;0;0;.00nan;0;0
492;195089;29;100;24;0;24;1.000;3600000;0
492;174718;12;0;0;0;0;.00nan;0;0
492;85798;12;71;45;4;41;.911;3600000;0
493;788;27;47;32;5;27;.844;3568000;0
493;193854;11;68;41;4;37;.902;3600000;0
493;171304;27;0;0;0;0;.00nan;0;0
493;146862;11;0;0;0;0;.00nan;0;0
494;183783;25;0;0;0;0;.00nan;0;0
494;194416;17;0;0;0;0;.00nan;0;0
494;178413;17;93;53;3;50;.943;4200000;0
494;191813;25;51;21;3;18;.857;4200000;0
495;3928;20;64;48;6;42;.875;3574000;0
495;205824;20;0;0;0;0;.00nan;0;0
495;196005;22;44;30;5;25;.833;3600000;0
495;143473;22;0;0;0;0;.00nan;0;0
496;788;27;0;0;0;0;.00nan;0;0
496;183859;23;0;0;0;0;.00nan;0;0
496;171304;27;54;35;5;30;.857;3600000;0
496;59540;23;92;24;1;23;.958;3600000;0
497;166646;0;54;29;4;25;.862;3600000;0
497;189333;0;0;0;0;0;.00nan;0;0
497;175092;9;94;22;0;22;1.000;3600000;0
497;190106;9;0;0;0;0;.00nan;0;0
498;3928;20;0;0;0;0;.00nan;0;0
498;173699;10;0;0;0;0;.00nan;0;0
498;205824;20;65;38;3;35;.921;3549000;0
498;90164;10;86;32;2;30;.938;3600000;0
499;184229;35;87;25;1;24;.960;3600000;0
499;170314;5;49;26;4;22;.846;3600000;0
499;201585;5;0;0;0;0;.00nan;0;0
499;147977;35;0;0;0;0;.00nan;0;0
500;676;24;55;43;5;38;.884;3537000;0
500;196090;4838;0;0;0;0;.00nan;0;0
500;185743;4838;68;27;3;24;.889;3600000;0
500;86192;24;0;0;0;0;.00nan;0;0
501;166591;15;0;0;0;0;.00nan;0;0
501;13714;8;68;32;4;28;.875;3562000;0
501;187362;15;74;31;2;29;.935;3600000;0
501;58830;8;0;0;0;0;.00nan;0;0
502;3284;21;0;0;0;0;.00nan;0;0
502;175912;14;70;30;3;27;.900;3600000;0
502;185034;14;0;0;0;0;.00nan;0;0
502;182116;21;51;25;4;21;.840;3583000;0
503;20432;28;57;31;4;27;.871;3523000;0
503;201174;28;0;0;0;0;.00nan;0;0
503;206789;30;0;0;0;0;.00nan;0;0
503;86697;30;85;34;2;32;.941;3600000;0
504;187537;19;0;0;0;0;.00nan;0;0
504;187578;26;0;0;0;0;.00nan;0;0
504;178384;19;98;50;2;48;.960;3600000;0
504;179154;26;100;26;0;26;1.000;3600000;0
505;187718;16;0;0;0;0;.00nan;0;0
505;50065;16;74;33;3;30;.909;4200000;0
505;139409;3;75;38;3;35;.921;4200000;0
505;148958;3;0;0;0;0;.00nan;0;0
506;556;33;99;58;2;56;.966;3600000;0
506;183844;29;0;0;0;0;.00nan;0;0
506;195089;29;48;17;3;14;.824;3551000;0
506;197038;33;0;0;0;0;.00nan;0;0
507;192733;18;0;0;0;0;.00nan;0;0
507;172340;4182;68;47;6;41;.872;3600000;0
507;173727;18;75;23;1;22;.957;3600000;0
507;140314;4182;0;0;0;0;.00nan;0;0
508;193854;11;0;0;0;0;.00nan;0;0
508;174718;12;0;0;0;0;.00nan;0;0
508;85798;12;77;39;3;36;.923;3600000;0
508;146862;11;38;20;5;15;.750;3600000;0
509;166591;15;58;31;4;27;.871;4200000;0
509;194416;17;0;0;0;0;.00nan;0;0
509;178413;17;65;41;4;37;.902;4200000;0
509;187362;15;0;0;0;0;.00nan;0;0
510;163471;34;59;13;1;12;.923;3600000;0
510;183904;34;0;0;0;0;.00nan;0;0
510;196090;4838;77;39;3;36;.923;3600000;0
510;185743;4838;0;0;0;0;.00nan;0;0
511;171838;31;0;0;0;0;.00nan;0;0
511;183783;25;0;0;0;0;.00nan;0;0
511;191813;25;32;10;3;7;.700;3600000;0
511;149452;31;89;57;5;52;.912;3549000;0
512;165723;32;70;25;2;23;.920;3600000;0
512;85727;32;0;0;0;0;.00nan;0;0
512;139409;3;0;0;0;0;.00nan;0;0
512;148958;3;57;21;3;18;.857;3582000;0
513;170314;5;0;0;0;0;.00nan;0;0
513;201585;5;92;29;1;28;.966;3600000;0
513;206789;30;0;0;0;0;.00nan;0;0
513;86697;30;60;23;3;20;.870;3517000;0
514;187578;26;0;0;0;0;.00nan;0;0
514;13714;8;100;25;0;25;1.000;3600000;0
514;179154;26;62;29;3;26;.897;3600000;0
514;58830;8;0;0;0;0;.00nan;0;0
515;3284;21;0;0;0;0;.00nan;0;0
515;196005;22;0;0;0;0;.00nan;0;0
515;182116;21;95;37;2;35;.946;3600000;0
515;143473;22;45;25;4;21;.840;3533000;0
516;166646;0;91;39;2;37;.949;3600000;0
516;189333;0;0;0;0;0;.00nan;0;0
516;173699;10;0;0;0;0;.00nan;0;0
516;90164;10;61;28;4;24;.857;3593000;0
517;171838;31;12;18;6;12;.667;2741000;0
517;187718;16;0;0;0;0;.00nan;0;0
517;50065;16;38;27;5;22;.815;3600000;0
517;149452;31;56;7;0;7;1.000;825000;0
518;676;24;91;36;2;34;.944;3600000;0
518;194416;17;53;26;3;23;.885;3600000;0
518;178413;17;0;0;0;0;.00nan;0;0
518;86192;24;0;0;0;0;.00nan;0;0
519;183844;29;69;27;2;25;.926;3600000;0
519;195089;29;0;0;0;0;.00nan;0;0
519;175912;14;51;31;4;27;.871;3600000;0
519;185034;14;0;0;0;0;.00nan;0;0
520;3928;20;0;0;0;0;.00nan;0;0
520;20432;28;0;0;0;0;.00nan;0;0
520;205824;20;96;43;2;41;.953;3600000;0
520;201174;28;72;39;3;36;.923;3565000;0
521;163471;34;0;0;0;0;.00nan;0;0
521;183904;34;65;21;2;19;.905;3600000;0
521;175092;9;62;32;3;29;.906;3554000;0
521;190106;9;0;0;0;0;.00nan;0;0
522;172340;4182;70;26;3;23;.885;3513000;0
522;183859;23;0;0;0;0;.00nan;0;0
522;59540;23;82;23;1;22;.957;3600000;0
522;140314;4182;0;0;0;0;.00nan;0;0
523;165723;32;0;0;0;0;.00nan;0;0
523;184229;35;89;28;1;27;.964;3600000;0
523;85727;32;68;34;3;31;.912;3515000;0
523;147977;35;0;0;0;0;.00nan;0;0
524;556;33;98;40;1;39;.975;3600000;0
524;174718;12;0;0;0;0;.00nan;0;0
524;197038;33;0;0;0;0;.00nan;0;0
524;85798;12;68;25;2;23;.920;3554000;0
525;192733;18;0;0;0;0;.00nan;0;0
525;788;27;52;9;1;8;.889;1257000;0
525;173727;18;43;23;5;18;.783;3600000;0
525;171304;27;36;37;6;31;.838;2343000;0
526;187537;19;0;0;0;0;.00nan;0;0
526;193854;11;0;0;0;0;.00nan;0;0
526;178384;19;86;35;3;32;.914;3600000;0
526;146862;11;53;28;4;24;.857;3600000;0
527;676;24;57;29;3;26;.897;3556000;0
527;173699;10;100;39;1;38;.974;3600000;0
527;86192;24;0;0;0;0;.00nan;0;0
527;90164;10;0;0;0;0;.00nan;0;0
528;3928;20;0;0;0;0;.00nan;0;0
528;163471;34;66;14;1;13;.929;3600000;0
528;183904;34;0;0;0;0;.00nan;0;0
528;205824;20;80;40;3;37;.925;3600000;0
529;20432;28;72;33;3;30;.909;3600000;0
529;170314;5;60;35;4;31;.886;3547000;0
529;201174;28;0;0;0;0;.00nan;0;0
529;201585;5;0;0;0;0;.00nan;0;0
530;166646;0;53;2;0;2;1.000;548000;0
530;183844;29;0;0;0;0;.00nan;0;0
530;189333;0;37;39;6;33;.846;3052000;0
530;195089;29;73;22;1;21;.955;3600000;0
531;171838;31;0;0;0;0;.00nan;0;0
531;175092;9;0;0;0;0;.00nan;0;0
531;190106;9;54;27;5;22;.815;3551000;0
531;149452;31;61;28;3;25;.893;3600000;0
532;175912;14;72;46;5;41;.891;3600000;0
532;196005;22;0;0;0;0;.00nan;0;0
532;185034;14;0;0;0;0;.00nan;0;0
532;143473;22;74;19;1;18;.947;3600000;0
533;187718;16;0;0;0;0;.00nan;0;0
533;194416;17;0;0;0;0;.00nan;0;0
533;178413;17;84;27;1;26;.963;3600000;0
533;50065;16;67;21;2;19;.905;3593000;0
534;3284;21;0;0;0;0;.00nan;0;0
534;13714;8;68;28;3;25;.893;3600000;0
534;182116;21;73;23;1;22;.957;3600000;0
534;58830;8;0;0;0;0;.00nan;0;0
535;187578;26;0;0;0;0;.00nan;0;0
535;184229;35;46;32;5;27;.844;3575000;0
535;179154;26;63;29;3;26;.897;3600000;0
535;147977;35;0;0;0;0;.00nan;0;0
536;556;33;58;18;2;16;.889;3541000;0
536;174718;12;0;0;0;0;.00nan;0;0
536;197038;33;0;0;0;0;.00nan;0;0
536;85798;12;90;28;1;27;.964;3600000;0
537;165723;32;48;0;0;0;.00nan;444000;0
537;183783;25;0;0;0;0;.00nan;0;0
537;191813;25;83;25;1;24;.960;3600000;0
537;85727;32;68;48;6;42;.875;3156000;0
538;192733;18;0;0;0;0;.00nan;0;0
538;183859;23;0;0;0;0;.00nan;0;0
538;173727;18;69;18;2;16;.889;3600000;0
538;59540;23;87;55;5;50;.909;3600000;0
539;172340;4182;58;26;3;23;.885;3600000;0
539;206789;30;0;0;0;0;.00nan;0;0
539;86697;30;96;45;1;44;.978;3600000;0
539;140314;4182;0;0;0;0;.00nan;0;0
540;788;27;59;42;5;37;.881;3600000;0
540;193854;11;0;0;0;0;.00nan;0;0
540;171304;27;0;0;0;0;.00nan;0;0
540;146862;11;67;17;1;16;.941;3600000;0
541;3284;21;0;0;0;0;.00nan;0;0
541;182116;21;63;30;3;27;.900;3551000;0
541;139409;3;69;24;2;22;.917;3600000;0
541;148958;3;0;0;0;0;.00nan;0;0
542;166591;15;82;26;1;25;.962;3600000;0
542;187537;19;0;0;0;0;.00nan;0;0
542;178384;19;61;40;5;35;.875;3600000;0
542;187362;15;0;0;0;0;.00nan;0;0
543;788;27;0;0;0;0;.00nan;0;0
543;171304;27;39;34;5;29;.853;3600000;0
543;206789;30;0;0;0;0;.00nan;0;0
543;86697;30;99;42;2;40;.952;3600000;0
544;193854;11;71;24;2;22;.917;3600000;0
544;196090;4838;40;8;2;6;.750;1294000;0
544;185743;4838;13;13;5;8;.615;2306000;0
544;146862;11;0;0;0;0;.00nan;0;0
545;166646;0;29;14;4;10;.714;762000;0
545;189333;0;61;17;1;16;.941;2809000;0
545;173699;10;0;0;0;0;.00nan;0;0
545;90164;10;53;24;4;20;.833;3600000;0
546;13714;8;42;37;6;31;.838;3600000;0
546;194416;17;0;0;0;0;.00nan;0;0
546;178413;17;83;27;1;26;.963;3600000;0
546;58830;8;0;0;0;0;.00nan;0;0
547;163471;34;82;26;2;24;.923;3600000;0
547;183904;34;0;0;0;0;.00nan;0;0
547;170314;5;60;31;4;27;.871;3544000;0
547;201585;5;0;0;0;0;.00nan;0;0
548;676;24;73;36;3;33;.917;3600000;0
548;183844;29;0;0;0;0;.00nan;0;0
548;195089;29;44;28;4;24;.857;3574000;0
548;86192;24;0;0;0;0;.00nan;0;0
549;3928;20;31;15;4;11;.733;846000;0
549;205824;20;70;45;4;41;.911;2754000;0
549;196005;22;0;0;0;0;.00nan;0;0
549;143473;22;70;20;1;19;.950;3600000;0
550;187578;26;0;0;0;0;.00nan;0;0
550;165723;32;69;12;0;12;1.000;1257000;0
550;179154;26;57;20;2;18;.900;3600000;0
550;85727;32;29;20;5;15;.750;2343000;0
551;556;33;70;46;5;41;.891;3545000;0
551;184229;35;66;32;3;29;.906;3600000;0
551;197038;33;0;0;0;0;.00nan;0;0
551;147977;35;0;0;0;0;.00nan;0;0
552;172340;4182;47;29;5;24;.828;3731000;0
552;174718;12;0;0;0;0;.00nan;0;0
552;85798;12;51;39;6;33;.846;3725000;0
552;140314;4182;0;0;0;0;.00nan;0;0
553;166591;15;0;0;0;0;.00nan;0;0
553;183859;23;0;0;0;0;.00nan;0;0
553;187362;15;72;31;4;27;.871;3858000;0
553;59540;23;62;27;3;24;.889;3858000;0
554;187718;16;54;31;4;27;.871;2547000;0
554;183783;25;0;0;0;0;.00nan;0;0
554;191813;25;51;23;4;19;.826;3600000;0
554;50065;16;35;16;4;12;.750;1053000;0
555;173699;10;100;39;1;38;.974;3600000;0
555;175092;9;61;24;3;21;.875;3546000;0
555;190106;9;0;0;0;0;.00nan;0;0
555;90164;10;0;0;0;0;.00nan;0;0
556;676;24;0;0;0;0;.00nan;0;0
556;171838;31;0;0;0;0;.00nan;0;0
556;86192;24;59;26;3;23;.885;3600000;0
556;149452;31;70;38;4;34;.895;3600000;0
557;170314;5;0;0;0;0;.00nan;0;0
557;201585;5;91;21;0;21;1.000;3600000;0
557;139409;3;93;36;1;35;.972;3569000;0
557;148958;3;0;0;0;0;.00nan;0;0
558;184229;35;0;0;0;0;.00nan;0;0
558;175912;14;68;23;2;21;.913;3600000;0
558;185034;14;0;0;0;0;.00nan;0;0
558;147977;35;55;38;6;32;.842;3600000;0
559;163471;34;0;0;0;0;.00nan;0;0
559;183904;34;76;26;2;24;.923;3600000;0
559;20432;28;0;0;0;0;.00nan;0;0
559;201174;28;57;37;4;33;.892;3575000;0
560;166646;0;78;42;3;39;.929;3600000;0
560;3284;21;0;0;0;0;.00nan;0;0
560;189333;0;0;0;0;0;.00nan;0;0
560;182116;21;64;23;2;21;.913;3600000;0
561;3928;20;81;27;2;25;.926;3556000;0
561;13714;8;91;31;1;30;.968;3600000;0
561;205824;20;0;0;0;0;.00nan;0;0
561;58830;8;0;0;0;0;.00nan;0;0
562;788;27;77;26;1;25;.962;3600000;0
562;171304;27;0;0;0;0;.00nan;0;0
562;196090;4838;0;0;0;0;.00nan;0;0
562;185743;4838;49;28;4;24;.857;3600000;0
563;187718;16;0;0;0;0;.00nan;0;0
563;183783;25;0;0;0;0;.00nan;0;0
563;191813;25;100;28;0;28;1.000;3600000;0
563;50065;16;91;36;2;34;.944;3581000;0
564;171838;31;89;37;2;35;.946;3592000;0
564;194416;17;0;0;0;0;.00nan;0;0
564;178413;17;77;22;1;21;.955;3600000;0
564;149452;31;0;0;0;0;.00nan;0;0
565;183844;29;0;0;0;0;.00nan;0;0
565;195089;29;50;25;3;22;.880;3568000;0
565;175092;9;0;0;0;0;.00nan;0;0
565;190106;9;85;33;2;31;.939;3600000;0
566;175912;14;93;46;3;43;.935;3538000;0
566;196005;22;0;0;0;0;.00nan;0;0
566;185034;14;0;0;0;0;.00nan;0;0
566;143473;22;78;22;1;21;.955;3600000;0
567;20432;28;85;27;2;25;.926;3600000;0
567;201174;28;0;0;0;0;.00nan;0;0
567;139409;3;20;9;4;5;.556;1131000;0
567;148958;3;73;29;2;27;.931;2469000;0
568;172340;4182;59;29;4;25;.862;3600000;0
568;196090;4838;47;37;5;32;.865;3600000;0
568;185743;4838;0;0;0;0;.00nan;0;0
568;140314;4182;0;0;0;0;.00nan;0;0
569;192733;18;0;0;0;0;.00nan;0;0
569;166591;15;94;44;2;42;.955;3837000;0
569;173727;18;64;27;3;24;.889;3837000;0
569;187362;15;0;0;0;0;.00nan;0;0
570;556;33;0;0;0;0;.00nan;0;0
570;193854;11;0;0;0;0;.00nan;0;0
570;197038;33;79;49;4;45;.918;3555000;0
570;146862;11;68;21;2;19;.905;3600000;0
571;187578;26;0;0;0;0;.00nan;0;0
571;165723;32;0;0;0;0;.00nan;0;0
571;179154;26;36;23;5;18;.783;3600000;0
571;85727;32;76;26;1;25;.962;3600000;0
572;183859;23;0;0;0;0;.00nan;0;0
572;206789;30;0;0;0;0;.00nan;0;0
572;59540;23;54;24;3;21;.875;3569000;0
572;86697;30;48;14;2;12;.857;3600000;0
573;171838;31;35;10;3;7;.700;1230000;0
573;173699;10;0;0;0;0;.00nan;0;0
573;90164;10;69;20;1;19;.950;3600000;0
573;149452;31;17;29;8;21;.724;2370000;0
574;3284;21;0;0;0;0;.00nan;0;0
574;163471;34;69;38;4;34;.895;3600000;0
574;183904;34;0;0;0;0;.00nan;0;0
574;182116;21;65;46;5;41;.891;3548000;0
575;3928;20;0;0;0;0;.00nan;0;0
575;205824;20;70;37;3;34;.919;3600000;0
575;175912;14;26;23;5;18;.783;3580000;0
575;185034;14;0;0;0;0;.00nan;0;0
576;187578;26;49;26;4;22;.846;4200000;0
576;179154;26;0;0;0;0;.00nan;0;0
576;139409;3;70;43;4;39;.907;4169000;0
576;148958;3;0;0;0;0;.00nan;0;0
577;192733;18;0;0;0;0;.00nan;0;0
577;187718;16;0;0;0;0;.00nan;0;0
577;173727;18;57;29;4;25;.862;3600000;0
577;50065;16;41;40;7;33;.825;3600000;0
578;13714;8;83;32;2;30;.938;3600000;0
578;165723;32;62;30;4;26;.867;3513000;0
578;58830;8;0;0;0;0;.00nan;0;0
578;85727;32;0;0;0;0;.00nan;0;0
579;183783;25;0;0;0;0;.00nan;0;0
579;20432;28;71;54;6;48;.889;3600000;0
579;201174;28;0;0;0;0;.00nan;0;0
579;191813;25;96;16;0;16;1.000;3600000;0
580;170314;5;0;0;0;0;.00nan;0;0
580;174718;12;0;0;0;0;.00nan;0;0
580;201585;5;78;28;2;26;.929;3600000;0
580;85798;12;71;40;4;36;.900;3521000;0
581;556;33;77;48;4;44;.917;3600000;0
581;196005;22;0;0;0;0;.00nan;0;0
581;197038;33;0;0;0;0;.00nan;0;0
581;143473;22;79;20;1;19;.950;3600000;0
582;166591;15;99;23;0;23;1.000;3600000;0
582;196090;4838;0;0;0;0;.00nan;0;0
582;185743;4838;49;22;3;19;.864;3600000;0
582;187362;15;0;0;0;0;.00nan;0;0
583;187537;19;0;0;0;0;.00nan;0;0
583;178384;19;99;45;2;43;.956;4200000;0
583;183844;29;0;0;0;0;.00nan;0;0
583;195089;29;73;26;2;24;.923;4200000;0
584;788;27;0;0;0;0;.00nan;0;0
584;166646;0;65;42;5;37;.881;3600000;0
584;189333;0;0;0;0;0;.00nan;0;0
584;171304;27;57;21;2;19;.905;3600000;0
585;193854;11;0;0;0;0;.00nan;0;0
585;194416;17;0;0;0;0;.00nan;0;0
585;178413;17;79;23;1;22;.957;3600000;0
585;146862;11;76;36;3;33;.917;3547000;0
586;676;24;78;34;2;32;.941;3600000;0
586;3928;20;80;38;3;35;.921;3551000;0
586;205824;20;0;0;0;0;.00nan;0;0
586;86192;24;0;0;0;0;.00nan;0;0
587;166646;0;95;31;1;30;.968;3548000;0
587;172340;4182;98;22;0;22;1.000;3600000;0
587;189333;0;0;0;0;0;.00nan;0;0
587;140314;4182;0;0;0;0;.00nan;0;0
588;171838;31;0;0;0;0;.00nan;0;0
588;175912;14;70;22;2;20;.909;3600000;0
588;185034;14;0;0;0;0;.00nan;0;0
588;149452;31;77;41;3;38;.927;3595000;0
589;175092;9;0;0;0;0;.00nan;0;0
589;190106;9;60;28;4;24;.857;3536000;0
589;139409;3;91;39;2;37;.949;3600000;0
589;148958;3;0;0;0;0;.00nan;0;0
590;163471;34;76;20;1;19;.950;3600000;0
590;165723;32;74;31;2;29;.935;3600000;0
590;183904;34;0;0;0;0;.00nan;0;0
590;85727;32;0;0;0;0;.00nan;0;0
591;166591;15;84;13;0;13;1.000;3600000;0
591;173699;10;84;68;6;62;.912;3600000;0
591;187362;15;0;0;0;0;.00nan;0;0
591;90164;10;0;0;0;0;.00nan;0;0
592;556;33;28;8;3;5;.625;596000;0
592;187578;26;0;0;0;0;.00nan;0;0
592;179154;26;60;24;2;22;.917;3600000;0
592;197038;33;41;32;5;27;.844;3004000;0
593;187718;16;26;25;5;20;.800;3600000;0
593;20432;28;100;46;1;45;.978;3600000;0
593;201174;28;0;0;0;0;.00nan;0;0
593;50065;16;0;0;0;0;.00nan;0;0
594;192733;18;0;0;0;0;.00nan;0;0
594;13714;8;57;41;5;36;.878;3600000;0
594;173727;18;98;34;1;33;.971;3600000;0
594;58830;8;0;0;0;0;.00nan;0;0
595;187537;19;0;0;0;0;.00nan;0;0
595;178384;19;92;34;2;32;.941;3600000;0
595;184229;35;79;24;1;23;.958;3600000;0
595;147977;35;0;0;0;0;.00nan;0;0
596;174718;12;0;0;0;0;.00nan;0;0
596;196005;22;0;0;0;0;.00nan;0;0
596;85798;12;64;48;5;43;.896;3600000;0
596;143473;22;62;17;2;15;.882;3600000;0
597;183844;29;0;0;0;0;.00nan;0;0
597;183859;23;0;0;0;0;.00nan;0;0
597;195089;29;78;32;3;29;.906;3600000;0
597;59540;23;100;30;0;30;1.000;3600000;0
598;170314;5;72;30;2;28;.933;3600000;0
598;201585;5;0;0;0;0;.00nan;0;0
598;206789;30;0;0;0;0;.00nan;0;0
598;86697;30;71;22;1;21;.955;3600000;0
599;788;27;73;23;1;22;.957;3600000;0
599;194416;17;0;0;0;0;.00nan;0;0
599;178413;17;72;27;3;24;.889;3575000;0
599;171304;27;0;0;0;0;.00nan;0;0
600;193854;11;80;48;3;45;.938;3559000;0
600;183783;25;0;0;0;0;.00nan;0;0
600;191813;25;70;29;2;27;.931;3600000;0
600;146862;11;0;0;0;0;.00nan;0;0
601;676;24;83;37;3;34;.919;4200000;0
601;165723;32;0;0;0;0;.00nan;0;0
601;85727;32;87;44;3;41;.932;4200000;0
601;86192;24;0;0;0;0;.00nan;0;0
602;3284;21;0;0;0;0;.00nan;0;0
602;3928;20;0;0;0;0;.00nan;0;0
602;205824;20;90;38;2;36;.947;3544000;0
602;182116;21;94;32;1;31;.969;3600000;0
603;172340;4182;100;26;0;26;1.000;3600000;0
603;183783;25;0;0;0;0;.00nan;0;0
603;191813;25;80;33;2;31;.939;3545000;0
603;140314;4182;0;0;0;0;.00nan;0;0
604;192733;18;0;0;0;0;.00nan;0;0
604;166591;15;81;33;3;30;.909;3600000;0
604;173727;18;55;31;4;27;.871;3550000;0
604;187362;15;0;0;0;0;.00nan;0;0
605;556;33;66;37;4;33;.892;4200000;0
605;170314;5;81;44;4;40;.909;4200000;0
605;201585;5;0;0;0;0;.00nan;0;0
605;197038;33;0;0;0;0;.00nan;0;0
606;171838;31;72;33;3;30;.909;4200000;0
606;20432;28;0;0;0;0;.00nan;0;0
606;201174;28;65;35;3;32;.914;4200000;0
606;149452;31;0;0;0;0;.00nan;0;0
607;3284;21;0;0;0;0;.00nan;0;0
607;184229;35;91;46;2;44;.957;3600000;0
607;182116;21;63;31;4;27;.871;3600000;0
607;147977;35;0;0;0;0;.00nan;0;0
608;187718;16;0;0;0;0;.00nan;0;0
608;173699;10;0;0;0;0;.00nan;0;0
608;50065;16;44;30;5;25;.833;3600000;0
608;90164;10;75;33;3;30;.909;3600000;0
609;163471;34;74;25;1;24;.960;3600000;0
609;183904;34;0;0;0;0;.00nan;0;0
609;139409;3;65;35;4;31;.886;3600000;0
609;148958;3;0;0;0;0;.00nan;0;0
610;676;24;0;0;0;0;.00nan;0;0
610;187537;19;43;3;1;2;.667;421000;0
610;178384;19;23;23;6;17;.739;3179000;0
610;86192;24;95;41;2;39;.951;3600000;0
611;175092;9;0;0;0;0;.00nan;0;0
611;175912;14;81;38;3;35;.921;3777000;0
611;190106;9;60;30;4;26;.867;3777000;0
611;185034;14;0;0;0;0;.00nan;0;0
612;166646;0;98;46;2;44;.957;4200000;0
612;193854;11;0;0;0;0;.00nan;0;0
612;189333;0;0;0;0;0;.00nan;0;0
612;146862;11;80;25;2;23;.920;4200000;0
613;187578;26;0;0;0;0;.00nan;0;0
613;13714;8;61;22;3;19;.864;3600000;0
613;179154;26;60;36;4;32;.889;3600000;0
613;58830;8;0;0;0;0;.00nan;0;0
614;183844;29;80;27;1;26;.963;3840000;0
614;195089;29;0;0;0;0;.00nan;0;0
614;196090;4838;0;0;0;0;.00nan;0;0
614;185743;4838;83;35;2;33;.943;3840000;0
615;196005;22;0;0;0;0;.00nan;0;0
615;206789;30;0;0;0;0;.00nan;0;0
615;86697;30;89;48;4;44;.917;3751000;0
615;143473;22;64;26;3;23;.885;3751000;0
616;192733;18;73;17;1;16;.941;3600000;0
616;165723;32;87;34;2;32;.941;3556000;0
616;173727;18;0;0;0;0;.00nan;0;0
616;85727;32;0;0;0;0;.00nan;0;0
617;788;27;72;30;3;27;.900;2920000;0
617;3928;20;64;41;5;36;.878;3600000;0
617;205824;20;0;0;0;0;.00nan;0;0
617;171304;27;23;10;4;6;.600;680000;0
618;183783;25;0;0;0;0;.00nan;0;0
618;174718;12;68;40;4;36;.900;3600000;0
618;191813;25;69;18;1;17;.944;3600000;0
618;85798;12;0;0;0;0;.00nan;0;0
619;172340;4182;59;33;4;29;.879;3600000;0
619;194416;17;0;0;0;0;.00nan;0;0
619;178413;17;65;14;1;13;.929;3600000;0
619;140314;4182;0;0;0;0;.00nan;0;0
620;187537;19;0;0;0;0;.00nan;0;0
620;163471;34;0;0;0;0;.00nan;0;0
620;178384;19;73;41;4;37;.902;3600000;0
620;183904;34;94;20;0;20;1.000;3600000;0
621;166591;15;0;0;0;0;.00nan;0;0
621;175912;14;29;28;6;22;.786;2216000;0
621;185034;14;59;13;1;12;.923;1384000;0
621;187362;15;53;23;3;20;.870;3600000;0
622;187578;26;0;0;0;0;.00nan;0;0
622;187718;16;0;0;0;0;.00nan;0;0
622;179154;26;70;26;2;24;.923;3600000;0
622;50065;16;84;43;4;39;.907;3600000;0
623;556;33;79;28;2;26;.929;3600000;0
623;171838;31;0;0;0;0;.00nan;0;0
623;197038;33;0;0;0;0;.00nan;0;0
623;149452;31;90;43;1;42;.977;3600000;0
624;183859;23;0;0;0;0;.00nan;0;0
624;175092;9;86;19;0;19;1.000;3600000;0
624;190106;9;0;0;0;0;.00nan;0;0
624;59540;23;65;38;5;33;.868;3600000;0
625;788;27;54;22;3;19;.864;3563000;0
625;20432;28;97;44;2;42;.955;3600000;0
625;171304;27;0;0;0;0;.00nan;0;0
625;201174;28;0;0;0;0;.00nan;0;0
626;166646;0;63;37;4;33;.892;3552000;0
626;193854;11;0;0;0;0;.00nan;0;0
626;189333;0;0;0;0;0;.00nan;0;0
626;146862;11;73;25;2;23;.920;3600000;0
627;187537;19;73;40;4;36;.900;3550000;0
627;178384;19;0;0;0;0;.00nan;0;0
627;196005;22;48;15;2;13;.867;3600000;0
627;143473;22;0;0;0;0;.00nan;0;0
628;172340;4182;59;35;4;31;.886;3530000;0
628;13714;8;64;18;2;16;.889;3600000;0
628;58830;8;0;0;0;0;.00nan;0;0
628;140314;4182;0;0;0;0;.00nan;0;0
629;184229;35;31;31;6;25;.806;2532000;0
629;170314;5;68;27;3;24;.889;3600000;0
629;201585;5;0;0;0;0;.00nan;0;0
629;147977;35;49;8;1;7;.875;1068000;0
630;183783;25;50;25;3;22;.880;3600000;0
630;173699;10;42;22;4;18;.818;1120000;0
630;191813;25;0;0;0;0;.00nan;0;0
630;90164;10;79;28;1;27;.964;2460000;0
631;165723;32;41;2;1;1;.500;310000;0
631;196090;4838;0;0;0;0;.00nan;0;0
631;185743;4838;85;47;3;44;.936;3600000;0
631;85727;32;39;26;5;21;.808;3290000;0
632;171838;31;84;31;1;30;.968;4200000;0
632;174718;12;0;0;0;0;.00nan;0;0
632;85798;12;93;41;1;40;.976;4200000;0
632;149452;31;0;0;0;0;.00nan;0;0
633;192733;18;0;0;0;0;.00nan;0;0
633;183844;29;87;39;3;36;.923;3600000;0
633;173727;18;68;40;5;35;.875;3590000;0
633;195089;29;0;0;0;0;.00nan;0;0
634;166591;15;100;28;0;28;1.000;3600000;0
634;187362;15;0;0;0;0;.00nan;0;0
634;139409;3;68;44;4;40;.909;3600000;0
634;148958;3;0;0;0;0;.00nan;0;0
635;187578;26;0;0;0;0;.00nan;0;0
635;187718;16;0;0;0;0;.00nan;0;0
635;179154;26;100;26;0;26;1.000;3600000;0
635;50065;16;59;28;3;25;.893;3600000;0
636;556;33;91;35;1;34;.971;3600000;0
636;206789;30;0;0;0;0;.00nan;0;0
636;197038;33;0;0;0;0;.00nan;0;0
636;86697;30;77;25;2;23;.920;3589000;0
637;183844;29;59;20;3;17;.850;3600000;0
637;195089;29;0;0;0;0;.00nan;0;0
637;175092;9;24;12;4;8;.667;1057000;0
637;190106;9;56;19;2;17;.895;2543000;0
638;3284;21;0;0;0;0;.00nan;0;0
638;172340;4182;75;38;3;35;.921;3600000;0
638;182116;21;100;32;0;32;1.000;3600000;0
638;140314;4182;0;0;0;0;.00nan;0;0
639;194416;17;0;0;0;0;.00nan;0;0
639;178413;17;84;31;2;29;.935;3816000;0
639;196090;4838;0;0;0;0;.00nan;0;0
639;185743;4838;65;27;3;24;.889;3816000;0
640;788;27;0;0;0;0;.00nan;0;0
640;170314;5;0;0;0;0;.00nan;0;0
640;171304;27;38;32;5;27;.844;3600000;0
640;201585;5;74;29;2;27;.931;3600000;0
641;193854;11;0;0;0;0;.00nan;0;0
641;139409;3;0;0;0;0;.00nan;0;0
641;146862;11;31;12;3;9;.750;3600000;0
641;148958;3;100;41;0;41;1.000;3600000;0
642;187537;19;0;0;0;0;.00nan;0;0
642;178384;19;69;23;2;21;.913;3600000;0
642;175912;14;51;30;4;26;.867;3062000;0
642;185034;14;41;3;1;2;.667;538000;0
643;676;24;70;34;4;30;.882;3567000;0
643;20432;28;0;0;0;0;.00nan;0;0
643;201174;28;80;34;2;32;.941;3600000;0
643;86192;24;0;0;0;0;.00nan;0;0
644;3928;20;63;33;3;30;.909;3567000;0
644;183859;23;0;0;0;0;.00nan;0;0
644;205824;20;0;0;0;0;.00nan;0;0
644;59540;23;93;36;2;34;.944;3600000;0
645;166646;0;80;42;4;38;.905;3951000;0
645;189333;0;0;0;0;0;.00nan;0;0
645;196005;22;0;0;0;0;.00nan;0;0
645;143473;22;48;33;5;28;.848;3951000;0
646;163471;34;0;0;0;0;.00nan;0;0
646;183904;34;66;28;3;25;.893;3600000;0
646;184229;35;100;26;0;26;1.000;3600000;0
646;147977;35;0;0;0;0;.00nan;0;0
647;165723;32;89;48;3;45;.938;3600000;0
647;183783;25;0;0;0;0;.00nan;0;0
647;191813;25;86;14;0;14;1.000;3600000;0
647;85727;32;0;0;0;0;.00nan;0;0
648;192733;18;0;0;0;0;.00nan;0;0
648;173727;18;71;33;3;30;.909;3819000;0
648;174718;12;0;0;0;0;.00nan;0;0
648;85798;12;94;61;4;57;.934;3819000;0
649;171838;31;0;0;0;0;.00nan;0;0
649;206789;30;63;25;2;23;.920;3549000;0
649;86697;30;0;0;0;0;.00nan;0;0
649;149452;31;93;37;1;36;.973;3600000;0
650;187578;26;0;0;0;0;.00nan;0;0
650;13714;8;87;26;1;25;.962;3600000;0
650;179154;26;69;33;3;30;.909;3528000;0
650;58830;8;0;0;0;0;.00nan;0;0
651;166591;15;77;24;1;23;.958;3600000;0
651;187718;16;0;0;0;0;.00nan;0;0
651;187362;15;0;0;0;0;.00nan;0;0
651;50065;16;85;37;2;35;.946;3558000;0
652;3928;20;97;51;3;48;.941;3876000;0
652;163471;34;50;20;4;16;.800;3876000;0
652;183904;34;0;0;0;0;.00nan;0;0
652;205824;20;0;0;0;0;.00nan;0;0
653;187537;19;0;0;0;0;.00nan;0;0
653;178384;19;95;50;3;47;.940;3583000;0
653;175092;9;0;0;0;0;.00nan;0;0
653;190106;9;91;27;1;26;.963;3600000;0
654;193854;11;0;0;0;0;.00nan;0;0
654;183844;29;64;31;3;28;.903;3600000;0
654;195089;29;0;0;0;0;.00nan;0;0
654;146862;11;45;26;4;22;.846;3585000;0
655;676;24;0;0;0;0;.00nan;0;0
655;170314;5;55;31;4;27;.871;3600000;0
655;201585;5;0;0;0;0;.00nan;0;0
655;86192;24;47;34;5;29;.853;3541000;0
656;3284;21;0;0;0;0;.00nan;0;0
656;175912;14;87;21;1;20;.952;3600000;0
656;185034;14;0;0;0;0;.00nan;0;0
656;182116;21;57;23;3;20;.870;3543000;0
657;183859;23;0;0;0;0;.00nan;0;0
657;173699;10;0;0;0;0;.00nan;0;0
657;59540;23;75;30;2;28;.933;3600000;0
657;90164;10;58;37;4;33;.892;3581000;0
658;788;27;92;36;1;35;.972;3600000;0
658;194416;17;0;0;0;0;.00nan;0;0
658;178413;17;84;19;0;19;1.000;3600000;0
658;171304;27;0;0;0;0;.00nan;0;0
659;196090;4838;0;0;0;0;.00nan;0;0
659;185743;4838;62;15;1;14;.933;3600000;0
659;139409;3;0;0;0;0;.00nan;0;0
659;148958;3;79;42;3;39;.929;3535000;0
660;172340;4182;86;39;3;36;.923;3531000;0
660;20432;28;0;0;0;0;.00nan;0;0
660;201174;28;90;39;2;37;.949;3600000;0
660;140314;4182;0;0;0;0;.00nan;0;0
661;556;33;88;41;3;38;.927;3600000;0
661;166646;0;57;34;4;30;.882;3593000;0
661;189333;0;0;0;0;0;.00nan;0;0
661;197038;33;0;0;0;0;.00nan;0;0
662;166591;15;0;0;0;0;.00nan;0;0
662;183783;25;0;0;0;0;.00nan;0;0
662;187362;15;53;40;5;35;.875;4000000;0
662;191813;25;40;36;6;30;.833;4000000;0
663;187578;26;49;18;3;15;.833;3600000;0
663;165723;32;63;37;4;33;.892;3600000;0
663;179154;26;0;0;0;0;.00nan;0;0
663;85727;32;0;0;0;0;.00nan;0;0
664;187718;16;43;27;5;22;.815;3600000;0
664;174718;12;0;0;0;0;.00nan;0;0
664;50065;16;0;0;0;0;.00nan;0;0
664;85798;12;58;48;6;42;.875;3600000;0
665;13714;8;0;0;0;0;.00nan;0;0
665;196005;22;0;0;0;0;.00nan;0;0
665;58830;8;61;49;6;43;.878;3600000;0
665;143473;22;51;24;3;21;.875;3600000;0
666;171838;31;95;34;1;33;.971;3600000;0
666;184229;35;52;21;3;18;.857;3573000;0
666;147977;35;0;0;0;0;.00nan;0;0
666;149452;31;0;0;0;0;.00nan;0;0
667;192733;18;0;0;0;0;.00nan;0;0
667;173727;18;62;31;4;27;.871;3545000;0
667;206789;30;0;0;0;0;.00nan;0;0
667;86697;30;67;25;3;22;.880;3600000;0
668;3928;20;0;0;0;0;.00nan;0;0
668;163471;34;0;0;0;0;.00nan;0;0
668;183904;34;65;19;1;18;.947;3600000;0
668;205824;20;91;66;5;61;.924;3600000;0
669;166646;0;0;0;0;0;.00nan;0;0
669;194416;17;0;0;0;0;.00nan;0;0
669;178413;17;55;24;3;21;.875;3600000;0
669;189333;0;64;35;4;31;.886;3591000;0
670;676;24;100;30;0;30;1.000;3600000;0
670;171838;31;0;0;0;0;.00nan;0;0
670;86192;24;0;0;0;0;.00nan;0;0
670;149452;31;87;32;1;31;.969;3541000;0
671;193854;11;0;0;0;0;.00nan;0;0
671;175092;9;0;0;0;0;.00nan;0;0
671;190106;9;92;35;1;34;.971;3600000;0
671;146862;11;41;30;5;25;.833;3600000;0
672;187537;19;51;2;0;2;1.000;322000;0
672;178384;19;21;20;6;14;.700;3278000;0
672;173699;10;80;35;3;32;.914;3600000;0
672;90164;10;0;0;0;0;.00nan;0;0
673;172340;4182;94;32;1;31;.969;3600000;0
673;170314;5;36;20;4;16;.800;3600000;0
673;201585;5;0;0;0;0;.00nan;0;0
673;140314;4182;0;0;0;0;.00nan;0;0
674;788;27;89;30;1;29;.967;3600000;0
674;3284;21;0;0;0;0;.00nan;0;0
674;171304;27;0;0;0;0;.00nan;0;0
674;182116;21;76;28;2;26;.929;3600000;0
675;187718;16;0;0;0;0;.00nan;0;0
675;196005;22;0;0;0;0;.00nan;0;0
675;50065;16;57;42;6;36;.857;3600000;0
675;143473;22;55;17;2;15;.882;3600000;0
676;183859;23;0;0;0;0;.00nan;0;0
676;175912;14;29;8;3;5;.625;515000;0
676;185034;14;76;29;2;27;.931;3020000;0
676;59540;23;57;25;3;22;.880;3600000;0
677;556;33;61;30;3;27;.900;3524000;0
677;197038;33;0;0;0;0;.00nan;0;0
677;139409;3;82;24;1;23;.958;3600000;0
677;148958;3;0;0;0;0;.00nan;0;0
678;166591;15;75;30;2;28;.933;3600000;0
678;184229;35;84;40;3;37;.925;3563000;0
678;187362;15;0;0;0;0;.00nan;0;0
678;147977;35;0;0;0;0;.00nan;0;0
679;13714;8;91;18;0;18;1.000;3600000;0
679;206789;30;0;0;0;0;.00nan;0;0
679;58830;8;0;0;0;0;.00nan;0;0
679;86697;30;72;25;1;24;.960;3566000;0
680;163471;34;0;0;0;0;.00nan;0;0
680;183859;23;0;0;0;0;.00nan;0;0
680;183904;34;53;27;4;23;.852;3600000;0
680;59540;23;42;29;5;24;.828;3572000;0
681;556;33;0;0;0;0;.00nan;0;0
681;183844;29;100;32;0;32;1.000;3600000;0
681;195089;29;0;0;0;0;.00nan;0;0
681;197038;33;75;42;4;38;.905;3600000;0
682;3928;20;60;27;4;23;.852;3600000;0
682;172340;4182;0;0;0;0;.00nan;0;0
682;205824;20;0;0;0;0;.00nan;0;0
682;140314;4182;40;34;5;29;.853;3565000;0
683;788;27;0;0;0;0;.00nan;0;0
683;187578;26;0;0;0;0;.00nan;0;0
683;171304;27;74;34;3;31;.912;3668000;0
683;179154;26;64;20;2;18;.900;3668000;0
684;183783;25;0;0;0;0;.00nan;0;0
684;196005;22;73;31;3;28;.903;3600000;0
684;191813;25;85;45;4;41;.911;3547000;0
684;143473;22;0;0;0;0;.00nan;0;0
685;193854;11;79;27;1;26;.963;3600000;0
685;165723;32;89;37;2;35;.946;3560000;0
685;85727;32;0;0;0;0;.00nan;0;0
685;146862;11;0;0;0;0;.00nan;0;0
686;192733;18;0;0;0;0;.00nan;0;0
686;173727;18;56;16;2;14;.875;3600000;0
686;174718;12;67;27;2;25;.926;2622000;0
686;85798;12;35;17;4;13;.765;978000;0
687;166646;0;92;41;2;39;.951;3851000;0
687;189333;0;0;0;0;0;.00nan;0;0
687;196090;4838;0;0;0;0;.00nan;0;0
687;185743;4838;78;27;1;26;.963;3851000;0
688;194416;17;0;0;0;0;.00nan;0;0
688;178413;17;44;26;4;22;.846;3600000;0
688;170314;5;65;29;3;26;.897;3600000;0
688;201585;5;0;0;0;0;.00nan;0;0
689;676;24;89;34;2;32;.941;4103000;0
689;86192;24;0;0;0;0;.00nan;0;0
689;139409;3;78;36;3;33;.917;4103000;0
689;148958;3;0;0;0;0;.00nan;0;0
690;165723;32;0;0;0;0;.00nan;0;0
690;175092;9;59;26;1;25;.962;4200000;0
690;190106;9;0;0;0;0;.00nan;0;0
690;85727;32;100;40;1;39;.975;4200000;0
691;556;33;84;44;4;40;.909;4200000;0
691;171838;31;52;27;4;23;.852;4200000;0
691;197038;33;0;0;0;0;.00nan;0;0
691;149452;31;0;0;0;0;.00nan;0;0
692;183844;29;15;16;5;11;.688;3600000;0
692;195089;29;0;0;0;0;.00nan;0;0
692;139409;3;79;31;2;29;.935;3600000;0
692;148958;3;0;0;0;0;.00nan;0;0
693;166591;15;68;21;2;19;.905;3741000;0
693;187578;26;0;0;0;0;.00nan;0;0
693;179154;26;88;36;3;33;.917;3741000;0
693;187362;15;0;0;0;0;.00nan;0;0
694;187718;16;0;0;0;0;.00nan;0;0
694;20432;28;0;0;0;0;.00nan;0;0
694;201174;28;68;39;4;35;.897;3600000;0
694;50065;16;67;19;1;18;.947;3600000;0
695;3928;20;95;38;1;37;.974;3581000;0
695;184229;35;99;24;0;24;1.000;3600000;0
695;205824;20;0;0;0;0;.00nan;0;0
695;147977;35;0;0;0;0;.00nan;0;0
696;192733;18;0;0;0;0;.00nan;0;0
696;166646;0;97;46;3;43;.935;3557000;0
696;189333;0;0;0;0;0;.00nan;0;0
696;173727;18;73;22;2;20;.909;3600000;0
697;183859;23;0;0;0;0;.00nan;0;0
697;196090;4838;0;0;0;0;.00nan;0;0
697;185743;4838;94;20;0;20;1.000;3600000;0
697;59540;23;88;31;1;30;.968;3600000;0
698;788;27;64;34;3;31;.912;3575000;0
698;13714;8;69;22;2;20;.909;3600000;0
698;171304;27;0;0;0;0;.00nan;0;0
698;58830;8;0;0;0;0;.00nan;0;0
699;187537;19;53;24;3;21;.875;3600000;0
699;178384;19;0;0;0;0;.00nan;0;0
699;174718;12;0;0;0;0;.00nan;0;0
699;85798;12;63;43;5;38;.884;3512000;0
700;163471;34;0;0;0;0;.00nan;0;0
700;183904;34;94;32;1;31;.969;3600000;0
700;206789;30;0;0;0;0;.00nan;0;0
700;86697;30;77;42;4;38;.905;3600000;0
701;3284;21;0;0;0;0;.00nan;0;0
701;194416;17;0;0;0;0;.00nan;0;0
701;178413;17;34;26;5;21;.808;3600000;0
701;182116;21;92;23;0;23;1.000;3600000;0
702;676;24;87;50;5;45;.900;3600000;0
702;173699;10;0;0;0;0;.00nan;0;0
702;86192;24;0;0;0;0;.00nan;0;0
702;90164;10;69;27;2;25;.926;3600000;0
703;187718;16;46;25;4;21;.840;3566000;0
703;170314;5;0;0;0;0;.00nan;0;0
703;201585;5;69;31;3;28;.903;3600000;0
703;50065;16;0;0;0;0;.00nan;0;0
704;165723;32;0;0;0;0;.00nan;0;0
704;196005;22;0;0;0;0;.00nan;0;0
704;85727;32;97;59;4;55;.932;3600000;0
704;143473;22;78;12;0;12;1.000;3600000;0
705;20432;28;48;30;5;25;.833;3576000;0
705;201174;28;0;0;0;0;.00nan;0;0
705;175092;9;0;0;0;0;.00nan;0;0
705;190106;9;61;30;4;26;.867;3600000;0
706;556;33;87;51;5;46;.902;3592000;0
706;166591;15;30;13;4;9;.692;1143000;0
706;187362;15;71;12;0;12;1.000;2457000;0
706;197038;33;0;0;0;0;.00nan;0;0
707;13714;8;72;32;3;29;.906;3600000;0
707;174718;12;0;0;0;0;.00nan;0;0
707;58830;8;0;0;0;0;.00nan;0;0
707;85798;12;83;33;2;31;.939;3600000;0
708;183783;25;0;0;0;0;.00nan;0;0
708;183844;29;85;50;4;46;.920;3600000;0
708;195089;29;0;0;0;0;.00nan;0;0
708;191813;25;65;16;1;15;.938;3600000;0
709;171838;31;0;0;0;0;.00nan;0;0
709;139409;3;49;22;4;18;.818;2240000;0
709;148958;3;53;21;2;19;.905;1360000;0
709;149452;31;99;37;2;35;.946;3600000;0
710;676;24;0;0;0;0;.00nan;0;0
710;187578;26;0;0;0;0;.00nan;0;0
710;179154;26;52;32;4;28;.875;4168000;0
710;86192;24;94;56;3;53;.946;4168000;0
711;187537;19;0;0;0;0;.00nan;0;0
711;166646;0;75;32;3;29;.906;3572000;0
711;178384;19;100;39;1;38;.974;3600000;0
711;189333;0;0;0;0;0;.00nan;0;0
712;3928;20;100;40;0;40;1.000;3600000;0
712;184229;35;39;17;3;14;.824;3600000;0
712;205824;20;0;0;0;0;.00nan;0;0
712;147977;35;0;0;0;0;.00nan;0;0
713;192733;18;86;22;1;21;.955;3600000;0
713;173727;18;0;0;0;0;.00nan;0;0
713;196090;4838;0;0;0;0;.00nan;0;0
713;185743;4838;41;37;6;31;.838;3600000;0
714;172340;4182;61;39;5;34;.872;3600000;0
714;193854;11;0;0;0;0;.00nan;0;0
714;140314;4182;0;0;0;0;.00nan;0;0
714;146862;11;48;20;3;17;.850;3600000;0
715;175912;14;0;0;0;0;.00nan;0;0
715;206789;30;0;0;0;0;.00nan;0;0
715;185034;14;62;35;4;31;.886;3600000;0
715;86697;30;73;21;1;20;.952;3600000;0
716;788;27;0;0;0;0;.00nan;0;0
716;163471;34;0;0;0;0;.00nan;0;0
716;183904;34;60;25;3;22;.880;4200000;0
716;171304;27;68;37;3;34;.919;4200000;0
717;166591;15;91;41;2;39;.951;3600000;0
717;183844;29;0;0;0;0;.00nan;0;0
717;195089;29;98;31;1;30;.968;3600000;0
717;187362;15;0;0;0;0;.00nan;0;0
718;3284;21;0;0;0;0;.00nan;0;0
718;187718;16;0;0;0;0;.00nan;0;0
718;182116;21;62;26;3;23;.885;3600000;0
718;50065;16;59;35;4;31;.886;3568000;0
719;194416;17;0;0;0;0;.00nan;0;0
719;178413;17;62;14;1;13;.929;3600000;0
719;20432;28;0;0;0;0;.00nan;0;0
719;201174;28;81;42;2;40;.952;3570000;0
720;187578;26;96;33;1;32;.970;3600000;0
720;179154;26;0;0;0;0;.00nan;0;0
720;196005;22;0;0;0;0;.00nan;0;0
720;143473;22;67;16;2;14;.875;3546000;0
721;172340;4182;89;43;2;41;.953;3580000;0
721;163471;34;80;22;1;21;.955;3600000;0
721;183904;34;0;0;0;0;.00nan;0;0
721;140314;4182;0;0;0;0;.00nan;0;0
722;166646;0;0;0;0;0;.00nan;0;0
722;183859;23;69;24;2;22;.917;3600000;0
722;189333;0;61;27;3;24;.889;3563000;0
722;59540;23;0;0;0;0;.00nan;0;0
723;171838;31;55;38;6;32;.842;2287000;0
723;183783;25;0;0;0;0;.00nan;0;0
723;191813;25;92;11;0;11;1.000;3600000;0
723;149452;31;75;25;2;23;.920;1313000;0
724;676;24;93;51;3;48;.941;4078000;0
724;206789;30;0;0;0;0;.00nan;0;0
724;86192;24;0;0;0;0;.00nan;0;0
724;86697;30;62;32;4;28;.875;4078000;0
725;13714;8;94;41;2;39;.951;3773000;0
725;170314;5;88;32;1;31;.969;3773000;0
725;201585;5;0;0;0;0;.00nan;0;0
725;58830;8;0;0;0;0;.00nan;0;0
726;174718;12;55;27;3;24;.889;3549000;0
726;175912;14;0;0;0;0;.00nan;0;0
726;185034;14;71;25;2;23;.920;3600000;0
726;85798;12;0;0;0;0;.00nan;0;0
727;187537;19;0;0;0;0;.00nan;0;0
727;165723;32;0;0;0;0;.00nan;0;0
727;178384;19;98;37;3;34;.919;3575000;0
727;85727;32;74;27;2;25;.926;3600000;0
728;788;27;70;38;3;35;.921;3543000;0
728;193854;11;0;0;0;0;.00nan;0;0
728;171304;27;0;0;0;0;.00nan;0;0
728;146862;11;61;21;2;19;.905;3600000;0
729;187578;26;0;0;0;0;.00nan;0;0
729;194416;17;15;19;6;13;.684;3600000;0
729;178413;17;0;0;0;0;.00nan;0;0
729;179154;26;89;32;1;31;.969;3600000;0
730;183844;29;85;20;0;20;1.000;3600000;0
730;195089;29;0;0;0;0;.00nan;0;0
730;139409;3;84;47;4;43;.915;3600000;0
730;148958;3;0;0;0;0;.00nan;0;0
731;166591;15;68;27;3;24;.889;4200000;0
731;20432;28;76;46;3;43;.935;4200000;0
731;201174;28;0;0;0;0;.00nan;0;0
731;187362;15;0;0;0;0;.00nan;0;0
732;196005;22;0;0;0;0;.00nan;0;0
732;206789;30;51;15;2;13;.867;1131000;0
732;86697;30;24;36;8;28;.778;2469000;0
732;143473;22;63;23;2;21;.913;3600000;0
733;187718;16;0;0;0;0;.00nan;0;0
733;3928;20;32;36;7;29;.806;3600000;0
733;205824;20;0;0;0;0;.00nan;0;0
733;50065;16;55;23;3;20;.870;3600000;0
734;192733;18;0;0;0;0;.00nan;0;0
734;173727;18;71;18;1;17;.944;3600000;0
734;184229;35;28;16;4;12;.750;1077000;0
734;147977;35;52;24;3;21;.875;2523000;0
735;173699;10;39;34;6;28;.824;2534000;0
735;196090;4838;0;0;0;0;.00nan;0;0
735;185743;4838;64;29;3;26;.897;3600000;0
735;90164;10;53;4;0;4;1.000;1066000;0
736;172340;4182;100;43;2;41;.953;3669000;0
736;175092;9;0;0;0;0;.00nan;0;0
736;190106;9;81;34;3;31;.912;3669000;0
736;140314;4182;0;0;0;0;.00nan;0;0
737;163471;34;0;0;0;0;.00nan;0;0
737;193854;11;70;44;5;39;.886;4200000;0
737;183904;34;77;40;5;35;.875;4200000;0
737;146862;11;0;0;0;0;.00nan;0;0
738;170314;5;85;33;2;31;.939;3600000;0
738;174718;12;0;0;0;0;.00nan;0;0
738;201585;5;0;0;0;0;.00nan;0;0
738;85798;12;92;47;4;43;.915;3541000;0
739;166646;0;98;54;2;52;.963;3600000;0
739;183783;25;0;0;0;0;.00nan;0;0
739;189333;0;0;0;0;0;.00nan;0;0
739;191813;25;80;10;0;10;1.000;3600000;0
740;171838;31;93;38;2;36;.947;3600000;0
740;3284;21;0;0;0;0;.00nan;0;0
740;182116;21;69;33;3;30;.909;3559000;0
740;149452;31;0;0;0;0;.00nan;0;0
741;556;33;87;34;2;32;.941;3600000;0
741;3928;20;55;1;0;1;1.000;442000;0
741;205824;20;54;41;6;35;.854;3158000;0
741;197038;33;0;0;0;0;.00nan;0;0
742;165723;32;0;0;0;0;.00nan;0;0
742;183859;23;0;0;0;0;.00nan;0;0
742;59540;23;61;32;4;28;.875;3517000;0
742;85727;32;93;37;2;35;.946;3600000;0
743;187537;19;0;0;0;0;.00nan;0;0
743;178384;19;83;46;4;42;.913;3596000;0
743;184229;35;54;21;3;18;.857;3600000;0
743;147977;35;0;0;0;0;.00nan;0;0
744;788;27;0;0;0;0;.00nan;0;0
744;171304;27;72;17;1;16;.941;3600000;0
744;175092;9;94;38;2;36;.947;3580000;0
744;190106;9;0;0;0;0;.00nan;0;0
745;676;24;22;5;3;2;.400;426000;0
745;3284;21;74;25;1;24;.960;3600000;0
745;182116;21;0;0;0;0;.00nan;0;0
745;86192;24;64;39;5;34;.872;3174000;0
746;166591;15;73;40;4;36;.900;3963000;0
746;194416;17;0;0;0;0;.00nan;0;0
746;178413;17;69;45;5;40;.889;3963000;0
746;187362;15;0;0;0;0;.00nan;0;0
747;196005;22;0;0;0;0;.00nan;0;0
747;139409;3;0;0;0;0;.00nan;0;0
747;143473;22;63;16;1;15;.938;3600000;0
747;148958;3;77;53;5;48;.906;3600000;0
748;171838;31;0;0;0;0;.00nan;0;0
748;183844;29;65;16;1;15;.938;3600000;0
748;195089;29;0;0;0;0;.00nan;0;0
748;149452;31;61;49;6;43;.878;3600000;0
749;20432;28;0;0;0;0;.00nan;0;0
749;201174;28;41;20;4;16;.800;3575000;0
749;174718;12;68;26;2;24;.923;3600000;0
749;85798;12;0;0;0;0;.00nan;0;0
750;187578;26;0;0;0;0;.00nan;0;0
750;172340;4182;73;26;2;24;.923;3600000;0
750;179154;26;73;39;3;36;.923;3600000;0
750;140314;4182;0;0;0;0;.00nan;0;0
751;187718;16;0;0;0;0;.00nan;0;0
751;13714;8;73;22;2;20;.909;4200000;0
751;50065;16;97;53;2;51;.962;4200000;0
751;58830;8;0;0;0;0;.00nan;0;0
752;192733;18;0;0;0;0;.00nan;0;0
752;173699;10;43;17;4;13;.765;2286000;0
752;173727;18;97;25;1;24;.960;3600000;0
752;90164;10;53;17;2;15;.882;1314000;0
753;165723;32;57;27;3;24;.889;3600000;0
753;196090;4838;0;0;0;0;.00nan;0;0
753;185743;4838;74;23;2;21;.913;3600000;0
753;85727;32;0;0;0;0;.00nan;0;0
754;163471;34;0;0;0;0;.00nan;0;0
754;183904;34;70;25;2;23;.920;4200000;0
754;206789;30;0;0;0;0;.00nan;0;0
754;86697;30;100;50;2;48;.960;4200000;0
755;170314;5;91;20;0;20;1.000;3600000;0
755;175912;14;71;39;4;35;.897;3600000;0
755;201585;5;0;0;0;0;.00nan;0;0
755;185034;14;0;0;0;0;.00nan;0;0
756;556;33;75;34;2;32;.941;3600000;0
756;788;27;59;26;3;23;.885;3559000;0
756;171304;27;0;0;0;0;.00nan;0;0
756;197038;33;0;0;0;0;.00nan;0;0
757;183859;23;0;0;0;0;.00nan;0;0
757;184229;35;36;22;4;18;.818;3590000;0
757;59540;23;60;27;3;24;.889;3600000;0
757;147977;35;0;0;0;0;.00nan;0;0
758;166591;15;82;22;1;21;.955;3600000;0
758;171838;31;0;0;0;0;.00nan;0;0
758;187362;15;0;0;0;0;.00nan;0;0
758;149452;31;34;30;6;24;.800;3600000;0
759;187578;26;0;0;0;0;.00nan;0;0
759;3928;20;91;33;1;32;.970;3600000;0
759;205824;20;0;0;0;0;.00nan;0;0
759;179154;26;86;34;2;32;.941;3600000;0
760;13714;8;98;24;0;24;1.000;3600000;0
760;196090;4838;0;0;0;0;.00nan;0;0
760;185743;4838;44;25;4;21;.840;3600000;0
760;58830;8;0;0;0;0;.00nan;0;0
761;193854;11;0;0;0;0;.00nan;0;0
761;175092;9;0;0;0;0;.00nan;0;0
761;190106;9;42;35;5;30;.857;3600000;0
761;146862;11;69;17;1;16;.941;3600000;0
762;3284;21;0;0;0;0;.00nan;0;0
762;174718;12;0;0;0;0;.00nan;0;0
762;182116;21;100;32;1;31;.969;3600000;0
762;85798;12;62;27;3;24;.889;3536000;0
763;194416;17;0;0;0;0;.00nan;0;0
763;178413;17;72;20;1;19;.950;3600000;0
763;206789;30;0;0;0;0;.00nan;0;0
763;86697;30;70;31;3;28;.903;3536000;0
764;163471;34;89;37;2;35;.946;4200000;0
764;183844;29;56;20;2;18;.900;4200000;0
764;183904;34;0;0;0;0;.00nan;0;0
764;195089;29;0;0;0;0;.00nan;0;0
765;175912;14;0;0;0;0;.00nan;0;0
765;185034;14;62;27;3;24;.889;3600000;0
765;139409;3;69;41;4;37;.902;3599000;0
765;148958;3;0;0;0;0;.00nan;0;0
766;676;24;0;0;0;0;.00nan;0;0
766;20432;28;71;29;3;26;.897;3574000;0
766;201174;28;0;0;0;0;.00nan;0;0
766;86192;24;83;39;2;37;.949;3600000;0
767;166646;0;89;59;5;54;.915;3600000;0
767;183783;25;0;0;0;0;.00nan;0;0
767;189333;0;0;0;0;0;.00nan;0;0
767;191813;25;77;11;0;11;1.000;3600000;0
768;170314;5;34;37;6;31;.838;2227000;0
768;201585;5;44;10;2;8;.800;1373000;0
768;196005;22;0;0;0;0;.00nan;0;0
768;143473;22;50;25;4;21;.840;3600000;0
769;187718;16;0;0;0;0;.00nan;0;0
769;172340;4182;68;37;4;33;.892;4200000;0
769;50065;16;66;38;4;34;.895;4200000;0
769;140314;4182;0;0;0;0;.00nan;0;0
770;192733;18;0;0;0;0;.00nan;0;0
770;165723;32;0;0;0;0;.00nan;0;0
770;173727;18;82;12;0;12;1.000;3600000;0
770;85727;32;87;45;3;42;.933;3600000;0
771;187537;19;0;0;0;0;.00nan;0;0
771;178384;19;95;35;1;34;.971;3600000;0
771;173699;10;0;0;0;0;.00nan;0;0
771;90164;10;79;29;2;27;.931;3549000;0
772;788;27;0;0;0;0;.00nan;0;0
772;184229;35;50;24;4;20;.833;3906000;0
772;171304;27;80;42;3;39;.929;3906000;0
772;147977;35;0;0;0;0;.00nan;0;0
773;183859;23;0;0;0;0;.00nan;0;0
773;173699;10;91;38;2;36;.947;3600000;0
773;59540;23;24;14;4;10;.714;3515000;0
773;90164;10;0;0;0;0;.00nan;0;0
774;13714;8;94;20;0;20;1.000;3600000;0
774;183844;29;74;42;4;38;.905;3600000;0
774;195089;29;0;0;0;0;.00nan;0;0
774;58830;8;0;0;0;0;.00nan;0;0
775;173699;10;0;0;0;0;.00nan;0;0
775;184229;35;0;0;0;0;.00nan;0;0
775;90164;10;100;37;0;37;1.000;3600000;0
775;147977;35;30;31;6;25;.806;3600000;0
776;193854;11;0;0;0;0;.00nan;0;0
776;183859;23;0;0;0;0;.00nan;0;0
776;59540;23;82;24;1;23;.958;3600000;0
776;146862;11;65;21;2;19;.905;3599000;0
777;194416;17;0;0;0;0;.00nan;0;0
777;183844;29;69;16;1;15;.938;3600000;0
777;178413;17;40;32;6;26;.813;3600000;0
777;195089;29;0;0;0;0;.00nan;0;0
778;788;27;49;29;4;25;.862;3600000;0
778;13714;8;93;25;1;24;.960;3600000;0
778;171304;27;0;0;0;0;.00nan;0;0
778;58830;8;0;0;0;0;.00nan;0;0
779;172340;4182;12;32;8;24;.750;3600000;0
779;193854;11;76;30;2;28;.933;3600000;0
779;140314;4182;0;0;0;0;.00nan;0;0
779;146862;11;0;0;0;0;.00nan;0;0
780;556;33;59;30;4;26;.867;3564000;0
780;163471;34;0;0;0;0;.00nan;0;0
780;183904;34;61;18;2;16;.889;3600000;0
780;197038;33;0;0;0;0;.00nan;0;0
781;166646;0;100;52;3;49;.942;4200000;0
781;189333;0;0;0;0;0;.00nan;0;0
781;196005;22;0;0;0;0;.00nan;0;0
781;143473;22;58;27;3;24;.889;4200000;0
782;192733;18;0;0;0;0;.00nan;0;0
782;171838;31;58;28;4;24;.857;3576000;0
782;173727;18;96;35;2;33;.943;3600000;0
782;149452;31;0;0;0;0;.00nan;0;0
783;187578;26;0;0;0;0;.00nan;0;0
783;179154;26;72;36;4;32;.889;3600000;0
783;175092;9;55;41;5;36;.878;3600000;0
783;190106;9;0;0;0;0;.00nan;0;0
784;187537;19;0;0;0;0;.00nan;0;0
784;3284;21;0;0;0;0;.00nan;0;0
784;178384;19;100;36;0;36;1.000;3600000;0
784;182116;21;58;18;2;16;.889;3513000;0
785;166591;15;78;30;2;28;.933;3600000;0
785;170314;5;0;0;0;0;.00nan;0;0
785;201585;5;63;31;3;28;.903;3596000;0
785;187362;15;0;0;0;0;.00nan;0;0
786;556;33;0;0;0;0;.00nan;0;0
786;676;24;0;0;0;0;.00nan;0;0
786;197038;33;65;30;3;27;.900;3600000;0
786;86192;24;98;24;0;24;1.000;3600000;0
787;183783;25;0;0;0;0;.00nan;0;0
787;175912;14;0;0;0;0;.00nan;0;0
787;185034;14;64;55;6;49;.891;3600000;0
787;191813;25;56;19;2;17;.895;3600000;0
788;3928;20;84;35;2;33;.943;3600000;0
788;205824;20;0;0;0;0;.00nan;0;0
788;139409;3;90;42;3;39;.929;3573000;0
788;148958;3;0;0;0;0;.00nan;0;0
789;206789;30;0;0;0;0;.00nan;0;0
789;196090;4838;0;0;0;0;.00nan;0;0
789;185743;4838;94;38;2;36;.947;3600000;0
789;86697;30;56;35;4;31;.886;3541000;0
790;163471;34;0;0;0;0;.00nan;0;0
790;183904;34;65;15;1;14;.933;3600000;0
790;20432;28;0;0;0;0;.00nan;0;0
790;201174;28;69;46;5;41;.891;3600000;0
791;166646;0;56;28;4;24;.857;3600000;0
791;187578;26;79;28;1;27;.964;3600000;0
791;189333;0;0;0;0;0;.00nan;0;0
791;179154;26;0;0;0;0;.00nan;0;0
792;187718;16;0;0;0;0;.00nan;0;0
792;165723;32;0;0;0;0;.00nan;0;0
792;50065;16;66;35;4;31;.886;3572000;0
792;85727;32;77;33;3;30;.909;3600000;0
793;171838;31;0;0;0;0;.00nan;0;0
793;187537;19;0;0;0;0;.00nan;0;0
793;178384;19;56;28;4;24;.857;3600000;0
793;149452;31;85;28;1;27;.964;3600000;0
794;3928;20;82;51;4;47;.922;3946000;0
794;170314;5;36;25;5;20;.800;3946000;0
794;205824;20;0;0;0;0;.00nan;0;0
794;201585;5;0;0;0;0;.00nan;0;0
795;192733;18;0;0;0;0;.00nan;0;0
795;676;24;0;0;0;0;.00nan;0;0
795;173727;18;77;24;1;23;.958;3600000;0
795;86192;24;89;38;2;36;.947;3565000;0
796;166591;15;95;62;3;59;.952;4200000;0
796;183783;25;0;0;0;0;.00nan;0;0
796;187362;15;0;0;0;0;.00nan;0;0
796;191813;25;76;31;3;28;.903;4200000;0
797;20432;28;83;54;5;49;.907;3600000;0
797;201174;28;0;0;0;0;.00nan;0;0
797;196005;22;0;0;0;0;.00nan;0;0
797;143473;22;69;26;2;24;.923;3600000;0
798;556;33;62;34;4;30;.882;3543000;0
798;3284;21;0;0;0;0;.00nan;0;0
798;182116;21;81;29;2;27;.931;3600000;0
798;197038;33;0;0;0;0;.00nan;0;0
799;174718;12;0;0;0;0;.00nan;0;0
799;206789;30;0;0;0;0;.00nan;0;0
799;85798;12;95;46;3;43;.935;3600000;0
799;86697;30;94;18;0;18;1.000;3600000;0
800;187718;16;0;0;0;0;.00nan;0;0
800;175912;14;0;0;0;0;.00nan;0;0
800;185034;14;46;36;5;31;.861;3600000;0
800;50065;16;69;25;2;23;.920;3600000;0
801;163471;34;0;0;0;0;.00nan;0;0
801;165723;32;0;0;0;0;.00nan;0;0
801;183904;34;95;22;0;22;1.000;3600000;0
801;85727;32;66;27;3;24;.889;3600000;0
802;172340;4182;93;36;1;35;.972;3600000;0
802;196090;4838;0;0;0;0;.00nan;0;0
802;185743;4838;64;25;3;22;.880;3562000;0
802;140314;4182;0;0;0;0;.00nan;0;0
803;184229;35;84;31;2;29;.935;3667000;0
803;175092;9;0;0;0;0;.00nan;0;0
803;190106;9;62;23;3;20;.870;3667000;0
803;147977;35;0;0;0;0;.00nan;0;0
804;187537;19;0;0;0;0;.00nan;0;0
804;178384;19;98;45;2;43;.956;3541000;0
804;194416;17;0;0;0;0;.00nan;0;0
804;178413;17;61;14;1;13;.929;3600000;0
805;187578;26;0;0;0;0;.00nan;0;0
805;179154;26;73;19;1;18;.947;3600000;0
805;139409;3;77;32;2;30;.938;3599000;0
805;148958;3;0;0;0;0;.00nan;0;0
806;192733;18;51;25;3;22;.880;3213000;0
806;173727;18;26;6;3;3;.500;387000;0
806;196005;22;74;18;1;17;.944;3600000;0
806;143473;22;0;0;0;0;.00nan;0;0
807;171838;31;100;33;0;33;1.000;4149000;0
807;3928;20;94;40;1;39;.975;4149000;0
807;205824;20;0;0;0;0;.00nan;0;0
807;149452;31;0;0;0;0;.00nan;0;0
808;556;33;70;29;2;27;.931;3531000;0
808;170314;5;97;23;0;23;1.000;3600000;0
808;201585;5;0;0;0;0;.00nan;0;0
808;197038;33;0;0;0;0;.00nan;0;0
809;676;24;0;0;0;0;.00nan;0;0
809;3284;21;0;0;0;0;.00nan;0;0
809;182116;21;75;32;3;29;.906;3570000;0
809;86192;24;91;26;1;25;.962;3600000;0
810;20432;28;0;0;0;0;.00nan;0;0
810;173699;10;0;0;0;0;.00nan;0;0
810;201174;28;79;28;2;26;.929;3564000;0
810;90164;10;75;21;1;20;.952;3600000;0
811;166646;0;75;33;3;30;.909;3577000;0
811;183844;29;60;13;1;12;.923;3600000;0
811;189333;0;0;0;0;0;.00nan;0;0
811;195089;29;0;0;0;0;.00nan;0;0
812;166591;15;0;0;0;0;.00nan;0;0
812;183859;23;0;0;0;0;.00nan;0;0
812;187362;15;85;32;1;31;.969;3600000;0
812;59540;23;19;26;7;19;.731;3600000;0
813;183783;25;79;25;1;24;.960;3600000;0
813;175912;14;0;0;0;0;.00nan;0;0
813;185034;14;68;36;4;32;.889;3600000;0
813;191813;25;0;0;0;0;.00nan;0;0
814;13714;8;86;22;1;21;.955;3600000;0
814;174718;12;0;0;0;0;.00nan;0;0
814;58830;8;0;0;0;0;.00nan;0;0
814;85798;12;60;39;4;35;.897;3600000;0
815;788;27;0;0;0;0;.00nan;0;0
815;171304;27;56;44;5;39;.886;3600000;0
815;196090;4838;86;19;0;19;1.000;3600000;0
815;185743;4838;0;0;0;0;.00nan;0;0
816;184229;35;0;0;0;0;.00nan;0;0
816;139409;3;0;0;0;0;.00nan;0;0
816;147977;35;43;21;3;18;.857;3717000;0
816;148958;3;76;33;2;31;.939;3717000;0
817;187537;19;0;0;0;0;.00nan;0;0
817;3928;20;64;18;1;17;.944;3600000;0
817;178384;19;42;32;5;27;.844;3600000;0
817;205824;20;0;0;0;0;.00nan;0;0
818;676;24;0;0;0;0;.00nan;0;0
818;183859;23;0;0;0;0;.00nan;0;0
818;59540;23;81;31;2;29;.935;3600000;0
818;86192;24;83;39;3;36;.923;3556000;0
819;192733;18;0;0;0;0;.00nan;0;0
819;163471;34;0;0;0;0;.00nan;0;0
819;183904;34;100;32;0;32;1.000;3600000;0
819;173727;18;63;38;4;34;.895;3600000;0
820;166591;15;80;12;0;12;1.000;3600000;0
820;174718;12;0;0;0;0;.00nan;0;0
820;187362;15;0;0;0;0;.00nan;0;0
820;85798;12;90;49;3;46;.939;3600000;0
821;187718;16;0;0;0;0;.00nan;0;0
821;206789;30;0;0;0;0;.00nan;0;0
821;50065;16;51;27;4;23;.852;3594000;0
821;86697;30;75;31;3;28;.903;3600000;0
822;171838;31;76;30;2;28;.933;3553000;0
822;20432;28;82;27;1;26;.963;3600000;0
822;201174;28;0;0;0;0;.00nan;0;0
822;149452;31;0;0;0;0;.00nan;0;0
823;788;27;56;28;4;24;.857;3576000;0
823;171304;27;0;0;0;0;.00nan;0;0
823;175092;9;0;0;0;0;.00nan;0;0
823;190106;9;79;31;2;29;.935;3600000;0
824;172340;4182;74;28;2;26;.929;3600000;0
824;139409;3;57;47;7;40;.851;3600000;0
824;140314;4182;0;0;0;0;.00nan;0;0
824;148958;3;0;0;0;0;.00nan;0;0
825;183844;29;81;26;1;25;.962;3600000;0
825;173699;10;43;29;5;24;.828;3600000;0
825;195089;29;0;0;0;0;.00nan;0;0
825;90164;10;0;0;0;0;.00nan;0;0
826;166646;0;98;38;2;36;.947;3600000;0
826;189333;0;0;0;0;0;.00nan;0;0
826;184229;35;90;27;1;26;.963;3600000;0
826;147977;35;0;0;0;0;.00nan;0;0
827;556;33;41;25;4;21;.840;3600000;0
827;3928;20;87;31;1;30;.968;3600000;0
827;205824;20;0;0;0;0;.00nan;0;0
827;197038;33;0;0;0;0;.00nan;0;0
828;183859;23;59;48;6;42;.875;3600000;0
828;196005;22;0;0;0;0;.00nan;0;0
828;59540;23;0;0;0;0;.00nan;0;0
828;143473;22;47;15;2;13;.867;3600000;0
829;187578;26;0;0;0;0;.00nan;0;0
829;3284;21;0;0;0;0;.00nan;0;0
829;179154;26;50;49;8;41;.837;3600000;0
829;182116;21;68;30;3;27;.900;3600000;0
830;676;24;75;38;3;35;.921;3600000;0
830;13714;8;100;24;0;24;1.000;3600000;0
830;58830;8;0;0;0;0;.00nan;0;0
830;86192;24;0;0;0;0;.00nan;0;0
831;187537;19;0;0;0;0;.00nan;0;0
831;165723;32;84;31;1;30;.968;3600000;0
831;178384;19;58;31;2;29;.935;3600000;0
831;85727;32;0;0;0;0;.00nan;0;0
832;194416;17;0;0;0;0;.00nan;0;0
832;178413;17;90;41;3;38;.927;3600000;0
832;196090;4838;27;15;4;11;.733;1084000;0
832;185743;4838;57;21;2;19;.905;2516000;0
833;170314;5;89;39;2;37;.949;3600000;0
833;175912;14;27;25;5;20;.800;3600000;0
833;201585;5;0;0;0;0;.00nan;0;0
833;185034;14;0;0;0;0;.00nan;0;0
834;193854;11;0;0;0;0;.00nan;0;0
834;183783;25;0;0;0;0;.00nan;0;0
834;191813;25;40;22;4;18;.818;3546000;0
834;146862;11;86;46;3;43;.935;3600000;0
835;187718;16;0;0;0;0;.00nan;0;0
835;174718;12;54;22;2;20;.909;3259000;0
835;50065;16;91;40;2;38;.950;3600000;0
835;85798;12;24;5;3;2;.400;341000;0
836;171838;31;0;0;0;0;.00nan;0;0
836;183859;23;0;0;0;0;.00nan;0;0
836;59540;23;73;29;2;27;.931;3600000;0
836;149452;31;32;27;5;22;.815;3600000;0
837;170314;5;0;0;0;0;.00nan;0;0
837;175092;9;53;35;5;30;.857;3600000;0
837;190106;9;0;0;0;0;.00nan;0;0
837;201585;5;100;30;0;30;1.000;3600000;0
838;676;24;0;0;0;0;.00nan;0;0
838;788;27;33;14;4;10;.714;1355000;0
838;171304;27;10;21;6;15;.714;2245000;0
838;86192;24;48;26;4;22;.846;3600000;0
839;163471;34;0;0;0;0;.00nan;0;0
839;183904;34;65;24;2;22;.917;3600000;0
839;139409;3;66;35;4;31;.886;3548000;0
839;148958;3;0;0;0;0;.00nan;0;0
840;172340;4182;72;41;4;37;.902;3600000;0
840;183844;29;89;28;1;27;.964;3600000;0
840;195089;29;0;0;0;0;.00nan;0;0
840;140314;4182;0;0;0;0;.00nan;0;0
841;556;33;87;36;3;33;.917;3600000;0
841;20432;28;0;0;0;0;.00nan;0;0
841;201174;28;34;34;6;28;.824;3600000;0
841;197038;33;0;0;0;0;.00nan;0;0
842;166591;15;64;23;2;21;.913;3600000;0
842;166646;0;78;35;3;32;.914;3577000;0
842;189333;0;0;0;0;0;.00nan;0;0
842;187362;15;0;0;0;0;.00nan;0;0
843;184229;35;67;30;2;28;.933;3580000;0
843;196090;4838;0;0;0;0;.00nan;0;0
843;185743;4838;79;24;1;23;.958;3600000;0
843;147977;35;0;0;0;0;.00nan;0;0
844;165723;32;0;0;0;0;.00nan;0;0
844;175912;14;99;39;1;38;.974;4006000;0
844;185034;14;0;0;0;0;.00nan;0;0
844;85727;32;94;41;2;39;.951;4006000;0
845;192733;18;60;25;3;22;.880;3600000;0
845;193854;11;63;38;4;34;.895;3596000;0
845;173727;18;0;0;0;0;.00nan;0;0
845;146862;11;0;0;0;0;.00nan;0;0
846;187578;26;0;0;0;0;.00nan;0;0
846;13714;8;85;17;0;17;1.000;3600000;0
846;179154;26;73;35;3;32;.914;3600000;0
846;58830;8;0;0;0;0;.00nan;0;0
847;187537;19;83;39;3;36;.923;3600000;0
847;178384;19;0;0;0;0;.00nan;0;0
847;194416;17;0;0;0;0;.00nan;0;0
847;178413;17;51;34;5;29;.853;3524000;0
848;3284;21;0;0;0;0;.00nan;0;0
848;174718;12;0;0;0;0;.00nan;0;0
848;182116;21;85;29;1;28;.966;3600000;0
848;85798;12;98;43;2;41;.953;3600000;0
849;187578;26;0;0;0;0;.00nan;0;0
849;179154;26;86;27;1;26;.963;3600000;0
849;196090;4838;0;0;0;0;.00nan;0;0
849;185743;4838;58;19;2;17;.895;3562000;0
850;165723;32;0;0;0;0;.00nan;0;0
850;183844;29;56;25;3;22;.880;3600000;0
850;195089;29;0;0;0;0;.00nan;0;0
850;85727;32;100;52;2;50;.962;3600000;0
851;192733;18;0;0;0;0;.00nan;0;0
851;194416;17;0;0;0;0;.00nan;0;0
851;178413;17;100;57;4;53;.930;4200000;0
851;173727;18;59;27;4;23;.852;4200000;0
852;788;27;57;22;3;19;.864;3600000;0
852;171838;31;51;32;4;28;.875;3552000;0
852;171304;27;0;0;0;0;.00nan;0;0
852;149452;31;0;0;0;0;.00nan;0;0
853;187718;16;36;30;6;24;.800;2617000;0
853;175092;9;0;0;0;0;.00nan;0;0
853;190106;9;51;33;5;28;.848;3600000;0
853;50065;16;65;15;1;14;.933;974000;0
854;13714;8;80;35;3;32;.914;3600000;0
854;184229;35;98;24;0;24;1.000;3600000;0
854;58830;8;0;0;0;0;.00nan;0;0
854;147977;35;0;0;0;0;.00nan;0;0
855;20432;28;98;36;2;34;.944;3577000;0
855;170314;5;0;0;0;0;.00nan;0;0
855;201174;28;0;0;0;0;.00nan;0;0
855;201585;5;76;22;1;21;.955;3600000;0
856;3928;20;73;35;3;32;.914;3562000;0
856;205824;20;0;0;0;0;.00nan;0;0
856;139409;3;86;32;2;30;.938;3600000;0
856;148958;3;0;0;0;0;.00nan;0;0
857;166646;0;32;23;5;18;.783;1884000;0
857;172340;4182;70;25;3;22;.880;3600000;0
857;189333;0;50;19;3;16;.842;1716000;0
857;140314;4182;0;0;0;0;.00nan;0;0
858;676;24;0;0;0;0;.00nan;0;0
858;166591;15;72;19;1;18;.947;3600000;0
858;187362;15;0;0;0;0;.00nan;0;0
858;86192;24;47;39;6;33;.846;3600000;0
859;187537;19;0;0;0;0;.00nan;0;0
859;183783;25;0;0;0;0;.00nan;0;0
859;178384;19;78;51;4;47;.922;3600000;0
859;191813;25;65;18;1;17;.944;3600000;0
860;193854;11;0;0;0;0;.00nan;0;0
860;173699;10;100;36;0;36;1.000;3600000;0
860;90164;10;0;0;0;0;.00nan;0;0
860;146862;11;78;31;3;28;.903;3600000;0
861;3284;21;89;31;1;30;.968;3600000;0
861;206789;30;46;35;5;30;.857;3600000;0
861;182116;21;0;0;0;0;.00nan;0;0
861;86697;30;0;0;0;0;.00nan;0;0
862;163471;34;0;0;0;0;.00nan;0;0
862;183904;34;50;25;3;22;.880;3600000;0
862;196005;22;0;0;0;0;.00nan;0;0
862;143473;22;92;37;2;35;.946;3600000;0
863;556;33;77;39;4;35;.897;3559000;0
863;174718;12;0;0;0;0;.00nan;0;0
863;197038;33;0;0;0;0;.00nan;0;0
863;85798;12;82;38;3;35;.921;3600000;0
864;788;27;0;0;0;0;.00nan;0;0
864;171304;27;56;29;3;26;.897;4112000;0
864;175912;14;0;0;0;0;.00nan;0;0
864;185034;14;69;28;2;26;.929;4112000;0
865;172340;4182;74;35;3;32;.914;3600000;0
865;175092;9;38;24;4;20;.833;3551000;0
865;190106;9;0;0;0;0;.00nan;0;0
865;140314;4182;0;0;0;0;.00nan;0;0
866;171838;31;0;0;0;0;.00nan;0;0
866;187578;26;0;0;0;0;.00nan;0;0
866;179154;26;31;28;6;22;.786;3600000;0
866;149452;31;100;33;0;33;1.000;3600000;0
867;166646;0;78;39;4;35;.897;3600000;0
867;189333;0;0;0;0;0;.00nan;0;0
867;184229;35;83;31;1;30;.968;3600000;0
867;147977;35;0;0;0;0;.00nan;0;0
868;187537;19;0;0;0;0;.00nan;0;0
868;187718;16;93;33;0;33;1.000;3075000;0
868;178384;19;56;32;4;28;.875;3670000;0
868;50065;16;34;8;3;5;.625;595000;0
869;194416;17;0;0;0;0;.00nan;0;0
869;178413;17;100;29;1;28;.966;3600000;0
869;183859;23;0;0;0;0;.00nan;0;0
869;59540;23;56;19;2;17;.895;3546000;0
870;174718;12;91;39;2;37;.949;3600000;0
870;196090;4838;0;0;0;0;.00nan;0;0
870;185743;4838;55;25;3;22;.880;3585000;0
870;85798;12;0;0;0;0;.00nan;0;0
871;192733;18;0;0;0;0;.00nan;0;0
871;183783;25;0;0;0;0;.00nan;0;0
871;173727;18;70;40;4;36;.900;3600000;0
871;191813;25;82;38;3;35;.921;3600000;0
872;193854;11;0;0;0;0;.00nan;0;0
872;206789;30;0;0;0;0;.00nan;0;0
872;86697;30;42;31;5;26;.839;3600000;0
872;146862;11;93;43;2;41;.953;3600000;0
873;3284;21;0;0;0;0;.00nan;0;0
873;165723;32;0;0;0;0;.00nan;0;0
873;182116;21;63;25;3;22;.880;3573000;0
873;85727;32;91;32;2;30;.938;3600000;0
874;183844;29;67;13;1;12;.923;3556000;0
874;20432;28;0;0;0;0;.00nan;0;0
874;195089;29;0;0;0;0;.00nan;0;0
874;201174;28;100;37;0;37;1.000;3600000;0
875;183844;29;0;0;0;0;.00nan;0;0
875;170314;5;82;29;1;28;.966;3600000;0
875;195089;29;62;21;2;19;.905;3582000;0
875;201585;5;0;0;0;0;.00nan;0;0
876;187578;26;94;37;1;36;.973;3600000;0
876;163471;34;0;0;0;0;.00nan;0;0
876;183904;34;77;31;3;28;.903;3509000;0
876;179154;26;0;0;0;0;.00nan;0;0
877;175912;14;80;29;1;28;.966;3579000;0
877;196005;22;0;0;0;0;.00nan;0;0
877;185034;14;0;0;0;0;.00nan;0;0
877;143473;22;86;15;0;15;1.000;3600000;0
878;676;24;0;0;0;0;.00nan;0;0
878;3928;20;58;34;4;30;.882;4200000;0
878;205824;20;0;0;0;0;.00nan;0;0
878;86192;24;75;43;4;39;.907;4200000;0
879;187718;16;0;0;0;0;.00nan;0;0
879;183783;25;0;0;0;0;.00nan;0;0
879;191813;25;62;35;4;31;.886;3600000;0
879;50065;16;100;38;1;37;.974;3600000;0
880;556;33;67;25;2;23;.920;3726000;0
880;187537;19;79;34;3;31;.912;3726000;0
880;178384;19;0;0;0;0;.00nan;0;0
880;197038;33;0;0;0;0;.00nan;0;0
881;13714;8;62;27;3;24;.889;3600000;0
881;206789;30;0;0;0;0;.00nan;0;0
881;58830;8;0;0;0;0;.00nan;0;0
881;86697;30;100;24;0;24;1.000;3600000;0
882;788;27;60;31;3;28;.903;3593000;0
882;173699;10;74;30;2;28;.933;3600000;0
882;171304;27;0;0;0;0;.00nan;0;0
882;90164;10;0;0;0;0;.00nan;0;0
883;175092;9;0;0;0;0;.00nan;0;0
883;190106;9;68;37;4;33;.892;3546000;0
883;139409;3;79;38;3;35;.921;3600000;0
883;148958;3;0;0;0;0;.00nan;0;0
884;166591;15;59;17;2;15;.882;3600000;0
884;165723;32;0;0;0;0;.00nan;0;0
884;187362;15;0;0;0;0;.00nan;0;0
884;85727;32;75;53;6;47;.887;3600000;0
885;172340;4182;60;32;3;29;.906;3600000;0
885;173699;10;0;0;0;0;.00nan;0;0
885;90164;10;67;37;5;32;.865;3542000;0
885;140314;4182;0;0;0;0;.00nan;0;0
886;166646;0;94;27;1;26;.963;3600000;0
886;189333;0;0;0;0;0;.00nan;0;0
886;174718;12;0;0;0;0;.00nan;0;0
886;85798;12;81;32;2;30;.938;3577000;0
887;171838;31;0;0;0;0;.00nan;0;0
887;196090;4838;0;0;0;0;.00nan;0;0
887;185743;4838;90;28;1;27;.964;3623000;0
887;149452;31;92;38;2;36;.947;3623000;0
888;3284;21;0;0;0;0;.00nan;0;0
888;170314;5;46;31;5;26;.839;3600000;0
888;201585;5;0;0;0;0;.00nan;0;0
888;182116;21;91;29;1;28;.966;3600000;0
889;556;33;55;37;4;33;.892;3556000;0
889;194416;17;0;0;0;0;.00nan;0;0
889;178413;17;63;29;3;26;.897;3600000;0
889;197038;33;0;0;0;0;.00nan;0;0
890;676;24;0;0;0;0;.00nan;0;0
890;163471;34;0;0;0;0;.00nan;0;0
890;183904;34;71;22;1;21;.955;3600000;0
890;86192;24;78;40;3;37;.925;3573000;0
891;187578;26;0;0;0;0;.00nan;0;0
891;183844;29;39;25;4;21;.840;3600000;0
891;195089;29;0;0;0;0;.00nan;0;0
891;179154;26;82;29;1;28;.966;3600000;0
892;175912;14;0;0;0;0;.00nan;0;0
892;185034;14;67;15;1;14;.933;3600000;0
892;139409;3;0;0;0;0;.00nan;0;0
892;148958;3;89;47;3;44;.936;3567000;0
893;3928;20;57;44;6;38;.864;2841000;0
893;20432;28;61;39;4;35;.897;3600000;0
893;205824;20;50;10;2;8;.800;759000;0
893;201174;28;0;0;0;0;.00nan;0;0
894;184229;35;16;32;8;24;.750;2925000;0
894;196005;22;0;0;0;0;.00nan;0;0
894;143473;22;68;19;1;18;.947;3600000;0
894;147977;35;44;5;1;4;.800;675000;0
895;192733;18;0;0;0;0;.00nan;0;0
895;171838;31;67;42;4;38;.905;3571000;0
895;173727;18;73;32;3;29;.906;3600000;0
895;149452;31;0;0;0;0;.00nan;0;0
896;187537;19;0;0;0;0;.00nan;0;0
896;178384;19;98;32;1;31;.969;3600000;0
896;183859;23;0;0;0;0;.00nan;0;0
896;59540;23;91;16;0;16;1.000;3600000;0
897;166646;0;96;38;2;36;.947;3600000;0
897;189333;0;0;0;0;0;.00nan;0;0
897;206789;30;0;0;0;0;.00nan;0;0
897;86697;30;59;24;3;21;.875;3600000;0
898;788;27;0;0;0;0;.00nan;0;0
898;13714;8;68;24;2;22;.917;3545000;0
898;171304;27;100;38;1;37;.974;3600000;0
898;58830;8;0;0;0;0;.00nan;0;0
899;173699;10;73;44;4;40;.909;3600000;0
899;175092;9;0;0;0;0;.00nan;0;0
899;190106;9;36;29;5;24;.828;3600000;0
899;90164;10;0;0;0;0;.00nan;0;0
900;165723;32;88;55;4;51;.927;3600000;0
900;183783;25;0;0;0;0;.00nan;0;0
900;191813;25;44;19;3;16;.842;3600000;0
900;85727;32;0;0;0;0;.00nan;0;0
901;187718;16;0;0;0;0;.00nan;0;0
901;196090;4838;0;0;0;0;.00nan;0;0
901;185743;4838;66;30;3;27;.900;3550000;0
901;50065;16;73;24;2;22;.917;3600000;0
902;676;24;0;0;0;0;.00nan;0;0
902;86192;24;84;53;5;48;.906;4200000;0
902;139409;3;32;24;5;19;.792;3334000;0
902;148958;3;54;2;0;2;1.000;866000;0
903;20432;28;72;55;6;49;.891;3600000;0
903;201174;28;0;0;0;0;.00nan;0;0
903;196005;22;73;11;0;11;1.000;3600000;0
903;143473;22;0;0;0;0;.00nan;0;0
904;166591;15;87;43;3;40;.930;3600000;0
904;163471;34;0;0;0;0;.00nan;0;0
904;183904;34;61;34;4;30;.882;3541000;0
904;187362;15;0;0;0;0;.00nan;0;0
905;3928;20;61;38;4;34;.895;3515000;0
905;170314;5;0;0;0;0;.00nan;0;0
905;205824;20;0;0;0;0;.00nan;0;0
905;201585;5;76;26;2;24;.923;3600000;0
906;187578;26;64;20;2;18;.900;3600000;0
906;3284;21;0;0;0;0;.00nan;0;0
906;179154;26;0;0;0;0;.00nan;0;0
906;182116;21;83;40;3;37;.925;3570000;0
907;556;33;60;20;2;18;.900;3552000;0
907;166646;0;100;39;0;39;1.000;3600000;0
907;189333;0;0;0;0;0;.00nan;0;0
907;197038;33;0;0;0;0;.00nan;0;0
908;194416;17;0;0;0;0;.00nan;0;0
908;178413;17;69;25;2;23;.920;3600000;0
908;184229;35;25;7;3;4;.571;304000;0
908;147977;35;66;34;3;31;.912;3296000;0
909;183844;29;46;20;4;16;.800;3514000;0
909;195089;29;0;0;0;0;.00nan;0;0
909;206789;30;0;0;0;0;.00nan;0;0
909;86697;30;87;36;2;34;.944;3600000;0
910;171838;31;0;0;0;0;.00nan;0;0
910;187537;19;0;0;0;0;.00nan;0;0
910;178384;19;63;31;3;28;.903;3536000;0
910;149452;31;100;41;1;40;.976;3600000;0
911;192733;18;0;0;0;0;.00nan;0;0
911;173727;18;64;28;3;25;.893;3600000;0
911;196090;4838;69;41;4;37;.902;3600000;0
911;185743;4838;0;0;0;0;.00nan;0;0
912;187718;16;0;0;0;0;.00nan;0;0
912;183859;23;0;0;0;0;.00nan;0;0
912;50065;16;78;30;1;29;.967;3600000;0
912;59540;23;65;23;2;21;.913;3563000;0
913;193854;11;0;0;0;0;.00nan;0;0
913;13714;8;90;37;2;35;.946;3884000;0
913;58830;8;0;0;0;0;.00nan;0;0
913;146862;11;81;35;3;32;.914;3884000;0
914;788;27;96;40;2;38;.950;3600000;0
914;172340;4182;63;15;1;14;.933;3600000;0
914;171304;27;0;0;0;0;.00nan;0;0
914;140314;4182;0;0;0;0;.00nan;0;0
915;676;24;94;38;1;37;.974;3913000;0
915;20432;28;0;0;0;0;.00nan;0;0
915;201174;28;100;30;0;30;1.000;3913000;0
915;86192;24;0;0;0;0;.00nan;0;0
916;166591;15;83;39;4;35;.897;3888000;0
916;175912;14;77;47;3;44;.936;3888000;0
916;185034;14;0;0;0;0;.00nan;0;0
916;187362;15;0;0;0;0;.00nan;0;0
917;3284;21;77;29;2;27;.931;3600000;0
917;175092;9;25;27;6;21;.778;1806000;0
917;190106;9;41;11;2;9;.818;1794000;0
917;182116;21;0;0;0;0;.00nan;0;0
918;163471;34;72;33;3;30;.909;3517000;0
918;183904;34;0;0;0;0;.00nan;0;0
918;173699;10;0;0;0;0;.00nan;0;0
918;90164;10;83;28;1;27;.964;3600000;0
919;165723;32;0;0;0;0;.00nan;0;0
919;194416;17;84;25;1;24;.960;3600000;0
919;178413;17;0;0;0;0;.00nan;0;0
919;85727;32;62;37;4;33;.892;3600000;0
920;183783;25;0;0;0;0;.00nan;0;0
920;174718;12;0;0;0;0;.00nan;0;0
920;191813;25;89;20;0;20;1.000;3600000;0
920;85798;12;66;53;6;47;.887;3600000;0
921;172340;4182;0;0;0;0;.00nan;0;0
921;13714;8;0;0;0;0;.00nan;0;0
921;58830;8;99;36;1;35;.972;3600000;0
921;140314;4182;47;24;4;20;.833;3600000;0
922;3928;20;0;0;0;0;.00nan;0;0
922;183844;29;99;35;1;34;.971;3600000;0
922;195089;29;0;0;0;0;.00nan;0;0
922;205824;20;73;32;3;29;.906;3552000;0
923;187578;26;62;14;1;13;.929;755000;0
923;179154;26;44;36;6;30;.833;2845000;0
923;196005;22;0;0;0;0;.00nan;0;0
923;143473;22;63;15;1;14;.933;3600000;0
924;788;27;0;0;0;0;.00nan;0;0
924;171304;27;72;29;2;27;.931;3600000;0
924;196090;4838;0;0;0;0;.00nan;0;0
924;185743;4838;52;29;3;26;.897;3569000;0
925;171838;31;0;0;0;0;.00nan;0;0
925;183859;23;0;0;0;0;.00nan;0;0
925;59540;23;77;11;0;11;1.000;3600000;0
925;149452;31;71;56;6;50;.893;3600000;0
926;3928;20;60;46;5;41;.891;3546000;0
926;194416;17;0;0;0;0;.00nan;0;0
926;178413;17;59;33;4;29;.879;3600000;0
926;205824;20;0;0;0;0;.00nan;0;0
927;170314;5;68;31;3;28;.903;3815000;0
927;175092;9;0;0;0;0;.00nan;0;0
927;190106;9;84;36;2;34;.944;3815000;0
927;201585;5;0;0;0;0;.00nan;0;0
928;174718;12;0;0;0;0;.00nan;0;0
928;85798;12;35;27;5;22;.815;3561000;0
928;139409;3;62;27;3;24;.889;3600000;0
928;148958;3;0;0;0;0;.00nan;0;0
929;166591;15;86;18;0;18;1.000;3600000;0
929;20432;28;25;11;4;7;.636;964000;0
929;201174;28;97;52;1;51;.981;2636000;0
929;187362;15;0;0;0;0;.00nan;0;0
930;166646;0;93;45;3;42;.933;3542000;0
930;189333;0;0;0;0;0;.00nan;0;0
930;206789;30;0;0;0;0;.00nan;0;0
930;86697;30;97;41;1;40;.976;3600000;0
931;3284;21;0;0;0;0;.00nan;0;0
931;187718;16;0;0;0;0;.00nan;0;0
931;182116;21;57;16;2;14;.875;3600000;0
931;50065;16;89;31;1;30;.968;3600000;0
932;13714;8;88;34;2;32;.941;3600000;0
932;183844;29;0;0;0;0;.00nan;0;0
932;195089;29;49;32;4;28;.875;3600000;0
932;58830;8;0;0;0;0;.00nan;0;0
933;183783;25;0;0;0;0;.00nan;0;0
933;184229;35;94;40;2;38;.950;3600000;0
933;191813;25;55;24;3;21;.875;3569000;0
933;147977;35;0;0;0;0;.00nan;0;0
934;192733;18;0;0;0;0;.00nan;0;0
934;788;27;77;50;5;45;.900;3600000;0
934;173727;18;49;13;2;11;.846;3600000;0
934;171304;27;0;0;0;0;.00nan;0;0
935;556;33;65;24;2;22;.917;3600000;0
935;187578;26;51;27;4;23;.852;3564000;0
935;179154;26;0;0;0;0;.00nan;0;0
935;197038;33;0;0;0;0;.00nan;0;0
936;187537;19;0;0;0;0;.00nan;0;0
936;178384;19;75;40;4;36;.900;3678000;0
936;175912;14;0;0;0;0;.00nan;0;0
936;185034;14;55;23;3;20;.870;3678000;0
937;676;24;91;44;2;42;.955;3556000;0
937;193854;11;0;0;0;0;.00nan;0;0
937;86192;24;0;0;0;0;.00nan;0;0
937;146862;11;89;18;0;18;1.000;3600000;0
938;163471;34;0;0;0;0;.00nan;0;0
938;183904;34;80;19;1;18;.947;3600000;0
938;173699;10;0;0;0;0;.00nan;0;0
938;90164;10;54;35;5;30;.857;3600000;0
939;184229;35;0;0;0;0;.00nan;0;0
939;196090;4838;0;0;0;0;.00nan;0;0
939;185743;4838;69;26;2;24;.923;3600000;0
939;147977;35;47;27;4;23;.852;3530000;0
940;171838;31;91;43;3;40;.930;4037000;0
940;206789;30;0;0;0;0;.00nan;0;0
940;86697;30;65;38;4;34;.895;4037000;0
940;149452;31;0;0;0;0;.00nan;0;0
941;3284;21;0;0;0;0;.00nan;0;0
941;173699;10;88;53;3;50;.943;3600000;0
941;182116;21;43;36;5;31;.861;3513000;0
941;90164;10;0;0;0;0;.00nan;0;0
942;194416;17;0;0;0;0;.00nan;0;0
942;178413;17;59;39;5;34;.872;3600000;0
942;196005;22;0;0;0;0;.00nan;0;0
942;143473;22;74;22;1;21;.955;3600000;0
943;170314;5;74;27;2;25;.926;3600000;0
943;201585;5;0;0;0;0;.00nan;0;0
943;139409;3;54;41;6;35;.854;3600000;0
943;148958;3;0;0;0;0;.00nan;0;0
944;20432;28;0;0;0;0;.00nan;0;0
944;201174;28;100;31;0;31;1.000;3600000;0
944;175092;9;0;0;0;0;.00nan;0;0
944;190106;9;72;40;4;36;.900;3600000;0
945;166646;0;0;0;0;0;.00nan;0;0
945;189333;0;63;25;3;22;.880;3600000;0
945;174718;12;0;0;0;0;.00nan;0;0
945;85798;12;59;34;4;30;.882;3554000;0
946;187578;26;79;47;4;43;.915;3600000;0
946;183783;25;0;0;0;0;.00nan;0;0
946;179154;26;0;0;0;0;.00nan;0;0
946;191813;25;58;14;2;12;.857;3600000;0
947;187718;16;0;0;0;0;.00nan;0;0
947;13714;8;56;33;4;29;.879;4200000;0
947;50065;16;58;31;4;27;.871;4200000;0
947;58830;8;0;0;0;0;.00nan;0;0
948;556;33;75;29;2;27;.931;4200000;0
948;165723;32;0;0;0;0;.00nan;0;0
948;197038;33;0;0;0;0;.00nan;0;0
948;85727;32;81;37;2;35;.946;4200000;0
949;183859;23;0;0;0;0;.00nan;0;0
949;175912;14;57;26;3;23;.885;3518000;0
949;185034;14;0;0;0;0;.00nan;0;0
949;59540;23;99;42;1;41;.976;3600000;0
950;788;27;71;30;2;28;.933;3600000;0
950;187537;19;0;0;0;0;.00nan;0;0
950;178384;19;70;34;3;31;.912;3580000;0
950;171304;27;0;0;0;0;.00nan;0;0
951;172340;4182;91;38;2;36;.947;3600000;0
951;193854;11;0;0;0;0;.00nan;0;0
951;140314;4182;0;0;0;0;.00nan;0;0
951;146862;11;86;23;1;22;.957;3600000;0
952;183844;29;70;23;1;22;.957;3600000;0
952;195089;29;0;0;0;0;.00nan;0;0
952;174718;12;0;0;0;0;.00nan;0;0
952;85798;12;68;38;4;34;.895;3600000;0
953;166591;15;60;18;2;16;.889;3600000;0
953;3928;20;89;47;3;44;.936;3548000;0
953;205824;20;0;0;0;0;.00nan;0;0
953;187362;15;0;0;0;0;.00nan;0;0
954;676;24;0;0;0;0;.00nan;0;0
954;172340;4182;100;44;1;43;.977;3861000;0
954;86192;24;72;28;2;26;.929;3861000;0
954;140314;4182;0;0;0;0;.00nan;0;0
955;3284;21;0;0;0;0;.00nan;0;0
955;183783;25;0;0;0;0;.00nan;0;0
955;182116;21;88;39;2;37;.949;3600000;0
955;191813;25;96;29;1;28;.966;3600000;0
956;171838;31;0;0;0;0;.00nan;0;0
956;196005;22;0;0;0;0;.00nan;0;0
956;143473;22;72;23;1;22;.957;3600000;0
956;149452;31;42;36;6;30;.833;3600000;0
957;183859;23;0;0;0;0;.00nan;0;0
957;196090;4838;0;0;0;0;.00nan;0;0
957;185743;4838;45;22;3;19;.864;3600000;0
957;59540;23;77;34;2;32;.941;3600000;0
958;556;33;78;48;4;44;.917;3600000;0
958;13714;8;72;23;2;21;.913;3600000;0
958;197038;33;0;0;0;0;.00nan;0;0
958;58830;8;0;0;0;0;.00nan;0;0
959;175092;9;88;44;4;40;.909;4115000;0
959;190106;9;0;0;0;0;.00nan;0;0
959;206789;30;0;0;0;0;.00nan;0;0
959;86697;30;62;36;5;31;.861;4115000;0
960;194416;17;0;0;0;0;.00nan;0;0
960;178413;17;90;23;1;22;.957;3600000;0
960;170314;5;0;0;0;0;.00nan;0;0
960;201585;5;64;35;4;31;.886;3600000;0
961;166591;15;0;0;0;0;.00nan;0;0
961;183844;29;75;28;2;26;.929;3060000;0
961;195089;29;30;18;4;14;.778;540000;0
961;187362;15;59;14;1;13;.929;3600000;0
962;20432;28;65;29;3;26;.897;3562000;0
962;201174;28;0;0;0;0;.00nan;0;0
962;139409;3;98;33;1;32;.970;3600000;0
962;148958;3;0;0;0;0;.00nan;0;0
963;166646;0;58;31;4;27;.871;3600000;0
963;163471;34;0;0;0;0;.00nan;0;0
963;183904;34;67;27;3;24;.889;3600000;0
963;189333;0;0;0;0;0;.00nan;0;0
964;165723;32;0;0;0;0;.00nan;0;0
964;173699;10;0;0;0;0;.00nan;0;0
964;85727;32;90;41;2;39;.951;3556000;0
964;90164;10;91;29;1;28;.966;3600000;0
965;187578;26;0;0;0;0;.00nan;0;0
965;193854;11;0;0;0;0;.00nan;0;0
965;179154;26;100;45;1;44;.978;3600000;0
965;146862;11;55;19;3;16;.842;3554000;0
966;187718;16;0;0;0;0;.00nan;0;0
966;184229;35;76;30;2;28;.933;3600000;0
966;50065;16;71;31;3;28;.903;3556000;0
966;147977;35;0;0;0;0;.00nan;0;0
967;192733;18;0;0;0;0;.00nan;0;0
967;173727;18;94;38;2;36;.947;3600000;0
967;175912;14;47;27;4;23;.852;3600000;0
967;185034;14;0;0;0;0;.00nan;0;0
968;3928;20;47;27;4;23;.852;3551000;0
968;205824;20;0;0;0;0;.00nan;0;0
968;174718;12;0;0;0;0;.00nan;0;0
968;85798;12;99;60;3;57;.950;3600000;0
969;676;24;0;0;0;0;.00nan;0;0
969;788;27;0;0;0;0;.00nan;0;0
969;171304;27;73;21;1;20;.952;3600000;0
969;86192;24;61;33;4;29;.879;3600000;0
970;183783;25;0;0;0;0;.00nan;0;0
970;175092;9;0;0;0;0;.00nan;0;0
970;190106;9;65;31;3;28;.903;3551000;0
970;191813;25;72;29;2;27;.931;3600000;0
971;187718;16;61;17;1;16;.941;3600000;0
971;193854;11;43;24;4;20;.833;3600000;0
971;50065;16;0;0;0;0;.00nan;0;0
971;146862;11;0;0;0;0;.00nan;0;0
972;187537;19;0;0;0;0;.00nan;0;0
972;172340;4182;100;28;0;28;1.000;3600000;0
972;178384;19;86;42;2;40;.952;3564000;0
972;140314;4182;0;0;0;0;.00nan;0;0
973;175912;14;0;0;0;0;.00nan;0;0
973;196090;4838;88;42;4;38;.905;3600000;0
973;185034;14;46;30;5;25;.833;3543000;0
973;185743;4838;0;0;0;0;.00nan;0;0
974;173699;10;100;47;1;46;.979;3600000;0
974;206789;30;0;0;0;0;.00nan;0;0
974;86697;30;69;30;3;27;.900;3558000;0
974;90164;10;0;0;0;0;.00nan;0;0
975;163471;34;0;0;0;0;.00nan;0;0
975;183904;34;67;16;1;15;.938;3600000;0
975;170314;5;44;34;5;29;.853;3600000;0
975;201585;5;0;0;0;0;.00nan;0;0
976;166591;15;66;36;4;32;.889;3825000;0
976;184229;35;32;11;3;8;.727;526000;0
976;187362;15;0;0;0;0;.00nan;0;0
976;147977;35;62;25;2;23;.920;3299000;0
977;171838;31;0;0;0;0;.00nan;0;0
977;166646;0;65;38;5;33;.868;3566000;0
977;189333;0;0;0;0;0;.00nan;0;0
977;149452;31;59;30;4;26;.867;3600000;0
978;556;33;0;0;0;0;.00nan;0;0
978;165723;32;0;0;0;0;.00nan;0;0
978;197038;33;51;29;4;25;.862;3828000;0
978;85727;32;100;49;3;46;.939;3828000;0
979;192733;18;60;21;3;18;.857;3554000;0
979;183859;23;0;0;0;0;.00nan;0;0
979;173727;18;0;0;0;0;.00nan;0;0
979;59540;23;82;25;1;24;.960;3600000;0
980;171838;31;83;48;4;44;.917;3600000;0
980;196090;4838;0;0;0;0;.00nan;0;0
980;185743;4838;49;18;2;16;.889;3600000;0
980;149452;31;0;0;0;0;.00nan;0;0
981;676;24;0;0;0;0;.00nan;0;0
981;170314;5;0;0;0;0;.00nan;0;0
981;201585;5;47;19;3;16;.842;4150000;0
981;86192;24;82;37;2;35;.946;4150000;0
982;173699;10;0;0;0;0;.00nan;0;0
982;175912;14;67;22;2;20;.909;3600000;0
982;185034;14;0;0;0;0;.00nan;0;0
982;90164;10;56;35;4;31;.886;3600000;0
983;184229;35;53;45;6;39;.867;3600000;0
983;196005;22;0;0;0;0;.00nan;0;0
983;143473;22;67;18;2;16;.889;3600000;0
983;147977;35;0;0;0;0;.00nan;0;0
984;13714;8;45;19;3;16;.842;3598000;0
984;58830;8;0;0;0;0;.00nan;0;0
984;139409;3;90;32;1;31;.969;3600000;0
984;148958;3;0;0;0;0;.00nan;0;0
985;183783;25;0;0;0;0;.00nan;0;0
985;183859;23;90;50;4;46;.920;3600000;0
985;191813;25;49;18;3;15;.833;3600000;0
985;59540;23;0;0;0;0;.00nan;0;0
986;165723;32;37;33;6;27;.818;3172000;0
986;174718;12;0;0;0;0;.00nan;0;0
986;85727;32;48;6;1;5;.833;428000;0
986;85798;12;64;24;2;22;.917;3600000;0
987;788;27;50;23;3;20;.870;3600000;0
987;187537;19;0;0;0;0;.00nan;0;0
987;178384;19;68;38;4;34;.895;3561000;0
987;171304;27;0;0;0;0;.00nan;0;0
988;187578;26;0;0;0;0;.00nan;0;0
988;193854;11;0;0;0;0;.00nan;0;0
988;179154;26;56;31;3;28;.903;4138000;0
988;146862;11;80;28;2;26;.929;4138000;0
989;166646;0;91;38;1;37;.974;3600000;0
989;189333;0;0;0;0;0;.00nan;0;0
989;175092;9;0;0;0;0;.00nan;0;0
989;190106;9;67;24;3;21;.875;3600000;0
990;556;33;100;28;0;28;1.000;3600000;0
990;194416;17;0;0;0;0;.00nan;0;0
990;178413;17;51;26;4;22;.846;3600000;0
990;197038;33;0;0;0;0;.00nan;0;0
991;172340;4182;68;26;2;24;.923;3600000;0
991;183844;29;66;30;3;27;.900;3600000;0
991;195089;29;0;0;0;0;.00nan;0;0
991;140314;4182;0;0;0;0;.00nan;0;0
992;171838;31;0;0;0;0;.00nan;0;0
992;166646;0;0;0;0;0;.00nan;0;0
992;189333;0;83;39;3;36;.923;4104000;0
992;149452;31;89;34;2;32;.941;4104000;0
993;3284;21;0;0;0;0;.00nan;0;0
993;182116;21;62;34;5;29;.853;3901000;0
993;139409;3;71;43;4;39;.907;3860000;0
993;148958;3;0;0;0;0;.00nan;0;0
994;173699;10;100;28;0;28;1.000;3600000;0
994;196090;4838;0;0;0;0;.00nan;0;0
994;185743;4838;36;20;4;16;.800;3600000;0
994;90164;10;0;0;0;0;.00nan;0;0
995;166591;15;78;24;1;23;.958;3600000;0
995;170314;5;38;33;6;27;.818;3600000;0
995;201585;5;0;0;0;0;.00nan;0;0
995;187362;15;0;0;0;0;.00nan;0;0
996;676;24;0;0;0;0;.00nan;0;0
996;184229;35;52;17;2;15;.882;3600000;0
996;86192;24;68;40;5;35;.875;3600000;0
996;147977;35;0;0;0;0;.00nan;0;0
997;3928;20;70;39;4;35;.897;3600000;0
997;205824;20;0;0;0;0;.00nan;0;0
997;175912;14;0;0;0;0;.00nan;0;0
997;185034;14;83;25;1;24;.960;3600000;0
998;192733;18;0;0;0;0;.00nan;0;0
998;20432;28;0;0;0;0;.00nan;0;0
998;173727;18;49;15;2;13;.867;3600000;0
998;201174;28;72;44;5;39;.886;3600000;0
999;13714;8;89;18;0;18;1.000;3600000;0
999;175092;9;59;41;5;36;.878;3600000;0
999;190106;9;0;0;0;0;.00nan;0;0
999;58830;8;0;0;0;0;.00nan;0;0
1000;187718;16;0;0;0;0;.00nan;0;0
1000;174718;12;0;0;0;0;.00nan;0;0
1000;50065;16;91;28;1;27;.964;3600000;0
1000;85798;12;74;36;3;33;.917;3562000;0
1001;187537;19;0;0;0;0;.00nan;0;0
1001;178384;19;82;26;1;25;.962;3600000;0
1001;206789;30;54;35;4;31;.886;3600000;0
1001;86697;30;0;0;0;0;.00nan;0;0
1002;788;27;0;0;0;0;.00nan;0;0
1002;183844;29;0;0;0;0;.00nan;0;0
1002;195089;29;73;23;1;22;.957;3600000;0
1002;171304;27;69;39;3;36;.923;3562000;0
1003;193854;11;0;0;0;0;.00nan;0;0
1003;196005;22;0;0;0;0;.00nan;0;0
1003;143473;22;56;23;3;20;.870;3600000;0
1003;146862;11;80;53;5;48;.906;3571000;0
1004;194416;17;0;0;0;0;.00nan;0;0
1004;178413;17;47;24;4;20;.833;3600000;0
1004;174718;12;53;4;0;4;1.000;331000;0
1004;85798;12;25;26;6;20;.769;3208000;0
1005;556;33;67;26;2;24;.923;3600000;0
1005;187718;16;8;10;5;5;.500;1045000;0
1005;197038;33;0;0;0;0;.00nan;0;0
1005;50065;16;52;30;5;25;.833;2555000;0
1006;187578;26;0;0;0;0;.00nan;0;0
1006;172340;4182;70;27;2;25;.926;3583000;0
1006;179154;26;100;38;0;38;1.000;3600000;0
1006;140314;4182;0;0;0;0;.00nan;0;0
1007;183783;25;0;0;0;0;.00nan;0;0
1007;183859;23;0;0;0;0;.00nan;0;0
1007;191813;25;82;13;0;13;1.000;3600000;0
1007;59540;23;86;45;3;42;.933;3600000;0
1008;175092;9;0;0;0;0;.00nan;0;0
1008;190106;9;87;42;3;39;.929;3600000;0
1008;196090;4838;0;0;0;0;.00nan;0;0
1008;185743;4838;44;27;5;22;.815;3516000;0
1009;13714;8;75;20;1;19;.950;3600000;0
1009;173699;10;74;48;5;43;.896;3600000;0
1009;58830;8;0;0;0;0;.00nan;0;0
1009;90164;10;0;0;0;0;.00nan;0;0
1010;676;24;0;0;0;0;.00nan;0;0
1010;3284;21;0;0;0;0;.00nan;0;0
1010;182116;21;78;32;3;29;.906;3890000;0
1010;86192;24;62;39;4;35;.897;3890000;0
1011;171838;31;0;0;0;0;.00nan;0;0
1011;175912;14;0;0;0;0;.00nan;0;0
1011;185034;14;69;24;2;22;.917;3548000;0
1011;149452;31;99;40;1;39;.975;3600000;0
1012;192733;18;0;0;0;0;.00nan;0;0
1012;173727;18;98;37;1;36;.973;4200000;0
1012;170314;5;95;38;1;37;.974;4200000;0
1012;201585;5;0;0;0;0;.00nan;0;0
1013;166646;0;80;25;1;24;.960;3600000;0
1013;189333;0;0;0;0;0;.00nan;0;0
1013;139409;3;48;30;5;25;.833;3600000;0
1013;148958;3;0;0;0;0;.00nan;0;0
1014;193854;11;0;0;0;0;.00nan;0;0
1014;183844;29;100;36;0;36;1.000;3600000;0
1014;195089;29;0;0;0;0;.00nan;0;0
1014;146862;11;74;22;1;21;.955;3579000;0
1015;166591;15;72;20;1;19;.950;3600000;0
1015;20432;28;98;59;2;57;.966;3553000;0
1015;201174;28;0;0;0;0;.00nan;0;0
1015;187362;15;0;0;0;0;.00nan;0;0
1016;3928;20;96;35;1;34;.971;3600000;0
1016;165723;32;56;31;5;26;.839;3600000;0
1016;205824;20;0;0;0;0;.00nan;0;0
1016;85727;32;0;0;0;0;.00nan;0;0
1017;163471;34;0;0;0;0;.00nan;0;0
1017;183904;34;44;26;4;22;.846;4200000;0
1017;184229;35;88;54;4;50;.926;4200000;0
1017;147977;35;0;0;0;0;.00nan;0;0
1018;187537;19;75;27;2;25;.926;3562000;0
1018;183783;25;0;0;0;0;.00nan;0;0
1018;178384;19;0;0;0;0;.00nan;0;0
1018;191813;25;66;16;1;15;.938;3600000;0
1019;194416;17;0;0;0;0;.00nan;0;0
1019;178413;17;65;24;3;21;.875;3735000;0
1019;206789;30;0;0;0;0;.00nan;0;0
1019;86697;30;74;31;2;29;.935;3724000;0
1020;788;27;34;38;7;31;.816;2603000;0
1020;187578;26;0;0;0;0;.00nan;0;0
1020;171304;27;63;9;0;9;1.000;997000;0
1020;179154;26;60;23;3;20;.870;3600000;0
1021;175912;14;84;34;2;32;.941;3600000;0
1021;196090;4838;59;35;4;31;.886;3551000;0
1021;185034;14;0;0;0;0;.00nan;0;0
1021;185743;4838;0;0;0;0;.00nan;0;0
1022;187718;16;0;0;0;0;.00nan;0;0
1022;13714;8;99;34;1;33;.971;3600000;0
1022;50065;16;45;35;5;30;.857;3600000;0
1022;58830;8;0;0;0;0;.00nan;0;0
1023;192733;18;58;26;4;22;.846;3600000;0
1023;3284;21;46;33;5;28;.848;3600000;0
1023;173727;18;0;0;0;0;.00nan;0;0
1023;182116;21;0;0;0;0;.00nan;0;0
1024;165723;32;0;0;0;0;.00nan;0;0
1024;174718;12;0;0;0;0;.00nan;0;0
1024;85727;32;80;35;3;32;.914;3600000;0
1024;85798;12;40;36;6;30;.833;3600000;0
1025;172340;4182;92;47;2;45;.957;3551000;0
1025;196005;22;0;0;0;0;.00nan;0;0
1025;140314;4182;0;0;0;0;.00nan;0;0
1025;143473;22;87;31;1;30;.968;3600000;0
1026;171838;31;0;0;0;0;.00nan;0;0
1026;184229;35;84;30;1;29;.967;3600000;0
1026;147977;35;0;0;0;0;.00nan;0;0
1026;149452;31;88;42;2;40;.952;3546000;0
1027;676;24;59;26;3;23;.885;2514000;0
1027;163471;34;0;0;0;0;.00nan;0;0
1027;183904;34;73;19;1;18;.947;3600000;0
1027;86192;24;38;19;4;15;.789;1086000;0
1028;3928;20;73;60;6;54;.900;3600000;0
1028;183783;25;59;19;3;16;.842;3600000;0
1028;205824;20;0;0;0;0;.00nan;0;0
1028;191813;25;0;0;0;0;.00nan;0;0
1029;788;27;0;0;0;0;.00nan;0;0
1029;171304;27;74;48;5;43;.896;3600000;0
1029;196005;22;2;13;6;7;.538;3297000;0
1029;143473;22;48;0;0;0;.00nan;285000;0
1030;194416;17;0;0;0;0;.00nan;0;0
1030;178413;17;82;34;2;32;.941;3600000;0
1030;175092;9;0;0;0;0;.00nan;0;0
1030;190106;9;59;32;4;28;.875;3527000;0
1031;3284;21;0;0;0;0;.00nan;0;0
1031;163471;34;71;17;1;16;.941;3600000;0
1031;183904;34;0;0;0;0;.00nan;0;0
1031;182116;21;55;46;7;39;.848;3600000;0
1032;173699;10;0;0;0;0;.00nan;0;0
1032;90164;10;86;35;1;34;.971;4145000;0
1032;139409;3;94;44;2;42;.955;4145000;0
1032;148958;3;0;0;0;0;.00nan;0;0
1033;183844;29;66;35;3;32;.914;4123000;0
1033;195089;29;0;0;0;0;.00nan;0;0
1033;175912;14;0;0;0;0;.00nan;0;0
1033;185034;14;62;33;4;29;.879;4123000;0
1034;166591;15;73;27;2;25;.926;4200000;0
1034;193854;11;0;0;0;0;.00nan;0;0
1034;187362;15;0;0;0;0;.00nan;0;0
1034;146862;11;100;57;2;55;.965;4200000;0
1035;187578;26;0;0;0;0;.00nan;0;0
1035;170314;5;70;30;3;27;.900;3553000;0
1035;179154;26;88;28;2;26;.929;3600000;0
1035;201585;5;0;0;0;0;.00nan;0;0
1036;187718;16;0;0;0;0;.00nan;0;0
1036;174718;12;0;0;0;0;.00nan;0;0
1036;50065;16;100;20;0;20;1.000;3600000;0
1036;85798;12;98;47;2;45;.957;3600000;0
1037;172340;4182;77;25;2;23;.920;3600000;0
1037;165723;32;47;27;4;23;.852;3526000;0
1037;85727;32;0;0;0;0;.00nan;0;0
1037;140314;4182;0;0;0;0;.00nan;0;0
1038;192733;18;0;0;0;0;.00nan;0;0
1038;556;33;87;58;5;53;.914;3561000;0
1038;173727;18;45;19;3;16;.842;3600000;0
1038;197038;33;0;0;0;0;.00nan;0;0
1039;183859;23;0;0;0;0;.00nan;0;0
1039;206789;30;0;0;0;0;.00nan;0;0
1039;59540;23;95;30;1;29;.967;3600000;0
1039;86697;30;71;31;3;28;.903;3517000;0
1040;788;27;77;35;3;32;.914;3600000;0
1040;184229;35;0;0;0;0;.00nan;0;0
1040;171304;27;0;0;0;0;.00nan;0;0
1040;147977;35;82;40;4;36;.900;3565000;0
1041;13714;8;89;50;4;46;.920;3600000;0
1041;183783;25;0;0;0;0;.00nan;0;0
1041;191813;25;77;11;0;11;1.000;3600000;0
1041;58830;8;0;0;0;0;.00nan;0;0
1042;3928;20;47;39;6;33;.846;2987000;0
1042;205824;20;50;1;0;1;1.000;613000;0
1042;196090;4838;0;0;0;0;.00nan;0;0
1042;185743;4838;87;32;1;31;.969;3600000;0
1043;556;33;0;0;0;0;.00nan;0;0
1043;187537;19;0;0;0;0;.00nan;0;0
1043;178384;19;52;15;2;13;.867;3600000;0
1043;197038;33;76;46;3;43;.935;3554000;0
1044;175092;9;96;64;4;60;.938;3589000;0
1044;190106;9;0;0;0;0;.00nan;0;0
1044;196005;22;0;0;0;0;.00nan;0;0
1044;143473;22;43;18;3;15;.833;3600000;0
1045;3284;21;0;0;0;0;.00nan;0;0
1045;170314;5;0;0;0;0;.00nan;0;0
1045;201585;5;71;28;3;25;.893;3600000;0
1045;182116;21;42;33;6;27;.818;3600000;0
1046;183844;29;56;32;4;28;.875;3600000;0
1046;173699;10;32;37;7;30;.811;3600000;0
1046;195089;29;0;0;0;0;.00nan;0;0
1046;90164;10;0;0;0;0;.00nan;0;0
1047;194416;17;0;0;0;0;.00nan;0;0
1047;178413;17;40;27;5;22;.815;3800000;0
1047;174718;12;0;0;0;0;.00nan;0;0
1047;85798;12;64;51;6;45;.882;3800000;0
1048;171838;31;0;0;0;0;.00nan;0;0
1048;139409;3;74;28;2;26;.929;3600000;0
1048;148958;3;0;0;0;0;.00nan;0;0
1048;149452;31;64;44;5;39;.886;3600000;0
1049;166591;15;52;21;3;18;.857;3548000;0
1049;166646;0;91;40;2;38;.950;3600000;0
1049;189333;0;0;0;0;0;.00nan;0;0
1049;187362;15;0;0;0;0;.00nan;0;0
1050;193854;11;0;0;0;0;.00nan;0;0
1050;175912;14;82;29;1;28;.966;3600000;0
1050;185034;14;0;0;0;0;.00nan;0;0
1050;146862;11;66;24;2;22;.917;3556000;0
1051;163471;34;0;0;0;0;.00nan;0;0
1051;183904;34;45;16;3;13;.813;3600000;0
1051;20432;28;0;0;0;0;.00nan;0;0
1051;201174;28;83;46;4;42;.913;3585000;0
1052;676;24;0;0;0;0;.00nan;0;0
1052;187578;26;0;0;0;0;.00nan;0;0
1052;179154;26;48;24;4;20;.833;3559000;0
1052;86192;24;99;53;3;50;.943;3600000;0
1053;187718;16;0;0;0;0;.00nan;0;0
1053;172340;4182;45;33;6;27;.818;3600000;0
1053;50065;16;86;31;2;29;.935;3600000;0
1053;140314;4182;0;0;0;0;.00nan;0;0
1054;192733;18;0;0;0;0;.00nan;0;0
1054;173727;18;100;22;0;22;1.000;3600000;0
1054;206789;30;0;0;0;0;.00nan;0;0
1054;86697;30;65;36;4;32;.889;3600000;0
1055;3928;20;100;38;0;38;1.000;3600000;0
1055;183859;23;0;0;0;0;.00nan;0;0
1055;205824;20;0;0;0;0;.00nan;0;0
1055;59540;23;63;21;2;19;.905;3549000;0
1056;172340;4182;60;31;4;27;.871;1943000;0
1056;183783;25;0;0;0;0;.00nan;0;0
1056;191813;25;66;27;2;25;.926;3600000;0
1056;140314;4182;10;20;6;14;.700;1657000;0
1057;788;27;0;0;0;0;.00nan;0;0
1057;165723;32;0;0;0;0;.00nan;0;0
1057;171304;27;64;26;2;24;.923;3560000;0
1057;85727;32;100;32;0;32;1.000;3600000;0
1058;194416;17;0;0;0;0;.00nan;0;0
1058;178413;17;92;25;1;24;.960;3600000;0
1058;175092;9;0;0;0;0;.00nan;0;0
1058;190106;9;66;40;4;36;.900;3600000;0
1059;183844;29;98;41;1;40;.976;3600000;0
1059;195089;29;0;0;0;0;.00nan;0;0
1059;196005;22;0;0;0;0;.00nan;0;0
1059;143473;22;54;16;3;13;.813;3541000;0
1060;163471;34;0;0;0;0;.00nan;0;0
1060;183904;34;76;24;1;23;.958;3600000;0
1060;175912;14;63;42;5;37;.881;3600000;0
1060;185034;14;0;0;0;0;.00nan;0;0
1061;676;24;56;6;0;6;1.000;285000;0
1061;174718;12;0;0;0;0;.00nan;0;0
1061;85798;12;91;44;3;41;.932;3600000;0
1061;86192;24;16;19;6;13;.684;3315000;0
1062;20432;28;57;37;5;32;.865;3600000;0
1062;170314;5;0;0;0;0;.00nan;0;0
1062;201174;28;0;0;0;0;.00nan;0;0
1062;201585;5;65;21;2;19;.905;3600000;0
1063;166591;15;64;21;2;19;.905;3600000;0
1063;171838;31;0;0;0;0;.00nan;0;0
1063;187362;15;0;0;0;0;.00nan;0;0
1063;149452;31;53;42;6;36;.857;3600000;0
1064;193854;11;0;0;0;0;.00nan;0;0
1064;173699;10;65;51;6;45;.882;3600000;0
1064;90164;10;0;0;0;0;.00nan;0;0
1064;146862;11;91;30;1;29;.967;3600000;0
1065;192733;18;0;0;0;0;.00nan;0;0
1065;173727;18;100;26;0;26;1.000;3600000;0
1065;139409;3;96;38;1;37;.974;3600000;0
1065;148958;3;0;0;0;0;.00nan;0;0
1066;166646;0;97;42;1;41;.976;4200000;0
1066;3284;21;0;0;0;0;.00nan;0;0
1066;189333;0;0;0;0;0;.00nan;0;0
1066;182116;21;83;26;1;25;.962;4200000;0
1067;788;27;51;29;3;26;.897;3547000;0
1067;187578;26;66;19;2;17;.895;3600000;0
1067;171304;27;0;0;0;0;.00nan;0;0
1067;179154;26;0;0;0;0;.00nan;0;0
1068;187718;16;0;0;0;0;.00nan;0;0
1068;184229;35;81;23;1;22;.957;3555000;0
1068;50065;16;100;31;0;31;1.000;3600000;0
1068;147977;35;0;0;0;0;.00nan;0;0
1069;556;33;97;45;2;43;.956;3600000;0
1069;196090;4838;0;0;0;0;.00nan;0;0
1069;185743;4838;74;19;1;18;.947;3600000;0
1069;197038;33;0;0;0;0;.00nan;0;0
1070;13714;8;46;48;8;40;.833;3600000;0
1070;183859;23;0;0;0;0;.00nan;0;0
1070;58830;8;0;0;0;0;.00nan;0;0
1070;59540;23;100;18;0;18;1.000;3600000;0
1071;187537;19;0;0;0;0;.00nan;0;0
1071;3928;20;82;31;2;29;.935;3566000;0
1071;178384;19;79;25;1;24;.960;3600000;0
1071;205824;20;0;0;0;0;.00nan;0;0
1072;163471;34;86;35;1;34;.971;3600000;0
1072;183904;34;0;0;0;0;.00nan;0;0
1072;196005;22;44;23;4;19;.826;3600000;0
1072;143473;22;0;0;0;0;.00nan;0;0
1073;676;24;87;40;2;38;.950;3600000;0
1073;206789;30;0;0;0;0;.00nan;0;0
1073;86192;24;0;0;0;0;.00nan;0;0
1073;86697;30;47;21;4;17;.810;3600000;0
1074;183783;25;0;0;0;0;.00nan;0;0
1074;173699;10;0;0;0;0;.00nan;0;0
1074;191813;25;70;24;1;23;.958;3600000;0
1074;90164;10;95;48;2;46;.958;3600000;0
1075;193854;11;18;7;4;3;.429;933000;0
1075;165723;32;0;0;0;0;.00nan;0;0
1075;85727;32;75;39;4;35;.897;3600000;0
1075;146862;11;59;26;3;23;.885;2667000;0
1076;3284;21;100;29;0;29;1.000;3600000;0
1076;183844;29;0;0;0;0;.00nan;0;0
1076;195089;29;71;37;3;34;.919;3600000;0
1076;182116;21;0;0;0;0;.00nan;0;0
1077;194416;17;90;17;0;17;1.000;3600000;0
1077;178413;17;0;0;0;0;.00nan;0;0
1077;175912;14;74;37;4;33;.892;3600000;0
1077;185034;14;0;0;0;0;.00nan;0;0
1078;172340;4182;60;29;3;26;.897;3566000;0
1078;184229;35;0;0;0;0;.00nan;0;0
1078;140314;4182;0;0;0;0;.00nan;0;0
1078;147977;35;68;22;2;20;.909;3600000;0
1079;192733;18;0;0;0;0;.00nan;0;0
1079;3928;20;89;51;3;48;.941;4154000;0
1079;173727;18;54;33;4;29;.879;4154000;0
1079;205824;20;0;0;0;0;.00nan;0;0
1080;183859;23;0;0;0;0;.00nan;0;0
1080;175092;9;0;0;0;0;.00nan;0;0
1080;190106;9;84;34;1;33;.971;4200000;0
1080;59540;23;92;33;1;32;.970;4200000;0
1081;171838;31;76;39;3;36;.923;3600000;0
1081;183844;29;59;18;2;16;.889;3600000;0
1081;195089;29;0;0;0;0;.00nan;0;0
1081;149452;31;0;0;0;0;.00nan;0;0
1082;194416;17;83;24;1;23;.958;3600000;0
1082;178413;17;0;0;0;0;.00nan;0;0
1082;173699;10;84;37;3;34;.919;3600000;0
1082;90164;10;0;0;0;0;.00nan;0;0
1083;676;24;73;23;1;22;.957;3035000;0
1083;175912;14;49;23;3;20;.870;3600000;0
1083;185034;14;0;0;0;0;.00nan;0;0
1083;86192;24;29;8;3;5;.625;564000;0
1084;163471;34;0;0;0;0;.00nan;0;0
1084;183783;25;0;0;0;0;.00nan;0;0
1084;183904;34;90;48;3;45;.938;4200000;0
1084;191813;25;74;35;3;32;.914;4200000;0
1085;166591;15;68;24;2;22;.917;3600000;0
1085;166646;0;52;36;5;31;.861;3600000;0
1085;189333;0;0;0;0;0;.00nan;0;0
1085;187362;15;0;0;0;0;.00nan;0;0
1086;3284;21;100;42;2;40;.952;3600000;0
1086;196005;22;0;0;0;0;.00nan;0;0
1086;182116;21;0;0;0;0;.00nan;0;0
1086;143473;22;40;25;5;20;.800;3600000;0
1087;193854;11;0;0;0;0;.00nan;0;0
1087;13714;8;90;36;2;34;.944;3600000;0
1087;58830;8;0;0;0;0;.00nan;0;0
1087;146862;11;62;37;5;32;.865;3600000;0
1088;556;33;99;48;2;46;.958;3600000;0
1088;184229;35;67;35;4;31;.886;3520000;0
1088;197038;33;0;0;0;0;.00nan;0;0
1088;147977;35;0;0;0;0;.00nan;0;0
1089;196090;4838;0;0;0;0;.00nan;0;0
1089;185743;4838;86;24;1;23;.958;3600000;0
1089;139409;3;29;28;6;22;.786;2309000;0
1089;148958;3;54;17;2;15;.882;1291000;0
1090;187718;16;0;0;0;0;.00nan;0;0
1090;172340;4182;51;22;3;19;.864;3573000;0
1090;50065;16;62;25;2;23;.920;3600000;0
1090;140314;4182;0;0;0;0;.00nan;0;0
1091;788;27;0;0;0;0;.00nan;0;0
1091;165723;32;0;0;0;0;.00nan;0;0
1091;171304;27;69;45;4;41;.911;3600000;0
1091;85727;32;63;44;5;39;.886;3559000;0
1092;187537;19;0;0;0;0;.00nan;0;0
1092;178384;19;67;32;4;28;.875;3581000;0
1092;175092;9;75;33;3;30;.909;3600000;0
1092;190106;9;0;0;0;0;.00nan;0;0
1093;20432;28;0;0;0;0;.00nan;0;0
1093;201174;28;76;47;4;43;.915;3600000;0
1093;206789;30;0;0;0;0;.00nan;0;0
1093;86697;30;74;22;1;21;.955;3600000;0
1094;166646;0;0;0;0;0;.00nan;0;0
1094;3928;20;0;0;0;0;.00nan;0;0
1094;189333;0;79;46;4;42;.913;3600000;0
1094;205824;20;67;32;3;29;.906;3600000;0
1095;187578;26;0;0;0;0;.00nan;0;0
1095;179154;26;88;17;0;17;1.000;3600000;0
1095;174718;12;0;0;0;0;.00nan;0;0
1095;85798;12;64;33;3;30;.909;3600000;0
1096;788;27;93;34;1;33;.971;3600000;0
1096;187718;16;20;24;6;18;.750;3600000;0
1096;171304;27;0;0;0;0;.00nan;0;0
1096;50065;16;0;0;0;0;.00nan;0;0
1097;171838;31;0;0;0;0;.00nan;0;0
1097;163471;34;0;0;0;0;.00nan;0;0
1097;183904;34;97;36;1;35;.972;3600000;0
1097;149452;31;31;30;7;23;.767;3600000;0
1098;166591;15;76;28;2;26;.929;3600000;0
1098;3284;21;0;0;0;0;.00nan;0;0
1098;182116;21;83;43;3;40;.930;3571000;0
1098;187362;15;0;0;0;0;.00nan;0;0
1099;194416;17;0;0;0;0;.00nan;0;0
1099;178413;17;77;39;3;36;.923;3561000;0
1099;196005;22;0;0;0;0;.00nan;0;0
1099;143473;22;79;33;2;31;.939;3600000;0
1100;13714;8;82;33;2;31;.939;3600000;0
1100;170314;5;67;33;3;30;.909;3559000;0
1100;201585;5;0;0;0;0;.00nan;0;0
1100;58830;8;0;0;0;0;.00nan;0;0
1101;676;24;0;0;0;0;.00nan;0;0
1101;183783;25;0;0;0;0;.00nan;0;0
1101;191813;25;39;13;3;10;.769;3600000;0
1101;86192;24;73;49;5;44;.898;3600000;0
1102;183844;29;100;23;0;23;1.000;3600000;0
1102;184229;35;66;43;4;39;.907;3600000;0
1102;195089;29;0;0;0;0;.00nan;0;0
1102;147977;35;0;0;0;0;.00nan;0;0
1103;175092;9;0;0;0;0;.00nan;0;0
1103;190106;9;98;38;1;37;.974;3600000;0
1103;196090;4838;0;0;0;0;.00nan;0;0
1103;185743;4838;62;21;2;19;.905;3597000;0
1104;172340;4182;71;37;4;33;.892;3600000;0
1104;165723;32;9;16;6;10;.625;2109000;0
1104;85727;32;50;9;1;8;.889;1491000;0
1104;140314;4182;0;0;0;0;.00nan;0;0
1105;187537;19;0;0;0;0;.00nan;0;0
1105;178384;19;84;44;3;41;.932;3744000;0
1105;139409;3;87;37;2;35;.946;3757000;0
1105;148958;3;0;0;0;0;.00nan;0;0
1106;183859;23;0;0;0;0;.00nan;0;0
1106;206789;30;0;0;0;0;.00nan;0;0
1106;59540;23;81;31;3;28;.903;3600000;0
1106;86697;30;66;24;2;22;.917;3600000;0
1107;193854;11;0;0;0;0;.00nan;0;0
1107;20432;28;100;42;0;42;1.000;3600000;0
1107;201174;28;0;0;0;0;.00nan;0;0
1107;146862;11;71;24;2;22;.917;3569000;0
1108;3284;21;94;37;1;36;.973;3600000;0
1108;3928;20;88;41;2;39;.951;3543000;0
1108;205824;20;0;0;0;0;.00nan;0;0
1108;182116;21;0;0;0;0;.00nan;0;0
1109;187578;26;0;0;0;0;.00nan;0;0
1109;179154;26;100;30;0;30;1.000;3600000;0
1109;175912;14;73;33;3;30;.909;3600000;0
1109;185034;14;0;0;0;0;.00nan;0;0
1110;556;33;76;24;2;22;.917;3600000;0
1110;173699;10;0;0;0;0;.00nan;0;0
1110;197038;33;0;0;0;0;.00nan;0;0
1110;90164;10;76;36;3;33;.917;3583000;0
1111;183859;23;93;34;1;33;.971;3600000;0
1111;174718;12;0;0;0;0;.00nan;0;0
1111;59540;23;0;0;0;0;.00nan;0;0
1111;85798;12;77;35;3;32;.914;3585000;0
1112;183783;25;0;0;0;0;.00nan;0;0
1112;196005;22;0;0;0;0;.00nan;0;0
1112;191813;25;100;27;0;27;1.000;3600000;0
1112;143473;22;66;32;3;29;.906;3600000;0
1113;166591;15;54;24;3;21;.875;3762000;0
1113;171838;31;0;0;0;0;.00nan;0;0
1113;187362;15;0;0;0;0;.00nan;0;0
1113;149452;31;67;40;4;36;.900;3762000;0
1114;187718;16;0;0;0;0;.00nan;0;0
1114;184229;35;51;45;6;39;.867;3568000;0
1114;50065;16;62;38;5;33;.868;3600000;0
1114;147977;35;0;0;0;0;.00nan;0;0
1115;13714;8;56;23;3;20;.870;3600000;0
1115;194416;17;0;0;0;0;.00nan;0;0
1115;178413;17;43;22;4;18;.818;3597000;0
1115;58830;8;0;0;0;0;.00nan;0;0
1116;676;24;0;0;0;0;.00nan;0;0
1116;183844;29;43;20;4;16;.800;3600000;0
1116;195089;29;0;0;0;0;.00nan;0;0
1116;86192;24;55;38;5;33;.868;3592000;0
1117;166646;0;53;36;5;31;.861;3600000;0
1117;189333;0;0;0;0;0;.00nan;0;0
1117;196090;4838;0;0;0;0;.00nan;0;0
1117;185743;4838;92;13;0;13;1.000;3600000;0
1118;163471;34;0;0;0;0;.00nan;0;0
1118;183904;34;78;23;1;22;.957;3793000;0
1118;170314;5;72;28;2;26;.929;3793000;0
1118;201585;5;0;0;0;0;.00nan;0;0
1119;192733;18;0;0;0;0;.00nan;0;0
1119;187537;19;90;48;3;45;.938;3600000;0
1119;178384;19;0;0;0;0;.00nan;0;0
1119;173727;18;93;22;0;22;1.000;3600000;0
1120;788;27;0;0;0;0;.00nan;0;0
1120;20432;28;77;28;2;26;.929;3600000;0
1120;171304;27;53;33;5;28;.848;3600000;0
1120;201174;28;0;0;0;0;.00nan;0;0
1121;193854;11;0;0;0;0;.00nan;0;0
1121;165723;32;0;0;0;0;.00nan;0;0
1121;85727;32;56;33;4;29;.879;3600000;0
1121;146862;11;99;36;1;35;.972;3600000;0
1122;173699;10;73;37;3;34;.919;3577000;0
1122;206789;30;0;0;0;0;.00nan;0;0
1122;86697;30;54;18;2;16;.889;3600000;0
1122;90164;10;0;0;0;0;.00nan;0;0
1123;3928;20;100;56;1;55;.982;4200000;0
1123;183783;25;0;0;0;0;.00nan;0;0
1123;205824;20;0;0;0;0;.00nan;0;0
1123;191813;25;79;25;1;24;.960;4200000;0
1124;556;33;91;40;2;38;.950;3600000;0
1124;175912;14;55;25;3;22;.880;3600000;0
1124;185034;14;0;0;0;0;.00nan;0;0
1124;197038;33;0;0;0;0;.00nan;0;0
1125;676;24;88;48;3;45;.938;3600000;0
1125;196005;22;95;21;0;21;1.000;3600000;0
1125;86192;24;0;0;0;0;.00nan;0;0
1125;143473;22;0;0;0;0;.00nan;0;0
1126;166646;0;52;42;6;36;.857;3136000;0
1126;3284;21;0;0;0;0;.00nan;0;0
1126;189333;0;59;6;0;6;1.000;464000;0
1126;182116;21;100;29;0;29;1.000;3600000;0
1127;183844;29;0;0;0;0;.00nan;0;0
1127;195089;29;92;33;2;31;.939;4098000;0
1127;196090;4838;0;0;0;0;.00nan;0;0
1127;185743;4838;49;19;3;16;.842;4098000;0
1128;166591;15;0;0;0;0;.00nan;0;0
1128;170314;5;0;0;0;0;.00nan;0;0
1128;201585;5;83;42;4;38;.905;3869000;0
1128;187362;15;57;30;3;27;.900;3869000;0
1129;187578;26;0;0;0;0;.00nan;0;0
1129;179154;26;76;18;1;17;.944;3600000;0
1129;174718;12;0;0;0;0;.00nan;0;0
1129;85798;12;72;25;2;23;.920;3600000;0
1130;172340;4182;78;24;1;23;.958;3600000;0
1130;20432;28;0;0;0;0;.00nan;0;0
1130;201174;28;96;53;2;51;.962;3549000;0
1130;140314;4182;0;0;0;0;.00nan;0;0
1131;192733;18;52;20;3;17;.850;3600000;0
1131;173727;18;0;0;0;0;.00nan;0;0
1131;175092;9;0;0;0;0;.00nan;0;0
1131;190106;9;47;30;4;26;.867;3544000;0
1132;183859;23;0;0;0;0;.00nan;0;0
1132;59540;23;64;14;1;13;.929;3600000;0
1132;139409;3;56;55;7;48;.873;3600000;0
1132;148958;3;0;0;0;0;.00nan;0;0
1133;184229;35;84;31;2;29;.935;3600000;0
1133;206789;30;0;0;0;0;.00nan;0;0
1133;86697;30;76;40;4;36;.900;3569000;0
1133;147977;35;0;0;0;0;.00nan;0;0
1134;788;27;87;45;2;43;.956;4200000;0
1134;187537;19;80;26;2;24;.923;4200000;0
1134;178384;19;0;0;0;0;.00nan;0;0
1134;171304;27;0;0;0;0;.00nan;0;0
1135;171838;31;0;0;0;0;.00nan;0;0
1135;170314;5;50;27;4;23;.852;3600000;0
1135;201585;5;0;0;0;0;.00nan;0;0
1135;149452;31;76;33;3;30;.909;3600000;0
1136;166591;15;89;30;2;28;.933;3600000;0
1136;163471;34;0;0;0;0;.00nan;0;0
1136;183904;34;39;18;3;15;.833;3555000;0
1136;187362;15;0;0;0;0;.00nan;0;0
1137;3284;21;0;0;0;0;.00nan;0;0
1137;175912;14;86;37;2;35;.946;3600000;0
1137;185034;14;0;0;0;0;.00nan;0;0
1137;182116;21;62;34;4;30;.882;3565000;0
1138;676;24;95;28;0;28;1.000;3600000;0
1138;166646;0;60;34;4;30;.882;3600000;0
1138;189333;0;0;0;0;0;.00nan;0;0
1138;86192;24;0;0;0;0;.00nan;0;0
1139;3928;20;32;9;3;6;.667;564000;0
1139;194416;17;0;0;0;0;.00nan;0;0
1139;178413;17;50;20;3;17;.850;3600000;0
1139;205824;20;57;34;5;29;.853;3036000;0
1140;13714;8;60;22;3;19;.864;3574000;0
1140;206789;30;0;0;0;0;.00nan;0;0
1140;58830;8;0;0;0;0;.00nan;0;0
1140;86697;30;79;27;2;25;.926;3600000;0
1141;183783;25;0;0;0;0;.00nan;0;0
1141;196090;4838;0;0;0;0;.00nan;0;0
1141;185743;4838;81;41;3;38;.927;3584000;0
1141;191813;25;94;30;1;29;.967;3600000;0
1142;192733;18;0;0;0;0;.00nan;0;0
1142;165723;32;0;0;0;0;.00nan;0;0
1142;173727;18;58;33;4;29;.879;3519000;0
1142;85727;32;82;29;2;27;.931;3600000;0
1143;556;33;100;31;0;31;1.000;3600000;0
1143;197038;33;0;0;0;0;.00nan;0;0
1143;139409;3;60;33;4;29;.879;3600000;0
1143;148958;3;0;0;0;0;.00nan;0;0
1144;173699;10;50;37;5;32;.865;3600000;0
1144;174718;12;0;0;0;0;.00nan;0;0
1144;85798;12;100;32;0;32;1.000;3600000;0
1144;90164;10;0;0;0;0;.00nan;0;0
1145;172340;4182;83;28;2;26;.929;3600000;0
1145;183859;23;0;0;0;0;.00nan;0;0
1145;59540;23;68;32;3;29;.906;3539000;0
1145;140314;4182;0;0;0;0;.00nan;0;0
1146;187578;26;0;0;0;0;.00nan;0;0
1146;193854;11;0;0;0;0;.00nan;0;0
1146;179154;26;58;40;5;35;.875;3600000;0
1146;146862;11;33;34;6;28;.824;3588000;0
1147;183844;29;89;29;1;28;.966;3600000;0
1147;195089;29;0;0;0;0;.00nan;0;0
1147;175092;9;0;0;0;0;.00nan;0;0
1147;190106;9;60;39;5;34;.872;3600000;0
1148;171838;31;63;26;3;23;.885;3600000;0
1148;20432;28;0;0;0;0;.00nan;0;0
1148;201174;28;67;38;4;34;.895;3554000;0
1148;149452;31;0;0;0;0;.00nan;0;0
1149;3284;21;0;0;0;0;.00nan;0;0
1149;194416;17;64;16;1;15;.938;2436000;0
1149;178413;17;26;16;5;11;.688;1142000;0
1149;182116;21;72;34;4;30;.882;3600000;0
1150;170314;5;76;31;3;28;.903;3727000;0
1150;201585;5;0;0;0;0;.00nan;0;0
1150;196005;22;0;0;0;0;.00nan;0;0
1150;143473;22;67;19;2;17;.895;3727000;0
1151;166591;15;73;21;2;19;.905;3600000;0
1151;187362;15;0;0;0;0;.00nan;0;0
1151;139409;3;0;0;0;0;.00nan;0;0
1151;148958;3;60;42;5;37;.881;3600000;0
1152;165723;32;78;48;5;43;.896;4200000;0
1152;183844;29;0;0;0;0;.00nan;0;0
1152;195089;29;33;29;5;24;.828;4200000;0
1152;85727;32;0;0;0;0;.00nan;0;0
1153;173699;10;80;38;2;36;.947;3803000;0
1153;175912;14;87;39;3;36;.923;3803000;0
1153;185034;14;0;0;0;0;.00nan;0;0
1153;90164;10;0;0;0;0;.00nan;0;0
1154;166646;0;0;0;0;0;.00nan;0;0
1154;3928;20;98;34;1;33;.971;3600000;0
1154;189333;0;38;40;6;34;.850;3600000;0
1154;205824;20;0;0;0;0;.00nan;0;0
1155;187718;16;0;0;0;0;.00nan;0;0
1155;193854;11;0;0;0;0;.00nan;0;0
1155;50065;16;94;22;0;22;1.000;3600000;0
1155;146862;11;71;34;2;32;.941;3563000;0
1156;192733;18;0;0;0;0;.00nan;0;0
1156;173727;18;79;33;4;29;.879;3792000;0
1156;184229;35;71;36;3;33;.917;3792000;0
1156;147977;35;0;0;0;0;.00nan;0;0
1157;183783;25;0;0;0;0;.00nan;0;0
1157;206789;30;64;8;0;8;1.000;256000;0
1157;191813;25;59;24;3;21;.875;3600000;0
1157;86697;30;37;41;7;34;.829;3344000;0
1158;556;33;24;5;3;2;.400;284000;0
1158;163471;34;0;0;0;0;.00nan;0;0
1158;183904;34;51;21;3;18;.857;3600000;0
1158;197038;33;65;24;2;22;.917;3292000;0
1159;788;27;0;0;0;0;.00nan;0;0
1159;171304;27;48;36;4;32;.889;3575000;0
1159;196090;4838;0;0;0;0;.00nan;0;0
1159;185743;4838;70;31;3;28;.903;3600000;0
1160;13714;8;96;17;0;17;1.000;3600000;0
1160;174718;12;0;0;0;0;.00nan;0;0
1160;58830;8;0;0;0;0;.00nan;0;0
1160;85798;12;72;39;4;35;.897;3600000;0
1161;172340;4182;68;30;4;26;.867;3695000;0
1161;183859;23;0;0;0;0;.00nan;0;0
1161;59540;23;39;23;5;18;.783;3695000;0
1161;140314;4182;0;0;0;0;.00nan;0;0
1162;187537;19;0;0;0;0;.00nan;0;0
1162;187578;26;0;0;0;0;.00nan;0;0
1162;178384;19;54;31;4;27;.871;4200000;0
1162;179154;26;73;34;4;30;.882;4200000;0
1163;676;24;75;39;3;36;.923;4200000;0
1163;175092;9;62;25;3;22;.880;4200000;0
1163;190106;9;0;0;0;0;.00nan;0;0
1163;86192;24;0;0;0;0;.00nan;0;0
1164;194416;17;0;0;0;0;.00nan;0;0
1164;178413;17;67;44;5;39;.886;3587000;0
1164;170314;5;0;0;0;0;.00nan;0;0
1164;201585;5;70;31;3;28;.903;3600000;0
1165;187718;16;0;0;0;0;.00nan;0;0
1165;206789;30;0;0;0;0;.00nan;0;0
1165;50065;16;96;22;0;22;1.000;3600000;0
1165;86697;30;80;47;4;43;.915;3600000;0
1166;172340;4182;66;42;5;37;.881;3600000;0
1166;196090;4838;0;0;0;0;.00nan;0;0
1166;185743;4838;52;21;3;18;.857;3600000;0
1166;140314;4182;0;0;0;0;.00nan;0;0
1167;163471;34;0;0;0;0;.00nan;0;0
1167;183904;34;72;17;1;16;.941;3600000;0
1167;174718;12;82;39;4;35;.897;3600000;0
1167;85798;12;0;0;0;0;.00nan;0;0
1168;556;33;50;14;2;12;.857;3550000;0
1168;13714;8;92;26;1;25;.962;3600000;0
1168;197038;33;0;0;0;0;.00nan;0;0
1168;58830;8;0;0;0;0;.00nan;0;0
1169;166646;0;74;30;3;27;.900;3615000;0
1169;189333;0;0;0;0;0;.00nan;0;0
1169;175092;9;0;0;0;0;.00nan;0;0
1169;190106;9;83;28;2;26;.929;3615000;0
1170;173699;10;0;0;0;0;.00nan;0;0
1170;175912;14;58;38;4;34;.895;3519000;0
1170;185034;14;0;0;0;0;.00nan;0;0
1170;90164;10;82;29;2;27;.931;3600000;0
1171;3284;21;0;0;0;0;.00nan;0;0
1171;182116;21;75;40;4;36;.900;3816000;0
1171;139409;3;58;32;5;27;.844;3816000;0
1171;148958;3;0;0;0;0;.00nan;0;0
1172;166591;15;82;20;1;19;.950;3600000;0
1172;165723;32;46;25;4;21;.840;1110000;0
1172;187362;15;0;0;0;0;.00nan;0;0
1172;85727;32;45;37;6;31;.838;2490000;0
1173;20432;28;13;27;7;20;.741;1701000;0
1173;201174;28;44;27;4;23;.852;1899000;0
1173;196005;22;0;0;0;0;.00nan;0;0
1173;143473;22;39;20;4;16;.800;3600000;0
1174;183783;25;0;0;0;0;.00nan;0;0
1174;183844;29;60;44;5;39;.886;3600000;0
1174;195089;29;0;0;0;0;.00nan;0;0
1174;191813;25;97;19;0;19;1.000;3600000;0
1175;171838;31;39;1;1;0;.000;450000;0
1175;3928;20;37;33;6;27;.818;2764000;0
1175;205824;20;55;3;0;3;1.000;836000;0
1175;149452;31;26;27;6;21;.778;3114000;0
1176;193854;11;0;0;0;0;.00nan;0;0
1176;184229;35;75;42;4;38;.905;3600000;0
1176;146862;11;80;23;1;22;.957;3600000;0
1176;147977;35;0;0;0;0;.00nan;0;0
1177;192733;18;0;0;0;0;.00nan;0;0
1177;788;27;80;49;4;45;.918;3600000;0
1177;173727;18;69;24;2;22;.917;3600000;0
1177;171304;27;0;0;0;0;.00nan;0;0
1178;187578;26;0;0;0;0;.00nan;0;0
1178;183859;23;0;0;0;0;.00nan;0;0
1178;179154;26;95;24;0;24;1.000;3600000;0
1178;59540;23;67;22;2;20;.909;3533000;0
1179;187537;19;0;0;0;0;.00nan;0;0
1179;172340;4182;0;0;0;0;.00nan;0;0
1179;178384;19;64;25;2;23;.920;3554000;0
1179;140314;4182;69;24;1;23;.958;3600000;0
1180;556;33;21;6;4;2;.333;363000;0
1180;173699;10;0;0;0;0;.00nan;0;0
1180;197038;33;97;48;1;47;.979;3237000;0
1180;90164;10;55;19;2;17;.895;3600000;0
1181;163471;34;53;20;3;17;.850;3600000;0
1181;183904;34;0;0;0;0;.00nan;0;0
1181;175912;14;44;47;7;40;.851;3275000;0
1181;185034;14;47;6;1;5;.833;325000;0
1182;166591;15;62;34;3;31;.912;3571000;0
1182;196005;22;0;0;0;0;.00nan;0;0
1182;187362;15;0;0;0;0;.00nan;0;0
1182;143473;22;64;20;1;19;.950;3600000;0
1183;194416;17;0;0;0;0;.00nan;0;0
1183;178413;17;73;21;1;20;.952;3997000;0
1183;20432;28;0;0;0;0;.00nan;0;0
1183;201174;28;94;41;2;39;.951;3997000;0
1184;166646;0;100;51;3;48;.941;4200000;0
1184;189333;0;0;0;0;0;.00nan;0;0
1184;170314;5;69;37;3;34;.919;4200000;0
1184;201585;5;0;0;0;0;.00nan;0;0
1185;184229;35;0;0;0;0;.00nan;0;0
1185;196090;4838;86;37;2;35;.946;3600000;0
1185;185743;4838;0;0;0;0;.00nan;0;0
1185;147977;35;92;29;1;28;.966;3600000;0
1186;788;27;39;1;1;0;.000;518000;0
1186;183783;25;64;15;1;14;.933;3600000;0
1186;171304;27;39;38;6;32;.842;3082000;0
1186;191813;25;0;0;0;0;.00nan;0;0
1187;193854;11;0;0;0;0;.00nan;0;0
1187;183859;23;0;0;0;0;.00nan;0;0
1187;59540;23;71;35;3;32;.914;3552000;0
1187;146862;11;62;18;2;16;.889;3600000;0
1188;3928;20;99;47;3;44;.936;3600000;0
1188;205824;20;0;0;0;0;.00nan;0;0
1188;175092;9;43;43;7;36;.837;3600000;0
1188;190106;9;0;0;0;0;.00nan;0;0
1189;170314;5;0;0;0;0;.00nan;0;0
1189;201585;5;78;36;3;33;.917;3581000;0
1189;139409;3;61;26;2;24;.923;3600000;0
1189;148958;3;0;0;0;0;.00nan;0;0
1190;676;24;0;0;0;0;.00nan;0;0
1190;175912;14;55;31;4;27;.871;3600000;0
1190;185034;14;0;0;0;0;.00nan;0;0
1190;86192;24;67;27;2;25;.926;3600000;0
1191;165723;32;76;30;2;28;.933;3222000;0
1191;196005;22;62;20;2;18;.900;3600000;0
1191;85727;32;31;10;3;7;.700;378000;0
1191;143473;22;0;0;0;0;.00nan;0;0
1192;187718;16;0;0;0;0;.00nan;0;0
1192;183844;29;86;35;2;33;.943;3644000;0
1192;195089;29;0;0;0;0;.00nan;0;0
1192;50065;16;65;28;3;25;.893;3644000;0
1193;171838;31;0;0;0;0;.00nan;0;0
1193;13714;8;0;0;0;0;.00nan;0;0
1193;58830;8;56;25;4;21;.840;3916000;0
1193;149452;31;100;49;3;46;.939;3916000;0
1194;192733;18;0;0;0;0;.00nan;0;0
1194;172340;4182;63;34;4;30;.882;3600000;0
1194;173727;18;80;40;3;37;.925;3600000;0
1194;140314;4182;0;0;0;0;.00nan;0;0
1195;187537;19;89;33;2;31;.939;3600000;0
1195;178384;19;0;0;0;0;.00nan;0;0
1195;206789;30;82;36;3;33;.917;3587000;0
1195;86697;30;0;0;0;0;.00nan;0;0
1196;166646;0;53;23;3;20;.870;3600000;0
1196;189333;0;0;0;0;0;.00nan;0;0
1196;20432;28;53;34;5;29;.853;3554000;0
1196;201174;28;0;0;0;0;.00nan;0;0
1197;676;24;96;54;2;52;.963;4200000;0
1197;163471;34;0;0;0;0;.00nan;0;0
1197;183904;34;75;25;2;23;.920;4200000;0
1197;86192;24;0;0;0;0;.00nan;0;0
1198;187578;26;0;0;0;0;.00nan;0;0
1198;179154;26;99;38;1;37;.974;3600000;0
1198;196090;4838;0;0;0;0;.00nan;0;0
1198;185743;4838;60;22;2;20;.909;3586000;0
1199;187537;19;0;0;0;0;.00nan;0;0
1199;178384;19;97;36;1;35;.972;4200000;0
1199;174718;12;0;0;0;0;.00nan;0;0
1199;85798;12;76;30;1;29;.967;4200000;0
1200;788;27;35;33;6;27;.818;3600000;0
1200;183859;23;0;0;0;0;.00nan;0;0
1200;171304;27;0;0;0;0;.00nan;0;0
1200;59540;23;51;33;5;28;.848;3600000;0
1201;171838;31;0;0;0;0;.00nan;0;0
1201;3284;21;0;0;0;0;.00nan;0;0
1201;182116;21;85;24;1;23;.958;3600000;0
1201;149452;31;52;44;6;38;.864;3600000;0
1202;173699;10;53;30;4;26;.867;3600000;0
1202;196005;22;0;0;0;0;.00nan;0;0
1202;90164;10;0;0;0;0;.00nan;0;0
1202;143473;22;78;23;1;22;.957;3600000;0
1203;20432;28;0;0;0;0;.00nan;0;0
1203;201174;28;50;30;4;26;.867;3600000;0
1203;139409;3;88;16;0;16;1.000;3600000;0
1203;148958;3;0;0;0;0;.00nan;0;0
1204;183844;29;55;27;4;23;.852;3600000;0
1204;170314;5;42;30;5;25;.833;3549000;0
1204;195089;29;0;0;0;0;.00nan;0;0
1204;201585;5;0;0;0;0;.00nan;0;0
1205;3928;20;81;44;4;40;.909;3600000;0
1205;205824;20;0;0;0;0;.00nan;0;0
1205;175912;14;49;36;5;31;.861;3550000;0
1205;185034;14;0;0;0;0;.00nan;0;0
1206;556;33;66;34;4;30;.882;3600000;0
1206;187718;16;0;0;0;0;.00nan;0;0
1206;197038;33;0;0;0;0;.00nan;0;0
1206;50065;16;76;20;1;19;.950;3600000;0
1207;13714;8;91;31;1;30;.968;3600000;0
1207;184229;35;19;9;4;5;.556;776000;0
1207;58830;8;0;0;0;0;.00nan;0;0
1207;147977;35;39;26;5;21;.808;2824000;0
1208;192733;18;0;0;0;0;.00nan;0;0
1208;183783;25;0;0;0;0;.00nan;0;0
1208;173727;18;69;25;2;23;.920;3600000;0
1208;191813;25;40;17;3;14;.824;3600000;0
1209;788;27;52;2;0;2;1.000;364000;0
1209;193854;11;0;0;0;0;.00nan;0;0
1209;171304;27;40;34;5;29;.853;3236000;0
1209;146862;11;86;28;1;27;.964;3600000;0
1210;166591;15;76;26;2;24;.923;3600000;0
1210;175092;9;0;0;0;0;.00nan;0;0
1210;190106;9;78;39;4;35;.897;3565000;0
1210;187362;15;0;0;0;0;.00nan;0;0
1211;3284;21;74;22;1;21;.955;3600000;0
1211;3928;20;94;47;2;45;.957;3600000;0
1211;205824;20;0;0;0;0;.00nan;0;0
1211;182116;21;0;0;0;0;.00nan;0;0
1212;163471;34;0;0;0;0;.00nan;0;0
1212;194416;17;0;0;0;0;.00nan;0;0
1212;178413;17;65;37;4;33;.892;3600000;0
1212;183904;34;76;18;1;17;.944;3600000;0
1213;556;33;90;34;1;33;.971;3600000;0
1213;196090;4838;0;0;0;0;.00nan;0;0
1213;185743;4838;69;27;2;25;.926;3600000;0
1213;197038;33;0;0;0;0;.00nan;0;0
1214;172340;4182;100;38;0;38;1.000;3600000;0
1214;183859;23;0;0;0;0;.00nan;0;0
1214;59540;23;81;23;1;22;.957;3543000;0
1214;140314;4182;0;0;0;0;.00nan;0;0
1215;174718;12;0;0;0;0;.00nan;0;0
1215;206789;30;0;0;0;0;.00nan;0;0
1215;85798;12;88;36;2;34;.944;4200000;0
1215;86697;30;72;25;2;23;.920;4200000;0
1216;20432;28;77;39;3;36;.923;3600000;0
1216;201174;28;0;0;0;0;.00nan;0;0
1216;175912;14;40;30;5;25;.833;3580000;0
1216;185034;14;0;0;0;0;.00nan;0;0
1217;171838;31;0;0;0;0;.00nan;0;0
1217;170314;5;66;27;3;24;.889;3546000;0
1217;201585;5;0;0;0;0;.00nan;0;0
1217;149452;31;90;39;2;37;.949;3600000;0
1218;187718;16;0;0;0;0;.00nan;0;0
1218;183783;25;0;0;0;0;.00nan;0;0
1218;191813;25;75;25;1;24;.960;3600000;0
1218;50065;16;78;46;4;42;.913;3600000;0
1219;187578;26;0;0;0;0;.00nan;0;0
1219;165723;32;0;0;0;0;.00nan;0;0
1219;179154;26;62;19;2;17;.895;3600000;0
1219;85727;32;71;37;4;33;.892;3533000;0
1220;193854;11;0;0;0;0;.00nan;0;0
1220;184229;35;92;49;1;48;.980;3989000;0
1220;146862;11;100;29;0;29;1.000;3989000;0
1220;147977;35;0;0;0;0;.00nan;0;0
1221;166591;15;76;32;2;30;.938;4200000;0
1221;173699;10;0;0;0;0;.00nan;0;0
1221;187362;15;0;0;0;0;.00nan;0;0
1221;90164;10;100;50;2;48;.960;4200000;0
1222;166646;0;88;37;2;35;.946;3600000;0
1222;189333;0;0;0;0;0;.00nan;0;0
1222;139409;3;62;28;3;25;.893;3593000;0
1222;148958;3;0;0;0;0;.00nan;0;0
1223;676;24;67;30;2;28;.933;3579000;0
1223;183844;29;77;24;1;23;.958;3600000;0
1223;195089;29;0;0;0;0;.00nan;0;0
1223;86192;24;0;0;0;0;.00nan;0;0
1224;13714;8;58;33;4;29;.879;3600000;0
1224;196005;22;0;0;0;0;.00nan;0;0
1224;58830;8;0;0;0;0;.00nan;0;0
1224;143473;22;67;23;2;21;.913;3600000;0
1225;192733;18;74;30;2;28;.933;3600000;0
1225;173727;18;0;0;0;0;.00nan;0;0
1225;196090;4838;42;35;5;30;.857;3600000;0
1225;185743;4838;0;0;0;0;.00nan;0;0
1226;788;27;38;34;5;29;.853;3542000;0
1226;187537;19;0;0;0;0;.00nan;0;0
1226;178384;19;61;25;3;22;.880;3600000;0
1226;171304;27;0;0;0;0;.00nan;0;0
1227;194416;17;0;0;0;0;.00nan;0;0
1227;178413;17;63;29;3;26;.897;3575000;0
1227;175092;9;0;0;0;0;.00nan;0;0
1227;190106;9;100;46;2;44;.957;3600000;0
1228;187718;16;71;31;2;29;.935;3600000;0
1228;165723;32;59;37;4;33;.892;3586000;0
1228;50065;16;0;0;0;0;.00nan;0;0
1228;85727;32;0;0;0;0;.00nan;0;0
1229;3284;21;0;0;0;0;.00nan;0;0
1229;173699;10;64;36;5;31;.861;3541000;0
1229;182116;21;100;44;3;41;.932;3600000;0
1229;90164;10;0;0;0;0;.00nan;0;0
1230;193854;11;0;0;0;0;.00nan;0;0
1230;174718;12;0;0;0;0;.00nan;0;0
1230;85798;12;64;46;6;40;.870;3600000;0
1230;146862;11;61;22;2;20;.909;3600000;0
1231;3928;20;0;0;0;0;.00nan;0;0
1231;183844;29;0;0;0;0;.00nan;0;0
1231;195089;29;91;40;2;38;.950;4037000;0
1231;205824;20;81;39;3;36;.923;4037000;0
1232;676;24;0;0;0;0;.00nan;0;0
1232;13714;8;54;34;5;29;.853;2351000;0
1232;58830;8;13;5;4;1;.200;1249000;0
1232;86192;24;67;30;3;27;.900;3600000;0
1233;163471;34;0;0;0;0;.00nan;0;0
1233;183904;34;83;27;2;25;.926;3600000;0
1233;139409;3;45;13;2;11;.846;888000;0
1233;148958;3;51;40;6;34;.850;2712000;0
1234;172340;4182;72;20;1;19;.950;3600000;0
1234;184229;35;77;38;3;35;.921;3564000;0
1234;140314;4182;0;0;0;0;.00nan;0;0
1234;147977;35;0;0;0;0;.00nan;0;0
1235;556;33;88;27;2;25;.926;4200000;0
1235;187578;26;56;24;2;22;.917;4200000;0
1235;179154;26;0;0;0;0;.00nan;0;0
1235;197038;33;0;0;0;0;.00nan;0;0
1236;166646;0;67;32;4;28;.875;3600000;0
1236;189333;0;0;0;0;0;.00nan;0;0
1236;175912;14;52;7;1;6;.857;3600000;0
1236;185034;14;0;0;0;0;.00nan;0;0
1237;187537;19;83;37;3;34;.919;3600000;0
1237;178384;19;0;0;0;0;.00nan;0;0
1237;206789;30;0;0;0;0;.00nan;0;0
1237;86697;30;64;13;1;12;.923;3600000;0
1238;171838;31;0;0;0;0;.00nan;0;0
1238;3284;21;0;0;0;0;.00nan;0;0
1238;182116;21;89;28;2;26;.929;3600000;0
1238;149452;31;77;49;5;44;.898;3600000;0
1239;3928;20;71;40;4;36;.900;3600000;0
1239;194416;17;43;18;3;15;.833;3600000;0
1239;178413;17;0;0;0;0;.00nan;0;0
1239;205824;20;0;0;0;0;.00nan;0;0
1240;183844;29;86;21;0;21;1.000;3600000;0
1240;170314;5;0;0;0;0;.00nan;0;0
1240;195089;29;0;0;0;0;.00nan;0;0
1240;201585;5;57;29;3;26;.897;3600000;0
1241;166591;15;78;30;1;29;.967;4200000;0
1241;187362;15;0;0;0;0;.00nan;0;0
1241;139409;3;100;43;1;42;.977;4200000;0
1241;148958;3;0;0;0;0;.00nan;0;0
1242;676;24;99;34;1;33;.971;3600000;0
1242;166646;0;87;38;2;36;.947;3548000;0
1242;189333;0;0;0;0;0;.00nan;0;0
1242;86192;24;0;0;0;0;.00nan;0;0
1243;163471;34;0;0;0;0;.00nan;0;0
1243;183904;34;73;33;2;31;.939;3519000;0
1243;196005;22;0;0;0;0;.00nan;0;0
1243;143473;22;87;31;1;30;.968;3600000;0
1244;20432;28;90;46;2;44;.957;4200000;0
1244;173699;10;93;43;2;41;.953;4200000;0
1244;201174;28;0;0;0;0;.00nan;0;0
1244;90164;10;0;0;0;0;.00nan;0;0
1245;187578;26;0;0;0;0;.00nan;0;0
1245;179154;26;54;30;4;26;.867;4005000;0
1245;175092;9;0;0;0;0;.00nan;0;0
1245;190106;9;82;35;3;32;.914;4005000;0
1246;13714;8;100;45;0;45;1.000;3600000;0
1246;183783;25;0;0;0;0;.00nan;0;0
1246;191813;25;68;16;1;15;.938;3564000;0
1246;58830;8;0;0;0;0;.00nan;0;0
1247;556;33;0;0;0;0;.00nan;0;0
1247;187718;16;0;0;0;0;.00nan;0;0
1247;197038;33;57;44;6;38;.864;3600000;0
1247;50065;16;90;33;2;31;.939;3600000;0
1248;788;27;60;26;3;23;.885;3600000;0
1248;172340;4182;97;20;0;20;1.000;3600000;0
1248;171304;27;0;0;0;0;.00nan;0;0
1248;140314;4182;0;0;0;0;.00nan;0;0
1249;183859;23;0;0;0;0;.00nan;0;0
1249;174718;12;0;0;0;0;.00nan;0;0
1249;59540;23;31;23;5;18;.783;3521000;0
1249;85798;12;68;26;3;23;.885;3600000;0
1250;192733;18;0;0;0;0;.00nan;0;0
1250;193854;11;0;0;0;0;.00nan;0;0
1250;173727;18;92;34;2;32;.941;3600000;0
1250;146862;11;62;23;3;20;.870;3595000;0
1251;165723;32;41;9;2;7;.778;1017000;0
1251;184229;35;79;24;1;23;.958;3600000;0
1251;85727;32;12;28;7;21;.750;2583000;0
1251;147977;35;0;0;0;0;.00nan;0;0
1252;206789;30;0;0;0;0;.00nan;0;0
1252;196090;4838;0;0;0;0;.00nan;0;0
1252;185743;4838;73;26;1;25;.962;3600000;0
1252;86697;30;86;36;2;34;.944;3545000;0
1253;187537;19;0;0;0;0;.00nan;0;0
1253;178384;19;56;30;4;26;.867;3554000;0
1253;174718;12;72;27;2;25;.926;3600000;0
1253;85798;12;0;0;0;0;.00nan;0;0
1254;3928;20;58;26;3;23;.885;4200000;0
1254;205824;20;0;0;0;0;.00nan;0;0
1254;175092;9;68;38;3;35;.921;4200000;0
1254;190106;9;0;0;0;0;.00nan;0;0
1255;173699;10;62;40;4;36;.900;3600000;0
1255;170314;5;83;15;0;15;1.000;3600000;0
1255;201585;5;0;0;0;0;.00nan;0;0
1255;90164;10;0;0;0;0;.00nan;0;0
1256;166591;15;64;28;3;25;.893;3582000;0
1256;163471;34;81;30;1;29;.967;3600000;0
1256;183904;34;0;0;0;0;.00nan;0;0
1256;187362;15;0;0;0;0;.00nan;0;0
1257;194416;17;0;0;0;0;.00nan;0;0
1257;178413;17;98;28;1;27;.964;3600000;0
1257;175912;14;73;39;4;35;.897;3600000;0
1257;185034;14;0;0;0;0;.00nan;0;0
1258;183844;29;22;35;7;28;.800;3600000;0
1258;20432;28;0;0;0;0;.00nan;0;0
1258;195089;29;0;0;0;0;.00nan;0;0
1258;201174;28;72;39;4;35;.897;3600000;0
1259;676;24;78;40;3;37;.925;3600000;0
1259;166646;0;100;23;0;23;1.000;3600000;0
1259;189333;0;0;0;0;0;.00nan;0;0
1259;86192;24;0;0;0;0;.00nan;0;0
1260;196005;22;0;0;0;0;.00nan;0;0
1260;139409;3;78;46;4;42;.913;3596000;0
1260;143473;22;55;12;2;10;.833;3600000;0
1260;148958;3;0;0;0;0;.00nan;0;0
1261;187578;26;0;0;0;0;.00nan;0;0
1261;183783;25;0;0;0;0;.00nan;0;0
1261;179154;26;76;47;5;42;.894;3543000;0
1261;191813;25;46;27;4;23;.852;3600000;0
1262;193854;11;0;0;0;0;.00nan;0;0
1262;183859;23;0;0;0;0;.00nan;0;0
1262;59540;23;100;32;0;32;1.000;3600000;0
1262;146862;11;49;25;4;21;.840;3600000;0
1263;192733;18;0;0;0;0;.00nan;0;0
1263;788;27;0;0;0;0;.00nan;0;0
1263;173727;18;39;14;3;11;.786;3600000;0
1263;171304;27;73;48;5;43;.896;3583000;0
1264;3284;21;0;0;0;0;.00nan;0;0
1264;184229;35;69;30;3;27;.900;3600000;0
1264;182116;21;70;41;4;37;.902;3567000;0
1264;147977;35;0;0;0;0;.00nan;0;0
1265;13714;8;49;23;4;19;.826;3600000;0
1265;165723;32;0;0;0;0;.00nan;0;0
1265;58830;8;0;0;0;0;.00nan;0;0
1265;85727;32;93;44;3;41;.932;3600000;0
1266;174718;12;0;0;0;0;.00nan;0;0
1266;196090;4838;0;0;0;0;.00nan;0;0
1266;185743;4838;62;24;2;22;.917;3562000;0
1266;85798;12;87;31;1;30;.968;3600000;0
1267;192733;18;83;35;2;33;.943;3600000;0
1267;172340;4182;75;50;5;45;.900;3600000;0
1267;173727;18;0;0;0;0;.00nan;0;0
1267;140314;4182;0;0;0;0;.00nan;0;0
1268;187718;16;0;0;0;0;.00nan;0;0
1268;206789;30;0;0;0;0;.00nan;0;0
1268;50065;16;100;45;3;42;.933;3600000;0
1268;86697;30;57;31;4;27;.871;3551000;0
1269;163471;34;0;0;0;0;.00nan;0;0
1269;183904;34;88;59;5;54;.915;3600000;0
1269;196005;22;0;0;0;0;.00nan;0;0
1269;143473;22;80;19;1;18;.947;3600000;0
1270;187578;26;67;23;2;21;.913;3309000;0
1270;183859;23;0;0;0;0;.00nan;0;0
1270;179154;26;23;4;3;1;.250;487000;0
1270;59540;23;49;25;4;21;.840;3796000;0
1271;556;33;98;55;3;52;.945;3574000;0
1271;183783;25;0;0;0;0;.00nan;0;0
1271;197038;33;0;0;0;0;.00nan;0;0
1271;191813;25;57;17;2;15;.882;3600000;0
1272;170314;5;64;23;3;20;.870;3600000;0
1272;175092;9;0;0;0;0;.00nan;0;0
1272;190106;9;47;25;4;21;.840;3562000;0
1272;201585;5;0;0;0;0;.00nan;0;0
1273;676;24;66;62;8;54;.871;3600000;0
1273;166591;15;0;0;0;0;.00nan;0;0
1273;187362;15;62;18;2;16;.889;3600000;0
1273;86192;24;0;0;0;0;.00nan;0;0
1274;3928;20;39;19;4;15;.789;3600000;0
1274;20432;28;46;36;6;30;.833;3560000;0
1274;205824;20;0;0;0;0;.00nan;0;0
1274;201174;28;0;0;0;0;.00nan;0;0
1275;183844;29;82;22;1;21;.955;3600000;0
1275;195089;29;0;0;0;0;.00nan;0;0
1275;139409;3;92;47;3;44;.936;3600000;0
1275;148958;3;0;0;0;0;.00nan;0;0
1276;166646;0;54;26;3;23;.885;3553000;0
1276;194416;17;0;0;0;0;.00nan;0;0
1276;178413;17;58;17;2;15;.882;3600000;0
1276;189333;0;0;0;0;0;.00nan;0;0
1277;13714;8;98;24;1;23;.958;3600000;0
1277;173699;10;60;41;6;35;.854;3342000;0
1277;58830;8;0;0;0;0;.00nan;0;0
1277;90164;10;48;0;0;0;.00nan;258000;0
1278;171838;31;0;0;0;0;.00nan;0;0
1278;175912;14;53;37;6;31;.838;3216000;0
1278;185034;14;50;6;1;5;.833;384000;0
1278;149452;31;77;28;3;25;.893;3600000;0
1279;187537;19;0;0;0;0;.00nan;0;0
1279;178384;19;45;30;5;25;.833;3600000;0
1279;196090;4838;77;34;2;32;.941;3600000;0
1279;185743;4838;0;0;0;0;.00nan;0;0
1280;788;27;62;28;3;25;.893;3645000;0
1280;172340;4182;0;0;0;0;.00nan;0;0
1280;171304;27;0;0;0;0;.00nan;0;0
1280;140314;4182;71;44;4;40;.909;3645000;0
1281;187718;16;30;25;5;20;.800;3600000;0
1281;193854;11;0;0;0;0;.00nan;0;0
1281;50065;16;0;0;0;0;.00nan;0;0
1281;146862;11;100;21;0;21;1.000;3600000;0
1282;183859;23;51;21;3;18;.857;3877000;0
1282;184229;35;82;44;4;40;.909;3877000;0
1282;59540;23;0;0;0;0;.00nan;0;0
1282;147977;35;0;0;0;0;.00nan;0;0
1283;556;33;0;0;0;0;.00nan;0;0
1283;206789;30;0;0;0;0;.00nan;0;0
1283;197038;33;57;30;3;27;.900;3600000;0
1283;86697;30;74;23;1;22;.957;3600000;0
1284;3284;21;0;0;0;0;.00nan;0;0
1284;165723;32;68;36;3;33;.917;2798000;0
1284;182116;21;74;29;2;27;.931;3600000;0
1284;85727;32;26;14;4;10;.714;802000;0
1285;192733;18;0;0;0;0;.00nan;0;0
1285;173727;18;60;25;3;22;.880;4200000;0
1285;174718;12;0;0;0;0;.00nan;0;0
1285;85798;12;81;42;3;39;.929;4200000;0
1286;194416;17;0;0;0;0;.00nan;0;0
1286;178413;17;67;32;3;29;.906;3600000;0
1286;139409;3;95;27;1;26;.963;3600000;0
1286;148958;3;0;0;0;0;.00nan;0;0
1287;676;24;97;43;2;41;.953;4200000;0
1287;196005;22;0;0;0;0;.00nan;0;0
1287;86192;24;0;0;0;0;.00nan;0;0
1287;143473;22;78;27;2;25;.926;4200000;0
1288;13714;8;100;25;0;25;1.000;3600000;0
1288;175912;14;98;33;1;32;.970;3546000;0
1288;185034;14;0;0;0;0;.00nan;0;0
1288;58830;8;0;0;0;0;.00nan;0;0
1289;20432;28;0;0;0;0;.00nan;0;0
1289;201174;28;100;47;1;46;.979;4200000;0
1289;175092;9;0;0;0;0;.00nan;0;0
1289;190106;9;97;40;1;39;.975;4200000;0
1290;171838;31;0;0;0;0;.00nan;0;0
1290;3928;20;61;29;4;25;.862;3600000;0
1290;205824;20;0;0;0;0;.00nan;0;0
1290;149452;31;94;44;2;42;.955;3600000;0
1291;163471;34;0;0;0;0;.00nan;0;0
1291;183844;29;34;40;8;32;.800;3123000;0
1291;183904;34;59;19;2;17;.895;3600000;0
1291;195089;29;49;1;0;1;1.000;477000;0
1292;193854;11;0;0;0;0;.00nan;0;0
1292;196090;4838;0;0;0;0;.00nan;0;0
1292;185743;4838;61;41;4;37;.902;3536000;0
1292;146862;11;95;31;2;29;.935;3600000;0
1293;788;27;0;0;0;0;.00nan;0;0
1293;187718;16;0;0;0;0;.00nan;0;0
1293;171304;27;47;23;3;20;.870;3600000;0
1293;50065;16;49;36;6;30;.833;3600000;0
1294;171838;31;19;34;8;26;.765;3098000;0
1294;183844;29;0;0;0;0;.00nan;0;0
1294;195089;29;47;30;5;25;.833;3600000;0
1294;149452;31;41;2;1;1;.500;502000;0
1295;3284;21;0;0;0;0;.00nan;0;0
1295;173699;10;0;0;0;0;.00nan;0;0
1295;182116;21;75;45;4;41;.911;3572000;0
1295;90164;10;87;39;3;36;.923;3600000;0
1296;166646;0;40;35;6;29;.829;3517000;0
1296;189333;0;0;0;0;0;.00nan;0;0
1296;170314;5;71;39;4;35;.897;3600000;0
1296;201585;5;0;0;0;0;.00nan;0;0
1297;194416;17;69;20;2;18;.900;3600000;0
1297;178413;17;0;0;0;0;.00nan;0;0
1297;139409;3;0;0;0;0;.00nan;0;0
1297;148958;3;94;44;3;41;.932;3594000;0
1298;166591;15;43;21;4;17;.810;3600000;0
1298;3928;20;95;43;3;40;.930;2938000;0
1298;205824;20;28;14;4;10;.714;662000;0
1298;187362;15;0;0;0;0;.00nan;0;0
1299;183783;25;0;0;0;0;.00nan;0;0
1299;183859;23;0;0;0;0;.00nan;0;0
1299;191813;25;68;12;1;11;.917;3600000;0
1299;59540;23;89;55;4;51;.927;3600000;0
1300;165723;32;0;0;0;0;.00nan;0;0
1300;206789;30;0;0;0;0;.00nan;0;0
1300;85727;32;69;35;4;31;.886;3600000;0
1300;86697;30;78;22;1;21;.955;3600000;0
1301;192733;18;0;0;0;0;.00nan;0;0
1301;187537;19;41;31;5;26;.839;3600000;0
1301;178384;19;0;0;0;0;.00nan;0;0
1301;173727;18;82;25;1;24;.960;3600000;0
1302;175912;14;60;34;4;30;.882;3600000;0
1302;196005;22;0;0;0;0;.00nan;0;0
1302;185034;14;0;0;0;0;.00nan;0;0
1302;143473;22;61;22;2;20;.909;3600000;0
1303;166646;0;87;28;1;27;.964;3600000;0
1303;189333;0;0;0;0;0;.00nan;0;0
1303;20432;28;64;29;3;26;.897;3600000;0
1303;201174;28;0;0;0;0;.00nan;0;0
1304;187578;26;0;0;0;0;.00nan;0;0
1304;184229;35;73;24;2;22;.917;3600000;0
1304;179154;26;98;50;4;46;.920;3593000;0
1304;147977;35;0;0;0;0;.00nan;0;0
1305;174718;12;0;0;0;0;.00nan;0;0
1305;196090;4838;0;0;0;0;.00nan;0;0
1305;185743;4838;91;21;0;21;1.000;3600000;0
1305;85798;12;73;31;2;29;.935;3513000;0
1306;187718;16;0;0;0;0;.00nan;0;0
1306;183859;23;0;0;0;0;.00nan;0;0
1306;50065;16;73;23;2;21;.913;3600000;0
1306;59540;23;50;22;3;19;.864;3545000;0
1307;187537;19;0;0;0;0;.00nan;0;0
1307;183783;25;0;0;0;0;.00nan;0;0
1307;178384;19;92;48;1;47;.979;3600000;0
1307;191813;25;97;38;3;35;.921;3541000;0
1308;192733;18;71;19;1;18;.947;3600000;0
1308;193854;11;0;0;0;0;.00nan;0;0
1308;173727;18;0;0;0;0;.00nan;0;0
1308;146862;11;86;50;4;46;.920;3600000;0
1309;556;33;41;34;6;28;.824;3118000;0
1309;196090;4838;0;0;0;0;.00nan;0;0
1309;185743;4838;73;38;3;35;.921;3600000;0
1309;197038;33;44;4;1;3;.750;482000;0
1310;172340;4182;61;30;4;26;.867;3874000;0
1310;206789;30;0;0;0;0;.00nan;0;0
1310;86697;30;76;34;3;31;.912;3874000;0
1310;140314;4182;0;0;0;0;.00nan;0;0
1311;788;27;48;24;3;21;.875;3599000;0
1311;165723;32;0;0;0;0;.00nan;0;0
1311;171304;27;0;0;0;0;.00nan;0;0
1311;85727;32;100;42;2;40;.952;3600000;0
1313;320;21;0;0;0;0;.00nan;0;0
1313;3284;21;79;40;3;37;.925;3563000;0
1313;205318;18;0;0;0;0;.00nan;0;0
1313;173727;18;77;24;1;23;.958;3600000;0
1315;184229;35;78;36;3;33;.917;3562000;0
1315;175912;14;0;0;0;0;.00nan;0;0
1315;185034;14;71;18;1;17;.944;3600000;0
1315;147977;35;0;0;0;0;.00nan;0;0
1317;163471;34;0;0;0;0;.00nan;0;0
1317;183904;34;51;31;5;26;.839;4200000;0
1317;205824;25;78;48;5;43;.896;4200000;0
1317;201673;25;0;0;0;0;.00nan;0;0
1319;676;24;87;39;2;37;.949;3600000;0
1319;166646;0;0;0;0;0;.00nan;0;0
1319;189333;0;50;28;4;24;.857;3519000;0
1319;86192;24;0;0;0;0;.00nan;0;0
1321;171838;31;98;42;1;41;.976;3600000;0
1321;13714;8;66;33;4;29;.879;3600000;0
1321;58830;8;0;0;0;0;.00nan;0;0
1321;149452;31;0;0;0;0;.00nan;0;0
1323;166591;20;0;0;0;0;.00nan;0;0
1323;183783;20;43;31;5;26;.839;3600000;0
1323;173699;10;76;30;2;28;.933;3600000;0
1323;90164;10;0;0;0;0;.00nan;0;0
1325;556;33;82;40;3;37;.925;3689000;0
1325;194416;17;0;0;0;0;.00nan;0;0
1325;178413;17;59;17;2;15;.882;3689000;0
1325;197038;33;0;0;0;0;.00nan;0;0
1327;210998;26;0;0;0;0;.00nan;0;0
1327;179154;26;85;26;1;25;.962;3600000;0
1327;196005;22;0;0;0;0;.00nan;0;0
1327;143473;22;65;32;3;29;.906;3519000;0
1329;165723;32;0;0;0;0;.00nan;0;0
1329;194893;32;54;36;5;31;.861;3586000;0
1329;186495;23;0;0;0;0;.00nan;0;0
1329;59540;23;75;36;3;33;.917;3600000;0
1331;201174;28;74;40;4;36;.900;3600000;0
1331;85437;28;0;0;0;0;.00nan;0;0
1331;139409;3;85;19;0;19;1.000;3600000;0
1331;148958;3;0;0;0;0;.00nan;0;0
1333;187537;19;0;0;0;0;.00nan;0;0
1333;187718;16;0;0;0;0;.00nan;0;0
1333;178384;19;62;27;3;24;.889;3557000;0
1333;50065;16;93;44;2;42;.955;3600000;0
1335;170977;30;0;0;0;0;.00nan;0;0
1335;175092;9;0;0;0;0;.00nan;0;0
1335;190106;9;85;47;4;43;.915;3600000;0
1335;86697;30;74;20;1;19;.950;3600000;0
1337;788;27;71;26;1;25;.962;3600000;0
1337;224943;27;0;0;0;0;.00nan;0;0
1337;196090;4838;57;26;3;23;.885;3516000;0
1337;179950;4838;0;0;0;0;.00nan;0;0
1339;3928;15;0;0;0;0;.00nan;0;0
1339;172340;4182;88;56;4;52;.929;3591000;0
1339;178098;15;49;22;3;19;.864;3600000;0
1339;140314;4182;0;0;0;0;.00nan;0;0
1341;193854;11;0;0;0;0;.00nan;0;0
1341;170314;5;98;28;1;27;.964;3600000;0
1341;201585;5;0;0;0;0;.00nan;0;0
1341;146862;11;82;34;2;32;.941;3600000;0
1343;183844;29;78;32;2;30;.938;3600000;0
1343;195089;29;0;0;0;0;.00nan;0;0
1343;174718;12;51;2;0;2;1.000;545000;0
1343;85798;12;28;29;6;23;.793;3055000;0
1345;183844;29;0;0;0;0;.00nan;0;0
1345;195089;29;39;32;5;27;.844;3974000;0
1345;174718;12;0;0;0;0;.00nan;0;0
1345;85798;12;67;39;4;35;.897;3974000;0
1347;193854;11;0;0;0;0;.00nan;0;0
1347;173699;10;0;0;0;0;.00nan;0;0
1347;90164;10;100;29;0;29;1.000;3600000;0
1347;146862;11;76;35;3;32;.914;3600000;0
1349;171838;31;65;11;1;10;.909;3600000;0
1349;187537;19;0;0;0;0;.00nan;0;0
1349;178384;19;98;47;2;45;.957;3591000;0
1349;149452;31;0;0;0;0;.00nan;0;0
1351;556;33;100;53;2;51;.962;3600000;0
1351;194416;17;0;0;0;0;.00nan;0;0
1351;178413;17;44;21;3;18;.857;3556000;0
1351;197038;33;0;0;0;0;.00nan;0;0
1353;676;24;65;37;4;33;.892;3600000;0
1353;186495;23;0;0;0;0;.00nan;0;0
1353;59540;23;65;30;3;27;.900;3600000;0
1353;86192;24;0;0;0;0;.00nan;0;0
1355;320;21;0;0;0;0;.00nan;0;0
1355;3284;21;68;28;2;26;.929;3600000;0
1355;3928;15;0;0;0;0;.00nan;0;0
1355;178098;15;48;22;4;18;.818;3514000;0
1357;163471;34;51;26;4;22;.846;3600000;0
1357;183904;34;0;0;0;0;.00nan;0;0
1357;210998;26;0;0;0;0;.00nan;0;0
1357;179154;26;42;25;5;20;.800;3575000;0
1359;13714;8;100;25;0;25;1.000;3600000;0
1359;58830;8;0;0;0;0;.00nan;0;0
1359;139409;3;29;32;7;25;.781;3130000;0
1359;148958;3;62;9;0;9;1.000;470000;0
1361;788;27;62;29;3;26;.897;2523000;0
1361;224943;27;38;19;4;15;.789;1077000;0
1361;205318;18;0;0;0;0;.00nan;0;0
1361;173727;18;64;26;3;23;.885;3600000;0
1363;166646;0;95;22;0;22;1.000;3600000;0
1363;189333;0;0;0;0;0;.00nan;0;0
1363;175912;14;0;0;0;0;.00nan;0;0
1363;185034;14;57;22;3;19;.864;3600000;0
1365;205824;25;83;33;2;31;.939;3600000;0
1365;170977;30;0;0;0;0;.00nan;0;0
1365;201673;25;0;0;0;0;.00nan;0;0
1365;86697;30;98;44;3;41;.932;3550000;0
1367;172340;4182;49;26;4;22;.846;3648000;0
1367;184229;35;79;35;3;32;.914;3648000;0
1367;140314;4182;0;0;0;0;.00nan;0;0
1367;147977;35;0;0;0;0;.00nan;0;0
1369;187718;16;0;0;0;0;.00nan;0;0
1369;196090;4838;0;0;0;0;.00nan;0;0
1369;179950;4838;78;39;3;36;.923;3600000;0
1369;50065;16;28;25;6;19;.760;3600000;0
1371;201174;28;81;43;3;40;.930;3600000;0
1371;175092;9;0;0;0;0;.00nan;0;0
1371;190106;9;58;32;4;28;.875;3585000;0
1371;85437;28;0;0;0;0;.00nan;0;0
1373;166591;20;36;34;6;28;.824;2973000;0
1373;183783;20;72;12;0;12;1.000;627000;0
1373;196005;22;0;0;0;0;.00nan;0;0
1373;143473;22;78;27;2;25;.926;3600000;0
1375;165723;32;70;26;2;24;.923;3600000;0
1375;194893;32;0;0;0;0;.00nan;0;0
1375;170314;5;0;0;0;0;.00nan;0;0
1375;201585;5;68;37;4;33;.892;3570000;0
1377;166646;0;72;31;2;29;.935;3600000;0
1377;172340;4182;0;0;0;0;.00nan;0;0
1377;189333;0;0;0;0;0;.00nan;0;0
1377;140314;4182;74;46;4;42;.913;3574000;0
1379;194416;17;98;34;1;33;.971;3600000;0
1379;178413;17;0;0;0;0;.00nan;0;0
1379;175092;9;76;26;2;24;.923;3544000;0
1379;190106;9;0;0;0;0;.00nan;0;0
1381;171838;31;0;0;0;0;.00nan;0;0
1381;13714;8;71;25;2;23;.920;3600000;0
1381;58830;8;0;0;0;0;.00nan;0;0
1381;149452;31;69;33;3;30;.909;3544000;0
1383;556;33;0;0;0;0;.00nan;0;0
1383;184229;35;0;0;0;0;.00nan;0;0
1383;197038;33;67;38;4;34;.895;3600000;0
1383;147977;35;66;27;3;24;.889;3600000;0
1385;201174;28;0;0;0;0;.00nan;0;0
1385;196005;22;49;22;3;19;.864;3544000;0
1385;85437;28;82;35;2;33;.943;3600000;0
1385;143473;22;0;0;0;0;.00nan;0;0
1387;320;21;69;27;2;25;.926;4200000;0
1387;676;24;0;0;0;0;.00nan;0;0
1387;3284;21;0;0;0;0;.00nan;0;0
1387;86192;24;98;42;2;40;.952;4200000;0
1389;183844;29;35;16;4;12;.750;900000;0
1389;195089;29;71;29;2;27;.931;3300000;0
1389;205824;25;35;29;6;23;.793;2899000;0
1389;201673;25;58;11;0;11;1.000;1301000;0
1391;174718;12;93;33;1;32;.970;3600000;0
1391;175912;14;56;29;4;25;.862;3600000;0
1391;185034;14;0;0;0;0;.00nan;0;0
1391;85798;12;0;0;0;0;.00nan;0;0
1393;163471;34;0;0;0;0;.00nan;0;0
1393;193854;11;77;63;6;57;.905;3600000;0
1393;183904;34;100;23;0;23;1.000;3600000;0
1393;146862;11;0;0;0;0;.00nan;0;0
1395;3928;15;70;16;1;15;.938;3600000;0
1395;178098;15;0;0;0;0;.00nan;0;0
1395;205318;18;85;53;4;49;.925;3600000;0
1395;173727;18;0;0;0;0;.00nan;0;0
1397;187718;16;100;27;0;27;1.000;3600000;0
1397;210998;26;79;50;4;46;.920;3600000;0
1397;179154;26;0;0;0;0;.00nan;0;0
1397;50065;16;0;0;0;0;.00nan;0;0
1399;166591;20;0;0;0;0;.00nan;0;0
1399;788;27;0;0;0;0;.00nan;0;0
1399;224943;27;55;25;3;22;.880;3527000;0
1399;183783;20;88;28;1;27;.964;3600000;0
1401;187537;19;67;28;2;26;.929;3600000;0
1401;178384;19;0;0;0;0;.00nan;0;0
1401;170314;5;79;45;3;42;.933;3561000;0
1401;201585;5;0;0;0;0;.00nan;0;0
1403;170977;30;73;23;2;21;.913;3600000;0
1403;86697;30;0;0;0;0;.00nan;0;0
1403;139409;3;0;0;0;0;.00nan;0;0
1403;148958;3;70;39;4;35;.897;3600000;0
1405;196090;4838;92;20;0;20;1.000;3600000;0
1405;179950;4838;0;0;0;0;.00nan;0;0
1405;186495;23;10;9;5;4;.444;1072000;0
1405;59540;23;56;23;3;20;.870;2528000;0
1407;173699;10;67;41;4;37;.902;4200000;0
1407;194893;32;65;43;4;39;.907;4200000;0
1407;85727;32;0;0;0;0;.00nan;0;0
1407;90164;10;0;0;0;0;.00nan;0;0
1409;166591;20;0;0;0;0;.00nan;0;0
1409;788;27;43;34;5;29;.853;4200000;0
1409;224943;27;0;0;0;0;.00nan;0;0
1409;183783;20;38;24;5;19;.792;4200000;0
1411;320;21;0;0;0;0;.00nan;0;0
1411;3284;21;46;31;4;27;.871;4200000;0
1411;205318;18;0;0;0;0;.00nan;0;0
1411;173727;18;61;33;4;29;.879;4200000;0
1413;676;24;0;0;0;0;.00nan;0;0
1413;13714;8;85;36;2;34;.944;3600000;0
1413;58830;8;0;0;0;0;.00nan;0;0
1413;86192;24;58;34;4;30;.882;3518000;0
1415;556;33;100;48;1;47;.979;3600000;0
1415;184229;35;56;17;2;15;.882;3600000;0
1415;197038;33;0;0;0;0;.00nan;0;0
1415;147977;35;0;0;0;0;.00nan;0;0
1417;201174;28;73;26;2;24;.923;3600000;0
1417;175092;9;0;0;0;0;.00nan;0;0
1417;190106;9;72;37;3;34;.919;3586000;0
1417;85437;28;0;0;0;0;.00nan;0;0
1419;173699;10;0;0;0;0;.00nan;0;0
1419;175912;14;0;0;0;0;.00nan;0;0
1419;185034;14;84;34;1;33;.971;4200000;0
1419;90164;10;100;34;1;33;.971;4200000;0
1421;170977;30;0;0;0;0;.00nan;0;0
1421;196005;22;0;0;0;0;.00nan;0;0
1421;86697;30;94;37;1;36;.973;3560000;0
1421;143473;22;99;25;0;25;1.000;3600000;0
1423;172340;4182;36;24;5;19;.792;3600000;0
1423;194893;32;69;25;2;23;.920;3600000;0
1423;85727;32;0;0;0;0;.00nan;0;0
1423;140314;4182;0;0;0;0;.00nan;0;0
1425;170314;5;74;29;2;27;.931;3600000;0
1425;201585;5;0;0;0;0;.00nan;0;0
1425;186495;23;0;0;0;0;.00nan;0;0
1425;59540;23;54;24;3;21;.875;3573000;0
1427;166646;0;100;41;2;39;.951;4200000;0
1427;183844;29;82;44;2;42;.955;4200000;0
1427;189333;0;0;0;0;0;.00nan;0;0
1427;195089;29;0;0;0;0;.00nan;0;0
1429;187537;19;0;0;0;0;.00nan;0;0
1429;193854;11;0;0;0;0;.00nan;0;0
1429;178384;19;72;29;2;27;.931;4200000;0
1429;146862;11;77;32;2;30;.938;4200000;0
1431;174718;12;0;0;0;0;.00nan;0;0
1431;196090;4838;62;33;5;28;.848;3600000;0
1431;179950;4838;0;0;0;0;.00nan;0;0
1431;85798;12;78;31;2;29;.935;3600000;0
1433;194416;17;0;0;0;0;.00nan;0;0
1433;178413;17;60;31;4;27;.871;3562000;0
1433;210998;26;0;0;0;0;.00nan;0;0
1433;179154;26;73;36;3;33;.917;3600000;0
1435;171838;31;85;28;1;27;.964;3600000;0
1435;187718;16;0;0;0;0;.00nan;0;0
1435;50065;16;64;27;3;24;.889;3600000;0
1435;149452;31;0;0;0;0;.00nan;0;0
1437;3928;15;74;39;3;36;.923;3600000;0
1437;178098;15;0;0;0;0;.00nan;0;0
1437;205824;25;0;0;0;0;.00nan;0;0
1437;201673;25;68;27;2;25;.926;3600000;0
1439;163471;34;0;0;0;0;.00nan;0;0
1439;183904;34;61;29;3;26;.897;3600000;0
1439;139409;3;51;34;5;29;.853;3600000;0
1439;148958;3;0;0;0;0;.00nan;0;0
1441;171838;31;0;0;0;0;.00nan;0;0
1441;3928;15;0;0;0;0;.00nan;0;0
1441;178098;15;45;11;2;9;.818;3600000;0
1441;149452;31;73;54;6;48;.889;3600000;0
1443;184229;35;0;0;0;0;.00nan;0;0
1443;174718;12;74;47;5;42;.894;3600000;0
1443;85798;12;0;0;0;0;.00nan;0;0
1443;147977;35;80;28;2;26;.929;3600000;0
1445;205318;18;58;17;2;15;.882;3600000;0
1445;173727;18;0;0;0;0;.00nan;0;0
1445;210998;26;80;40;3;37;.925;3600000;0
1445;179154;26;0;0;0;0;.00nan;0;0
1447;187718;16;67;23;1;22;.957;3600000;0
1447;170977;30;70;46;4;42;.913;3600000;0
1447;50065;16;0;0;0;0;.00nan;0;0
1447;86697;30;0;0;0;0;.00nan;0;0
1449;173699;10;100;34;0;34;1.000;3600000;0
1449;186495;23;84;40;4;36;.900;3600000;0
1449;59540;23;0;0;0;0;.00nan;0;0
1449;90164;10;0;0;0;0;.00nan;0;0
1451;676;24;90;20;0;20;1.000;3600000;0
1451;86192;24;0;0;0;0;.00nan;0;0
1451;139409;3;0;0;0;0;.00nan;0;0
1451;148958;3;83;51;4;47;.922;3600000;0
1453;320;21;65;18;1;17;.944;3600000;0
1453;3284;21;0;0;0;0;.00nan;0;0
1453;201174;28;52;39;6;33;.846;2465000;0
1453;85437;28;28;14;4;10;.714;1135000;0
1455;205824;25;0;0;0;0;.00nan;0;0
1455;201673;25;36;13;3;10;.769;3600000;0
1455;196090;4838;0;0;0;0;.00nan;0;0
1455;179950;4838;100;30;0;30;1.000;3600000;0
1457;193854;11;77;30;2;28;.933;3564000;0
1457;175092;9;76;25;1;24;.960;3600000;0
1457;190106;9;0;0;0;0;.00nan;0;0
1457;146862;11;0;0;0;0;.00nan;0;0
1459;187537;19;74;45;4;41;.911;3600000;0
1459;178384;19;0;0;0;0;.00nan;0;0
1459;194416;17;95;30;1;29;.967;3600000;0
1459;178413;17;0;0;0;0;.00nan;0;0
1461;172340;4182;97;37;1;36;.973;4200000;0
1461;196005;22;73;22;1;21;.955;4200000;0
1461;140314;4182;0;0;0;0;.00nan;0;0
1461;143473;22;0;0;0;0;.00nan;0;0
1463;556;33;0;0;0;0;.00nan;0;0
1463;194893;32;0;0;0;0;.00nan;0;0
1463;197038;33;74;40;3;37;.925;3594000;0
1463;85727;32;70;23;2;21;.913;3600000;0
1465;166646;0;0;0;0;0;.00nan;0;0
1465;189333;0;95;34;1;33;.971;3600000;0
1465;175912;14;70;34;3;31;.912;3578000;0
1465;185034;14;0;0;0;0;.00nan;0;0
1467;163471;34;56;30;4;26;.867;3600000;0
1467;183904;34;0;0;0;0;.00nan;0;0
1467;170314;5;56;12;1;11;.917;1073000;0
1467;201585;5;47;34;6;28;.824;2527000;0
1469;788;27;0;0;0;0;.00nan;0;0
1469;224943;27;64;34;3;31;.912;4200000;0
1469;13714;8;0;0;0;0;.00nan;0;0
1469;58830;8;55;30;3;27;.900;4200000;0
1471;166591;20;67;32;3;29;.906;3600000;0
1471;183783;20;0;0;0;0;.00nan;0;0
1471;183844;29;0;0;0;0;.00nan;0;0
1471;195089;29;83;31;2;29;.935;3600000;0
1473;170977;30;0;0;0;0;.00nan;0;0
1473;186495;23;0;0;0;0;.00nan;0;0
1473;59540;23;86;47;4;43;.915;3600000;0
1473;86697;30;69;16;1;15;.938;3600000;0
1475;205824;25;0;0;0;0;.00nan;0;0
1475;175092;9;0;0;0;0;.00nan;0;0
1475;190106;9;72;45;4;41;.911;3600000;0
1475;201673;25;81;17;1;16;.941;3600000;0
1477;194893;32;82;38;2;36;.947;3600000;0
1477;174718;12;96;51;3;48;.941;3572000;0
1477;85727;32;0;0;0;0;.00nan;0;0
1477;85798;12;0;0;0;0;.00nan;0;0
1479;166591;20;0;0;0;0;.00nan;0;0
1479;166646;0;82;23;1;22;.957;3575000;0
1479;183783;20;100;34;0;34;1.000;3600000;0
1479;189333;0;0;0;0;0;.00nan;0;0
1481;163471;34;0;0;0;0;.00nan;0;0
1481;183904;34;71;7;0;7;1.000;3600000;0
1481;139409;3;84;55;5;50;.909;3600000;0
1481;148958;3;0;0;0;0;.00nan;0;0
1483;556;33;92;56;5;51;.911;3600000;0
1483;184229;35;93;34;1;33;.971;3600000;0
1483;197038;33;0;0;0;0;.00nan;0;0
1483;147977;35;0;0;0;0;.00nan;0;0
1485;13714;8;54;34;5;29;.853;3600000;0
1485;175912;14;0;0;0;0;.00nan;0;0
1485;185034;14;99;44;2;42;.955;3600000;0
1485;58830;8;0;0;0;0;.00nan;0;0
1487;320;21;0;0;0;0;.00nan;0;0
1487;3284;21;62;31;3;28;.903;3600000;0
1487;193854;11;0;0;0;0;.00nan;0;0
1487;146862;11;47;30;4;26;.867;3575000;0
1489;183844;29;100;41;1;40;.976;3600000;0
1489;173699;10;50;18;2;16;.889;3600000;0
1489;195089;29;0;0;0;0;.00nan;0;0
1489;90164;10;0;0;0;0;.00nan;0;0
1491;194416;17;0;0;0;0;.00nan;0;0
1491;178413;17;47;33;4;29;.879;3600000;0
1491;201174;28;80;59;6;53;.898;3513000;0
1491;85437;28;0;0;0;0;.00nan;0;0
1493;170314;5;71;24;2;22;.917;3600000;0
1493;210998;26;0;0;0;0;.00nan;0;0
1493;179154;26;52;30;4;26;.867;3600000;0
1493;201585;5;0;0;0;0;.00nan;0;0
1495;676;24;53;37;5;32;.865;3600000;0
1495;205318;18;0;0;0;0;.00nan;0;0
1495;173727;18;38;31;6;25;.806;3549000;0
1495;86192;24;0;0;0;0;.00nan;0;0
1497;172340;4182;50;25;3;22;.880;3600000;0
1497;196090;4838;0;0;0;0;.00nan;0;0
1497;179950;4838;98;42;1;41;.976;3600000;0
1497;140314;4182;0;0;0;0;.00nan;0;0
1499;788;27;70;33;2;31;.939;3833000;0
1499;224943;27;0;0;0;0;.00nan;0;0
1499;196005;22;0;0;0;0;.00nan;0;0
1499;143473;22;50;20;3;17;.850;3833000;0
1501;187537;19;0;0;0;0;.00nan;0;0
1501;187718;16;0;0;0;0;.00nan;0;0
1501;178384;19;74;23;1;22;.957;3600000;0
1501;50065;16;74;29;2;27;.931;3600000;0
1503;171838;31;98;51;3;48;.941;3600000;0
1503;3928;15;0;0;0;0;.00nan;0;0
1503;178098;15;39;21;4;17;.810;3559000;0
1503;149452;31;0;0;0;0;.00nan;0;0
1505;320;21;86;30;1;29;.967;3600000;0
1505;3284;21;0;0;0;0;.00nan;0;0
1505;194416;17;23;38;7;31;.816;3600000;0
1505;178413;17;0;0;0;0;.00nan;0;0
1507;556;33;77;53;4;49;.925;3600000;0
1507;186495;23;67;18;1;17;.944;3600000;0
1507;197038;33;0;0;0;0;.00nan;0;0
1507;59540;23;0;0;0;0;.00nan;0;0
1509;171838;31;0;0;0;0;.00nan;0;0
1509;173699;10;0;0;0;0;.00nan;0;0
1509;90164;10;92;34;2;32;.941;4200000;0
1509;149452;31;86;40;2;38;.950;4200000;0
1511;676;24;64;9;0;9;1.000;1062000;0
1511;205824;25;0;0;0;0;.00nan;0;0
1511;201673;25;57;22;3;19;.864;3600000;0
1511;86192;24;27;27;6;21;.778;2538000;0
1513;170314;5;0;0;0;0;.00nan;0;0
1513;170977;30;71;27;2;25;.926;3600000;0
1513;201585;5;49;27;3;24;.889;3600000;0
1513;86697;30;0;0;0;0;.00nan;0;0
1515;196005;22;33;15;4;11;.733;3754000;0
1515;139409;3;97;48;3;45;.938;3754000;0
1515;143473;22;0;0;0;0;.00nan;0;0
1515;148958;3;0;0;0;0;.00nan;0;0
1517;166591;20;0;0;0;0;.00nan;0;0
1517;183783;20;76;33;3;30;.909;3600000;0
1517;175912;14;55;39;5;34;.872;3565000;0
1517;185034;14;0;0;0;0;.00nan;0;0
1519;187537;19;84;40;4;36;.900;3600000;0
1519;178384;19;0;0;0;0;.00nan;0;0
1519;201174;28;0;0;0;0;.00nan;0;0
1519;85437;28;68;25;2;23;.920;3600000;0
1521;172340;4182;0;0;0;0;.00nan;0;0
1521;175092;9;42;25;5;20;.800;1841000;0
1521;190106;9;72;13;0;13;1.000;1759000;0
1521;140314;4182;24;36;7;29;.806;3575000;0
1523;788;27;29;27;6;21;.778;1949000;0
1523;163471;34;0;0;0;0;.00nan;0;0
1523;224943;27;38;11;2;9;.818;1651000;0
1523;183904;34;72;26;2;24;.923;3600000;0
1525;3928;15;84;11;0;11;1.000;3600000;0
1525;178098;15;0;0;0;0;.00nan;0;0
1525;174718;12;60;9;0;9;1.000;1077000;0
1525;85798;12;52;41;6;35;.854;2523000;0
1527;166646;0;0;0;0;0;.00nan;0;0
1527;13714;8;0;0;0;0;.00nan;0;0
1527;189333;0;61;33;4;29;.879;3511000;0
1527;58830;8;100;39;2;37;.949;3600000;0
1529;205318;18;21;13;5;8;.615;1681000;0
1529;173727;18;54;10;1;9;.900;1919000;0
1529;210998;26;61;28;3;25;.893;3600000;0
1529;179154;26;0;0;0;0;.00nan;0;0
1531;183844;29;0;0;0;0;.00nan;0;0
1531;194893;32;0;0;0;0;.00nan;0;0
1531;195089;29;62;34;4;30;.882;3580000;0
1531;85727;32;52;22;3;19;.864;3600000;0
1533;187718;16;52;34;4;30;.882;3600000;0
1533;196090;4838;71;25;2;23;.920;3600000;0
1533;179950;4838;0;0;0;0;.00nan;0;0
1533;50065;16;0;0;0;0;.00nan;0;0
1535;193854;11;62;48;6;42;.875;3143000;0
1535;184229;35;0;0;0;0;.00nan;0;0
1535;146862;11;41;3;1;2;.667;457000;0
1535;147977;35;42;18;3;15;.833;3600000;0
2324;166591;15;100;28;1;27;.964;3600000;0
2324;173699;10;98;50;3;47;.940;3538000;0
2324;187362;15;0;0;0;0;.00nan;0;0
2324;90164;10;0;0;0;0;.00nan;0;0
2325;3284;21;0;0;0;0;.00nan;0;0
2325;183844;29;95;50;3;47;.940;4443000;0
2325;195089;29;0;0;0;0;.00nan;0;0
2325;182116;21;48;28;4;24;.857;4443000;0
2326;170314;5;89;39;3;36;.923;3624000;0
2326;201585;5;0;0;0;0;.00nan;0;0
2326;196005;22;0;0;0;0;.00nan;0;0
2326;143473;22;53;16;2;14;.875;3624000;0
2327;163471;34;0;0;0;0;.00nan;0;0
2327;194416;17;0;0;0;0;.00nan;0;0
2327;178413;17;51;31;4;27;.871;3559000;0
2327;183904;34;93;43;3;40;.930;3600000;0
2328;183783;25;0;0;0;0;.00nan;0;0
2328;184229;35;74;28;2;26;.929;3580000;0
2328;191813;25;82;22;1;21;.955;3600000;0
2328;147977;35;0;0;0;0;.00nan;0;0
2329;192733;18;0;0;0;0;.00nan;0;0
2329;187718;16;0;0;0;0;.00nan;0;0
2329;173727;18;30;23;5;18;.783;3521000;0
2329;50065;16;77;39;3;36;.923;3600000;0
2330;187578;26;0;0;0;0;.00nan;0;0
2330;183859;23;0;0;0;0;.00nan;0;0
2330;179154;26;92;37;2;35;.946;3600000;0
2330;59540;23;52;32;5;27;.844;3589000;0
2331;193854;11;0;0;0;0;.00nan;0;0
2331;13714;8;61;33;3;30;.909;4324000;0
2331;58830;8;0;0;0;0;.00nan;0;0
2331;146862;11;96;38;2;36;.947;4324000;0
2332;166591;15;57;25;3;22;.880;3871000;0
2332;173699;10;91;37;2;35;.946;3871000;0
2332;187362;15;0;0;0;0;.00nan;0;0
2332;90164;10;0;0;0;0;.00nan;0;0
2333;3284;21;0;0;0;0;.00nan;0;0
2333;183844;29;70;33;3;30;.909;3600000;0
2333;195089;29;0;0;0;0;.00nan;0;0
2333;182116;21;94;22;0;22;1.000;3600000;0
2334;170314;5;69;31;3;28;.903;3580000;0
2334;201585;5;0;0;0;0;.00nan;0;0
2334;196005;22;0;0;0;0;.00nan;0;0
2334;143473;22;80;25;1;24;.960;3600000;0
2335;163471;34;0;0;0;0;.00nan;0;0
2335;194416;17;0;0;0;0;.00nan;0;0
2335;178413;17;69;32;3;29;.906;3561000;0
2335;183904;34;98;22;0;22;1.000;3600000;0
2336;183783;25;0;0;0;0;.00nan;0;0
2336;184229;35;83;37;2;35;.946;3600000;0
2336;191813;25;32;19;4;15;.789;3543000;0
2336;147977;35;0;0;0;0;.00nan;0;0
2337;192733;18;0;0;0;0;.00nan;0;0
2337;187718;16;0;0;0;0;.00nan;0;0
2337;173727;18;67;22;2;20;.909;3773000;0
2337;50065;16;78;26;1;25;.962;3773000;0
2338;187578;26;0;0;0;0;.00nan;0;0
2338;183859;23;0;0;0;0;.00nan;0;0
2338;179154;26;100;30;0;30;1.000;3600000;0
2338;59540;23;95;30;1;29;.967;3600000;0
2339;193854;11;0;0;0;0;.00nan;0;0
2339;13714;8;100;24;0;24;1.000;3600000;0
2339;58830;8;0;0;0;0;.00nan;0;0
2339;146862;11;89;38;1;37;.974;3600000;0
2340;166591;15;93;18;0;18;1.000;3600000;0
2340;173699;10;98;45;1;44;.978;3597000;0
2340;187362;15;0;0;0;0;.00nan;0;0
2340;90164;10;0;0;0;0;.00nan;0;0
2341;3284;21;0;0;0;0;.00nan;0;0
2341;183844;29;94;50;2;48;.960;4651000;0
2341;195089;29;0;0;0;0;.00nan;0;0
2341;182116;21;90;45;3;42;.933;4651000;0
2342;170314;5;80;32;2;30;.938;3600000;0
2342;201585;5;0;0;0;0;.00nan;0;0
2342;196005;22;0;0;0;0;.00nan;0;0
2342;143473;22;54;28;4;24;.857;3555000;0
2343;163471;34;0;0;0;0;.00nan;0;0
2343;194416;17;0;0;0;0;.00nan;0;0
2343;178413;17;55;23;3;20;.870;3596000;0
2343;183904;34;70;25;2;23;.920;3600000;0
2344;183783;25;0;0;0;0;.00nan;0;0
2344;184229;35;92;44;2;42;.955;3846000;0
2344;191813;25;78;19;1;18;.947;3846000;0
2344;147977;35;0;0;0;0;.00nan;0;0
2345;192733;18;76;20;0;20;1.000;1389000;0
2345;187718;16;0;0;0;0;.00nan;0;0
2345;173727;18;15;19;6;13;.684;2211000;0
2345;50065;16;72;29;2;27;.931;3600000;0
2346;187578;26;0;0;0;0;.00nan;0;0
2346;183859;23;0;0;0;0;.00nan;0;0
2346;179154;26;36;36;7;29;.806;3600000;0
2346;59540;23;71;25;2;23;.920;3600000;0
2347;193854;11;0;0;0;0;.00nan;0;0
2347;13714;8;51;34;5;29;.853;3600000;0
2347;58830;8;0;0;0;0;.00nan;0;0
2347;146862;11;85;14;0;14;1.000;3600000;0
2348;166591;15;87;34;2;32;.941;3515000;0
2348;173699;10;100;33;0;33;1.000;3600000;0
2348;187362;15;0;0;0;0;.00nan;0;0
2348;90164;10;0;0;0;0;.00nan;0;0
2349;3284;21;0;0;0;0;.00nan;0;0
2349;183844;29;62;40;5;35;.875;3551000;0
2349;195089;29;0;0;0;0;.00nan;0;0
2349;182116;21;53;29;4;25;.862;3600000;0
2350;170314;5;60;37;4;33;.892;3600000;0
2350;201585;5;0;0;0;0;.00nan;0;0
2350;196005;22;0;0;0;0;.00nan;0;0
2350;143473;22;74;11;0;11;1.000;3600000;0
2351;163471;34;0;0;0;0;.00nan;0;0
2351;194416;17;0;0;0;0;.00nan;0;0
2351;178413;17;82;35;2;33;.943;3600000;0
2351;183904;34;78;41;3;38;.927;3600000;0
2352;183783;25;0;0;0;0;.00nan;0;0
2352;184229;35;63;30;3;27;.900;3600000;0
2352;191813;25;39;20;4;16;.800;3589000;0
2352;147977;35;0;0;0;0;.00nan;0;0
2353;192733;18;0;0;0;0;.00nan;0;0
2353;187718;16;0;0;0;0;.00nan;0;0
2353;173727;18;74;10;0;10;1.000;3600000;0
2353;50065;16;60;45;5;40;.889;3600000;0
2354;187578;26;0;0;0;0;.00nan;0;0
2354;183859;23;0;0;0;0;.00nan;0;0
2354;179154;26;56;23;3;20;.870;3600000;0
2354;59540;23;71;26;2;24;.923;3600000;0
2355;193854;11;0;0;0;0;.00nan;0;0
2355;13714;8;65;31;3;28;.903;3522000;0
2355;58830;8;0;0;0;0;.00nan;0;0
2355;146862;11;60;15;1;14;.933;3600000;0
2529;166591;15;72;22;1;21;.955;3600000;0
2529;173699;10;76;46;6;40;.870;3600000;0
2529;187362;15;0;0;0;0;.00nan;0;0
2529;90164;10;0;0;0;0;.00nan;0;0
2530;3284;21;0;0;0;0;.00nan;0;0
2530;183844;29;75;33;3;30;.909;3600000;0
2530;195089;29;0;0;0;0;.00nan;0;0
2530;182116;21;68;37;4;33;.892;3579000;0
2531;170314;5;57;40;5;35;.875;3600000;0
2531;201585;5;0;0;0;0;.00nan;0;0
2531;196005;22;0;0;0;0;.00nan;0;0
2531;143473;22;89;15;0;15;1.000;3600000;0
2532;163471;34;0;0;0;0;.00nan;0;0
2532;194416;17;0;0;0;0;.00nan;0;0
2532;178413;17;69;26;2;24;.923;3600000;0
2532;183904;34;50;22;3;19;.864;3535000;0
2533;183783;25;0;0;0;0;.00nan;0;0
2533;184229;35;23;12;4;8;.667;1041000;0
2533;191813;25;60;24;2;22;.917;3600000;0
2533;147977;35;47;27;4;23;.852;2559000;0
2534;192733;18;0;0;0;0;.00nan;0;0
2534;187718;16;0;0;0;0;.00nan;0;0
2534;173727;18;77;22;1;21;.955;3600000;0
2534;50065;16;47;36;5;31;.861;3600000;0
2535;187578;26;0;0;0;0;.00nan;0;0
2535;183859;23;0;0;0;0;.00nan;0;0
2535;179154;26;76;34;3;31;.912;3600000;0
2535;59540;23;55;29;4;25;.862;3552000;0
2536;193854;11;0;0;0;0;.00nan;0;0
2536;13714;8;98;22;0;22;1.000;3600000;0
2536;58830;8;0;0;0;0;.00nan;0;0
2536;146862;11;48;26;4;22;.846;3600000;0
2556;166591;15;70;17;1;16;.941;3600000;0
2556;173699;10;89;48;3;45;.938;3547000;0
2556;187362;15;0;0;0;0;.00nan;0;0
2556;90164;10;0;0;0;0;.00nan;0;0
2557;3284;21;0;0;0;0;.00nan;0;0
2557;183844;29;86;58;4;54;.931;5330000;0
2557;195089;29;0;0;0;0;.00nan;0;0
2557;182116;21;67;39;3;36;.923;5330000;0
2558;163471;34;0;0;0;0;.00nan;0;0
2558;194416;17;0;0;0;0;.00nan;0;0
2558;178413;17;69;29;2;27;.931;3600000;0
2558;183904;34;46;32;5;27;.844;3600000;0
2559;183783;25;0;0;0;0;.00nan;0;0
2559;184229;35;46;30;5;25;.833;3600000;0
2559;191813;25;71;15;1;14;.933;3600000;0
2559;147977;35;0;0;0;0;.00nan;0;0
2560;192733;18;0;0;0;0;.00nan;0;0
2560;187718;16;0;0;0;0;.00nan;0;0
2560;173727;18;49;18;3;15;.833;3600000;0
2560;50065;16;55;31;4;27;.871;3600000;0
2561;187578;26;0;0;0;0;.00nan;0;0
2561;183859;23;0;0;0;0;.00nan;0;0
2561;179154;26;78;39;3;36;.923;3600000;0
2561;59540;23;56;28;4;24;.857;3600000;0
2562;193854;11;0;0;0;0;.00nan;0;0
2562;13714;8;98;44;2;42;.955;3556000;0
2562;58830;8;0;0;0;0;.00nan;0;0
2562;146862;11;70;19;1;18;.947;3600000;0
2574;3284;21;0;0;0;0;.00nan;0;0
2574;183844;29;78;32;2;30;.938;3600000;0
2574;195089;29;0;0;0;0;.00nan;0;0
2574;182116;21;50;26;4;22;.846;3563000;0
2575;163471;34;0;0;0;0;.00nan;0;0
2575;194416;17;0;0;0;0;.00nan;0;0
2575;178413;17;91;47;2;45;.957;3956000;0
2575;183904;34;80;23;1;22;.957;3887000;0
2576;192733;18;0;0;0;0;.00nan;0;0
2576;187718;16;0;0;0;0;.00nan;0;0
2576;173727;18;67;33;3;30;.909;3556000;0
2576;50065;16;63;24;2;22;.917;3600000;0
2642;166591;15;88;38;2;36;.947;3552000;0
2642;163471;34;0;0;0;0;.00nan;0;0
2642;183904;34;100;24;0;24;1.000;3600000;0
2642;187362;15;0;0;0;0;.00nan;0;0
2643;183844;29;83;30;1;29;.967;3600000;0
2643;195089;29;0;0;0;0;.00nan;0;0
2643;196005;22;0;0;0;0;.00nan;0;0
2643;143473;22;85;30;2;28;.933;3600000;0
2644;187718;16;48;0;0;0;.00nan;249000;0
2644;183783;25;0;0;0;0;.00nan;0;0
2644;191813;25;59;32;4;28;.875;3600000;0
2644;50065;16;39;46;8;38;.826;3351000;0
2645;187578;26;0;0;0;0;.00nan;0;0
2645;193854;11;0;0;0;0;.00nan;0;0
2645;179154;26;52;26;4;22;.846;3731000;0
2645;146862;11;75;32;3;29;.906;3731000;0
2646;166591;15;60;28;3;25;.893;3600000;0
2646;163471;34;0;0;0;0;.00nan;0;0
2646;183904;34;94;40;2;38;.950;3600000;0
2646;187362;15;0;0;0;0;.00nan;0;0
2647;183844;29;0;0;0;0;.00nan;0;0
2647;195089;29;95;57;4;53;.930;3554000;0
2647;196005;22;0;0;0;0;.00nan;0;0
2647;143473;22;44;16;3;13;.813;3600000;0
2648;187718;16;0;0;0;0;.00nan;0;0
2648;183783;25;0;0;0;0;.00nan;0;0
2648;191813;25;90;19;0;19;1.000;3600000;0
2648;50065;16;87;55;5;50;.909;3600000;0
2649;187578;26;0;0;0;0;.00nan;0;0
2649;193854;11;0;0;0;0;.00nan;0;0
2649;179154;26;100;38;1;37;.974;3600000;0
2649;146862;11;73;29;2;27;.931;3553000;0
2650;166591;15;77;37;3;34;.919;3552000;0
2650;163471;34;0;0;0;0;.00nan;0;0
2650;183904;34;83;30;2;28;.933;3600000;0
2650;187362;15;0;0;0;0;.00nan;0;0
2651;183844;29;20;15;5;10;.667;1024000;0
2651;195089;29;58;30;4;26;.867;2576000;0
2651;196005;22;0;0;0;0;.00nan;0;0
2651;143473;22;91;13;0;13;1.000;3600000;0
2652;187718;16;0;0;0;0;.00nan;0;0
2652;183783;25;0;0;0;0;.00nan;0;0
2652;191813;25;60;30;3;27;.900;3600000;0
2652;50065;16;48;31;5;26;.839;3566000;0
2653;187578;26;0;0;0;0;.00nan;0;0
2653;193854;11;0;0;0;0;.00nan;0;0
2653;179154;26;84;30;2;28;.933;3649000;0
2653;146862;11;61;27;3;24;.889;3648000;0
2654;166591;15;68;29;3;26;.897;3600000;0
2654;163471;34;0;0;0;0;.00nan;0;0
2654;183904;34;100;30;0;30;1.000;3600000;0
2654;187362;15;0;0;0;0;.00nan;0;0
2655;183844;29;76;40;3;37;.925;3600000;0
2655;195089;29;0;0;0;0;.00nan;0;0
2655;196005;22;0;0;0;0;.00nan;0;0
2655;143473;22;60;12;1;11;.917;3600000;0
2656;187718;16;0;0;0;0;.00nan;0;0
2656;183783;25;0;0;0;0;.00nan;0;0
2656;191813;25;72;26;2;24;.923;3600000;0
2656;50065;16;56;25;3;22;.880;3600000;0
2657;187578;26;0;0;0;0;.00nan;0;0
2657;193854;11;0;0;0;0;.00nan;0;0
2657;179154;26;66;22;2;20;.909;3600000;0
2657;146862;11;57;24;3;21;.875;3556000;0
2753;183844;29;50;43;6;37;.860;3168000;0
2753;195089;29;51;2;0;2;1.000;432000;0
2753;196005;22;0;0;0;0;.00nan;0;0
2753;143473;22;64;17;1;16;.941;3600000;0
2754;187578;26;0;0;0;0;.00nan;0;0
2754;193854;11;0;0;0;0;.00nan;0;0
2754;179154;26;57;25;3;22;.880;3541000;0
2754;146862;11;90;28;1;27;.964;3600000;0
2771;187578;26;59;7;0;7;1.000;856000;0
2771;193854;11;0;0;0;0;.00nan;0;0
2771;179154;26;11;25;7;18;.720;2744000;0
2771;146862;11;88;33;1;32;.970;3600000;0
2776;187578;26;41;36;6;30;.833;3253000;0
2776;193854;11;0;0;0;0;.00nan;0;0
2776;179154;26;34;5;2;3;.600;347000;0
2776;146862;11;54;21;3;18;.857;3600000;0
2778;163471;34;0;0;0;0;.00nan;0;0
2778;183904;34;71;34;3;31;.912;3600000;0
2778;196005;22;0;0;0;0;.00nan;0;0
2778;143473;22;38;31;6;25;.806;3600000;0
2779;193854;11;0;0;0;0;.00nan;0;0
2779;183783;25;0;0;0;0;.00nan;0;0
2779;191813;25;89;22;0;22;1.000;3600000;0
2779;146862;11;44;32;6;26;.813;3600000;0
2780;163471;34;0;0;0;0;.00nan;0;0
2780;183904;34;77;39;3;36;.923;3600000;0
2780;196005;22;0;0;0;0;.00nan;0;0
2780;143473;22;97;28;0;28;1.000;3600000;0
2781;193854;11;62;9;0;9;1.000;529000;0
2781;183783;25;0;0;0;0;.00nan;0;0
2781;191813;25;57;20;3;17;.850;3600000;0
2781;146862;11;42;35;6;29;.829;3071000;0
2782;163471;34;0;0;0;0;.00nan;0;0
2782;183904;34;48;29;4;25;.862;3534000;0
2782;196005;22;0;0;0;0;.00nan;0;0
2782;143473;22;76;26;2;24;.923;3600000;0
2783;193854;11;0;0;0;0;.00nan;0;0
2783;183783;25;0;0;0;0;.00nan;0;0
2783;191813;25;83;30;2;28;.933;3572000;0
2783;146862;11;84;25;1;24;.960;3600000;0
2784;163471;34;0;0;0;0;.00nan;0;0
2784;183904;34;88;30;1;29;.967;3600000;0
2784;196005;22;0;0;0;0;.00nan;0;0
2784;143473;22;90;37;2;35;.946;3544000;0
2785;193854;11;0;0;0;0;.00nan;0;0
2785;183783;25;0;0;0;0;.00nan;0;0
2785;191813;25;72;39;4;35;.897;4726000;0
2785;146862;11;77;44;3;41;.932;4726000;0
2802;163471;34;0;0;0;0;.00nan;0;0
2802;183904;34;72;28;2;26;.929;4569000;0
2802;196005;22;0;0;0;0;.00nan;0;0
2802;143473;22;94;36;1;35;.972;4569000;0
2803;193854;11;0;0;0;0;.00nan;0;0
2803;183783;25;0;0;0;0;.00nan;0;0
2803;191813;25;49;14;2;12;.857;3576000;0
2803;146862;11;96;35;1;34;.971;3600000;0
2811;163471;34;0;0;0;0;.00nan;0;0
2811;183904;34;90;27;1;26;.963;3600000;0
2811;196005;22;0;0;0;0;.00nan;0;0
2811;143473;22;61;33;4;29;.879;3600000;0
2812;193854;11;0;0;0;0;.00nan;0;0
2812;183783;25;0;0;0;0;.00nan;0;0
2812;191813;25;78;15;0;15;1.000;3600000;0
2812;146862;11;82;44;4;40;.909;3600000;0
2814;163471;34;0;0;0;0;.00nan;0;0
2814;183904;34;70;31;3;28;.903;3863000;0
2814;196005;22;0;0;0;0;.00nan;0;0
2814;143473;22;71;25;2;23;.920;3863000;0
2815;193854;11;0;0;0;0;.00nan;0;0
2815;183783;25;0;0;0;0;.00nan;0;0
2815;191813;25;53;18;2;16;.889;3558000;0
2815;146862;11;99;42;1;41;.976;3600000;0
2816;193854;11;0;0;0;0;.00nan;0;0
2816;196005;22;0;0;0;0;.00nan;0;0
2816;143473;22;51;23;3;20;.870;3600000;0
2816;146862;11;79;34;2;32;.941;3600000;0
2817;193854;11;0;0;0;0;.00nan;0;0
2817;196005;22;0;0;0;0;.00nan;0;0
2817;143473;22;69;22;2;20;.909;3600000;0
2817;146862;11;98;48;4;44;.917;3581000;0
2818;193854;11;0;0;0;0;.00nan;0;0
2818;196005;22;0;0;0;0;.00nan;0;0
2818;143473;22;81;26;2;24;.923;3578000;0
2818;146862;11;93;37;1;36;.973;3600000;0
2819;193854;11;0;0;0;0;.00nan;0;0
2819;196005;22;0;0;0;0;.00nan;0;0
2819;143473;22;44;17;3;14;.824;3552000;0
2819;146862;11;75;30;2;28;.933;3600000;0
2822;193854;11;0;0;0;0;.00nan;0;0
2822;196005;22;0;0;0;0;.00nan;0;0
2822;143473;22;74;26;2;24;.923;3848000;0
2822;146862;11;99;50;1;49;.980;3848000;0
1536;178789;65;58;48;6;42;.875;3075000;0
1536;205799;57;0;0;0;0;.00nan;0;0
1536;184770;65;46;5;1;4;.800;525000;0
1536;152418;57;83;27;1;26;.963;3600000;0
1537;163565;40;55;32;4;28;.875;3600000;0
1537;170977;62;82;28;2;26;.929;3186000;0
1537;185812;40;0;0;0;0;.00nan;0;0
1537;186549;62;23;6;3;3;.500;382000;0
1538;197940;49;0;0;0;0;.00nan;0;0
1538;-1;45;91;42;3;39;.929;3600000;0
1538;201075;49;80;21;1;20;.952;3600000;0
1538;184610;45;0;0;0;0;.00nan;0;0
1539;4622;64;0;0;0;0;.00nan;0;0
1539;205318;61;94;45;3;42;.933;3581000;0
1539;-1;61;0;0;0;0;.00nan;0;0
1539;85661;64;69;25;2;23;.920;3600000;0
1540;3359;43;0;0;0;0;.00nan;0;0
1540;181102;48;0;0;0;0;.00nan;0;0
1540;182116;43;45;21;4;17;.810;3600000;0
1540;142492;48;33;45;7;38;.844;3600000;0
1541;189644;42;96;39;1;38;.974;3600000;0
1541;176060;42;0;0;0;0;.00nan;0;0
1541;185743;4837;63;23;2;21;.913;3561000;0
1541;187295;4837;0;0;0;0;.00nan;0;0
1542;187699;47;0;0;0;0;.00nan;0;0
1542;186495;47;85;23;1;22;.957;3878000;0
1542;79132;4619;0;0;0;0;.00nan;0;0
1542;86228;4619;92;44;2;42;.955;3878000;0
1543;2195;53;38;17;3;14;.824;3600000;0
1543;169323;53;0;0;0;0;.00nan;0;0
1543;176921;38;96;60;4;56;.933;3600000;0
1543;-1;38;0;0;0;0;.00nan;0;0
1544;38124;58;90;40;3;37;.925;3600000;0
1544;191026;58;0;0;0;0;.00nan;0;0
1544;77955;56;0;0;0;0;.00nan;0;0
1544;85437;56;86;36;2;34;.944;3600000;0
1545;210998;44;0;0;0;0;.00nan;0;0
1545;196372;37;0;0;0;0;.00nan;0;0
1545;202161;37;45;35;6;29;.829;3679000;0
1545;64911;44;64;38;5;33;.868;3679000;0
1546;224943;60;0;0;0;0;.00nan;0;0
1546;181341;60;48;29;4;25;.862;3600000;0
1546;182049;46;46;42;7;35;.833;3600000;0
1546;218119;46;0;0;0;0;.00nan;0;0
1547;171970;55;0;0;0;0;.00nan;0;0
1547;194502;55;78;29;3;26;.897;3548000;0
1547;175658;36;0;0;0;0;.00nan;0;0
1547;192552;36;75;24;2;22;.917;3600000;0
1548;178789;65;9;32;8;24;.750;3600000;0
1548;205799;57;0;0;0;0;.00nan;0;0
1548;184770;65;0;0;0;0;.00nan;0;0
1548;152418;57;99;26;0;26;1.000;3600000;0
1549;165744;50;52;21;3;18;.857;3558000;0
1549;194893;54;97;50;2;48;.960;3600000;0
1549;189639;54;0;0;0;0;.00nan;0;0
1549;57215;50;0;0;0;0;.00nan;0;0
1550;197940;49;82;14;0;14;1.000;3600000;0
1550;-1;45;34;20;4;16;.800;1161000;0
1550;201075;49;0;0;0;0;.00nan;0;0
1550;184610;45;56;30;4;26;.867;2439000;0
1551;185960;39;0;0;0;0;.00nan;0;0
1551;187362;59;0;0;0;0;.00nan;0;0
1551;197704;39;81;46;5;41;.891;3600000;0
1551;143156;59;87;29;1;28;.966;3600000;0
1552;4622;64;0;0;0;0;.00nan;0;0
1552;205318;61;41;27;4;23;.852;3900000;0
1552;-1;61;0;0;0;0;.00nan;0;0
1552;85661;64;80;40;4;36;.900;3900000;0
1553;3359;43;0;0;0;0;.00nan;0;0
1553;181102;48;30;16;4;12;.750;901000;0
1553;182116;43;67;20;1;19;.950;3600000;0
1553;142492;48;31;30;6;24;.800;2699000;0
1554;203288;51;0;0;0;0;.00nan;0;0
1554;188888;51;49;23;4;19;.826;3564000;0
1554;194264;41;93;47;3;44;.936;3600000;0
1554;192688;41;0;0;0;0;.00nan;0;0
1555;210998;44;0;0;0;0;.00nan;0;0
1555;196372;37;0;0;0;0;.00nan;0;0
1555;202161;37;100;32;0;32;1.000;3600000;0
1555;64911;44;59;27;3;24;.889;3600000;0
1556;184081;52;78;19;1;18;.947;3600000;0
1556;176921;38;44;48;7;41;.854;3600000;0
1556;-1;38;0;0;0;0;.00nan;0;0
1556;91398;52;0;0;0;0;.00nan;0;0
1557;171970;55;79;30;2;28;.933;3600000;0
1557;194502;55;0;0;0;0;.00nan;0;0
1557;38124;58;74;38;3;35;.921;3545000;0
1557;191026;58;0;0;0;0;.00nan;0;0
1558;224943;60;0;0;0;0;.00nan;0;0
1558;181341;60;94;36;1;35;.972;3900000;0
1558;182049;46;68;27;1;26;.963;3900000;0
1558;218119;46;0;0;0;0;.00nan;0;0
1559;178695;63;90;41;3;38;.927;3900000;0
1559;180873;63;0;0;0;0;.00nan;0;0
1559;77955;56;0;0;0;0;.00nan;0;0
1559;85437;56;64;28;3;25;.893;3900000;0
1560;203288;51;0;0;0;0;.00nan;0;0
1560;188888;51;97;47;2;45;.957;3600000;0
1560;187362;59;91;33;1;32;.970;3600000;0
1560;143156;59;0;0;0;0;.00nan;0;0
1561;194264;41;0;0;0;0;.00nan;0;0
1561;185960;39;45;49;8;41;.837;3600000;0
1561;192688;41;81;28;2;26;.929;3600000;0
1561;197704;39;0;0;0;0;.00nan;0;0
1562;189644;42;100;42;1;41;.976;3600000;0
1562;176060;42;0;0;0;0;.00nan;0;0
1562;185743;4837;49;28;4;24;.857;3600000;0
1562;187295;4837;0;0;0;0;.00nan;0;0
1563;187699;47;0;0;0;0;.00nan;0;0
1563;186495;47;99;32;1;31;.969;3600000;0
1563;79132;4619;91;47;2;45;.957;3557000;0
1563;86228;4619;0;0;0;0;.00nan;0;0
1564;2195;53;27;25;6;19;.760;3303000;0
1564;184081;52;0;0;0;0;.00nan;0;0
1564;169323;53;58;5;0;5;1.000;297000;0
1564;91398;52;79;30;2;28;.933;3600000;0
1565;178695;63;43;26;5;21;.808;3600000;0
1565;175658;36;0;0;0;0;.00nan;0;0
1565;180873;63;0;0;0;0;.00nan;0;0
1565;192552;36;95;29;1;28;.966;3600000;0
1566;165744;50;85;29;1;28;.966;3600000;0
1566;182049;46;41;33;6;27;.818;2483000;0
1566;218119;46;51;11;1;10;.909;1117000;0
1566;57215;50;0;0;0;0;.00nan;0;0
1567;3359;43;31;24;5;19;.792;3803000;0
1567;182116;43;0;0;0;0;.00nan;0;0
1567;77955;56;0;0;0;0;.00nan;0;0
1567;85437;56;58;48;6;42;.875;3803000;0
1568;2195;53;71;18;1;17;.944;3600000;0
1568;169323;53;0;0;0;0;.00nan;0;0
1568;38124;58;71;46;4;42;.913;3600000;0
1568;191026;58;0;0;0;0;.00nan;0;0
1569;181102;48;68;39;4;35;.897;3600000;0
1569;185743;4837;0;0;0;0;.00nan;0;0
1569;187295;4837;32;25;5;20;.800;3553000;0
1569;142492;48;0;0;0;0;.00nan;0;0
1570;203288;51;0;0;0;0;.00nan;0;0
1570;171970;55;75;50;5;45;.900;3600000;0
1570;188888;51;78;14;0;14;1.000;3600000;0
1570;194502;55;0;0;0;0;.00nan;0;0
1571;197940;49;72;19;1;18;.947;3600000;0
1571;-1;45;97;43;2;41;.953;3575000;0
1571;201075;49;0;0;0;0;.00nan;0;0
1571;184610;45;0;0;0;0;.00nan;0;0
1572;178789;65;93;37;3;34;.919;3569000;0
1572;184770;65;0;0;0;0;.00nan;0;0
1572;176921;38;95;28;1;27;.964;3600000;0
1572;-1;38;0;0;0;0;.00nan;0;0
1573;205318;61;0;0;0;0;.00nan;0;0
1573;210998;44;0;0;0;0;.00nan;0;0
1573;-1;61;82;30;1;29;.967;3900000;0
1573;64911;44;92;23;1;22;.957;3900000;0
1574;3359;43;0;0;0;0;.00nan;0;0
1574;182116;43;86;27;2;25;.926;3900000;0
1574;77955;56;0;0;0;0;.00nan;0;0
1574;85437;56;66;27;2;25;.926;3900000;0
1575;4622;64;0;0;0;0;.00nan;0;0
1575;189644;42;0;0;0;0;.00nan;0;0
1575;176060;42;76;36;3;33;.917;3757000;0
1575;85661;64;72;34;4;30;.882;3757000;0
1576;2195;53;0;0;0;0;.00nan;0;0
1576;169323;53;87;46;4;42;.913;3600000;0
1576;187362;59;66;14;1;13;.929;3600000;0
1576;143156;59;0;0;0;0;.00nan;0;0
1577;187699;47;48;26;4;22;.846;3664000;0
1577;186495;47;0;0;0;0;.00nan;0;0
1577;79132;4619;74;32;3;29;.906;3664000;0
1577;86228;4619;0;0;0;0;.00nan;0;0
1578;194264;41;0;0;0;0;.00nan;0;0
1578;184081;52;0;0;0;0;.00nan;0;0
1578;192688;41;90;42;3;39;.929;3900000;0
1578;91398;52;66;32;3;29;.906;3900000;0
1579;181102;48;96;58;4;54;.931;3576000;0
1579;185743;4837;45;18;3;15;.833;3600000;0
1579;187295;4837;0;0;0;0;.00nan;0;0
1579;142492;48;0;0;0;0;.00nan;0;0
1580;170977;62;0;0;0;0;.00nan;0;0
1580;186549;62;76;33;2;31;.939;3749000;0
1580;79132;4619;54;21;3;18;.857;3749000;0
1580;86228;4619;0;0;0;0;.00nan;0;0
1581;3359;43;90;29;1;28;.966;3600000;0
1581;182116;43;0;0;0;0;.00nan;0;0
1581;185960;39;86;34;3;31;.912;3586000;0
1581;197704;39;0;0;0;0;.00nan;0;0
1582;175658;36;96;22;0;22;1.000;3600000;0
1582;38124;58;0;0;0;0;.00nan;0;0
1582;191026;58;65;43;4;39;.907;3600000;0
1582;192552;36;0;0;0;0;.00nan;0;0
1583;203288;51;0;0;0;0;.00nan;0;0
1583;171970;55;90;42;2;40;.952;3568000;0
1583;188888;51;83;14;0;14;1.000;3600000;0
1583;194502;55;0;0;0;0;.00nan;0;0
1584;197940;49;52;17;2;15;.882;3600000;0
1584;-1;45;0;0;0;0;.00nan;0;0
1584;201075;49;0;0;0;0;.00nan;0;0
1584;184610;45;97;57;4;53;.930;3571000;0
1585;194264;41;0;0;0;0;.00nan;0;0
1585;176921;38;0;0;0;0;.00nan;0;0
1585;-1;38;90;58;5;53;.914;3600000;0
1585;192688;41;58;16;2;14;.875;3600000;0
1586;205318;61;80;36;2;34;.944;3548000;0
1586;210998;44;81;24;1;23;.958;3600000;0
1586;-1;61;0;0;0;0;.00nan;0;0
1586;64911;44;0;0;0;0;.00nan;0;0
1587;4622;64;45;26;4;22;.846;3543000;0
1587;189644;42;100;44;2;42;.955;3600000;0
1587;176060;42;0;0;0;0;.00nan;0;0
1587;85661;64;0;0;0;0;.00nan;0;0
1588;194893;54;86;44;3;41;.932;3600000;0
1588;189639;54;0;0;0;0;.00nan;0;0
1588;182049;46;86;16;0;16;1.000;3600000;0
1588;218119;46;0;0;0;0;.00nan;0;0
1589;2195;53;79;35;2;33;.943;3600000;0
1589;169323;53;0;0;0;0;.00nan;0;0
1589;187362;59;0;0;0;0;.00nan;0;0
1589;143156;59;28;30;6;24;.800;3600000;0
1590;165744;50;81;31;2;29;.935;3600000;0
1590;196372;37;0;0;0;0;.00nan;0;0
1590;202161;37;74;37;4;33;.892;3528000;0
1590;57215;50;0;0;0;0;.00nan;0;0
1591;178695;63;0;0;0;0;.00nan;0;0
1591;205799;57;0;0;0;0;.00nan;0;0
1591;180873;63;57;31;3;28;.903;3551000;0
1591;152418;57;90;34;1;33;.971;3600000;0
1592;163565;40;66;40;4;36;.900;3600000;0
1592;224943;60;0;0;0;0;.00nan;0;0
1592;181341;60;52;40;5;35;.875;3559000;0
1592;185812;40;0;0;0;0;.00nan;0;0
1593;184081;52;0;0;0;0;.00nan;0;0
1593;178789;65;0;0;0;0;.00nan;0;0
1593;184770;65;89;40;2;38;.950;3551000;0
1593;91398;52;80;25;1;24;.960;3600000;0
1594;38124;58;27;14;4;10;.714;851000;0
1594;191026;58;80;36;2;34;.944;2749000;0
1594;187362;59;61;12;1;11;.917;3600000;0
1594;143156;59;0;0;0;0;.00nan;0;0
1595;165744;50;0;0;0;0;.00nan;0;0
1595;182049;46;40;21;3;18;.857;3536000;0
1595;218119;46;0;0;0;0;.00nan;0;0
1595;57215;50;99;42;1;41;.976;3600000;0
1596;194264;41;47;26;4;22;.846;3600000;0
1596;184081;52;69;25;1;24;.960;3600000;0
1596;192688;41;0;0;0;0;.00nan;0;0
1596;91398;52;0;0;0;0;.00nan;0;0
1597;178695;63;49;25;4;21;.840;3522000;0
1597;205799;57;60;21;2;19;.905;3600000;0
1597;180873;63;0;0;0;0;.00nan;0;0
1597;152418;57;0;0;0;0;.00nan;0;0
1598;197940;49;0;0;0;0;.00nan;0;0
1598;201075;49;64;28;3;25;.893;3550000;0
1598;181102;48;0;0;0;0;.00nan;0;0
1598;142492;48;75;32;2;30;.938;3600000;0
1599;205318;61;79;37;3;34;.919;3600000;0
1599;170977;62;0;0;0;0;.00nan;0;0
1599;-1;61;0;0;0;0;.00nan;0;0
1599;186549;62;21;26;6;20;.769;3600000;0
1600;178695;63;60;25;3;22;.880;3600000;0
1600;194893;54;45;39;6;33;.846;3600000;0
1600;189639;54;0;0;0;0;.00nan;0;0
1600;180873;63;0;0;0;0;.00nan;0;0
1601;187699;47;0;0;0;0;.00nan;0;0
1601;224943;60;0;0;0;0;.00nan;0;0
1601;181341;60;80;50;4;46;.920;3842000;0
1601;186495;47;56;23;3;20;.870;3842000;0
1602;197940;49;53;22;3;19;.864;3600000;0
1602;201075;49;0;0;0;0;.00nan;0;0
1602;181102;48;27;32;7;25;.781;2396000;0
1602;142492;48;39;24;4;20;.833;1204000;0
1603;194893;54;0;0;0;0;.00nan;0;0
1603;189639;54;75;35;4;31;.886;3549000;0
1603;185960;39;53;25;3;22;.880;3600000;0
1603;197704;39;0;0;0;0;.00nan;0;0
1604;163565;40;100;37;0;37;1.000;3600000;0
1604;185812;40;0;0;0;0;.00nan;0;0
1604;79132;4619;39;15;3;12;.800;3600000;0
1604;86228;4619;0;0;0;0;.00nan;0;0
1605;4622;64;65;29;2;27;.931;3284000;0
1605;165744;50;86;30;2;28;.933;3600000;0
1605;57215;50;0;0;0;0;.00nan;0;0
1605;85661;64;25;5;3;2;.400;316000;0
1606;205799;57;0;0;0;0;.00nan;0;0
1606;77955;56;59;16;2;14;.875;3600000;0
1606;85437;56;0;0;0;0;.00nan;0;0
1606;152418;57;75;48;4;44;.917;3586000;0
1607;205318;61;0;0;0;0;.00nan;0;0
1607;210998;44;0;0;0;0;.00nan;0;0
1607;-1;61;64;27;2;25;.926;3600000;0
1607;64911;44;100;28;0;28;1.000;3600000;0
1608;178789;65;53;44;7;37;.841;3086000;0
1608;184770;65;44;5;1;4;.800;514000;0
1608;187362;59;0;0;0;0;.00nan;0;0
1608;143156;59;54;20;3;17;.850;3600000;0
1609;178695;63;65;34;3;31;.912;3561000;0
1609;180873;63;0;0;0;0;.00nan;0;0
1609;185960;39;0;0;0;0;.00nan;0;0
1609;197704;39;99;33;1;32;.970;3600000;0
1610;205799;57;0;0;0;0;.00nan;0;0
1610;38124;58;0;0;0;0;.00nan;0;0
1610;191026;58;91;40;2;38;.950;3600000;0
1610;152418;57;46;24;4;20;.833;3573000;0
1611;203288;51;0;0;0;0;.00nan;0;0
1611;188888;51;54;17;2;15;.882;3600000;0
1611;-1;45;0;0;0;0;.00nan;0;0
1611;184610;45;76;33;3;30;.909;3590000;0
1612;184081;52;0;0;0;0;.00nan;0;0
1612;176921;38;77;33;2;31;.939;3900000;0
1612;-1;38;0;0;0;0;.00nan;0;0
1612;91398;52;91;33;2;31;.939;3900000;0
1613;205318;61;86;47;4;43;.915;3900000;0
1613;-1;61;0;0;0;0;.00nan;0;0
1613;79132;4619;66;39;4;35;.897;3898000;0
1613;86228;4619;0;0;0;0;.00nan;0;0
1614;3359;43;0;0;0;0;.00nan;0;0
1614;182116;43;100;28;0;28;1.000;3600000;0
1614;77955;56;0;0;0;0;.00nan;0;0
1614;85437;56;51;34;4;30;.882;3600000;0
1615;4622;64;0;0;0;0;.00nan;0;0
1615;196372;37;64;25;3;22;.880;3600000;0
1615;202161;37;0;0;0;0;.00nan;0;0
1615;85661;64;42;33;5;28;.848;3524000;0
1616;187699;47;72;44;4;40;.909;3708000;0
1616;181102;48;64;27;3;24;.889;3695000;0
1616;186495;47;0;0;0;0;.00nan;0;0
1616;142492;48;0;0;0;0;.00nan;0;0
1617;171970;55;50;2;0;2;1.000;365000;0
1617;194502;55;39;30;6;24;.800;3235000;0
1617;175658;36;0;0;0;0;.00nan;0;0
1617;192552;36;62;27;3;24;.889;3600000;0
1618;189644;42;72;43;4;39;.907;3820000;0
1618;176060;42;0;0;0;0;.00nan;0;0
1618;182049;46;53;29;5;24;.828;3820000;0
1618;218119;46;0;0;0;0;.00nan;0;0
1619;224943;60;64;40;4;36;.900;3544000;0
1619;170977;62;0;0;0;0;.00nan;0;0
1619;181341;60;0;0;0;0;.00nan;0;0
1619;186549;62;71;34;2;32;.941;3600000;0
1620;178695;63;0;0;0;0;.00nan;0;0
1620;180873;63;89;34;2;32;.941;3600000;0
1620;185960;39;28;7;3;4;.571;405000;0
1620;197704;39;82;29;2;27;.931;3195000;0
1621;197940;49;69;23;2;21;.913;3600000;0
1621;201075;49;0;0;0;0;.00nan;0;0
1621;185743;4837;49;38;5;33;.868;3600000;0
1621;187295;4837;0;0;0;0;.00nan;0;0
1622;205799;57;62;17;2;15;.882;3600000;0
1622;38124;58;22;31;7;24;.774;1872000;0
1622;191026;58;57;33;4;29;.879;1728000;0
1622;152418;57;0;0;0;0;.00nan;0;0
1623;203288;51;57;34;5;29;.853;3598000;0
1623;165744;50;0;0;0;0;.00nan;0;0
1623;188888;51;0;0;0;0;.00nan;0;0
1623;57215;50;59;26;3;23;.885;3600000;0
1624;194264;41;0;0;0;0;.00nan;0;0
1624;187362;59;0;0;0;0;.00nan;0;0
1624;192688;41;81;44;3;41;.932;3600000;0
1624;143156;59;27;18;4;14;.778;3559000;0
1625;4622;64;49;16;2;14;.875;3600000;0
1625;194893;54;30;21;5;16;.762;2271000;0
1625;189639;54;42;18;3;15;.833;1329000;0
1625;85661;64;0;0;0;0;.00nan;0;0
1626;-1;45;80;45;3;42;.933;3598000;0
1626;184610;45;0;0;0;0;.00nan;0;0
1626;196372;37;0;0;0;0;.00nan;0;0
1626;202161;37;78;24;1;23;.958;3600000;0
1627;163565;40;47;35;5;30;.857;3571000;0
1627;210998;44;0;0;0;0;.00nan;0;0
1627;185812;40;0;0;0;0;.00nan;0;0
1627;64911;44;87;31;3;28;.903;3600000;0
1628;2195;53;26;22;5;17;.773;3600000;0
1628;184081;52;79;30;2;28;.933;3600000;0
1628;169323;53;0;0;0;0;.00nan;0;0
1628;91398;52;0;0;0;0;.00nan;0;0
1629;171970;55;48;38;6;32;.842;2995000;0
1629;3359;43;0;0;0;0;.00nan;0;0
1629;194502;55;62;10;0;10;1.000;605000;0
1629;182116;43;69;19;1;18;.947;3600000;0
1630;189644;42;0;0;0;0;.00nan;0;0
1630;176060;42;57;39;5;34;.872;3600000;0
1630;182049;46;0;0;0;0;.00nan;0;0
1630;218119;46;95;27;0;27;1.000;3600000;0
1631;224943;60;0;0;0;0;.00nan;0;0
1631;170977;62;71;39;4;35;.897;3713000;0
1631;181341;60;72;32;3;29;.906;3713000;0
1631;186549;62;0;0;0;0;.00nan;0;0
1632;175658;36;84;61;5;56;.918;3600000;0
1632;192552;36;0;0;0;0;.00nan;0;0
1632;77955;56;45;18;3;15;.833;3600000;0
1632;85437;56;0;0;0;0;.00nan;0;0
1633;178789;65;0;0;0;0;.00nan;0;0
1633;184770;65;56;24;4;20;.833;3579000;0
1633;176921;38;72;37;3;34;.919;3600000;0
1633;-1;38;0;0;0;0;.00nan;0;0
1634;197940;49;0;0;0;0;.00nan;0;0
1634;201075;49;72;27;2;25;.926;3591000;0
1634;185743;4837;0;0;0;0;.00nan;0;0
1634;187295;4837;81;29;1;28;.966;3600000;0
1635;187699;47;0;0;0;0;.00nan;0;0
1635;205318;61;0;0;0;0;.00nan;0;0
1635;-1;61;78;32;2;30;.938;3900000;0
1635;186495;47;100;44;2;42;.955;3900000;0
1636;178789;65;86;64;5;59;.922;3600000;0
1636;184770;65;0;0;0;0;.00nan;0;0
1636;187362;59;64;13;1;12;.923;3600000;0
1636;143156;59;0;0;0;0;.00nan;0;0
1637;194264;41;59;28;3;25;.893;3867000;0
1637;176921;38;0;0;0;0;.00nan;0;0
1637;-1;38;88;51;4;47;.922;3867000;0
1637;192688;41;0;0;0;0;.00nan;0;0
1638;181102;48;0;0;0;0;.00nan;0;0
1638;79132;4619;0;0;0;0;.00nan;0;0
1638;86228;4619;63;23;2;21;.913;3600000;0
1638;142492;48;55;40;5;35;.875;3600000;0
1639;2195;53;0;0;0;0;.00nan;0;0
1639;184081;52;0;0;0;0;.00nan;0;0
1639;169323;53;41;22;4;18;.818;3515000;0
1639;91398;52;89;38;2;36;.947;3600000;0
1640;163565;40;0;0;0;0;.00nan;0;0
1640;210998;44;16;28;7;21;.750;2584000;0
1640;185812;40;75;31;2;29;.935;3600000;0
1640;64911;44;58;5;0;5;1.000;1016000;0
1641;163565;40;55;28;3;25;.893;3547000;0
1641;181102;48;91;33;1;32;.970;3600000;0
1641;185812;40;0;0;0;0;.00nan;0;0
1641;142492;48;0;0;0;0;.00nan;0;0
1642;203288;51;0;0;0;0;.00nan;0;0
1642;188888;51;92;19;0;19;1.000;3600000;0
1642;-1;45;76;37;3;34;.919;3600000;0
1642;184610;45;0;0;0;0;.00nan;0;0
1643;3359;43;0;0;0;0;.00nan;0;0
1643;175658;36;0;0;0;0;.00nan;0;0
1643;182116;43;60;27;3;24;.889;3600000;0
1643;192552;36;81;45;4;41;.911;3552000;0
1644;171970;55;0;0;0;0;.00nan;0;0
1644;194502;55;79;50;5;45;.900;3600000;0
1644;77955;56;0;0;0;0;.00nan;0;0
1644;85437;56;68;23;2;21;.913;3600000;0
1645;2195;53;75;10;0;10;1.000;3600000;0
1645;169323;53;0;0;0;0;.00nan;0;0
1645;178789;65;54;56;7;49;.875;3600000;0
1645;184770;65;0;0;0;0;.00nan;0;0
1646;4622;64;0;0;0;0;.00nan;0;0
1646;194893;54;30;15;4;11;.733;941000;0
1646;189639;54;68;31;3;28;.903;2659000;0
1646;85661;64;57;11;1;10;.909;3600000;0
1647;205318;61;90;47;3;44;.936;3541000;0
1647;-1;61;0;0;0;0;.00nan;0;0
1647;181102;48;75;28;2;26;.929;3600000;0
1647;142492;48;0;0;0;0;.00nan;0;0
1648;210998;44;0;0;0;0;.00nan;0;0
1648;185743;4837;64;22;1;21;.955;3600000;0
1648;187295;4837;0;0;0;0;.00nan;0;0
1648;64911;44;76;31;2;29;.935;3581000;0
1649;187699;47;0;0;0;0;.00nan;0;0
1649;205799;57;100;53;3;50;.943;3900000;0
1649;186495;47;56;21;3;18;.857;3900000;0
1649;152418;57;0;0;0;0;.00nan;0;0
1650;203288;51;0;0;0;0;.00nan;0;0
1650;2195;53;75;36;3;33;.917;3547000;0
1650;188888;51;66;31;2;29;.935;3600000;0
1650;169323;53;0;0;0;0;.00nan;0;0
1651;197940;49;53;33;5;28;.848;3588000;0
1651;201075;49;0;0;0;0;.00nan;0;0
1651;79132;4619;71;36;3;33;.917;3600000;0
1651;86228;4619;0;0;0;0;.00nan;0;0
1652;3359;43;0;0;0;0;.00nan;0;0
1652;178695;63;47;33;5;28;.848;3600000;0
1652;180873;63;0;0;0;0;.00nan;0;0
1652;182116;43;55;15;2;13;.867;3600000;0
1653;194264;41;0;0;0;0;.00nan;0;0
1653;176921;38;0;0;0;0;.00nan;0;0
1653;-1;38;72;37;4;33;.892;3600000;0
1653;192688;41;63;16;1;15;.938;3600000;0
1654;175658;36;75;49;5;44;.898;3600000;0
1654;192552;36;0;0;0;0;.00nan;0;0
1654;77955;56;0;0;0;0;.00nan;0;0
1654;85437;56;81;26;1;25;.962;3600000;0
1655;184081;52;90;32;1;31;.969;3600000;0
1655;185960;39;0;0;0;0;.00nan;0;0
1655;197704;39;88;43;2;41;.953;3560000;0
1655;91398;52;0;0;0;0;.00nan;0;0
1656;224943;60;0;0;0;0;.00nan;0;0
1656;165744;50;0;0;0;0;.00nan;0;0
1656;181341;60;69;36;3;33;.917;3760000;0
1656;57215;50;63;29;4;25;.862;3760000;0
1657;178789;65;98;60;4;56;.933;3600000;0
1657;184770;65;0;0;0;0;.00nan;0;0
1657;187362;59;84;18;0;18;1.000;3600000;0
1657;143156;59;0;0;0;0;.00nan;0;0
1658;205318;61;0;0;0;0;.00nan;0;0
1658;-1;61;72;38;4;34;.895;3623000;0
1658;181102;48;0;0;0;0;.00nan;0;0
1658;142492;48;60;29;3;26;.897;3623000;0
1659;163565;40;73;39;3;36;.923;3560000;0
1659;170977;62;0;0;0;0;.00nan;0;0
1659;185812;40;0;0;0;0;.00nan;0;0
1659;186549;62;67;19;2;17;.895;3600000;0
1660;187699;47;68;34;3;31;.912;3511000;0
1660;205799;57;0;0;0;0;.00nan;0;0
1660;186495;47;0;0;0;0;.00nan;0;0
1660;152418;57;99;33;1;32;.970;3600000;0
1661;203288;51;47;27;5;22;.815;3600000;0
1661;2195;53;0;0;0;0;.00nan;0;0
1661;188888;51;0;0;0;0;.00nan;0;0
1661;169323;53;60;25;3;22;.880;3600000;0
1662;197940;49;0;0;0;0;.00nan;0;0
1662;201075;49;90;32;1;31;.969;3600000;0
1662;79132;4619;0;0;0;0;.00nan;0;0
1662;86228;4619;55;30;3;27;.900;3521000;0
1663;38124;58;0;0;0;0;.00nan;0;0
1663;191026;58;88;65;3;62;.954;3600000;0
1663;187362;59;78;11;0;11;1.000;3600000;0
1663;143156;59;0;0;0;0;.00nan;0;0
1664;4622;64;0;0;0;0;.00nan;0;0
1664;182049;46;87;28;0;28;1.000;3900000;0
1664;218119;46;0;0;0;0;.00nan;0;0
1664;85661;64;100;36;0;36;1.000;3900000;0
1665;3359;43;66;21;1;20;.952;3600000;0
1665;178695;63;0;0;0;0;.00nan;0;0
1665;180873;63;83;33;2;31;.939;3554000;0
1665;182116;43;0;0;0;0;.00nan;0;0
1666;189644;42;50;44;6;38;.864;3097000;0
1666;176060;42;64;9;0;9;1.000;466000;0
1666;196372;37;0;0;0;0;.00nan;0;0
1666;202161;37;50;30;5;25;.833;3600000;0
1667;194893;54;92;39;2;37;.949;3544000;0
1667;189639;54;0;0;0;0;.00nan;0;0
1667;-1;45;100;31;0;31;1.000;3600000;0
1667;184610;45;0;0;0;0;.00nan;0;0
1668;194264;41;87;36;1;35;.972;3873000;0
1668;184081;52;0;0;0;0;.00nan;0;0
1668;192688;41;0;0;0;0;.00nan;0;0
1668;91398;52;62;27;2;25;.926;3873000;0
1669;171970;55;61;36;4;32;.889;3600000;0
1669;194502;55;0;0;0;0;.00nan;0;0
1669;77955;56;24;22;5;17;.773;3544000;0
1669;85437;56;0;0;0;0;.00nan;0;0
1670;224943;60;0;0;0;0;.00nan;0;0
1670;165744;50;82;24;2;22;.917;3900000;0
1670;181341;60;95;37;2;35;.946;3900000;0
1670;57215;50;0;0;0;0;.00nan;0;0
1671;175658;36;0;0;0;0;.00nan;0;0
1671;176921;38;89;33;1;32;.970;3600000;0
1671;-1;38;0;0;0;0;.00nan;0;0
1671;192552;36;84;42;3;39;.929;3573000;0
1672;178789;65;0;0;0;0;.00nan;0;0
1672;184770;65;84;50;4;46;.920;3600000;0
1672;185960;39;68;24;2;22;.917;3600000;0
1672;197704;39;0;0;0;0;.00nan;0;0
1673;184081;52;81;28;1;27;.964;3600000;0
1673;38124;58;0;0;0;0;.00nan;0;0
1673;191026;58;93;40;2;38;.950;3579000;0
1673;91398;52;0;0;0;0;.00nan;0;0
1674;210998;44;0;0;0;0;.00nan;0;0
1674;185743;4837;40;15;3;12;.800;3600000;0
1674;187295;4837;0;0;0;0;.00nan;0;0
1674;64911;44;85;46;4;42;.913;3545000;0
1675;4622;64;0;0;0;0;.00nan;0;0
1675;182049;46;70;29;2;27;.931;3600000;0
1675;218119;46;0;0;0;0;.00nan;0;0
1675;85661;64;55;25;4;21;.840;3542000;0
1676;189644;42;0;0;0;0;.00nan;0;0
1676;176060;42;37;24;5;19;.792;3560000;0
1676;196372;37;58;32;4;28;.875;3600000;0
1676;202161;37;0;0;0;0;.00nan;0;0
1677;197940;49;44;16;3;13;.813;3791000;0
1677;205318;61;92;59;4;55;.932;3791000;0
1677;-1;61;0;0;0;0;.00nan;0;0
1677;201075;49;0;0;0;0;.00nan;0;0
1678;171970;55;100;32;1;31;.969;3600000;0
1678;194502;55;0;0;0;0;.00nan;0;0
1678;185960;39;0;0;0;0;.00nan;0;0
1678;197704;39;77;34;3;31;.912;3539000;0
1679;187699;47;0;0;0;0;.00nan;0;0
1679;163565;40;96;51;3;48;.941;3600000;0
1679;185812;40;0;0;0;0;.00nan;0;0
1679;186495;47;80;21;1;20;.952;3600000;0
1680;197940;49;0;0;0;0;.00nan;0;0
1680;205318;61;0;0;0;0;.00nan;0;0
1680;-1;61;63;33;3;30;.909;3600000;0
1680;201075;49;68;24;3;21;.875;3577000;0
1681;178695;63;68;31;3;28;.903;3521000;0
1681;194893;54;0;0;0;0;.00nan;0;0
1681;189639;54;94;39;1;38;.974;3600000;0
1681;180873;63;0;0;0;0;.00nan;0;0
1682;224943;60;0;0;0;0;.00nan;0;0
1682;181341;60;75;39;3;36;.923;3600000;0
1682;79132;4619;100;22;0;22;1.000;3600000;0
1682;86228;4619;0;0;0;0;.00nan;0;0
1683;196372;37;0;0;0;0;.00nan;0;0
1683;202161;37;94;30;1;29;.967;3600000;0
1683;182049;46;69;25;2;23;.920;3544000;0
1683;218119;46;0;0;0;0;.00nan;0;0
1684;194264;41;0;0;0;0;.00nan;0;0
1684;184081;52;0;0;0;0;.00nan;0;0
1684;192688;41;60;23;2;21;.913;3545000;0
1684;91398;52;78;18;1;17;.944;3600000;0
1685;170977;62;0;0;0;0;.00nan;0;0
1685;181102;48;60;22;2;20;.909;3600000;0
1685;186549;62;80;47;4;43;.915;3594000;0
1685;142492;48;0;0;0;0;.00nan;0;0
1686;203288;51;0;0;0;0;.00nan;0;0
1686;188888;51;77;29;2;27;.931;3600000;0
1686;185960;39;66;38;3;35;.921;3600000;0
1686;197704;39;0;0;0;0;.00nan;0;0
1687;176921;38;0;0;0;0;.00nan;0;0
1687;-1;38;76;27;1;26;.963;3600000;0
1687;38124;58;98;38;2;36;.947;3600000;0
1687;191026;58;0;0;0;0;.00nan;0;0
1688;178695;63;71;29;2;27;.931;3577000;0
1688;-1;45;100;48;1;47;.979;3600000;0
1688;184610;45;0;0;0;0;.00nan;0;0
1688;180873;63;0;0;0;0;.00nan;0;0
1689;224943;60;0;0;0;0;.00nan;0;0
1689;181341;60;62;40;5;35;.875;3600000;0
1689;79132;4619;34;30;6;24;.800;3215000;0
1689;86228;4619;54;3;0;3;1.000;326000;0
1690;2195;53;34;23;5;18;.783;3600000;0
1690;184081;52;100;34;1;33;.971;3600000;0
1690;169323;53;0;0;0;0;.00nan;0;0
1690;91398;52;0;0;0;0;.00nan;0;0
1691;175658;36;70;43;4;39;.907;3600000;0
1691;192552;36;0;0;0;0;.00nan;0;0
1691;77955;56;0;0;0;0;.00nan;0;0
1691;85437;56;65;18;1;17;.944;3600000;0
1692;4622;64;0;0;0;0;.00nan;0;0
1692;196372;37;0;0;0;0;.00nan;0;0
1692;202161;37;81;32;2;30;.938;3600000;0
1692;85661;64;76;30;3;27;.900;3573000;0
1693;187699;47;0;0;0;0;.00nan;0;0
1693;185743;4837;76;20;1;19;.950;3600000;0
1693;186495;47;63;25;3;22;.880;3557000;0
1693;187295;4837;0;0;0;0;.00nan;0;0
1694;205799;57;78;34;2;32;.941;3600000;0
1694;210998;44;0;0;0;0;.00nan;0;0
1694;64911;44;54;32;5;27;.844;3600000;0
1694;152418;57;0;0;0;0;.00nan;0;0
1695;171970;55;58;14;1;13;.929;1292000;0
1695;194502;55;14;19;6;13;.684;2308000;0
1695;178789;65;81;30;1;29;.967;3600000;0
1695;184770;65;0;0;0;0;.00nan;0;0
1696;194893;54;56;35;4;31;.886;3600000;0
1696;189639;54;0;0;0;0;.00nan;0;0
1696;182049;46;0;0;0;0;.00nan;0;0
1696;218119;46;65;18;1;17;.944;3600000;0
1697;170977;62;0;0;0;0;.00nan;0;0
1697;181102;48;0;0;0;0;.00nan;0;0
1697;186549;62;69;29;2;27;.931;3545000;0
1697;142492;48;87;32;1;31;.969;3600000;0
1698;184081;52;0;0;0;0;.00nan;0;0
1698;38124;58;0;0;0;0;.00nan;0;0
1698;191026;58;83;36;3;33;.917;3531000;0
1698;91398;52;79;21;1;20;.952;3600000;0
1699;4622;64;27;28;6;22;.786;3600000;0
1699;165744;50;0;0;0;0;.00nan;0;0
1699;57215;50;73;26;2;24;.923;3600000;0
1699;85661;64;0;0;0;0;.00nan;0;0
1700;163565;40;0;0;0;0;.00nan;0;0
1700;185743;4837;62;27;3;24;.889;3594000;0
1700;185812;40;100;34;1;33;.971;3600000;0
1700;187295;4837;0;0;0;0;.00nan;0;0
1701;178695;63;0;0;0;0;.00nan;0;0
1701;-1;45;0;0;0;0;.00nan;0;0
1701;184610;45;59;44;5;39;.886;3600000;0
1701;180873;63;65;20;2;18;.900;3600000;0
1702;2195;53;0;0;0;0;.00nan;0;0
1702;169323;53;59;8;1;7;.875;3600000;0
1702;176921;38;69;42;4;38;.905;3600000;0
1702;-1;38;0;0;0;0;.00nan;0;0
1703;194264;41;66;37;4;33;.892;3900000;0
1703;187362;59;49;31;4;27;.871;3900000;0
1703;192688;41;0;0;0;0;.00nan;0;0
1703;143156;59;0;0;0;0;.00nan;0;0
1704;197940;49;75;26;2;24;.923;3600000;0
1704;187699;47;53;39;6;33;.846;2518000;0
1704;201075;49;0;0;0;0;.00nan;0;0
1704;186495;47;73;17;1;16;.941;1082000;0
1705;194893;54;58;35;4;31;.886;3061000;0
1705;189639;54;35;14;3;11;.786;539000;0
1705;182049;46;70;29;2;27;.931;3600000;0
1705;218119;46;0;0;0;0;.00nan;0;0
1706;175658;36;0;0;0;0;.00nan;0;0
1706;192552;36;62;35;4;31;.886;3600000;0
1706;77955;56;100;26;0;26;1.000;3600000;0
1706;85437;56;0;0;0;0;.00nan;0;0
1707;171970;55;49;24;3;21;.875;3549000;0
1707;194502;55;0;0;0;0;.00nan;0;0
1707;178789;65;0;0;0;0;.00nan;0;0
1707;184770;65;99;45;1;44;.978;3600000;0
1708;203288;51;0;0;0;0;.00nan;0;0
1708;188888;51;63;27;3;24;.889;3900000;0
1708;185960;39;0;0;0;0;.00nan;0;0
1708;197704;39;99;45;3;42;.933;3900000;0
1709;165744;50;76;28;2;26;.929;3600000;0
1709;196372;37;55;4;0;4;1.000;238000;0
1709;202161;37;31;30;6;24;.800;3362000;0
1709;57215;50;0;0;0;0;.00nan;0;0
1710;163565;40;65;32;4;28;.875;3600000;0
1710;224943;60;0;0;0;0;.00nan;0;0
1710;181341;60;38;33;6;27;.818;3560000;0
1710;185812;40;0;0;0;0;.00nan;0;0
1711;194264;41;57;5;0;5;1.000;582000;0
1711;187362;59;0;0;0;0;.00nan;0;0
1711;192688;41;35;36;7;29;.806;3018000;0
1711;143156;59;95;15;0;15;1.000;3600000;0
1712;3359;43;0;0;0;0;.00nan;0;0
1712;189644;42;57;40;5;35;.875;3600000;0
1712;176060;42;0;0;0;0;.00nan;0;0
1712;182116;43;68;23;2;21;.913;3600000;0
1713;197940;49;0;0;0;0;.00nan;0;0
1713;201075;49;85;27;1;26;.963;3600000;0
1713;79132;4619;0;0;0;0;.00nan;0;0
1713;86228;4619;85;36;2;34;.944;3550000;0
1714;2195;53;30;18;4;14;.778;3900000;0
1714;169323;53;0;0;0;0;.00nan;0;0
1714;176921;38;0;0;0;0;.00nan;0;0
1714;-1;38;76;44;4;40;.909;3900000;0
1715;205799;57;0;0;0;0;.00nan;0;0
1715;210998;44;0;0;0;0;.00nan;0;0
1715;64911;44;46;37;6;31;.838;3600000;0
1715;152418;57;71;30;2;28;.933;3600000;0
1716;3359;43;63;16;2;14;.875;3600000;0
1716;189644;42;43;4;1;3;.750;1039000;0
1716;176060;42;25;39;7;32;.821;2561000;0
1716;182116;43;0;0;0;0;.00nan;0;0
1717;171970;55;74;25;2;23;.920;3900000;0
1717;194502;55;0;0;0;0;.00nan;0;0
1717;38124;58;92;50;2;48;.960;3900000;0
1717;191026;58;0;0;0;0;.00nan;0;0
1718;170977;62;0;0;0;0;.00nan;0;0
1718;185743;4837;0;0;0;0;.00nan;0;0
1718;186549;62;51;36;5;31;.861;3563000;0
1718;187295;4837;64;32;3;29;.906;3600000;0
1719;170977;62;98;49;2;47;.959;3533000;0
1719;185743;4837;88;16;0;16;1.000;3600000;0
1719;186549;62;0;0;0;0;.00nan;0;0
1719;187295;4837;0;0;0;0;.00nan;0;0
1720;165744;50;0;0;0;0;.00nan;0;0
1720;-1;45;50;33;4;29;.879;3600000;0
1720;184610;45;0;0;0;0;.00nan;0;0
1720;57215;50;80;37;3;34;.919;3600000;0
1721;184081;52;90;21;0;21;1.000;3600000;0
1721;176921;38;0;0;0;0;.00nan;0;0
1721;-1;38;72;58;6;52;.897;3600000;0
1721;91398;52;0;0;0;0;.00nan;0;0
1722;163565;40;50;39;6;33;.846;3180000;0
1722;205318;61;56;26;3;23;.885;3600000;0
1722;-1;61;0;0;0;0;.00nan;0;0
1722;185812;40;55;7;1;6;.857;420000;0
1723;3359;43;0;0;0;0;.00nan;0;0
1723;182116;43;69;20;1;19;.950;3600000;0
1723;185960;39;43;41;7;34;.829;3183000;0
1723;197704;39;59;6;0;6;1.000;417000;0
1724;187699;47;0;0;0;0;.00nan;0;0
1724;205799;57;0;0;0;0;.00nan;0;0
1724;186495;47;68;21;1;20;.952;3600000;0
1724;152418;57;71;30;2;28;.933;3547000;0
1725;178789;65;99;60;2;58;.967;3600000;0
1725;184770;65;0;0;0;0;.00nan;0;0
1725;187362;59;0;0;0;0;.00nan;0;0
1725;143156;59;45;18;3;15;.833;3543000;0
1726;203288;51;0;0;0;0;.00nan;0;0
1726;188888;51;100;27;0;27;1.000;3600000;0
1726;77955;56;72;35;3;32;.914;3600000;0
1726;85437;56;0;0;0;0;.00nan;0;0
1727;189644;42;80;33;3;30;.909;3900000;0
1727;176060;42;0;0;0;0;.00nan;0;0
1727;185960;39;0;0;0;0;.00nan;0;0
1727;197704;39;100;47;3;44;.936;3900000;0
1728;205318;61;77;32;3;29;.906;3596000;0
1728;-1;61;0;0;0;0;.00nan;0;0
1728;181102;48;68;26;2;24;.923;3600000;0
1728;142492;48;0;0;0;0;.00nan;0;0
1729;38124;58;43;33;5;28;.848;1275000;0
1729;191026;58;30;33;6;27;.818;2325000;0
1729;187362;59;79;13;0;13;1.000;3600000;0
1729;143156;59;0;0;0;0;.00nan;0;0
1730;3359;43;0;0;0;0;.00nan;0;0
1730;194264;41;86;28;1;27;.964;3600000;0
1730;182116;43;50;26;4;22;.846;3600000;0
1730;192688;41;0;0;0;0;.00nan;0;0
1731;185743;4837;61;32;4;28;.875;3600000;0
1731;187295;4837;0;0;0;0;.00nan;0;0
1731;79132;4619;81;23;1;22;.957;3600000;0
1731;86228;4619;0;0;0;0;.00nan;0;0
1732;2195;53;89;11;0;11;1.000;3600000;0
1732;169323;53;0;0;0;0;.00nan;0;0
1732;178789;65;98;53;2;51;.962;3600000;0
1732;184770;65;0;0;0;0;.00nan;0;0
1733;194893;54;78;39;3;36;.923;3900000;0
1733;189639;54;0;0;0;0;.00nan;0;0
1733;196372;37;65;28;3;25;.893;3900000;0
1733;202161;37;0;0;0;0;.00nan;0;0
1734;187699;47;0;0;0;0;.00nan;0;0
1734;205799;57;0;0;0;0;.00nan;0;0
1734;186495;47;78;42;5;37;.881;3900000;0
1734;152418;57;65;38;5;33;.868;3900000;0
1735;197940;49;54;16;2;14;.875;3600000;0
1735;210998;44;49;44;7;37;.841;2843000;0
1735;201075;49;0;0;0;0;.00nan;0;0
1735;64911;44;67;10;0;10;1.000;757000;0
1736;184081;52;0;0;0;0;.00nan;0;0
1736;175658;36;53;33;5;28;.848;3619000;0
1736;192552;36;0;0;0;0;.00nan;0;0
1736;91398;52;37;32;6;26;.813;3592000;0
1737;171970;55;0;0;0;0;.00nan;0;0
1737;194502;55;76;39;3;36;.923;3900000;0
1737;176921;38;69;32;3;29;.906;3900000;0
1737;-1;38;0;0;0;0;.00nan;0;0
1738;-1;45;72;51;5;46;.902;3600000;0
1738;184610;45;0;0;0;0;.00nan;0;0
1738;182049;46;32;18;4;14;.778;2093000;0
1738;218119;46;45;10;2;8;.800;1449000;0
1739;163565;40;60;30;4;26;.867;3600000;0
1739;224943;60;0;0;0;0;.00nan;0;0
1739;181341;60;94;29;1;28;.966;3600000;0
1739;185812;40;0;0;0;0;.00nan;0;0
1740;194264;41;0;0;0;0;.00nan;0;0
1740;185960;39;73;22;1;21;.955;3600000;0
1740;192688;41;68;35;3;32;.914;3519000;0
1740;197704;39;0;0;0;0;.00nan;0;0
1741;38124;58;63;51;6;45;.882;3007000;0
1741;191026;58;64;12;0;12;1.000;593000;0
1741;187362;59;79;17;1;16;.941;3600000;0
1741;143156;59;0;0;0;0;.00nan;0;0
1742;203288;51;0;0;0;0;.00nan;0;0
1742;188888;51;100;32;0;32;1.000;3600000;0
1742;77955;56;40;25;4;21;.840;3600000;0
1742;85437;56;0;0;0;0;.00nan;0;0
1743;171970;55;100;39;1;38;.974;3600000;0
1743;194502;55;0;0;0;0;.00nan;0;0
1743;176921;38;0;0;0;0;.00nan;0;0
1743;-1;38;66;30;3;27;.900;3521000;0
1744;205318;61;0;0;0;0;.00nan;0;0
1744;-1;61;42;15;3;12;.800;3600000;0
1744;181102;48;0;0;0;0;.00nan;0;0
1744;142492;48;58;40;4;36;.900;3568000;0
1745;4622;64;0;0;0;0;.00nan;0;0
1745;196372;37;0;0;0;0;.00nan;0;0
1745;202161;37;57;41;5;36;.878;3600000;0
1745;85661;64;73;24;1;23;.958;3600000;0
1746;165744;50;79;19;1;18;.947;3600000;0
1746;194893;54;0;0;0;0;.00nan;0;0
1746;189639;54;69;37;4;33;.892;3600000;0
1746;57215;50;0;0;0;0;.00nan;0;0
1747;2195;53;52;14;2;12;.857;3600000;0
1747;169323;53;0;0;0;0;.00nan;0;0
1747;178789;65;98;56;3;53;.946;3600000;0
1747;184770;65;0;0;0;0;.00nan;0;0
1748;197940;49;0;0;0;0;.00nan;0;0
1748;210998;44;0;0;0;0;.00nan;0;0
1748;201075;49;70;15;1;14;.933;3600000;0
1748;64911;44;67;39;4;35;.897;3600000;0
1749;-1;45;95;43;3;40;.930;3600000;0
1749;184610;45;0;0;0;0;.00nan;0;0
1749;182049;46;84;8;0;8;1.000;3600000;0
1749;218119;46;0;0;0;0;.00nan;0;0
1750;178695;63;50;28;4;24;.857;3583000;0
1750;189644;42;0;0;0;0;.00nan;0;0
1750;176060;42;54;24;2;22;.917;3600000;0
1750;180873;63;0;0;0;0;.00nan;0;0
1751;163565;40;0;0;0;0;.00nan;0;0
1751;224943;60;0;0;0;0;.00nan;0;0
1751;181341;60;42;23;4;19;.826;3600000;0
1751;185812;40;53;43;5;38;.884;3546000;0
1752;3359;43;22;19;5;14;.737;2350000;0
1752;175658;36;0;0;0;0;.00nan;0;0
1752;182116;43;60;5;0;5;1.000;1250000;0
1752;192552;36;100;43;1;42;.977;3600000;0
1753;2195;53;0;0;0;0;.00nan;0;0
1753;169323;53;86;12;0;12;1.000;3600000;0
1753;38124;58;93;37;1;36;.973;2721000;0
1753;191026;58;24;11;4;7;.636;879000;0
1754;165744;50;0;0;0;0;.00nan;0;0
1754;194893;54;72;40;4;36;.900;3600000;0
1754;189639;54;0;0;0;0;.00nan;0;0
1754;57215;50;70;16;1;15;.938;3600000;0
1755;4622;64;59;37;4;33;.892;3600000;0
1755;196372;37;49;33;5;28;.848;3600000;0
1755;202161;37;0;0;0;0;.00nan;0;0
1755;85661;64;0;0;0;0;.00nan;0;0
1756;185743;4837;60;22;2;20;.909;3600000;0
1756;187295;4837;0;0;0;0;.00nan;0;0
1756;79132;4619;0;0;0;0;.00nan;0;0
1756;86228;4619;97;51;3;48;.941;3568000;0
1757;178695;63;0;0;0;0;.00nan;0;0
1757;189644;42;74;39;3;36;.923;3543000;0
1757;176060;42;0;0;0;0;.00nan;0;0
1757;180873;63;72;31;2;29;.935;3600000;0
1758;203288;51;0;0;0;0;.00nan;0;0
1758;188888;51;43;27;4;23;.852;3750000;0
1758;205799;57;0;0;0;0;.00nan;0;0
1758;152418;57;59;33;5;28;.848;3750000;0
1759;205318;61;48;35;5;30;.857;3585000;0
1759;170977;62;0;0;0;0;.00nan;0;0
1759;-1;61;0;0;0;0;.00nan;0;0
1759;186549;62;68;33;3;30;.909;3600000;0
1760;224943;60;0;0;0;0;.00nan;0;0
1760;181341;60;100;42;2;40;.952;3600000;0
1760;185743;4837;65;38;4;34;.895;3579000;0
1760;187295;4837;0;0;0;0;.00nan;0;0
1761;163565;40;86;40;2;38;.950;3600000;0
1761;185812;40;0;0;0;0;.00nan;0;0
1761;79132;4619;0;0;0;0;.00nan;0;0
1761;86228;4619;84;26;1;25;.962;3600000;0
1762;187699;47;0;0;0;0;.00nan;0;0
1762;210998;44;41;36;6;30;.833;2088000;0
1762;186495;47;84;27;1;26;.963;3600000;0
1762;64911;44;56;16;2;14;.875;1512000;0
1763;194264;41;76;24;2;22;.917;3564000;0
1763;178695;63;83;29;1;28;.966;3600000;0
1763;180873;63;0;0;0;0;.00nan;0;0
1763;192688;41;0;0;0;0;.00nan;0;0
1764;224943;60;71;23;1;22;.957;1802000;0
1764;181341;60;26;27;6;21;.778;1798000;0
1764;185743;4837;0;0;0;0;.00nan;0;0
1764;187295;4837;46;18;3;15;.833;3600000;0
1765;203288;51;0;0;0;0;.00nan;0;0
1765;188888;51;95;35;1;34;.971;3600000;0
1765;205799;57;0;0;0;0;.00nan;0;0
1765;152418;57;73;36;3;33;.917;3567000;0
1766;2195;53;0;0;0;0;.00nan;0;0
1766;169323;53;82;20;1;19;.950;3600000;0
1766;176921;38;55;49;7;42;.857;3600000;0
1766;-1;38;0;0;0;0;.00nan;0;0
1767;178789;65;90;49;2;47;.959;3546000;0
1767;184770;65;0;0;0;0;.00nan;0;0
1767;187362;59;0;0;0;0;.00nan;0;0
1767;143156;59;71;17;1;16;.941;3600000;0
1768;4622;64;0;0;0;0;.00nan;0;0
1768;194893;54;72;57;6;51;.895;3600000;0
1768;189639;54;0;0;0;0;.00nan;0;0
1768;85661;64;40;9;2;7;.778;3600000;0
1769;3359;43;0;0;0;0;.00nan;0;0
1769;182116;43;68;24;2;22;.917;3900000;0
1769;77955;56;0;0;0;0;.00nan;0;0
1769;85437;56;75;26;2;24;.923;3900000;0
1770;189644;42;97;49;2;47;.959;3577000;0
1770;176060;42;0;0;0;0;.00nan;0;0
1770;196372;37;0;0;0;0;.00nan;0;0
1770;202161;37;100;24;0;24;1.000;3600000;0
1771;184081;52;64;21;1;20;.952;3600000;0
1771;38124;58;57;13;1;12;.923;904000;0
1771;191026;58;25;31;7;24;.774;2696000;0
1771;91398;52;0;0;0;0;.00nan;0;0
1772;171970;55;0;0;0;0;.00nan;0;0
1772;194502;55;43;34;6;28;.824;3592000;0
1772;175658;36;75;38;4;34;.895;3600000;0
1772;192552;36;0;0;0;0;.00nan;0;0
1773;178789;65;91;41;3;38;.927;3583000;0
1773;205799;57;47;12;2;10;.833;3600000;0
1773;184770;65;0;0;0;0;.00nan;0;0
1773;152418;57;0;0;0;0;.00nan;0;0
1774;203288;51;74;28;3;25;.893;3900000;0
1774;188888;51;0;0;0;0;.00nan;0;0
1774;178695;63;68;32;3;29;.906;3896000;0
1774;180873;63;0;0;0;0;.00nan;0;0
1775;197940;49;59;29;3;26;.897;3900000;0
1775;201075;49;0;0;0;0;.00nan;0;0
1775;182049;46;82;38;3;35;.921;3900000;0
1775;218119;46;0;0;0;0;.00nan;0;0
1776;189644;42;77;42;3;39;.929;3546000;0
1776;-1;45;0;0;0;0;.00nan;0;0
1776;184610;45;75;33;2;31;.939;3600000;0
1776;176060;42;0;0;0;0;.00nan;0;0
1777;2195;53;75;23;1;22;.957;3600000;0
1777;194264;41;62;37;3;34;.919;3526000;0
1777;169323;53;0;0;0;0;.00nan;0;0
1777;192688;41;0;0;0;0;.00nan;0;0
1778;3359;43;0;0;0;0;.00nan;0;0
1778;182116;43;45;32;5;27;.844;3600000;0
1778;77955;56;0;0;0;0;.00nan;0;0
1778;85437;56;88;26;1;25;.962;3600000;0
1779;194893;54;91;45;3;42;.933;3643000;0
1779;189639;54;0;0;0;0;.00nan;0;0
1779;196372;37;0;0;0;0;.00nan;0;0
1779;202161;37;51;25;4;21;.840;3643000;0
1780;187699;47;0;0;0;0;.00nan;0;0
1780;165744;50;65;29;3;26;.897;3600000;0
1780;186495;47;83;43;4;39;.907;3600000;0
1780;57215;50;0;0;0;0;.00nan;0;0
1781;210998;44;0;0;0;0;.00nan;0;0
1781;64911;44;87;64;6;58;.906;3600000;0
1781;79132;4619;0;0;0;0;.00nan;0;0
1781;86228;4619;65;17;1;16;.941;3600000;0
1782;184081;52;60;21;2;19;.905;3600000;0
1782;176921;38;67;37;4;33;.892;3600000;0
1782;-1;38;0;0;0;0;.00nan;0;0
1782;91398;52;0;0;0;0;.00nan;0;0
1783;171970;55;61;11;1;10;.909;1477000;0
1783;194502;55;27;28;6;22;.786;2123000;0
1783;175658;36;0;0;0;0;.00nan;0;0
1783;192552;36;44;20;4;16;.800;3600000;0
1784;163565;40;63;19;1;18;.947;3600000;0
1784;170977;62;0;0;0;0;.00nan;0;0
1784;185812;40;0;0;0;0;.00nan;0;0
1784;186549;62;59;27;3;24;.889;3600000;0
1785;2195;53;0;0;0;0;.00nan;0;0
1785;169323;53;82;15;0;15;1.000;3600000;0
1785;38124;58;0;0;0;0;.00nan;0;0
1785;191026;58;88;53;4;49;.925;3600000;0
1786;181102;48;0;0;0;0;.00nan;0;0
1786;185743;4837;79;21;1;20;.952;3600000;0
1786;187295;4837;0;0;0;0;.00nan;0;0
1786;142492;48;61;39;4;35;.897;3600000;0
1787;178789;65;58;34;4;30;.882;3600000;0
1787;205799;57;0;0;0;0;.00nan;0;0
1787;184770;65;0;0;0;0;.00nan;0;0
1787;152418;57;61;13;1;12;.923;3600000;0
1788;197940;49;0;0;0;0;.00nan;0;0
1788;201075;49;54;42;6;36;.857;3600000;0
1788;182049;46;85;34;3;31;.912;3600000;0
1788;218119;46;0;0;0;0;.00nan;0;0
1789;176921;38;48;7;1;6;.857;1088000;0
1789;-1;38;23;40;8;32;.800;2512000;0
1789;185960;39;0;0;0;0;.00nan;0;0
1789;197704;39;67;25;3;22;.880;3600000;0
1790;224943;60;0;0;0;0;.00nan;0;0
1790;205318;61;84;32;2;30;.938;3609000;0
1790;-1;61;0;0;0;0;.00nan;0;0
1790;181341;60;72;32;3;29;.906;3609000;0
1791;4622;64;0;0;0;0;.00nan;0;0
1791;187362;59;67;22;2;20;.909;3600000;0
1791;85661;64;84;39;3;36;.923;3556000;0
1791;143156;59;0;0;0;0;.00nan;0;0
1792;194264;41;0;0;0;0;.00nan;0;0
1792;192688;41;62;26;4;22;.846;3600000;0
1792;77955;56;77;39;3;36;.923;3600000;0
1792;85437;56;0;0;0;0;.00nan;0;0
1793;194893;54;0;0;0;0;.00nan;0;0
1793;189639;54;100;46;2;44;.957;3900000;0
1793;196372;37;70;28;2;26;.929;3900000;0
1793;202161;37;0;0;0;0;.00nan;0;0
1794;187699;47;45;20;4;16;.800;3583000;0
1794;165744;50;0;0;0;0;.00nan;0;0
1794;186495;47;0;0;0;0;.00nan;0;0
1794;57215;50;96;38;2;36;.947;3600000;0
1795;210998;44;100;46;0;46;1.000;3600000;0
1795;64911;44;0;0;0;0;.00nan;0;0
1795;79132;4619;38;12;3;9;.750;2560000;0
1795;86228;4619;14;12;5;7;.583;1040000;0
1796;184081;52;73;22;1;21;.955;3600000;0
1796;175658;36;94;57;5;52;.912;3600000;0
1796;192552;36;0;0;0;0;.00nan;0;0
1796;91398;52;0;0;0;0;.00nan;0;0
1797;171970;55;62;35;4;31;.886;3600000;0
1797;3359;43;73;22;1;21;.955;3600000;0
1797;194502;55;0;0;0;0;.00nan;0;0
1797;182116;43;0;0;0;0;.00nan;0;0
1798;38124;58;0;0;0;0;.00nan;0;0
1798;185960;39;0;0;0;0;.00nan;0;0
1798;191026;58;57;32;4;28;.875;3600000;0
1798;197704;39;69;23;2;21;.913;3600000;0
1799;181102;48;81;40;3;37;.925;3554000;0
1799;185743;4837;68;18;1;17;.944;3600000;0
1799;187295;4837;0;0;0;0;.00nan;0;0
1799;142492;48;0;0;0;0;.00nan;0;0
1800;189644;42;86;26;2;24;.923;3900000;0
1800;-1;45;97;45;2;43;.956;3900000;0
1800;184610;45;0;0;0;0;.00nan;0;0
1800;176060;42;0;0;0;0;.00nan;0;0
1801;224943;60;0;0;0;0;.00nan;0;0
1801;205318;61;0;0;0;0;.00nan;0;0
1801;-1;61;95;34;1;33;.971;3600000;0
1801;181341;60;68;31;3;28;.903;3563000;0
1802;4622;64;27;34;7;27;.794;2985000;0
1802;187362;59;0;0;0;0;.00nan;0;0
1802;85661;64;49;2;0;2;1.000;615000;0
1802;143156;59;71;25;2;23;.920;3600000;0
1803;203288;51;0;0;0;0;.00nan;0;0
1803;188888;51;99;20;0;20;1.000;3600000;0
1803;178695;63;87;31;1;30;.968;3600000;0
1803;180873;63;0;0;0;0;.00nan;0;0
1804;224943;60;0;0;0;0;.00nan;0;0
1804;181341;60;91;30;1;29;.967;3600000;0
1804;79132;4619;0;0;0;0;.00nan;0;0
1804;86228;4619;84;34;2;32;.941;3542000;0
1805;163565;40;0;0;0;0;.00nan;0;0
1805;210998;44;17;26;7;19;.731;3562000;0
1805;185812;40;50;32;5;27;.844;3600000;0
1805;64911;44;0;0;0;0;.00nan;0;0
1806;165744;50;83;25;1;24;.960;3600000;0
1806;-1;45;93;40;2;38;.950;3565000;0
1806;184610;45;0;0;0;0;.00nan;0;0
1806;57215;50;0;0;0;0;.00nan;0;0
1807;205318;61;85;27;1;26;.963;3600000;0
1807;170977;62;0;0;0;0;.00nan;0;0
1807;-1;61;0;0;0;0;.00nan;0;0
1807;186549;62;70;32;3;29;.906;3561000;0
1808;187699;47;0;0;0;0;.00nan;0;0
1808;182049;46;92;35;1;34;.971;3600000;0
1808;218119;46;0;0;0;0;.00nan;0;0
1808;186495;47;57;29;4;25;.862;3600000;0
1809;175658;36;58;10;1;9;.900;332000;0
1809;185960;39;0;0;0;0;.00nan;0;0
1809;192552;36;78;53;5;48;.906;3268000;0
1809;197704;39;65;15;1;14;.933;3600000;0
1810;178098;59;0;0;0;0;.00nan;0;0
1810;178789;65;97;67;2;65;.970;3560000;0
1810;174407;59;78;13;0;13;1.000;3600000;0
1810;184770;65;0;0;0;0;.00nan;0;0
1811;3359;43;0;0;0;0;.00nan;0;0
1811;173856;43;53;24;3;21;.875;3854000;0
1811;181102;48;0;0;0;0;.00nan;0;0
1811;142492;48;84;47;4;43;.915;3854000;0
1812;170977;62;0;0;0;0;.00nan;0;0
1812;182049;46;88;37;2;35;.946;3600000;0
1812;218119;46;0;0;0;0;.00nan;0;0
1812;186549;62;90;43;3;40;.930;3600000;0
1813;185960;39;0;0;0;0;.00nan;0;0
1813;197704;39;78;26;1;25;.962;3600000;0
1813;77955;56;0;0;0;0;.00nan;0;0
1813;85437;56;97;56;2;54;.964;3600000;0
1814;178098;59;64;20;1;19;.950;3600000;0
1814;205799;57;77;41;4;37;.902;3600000;0
1814;174407;59;0;0;0;0;.00nan;0;0
1814;152418;57;0;0;0;0;.00nan;0;0
1815;197940;49;90;20;0;20;1.000;3600000;0
1815;4622;64;0;0;0;0;.00nan;0;0
1815;201075;49;0;0;0;0;.00nan;0;0
1815;85661;64;48;27;4;23;.852;3600000;0
1816;194893;54;100;49;3;46;.939;3900000;0
1816;189639;54;0;0;0;0;.00nan;0;0
1816;-1;45;55;23;3;20;.870;3900000;0
1816;184610;45;0;0;0;0;.00nan;0;0
1817;194264;41;91;20;0;20;1.000;3600000;0
1817;176921;38;64;45;5;40;.889;3600000;0
1817;-1;38;0;0;0;0;.00nan;0;0
1817;192688;41;0;0;0;0;.00nan;0;0
1818;205318;61;79;41;4;37;.902;3584000;0
1818;-1;61;0;0;0;0;.00nan;0;0
1818;179950;4837;62;28;3;25;.893;3600000;0
1818;187295;4837;0;0;0;0;.00nan;0;0
1819;189644;42;0;0;0;0;.00nan;0;0
1819;176060;42;49;36;5;31;.861;3564000;0
1819;196372;37;0;0;0;0;.00nan;0;0
1819;202161;37;74;30;3;27;.900;3600000;0
1820;163565;40;61;45;6;39;.867;3559000;0
1820;185812;40;0;0;0;0;.00nan;0;0
1820;79132;4619;74;15;0;15;1.000;2705000;0
1820;86228;4619;28;11;4;7;.636;895000;0
1821;2195;53;0;0;0;0;.00nan;0;0
1821;169323;53;45;21;3;18;.857;3545000;0
1821;38124;58;0;0;0;0;.00nan;0;0
1821;191026;58;97;42;2;40;.952;3600000;0
1822;184081;52;75;25;2;23;.920;3600000;0
1822;178789;65;75;41;3;38;.927;3600000;0
1822;184770;65;0;0;0;0;.00nan;0;0
1822;91398;52;0;0;0;0;.00nan;0;0
1823;171970;55;0;0;0;0;.00nan;0;0
1823;194502;55;97;43;2;41;.953;3600000;0
1823;178695;63;0;0;0;0;.00nan;0;0
1823;180873;63;54;24;3;21;.875;3564000;0
1824;224943;60;63;38;4;34;.895;3544000;0
1824;210998;44;0;0;0;0;.00nan;0;0
1824;181341;60;0;0;0;0;.00nan;0;0
1824;64911;44;84;37;3;34;.919;3600000;0
1825;3359;43;88;15;0;15;1.000;3600000;0
1825;173856;43;0;0;0;0;.00nan;0;0
1825;181102;48;74;34;4;30;.882;3600000;0
1825;142492;48;0;0;0;0;.00nan;0;0
1826;170977;62;62;38;4;34;.895;3600000;0
1826;182049;46;98;31;1;30;.968;3600000;0
1826;218119;46;0;0;0;0;.00nan;0;0
1826;186549;62;0;0;0;0;.00nan;0;0
1827;185960;39;94;23;0;23;1.000;3600000;0
1827;197704;39;0;0;0;0;.00nan;0;0
1827;77955;56;66;34;4;30;.882;3600000;0
1827;85437;56;0;0;0;0;.00nan;0;0
1828;2195;53;27;15;4;11;.733;3544000;0
1828;169323;53;0;0;0;0;.00nan;0;0
1828;38124;58;93;49;3;46;.939;3600000;0
1828;191026;58;0;0;0;0;.00nan;0;0
1829;178098;59;94;18;0;18;1.000;3600000;0
1829;205799;57;0;0;0;0;.00nan;0;0
1829;174407;59;0;0;0;0;.00nan;0;0
1829;152418;57;77;42;5;37;.881;3600000;0
1830;187699;47;0;0;0;0;.00nan;0;0
1830;165744;50;0;0;0;0;.00nan;0;0
1830;186495;47;91;36;2;34;.944;3600000;0
1830;57215;50;41;29;5;24;.828;3600000;0
1831;203288;51;0;0;0;0;.00nan;0;0
1831;188888;51;58;26;3;23;.885;3556000;0
1831;175658;36;92;41;2;39;.951;3600000;0
1831;192552;36;0;0;0;0;.00nan;0;0
1832;163565;40;0;0;0;0;.00nan;0;0
1832;185812;40;58;40;5;35;.875;3600000;0
1832;79132;4619;44;21;3;18;.857;3084000;0
1832;86228;4619;22;4;3;1;.250;495000;0
1833;197940;49;25;22;5;17;.773;3600000;0
1833;4622;64;88;37;2;35;.946;3600000;0
1833;201075;49;0;0;0;0;.00nan;0;0
1833;85661;64;0;0;0;0;.00nan;0;0
1834;194264;41;63;21;2;19;.905;3600000;0
1834;176921;38;0;0;0;0;.00nan;0;0
1834;-1;38;60;43;5;38;.884;3600000;0
1834;192688;41;0;0;0;0;.00nan;0;0
1835;194893;54;0;0;0;0;.00nan;0;0
1835;189639;54;87;30;1;29;.967;3600000;0
1835;-1;45;0;0;0;0;.00nan;0;0
1835;184610;45;52;37;5;32;.865;3600000;0
1836;171970;55;41;23;4;19;.826;2149000;0
1836;194502;55;65;16;1;15;.938;1451000;0
1836;178695;63;54;15;2;13;.867;3600000;0
1836;180873;63;0;0;0;0;.00nan;0;0
1837;224943;60;0;0;0;0;.00nan;0;0
1837;210998;44;68;27;3;24;.889;3600000;0
1837;181341;60;33;34;7;27;.794;3600000;0
1837;64911;44;0;0;0;0;.00nan;0;0
1838;184081;52;57;18;2;16;.889;3570000;0
1838;178789;65;0;0;0;0;.00nan;0;0
1838;184770;65;100;37;0;37;1.000;3600000;0
1838;91398;52;0;0;0;0;.00nan;0;0
1839;187699;47;0;0;0;0;.00nan;0;0
1839;165744;50;100;40;1;39;.975;3600000;0
1839;186495;47;51;19;3;16;.842;3522000;0
1839;57215;50;0;0;0;0;.00nan;0;0
1840;203288;51;69;24;2;22;.917;3600000;0
1840;188888;51;0;0;0;0;.00nan;0;0
1840;175658;36;0;0;0;0;.00nan;0;0
1840;192552;36;44;33;5;28;.848;3600000;0
1841;205318;61;74;30;3;27;.900;3600000;0
1841;-1;61;0;0;0;0;.00nan;0;0
1841;179950;4837;84;12;0;12;1.000;3600000;0
1841;187295;4837;0;0;0;0;.00nan;0;0
1842;189644;42;100;58;1;57;.983;3600000;0
1842;176060;42;0;0;0;0;.00nan;0;0
1842;196372;37;0;0;0;0;.00nan;0;0
1842;202161;37;56;22;3;19;.864;3529000;0
1843;2195;53;80;34;2;32;.941;3900000;0
1843;194264;41;0;0;0;0;.00nan;0;0
1843;169323;53;0;0;0;0;.00nan;0;0
1843;192688;41;90;30;2;28;.933;3900000;0
1844;4622;64;0;0;0;0;.00nan;0;0
1844;196372;37;0;0;0;0;.00nan;0;0
1844;202161;37;40;21;4;17;.810;3600000;0
1844;85661;64;77;32;1;31;.969;3600000;0
1845;178695;63;0;0;0;0;.00nan;0;0
1845;-1;45;100;37;0;37;1.000;3600000;0
1845;184610;45;0;0;0;0;.00nan;0;0
1845;180873;63;65;15;1;14;.933;3600000;0
1846;203288;51;0;0;0;0;.00nan;0;0
1846;188888;51;89;22;1;21;.955;3600000;0
1846;176921;38;70;37;3;34;.919;3600000;0
1846;-1;38;0;0;0;0;.00nan;0;0
1847;3359;43;61;16;1;15;.938;3600000;0
1847;173856;43;0;0;0;0;.00nan;0;0
1847;185960;39;0;0;0;0;.00nan;0;0
1847;197704;39;86;42;4;38;.905;3600000;0
1848;187699;47;0;0;0;0;.00nan;0;0
1848;194893;54;71;36;3;33;.917;3600000;0
1848;189639;54;0;0;0;0;.00nan;0;0
1848;186495;47;64;18;2;16;.889;3600000;0
1849;205318;61;52;32;5;27;.844;3600000;0
1849;-1;61;0;0;0;0;.00nan;0;0
1849;79132;4619;0;0;0;0;.00nan;0;0
1849;86228;4619;66;21;2;19;.905;3600000;0
1850;163565;40;57;27;4;23;.852;3600000;0
1850;181102;48;0;0;0;0;.00nan;0;0
1850;185812;40;0;0;0;0;.00nan;0;0
1850;142492;48;72;25;1;24;.960;3600000;0
1851;-1;45;70;54;5;49;.907;3600000;0
1851;184610;45;0;0;0;0;.00nan;0;0
1851;185960;39;0;0;0;0;.00nan;0;0
1851;197704;39;88;14;0;14;1.000;3600000;0
1852;189644;42;74;37;2;35;.946;3587000;0
1852;176060;42;0;0;0;0;.00nan;0;0
1852;179950;4837;96;34;1;33;.971;3600000;0
1852;187295;4837;0;0;0;0;.00nan;0;0
1853;197940;49;62;17;2;15;.882;3600000;0
1853;224943;60;0;0;0;0;.00nan;0;0
1853;201075;49;0;0;0;0;.00nan;0;0
1853;181341;60;67;49;5;44;.898;3600000;0
1854;4622;64;0;0;0;0;.00nan;0;0
1854;194893;54;58;49;6;43;.878;3600000;0
1854;189639;54;0;0;0;0;.00nan;0;0
1854;85661;64;65;19;1;18;.947;3600000;0
1855;3359;43;0;0;0;0;.00nan;0;0
1855;173856;43;19;15;5;10;.667;3600000;0
1855;176921;38;51;32;4;28;.875;1809000;0
1855;-1;38;31;31;6;25;.806;1791000;0
1856;2195;53;62;22;3;19;.864;3120000;0
1856;194264;41;75;22;1;21;.955;3600000;0
1856;169323;53;22;5;3;2;.400;480000;0
1856;192688;41;0;0;0;0;.00nan;0;0
1857;170977;62;61;28;3;25;.893;3211000;0
1857;186549;62;28;7;3;4;.571;389000;0
1857;79132;4619;78;30;2;28;.933;3600000;0
1857;86228;4619;0;0;0;0;.00nan;0;0
1858;205799;57;0;0;0;0;.00nan;0;0
1858;77955;56;0;0;0;0;.00nan;0;0
1858;85437;56;56;22;3;19;.864;3600000;0
1858;152418;57;67;45;4;41;.911;3551000;0
1859;187699;47;0;0;0;0;.00nan;0;0
1859;196372;37;0;0;0;0;.00nan;0;0
1859;202161;37;71;45;5;40;.889;3600000;0
1859;186495;47;60;29;3;26;.897;3600000;0
1860;205318;61;76;32;3;29;.906;3562000;0
1860;210998;44;0;0;0;0;.00nan;0;0
1860;-1;61;0;0;0;0;.00nan;0;0
1860;64911;44;79;27;1;26;.963;3600000;0
1861;171970;55;26;27;6;21;.778;1175000;0
1861;178098;59;87;16;0;16;1.000;3600000;0
1861;194502;55;71;41;4;37;.902;2425000;0
1861;174407;59;0;0;0;0;.00nan;0;0
1862;165744;50;0;0;0;0;.00nan;0;0
1862;182049;46;96;47;3;44;.936;3569000;0
1862;218119;46;0;0;0;0;.00nan;0;0
1862;57215;50;81;31;2;29;.935;3600000;0
1863;175658;36;46;27;5;22;.815;3600000;0
1863;38124;58;0;0;0;0;.00nan;0;0
1863;191026;58;85;32;2;30;.938;3600000;0
1863;192552;36;0;0;0;0;.00nan;0;0
1864;203288;51;0;0;0;0;.00nan;0;0
1864;188888;51;78;11;0;11;1.000;3600000;0
1864;178789;65;0;0;0;0;.00nan;0;0
1864;184770;65;98;47;2;45;.957;3600000;0
1865;163565;40;0;0;0;0;.00nan;0;0
1865;181102;48;69;21;1;20;.952;3600000;0
1865;185812;40;62;42;5;37;.881;3600000;0
1865;142492;48;0;0;0;0;.00nan;0;0
1866;170977;62;0;0;0;0;.00nan;0;0
1866;186549;62;99;41;1;40;.976;3600000;0
1866;79132;4619;0;0;0;0;.00nan;0;0
1866;86228;4619;35;19;4;15;.789;3600000;0
1867;-1;45;87;51;4;47;.922;3600000;0
1867;184610;45;0;0;0;0;.00nan;0;0
1867;185960;39;0;0;0;0;.00nan;0;0
1867;197704;39;68;15;1;14;.933;3600000;0
1868;197940;49;0;0;0;0;.00nan;0;0
1868;224943;60;0;0;0;0;.00nan;0;0
1868;201075;49;91;16;0;16;1.000;3600000;0
1868;181341;60;76;39;3;36;.923;3600000;0
1869;203288;51;0;0;0;0;.00nan;0;0
1869;178098;59;0;0;0;0;.00nan;0;0
1869;188888;51;74;48;6;42;.875;3600000;0
1869;174407;59;48;23;3;20;.870;3600000;0
1870;4622;64;72;22;1;21;.955;3600000;0
1870;194893;54;82;38;3;35;.921;3553000;0
1870;189639;54;0;0;0;0;.00nan;0;0
1870;85661;64;0;0;0;0;.00nan;0;0
1871;3359;43;66;14;1;13;.929;3600000;0
1871;173856;43;0;0;0;0;.00nan;0;0
1871;176921;38;55;46;6;40;.870;3600000;0
1871;-1;38;0;0;0;0;.00nan;0;0
1872;194264;41;0;0;0;0;.00nan;0;0
1872;205799;57;60;22;2;20;.909;3600000;0
1872;192688;41;58;26;3;23;.885;3566000;0
1872;152418;57;0;0;0;0;.00nan;0;0
1873;187699;47;0;0;0;0;.00nan;0;0
1873;196372;37;74;26;2;24;.923;3900000;0
1873;202161;37;0;0;0;0;.00nan;0;0
1873;186495;47;86;34;2;32;.941;3900000;0
1874;205318;61;0;0;0;0;.00nan;0;0
1874;210998;44;90;37;2;35;.946;3600000;0
1874;-1;61;19;33;8;25;.758;3600000;0
1874;64911;44;0;0;0;0;.00nan;0;0
1875;184081;52;0;0;0;0;.00nan;0;0
1875;38124;58;100;63;4;59;.937;3900000;0
1875;191026;58;0;0;0;0;.00nan;0;0
1875;91398;52;39;18;4;14;.778;3876000;0
1876;171970;55;35;32;6;26;.813;3600000;0
1876;194502;55;0;0;0;0;.00nan;0;0
1876;175658;36;0;0;0;0;.00nan;0;0
1876;192552;36;69;25;2;23;.920;3600000;0
1877;165744;50;47;35;6;29;.829;3600000;0
1877;182049;46;0;0;0;0;.00nan;0;0
1877;218119;46;75;35;2;33;.943;3600000;0
1877;57215;50;0;0;0;0;.00nan;0;0
1878;2195;53;0;0;0;0;.00nan;0;0
1878;169323;53;86;17;0;17;1.000;3600000;0
1878;178789;65;98;56;3;53;.946;3600000;0
1878;184770;65;0;0;0;0;.00nan;0;0
1879;189644;42;0;0;0;0;.00nan;0;0
1879;176060;42;71;25;2;23;.920;3900000;0
1879;179950;4837;0;0;0;0;.00nan;0;0
1879;187295;4837;70;27;2;25;.926;3900000;0
1880;178098;59;53;19;3;16;.842;3600000;0
1880;205799;57;0;0;0;0;.00nan;0;0
1880;174407;59;0;0;0;0;.00nan;0;0
1880;152418;57;98;53;4;49;.925;3545000;0
1881;178695;63;66;26;3;23;.885;3900000;0
1881;-1;45;0;0;0;0;.00nan;0;0
1881;184610;45;93;43;3;40;.930;3900000;0
1881;180873;63;0;0;0;0;.00nan;0;0
1882;171970;55;0;0;0;0;.00nan;0;0
1882;194502;55;100;44;0;44;1.000;3600000;0
1882;175658;36;0;0;0;0;.00nan;0;0
1882;192552;36;78;23;1;22;.957;3553000;0
1883;197940;49;0;0;0;0;.00nan;0;0
1883;170977;62;84;35;2;33;.943;1635000;0
1883;201075;49;50;20;3;17;.850;3600000;0
1883;186549;62;17;20;6;14;.700;1965000;0
1884;4622;64;0;0;0;0;.00nan;0;0
1884;165744;50;24;22;6;16;.727;3132000;0
1884;57215;50;54;4;0;4;1.000;468000;0
1884;85661;64;76;25;2;23;.920;3600000;0
1885;163565;40;77;35;2;33;.943;3900000;0
1885;181102;48;0;0;0;0;.00nan;0;0
1885;185812;40;0;0;0;0;.00nan;0;0
1885;142492;48;88;35;2;33;.943;3900000;0
1886;-1;45;40;37;6;31;.838;3600000;0
1886;184610;45;0;0;0;0;.00nan;0;0
1886;182049;46;67;23;2;21;.913;3600000;0
1886;218119;46;0;0;0;0;.00nan;0;0
1887;2195;53;0;0;0;0;.00nan;0;0
1887;178098;59;0;0;0;0;.00nan;0;0
1887;169323;53;67;41;5;36;.878;3600000;0
1887;174407;59;66;21;2;19;.905;3600000;0
1888;194264;41;55;24;3;21;.875;3600000;0
1888;205799;57;0;0;0;0;.00nan;0;0
1888;192688;41;0;0;0;0;.00nan;0;0
1888;152418;57;49;37;5;32;.865;3589000;0
1889;205318;61;62;35;5;30;.857;3600000;0
1889;-1;61;0;0;0;0;.00nan;0;0
1889;79132;4619;60;19;2;17;.895;3600000;0
1889;86228;4619;0;0;0;0;.00nan;0;0
1890;184081;52;61;15;2;13;.867;3900000;0
1890;77955;56;0;0;0;0;.00nan;0;0
1890;85437;56;96;49;2;47;.959;3900000;0
1890;91398;52;0;0;0;0;.00nan;0;0
1891;171970;55;0;0;0;0;.00nan;0;0
1891;194502;55;87;26;1;25;.962;3600000;0
1891;178789;65;77;48;4;44;.917;3600000;0
1891;184770;65;0;0;0;0;.00nan;0;0
1892;203288;51;0;0;0;0;.00nan;0;0
1892;188888;51;37;25;5;20;.800;3900000;0
1892;185960;39;0;0;0;0;.00nan;0;0
1892;197704;39;100;60;5;55;.917;3900000;0
1893;205799;57;72;29;3;26;.897;3791000;0
1893;38124;58;0;0;0;0;.00nan;0;0
1893;191026;58;81;41;4;37;.902;3791000;0
1893;152418;57;0;0;0;0;.00nan;0;0
1894;203288;51;95;35;1;34;.971;3600000;0
1894;188888;51;0;0;0;0;.00nan;0;0
1894;185960;39;0;0;0;0;.00nan;0;0
1894;197704;39;66;33;3;30;.909;3571000;0
1895;-1;45;84;52;5;47;.904;3600000;0
1895;184610;45;0;0;0;0;.00nan;0;0
1895;182049;46;83;13;0;13;1.000;3600000;0
1895;218119;46;0;0;0;0;.00nan;0;0
1896;176921;38;66;54;6;48;.889;3600000;0
1896;-1;38;0;0;0;0;.00nan;0;0
1896;77955;56;0;0;0;0;.00nan;0;0
1896;85437;56;57;18;2;16;.889;3600000;0
1897;3359;43;70;41;4;37;.902;3600000;0
1897;194264;41;73;32;3;29;.906;3600000;0
1897;173856;43;0;0;0;0;.00nan;0;0
1897;192688;41;0;0;0;0;.00nan;0;0
1898;194893;54;97;46;1;45;.978;3900000;0
1898;189639;54;0;0;0;0;.00nan;0;0
1898;189644;42;84;27;1;26;.963;3900000;0
1898;176060;42;0;0;0;0;.00nan;0;0
1899;2195;53;56;18;2;16;.889;3600000;0
1899;178695;63;71;42;4;38;.905;3543000;0
1899;169323;53;0;0;0;0;.00nan;0;0
1899;180873;63;0;0;0;0;.00nan;0;0
1900;4622;64;0;0;0;0;.00nan;0;0
1900;196372;37;0;0;0;0;.00nan;0;0
1900;202161;37;80;33;3;30;.909;3600000;0
1900;85661;64;89;33;2;31;.939;3600000;0
1901;210998;44;0;0;0;0;.00nan;0;0
1901;179950;4837;82;28;2;26;.929;3890000;0
1901;187295;4837;0;0;0;0;.00nan;0;0
1901;64911;44;93;37;1;36;.973;3890000;0
1902;224943;60;0;0;0;0;.00nan;0;0
1902;181102;48;0;0;0;0;.00nan;0;0
1902;181341;60;63;32;4;28;.875;3900000;0
1902;142492;48;71;36;4;32;.889;3900000;0
1903;178789;65;72;38;4;34;.895;3579000;0
1903;175658;36;46;16;3;13;.813;3600000;0
1903;184770;65;0;0;0;0;.00nan;0;0
1903;192552;36;0;0;0;0;.00nan;0;0
1904;205799;57;0;0;0;0;.00nan;0;0
1904;38124;58;76;37;3;34;.919;3600000;0
1904;191026;58;0;0;0;0;.00nan;0;0
1904;152418;57;100;31;0;31;1.000;3600000;0
1905;165744;50;0;0;0;0;.00nan;0;0
1905;182049;46;71;27;3;24;.889;3600000;0
1905;218119;46;0;0;0;0;.00nan;0;0
1905;57215;50;45;26;4;22;.846;3545000;0
1906;163565;40;0;0;0;0;.00nan;0;0
1906;170977;62;0;0;0;0;.00nan;0;0
1906;185812;40;76;24;1;23;.958;3600000;0
1906;186549;62;66;26;2;24;.923;3547000;0
1907;3359;43;0;0;0;0;.00nan;0;0
1907;178098;59;100;28;0;28;1.000;3600000;0
1907;173856;43;97;45;3;42;.933;3600000;0
1907;174407;59;0;0;0;0;.00nan;0;0
1908;194264;41;0;0;0;0;.00nan;0;0
1908;184081;52;63;23;2;21;.913;3579000;0
1908;192688;41;75;21;1;20;.952;3600000;0
1908;91398;52;0;0;0;0;.00nan;0;0
1909;197940;49;81;27;1;26;.963;3600000;0
1909;201075;49;0;0;0;0;.00nan;0;0
1909;79132;4619;0;0;0;0;.00nan;0;0
1909;86228;4619;78;25;2;23;.920;3543000;0
1910;4622;64;41;2;1;1;.500;366000;0
1910;196372;37;75;29;2;27;.931;3600000;0
1910;202161;37;0;0;0;0;.00nan;0;0
1910;85661;64;59;40;6;34;.850;3234000;0
1911;205318;61;100;39;1;38;.974;3600000;0
1911;-1;61;0;0;0;0;.00nan;0;0
1911;186495;47;43;15;3;12;.800;3591000;0
1911;58100;47;0;0;0;0;.00nan;0;0
1912;210998;44;48;34;5;29;.853;3900000;0
1912;179950;4837;0;0;0;0;.00nan;0;0
1912;187295;4837;48;29;5;24;.828;3900000;0
1912;64911;44;0;0;0;0;.00nan;0;0
1913;224943;60;0;0;0;0;.00nan;0;0
1913;181102;48;57;33;4;29;.879;3600000;0
1913;181341;60;78;23;1;22;.957;3600000;0
1913;142492;48;0;0;0;0;.00nan;0;0
1914;171970;55;0;0;0;0;.00nan;0;0
1914;194502;55;56;36;5;31;.861;3600000;0
1914;175658;36;0;0;0;0;.00nan;0;0
1914;192552;36;83;34;2;32;.941;3600000;0
1915;178789;65;0;0;0;0;.00nan;0;0
1915;184770;65;84;52;5;47;.904;3526000;0
1915;77955;56;41;12;3;9;.750;3600000;0
1915;85437;56;0;0;0;0;.00nan;0;0
1916;165744;50;100;43;1;42;.977;3600000;0
1916;196372;37;0;0;0;0;.00nan;0;0
1916;202161;37;62;30;3;27;.900;3592000;0
1916;57215;50;0;0;0;0;.00nan;0;0
1917;197940;49;0;0;0;0;.00nan;0;0
1917;163565;40;75;46;5;41;.891;3600000;0
1917;201075;49;88;28;1;27;.964;3600000;0
1917;185812;40;0;0;0;0;.00nan;0;0
1918;178695;63;0;0;0;0;.00nan;0;0
1918;176921;38;99;38;1;37;.974;3600000;0
1918;-1;38;0;0;0;0;.00nan;0;0
1918;180873;63;46;20;3;17;.850;3600000;0
1919;178098;59;98;18;0;18;1.000;3600000;0
1919;184081;52;0;0;0;0;.00nan;0;0
1919;174407;59;0;0;0;0;.00nan;0;0
1919;91398;52;91;38;2;36;.947;3575000;0
1920;194893;54;45;22;4;18;.818;2250000;0
1920;189639;54;46;13;2;11;.846;1350000;0
1920;189644;42;0;0;0;0;.00nan;0;0
1920;176060;42;52;18;3;15;.833;3600000;0
1921;2195;53;78;13;0;13;1.000;3600000;0
1921;171970;55;66;41;5;36;.878;3600000;0
1921;194502;55;0;0;0;0;.00nan;0;0
1921;169323;53;0;0;0;0;.00nan;0;0
1922;165744;50;0;0;0;0;.00nan;0;0
1922;189644;42;30;9;3;6;.667;422000;0
1922;176060;42;78;42;3;39;.929;3178000;0
1922;57215;50;80;34;3;31;.912;3600000;0
1923;-1;45;87;34;2;32;.941;3585000;0
1923;184610;45;0;0;0;0;.00nan;0;0
1923;182049;46;99;33;1;32;.970;3600000;0
1923;218119;46;0;0;0;0;.00nan;0;0
1924;181102;48;0;0;0;0;.00nan;0;0
1924;79132;4619;51;34;5;29;.853;3690000;0
1924;86228;4619;0;0;0;0;.00nan;0;0
1924;142492;48;60;46;6;40;.870;3690000;0
1925;170977;62;95;40;2;38;.950;3900000;0
1925;179950;4837;90;32;2;30;.938;3900000;0
1925;186549;62;0;0;0;0;.00nan;0;0
1925;187295;4837;0;0;0;0;.00nan;0;0
1926;163565;40;79;27;2;25;.926;3567000;0
1926;205318;61;83;29;1;28;.966;3600000;0
1926;-1;61;0;0;0;0;.00nan;0;0
1926;185812;40;0;0;0;0;.00nan;0;0
1927;4622;64;0;0;0;0;.00nan;0;0
1927;194893;54;20;22;6;16;.727;2373000;0
1927;189639;54;73;15;0;15;1.000;1227000;0
1927;85661;64;91;18;0;18;1.000;3600000;0
1928;203288;51;0;0;0;0;.00nan;0;0
1928;188888;51;36;18;3;15;.833;3900000;0
1928;77955;56;0;0;0;0;.00nan;0;0
1928;85437;56;99;42;3;39;.929;3900000;0
1929;196372;37;0;0;0;0;.00nan;0;0
1929;202161;37;53;54;7;47;.870;3600000;0
1929;186495;47;83;15;0;15;1.000;3600000;0
1929;58100;47;0;0;0;0;.00nan;0;0
1930;224943;60;0;0;0;0;.00nan;0;0
1930;210998;44;0;0;0;0;.00nan;0;0
1930;181341;60;46;12;2;10;.833;3600000;0
1930;64911;44;78;38;3;35;.921;3584000;0
1931;171970;55;0;0;0;0;.00nan;0;0
1931;3359;43;0;0;0;0;.00nan;0;0
1931;194502;55;66;54;7;47;.870;3600000;0
1931;173856;43;87;19;0;19;1.000;3600000;0
1932;-1;45;72;48;5;43;.896;3558000;0
1932;184610;45;0;0;0;0;.00nan;0;0
1932;182049;46;0;0;0;0;.00nan;0;0
1932;218119;46;52;23;3;20;.870;3600000;0
1933;2195;53;64;36;4;32;.889;3900000;0
1933;178695;63;81;42;4;38;.905;3900000;0
1933;169323;53;0;0;0;0;.00nan;0;0
1933;180873;63;0;0;0;0;.00nan;0;0
1934;181102;48;66;45;5;40;.889;3588000;0
1934;79132;4619;73;36;4;32;.889;3600000;0
1934;86228;4619;0;0;0;0;.00nan;0;0
1934;142492;48;0;0;0;0;.00nan;0;0
1935;178789;65;48;28;4;24;.857;3562000;0
1935;184770;65;0;0;0;0;.00nan;0;0
1935;185960;39;0;0;0;0;.00nan;0;0
1935;197704;39;82;34;2;32;.941;3600000;0
1936;194264;41;54;13;1;12;.923;3900000;0
1936;205799;57;0;0;0;0;.00nan;0;0
1936;192688;41;0;0;0;0;.00nan;0;0
1936;152418;57;100;41;1;40;.976;3900000;0
1937;224943;60;0;0;0;0;.00nan;0;0
1937;170977;62;0;0;0;0;.00nan;0;0
1937;181341;60;51;33;5;28;.848;3568000;0
1937;186549;62;80;38;3;35;.921;3600000;0
1938;178695;63;61;44;6;38;.864;3600000;0
1938;180873;63;0;0;0;0;.00nan;0;0
1938;185960;39;76;24;1;23;.958;3600000;0
1938;197704;39;0;0;0;0;.00nan;0;0
1939;194264;41;0;0;0;0;.00nan;0;0
1939;205799;57;47;31;4;27;.871;3600000;0
1939;192688;41;97;23;0;23;1.000;3600000;0
1939;152418;57;0;0;0;0;.00nan;0;0
1940;197940;49;56;26;4;22;.846;3554000;0
1940;201075;49;0;0;0;0;.00nan;0;0
1940;179950;4837;99;52;3;49;.942;3600000;0
1940;187295;4837;0;0;0;0;.00nan;0;0
1941;176921;38;70;36;4;32;.889;3545000;0
1941;-1;38;0;0;0;0;.00nan;0;0
1941;38124;58;84;43;3;40;.930;3600000;0
1941;191026;58;0;0;0;0;.00nan;0;0
1942;205318;61;92;41;3;38;.927;3600000;0
1942;210998;44;0;0;0;0;.00nan;0;0
1942;-1;61;0;0;0;0;.00nan;0;0
1942;64911;44;100;30;0;30;1.000;3600000;0
1943;4622;64;0;0;0;0;.00nan;0;0
1943;189644;42;0;0;0;0;.00nan;0;0
1943;176060;42;77;34;3;31;.912;3600000;0
1943;85661;64;62;36;4;32;.889;3569000;0
1944;3359;43;0;0;0;0;.00nan;0;0
1944;178789;65;73;34;4;30;.882;2166000;0
1944;173856;43;82;13;0;13;1.000;3600000;0
1944;184770;65;43;36;6;30;.833;1434000;0
1945;165744;50;66;19;2;17;.895;3600000;0
1945;194893;54;27;28;6;22;.786;1918000;0
1945;189639;54;70;17;0;17;1.000;1682000;0
1945;57215;50;0;0;0;0;.00nan;0;0
1946;2195;53;89;32;1;31;.969;3600000;0
1946;169323;53;0;0;0;0;.00nan;0;0
1946;77955;56;0;0;0;0;.00nan;0;0
1946;85437;56;78;34;2;32;.941;3543000;0
1947;196372;37;0;0;0;0;.00nan;0;0
1947;202161;37;65;35;3;32;.914;3546000;0
1947;186495;47;83;30;2;28;.933;3600000;0
1947;58100;47;0;0;0;0;.00nan;0;0
1948;178098;59;77;19;1;18;.947;3900000;0
1948;184081;52;97;42;1;41;.976;3900000;0
1948;174407;59;0;0;0;0;.00nan;0;0
1948;91398;52;0;0;0;0;.00nan;0;0
1949;203288;51;0;0;0;0;.00nan;0;0
1949;171970;55;0;0;0;0;.00nan;0;0
1949;188888;51;67;23;2;21;.913;3548000;0
1949;194502;55;100;50;1;49;.980;3600000;0
1950;165744;50;0;0;0;0;.00nan;0;0
1950;194893;54;96;43;2;41;.953;3900000;0
1950;189639;54;0;0;0;0;.00nan;0;0
1950;57215;50;65;22;2;20;.909;3900000;0
1951;163565;40;0;0;0;0;.00nan;0;0
1951;170977;62;0;0;0;0;.00nan;0;0
1951;185812;40;74;31;3;28;.903;3600000;0
1951;186549;62;62;43;5;38;.884;3518000;0
1952;197940;49;0;0;0;0;.00nan;0;0
1952;201075;49;74;29;2;27;.931;3600000;0
1952;179950;4837;69;35;3;32;.914;3545000;0
1952;187295;4837;0;0;0;0;.00nan;0;0
1953;205318;61;0;0;0;0;.00nan;0;0
1953;210998;44;0;0;0;0;.00nan;0;0
1953;-1;61;94;47;4;43;.915;3600000;0
1953;64911;44;76;31;1;30;.968;3600000;0
1954;2195;53;86;37;2;35;.946;3600000;0
1954;178098;59;0;0;0;0;.00nan;0;0
1954;169323;53;0;0;0;0;.00nan;0;0
1954;174407;59;42;24;4;20;.833;3600000;0
1955;4622;64;65;31;4;27;.871;3702000;0
1955;189644;42;68;42;5;37;.881;3702000;0
1955;176060;42;0;0;0;0;.00nan;0;0
1955;85661;64;0;0;0;0;.00nan;0;0
1956;224943;60;0;0;0;0;.00nan;0;0
1956;181341;60;70;41;4;37;.902;3600000;0
1956;186495;47;92;19;0;19;1.000;3600000;0
1956;58100;47;0;0;0;0;.00nan;0;0
1957;184081;52;0;0;0;0;.00nan;0;0
1957;38124;58;86;35;2;33;.943;3600000;0
1957;191026;58;0;0;0;0;.00nan;0;0
1957;91398;52;46;30;5;25;.833;3600000;0
1958;171970;55;97;46;2;44;.957;3600000;0
1958;194502;55;0;0;0;0;.00nan;0;0
1958;77955;56;86;29;1;28;.966;3600000;0
1958;85437;56;0;0;0;0;.00nan;0;0
1959;203288;51;89;33;1;32;.970;3600000;0
1959;188888;51;0;0;0;0;.00nan;0;0
1959;175658;36;43;43;7;36;.837;3267000;0
1959;192552;36;52;2;0;2;1.000;333000;0
1960;178695;63;0;0;0;0;.00nan;0;0
1960;180873;63;86;28;1;27;.964;3600000;0
1960;185960;39;0;0;0;0;.00nan;0;0
1960;197704;39;97;46;2;44;.957;3586000;0
1961;205318;61;85;34;3;31;.912;3552000;0
1961;170977;62;0;0;0;0;.00nan;0;0
1961;-1;61;0;0;0;0;.00nan;0;0
1961;186549;62;77;21;1;20;.952;3600000;0
1962;2195;53;91;19;0;19;1.000;3600000;0
1962;169323;53;0;0;0;0;.00nan;0;0
1962;38124;58;91;41;3;38;.927;3600000;0
1962;191026;58;0;0;0;0;.00nan;0;0
1963;203288;51;0;0;0;0;.00nan;0;0
1963;188888;51;82;15;0;15;1.000;3600000;0
1963;178695;63;75;53;4;49;.925;3600000;0
1963;180873;63;0;0;0;0;.00nan;0;0
1964;163565;40;0;0;0;0;.00nan;0;0
1964;185812;40;31;39;7;32;.821;3600000;0
1964;186495;47;90;32;1;31;.969;3600000;0
1964;58100;47;0;0;0;0;.00nan;0;0
1965;178098;59;87;14;0;14;1.000;3600000;0
1965;178789;65;32;10;3;7;.700;472000;0
1965;174407;59;0;0;0;0;.00nan;0;0
1965;184770;65;91;40;2;38;.950;3128000;0
1966;194264;41;0;0;0;0;.00nan;0;0
1966;175658;36;0;0;0;0;.00nan;0;0
1966;192552;36;70;31;3;28;.903;3900000;0
1966;192688;41;58;30;3;27;.900;3900000;0
1967;165744;50;67;18;1;17;.944;3600000;0
1967;194893;54;75;37;3;34;.919;3600000;0
1967;189639;54;0;0;0;0;.00nan;0;0
1967;57215;50;0;0;0;0;.00nan;0;0
1968;171970;55;0;0;0;0;.00nan;0;0
1968;194502;55;98;53;1;52;.981;3575000;0
1968;77955;56;0;0;0;0;.00nan;0;0
1968;85437;56;92;23;0;23;1.000;3600000;0
1969;-1;45;27;32;6;26;.813;2052000;0
1969;184610;45;74;22;1;21;.955;1548000;0
1969;196372;37;43;24;4;20;.833;3600000;0
1969;202161;37;0;0;0;0;.00nan;0;0
1970;184081;52;84;27;2;25;.926;3558000;0
1970;176921;38;92;41;1;40;.976;3600000;0
1970;-1;38;0;0;0;0;.00nan;0;0
1970;91398;52;0;0;0;0;.00nan;0;0
1971;3359;43;59;16;1;15;.938;1429000;0
1971;173856;43;10;21;7;14;.667;2171000;0
1971;185960;39;0;0;0;0;.00nan;0;0
1971;197704;39;83;45;5;40;.889;3600000;0
1972;179950;4837;58;25;4;21;.840;3600000;0
1972;181102;48;0;0;0;0;.00nan;0;0
1972;187295;4837;0;0;0;0;.00nan;0;0
1972;142492;48;91;32;1;31;.969;3600000;0
1973;197940;49;85;28;1;27;.964;3600000;0
1973;4622;64;0;0;0;0;.00nan;0;0
1973;201075;49;0;0;0;0;.00nan;0;0
1973;85661;64;38;30;5;25;.833;3600000;0
1974;186495;47;90;32;1;31;.969;3600000;0
1974;58100;47;0;0;0;0;.00nan;0;0
1974;79132;4619;72;38;4;34;.895;3600000;0
1974;86228;4619;0;0;0;0;.00nan;0;0
1975;170977;62;0;0;0;0;.00nan;0;0
1975;210998;44;0;0;0;0;.00nan;0;0
1975;186549;62;84;20;1;19;.950;3600000;0
1975;64911;44;27;33;6;27;.818;3600000;0
1976;179950;4837;0;0;0;0;.00nan;0;0
1976;181102;48;59;53;6;47;.887;3556000;0
1976;187295;4837;59;26;4;22;.846;3600000;0
1976;142492;48;0;0;0;0;.00nan;0;0
1977;165744;50;0;0;0;0;.00nan;0;0
1977;-1;45;98;50;3;47;.940;3600000;0
1977;184610;45;0;0;0;0;.00nan;0;0
1977;57215;50;65;22;2;20;.909;3600000;0
1978;171970;55;0;0;0;0;.00nan;0;0
1978;3359;43;38;21;4;17;.810;3580000;0
1978;194502;55;92;46;3;43;.935;3600000;0
1978;173856;43;0;0;0;0;.00nan;0;0
1979;189644;42;0;0;0;0;.00nan;0;0
1979;176060;42;80;49;4;45;.918;3900000;0
1979;182049;46;70;30;4;26;.867;3900000;0
1979;218119;46;0;0;0;0;.00nan;0;0
1980;178098;59;60;23;2;21;.913;3600000;0
1980;174407;59;0;0;0;0;.00nan;0;0
1980;77955;56;0;0;0;0;.00nan;0;0
1980;85437;56;80;48;4;44;.917;3600000;0
1981;184081;52;59;16;2;14;.875;3600000;0
1981;38124;58;62;43;5;38;.884;3600000;0
1981;191026;58;0;0;0;0;.00nan;0;0
1981;91398;52;0;0;0;0;.00nan;0;0
1982;163565;40;0;0;0;0;.00nan;0;0
1982;224943;60;0;0;0;0;.00nan;0;0
1982;181341;60;38;24;5;19;.792;3828000;0
1982;185812;40;81;43;4;39;.907;3828000;0
1983;2195;53;70;25;2;23;.920;3600000;0
1983;169323;53;0;0;0;0;.00nan;0;0
1983;175658;36;34;17;4;13;.765;1055000;0
1983;192552;36;93;49;2;47;.959;2545000;0
1984;178789;65;0;0;0;0;.00nan;0;0
1984;205799;57;91;33;1;32;.970;3600000;0
1984;184770;65;42;32;6;26;.813;3600000;0
1984;152418;57;0;0;0;0;.00nan;0;0
1985;203288;51;0;0;0;0;.00nan;0;0
1985;165744;50;84;43;3;40;.930;3545000;0
1985;188888;51;81;22;1;21;.955;3600000;0
1985;57215;50;0;0;0;0;.00nan;0;0
1986;176921;38;0;0;0;0;.00nan;0;0
1986;-1;38;72;33;3;30;.909;3548000;0
1986;38124;58;83;29;2;27;.931;3600000;0
1986;191026;58;0;0;0;0;.00nan;0;0
1987;205318;61;75;46;4;42;.913;3600000;0
1987;-1;61;0;0;0;0;.00nan;0;0
1987;79132;4619;48;13;3;10;.769;3600000;0
1987;86228;4619;0;0;0;0;.00nan;0;0
1988;197940;49;68;21;2;19;.905;3600000;0
1988;4622;64;0;0;0;0;.00nan;0;0
1988;201075;49;0;0;0;0;.00nan;0;0
1988;85661;64;63;42;5;37;.881;3600000;0
1989;171970;55;71;50;6;44;.880;3600000;0
1989;3359;43;0;0;0;0;.00nan;0;0
1989;194502;55;0;0;0;0;.00nan;0;0
1989;173856;43;91;18;0;18;1.000;3600000;0
1990;178098;59;72;22;2;20;.909;2987000;0
1990;194264;41;57;24;3;21;.875;3600000;0
1990;174407;59;15;6;4;2;.333;608000;0
1990;192688;41;0;0;0;0;.00nan;0;0
1991;194893;54;68;35;3;32;.914;3600000;0
1991;189639;54;0;0;0;0;.00nan;0;0
1991;196372;37;0;0;0;0;.00nan;0;0
1991;202161;37;65;22;2;20;.909;3600000;0
1992;170977;62;94;38;2;36;.947;3900000;0
1992;210998;44;77;31;2;29;.935;3900000;0
1992;186549;62;0;0;0;0;.00nan;0;0
1992;64911;44;0;0;0;0;.00nan;0;0
1993;2195;53;54;18;2;16;.889;3600000;0
1993;184081;52;0;0;0;0;.00nan;0;0
1993;169323;53;0;0;0;0;.00nan;0;0
1993;91398;52;39;33;5;28;.848;3600000;0
1994;178695;63;0;0;0;0;.00nan;0;0
1994;180873;63;84;38;2;36;.947;3583000;0
1994;185960;39;0;0;0;0;.00nan;0;0
1994;197704;39;88;26;1;25;.962;3600000;0
1995;224943;60;72;34;3;31;.912;3587000;0
1995;181341;60;0;0;0;0;.00nan;0;0
1995;186495;47;82;31;2;29;.935;3600000;0
1995;58100;47;0;0;0;0;.00nan;0;0
1996;175658;36;0;0;0;0;.00nan;0;0
1996;192552;36;63;30;3;27;.900;3900000;0
1996;77955;56;57;25;3;22;.880;3900000;0
1996;85437;56;0;0;0;0;.00nan;0;0
1997;178789;65;100;53;2;51;.962;3600000;0
1997;205799;57;0;0;0;0;.00nan;0;0
1997;184770;65;0;0;0;0;.00nan;0;0
1997;152418;57;44;23;4;19;.826;3578000;0
1998;203288;51;68;18;1;17;.944;3600000;0
1998;188888;51;0;0;0;0;.00nan;0;0
1998;-1;45;71;48;5;43;.896;3052000;0
1998;184610;45;47;6;1;5;.833;548000;0
1999;194264;41;0;0;0;0;.00nan;0;0
1999;205799;57;51;38;5;33;.868;3600000;0
1999;192688;41;72;20;1;19;.950;3600000;0
1999;152418;57;0;0;0;0;.00nan;0;0
2000;189644;42;40;28;5;23;.821;3537000;0
2000;176060;42;0;0;0;0;.00nan;0;0
2000;182049;46;83;38;3;35;.921;3600000;0
2000;218119;46;0;0;0;0;.00nan;0;0
2001;205318;61;0;0;0;0;.00nan;0;0
2001;-1;61;60;45;5;40;.889;3600000;0
2001;79132;4619;76;21;1;20;.952;3600000;0
2001;86228;4619;0;0;0;0;.00nan;0;0
2002;194893;54;63;39;4;35;.897;3565000;0
2002;189639;54;0;0;0;0;.00nan;0;0
2002;196372;37;67;27;2;25;.926;3600000;0
2002;202161;37;0;0;0;0;.00nan;0;0
2003;163565;40;0;0;0;0;.00nan;0;0
2003;179950;4837;33;11;3;8;.727;3600000;0
2003;185812;40;61;55;7;48;.873;3600000;0
2003;187295;4837;0;0;0;0;.00nan;0;0
2004;163565;40;60;49;5;44;.898;3600000;0
2004;179950;4837;0;0;0;0;.00nan;0;0
2004;185812;40;0;0;0;0;.00nan;0;0
2004;187295;4837;74;28;2;26;.929;3600000;0
2005;165744;50;71;27;2;25;.926;3695000;0
2005;182049;46;87;39;3;36;.923;3695000;0
2005;218119;46;0;0;0;0;.00nan;0;0
2005;57215;50;0;0;0;0;.00nan;0;0
2006;170977;62;0;0;0;0;.00nan;0;0
2006;181102;48;0;0;0;0;.00nan;0;0
2006;186549;62;55;25;3;22;.880;3600000;0
2006;142492;48;72;43;4;39;.907;3567000;0
2007;205318;61;65;31;3;28;.903;3600000;0
2007;-1;61;0;0;0;0;.00nan;0;0
2007;186495;47;53;31;4;27;.871;3565000;0
2007;58100;47;0;0;0;0;.00nan;0;0
2008;178098;59;36;12;3;9;.750;3600000;0
2008;205799;57;0;0;0;0;.00nan;0;0
2008;174407;59;0;0;0;0;.00nan;0;0
2008;152418;57;79;46;4;42;.913;3596000;0
2009;224943;60;0;0;0;0;.00nan;0;0
2009;210998;44;0;0;0;0;.00nan;0;0
2009;181341;60;60;32;4;28;.875;3900000;0
2009;64911;44;58;30;4;26;.867;3900000;0
2010;203288;51;0;0;0;0;.00nan;0;0
2010;188888;51;84;30;2;28;.933;3546000;0
2010;178695;63;0;0;0;0;.00nan;0;0
2010;180873;63;70;24;1;23;.958;3600000;0
2011;176921;38;86;34;1;33;.971;3600000;0
2011;-1;38;0;0;0;0;.00nan;0;0
2011;38124;58;0;0;0;0;.00nan;0;0
2011;191026;58;36;29;5;24;.828;3600000;0
2012;205318;61;56;18;2;16;.889;986000;0
2012;-1;61;50;34;6;28;.824;2614000;0
2012;179950;4837;82;13;0;13;1.000;3600000;0
2012;187295;4837;0;0;0;0;.00nan;0;0
2013;224943;60;43;30;5;25;.833;3432000;0
2013;165744;50;76;22;2;20;.909;3600000;0
2013;181341;60;31;6;3;3;.500;168000;0
2013;57215;50;0;0;0;0;.00nan;0;0
2014;4622;64;0;0;0;0;.00nan;0;0
2014;-1;45;69;35;3;32;.914;3559000;0
2014;184610;45;0;0;0;0;.00nan;0;0
2014;85661;64;66;24;2;22;.917;3600000;0
2015;197940;49;76;21;1;20;.952;3600000;0
2015;194893;54;81;39;3;36;.923;3536000;0
2015;189639;54;0;0;0;0;.00nan;0;0
2015;201075;49;0;0;0;0;.00nan;0;0
2016;210998;44;0;0;0;0;.00nan;0;0
2016;64911;44;88;43;3;40;.930;3582000;0
2016;79132;4619;82;23;1;22;.957;3600000;0
2016;86228;4619;0;0;0;0;.00nan;0;0
2017;203288;51;0;0;0;0;.00nan;0;0
2017;188888;51;52;25;4;21;.840;3900000;0
2017;77955;56;0;0;0;0;.00nan;0;0
2017;85437;56;73;43;4;39;.907;3900000;0
2018;170977;62;0;0;0;0;.00nan;0;0
2018;186495;47;0;0;0;0;.00nan;0;0
2018;186549;62;91;33;1;32;.970;3600000;0
2018;58100;47;76;32;2;30;.938;3562000;0
2019;184081;52;0;0;0;0;.00nan;0;0
2019;178789;65;65;47;5;42;.894;3566000;0
2019;184770;65;0;0;0;0;.00nan;0;0
2019;91398;52;47;20;3;17;.850;3600000;0
2020;196372;37;85;25;1;24;.960;3600000;0
2020;202161;37;0;0;0;0;.00nan;0;0
2020;182049;46;89;34;2;32;.941;3575000;0
2020;218119;46;0;0;0;0;.00nan;0;0
2021;3359;43;0;0;0;0;.00nan;0;0
2021;173856;43;52;28;4;24;.857;3900000;0
2021;175658;36;87;53;4;49;.925;3900000;0
2021;192552;36;0;0;0;0;.00nan;0;0
2022;205799;57;0;0;0;0;.00nan;0;0
2022;38124;58;98;39;1;38;.974;3600000;0
2022;191026;58;0;0;0;0;.00nan;0;0
2022;152418;57;94;23;0;23;1.000;3600000;0
2023;205318;61;34;19;4;15;.789;1012000;0
2023;-1;61;91;32;0;32;1.000;2888000;0
2023;179950;4837;50;26;4;22;.846;3900000;0
2023;187295;4837;0;0;0;0;.00nan;0;0
2024;224943;60;0;0;0;0;.00nan;0;0
2024;165744;50;0;0;0;0;.00nan;0;0
2024;181341;60;48;36;5;31;.861;3600000;0
2024;57215;50;67;24;2;22;.917;3600000;0
2025;203288;51;92;27;1;26;.963;3600000;0
2025;188888;51;0;0;0;0;.00nan;0;0
2025;77955;56;70;33;3;30;.909;3541000;0
2025;85437;56;0;0;0;0;.00nan;0;0
2026;163565;40;0;0;0;0;.00nan;0;0
2026;181102;48;0;0;0;0;.00nan;0;0
2026;185812;40;58;18;2;16;.889;3567000;0
2026;142492;48;100;35;1;34;.971;3600000;0
2027;178098;59;59;8;1;7;.875;3600000;0
2027;174407;59;0;0;0;0;.00nan;0;0
2027;176921;38;66;41;5;36;.878;2400000;0
2027;-1;38;33;14;3;11;.786;1200000;0
2028;4622;64;40;19;3;16;.842;3900000;0
2028;-1;45;0;0;0;0;.00nan;0;0
2028;184610;45;100;51;3;48;.941;3900000;0
2028;85661;64;0;0;0;0;.00nan;0;0
2029;189644;42;38;39;6;33;.846;3600000;0
2029;176060;42;0;0;0;0;.00nan;0;0
2029;185960;39;0;0;0;0;.00nan;0;0
2029;197704;39;40;15;3;12;.800;3600000;0
2030;197940;49;0;0;0;0;.00nan;0;0
2030;194893;54;79;33;2;31;.939;3134000;0
2030;189639;54;29;10;3;7;.700;466000;0
2030;201075;49;54;21;3;18;.857;3600000;0
2031;210998;44;83;42;3;39;.929;3600000;0
2031;64911;44;0;0;0;0;.00nan;0;0
2031;79132;4619;0;0;0;0;.00nan;0;0
2031;86228;4619;32;21;5;16;.762;3555000;0
2032;170977;62;29;35;7;28;.800;2883000;0
2032;186495;47;97;18;0;18;1.000;3600000;0
2032;186549;62;52;13;2;11;.846;717000;0
2032;58100;47;0;0;0;0;.00nan;0;0
2033;2195;53;72;38;3;35;.921;3545000;0
2033;184081;52;87;34;2;32;.941;3600000;0
2033;169323;53;0;0;0;0;.00nan;0;0
2033;91398;52;0;0;0;0;.00nan;0;0
2034;196372;37;0;0;0;0;.00nan;0;0
2034;202161;37;86;34;2;32;.941;3900000;0
2034;182049;46;85;34;2;32;.941;3900000;0
2034;218119;46;0;0;0;0;.00nan;0;0
2035;171970;55;0;0;0;0;.00nan;0;0
2035;194502;55;65;37;4;33;.892;3600000;0
2035;178695;63;73;22;1;21;.955;3600000;0
2035;180873;63;0;0;0;0;.00nan;0;0
2036;194264;41;57;21;3;18;.857;3574000;0
2036;178789;65;92;52;2;50;.962;3600000;0
2036;184770;65;0;0;0;0;.00nan;0;0
2036;192688;41;0;0;0;0;.00nan;0;0
2037;205799;57;0;0;0;0;.00nan;0;0
2037;38124;58;0;0;0;0;.00nan;0;0
2037;191026;58;71;47;4;43;.915;3539000;0
2037;152418;57;67;21;2;19;.905;3600000;0
2038;163565;40;95;37;2;35;.946;3900000;0
2038;181102;48;0;0;0;0;.00nan;0;0
2038;185812;40;0;0;0;0;.00nan;0;0
2038;142492;48;97;37;2;35;.946;3900000;0
2039;178098;59;0;0;0;0;.00nan;0;0
2039;194264;41;0;0;0;0;.00nan;0;0
2039;174407;59;91;18;0;18;1.000;3600000;0
2039;192688;41;63;45;5;40;.889;3600000;0
2040;189644;42;62;14;1;13;.929;1373000;0
2040;176060;42;42;41;7;34;.829;2227000;0
2040;185960;39;29;13;4;9;.692;1495000;0
2040;197704;39;3;13;6;7;.538;2058000;0
2041;2195;53;0;0;0;0;.00nan;0;0
2041;184081;52;0;0;0;0;.00nan;0;0
2041;169323;53;63;28;3;25;.893;3600000;0
2041;91398;52;62;38;4;34;.895;3547000;0
2042;171970;55;0;0;0;0;.00nan;0;0
2042;194502;55;79;46;5;41;.891;3580000;0
2042;178695;63;0;0;0;0;.00nan;0;0
2042;180873;63;56;31;4;27;.871;3600000;0
2043;3359;43;0;0;0;0;.00nan;0;0
2043;173856;43;60;24;3;21;.875;3600000;0
2043;175658;36;0;0;0;0;.00nan;0;0
2043;192552;36;67;41;4;37;.902;3588000;0
2044;178789;65;0;0;0;0;.00nan;0;0
2044;184770;65;68;20;1;19;.950;3600000;0
2044;176921;38;0;0;0;0;.00nan;0;0
2044;-1;38;44;35;6;29;.829;3600000;0
2045;210998;44;0;0;0;0;.00nan;0;0
2045;64911;44;87;50;4;46;.920;3537000;0
2045;79132;4619;58;17;2;15;.882;3600000;0
2045;86228;4619;0;0;0;0;.00nan;0;0
2046;189644;42;45;40;6;34;.850;3565000;0
2046;176060;42;0;0;0;0;.00nan;0;0
2046;185960;39;0;0;0;0;.00nan;0;0
2046;197704;39;52;34;5;29;.853;3600000;0
2047;184081;52;61;10;1;9;.900;3600000;0
2047;38124;58;96;49;4;45;.918;3600000;0
2047;191026;58;0;0;0;0;.00nan;0;0
2047;91398;52;0;0;0;0;.00nan;0;0
2048;194893;54;38;40;7;33;.825;3257000;0
2048;189639;54;31;4;2;2;.500;343000;0
2048;-1;45;68;34;3;31;.912;3600000;0
2048;184610;45;0;0;0;0;.00nan;0;0
2049;3359;43;63;23;2;21;.913;3590000;0
2049;173856;43;0;0;0;0;.00nan;0;0
2049;175658;36;95;30;1;29;.967;3600000;0
2049;192552;36;0;0;0;0;.00nan;0;0
2050;163565;40;78;45;3;42;.933;3557000;0
2050;185812;40;0;0;0;0;.00nan;0;0
2050;186495;47;55;18;2;16;.889;3600000;0
2050;58100;47;0;0;0;0;.00nan;0;0
2051;179950;4837;63;23;2;21;.913;3600000;0
2051;187295;4837;0;0;0;0;.00nan;0;0
2051;79132;4619;26;28;6;22;.786;1783000;0
2051;86228;4619;61;22;3;19;.864;1817000;0
2052;224943;60;0;0;0;0;.00nan;0;0
2052;181102;48;0;0;0;0;.00nan;0;0
2052;181341;60;98;35;2;33;.943;3600000;0
2052;142492;48;100;41;1;40;.976;3600000;0
2053;179950;4837;0;0;0;0;.00nan;0;0
2053;187295;4837;39;20;4;16;.800;3600000;0
2053;79132;4619;53;40;6;34;.850;3528000;0
2053;86228;4619;0;0;0;0;.00nan;0;0
2054;205799;57;0;0;0;0;.00nan;0;0
2054;77955;56;0;0;0;0;.00nan;0;0
2054;85437;56;86;36;2;34;.944;3600000;0
2054;152418;57;54;31;4;27;.871;3552000;0
2055;197940;49;44;10;2;8;.800;3600000;0
2055;163565;40;91;60;3;57;.950;3566000;0
2055;201075;49;0;0;0;0;.00nan;0;0
2055;185812;40;0;0;0;0;.00nan;0;0
2056;-1;45;69;36;4;32;.889;3900000;0
2056;184610;45;0;0;0;0;.00nan;0;0
2056;196372;37;51;25;4;21;.840;3900000;0
2056;202161;37;0;0;0;0;.00nan;0;0
2057;205318;61;70;19;1;18;.947;3900000;0
2057;194893;54;93;39;1;38;.974;3900000;0
2057;189639;54;0;0;0;0;.00nan;0;0
2057;-1;61;0;0;0;0;.00nan;0;0
2058;3359;43;0;0;0;0;.00nan;0;0
2058;173856;43;81;26;1;25;.962;3600000;0
2058;189644;42;86;43;2;41;.953;3547000;0
2058;176060;42;0;0;0;0;.00nan;0;0
2059;194264;41;94;23;0;23;1.000;3600000;0
2059;176921;38;67;38;3;35;.921;3600000;0
2059;-1;38;0;0;0;0;.00nan;0;0
2059;192688;41;0;0;0;0;.00nan;0;0
2060;2195;53;37;11;3;8;.727;3600000;0
2060;169323;53;0;0;0;0;.00nan;0;0
2060;178789;65;79;48;5;43;.896;3542000;0
2060;184770;65;0;0;0;0;.00nan;0;0
2061;4622;64;0;0;0;0;.00nan;0;0
2061;186495;47;60;29;4;25;.862;3900000;0
2061;58100;47;0;0;0;0;.00nan;0;0
2061;85661;64;64;37;4;33;.892;3870000;0
2062;170977;62;0;0;0;0;.00nan;0;0
2062;210998;44;0;0;0;0;.00nan;0;0
2062;186549;62;84;31;2;29;.935;3900000;0
2062;64911;44;83;36;2;34;.944;3900000;0
2063;171970;55;0;0;0;0;.00nan;0;0
2063;194502;55;83;41;3;38;.927;3548000;0
2063;184081;52;64;22;2;20;.909;3600000;0
2063;91398;52;0;0;0;0;.00nan;0;0
2064;178695;63;84;31;3;28;.903;3522000;0
2064;180873;63;0;0;0;0;.00nan;0;0
2064;185960;39;0;0;0;0;.00nan;0;0
2064;197704;39;84;24;1;23;.958;3600000;0
2065;203288;51;0;0;0;0;.00nan;0;0
2065;188888;51;76;28;2;26;.929;3559000;0
2065;175658;36;0;0;0;0;.00nan;0;0
2065;192552;36;99;39;1;38;.974;3600000;0
2066;224943;60;0;0;0;0;.00nan;0;0
2066;181102;48;78;46;4;42;.913;3587000;0
2066;181341;60;73;27;2;25;.926;3600000;0
2066;142492;48;0;0;0;0;.00nan;0;0
2067;170977;62;78;25;1;24;.960;3600000;0
2067;210998;44;58;35;4;31;.886;3600000;0
2067;186549;62;0;0;0;0;.00nan;0;0
2067;64911;44;0;0;0;0;.00nan;0;0
2068;178789;65;50;32;5;27;.844;3144000;0
2068;184770;65;51;9;1;8;.889;456000;0
2068;38124;58;0;0;0;0;.00nan;0;0
2068;191026;58;94;22;0;22;1.000;3600000;0
2069;205799;57;49;35;5;30;.857;3543000;0
2069;77955;56;56;29;3;26;.897;3600000;0
2069;85437;56;0;0;0;0;.00nan;0;0
2069;152418;57;0;0;0;0;.00nan;0;0
2070;197940;49;0;0;0;0;.00nan;0;0
2070;163565;40;0;0;0;0;.00nan;0;0
2070;201075;49;70;19;1;18;.947;3600000;0
2070;185812;40;87;38;2;36;.947;3545000;0
2071;-1;45;0;0;0;0;.00nan;0;0
2071;184610;45;81;40;3;37;.925;3558000;0
2071;196372;37;0;0;0;0;.00nan;0;0
2071;202161;37;93;34;1;33;.971;3600000;0
2072;2195;53;92;24;0;24;1.000;3600000;0
2072;169323;53;0;0;0;0;.00nan;0;0
2072;176921;38;0;0;0;0;.00nan;0;0
2072;-1;38;82;40;3;37;.925;3600000;0
2073;205318;61;0;0;0;0;.00nan;0;0
2073;194893;54;49;26;4;22;.846;3600000;0
2073;189639;54;0;0;0;0;.00nan;0;0
2073;-1;61;91;30;1;29;.967;3600000;0
2074;3359;43;69;30;3;27;.900;3600000;0
2074;173856;43;0;0;0;0;.00nan;0;0
2074;189644;42;21;35;7;28;.800;3600000;0
2074;176060;42;0;0;0;0;.00nan;0;0
2075;178098;59;0;0;0;0;.00nan;0;0
2075;194264;41;62;34;4;30;.882;3600000;0
2075;174407;59;83;19;1;18;.947;3600000;0
2075;192688;41;0;0;0;0;.00nan;0;0
2076;4622;64;84;38;2;36;.947;3600000;0
2076;186495;47;0;0;0;0;.00nan;0;0
2076;58100;47;53;27;3;24;.889;3563000;0
2076;85661;64;0;0;0;0;.00nan;0;0
2077;203288;51;65;19;2;17;.895;3900000;0
2077;171970;55;0;0;0;0;.00nan;0;0
2077;188888;51;0;0;0;0;.00nan;0;0
2077;194502;55;92;39;2;37;.949;3876000;0
2078;165744;50;78;27;2;25;.926;3600000;0
2078;182049;46;33;28;6;22;.786;3074000;0
2078;218119;46;68;8;0;8;1.000;526000;0
2078;57215;50;0;0;0;0;.00nan;0;0
2079;184081;52;0;0;0;0;.00nan;0;0
2079;175658;36;96;41;2;39;.951;3900000;0
2079;192552;36;0;0;0;0;.00nan;0;0
2079;91398;52;96;40;2;38;.950;3900000;0
2080;178695;63;0;0;0;0;.00nan;0;0
2080;180873;63;75;24;1;23;.958;3600000;0
2080;185960;39;0;0;0;0;.00nan;0;0
2080;197704;39;63;22;2;20;.909;3591000;0
2081;2195;53;60;16;1;15;.938;3600000;0
2081;169323;53;0;0;0;0;.00nan;0;0
2081;38124;58;18;32;7;25;.781;3600000;0
2081;191026;58;0;0;0;0;.00nan;0;0
2082;165744;50;0;0;0;0;.00nan;0;0
2082;182049;46;0;0;0;0;.00nan;0;0
2082;218119;46;80;30;2;28;.933;3600000;0
2082;57215;50;52;36;5;31;.861;3600000;0
2083;178098;59;44;10;2;8;.800;3600000;0
2083;174407;59;0;0;0;0;.00nan;0;0
2083;38124;58;0;0;0;0;.00nan;0;0
2083;191026;58;79;47;3;44;.936;3600000;0
2084;163565;40;80;37;3;34;.919;3886000;0
2084;205318;61;58;36;4;32;.889;3886000;0
2084;-1;61;0;0;0;0;.00nan;0;0
2084;185812;40;0;0;0;0;.00nan;0;0
2085;184081;52;0;0;0;0;.00nan;0;0
2085;178789;65;72;37;3;34;.919;3590000;0
2085;184770;65;0;0;0;0;.00nan;0;0
2085;91398;52;64;24;2;22;.917;3600000;0
2086;171970;55;0;0;0;0;.00nan;0;0
2086;194502;55;75;31;3;28;.903;3557000;0
2086;175658;36;0;0;0;0;.00nan;0;0
2086;192552;36;67;19;1;18;.947;3600000;0
2087;4622;64;0;0;0;0;.00nan;0;0
2087;224943;60;0;0;0;0;.00nan;0;0
2087;181341;60;48;27;4;23;.852;3544000;0
2087;85661;64;64;27;3;24;.889;3600000;0
2088;181102;48;0;0;0;0;.00nan;0;0
2088;79132;4619;56;33;4;29;.879;3550000;0
2088;86228;4619;0;0;0;0;.00nan;0;0
2088;142492;48;70;34;3;31;.912;3600000;0
2089;205799;57;0;0;0;0;.00nan;0;0
2089;210998;44;0;0;0;0;.00nan;0;0
2089;64911;44;43;28;4;24;.857;3552000;0
2089;152418;57;69;29;3;26;.897;3600000;0
2090;197940;49;0;0;0;0;.00nan;0;0
2090;170977;62;0;0;0;0;.00nan;0;0
2090;201075;49;64;23;3;20;.870;3600000;0
2090;186549;62;66;36;4;32;.889;3600000;0
2091;181102;48;0;0;0;0;.00nan;0;0
2091;79132;4619;85;26;0;26;1.000;2457000;0
2091;86228;4619;32;12;4;8;.667;1143000;0
2091;142492;48;50;39;5;34;.872;3600000;0
2092;205799;57;74;24;2;22;.917;3900000;0
2092;210998;44;77;32;2;30;.938;3900000;0
2092;64911;44;0;0;0;0;.00nan;0;0
2092;152418;57;0;0;0;0;.00nan;0;0
2093;163565;40;49;30;4;26;.867;3600000;0
2093;205318;61;0;0;0;0;.00nan;0;0
2093;-1;61;39;27;5;22;.815;3585000;0
2093;185812;40;0;0;0;0;.00nan;0;0
2094;197940;49;36;21;4;17;.810;3511000;0
2094;170977;62;84;40;2;38;.950;3600000;0
2094;201075;49;0;0;0;0;.00nan;0;0
2094;186549;62;0;0;0;0;.00nan;0;0
2095;194264;41;76;28;2;26;.929;3600000;0
2095;192688;41;0;0;0;0;.00nan;0;0
2095;77955;56;0;0;0;0;.00nan;0;0
2095;85437;56;40;15;4;11;.733;3533000;0
2096;4622;64;0;0;0;0;.00nan;0;0
2096;224943;60;0;0;0;0;.00nan;0;0
2096;181341;60;73;36;3;33;.917;3600000;0
2096;85661;64;69;31;2;29;.935;3600000;0
2097;175658;36;75;32;3;29;.906;3900000;0
2097;185960;39;0;0;0;0;.00nan;0;0
2097;192552;36;0;0;0;0;.00nan;0;0
2097;197704;39;92;44;3;41;.932;3900000;0
2098;2195;53;72;21;1;20;.952;3600000;0
2098;169323;53;0;0;0;0;.00nan;0;0
2098;178789;65;98;47;3;44;.936;3600000;0
2098;184770;65;0;0;0;0;.00nan;0;0
2099;203288;51;0;0;0;0;.00nan;0;0
2099;188888;51;86;31;2;29;.935;3600000;0
2099;194264;41;51;27;4;23;.852;3583000;0
2099;192688;41;0;0;0;0;.00nan;0;0
2100;163565;40;87;40;3;37;.925;3600000;0
2100;179950;4837;84;13;0;13;1.000;3600000;0
2100;185812;40;0;0;0;0;.00nan;0;0
2100;187295;4837;0;0;0;0;.00nan;0;0
2101;178098;59;50;23;3;20;.870;3600000;0
2101;174407;59;0;0;0;0;.00nan;0;0
2101;176921;38;83;57;5;52;.912;3547000;0
2101;-1;38;0;0;0;0;.00nan;0;0
2102;3359;43;0;0;0;0;.00nan;0;0
2102;173856;43;58;25;3;22;.880;3550000;0
2102;185960;39;0;0;0;0;.00nan;0;0
2102;197704;39;95;44;2;42;.955;3600000;0
2103;189644;42;0;0;0;0;.00nan;0;0
2103;-1;45;68;51;6;45;.882;3600000;0
2103;184610;45;0;0;0;0;.00nan;0;0
2103;176060;42;42;25;5;20;.800;3600000;0
2104;194893;54;33;32;6;26;.813;2700000;0
2104;189639;54;49;7;1;6;.857;900000;0
2104;182049;46;75;17;1;16;.941;3600000;0
2104;218119;46;0;0;0;0;.00nan;0;0
2105;165744;50;71;22;2;20;.909;3900000;0
2105;196372;37;95;44;2;42;.955;3900000;0
2105;202161;37;0;0;0;0;.00nan;0;0
2105;57215;50;0;0;0;0;.00nan;0;0
2106;2195;53;73;22;1;21;.955;3600000;0
2106;171970;55;15;24;7;17;.708;1496000;0
2106;194502;55;98;37;1;36;.973;2104000;0
2106;169323;53;0;0;0;0;.00nan;0;0
2107;224943;60;0;0;0;0;.00nan;0;0
2107;205318;61;0;0;0;0;.00nan;0;0
2107;-1;61;72;36;3;33;.917;3600000;0
2107;181341;60;89;15;0;15;1.000;3600000;0
2108;175658;36;0;0;0;0;.00nan;0;0
2108;192552;36;88;35;2;33;.943;3900000;0
2108;77955;56;0;0;0;0;.00nan;0;0
2108;85437;56;70;34;2;32;.941;3900000;0
2109;181102;48;0;0;0;0;.00nan;0;0
2109;186495;47;74;24;2;22;.917;3900000;0
2109;58100;47;0;0;0;0;.00nan;0;0
2109;142492;48;97;39;2;37;.949;3900000;0
2110;170977;62;0;0;0;0;.00nan;0;0
2110;179950;4837;60;33;5;28;.848;3547000;0
2110;186549;62;73;36;3;33;.917;3600000;0
2110;187295;4837;0;0;0;0;.00nan;0;0
2111;3359;43;73;23;1;22;.957;3600000;0
2111;173856;43;0;0;0;0;.00nan;0;0
2111;185960;39;57;5;0;5;1.000;413000;0
2111;197704;39;47;34;5;29;.853;3187000;0
2112;176921;38;50;9;1;8;.889;1489000;0
2112;-1;38;15;22;6;16;.727;2111000;0
2112;38124;58;100;34;0;34;1.000;3600000;0
2112;191026;58;0;0;0;0;.00nan;0;0
2113;178695;63;0;0;0;0;.00nan;0;0
2113;205799;57;0;0;0;0;.00nan;0;0
2113;180873;63;92;30;1;29;.967;3900000;0
2113;152418;57;97;26;1;25;.962;3900000;0
2114;203288;51;100;27;0;27;1.000;3600000;0
2114;188888;51;0;0;0;0;.00nan;0;0
2114;194264;41;0;0;0;0;.00nan;0;0
2114;192688;41;60;30;4;26;.867;3600000;0
2115;197940;49;62;19;2;17;.895;3600000;0
2115;210998;44;67;15;0;15;1.000;617000;0
2115;201075;49;0;0;0;0;.00nan;0;0
2115;64911;44;41;35;6;29;.829;2983000;0
2116;178098;59;0;0;0;0;.00nan;0;0
2116;178789;65;80;49;4;45;.918;3600000;0
2116;174407;59;32;10;3;7;.700;3600000;0
2116;184770;65;0;0;0;0;.00nan;0;0
2117;189644;42;88;21;0;21;1.000;3600000;0
2117;-1;45;0;0;0;0;.00nan;0;0
2117;184610;45;87;46;3;43;.935;3600000;0
2117;176060;42;0;0;0;0;.00nan;0;0
2118;194893;54;51;31;4;27;.871;3548000;0
2118;189639;54;0;0;0;0;.00nan;0;0
2118;182049;46;80;33;3;30;.909;3600000;0
2118;218119;46;0;0;0;0;.00nan;0;0
2119;163565;40;0;0;0;0;.00nan;0;0
2119;185812;40;88;38;2;36;.947;3600000;0
2119;79132;4619;45;20;3;17;.850;3546000;0
2119;86228;4619;0;0;0;0;.00nan;0;0
2120;184081;52;0;0;0;0;.00nan;0;0
2120;77955;56;70;38;4;34;.895;3532000;0
2120;85437;56;0;0;0;0;.00nan;0;0
2120;91398;52;75;23;2;21;.913;3600000;0
2121;4622;64;0;0;0;0;.00nan;0;0
2121;196372;37;0;0;0;0;.00nan;0;0
2121;202161;37;75;39;3;36;.923;3600000;0
2121;85661;64;100;27;0;27;1.000;3600000;0
2122;171970;55;0;0;0;0;.00nan;0;0
2122;194502;55;56;38;4;34;.895;3553000;0
2122;175658;36;71;27;2;25;.926;3600000;0
2122;192552;36;0;0;0;0;.00nan;0;0
2123;224943;60;0;0;0;0;.00nan;0;0
2123;205318;61;44;35;5;30;.857;3549000;0
2123;-1;61;0;0;0;0;.00nan;0;0
2123;181341;60;76;30;3;27;.900;3600000;0
2124;181102;48;92;60;4;56;.933;3553000;0
2124;186495;47;56;17;3;14;.824;3600000;0
2124;58100;47;0;0;0;0;.00nan;0;0
2124;142492;48;0;0;0;0;.00nan;0;0
2125;178695;63;66;30;3;27;.900;3525000;0
2125;205799;57;89;30;1;29;.967;3600000;0
2125;180873;63;0;0;0;0;.00nan;0;0
2125;152418;57;0;0;0;0;.00nan;0;0
2126;197940;49;0;0;0;0;.00nan;0;0
2126;210998;44;90;26;1;25;.962;3600000;0
2126;201075;49;76;31;2;29;.935;3600000;0
2126;64911;44;0;0;0;0;.00nan;0;0
2127;170977;62;88;52;4;48;.923;3863000;0
2127;186549;62;0;0;0;0;.00nan;0;0
2127;79132;4619;0;0;0;0;.00nan;0;0
2127;86228;4619;62;31;3;28;.903;3863000;0
2128;2195;53;54;14;2;12;.857;3600000;0
2128;169323;53;0;0;0;0;.00nan;0;0
2128;38124;58;31;10;3;7;.700;299000;0
2128;191026;58;86;43;3;40;.930;3301000;0
2129;184081;52;61;15;1;14;.933;3600000;0
2129;178789;65;0;0;0;0;.00nan;0;0
2129;184770;65;95;45;2;43;.956;3578000;0
2129;91398;52;0;0;0;0;.00nan;0;0
2130;4622;64;0;0;0;0;.00nan;0;0
2130;182049;46;65;25;2;23;.920;3900000;0
2130;218119;46;0;0;0;0;.00nan;0;0
2130;85661;64;100;39;2;37;.949;3900000;0
2131;165744;50;54;40;6;34;.850;3600000;0
2131;189644;42;62;28;3;25;.893;3600000;0
2131;176060;42;0;0;0;0;.00nan;0;0
2131;75313;50;0;0;0;0;.00nan;0;0
2132;181102;48;62;18;2;16;.889;1531000;0
2132;186495;47;72;22;1;21;.955;3600000;0
2132;58100;47;0;0;0;0;.00nan;0;0
2132;142492;48;36;30;6;24;.800;2069000;0
2133;203288;51;30;15;4;11;.733;3546000;0
2133;188888;51;0;0;0;0;.00nan;0;0
2133;178695;63;0;0;0;0;.00nan;0;0
2133;180873;63;60;24;3;21;.875;3600000;0
2134;-1;45;70;13;0;13;1.000;1081000;0
2134;184610;45;42;30;6;24;.800;2519000;0
2134;196372;37;0;0;0;0;.00nan;0;0
2134;202161;37;98;24;0;24;1.000;3600000;0
2135;163565;40;43;39;6;33;.846;3600000;0
2135;205318;61;66;26;3;23;.885;3600000;0
2135;-1;61;0;0;0;0;.00nan;0;0
2135;185812;40;0;0;0;0;.00nan;0;0
2136;178098;59;54;17;2;15;.882;3600000;0
2136;184081;52;82;40;3;37;.925;3584000;0
2136;174407;59;0;0;0;0;.00nan;0;0
2136;91398;52;0;0;0;0;.00nan;0;0
2137;4622;64;0;0;0;0;.00nan;0;0
2137;182049;46;48;15;2;13;.867;3600000;0
2137;218119;46;0;0;0;0;.00nan;0;0
2137;85661;64;46;34;5;29;.853;3600000;0
2138;3359;43;0;0;0;0;.00nan;0;0
2138;173856;43;58;18;2;16;.889;3600000;0
2138;175658;36;45;5;1;4;.800;618000;0
2138;192552;36;37;27;6;21;.778;2982000;0
2139;165744;50;0;0;0;0;.00nan;0;0
2139;189644;42;66;28;3;25;.893;3804000;0
2139;176060;42;0;0;0;0;.00nan;0;0
2139;75313;50;62;31;4;27;.871;3812000;0
2140;194893;54;92;35;2;33;.943;3900000;0
2140;189639;54;0;0;0;0;.00nan;0;0
2140;185960;39;0;0;0;0;.00nan;0;0
2140;197704;39;76;27;2;25;.926;3900000;0
2141;170977;62;0;0;0;0;.00nan;0;0
2141;210998;44;44;28;4;24;.857;3547000;0
2141;186549;62;69;29;3;26;.897;3600000;0
2141;64911;44;0;0;0;0;.00nan;0;0
2142;178789;65;71;35;3;32;.914;3900000;0
2142;184770;65;0;0;0;0;.00nan;0;0
2142;176921;38;60;32;3;29;.906;3900000;0
2142;-1;38;0;0;0;0;.00nan;0;0
2143;170977;62;0;0;0;0;.00nan;0;0
2143;181102;48;0;0;0;0;.00nan;0;0
2143;186549;62;69;26;2;24;.923;3600000;0
2143;142492;48;89;49;4;45;.918;3517000;0
2144;203288;51;0;0;0;0;.00nan;0;0
2144;188888;51;62;15;1;14;.933;3600000;0
2144;176921;38;42;40;6;34;.850;3600000;0
2144;-1;38;0;0;0;0;.00nan;0;0
2145;-1;45;94;49;4;45;.918;3555000;0
2145;184610;45;0;0;0;0;.00nan;0;0
2145;185960;39;0;0;0;0;.00nan;0;0
2145;197704;39;66;22;3;19;.864;3600000;0
2146;197940;49;0;0;0;0;.00nan;0;0
2146;205318;61;0;0;0;0;.00nan;0;0
2146;-1;61;90;58;3;55;.948;3600000;0
2146;201075;49;59;17;2;15;.882;3600000;0
2147;4622;64;0;0;0;0;.00nan;0;0
2147;186495;47;72;27;2;25;.926;3900000;0
2147;58100;47;0;0;0;0;.00nan;0;0
2147;85661;64;77;26;2;24;.923;3900000;0
2148;194264;41;73;21;1;20;.952;3600000;0
2148;178789;65;64;41;4;37;.902;3600000;0
2148;184770;65;0;0;0;0;.00nan;0;0
2148;192688;41;0;0;0;0;.00nan;0;0
2149;194893;54;85;39;3;36;.923;3589000;0
2149;189639;54;0;0;0;0;.00nan;0;0
2149;196372;37;0;0;0;0;.00nan;0;0
2149;202161;37;90;26;1;25;.962;3600000;0
2150;2195;53;67;21;2;19;.905;3600000;0
2150;169323;53;0;0;0;0;.00nan;0;0
2150;38124;58;0;0;0;0;.00nan;0;0
2150;191026;58;65;53;6;47;.887;3600000;0
2151;175658;36;87;48;4;44;.917;3585000;0
2151;192552;36;0;0;0;0;.00nan;0;0
2151;77955;56;0;0;0;0;.00nan;0;0
2151;85437;56;59;21;3;18;.857;3600000;0
2152;210998;44;100;40;0;40;1.000;3600000;0
2152;179950;4837;52;20;3;17;.850;3600000;0
2152;187295;4837;0;0;0;0;.00nan;0;0
2152;64911;44;0;0;0;0;.00nan;0;0
2153;184081;52;0;0;0;0;.00nan;0;0
2153;205799;57;0;0;0;0;.00nan;0;0
2153;91398;52;100;27;0;27;1.000;3600000;0
2153;152418;57;94;38;2;36;.947;3580000;0
2154;171970;55;0;0;0;0;.00nan;0;0
2154;3359;43;64;14;1;13;.929;3600000;0
2154;194502;55;89;40;2;38;.950;3545000;0
2154;173856;43;0;0;0;0;.00nan;0;0
2155;163565;40;74;34;3;31;.912;3600000;0
2155;182049;46;41;24;4;20;.833;3543000;0
2155;218119;46;0;0;0;0;.00nan;0;0
2155;185812;40;0;0;0;0;.00nan;0;0
2156;224943;60;0;0;0;0;.00nan;0;0
2156;181341;60;97;47;3;44;.936;3600000;0
2156;79132;4619;100;28;0;28;1.000;3600000;0
2156;86228;4619;0;0;0;0;.00nan;0;0
2157;170977;62;82;22;1;21;.955;3900000;0
2157;181102;48;96;38;1;37;.974;3900000;0
2157;186549;62;0;0;0;0;.00nan;0;0
2157;142492;48;0;0;0;0;.00nan;0;0
2158;2195;53;87;10;0;10;1.000;3600000;0
2158;169323;53;0;0;0;0;.00nan;0;0
2158;38124;58;92;47;3;44;.936;3600000;0
2158;191026;58;0;0;0;0;.00nan;0;0
2159;165744;50;79;22;1;21;.955;3600000;0
2159;194893;54;73;43;5;38;.884;3600000;0
2159;189639;54;0;0;0;0;.00nan;0;0
2159;75313;50;0;0;0;0;.00nan;0;0
2160;203288;51;64;16;1;15;.938;3600000;0
2160;188888;51;0;0;0;0;.00nan;0;0
2160;176921;38;53;3;0;3;1.000;246000;0
2160;-1;38;62;56;7;49;.875;3354000;0
2161;-1;45;0;0;0;0;.00nan;0;0
2161;184610;45;99;54;2;52;.963;3600000;0
2161;185960;39;0;0;0;0;.00nan;0;0
2161;197704;39;50;21;3;18;.857;3556000;0
2162;197940;49;73;23;1;22;.957;3600000;0
2162;205318;61;97;68;5;63;.926;3600000;0
2162;-1;61;0;0;0;0;.00nan;0;0
2162;201075;49;0;0;0;0;.00nan;0;0
2163;4622;64;100;49;3;46;.939;3600000;0
2163;186495;47;0;0;0;0;.00nan;0;0
2163;58100;47;48;29;4;25;.862;3563000;0
2163;85661;64;0;0;0;0;.00nan;0;0
2164;194264;41;0;0;0;0;.00nan;0;0
2164;178695;63;0;0;0;0;.00nan;0;0
2164;180873;63;72;41;4;37;.902;3801000;0
2164;192688;41;100;44;3;41;.932;3801000;0
2165;3359;43;0;0;0;0;.00nan;0;0
2165;173856;43;74;29;2;27;.931;3600000;0
2165;77955;56;62;34;4;30;.882;3570000;0
2165;85437;56;0;0;0;0;.00nan;0;0
2166;189644;42;71;38;3;35;.921;3600000;0
2166;176060;42;0;0;0;0;.00nan;0;0
2166;196372;37;89;50;4;46;.920;3579000;0
2166;202161;37;0;0;0;0;.00nan;0;0
2167;210998;44;100;31;0;31;1.000;3600000;0
2167;179950;4837;0;0;0;0;.00nan;0;0
2167;187295;4837;81;28;1;27;.964;3568000;0
2167;64911;44;0;0;0;0;.00nan;0;0
2168;184081;52;72;27;2;25;.926;3600000;0
2168;205799;57;67;39;4;35;.897;3576000;0
2168;91398;52;0;0;0;0;.00nan;0;0
2168;152418;57;0;0;0;0;.00nan;0;0
2169;163565;40;77;42;3;39;.929;3275000;0
2169;182049;46;0;0;0;0;.00nan;0;0
2169;218119;46;58;23;2;21;.913;3600000;0
2169;185812;40;28;8;3;5;.625;325000;0
2170;224943;60;55;27;3;24;.889;3751000;0
2170;181341;60;0;0;0;0;.00nan;0;0
2170;79132;4619;0;0;0;0;.00nan;0;0
2170;86228;4619;68;28;2;26;.929;3751000;0
2171;171970;55;0;0;0;0;.00nan;0;0
2171;194502;55;95;41;3;38;.927;3600000;0
2171;175658;36;0;0;0;0;.00nan;0;0
2171;192552;36;76;36;4;32;.889;3600000;0
2172;178098;59;90;17;0;17;1.000;3600000;0
2172;178789;65;98;56;3;53;.946;3600000;0
2172;174407;59;0;0;0;0;.00nan;0;0
2172;184770;65;0;0;0;0;.00nan;0;0
2173;165744;50;0;0;0;0;.00nan;0;0
2173;189644;42;76;43;5;38;.884;3558000;0
2173;176060;42;0;0;0;0;.00nan;0;0
2173;75313;50;89;43;3;40;.930;3600000;0
2174;178098;59;75;27;2;25;.926;3600000;0
2174;178695;63;80;41;3;38;.927;3566000;0
2174;174407;59;0;0;0;0;.00nan;0;0
2174;180873;63;0;0;0;0;.00nan;0;0
2175;2195;53;51;24;3;21;.875;3600000;0
2175;169323;53;0;0;0;0;.00nan;0;0
2175;205799;57;0;0;0;0;.00nan;0;0
2175;152418;57;84;35;2;33;.943;3600000;0
2176;194893;54;64;40;5;35;.875;3600000;0
2176;189639;54;0;0;0;0;.00nan;0;0
2176;186495;47;69;21;2;19;.905;3600000;0
2176;58100;47;0;0;0;0;.00nan;0;0
2177;197940;49;100;28;0;28;1.000;3600000;0
2177;201075;49;0;0;0;0;.00nan;0;0
2177;79132;4619;95;29;2;27;.931;3524000;0
2177;86228;4619;0;0;0;0;.00nan;0;0
2178;189644;42;73;30;3;27;.900;3600000;0
2178;176060;42;0;0;0;0;.00nan;0;0
2178;196372;37;0;0;0;0;.00nan;0;0
2178;202161;37;67;40;4;36;.900;3600000;0
2179;224943;60;0;0;0;0;.00nan;0;0
2179;170977;62;58;6;0;6;1.000;962000;0
2179;181341;60;62;27;3;24;.889;3600000;0
2179;186549;62;18;26;7;19;.731;2638000;0
2180;184081;52;0;0;0;0;.00nan;0;0
2180;38124;58;0;0;0;0;.00nan;0;0
2180;191026;58;92;42;3;39;.929;3691000;0
2180;91398;52;53;29;4;25;.862;3691000;0
2181;163565;40;94;34;1;33;.971;3600000;0
2181;179950;4837;61;20;2;18;.900;3562000;0
2181;185812;40;0;0;0;0;.00nan;0;0
2181;187295;4837;0;0;0;0;.00nan;0;0
2182;205799;57;0;0;0;0;.00nan;0;0
2182;176921;38;92;32;1;31;.969;3600000;0
2182;-1;38;0;0;0;0;.00nan;0;0
2182;152418;57;55;27;3;24;.889;3584000;0
2183;3359;43;56;18;2;16;.889;3600000;0
2183;173856;43;0;0;0;0;.00nan;0;0
2183;175658;36;0;0;0;0;.00nan;0;0
2183;192552;36;97;53;3;50;.943;3589000;0
2184;178098;59;0;0;0;0;.00nan;0;0
2184;194264;41;58;41;5;36;.878;3600000;0
2184;174407;59;82;26;1;25;.962;3600000;0
2184;192688;41;0;0;0;0;.00nan;0;0
2185;171970;55;64;12;0;12;1.000;1047000;0
2185;194502;55;32;31;6;25;.806;2553000;0
2185;77955;56;0;0;0;0;.00nan;0;0
2185;85437;56;46;22;3;19;.864;3600000;0
2186;178695;63;0;0;0;0;.00nan;0;0
2186;178789;65;52;43;6;37;.860;3600000;0
2186;184770;65;0;0;0;0;.00nan;0;0
2186;180873;63;86;25;1;24;.960;3600000;0
2187;203288;51;0;0;0;0;.00nan;0;0
2187;165744;50;49;19;2;17;.895;3600000;0
2187;188888;51;100;38;1;37;.974;3600000;0
2187;75313;50;0;0;0;0;.00nan;0;0
2188;210998;44;23;3;3;0;.000;446000;0
2188;181102;48;77;20;1;19;.950;1540000;0
2188;64911;44;68;19;1;18;.947;3154000;0
2188;142492;48;42;24;4;20;.833;2011000;0
2189;184081;52;24;23;6;17;.739;3600000;0
2189;38124;58;0;0;0;0;.00nan;0;0
2189;191026;58;77;31;2;29;.935;3600000;0
2189;91398;52;0;0;0;0;.00nan;0;0
2190;2195;53;55;19;3;16;.842;3900000;0
2190;169323;53;0;0;0;0;.00nan;0;0
2190;205799;57;0;0;0;0;.00nan;0;0
2190;152418;57;100;50;3;47;.940;3900000;0
2191;163565;40;79;39;3;36;.923;3600000;0
2191;179950;4837;86;33;1;32;.970;3600000;0
2191;185812;40;0;0;0;0;.00nan;0;0
2191;187295;4837;0;0;0;0;.00nan;0;0
2192;178789;65;58;39;4;35;.897;3547000;0
2192;184770;65;0;0;0;0;.00nan;0;0
2192;176921;38;70;26;2;24;.923;3600000;0
2192;-1;38;0;0;0;0;.00nan;0;0
2193;4622;64;0;0;0;0;.00nan;0;0
2193;205318;61;0;0;0;0;.00nan;0;0
2193;-1;61;83;47;4;43;.915;3600000;0
2193;85661;64;89;14;0;14;1.000;3600000;0
2194;3359;43;64;11;0;11;1.000;623000;0
2194;173856;43;20;24;6;18;.750;2945000;0
2194;77955;56;0;0;0;0;.00nan;0;0
2194;85437;56;63;39;5;34;.872;3600000;0
2195;178098;59;38;24;5;19;.792;3588000;0
2195;194264;41;74;34;4;30;.882;3600000;0
2195;174407;59;0;0;0;0;.00nan;0;0
2195;192688;41;0;0;0;0;.00nan;0;0
2196;194893;54;28;33;6;27;.818;3201000;0
2196;189639;54;59;7;0;7;1.000;399000;0
2196;189644;42;66;27;3;24;.889;3600000;0
2196;176060;42;0;0;0;0;.00nan;0;0
2197;197940;49;95;22;0;22;1.000;3600000;0
2197;201075;49;0;0;0;0;.00nan;0;0
2197;79132;4619;21;17;5;12;.706;2326000;0
2197;86228;4619;46;14;2;12;.857;1274000;0
2198;-1;45;45;33;6;27;.818;3274000;0
2198;184610;45;39;1;1;0;.000;326000;0
2198;196372;37;0;0;0;0;.00nan;0;0
2198;202161;37;100;25;0;25;1.000;3600000;0
2199;224943;60;0;0;0;0;.00nan;0;0
2199;181341;60;73;36;4;32;.889;3600000;0
2199;186495;47;83;23;1;22;.957;3600000;0
2199;58100;47;0;0;0;0;.00nan;0;0
2200;171970;55;76;44;4;40;.909;3600000;0
2200;194502;55;0;0;0;0;.00nan;0;0
2200;185960;39;0;0;0;0;.00nan;0;0
2200;197704;39;68;17;1;16;.941;3600000;0
2201;170977;62;0;0;0;0;.00nan;0;0
2201;182049;46;60;23;2;21;.913;3600000;0
2201;218119;46;0;0;0;0;.00nan;0;0
2201;186549;62;85;56;3;53;.946;3591000;0
2202;178695;63;0;0;0;0;.00nan;0;0
2202;175658;36;60;50;5;45;.900;3609000;0
2202;180873;63;52;29;4;25;.862;3609000;0
2202;192552;36;0;0;0;0;.00nan;0;0
2203;210998;44;66;34;3;31;.912;3600000;0
2203;181102;48;99;24;0;24;1.000;3600000;0
2203;64911;44;0;0;0;0;.00nan;0;0
2203;142492;48;0;0;0;0;.00nan;0;0
2204;2195;53;67;44;5;39;.886;3590000;0
2204;169323;53;0;0;0;0;.00nan;0;0
2204;205799;57;63;37;4;33;.892;3600000;0
2204;152418;57;0;0;0;0;.00nan;0;0
2205;203288;51;47;29;5;24;.828;3533000;0
2205;165744;50;55;23;3;20;.870;3600000;0
2205;188888;51;0;0;0;0;.00nan;0;0
2205;75313;50;0;0;0;0;.00nan;0;0
2206;163565;40;0;0;0;0;.00nan;0;0
2206;224943;60;58;6;0;6;1.000;1557000;0
2206;181341;60;30;23;6;17;.739;1995000;0
2206;185812;40;59;35;4;31;.886;3600000;0
2207;184081;52;0;0;0;0;.00nan;0;0
2207;176921;38;0;0;0;0;.00nan;0;0
2207;-1;38;82;38;2;36;.947;3600000;0
2207;91398;52;72;21;1;20;.952;3600000;0
2208;4622;64;0;0;0;0;.00nan;0;0
2208;205318;61;80;29;2;27;.931;3600000;0
2208;-1;61;0;0;0;0;.00nan;0;0
2208;85661;64;85;37;3;34;.919;3596000;0
2209;178098;59;0;0;0;0;.00nan;0;0
2209;174407;59;68;7;0;7;1.000;3600000;0
2209;38124;58;33;30;6;24;.800;2183000;0
2209;191026;58;38;21;4;17;.810;1417000;0
2210;3359;43;78;33;3;30;.909;3593000;0
2210;173856;43;0;0;0;0;.00nan;0;0
2210;77955;56;0;0;0;0;.00nan;0;0
2210;85437;56;85;34;2;32;.941;3600000;0
2211;194264;41;82;25;1;24;.960;3838000;0
2211;178789;65;94;49;2;47;.959;3838000;0
2211;184770;65;0;0;0;0;.00nan;0;0
2211;192688;41;0;0;0;0;.00nan;0;0
2212;179950;4837;94;38;1;37;.974;3600000;0
2212;187295;4837;0;0;0;0;.00nan;0;0
2212;79132;4619;0;0;0;0;.00nan;0;0
2212;86228;4619;75;30;2;28;.933;3576000;0
2213;189644;42;67;19;1;18;.947;3600000;0
2213;176060;42;0;0;0;0;.00nan;0;0
2213;196372;37;41;12;2;10;.833;1359000;0
2213;202161;37;34;18;4;14;.778;2241000;0
2214;197940;49;0;0;0;0;.00nan;0;0
2214;201075;49;81;28;2;26;.929;3764000;0
2214;186495;47;84;38;3;35;.921;3764000;0
2214;58100;47;0;0;0;0;.00nan;0;0
2215;171970;55;0;0;0;0;.00nan;0;0
2215;194502;55;63;38;5;33;.868;3600000;0
2215;185960;39;0;0;0;0;.00nan;0;0
2215;197704;39;67;19;2;17;.895;3600000;0
2216;170977;62;97;57;4;53;.930;3539000;0
2216;182049;46;50;15;2;13;.867;3600000;0
2216;218119;46;0;0;0;0;.00nan;0;0
2216;186549;62;0;0;0;0;.00nan;0;0
2217;178695;63;61;30;4;26;.867;3577000;0
2217;175658;36;0;0;0;0;.00nan;0;0
2217;180873;63;0;0;0;0;.00nan;0;0
2217;192552;36;61;30;3;27;.900;3600000;0
2218;170977;62;0;0;0;0;.00nan;0;0
2218;210998;44;76;36;3;33;.917;3900000;0
2218;186549;62;68;23;3;20;.870;3900000;0
2218;64911;44;0;0;0;0;.00nan;0;0
2219;175658;36;48;44;7;37;.841;3600000;0
2219;185960;39;70;31;3;28;.903;3600000;0
2219;192552;36;0;0;0;0;.00nan;0;0
2219;197704;39;0;0;0;0;.00nan;0;0
2220;179950;4837;0;0;0;0;.00nan;0;0
2220;186495;47;78;36;3;33;.917;3900000;0
2220;187295;4837;49;21;3;18;.857;3900000;0
2220;58100;47;0;0;0;0;.00nan;0;0
2221;203288;51;0;0;0;0;.00nan;0;0
2221;188888;51;67;31;3;28;.903;3600000;0
2221;205799;57;0;0;0;0;.00nan;0;0
2221;152418;57;85;37;2;35;.946;3600000;0
2222;197940;49;71;28;2;26;.929;3900000;0
2222;201075;49;0;0;0;0;.00nan;0;0
2222;181102;48;92;37;2;35;.946;3900000;0
2222;142492;48;0;0;0;0;.00nan;0;0
2223;189644;42;59;20;2;18;.900;3600000;0
2223;-1;45;0;0;0;0;.00nan;0;0
2223;184610;45;25;26;6;20;.769;3600000;0
2223;176060;42;0;0;0;0;.00nan;0;0
2224;176921;38;84;30;1;29;.967;3600000;0
2224;-1;38;0;0;0;0;.00nan;0;0
2224;38124;58;0;0;0;0;.00nan;0;0
2224;191026;58;87;36;2;34;.944;3575000;0
2225;4622;64;0;0;0;0;.00nan;0;0
2225;224943;60;0;0;0;0;.00nan;0;0
2225;181341;60;99;31;1;30;.968;3600000;0
2225;85661;64;77;29;2;27;.931;3587000;0
2226;194264;41;62;14;1;13;.929;3600000;0
2226;178789;65;90;57;4;53;.930;3600000;0
2226;184770;65;0;0;0;0;.00nan;0;0
2226;192688;41;0;0;0;0;.00nan;0;0
2227;205318;61;95;47;4;43;.915;3600000;0
2227;-1;61;0;0;0;0;.00nan;0;0
2227;79132;4619;18;8;4;4;.500;987000;0
2227;86228;4619;78;21;1;20;.952;2613000;0
2228;2195;53;0;0;0;0;.00nan;0;0
2228;178098;59;0;0;0;0;.00nan;0;0
2228;169323;53;73;39;4;35;.897;3523000;0
2228;174407;59;75;23;2;21;.913;3600000;0
2229;171970;55;0;0;0;0;.00nan;0;0
2229;194502;55;53;37;5;32;.865;3600000;0
2229;77955;56;0;0;0;0;.00nan;0;0
2229;85437;56;95;30;1;29;.967;3600000;0
2230;196372;37;0;0;0;0;.00nan;0;0
2230;202161;37;92;63;3;60;.952;3600000;0
2230;182049;46;33;38;7;31;.816;3600000;0
2230;218119;46;0;0;0;0;.00nan;0;0
2231;3359;43;0;0;0;0;.00nan;0;0
2231;178695;63;0;0;0;0;.00nan;0;0
2231;173856;43;71;21;1;20;.952;3600000;0
2231;180873;63;76;41;5;36;.878;3600000;0
2232;175658;36;0;0;0;0;.00nan;0;0
2232;185960;39;0;0;0;0;.00nan;0;0
2232;192552;36;57;32;4;28;.875;3600000;0
2232;197704;39;77;26;1;25;.962;3600000;0
2233;194264;41;100;21;0;21;1.000;3600000;0
2233;38124;58;0;0;0;0;.00nan;0;0
2233;191026;58;80;40;3;37;.925;3600000;0
2233;192688;41;0;0;0;0;.00nan;0;0
2234;179950;4837;75;27;2;25;.926;3600000;0
2234;186495;47;75;41;5;36;.878;3600000;0
2234;187295;4837;0;0;0;0;.00nan;0;0
2234;58100;47;0;0;0;0;.00nan;0;0
2235;163565;40;90;21;0;21;1.000;3600000;0
2235;205318;61;0;0;0;0;.00nan;0;0
2235;-1;61;71;40;3;37;.925;3600000;0
2235;185812;40;0;0;0;0;.00nan;0;0
2236;197940;49;0;0;0;0;.00nan;0;0
2236;201075;49;71;20;1;19;.950;3600000;0
2236;181102;48;0;0;0;0;.00nan;0;0
2236;142492;48;64;43;5;38;.884;3600000;0
2237;189644;42;96;37;2;35;.946;3600000;0
2237;-1;45;75;43;4;39;.907;3562000;0
2237;184610;45;0;0;0;0;.00nan;0;0
2237;176060;42;0;0;0;0;.00nan;0;0
2238;2195;53;64;34;4;30;.882;3513000;0
2238;169323;53;0;0;0;0;.00nan;0;0
2238;176921;38;0;0;0;0;.00nan;0;0
2238;-1;38;100;47;2;45;.957;3600000;0
2239;4622;64;66;15;2;13;.867;3600000;0
2239;224943;60;0;0;0;0;.00nan;0;0
2239;181341;60;65;38;4;34;.895;3561000;0
2239;85661;64;0;0;0;0;.00nan;0;0
2240;194893;54;0;0;0;0;.00nan;0;0
2240;189639;54;95;42;1;41;.976;3600000;0
2240;182049;46;46;19;3;16;.842;3588000;0
2240;218119;46;0;0;0;0;.00nan;0;0
2241;165744;50;67;28;3;25;.893;3803000;0
2241;196372;37;56;29;4;25;.862;3803000;0
2241;202161;37;0;0;0;0;.00nan;0;0
2241;75313;50;0;0;0;0;.00nan;0;0
2242;170977;62;95;27;0;27;1.000;3600000;0
2242;210998;44;0;0;0;0;.00nan;0;0
2242;186549;62;0;0;0;0;.00nan;0;0
2242;64911;44;79;30;2;28;.933;3535000;0
2243;178098;59;69;25;2;23;.920;3701000;0
2243;184081;52;89;41;3;38;.927;3701000;0
2243;174407;59;0;0;0;0;.00nan;0;0
2243;91398;52;0;0;0;0;.00nan;0;0
2244;171970;55;82;52;5;47;.904;3555000;0
2244;194502;55;0;0;0;0;.00nan;0;0
2244;77955;56;0;0;0;0;.00nan;0;0
2244;85437;56;82;39;3;36;.923;3600000;0
2245;3359;43;55;33;4;29;.879;3518000;0
2245;178695;63;74;30;2;28;.933;3600000;0
2245;173856;43;0;0;0;0;.00nan;0;0
2245;180873;63;0;0;0;0;.00nan;0;0
2246;203288;51;84;29;1;28;.966;3600000;0
2246;188888;51;0;0;0;0;.00nan;0;0
2246;205799;57;0;0;0;0;.00nan;0;0
2246;152418;57;71;32;3;29;.906;3577000;0
2247;189644;42;86;37;3;34;.919;3560000;0
2247;176060;42;0;0;0;0;.00nan;0;0
2247;179950;4837;0;0;0;0;.00nan;0;0
2247;187295;4837;94;30;1;29;.967;3600000;0
2248;203288;51;0;0;0;0;.00nan;0;0
2248;188888;51;64;13;1;12;.923;3600000;0
2248;-1;45;0;0;0;0;.00nan;0;0
2248;184610;45;93;62;4;58;.935;3600000;0
2249;197940;49;62;19;2;17;.895;3900000;0
2249;170977;62;100;50;2;48;.960;3900000;0
2249;201075;49;0;0;0;0;.00nan;0;0
2249;186549;62;0;0;0;0;.00nan;0;0
2250;165744;50;37;12;3;9;.750;377000;0
2250;194893;54;87;51;4;47;.922;3600000;0
2250;189639;54;0;0;0;0;.00nan;0;0
2250;75313;50;49;26;4;22;.846;3223000;0
2251;196372;37;0;0;0;0;.00nan;0;0
2251;202161;37;57;38;5;33;.868;3600000;0
2251;182049;46;69;21;2;19;.905;3600000;0
2251;218119;46;0;0;0;0;.00nan;0;0
2252;171970;55;0;0;0;0;.00nan;0;0
2252;194502;55;66;52;6;46;.885;3600000;0
2252;185960;39;0;0;0;0;.00nan;0;0
2252;197704;39;71;25;2;23;.920;3600000;0
2253;189644;42;72;34;3;31;.912;3558000;0
2253;176060;42;0;0;0;0;.00nan;0;0
2253;179950;4837;77;27;1;26;.963;3600000;0
2253;187295;4837;0;0;0;0;.00nan;0;0
2254;197940;49;0;0;0;0;.00nan;0;0
2254;170977;62;0;0;0;0;.00nan;0;0
2254;201075;49;27;17;5;12;.706;3600000;0
2254;186549;62;47;39;6;33;.846;3594000;0
2255;178098;59;59;21;2;19;.905;3543000;0
2255;194264;41;94;34;1;33;.971;3600000;0
2255;174407;59;0;0;0;0;.00nan;0;0
2255;192688;41;0;0;0;0;.00nan;0;0
2256;210998;44;87;27;1;26;.963;3600000;0
2256;186495;47;78;30;2;28;.933;3600000;0
2256;58100;47;0;0;0;0;.00nan;0;0
2256;64911;44;0;0;0;0;.00nan;0;0
2257;178695;63;0;0;0;0;.00nan;0;0
2257;178789;65;78;33;3;30;.909;3582000;0
2257;184770;65;0;0;0;0;.00nan;0;0
2257;180873;63;77;31;2;29;.935;3600000;0
2258;175658;36;77;40;3;37;.925;3522000;0
2258;192552;36;0;0;0;0;.00nan;0;0
2258;77955;56;0;0;0;0;.00nan;0;0
2258;85437;56;84;24;1;23;.958;3600000;0
2259;163565;40;78;35;2;33;.943;3558000;0
2259;210998;44;0;0;0;0;.00nan;0;0
2259;185812;40;0;0;0;0;.00nan;0;0
2259;64911;44;79;25;1;24;.960;3600000;0
2260;178695;63;0;0;0;0;.00nan;0;0
2260;180873;63;61;25;3;22;.880;3522000;0
2260;185960;39;0;0;0;0;.00nan;0;0
2260;197704;39;89;25;1;24;.960;3600000;0
2261;203288;51;55;2;0;2;1.000;1176000;0
2261;188888;51;29;24;6;18;.750;2424000;0
2261;-1;45;0;0;0;0;.00nan;0;0
2261;184610;45;93;37;2;35;.946;3600000;0
2262;3359;43;0;0;0;0;.00nan;0;0
2262;173856;43;46;22;4;18;.818;3600000;0
2262;176921;38;40;38;6;32;.842;2262000;0
2262;-1;38;48;24;3;21;.875;1338000;0
2263;2195;53;55;13;2;11;.846;3900000;0
2263;169323;53;0;0;0;0;.00nan;0;0
2263;38124;58;0;0;0;0;.00nan;0;0
2263;191026;58;100;51;2;49;.961;3900000;0
2264;178789;65;55;35;5;30;.857;3541000;0
2264;184770;65;0;0;0;0;.00nan;0;0
2264;77955;56;0;0;0;0;.00nan;0;0
2264;85437;56;57;20;3;17;.850;3600000;0
2265;165744;50;68;32;3;29;.906;3600000;0
2265;196372;37;0;0;0;0;.00nan;0;0
2265;202161;37;58;35;4;31;.886;3600000;0
2265;75313;50;0;0;0;0;.00nan;0;0
2266;4622;64;0;0;0;0;.00nan;0;0
2266;182049;46;85;31;2;29;.935;3553000;0
2266;218119;46;0;0;0;0;.00nan;0;0
2266;85661;64;87;29;1;28;.966;3600000;0
2267;224943;60;0;0;0;0;.00nan;0;0
2267;181341;60;88;34;2;32;.941;3600000;0
2267;79132;4619;31;25;5;20;.800;3600000;0
2267;86228;4619;0;0;0;0;.00nan;0;0
2268;179950;4837;37;30;5;25;.833;3600000;0
2268;181102;48;78;30;2;28;.933;3600000;0
2268;187295;4837;0;0;0;0;.00nan;0;0
2268;142492;48;0;0;0;0;.00nan;0;0
2269;170977;62;0;0;0;0;.00nan;0;0
2269;210998;44;84;23;1;22;.957;3600000;0
2269;186549;62;67;38;3;35;.921;3515000;0
2269;64911;44;0;0;0;0;.00nan;0;0
2270;176921;38;94;58;6;52;.897;3600000;0
2270;-1;38;0;0;0;0;.00nan;0;0
2270;38124;58;100;25;0;25;1.000;3600000;0
2270;191026;58;0;0;0;0;.00nan;0;0
2271;184081;52;46;23;3;20;.870;3600000;0
2271;205799;57;83;49;4;45;.918;3574000;0
2271;91398;52;0;0;0;0;.00nan;0;0
2271;152418;57;0;0;0;0;.00nan;0;0
2272;203288;51;71;32;3;29;.906;3585000;0
2272;165744;50;0;0;0;0;.00nan;0;0
2272;188888;51;0;0;0;0;.00nan;0;0
2272;75313;50;71;19;1;18;.947;3600000;0
2273;197940;49;80;24;1;23;.958;3600000;0
2273;163565;40;0;0;0;0;.00nan;0;0
2273;201075;49;0;0;0;0;.00nan;0;0
2273;185812;40;63;51;6;45;.882;3600000;0
2274;171970;55;66;44;5;39;.886;3600000;0
2274;194264;41;64;21;2;19;.905;3600000;0
2274;194502;55;0;0;0;0;.00nan;0;0
2274;192688;41;0;0;0;0;.00nan;0;0
2275;194893;54;94;36;1;35;.972;3900000;0
2275;189639;54;0;0;0;0;.00nan;0;0
2275;189644;42;0;0;0;0;.00nan;0;0
2275;176060;42;78;23;1;22;.957;3900000;0
2276;-1;45;88;47;3;44;.936;3600000;0
2276;184610;45;0;0;0;0;.00nan;0;0
2276;196372;37;0;0;0;0;.00nan;0;0
2276;202161;37;88;22;1;21;.955;3600000;0
2277;205318;61;72;34;3;31;.912;3600000;0
2277;-1;61;0;0;0;0;.00nan;0;0
2277;186495;47;81;30;2;28;.933;3600000;0
2277;58100;47;0;0;0;0;.00nan;0;0
2278;4622;64;0;0;0;0;.00nan;0;0
2278;182049;46;0;0;0;0;.00nan;0;0
2278;218119;46;49;21;3;18;.857;3566000;0
2278;85661;64;79;32;2;30;.938;3600000;0
2279;178098;59;64;15;1;14;.933;3600000;0
2279;178695;63;79;29;2;27;.931;3600000;0
2279;174407;59;0;0;0;0;.00nan;0;0
2279;180873;63;0;0;0;0;.00nan;0;0
2280;224943;60;0;0;0;0;.00nan;0;0
2280;181341;60;93;36;1;35;.972;3724000;0
2280;79132;4619;0;0;0;0;.00nan;0;0
2280;86228;4619;80;30;2;28;.933;3724000;0
2281;175658;36;0;0;0;0;.00nan;0;0
2281;185960;39;0;0;0;0;.00nan;0;0
2281;192552;36;91;42;3;39;.929;3600000;0
2281;197704;39;31;21;5;16;.762;3541000;0
2282;3359;43;65;17;1;16;.941;3600000;0
2282;178789;65;0;0;0;0;.00nan;0;0
2282;173856;43;0;0;0;0;.00nan;0;0
2282;184770;65;76;54;5;49;.907;3600000;0
2283;197940;49;0;0;0;0;.00nan;0;0
2283;170977;62;86;38;2;36;.947;3600000;0
2283;201075;49;45;13;3;10;.769;3545000;0
2283;186549;62;0;0;0;0;.00nan;0;0
2284;3359;43;0;0;0;0;.00nan;0;0
2284;173856;43;78;11;0;11;1.000;3600000;0
2284;38124;58;0;0;0;0;.00nan;0;0
2284;191026;58;98;61;2;59;.967;3592000;0
2285;184081;52;0;0;0;0;.00nan;0;0
2285;205799;57;0;0;0;0;.00nan;0;0
2285;91398;52;94;21;0;21;1.000;3600000;0
2285;152418;57;74;47;5;42;.894;3600000;0
2286;203288;51;0;0;0;0;.00nan;0;0
2286;165744;50;74;30;2;28;.933;3600000;0
2286;188888;51;38;39;7;32;.821;3600000;0
2286;75313;50;0;0;0;0;.00nan;0;0
2287;163565;40;44;23;4;19;.826;3600000;0
2287;205318;61;0;0;0;0;.00nan;0;0
2287;-1;61;100;24;0;24;1.000;3600000;0
2287;185812;40;0;0;0;0;.00nan;0;0
2288;2195;53;0;0;0;0;.00nan;0;0
2288;169323;53;51;20;3;17;.850;3600000;0
2288;176921;38;52;13;1;12;.923;1071000;0
2288;-1;38;49;46;6;40;.870;2529000;0
2289;175658;36;22;10;4;6;.600;1087000;0
2289;192552;36;96;28;0;28;1.000;2513000;0
2289;77955;56;0;0;0;0;.00nan;0;0
2289;85437;56;74;20;1;19;.950;3600000;0
2290;179950;4837;67;24;2;22;.917;3600000;0
2290;181102;48;56;45;6;39;.867;2712000;0
2290;187295;4837;0;0;0;0;.00nan;0;0
2290;142492;48;49;16;3;13;.813;888000;0
2291;178098;59;60;26;3;23;.885;3600000;0
2291;174407;59;0;0;0;0;.00nan;0;0
2291;185960;39;74;42;4;38;.905;3600000;0
2291;197704;39;0;0;0;0;.00nan;0;0
2292;4622;64;0;0;0;0;.00nan;0;0
2292;196372;37;67;9;0;9;1.000;1925000;0
2292;202161;37;15;19;6;13;.684;1675000;0
2292;85661;64;97;48;2;46;.958;3600000;0
2293;194893;54;91;37;1;36;.973;3600000;0
2293;189639;54;0;0;0;0;.00nan;0;0
2293;189644;42;63;24;2;22;.917;3542000;0
2293;176060;42;0;0;0;0;.00nan;0;0
2294;178695;63;0;0;0;0;.00nan;0;0
2294;180873;63;89;32;1;31;.969;3600000;0
2294;77955;56;0;0;0;0;.00nan;0;0
2294;85437;56;54;28;4;24;.857;3600000;0
2295;170977;62;63;37;5;32;.865;3600000;0
2295;186495;47;86;25;1;24;.960;3600000;0
2295;186549;62;0;0;0;0;.00nan;0;0
2295;58100;47;0;0;0;0;.00nan;0;0
2296;-1;45;0;0;0;0;.00nan;0;0
2296;184610;45;89;38;2;36;.947;3592000;0
2296;182049;46;100;21;0;21;1.000;3600000;0
2296;218119;46;0;0;0;0;.00nan;0;0
2297;176921;38;60;40;4;36;.900;3600000;0
2297;-1;38;0;0;0;0;.00nan;0;0
2297;38124;58;0;0;0;0;.00nan;0;0
2297;191026;58;37;34;6;28;.824;3559000;0
2298;4622;64;0;0;0;0;.00nan;0;0
2298;196372;37;0;0;0;0;.00nan;0;0
2298;202161;37;100;31;1;30;.968;3600000;0
2298;85661;64;80;28;2;26;.929;3570000;0
2299;3359;43;27;8;3;5;.625;583000;0
2299;178098;59;0;0;0;0;.00nan;0;0
2299;173856;43;77;27;2;25;.926;3017000;0
2299;174407;59;78;24;1;23;.958;3600000;0
2300;181102;48;85;40;3;37;.925;3550000;0
2300;79132;4619;97;32;1;31;.969;3600000;0
2300;86228;4619;0;0;0;0;.00nan;0;0
2300;142492;48;0;0;0;0;.00nan;0;0
2301;185960;39;86;34;2;32;.941;3600000;0
2301;197704;39;0;0;0;0;.00nan;0;0
2301;77955;56;68;29;3;26;.897;3569000;0
2301;85437;56;0;0;0;0;.00nan;0;0
2302;163565;40;94;20;0;20;1.000;3600000;0
2302;210998;44;82;37;3;34;.919;3600000;0
2302;185812;40;0;0;0;0;.00nan;0;0
2302;64911;44;0;0;0;0;.00nan;0;0
2303;194264;41;66;23;2;21;.913;3600000;0
2303;178789;65;37;26;5;21;.808;3600000;0
2303;184770;65;0;0;0;0;.00nan;0;0
2303;192688;41;0;0;0;0;.00nan;0;0
2304;165744;50;60;18;2;16;.889;3600000;0
2304;194893;54;58;49;6;43;.878;3600000;0
2304;189639;54;0;0;0;0;.00nan;0;0
2304;75313;50;0;0;0;0;.00nan;0;0
2305;197940;49;69;18;1;17;.944;3600000;0
2305;205318;61;0;0;0;0;.00nan;0;0
2305;-1;61;69;54;6;48;.889;3600000;0
2305;201075;49;0;0;0;0;.00nan;0;0
2306;178098;59;70;7;0;7;1.000;3600000;0
2306;178789;65;97;65;4;61;.938;3600000;0
2306;174407;59;0;0;0;0;.00nan;0;0
2306;184770;65;0;0;0;0;.00nan;0;0
2307;3359;43;0;0;0;0;.00nan;0;0
2307;178695;63;85;46;4;42;.913;3600000;0
2307;173856;43;59;13;1;12;.923;3600000;0
2307;180873;63;0;0;0;0;.00nan;0;0
2308;189644;42;55;35;5;30;.857;3517000;0
2308;176060;42;0;0;0;0;.00nan;0;0
2308;179950;4837;71;30;3;27;.900;3600000;0
2308;187295;4837;0;0;0;0;.00nan;0;0
2309;163565;40;70;49;5;44;.898;3600000;0
2309;185812;40;0;0;0;0;.00nan;0;0
2309;79132;4619;0;0;0;0;.00nan;0;0
2309;86228;4619;72;18;1;17;.944;3600000;0
2310;203288;51;0;0;0;0;.00nan;0;0
2310;2195;53;60;21;2;19;.905;3600000;0
2310;188888;51;89;55;5;50;.909;3600000;0
2310;169323;53;0;0;0;0;.00nan;0;0
2311;185960;39;42;24;4;20;.833;3560000;0
2311;197704;39;0;0;0;0;.00nan;0;0
2311;77955;56;0;0;0;0;.00nan;0;0
2311;85437;56;55;24;3;21;.875;3600000;0
2312;196372;37;0;0;0;0;.00nan;0;0
2312;202161;37;63;35;4;31;.886;3543000;0
2312;182049;46;74;32;3;29;.906;3600000;0
2312;218119;46;0;0;0;0;.00nan;0;0
2313;210998;44;0;0;0;0;.00nan;0;0
2313;181102;48;79;38;3;35;.921;3647000;0
2313;64911;44;82;38;4;34;.895;3647000;0
2313;142492;48;0;0;0;0;.00nan;0;0
2314;184081;52;0;0;0;0;.00nan;0;0
2314;176921;38;76;44;4;40;.909;3600000;0
2314;-1;38;0;0;0;0;.00nan;0;0
2314;91398;52;75;10;0;10;1.000;3600000;0
2315;224943;60;0;0;0;0;.00nan;0;0
2315;170977;62;61;37;5;32;.865;3600000;0
2315;181341;60;77;30;2;28;.933;3600000;0
2315;186549;62;0;0;0;0;.00nan;0;0
2316;171970;55;0;0;0;0;.00nan;0;0
2316;194502;55;83;52;6;46;.885;3583000;0
2316;175658;36;0;0;0;0;.00nan;0;0
2316;192552;36;59;30;4;26;.867;3600000;0
2317;194264;41;39;23;4;19;.826;3514000;0
2317;205799;57;81;30;2;28;.933;3600000;0
2317;192688;41;0;0;0;0;.00nan;0;0
2317;152418;57;0;0;0;0;.00nan;0;0
2318;197940;49;0;0;0;0;.00nan;0;0
2318;205318;61;86;44;3;41;.932;3600000;0
2318;-1;61;0;0;0;0;.00nan;0;0
2318;201075;49;48;14;2;12;.857;3600000;0
2319;-1;45;0;0;0;0;.00nan;0;0
2319;184610;45;95;35;1;34;.971;3600000;0
2319;182049;46;48;23;4;19;.826;3600000;0
2319;218119;46;0;0;0;0;.00nan;0;0
2320;203288;51;52;13;2;11;.846;3600000;0
2320;188888;51;0;0;0;0;.00nan;0;0
2320;176921;38;0;0;0;0;.00nan;0;0
2320;-1;38;81;46;4;42;.913;3557000;0
2321;178098;59;31;13;4;9;.692;3600000;0
2321;174407;59;0;0;0;0;.00nan;0;0
2321;77955;56;0;0;0;0;.00nan;0;0
2321;85437;56;90;34;1;33;.971;3600000;0
2322;3359;43;40;26;6;20;.769;3600000;0
2322;178695;63;0;0;0;0;.00nan;0;0
2322;173856;43;0;0;0;0;.00nan;0;0
2322;180873;63;46;45;7;38;.844;3596000;0
2323;189644;42;56;44;5;39;.886;3569000;0
2323;176060;42;0;0;0;0;.00nan;0;0
2323;179950;4837;0;0;0;0;.00nan;0;0
2323;187295;4837;40;19;4;15;.789;3600000;0
2324;165744;50;65;20;3;17;.850;3544000;0
2324;194893;54;77;32;2;30;.938;3600000;0
2324;189639;54;0;0;0;0;.00nan;0;0
2324;75313;50;0;0;0;0;.00nan;0;0
2325;4622;64;0;0;0;0;.00nan;0;0
2325;196372;37;38;29;5;24;.828;3600000;0
2325;202161;37;0;0;0;0;.00nan;0;0
2325;85661;64;89;26;1;25;.962;3600000;0
2326;186495;47;91;27;1;26;.963;3600000;0
2326;58100;47;0;0;0;0;.00nan;0;0
2326;79132;4619;89;39;2;37;.949;3532000;0
2326;86228;4619;0;0;0;0;.00nan;0;0
2327;210998;44;90;30;1;29;.967;3600000;0
2327;181102;48;69;43;5;38;.884;3600000;0
2327;64911;44;0;0;0;0;.00nan;0;0
2327;142492;48;0;0;0;0;.00nan;0;0
2328;2195;53;0;0;0;0;.00nan;0;0
2328;184081;52;79;29;2;27;.931;3600000;0
2328;169323;53;60;32;4;28;.875;3516000;0
2328;91398;52;0;0;0;0;.00nan;0;0
2329;171970;55;77;48;4;44;.917;3574000;0
2329;194502;55;0;0;0;0;.00nan;0;0
2329;185960;39;72;22;2;20;.909;3600000;0
2329;197704;39;0;0;0;0;.00nan;0;0
2330;224943;60;0;0;0;0;.00nan;0;0
2330;170977;62;0;0;0;0;.00nan;0;0
2330;181341;60;63;26;3;23;.885;3600000;0
2330;186549;62;52;38;5;33;.868;3600000;0
2331;178789;65;60;27;3;24;.889;3600000;0
2331;184770;65;0;0;0;0;.00nan;0;0
2331;38124;58;0;0;0;0;.00nan;0;0
2331;191026;58;49;37;5;32;.865;3591000;0
2332;184081;52;0;0;0;0;.00nan;0;0
2332;38124;58;0;0;0;0;.00nan;0;0
2332;191026;58;65;30;3;27;.900;3574000;0
2332;91398;52;67;14;1;13;.929;3600000;0
2333;194264;41;100;40;0;40;1.000;3600000;0
2333;205799;57;0;0;0;0;.00nan;0;0
2333;192688;41;0;0;0;0;.00nan;0;0
2333;152418;57;66;25;2;23;.920;3516000;0
2334;4622;64;0;0;0;0;.00nan;0;0
2334;165744;50;0;0;0;0;.00nan;0;0
2334;75313;50;46;34;5;29;.853;3600000;0
2334;85661;64;76;25;1;24;.960;3600000;0
2335;194893;54;51;22;3;19;.864;3549000;0
2335;189639;54;0;0;0;0;.00nan;0;0
2335;-1;45;82;36;1;35;.972;3600000;0
2335;184610;45;0;0;0;0;.00nan;0;0
2336;203288;51;0;0;0;0;.00nan;0;0
2336;2195;53;72;36;3;33;.917;3900000;0
2336;188888;51;78;30;3;27;.900;3900000;0
2336;169323;53;0;0;0;0;.00nan;0;0
2337;171970;55;0;0;0;0;.00nan;0;0
2337;194502;55;61;39;5;34;.872;3600000;0
2337;175658;36;14;11;5;6;.545;2195000;0
2337;192552;36;61;9;1;8;.889;1399000;0
2338;197940;49;71;26;2;24;.923;3600000;0
2338;201075;49;0;0;0;0;.00nan;0;0
2338;181102;48;95;47;3;44;.936;3576000;0
2338;142492;48;0;0;0;0;.00nan;0;0
2339;210998;44;0;0;0;0;.00nan;0;0
2339;64911;44;77;36;3;33;.917;3547000;0
2339;79132;4619;0;0;0;0;.00nan;0;0
2339;86228;4619;59;21;2;19;.905;3600000;0
2340;182049;46;59;37;5;32;.865;3544000;0
2340;218119;46;0;0;0;0;.00nan;0;0
2340;186495;47;47;24;4;20;.833;3600000;0
2340;58100;47;0;0;0;0;.00nan;0;0
2341;197940;49;0;0;0;0;.00nan;0;0
2341;201075;49;72;22;1;21;.955;3600000;0
2341;181102;48;67;46;5;41;.891;3600000;0
2341;142492;48;0;0;0;0;.00nan;0;0
2342;224943;60;0;0;0;0;.00nan;0;0
2342;170977;62;0;0;0;0;.00nan;0;0
2342;181341;60;74;20;1;19;.950;3600000;0
2342;186549;62;94;54;4;50;.926;3600000;0
2343;175658;36;0;0;0;0;.00nan;0;0
2343;185960;39;21;26;6;20;.769;3062000;0
2343;192552;36;65;43;5;38;.884;3600000;0
2343;197704;39;53;2;0;2;1.000;531000;0
2344;3359;43;71;20;1;19;.950;3600000;0
2344;173856;43;0;0;0;0;.00nan;0;0
2344;38124;58;44;4;1;3;.750;244000;0
2344;191026;58;76;52;5;47;.904;3356000;0
2345;203288;51;0;0;0;0;.00nan;0;0
2345;188888;51;60;14;1;13;.929;3600000;0
2345;178695;63;60;32;4;28;.875;3600000;0
2345;180873;63;0;0;0;0;.00nan;0;0
2346;163565;40;0;0;0;0;.00nan;0;0
2346;210998;44;57;36;5;31;.861;3600000;0
2346;185812;40;68;25;2;23;.920;3600000;0
2346;64911;44;0;0;0;0;.00nan;0;0
2347;4622;64;0;0;0;0;.00nan;0;0
2347;-1;45;0;0;0;0;.00nan;0;0
2347;184610;45;94;40;3;37;.925;3847000;0
2347;85661;64;78;31;2;29;.935;3847000;0
2348;205799;57;0;0;0;0;.00nan;0;0
2348;176921;38;29;31;6;25;.806;3060000;0
2348;-1;38;53;11;1;10;.909;540000;0
2348;152418;57;64;21;3;18;.857;3600000;0
2349;171970;55;0;0;0;0;.00nan;0;0
2349;194502;55;90;45;3;42;.933;3600000;0
2349;77955;56;0;0;0;0;.00nan;0;0
2349;85437;56;100;17;0;17;1.000;3600000;0
2350;182049;46;24;15;4;11;.733;2676000;0
2350;218119;46;24;12;4;8;.667;924000;0
2350;186495;47;66;35;4;31;.886;3600000;0
2350;58100;47;0;0;0;0;.00nan;0;0
2351;163565;40;100;34;1;33;.971;3900000;0
2351;170977;62;0;0;0;0;.00nan;0;0
2351;185812;40;0;0;0;0;.00nan;0;0
2351;186549;62;71;24;1;23;.958;3900000;0
2352;185960;39;68;39;4;35;.897;3550000;0
2352;197704;39;0;0;0;0;.00nan;0;0
2352;77955;56;0;0;0;0;.00nan;0;0
2352;85437;56;82;29;3;26;.897;3600000;0
2353;197940;49;35;20;4;16;.800;3561000;0
2353;201075;49;0;0;0;0;.00nan;0;0
2353;179950;4837;63;29;3;26;.897;3600000;0
2353;187295;4837;0;0;0;0;.00nan;0;0
2354;203288;51;70;32;3;29;.906;3900000;0
2354;165744;50;69;33;3;30;.909;3900000;0
2354;188888;51;0;0;0;0;.00nan;0;0
2354;75313;50;0;0;0;0;.00nan;0;0
2355;4622;64;0;0;0;0;.00nan;0;0
2355;-1;45;0;0;0;0;.00nan;0;0
2355;184610;45;82;50;4;46;.920;3600000;0
2355;85661;64;73;22;1;21;.955;3600000;0
2356;3359;43;0;0;0;0;.00nan;0;0
2356;173856;43;63;18;2;16;.889;3600000;0
2356;176921;38;87;45;3;42;.933;3570000;0
2356;-1;38;0;0;0;0;.00nan;0;0
2357;224943;60;0;0;0;0;.00nan;0;0
2357;205318;61;58;38;4;34;.895;3579000;0
2357;-1;61;0;0;0;0;.00nan;0;0
2357;181341;60;89;37;2;35;.946;3600000;0
2358;194893;54;75;32;3;29;.906;3567000;0
2358;189639;54;0;0;0;0;.00nan;0;0
2358;196372;37;0;0;0;0;.00nan;0;0
2358;202161;37;70;21;1;20;.952;3600000;0
2359;201673;4619;81;22;1;21;.955;3900000;0
2359;186495;47;93;44;1;43;.977;3900000;0
2359;58100;47;0;0;0;0;.00nan;0;0
2359;79132;4619;0;0;0;0;.00nan;0;0
2360;2195;53;42;21;4;17;.810;3596000;0
2360;184081;52;81;44;3;41;.932;3600000;0
2360;169323;53;0;0;0;0;.00nan;0;0
2360;91398;52;0;0;0;0;.00nan;0;0
2361;171970;55;87;42;3;39;.929;3600000;0
2361;194502;55;0;0;0;0;.00nan;0;0
2361;178695;63;0;0;0;0;.00nan;0;0
2361;180873;63;29;20;5;15;.750;3513000;0
2362;194264;41;67;15;1;14;.933;3600000;0
2362;175658;36;69;47;5;42;.894;3600000;0
2362;192552;36;0;0;0;0;.00nan;0;0
2362;192688;41;0;0;0;0;.00nan;0;0
2363;178789;65;66;36;4;32;.889;3600000;0
2363;205799;57;0;0;0;0;.00nan;0;0
2363;184770;65;0;0;0;0;.00nan;0;0
2363;152418;57;69;18;1;17;.944;3600000;0
2364;170977;62;100;39;0;39;1.000;3600000;0
2364;181102;48;89;37;2;35;.946;3600000;0
2364;186549;62;0;0;0;0;.00nan;0;0
2364;142492;48;0;0;0;0;.00nan;0;0
2365;185960;39;80;31;2;29;.935;3600000;0
2365;197704;39;0;0;0;0;.00nan;0;0
2365;77955;56;0;0;0;0;.00nan;0;0
2365;85437;56;51;38;5;33;.868;3600000;0
2366;203288;51;0;0;0;0;.00nan;0;0
2366;165744;50;57;11;1;10;.909;1125000;0
2366;188888;51;94;30;1;29;.967;3600000;0
2366;75313;50;37;37;6;31;.838;2475000;0
2367;-1;45;69;36;3;33;.917;3600000;0
2367;184610;45;0;0;0;0;.00nan;0;0
2367;196372;37;0;0;0;0;.00nan;0;0
2367;202161;37;44;26;4;22;.846;3579000;0
2368;224943;60;0;0;0;0;.00nan;0;0
2368;205318;61;0;0;0;0;.00nan;0;0
2368;-1;61;56;20;2;18;.900;3600000;0
2368;181341;60;68;33;3;30;.909;3573000;0
2369;178098;59;42;9;2;7;.778;3600000;0
2369;174407;59;0;0;0;0;.00nan;0;0
2369;175658;36;0;0;0;0;.00nan;0;0
2369;192552;36;60;58;8;50;.862;3600000;0
2370;194264;41;0;0;0;0;.00nan;0;0
2370;38124;58;0;0;0;0;.00nan;0;0
2370;191026;58;87;42;4;38;.905;3600000;0
2370;192688;41;78;30;2;28;.933;3600000;0
2371;189644;42;81;38;3;35;.921;3600000;0
2371;176060;42;0;0;0;0;.00nan;0;0
2371;182049;46;28;24;6;18;.750;3600000;0
2371;218119;46;0;0;0;0;.00nan;0;0
2372;163565;40;0;0;0;0;.00nan;0;0
2372;210998;44;0;0;0;0;.00nan;0;0
2372;185812;40;62;37;4;33;.892;3591000;0
2372;64911;44;78;31;2;29;.935;3600000;0
2373;3359;43;56;30;3;27;.900;3600000;0
2373;184081;52;0;0;0;0;.00nan;0;0
2373;173856;43;0;0;0;0;.00nan;0;0
2373;91398;52;81;40;4;36;.900;3600000;0
2374;171970;55;0;0;0;0;.00nan;0;0
2374;194502;55;65;24;2;22;.917;3533000;0
2374;178695;63;81;15;0;15;1.000;3600000;0
2374;180873;63;0;0;0;0;.00nan;0;0
2375;178789;65;0;0;0;0;.00nan;0;0
2375;205799;57;64;19;1;18;.947;3600000;0
2375;184770;65;73;31;2;29;.935;3588000;0
2375;152418;57;0;0;0;0;.00nan;0;0
2376;197940;49;96;24;0;24;1.000;3600000;0
2376;201075;49;0;0;0;0;.00nan;0;0
2376;179950;4837;81;40;3;37;.925;3600000;0
2376;187295;4837;0;0;0;0;.00nan;0;0
2377;178098;59;0;0;0;0;.00nan;0;0
2377;194264;41;64;35;4;31;.886;3563000;0
2377;174407;59;65;20;3;17;.850;3600000;0
2377;192688;41;0;0;0;0;.00nan;0;0
2378;189644;42;55;34;4;30;.882;3587000;0
2378;176060;42;0;0;0;0;.00nan;0;0
2378;182049;46;77;31;3;28;.903;3600000;0
2378;218119;46;0;0;0;0;.00nan;0;0
2379;4622;64;0;0;0;0;.00nan;0;0
2379;194893;54;85;35;2;33;.943;3593000;0
2379;189639;54;0;0;0;0;.00nan;0;0
2379;85661;64;99;20;0;20;1.000;3600000;0
2380;201673;4619;50;22;4;18;.818;3600000;0
2380;181102;48;65;17;1;16;.941;1162000;0
2380;79132;4619;0;0;0;0;.00nan;0;0
2380;142492;48;28;46;9;37;.804;2438000;0
2381;2195;53;59;19;2;17;.895;3600000;0
2381;169323;53;0;0;0;0;.00nan;0;0
2381;176921;38;46;42;6;36;.857;3600000;0
2381;-1;38;0;0;0;0;.00nan;0;0
2382;184081;52;73;20;1;19;.950;3600000;0
2382;38124;58;98;45;2;43;.956;3600000;0
2382;191026;58;0;0;0;0;.00nan;0;0
2382;91398;52;0;0;0;0;.00nan;0;0
2383;203288;51;0;0;0;0;.00nan;0;0
2383;188888;51;90;14;0;14;1.000;3600000;0
2383;-1;45;0;0;0;0;.00nan;0;0
2383;184610;45;73;56;6;50;.893;3600000;0
2384;224943;60;0;0;0;0;.00nan;0;0
2384;179950;4837;65;30;2;28;.933;3600000;0
2384;181341;60;99;34;1;33;.971;3600000;0
2384;187295;4837;0;0;0;0;.00nan;0;0
2385;205318;61;86;30;1;29;.967;3600000;0
2385;170977;62;58;45;6;39;.867;3600000;0
2385;-1;61;0;0;0;0;.00nan;0;0
2385;186549;62;0;0;0;0;.00nan;0;0
2386;171970;55;0;0;0;0;.00nan;0;0
2386;3359;43;0;0;0;0;.00nan;0;0
2386;194502;55;88;43;3;40;.930;3600000;0
2386;173856;43;60;17;2;15;.882;3600000;0
2387;194893;54;31;16;4;12;.750;1036000;0
2387;189639;54;59;23;2;21;.913;2564000;0
2387;189644;42;87;17;0;17;1.000;3600000;0
2387;176060;42;0;0;0;0;.00nan;0;0
2388;201673;4619;64;25;3;22;.880;3900000;0
2388;181102;48;95;47;3;44;.936;3900000;0
2388;79132;4619;0;0;0;0;.00nan;0;0
2388;142492;48;0;0;0;0;.00nan;0;0
2389;163565;40;75;40;4;36;.900;3521000;0
2389;185812;40;0;0;0;0;.00nan;0;0
2389;186495;47;64;20;2;18;.900;3600000;0
2389;85281;47;0;0;0;0;.00nan;0;0
2390;178695;63;67;40;4;36;.900;3600000;0
2390;180873;63;0;0;0;0;.00nan;0;0
2390;185960;39;77;24;1;23;.958;3600000;0
2390;197704;39;0;0;0;0;.00nan;0;0
2391;224943;60;72;32;2;30;.938;3900000;0
2391;179950;4837;0;0;0;0;.00nan;0;0
2391;181341;60;0;0;0;0;.00nan;0;0
2391;187295;4837;78;29;2;27;.931;3900000;0
2392;197940;49;69;15;1;14;.933;3600000;0
2392;170977;62;0;0;0;0;.00nan;0;0
2392;201075;49;0;0;0;0;.00nan;0;0
2392;186549;62;62;41;5;36;.878;3600000;0
2393;178098;59;75;21;1;20;.952;3600000;0
2393;205799;57;90;44;2;42;.955;3597000;0
2393;174407;59;0;0;0;0;.00nan;0;0
2393;85787;57;0;0;0;0;.00nan;0;0
2394;165744;50;60;21;2;19;.905;3548000;0
2394;-1;45;0;0;0;0;.00nan;0;0
2394;184610;45;100;37;1;36;.973;3600000;0
2394;75313;50;0;0;0;0;.00nan;0;0
2395;2195;53;67;18;1;17;.944;3600000;0
2395;169323;53;0;0;0;0;.00nan;0;0
2395;176921;38;86;42;2;40;.952;3555000;0
2395;-1;38;0;0;0;0;.00nan;0;0
2396;205318;61;50;34;5;29;.853;3600000;0
2396;-1;61;0;0;0;0;.00nan;0;0
2396;181102;48;51;26;4;22;.846;3600000;0
2396;142492;48;0;0;0;0;.00nan;0;0
2397;203288;51;0;0;0;0;.00nan;0;0
2397;3359;43;46;36;5;31;.861;3600000;0
2397;188888;51;75;39;3;36;.923;3600000;0
2397;173856;43;0;0;0;0;.00nan;0;0
2398;194264;41;93;15;0;15;1.000;3600000;0
2398;178789;65;41;42;7;35;.833;3600000;0
2398;184770;65;0;0;0;0;.00nan;0;0
2398;192688;41;0;0;0;0;.00nan;0;0
2399;171970;55;0;0;0;0;.00nan;0;0
2399;194502;55;78;38;3;35;.921;3547000;0
2399;77955;56;0;0;0;0;.00nan;0;0
2399;85437;56;65;27;2;25;.926;3600000;0
2400;163565;40;76;54;7;47;.870;3295000;0
2400;185812;40;24;5;3;2;.400;305000;0
2400;186495;47;71;18;1;17;.944;3600000;0
2400;85281;47;0;0;0;0;.00nan;0;0
2401;184081;52;0;0;0;0;.00nan;0;0
2401;38124;58;0;0;0;0;.00nan;0;0
2401;191026;58;79;41;4;37;.902;3639000;0
2401;91398;52;44;16;3;13;.813;3639000;0
2402;210998;44;99;40;1;39;.975;3600000;0
2402;182049;46;77;29;2;27;.931;3545000;0
2402;218119;46;0;0;0;0;.00nan;0;0
2402;64911;44;0;0;0;0;.00nan;0;0
2403;180873;63;0;0;0;0;.00nan;0;0
2403;86485;36;89;39;2;37;.949;3600000;0
2403;91391;36;0;0;0;0;.00nan;0;0
2403;152418;63;90;27;1;26;.963;3600000;0
2404;197940;49;0;0;0;0;.00nan;0;0
2404;170977;62;43;38;6;32;.842;1951000;0
2404;201075;49;72;22;1;21;.955;3600000;0
2404;186549;62;50;20;3;17;.850;1649000;0
2405;176921;38;75;39;3;36;.923;3578000;0
2405;-1;38;0;0;0;0;.00nan;0;0
2405;38124;58;95;35;1;34;.971;3600000;0
2405;191026;58;0;0;0;0;.00nan;0;0
2406;201673;4619;39;31;5;26;.839;3570000;0
2406;179950;4837;46;21;4;17;.810;2383000;0
2406;187295;4837;81;18;0;18;1.000;1217000;0
2406;79132;4619;0;0;0;0;.00nan;0;0
2407;178098;59;0;0;0;0;.00nan;0;0
2407;205799;57;85;43;3;40;.930;3600000;0
2407;174407;59;72;26;2;24;.923;3600000;0
2407;85787;57;0;0;0;0;.00nan;0;0
2408;165744;50;0;0;0;0;.00nan;0;0
2408;196372;37;41;11;2;9;.818;653000;0
2408;202161;37;32;30;6;24;.800;2947000;0
2408;75313;50;92;30;1;29;.967;3600000;0
2409;163565;40;0;0;0;0;.00nan;0;0
2409;224943;60;0;0;0;0;.00nan;0;0
2409;181341;60;72;19;1;18;.947;3600000;0
2409;185812;40;82;38;3;35;.921;3561000;0
2410;205318;61;0;0;0;0;.00nan;0;0
2410;-1;61;65;39;4;35;.897;3526000;0
2410;181102;48;0;0;0;0;.00nan;0;0
2410;142492;48;85;35;2;33;.943;3600000;0
2411;189644;42;42;22;4;18;.818;3600000;0
2411;175658;64;0;0;0;0;.00nan;0;0
2411;176060;42;0;0;0;0;.00nan;0;0
2411;85661;64;91;31;1;30;.968;3600000;0
2412;203288;51;100;24;0;24;1.000;3600000;0
2412;3359;43;0;0;0;0;.00nan;0;0
2412;188888;51;0;0;0;0;.00nan;0;0
2412;173856;43;65;33;3;30;.909;3600000;0
2413;194893;54;0;0;0;0;.00nan;0;0
2413;189639;54;72;29;2;27;.931;3575000;0
2413;-1;45;88;30;1;29;.967;3600000;0
2413;184610;45;0;0;0;0;.00nan;0;0
2414;184081;52;25;31;7;24;.774;3600000;0
2414;180873;63;0;0;0;0;.00nan;0;0
2414;91398;52;0;0;0;0;.00nan;0;0
2414;152418;63;95;22;0;22;1.000;3600000;0
2415;171970;55;51;50;6;44;.880;3600000;0
2415;194502;55;0;0;0;0;.00nan;0;0
2415;77955;56;0;0;0;0;.00nan;0;0
2415;85437;56;84;29;1;28;.966;3600000;0
2416;210998;44;0;0;0;0;.00nan;0;0
2416;182049;46;59;28;3;25;.893;3600000;0
2416;218119;46;0;0;0;0;.00nan;0;0
2416;64911;44;96;28;0;28;1.000;3600000;0
2417;185960;39;96;19;0;19;1.000;3600000;0
2417;197704;39;0;0;0;0;.00nan;0;0
2417;86485;36;0;0;0;0;.00nan;0;0
2417;91391;36;51;39;5;34;.872;3600000;0
2418;194264;41;0;0;0;0;.00nan;0;0
2418;178789;65;85;50;4;46;.920;3600000;0
2418;184770;65;0;0;0;0;.00nan;0;0
2418;192688;41;99;24;0;24;1.000;3600000;0
2419;194264;41;66;19;1;18;.947;3600000;0
2419;38124;58;0;0;0;0;.00nan;0;0
2419;191026;58;60;35;4;31;.886;3600000;0
2419;192688;41;0;0;0;0;.00nan;0;0
2420;201673;4619;37;25;4;21;.840;1946000;0
2420;179950;4837;0;0;0;0;.00nan;0;0
2420;187295;4837;60;25;3;22;.880;3600000;0
2420;79132;4619;79;17;0;17;1.000;1624000;0
2421;165744;50;88;29;1;28;.966;3600000;0
2421;194893;54;75;36;3;33;.917;3562000;0
2421;189639;54;0;0;0;0;.00nan;0;0
2421;75313;50;0;0;0;0;.00nan;0;0
2422;189644;42;70;39;4;35;.897;3562000;0
2422;175658;64;0;0;0;0;.00nan;0;0
2422;176060;42;0;0;0;0;.00nan;0;0
2422;85661;64;66;22;2;20;.909;3600000;0
2423;2195;53;0;0;0;0;.00nan;0;0
2423;184081;52;50;10;1;9;.900;1697000;0
2423;169323;53;100;37;2;35;.946;3600000;0
2423;91398;52;26;27;6;21;.778;1903000;0
2424;77955;56;57;30;3;27;.900;3578000;0
2424;85437;56;0;0;0;0;.00nan;0;0
2424;86485;36;0;0;0;0;.00nan;0;0
2424;91391;36;100;38;1;37;.974;3600000;0
2425;170977;62;0;0;0;0;.00nan;0;0
2425;181102;48;73;28;2;26;.929;3548000;0
2425;186549;62;100;38;1;37;.974;3600000;0
2425;142492;48;0;0;0;0;.00nan;0;0
2426;205799;57;45;16;3;13;.813;3600000;0
2426;176921;38;70;56;6;50;.893;2427000;0
2426;-1;38;50;8;1;7;.875;1173000;0
2426;85787;57;0;0;0;0;.00nan;0;0
2427;196372;37;0;0;0;0;.00nan;0;0
2427;202161;37;99;51;3;48;.941;3600000;0
2427;182049;46;65;37;4;33;.892;3576000;0
2427;218119;46;0;0;0;0;.00nan;0;0
2428;224943;60;0;0;0;0;.00nan;0;0
2428;205318;61;93;35;1;34;.971;3600000;0
2428;-1;61;0;0;0;0;.00nan;0;0
2428;181341;60;73;34;4;30;.882;3600000;0
2429;170977;62;80;41;3;38;.927;3600000;0
2429;181102;48;0;0;0;0;.00nan;0;0
2429;186549;62;0;0;0;0;.00nan;0;0
2429;142492;48;49;33;4;29;.879;3554000;0
2430;185960;39;74;24;2;22;.917;3600000;0
2430;197704;39;0;0;0;0;.00nan;0;0
2430;86485;36;88;27;1;26;.963;2682000;0
2430;91391;36;36;18;4;14;.778;918000;0
2431;205799;57;0;0;0;0;.00nan;0;0
2431;176921;38;64;47;6;41;.872;3349000;0
2431;-1;38;50;1;0;1;1.000;251000;0
2431;85787;57;98;25;0;25;1.000;3600000;0
2432;203288;51;100;36;1;35;.972;3600000;0
2432;188888;51;0;0;0;0;.00nan;0;0
2432;-1;45;0;0;0;0;.00nan;0;0
2432;184610;45;84;43;4;39;.907;3600000;0
2433;3359;43;69;5;0;5;1.000;3600000;0
2433;173856;43;0;0;0;0;.00nan;0;0
2433;38124;58;0;0;0;0;.00nan;0;0
2433;191026;58;44;39;6;33;.846;3600000;0
2434;194893;54;42;34;6;28;.824;3334000;0
2434;189639;54;39;1;1;0;.000;180000;0
2434;189644;42;41;29;5;24;.828;3600000;0
2434;176060;42;0;0;0;0;.00nan;0;0
2435;201673;4619;90;33;2;31;.939;3600000;0
2435;186495;47;87;46;3;43;.935;3593000;0
2435;79132;4619;0;0;0;0;.00nan;0;0
2435;85281;47;0;0;0;0;.00nan;0;0
2436;171970;55;0;0;0;0;.00nan;0;0
2436;194502;55;74;44;5;39;.886;3600000;0
2436;77955;56;0;0;0;0;.00nan;0;0
2436;85437;56;100;31;0;31;1.000;3600000;0
2437;196372;37;67;34;3;31;.912;3525000;0
2437;202161;37;0;0;0;0;.00nan;0;0
2437;182049;46;0;0;0;0;.00nan;0;0
2437;218119;46;93;28;1;27;.964;3600000;0
2438;224943;60;0;0;0;0;.00nan;0;0
2438;205318;61;0;0;0;0;.00nan;0;0
2438;-1;61;70;32;3;29;.906;3520000;0
2438;181341;60;62;14;1;13;.929;3600000;0
2439;194264;41;81;13;0;13;1.000;3600000;0
2439;178789;65;83;39;3;36;.923;3600000;0
2439;184770;65;0;0;0;0;.00nan;0;0
2439;192688;41;0;0;0;0;.00nan;0;0
2440;165744;50;73;22;2;20;.909;3600000;0
2440;189644;42;22;25;6;19;.760;3217000;0
2440;176060;42;41;2;1;1;.500;383000;0
2440;75313;50;0;0;0;0;.00nan;0;0
2441;203288;51;67;21;2;19;.905;3600000;0
2441;188888;51;0;0;0;0;.00nan;0;0
2441;178789;65;65;59;8;51;.864;3600000;0
2441;184770;65;0;0;0;0;.00nan;0;0
2442;197940;49;78;25;1;24;.960;3600000;0
2442;201075;49;0;0;0;0;.00nan;0;0
2442;179950;4837;0;0;0;0;.00nan;0;0
2442;187295;4837;88;54;3;51;.944;3600000;0
2443;-1;45;0;0;0;0;.00nan;0;0
2443;184610;45;88;48;2;46;.958;3580000;0
2443;175658;64;0;0;0;0;.00nan;0;0
2443;85661;64;85;15;0;15;1.000;3600000;0
2444;3359;43;76;6;0;6;1.000;3600000;0
2444;173856;43;0;0;0;0;.00nan;0;0
2444;38124;58;0;0;0;0;.00nan;0;0
2444;191026;58;98;62;3;59;.952;3600000;0
2445;163565;40;66;39;4;35;.897;3600000;0
2445;201673;4619;64;19;1;18;.947;3600000;0
2445;185812;40;0;0;0;0;.00nan;0;0
2445;79132;4619;0;0;0;0;.00nan;0;0
2446;2195;53;99;36;1;35;.972;3600000;0
2446;194264;41;75;30;4;26;.867;3600000;0
2446;169323;53;0;0;0;0;.00nan;0;0
2446;192688;41;0;0;0;0;.00nan;0;0
2447;180873;63;0;0;0;0;.00nan;0;0
2447;77955;56;0;0;0;0;.00nan;0;0
2447;85437;56;72;26;1;25;.962;3600000;0
2447;152418;63;33;24;5;19;.792;3600000;0
2448;194893;54;80;43;3;40;.930;3600000;0
2448;189639;54;0;0;0;0;.00nan;0;0
2448;186495;47;95;20;0;20;1.000;3600000;0
2448;85281;47;0;0;0;0;.00nan;0;0
2449;171970;55;68;27;2;25;.926;1725000;0
2449;194502;55;37;31;6;25;.806;1875000;0
2449;185960;39;72;19;1;18;.947;3600000;0
2449;197704;39;0;0;0;0;.00nan;0;0
2450;178098;59;36;17;4;13;.765;3534000;0
2450;174407;59;0;0;0;0;.00nan;0;0
2450;86485;36;97;40;2;38;.950;3600000;0
2450;91391;36;0;0;0;0;.00nan;0;0
2451;205318;61;88;28;1;27;.964;3600000;0
2451;-1;61;0;0;0;0;.00nan;0;0
2451;181102;48;57;31;4;27;.871;3574000;0
2451;142492;48;0;0;0;0;.00nan;0;0
2452;170977;62;61;4;0;4;1.000;746000;0
2452;201673;4619;77;28;2;26;.929;3600000;0
2452;186549;62;46;43;7;36;.837;2854000;0
2452;79132;4619;0;0;0;0;.00nan;0;0
2453;38124;58;65;48;6;42;.875;3600000;0
2453;185960;39;84;29;2;27;.931;3600000;0
2453;191026;58;0;0;0;0;.00nan;0;0
2453;197704;39;0;0;0;0;.00nan;0;0
2454;184081;52;87;25;1;24;.960;3600000;0
2454;205799;57;0;0;0;0;.00nan;0;0
2454;85787;57;58;30;3;27;.900;3563000;0
2454;91398;52;0;0;0;0;.00nan;0;0
2455;165744;50;0;0;0;0;.00nan;0;0
2455;189644;42;37;35;6;29;.829;2782000;0
2455;176060;42;65;9;0;9;1.000;818000;0
2455;75313;50;65;30;3;27;.900;3600000;0
2456;203288;51;0;0;0;0;.00nan;0;0
2456;188888;51;73;19;1;18;.947;3600000;0
2456;178789;65;58;42;6;36;.857;3234000;0
2456;184770;65;53;3;0;3;1.000;366000;0
2457;197940;49;0;0;0;0;.00nan;0;0
2457;201075;49;86;30;2;28;.933;3600000;0
2457;179950;4837;75;22;1;21;.955;3600000;0
2457;187295;4837;0;0;0;0;.00nan;0;0
2458;-1;45;67;38;4;34;.895;3600000;0
2458;184610;45;0;0;0;0;.00nan;0;0
2458;175658;64;0;0;0;0;.00nan;0;0
2458;85661;64;62;22;2;20;.909;3600000;0
2459;176921;38;0;0;0;0;.00nan;0;0
2459;-1;38;66;28;3;25;.893;3900000;0
2459;86485;36;0;0;0;0;.00nan;0;0
2459;91391;36;49;26;3;23;.885;3900000;0
2460;171970;55;65;55;6;49;.891;3600000;0
2460;178098;59;0;0;0;0;.00nan;0;0
2460;194502;55;0;0;0;0;.00nan;0;0
2460;174407;59;77;11;0;11;1.000;3600000;0
2461;2195;53;0;0;0;0;.00nan;0;0
2461;194264;41;0;0;0;0;.00nan;0;0
2461;169323;53;80;33;2;31;.939;3900000;0
2461;192688;41;88;32;2;30;.938;3900000;0
2462;210998;44;59;7;0;7;1.000;900000;0
2462;196372;37;0;0;0;0;.00nan;0;0
2462;202161;37;93;20;0;20;1.000;3600000;0
2462;64911;44;25;34;7;27;.794;2700000;0
2463;194893;54;36;9;2;7;.778;853000;0
2463;189639;54;38;33;6;27;.818;2747000;0
2463;186495;47;76;23;1;22;.957;3600000;0
2463;85281;47;0;0;0;0;.00nan;0;0
2464;180873;63;0;0;0;0;.00nan;0;0
2464;77955;56;0;0;0;0;.00nan;0;0
2464;85437;56;76;36;3;33;.917;3600000;0
2464;152418;63;58;24;2;22;.917;3600000;0
2465;224943;60;0;0;0;0;.00nan;0;0
2465;181341;60;90;29;1;28;.966;3600000;0
2465;182049;46;68;32;3;29;.906;3548000;0
2465;218119;46;0;0;0;0;.00nan;0;0
2466;205318;61;0;0;0;0;.00nan;0;0
2466;-1;61;62;35;5;30;.857;3600000;0
2466;181102;48;0;0;0;0;.00nan;0;0
2466;142492;48;77;16;1;15;.938;3600000;0
2467;184081;52;62;30;3;27;.900;3527000;0
2467;205799;57;96;34;1;33;.971;3600000;0
2467;85787;57;0;0;0;0;.00nan;0;0
2467;91398;52;0;0;0;0;.00nan;0;0
2468;165744;50;99;22;0;22;1.000;3600000;0
2468;175658;64;80;26;1;25;.962;3559000;0
2468;75313;50;0;0;0;0;.00nan;0;0
2468;85661;64;0;0;0;0;.00nan;0;0
2469;178098;59;53;9;1;8;.889;3600000;0
2469;174407;59;0;0;0;0;.00nan;0;0
2469;176921;38;84;69;6;63;.913;3335000;0
2469;-1;38;54;5;0;5;1.000;265000;0
2470;210998;44;78;40;4;36;.900;3600000;0
2470;196372;37;0;0;0;0;.00nan;0;0
2470;202161;37;85;29;1;28;.966;3600000;0
2470;64911;44;0;0;0;0;.00nan;0;0
2471;3359;43;48;19;3;16;.842;3600000;0
2471;173856;43;0;0;0;0;.00nan;0;0
2471;180873;63;0;0;0;0;.00nan;0;0
2471;152418;63;39;21;4;17;.810;3600000;0
2472;224943;60;0;0;0;0;.00nan;0;0
2472;181341;60;84;39;2;37;.949;3547000;0
2472;182049;46;88;26;1;25;.962;3600000;0
2472;218119;46;0;0;0;0;.00nan;0;0
2473;170977;62;0;0;0;0;.00nan;0;0
2473;179950;4837;0;0;0;0;.00nan;0;0
2473;186549;62;72;39;5;34;.872;3600000;0
2473;187295;4837;64;28;2;26;.929;3600000;0
2474;197940;49;86;15;0;15;1.000;3600000;0
2474;194893;54;44;46;7;39;.848;3600000;0
2474;189639;54;0;0;0;0;.00nan;0;0
2474;201075;49;0;0;0;0;.00nan;0;0
2475;189644;42;84;30;1;29;.967;3600000;0
2475;-1;45;0;0;0;0;.00nan;0;0
2475;184610;45;85;35;2;33;.943;3552000;0
2475;176060;42;0;0;0;0;.00nan;0;0
2476;170977;62;70;44;4;40;.909;3540000;0
2476;179950;4837;63;23;2;21;.913;3600000;0
2476;186549;62;0;0;0;0;.00nan;0;0
2476;187295;4837;0;0;0;0;.00nan;0;0
2477;163565;40;81;40;4;36;.900;3540000;0
2477;182049;46;51;18;2;16;.889;3600000;0
2477;218119;46;0;0;0;0;.00nan;0;0
2477;185812;40;0;0;0;0;.00nan;0;0
2478;197940;49;80;14;0;14;1.000;3600000;0
2478;194893;54;69;41;4;37;.902;3600000;0
2478;189639;54;0;0;0;0;.00nan;0;0
2478;201075;49;0;0;0;0;.00nan;0;0
2479;194264;41;0;0;0;0;.00nan;0;0
2479;184081;52;0;0;0;0;.00nan;0;0
2479;192688;41;60;11;1;10;.909;3600000;0
2479;91398;52;66;32;3;29;.906;3557000;0
2480;189644;42;0;0;0;0;.00nan;0;0
2480;-1;45;57;42;6;36;.857;3600000;0
2480;184610;45;0;0;0;0;.00nan;0;0
2480;176060;42;68;28;2;26;.929;3600000;0
2481;224943;60;48;8;1;7;.875;1335000;0
2481;201673;4619;58;30;3;27;.900;3600000;0
2481;181341;60;35;19;4;15;.789;2199000;0
2481;79132;4619;0;0;0;0;.00nan;0;0
2482;176921;38;69;35;4;31;.886;3600000;0
2482;-1;38;0;0;0;0;.00nan;0;0
2482;77955;56;0;0;0;0;.00nan;0;0
2482;85437;56;52;22;3;19;.864;3600000;0
2483;165744;50;66;33;3;30;.909;3600000;0
2483;196372;37;0;0;0;0;.00nan;0;0
2483;202161;37;66;41;4;37;.902;3561000;0
2483;75313;50;0;0;0;0;.00nan;0;0
2484;210998;44;0;0;0;0;.00nan;0;0
2484;186495;47;79;25;1;24;.960;3600000;0
2484;64911;44;79;46;5;41;.891;3600000;0
2484;85281;47;0;0;0;0;.00nan;0;0
2485;203288;51;0;0;0;0;.00nan;0;0
2485;178098;59;92;16;0;16;1.000;3600000;0
2485;188888;51;73;31;2;29;.935;3583000;0
2485;174407;59;0;0;0;0;.00nan;0;0
2486;163565;40;78;37;3;34;.919;3693000;0
2486;170977;62;0;0;0;0;.00nan;0;0
2486;185812;40;0;0;0;0;.00nan;0;0
2486;186549;62;62;28;4;24;.857;3693000;0
2487;3359;43;98;43;3;40;.930;3547000;0
2487;173856;43;0;0;0;0;.00nan;0;0
2487;185960;39;58;18;2;16;.889;3600000;0
2487;197704;39;0;0;0;0;.00nan;0;0
2488;165744;50;50;40;5;35;.875;3900000;0
2488;175658;64;0;0;0;0;.00nan;0;0
2488;75313;50;0;0;0;0;.00nan;0;0
2488;85661;64;62;42;5;37;.881;3900000;0
2489;201673;4619;79;31;2;29;.935;3900000;0
2489;179950;4837;0;0;0;0;.00nan;0;0
2489;187295;4837;100;40;2;38;.950;3900000;0
2489;79132;4619;0;0;0;0;.00nan;0;0
2490;180873;63;0;0;0;0;.00nan;0;0
2490;77955;56;0;0;0;0;.00nan;0;0
2490;85437;56;51;33;4;29;.879;3600000;0
2490;152418;63;82;29;1;28;.966;3600000;0
2491;182049;46;41;36;7;29;.806;3600000;0
2491;218119;46;0;0;0;0;.00nan;0;0
2491;186495;47;66;34;4;30;.882;3600000;0
2491;85281;47;0;0;0;0;.00nan;0;0
2492;184081;52;83;28;1;27;.964;3600000;0
2492;205799;57;55;28;4;24;.857;3600000;0
2492;85787;57;0;0;0;0;.00nan;0;0
2492;91398;52;0;0;0;0;.00nan;0;0
2493;171970;55;83;26;1;25;.962;3600000;0
2493;194502;55;0;0;0;0;.00nan;0;0
2493;178789;65;75;34;2;32;.941;3542000;0
2493;184770;65;0;0;0;0;.00nan;0;0
2494;38124;58;0;0;0;0;.00nan;0;0
2494;191026;58;99;41;1;40;.976;3600000;0
2494;86485;36;63;21;3;18;.857;3579000;0
2494;91391;36;0;0;0;0;.00nan;0;0
2495;3359;43;0;0;0;0;.00nan;0;0
2495;173856;43;69;24;2;22;.917;3600000;0
2495;185960;39;63;27;3;24;.889;3600000;0
2495;197704;39;0;0;0;0;.00nan;0;0
2496;203288;51;97;35;1;34;.971;3600000;0
2496;178098;59;40;29;5;24;.828;3600000;0
2496;188888;51;0;0;0;0;.00nan;0;0
2496;174407;59;0;0;0;0;.00nan;0;0
2497;163565;40;0;0;0;0;.00nan;0;0
2497;182049;46;71;18;1;17;.944;3600000;0
2497;218119;46;0;0;0;0;.00nan;0;0
2497;185812;40;93;51;3;48;.941;3576000;0
2498;165744;50;71;22;2;20;.909;3900000;0
2498;175658;64;0;0;0;0;.00nan;0;0
2498;75313;50;0;0;0;0;.00nan;0;0
2498;85661;64;74;30;2;28;.933;3900000;0
2499;194264;41;0;0;0;0;.00nan;0;0
2499;38124;58;29;34;6;28;.824;2875000;0
2499;191026;58;53;8;1;7;.875;725000;0
2499;192688;41;29;14;4;10;.714;3600000;0
2500;189644;42;85;29;1;28;.966;3600000;0
2500;176060;42;0;0;0;0;.00nan;0;0
2500;181102;48;77;46;5;41;.891;3600000;0
2500;142492;48;0;0;0;0;.00nan;0;0
2501;205318;61;99;45;2;43;.956;3600000;0
2501;194893;54;67;30;3;27;.900;3543000;0
2501;189639;54;0;0;0;0;.00nan;0;0
2501;-1;61;0;0;0;0;.00nan;0;0
2502;2195;53;80;17;1;16;.941;3600000;0
2502;169323;53;0;0;0;0;.00nan;0;0
2502;205799;57;0;0;0;0;.00nan;0;0
2502;85787;57;65;42;5;37;.881;3600000;0
2503;-1;45;58;29;3;26;.897;3900000;0
2503;184610;45;0;0;0;0;.00nan;0;0
2503;196372;37;0;0;0;0;.00nan;0;0
2503;202161;37;60;24;3;21;.875;3900000;0
2504;224943;60;0;0;0;0;.00nan;0;0
2504;210998;44;100;41;2;39;.951;3600000;0
2504;181341;60;49;20;3;17;.850;3549000;0
2504;64911;44;0;0;0;0;.00nan;0;0
2505;171970;55;0;0;0;0;.00nan;0;0
2505;194502;55;74;28;2;26;.929;3600000;0
2505;184081;52;56;13;1;12;.923;1232000;0
2505;91398;52;32;17;4;13;.765;2368000;0
2506;176921;38;71;31;3;28;.903;3542000;0
2506;-1;38;0;0;0;0;.00nan;0;0
2506;180873;63;0;0;0;0;.00nan;0;0
2506;152418;63;72;26;1;25;.962;3600000;0
2507;178789;65;0;0;0;0;.00nan;0;0
2507;184770;65;43;43;7;36;.837;3600000;0
2507;86485;36;0;0;0;0;.00nan;0;0
2507;91391;36;51;22;3;19;.864;3600000;0
2508;176921;38;50;10;1;9;.900;816000;0
2508;-1;38;38;40;7;33;.825;2784000;0
2508;185960;39;93;16;0;16;1.000;3600000;0
2508;197704;39;0;0;0;0;.00nan;0;0
2509;194264;41;0;0;0;0;.00nan;0;0
2509;178789;65;77;40;3;37;.925;3600000;0
2509;184770;65;0;0;0;0;.00nan;0;0
2509;192688;41;78;15;0;15;1.000;3600000;0
2510;189644;42;64;18;1;17;.944;3600000;0
2510;176060;42;0;0;0;0;.00nan;0;0
2510;181102;48;0;0;0;0;.00nan;0;0
2510;142492;48;80;50;5;45;.900;3600000;0
2511;205318;61;0;0;0;0;.00nan;0;0
2511;194893;54;0;0;0;0;.00nan;0;0
2511;189639;54;81;28;1;27;.964;3600000;0
2511;-1;61;61;32;3;29;.906;3556000;0
2512;170977;62;64;18;1;17;.944;1151000;0
2512;201673;4619;82;13;0;13;1.000;3600000;0
2512;186549;62;55;40;6;34;.850;2449000;0
2512;79132;4619;0;0;0;0;.00nan;0;0
2513;2195;53;0;0;0;0;.00nan;0;0
2513;171970;55;84;47;3;44;.936;3600000;0
2513;194502;55;0;0;0;0;.00nan;0;0
2513;169323;53;45;23;4;19;.826;3545000;0
2514;77955;56;0;0;0;0;.00nan;0;0
2514;85437;56;63;27;3;24;.889;3578000;0
2514;86485;36;72;29;2;27;.931;3600000;0
2514;91391;36;0;0;0;0;.00nan;0;0
2515;179950;4837;0;0;0;0;.00nan;0;0
2515;186495;47;71;43;5;38;.884;3600000;0
2515;187295;4837;76;26;2;24;.923;3600000;0
2515;85281;47;0;0;0;0;.00nan;0;0
2516;224943;60;0;0;0;0;.00nan;0;0
2516;210998;44;0;0;0;0;.00nan;0;0
2516;181341;60;43;36;6;30;.833;3600000;0
2516;64911;44;87;40;2;38;.950;3600000;0
2517;3359;43;46;26;4;22;.846;3600000;0
2517;173856;43;0;0;0;0;.00nan;0;0
2517;180873;63;0;0;0;0;.00nan;0;0
2517;152418;63;89;29;1;28;.966;3600000;0
2518;163565;40;64;45;5;40;.889;3561000;0
2518;179950;4837;0;0;0;0;.00nan;0;0
2518;185812;40;0;0;0;0;.00nan;0;0
2518;187295;4837;70;27;3;24;.889;3600000;0
2519;2195;53;52;33;5;28;.848;3600000;0
2519;178098;59;0;0;0;0;.00nan;0;0
2519;169323;53;0;0;0;0;.00nan;0;0
2519;174407;59;74;17;1;16;.941;3600000;0
2520;194893;54;32;35;6;29;.829;3600000;0
2520;189639;54;0;0;0;0;.00nan;0;0
2520;175658;64;0;0;0;0;.00nan;0;0
2520;85661;64;60;12;1;11;.917;3600000;0
2521;163565;40;0;0;0;0;.00nan;0;0
2521;179950;4837;0;0;0;0;.00nan;0;0
2521;185812;40;72;54;5;49;.907;3600000;0
2521;187295;4837;47;13;2;11;.846;3600000;0
2522;165744;50;35;22;5;17;.773;3600000;0
2522;196372;37;0;0;0;0;.00nan;0;0
2522;202161;37;100;45;2;43;.956;3600000;0
2522;75313;50;0;0;0;0;.00nan;0;0
2523;203288;51;59;20;3;17;.850;3545000;0
2523;188888;51;0;0;0;0;.00nan;0;0
2523;-1;45;0;0;0;0;.00nan;0;0
2523;184610;45;68;26;2;24;.923;3600000;0
2524;205799;57;63;21;2;19;.905;3600000;0
2524;176921;38;81;52;4;48;.923;3575000;0
2524;-1;38;0;0;0;0;.00nan;0;0
2524;85787;57;0;0;0;0;.00nan;0;0
2525;189644;42;63;27;2;25;.926;3854000;0
2525;176060;42;0;0;0;0;.00nan;0;0
2525;180873;63;0;0;0;0;.00nan;0;0
2525;152418;63;100;37;1;36;.973;3854000;0
2526;210998;44;65;29;3;26;.897;3600000;0
2526;201673;4619;93;21;0;21;1.000;3600000;0
2526;64911;44;0;0;0;0;.00nan;0;0
2526;79132;4619;0;0;0;0;.00nan;0;0
2527;171970;55;0;0;0;0;.00nan;0;0
2527;194502;55;85;32;2;30;.938;3600000;0
2527;77955;56;0;0;0;0;.00nan;0;0
2527;85437;56;36;20;4;16;.800;3582000;0
2528;3359;43;75;9;0;9;1.000;3600000;0
2528;173856;43;0;0;0;0;.00nan;0;0
2528;86485;36;0;0;0;0;.00nan;0;0
2528;91391;36;92;63;3;60;.952;3600000;0
2529;205799;57;95;34;1;33;.971;3600000;0
2529;38124;58;0;0;0;0;.00nan;0;0
2529;191026;58;77;29;3;26;.897;3566000;0
2529;85787;57;0;0;0;0;.00nan;0;0
2530;210998;44;0;0;0;0;.00nan;0;0
2530;179950;4837;0;0;0;0;.00nan;0;0
2530;187295;4837;86;35;2;33;.943;3600000;0
2530;64911;44;58;47;6;41;.872;3600000;0
2531;165744;50;92;31;1;30;.968;3600000;0
2531;-1;45;0;0;0;0;.00nan;0;0
2531;184610;45;86;49;3;46;.939;3600000;0
2531;75313;50;0;0;0;0;.00nan;0;0
2532;197940;49;62;27;3;24;.889;3600000;0
2532;201075;49;0;0;0;0;.00nan;0;0
2532;181102;48;54;37;5;32;.865;3584000;0
2532;142492;48;0;0;0;0;.00nan;0;0
2533;184081;52;66;18;2;16;.889;3600000;0
2533;176921;38;44;42;6;36;.857;3600000;0
2533;-1;38;0;0;0;0;.00nan;0;0
2533;91398;52;0;0;0;0;.00nan;0;0
2534;205318;61;99;45;2;43;.956;3600000;0
2534;170977;62;0;0;0;0;.00nan;0;0
2534;-1;61;0;0;0;0;.00nan;0;0
2534;186549;62;67;44;5;39;.886;3600000;0
2535;3359;43;97;38;1;37;.974;3600000;0
2535;173856;43;0;0;0;0;.00nan;0;0
2535;185960;39;47;40;6;34;.850;3600000;0
2535;197704;39;0;0;0;0;.00nan;0;0
2536;189644;42;66;30;2;28;.933;3600000;0
2536;176060;42;0;0;0;0;.00nan;0;0
2536;180873;63;0;0;0;0;.00nan;0;0
2536;152418;63;53;29;4;25;.862;3592000;0
2537;194893;54;70;45;5;40;.889;3600000;0
2537;189639;54;0;0;0;0;.00nan;0;0
2537;196372;37;0;0;0;0;.00nan;0;0
2537;202161;37;49;12;2;10;.833;3600000;0
2538;171970;55;80;42;3;39;.929;3577000;0
2538;194264;41;0;0;0;0;.00nan;0;0
2538;194502;55;0;0;0;0;.00nan;0;0
2538;192688;41;60;15;2;13;.867;3600000;0
2539;175658;64;0;0;0;0;.00nan;0;0
2539;182049;46;67;33;3;30;.909;3573000;0
2539;218119;46;0;0;0;0;.00nan;0;0
2539;85661;64;72;29;2;27;.931;3600000;0
2540;224943;60;0;0;0;0;.00nan;0;0
2540;181341;60;65;32;3;29;.906;3600000;0
2540;186495;47;76;25;2;23;.920;3600000;0
2540;85281;47;0;0;0;0;.00nan;0;0
2541;2195;53;60;18;2;16;.889;3698000;0
2541;169323;53;0;0;0;0;.00nan;0;0
2541;86485;36;0;0;0;0;.00nan;0;0
2541;91391;36;94;53;3;50;.943;3698000;0
2542;205799;57;0;0;0;0;.00nan;0;0
2542;38124;58;51;29;4;25;.862;3600000;0
2542;191026;58;0;0;0;0;.00nan;0;0
2542;85787;57;60;22;3;19;.864;3600000;0
2543;165744;50;0;0;0;0;.00nan;0;0
2543;196372;37;0;0;0;0;.00nan;0;0
2543;202161;37;98;45;2;43;.956;3562000;0
2543;75313;50;100;31;0;31;1.000;3600000;0
2544;203288;51;72;32;3;29;.906;3600000;0
2544;188888;51;0;0;0;0;.00nan;0;0
2544;77955;56;0;0;0;0;.00nan;0;0
2544;85437;56;53;39;5;34;.872;3586000;0
2545;197940;49;0;0;0;0;.00nan;0;0
2545;201075;49;75;22;2;20;.909;3600000;0
2545;181102;48;98;61;5;56;.918;3600000;0
2545;142492;48;0;0;0;0;.00nan;0;0
2546;178098;59;91;15;0;15;1.000;3600000;0
2546;174407;59;0;0;0;0;.00nan;0;0
2546;176921;38;0;0;0;0;.00nan;0;0
2546;-1;38;96;45;1;44;.978;3600000;0
2547;163565;40;47;28;5;23;.821;3600000;0
2547;205318;61;99;38;2;36;.947;3600000;0
2547;-1;61;0;0;0;0;.00nan;0;0
2547;185812;40;0;0;0;0;.00nan;0;0
2548;3359;43;0;0;0;0;.00nan;0;0
2548;173856;43;76;19;1;18;.947;3600000;0
2548;185960;39;82;43;3;40;.930;3582000;0
2548;197704;39;0;0;0;0;.00nan;0;0
2549;194893;54;74;39;3;36;.923;3600000;0
2549;189639;54;0;0;0;0;.00nan;0;0
2549;-1;45;52;26;4;22;.846;3544000;0
2549;184610;45;0;0;0;0;.00nan;0;0
2550;170977;62;57;35;5;30;.857;3600000;0
2550;201673;4619;81;31;2;29;.935;3600000;0
2550;186549;62;0;0;0;0;.00nan;0;0
2550;79132;4619;0;0;0;0;.00nan;0;0
2551;2195;53;0;0;0;0;.00nan;0;0
2551;171970;55;0;0;0;0;.00nan;0;0
2551;194502;55;69;36;4;32;.889;3574000;0
2551;169323;53;48;22;3;19;.864;3600000;0
2552;175658;64;0;0;0;0;.00nan;0;0
2552;182049;46;0;0;0;0;.00nan;0;0
2552;218119;46;73;32;2;30;.938;3600000;0
2552;85661;64;54;31;4;27;.871;3558000;0
2553;224943;60;0;0;0;0;.00nan;0;0
2553;181341;60;70;38;3;35;.921;3579000;0
2553;186495;47;68;22;2;20;.909;3600000;0
2553;85281;47;0;0;0;0;.00nan;0;0
2554;184081;52;0;0;0;0;.00nan;0;0
2554;86485;36;15;21;6;15;.714;2026000;0
2554;91391;36;40;14;3;11;.786;1574000;0
2554;91398;52;31;20;5;15;.750;3600000;0
2555;194264;41;81;28;2;26;.929;3600000;0
2555;178789;65;61;32;3;29;.906;3571000;0
2555;184770;65;0;0;0;0;.00nan;0;0
2555;192688;41;0;0;0;0;.00nan;0;0
2556;210998;44;43;28;4;24;.857;3549000;0
2556;179950;4837;0;0;0;0;.00nan;0;0
2556;187295;4837;59;26;3;23;.885;3600000;0
2556;64911;44;0;0;0;0;.00nan;0;0
2557;189644;42;89;18;0;18;1.000;3600000;0
2557;176060;42;0;0;0;0;.00nan;0;0
2557;181102;48;77;33;3;30;.909;3600000;0
2557;142492;48;0;0;0;0;.00nan;0;0
2558;38124;58;0;0;0;0;.00nan;0;0
2558;191026;58;61;28;3;25;.893;3567000;0
2558;86485;36;0;0;0;0;.00nan;0;0
2558;91391;36;76;28;2;26;.929;3600000;0
2559;178098;59;96;18;0;18;1.000;3600000;0
2559;194264;41;76;38;3;35;.921;3600000;0
2559;174407;59;0;0;0;0;.00nan;0;0
2559;192688;41;0;0;0;0;.00nan;0;0
2560;194893;54;84;41;3;38;.927;3600000;0
2560;189639;54;0;0;0;0;.00nan;0;0
2560;196372;37;81;13;0;13;1.000;3600000;0
2560;202161;37;0;0;0;0;.00nan;0;0
2561;197940;49;49;31;4;27;.871;3600000;0
2561;201075;49;0;0;0;0;.00nan;0;0
2561;182049;46;93;41;1;40;.976;3600000;0
2561;218119;46;0;0;0;0;.00nan;0;0
2562;189644;42;89;38;3;35;.921;3900000;0
2562;176060;42;0;0;0;0;.00nan;0;0
2562;181102;48;0;0;0;0;.00nan;0;0
2562;142492;48;89;42;3;39;.929;3900000;0
2563;224943;60;0;0;0;0;.00nan;0;0
2563;170977;62;22;12;4;8;.667;717000;0
2563;181341;60;94;46;3;43;.935;3600000;0
2563;186549;62;66;26;2;24;.923;2883000;0
2564;165744;50;0;0;0;0;.00nan;0;0
2564;-1;45;0;0;0;0;.00nan;0;0
2564;184610;45;91;47;3;44;.936;3526000;0
2564;75313;50;71;18;1;17;.944;3600000;0
2565;176921;38;72;17;1;16;.941;3600000;0
2565;-1;38;0;0;0;0;.00nan;0;0
2565;38124;58;51;44;6;38;.864;3233000;0
2565;191026;58;56;4;0;4;1.000;367000;0
2566;205318;61;58;30;3;27;.900;3596000;0
2566;-1;61;0;0;0;0;.00nan;0;0
2566;201673;4619;67;28;2;26;.929;3600000;0
2566;79132;4619;0;0;0;0;.00nan;0;0
2567;203288;51;97;44;2;42;.955;3550000;0
2567;188888;51;0;0;0;0;.00nan;0;0
2567;77955;56;0;0;0;0;.00nan;0;0
2567;85437;56;74;21;1;20;.952;3600000;0
2568;210998;44;51;2;0;2;1.000;622000;0
2568;186495;47;86;37;3;34;.919;3600000;0
2568;64911;44;18;29;7;22;.759;2978000;0
2568;85281;47;0;0;0;0;.00nan;0;0
2569;197940;49;63;33;4;29;.879;3600000;0
2569;201075;49;0;0;0;0;.00nan;0;0
2569;182049;46;99;33;1;32;.970;3600000;0
2569;218119;46;0;0;0;0;.00nan;0;0
2570;184081;52;69;33;3;30;.909;3545000;0
2570;180873;63;0;0;0;0;.00nan;0;0
2570;91398;52;0;0;0;0;.00nan;0;0
2570;152418;63;74;25;1;24;.960;3600000;0
2571;163565;40;65;20;2;18;.900;3600000;0
2571;210998;44;76;20;1;19;.950;3600000;0
2571;185812;40;0;0;0;0;.00nan;0;0
2571;64911;44;0;0;0;0;.00nan;0;0
2572;170977;62;63;27;3;24;.889;3581000;0
2572;179950;4837;0;0;0;0;.00nan;0;0
2572;186549;62;0;0;0;0;.00nan;0;0
2572;187295;4837;89;31;2;29;.935;3600000;0
2573;184081;52;100;27;0;27;1.000;3600000;0
2573;185960;39;86;32;2;30;.938;3576000;0
2573;197704;39;0;0;0;0;.00nan;0;0
2573;91398;52;0;0;0;0;.00nan;0;0
2574;-1;45;76;44;4;40;.909;3600000;0
2574;184610;45;0;0;0;0;.00nan;0;0
2574;196372;37;92;17;0;17;1.000;3600000;0
2574;202161;37;0;0;0;0;.00nan;0;0
2575;178098;59;76;27;2;25;.926;3900000;0
2575;174407;59;0;0;0;0;.00nan;0;0
2575;175658;64;0;0;0;0;.00nan;0;0
2575;85661;64;80;31;2;29;.935;3900000;0
2576;171970;55;50;48;8;40;.833;3178000;0
2576;3359;43;63;10;1;9;.900;3600000;0
2576;194502;55;51;2;0;2;1.000;422000;0
2576;173856;43;0;0;0;0;.00nan;0;0
2577;2195;53;62;29;3;26;.897;3600000;0
2577;194264;41;41;34;6;28;.824;3600000;0
2577;169323;53;0;0;0;0;.00nan;0;0
2577;192688;41;0;0;0;0;.00nan;0;0
2578;203288;51;63;14;1;13;.929;3600000;0
2578;188888;51;0;0;0;0;.00nan;0;0
2578;178789;65;47;54;8;46;.852;3600000;0
2578;184770;65;0;0;0;0;.00nan;0;0
2579;163565;40;75;40;3;37;.925;3600000;0
2579;181102;48;100;33;0;33;1.000;3600000;0
2579;185812;40;0;0;0;0;.00nan;0;0
2579;142492;48;0;0;0;0;.00nan;0;0
2580;170977;62;55;4;0;4;1.000;694000;0
2580;179950;4837;0;0;0;0;.00nan;0;0
2580;186549;62;13;38;8;30;.789;2906000;0
2580;187295;4837;62;19;2;17;.895;3600000;0
2581;171970;55;0;0;0;0;.00nan;0;0
2581;194502;55;86;41;2;39;.951;3600000;0
2581;185960;39;67;21;1;20;.952;3600000;0
2581;197704;39;0;0;0;0;.00nan;0;0
2582;178789;65;0;0;0;0;.00nan;0;0
2582;184770;65;87;34;2;32;.941;3600000;0
2582;38124;58;0;0;0;0;.00nan;0;0
2582;191026;58;70;39;4;35;.897;3528000;0
2583;205799;57;75;23;2;21;.913;3600000;0
2583;176921;38;53;35;4;31;.886;3600000;0
2583;-1;38;0;0;0;0;.00nan;0;0
2583;85787;57;0;0;0;0;.00nan;0;0
2584;197940;49;81;26;2;24;.923;3600000;0
2584;205318;61;93;46;4;42;.913;3562000;0
2584;-1;61;0;0;0;0;.00nan;0;0
2584;201075;49;0;0;0;0;.00nan;0;0
2585;178098;59;0;0;0;0;.00nan;0;0
2585;174407;59;55;27;3;24;.889;3600000;0
2585;175658;64;51;28;4;24;.857;3562000;0
2585;85661;64;0;0;0;0;.00nan;0;0
2586;3359;43;0;0;0;0;.00nan;0;0
2586;184081;52;72;37;3;34;.919;3600000;0
2586;173856;43;71;39;4;35;.897;3600000;0
2586;91398;52;0;0;0;0;.00nan;0;0
2587;203288;51;0;0;0;0;.00nan;0;0
2587;188888;51;86;36;3;33;.917;3600000;0
2587;194264;41;0;0;0;0;.00nan;0;0
2587;192688;41;61;38;4;34;.895;3600000;0
2588;165744;50;91;16;0;16;1.000;3600000;0
2588;189644;42;69;49;5;44;.898;3600000;0
2588;176060;42;0;0;0;0;.00nan;0;0
2588;75313;50;0;0;0;0;.00nan;0;0
2589;210998;44;0;0;0;0;.00nan;0;0
2589;201673;4619;71;22;2;20;.909;3900000;0
2589;64911;44;90;41;2;39;.951;3900000;0
2589;79132;4619;0;0;0;0;.00nan;0;0
2590;2195;53;0;0;0;0;.00nan;0;0
2590;169323;53;85;31;1;30;.968;3600000;0
2590;77955;56;0;0;0;0;.00nan;0;0
2590;85437;56;55;23;3;20;.870;3561000;0
2591;-1;45;0;0;0;0;.00nan;0;0
2591;184610;45;62;43;5;38;.884;3900000;0
2591;196372;37;34;24;5;19;.792;3040000;0
2591;202161;37;47;1;0;1;1.000;860000;0
2592;224943;60;0;0;0;0;.00nan;0;0
2592;181341;60;45;46;7;39;.848;3600000;0
2592;186495;47;100;26;0;26;1.000;3600000;0
2592;85281;47;0;0;0;0;.00nan;0;0
2593;194893;54;80;55;4;51;.927;3600000;0
2593;189639;54;0;0;0;0;.00nan;0;0
2593;182049;46;85;19;0;19;1.000;3600000;0
2593;218119;46;0;0;0;0;.00nan;0;0
2594;180873;63;0;0;0;0;.00nan;0;0
2594;86485;36;92;42;3;39;.929;3817000;0
2594;91391;36;0;0;0;0;.00nan;0;0
2594;152418;63;85;33;2;31;.939;3817000;0
2595;163565;40;89;33;3;30;.909;3600000;0
2595;181102;48;100;27;0;27;1.000;3600000;0
2595;185812;40;0;0;0;0;.00nan;0;0
2595;142492;48;0;0;0;0;.00nan;0;0
2596;38124;58;64;57;8;49;.860;3600000;0
2596;191026;58;0;0;0;0;.00nan;0;0
2596;77955;56;49;28;4;24;.857;3600000;0
2596;85437;56;0;0;0;0;.00nan;0;0
2597;205799;57;0;0;0;0;.00nan;0;0
2597;176921;38;37;13;3;10;.769;1317000;0
2597;-1;38;23;26;6;20;.769;2283000;0
2597;85787;57;52;27;4;23;.852;3600000;0
2598;197940;49;44;19;3;16;.842;3593000;0
2598;205318;61;0;0;0;0;.00nan;0;0
2598;-1;61;94;40;2;38;.950;3600000;0
2598;201075;49;0;0;0;0;.00nan;0;0
2599;165744;50;39;26;5;21;.808;2053000;0
2599;189644;42;0;0;0;0;.00nan;0;0
2599;176060;42;86;44;4;40;.909;3600000;0
2599;75313;50;27;14;4;10;.714;1547000;0
2600;224943;60;0;0;0;0;.00nan;0;0
2600;181341;60;79;38;2;36;.947;3600000;0
2600;186495;47;0;0;0;0;.00nan;0;0
2600;85281;47;64;14;1;13;.929;3600000;0
2601;194893;54;94;44;2;42;.955;3874000;0
2601;189639;54;0;0;0;0;.00nan;0;0
2601;182049;46;64;19;1;18;.947;3874000;0
2601;218119;46;0;0;0;0;.00nan;0;0
2602;180873;63;0;0;0;0;.00nan;0;0
2602;86485;36;0;0;0;0;.00nan;0;0
2602;91391;36;57;28;3;25;.893;3600000;0
2602;152418;63;41;30;4;26;.867;3600000;0
2603;194264;41;65;24;2;22;.917;3600000;0
2603;178789;65;40;39;7;32;.821;3600000;0
2603;184770;65;0;0;0;0;.00nan;0;0
2603;192688;41;0;0;0;0;.00nan;0;0
2604;175658;64;0;0;0;0;.00nan;0;0
2604;196372;37;0;0;0;0;.00nan;0;0
2604;202161;37;64;21;2;19;.905;3900000;0
2604;85661;64;77;30;2;28;.933;3900000;0
2605;170977;62;74;31;3;28;.903;3765000;0
2605;186495;47;75;27;2;25;.926;3765000;0
2605;186549;62;0;0;0;0;.00nan;0;0
2605;85281;47;0;0;0;0;.00nan;0;0
2606;163565;40;29;33;7;26;.788;3600000;0
2606;201673;4619;63;28;3;25;.893;3600000;0
2606;185812;40;0;0;0;0;.00nan;0;0
2606;79132;4619;0;0;0;0;.00nan;0;0
2607;205318;61;77;32;2;30;.938;3600000;0
2607;210998;44;84;39;3;36;.923;3561000;0
2607;-1;61;0;0;0;0;.00nan;0;0
2607;64911;44;0;0;0;0;.00nan;0;0
2608;180873;63;0;0;0;0;.00nan;0;0
2608;185960;39;31;21;5;16;.762;3600000;0
2608;197704;39;0;0;0;0;.00nan;0;0
2608;152418;63;93;37;1;36;.973;3600000;0
2609;179950;4837;0;0;0;0;.00nan;0;0
2609;181102;48;72;44;4;40;.909;3600000;0
2609;187295;4837;48;15;2;13;.867;3600000;0
2609;142492;48;0;0;0;0;.00nan;0;0
2610;203288;51;51;35;5;30;.857;3706000;0
2610;3359;43;42;31;6;25;.806;3706000;0
2610;188888;51;0;0;0;0;.00nan;0;0
2610;173856;43;0;0;0;0;.00nan;0;0
2611;179950;4837;59;12;1;11;.917;3600000;0
2611;181102;48;70;21;1;20;.952;1822000;0
2611;187295;4837;0;0;0;0;.00nan;0;0
2611;142492;48;40;34;6;28;.824;1778000;0
2612;163565;40;72;23;2;21;.913;3600000;0
2612;170977;62;39;43;7;36;.837;3600000;0
2612;185812;40;0;0;0;0;.00nan;0;0
2612;186549;62;0;0;0;0;.00nan;0;0
2613;-1;45;0;0;0;0;.00nan;0;0
2613;184610;45;72;40;5;35;.875;3900000;0
2613;196372;37;0;0;0;0;.00nan;0;0
2613;202161;37;77;37;5;32;.865;3900000;0
2614;184081;52;61;16;1;15;.938;3600000;0
2614;176921;38;50;49;8;41;.837;3600000;0
2614;-1;38;0;0;0;0;.00nan;0;0
2614;91398;52;0;0;0;0;.00nan;0;0
2615;178098;59;63;18;2;16;.889;3600000;0
2615;194264;41;56;17;2;15;.882;1434000;0
2615;174407;59;0;0;0;0;.00nan;0;0
2615;192688;41;42;32;6;26;.813;2166000;0
2616;165744;50;52;14;2;12;.857;3600000;0
2616;194893;54;0;0;0;0;.00nan;0;0
2616;189639;54;60;39;5;34;.872;3600000;0
2616;75313;50;0;0;0;0;.00nan;0;0
2617;201673;4619;44;40;7;33;.825;3600000;0
2617;186495;47;87;25;2;23;.920;3600000;0
2617;79132;4619;0;0;0;0;.00nan;0;0
2617;85281;47;0;0;0;0;.00nan;0;0
2618;2195;53;0;0;0;0;.00nan;0;0
2618;169323;53;59;30;4;26;.867;3678000;0
2618;86485;36;95;47;3;44;.936;3678000;0
2618;91391;36;0;0;0;0;.00nan;0;0
2619;185960;39;61;28;3;25;.893;3545000;0
2619;197704;39;0;0;0;0;.00nan;0;0
2619;77955;56;0;0;0;0;.00nan;0;0
2619;85437;56;100;48;2;46;.958;3600000;0
2620;210998;44;0;0;0;0;.00nan;0;0
2620;182049;46;54;12;1;11;.917;3600000;0
2620;218119;46;0;0;0;0;.00nan;0;0
2620;64911;44;62;32;3;29;.906;3600000;0
2621;171970;55;0;0;0;0;.00nan;0;0
2621;194502;55;73;48;5;43;.896;3600000;0
2621;180873;63;0;0;0;0;.00nan;0;0
2621;152418;63;72;16;1;15;.938;3600000;0
2622;197940;49;83;23;1;22;.957;3600000;0
2622;224943;60;0;0;0;0;.00nan;0;0
2622;201075;49;0;0;0;0;.00nan;0;0
2622;181341;60;77;51;5;46;.902;3600000;0
2623;178789;65;72;30;2;28;.933;3886000;0
2623;184770;65;0;0;0;0;.00nan;0;0
2623;38124;58;0;0;0;0;.00nan;0;0
2623;191026;58;72;37;3;34;.919;3886000;0
2624;165744;50;0;0;0;0;.00nan;0;0
2624;-1;45;77;44;4;40;.909;3900000;0
2624;184610;45;0;0;0;0;.00nan;0;0
2624;75313;50;43;23;4;19;.826;3900000;0
2625;203288;51;49;25;4;21;.840;2334000;0
2625;3359;43;72;32;3;29;.906;3600000;0
2625;188888;51;52;7;1;6;.857;1265000;0
2625;173856;43;0;0;0;0;.00nan;0;0
2626;205318;61;84;43;3;40;.930;3900000;0
2626;-1;61;0;0;0;0;.00nan;0;0
2626;201673;4619;64;26;3;23;.885;3900000;0
2626;79132;4619;0;0;0;0;.00nan;0;0
2627;194264;41;85;13;0;13;1.000;3600000;0
2627;38124;58;89;51;2;49;.961;3600000;0
2627;191026;58;0;0;0;0;.00nan;0;0
2627;192688;41;0;0;0;0;.00nan;0;0
2628;189644;42;89;29;1;28;.966;3900000;0
2628;175658;64;0;0;0;0;.00nan;0;0
2628;176060;42;0;0;0;0;.00nan;0;0
2628;85661;64;83;28;1;27;.964;3900000;0
2629;2195;53;88;12;0;12;1.000;3600000;0
2629;169323;53;0;0;0;0;.00nan;0;0
2629;86485;36;0;0;0;0;.00nan;0;0
2629;91391;36;83;57;6;51;.895;3600000;0
2630;185960;39;50;21;3;18;.857;3900000;0
2630;197704;39;0;0;0;0;.00nan;0;0
2630;77955;56;90;46;3;43;.935;3900000;0
2630;85437;56;0;0;0;0;.00nan;0;0
2631;194893;54;93;40;2;38;.950;3545000;0
2631;189639;54;0;0;0;0;.00nan;0;0
2631;196372;37;76;20;1;19;.950;3600000;0
2631;202161;37;0;0;0;0;.00nan;0;0
2632;210998;44;86;28;1;27;.964;3600000;0
2632;182049;46;53;25;3;22;.880;3520000;0
2632;218119;46;0;0;0;0;.00nan;0;0
2632;64911;44;0;0;0;0;.00nan;0;0
2633;184081;52;0;0;0;0;.00nan;0;0
2633;205799;57;22;23;6;17;.739;2421000;0
2633;85787;57;50;8;1;7;.875;1179000;0
2633;91398;52;100;29;0;29;1.000;3600000;0
2634;171970;55;36;37;7;30;.811;3052000;0
2634;194502;55;64;9;0;9;1.000;548000;0
2634;180873;63;0;0;0;0;.00nan;0;0
2634;152418;63;62;19;2;17;.895;3600000;0
2635;197940;49;54;20;3;17;.850;3600000;0
2635;224943;60;0;0;0;0;.00nan;0;0
2635;201075;49;0;0;0;0;.00nan;0;0
2635;181341;60;63;33;4;29;.879;3566000;0
2636;178098;59;0;0;0;0;.00nan;0;0
2636;178789;65;0;0;0;0;.00nan;0;0
2636;174407;59;79;19;1;18;.947;3600000;0
2636;184770;65;71;49;5;44;.898;3600000;0
2637;165744;50;100;25;0;25;1.000;3600000;0
2637;-1;45;0;0;0;0;.00nan;0;0
2637;184610;45;77;43;4;39;.907;3600000;0
2637;75313;50;0;0;0;0;.00nan;0;0
2638;163565;40;0;0;0;0;.00nan;0;0
2638;185812;40;66;51;5;46;.902;3600000;0
2638;186495;47;82;25;1;24;.960;3600000;0
2638;85281;47;0;0;0;0;.00nan;0;0
2639;205799;57;0;0;0;0;.00nan;0;0
2639;176921;38;70;56;7;49;.875;3600000;0
2639;-1;38;0;0;0;0;.00nan;0;0
2639;85787;57;46;13;2;11;.846;3600000;0
2640;178098;59;74;14;1;13;.929;3600000;0
2640;178789;65;62;48;6;42;.875;3162000;0
2640;174407;59;0;0;0;0;.00nan;0;0
2640;184770;65;60;7;0;7;1.000;438000;0
2641;189644;42;70;49;5;44;.898;3600000;0
2641;175658;64;0;0;0;0;.00nan;0;0
2641;176060;42;0;0;0;0;.00nan;0;0
2641;85661;64;55;24;2;22;.917;3600000;0
2642;194893;54;86;34;2;32;.941;3600000;0
2642;189639;54;0;0;0;0;.00nan;0;0
2642;196372;37;0;0;0;0;.00nan;0;0
2642;202161;37;71;17;1;16;.941;3600000;0
2643;2195;53;73;28;2;26;.929;3600000;0
2643;184081;52;0;0;0;0;.00nan;0;0
2643;169323;53;0;0;0;0;.00nan;0;0
2643;91398;52;57;26;3;23;.885;3580000;0
2644;197940;49;49;25;4;21;.840;3521000;0
2644;201075;49;0;0;0;0;.00nan;0;0
2644;186495;47;95;40;2;38;.950;3600000;0
2644;85281;47;0;0;0;0;.00nan;0;0
2645;170977;62;46;36;6;30;.833;1992000;0
2645;201673;4619;37;27;5;22;.815;3600000;0
2645;186549;62;58;19;2;17;.895;1608000;0
2645;79132;4619;0;0;0;0;.00nan;0;0
2646;171970;55;0;0;0;0;.00nan;0;0
2646;194502;55;86;44;3;41;.932;3797000;0
2646;185960;39;60;34;4;30;.882;3797000;0
2646;197704;39;0;0;0;0;.00nan;0;0
2647;163565;40;91;34;2;32;.941;3900000;0
2647;224943;60;0;0;0;0;.00nan;0;0
2647;181341;60;86;35;2;33;.943;3900000;0
2647;185812;40;0;0;0;0;.00nan;0;0
2648;197940;49;0;0;0;0;.00nan;0;0
2648;201075;49;93;39;3;36;.923;3900000;0
2648;186495;47;71;34;3;31;.912;3900000;0
2648;85281;47;0;0;0;0;.00nan;0;0
2649;178098;59;0;0;0;0;.00nan;0;0
2649;205799;57;98;52;2;50;.962;3600000;0
2649;174407;59;92;17;0;17;1.000;3600000;0
2649;85787;57;0;0;0;0;.00nan;0;0
2650;-1;45;55;29;4;25;.862;3600000;0
2650;184610;45;0;0;0;0;.00nan;0;0
2650;175658;64;0;0;0;0;.00nan;0;0
2650;85661;64;85;24;1;23;.958;3600000;0
2651;194893;54;59;35;4;31;.886;3600000;0
2651;189639;54;0;0;0;0;.00nan;0;0
2651;189644;42;68;24;1;23;.958;3600000;0
2651;176060;42;0;0;0;0;.00nan;0;0
2652;180873;63;52;4;0;4;1.000;651000;0
2652;77955;56;0;0;0;0;.00nan;0;0
2652;85437;56;81;22;1;21;.955;3600000;0
2652;152418;63;58;41;6;35;.854;2949000;0
2653;179950;4837;0;0;0;0;.00nan;0;0
2653;181102;48;29;24;6;18;.750;2614000;0
2653;187295;4837;85;16;0;16;1.000;3600000;0
2653;142492;48;71;18;1;17;.944;986000;0
2654;3359;43;68;32;3;29;.906;3578000;0
2654;173856;43;0;0;0;0;.00nan;0;0
2654;185960;39;82;25;1;24;.960;3600000;0
2654;197704;39;0;0;0;0;.00nan;0;0
2655;194264;41;32;17;4;13;.765;3586000;0
2655;38124;58;0;0;0;0;.00nan;0;0
2655;191026;58;78;39;3;36;.923;3600000;0
2655;192688;41;0;0;0;0;.00nan;0;0
2656;178789;65;45;26;4;22;.846;3600000;0
2656;184770;65;0;0;0;0;.00nan;0;0
2656;176921;38;76;24;1;23;.958;3600000;0
2656;-1;38;0;0;0;0;.00nan;0;0
2657;205318;61;25;7;3;4;.571;394000;0
2657;170977;62;83;38;3;35;.921;3900000;0
2657;-1;61;91;29;0;29;1.000;3506000;0
2657;186549;62;0;0;0;0;.00nan;0;0
2658;-1;45;0;0;0;0;.00nan;0;0
2658;184610;45;68;51;5;46;.902;3600000;0
2658;175658;64;0;0;0;0;.00nan;0;0
2658;85661;64;70;21;2;19;.905;3600000;0
2659;2195;53;84;28;1;27;.964;3600000;0
2659;184081;52;68;45;4;41;.911;3600000;0
2659;169323;53;0;0;0;0;.00nan;0;0
2659;91398;52;0;0;0;0;.00nan;0;0
2660;203288;51;0;0;0;0;.00nan;0;0
2660;188888;51;46;28;4;24;.857;3578000;0
2660;77955;56;0;0;0;0;.00nan;0;0
2660;85437;56;74;27;2;25;.926;3600000;0
2661;165744;50;65;23;2;21;.913;3560000;0
2661;196372;37;0;0;0;0;.00nan;0;0
2661;202161;37;99;46;1;45;.978;3600000;0
2661;75313;50;0;0;0;0;.00nan;0;0
2662;189644;42;56;34;5;29;.853;3514000;0
2662;176060;42;0;0;0;0;.00nan;0;0
2662;182049;46;52;25;3;22;.880;3600000;0
2662;218119;46;0;0;0;0;.00nan;0;0
2663;224943;60;0;0;0;0;.00nan;0;0
2663;210998;44;0;0;0;0;.00nan;0;0
2663;181341;60;56;19;2;17;.895;3600000;0
2663;64911;44;82;43;3;40;.930;3597000;0
2664;171970;55;0;0;0;0;.00nan;0;0
2664;194502;55;91;53;5;48;.906;3587000;0
2664;86485;36;45;19;4;15;.789;3600000;0
2664;91391;36;0;0;0;0;.00nan;0;0
2665;179950;4837;54;24;3;21;.875;3600000;0
2665;181102;48;72;46;6;40;.870;3600000;0
2665;187295;4837;0;0;0;0;.00nan;0;0
2665;142492;48;0;0;0;0;.00nan;0;0
2666;205318;61;74;24;2;22;.917;3600000;0
2666;170977;62;0;0;0;0;.00nan;0;0
2666;-1;61;0;0;0;0;.00nan;0;0
2666;186549;62;70;33;3;30;.909;3552000;0
2667;2195;53;0;0;0;0;.00nan;0;0
2667;169323;53;69;16;2;14;.875;3600000;0
2667;38124;58;96;58;4;54;.931;3600000;0
2667;191026;58;0;0;0;0;.00nan;0;0
2668;165744;50;0;0;0;0;.00nan;0;0
2668;175658;64;0;0;0;0;.00nan;0;0
2668;75313;50;69;24;2;22;.917;3586000;0
2668;85661;64;100;35;0;35;1.000;3600000;0
2669;197940;49;68;29;2;27;.931;3600000;0
2669;201075;49;0;0;0;0;.00nan;0;0
2669;201673;4619;48;32;5;27;.844;3600000;0
2669;79132;4619;0;0;0;0;.00nan;0;0
2670;178098;59;0;0;0;0;.00nan;0;0
2670;205799;57;53;45;6;39;.867;3600000;0
2670;174407;59;82;17;1;16;.941;3600000;0
2670;85787;57;0;0;0;0;.00nan;0;0
2671;3359;43;0;0;0;0;.00nan;0;0
2671;173856;43;53;24;3;21;.875;3553000;0
2671;185960;39;66;29;2;27;.931;3600000;0
2671;197704;39;0;0;0;0;.00nan;0;0
2672;194264;41;0;0;0;0;.00nan;0;0
2672;178789;65;27;7;3;4;.571;1293000;0
2672;184770;65;46;40;6;34;.850;2307000;0
2672;192688;41;71;15;1;14;.933;3600000;0
2673;194893;54;69;41;4;37;.902;3900000;0
2673;189639;54;0;0;0;0;.00nan;0;0
2673;196372;37;34;21;4;17;.810;3900000;0
2673;202161;37;0;0;0;0;.00nan;0;0
2674;163565;40;35;51;9;42;.824;3600000;0
2674;185812;40;0;0;0;0;.00nan;0;0
2674;186495;47;72;22;2;20;.909;3600000;0
2674;85281;47;0;0;0;0;.00nan;0;0
2675;184081;52;0;0;0;0;.00nan;0;0
2675;176921;38;0;0;0;0;.00nan;0;0
2675;-1;38;99;34;1;33;.971;3600000;0
2675;91398;52;68;32;3;29;.906;3535000;0
2676;171970;55;60;19;2;17;.895;3600000;0
2676;194502;55;0;0;0;0;.00nan;0;0
2676;86485;36;0;0;0;0;.00nan;0;0
2676;91391;36;50;23;3;20;.870;3600000;0
2677;189644;42;81;31;2;29;.935;3600000;0
2677;176060;42;0;0;0;0;.00nan;0;0
2677;182049;46;0;0;0;0;.00nan;0;0
2677;218119;46;54;36;4;32;.889;3576000;0
2678;203288;51;84;26;1;25;.962;3600000;0
2678;188888;51;0;0;0;0;.00nan;0;0
2678;180873;63;0;0;0;0;.00nan;0;0
2678;152418;63;57;32;4;28;.875;3600000;0
2679;224943;60;0;0;0;0;.00nan;0;0
2679;210998;44;48;39;5;34;.872;2892000;0
2679;181341;60;50;16;2;14;.875;3600000;0
2679;64911;44;47;5;1;4;.800;708000;0
2680;165744;50;80;31;1;30;.968;3641000;0
2680;196372;37;0;0;0;0;.00nan;0;0
2680;202161;37;81;28;2;26;.929;3641000;0
2680;75313;50;0;0;0;0;.00nan;0;0
2681;163565;40;0;0;0;0;.00nan;0;0
2681;185812;40;100;50;2;48;.960;3900000;0
2681;186495;47;68;20;2;18;.900;3900000;0
2681;85281;47;0;0;0;0;.00nan;0;0
2682;197940;49;84;18;0;18;1.000;3600000;0
2682;201075;49;0;0;0;0;.00nan;0;0
2682;201673;4619;61;22;3;19;.864;3600000;0
2682;79132;4619;0;0;0;0;.00nan;0;0
2683;194893;54;0;0;0;0;.00nan;0;0
2683;189639;54;35;28;5;23;.821;3600000;0
2683;-1;45;71;27;2;25;.926;3600000;0
2683;184610;45;0;0;0;0;.00nan;0;0
2684;194264;41;23;4;3;1;.250;302000;0
2684;205799;57;0;0;0;0;.00nan;0;0
2684;192688;41;77;24;1;23;.958;3254000;0
2684;85787;57;61;28;3;25;.893;3600000;0
2685;2195;53;69;29;2;27;.931;3600000;0
2685;169323;53;0;0;0;0;.00nan;0;0
2685;176921;38;87;33;1;32;.970;3600000;0
2685;-1;38;0;0;0;0;.00nan;0;0
2686;203288;51;0;0;0;0;.00nan;0;0
2686;188888;51;49;33;5;28;.848;3600000;0
2686;180873;63;0;0;0;0;.00nan;0;0
2686;152418;63;53;26;3;23;.885;3600000;0
2687;77955;56;0;0;0;0;.00nan;0;0
2687;85437;56;96;24;0;24;1.000;3600000;0
2687;86485;36;75;31;3;28;.903;3600000;0
2687;91391;36;0;0;0;0;.00nan;0;0
2689;171970;55;0;0;0;0;.00nan;0;0
2689;194502;55;45;32;5;27;.844;3600000;0
2689;-1;45;57;33;4;29;.879;3600000;0
2689;184610;45;0;0;0;0;.00nan;0;0
2691;197940;49;90;48;3;45;.938;3600000;0
2691;3359;43;0;0;0;0;.00nan;0;0
2691;201075;49;0;0;0;0;.00nan;0;0
2691;182116;43;89;22;0;22;1.000;3600000;0
2693;203288;51;96;34;2;32;.941;3818000;0
2693;188888;51;0;0;0;0;.00nan;0;0
2693;176921;38;83;43;3;40;.930;3818000;0
2693;-1;38;0;0;0;0;.00nan;0;0
2695;175658;36;85;34;2;32;.941;3548000;0
2695;185960;39;73;25;1;24;.960;3600000;0
2695;192552;36;0;0;0;0;.00nan;0;0
2695;197704;39;0;0;0;0;.00nan;0;0
2697;187699;47;0;0;0;0;.00nan;0;0
2697;178695;63;62;29;3;26;.897;3592000;0
2697;180873;63;0;0;0;0;.00nan;0;0
2697;186495;47;61;14;1;13;.929;3600000;0
2699;182049;46;28;31;6;25;.806;3600000;0
2699;218119;46;0;0;0;0;.00nan;0;0
2699;79132;4619;80;31;2;29;.935;3600000;0
2699;86228;4619;0;0;0;0;.00nan;0;0
2701;4622;64;0;0;0;0;.00nan;0;0
2701;181341;60;57;25;3;22;.880;3600000;0
2701;85661;64;79;40;4;36;.900;3600000;0
2701;86862;60;0;0;0;0;.00nan;0;0
2703;205799;57;0;0;0;0;.00nan;0;0
2703;38124;58;0;0;0;0;.00nan;0;0
2703;191026;58;65;36;4;32;.889;3567000;0
2703;152418;57;73;25;2;23;.920;3600000;0
2705;163565;40;0;0;0;0;.00nan;0;0
2705;185812;40;72;40;4;36;.900;3610000;0
2705;85437;56;57;24;3;21;.875;3610000;0
2705;86875;56;0;0;0;0;.00nan;0;0
2707;196372;37;82;29;1;28;.966;3900000;0
2707;202161;37;0;0;0;0;.00nan;0;0
2707;187362;59;91;32;1;31;.969;3900000;0
2707;143156;59;0;0;0;0;.00nan;0;0
2709;165744;50;63;15;1;14;.933;3600000;0
2709;178789;65;0;0;0;0;.00nan;0;0
2709;184770;65;56;37;5;32;.865;3600000;0
2709;57215;50;0;0;0;0;.00nan;0;0
2711;194264;41;45;20;3;17;.850;3525000;0
2711;170977;62;0;0;0;0;.00nan;0;0
2711;186549;62;87;30;1;29;.967;3600000;0
2711;192688;41;0;0;0;0;.00nan;0;0
2713;194219;44;87;38;2;36;.947;3600000;0
2713;194893;54;70;31;3;28;.903;3553000;0
2713;189639;54;0;0;0;0;.00nan;0;0
2713;64911;44;0;0;0;0;.00nan;0;0
2715;2195;53;63;13;1;12;.923;3600000;0
2715;184081;52;75;30;2;28;.933;3548000;0
2715;169323;53;0;0;0;0;.00nan;0;0
2715;91398;52;0;0;0;0;.00nan;0;0
2717;205318;61;59;35;4;31;.886;3549000;0
2717;-1;61;0;0;0;0;.00nan;0;0
2717;181102;48;0;0;0;0;.00nan;0;0
2717;142492;48;62;30;3;27;.900;3600000;0
2719;189644;42;72;43;4;39;.907;3570000;0
2719;176060;42;0;0;0;0;.00nan;0;0
2719;185743;4837;48;19;3;16;.842;3600000;0
2719;187295;4837;0;0;0;0;.00nan;0;0
2416;2195;53;46;17;3;14;.824;3600000;0
2416;169323;53;0;0;0;0;.00nan;0;0
2416;176921;38;76;52;6;46;.885;3600000;0
2416;-1;38;0;0;0;0;.00nan;0;0
2417;194264;41;99;38;1;37;.974;3600000;0
2417;205799;57;53;20;2;18;.900;3600000;0
2417;192688;41;0;0;0;0;.00nan;0;0
2417;85787;57;0;0;0;0;.00nan;0;0
2418;180873;63;0;0;0;0;.00nan;0;0
2418;185960;39;52;22;3;19;.864;3600000;0
2418;197704;39;0;0;0;0;.00nan;0;0
2418;152418;63;54;30;4;26;.867;3600000;0
2419;189644;42;85;29;1;28;.966;3600000;0
2419;176060;42;0;0;0;0;.00nan;0;0
2419;196372;37;0;0;0;0;.00nan;0;0
2419;202161;37;80;42;4;38;.905;3600000;0
2420;205318;61;41;29;5;24;.828;3600000;0
2420;-1;61;0;0;0;0;.00nan;0;0
2420;186495;47;73;21;2;19;.905;3600000;0
2420;85281;47;0;0;0;0;.00nan;0;0
2421;210998;44;62;38;4;34;.895;3600000;0
2421;179950;4837;0;0;0;0;.00nan;0;0
2421;187295;4837;22;16;5;11;.688;3565000;0
2421;64911;44;0;0;0;0;.00nan;0;0
2422;224943;60;48;5;1;4;.800;270000;0
2422;201673;4619;54;29;4;25;.862;3600000;0
2422;181341;60;41;30;6;24;.800;3330000;0
2422;79132;4619;0;0;0;0;.00nan;0;0
2423;2195;53;85;29;1;28;.966;4074000;0
2423;169323;53;0;0;0;0;.00nan;0;0
2423;176921;38;91;49;2;47;.959;4074000;0
2423;-1;38;0;0;0;0;.00nan;0;0
2424;194264;41;0;0;0;0;.00nan;0;0
2424;205799;57;100;32;0;32;1.000;3600000;0
2424;192688;41;64;22;2;20;.909;3518000;0
2424;85787;57;0;0;0;0;.00nan;0;0
2425;180873;63;0;0;0;0;.00nan;0;0
2425;185960;39;60;21;2;19;.905;3600000;0
2425;197704;39;0;0;0;0;.00nan;0;0
2425;152418;63;67;34;4;30;.882;3600000;0
2426;189644;42;88;33;1;32;.970;4106000;0
2426;176060;42;0;0;0;0;.00nan;0;0
2426;196372;37;0;0;0;0;.00nan;0;0
2426;202161;37;75;34;2;32;.941;4106000;0
2427;205318;61;70;37;3;34;.919;3585000;0
2427;-1;61;0;0;0;0;.00nan;0;0
2427;186495;47;59;18;2;16;.889;3600000;0
2427;85281;47;0;0;0;0;.00nan;0;0
2428;210998;44;0;0;0;0;.00nan;0;0
2428;179950;4837;80;32;2;30;.938;3600000;0
2428;187295;4837;0;0;0;0;.00nan;0;0
2428;64911;44;75;46;4;42;.913;3569000;0
2429;224943;60;0;0;0;0;.00nan;0;0
2429;201673;4619;24;13;4;9;.692;1014000;0
2429;181341;60;96;34;1;33;.971;3600000;0
2429;79132;4619;67;17;0;17;1.000;2586000;0
2482;194264;41;0;0;0;0;.00nan;0;0
2482;205799;57;79;28;1;27;.964;3600000;0
2482;192688;41;51;19;3;16;.842;3538000;0
2482;85787;57;0;0;0;0;.00nan;0;0
2483;210998;44;0;0;0;0;.00nan;0;0
2483;179950;4837;87;33;2;31;.939;4225000;0
2483;187295;4837;0;0;0;0;.00nan;0;0
2483;64911;44;82;38;3;35;.921;4225000;0
2484;224943;60;0;0;0;0;.00nan;0;0
2484;201673;4619;72;34;3;31;.912;3515000;0
2484;181341;60;84;30;1;29;.967;3600000;0
2484;79132;4619;0;0;0;0;.00nan;0;0
2499;178098;59;43;21;3;18;.857;3600000;0
2499;205799;57;19;25;7;18;.720;2329000;0
2499;174407;59;0;0;0;0;.00nan;0;0
2499;85787;57;61;8;0;8;1.000;1271000;0
2500;2195;53;63;39;4;35;.897;3564000;0
2500;184081;52;73;28;2;26;.929;3600000;0
2500;169323;53;0;0;0;0;.00nan;0;0
2500;91398;52;0;0;0;0;.00nan;0;0
2501;3359;43;38;20;4;16;.800;3557000;0
2501;173856;43;0;0;0;0;.00nan;0;0
2501;185960;39;54;17;2;15;.882;3600000;0
2501;197704;39;0;0;0;0;.00nan;0;0
2502;203288;51;0;0;0;0;.00nan;0;0
2502;188888;51;54;25;3;22;.880;3598000;0
2502;77955;56;0;0;0;0;.00nan;0;0
2502;85437;56;76;28;2;26;.929;3600000;0
2503;165744;50;91;14;0;14;1.000;3600000;0
2503;189644;42;72;35;3;32;.914;3600000;0
2503;176060;42;0;0;0;0;.00nan;0;0
2503;75313;50;0;0;0;0;.00nan;0;0
2504;175658;64;0;0;0;0;.00nan;0;0
2504;182049;46;53;30;5;25;.833;5045000;0
2504;218119;46;0;0;0;0;.00nan;0;0
2504;85661;64;99;72;4;68;.944;5045000;0
2505;197940;49;72;20;1;19;.950;3600000;0
2505;224943;60;0;0;0;0;.00nan;0;0
2505;201075;49;0;0;0;0;.00nan;0;0
2505;181341;60;98;44;2;42;.955;3547000;0
2506;179950;4837;65;44;4;40;.909;5582000;0
2506;186495;47;86;46;3;43;.935;5582000;0
2506;187295;4837;0;0;0;0;.00nan;0;0
2506;85281;47;0;0;0;0;.00nan;0;0
2507;178098;59;71;16;1;15;.938;3600000;0
2507;205799;57;67;43;5;38;.884;3600000;0
2507;174407;59;0;0;0;0;.00nan;0;0
2507;85787;57;0;0;0;0;.00nan;0;0
2508;2195;53;45;33;5;28;.848;3600000;0
2508;184081;52;85;37;3;34;.919;3600000;0
2508;169323;53;0;0;0;0;.00nan;0;0
2508;91398;52;0;0;0;0;.00nan;0;0
2509;3359;43;60;34;4;30;.882;3586000;0
2509;173856;43;0;0;0;0;.00nan;0;0
2509;185960;39;72;36;3;33;.917;3600000;0
2509;197704;39;0;0;0;0;.00nan;0;0
2510;203288;51;0;0;0;0;.00nan;0;0
2510;188888;51;41;23;4;19;.826;3600000;0
2510;77955;56;0;0;0;0;.00nan;0;0
2510;85437;56;51;41;6;35;.854;3552000;0
2511;165744;50;59;15;2;13;.867;3600000;0
2511;189644;42;41;35;6;29;.829;2835000;0
2511;176060;42;61;8;0;8;1.000;765000;0
2511;75313;50;0;0;0;0;.00nan;0;0
2512;175658;64;0;0;0;0;.00nan;0;0
2512;182049;46;79;35;3;32;.914;3599000;0
2512;218119;46;0;0;0;0;.00nan;0;0
2512;85661;64;70;24;2;22;.917;3600000;0
2513;197940;49;63;24;3;21;.875;3600000;0
2513;224943;60;0;0;0;0;.00nan;0;0
2513;201075;49;0;0;0;0;.00nan;0;0
2513;181341;60;46;37;6;31;.838;3600000;0
2514;179950;4837;52;30;4;26;.867;3600000;0
2514;186495;47;86;24;1;23;.958;3600000;0
2514;187295;4837;0;0;0;0;.00nan;0;0
2514;85281;47;0;0;0;0;.00nan;0;0
2515;178098;59;73;19;1;18;.947;3600000;0
2515;205799;57;33;9;3;6;.667;488000;0
2515;174407;59;0;0;0;0;.00nan;0;0
2515;85787;57;70;32;2;30;.938;3112000;0
2516;2195;53;58;25;2;23;.920;3545000;0
2516;184081;52;91;30;1;29;.967;3600000;0
2516;169323;53;0;0;0;0;.00nan;0;0
2516;91398;52;0;0;0;0;.00nan;0;0
2517;3359;43;58;26;3;23;.885;3590000;0
2517;173856;43;0;0;0;0;.00nan;0;0
2517;185960;39;81;28;1;27;.964;3600000;0
2517;197704;39;0;0;0;0;.00nan;0;0
2518;203288;51;0;0;0;0;.00nan;0;0
2518;188888;51;80;33;2;31;.939;3600000;0
2518;77955;56;0;0;0;0;.00nan;0;0
2518;85437;56;89;39;3;36;.923;3568000;0
2519;165744;50;95;28;1;27;.964;3600000;0
2519;189644;42;79;56;4;52;.929;3600000;0
2519;176060;42;0;0;0;0;.00nan;0;0
2519;75313;50;0;0;0;0;.00nan;0;0
2520;175658;64;0;0;0;0;.00nan;0;0
2520;182049;46;71;32;3;29;.906;3600000;0
2520;218119;46;0;0;0;0;.00nan;0;0
2520;85661;64;100;29;0;29;1.000;3600000;0
2521;197940;49;82;16;0;16;1.000;3600000;0
2521;224943;60;0;0;0;0;.00nan;0;0
2521;201075;49;0;0;0;0;.00nan;0;0
2521;181341;60;98;41;2;39;.951;3581000;0
2522;179950;4837;71;45;4;41;.911;3600000;0
2522;186495;47;85;24;1;23;.958;3600000;0
2522;187295;4837;0;0;0;0;.00nan;0;0
2522;85281;47;0;0;0;0;.00nan;0;0
2577;203288;51;0;0;0;0;.00nan;0;0
2577;188888;51;76;29;2;27;.931;3600000;0
2577;77955;56;0;0;0;0;.00nan;0;0
2577;85437;56;48;31;5;26;.839;3600000;0
2658;178098;59;87;16;0;16;1.000;3600000;0
2658;184081;52;79;47;4;43;.915;3600000;0
2658;174407;59;0;0;0;0;.00nan;0;0
2658;91398;52;0;0;0;0;.00nan;0;0
2659;203288;51;0;0;0;0;.00nan;0;0
2659;188888;51;80;50;5;45;.900;3600000;0
2659;185960;39;62;25;2;23;.920;3600000;0
2659;197704;39;0;0;0;0;.00nan;0;0
2660;165744;50;32;17;5;12;.706;3513000;0
2660;175658;64;0;0;0;0;.00nan;0;0
2660;75313;50;0;0;0;0;.00nan;0;0
2660;85661;64;73;32;3;29;.906;3600000;0
2661;197940;49;98;35;1;34;.971;3600000;0
2661;201075;49;0;0;0;0;.00nan;0;0
2661;186495;47;92;44;3;41;.932;3568000;0
2661;85281;47;0;0;0;0;.00nan;0;0
2662;178098;59;68;26;2;24;.923;3600000;0
2662;184081;52;56;29;4;25;.862;3600000;0
2662;174407;59;0;0;0;0;.00nan;0;0
2662;91398;52;0;0;0;0;.00nan;0;0
2663;203288;51;0;0;0;0;.00nan;0;0
2663;188888;51;89;31;1;30;.968;3600000;0
2663;185960;39;60;35;4;31;.886;3600000;0
2663;197704;39;0;0;0;0;.00nan;0;0
2664;165744;50;67;23;2;21;.913;3542000;0
2664;175658;64;0;0;0;0;.00nan;0;0
2664;75313;50;0;0;0;0;.00nan;0;0
2664;85661;64;100;22;0;22;1.000;3600000;0
2665;197940;49;79;23;1;22;.957;3600000;0
2665;201075;49;0;0;0;0;.00nan;0;0
2665;186495;47;73;42;4;38;.905;3600000;0
2665;85281;47;0;0;0;0;.00nan;0;0
2666;178098;59;66;23;2;21;.913;3587000;0
2666;184081;52;85;32;1;31;.969;3600000;0
2666;174407;59;0;0;0;0;.00nan;0;0
2666;91398;52;0;0;0;0;.00nan;0;0
2667;203288;51;0;0;0;0;.00nan;0;0
2667;188888;51;96;37;1;36;.973;3600000;0
2667;185960;39;73;33;2;31;.939;3562000;0
2667;197704;39;0;0;0;0;.00nan;0;0
2668;165744;50;91;29;1;28;.966;3600000;0
2668;175658;64;0;0;0;0;.00nan;0;0
2668;75313;50;0;0;0;0;.00nan;0;0
2668;85661;64;58;27;4;23;.852;3600000;0
2669;197940;49;51;27;4;23;.852;3600000;0
2669;201075;49;0;0;0;0;.00nan;0;0
2669;186495;47;32;31;6;25;.806;2683000;0
2669;85281;47;57;11;1;10;.909;917000;0
2731;178098;59;73;17;1;16;.941;3600000;0
2731;184081;52;65;36;4;32;.889;3600000;0
2731;174407;59;0;0;0;0;.00nan;0;0
2731;91398;52;0;0;0;0;.00nan;0;0
2732;203288;51;0;0;0;0;.00nan;0;0
2732;188888;51;75;35;4;31;.886;3551000;0
2732;185960;39;63;30;3;27;.900;3600000;0
2732;197704;39;0;0;0;0;.00nan;0;0
2733;165744;50;54;41;6;35;.854;3600000;0
2733;175658;64;0;0;0;0;.00nan;0;0
2733;75313;50;0;0;0;0;.00nan;0;0
2733;85661;64;48;20;3;17;.850;3600000;0
2738;203288;51;0;0;0;0;.00nan;0;0
2738;188888;51;72;33;3;30;.909;3554000;0
2738;185960;39;76;28;2;26;.929;3600000;0
2738;197704;39;0;0;0;0;.00nan;0;0
2755;178098;59;55;24;3;21;.875;3712000;0
2755;174407;59;0;0;0;0;.00nan;0;0
2755;185960;39;92;44;2;42;.955;3712000;0
2755;197704;39;0;0;0;0;.00nan;0;0
2756;197940;49;98;24;0;24;1.000;3600000;0
2756;201075;49;0;0;0;0;.00nan;0;0
2756;175658;64;0;0;0;0;.00nan;0;0
2756;85661;64;57;25;3;22;.880;3600000;0
2757;178098;59;71;30;2;28;.933;3600000;0
2757;174407;59;0;0;0;0;.00nan;0;0
2757;185960;39;58;38;4;34;.895;3583000;0
2757;197704;39;0;0;0;0;.00nan;0;0
2758;197940;49;71;18;1;17;.944;3600000;0
2758;201075;49;0;0;0;0;.00nan;0;0
2758;175658;64;0;0;0;0;.00nan;0;0
2758;85661;64;60;33;4;29;.879;3600000;0
2759;178098;59;56;20;2;18;.900;3600000;0
2759;174407;59;0;0;0;0;.00nan;0;0
2759;185960;39;69;37;4;33;.892;3515000;0
2759;197704;39;0;0;0;0;.00nan;0;0
2760;197940;49;46;21;3;18;.857;3600000;0
2760;201075;49;0;0;0;0;.00nan;0;0
2760;175658;64;0;0;0;0;.00nan;0;0
2760;85661;64;55;37;5;32;.865;3576000;0
2761;178098;59;69;22;2;20;.909;3600000;0
2761;174407;59;0;0;0;0;.00nan;0;0
2761;185960;39;76;49;5;44;.898;3600000;0
2761;197704;39;0;0;0;0;.00nan;0;0
2762;197940;49;55;34;4;30;.882;4214000;0
2762;201075;49;0;0;0;0;.00nan;0;0
2762;175658;64;0;0;0;0;.00nan;0;0
2762;85661;64;77;46;5;41;.891;4214000;0
2789;178098;59;71;23;2;21;.913;3600000;0
2789;174407;59;0;0;0;0;.00nan;0;0
2789;185960;39;54;39;5;34;.872;3600000;0
2789;197704;39;0;0;0;0;.00nan;0;0
2792;197940;49;88;33;1;32;.970;3908000;0
2792;178098;59;85;29;2;27;.931;3908000;0
2792;201075;49;0;0;0;0;.00nan;0;0
2792;174407;59;0;0;0;0;.00nan;0;0
2793;197940;49;66;42;5;37;.881;3600000;0
2793;178098;59;68;24;2;22;.917;3600000;0
2793;201075;49;0;0;0;0;.00nan;0;0
2793;174407;59;0;0;0;0;.00nan;0;0
2794;197940;49;70;21;1;20;.952;3600000;0
2794;178098;59;92;34;2;32;.941;3599000;0
2794;201075;49;0;0;0;0;.00nan;0;0
2794;174407;59;0;0;0;0;.00nan;0;0
2795;197940;49;38;28;5;23;.821;3543000;0
2795;178098;59;56;26;3;23;.885;3600000;0
2795;201075;49;0;0;0;0;.00nan;0;0
2795;174407;59;0;0;0;0;.00nan;0;0
2804;197940;49;70;28;2;26;.929;3600000;0
2804;178098;59;77;30;2;28;.933;3555000;0
2804;201075;49;0;0;0;0;.00nan;0;0
2804;174407;59;0;0;0;0;.00nan;0;0
2813;197940;49;87;29;2;27;.931;3600000;0
2813;178098;59;43;25;5;20;.800;3600000;0
2813;201075;49;0;0;0;0;.00nan;0;0
2813;174407;59;0;0;0;0;.00nan;0;0
2720;198736;3789;80;25;1;24;.960;3600000;0
2720;180990;744;76;44;4;40;.909;3600000;0
2720;207771;744;0;0;0;0;.00nan;0;0
2720;-1;3789;0;0;0;0;.00nan;0;0
2721;31165;752;49;45;6;39;.867;3600000;0
2721;180177;747;0;0;0;0;.00nan;0;0
2721;76405;747;73;27;2;25;.926;3600000;0
2721;149221;752;0;0;0;0;.00nan;0;0
2722;212999;2168;0;0;0;0;.00nan;0;0
2722;218546;748;0;0;0;0;.00nan;0;0
2722;-1;748;55;24;2;22;.917;3900000;0
2722;49935;2168;97;40;2;38;.950;3900000;0
2723;595;732;71;24;2;22;.917;3600000;0
2723;204272;737;0;0;0;0;.00nan;0;0
2723;201947;737;100;33;0;33;1.000;3600000;0
2723;87798;732;0;0;0;0;.00nan;0;0
2724;1957;1880;86;31;1;30;.968;3600000;0
2724;2643;738;59;31;4;27;.871;3600000;0
2724;209518;738;0;0;0;0;.00nan;0;0
2724;-1;1880;0;0;0;0;.00nan;0;0
2725;170547;764;81;29;2;27;.931;3600000;0
2725;206313;745;67;28;3;25;.893;3543000;0
2725;-1;764;0;0;0;0;.00nan;0;0
2725;152624;745;0;0;0;0;.00nan;0;0
2726;3435;739;44;22;4;18;.818;3600000;0
2726;211572;742;0;0;0;0;.00nan;0;0
2726;-1;739;0;0;0;0;.00nan;0;0
2726;148573;742;73;24;1;23;.958;3600000;0
2727;175764;734;0;0;0;0;.00nan;0;0
2727;207184;740;0;0;0;0;.00nan;0;0
2727;86151;740;60;32;3;29;.906;3636000;0
2727;148508;734;74;34;2;32;.941;3636000;0
2728;1061;751;0;0;0;0;.00nan;0;0
2728;164424;736;99;36;1;35;.972;3600000;0
2728;213298;736;0;0;0;0;.00nan;0;0
2728;148788;751;61;34;4;30;.882;3600000;0
2729;202516;743;0;0;0;0;.00nan;0;0
2729;223469;743;72;33;4;29;.879;3600000;0
2729;56565;741;64;39;5;34;.872;3554000;0
2729;82273;741;0;0;0;0;.00nan;0;0
2730;198736;3789;69;34;4;30;.882;3516000;0
2730;-1;3789;0;0;0;0;.00nan;0;0
2730;-1;749;0;0;0;0;.00nan;0;0
2730;85797;749;91;35;2;33;.943;3600000;0
2731;203977;729;0;0;0;0;.00nan;0;0
2731;211604;729;73;28;3;25;.893;3600000;0
2731;66245;733;0;0;0;0;.00nan;0;0
2731;148503;733;94;56;4;52;.929;3600000;0
2732;170547;764;95;42;1;41;.976;3600000;0
2732;180990;744;76;29;2;27;.931;3542000;0
2732;207771;744;0;0;0;0;.00nan;0;0
2732;-1;764;0;0;0;0;.00nan;0;0
2733;180177;747;0;0;0;0;.00nan;0;0
2733;212999;2168;0;0;0;0;.00nan;0;0
2733;49935;2168;66;31;3;28;.903;3588000;0
2733;76405;747;69;24;2;22;.917;3600000;0
2734;1061;751;0;0;0;0;.00nan;0;0
2734;2643;738;63;29;3;26;.897;3600000;0
2734;209518;738;0;0;0;0;.00nan;0;0
2734;148788;751;60;35;4;31;.886;3566000;0
2735;595;732;44;39;6;33;.846;3361000;0
2735;175764;734;70;31;3;28;.903;3600000;0
2735;87798;732;49;1;0;1;1.000;239000;0
2735;148508;734;0;0;0;0;.00nan;0;0
2736;1957;1880;70;33;3;30;.909;3582000;0
2736;206313;745;86;37;2;35;.946;3600000;0
2736;-1;1880;0;0;0;0;.00nan;0;0
2736;152624;745;0;0;0;0;.00nan;0;0
2737;204272;737;24;17;5;12;.706;2226000;0
2737;201947;737;58;13;1;12;.923;1312000;0
2737;207184;740;0;0;0;0;.00nan;0;0
2737;86151;740;46;28;4;24;.857;3600000;0
2738;3435;739;66;24;2;22;.917;3600000;0
2738;164424;736;52;35;4;31;.886;3600000;0
2738;213298;736;0;0;0;0;.00nan;0;0
2738;-1;739;0;0;0;0;.00nan;0;0
2739;202516;743;61;26;3;23;.885;3630000;0
2739;223469;743;0;0;0;0;.00nan;0;0
2739;218546;748;87;40;2;38;.950;3630000;0
2739;-1;748;0;0;0;0;.00nan;0;0
2740;198736;3789;57;46;6;40;.870;3600000;0
2740;-1;3789;0;0;0;0;.00nan;0;0
2740;56565;741;69;22;2;20;.909;3600000;0
2740;82273;741;0;0;0;0;.00nan;0;0
2741;595;732;83;32;2;30;.938;3600000;0
2741;180990;744;93;49;3;46;.939;3543000;0
2741;207771;744;0;0;0;0;.00nan;0;0
2741;87798;732;0;0;0;0;.00nan;0;0
2742;3435;739;70;24;2;22;.917;3892000;0
2742;175764;734;92;50;2;48;.960;3900000;0
2742;-1;739;0;0;0;0;.00nan;0;0
2742;148508;734;0;0;0;0;.00nan;0;0
2743;206313;745;0;0;0;0;.00nan;0;0
2743;218546;748;74;21;1;20;.952;3600000;0
2743;-1;748;0;0;0;0;.00nan;0;0
2743;152624;745;74;29;2;27;.931;3600000;0
2744;203977;729;0;0;0;0;.00nan;0;0
2744;170547;764;66;25;2;23;.920;3600000;0
2744;211604;729;32;27;5;22;.815;3600000;0
2744;-1;764;0;0;0;0;.00nan;0;0
2745;1957;1880;74;24;1;23;.958;3600000;0
2745;-1;1880;0;0;0;0;.00nan;0;0
2745;66245;733;66;28;2;26;.929;3549000;0
2745;148503;733;0;0;0;0;.00nan;0;0
2746;204272;737;70;34;3;31;.912;3521000;0
2746;211572;742;0;0;0;0;.00nan;0;0
2746;201947;737;0;0;0;0;.00nan;0;0
2746;148573;742;79;24;1;23;.958;3600000;0
2747;1061;751;53;30;4;26;.867;3600000;0
2747;207184;740;0;0;0;0;.00nan;0;0
2747;86151;740;99;43;1;42;.977;3600000;0
2747;148788;751;0;0;0;0;.00nan;0;0
2748;164424;736;97;42;1;41;.976;3900000;0
2748;213298;736;0;0;0;0;.00nan;0;0
2748;-1;749;0;0;0;0;.00nan;0;0
2748;85797;749;95;26;1;25;.962;3900000;0
2749;31165;752;0;0;0;0;.00nan;0;0
2749;202516;743;50;14;2;12;.857;3600000;0
2749;223469;743;0;0;0;0;.00nan;0;0
2749;149221;752;58;45;6;39;.867;3600000;0
2750;2643;738;55;33;5;28;.848;3600000;0
2750;209518;738;0;0;0;0;.00nan;0;0
2750;56565;741;68;30;2;28;.933;3600000;0
2750;82273;741;0;0;0;0;.00nan;0;0
2751;180177;747;57;20;2;18;.900;3545000;0
2751;212999;2168;0;0;0;0;.00nan;0;0
2751;49935;2168;84;33;1;32;.970;3600000;0
2751;76405;747;0;0;0;0;.00nan;0;0
2752;175764;734;39;29;5;24;.828;3600000;0
2752;180990;744;0;0;0;0;.00nan;0;0
2752;207771;744;100;25;0;25;1.000;3600000;0
2752;148508;734;0;0;0;0;.00nan;0;0
2753;1957;1880;98;35;1;34;.971;3600000;0
2753;203977;729;0;0;0;0;.00nan;0;0
2753;211604;729;75;26;2;24;.923;3596000;0
2753;-1;1880;0;0;0;0;.00nan;0;0
2754;3435;739;79;33;2;31;.939;3600000;0
2754;-1;739;0;0;0;0;.00nan;0;0
2754;66245;733;81;45;3;42;.933;3586000;0
2754;148503;733;0;0;0;0;.00nan;0;0
2755;198736;3789;98;44;2;42;.955;3562000;0
2755;211572;742;0;0;0;0;.00nan;0;0
2755;-1;3789;0;0;0;0;.00nan;0;0
2755;148573;742;100;31;0;31;1.000;3600000;0
2756;207184;740;0;0;0;0;.00nan;0;0
2756;75362;749;86;30;2;28;.933;3600000;0
2756;85797;749;0;0;0;0;.00nan;0;0
2756;86151;740;82;39;3;36;.923;3600000;0
2757;164424;736;90;38;2;36;.947;3583000;0
2757;170547;764;0;0;0;0;.00nan;0;0
2757;213298;736;0;0;0;0;.00nan;0;0
2757;-1;764;93;19;0;19;1.000;3600000;0
2758;31165;752;0;0;0;0;.00nan;0;0
2758;212999;2168;0;0;0;0;.00nan;0;0
2758;49935;2168;77;36;2;34;.944;3600000;0
2758;149221;752;57;31;4;27;.871;3600000;0
2759;595;732;63;16;1;15;.938;3600000;0
2759;2643;738;91;56;3;53;.946;3513000;0
2759;209518;738;0;0;0;0;.00nan;0;0
2759;87798;732;0;0;0;0;.00nan;0;0
2760;1061;751;0;0;0;0;.00nan;0;0
2760;206313;745;95;43;2;41;.953;3600000;0
2760;148788;751;91;31;1;30;.968;3600000;0
2760;152624;745;0;0;0;0;.00nan;0;0
2761;180177;747;0;0;0;0;.00nan;0;0
2761;202516;743;0;0;0;0;.00nan;0;0
2761;223469;743;58;25;3;22;.880;3515000;0
2761;76405;747;95;32;1;31;.969;3600000;0
2762;164424;736;70;13;0;13;1.000;1599000;0
2762;213298;736;29;30;6;24;.800;2001000;0
2762;56565;741;52;22;2;20;.909;3600000;0
2762;82273;741;0;0;0;0;.00nan;0;0
2763;198736;3789;36;13;3;10;.769;569000;0
2763;175764;734;0;0;0;0;.00nan;0;0
2763;-1;3789;38;12;3;9;.750;3031000;0
2763;148508;734;95;38;1;37;.974;3600000;0
2764;1061;751;0;0;0;0;.00nan;0;0
2764;31165;752;0;0;0;0;.00nan;0;0
2764;148788;751;81;43;4;39;.907;3782000;0
2764;149221;752;73;42;5;37;.881;3782000;0
2765;2643;738;68;25;2;23;.920;3574000;0
2765;209518;738;0;0;0;0;.00nan;0;0
2765;212999;2168;0;0;0;0;.00nan;0;0
2765;49935;2168;86;24;1;23;.958;3600000;0
2766;595;732;51;35;5;30;.857;3600000;0
2766;203977;729;70;21;1;20;.952;3600000;0
2766;211604;729;0;0;0;0;.00nan;0;0
2766;87798;732;0;0;0;0;.00nan;0;0
2767;211572;742;0;0;0;0;.00nan;0;0
2767;202516;743;0;0;0;0;.00nan;0;0
2767;223469;743;81;26;1;25;.962;3600000;0
2767;148573;742;64;30;3;27;.900;3553000;0
2768;218546;748;59;32;4;28;.875;3600000;0
2768;-1;748;0;0;0;0;.00nan;0;0
2768;56565;741;81;34;3;31;.912;3600000;0
2768;82273;741;0;0;0;0;.00nan;0;0
2769;3435;739;74;33;2;31;.939;3593000;0
2769;180990;744;0;0;0;0;.00nan;0;0
2769;207771;744;76;26;1;25;.962;3600000;0
2769;-1;739;0;0;0;0;.00nan;0;0
2770;203977;729;0;0;0;0;.00nan;0;0
2770;211604;729;73;10;0;10;1.000;3600000;0
2770;175764;734;77;30;2;28;.933;3571000;0
2770;148508;734;0;0;0;0;.00nan;0;0
2771;66245;733;100;32;0;32;1.000;3600000;0
2771;75362;749;0;0;0;0;.00nan;0;0
2771;85797;749;92;42;2;40;.952;3600000;0
2771;148503;733;0;0;0;0;.00nan;0;0
2772;1957;1880;72;33;2;31;.939;3900000;0
2772;207184;740;0;0;0;0;.00nan;0;0
2772;-1;1880;0;0;0;0;.00nan;0;0
2772;86151;740;78;32;2;30;.938;3900000;0
2773;170547;764;0;0;0;0;.00nan;0;0
2773;206313;745;66;38;5;33;.868;3761000;0
2773;-1;764;54;31;4;27;.871;3761000;0
2773;152624;745;0;0;0;0;.00nan;0;0
2774;595;732;100;43;0;43;1.000;3600000;0
2774;204272;737;51;24;3;21;.875;3600000;0
2774;201947;737;0;0;0;0;.00nan;0;0
2774;87798;732;0;0;0;0;.00nan;0;0
2775;2643;738;84;28;1;27;.964;3600000;0
2775;198736;3789;0;0;0;0;.00nan;0;0
2775;209518;738;0;0;0;0;.00nan;0;0
2775;-1;3789;59;41;5;36;.878;3600000;0
2776;1061;751;0;0;0;0;.00nan;0;0
2776;180177;747;85;39;2;37;.949;3600000;0
2776;76405;747;0;0;0;0;.00nan;0;0
2776;148788;751;55;40;5;35;.875;3600000;0
2777;31165;752;97;39;1;38;.974;3600000;0
2777;75362;749;0;0;0;0;.00nan;0;0
2777;85797;749;41;17;3;14;.824;3551000;0
2777;149221;752;0;0;0;0;.00nan;0;0
2778;206313;745;0;0;0;0;.00nan;0;0
2778;187118;745;92;48;3;45;.938;3600000;0
2778;56565;741;0;0;0;0;.00nan;0;0
2778;85670;741;59;14;1;13;.929;3600000;0
2779;175764;734;0;0;0;0;.00nan;0;0
2779;66245;733;79;39;3;36;.923;3751000;0
2779;148503;733;0;0;0;0;.00nan;0;0
2779;148508;734;69;31;4;27;.871;3751000;0
2780;184158;748;61;31;4;27;.871;3584000;0
2780;180990;744;79;30;2;28;.933;3600000;0
2780;207771;744;0;0;0;0;.00nan;0;0
2780;218546;748;0;0;0;0;.00nan;0;0
2781;3435;739;70;25;2;23;.920;3600000;0
2781;170547;764;89;42;3;39;.929;3554000;0
2781;-1;764;0;0;0;0;.00nan;0;0
2781;-1;739;0;0;0;0;.00nan;0;0
2782;164424;736;75;27;2;25;.926;3600000;0
2782;207184;740;0;0;0;0;.00nan;0;0
2782;213298;736;0;0;0;0;.00nan;0;0
2782;86151;740;33;20;4;16;.800;3541000;0
2783;163195;743;100;35;1;34;.971;3900000;0
2783;211572;742;0;0;0;0;.00nan;0;0
2783;223469;743;0;0;0;0;.00nan;0;0
2783;148573;742;97;38;1;37;.974;3900000;0
2784;1957;1880;97;47;2;45;.957;3560000;0
2784;2643;738;100;25;0;25;1.000;3600000;0
2784;209518;738;0;0;0;0;.00nan;0;0
2784;-1;1880;0;0;0;0;.00nan;0;0
2785;595;732;73;32;2;30;.938;3580000;0
2785;180177;747;0;0;0;0;.00nan;0;0
2785;76405;747;79;28;1;27;.964;3600000;0
2785;87798;732;0;0;0;0;.00nan;0;0
2786;211572;742;0;0;0;0;.00nan;0;0
2786;31165;752;0;0;0;0;.00nan;0;0
2786;148573;742;45;26;4;22;.846;3551000;0
2786;149221;752;69;33;3;30;.909;3600000;0
2787;180990;744;0;0;0;0;.00nan;0;0
2787;207771;744;85;27;1;26;.963;3900000;0
2787;66245;733;100;37;1;36;.973;3900000;0
2787;148503;733;0;0;0;0;.00nan;0;0
2788;212999;2168;0;0;0;0;.00nan;0;0
2788;49935;2168;92;40;1;39;.975;3900000;0
2788;75362;749;0;0;0;0;.00nan;0;0
2788;85797;749;82;25;1;24;.960;3900000;0
2789;198736;3789;50;21;3;18;.857;3544000;0
2789;207184;740;0;0;0;0;.00nan;0;0
2789;-1;3789;0;0;0;0;.00nan;0;0
2789;86151;740;77;34;2;32;.941;3600000;0
2790;203977;729;0;0;0;0;.00nan;0;0
2790;211604;729;79;30;1;29;.967;3590000;0
2790;175764;734;100;25;0;25;1.000;3600000;0
2790;148508;734;0;0;0;0;.00nan;0;0
2791;206313;745;0;0;0;0;.00nan;0;0
2791;187118;745;60;51;6;45;.882;3600000;0
2791;56565;741;0;0;0;0;.00nan;0;0
2791;85670;741;70;34;3;31;.912;3600000;0
2792;163195;743;91;32;2;30;.938;3600000;0
2792;170547;764;0;0;0;0;.00nan;0;0
2792;223469;743;0;0;0;0;.00nan;0;0
2792;-1;764;60;24;3;21;.875;3600000;0
2793;164424;736;55;23;3;20;.870;3644000;0
2793;204272;737;57;26;4;22;.846;3644000;0
2793;201947;737;0;0;0;0;.00nan;0;0
2793;213298;736;0;0;0;0;.00nan;0;0
2794;1957;1880;98;36;2;34;.944;3567000;0
2794;180177;747;0;0;0;0;.00nan;0;0
2794;-1;1880;0;0;0;0;.00nan;0;0
2794;76405;747;88;25;1;24;.960;3600000;0
2795;164424;736;55;33;4;29;.879;3600000;0
2795;180990;744;85;25;1;24;.960;3600000;0
2795;207771;744;0;0;0;0;.00nan;0;0
2795;213298;736;0;0;0;0;.00nan;0;0
2796;211572;742;0;0;0;0;.00nan;0;0
2796;212999;2168;0;0;0;0;.00nan;0;0
2796;49935;2168;81;38;3;35;.921;3546000;0
2796;148573;742;100;39;2;37;.949;3600000;0
2797;198736;3789;82;53;5;48;.906;3600000;0
2797;203977;729;0;0;0;0;.00nan;0;0
2797;211604;729;71;29;2;27;.931;3600000;0
2797;-1;3789;0;0;0;0;.00nan;0;0
2798;2643;738;53;26;4;22;.846;3600000;0
2798;209518;738;0;0;0;0;.00nan;0;0
2798;207184;740;0;0;0;0;.00nan;0;0
2798;86151;740;100;31;0;31;1.000;3600000;0
2799;163195;743;84;17;0;17;1.000;3600000;0
2799;223469;743;0;0;0;0;.00nan;0;0
2799;56565;741;0;0;0;0;.00nan;0;0
2799;85670;741;59;33;4;29;.879;3600000;0
2800;184158;748;88;16;0;16;1.000;3600000;0
2800;218546;748;0;0;0;0;.00nan;0;0
2800;66245;733;81;48;4;44;.917;3600000;0
2800;148503;733;0;0;0;0;.00nan;0;0
2801;595;732;58;29;3;26;.897;3600000;0
2801;204272;737;28;15;4;11;.733;949000;0
2801;201947;737;56;27;3;24;.889;2651000;0
2801;87798;732;0;0;0;0;.00nan;0;0
2802;170547;764;38;29;6;23;.793;2321000;0
2802;206313;745;0;0;0;0;.00nan;0;0
2802;187118;745;66;28;3;25;.893;3600000;0
2802;-1;764;64;18;2;16;.889;1279000;0
2803;1061;751;0;0;0;0;.00nan;0;0
2803;175764;734;70;30;2;28;.933;3900000;0
2803;148508;734;0;0;0;0;.00nan;0;0
2803;148788;751;97;43;2;41;.953;3900000;0
2804;3435;739;0;0;0;0;.00nan;0;0
2804;203977;729;0;0;0;0;.00nan;0;0
2804;211604;729;63;31;4;27;.871;3670000;0
2804;-1;739;58;25;3;22;.880;3670000;0
2805;163195;743;88;29;1;28;.966;3600000;0
2805;223469;743;0;0;0;0;.00nan;0;0
2805;56565;741;0;0;0;0;.00nan;0;0
2805;85670;741;43;35;5;30;.857;3600000;0
2806;164424;736;77;25;1;24;.960;3600000;0
2806;213298;736;0;0;0;0;.00nan;0;0
2806;66245;733;0;0;0;0;.00nan;0;0
2806;148503;733;46;28;4;24;.857;3600000;0
2807;184158;748;29;20;5;15;.750;3600000;0
2807;211572;742;0;0;0;0;.00nan;0;0
2807;218546;748;0;0;0;0;.00nan;0;0
2807;148573;742;80;33;2;31;.939;3600000;0
2808;1957;1880;94;39;2;37;.949;3900000;0
2808;204272;737;71;24;2;22;.917;3900000;0
2808;201947;737;0;0;0;0;.00nan;0;0
2808;-1;1880;0;0;0;0;.00nan;0;0
2809;1061;751;82;29;1;28;.966;3600000;0
2809;2643;738;62;39;3;36;.923;3575000;0
2809;209518;738;0;0;0;0;.00nan;0;0
2809;148788;751;0;0;0;0;.00nan;0;0
2810;198736;3789;87;30;1;29;.967;3600000;0
2810;206313;745;0;0;0;0;.00nan;0;0
2810;187118;745;53;25;3;22;.880;3549000;0
2810;-1;3789;0;0;0;0;.00nan;0;0
2811;31165;752;0;0;0;0;.00nan;0;0
2811;180177;747;67;18;1;17;.944;3600000;0
2811;76405;747;0;0;0;0;.00nan;0;0
2811;149221;752;63;38;5;33;.868;3600000;0
2812;595;732;50;31;4;27;.871;3566000;0
2812;170547;764;0;0;0;0;.00nan;0;0
2812;-1;764;67;22;2;20;.909;3600000;0
2812;87798;732;0;0;0;0;.00nan;0;0
2813;207184;740;0;0;0;0;.00nan;0;0
2813;212999;2168;0;0;0;0;.00nan;0;0
2813;49935;2168;85;31;1;30;.968;3600000;0
2813;86151;740;71;33;3;30;.909;3557000;0
2814;175764;734;62;22;2;20;.909;3600000;0
2814;75362;749;56;29;4;25;.862;3584000;0
2814;85797;749;0;0;0;0;.00nan;0;0
2814;148508;734;0;0;0;0;.00nan;0;0
2815;3435;739;74;29;2;27;.931;3600000;0
2815;164424;736;50;28;4;24;.857;3563000;0
2815;213298;736;0;0;0;0;.00nan;0;0
2815;-1;739;0;0;0;0;.00nan;0;0
2816;163195;743;77;34;3;31;.912;3556000;0
2816;184158;748;95;34;2;32;.941;3600000;0
2816;223469;743;0;0;0;0;.00nan;0;0
2816;218546;748;0;0;0;0;.00nan;0;0
2817;204272;737;0;0;0;0;.00nan;0;0
2817;201947;737;74;37;3;34;.919;3563000;0
2817;56565;741;0;0;0;0;.00nan;0;0
2817;85670;741;88;31;1;30;.968;3600000;0
2818;1061;751;0;0;0;0;.00nan;0;0
2818;1957;1880;76;42;4;38;.905;3554000;0
2818;-1;1880;0;0;0;0;.00nan;0;0
2818;148788;751;48;19;3;16;.842;3600000;0
2819;206313;745;0;0;0;0;.00nan;0;0
2819;175764;734;74;26;1;25;.962;3600000;0
2819;187118;745;90;40;2;38;.950;3595000;0
2819;148508;734;0;0;0;0;.00nan;0;0
2820;198736;3789;60;31;4;27;.871;3600000;0
2820;203977;729;84;30;1;29;.967;3600000;0
2820;211604;729;0;0;0;0;.00nan;0;0
2820;-1;3789;0;0;0;0;.00nan;0;0
2821;211572;742;0;0;0;0;.00nan;0;0
2821;31165;752;0;0;0;0;.00nan;0;0
2821;148573;742;72;20;1;19;.950;3600000;0
2821;149221;752;90;36;2;34;.944;3600000;0
2822;180177;747;96;44;3;41;.932;3689000;0
2822;212999;2168;0;0;0;0;.00nan;0;0
2822;49935;2168;45;22;4;18;.818;3689000;0
2822;76405;747;0;0;0;0;.00nan;0;0
2823;170547;764;56;34;4;30;.882;3517000;0
2823;207184;740;0;0;0;0;.00nan;0;0
2823;-1;764;0;0;0;0;.00nan;0;0
2823;86151;740;79;37;2;35;.946;3600000;0
2824;2643;738;82;35;2;33;.943;3600000;0
2824;209518;738;0;0;0;0;.00nan;0;0
2824;75362;749;0;0;0;0;.00nan;0;0
2824;85797;749;84;39;3;36;.923;3526000;0
2825;184158;748;83;25;1;24;.960;3600000;0
2825;180990;744;48;32;5;27;.844;3600000;0
2825;207771;744;0;0;0;0;.00nan;0;0
2825;218546;748;0;0;0;0;.00nan;0;0
2826;3435;739;52;9;1;8;.889;3600000;0
2826;-1;739;0;0;0;0;.00nan;0;0
2826;66245;733;85;38;2;36;.947;3591000;0
2826;148503;733;0;0;0;0;.00nan;0;0
2827;170547;764;0;0;0;0;.00nan;0;0
2827;206313;745;0;0;0;0;.00nan;0;0
2827;187118;745;99;20;0;20;1.000;3600000;0
2827;-1;764;36;26;4;22;.846;3600000;0
2828;203977;729;0;0;0;0;.00nan;0;0
2828;211604;729;83;28;1;27;.964;3822000;0
2828;56565;741;0;0;0;0;.00nan;0;0
2828;85670;741;100;23;0;23;1.000;3822000;0
2829;211572;742;0;0;0;0;.00nan;0;0
2829;212999;2168;0;0;0;0;.00nan;0;0
2829;49935;2168;84;33;2;31;.939;3600000;0
2829;148573;742;71;35;3;32;.914;3554000;0
2830;2643;738;59;27;3;24;.889;3900000;0
2830;209518;738;0;0;0;0;.00nan;0;0
2830;180177;747;0;0;0;0;.00nan;0;0
2830;76405;747;58;25;3;22;.880;3900000;0
2831;1957;1880;70;28;2;26;.929;3600000;0
2831;-1;1880;0;0;0;0;.00nan;0;0
2831;75362;749;73;35;3;32;.914;3581000;0
2831;85797;749;0;0;0;0;.00nan;0;0
2832;163195;743;65;24;2;22;.917;3600000;0
2832;31165;752;0;0;0;0;.00nan;0;0
2832;223469;743;0;0;0;0;.00nan;0;0
2832;149221;752;42;38;7;31;.816;3600000;0
2833;198736;3789;100;37;0;37;1.000;3655000;0
2833;204272;737;86;25;1;24;.960;3655000;0
2833;201947;737;0;0;0;0;.00nan;0;0
2833;-1;3789;0;0;0;0;.00nan;0;0
2834;3435;739;86;29;1;28;.966;3600000;0
2834;180990;744;72;32;3;29;.906;3587000;0
2834;207771;744;0;0;0;0;.00nan;0;0
2834;-1;739;0;0;0;0;.00nan;0;0
2835;595;732;49;15;2;13;.867;3900000;0
2835;207184;740;0;0;0;0;.00nan;0;0
2835;86151;740;95;43;2;41;.953;3900000;0
2835;87798;732;0;0;0;0;.00nan;0;0
2836;164424;736;56;25;3;22;.880;3600000;0
2836;213298;736;0;0;0;0;.00nan;0;0
2836;66245;733;86;33;2;31;.939;3600000;0
2836;148503;733;0;0;0;0;.00nan;0;0
2837;175764;734;0;0;0;0;.00nan;0;0
2837;56565;741;0;0;0;0;.00nan;0;0
2837;85670;741;100;25;0;25;1.000;3600000;0
2837;148508;734;93;50;3;47;.940;3600000;0
2838;163195;743;85;18;0;18;1.000;3600000;0
2838;203977;729;0;0;0;0;.00nan;0;0
2838;211604;729;98;46;2;44;.957;3578000;0
2838;223469;743;0;0;0;0;.00nan;0;0
2839;1061;751;0;0;0;0;.00nan;0;0
2839;211572;742;97;27;0;27;1.000;3600000;0
2839;148573;742;0;0;0;0;.00nan;0;0
2839;148788;751;63;33;3;30;.909;3600000;0
2840;1957;1880;67;36;4;32;.889;3555000;0
2840;180177;747;69;28;3;25;.893;3600000;0
2840;-1;1880;0;0;0;0;.00nan;0;0
2840;76405;747;0;0;0;0;.00nan;0;0
2841;184158;748;63;21;2;19;.905;3600000;0
2841;170547;764;51;24;4;20;.833;3590000;0
2841;218546;748;0;0;0;0;.00nan;0;0
2841;-1;764;0;0;0;0;.00nan;0;0
2842;212999;2168;0;0;0;0;.00nan;0;0
2842;49935;2168;84;35;2;33;.943;3600000;0
2842;75362;749;0;0;0;0;.00nan;0;0
2842;85797;749;67;42;4;38;.905;3515000;0
2843;204272;737;83;24;1;23;.958;3900000;0
2843;201947;737;0;0;0;0;.00nan;0;0
2843;207184;740;0;0;0;0;.00nan;0;0
2843;86151;740;87;25;1;24;.960;3900000;0
2844;595;732;54;39;6;33;.846;3600000;0
2844;198736;3789;100;36;0;36;1.000;3600000;0
2844;-1;3789;0;0;0;0;.00nan;0;0
2844;87798;732;0;0;0;0;.00nan;0;0
2845;180990;744;97;24;0;24;1.000;3600000;0
2845;207771;744;0;0;0;0;.00nan;0;0
2845;66245;733;0;0;0;0;.00nan;0;0
2845;148503;733;83;30;2;28;.933;3600000;0
2846;164424;736;97;45;1;44;.978;3600000;0
2846;206313;745;0;0;0;0;.00nan;0;0
2846;187118;745;69;26;2;24;.923;3545000;0
2846;213298;736;0;0;0;0;.00nan;0;0
2847;2643;738;100;29;0;29;1.000;3600000;0
2847;209518;738;0;0;0;0;.00nan;0;0
2847;31165;752;0;0;0;0;.00nan;0;0
2847;149221;752;58;31;4;27;.871;3600000;0
2848;1061;751;0;0;0;0;.00nan;0;0
2848;175764;734;94;40;2;38;.950;3535000;0
2848;148508;734;0;0;0;0;.00nan;0;0
2848;148788;751;99;29;0;29;1.000;3600000;0
2849;184158;748;90;19;0;19;1.000;3600000;0
2849;218546;748;0;0;0;0;.00nan;0;0
2849;56565;741;0;0;0;0;.00nan;0;0
2849;85670;741;94;44;2;42;.955;3515000;0
2850;180177;747;0;0;0;0;.00nan;0;0
2850;212999;2168;0;0;0;0;.00nan;0;0
2850;49935;2168;100;38;0;38;1.000;3600000;0
2850;76405;747;53;29;4;25;.862;3600000;0
2851;203977;729;0;0;0;0;.00nan;0;0
2851;204272;737;0;0;0;0;.00nan;0;0
2851;211604;729;76;32;2;30;.938;3600000;0
2851;201947;737;91;33;1;32;.970;3600000;0
2852;3435;739;64;20;2;18;.900;3600000;0
2852;206313;745;0;0;0;0;.00nan;0;0
2852;187118;745;81;58;4;54;.931;3600000;0
2852;-1;739;0;0;0;0;.00nan;0;0
2853;595;732;56;17;2;15;.882;3600000;0
2853;66245;733;75;54;5;49;.907;3600000;0
2853;87798;732;0;0;0;0;.00nan;0;0
2853;148503;733;0;0;0;0;.00nan;0;0
2854;170547;764;0;0;0;0;.00nan;0;0
2854;211572;742;37;33;6;27;.818;3600000;0
2854;-1;764;100;28;0;28;1.000;3600000;0
2854;148573;742;0;0;0;0;.00nan;0;0
2855;163195;743;74;30;2;28;.933;3600000;0
2855;223469;743;0;0;0;0;.00nan;0;0
2855;75362;749;66;34;4;30;.882;3515000;0
2855;85797;749;0;0;0;0;.00nan;0;0
2856;1061;751;0;0;0;0;.00nan;0;0
2856;180990;744;0;0;0;0;.00nan;0;0
2856;207771;744;69;28;2;26;.929;3600000;0
2856;148788;751;66;36;4;32;.889;3515000;0
2857;175764;734;89;16;0;16;1.000;3600000;0
2857;31165;752;0;0;0;0;.00nan;0;0
2857;148508;734;0;0;0;0;.00nan;0;0
2857;149221;752;84;42;3;39;.929;3600000;0
2858;198736;3789;100;26;0;26;1.000;3600000;0
2858;164424;736;49;32;5;27;.844;3600000;0
2858;213298;736;0;0;0;0;.00nan;0;0
2858;-1;3789;0;0;0;0;.00nan;0;0
2859;3435;739;70;28;2;26;.929;3600000;0
2859;212999;2168;0;0;0;0;.00nan;0;0
2859;-1;739;0;0;0;0;.00nan;0;0
2859;49935;2168;66;35;4;31;.886;3574000;0
2860;2643;738;65;35;4;31;.886;3900000;0
2860;209518;738;0;0;0;0;.00nan;0;0
2860;175764;734;57;26;4;22;.846;3900000;0
2860;148508;734;0;0;0;0;.00nan;0;0
2861;184158;748;52;25;3;22;.880;3580000;0
2861;206313;745;88;32;1;31;.969;3600000;0
2861;187118;745;0;0;0;0;.00nan;0;0
2861;218546;748;0;0;0;0;.00nan;0;0
2862;211572;742;0;0;0;0;.00nan;0;0
2862;56565;741;0;0;0;0;.00nan;0;0
2862;85670;741;100;34;0;34;1.000;3600000;0
2862;148573;742;92;41;1;40;.976;3600000;0
2863;595;732;0;0;0;0;.00nan;0;0
2863;1957;1880;77;30;2;28;.933;3600000;0
2863;-1;1880;0;0;0;0;.00nan;0;0
2863;87798;732;83;27;1;26;.963;3600000;0
2864;203977;729;0;0;0;0;.00nan;0;0
2864;211604;729;94;33;1;32;.970;3900000;0
2864;207184;740;0;0;0;0;.00nan;0;0
2864;86151;740;83;33;1;32;.970;3900000;0
2865;170547;764;86;36;2;34;.944;3600000;0
2865;180177;747;37;34;7;27;.794;3600000;0
2865;-1;764;0;0;0;0;.00nan;0;0
2865;76405;747;0;0;0;0;.00nan;0;0
2866;204272;737;0;0;0;0;.00nan;0;0
2866;201947;737;56;28;3;25;.893;3539000;0
2866;180990;744;86;33;1;32;.970;3600000;0
2866;207771;744;0;0;0;0;.00nan;0;0
2867;31165;752;0;0;0;0;.00nan;0;0
2867;66245;733;64;30;3;27;.900;3585000;0
2867;148503;733;0;0;0;0;.00nan;0;0
2867;149221;752;87;37;2;35;.946;3600000;0
2868;1061;751;0;0;0;0;.00nan;0;0
2868;163195;743;100;23;0;23;1.000;3600000;0
2868;223469;743;0;0;0;0;.00nan;0;0
2868;148788;751;92;52;4;48;.923;3600000;0
2869;198736;3789;65;31;3;28;.903;3543000;0
2869;212999;2168;0;0;0;0;.00nan;0;0
2869;-1;3789;0;0;0;0;.00nan;0;0
2869;49935;2168;94;40;2;38;.950;3600000;0
2870;1957;1880;69;35;3;32;.914;3600000;0
2870;3435;739;100;19;0;19;1.000;3600000;0
2870;-1;739;0;0;0;0;.00nan;0;0
2870;-1;1880;0;0;0;0;.00nan;0;0
2871;2643;738;89;26;2;24;.923;3600000;0
2871;203977;729;50;3;0;3;1.000;528000;0
2871;209518;738;0;0;0;0;.00nan;0;0
2871;211604;729;45;23;4;19;.826;3019000;0
2872;211572;742;0;0;0;0;.00nan;0;0
2872;56565;741;0;0;0;0;.00nan;0;0
2872;85670;741;55;18;2;16;.889;3600000;0
2872;148573;742;58;30;4;26;.867;3570000;0
2873;180177;747;0;0;0;0;.00nan;0;0
2873;207184;740;0;0;0;0;.00nan;0;0
2873;76405;747;54;28;4;24;.857;3600000;0
2873;86151;740;58;38;5;33;.868;3600000;0
2874;184158;748;80;39;3;36;.923;3600000;0
2874;170547;764;0;0;0;0;.00nan;0;0
2874;218546;748;0;0;0;0;.00nan;0;0
2874;-1;764;36;38;7;31;.816;3600000;0
2875;164424;736;100;38;0;38;1.000;3600000;0
2875;175764;734;60;34;4;30;.882;3600000;0
2875;213298;736;0;0;0;0;.00nan;0;0
2875;148508;734;0;0;0;0;.00nan;0;0
2876;31165;752;0;0;0;0;.00nan;0;0
2876;180990;744;100;26;0;26;1.000;3600000;0
2876;207771;744;0;0;0;0;.00nan;0;0
2876;149221;752;62;36;4;32;.889;3600000;0
2877;175764;734;0;0;0;0;.00nan;0;0
2877;66245;733;93;53;3;50;.943;3600000;0
2877;148503;733;0;0;0;0;.00nan;0;0
2877;148508;734;56;29;4;25;.862;3539000;0
2878;595;732;68;31;3;28;.903;3550000;0
2878;204272;737;0;0;0;0;.00nan;0;0
2878;201947;737;93;35;2;33;.943;3600000;0
2878;87798;732;0;0;0;0;.00nan;0;0
2879;206313;745;0;0;0;0;.00nan;0;0
2879;187118;745;100;35;0;35;1.000;3600000;0
2879;75362;749;93;40;2;38;.950;3541000;0
2879;85797;749;0;0;0;0;.00nan;0;0
2880;1957;1880;100;38;0;38;1.000;3600000;0
2880;198736;3789;0;0;0;0;.00nan;0;0
2880;-1;3789;49;30;4;26;.867;3600000;0
2880;-1;1880;0;0;0;0;.00nan;0;0
2881;3435;739;64;25;2;23;.920;3600000;0
2881;203977;729;0;0;0;0;.00nan;0;0
2881;211604;729;91;49;3;46;.939;3543000;0
2881;-1;739;0;0;0;0;.00nan;0;0
2882;184158;748;90;36;2;34;.944;3900000;0
2882;218546;748;0;0;0;0;.00nan;0;0
2882;56565;741;0;0;0;0;.00nan;0;0
2882;85670;741;79;33;2;31;.939;3900000;0
2883;163195;743;81;27;1;26;.963;3600000;0
2883;180177;747;45;34;5;29;.853;3600000;0
2883;223469;743;0;0;0;0;.00nan;0;0
2883;76405;747;0;0;0;0;.00nan;0;0
2884;164424;736;45;24;4;20;.833;3591000;0
2884;212999;2168;0;0;0;0;.00nan;0;0
2884;213298;736;0;0;0;0;.00nan;0;0
2884;49935;2168;68;31;3;28;.903;3600000;0
2885;206313;745;0;0;0;0;.00nan;0;0
2885;187118;745;58;27;4;23;.852;3560000;0
2885;75362;749;0;0;0;0;.00nan;0;0
2885;85797;749;96;43;2;41;.953;3600000;0
2886;170547;764;87;31;1;30;.968;3600000;0
2886;31165;752;62;27;3;24;.889;3518000;0
2886;-1;764;0;0;0;0;.00nan;0;0
2886;149221;752;0;0;0;0;.00nan;0;0
2887;2643;738;68;34;3;31;.912;3514000;0
2887;209518;738;0;0;0;0;.00nan;0;0
2887;66245;733;88;33;1;32;.970;3600000;0
2887;148503;733;0;0;0;0;.00nan;0;0
2888;175764;734;100;32;0;32;1.000;3600000;0
2888;207184;740;0;0;0;0;.00nan;0;0
2888;86151;740;84;31;1;30;.968;3544000;0
2888;148508;734;0;0;0;0;.00nan;0;0
2889;595;732;66;34;4;30;.882;3900000;0
2889;204272;737;0;0;0;0;.00nan;0;0
2889;201947;737;67;33;4;29;.879;3900000;0
2889;87798;732;0;0;0;0;.00nan;0;0
2890;1061;751;0;0;0;0;.00nan;0;0
2890;206313;745;0;0;0;0;.00nan;0;0
2890;187118;745;77;34;3;31;.912;3567000;0
2890;148788;751;81;28;2;26;.929;3600000;0
2891;184158;748;76;37;3;34;.919;3600000;0
2891;218546;748;0;0;0;0;.00nan;0;0
2891;56565;741;27;23;5;18;.783;3540000;0
2891;85670;741;0;0;0;0;.00nan;0;0
2892;163195;743;66;26;3;23;.885;3600000;0
2892;211572;742;0;0;0;0;.00nan;0;0
2892;223469;743;0;0;0;0;.00nan;0;0
2892;148573;742;96;49;4;45;.918;3557000;0
2893;180990;744;88;38;3;35;.921;3566000;0
2893;207771;744;0;0;0;0;.00nan;0;0
2893;75362;749;0;0;0;0;.00nan;0;0
2893;85797;749;90;29;1;28;.966;3600000;0
2894;170547;764;0;0;0;0;.00nan;0;0
2894;212999;2168;0;0;0;0;.00nan;0;0
2894;-1;764;96;29;0;29;1.000;3900000;0
2894;49935;2168;100;36;0;36;1.000;3900000;0
2895;2643;738;74;31;3;28;.903;3515000;0
2895;204272;737;0;0;0;0;.00nan;0;0
2895;209518;738;0;0;0;0;.00nan;0;0
2895;201947;737;96;32;1;31;.969;3600000;0
2896;203977;729;39;32;5;27;.844;3558000;0
2896;211604;729;0;0;0;0;.00nan;0;0
2896;66245;733;59;24;3;21;.875;3600000;0
2896;148503;733;0;0;0;0;.00nan;0;0
2897;1957;1880;32;31;6;25;.806;3547000;0
2897;175764;734;55;40;5;35;.875;3600000;0
2897;-1;1880;0;0;0;0;.00nan;0;0
2897;148508;734;0;0;0;0;.00nan;0;0
2898;595;732;83;29;2;27;.931;3600000;0
2898;198736;3789;68;35;3;32;.914;3600000;0
2898;-1;3789;0;0;0;0;.00nan;0;0
2898;87798;732;0;0;0;0;.00nan;0;0
2899;164424;736;82;32;2;30;.938;3555000;0
2899;207184;740;0;0;0;0;.00nan;0;0
2899;213298;736;0;0;0;0;.00nan;0;0
2899;86151;740;99;40;1;39;.975;3600000;0
2900;1061;751;0;0;0;0;.00nan;0;0
2900;206313;745;0;0;0;0;.00nan;0;0
2900;187118;745;80;43;4;39;.907;3592000;0
2900;148788;751;71;29;2;27;.931;3600000;0
2901;163195;743;93;24;0;24;1.000;3600000;0
2901;184158;748;89;29;1;28;.966;3600000;0
2901;223469;743;0;0;0;0;.00nan;0;0
2901;218546;748;0;0;0;0;.00nan;0;0
2902;180990;744;84;32;2;30;.938;3600000;0
2902;207771;744;0;0;0;0;.00nan;0;0
2902;75362;749;69;30;4;26;.867;3568000;0
2902;85797;749;0;0;0;0;.00nan;0;0
2903;31165;752;0;0;0;0;.00nan;0;0
2903;56565;741;0;0;0;0;.00nan;0;0
2903;85670;741;60;21;2;19;.905;3600000;0
2903;149221;752;68;39;3;36;.923;3581000;0
2904;2643;738;90;32;2;30;.938;3552000;0
2904;209518;738;0;0;0;0;.00nan;0;0
2904;212999;2168;0;0;0;0;.00nan;0;0
2904;49935;2168;83;32;1;31;.969;3600000;0
2905;204272;737;64;39;4;35;.897;3600000;0
2905;201947;737;0;0;0;0;.00nan;0;0
2905;66245;733;72;21;1;20;.952;3600000;0
2905;148503;733;0;0;0;0;.00nan;0;0
2906;3435;739;31;34;6;28;.824;3600000;0
2906;175764;734;76;39;3;36;.923;3600000;0
2906;-1;739;0;0;0;0;.00nan;0;0
2906;148508;734;0;0;0;0;.00nan;0;0
2907;164424;736;93;28;1;27;.964;3900000;0
2907;211572;742;0;0;0;0;.00nan;0;0
2907;213298;736;0;0;0;0;.00nan;0;0
2907;148573;742;93;28;1;27;.964;3900000;0
2908;170547;764;65;41;4;37;.902;3600000;0
2908;180177;747;0;0;0;0;.00nan;0;0
2908;-1;764;0;0;0;0;.00nan;0;0
2908;76405;747;72;22;1;21;.955;3600000;0
2909;1957;1880;0;0;0;0;.00nan;0;0
2909;203977;729;0;0;0;0;.00nan;0;0
2909;211604;729;66;25;2;23;.920;3593000;0
2909;-1;1880;96;43;1;42;.977;3600000;0
2910;198736;3789;50;20;3;17;.850;3559000;0
2910;207184;740;0;0;0;0;.00nan;0;0
2910;-1;3789;0;0;0;0;.00nan;0;0
2910;86151;740;100;36;1;35;.972;3600000;0
2911;1061;751;0;0;0;0;.00nan;0;0
2911;180990;744;51;39;6;33;.846;2909000;0
2911;207771;744;64;10;0;10;1.000;691000;0
2911;148788;751;98;15;0;15;1.000;3600000;0
2912;595;732;47;36;5;31;.861;3578000;0
2912;211572;742;65;30;3;27;.900;3600000;0
2912;87798;732;0;0;0;0;.00nan;0;0
2912;148573;742;0;0;0;0;.00nan;0;0
2913;2643;738;92;33;1;32;.970;3556000;0
2913;209518;738;0;0;0;0;.00nan;0;0
2913;31165;752;100;37;0;37;1.000;3600000;0
2913;149221;752;0;0;0;0;.00nan;0;0
2914;203977;729;0;0;0;0;.00nan;0;0
2914;211604;729;76;29;2;27;.931;3600000;0
2914;212999;2168;0;0;0;0;.00nan;0;0
2914;49935;2168;75;40;3;37;.925;3573000;0
2915;180177;747;0;0;0;0;.00nan;0;0
2915;56565;741;0;0;0;0;.00nan;0;0
2915;76405;747;96;21;0;21;1.000;3600000;0
2915;85670;741;88;27;1;26;.963;3544000;0
2916;164424;736;64;33;4;29;.879;3722000;0
2916;184158;748;50;24;3;21;.875;3722000;0
2916;213298;736;0;0;0;0;.00nan;0;0
2916;218546;748;0;0;0;0;.00nan;0;0
2917;1957;1880;78;45;4;41;.911;3600000;0
2917;3435;739;80;27;1;26;.963;3600000;0
2917;-1;739;0;0;0;0;.00nan;0;0
2917;-1;1880;0;0;0;0;.00nan;0;0
2918;163195;743;67;25;3;22;.880;3900000;0
2918;170547;764;0;0;0;0;.00nan;0;0
2918;223469;743;0;0;0;0;.00nan;0;0
2918;-1;764;68;34;3;31;.912;3900000;0
2919;595;732;74;43;4;39;.907;3600000;0
2919;198736;3789;0;0;0;0;.00nan;0;0
2919;87798;732;0;0;0;0;.00nan;0;0
2919;143301;3789;72;20;1;19;.950;3600000;0
2920;1061;751;0;0;0;0;.00nan;0;0
2920;180990;744;63;45;5;40;.889;3600000;0
2920;207771;744;0;0;0;0;.00nan;0;0
2920;148788;751;90;32;2;30;.938;3600000;0
2921;211572;742;0;0;0;0;.00nan;0;0
2921;175764;734;70;41;3;38;.927;3837000;0
2921;148508;734;0;0;0;0;.00nan;0;0
2921;148573;742;64;35;4;31;.886;3837000;0
2922;206313;745;0;0;0;0;.00nan;0;0
2922;187118;745;54;25;3;22;.880;3900000;0
2922;75362;749;0;0;0;0;.00nan;0;0
2922;85797;749;78;38;3;35;.921;3900000;0
2923;207184;740;0;0;0;0;.00nan;0;0
2923;66245;733;0;0;0;0;.00nan;0;0
2923;86151;740;52;28;3;25;.893;3900000;0
2923;148503;733;97;46;3;43;.935;3900000;0
2924;203977;729;0;0;0;0;.00nan;0;0
2924;211604;729;67;25;2;23;.920;3600000;0
2924;31165;752;64;33;3;30;.909;3551000;0
2924;149221;752;0;0;0;0;.00nan;0;0
2925;212999;2168;0;0;0;0;.00nan;0;0
2925;49935;2168;60;31;3;28;.903;3600000;0
2925;56565;741;0;0;0;0;.00nan;0;0
2925;85670;741;91;34;1;33;.971;3600000;0
2926;3435;739;90;31;1;30;.968;3600000;0
2926;184158;748;71;32;3;29;.906;3529000;0
2926;218546;748;0;0;0;0;.00nan;0;0
2926;-1;739;0;0;0;0;.00nan;0;0
2927;163195;743;56;16;2;14;.875;3600000;0
2927;164424;736;80;38;3;35;.921;3581000;0
2927;223469;743;0;0;0;0;.00nan;0;0
2927;213298;736;0;0;0;0;.00nan;0;0
2928;198736;3789;0;0;0;0;.00nan;0;0
2928;175764;734;95;36;0;36;1.000;3900000;0
2928;143301;3789;100;29;0;29;1.000;3900000;0
2928;148508;734;0;0;0;0;.00nan;0;0
2929;2643;738;84;37;3;34;.919;3600000;0
2929;209518;738;0;0;0;0;.00nan;0;0
2929;180177;747;0;0;0;0;.00nan;0;0
2929;76405;747;97;26;0;26;1.000;3600000;0
2930;206313;745;0;0;0;0;.00nan;0;0
2930;211572;742;0;0;0;0;.00nan;0;0
2930;187118;745;57;28;3;25;.893;3530000;0
2930;148573;742;94;35;1;34;.971;3600000;0
2931;204272;737;0;0;0;0;.00nan;0;0
2931;66245;733;57;29;4;25;.862;3565000;0
2931;78573;737;58;20;2;18;.900;3600000;0
2931;148503;733;0;0;0;0;.00nan;0;0
2932;1957;1880;87;16;0;16;1.000;3600000;0
2932;-1;1880;0;0;0;0;.00nan;0;0
2932;75362;749;72;28;2;26;.929;3576000;0
2932;85797;749;0;0;0;0;.00nan;0;0
2933;595;732;0;0;0;0;.00nan;0;0
2933;207184;740;0;0;0;0;.00nan;0;0
2933;86151;740;84;35;2;33;.943;3553000;0
2933;87798;732;95;20;0;20;1.000;3600000;0
2934;1061;751;0;0;0;0;.00nan;0;0
2934;170547;764;43;18;4;14;.778;3600000;0
2934;-1;764;0;0;0;0;.00nan;0;0
2934;148788;751;32;25;6;19;.760;3593000;0
2935;163195;743;65;25;2;23;.920;3600000;0
2935;223469;743;0;0;0;0;.00nan;0;0
2935;56565;741;0;0;0;0;.00nan;0;0
2935;85670;741;93;42;3;39;.929;3593000;0
2936;2643;738;55;34;4;30;.882;3600000;0
2936;204272;737;0;0;0;0;.00nan;0;0
2936;209518;738;0;0;0;0;.00nan;0;0
2936;78573;737;86;24;1;23;.958;3600000;0
2937;206313;745;0;0;0;0;.00nan;0;0
2937;212999;2168;0;0;0;0;.00nan;0;0
2937;187118;745;76;29;2;27;.931;3608000;0
2937;49935;2168;80;29;1;28;.966;3608000;0
2938;180177;747;0;0;0;0;.00nan;0;0
2938;66245;733;95;31;0;31;1.000;3900000;0
2938;76405;747;100;30;0;30;1.000;3900000;0
2938;148503;733;0;0;0;0;.00nan;0;0
2939;211572;742;0;0;0;0;.00nan;0;0
2939;75362;749;0;0;0;0;.00nan;0;0
2939;85797;749;100;40;1;39;.975;3600000;0
2939;148573;742;42;14;3;11;.786;3564000;0
2940;595;732;47;20;3;17;.850;3543000;0
2940;207184;740;0;0;0;0;.00nan;0;0
2940;86151;740;69;26;2;24;.923;3600000;0
2940;87798;732;0;0;0;0;.00nan;0;0
2941;164424;736;86;36;2;34;.944;3600000;0
2941;31165;752;30;24;6;18;.750;2450000;0
2941;213298;736;0;0;0;0;.00nan;0;0
2941;149221;752;54;11;1;10;.909;1150000;0
2942;198736;3789;0;0;0;0;.00nan;0;0
2942;203977;729;0;0;0;0;.00nan;0;0
2942;211604;729;49;33;5;28;.848;3658000;0
2942;143301;3789;51;27;4;23;.852;3658000;0
2943;3435;739;75;20;1;19;.950;3600000;0
2943;175764;734;68;45;4;41;.911;3600000;0
2943;-1;739;0;0;0;0;.00nan;0;0
2943;148508;734;0;0;0;0;.00nan;0;0
2944;170547;764;94;32;1;31;.969;3600000;0
2944;-1;764;0;0;0;0;.00nan;0;0
2944;56565;741;0;0;0;0;.00nan;0;0
2944;85670;741;76;33;2;31;.939;3570000;0
2945;1061;751;0;0;0;0;.00nan;0;0
2945;163195;743;49;21;3;18;.857;3600000;0
2945;223469;743;0;0;0;0;.00nan;0;0
2945;148788;751;97;47;4;43;.915;3556000;0
2946;180177;747;0;0;0;0;.00nan;0;0
2946;180990;744;85;32;2;30;.938;3600000;0
2946;207771;744;0;0;0;0;.00nan;0;0
2946;76405;747;94;14;0;14;1.000;3600000;0
2947;204272;737;0;0;0;0;.00nan;0;0
2947;184158;748;97;42;1;41;.976;3564000;0
2947;218546;748;0;0;0;0;.00nan;0;0
2947;78573;737;100;27;0;27;1.000;3600000;0
2948;206313;745;55;28;3;25;.893;3600000;0
2948;31165;752;55;3;0;3;1.000;491000;0
2948;187118;745;0;0;0;0;.00nan;0;0
2948;149221;752;79;59;6;53;.898;3109000;0
2949;595;732;67;26;3;23;.885;3600000;0
2949;212999;2168;0;0;0;0;.00nan;0;0
2949;49935;2168;48;36;5;31;.861;3566000;0
2949;87798;732;0;0;0;0;.00nan;0;0
2950;1061;751;0;0;0;0;.00nan;0;0
2950;66245;733;75;18;1;17;.944;3600000;0
2950;148503;733;0;0;0;0;.00nan;0;0
2950;148788;751;51;36;6;30;.833;3600000;0
2951;1957;1880;70;32;3;29;.906;3600000;0
2951;211572;742;0;0;0;0;.00nan;0;0
2951;-1;1880;0;0;0;0;.00nan;0;0
2951;148573;742;50;25;4;21;.840;3549000;0
2952;203977;729;0;0;0;0;.00nan;0;0
2952;164424;736;70;26;2;24;.923;3600000;0
2952;211604;729;96;29;1;28;.966;3600000;0
2952;213298;736;0;0;0;0;.00nan;0;0
2953;198736;3789;0;0;0;0;.00nan;0;0
2953;180990;744;0;0;0;0;.00nan;0;0
2953;207771;744;99;34;1;33;.971;3600000;0
2953;143301;3789;75;34;3;31;.912;3560000;0
2954;3435;739;0;0;0;0;.00nan;0;0
2954;184158;748;85;39;3;36;.923;3900000;0
2954;218546;748;0;0;0;0;.00nan;0;0
2954;-1;739;92;50;3;47;.940;3900000;0
2955;2643;738;0;0;0;0;.00nan;0;0
2955;209518;738;62;27;3;24;.889;3568000;0
2955;206313;745;0;0;0;0;.00nan;0;0
2955;187118;745;65;25;2;23;.920;3600000;0
2956;175764;734;71;20;1;19;.950;3600000;0
2956;212999;2168;0;0;0;0;.00nan;0;0
2956;49935;2168;66;38;4;34;.895;3600000;0
2956;148508;734;0;0;0;0;.00nan;0;0
2957;31165;752;0;0;0;0;.00nan;0;0
2957;56565;741;0;0;0;0;.00nan;0;0
2957;85670;741;84;32;2;30;.938;3600000;0
2957;149221;752;68;29;3;26;.897;3566000;0
2958;207184;740;0;0;0;0;.00nan;0;0
2958;75362;749;0;0;0;0;.00nan;0;0
2958;85797;749;50;36;5;31;.861;3600000;0
2958;86151;740;57;17;2;15;.882;3600000;0
2959;163195;743;64;19;2;17;.895;3600000;0
2959;180177;747;0;0;0;0;.00nan;0;0
2959;223469;743;0;0;0;0;.00nan;0;0
2959;76405;747;70;30;3;27;.900;3558000;0
2960;1957;1880;75;31;2;29;.935;3587000;0
2960;203977;729;72;22;1;21;.955;3600000;0
2960;211604;729;0;0;0;0;.00nan;0;0
2960;-1;1880;0;0;0;0;.00nan;0;0
2961;170547;764;0;0;0;0;.00nan;0;0
2961;211572;742;0;0;0;0;.00nan;0;0
2961;-1;764;100;30;0;30;1.000;3600000;0
2961;148573;742;77;29;2;27;.931;3553000;0
2962;31165;752;0;0;0;0;.00nan;0;0
2962;180990;744;33;26;5;21;.808;3546000;0
2962;207771;744;0;0;0;0;.00nan;0;0
2962;149221;752;60;36;4;32;.889;3600000;0
2963;204272;737;0;0;0;0;.00nan;0;0
2963;206313;745;0;0;0;0;.00nan;0;0
2963;187118;745;84;22;1;21;.955;3600000;0
2963;78573;737;43;24;4;20;.833;3600000;0
2964;1061;751;96;38;1;37;.974;3900000;0
2964;207184;740;0;0;0;0;.00nan;0;0
2964;86151;740;75;28;1;27;.964;3900000;0
2964;148788;751;0;0;0;0;.00nan;0;0
2965;184158;748;82;14;0;14;1.000;3600000;0
2965;218546;748;0;0;0;0;.00nan;0;0
2965;66245;733;68;32;3;29;.906;3600000;0
2965;148503;733;0;0;0;0;.00nan;0;0
2966;2643;738;100;34;1;33;.971;3600000;0
2966;164424;736;85;38;2;36;.947;3584000;0
2966;209518;738;0;0;0;0;.00nan;0;0
2966;213298;736;0;0;0;0;.00nan;0;0
2967;198736;3789;0;0;0;0;.00nan;0;0
2967;75362;749;0;0;0;0;.00nan;0;0
2967;85797;749;85;31;2;29;.935;3590000;0
2967;143301;3789;100;28;0;28;1.000;3600000;0
2968;163195;743;97;32;1;31;.969;3600000;0
2968;212999;2168;0;0;0;0;.00nan;0;0
2968;223469;743;0;0;0;0;.00nan;0;0
2968;49935;2168;88;40;2;38;.950;3566000;0
2969;1957;1880;53;29;4;25;.862;3555000;0
2969;175764;734;81;34;2;32;.941;3600000;0
2969;-1;1880;0;0;0;0;.00nan;0;0
2969;148508;734;0;0;0;0;.00nan;0;0
2970;170547;764;74;23;2;21;.913;3600000;0
2970;-1;764;0;0;0;0;.00nan;0;0
2970;56565;741;0;0;0;0;.00nan;0;0
2970;85670;741;56;34;5;29;.853;3600000;0
2971;184158;748;50;15;2;13;.867;3600000;0
2971;31165;752;97;49;3;46;.939;3543000;0
2971;218546;748;0;0;0;0;.00nan;0;0
2971;149221;752;0;0;0;0;.00nan;0;0
2972;1061;751;0;0;0;0;.00nan;0;0
2972;198736;3789;0;0;0;0;.00nan;0;0
2972;143301;3789;60;26;3;23;.885;3544000;0
2972;148788;751;86;30;2;28;.933;3600000;0
2973;180177;747;69;23;2;21;.913;3600000;0
2973;207184;740;0;0;0;0;.00nan;0;0
2973;76405;747;0;0;0;0;.00nan;0;0
2973;86151;740;87;45;3;42;.933;3600000;0
2974;164424;736;86;43;3;40;.930;3587000;0
2974;213298;736;0;0;0;0;.00nan;0;0
2974;75362;749;88;33;2;31;.939;3600000;0
2974;85797;749;0;0;0;0;.00nan;0;0
2975;3435;739;75;17;1;16;.941;3600000;0
2975;212999;2168;70;35;3;32;.914;3534000;0
2975;-1;739;0;0;0;0;.00nan;0;0
2975;49935;2168;0;0;0;0;.00nan;0;0
2976;206313;745;0;0;0;0;.00nan;0;0
2976;180990;744;78;33;2;31;.939;3556000;0
2976;207771;744;0;0;0;0;.00nan;0;0
2976;187118;745;75;24;1;23;.958;3600000;0
2977;203977;729;0;0;0;0;.00nan;0;0
2977;204272;737;0;0;0;0;.00nan;0;0
2977;211604;729;61;32;3;29;.906;3600000;0
2977;78573;737;98;23;0;23;1.000;3600000;0
2978;163195;743;92;19;0;19;1.000;3600000;0
2978;223469;743;0;0;0;0;.00nan;0;0
2978;66245;733;80;46;4;42;.913;3600000;0
2978;148503;733;0;0;0;0;.00nan;0;0
2979;211572;742;0;0;0;0;.00nan;0;0
2979;175764;734;99;38;1;37;.974;3900000;0
2979;148508;734;0;0;0;0;.00nan;0;0
2979;148573;742;72;23;1;22;.957;3900000;0
2980;595;732;45;25;4;21;.840;3600000;0
2980;1957;1880;92;32;1;31;.969;3600000;0
2980;-1;1880;0;0;0;0;.00nan;0;0
2980;87798;732;0;0;0;0;.00nan;0;0
2981;170547;764;0;0;0;0;.00nan;0;0
2981;-1;764;71;30;3;27;.900;3768000;0
2981;56565;741;0;0;0;0;.00nan;0;0
2981;85670;741;73;27;2;25;.926;3768000;0
2982;1061;751;0;0;0;0;.00nan;0;0
2982;164424;736;61;31;4;27;.871;3900000;0
2982;213298;736;0;0;0;0;.00nan;0;0
2982;148788;751;80;48;4;44;.917;3900000;0
2983;198736;3789;0;0;0;0;.00nan;0;0
2983;180177;747;0;0;0;0;.00nan;0;0
2983;76405;747;67;35;4;31;.886;3539000;0
2983;143301;3789;87;35;2;33;.943;3600000;0
2984;2643;738;98;52;2;50;.962;3900000;0
2984;209518;738;0;0;0;0;.00nan;0;0
2984;184158;748;92;35;2;33;.943;3900000;0
2984;218546;748;0;0;0;0;.00nan;0;0
2985;3435;739;53;15;2;13;.867;3799000;0
2985;31165;752;0;0;0;0;.00nan;0;0
2985;-1;739;0;0;0;0;.00nan;0;0
2985;149221;752;86;54;3;51;.944;3799000;0
2986;212999;2168;0;0;0;0;.00nan;0;0
2986;49935;2168;82;27;1;26;.963;3600000;0
2986;66245;733;80;34;2;32;.941;3576000;0
2986;148503;733;0;0;0;0;.00nan;0;0
2987;163195;743;58;30;4;26;.867;3600000;0
2987;204272;737;0;0;0;0;.00nan;0;0
2987;223469;743;0;0;0;0;.00nan;0;0
2987;78573;737;100;34;0;34;1.000;3600000;0
2988;206313;745;0;0;0;0;.00nan;0;0
2988;187118;745;80;25;1;24;.960;3600000;0
2988;56565;741;0;0;0;0;.00nan;0;0
2988;85670;741;68;38;4;34;.895;3600000;0
2989;211572;742;0;0;0;0;.00nan;0;0
2989;180990;744;40;26;5;21;.808;751000;0
2989;207771;744;83;35;2;33;.943;2849000;0
2989;148573;742;100;32;0;32;1.000;3600000;0
2990;170547;764;82;36;2;34;.944;3900000;0
2990;175764;734;82;25;2;23;.920;3900000;0
2990;-1;764;0;0;0;0;.00nan;0;0
2990;148508;734;0;0;0;0;.00nan;0;0
2991;206313;745;54;35;5;30;.857;3600000;0
2991;187118;745;0;0;0;0;.00nan;0;0
2991;75362;749;0;0;0;0;.00nan;0;0
2991;85797;749;89;46;2;44;.957;3600000;0
2992;164424;736;71;23;2;21;.913;3600000;0
2992;180177;747;0;0;0;0;.00nan;0;0
2992;213298;736;0;0;0;0;.00nan;0;0
2992;76405;747;93;28;1;27;.964;3600000;0
2993;595;732;0;0;0;0;.00nan;0;0
2993;2643;738;81;36;3;33;.917;3570000;0
2993;209518;738;0;0;0;0;.00nan;0;0
2993;87798;732;100;44;1;43;.977;3600000;0
2994;31165;752;72;43;4;39;.907;3573000;0
2994;66245;733;84;35;2;33;.943;3600000;0
2994;148503;733;0;0;0;0;.00nan;0;0
2994;149221;752;0;0;0;0;.00nan;0;0
2995;3435;739;100;33;1;32;.970;3600000;0
2995;204272;737;0;0;0;0;.00nan;0;0
2995;-1;739;0;0;0;0;.00nan;0;0
2995;78573;737;79;45;4;41;.911;3600000;0
2996;212999;2168;0;0;0;0;.00nan;0;0
2996;49935;2168;100;34;0;34;1.000;3600000;0
2996;56565;741;0;0;0;0;.00nan;0;0
2996;85670;741;73;30;2;28;.933;3585000;0
2997;1061;751;0;0;0;0;.00nan;0;0
2997;184158;748;100;23;0;23;1.000;3600000;0
2997;218546;748;0;0;0;0;.00nan;0;0
2997;148788;751;63;43;5;38;.884;3600000;0
2998;1957;1880;64;21;2;19;.905;3589000;0
2998;180990;744;70;17;1;16;.941;3600000;0
2998;207771;744;0;0;0;0;.00nan;0;0
2998;-1;1880;0;0;0;0;.00nan;0;0
2999;595;732;100;34;1;33;.971;3600000;0
2999;2643;738;85;29;2;27;.931;3586000;0
2999;209518;738;0;0;0;0;.00nan;0;0
2999;87798;732;0;0;0;0;.00nan;0;0
3000;211572;742;0;0;0;0;.00nan;0;0
3000;207184;740;0;0;0;0;.00nan;0;0
3000;86151;740;77;34;3;31;.912;3900000;0
3000;148573;742;66;29;3;26;.897;3900000;0
3001;163195;743;90;40;2;38;.950;3600000;0
3001;175764;734;51;30;4;26;.867;3515000;0
3001;223469;743;0;0;0;0;.00nan;0;0
3001;148508;734;0;0;0;0;.00nan;0;0
3002;170547;764;0;0;0;0;.00nan;0;0
3002;-1;764;93;40;2;38;.950;3600000;0
3002;75362;749;37;6;2;4;.667;561000;0
3002;85797;749;20;23;6;17;.739;3039000;0
3003;175764;734;0;0;0;0;.00nan;0;0
3003;66245;733;60;35;4;31;.886;3514000;0
3003;148503;733;0;0;0;0;.00nan;0;0
3003;148508;734;72;23;2;21;.913;3600000;0
3004;204272;737;0;0;0;0;.00nan;0;0
3004;206313;745;0;0;0;0;.00nan;0;0
3004;187118;745;84;44;3;41;.932;3600000;0
3004;78573;737;60;32;4;28;.875;3569000;0
3005;3435;739;90;38;1;37;.974;3600000;0
3005;203977;729;0;0;0;0;.00nan;0;0
3005;211604;729;77;45;4;41;.911;3600000;0
3005;-1;739;0;0;0;0;.00nan;0;0
3006;211572;742;54;4;0;4;1.000;671000;0
3006;180177;747;0;0;0;0;.00nan;0;0
3006;76405;747;84;32;2;30;.938;3600000;0
3006;148573;742;45;37;6;31;.838;2929000;0
3007;184158;748;63;35;3;32;.914;3900000;0
3007;180990;744;88;37;3;34;.919;3900000;0
3007;207771;744;0;0;0;0;.00nan;0;0
3007;218546;748;0;0;0;0;.00nan;0;0
3008;1957;1880;77;30;3;27;.900;3900000;0
3008;31165;752;0;0;0;0;.00nan;0;0
3008;-1;1880;0;0;0;0;.00nan;0;0
3008;149221;752;93;43;3;40;.930;3900000;0
3009;595;732;0;0;0;0;.00nan;0;0
3009;1061;751;0;0;0;0;.00nan;0;0
3009;87798;732;94;38;2;36;.947;3900000;0
3009;148788;751;81;35;2;33;.943;3900000;0
3010;198736;3789;0;0;0;0;.00nan;0;0
3010;207184;740;0;0;0;0;.00nan;0;0
3010;86151;740;39;26;5;21;.808;3589000;0
3010;143301;3789;62;38;4;34;.895;3600000;0
3011;163195;743;84;33;3;30;.909;3900000;0
3011;212999;2168;0;0;0;0;.00nan;0;0
3011;223469;743;0;0;0;0;.00nan;0;0
3011;49935;2168;97;52;3;49;.942;3900000;0
3012;170547;764;85;14;0;14;1.000;3600000;0
3012;-1;764;0;0;0;0;.00nan;0;0
3012;75362;749;50;38;6;32;.842;3203000;0
3012;85797;749;26;6;3;3;.500;397000;0
3013;180990;744;55;27;3;24;.889;3898000;0
3013;212999;2168;0;0;0;0;.00nan;0;0
3013;207771;744;0;0;0;0;.00nan;0;0
3013;49935;2168;70;26;3;23;.885;3900000;0
3014;2643;738;70;39;4;35;.897;3544000;0
3014;203977;729;0;0;0;0;.00nan;0;0
3014;209518;738;0;0;0;0;.00nan;0;0
3014;211604;729;58;25;3;22;.880;3600000;0
3015;3435;739;75;22;1;21;.955;3600000;0
3015;-1;739;0;0;0;0;.00nan;0;0
3015;56565;741;0;0;0;0;.00nan;0;0
3015;85670;741;69;24;2;22;.917;3574000;0
3016;184158;748;62;36;5;31;.861;3600000;0
3016;180177;747;0;0;0;0;.00nan;0;0
3016;218546;748;0;0;0;0;.00nan;0;0
3016;76405;747;94;35;2;33;.943;3600000;0
3017;595;732;0;0;0;0;.00nan;0;0
3017;31165;752;0;0;0;0;.00nan;0;0
3017;87798;732;69;23;2;21;.913;3600000;0
3017;149221;752;45;29;5;24;.828;3600000;0
3018;207184;740;66;26;2;24;.923;3900000;0
3018;66245;733;65;20;2;18;.900;3900000;0
3018;86151;740;0;0;0;0;.00nan;0;0
3018;148503;733;0;0;0;0;.00nan;0;0
3019;1957;1880;68;37;3;34;.919;3543000;0
3019;164424;736;0;0;0;0;.00nan;0;0
3019;213298;736;69;25;1;24;.960;3600000;0
3019;-1;1880;0;0;0;0;.00nan;0;0
3020;163195;743;85;34;2;32;.941;3600000;0
3020;211572;742;0;0;0;0;.00nan;0;0
3020;223469;743;0;0;0;0;.00nan;0;0
3020;148573;742;80;36;3;33;.917;3531000;0
3021;198736;3789;0;0;0;0;.00nan;0;0
3021;206313;745;0;0;0;0;.00nan;0;0
3021;187118;745;59;35;4;31;.886;3600000;0
3021;143301;3789;100;30;0;30;1.000;3600000;0
3022;204272;737;0;0;0;0;.00nan;0;0
3022;175764;734;49;36;5;31;.861;3900000;0
3022;78573;737;69;43;5;38;.884;3863000;0
3022;148508;734;0;0;0;0;.00nan;0;0
3023;3435;739;62;21;2;19;.905;3600000;0
3023;31165;752;83;42;4;38;.905;3600000;0
3023;-1;739;0;0;0;0;.00nan;0;0
3023;149221;752;0;0;0;0;.00nan;0;0
3024;1061;751;0;0;0;0;.00nan;0;0
3024;203977;729;54;9;1;8;.889;1755000;0
3024;211604;729;32;22;5;17;.773;1845000;0
3024;148788;751;72;37;3;34;.919;3600000;0
3025;204272;737;0;0;0;0;.00nan;0;0
3025;175764;734;0;0;0;0;.00nan;0;0
3025;78573;737;88;38;2;36;.947;3600000;0
3025;148508;734;68;37;3;34;.919;3573000;0
3026;184158;748;81;42;4;38;.905;3557000;0
3026;211572;742;0;0;0;0;.00nan;0;0
3026;218546;748;0;0;0;0;.00nan;0;0
3026;148573;742;81;37;3;34;.919;3600000;0
3027;1957;1880;34;30;6;24;.800;3578000;0
3027;207184;740;0;0;0;0;.00nan;0;0
3027;-1;1880;0;0;0;0;.00nan;0;0
3027;86151;740;63;35;4;31;.886;3600000;0
3028;2643;738;94;35;1;34;.971;3600000;0
3028;164424;736;81;37;2;35;.946;3575000;0
3028;209518;738;0;0;0;0;.00nan;0;0
3028;213298;736;0;0;0;0;.00nan;0;0
3029;163195;743;66;26;3;23;.885;3600000;0
3029;180177;747;0;0;0;0;.00nan;0;0
3029;223469;743;0;0;0;0;.00nan;0;0
3029;76405;747;60;30;4;26;.867;3548000;0
3030;180990;744;66;29;3;26;.897;3900000;0
3030;212999;2168;0;0;0;0;.00nan;0;0
3030;207771;744;0;0;0;0;.00nan;0;0
3030;49935;2168;80;34;3;31;.912;3900000;0
3031;198736;3789;57;32;4;28;.875;3600000;0
3031;170547;764;61;36;5;31;.861;3573000;0
3031;-1;764;0;0;0;0;.00nan;0;0
3031;-1;3789;0;0;0;0;.00nan;0;0
3032;595;732;63;25;2;23;.920;3600000;0
3032;184158;748;0;0;0;0;.00nan;0;0
3032;218546;748;66;29;3;26;.897;3600000;0
3032;87798;732;0;0;0;0;.00nan;0;0
3033;2643;738;81;25;2;23;.920;3600000;0
3033;209518;738;0;0;0;0;.00nan;0;0
3033;175764;734;84;50;4;46;.920;3525000;0
3033;148508;734;0;0;0;0;.00nan;0;0
3034;180177;747;0;0;0;0;.00nan;0;0
3034;56565;741;0;0;0;0;.00nan;0;0
3034;76405;747;65;34;4;30;.882;3600000;0
3034;85670;741;100;25;0;25;1.000;3600000;0
3035;164424;736;85;28;1;27;.964;3600000;0
3035;213298;736;0;0;0;0;.00nan;0;0
3035;66245;733;68;37;4;33;.892;3600000;0
3035;148503;733;0;0;0;0;.00nan;0;0
3036;203977;729;0;0;0;0;.00nan;0;0
3036;211604;729;76;28;2;26;.929;3624000;0
3036;75362;749;0;0;0;0;.00nan;0;0
3036;85797;749;100;39;1;38;.974;3624000;0
3037;198736;3789;100;23;0;23;1.000;3600000;0
3037;31165;752;88;42;2;40;.952;3514000;0
3037;-1;3789;0;0;0;0;.00nan;0;0
3037;149221;752;0;0;0;0;.00nan;0;0
3038;595;732;0;0;0;0;.00nan;0;0
3038;3435;739;74;36;3;33;.917;3550000;0
3038;-1;739;0;0;0;0;.00nan;0;0
3038;87798;732;99;43;2;41;.953;3600000;0
3039;1061;751;0;0;0;0;.00nan;0;0
3039;163195;743;68;30;2;28;.933;3600000;0
3039;223469;743;0;0;0;0;.00nan;0;0
3039;148788;751;86;42;3;39;.929;3600000;0
3040;206313;745;0;0;0;0;.00nan;0;0
3040;180990;744;82;27;2;25;.926;3600000;0
3040;207771;744;0;0;0;0;.00nan;0;0
3040;187118;745;66;28;3;25;.893;3558000;0
3041;211572;742;0;0;0;0;.00nan;0;0
3041;207184;740;0;0;0;0;.00nan;0;0
3041;86151;740;87;40;2;38;.950;3900000;0
3041;148573;742;66;26;2;24;.923;3900000;0
3042;1957;1880;85;36;2;34;.944;3900000;0
3042;170547;764;86;35;2;33;.943;3900000;0
3042;-1;764;0;0;0;0;.00nan;0;0
3042;-1;1880;0;0;0;0;.00nan;0;0
3043;175764;734;62;32;3;29;.906;3543000;0
3043;212999;2168;0;0;0;0;.00nan;0;0
3043;49935;2168;99;46;2;44;.957;3600000;0
3043;148508;734;0;0;0;0;.00nan;0;0
3044;595;732;77;49;4;45;.918;3600000;0
3044;3435;739;0;0;0;0;.00nan;0;0
3044;-1;739;91;23;0;23;1.000;3600000;0
3044;87798;732;0;0;0;0;.00nan;0;0
3045;1061;751;97;41;1;40;.976;3600000;0
3045;163195;743;62;24;2;22;.917;3547000;0
3045;223469;743;0;0;0;0;.00nan;0;0
3045;148788;751;0;0;0;0;.00nan;0;0
3046;203977;729;0;0;0;0;.00nan;0;0
3046;211604;729;77;36;3;33;.917;3600000;0
3046;180177;747;0;0;0;0;.00nan;0;0
3046;76405;747;100;28;0;28;1.000;3600000;0
3047;164424;736;95;37;1;36;.973;3600000;0
3047;204272;737;0;0;0;0;.00nan;0;0
3047;213298;736;0;0;0;0;.00nan;0;0
3047;78573;737;69;25;2;23;.920;3600000;0
3048;66245;733;88;41;3;38;.927;3570000;0
3048;75362;749;0;0;0;0;.00nan;0;0
3048;85797;749;94;38;1;37;.974;3600000;0
3048;148503;733;0;0;0;0;.00nan;0;0
3049;206313;745;0;0;0;0;.00nan;0;0
3049;207184;740;0;0;0;0;.00nan;0;0
3049;187118;745;79;26;1;25;.962;3900000;0
3049;86151;740;98;45;1;44;.978;3900000;0
3050;180990;744;60;34;4;30;.882;3600000;0
3050;207771;744;0;0;0;0;.00nan;0;0
3050;56565;741;0;0;0;0;.00nan;0;0
3050;85670;741;100;35;0;35;1.000;3600000;0
3051;1957;1880;92;39;2;37;.949;3600000;0
3051;211572;742;0;0;0;0;.00nan;0;0
3051;-1;1880;0;0;0;0;.00nan;0;0
3051;148573;742;67;29;3;26;.897;3565000;0
3052;175764;734;81;28;2;26;.929;3600000;0
3052;31165;752;57;30;4;26;.867;3528000;0
3052;148508;734;0;0;0;0;.00nan;0;0
3052;149221;752;0;0;0;0;.00nan;0;0
3053;204272;737;0;0;0;0;.00nan;0;0
3053;212999;2168;62;20;2;18;.900;3178000;0
3053;49935;2168;37;11;3;8;.727;422000;0
3053;78573;737;61;21;2;19;.905;3600000;0
3054;2643;738;73;38;4;34;.895;3600000;0
3054;3435;739;0;0;0;0;.00nan;0;0
3054;209518;738;0;0;0;0;.00nan;0;0
3054;-1;739;60;28;3;25;.893;3600000;0
3055;1061;751;41;3;1;2;.667;430000;0
3055;66245;733;48;35;6;29;.829;3600000;0
3055;148503;733;0;0;0;0;.00nan;0;0
3055;148788;751;33;32;6;26;.813;3118000;0
3056;203977;729;0;0;0;0;.00nan;0;0
3056;184158;748;67;17;1;16;.941;3600000;0
3056;211604;729;82;44;3;41;.932;3600000;0
3056;218546;748;0;0;0;0;.00nan;0;0
3057;163195;743;66;22;1;21;.955;3600000;0
3057;223469;743;0;0;0;0;.00nan;0;0
3057;75362;749;0;0;0;0;.00nan;0;0
3057;85797;749;93;47;3;44;.936;3593000;0
3058;198736;3789;0;0;0;0;.00nan;0;0
3058;211572;742;0;0;0;0;.00nan;0;0
3058;143301;3789;84;37;3;34;.919;3519000;0
3058;148573;742;82;25;1;24;.960;3600000;0
3059;595;732;0;0;0;0;.00nan;0;0
3059;164424;736;55;32;4;28;.875;3544000;0
3059;213298;736;0;0;0;0;.00nan;0;0
3059;87798;732;84;41;3;38;.927;3600000;0
3060;31165;752;63;27;3;24;.889;3543000;0
3060;78573;737;83;32;2;30;.938;3600000;0
3060;139467;737;0;0;0;0;.00nan;0;0
3060;149221;752;0;0;0;0;.00nan;0;0
3061;1957;1880;62;23;2;21;.913;3600000;0
3061;180990;744;0;0;0;0;.00nan;0;0
3061;207771;744;55;37;4;33;.892;3567000;0
3061;-1;1880;0;0;0;0;.00nan;0;0
3062;3435;739;91;34;1;33;.971;3600000;0
3062;-1;739;0;0;0;0;.00nan;0;0
3062;56565;741;0;0;0;0;.00nan;0;0
3062;85670;741;64;29;3;26;.897;3575000;0
3063;180177;747;0;0;0;0;.00nan;0;0
3063;66245;733;73;32;2;30;.938;3600000;0
3063;76405;747;77;23;1;22;.957;3600000;0
3063;148503;733;0;0;0;0;.00nan;0;0
3064;595;732;83;36;3;33;.917;3600000;0
3064;164424;736;57;33;5;28;.848;3600000;0
3064;213298;736;0;0;0;0;.00nan;0;0
3064;87798;732;0;0;0;0;.00nan;0;0
3065;2643;738;79;30;2;28;.933;3558000;0
3065;209518;738;0;0;0;0;.00nan;0;0
3065;207184;740;0;0;0;0;.00nan;0;0
3065;86151;740;100;38;0;38;1.000;3600000;0
3066;184158;748;59;18;2;16;.889;3600000;0
3066;170547;764;0;0;0;0;.00nan;0;0
3066;218546;748;0;0;0;0;.00nan;0;0
3066;-1;764;54;23;3;20;.870;3597000;0
3067;163195;743;77;42;3;39;.929;3778000;0
3067;223469;743;0;0;0;0;.00nan;0;0
3067;75362;749;0;0;0;0;.00nan;0;0
3067;85797;749;81;38;2;36;.947;3778000;0
3068;1061;751;0;0;0;0;.00nan;0;0
3068;198736;3789;0;0;0;0;.00nan;0;0
3068;143301;3789;66;29;3;26;.897;3900000;0
3068;148788;751;85;44;3;41;.932;3900000;0
3069;2643;738;88;35;2;33;.943;3564000;0
3069;209518;738;0;0;0;0;.00nan;0;0
3069;180990;744;58;13;1;12;.923;3600000;0
3069;207771;744;0;0;0;0;.00nan;0;0
3070;1957;1880;82;32;2;30;.938;3600000;0
3070;-1;1880;0;0;0;0;.00nan;0;0
3070;78573;737;85;41;3;38;.927;3595000;0
3070;139467;737;0;0;0;0;.00nan;0;0
3071;3435;739;71;21;1;20;.952;3600000;0
3071;164424;736;97;52;3;49;.942;3600000;0
3071;213298;736;0;0;0;0;.00nan;0;0
3071;-1;739;0;0;0;0;.00nan;0;0
3072;203977;729;0;0;0;0;.00nan;0;0
3072;211604;729;77;28;1;27;.964;3600000;0
3072;175764;734;56;33;4;29;.879;3600000;0
3072;148508;734;0;0;0;0;.00nan;0;0
3073;180177;747;0;0;0;0;.00nan;0;0
3073;56565;741;0;0;0;0;.00nan;0;0
3073;76405;747;79;25;1;24;.960;3600000;0
3073;85670;741;62;32;3;29;.906;3514000;0
3074;595;732;0;0;0;0;.00nan;0;0
3074;206313;745;0;0;0;0;.00nan;0;0
3074;187118;745;53;22;3;19;.864;3600000;0
3074;87798;732;98;26;0;26;1.000;3600000;0
3075;184158;748;82;32;3;29;.906;3900000;0
3075;207184;740;0;0;0;0;.00nan;0;0
3075;218546;748;0;0;0;0;.00nan;0;0
3075;86151;740;59;30;3;27;.900;3900000;0
3076;170547;764;68;21;1;20;.952;3600000;0
3076;212999;2168;53;3;0;3;1.000;336000;0
3076;-1;764;0;0;0;0;.00nan;0;0
3076;49935;2168;56;35;5;30;.857;3264000;0
3077;31165;752;0;0;0;0;.00nan;0;0
3077;75362;749;0;0;0;0;.00nan;0;0
3077;85797;749;100;40;1;39;.975;3600000;0
3077;149221;752;51;28;4;24;.857;3600000;0
3078;1061;751;0;0;0;0;.00nan;0;0
3078;211572;742;0;0;0;0;.00nan;0;0
3078;148573;742;65;27;3;24;.889;3600000;0
3078;148788;751;61;33;4;29;.879;3554000;0
3079;184158;748;86;27;1;26;.963;3600000;0
3079;180990;744;56;31;4;27;.871;3600000;0
3079;207771;744;0;0;0;0;.00nan;0;0
3079;218546;748;0;0;0;0;.00nan;0;0
3080;164424;736;45;44;6;38;.864;3259000;0
3080;213298;736;55;5;0;5;1.000;341000;0
3080;78573;737;75;30;2;28;.933;3600000;0
3080;139467;737;0;0;0;0;.00nan;0;0
3081;175764;734;77;43;4;39;.907;3900000;0
3081;180177;747;0;0;0;0;.00nan;0;0
3081;76405;747;58;31;4;27;.871;3900000;0
3081;148508;734;0;0;0;0;.00nan;0;0
3082;1957;1880;54;42;6;36;.857;3600000;0
3082;203977;729;0;0;0;0;.00nan;0;0
3082;211604;729;67;30;3;27;.900;3600000;0
3082;-1;1880;0;0;0;0;.00nan;0;0
3083;212999;2168;0;0;0;0;.00nan;0;0
3083;49935;2168;75;27;1;26;.963;3900000;0
3083;56565;741;0;0;0;0;.00nan;0;0
3083;85670;741;100;39;1;38;.974;3900000;0
3084;2643;738;92;36;2;34;.944;3872000;0
3084;209518;738;0;0;0;0;.00nan;0;0
3084;66245;733;90;32;1;31;.969;3872000;0
3084;148503;733;0;0;0;0;.00nan;0;0
3085;595;732;0;0;0;0;.00nan;0;0
3085;198736;3789;48;0;0;0;.00nan;317000;0
3085;87798;732;100;47;1;46;.979;3600000;0
3085;143301;3789;36;21;4;17;.810;3283000;0
3086;206313;745;0;0;0;0;.00nan;0;0
3086;207184;740;53;15;2;13;.867;1572000;0
3086;187118;745;63;25;3;22;.880;3600000;0
3086;86151;740;37;32;6;26;.813;2028000;0
3087;163195;743;71;31;2;29;.935;3600000;0
3087;170547;764;75;22;1;21;.955;3600000;0
3087;223469;743;0;0;0;0;.00nan;0;0
3087;-1;764;0;0;0;0;.00nan;0;0
3088;164424;736;33;32;6;26;.813;3047000;0
3088;213298;736;55;4;0;4;1.000;553000;0
3088;78573;737;0;0;0;0;.00nan;0;0
3088;139467;737;42;32;5;27;.844;3600000;0
3089;1061;751;96;24;0;24;1.000;3600000;0
3089;75362;749;0;0;0;0;.00nan;0;0
3089;85797;749;81;29;2;27;.931;3600000;0
3089;148788;751;0;0;0;0;.00nan;0;0
3090;211572;742;0;0;0;0;.00nan;0;0
3090;31165;752;0;0;0;0;.00nan;0;0
3090;148573;742;79;29;1;28;.966;3600000;0
3090;149221;752;62;28;2;26;.929;3544000;0
3091;3435;739;75;26;2;24;.923;3900000;0
3091;206313;745;77;37;2;35;.946;3900000;0
3091;187118;745;0;0;0;0;.00nan;0;0
3091;-1;739;0;0;0;0;.00nan;0;0
3092;180177;747;0;0;0;0;.00nan;0;0
3092;56565;741;0;0;0;0;.00nan;0;0
3092;76405;747;36;23;5;18;.783;3545000;0
3092;85670;741;56;35;4;31;.886;3600000;0
3093;212999;2168;0;0;0;0;.00nan;0;0
3093;49935;2168;87;36;1;35;.972;3600000;0
3093;66245;733;87;34;2;32;.941;3553000;0
3093;148503;733;0;0;0;0;.00nan;0;0
3094;1957;1880;0;0;0;0;.00nan;0;0
3094;198736;3789;0;0;0;0;.00nan;0;0
3094;-1;1880;84;34;1;33;.971;3552000;0
3094;143301;3789;96;19;0;19;1.000;3600000;0
3095;2643;738;64;33;3;30;.909;3843000;0
3095;209518;738;0;0;0;0;.00nan;0;0
3095;180990;744;84;29;2;27;.931;3843000;0
3095;207771;744;0;0;0;0;.00nan;0;0
3096;1061;751;93;29;1;28;.966;3600000;0
3096;75362;749;0;0;0;0;.00nan;0;0
3096;85797;749;64;29;3;26;.897;3554000;0
3096;148788;751;0;0;0;0;.00nan;0;0
3097;203977;729;70;31;2;29;.935;3600000;0
3097;211604;729;0;0;0;0;.00nan;0;0
3097;207184;740;0;0;0;0;.00nan;0;0
3097;86151;740;90;33;1;32;.970;3600000;0
3098;184158;748;82;37;2;35;.946;3600000;0
3098;211572;742;73;17;0;17;1.000;1298000;0
3098;218546;748;0;0;0;0;.00nan;0;0
3098;148573;742;26;19;5;14;.737;2302000;0
3099;170547;764;0;0;0;0;.00nan;0;0
3099;31165;752;93;44;4;40;.909;3791000;0
3099;-1;764;86;34;3;31;.912;3791000;0
3099;149221;752;0;0;0;0;.00nan;0;0
3100;198736;3789;0;0;0;0;.00nan;0;0
3100;78573;737;97;23;0;23;1.000;3600000;0
3100;139467;737;0;0;0;0;.00nan;0;0
3100;143301;3789;73;29;2;27;.931;3590000;0
3101;595;732;0;0;0;0;.00nan;0;0
3101;180177;747;0;0;0;0;.00nan;0;0
3101;76405;747;100;22;0;22;1.000;3600000;0
3101;87798;732;76;32;2;30;.938;3537000;0
3102;3435;739;92;36;2;34;.944;3600000;0
3102;163195;743;67;29;3;26;.897;3555000;0
3102;223469;743;0;0;0;0;.00nan;0;0
3102;-1;739;0;0;0;0;.00nan;0;0
3103;211572;742;0;0;0;0;.00nan;0;0
3103;212999;2168;0;0;0;0;.00nan;0;0
3103;49935;2168;96;41;2;39;.951;3600000;0
3103;148573;742;67;17;1;16;.941;3600000;0
3104;2643;738;100;41;2;39;.951;3900000;0
3104;209518;738;0;0;0;0;.00nan;0;0
3104;66245;733;70;27;2;25;.926;3900000;0
3104;148503;733;0;0;0;0;.00nan;0;0
3105;175764;734;0;0;0;0;.00nan;0;0
3105;180990;744;49;36;5;31;.861;3588000;0
3105;207771;744;0;0;0;0;.00nan;0;0
3105;148508;734;84;40;3;37;.925;3600000;0
3106;203977;729;0;0;0;0;.00nan;0;0
3106;206313;745;0;0;0;0;.00nan;0;0
3106;211604;729;57;35;4;31;.886;3647000;0
3106;187118;745;49;31;5;26;.839;3647000;0
3107;170547;764;0;0;0;0;.00nan;0;0
3107;-1;764;73;30;3;27;.900;3564000;0
3107;56565;741;0;0;0;0;.00nan;0;0
3107;85670;741;82;33;2;31;.939;3600000;0
3108;184158;748;81;27;1;26;.963;3600000;0
3108;31165;752;0;0;0;0;.00nan;0;0
3108;218546;748;0;0;0;0;.00nan;0;0
3108;149221;752;90;42;2;40;.952;3592000;0
3109;1957;1880;82;36;2;34;.944;3545000;0
3109;207184;740;0;0;0;0;.00nan;0;0
3109;-1;1880;0;0;0;0;.00nan;0;0
3109;86151;740;91;37;1;36;.973;3600000;0
3110;3435;739;74;28;2;26;.929;3582000;0
3110;198736;3789;0;0;0;0;.00nan;0;0
3110;-1;739;0;0;0;0;.00nan;0;0
3110;143301;3789;93;38;1;37;.974;3600000;0
3111;1061;751;0;0;0;0;.00nan;0;0
3111;78573;737;55;27;3;24;.889;3553000;0
3111;139467;737;0;0;0;0;.00nan;0;0
3111;148788;751;95;37;2;35;.946;3600000;0
3112;595;732;0;0;0;0;.00nan;0;0
3112;75362;749;0;0;0;0;.00nan;0;0
3112;85797;749;60;27;3;24;.889;3593000;0
3112;87798;732;91;32;2;30;.938;3600000;0
3113;207184;740;0;0;0;0;.00nan;0;0
3113;56565;741;0;0;0;0;.00nan;0;0
3113;85670;741;100;27;0;27;1.000;3600000;0
3113;86151;740;51;30;4;26;.867;3600000;0
3114;211572;742;0;0;0;0;.00nan;0;0
3114;180177;747;0;0;0;0;.00nan;0;0
3114;76405;747;88;40;2;38;.950;3600000;0
3114;148573;742;47;24;3;21;.875;3554000;0
3115;184158;748;78;40;3;37;.925;3600000;0
3115;170547;764;0;0;0;0;.00nan;0;0
3115;218546;748;0;0;0;0;.00nan;0;0
3115;-1;764;34;27;5;22;.815;3534000;0
3116;1957;1880;59;21;2;19;.905;3900000;0
3116;-1;1880;0;0;0;0;.00nan;0;0
3116;66245;733;100;40;2;38;.950;3900000;0
3116;148503;733;0;0;0;0;.00nan;0;0
3117;164424;736;19;22;6;16;.727;2225000;0
3117;180990;744;71;28;2;26;.929;3600000;0
3117;207771;744;0;0;0;0;.00nan;0;0
3117;213298;736;73;22;1;21;.955;1375000;0
3118;163195;743;59;18;2;16;.889;3600000;0
3118;206313;745;66;10;0;10;1.000;878000;0
3118;187118;745;57;41;6;35;.854;2722000;0
3118;223469;743;0;0;0;0;.00nan;0;0
3119;2643;738;69;46;5;41;.891;3600000;0
3119;3435;739;60;20;2;18;.900;3600000;0
3119;209518;738;0;0;0;0;.00nan;0;0
3119;-1;739;0;0;0;0;.00nan;0;0
3120;595;732;0;0;0;0;.00nan;0;0
3120;1061;751;0;0;0;0;.00nan;0;0
3120;87798;732;59;43;6;37;.860;3600000;0
3120;148788;751;71;7;0;7;1.000;3600000;0
3121;75362;749;0;0;0;0;.00nan;0;0
3121;78573;737;67;38;4;34;.895;3600000;0
3121;85797;749;76;24;1;23;.958;3600000;0
3121;139467;737;0;0;0;0;.00nan;0;0
3122;164424;736;66;29;3;26;.897;3762000;0
3122;212999;2168;0;0;0;0;.00nan;0;0
3122;213298;736;0;0;0;0;.00nan;0;0
3122;49935;2168;71;37;4;33;.892;3762000;0
3123;198736;3789;57;6;0;6;1.000;758000;0
3123;203977;729;0;0;0;0;.00nan;0;0
3123;211604;729;74;37;3;34;.919;3600000;0
3123;143301;3789;12;21;6;15;.714;2842000;0
3124;175764;734;46;27;4;23;.852;3534000;0
3124;180177;747;0;0;0;0;.00nan;0;0
3124;76405;747;81;27;2;25;.926;3600000;0
3124;148508;734;0;0;0;0;.00nan;0;0
3125;170547;764;78;25;1;24;.960;3569000;0
3125;-1;764;0;0;0;0;.00nan;0;0
3125;66245;733;100;24;0;24;1.000;3600000;0
3125;148503;733;0;0;0;0;.00nan;0;0
3126;163195;743;82;27;1;26;.963;3600000;0
3126;207184;740;0;0;0;0;.00nan;0;0
3126;223469;743;0;0;0;0;.00nan;0;0
3126;86151;740;82;35;2;33;.943;3555000;0
3127;206313;745;0;0;0;0;.00nan;0;0
3127;180990;744;100;26;0;26;1.000;3600000;0
3127;207771;744;0;0;0;0;.00nan;0;0
3127;187118;745;86;35;3;32;.914;3600000;0
3128;1061;751;0;0;0;0;.00nan;0;0
3128;75362;749;0;0;0;0;.00nan;0;0
3128;85797;749;86;34;2;32;.941;3765000;0
3128;148788;751;89;42;3;39;.929;3765000;0
3129;211572;742;74;36;3;33;.917;3580000;0
3129;56565;741;0;0;0;0;.00nan;0;0
3129;85670;741;100;38;1;37;.974;3600000;0
3129;148573;742;0;0;0;0;.00nan;0;0
3130;180177;747;62;30;3;27;.900;3591000;0
3130;76405;747;0;0;0;0;.00nan;0;0
3130;78573;737;89;30;2;28;.933;3600000;0
3130;139467;737;0;0;0;0;.00nan;0;0
3131;1957;1880;89;36;2;34;.944;3600000;0
3131;2643;738;46;34;6;28;.824;3600000;0
3131;209518;738;0;0;0;0;.00nan;0;0
3131;-1;1880;0;0;0;0;.00nan;0;0
3132;164424;736;70;31;3;28;.903;3572000;0
3132;31165;752;0;0;0;0;.00nan;0;0
3132;213298;736;0;0;0;0;.00nan;0;0
3132;149221;752;75;25;2;23;.920;3600000;0
3133;3435;739;69;28;2;26;.929;3600000;0
3133;198736;3789;0;0;0;0;.00nan;0;0
3133;-1;739;0;0;0;0;.00nan;0;0
3133;143301;3789;100;30;0;30;1.000;3600000;0
3134;203977;729;0;0;0;0;.00nan;0;0
3134;211604;729;60;37;5;32;.865;3600000;0
3134;66245;733;81;29;1;28;.966;3600000;0
3134;148503;733;0;0;0;0;.00nan;0;0
3135;163195;743;79;20;1;19;.950;3600000;0
3135;180990;744;84;40;3;37;.925;3578000;0
3135;207771;744;0;0;0;0;.00nan;0;0
3135;223469;743;0;0;0;0;.00nan;0;0
3136;212999;2168;79;38;3;35;.921;3600000;0
3136;49935;2168;0;0;0;0;.00nan;0;0
3136;56565;741;0;0;0;0;.00nan;0;0
3136;85670;741;44;29;5;24;.828;3600000;0
3137;175764;734;84;37;2;35;.946;3875000;0
3137;207184;740;0;0;0;0;.00nan;0;0
3137;86151;740;71;30;3;27;.900;3875000;0
3137;148508;734;0;0;0;0;.00nan;0;0
3138;180177;747;0;0;0;0;.00nan;0;0
3138;75362;749;0;0;0;0;.00nan;0;0
3138;76405;747;88;33;2;31;.939;3600000;0
3138;85797;749;84;52;4;48;.923;3539000;0
3139;184158;748;82;35;3;32;.914;3900000;0
3139;206313;745;0;0;0;0;.00nan;0;0
3139;187118;745;76;37;3;34;.919;3900000;0
3139;218546;748;0;0;0;0;.00nan;0;0
3140;211572;742;0;0;0;0;.00nan;0;0
3140;31165;752;58;33;4;29;.879;3600000;0
3140;148573;742;98;28;1;27;.964;3600000;0
3140;149221;752;0;0;0;0;.00nan;0;0
3141;1061;751;93;39;2;37;.949;3600000;0
3141;3435;739;51;32;5;27;.844;3600000;0
3141;-1;739;0;0;0;0;.00nan;0;0
3141;148788;751;0;0;0;0;.00nan;0;0
3142;1957;1880;100;24;0;24;1.000;3600000;0
3142;164424;736;74;27;2;25;.926;3583000;0
3142;213298;736;0;0;0;0;.00nan;0;0
3142;-1;1880;0;0;0;0;.00nan;0;0
3143;595;732;0;0;0;0;.00nan;0;0
3143;203977;729;0;0;0;0;.00nan;0;0
3143;211604;729;80;36;2;34;.944;3600000;0
3143;87798;732;76;32;3;29;.906;3549000;0
3144;2643;738;69;32;4;28;.875;3591000;0
3144;209518;738;0;0;0;0;.00nan;0;0
3144;170547;764;0;0;0;0;.00nan;0;0
3144;-1;764;75;28;2;26;.929;3600000;0
3145;163195;743;77;24;1;23;.958;3600000;0
3145;175764;734;81;35;2;33;.943;3600000;0
3145;223469;743;0;0;0;0;.00nan;0;0
3145;148508;734;0;0;0;0;.00nan;0;0
3146;206313;745;0;0;0;0;.00nan;0;0
3146;180177;747;0;0;0;0;.00nan;0;0
3146;187118;745;90;42;3;39;.929;3813000;0
3146;76405;747;81;33;2;31;.939;3813000;0
3147;184158;748;76;22;1;21;.955;3600000;0
3147;207184;740;0;0;0;0;.00nan;0;0
3147;218546;748;0;0;0;0;.00nan;0;0
3147;86151;740;60;23;2;21;.913;3565000;0
3148;211572;742;0;0;0;0;.00nan;0;0
3148;180990;744;0;0;0;0;.00nan;0;0
3148;207771;744;94;48;3;45;.938;3544000;0
3148;148573;742;73;26;2;24;.923;3600000;0
3149;212999;2168;0;0;0;0;.00nan;0;0
3149;49935;2168;84;46;5;41;.891;3600000;0
3149;78573;737;51;17;2;15;.882;3600000;0
3149;139467;737;0;0;0;0;.00nan;0;0
3150;1957;1880;63;26;2;24;.923;3600000;0
3150;-1;1880;0;0;0;0;.00nan;0;0
3150;56565;741;100;45;1;44;.978;3600000;0
3150;85670;741;0;0;0;0;.00nan;0;0
3151;2643;738;88;46;3;43;.935;3574000;0
3151;209518;738;0;0;0;0;.00nan;0;0
3151;66245;733;0;0;0;0;.00nan;0;0
3151;148503;733;84;29;1;28;.966;3600000;0
3152;595;732;0;0;0;0;.00nan;0;0
3152;203977;729;84;28;1;27;.964;3244000;0
3152;211604;729;18;8;4;4;.500;274000;0
3152;87798;732;72;32;3;29;.906;3600000;0
3153;198736;3789;0;0;0;0;.00nan;0;0
3153;170547;764;0;0;0;0;.00nan;0;0
3153;-1;764;27;19;5;14;.737;3557000;0
3153;143301;3789;81;38;3;35;.921;3600000;0
3154;3435;739;59;34;4;30;.882;3600000;0
3154;-1;739;0;0;0;0;.00nan;0;0
3154;75362;749;0;0;0;0;.00nan;0;0
3154;85797;749;68;31;3;28;.903;3600000;0
3155;1061;751;0;0;0;0;.00nan;0;0
3155;31165;752;0;0;0;0;.00nan;0;0
3155;148788;751;81;31;2;29;.935;3600000;0
3155;149221;752;65;32;4;28;.875;3586000;0
3156;31165;752;91;46;3;43;.935;3600000;0
3156;212999;2168;0;0;0;0;.00nan;0;0
3156;49935;2168;100;32;1;31;.969;3600000;0
3156;149221;752;0;0;0;0;.00nan;0;0
3157;180990;744;71;39;4;35;.897;3600000;0
3157;207771;744;0;0;0;0;.00nan;0;0
3157;78573;737;51;20;3;17;.850;3600000;0
3157;139467;737;0;0;0;0;.00nan;0;0
3158;595;732;0;0;0;0;.00nan;0;0
3158;175764;734;77;23;1;22;.957;3600000;0
3158;87798;732;64;33;4;29;.879;3600000;0
3158;148508;734;0;0;0;0;.00nan;0;0
3159;206313;745;0;0;0;0;.00nan;0;0
3159;187118;745;56;29;4;25;.862;3600000;0
3159;66245;733;64;40;5;35;.875;3600000;0
3159;148503;733;0;0;0;0;.00nan;0;0
3160;198736;3789;0;0;0;0;.00nan;0;0
3160;56565;741;0;0;0;0;.00nan;0;0
3160;85670;741;91;38;3;35;.921;3600000;0
3160;143301;3789;88;19;0;19;1.000;3600000;0
3161;3435;739;57;35;5;30;.857;3600000;0
3161;180177;747;0;0;0;0;.00nan;0;0
3161;-1;739;0;0;0;0;.00nan;0;0
3161;76405;747;79;23;1;22;.957;3600000;0
3162;2643;738;48;30;4;26;.867;3600000;0
3162;209518;738;0;0;0;0;.00nan;0;0
3162;207184;740;77;21;1;20;.952;3600000;0
3162;86151;740;0;0;0;0;.00nan;0;0
3163;164424;736;38;36;6;30;.833;3600000;0
3163;184158;748;84;25;1;24;.960;3600000;0
3163;213298;736;0;0;0;0;.00nan;0;0
3163;218546;748;0;0;0;0;.00nan;0;0
3164;1957;1880;100;36;0;36;1.000;3600000;0
3164;163195;743;0;0;0;0;.00nan;0;0
3164;223469;743;72;24;1;23;.958;3562000;0
3164;-1;1880;0;0;0;0;.00nan;0;0
3165;1061;751;0;0;0;0;.00nan;0;0
3165;75362;749;0;0;0;0;.00nan;0;0
3165;85797;749;61;29;3;26;.897;3600000;0
3165;148788;751;63;34;4;30;.882;3575000;0
3166;2643;738;98;47;2;45;.957;3576000;0
3166;209518;738;0;0;0;0;.00nan;0;0
3166;78573;737;91;28;1;27;.964;3600000;0
3166;139467;737;0;0;0;0;.00nan;0;0
3167;206313;745;0;0;0;0;.00nan;0;0
3167;211572;742;0;0;0;0;.00nan;0;0
3167;187118;745;98;38;2;36;.947;3600000;0
3167;148573;742;70;34;4;30;.882;3561000;0
3168;203977;729;72;33;3;30;.909;3600000;0
3168;211604;729;0;0;0;0;.00nan;0;0
3168;180990;744;28;21;5;16;.762;3560000;0
3168;207771;744;0;0;0;0;.00nan;0;0
3169;56565;741;0;0;0;0;.00nan;0;0
3169;66245;733;88;35;2;33;.943;3600000;0
3169;85670;741;54;22;3;19;.864;3582000;0
3169;148503;733;0;0;0;0;.00nan;0;0
3170;180177;747;0;0;0;0;.00nan;0;0
3170;212999;2168;0;0;0;0;.00nan;0;0
3170;49935;2168;80;39;2;37;.949;3588000;0
3170;76405;747;100;30;0;30;1.000;3600000;0
3171;595;732;0;0;0;0;.00nan;0;0
3171;207184;740;0;0;0;0;.00nan;0;0
3171;86151;740;82;30;1;29;.967;3600000;0
3171;87798;732;61;27;3;24;.889;3542000;0
3172;1957;1880;99;39;1;38;.974;3600000;0
3172;170547;764;62;22;2;20;.909;3600000;0
3172;-1;764;0;0;0;0;.00nan;0;0
3172;-1;1880;0;0;0;0;.00nan;0;0
3173;198736;3789;0;0;0;0;.00nan;0;0
3173;164424;736;53;36;5;31;.861;3600000;0
3173;213298;736;0;0;0;0;.00nan;0;0
3173;143301;3789;75;25;2;23;.920;3600000;0
3174;1061;751;43;25;4;21;.840;2058000;0
3174;75362;749;87;32;2;30;.938;3600000;0
3174;85797;749;0;0;0;0;.00nan;0;0
3174;148788;751;66;21;1;20;.952;1542000;0
3175;163195;743;67;32;3;29;.906;3554000;0
3175;184158;748;85;36;2;34;.944;3600000;0
3175;223469;743;0;0;0;0;.00nan;0;0
3175;218546;748;0;0;0;0;.00nan;0;0
3176;31165;752;0;0;0;0;.00nan;0;0
3176;180990;744;100;29;0;29;1.000;3724000;0
3176;207771;744;0;0;0;0;.00nan;0;0
3176;149221;752;94;49;1;48;.980;3724000;0
3177;3435;739;100;32;0;32;1.000;3600000;0
3177;213298;736;96;35;1;34;.971;3544000;0
3177;218542;736;0;0;0;0;.00nan;0;0
3177;-1;739;0;0;0;0;.00nan;0;0
3178;2643;738;97;41;2;39;.951;3582000;0
3178;198736;3789;0;0;0;0;.00nan;0;0
3178;164424;738;0;0;0;0;.00nan;0;0
3178;143301;3789;100;34;0;34;1.000;3600000;0
3179;206313;745;0;0;0;0;.00nan;0;0
3179;180177;747;0;0;0;0;.00nan;0;0
3179;187118;745;90;53;4;49;.925;3591000;0
3179;76405;747;60;15;2;13;.867;3600000;0
3180;203977;729;0;0;0;0;.00nan;0;0
3180;211604;729;85;37;3;34;.919;3600000;0
3180;78573;737;61;32;4;28;.875;3594000;0
3180;139467;737;0;0;0;0;.00nan;0;0
3181;207184;740;0;0;0;0;.00nan;0;0
3181;66245;733;100;40;1;39;.975;3600000;0
3181;86151;740;45;39;6;33;.846;3600000;0
3181;148503;733;0;0;0;0;.00nan;0;0
3182;184158;748;66;27;3;24;.889;3561000;0
3182;212999;2168;0;0;0;0;.00nan;0;0
3182;218546;748;0;0;0;0;.00nan;0;0
3182;49935;2168;85;35;2;33;.943;3600000;0
3183;595;732;60;7;0;7;1.000;427000;0
3183;219985;1880;0;0;0;0;.00nan;0;0
3183;87798;732;37;38;8;30;.789;3106000;0
3183;148573;1880;25;24;6;18;.750;3600000;0
3184;163195;743;39;20;4;16;.800;3600000;0
3184;170547;764;33;28;6;22;.786;2671000;0
3184;223469;743;0;0;0;0;.00nan;0;0
3184;-1;764;57;6;0;6;1.000;929000;0
3185;1061;751;0;0;0;0;.00nan;0;0
3185;75362;749;0;0;0;0;.00nan;0;0
3185;85797;749;54;34;5;29;.853;3600000;0
3185;148788;751;85;33;2;31;.939;3600000;0
3186;595;732;0;0;0;0;.00nan;0;0
3186;31165;752;0;0;0;0;.00nan;0;0
3186;87798;732;80;23;1;22;.957;3600000;0
3186;149221;752;79;22;2;20;.909;3544000;0
3187;66245;733;78;41;3;38;.927;3600000;0
3187;78573;737;17;21;6;15;.714;3600000;0
3187;139467;737;0;0;0;0;.00nan;0;0
3187;148503;733;0;0;0;0;.00nan;0;0
3188;2643;738;70;29;2;27;.931;3600000;0
3188;164424;738;0;0;0;0;.00nan;0;0
3188;170547;764;0;0;0;0;.00nan;0;0
3188;-1;764;88;36;3;33;.917;3576000;0
3189;206313;745;69;25;2;23;.920;3900000;0
3189;180177;747;0;0;0;0;.00nan;0;0
3189;187118;745;0;0;0;0;.00nan;0;0
3189;76405;747;65;23;2;21;.913;3900000;0
3190;203977;729;0;0;0;0;.00nan;0;0
3190;211604;729;83;41;3;38;.927;3551000;0
3190;213298;736;92;31;1;30;.968;3600000;0
3190;218542;736;0;0;0;0;.00nan;0;0
3191;1957;742;71;18;1;17;.944;3600000;0
3191;212999;2168;0;0;0;0;.00nan;0;0
3191;49935;2168;85;50;3;47;.940;3515000;0
3191;-1;742;0;0;0;0;.00nan;0;0
3192;198736;3789;0;0;0;0;.00nan;0;0
3192;219985;1880;0;0;0;0;.00nan;0;0
3192;143301;3789;68;16;1;15;.938;3600000;0
3192;148573;1880;87;42;3;39;.929;3559000;0
3193;163195;743;72;38;4;34;.895;3600000;0
3193;180990;744;54;36;5;31;.861;3600000;0
3193;207771;744;0;0;0;0;.00nan;0;0
3193;223469;743;0;0;0;0;.00nan;0;0
3194;170547;764;83;35;2;33;.943;3645000;0
3194;175764;734;68;20;1;19;.950;3645000;0
3194;-1;764;0;0;0;0;.00nan;0;0
3194;148508;734;0;0;0;0;.00nan;0;0
3195;1061;751;71;42;4;38;.905;3600000;0
3195;56565;741;0;0;0;0;.00nan;0;0
3195;85670;741;73;19;1;18;.947;3600000;0
3195;148788;751;0;0;0;0;.00nan;0;0
3196;184158;748;100;32;1;31;.969;3600000;0
3196;218546;748;0;0;0;0;.00nan;0;0
3196;75362;749;0;0;0;0;.00nan;0;0
3196;85797;749;66;41;5;36;.878;3600000;0
3197;3435;739;70;24;2;22;.917;3600000;0
3197;207184;740;0;0;0;0;.00nan;0;0
3197;-1;739;0;0;0;0;.00nan;0;0
3197;86151;740;59;42;5;37;.881;3600000;0
3198;595;732;0;0;0;0;.00nan;0;0
3198;212999;2168;0;0;0;0;.00nan;0;0
3198;49935;2168;57;40;6;34;.850;3600000;0
3198;87798;732;66;28;2;26;.929;3600000;0
3199;198736;3789;0;0;0;0;.00nan;0;0
3199;203977;729;0;0;0;0;.00nan;0;0
3199;211604;729;78;46;3;43;.935;3550000;0
3199;143301;3789;75;23;1;22;.957;3600000;0
3200;219985;1880;0;0;0;0;.00nan;0;0
3200;66245;733;58;42;5;37;.881;3557000;0
3200;148503;733;0;0;0;0;.00nan;0;0
3200;148573;1880;60;33;4;29;.879;3600000;0
3201;1957;742;98;35;1;34;.971;3600000;0
3201;2643;738;92;46;3;43;.935;3528000;0
3201;164424;738;0;0;0;0;.00nan;0;0
3201;-1;742;0;0;0;0;.00nan;0;0
3202;180177;747;0;0;0;0;.00nan;0;0
3202;180990;744;95;23;0;23;1.000;3600000;0
3202;207771;744;0;0;0;0;.00nan;0;0
3202;76405;747;45;24;4;20;.833;3600000;0
3203;31165;752;0;0;0;0;.00nan;0;0
3203;56565;741;0;0;0;0;.00nan;0;0
3203;85670;741;68;31;3;28;.903;3739000;0
3203;149221;752;77;32;2;30;.938;3739000;0
3204;75362;749;0;0;0;0;.00nan;0;0
3204;78573;737;0;0;0;0;.00nan;0;0
3204;85797;749;92;36;1;35;.972;3600000;0
3204;139467;737;64;32;2;30;.938;3571000;0
3205;163195;743;86;34;2;32;.941;3600000;0
3205;206313;745;46;4;1;3;.750;686000;0
3205;187118;745;50;39;6;33;.846;2914000;0
3205;223469;743;0;0;0;0;.00nan;0;0
3206;175764;734;83;32;1;31;.969;3600000;0
3206;207184;740;0;0;0;0;.00nan;0;0
3206;86151;740;71;27;2;25;.926;3559000;0
3206;148508;734;0;0;0;0;.00nan;0;0
3207;3435;739;90;40;2;38;.950;3600000;0
3207;213298;736;0;0;0;0;.00nan;0;0
3207;218542;736;60;45;5;40;.889;3600000;0
3207;-1;739;0;0;0;0;.00nan;0;0
3208;198736;3789;50;24;3;21;.875;3600000;0
3208;184158;748;75;47;4;43;.915;3600000;0
3208;218546;748;0;0;0;0;.00nan;0;0
3208;143301;3789;0;0;0;0;.00nan;0;0
3209;2643;738;26;29;6;23;.793;3320000;0
3209;164424;738;48;0;0;0;.00nan;280000;0
3209;219985;1880;0;0;0;0;.00nan;0;0
3209;148573;1880;63;16;1;15;.938;3600000;0
3210;1061;751;0;0;0;0;.00nan;0;0
3210;1957;742;91;32;1;31;.969;3600000;0
3210;-1;742;0;0;0;0;.00nan;0;0
3210;148788;751;70;30;3;27;.900;3513000;0
3211;170547;764;0;0;0;0;.00nan;0;0
3211;-1;764;84;43;4;39;.907;3900000;0
3211;78573;737;61;31;4;27;.871;3900000;0
3211;139467;737;0;0;0;0;.00nan;0;0
3212;3435;739;67;28;3;25;.893;3600000;0
3212;163195;743;23;4;3;1;.250;479000;0
3212;223469;743;68;38;4;34;.895;3121000;0
3212;-1;739;0;0;0;0;.00nan;0;0
3213;203977;729;0;0;0;0;.00nan;0;0
3213;175764;734;0;0;0;0;.00nan;0;0
3213;218546;729;62;42;6;36;.857;3568000;0
3213;148508;734;50;18;4;14;.778;3600000;0
3214;206313;745;0;0;0;0;.00nan;0;0
3214;187118;745;65;28;4;24;.857;3570000;0
3214;56565;741;0;0;0;0;.00nan;0;0
3214;85670;741;97;41;2;39;.951;3600000;0
3215;207184;740;0;0;0;0;.00nan;0;0
3215;66245;733;45;29;4;25;.862;3900000;0
3215;86151;740;68;34;4;30;.882;3900000;0
3215;148503;733;0;0;0;0;.00nan;0;0
3216;31165;752;0;0;0;0;.00nan;0;0
3216;-1;747;0;0;0;0;.00nan;0;0
3216;76405;747;52;26;4;22;.846;3900000;0
3216;149221;752;85;48;4;44;.917;3900000;0
3217;595;732;0;0;0;0;.00nan;0;0
3217;75362;749;0;0;0;0;.00nan;0;0
3217;85797;749;80;26;1;25;.962;3600000;0
3217;87798;732;73;36;3;33;.917;3569000;0
3218;198736;3789;0;0;0;0;.00nan;0;0
3218;219985;1880;0;0;0;0;.00nan;0;0
3218;143301;3789;83;28;1;27;.964;3600000;0
3218;148573;1880;100;27;0;27;1.000;3600000;0
3219;1061;751;88;42;3;39;.929;3800000;0
3219;1957;742;72;28;2;26;.929;3800000;0
3219;167642;751;0;0;0;0;.00nan;0;0
3219;-1;742;0;0;0;0;.00nan;0;0
3220;180990;744;67;32;3;29;.906;3540000;0
3220;207771;744;0;0;0;0;.00nan;0;0
3220;56565;741;0;0;0;0;.00nan;0;0
3220;85670;741;88;31;1;30;.968;3600000;0
3221;31165;752;0;0;0;0;.00nan;0;0
3221;212999;2168;85;31;2;29;.935;3600000;0
3221;49935;2168;0;0;0;0;.00nan;0;0
3221;149221;752;88;41;3;38;.927;3567000;0
3222;175764;734;85;27;1;26;.963;3600000;0
3222;78573;737;73;24;2;22;.917;3555000;0
3222;139467;737;0;0;0;0;.00nan;0;0
3222;148508;734;0;0;0;0;.00nan;0;0
3223;3435;739;59;26;3;23;.885;3900000;0
3223;207184;740;0;0;0;0;.00nan;0;0
3223;-1;739;0;0;0;0;.00nan;0;0
3223;86151;740;87;44;3;41;.932;3900000;0
3224;2643;738;88;31;1;30;.968;3600000;0
3224;164424;738;0;0;0;0;.00nan;0;0
3224;206313;745;0;0;0;0;.00nan;0;0
3224;187118;745;66;33;3;30;.909;3553000;0
3225;203977;729;81;35;2;33;.943;3550000;0
3225;218546;729;0;0;0;0;.00nan;0;0
3225;66245;733;96;26;0;26;1.000;3600000;0
3225;148503;733;0;0;0;0;.00nan;0;0
3226;170547;764;96;50;3;47;.940;3575000;0
3226;-1;764;0;0;0;0;.00nan;0;0
3226;-1;747;0;0;0;0;.00nan;0;0
3226;76405;747;77;28;2;26;.929;3600000;0
3227;147;748;0;0;0;0;.00nan;0;0
3227;595;732;0;0;0;0;.00nan;0;0
3227;184158;748;68;16;1;15;.938;3600000;0
3227;87798;732;48;38;6;32;.842;3600000;0
3228;163195;743;49;20;4;16;.800;3600000;0
3228;223469;743;0;0;0;0;.00nan;0;0
3228;213298;736;28;23;5;18;.783;2029000;0
3228;218542;736;49;6;1;5;.833;1498000;0
3229;1957;742;100;31;1;30;.968;3600000;0
3229;-1;742;0;0;0;0;.00nan;0;0
3229;75362;749;0;0;0;0;.00nan;0;0
3229;85797;749;77;35;2;33;.943;3561000;0
3230;147;748;0;0;0;0;.00nan;0;0
3230;184158;748;63;20;2;18;.900;3600000;0
3230;180990;744;0;0;0;0;.00nan;0;0
3230;207771;744;62;34;3;31;.912;3600000;0
3231;170547;764;0;0;0;0;.00nan;0;0
3231;212999;2168;0;0;0;0;.00nan;0;0
3231;-1;764;72;29;2;27;.931;3732000;0
3231;49935;2168;98;31;1;30;.968;3732000;0
3232;198736;3789;0;0;0;0;.00nan;0;0
3232;78573;737;83;38;2;36;.947;3579000;0
3232;139467;737;0;0;0;0;.00nan;0;0
3232;143301;3789;79;15;0;15;1.000;3600000;0
3233;206313;745;0;0;0;0;.00nan;0;0
3233;31165;752;34;10;3;7;.700;204000;0
3233;187118;745;70;20;1;19;.950;3600000;0
3233;149221;752;73;42;4;38;.905;3396000;0
3234;2643;738;75;37;3;34;.919;3600000;0
3234;203977;729;0;0;0;0;.00nan;0;0
3234;164424;738;0;0;0;0;.00nan;0;0
3234;218546;729;56;34;5;29;.853;3565000;0
3235;175764;734;44;26;4;22;.846;3595000;0
3235;56565;741;0;0;0;0;.00nan;0;0
3235;85670;741;86;36;2;34;.944;3600000;0
3235;148508;734;0;0;0;0;.00nan;0;0
3236;163195;743;71;28;3;25;.893;3600000;0
3236;219985;1880;0;0;0;0;.00nan;0;0
3236;223469;743;0;0;0;0;.00nan;0;0
3236;148573;1880;55;37;5;32;.865;3570000;0
3237;595;732;84;38;2;36;.947;3900000;0
3237;3435;739;96;35;2;33;.943;3900000;0
3237;-1;739;0;0;0;0;.00nan;0;0
3237;87798;732;0;0;0;0;.00nan;0;0
3238;207184;740;0;0;0;0;.00nan;0;0
3238;213298;736;48;28;4;24;.857;3549000;0
3238;218542;736;0;0;0;0;.00nan;0;0
3238;86151;740;67;29;3;26;.897;3600000;0
3239;1957;742;66;35;4;31;.886;3576000;0
3239;-1;742;0;0;0;0;.00nan;0;0
3239;75362;749;83;32;3;29;.906;3600000;0
3239;85797;749;0;0;0;0;.00nan;0;0
3240;147;748;0;0;0;0;.00nan;0;0
3240;184158;748;73;23;2;21;.913;3600000;0
3240;31165;752;0;0;0;0;.00nan;0;0
3240;149221;752;80;44;3;41;.932;3559000;0
3241;1061;751;56;40;5;35;.875;3600000;0
3241;167642;751;0;0;0;0;.00nan;0;0
3241;78573;737;89;19;0;19;1.000;3600000;0
3241;139467;737;0;0;0;0;.00nan;0;0
3242;203977;729;60;34;4;30;.882;3600000;0
3242;212999;2168;0;0;0;0;.00nan;0;0
3242;218546;729;0;0;0;0;.00nan;0;0
3242;49935;2168;49;29;5;24;.828;3552000;0
3243;-1;747;0;0;0;0;.00nan;0;0
3243;75362;749;0;0;0;0;.00nan;0;0
3243;76405;747;57;25;3;22;.880;3600000;0
3243;85797;749;52;30;4;26;.867;3542000;0
3244;219985;1880;0;0;0;0;.00nan;0;0
3244;213298;736;67;28;2;26;.929;3784000;0
3244;218542;736;0;0;0;0;.00nan;0;0
3244;148573;1880;49;24;3;21;.875;3784000;0
3245;595;732;0;0;0;0;.00nan;0;0
3245;56565;741;0;0;0;0;.00nan;0;0
3245;85670;741;90;29;1;28;.966;3900000;0
3245;87798;732;100;29;1;28;.966;3900000;0
3246;163195;743;58;30;4;26;.867;3600000;0
3246;170547;764;100;37;0;37;1.000;3600000;0
3246;223469;743;0;0;0;0;.00nan;0;0
3246;-1;764;0;0;0;0;.00nan;0;0
3247;175764;734;94;21;0;21;1.000;3600000;0
3247;66245;733;71;47;5;42;.894;3600000;0
3247;148503;733;0;0;0;0;.00nan;0;0
3247;148508;734;0;0;0;0;.00nan;0;0
3248;1957;742;70;27;2;25;.926;3600000;0
3248;206313;745;0;0;0;0;.00nan;0;0
3248;187118;745;69;38;4;34;.895;3590000;0
3248;-1;742;0;0;0;0;.00nan;0;0
3249;180990;744;51;32;4;28;.875;3573000;0
3249;207771;744;0;0;0;0;.00nan;0;0
3249;75362;749;0;0;0;0;.00nan;0;0
3249;85797;749;45;18;3;15;.833;3600000;0
3250;213298;736;0;0;0;0;.00nan;0;0
3250;218542;736;63;45;5;40;.889;3600000;0
3250;78573;737;70;22;1;21;.955;3600000;0
3250;139467;737;0;0;0;0;.00nan;0;0
3251;198736;3789;0;0;0;0;.00nan;0;0
3251;207184;740;0;0;0;0;.00nan;0;0
3251;86151;740;100;43;0;43;1.000;3900000;0
3251;143301;3789;66;20;0;20;1.000;3900000;0
3252;1061;751;96;37;2;35;.946;3600000;0
3252;3435;739;0;0;0;0;.00nan;0;0
3252;167642;751;0;0;0;0;.00nan;0;0
3252;-1;739;47;25;4;21;.840;3512000;0
3253;1957;742;0;0;0;0;.00nan;0;0
3253;-1;742;85;42;2;40;.952;3584000;0
3253;56565;741;0;0;0;0;.00nan;0;0
3253;85670;741;64;16;1;15;.938;3600000;0
3254;147;748;0;0;0;0;.00nan;0;0
3254;184158;748;100;31;0;31;1.000;3900000;0
3254;-1;747;0;0;0;0;.00nan;0;0
3254;76405;747;95;29;0;29;1.000;3900000;0
3255;203977;729;0;0;0;0;.00nan;0;0
3255;219985;1880;0;0;0;0;.00nan;0;0
3255;218546;729;99;46;2;44;.957;3600000;0
3255;148573;1880;33;22;5;17;.773;3600000;0
3256;595;732;95;26;0;26;1.000;3600000;0
3256;163195;743;98;32;1;31;.969;3600000;0
3256;223469;743;0;0;0;0;.00nan;0;0
3256;87798;732;0;0;0;0;.00nan;0;0
3257;170547;764;100;29;0;29;1.000;3600000;0
3257;212999;2168;0;0;0;0;.00nan;0;0
3257;-1;764;0;0;0;0;.00nan;0;0
3257;49935;2168;79;36;2;34;.944;3566000;0
3258;206313;745;0;0;0;0;.00nan;0;0
3258;31165;752;0;0;0;0;.00nan;0;0
3258;187118;745;77;35;3;32;.914;3588000;0
3258;149221;752;90;55;2;53;.964;3600000;0
3259;2643;738;100;40;2;38;.950;3600000;0
3259;164424;738;0;0;0;0;.00nan;0;0
3259;175764;734;16;21;6;15;.714;2687000;0
3259;148508;734;47;3;1;2;.667;913000;0
3260;163195;743;53;18;3;15;.833;3600000;0
3260;180990;744;69;46;4;42;.913;3600000;0
3260;207771;744;0;0;0;0;.00nan;0;0
3260;223469;743;0;0;0;0;.00nan;0;0
3261;595;732;49;30;4;26;.867;3600000;0
3261;78573;737;72;27;2;25;.926;3600000;0
3261;87798;732;0;0;0;0;.00nan;0;0
3261;139467;737;0;0;0;0;.00nan;0;0
3262;198736;3789;50;2;0;2;1.000;318000;0
3262;175764;734;46;26;4;22;.846;3600000;0
3262;143301;3789;42;34;6;28;.824;3282000;0
3262;148508;734;0;0;0;0;.00nan;0;0
3263;2643;738;97;34;1;33;.971;3900000;0
3263;164424;738;0;0;0;0;.00nan;0;0
3263;207184;740;0;0;0;0;.00nan;0;0
3263;86151;740;100;40;1;39;.975;3900000;0
3264;3435;739;64;13;1;12;.923;3600000;0
3264;-1;739;0;0;0;0;.00nan;0;0
3264;66245;733;0;0;0;0;.00nan;0;0
3264;148503;733;81;51;4;47;.922;3600000;0
3265;147;748;0;0;0;0;.00nan;0;0
3265;184158;748;88;38;2;36;.947;3600000;0
3265;212999;2168;0;0;0;0;.00nan;0;0
3265;49935;2168;53;22;3;19;.864;3571000;0
3266;219985;1880;0;0;0;0;.00nan;0;0
3266;56565;741;0;0;0;0;.00nan;0;0
3266;85670;741;47;34;5;29;.853;3523000;0
3266;148573;1880;76;38;3;35;.921;3600000;0
3267;203977;729;74;40;4;36;.900;3600000;0
3267;170547;764;30;26;6;20;.769;2350000;0
3267;218546;729;0;0;0;0;.00nan;0;0
3267;-1;764;56;9;1;8;.889;1250000;0
3268;1957;742;69;28;2;26;.929;3543000;0
3268;213298;736;83;31;1;30;.968;3600000;0
3268;218542;736;0;0;0;0;.00nan;0;0
3268;-1;742;0;0;0;0;.00nan;0;0
3269;1061;751;72;34;3;31;.912;3513000;0
3269;167642;751;0;0;0;0;.00nan;0;0
3269;-1;747;0;0;0;0;.00nan;0;0
3269;76405;747;75;21;1;20;.952;3600000;0
3270;31165;752;66;33;3;30;.909;3519000;0
3270;75362;749;0;0;0;0;.00nan;0;0
3270;85797;749;68;17;1;16;.941;3600000;0
3270;149221;752;0;0;0;0;.00nan;0;0
3271;180990;744;66;24;2;22;.917;3753000;0
3271;212999;2168;0;0;0;0;.00nan;0;0
3271;207771;744;0;0;0;0;.00nan;0;0
3271;49935;2168;67;27;3;24;.889;3753000;0
3272;198736;3789;0;0;0;0;.00nan;0;0
3272;66245;733;80;46;4;42;.913;3560000;0
3272;143301;3789;53;23;3;20;.870;3600000;0
3272;148503;733;0;0;0;0;.00nan;0;0
3273;3435;739;91;19;0;19;1.000;3600000;0
3273;207184;740;54;28;4;24;.857;3314000;0
3273;-1;739;0;0;0;0;.00nan;0;0
3273;86151;740;24;5;3;2;.400;286000;0
3274;595;732;0;0;0;0;.00nan;0;0
3274;2643;738;88;40;2;38;.950;3600000;0
3274;164424;738;0;0;0;0;.00nan;0;0
3274;87798;732;52;25;3;22;.880;3600000;0
3275;163195;743;44;17;3;14;.824;3600000;0
3275;206313;745;100;38;0;38;1.000;3600000;0
3275;187118;745;0;0;0;0;.00nan;0;0
3275;223469;743;0;0;0;0;.00nan;0;0
3276;203977;729;44;27;4;23;.852;3550000;0
3276;211604;729;0;0;0;0;.00nan;0;0
3276;56565;741;69;22;2;20;.909;3600000;0
3276;85670;741;0;0;0;0;.00nan;0;0
3277;147;748;0;0;0;0;.00nan;0;0
3277;184158;748;77;47;5;42;.894;3687000;0
3277;175764;734;43;24;4;20;.833;3687000;0
3277;148508;734;0;0;0;0;.00nan;0;0
3278;1957;742;57;38;6;32;.842;3600000;0
3278;170547;764;78;23;1;22;.957;1906000;0
3278;-1;764;4;21;7;14;.667;1644000;0
3278;-1;742;0;0;0;0;.00nan;0;0
3279;1061;751;84;40;3;37;.925;3591000;0
3279;167642;751;0;0;0;0;.00nan;0;0
3279;-1;747;0;0;0;0;.00nan;0;0
3279;76405;747;99;34;2;32;.941;3600000;0
3280;219985;1880;0;0;0;0;.00nan;0;0
3280;213298;736;0;0;0;0;.00nan;0;0
3280;218542;736;38;34;5;29;.853;3600000;0
3280;148573;1880;74;21;2;19;.905;3600000;0
3281;31165;752;0;0;0;0;.00nan;0;0
3281;75362;749;0;0;0;0;.00nan;0;0
3281;85797;749;78;24;2;22;.917;3600000;0
3281;149221;752;64;40;4;36;.900;3580000;0
3282;2643;738;84;48;3;45;.938;3553000;0
3282;198736;3789;0;0;0;0;.00nan;0;0
3282;164424;738;0;0;0;0;.00nan;0;0
3282;143301;3789;72;24;2;22;.917;3600000;0
3283;3435;739;52;26;4;22;.846;3600000;0
3283;-1;739;0;0;0;0;.00nan;0;0
3283;66245;733;75;50;5;45;.900;3600000;0
3283;148503;733;0;0;0;0;.00nan;0;0
3284;203977;729;50;9;1;8;.889;1406000;0
3284;206313;745;55;25;3;22;.880;3600000;0
3284;211604;729;56;36;5;31;.861;2194000;0
3284;187118;745;0;0;0;0;.00nan;0;0
3285;595;732;98;38;1;37;.974;3600000;0
3285;56565;741;0;0;0;0;.00nan;0;0
3285;85670;741;76;37;3;34;.919;3523000;0
3285;87798;732;0;0;0;0;.00nan;0;0
3286;175764;734;75;33;2;31;.939;3900000;0
3286;78573;737;0;0;0;0;.00nan;0;0
3286;139467;737;76;28;2;26;.929;3900000;0
3286;148508;734;0;0;0;0;.00nan;0;0
3287;1061;751;78;26;1;25;.962;3600000;0
3287;167642;751;0;0;0;0;.00nan;0;0
3287;31165;752;0;0;0;0;.00nan;0;0
3287;149221;752;61;33;4;29;.879;3600000;0
3288;147;748;0;0;0;0;.00nan;0;0
3288;1957;742;100;31;0;31;1.000;3600000;0
3288;184158;748;52;19;3;16;.842;3600000;0
3288;-1;742;0;0;0;0;.00nan;0;0
3289;219985;1880;0;0;0;0;.00nan;0;0
3289;207184;740;0;0;0;0;.00nan;0;0
3289;86151;740;79;41;3;38;.927;3560000;0
3289;148573;1880;66;24;1;23;.958;3600000;0
3290;170547;764;0;0;0;0;.00nan;0;0
3290;180990;744;94;31;1;30;.968;3600000;0
3290;207771;744;0;0;0;0;.00nan;0;0
3290;-1;764;53;21;3;18;.857;3572000;0
3291;-1;747;0;0;0;0;.00nan;0;0
3291;75362;749;0;0;0;0;.00nan;0;0
3291;76405;747;100;18;0;18;1.000;3600000;0
3291;85797;749;97;35;1;34;.971;3544000;0
3292;2643;738;81;29;2;27;.931;3558000;0
3292;164424;738;0;0;0;0;.00nan;0;0
3292;66245;733;100;36;0;36;1.000;3600000;0
3292;148503;733;0;0;0;0;.00nan;0;0
3293;1061;751;0;0;0;0;.00nan;0;0
3293;167642;751;73;31;3;28;.903;3600000;0
3293;31165;752;82;42;4;38;.905;3600000;0
3293;149221;752;0;0;0;0;.00nan;0;0
3294;163195;743;61;33;4;29;.879;3578000;0
3294;206313;745;0;0;0;0;.00nan;0;0
3294;187118;745;64;23;2;21;.913;3600000;0
3294;223469;743;0;0;0;0;.00nan;0;0
3295;219985;1880;0;0;0;0;.00nan;0;0
3295;78573;737;75;35;3;32;.914;3555000;0
3295;139467;737;0;0;0;0;.00nan;0;0
3295;148573;1880;46;16;2;14;.875;3600000;0
3296;3435;739;76;24;1;23;.958;3600000;0
3296;170547;764;0;0;0;0;.00nan;0;0
3296;-1;764;81;40;3;37;.925;3595000;0
3296;-1;739;0;0;0;0;.00nan;0;0
3297;147;748;71;21;1;20;.952;3006000;0
3297;184158;748;23;6;3;3;.500;533000;0
3297;175764;734;0;0;0;0;.00nan;0;0
3297;148788;734;94;41;2;39;.951;3600000;0
3298;203977;729;0;0;0;0;.00nan;0;0
3298;211604;729;61;14;1;13;.929;3600000;0
3298;213298;736;56;41;5;36;.878;3600000;0
3298;218542;736;0;0;0;0;.00nan;0;0
3299;1957;742;82;35;2;33;.943;3596000;0
3299;180990;744;100;38;0;38;1.000;3600000;0
3299;207771;744;0;0;0;0;.00nan;0;0
3299;-1;742;0;0;0;0;.00nan;0;0
3300;207184;740;44;26;4;22;.846;3600000;0
3300;56565;741;0;0;0;0;.00nan;0;0
3300;85670;741;100;26;0;26;1.000;3600000;0
3300;86151;740;0;0;0;0;.00nan;0;0
3301;-1;747;67;9;0;9;1.000;722000;0
3301;75362;749;0;0;0;0;.00nan;0;0
3301;76405;747;39;32;6;26;.813;2835000;0
3301;85797;749;72;46;5;41;.891;3600000;0
3302;206313;745;0;0;0;0;.00nan;0;0
3302;212999;2168;0;0;0;0;.00nan;0;0
3302;187118;745;95;34;1;33;.971;3900000;0
3302;49935;2168;99;33;1;32;.970;3900000;0
3303;163195;743;87;41;3;38;.927;3546000;0
3303;198736;3789;0;0;0;0;.00nan;0;0
3303;223469;743;0;0;0;0;.00nan;0;0
3303;143301;3789;83;29;2;27;.931;3600000;0
3304;147;748;0;0;0;0;.00nan;0;0
3304;184158;748;42;20;4;16;.800;3544000;0
3304;212999;2168;91;45;3;42;.933;3600000;0
3304;49935;2168;0;0;0;0;.00nan;0;0
3305;3435;739;100;29;0;29;1.000;3600000;0
3305;175764;734;0;0;0;0;.00nan;0;0
3305;-1;739;0;0;0;0;.00nan;0;0
3305;148788;734;93;40;2;38;.950;3600000;0
3306;1957;742;53;15;2;13;.867;3600000;0
3306;203977;729;0;0;0;0;.00nan;0;0
3306;211604;729;74;39;3;36;.923;3571000;0
3306;-1;742;0;0;0;0;.00nan;0;0
3307;56565;741;0;0;0;0;.00nan;0;0
3307;66245;733;86;42;2;40;.952;3751000;0
3307;85670;741;86;35;3;32;.914;3751000;0
3307;148503;733;0;0;0;0;.00nan;0;0
3308;595;732;0;0;0;0;.00nan;0;0
3308;180990;744;64;24;2;22;.917;3600000;0
3308;207771;744;0;0;0;0;.00nan;0;0
3308;87798;732;75;33;3;30;.909;3574000;0
3309;207184;740;0;0;0;0;.00nan;0;0
3309;213298;736;73;42;5;37;.881;3600000;0
3309;218542;736;0;0;0;0;.00nan;0;0
3309;86151;740;65;15;1;14;.933;3600000;0
3310;198736;3789;0;0;0;0;.00nan;0;0
3310;31165;752;56;5;0;5;1.000;700000;0
3310;143301;3789;56;27;4;23;.852;3600000;0
3310;149221;752;29;38;7;31;.816;2900000;0
3311;3435;739;100;36;2;34;.944;3600000;0
3311;175764;734;0;0;0;0;.00nan;0;0
3311;-1;739;0;0;0;0;.00nan;0;0
3311;148788;734;54;37;6;31;.838;3600000;0
3312;1061;751;76;26;2;24;.923;3600000;0
3312;167642;751;0;0;0;0;.00nan;0;0
3312;219985;1880;0;0;0;0;.00nan;0;0
3312;148573;1880;50;28;4;24;.857;3600000;0
3313;170547;764;100;25;0;25;1.000;3749000;0
3313;-1;764;0;0;0;0;.00nan;0;0
3313;78573;737;92;34;1;33;.971;3749000;0
3313;139467;737;0;0;0;0;.00nan;0;0
3314;163195;743;80;34;2;32;.941;3600000;0
3314;223469;743;0;0;0;0;.00nan;0;0
3314;75362;749;0;0;0;0;.00nan;0;0
3314;85797;749;78;44;4;40;.909;3568000;0
3315;206313;745;70;21;1;20;.952;3600000;0
3315;180990;744;0;0;0;0;.00nan;0;0
3315;207771;744;86;39;3;36;.923;3584000;0
3315;187118;745;0;0;0;0;.00nan;0;0
3316;1957;742;77;47;5;42;.894;3600000;0
3316;2643;738;100;33;0;33;1.000;3600000;0
3316;164424;738;0;0;0;0;.00nan;0;0
3316;-1;742;0;0;0;0;.00nan;0;0
3317;213298;736;0;0;0;0;.00nan;0;0
3317;218542;736;73;28;2;26;.929;3571000;0
3317;66245;733;81;21;1;20;.952;3600000;0
3317;148503;733;0;0;0;0;.00nan;0;0
3318;147;748;0;0;0;0;.00nan;0;0
3318;184158;748;71;22;1;21;.955;3600000;0
3318;-1;747;0;0;0;0;.00nan;0;0
3318;76405;747;52;30;4;26;.867;3600000;0
3319;198736;3789;0;0;0;0;.00nan;0;0
3319;212999;2168;0;0;0;0;.00nan;0;0
3319;49935;2168;66;52;5;47;.904;3600000;0
3319;143301;3789;100;26;0;26;1.000;3600000;0
3320;1061;751;76;40;4;36;.900;3564000;0
3320;203977;729;0;0;0;0;.00nan;0;0
3320;167642;751;0;0;0;0;.00nan;0;0
3320;211604;729;74;36;3;33;.917;3600000;0
3321;56565;741;0;0;0;0;.00nan;0;0
3321;75362;749;0;0;0;0;.00nan;0;0
3321;85670;741;84;52;5;47;.904;3574000;0
3321;85797;749;82;44;4;40;.909;3600000;0
3322;219985;1880;0;0;0;0;.00nan;0;0
3322;175764;734;0;0;0;0;.00nan;0;0
3322;148573;1880;53;21;3;18;.857;3600000;0
3322;148788;734;96;44;2;42;.955;3600000;0
3323;170547;764;97;21;0;21;1.000;3600000;0
3323;207184;740;0;0;0;0;.00nan;0;0
3323;-1;764;0;0;0;0;.00nan;0;0
3323;86151;740;56;28;3;25;.893;3600000;0
3324;163195;743;67;27;2;25;.926;3571000;0
3324;223469;743;0;0;0;0;.00nan;0;0
3324;78573;737;76;24;1;23;.958;3600000;0
3324;139467;737;0;0;0;0;.00nan;0;0
3325;2643;738;89;33;1;32;.970;3600000;0
3325;3435;739;55;25;3;22;.880;3526000;0
3325;164424;738;0;0;0;0;.00nan;0;0
3325;-1;739;0;0;0;0;.00nan;0;0
3326;206313;745;0;0;0;0;.00nan;0;0
3326;187118;745;67;17;1;16;.941;3600000;0
3326;213298;736;87;45;2;43;.956;3582000;0
3326;218542;736;0;0;0;0;.00nan;0;0
3327;207184;740;0;0;0;0;.00nan;0;0
3327;180990;744;54;35;5;30;.857;3574000;0
3327;207771;744;0;0;0;0;.00nan;0;0
3327;86151;740;64;27;3;24;.889;3600000;0
3328;203977;729;0;0;0;0;.00nan;0;0
3328;211604;729;86;40;2;38;.950;3896000;0
3328;31165;752;95;48;2;46;.958;3900000;0
3328;149221;752;0;0;0;0;.00nan;0;0
3329;56565;741;0;0;0;0;.00nan;0;0
3329;78573;737;64;31;3;28;.903;3556000;0
3329;85670;741;94;27;1;26;.963;3600000;0
3329;139467;737;0;0;0;0;.00nan;0;0
3330;198736;3789;0;0;0;0;.00nan;0;0
3330;66245;733;100;28;1;27;.964;3600000;0
3330;143301;3789;70;30;3;27;.900;3522000;0
3330;148503;733;0;0;0;0;.00nan;0;0
3331;1957;742;56;33;4;29;.879;3600000;0
3331;-1;742;0;0;0;0;.00nan;0;0
3331;75362;749;0;0;0;0;.00nan;0;0
3331;85797;749;53;35;5;30;.857;3543000;0
3332;147;748;0;0;0;0;.00nan;0;0
3332;1061;751;87;34;2;32;.941;3600000;0
3332;167642;751;0;0;0;0;.00nan;0;0
3332;184158;748;67;36;4;32;.889;3543000;0
3333;163195;743;89;29;1;28;.966;3600000;0
3333;212999;2168;0;0;0;0;.00nan;0;0
3333;223469;743;0;0;0;0;.00nan;0;0
3333;49935;2168;64;35;3;32;.914;3547000;0
3334;595;732;88;46;4;42;.913;3566000;0
3334;206313;745;60;17;3;14;.824;3600000;0
3334;187118;745;0;0;0;0;.00nan;0;0
3334;87798;732;0;0;0;0;.00nan;0;0
3335;3435;739;69;21;2;19;.905;3600000;0
3335;219985;1880;0;0;0;0;.00nan;0;0
3335;-1;739;0;0;0;0;.00nan;0;0
3335;148573;1880;64;25;3;22;.880;3547000;0
3336;170547;764;96;44;2;42;.955;3900000;0
3336;-1;764;0;0;0;0;.00nan;0;0
3336;-1;747;0;0;0;0;.00nan;0;0
3336;76405;747;84;32;2;30;.938;3900000;0
3337;31165;752;0;0;0;0;.00nan;0;0
3337;78573;737;98;33;1;32;.970;3600000;0
3337;139467;737;0;0;0;0;.00nan;0;0
3337;149221;752;72;34;3;31;.912;3514000;0
3338;2643;738;85;36;2;34;.944;3741000;0
3338;164424;738;0;0;0;0;.00nan;0;0
3338;207184;740;0;0;0;0;.00nan;0;0
3338;86151;740;75;22;1;21;.955;3741000;0
3339;3435;739;64;25;2;23;.920;3600000;0
3339;198736;3789;74;40;3;37;.925;3600000;0
3339;-1;739;0;0;0;0;.00nan;0;0
3339;143301;3789;0;0;0;0;.00nan;0;0
3340;147;748;0;0;0;0;.00nan;0;0
3340;1061;751;64;37;4;33;.892;3900000;0
3340;167642;751;0;0;0;0;.00nan;0;0
3340;184158;748;54;27;4;23;.852;3900000;0
3341;595;732;65;29;3;26;.897;3900000;0
3341;203977;729;0;0;0;0;.00nan;0;0
3341;211604;729;91;38;3;35;.921;3900000;0
3341;87798;732;0;0;0;0;.00nan;0;0
3342;1957;742;69;22;2;20;.909;3600000;0
3342;-1;742;0;0;0;0;.00nan;0;0
3342;66245;733;97;49;3;46;.939;3600000;0
3342;148503;733;0;0;0;0;.00nan;0;0
3343;219985;1880;0;0;0;0;.00nan;0;0
3343;212999;2168;0;0;0;0;.00nan;0;0
3343;49935;2168;84;31;1;30;.968;3600000;0
3343;148573;1880;78;25;2;23;.920;3551000;0
3344;213298;736;0;0;0;0;.00nan;0;0
3344;218542;736;39;42;7;35;.833;3600000;0
3344;-1;747;0;0;0;0;.00nan;0;0
3344;76405;747;95;23;0;23;1.000;3600000;0
3345;56565;741;0;0;0;0;.00nan;0;0
3345;75362;749;0;0;0;0;.00nan;0;0
3345;85670;741;67;22;2;20;.909;3600000;0
3345;85797;749;70;31;3;28;.903;3595000;0
3346;163195;743;81;27;1;26;.963;3600000;0
3346;180990;744;56;38;5;33;.868;3600000;0
3346;207771;744;0;0;0;0;.00nan;0;0
3346;223469;743;0;0;0;0;.00nan;0;0
3347;2643;738;83;43;3;40;.930;3548000;0
3347;164424;738;0;0;0;0;.00nan;0;0
3347;175764;734;0;0;0;0;.00nan;0;0
3347;148788;734;78;29;2;27;.931;3600000;0
3348;31165;752;0;0;0;0;.00nan;0;0
3348;180990;744;72;32;2;30;.938;3564000;0
3348;207771;744;0;0;0;0;.00nan;0;0
3348;149221;752;80;29;1;28;.966;3600000;0
3349;-1;747;0;0;0;0;.00nan;0;0
3349;76405;747;81;47;4;43;.915;3600000;0
3349;78573;737;84;33;1;32;.970;3600000;0
3349;139467;737;0;0;0;0;.00nan;0;0
3350;147;748;0;0;0;0;.00nan;0;0
3350;1061;751;71;40;4;36;.900;3521000;0
3350;167642;751;0;0;0;0;.00nan;0;0
3350;184158;748;78;30;2;28;.933;3600000;0
3351;206313;745;0;0;0;0;.00nan;0;0
3351;212999;2168;0;0;0;0;.00nan;0;0
3351;187118;745;53;32;4;28;.875;3543000;0
3351;49935;2168;63;29;3;26;.897;3600000;0
3352;3435;739;83;15;0;15;1.000;3900000;0
3352;203977;729;0;0;0;0;.00nan;0;0
3352;211604;729;100;38;0;38;1.000;3900000;0
3352;-1;739;0;0;0;0;.00nan;0;0
3353;1957;742;82;44;3;41;.932;3575000;0
3353;170547;764;97;29;1;28;.966;3600000;0
3353;-1;764;0;0;0;0;.00nan;0;0
3353;-1;742;0;0;0;0;.00nan;0;0
3354;198736;3789;0;0;0;0;.00nan;0;0
3354;219985;1880;0;0;0;0;.00nan;0;0
3354;143301;3789;97;49;3;46;.939;3600000;0
3354;148573;1880;59;33;4;29;.879;3563000;0
3355;595;732;0;0;0;0;.00nan;0;0
3355;213298;736;92;38;2;36;.947;3768000;0
3355;218542;736;0;0;0;0;.00nan;0;0
3355;87798;732;87;26;1;25;.962;3768000;0
3356;56565;741;0;0;0;0;.00nan;0;0
3356;75362;749;0;0;0;0;.00nan;0;0
3356;85670;741;75;26;2;24;.923;3589000;0
3356;85797;749;69;18;1;17;.944;3600000;0
3357;163195;743;66;17;1;16;.941;3600000;0
3357;223469;743;0;0;0;0;.00nan;0;0
3357;66245;733;70;37;3;34;.919;3512000;0
3357;148503;733;0;0;0;0;.00nan;0;0
3358;2643;738;63;34;4;30;.882;3544000;0
3358;164424;738;0;0;0;0;.00nan;0;0
3358;207184;740;0;0;0;0;.00nan;0;0
3358;86151;740;65;25;3;22;.880;3600000;0
3359;170547;764;54;42;6;36;.857;3589000;0
3359;31165;752;72;36;4;32;.889;3600000;0
3359;-1;764;0;0;0;0;.00nan;0;0
3359;149221;752;0;0;0;0;.00nan;0;0
3360;180990;744;12;18;6;12;.667;1975000;0
3360;212999;2168;0;0;0;0;.00nan;0;0
3360;207771;744;73;16;0;16;1.000;1625000;0
3360;49935;2168;53;15;2;13;.867;3600000;0
3361;198736;3789;0;0;0;0;.00nan;0;0
3361;78573;737;64;29;3;26;.897;3600000;0
3361;139467;737;0;0;0;0;.00nan;0;0
3361;143301;3789;53;28;4;24;.857;3577000;0
3362;3435;739;55;29;4;25;.862;3537000;0
3362;-1;739;0;0;0;0;.00nan;0;0
3362;-1;747;0;0;0;0;.00nan;0;0
3362;76405;747;99;37;2;35;.946;3600000;0
3363;1061;751;95;33;1;32;.970;3600000;0
3363;167642;751;0;0;0;0;.00nan;0;0
3363;56565;741;0;0;0;0;.00nan;0;0
3363;85670;741;52;25;4;21;.840;3600000;0
3364;1957;742;53;28;4;24;.857;3600000;0
3364;206313;745;6;23;7;16;.696;2858000;0
3364;187118;745;54;5;0;5;1.000;742000;0
3364;-1;742;0;0;0;0;.00nan;0;0
3365;595;732;0;0;0;0;.00nan;0;0
3365;175764;734;0;0;0;0;.00nan;0;0
3365;87798;732;53;42;5;37;.881;3600000;0
3365;148788;734;59;29;4;25;.862;3600000;0
3366;147;748;0;0;0;0;.00nan;0;0
3366;184158;748;68;30;3;27;.900;3600000;0
3366;75362;749;0;0;0;0;.00nan;0;0
3366;85797;749;45;49;8;41;.837;3600000;0
3367;2643;738;70;18;1;17;.944;3600000;0
3367;164424;738;0;0;0;0;.00nan;0;0
3367;213298;736;0;0;0;0;.00nan;0;0
3367;218542;736;59;28;3;25;.893;3583000;0
3368;1061;751;0;0;0;0;.00nan;0;0
3368;167642;751;90;30;1;29;.967;3600000;0
3368;56565;741;64;34;3;31;.912;3600000;0
3368;85670;741;0;0;0;0;.00nan;0;0
3369;203977;729;0;0;0;0;.00nan;0;0
3369;219985;1880;0;0;0;0;.00nan;0;0
3369;211604;729;63;32;3;29;.906;3600000;0
3369;148573;1880;75;25;2;23;.920;3600000;0
3370;595;732;88;32;2;30;.938;3600000;0
3370;175764;734;0;0;0;0;.00nan;0;0
3370;87798;732;0;0;0;0;.00nan;0;0
3370;148788;734;63;34;3;31;.912;3600000;0
3371;207184;740;0;0;0;0;.00nan;0;0
3371;66245;733;78;43;3;40;.930;3600000;0
3371;86151;740;54;18;2;16;.889;3600000;0
3371;148503;733;0;0;0;0;.00nan;0;0
3372;147;748;0;0;0;0;.00nan;0;0
3372;184158;748;73;32;3;29;.906;3553000;0
3372;75362;749;68;24;2;22;.917;3600000;0
3372;85797;749;0;0;0;0;.00nan;0;0
3373;1957;742;91;49;4;45;.918;3600000;0
3373;206313;745;43;5;1;4;.800;583000;0
3373;187118;745;32;33;6;27;.818;3017000;0
3373;-1;742;0;0;0;0;.00nan;0;0
3374;180990;744;96;48;3;45;.938;3600000;0
3374;207771;744;0;0;0;0;.00nan;0;0
3374;-1;747;0;0;0;0;.00nan;0;0
3374;76405;747;80;12;0;12;1.000;3600000;0
3375;31165;752;89;31;1;30;.968;3600000;0
3375;212999;2168;0;0;0;0;.00nan;0;0
3375;49935;2168;60;23;2;21;.913;3569000;0
3375;149221;752;0;0;0;0;.00nan;0;0
3376;198736;3789;0;0;0;0;.00nan;0;0
3376;66245;733;43;32;6;26;.813;2474000;0
3376;143301;3789;92;28;1;27;.964;3600000;0
3376;148503;733;69;15;0;15;1.000;1126000;0
3377;175764;734;0;0;0;0;.00nan;0;0
3377;213298;736;100;46;1;45;.978;3600000;0
3377;218542;736;0;0;0;0;.00nan;0;0
3377;148788;734;61;28;3;25;.893;3514000;0
3378;595;732;0;0;0;0;.00nan;0;0
3378;3435;739;76;26;2;24;.923;3600000;0
3378;-1;739;0;0;0;0;.00nan;0;0
3378;87798;732;81;46;4;42;.913;3557000;0
3379;203977;729;0;0;0;0;.00nan;0;0
3379;211604;729;91;43;2;41;.953;3900000;0
3379;207184;740;0;0;0;0;.00nan;0;0
3379;86151;740;73;30;2;28;.933;3900000;0
3380;163195;743;99;30;1;29;.967;3600000;0
3380;170547;764;55;25;3;22;.880;971000;0
3380;223469;743;0;0;0;0;.00nan;0;0
3380;-1;764;23;23;6;17;.739;2629000;0
3381;147;748;0;0;0;0;.00nan;0;0
3381;184158;748;74;29;3;26;.897;3900000;0
3381;206313;745;57;22;3;19;.864;3900000;0
3381;187118;745;0;0;0;0;.00nan;0;0
3382;3435;739;72;40;4;36;.900;3561000;0
3382;-1;739;0;0;0;0;.00nan;0;0
3382;78573;737;0;0;0;0;.00nan;0;0
3382;139467;737;82;35;3;32;.914;3600000;0
3383;198736;3789;0;0;0;0;.00nan;0;0
3383;219985;1880;0;0;0;0;.00nan;0;0
3383;143301;3789;91;29;1;28;.966;3857000;0
3383;148573;1880;90;42;2;40;.952;3857000;0
3384;175764;734;0;0;0;0;.00nan;0;0
3384;75362;749;0;0;0;0;.00nan;0;0
3384;85797;749;87;42;3;39;.929;3600000;0
3384;148788;734;100;28;0;28;1.000;3600000;0
3385;31165;752;0;0;0;0;.00nan;0;0
3385;56565;741;0;0;0;0;.00nan;0;0
3385;85670;741;61;20;2;18;.900;3587000;0
3385;149221;752;100;42;0;42;1.000;3600000;0
3386;2643;738;53;40;5;35;.875;3600000;0
3386;164424;738;0;0;0;0;.00nan;0;0
3386;66245;733;94;32;1;31;.969;3600000;0
3386;148503;733;0;0;0;0;.00nan;0;0
3387;1061;751;69;27;3;24;.889;3540000;0
3387;167642;751;0;0;0;0;.00nan;0;0
3387;-1;747;0;0;0;0;.00nan;0;0
3387;76405;747;61;20;2;18;.900;3600000;0
3388;163195;743;68;27;2;25;.926;3530000;0
3388;207184;740;0;0;0;0;.00nan;0;0
3388;223469;743;0;0;0;0;.00nan;0;0
3388;86151;740;100;34;0;34;1.000;3600000;0
3389;203977;729;0;0;0;0;.00nan;0;0
3389;211604;729;94;21;0;21;1.000;3600000;0
3389;213298;736;0;0;0;0;.00nan;0;0
3389;218542;736;76;38;3;35;.921;3600000;0
3390;170547;764;43;2;1;1;.500;479000;0
3390;180990;744;38;31;6;25;.806;2980000;0
3390;207771;744;40;8;2;6;.750;578000;0
3390;-1;764;29;28;6;22;.786;3121000;0
3391;1061;751;20;30;7;23;.767;3600000;0
3391;167642;751;0;0;0;0;.00nan;0;0
3391;212999;2168;0;0;0;0;.00nan;0;0
3391;49935;2168;87;44;3;41;.932;3600000;0
3392;163195;743;74;29;2;27;.931;3546000;0
3392;198736;3789;0;0;0;0;.00nan;0;0
3392;223469;743;0;0;0;0;.00nan;0;0
3392;143301;3789;86;27;1;26;.963;3600000;0
3393;3435;739;77;37;3;34;.919;3749000;0
3393;-1;739;0;0;0;0;.00nan;0;0
3393;75362;749;0;0;0;0;.00nan;0;0
3393;85797;749;98;46;2;44;.957;3749000;0
3394;2643;738;96;28;0;28;1.000;3900000;0
3394;203977;729;0;0;0;0;.00nan;0;0
3394;164424;738;0;0;0;0;.00nan;0;0
3394;211604;729;100;29;0;29;1.000;3900000;0
3395;66245;733;81;25;1;24;.960;3600000;0
3395;78573;737;79;35;2;33;.943;3563000;0
3395;139467;737;0;0;0;0;.00nan;0;0
3395;148503;733;0;0;0;0;.00nan;0;0
3396;147;748;0;0;0;0;.00nan;0;0
3396;219985;1880;0;0;0;0;.00nan;0;0
3396;184158;748;71;38;3;35;.921;3600000;0
3396;148573;1880;59;30;4;26;.867;3572000;0
3397;31165;752;0;0;0;0;.00nan;0;0
3397;207184;740;0;0;0;0;.00nan;0;0
3397;86151;740;56;37;5;32;.865;3600000;0
3397;149221;752;30;27;6;21;.778;3600000;0
3398;175764;734;0;0;0;0;.00nan;0;0
3398;213298;736;83;31;1;30;.968;3900000;0
3398;218542;736;0;0;0;0;.00nan;0;0
3398;148788;734;79;26;1;25;.962;3900000;0
3399;180990;744;98;31;1;30;.968;3600000;0
3399;207771;744;0;0;0;0;.00nan;0;0
3399;-1;747;0;0;0;0;.00nan;0;0
3399;76405;747;94;31;2;29;.935;3542000;0
3400;1957;742;71;38;4;34;.895;3600000;0
3400;206313;745;95;32;1;31;.969;3600000;0
3400;187118;745;0;0;0;0;.00nan;0;0
3400;-1;742;0;0;0;0;.00nan;0;0
3401;170547;764;52;30;5;25;.833;3600000;0
3401;-1;764;0;0;0;0;.00nan;0;0
3401;66245;733;0;0;0;0;.00nan;0;0
3401;148503;733;100;40;0;40;1.000;3600000;0
3402;595;732;62;35;4;31;.886;3600000;0
3402;213298;736;0;0;0;0;.00nan;0;0
3402;218542;736;55;35;5;30;.857;3600000;0
3402;87798;732;0;0;0;0;.00nan;0;0
3403;219985;1880;0;0;0;0;.00nan;0;0
3403;31165;752;51;37;5;32;.865;3600000;0
3403;148573;1880;78;33;2;31;.939;3600000;0
3403;149221;752;0;0;0;0;.00nan;0;0
3404;1061;751;68;37;4;33;.892;3679000;0
3404;167642;751;0;0;0;0;.00nan;0;0
3404;212999;2168;0;0;0;0;.00nan;0;0
3404;49935;2168;62;35;5;30;.857;3679000;0
3405;3435;739;67;26;2;24;.923;3600000;0
3405;-1;739;0;0;0;0;.00nan;0;0
3405;78573;737;59;41;5;36;.878;3600000;0
3405;139467;737;0;0;0;0;.00nan;0;0
3406;2643;738;77;32;2;30;.938;3600000;0
3406;163195;743;59;24;3;21;.875;3549000;0
3406;164424;738;0;0;0;0;.00nan;0;0
3406;223469;743;0;0;0;0;.00nan;0;0
3407;56565;741;0;0;0;0;.00nan;0;0
3407;75362;749;0;0;0;0;.00nan;0;0
3407;85670;741;90;21;0;21;1.000;3600000;0
3407;85797;749;75;40;3;37;.925;3600000;0
3408;147;748;0;0;0;0;.00nan;0;0
3408;198736;3789;78;23;1;22;.957;3600000;0
3408;184158;748;91;35;2;33;.943;3586000;0
3408;-1;3789;0;0;0;0;.00nan;0;0
3409;203977;729;0;0;0;0;.00nan;0;0
3409;211604;729;99;49;2;47;.959;3600000;0
3409;-1;747;0;0;0;0;.00nan;0;0
3409;76405;747;65;27;3;24;.889;3545000;0
3410;595;732;0;0;0;0;.00nan;0;0
3410;170547;764;83;39;4;35;.897;3600000;0
3410;-1;764;0;0;0;0;.00nan;0;0
3410;87798;732;69;56;6;50;.893;3530000;0
3411;31165;752;0;0;0;0;.00nan;0;0
3411;207184;740;0;0;0;0;.00nan;0;0
3411;86151;740;93;19;0;19;1.000;3600000;0
3411;149221;752;98;44;2;42;.955;3514000;0
3412;219985;1880;64;11;0;11;1.000;1804000;0
3412;212999;2168;0;0;0;0;.00nan;0;0
3412;49935;2168;99;36;1;35;.972;3600000;0
3412;148573;1880;34;19;4;15;.789;1796000;0
3413;3435;739;77;42;4;38;.905;3600000;0
3413;198736;3789;63;42;5;37;.881;3586000;0
3413;-1;3789;0;0;0;0;.00nan;0;0
3413;-1;739;0;0;0;0;.00nan;0;0
3414;1061;751;94;44;3;41;.932;3900000;0
3414;167642;751;0;0;0;0;.00nan;0;0
3414;206313;745;67;32;3;29;.906;3900000;0
3414;187118;745;0;0;0;0;.00nan;0;0
3415;203977;729;91;48;3;45;.938;3713000;0
3415;211604;729;0;0;0;0;.00nan;0;0
3415;75362;749;54;27;4;23;.852;3713000;0
3415;85797;749;0;0;0;0;.00nan;0;0
3416;170547;764;0;0;0;0;.00nan;0;0
3416;180990;744;21;25;6;19;.760;3600000;0
3416;207771;744;0;0;0;0;.00nan;0;0
3416;-1;764;88;35;2;33;.943;3600000;0
3417;213298;736;89;24;1;23;.958;3600000;0
3417;218542;736;0;0;0;0;.00nan;0;0
3417;78573;737;50;36;4;32;.889;3600000;0
3417;139467;737;0;0;0;0;.00nan;0;0
3418;595;732;92;40;2;38;.950;3600000;0
3418;66245;733;0;0;0;0;.00nan;0;0
3418;87798;732;0;0;0;0;.00nan;0;0
3418;148503;733;86;28;1;27;.964;3600000;0
3419;1957;742;71;47;5;42;.894;3600000;0
3419;-1;742;0;0;0;0;.00nan;0;0
3419;-1;747;0;0;0;0;.00nan;0;0
3419;76405;747;85;14;0;14;1.000;3600000;0
3420;207184;740;0;0;0;0;.00nan;0;0
3420;212999;2168;0;0;0;0;.00nan;0;0
3420;49935;2168;70;30;2;28;.933;3600000;0
3420;86151;740;93;32;1;31;.969;3600000;0
3421;203977;729;0;0;0;0;.00nan;0;0
3421;211604;729;97;55;2;53;.964;3600000;0
3421;78573;737;72;20;1;19;.950;3600000;0
3421;139467;737;0;0;0;0;.00nan;0;0
3422;147;748;0;0;0;0;.00nan;0;0
3422;184158;748;80;22;1;21;.955;3600000;0
3422;180990;744;73;35;3;32;.914;3566000;0
3422;207771;744;0;0;0;0;.00nan;0;0
3423;31165;752;0;0;0;0;.00nan;0;0
3423;-1;747;0;0;0;0;.00nan;0;0
3423;76405;747;71;18;1;17;.944;3600000;0
3423;149221;752;95;52;2;50;.962;3590000;0
3424;3435;739;97;26;1;25;.962;3600000;0
3424;-1;739;0;0;0;0;.00nan;0;0
3424;78573;737;0;0;0;0;.00nan;0;0
3424;139467;737;70;23;2;21;.913;3591000;0
3425;2643;738;68;32;3;29;.906;3583000;0
3425;164424;738;0;0;0;0;.00nan;0;0
3425;56565;741;0;0;0;0;.00nan;0;0
3425;85670;741;89;32;2;30;.938;3600000;0
3426;1957;742;100;29;0;29;1.000;3600000;0
3426;-1;742;0;0;0;0;.00nan;0;0
3426;66245;733;98;44;1;43;.977;3558000;0
3426;148503;733;0;0;0;0;.00nan;0;0
3427;595;732;0;0;0;0;.00nan;0;0
3427;219985;1880;58;13;1;12;.923;3600000;0
3427;87798;732;74;39;4;35;.897;3600000;0
3427;148573;1880;0;0;0;0;.00nan;0;0
3428;198736;3789;0;0;0;0;.00nan;0;0
3428;213298;736;0;0;0;0;.00nan;0;0
3428;218542;736;63;36;4;32;.889;3796000;0
3428;143301;3789;68;32;3;29;.906;3796000;0
3429;203977;729;0;0;0;0;.00nan;0;0
3429;211604;729;76;34;3;31;.912;3900000;0
3429;207184;740;0;0;0;0;.00nan;0;0
3429;86151;740;82;33;3;30;.909;3900000;0
3430;1957;742;54;29;4;25;.862;3900000;0
3430;180990;744;0;0;0;0;.00nan;0;0
3430;207771;744;59;34;4;30;.882;3880000;0
3430;-1;742;0;0;0;0;.00nan;0;0
3431;1061;751;99;36;1;35;.972;3900000;0
3431;167642;751;0;0;0;0;.00nan;0;0
3431;170547;764;76;23;1;22;.957;3900000;0
3431;-1;764;0;0;0;0;.00nan;0;0
3432;198736;3789;0;0;0;0;.00nan;0;0
3432;175764;734;0;0;0;0;.00nan;0;0
3432;143301;3789;64;21;2;19;.905;3900000;0
3432;148788;734;76;31;2;29;.935;3900000;0
3433;147;748;71;14;1;13;.929;3077000;0
3433;184158;748;28;14;4;10;.714;823000;0
3433;31165;752;0;0;0;0;.00nan;0;0
3433;149221;752;31;26;5;21;.808;3900000;0
3434;219985;1880;66;32;3;29;.906;3138000;0
3434;206313;745;39;11;3;8;.727;539000;0
3434;187118;745;77;28;1;27;.964;3061000;0
3434;148573;1880;23;4;3;1;.250;393000;0
3435;3435;739;45;27;4;23;.852;3600000;0
3435;213298;736;99;41;1;40;.976;3600000;0
3435;218542;736;0;0;0;0;.00nan;0;0
3435;-1;739;0;0;0;0;.00nan;0;0
3436;212999;2168;0;0;0;0;.00nan;0;0
3436;49935;2168;36;37;6;31;.838;3599000;0
3436;75362;749;0;0;0;0;.00nan;0;0
3436;85797;749;57;35;4;31;.886;3600000;0
3437;2643;738;79;57;5;52;.912;3576000;0
3437;163195;743;60;28;3;25;.893;3600000;0
3437;164424;738;0;0;0;0;.00nan;0;0
3437;223469;743;0;0;0;0;.00nan;0;0
3438;207184;740;0;0;0;0;.00nan;0;0
3438;78573;737;100;28;0;28;1.000;3600000;0
3438;86151;740;76;35;2;33;.943;3600000;0
3438;139467;737;0;0;0;0;.00nan;0;0
3439;1061;751;0;0;0;0;.00nan;0;0
3439;167642;751;99;43;1;42;.977;3600000;0
3439;170547;764;0;0;0;0;.00nan;0;0
3439;-1;764;41;25;4;21;.840;3600000;0
3440;595;732;64;25;2;23;.920;3600000;0
3440;66245;733;40;40;7;33;.825;3600000;0
3440;87798;732;0;0;0;0;.00nan;0;0
3440;148503;733;0;0;0;0;.00nan;0;0
3441;212999;2168;0;0;0;0;.00nan;0;0
3441;49935;2168;66;24;2;22;.917;3600000;0
3441;75362;749;43;29;5;24;.828;3600000;0
3441;85797;749;0;0;0;0;.00nan;0;0
3442;180990;744;78;22;1;21;.955;3550000;0
3442;207771;744;0;0;0;0;.00nan;0;0
3442;56565;741;0;0;0;0;.00nan;0;0
3442;85670;741;100;25;0;25;1.000;3600000;0
3443;2643;738;87;40;2;38;.950;3577000;0
3443;3435;739;84;17;0;17;1.000;3600000;0
3443;164424;738;0;0;0;0;.00nan;0;0
3443;-1;739;0;0;0;0;.00nan;0;0
3444;206313;745;0;0;0;0;.00nan;0;0
3444;175764;734;0;0;0;0;.00nan;0;0
3444;187118;745;55;32;4;28;.875;3595000;0
3444;148788;734;93;42;3;39;.929;3600000;0
3445;198736;3789;0;0;0;0;.00nan;0;0
3445;203977;729;0;0;0;0;.00nan;0;0
3445;211604;729;97;42;2;40;.952;3600000;0
3445;143301;3789;47;18;3;15;.833;3584000;0
3446;1957;742;42;43;7;36;.837;3600000;0
3446;-1;742;0;0;0;0;.00nan;0;0
3446;-1;747;0;0;0;0;.00nan;0;0
3446;76405;747;61;20;2;18;.900;3600000;0
3447;147;748;0;0;0;0;.00nan;0;0
3447;219985;1880;0;0;0;0;.00nan;0;0
3447;184158;748;60;45;5;40;.889;3600000;0
3447;148573;1880;21;27;6;21;.778;3544000;0
3448;163195;743;84;25;1;24;.960;3600000;0
3448;31165;752;0;0;0;0;.00nan;0;0
3448;223469;743;0;0;0;0;.00nan;0;0
3448;149221;752;76;37;4;33;.892;3600000;0
3449;1061;751;59;38;4;34;.895;3600000;0
3449;167642;751;0;0;0;0;.00nan;0;0
3449;212999;2168;0;0;0;0;.00nan;0;0
3449;49935;2168;96;30;1;29;.967;3600000;0
3450;595;732;0;0;0;0;.00nan;0;0
3450;66245;733;95;45;2;43;.956;3567000;0
3450;87798;732;93;28;1;27;.964;3600000;0
3450;148503;733;0;0;0;0;.00nan;0;0
3451;170547;764;100;27;0;27;1.000;3600000;0
3451;-1;764;0;0;0;0;.00nan;0;0
3451;75362;749;0;0;0;0;.00nan;0;0
3451;85797;749;78;30;2;28;.933;3516000;0
3452;31165;752;0;0;0;0;.00nan;0;0
3452;56565;741;0;0;0;0;.00nan;0;0
3452;85670;741;70;20;2;18;.900;3600000;0
3452;149221;752;68;36;3;33;.917;3600000;0
3453;2643;738;0;0;0;0;.00nan;0;0
3453;164424;738;68;19;1;18;.947;3600000;0
3453;213298;736;52;38;5;33;.868;3600000;0
3453;218542;736;0;0;0;0;.00nan;0;0
3454;3435;739;100;31;1;30;.968;3900000;0
3454;175764;734;0;0;0;0;.00nan;0;0
3454;-1;739;0;0;0;0;.00nan;0;0
3454;148788;734;91;29;1;28;.966;3900000;0
3455;147;748;0;0;0;0;.00nan;0;0
3455;203977;729;0;0;0;0;.00nan;0;0
3455;184158;748;57;26;3;23;.885;3577000;0
3455;211604;729;96;37;2;35;.946;3600000;0
3456;207184;740;0;0;0;0;.00nan;0;0
3456;180990;744;54;37;5;32;.865;3582000;0
3456;207771;744;0;0;0;0;.00nan;0;0
3456;86151;740;27;14;4;10;.714;3600000;0
3457;1957;742;91;47;3;44;.936;3900000;0
3457;-1;742;0;0;0;0;.00nan;0;0
3457;78573;737;79;40;3;37;.925;3900000;0
3457;139467;737;0;0;0;0;.00nan;0;0
3458;1061;751;80;33;2;31;.939;3600000;0
3458;167642;751;0;0;0;0;.00nan;0;0
3458;212999;2168;0;0;0;0;.00nan;0;0
3458;49935;2168;76;34;3;31;.912;3600000;0
3459;219985;1880;0;0;0;0;.00nan;0;0
3459;66245;733;98;34;1;33;.971;3600000;0
3459;148503;733;0;0;0;0;.00nan;0;0
3459;148573;1880;85;14;0;14;1.000;3600000;0
3460;170547;764;49;31;5;26;.839;3900000;0
3460;-1;764;0;0;0;0;.00nan;0;0
3460;75362;749;0;0;0;0;.00nan;0;0
3460;85797;749;58;42;5;37;.881;3900000;0
3461;595;732;59;33;4;29;.879;3600000;0
3461;163195;743;85;31;1;30;.968;3600000;0
3461;223469;743;0;0;0;0;.00nan;0;0
3461;87798;732;0;0;0;0;.00nan;0;0
3462;198736;3789;0;0;0;0;.00nan;0;0
3462;213298;736;85;52;3;49;.942;3600000;0
3462;218542;736;0;0;0;0;.00nan;0;0
3462;143301;3789;100;23;0;23;1.000;3600000;0
3463;147;748;0;0;0;0;.00nan;0;0
3463;2643;738;74;47;4;43;.915;3600000;0
3463;164424;738;0;0;0;0;.00nan;0;0
3463;184158;748;76;22;1;21;.955;3600000;0
3464;180990;744;57;21;2;19;.905;3565000;0
3464;207771;744;0;0;0;0;.00nan;0;0
3464;56565;741;0;0;0;0;.00nan;0;0
3464;85670;741;100;27;0;27;1.000;3600000;0
3465;163195;743;80;12;1;11;.917;3900000;0
3465;31165;752;100;51;1;50;.980;3900000;0
3465;223469;743;0;0;0;0;.00nan;0;0
3465;149221;752;0;0;0;0;.00nan;0;0
3466;1957;742;58;35;4;31;.886;3900000;0
3466;3435;739;64;28;4;24;.857;3900000;0
3466;-1;739;0;0;0;0;.00nan;0;0
3466;-1;742;0;0;0;0;.00nan;0;0
3467;595;732;0;0;0;0;.00nan;0;0
3467;175764;734;0;0;0;0;.00nan;0;0
3467;87798;732;98;55;3;52;.945;3567000;0
3467;148788;734;93;29;1;28;.966;3600000;0
3468;206313;745;0;0;0;0;.00nan;0;0
3468;187118;745;91;32;2;30;.938;3600000;0
3468;-1;747;0;0;0;0;.00nan;0;0
3468;76405;747;49;22;3;19;.864;3600000;0
3469;219985;1880;0;0;0;0;.00nan;0;0
3469;78573;737;81;26;1;25;.962;3600000;0
3469;139467;737;0;0;0;0;.00nan;0;0
3469;148573;1880;62;24;2;22;.917;3586000;0
3470;207184;740;0;0;0;0;.00nan;0;0
3470;66245;733;77;23;1;22;.957;3600000;0
3470;86151;740;74;30;2;28;.933;3560000;0
3470;148503;733;0;0;0;0;.00nan;0;0
3471;203977;729;0;0;0;0;.00nan;0;0
3471;211604;729;75;38;4;34;.895;3600000;0
3471;180990;744;62;28;3;25;.893;3600000;0
3471;207771;744;0;0;0;0;.00nan;0;0
3472;147;748;75;35;3;32;.914;3593000;0
3472;184158;748;0;0;0;0;.00nan;0;0
3472;75362;749;0;0;0;0;.00nan;0;0
3472;85797;749;75;26;2;24;.923;3600000;0
3473;206313;745;0;0;0;0;.00nan;0;0
3473;31165;752;0;0;0;0;.00nan;0;0
3473;187118;745;100;30;0;30;1.000;3600000;0
3473;149221;752;71;39;4;35;.897;3600000;0
3474;163195;743;78;22;1;21;.955;3600000;0
3474;212999;2168;79;50;5;45;.900;3600000;0
3474;223469;743;0;0;0;0;.00nan;0;0
3474;49935;2168;0;0;0;0;.00nan;0;0
3475;198736;3789;0;0;0;0;.00nan;0;0
3475;-1;747;0;0;0;0;.00nan;0;0
3475;76405;747;72;31;3;28;.903;3528000;0
3475;143301;3789;91;33;1;32;.970;3600000;0
3476;2643;738;95;51;0;51;1.000;3900000;0
3476;164424;738;0;0;0;0;.00nan;0;0
3476;78573;737;92;17;0;17;1.000;3900000;0
3476;139467;737;0;0;0;0;.00nan;0;0
3477;1061;751;76;31;2;29;.935;3600000;0
3477;167642;751;0;0;0;0;.00nan;0;0
3477;56565;741;0;0;0;0;.00nan;0;0
3477;85670;741;43;26;4;22;.846;3563000;0
3478;170547;764;74;29;2;27;.931;3600000;0
3478;213298;736;0;0;0;0;.00nan;0;0
3478;218542;736;67;31;4;27;.871;3566000;0
3478;-1;764;0;0;0;0;.00nan;0;0
3479;3435;739;93;36;2;34;.944;3600000;0
3479;219985;1880;0;0;0;0;.00nan;0;0
3479;-1;739;0;0;0;0;.00nan;0;0
3479;148573;1880;77;48;4;44;.917;3600000;0
3480;1957;742;61;26;3;23;.885;3600000;0
3480;203977;729;0;0;0;0;.00nan;0;0
3480;211604;729;55;38;5;33;.868;3557000;0
3480;-1;742;0;0;0;0;.00nan;0;0
3481;595;732;73;25;2;23;.920;3567000;0
3481;175764;734;0;0;0;0;.00nan;0;0
3481;87798;732;0;0;0;0;.00nan;0;0
3481;148788;734;97;34;1;33;.971;3600000;0
3482;1061;751;75;38;4;34;.895;3574000;0
3482;167642;751;0;0;0;0;.00nan;0;0
3482;180990;744;81;29;2;27;.931;3600000;0
3482;207771;744;0;0;0;0;.00nan;0;0
3483;206313;745;0;0;0;0;.00nan;0;0
3483;212999;2168;0;0;0;0;.00nan;0;0
3483;187118;745;60;37;4;33;.892;3600000;0
3483;49935;2168;63;27;3;24;.889;3600000;0
3484;2643;738;68;54;5;49;.907;3559000;0
3484;164424;738;0;0;0;0;.00nan;0;0
3484;75362;749;0;0;0;0;.00nan;0;0
3484;85797;749;69;33;4;29;.879;3600000;0
3485;213298;736;80;38;2;36;.947;3600000;0
3485;218542;736;0;0;0;0;.00nan;0;0
3485;56565;741;0;0;0;0;.00nan;0;0
3485;85670;741;33;17;5;12;.706;3600000;0
3486;198736;3789;0;0;0;0;.00nan;0;0
3486;66245;733;69;34;3;31;.912;3600000;0
3486;143301;3789;96;24;0;24;1.000;3600000;0
3486;148503;733;0;0;0;0;.00nan;0;0
3487;147;748;0;0;0;0;.00nan;0;0
3487;184158;748;55;38;4;34;.895;3600000;0
3487;-1;747;0;0;0;0;.00nan;0;0
3487;76405;747;82;26;1;25;.962;3600000;0
3488;207184;740;0;0;0;0;.00nan;0;0
3488;78573;737;62;25;3;22;.880;3551000;0
3488;86151;740;72;32;2;30;.938;3600000;0
3488;139467;737;0;0;0;0;.00nan;0;0
3489;170547;764;65;26;2;24;.923;3600000;0
3489;31165;752;47;5;1;4;.800;367000;0
3489;-1;764;0;0;0;0;.00nan;0;0
3489;149221;752;28;27;6;21;.778;3233000;0
3490;219985;1880;0;0;0;0;.00nan;0;0
3490;175764;734;0;0;0;0;.00nan;0;0
3490;148573;1880;93;38;1;37;.974;3600000;0
3490;148788;734;94;30;2;28;.933;3550000;0
3491;595;732;0;0;0;0;.00nan;0;0
3491;1957;742;52;18;2;16;.889;3548000;0
3491;-1;742;0;0;0;0;.00nan;0;0
3491;87798;732;92;35;1;34;.971;3600000;0
3492;163195;743;0;0;0;0;.00nan;0;0
3492;203977;729;0;0;0;0;.00nan;0;0
3492;211604;729;76;55;6;49;.891;3600000;0
3492;223469;743;72;22;1;21;.955;3600000;0
3493;180990;744;0;0;0;0;.00nan;0;0
3493;207771;744;74;43;3;40;.930;3513000;0
3493;75362;749;0;0;0;0;.00nan;0;0
3493;85797;749;91;32;1;31;.969;3600000;0
3494;212999;2168;0;0;0;0;.00nan;0;0
3494;49935;2168;83;42;3;39;.929;3592000;0
3494;-1;747;0;0;0;0;.00nan;0;0
3494;76405;747;73;19;1;18;.947;3600000;0
3495;2643;738;91;44;3;41;.932;3823000;0
3495;198736;3789;0;0;0;0;.00nan;0;0
3495;164424;738;0;0;0;0;.00nan;0;0
3495;143301;3789;55;27;4;23;.852;3823000;0
3496;175764;734;0;0;0;0;.00nan;0;0
3496;213298;736;0;0;0;0;.00nan;0;0
3496;218542;736;90;38;2;36;.947;3582000;0
3496;148788;734;74;24;1;23;.958;3600000;0
3497;31165;752;0;0;0;0;.00nan;0;0
3497;56565;741;0;0;0;0;.00nan;0;0
3497;85670;741;57;21;3;18;.857;3610000;0
3497;149221;752;92;43;2;41;.953;3609000;0
3498;206313;745;0;0;0;0;.00nan;0;0
3498;187118;745;63;34;5;29;.853;3600000;0
3498;66245;733;100;32;0;32;1.000;3600000;0
3498;148503;733;0;0;0;0;.00nan;0;0
3499;147;748;0;0;0;0;.00nan;0;0
3499;184158;748;61;37;4;33;.892;3513000;0
3499;78573;737;63;23;2;21;.913;3600000;0
3499;139467;737;0;0;0;0;.00nan;0;0
3500;3435;739;41;23;4;19;.826;3544000;0
3500;207184;740;0;0;0;0;.00nan;0;0
3500;-1;739;0;0;0;0;.00nan;0;0
3500;86151;740;66;37;3;34;.919;3600000;0
3501;1061;751;82;27;1;26;.963;3900000;0
3501;167642;751;0;0;0;0;.00nan;0;0
3501;170547;764;0;0;0;0;.00nan;0;0
3501;-1;764;91;38;1;37;.974;3900000;0
3503;212999;2168;0;0;0;0;.00nan;0;0
3503;49935;2168;66;32;3;29;.906;3565000;0
3503;66245;733;0;0;0;0;.00nan;0;0
3503;148503;733;78;30;2;28;.933;3600000;0
3505;1061;751;49;13;2;11;.846;1832000;0
3505;3435;739;72;21;1;20;.952;3600000;0
3505;-1;739;0;0;0;0;.00nan;0;0
3505;148788;751;24;13;4;9;.692;1768000;0
3507;164424;736;60;42;5;37;.881;3600000;0
3507;204272;737;0;0;0;0;.00nan;0;0
3507;201947;737;70;28;2;26;.929;3600000;0
3507;213298;736;0;0;0;0;.00nan;0;0
3509;211572;742;0;0;0;0;.00nan;0;0
3509;180990;744;68;30;3;27;.900;3600000;0
3509;207771;744;0;0;0;0;.00nan;0;0
3509;148573;742;100;31;0;31;1.000;3600000;0
3511;1957;1880;75;43;4;39;.907;3600000;0
3511;2643;738;49;36;6;30;.833;3564000;0
3511;209518;738;0;0;0;0;.00nan;0;0
3511;-1;1880;0;0;0;0;.00nan;0;0
3513;170547;764;84;16;0;16;1.000;3600000;0
3513;180177;747;0;0;0;0;.00nan;0;0
3513;-1;764;0;0;0;0;.00nan;0;0
3513;76405;747;97;53;3;50;.943;3600000;0
3515;175764;734;84;21;1;20;.952;3600000;0
3515;218546;748;74;44;4;40;.909;3600000;0
3515;-1;748;0;0;0;0;.00nan;0;0
3515;148508;734;0;0;0;0;.00nan;0;0
3517;206313;745;49;34;4;30;.882;3600000;0
3517;56565;741;78;26;1;25;.962;3600000;0
3517;82273;741;0;0;0;0;.00nan;0;0
3517;152624;745;0;0;0;0;.00nan;0;0
3519;198736;3789;72;25;2;23;.920;3871000;0
3519;-1;3789;0;0;0;0;.00nan;0;0
3519;-1;749;0;0;0;0;.00nan;0;0
3519;-1;749;92;36;1;35;.972;3871000;0
3521;595;732;94;40;3;37;.925;3900000;0
3521;202516;743;0;0;0;0;.00nan;0;0
3521;223469;743;76;38;3;35;.921;3900000;0
3521;149280;732;0;0;0;0;.00nan;0;0
3523;31165;752;75;29;2;27;.931;2559000;0
3523;207184;740;0;0;0;0;.00nan;0;0
3523;86151;740;87;38;2;36;.947;3600000;0
3523;149221;752;22;13;4;9;.692;1041000;0
3525;1957;1880;44;24;4;20;.833;3513000;0
3525;206313;745;67;28;2;26;.929;3600000;0
3525;-1;1880;0;0;0;0;.00nan;0;0
3525;152624;745;0;0;0;0;.00nan;0;0
3527;170547;764;72;32;3;29;.906;3600000;0
3527;-1;764;0;0;0;0;.00nan;0;0
3527;56565;741;62;37;4;33;.892;3543000;0
3527;82273;741;0;0;0;0;.00nan;0;0
3529;595;732;70;35;3;32;.914;3559000;0
3529;211572;742;0;0;0;0;.00nan;0;0
3529;148573;742;92;38;2;36;.947;3600000;0
3529;149280;732;0;0;0;0;.00nan;0;0
3531;198736;3789;94;35;1;34;.971;3900000;0
3531;-1;3789;0;0;0;0;.00nan;0;0
3531;66245;733;0;0;0;0;.00nan;0;0
3531;148503;733;93;46;1;45;.978;3900000;0
3533;207184;740;0;0;0;0;.00nan;0;0
3533;-1;749;65;27;2;25;.926;3600000;0
3533;-1;749;0;0;0;0;.00nan;0;0
3533;86151;740;52;30;4;26;.867;3574000;0
3535;164424;736;98;49;2;47;.959;3546000;0
3535;213298;736;0;0;0;0;.00nan;0;0
3535;218546;748;67;23;1;22;.957;3600000;0
3535;-1;748;0;0;0;0;.00nan;0;0
3537;2643;738;57;45;5;40;.889;3564000;0
3537;3435;739;64;24;3;21;.875;3600000;0
3537;209518;738;0;0;0;0;.00nan;0;0
3537;-1;739;0;0;0;0;.00nan;0;0
3539;204272;737;63;36;4;32;.889;3600000;0
3539;31165;752;0;0;0;0;.00nan;0;0
3539;201947;737;0;0;0;0;.00nan;0;0
3539;149221;752;81;24;1;23;.958;3600000;0
3541;1061;751;0;0;0;0;.00nan;0;0
3541;202516;743;0;0;0;0;.00nan;0;0
3541;223469;743;79;33;2;31;.939;3600000;0
3541;148788;751;37;43;7;36;.837;3600000;0
3543;203977;729;0;0;0;0;.00nan;0;0
3543;211604;729;97;39;1;38;.974;3600000;0
3543;180177;747;56;17;2;15;.882;3551000;0
3543;76405;747;0;0;0;0;.00nan;0;0
3545;175764;734;0;0;0;0;.00nan;0;0
3545;212999;2168;0;0;0;0;.00nan;0;0
3545;49935;2168;88;39;2;37;.949;3571000;0
3545;148508;734;85;15;0;15;1.000;3600000;0
3547;31165;752;100;32;0;32;1.000;3600000;0
3547;180990;744;82;45;4;41;.911;3600000;0
3547;207771;744;0;0;0;0;.00nan;0;0
3547;149221;752;0;0;0;0;.00nan;0;0
3549;203977;729;76;29;1;28;.966;3600000;0
3549;211604;729;0;0;0;0;.00nan;0;0
3549;175764;734;0;0;0;0;.00nan;0;0
3549;148508;734;47;39;6;33;.846;3600000;0
3551;204272;737;0;0;0;0;.00nan;0;0
3551;201947;737;56;28;4;24;.857;3600000;0
3551;212999;2168;82;30;1;29;.967;3600000;0
3551;49935;2168;0;0;0;0;.00nan;0;0
3553;2643;738;0;0;0;0;.00nan;0;0
3553;198736;3789;0;0;0;0;.00nan;0;0
3553;209518;738;100;52;1;51;.981;3600000;0
3553;-1;3789;78;34;2;32;.941;3554000;0
3555;1061;751;64;22;2;20;.909;3900000;0
3555;1957;1880;0;0;0;0;.00nan;0;0
3555;-1;1880;76;32;2;30;.938;3900000;0
3555;148788;751;0;0;0;0;.00nan;0;0
3557;164424;736;0;0;0;0;.00nan;0;0
3557;207184;740;75;32;2;30;.938;3573000;0
3557;213298;736;84;27;1;26;.963;3600000;0
3557;86151;740;0;0;0;0;.00nan;0;0
3559;3435;739;46;6;1;5;.833;783000;0
3559;180177;747;0;0;0;0;.00nan;0;0
3559;-1;739;18;18;6;12;.667;2817000;0
3559;76405;747;64;32;4;28;.875;3600000;0
3561;170547;764;0;0;0;0;.00nan;0;0
3561;218546;748;0;0;0;0;.00nan;0;0
3561;-1;764;68;34;3;31;.912;3519000;0
3561;-1;748;94;29;1;28;.966;3600000;0
3563;206313;745;0;0;0;0;.00nan;0;0
3563;-1;749;0;0;0;0;.00nan;0;0
3563;-1;749;57;32;3;29;.906;3894000;0
3563;152624;745;59;29;3;26;.897;3900000;0
3565;56565;741;0;0;0;0;.00nan;0;0
3565;66245;733;83;32;1;31;.969;3552000;0
3565;82273;741;100;37;0;37;1.000;3600000;0
3565;148503;733;0;0;0;0;.00nan;0;0
3567;595;732;0;0;0;0;.00nan;0;0
3567;211572;742;45;29;5;24;.828;3544000;0
3567;148573;742;0;0;0;0;.00nan;0;0
3567;149280;732;81;44;4;40;.909;3600000;0
3569;180990;744;56;38;5;33;.868;3600000;0
3569;207771;744;0;0;0;0;.00nan;0;0
3569;218546;748;83;37;2;35;.946;3600000;0
3569;-1;748;0;0;0;0;.00nan;0;0
3571;1957;1880;79;33;2;31;.939;3900000;0
3571;204272;737;0;0;0;0;.00nan;0;0
3571;201947;737;68;22;2;20;.909;3900000;0
3571;-1;1880;0;0;0;0;.00nan;0;0
3573;-1;749;91;21;0;21;1.000;3600000;0
3573;-1;749;0;0;0;0;.00nan;0;0
3573;66245;733;63;25;2;23;.920;3568000;0
3573;148503;733;0;0;0;0;.00nan;0;0
3575;3435;739;68;32;4;28;.875;3900000;0
3575;212999;2168;60;8;0;8;1.000;1509000;0
3575;-1;739;0;0;0;0;.00nan;0;0
3575;49935;2168;45;28;4;24;.857;2391000;0
3577;2643;738;60;34;4;30;.882;3572000;0
3577;209518;738;0;0;0;0;.00nan;0;0
3577;207184;740;0;0;0;0;.00nan;0;0
3577;86151;740;63;22;2;20;.909;3600000;0
3579;595;732;81;26;1;25;.962;3600000;0
3579;206313;745;64;38;4;34;.895;3600000;0
3579;149280;732;0;0;0;0;.00nan;0;0
3579;152624;745;0;0;0;0;.00nan;0;0
3581;31165;752;98;41;2;39;.951;3823000;0
3581;56565;741;0;0;0;0;.00nan;0;0
3581;82273;741;68;27;3;24;.889;3823000;0
3581;149221;752;0;0;0;0;.00nan;0;0
3583;170547;764;100;29;0;29;1.000;3600000;0
3583;202516;743;0;0;0;0;.00nan;0;0
3583;223469;743;77;23;1;22;.957;3600000;0
3583;-1;764;0;0;0;0;.00nan;0;0
3585;203977;729;0;0;0;0;.00nan;0;0
3585;211604;729;76;25;1;24;.960;3600000;0
3585;175764;734;59;36;4;32;.889;3600000;0
3585;148508;734;0;0;0;0;.00nan;0;0
3587;198736;3789;82;41;3;38;.927;3570000;0
3587;180177;747;0;0;0;0;.00nan;0;0
3587;-1;3789;0;0;0;0;.00nan;0;0
3587;76405;747;78;24;2;22;.917;3600000;0
3589;164424;736;95;43;2;41;.953;3900000;0
3589;211572;742;0;0;0;0;.00nan;0;0
3589;213298;736;0;0;0;0;.00nan;0;0
3589;148573;742;82;25;2;23;.920;3900000;0
3591;170547;764;55;19;2;17;.895;3565000;0
3591;-1;764;0;0;0;0;.00nan;0;0
3591;66245;733;0;0;0;0;.00nan;0;0
3591;148503;733;99;47;1;46;.979;3600000;0
3593;1957;1880;0;0;0;0;.00nan;0;0
3593;204272;737;90;42;2;40;.952;3900000;0
3593;201947;737;0;0;0;0;.00nan;0;0
3593;-1;1880;67;26;2;24;.923;3900000;0
3595;595;732;0;0;0;0;.00nan;0;0
3595;56565;741;32;28;6;22;.786;3314000;0
3595;82273;741;57;4;0;4;1.000;286000;0
3595;149280;732;89;42;3;39;.929;3600000;0
3597;31165;752;0;0;0;0;.00nan;0;0
3597;202516;743;52;35;4;31;.886;3600000;0
3597;223469;743;0;0;0;0;.00nan;0;0
3597;149221;752;77;45;5;40;.889;3581000;0
3599;203977;729;83;30;1;29;.967;3600000;0
3599;211604;729;0;0;0;0;.00nan;0;0
3599;218546;748;0;0;0;0;.00nan;0;0
3599;-1;748;82;33;2;31;.939;3600000;0
3601;211572;742;98;38;2;36;.947;3600000;0
3601;180990;744;0;0;0;0;.00nan;0;0
3601;207771;744;70;42;4;38;.905;3526000;0
3601;148573;742;0;0;0;0;.00nan;0;0
3603;175764;734;0;0;0;0;.00nan;0;0
3603;-1;749;100;33;0;33;1.000;3600000;0
3603;-1;749;0;0;0;0;.00nan;0;0
3603;148508;734;42;18;3;15;.833;3600000;0
3605;1061;751;0;0;0;0;.00nan;0;0
3605;206313;745;0;0;0;0;.00nan;0;0
3605;148788;751;67;33;4;29;.879;3518000;0
3605;152624;745;82;32;2;30;.938;3600000;0
3607;3435;739;0;0;0;0;.00nan;0;0
3607;198736;3789;0;0;0;0;.00nan;0;0
3607;-1;3789;78;33;2;31;.939;3573000;0
3607;-1;739;74;23;1;22;.957;3600000;0
3609;2643;738;0;0;0;0;.00nan;0;0
3609;209518;738;75;36;3;33;.917;3600000;0
3609;212999;2168;0;0;0;0;.00nan;0;0
3609;49935;2168;34;34;6;28;.824;3600000;0
3611;180177;747;50;20;3;17;.850;3600000;0
3611;207184;740;78;46;4;42;.913;3559000;0
3611;76405;747;0;0;0;0;.00nan;0;0
3611;86151;740;0;0;0;0;.00nan;0;0
3613;175764;734;67;25;2;23;.920;3600000;0
3613;66245;733;77;47;4;43;.915;3600000;0
3613;148503;733;0;0;0;0;.00nan;0;0
3613;148508;734;0;0;0;0;.00nan;0;0
3615;203977;729;0;0;0;0;.00nan;0;0
3615;211604;729;58;27;2;25;.926;3588000;0
3615;202516;743;0;0;0;0;.00nan;0;0
3615;223469;743;79;13;0;13;1.000;3600000;0
3617;2643;738;100;24;0;24;1.000;3600000;0
3617;209518;738;0;0;0;0;.00nan;0;0
3617;206313;745;70;33;3;30;.909;3600000;0
3617;152624;745;0;0;0;0;.00nan;0;0
3619;207184;740;0;0;0;0;.00nan;0;0
3619;180990;744;46;24;3;21;.875;3600000;0
3619;207771;744;0;0;0;0;.00nan;0;0
3619;86151;740;90;37;2;35;.946;3600000;0
3621;170547;764;49;23;3;20;.870;3591000;0
3621;31165;752;86;31;1;30;.968;3600000;0
3621;-1;764;0;0;0;0;.00nan;0;0
3621;149221;752;0;0;0;0;.00nan;0;0
3623;164424;736;77;30;2;28;.933;3804000;0
3623;212999;2168;0;0;0;0;.00nan;0;0
3623;213298;736;0;0;0;0;.00nan;0;0
3623;49935;2168;76;34;3;31;.912;3804000;0
3625;1061;751;84;35;3;32;.914;3600000;0
3625;211572;742;0;0;0;0;.00nan;0;0
3625;148573;742;40;29;5;24;.828;3572000;0
3625;148788;751;0;0;0;0;.00nan;0;0
3627;3435;739;76;29;2;27;.931;3600000;0
3627;-1;739;0;0;0;0;.00nan;0;0
3627;-1;749;47;40;6;34;.850;3600000;0
3627;-1;749;0;0;0;0;.00nan;0;0
3629;204272;737;0;0;0;0;.00nan;0;0
3629;201947;737;82;41;4;37;.902;3600000;0
3629;218546;748;84;29;2;27;.931;3600000;0
3629;-1;748;0;0;0;0;.00nan;0;0
3631;1957;1880;86;38;3;35;.921;3900000;0
3631;198736;3789;72;35;3;32;.914;3900000;0
3631;-1;3789;0;0;0;0;.00nan;0;0
3631;-1;1880;0;0;0;0;.00nan;0;0
3633;180177;747;0;0;0;0;.00nan;0;0
3633;56565;741;37;38;6;32;.842;3600000;0
3633;76405;747;78;22;1;21;.955;3600000;0
3633;82273;741;0;0;0;0;.00nan;0;0
3635;164424;736;0;0;0;0;.00nan;0;0
3635;213298;736;92;31;1;30;.968;3900000;0
3635;-1;749;0;0;0;0;.00nan;0;0
3635;-1;749;80;31;1;30;.968;3900000;0
3637;2643;738;85;37;3;34;.919;3600000;0
3637;209518;738;0;0;0;0;.00nan;0;0
3637;218546;748;0;0;0;0;.00nan;0;0
3637;-1;748;87;20;0;20;1.000;3600000;0
3639;180177;747;59;37;5;32;.865;3600000;0
3639;66245;733;0;0;0;0;.00nan;0;0
3639;76405;747;0;0;0;0;.00nan;0;0
3639;148503;733;100;36;0;36;1.000;3600000;0
3641;206313;745;0;0;0;0;.00nan;0;0
3641;211572;742;78;39;3;36;.923;3600000;0
3641;148573;742;0;0;0;0;.00nan;0;0
3641;152624;745;68;46;5;41;.891;3534000;0
3643;204272;737;73;31;3;28;.903;3864000;0
3643;201947;737;0;0;0;0;.00nan;0;0
3643;212999;2168;69;42;4;38;.905;3864000;0
3643;49935;2168;0;0;0;0;.00nan;0;0
3645;595;732;71;40;4;36;.900;3900000;0
3645;203977;729;76;41;4;37;.902;3900000;0
3645;211604;729;0;0;0;0;.00nan;0;0
3645;149280;732;0;0;0;0;.00nan;0;0
3647;175764;734;0;0;0;0;.00nan;0;0
3647;202516;743;0;0;0;0;.00nan;0;0
3647;223469;743;100;33;0;33;1.000;3600000;0
3647;148508;734;77;38;3;35;.921;3600000;0
3649;1061;751;0;0;0;0;.00nan;0;0
3649;31165;752;61;7;0;7;1.000;642000;0
3649;148788;751;68;18;1;17;.944;3600000;0
3649;149221;752;28;37;7;30;.811;2958000;0
3651;3435;739;0;0;0;0;.00nan;0;0
3651;170547;764;0;0;0;0;.00nan;0;0
3651;-1;764;98;34;1;33;.971;3600000;0
3651;-1;739;62;36;4;32;.889;3600000;0
3653;198736;3789;0;0;0;0;.00nan;0;0
3653;207184;740;89;35;2;33;.943;3600000;0
3653;-1;3789;55;27;3;24;.889;3565000;0
3653;86151;740;0;0;0;0;.00nan;0;0
3655;180990;744;0;0;0;0;.00nan;0;0
3655;207771;744;75;42;4;38;.905;3569000;0
3655;56565;741;0;0;0;0;.00nan;0;0
3655;82273;741;72;29;2;27;.931;3600000;0
854;3435;739;55;19;2;17;.895;3582000;0
854;-1;739;0;0;0;0;.00nan;0;0
854;66245;733;99;45;1;44;.978;3600000;0
854;148503;733;0;0;0;0;.00nan;0;0
855;203977;729;0;0;0;0;.00nan;0;0
855;211604;729;71;26;1;25;.962;4518000;0
855;207184;740;0;0;0;0;.00nan;0;0
855;86151;740;90;43;2;41;.953;4518000;0
856;595;732;92;42;3;39;.929;3794000;0
856;175764;734;0;0;0;0;.00nan;0;0
856;87798;732;0;0;0;0;.00nan;0;0
856;148788;734;58;28;4;24;.857;3794000;0
857;198736;3789;0;0;0;0;.00nan;0;0
857;78573;737;72;40;5;35;.875;3600000;0
857;139467;737;0;0;0;0;.00nan;0;0
857;143301;3789;73;21;1;20;.952;3600000;0
858;163195;743;59;22;2;20;.909;3600000;0
858;212999;2168;0;0;0;0;.00nan;0;0
858;223469;743;0;0;0;0;.00nan;0;0
858;49935;2168;82;49;5;44;.898;3600000;0
859;170547;764;49;34;5;29;.853;3600000;0
859;-1;764;0;0;0;0;.00nan;0;0
859;-1;747;0;0;0;0;.00nan;0;0
859;76405;747;85;23;1;22;.957;3600000;0
860;147;748;60;20;2;18;.900;2543000;0
860;1957;742;66;15;1;14;.933;3600000;0
860;184158;748;21;13;4;9;.692;1057000;0
860;-1;742;0;0;0;0;.00nan;0;0
861;1061;751;73;38;4;34;.895;3600000;0
861;167642;751;0;0;0;0;.00nan;0;0
861;56565;741;0;0;0;0;.00nan;0;0
861;85670;741;89;20;0;20;1.000;3600000;0
862;3435;739;51;22;4;18;.818;3600000;0
862;-1;739;0;0;0;0;.00nan;0;0
862;66245;733;61;39;5;34;.872;3600000;0
862;148503;733;0;0;0;0;.00nan;0;0
863;203977;729;0;0;0;0;.00nan;0;0
863;211604;729;69;26;2;24;.923;4088000;0
863;207184;740;0;0;0;0;.00nan;0;0
863;86151;740;82;27;1;26;.963;4088000;0
864;595;732;61;26;3;23;.885;3584000;0
864;175764;734;0;0;0;0;.00nan;0;0
864;87798;732;0;0;0;0;.00nan;0;0
864;148788;734;98;37;2;35;.946;3600000;0
865;198736;3789;0;0;0;0;.00nan;0;0
865;78573;737;48;37;6;31;.838;3600000;0
865;139467;737;0;0;0;0;.00nan;0;0
865;143301;3789;85;33;2;31;.939;3600000;0
866;163195;743;60;28;3;25;.893;3600000;0
866;212999;2168;50;1;0;1;1.000;359000;0
866;223469;743;0;0;0;0;.00nan;0;0
866;49935;2168;33;35;6;29;.829;3241000;0
867;170547;764;64;48;5;43;.896;4605000;0
867;-1;764;0;0;0;0;.00nan;0;0
867;-1;747;0;0;0;0;.00nan;0;0
867;76405;747;69;39;4;35;.897;4605000;0
868;147;748;0;0;0;0;.00nan;0;0
868;1957;742;99;30;1;29;.967;3600000;0
868;184158;748;89;56;5;51;.911;3600000;0
868;-1;742;0;0;0;0;.00nan;0;0
869;1061;751;89;44;3;41;.932;3806000;0
869;167642;751;0;0;0;0;.00nan;0;0
869;56565;741;0;0;0;0;.00nan;0;0
869;85670;741;51;22;4;18;.818;3803000;0
870;3435;739;55;15;2;13;.867;3572000;0
870;-1;739;0;0;0;0;.00nan;0;0
870;66245;733;100;47;1;46;.979;3600000;0
870;148503;733;0;0;0;0;.00nan;0;0
871;203977;729;0;0;0;0;.00nan;0;0
871;211604;729;78;32;2;30;.938;3600000;0
871;207184;740;0;0;0;0;.00nan;0;0
871;86151;740;62;32;3;29;.906;3600000;0
872;595;732;86;24;1;23;.958;4692000;0
872;175764;734;0;0;0;0;.00nan;0;0
872;87798;732;0;0;0;0;.00nan;0;0
872;148788;734;100;33;0;33;1.000;4692000;0
873;198736;3789;0;0;0;0;.00nan;0;0
873;78573;737;100;30;0;30;1.000;3600000;0
873;139467;737;0;0;0;0;.00nan;0;0
873;143301;3789;74;42;4;38;.905;3600000;0
874;163195;743;99;39;1;38;.974;3600000;0
874;212999;2168;0;0;0;0;.00nan;0;0
874;223469;743;0;0;0;0;.00nan;0;0
874;49935;2168;75;27;2;25;.926;3580000;0
875;170547;764;58;31;4;27;.871;3709000;0
875;-1;764;0;0;0;0;.00nan;0;0
875;-1;747;0;0;0;0;.00nan;0;0
875;76405;747;52;21;3;18;.857;3709000;0
876;147;748;0;0;0;0;.00nan;0;0
876;1957;742;100;21;0;21;1.000;3600000;0
876;184158;748;76;20;1;19;.950;3558000;0
876;-1;742;0;0;0;0;.00nan;0;0
877;1061;751;96;58;4;54;.931;3974000;0
877;167642;751;0;0;0;0;.00nan;0;0
877;56565;741;0;0;0;0;.00nan;0;0
877;85670;741;40;25;5;20;.800;3974000;0
878;3435;739;60;23;3;20;.870;3600000;0
878;-1;739;0;0;0;0;.00nan;0;0
878;66245;733;100;37;0;37;1.000;3600000;0
878;148503;733;0;0;0;0;.00nan;0;0
879;203977;729;0;0;0;0;.00nan;0;0
879;211604;729;72;35;2;33;.943;3600000;0
879;207184;740;0;0;0;0;.00nan;0;0
879;86151;740;69;39;4;35;.897;3582000;0
880;595;732;79;40;3;37;.925;3890000;0
880;175764;734;0;0;0;0;.00nan;0;0
880;87798;732;0;0;0;0;.00nan;0;0
880;148788;734;93;42;2;40;.952;3890000;0
881;198736;3789;0;0;0;0;.00nan;0;0
881;78573;737;83;35;2;33;.943;3546000;0
881;139467;737;0;0;0;0;.00nan;0;0
881;143301;3789;95;39;1;38;.974;3600000;0
882;163195;743;55;25;3;22;.880;3545000;0
882;212999;2168;0;0;0;0;.00nan;0;0
882;223469;743;0;0;0;0;.00nan;0;0
882;49935;2168;100;52;2;50;.962;3600000;0
883;170547;764;80;40;3;37;.925;3568000;0
883;-1;764;0;0;0;0;.00nan;0;0
883;-1;747;0;0;0;0;.00nan;0;0
883;76405;747;78;26;1;25;.962;3600000;0
884;147;748;0;0;0;0;.00nan;0;0
884;1957;742;73;33;3;30;.909;3600000;0
884;184158;748;39;21;4;17;.810;3544000;0
884;-1;742;0;0;0;0;.00nan;0;0
885;1061;751;99;30;1;29;.967;3600000;0
885;167642;751;0;0;0;0;.00nan;0;0
885;56565;741;0;0;0;0;.00nan;0;0
885;85670;741;57;17;2;15;.882;3548000;0
1101;3435;739;57;18;2;16;.889;3600000;0
1101;-1;739;0;0;0;0;.00nan;0;0
1101;66245;733;74;37;3;34;.919;3551000;0
1101;148503;733;0;0;0;0;.00nan;0;0
1102;203977;729;0;0;0;0;.00nan;0;0
1102;211604;729;73;27;2;25;.926;3545000;0
1102;207184;740;0;0;0;0;.00nan;0;0
1102;86151;740;75;26;1;25;.962;3600000;0
1103;595;732;71;46;5;41;.891;3600000;0
1103;175764;734;0;0;0;0;.00nan;0;0
1103;87798;732;0;0;0;0;.00nan;0;0
1103;148788;734;100;34;1;33;.971;3600000;0
1104;198736;3789;0;0;0;0;.00nan;0;0
1104;78573;737;72;42;5;37;.881;3600000;0
1104;139467;737;0;0;0;0;.00nan;0;0
1104;143301;3789;21;20;6;14;.700;3556000;0
1105;163195;743;100;26;0;26;1.000;3600000;0
1105;212999;2168;0;0;0;0;.00nan;0;0
1105;223469;743;0;0;0;0;.00nan;0;0
1105;49935;2168;78;48;4;44;.917;3600000;0
1106;1061;751;75;38;3;35;.921;3589000;0
1106;167642;751;0;0;0;0;.00nan;0;0
1106;56565;741;0;0;0;0;.00nan;0;0
1106;85670;741;63;18;2;16;.889;3600000;0
1191;3435;739;78;30;2;28;.933;3583000;0
1191;-1;739;0;0;0;0;.00nan;0;0
1191;66245;733;100;33;0;33;1.000;3600000;0
1191;148503;733;0;0;0;0;.00nan;0;0
1192;203977;729;0;0;0;0;.00nan;0;0
1192;211604;729;65;33;3;30;.909;3600000;0
1192;207184;740;0;0;0;0;.00nan;0;0
1192;86151;740;100;38;1;37;.974;3600000;0
1193;198736;3789;0;0;0;0;.00nan;0;0
1193;78573;737;100;44;0;44;1.000;3600000;0
1193;139467;737;0;0;0;0;.00nan;0;0
1193;143301;3789;83;25;1;24;.960;3589000;0
1194;1061;751;97;42;3;39;.929;3600000;0
1194;167642;751;0;0;0;0;.00nan;0;0
1194;56565;741;0;0;0;0;.00nan;0;0
1194;85670;741;100;21;0;21;1.000;3600000;0
1297;203977;729;0;0;0;0;.00nan;0;0
1297;211604;729;85;35;2;33;.943;3864000;0
1297;207184;740;0;0;0;0;.00nan;0;0
1297;86151;740;69;33;3;30;.909;3864000;0
1298;198736;3789;0;0;0;0;.00nan;0;0
1298;78573;737;100;21;0;21;1.000;3600000;0
1298;139467;737;0;0;0;0;.00nan;0;0
1298;143301;3789;88;39;2;37;.949;3600000;0
1299;1061;751;100;34;0;34;1.000;3600000;0
1299;167642;751;0;0;0;0;.00nan;0;0
1299;56565;741;0;0;0;0;.00nan;0;0
1299;85670;741;68;24;2;22;.917;3516000;0
1332;175764;734;0;0;0;0;.00nan;0;0
1332;66245;733;65;28;2;26;.929;3550000;0
1332;148503;733;0;0;0;0;.00nan;0;0
1332;148788;734;85;29;1;28;.966;3600000;0
1333;203977;729;0;0;0;0;.00nan;0;0
1333;211604;729;85;25;1;24;.960;3600000;0
1333;78573;737;88;32;2;30;.938;3600000;0
1333;139467;737;0;0;0;0;.00nan;0;0
1334;1957;742;55;23;3;20;.870;3600000;0
1334;163195;743;77;11;0;11;1.000;3600000;0
1334;223469;743;0;0;0;0;.00nan;0;0
1334;-1;742;0;0;0;0;.00nan;0;0
1335;1061;751;63;37;4;33;.892;3600000;0
1335;167642;751;0;0;0;0;.00nan;0;0
1335;-1;747;0;0;0;0;.00nan;0;0
1335;76405;747;68;19;1;18;.947;3600000;0
1336;175764;734;0;0;0;0;.00nan;0;0
1336;66245;733;87;57;5;52;.912;3600000;0
1336;148503;733;0;0;0;0;.00nan;0;0
1336;148788;734;98;26;0;26;1.000;3600000;0
1337;203977;729;0;0;0;0;.00nan;0;0
1337;211604;729;98;48;1;47;.979;3600000;0
1337;78573;737;100;29;0;29;1.000;3600000;0
1337;139467;737;0;0;0;0;.00nan;0;0
1338;1957;742;71;31;3;28;.903;3600000;0
1338;163195;743;53;23;4;19;.826;3558000;0
1338;223469;743;0;0;0;0;.00nan;0;0
1338;-1;742;0;0;0;0;.00nan;0;0
1339;1061;751;46;33;5;28;.848;3600000;0
1339;167642;751;0;0;0;0;.00nan;0;0
1339;-1;747;0;0;0;0;.00nan;0;0
1339;76405;747;67;21;2;19;.905;3600000;0
1340;175764;734;0;0;0;0;.00nan;0;0
1340;66245;733;100;33;0;33;1.000;3600000;0
1340;148503;733;0;0;0;0;.00nan;0;0
1340;148788;734;46;32;5;27;.844;3600000;0
1341;203977;729;0;0;0;0;.00nan;0;0
1341;211604;729;85;67;6;61;.910;5126000;0
1341;78573;737;27;27;5;22;.815;5126000;0
1341;139467;737;0;0;0;0;.00nan;0;0
1342;1957;742;100;35;0;35;1.000;3600000;0
1342;163195;743;67;19;2;17;.895;3545000;0
1342;223469;743;0;0;0;0;.00nan;0;0
1342;-1;742;0;0;0;0;.00nan;0;0
1343;1061;751;59;40;5;35;.875;3600000;0
1343;167642;751;0;0;0;0;.00nan;0;0
1343;-1;747;0;0;0;0;.00nan;0;0
1343;76405;747;91;46;3;43;.935;3600000;0
1344;175764;734;0;0;0;0;.00nan;0;0
1344;66245;733;89;51;3;48;.941;3576000;0
1344;148503;733;0;0;0;0;.00nan;0;0
1344;148788;734;78;19;1;18;.947;3600000;0
1345;203977;729;0;0;0;0;.00nan;0;0
1345;211604;729;67;27;3;24;.889;3562000;0
1345;78573;737;61;20;2;18;.900;3600000;0
1345;139467;737;0;0;0;0;.00nan;0;0
1346;1957;742;69;39;3;36;.923;4574000;0
1346;163195;743;57;31;4;27;.871;4574000;0
1346;223469;743;0;0;0;0;.00nan;0;0
1346;-1;742;0;0;0;0;.00nan;0;0
1347;1061;751;89;45;3;42;.933;3600000;0
1347;167642;751;0;0;0;0;.00nan;0;0
1347;-1;747;0;0;0;0;.00nan;0;0
1347;76405;747;33;17;4;13;.765;3544000;0
1570;175764;734;0;0;0;0;.00nan;0;0
1570;66245;733;56;50;6;44;.880;3600000;0
1570;148503;733;0;0;0;0;.00nan;0;0
1570;148788;734;89;28;2;26;.929;3600000;0
1571;203977;729;0;0;0;0;.00nan;0;0
1571;211604;729;62;42;5;37;.881;3600000;0
1571;78573;737;95;20;0;20;1.000;3600000;0
1571;139467;737;0;0;0;0;.00nan;0;0
1572;1957;742;98;41;2;39;.951;3600000;0
1572;163195;743;70;28;3;25;.893;3543000;0
1572;223469;743;0;0;0;0;.00nan;0;0
1572;-1;742;0;0;0;0;.00nan;0;0
1573;1061;751;100;37;2;35;.946;3600000;0
1573;167642;751;0;0;0;0;.00nan;0;0
1573;-1;747;0;0;0;0;.00nan;0;0
1573;76405;747;73;30;3;27;.900;3554000;0
1616;1061;751;83;45;3;42;.933;4454000;0
1616;167642;751;0;0;0;0;.00nan;0;0
1616;-1;747;0;0;0;0;.00nan;0;0
1616;76405;747;78;25;2;23;.920;4454000;0
1677;175764;734;0;0;0;0;.00nan;0;0
1677;78573;737;47;20;3;17;.850;3569000;0
1677;139467;737;0;0;0;0;.00nan;0;0
1677;148788;734;90;41;2;39;.951;3600000;0
1678;1957;742;91;34;1;33;.971;3600000;0
1678;-1;742;0;0;0;0;.00nan;0;0
1678;-1;747;0;0;0;0;.00nan;0;0
1678;76405;747;52;15;2;13;.867;3600000;0
1679;175764;734;0;0;0;0;.00nan;0;0
1679;78573;737;83;27;1;26;.963;3600000;0
1679;139467;737;0;0;0;0;.00nan;0;0
1679;148788;734;72;30;2;28;.933;3552000;0
1680;1957;742;83;27;2;25;.926;3596000;0
1680;-1;742;0;0;0;0;.00nan;0;0
1680;-1;747;0;0;0;0;.00nan;0;0
1680;76405;747;69;19;1;18;.947;3600000;0
1681;175764;734;0;0;0;0;.00nan;0;0
1681;78573;737;78;23;1;22;.957;3600000;0
1681;139467;737;0;0;0;0;.00nan;0;0
1681;148788;734;60;35;4;31;.886;3600000;0
1682;1957;742;82;39;3;36;.923;3600000;0
1682;-1;742;0;0;0;0;.00nan;0;0
1682;-1;747;0;0;0;0;.00nan;0;0
1682;76405;747;55;35;5;30;.857;3566000;0
1683;175764;734;0;0;0;0;.00nan;0;0
1683;78573;737;79;31;3;28;.903;3721000;0
1683;139467;737;0;0;0;0;.00nan;0;0
1683;148788;734;75;41;4;37;.902;3721000;0
1684;1957;742;79;32;2;30;.938;3544000;0
1684;-1;742;0;0;0;0;.00nan;0;0
1684;-1;747;0;0;0;0;.00nan;0;0
1684;76405;747;84;27;1;26;.963;3600000;0
1886;175764;734;0;0;0;0;.00nan;0;0
1886;78573;737;50;29;4;25;.862;3600000;0
1886;139467;737;0;0;0;0;.00nan;0;0
1886;148788;734;61;39;5;34;.872;3550000;0
1887;1957;742;87;45;3;42;.933;3560000;0
1887;-1;742;0;0;0;0;.00nan;0;0
1887;-1;747;0;0;0;0;.00nan;0;0
1887;76405;747;80;27;1;26;.963;3600000;0
1934;1957;742;65;38;4;34;.895;3600000;0
1934;-1;742;0;0;0;0;.00nan;0;0
1934;-1;747;0;0;0;0;.00nan;0;0
1934;76405;747;65;16;1;15;.938;3600000;0
1980;-1;747;0;0;0;0;.00nan;0;0
1980;76405;747;100;34;0;34;1.000;3600000;0
1980;78573;737;71;39;3;36;.923;3600000;0
1980;139467;737;0;0;0;0;.00nan;0;0
1981;-1;747;0;0;0;0;.00nan;0;0
1981;76405;747;56;16;2;14;.875;3600000;0
1981;78573;737;73;34;3;31;.912;3559000;0
1981;139467;737;0;0;0;0;.00nan;0;0
1982;-1;747;0;0;0;0;.00nan;0;0
1982;76405;747;57;22;3;19;.864;3546000;0
1982;78573;737;77;33;2;31;.939;3600000;0
1982;139467;737;0;0;0;0;.00nan;0;0
1983;-1;747;0;0;0;0;.00nan;0;0
1983;76405;747;100;39;0;39;1.000;3600000;0
1983;78573;737;47;24;4;20;.833;3600000;0
1983;139467;737;0;0;0;0;.00nan;0;0
2179;-1;747;0;0;0;0;.00nan;0;0
2179;76405;747;47;29;4;25;.862;4996000;0
2179;78573;737;90;43;3;40;.930;4996000;0
2179;139467;737;0;0;0;0;.00nan;0;0
2269;-1;747;0;0;0;0;.00nan;0;0
2269;76405;747;81;40;3;37;.925;3600000;0
2269;78573;737;60;34;4;30;.882;3586000;0
2269;139467;737;0;0;0;0;.00nan;0;0
3656;6127;575;50;36;5;31;.861;3600000;0
3656;14191;575;0;0;0;0;.00nan;0;0
3656;-1;573;67;20;2;18;.900;3600000;0
3656;67626;573;0;0;0;0;.00nan;0;0
3657;14459;566;87;44;3;41;.932;3600000;0
3657;28453;566;0;0;0;0;.00nan;0;0
3657;59614;562;75;42;4;38;.905;3581000;0
3657;155943;562;0;0;0;0;.00nan;0;0
3658;13033;577;75;31;2;29;.935;3600000;0
3658;13065;564;0;0;0;0;.00nan;0;0
3658;185232;577;0;0;0;0;.00nan;0;0
3658;141419;564;72;16;1;15;.938;3600000;0
3659;143523;569;0;0;0;0;.00nan;0;0
3659;144705;569;63;13;1;12;.923;3600000;0
3659;152478;572;98;50;2;48;.960;3600000;0
3659;153618;572;0;0;0;0;.00nan;0;0
3660;170144;574;0;0;0;0;.00nan;0;0
3660;195646;568;72;24;2;22;.917;3549000;0
3660;185220;574;75;24;1;23;.958;3600000;0
3660;84430;568;0;0;0;0;.00nan;0;0
3661;483;570;0;0;0;0;.00nan;0;0
3661;190465;578;0;0;0;0;.00nan;0;0
3661;35520;578;92;38;2;36;.947;3805000;0
3661;68167;570;91;31;1;30;.968;3805000;0
3662;169493;571;88;16;0;16;1.000;3600000;0
3662;67614;565;82;41;3;38;.927;3600000;0
3662;86180;571;0;0;0;0;.00nan;0;0
3662;157189;565;0;0;0;0;.00nan;0;0
3663;6127;575;0;0;0;0;.00nan;0;0
3663;170963;575;53;17;2;15;.882;3600000;0
3663;59614;562;67;46;5;41;.891;3600000;0
3663;155943;562;0;0;0;0;.00nan;0;0
3664;-1;573;75;45;4;41;.911;3534000;0
3664;85395;573;0;0;0;0;.00nan;0;0
3664;143523;569;0;0;0;0;.00nan;0;0
3664;144705;569;61;20;2;18;.900;3600000;0
3665;13065;564;0;0;0;0;.00nan;0;0
3665;195646;568;85;23;1;22;.957;3600000;0
3665;84430;568;0;0;0;0;.00nan;0;0
3665;141419;564;81;35;2;33;.943;3600000;0
3666;180535;576;79;22;1;21;.955;3600000;0
3666;67614;565;56;36;5;31;.861;3600000;0
3666;67625;576;0;0;0;0;.00nan;0;0
3666;157189;565;0;0;0;0;.00nan;0;0
3667;483;570;0;0;0;0;.00nan;0;0
3667;14459;566;0;0;0;0;.00nan;0;0
3667;28453;566;51;16;2;14;.875;3557000;0
3667;68167;570;98;39;1;38;.974;3600000;0
3668;14459;566;55;5;0;5;1.000;505000;0
3668;170144;574;49;31;5;26;.839;3600000;0
3668;28453;566;37;35;6;29;.829;3088000;0
3668;185220;574;0;0;0;0;.00nan;0;0
3669;-1;573;0;0;0;0;.00nan;0;0
3669;59614;562;97;41;2;39;.951;3561000;0
3669;85395;573;64;14;1;13;.929;3600000;0
3669;155943;562;0;0;0;0;.00nan;0;0
3670;13033;577;0;0;0;0;.00nan;0;0
3670;185232;577;71;17;1;16;.941;3600000;0
3670;152478;572;56;30;4;26;.867;3600000;0
3670;153618;572;0;0;0;0;.00nan;0;0
3671;13065;564;78;37;2;35;.946;3600000;0
3671;195646;568;0;0;0;0;.00nan;0;0
3671;84430;568;86;28;1;27;.964;3600000;0
3671;141419;564;0;0;0;0;.00nan;0;0
3672;6127;575;0;0;0;0;.00nan;0;0
3672;170963;575;57;26;3;23;.885;3600000;0
3672;180535;576;0;0;0;0;.00nan;0;0
3672;67625;576;54;31;4;27;.871;3576000;0
3673;169493;571;0;0;0;0;.00nan;0;0
3673;190465;578;71;45;5;40;.889;3600000;0
3673;35520;578;0;0;0;0;.00nan;0;0
3673;86180;571;67;19;2;17;.895;3600000;0
3674;483;570;76;39;2;37;.949;3634000;0
3674;68167;570;0;0;0;0;.00nan;0;0
3674;143523;569;75;32;3;29;.906;3634000;0
3674;144705;569;0;0;0;0;.00nan;0;0
3675;13033;577;48;0;0;0;.00nan;633000;0
3675;-1;573;66;30;3;27;.900;3600000;0
3675;185232;577;30;25;6;19;.760;2967000;0
3675;85395;573;0;0;0;0;.00nan;0;0
3676;13065;564;0;0;0;0;.00nan;0;0
3676;180535;576;79;42;3;39;.929;3600000;0
3676;67625;576;0;0;0;0;.00nan;0;0
3676;141419;564;54;17;2;15;.882;3600000;0
3677;67614;565;56;31;4;27;.871;3600000;0
3677;152478;572;76;21;1;20;.952;3600000;0
3677;153618;572;0;0;0;0;.00nan;0;0
3677;157189;565;0;0;0;0;.00nan;0;0
3678;169493;571;0;0;0;0;.00nan;0;0
3678;170144;574;92;28;0;28;1.000;3900000;0
3678;185220;574;0;0;0;0;.00nan;0;0
3678;86180;571;100;32;0;32;1.000;3900000;0
3679;190465;578;67;36;3;33;.917;3568000;0
3679;35520;578;0;0;0;0;.00nan;0;0
3679;143523;569;0;0;0;0;.00nan;0;0
3679;144705;569;100;32;1;31;.969;3600000;0
3680;6127;575;0;0;0;0;.00nan;0;0
3680;170963;575;74;21;1;20;.952;3600000;0
3680;59614;562;18;26;6;20;.769;3600000;0
3680;155943;562;0;0;0;0;.00nan;0;0
3681;14459;566;0;0;0;0;.00nan;0;0
3681;195646;568;71;20;1;19;.950;3600000;0
3681;28453;566;63;31;3;28;.903;3574000;0
3681;84430;568;0;0;0;0;.00nan;0;0
3682;13033;577;0;0;0;0;.00nan;0;0
3682;14459;566;67;40;4;36;.900;3600000;0
3682;28453;566;0;0;0;0;.00nan;0;0
3682;185232;577;57;27;3;24;.889;3600000;0
3683;-1;573;41;19;4;15;.789;3583000;0
3683;180535;576;77;31;3;28;.903;3600000;0
3683;67625;576;0;0;0;0;.00nan;0;0
3683;85395;573;0;0;0;0;.00nan;0;0
3684;169493;571;0;0;0;0;.00nan;0;0
3684;59614;562;0;0;0;0;.00nan;0;0
3684;86180;571;38;23;5;18;.783;3542000;0
3684;155943;562;72;39;3;36;.923;3600000;0
3685;6127;575;0;0;0;0;.00nan;0;0
3685;170144;574;68;27;2;25;.926;3600000;0
3685;170963;575;56;36;4;32;.889;3538000;0
3685;185220;574;0;0;0;0;.00nan;0;0
3686;483;570;0;0;0;0;.00nan;0;0
3686;13065;564;48;0;0;0;.00nan;364000;0
3686;68167;570;65;34;4;30;.882;3600000;0
3686;141419;564;60;40;5;35;.875;3189000;0
3687;14459;566;0;0;0;0;.00nan;0;0
3687;-1;573;0;0;0;0;.00nan;0;0
3687;28453;566;97;31;0;31;1.000;3900000;0
3687;85395;573;91;16;0;16;1.000;3900000;0
3688;13065;564;58;16;2;14;.875;3600000;0
3688;141419;564;0;0;0;0;.00nan;0;0
3688;152478;572;78;42;4;38;.905;3586000;0
3688;153618;572;0;0;0;0;.00nan;0;0
3689;6127;575;49;27;5;22;.815;3570000;0
3689;170963;575;0;0;0;0;.00nan;0;0
3689;190465;578;58;26;3;23;.885;3600000;0
3689;35520;578;0;0;0;0;.00nan;0;0
3690;13033;577;55;19;3;16;.842;3900000;0
3690;169493;571;69;27;3;24;.889;3900000;0
3690;185232;577;0;0;0;0;.00nan;0;0
3690;86180;571;0;0;0;0;.00nan;0;0
3691;483;570;99;46;2;44;.957;3600000;0
3691;195646;568;43;28;4;24;.857;3540000;0
3691;68167;570;0;0;0;0;.00nan;0;0
3691;84430;568;0;0;0;0;.00nan;0;0
3692;170144;574;0;0;0;0;.00nan;0;0
3692;185220;574;62;13;1;12;.923;3600000;0
3692;67614;565;93;44;2;42;.955;3600000;0
3692;157189;565;0;0;0;0;.00nan;0;0
3693;59614;562;43;27;5;22;.815;3600000;0
3693;143523;569;0;0;0;0;.00nan;0;0
3693;144705;569;100;23;0;23;1.000;3600000;0
3693;155943;562;0;0;0;0;.00nan;0;0
3694;170144;574;69;22;2;20;.909;3646000;0
3694;185220;574;0;0;0;0;.00nan;0;0
3694;59614;562;100;38;1;37;.974;3646000;0
3694;155943;562;0;0;0;0;.00nan;0;0
3695;-1;573;0;0;0;0;.00nan;0;0
3695;85395;573;77;27;2;25;.926;3600000;0
3695;152478;572;84;37;3;34;.919;3600000;0
3695;153618;572;0;0;0;0;.00nan;0;0
3696;13033;577;0;0;0;0;.00nan;0;0
3696;180535;576;55;36;4;32;.889;3566000;0
3696;185232;577;65;32;3;29;.906;3600000;0
3696;67625;576;0;0;0;0;.00nan;0;0
3697;13065;564;0;0;0;0;.00nan;0;0
3697;67614;565;90;43;2;41;.953;3545000;0
3697;141419;564;68;19;1;18;.947;3600000;0
3697;157189;565;0;0;0;0;.00nan;0;0
3698;6127;575;0;0;0;0;.00nan;0;0
3698;169493;571;0;0;0;0;.00nan;0;0
3698;170963;575;62;29;3;26;.897;3600000;0
3698;86180;571;76;30;2;28;.933;3600000;0
3699;483;570;0;0;0;0;.00nan;0;0
3699;190465;578;85;49;3;46;.939;3566000;0
3699;35520;578;0;0;0;0;.00nan;0;0
3699;68167;570;66;16;1;15;.938;3600000;0
3700;59614;562;81;37;3;34;.919;3600000;0
3700;67614;565;0;0;0;0;.00nan;0;0
3700;155943;562;0;0;0;0;.00nan;0;0
3700;157189;565;43;32;5;27;.844;3525000;0
3701;180535;576;47;24;3;21;.875;3580000;0
3701;59614;562;0;0;0;0;.00nan;0;0
3701;67625;576;0;0;0;0;.00nan;0;0
3701;155943;562;71;27;2;25;.926;3600000;0
3702;170144;574;54;17;3;14;.824;3900000;0
3702;185220;574;0;0;0;0;.00nan;0;0
3702;152478;572;96;48;3;45;.938;3900000;0
3702;153618;572;0;0;0;0;.00nan;0;0
3703;195646;568;0;0;0;0;.00nan;0;0
3703;190465;578;0;0;0;0;.00nan;0;0
3703;35520;578;55;38;4;34;.895;3600000;0
3703;84430;568;75;25;1;24;.960;3600000;0
3704;6127;575;0;0;0;0;.00nan;0;0
3704;13065;564;0;0;0;0;.00nan;0;0
3704;170963;575;88;45;3;42;.933;3575000;0
3704;141419;564;75;25;1;24;.960;3600000;0
3705;483;570;0;0;0;0;.00nan;0;0
3705;169493;571;0;0;0;0;.00nan;0;0
3705;68167;570;93;38;1;37;.974;3698000;0
3705;86180;571;100;26;0;26;1.000;3698000;0
3706;14459;566;0;0;0;0;.00nan;0;0
3706;28453;566;77;31;2;29;.935;3600000;0
3706;143523;569;0;0;0;0;.00nan;0;0
3706;144705;569;78;22;1;21;.955;3600000;0
3707;14459;566;47;25;3;22;.880;3537000;0
3707;28453;566;0;0;0;0;.00nan;0;0
3707;143523;569;100;38;1;37;.974;3600000;0
3707;144705;569;0;0;0;0;.00nan;0;0
3708;169493;571;82;33;2;31;.939;3542000;0
3708;180535;576;0;0;0;0;.00nan;0;0
3708;67625;576;80;26;1;25;.962;3600000;0
3708;86180;571;0;0;0;0;.00nan;0;0
3709;195646;568;78;23;1;22;.957;3600000;0
3709;84430;568;0;0;0;0;.00nan;0;0
3709;152478;572;68;49;6;43;.878;3600000;0
3709;153618;572;0;0;0;0;.00nan;0;0
3710;-1;573;55;18;2;16;.889;3600000;0
3710;67614;565;87;48;4;44;.917;3558000;0
3710;85395;573;0;0;0;0;.00nan;0;0
3710;157189;565;0;0;0;0;.00nan;0;0
3711;483;570;0;0;0;0;.00nan;0;0
3711;13033;577;0;0;0;0;.00nan;0;0
3711;185232;577;100;33;0;33;1.000;3600000;0
3711;68167;570;74;25;2;23;.920;3589000;0
3712;6127;575;100;46;0;46;1.000;3600000;0
3712;170144;574;0;0;0;0;.00nan;0;0
3712;170963;575;0;0;0;0;.00nan;0;0
3712;185220;574;80;22;1;21;.955;3563000;0
3713;6127;575;57;19;2;17;.895;3557000;0
3713;170963;575;0;0;0;0;.00nan;0;0
3713;67614;565;88;26;1;25;.962;3600000;0
3713;157189;565;0;0;0;0;.00nan;0;0
3714;14459;566;58;12;1;11;.917;3600000;0
3714;28453;566;0;0;0;0;.00nan;0;0
3714;152478;572;100;37;0;37;1.000;3600000;0
3714;153618;572;0;0;0;0;.00nan;0;0
3715;13065;564;0;0;0;0;.00nan;0;0
3715;169493;571;0;0;0;0;.00nan;0;0
3715;86180;571;75;44;4;40;.909;3600000;0
3715;141419;564;100;24;0;24;1.000;3600000;0
3716;-1;573;0;0;0;0;.00nan;0;0
3716;85395;573;93;40;1;39;.975;3900000;0
3716;143523;569;0;0;0;0;.00nan;0;0
3716;144705;569;90;28;1;27;.964;3899000;0
3717;483;570;0;0;0;0;.00nan;0;0
3717;180535;576;44;26;3;23;.885;3588000;0
3717;67625;576;0;0;0;0;.00nan;0;0
3717;68167;570;70;28;2;26;.929;3600000;0
3718;190465;578;90;38;2;36;.947;3600000;0
3718;35520;578;0;0;0;0;.00nan;0;0
3718;59614;562;68;29;4;25;.862;3544000;0
3718;155943;562;0;0;0;0;.00nan;0;0
3719;6127;575;0;0;0;0;.00nan;0;0
3719;170963;575;79;34;3;31;.912;3600000;0
3719;195646;568;72;22;1;21;.955;3600000;0
3719;84430;568;0;0;0;0;.00nan;0;0
3720;483;570;0;0;0;0;.00nan;0;0
3720;170144;574;68;19;1;18;.947;3900000;0
3720;185220;574;0;0;0;0;.00nan;0;0
3720;68167;570;91;34;1;33;.971;3900000;0
3721;13065;564;0;0;0;0;.00nan;0;0
3721;-1;573;82;37;2;35;.946;3600000;0
3721;85395;573;0;0;0;0;.00nan;0;0
3721;141419;564;48;29;4;25;.862;3510000;0
3722;13033;577;0;0;0;0;.00nan;0;0
3722;185232;577;93;31;1;30;.968;3600000;0
3722;67614;565;48;32;5;27;.844;3600000;0
3722;157189;565;0;0;0;0;.00nan;0;0
3723;169493;571;0;0;0;0;.00nan;0;0
3723;86180;571;60;42;6;36;.857;3648000;0
3723;143523;569;40;25;5;20;.800;3648000;0
3723;144705;569;0;0;0;0;.00nan;0;0
3724;14459;566;0;0;0;0;.00nan;0;0
3724;28453;566;55;24;3;21;.875;3558000;0
3724;180535;576;43;17;2;15;.882;3600000;0
3724;67625;576;0;0;0;0;.00nan;0;0
3725;-1;573;77;28;2;26;.929;3900000;0
3725;195646;568;82;26;2;24;.923;3900000;0
3725;84430;568;0;0;0;0;.00nan;0;0
3725;85395;573;0;0;0;0;.00nan;0;0
3726;13065;564;0;0;0;0;.00nan;0;0
3726;59614;562;90;54;4;50;.926;3600000;0
3726;141419;564;47;8;1;7;.875;3600000;0
3726;155943;562;0;0;0;0;.00nan;0;0
3727;483;570;0;0;0;0;.00nan;0;0
3727;13033;577;80;21;1;20;.952;3600000;0
3727;185232;577;0;0;0;0;.00nan;0;0
3727;68167;570;66;49;5;44;.898;3600000;0
3728;190465;578;81;24;1;23;.958;3600000;0
3728;35520;578;0;0;0;0;.00nan;0;0
3728;152478;572;78;32;3;29;.906;3600000;0
3728;153618;572;0;0;0;0;.00nan;0;0
3729;6127;575;0;0;0;0;.00nan;0;0
3729;170963;575;97;45;2;43;.956;3900000;0
3729;143523;569;0;0;0;0;.00nan;0;0
3729;144705;569;60;17;2;15;.882;3900000;0
3730;169493;571;91;29;1;28;.966;3600000;0
3730;67614;565;0;0;0;0;.00nan;0;0
3730;86180;571;0;0;0;0;.00nan;0;0
3730;157189;565;61;23;2;21;.913;3567000;0
3731;13065;564;0;0;0;0;.00nan;0;0
3731;14459;566;75;36;3;33;.917;3600000;0
3731;28453;566;0;0;0;0;.00nan;0;0
3731;141419;564;39;22;4;18;.818;3600000;0
3732;-1;573;0;0;0;0;.00nan;0;0
3732;180535;576;78;47;5;42;.894;3600000;0
3732;67625;576;0;0;0;0;.00nan;0;0
3732;85395;573;60;21;2;19;.905;3600000;0
3733;195646;568;0;0;0;0;.00nan;0;0
3733;190465;578;65;29;3;26;.897;3553000;0
3733;35520;578;0;0;0;0;.00nan;0;0
3733;84430;568;89;26;1;25;.962;3600000;0
3734;170144;574;50;33;5;28;.848;3551000;0
3734;185220;574;0;0;0;0;.00nan;0;0
3734;143523;569;0;0;0;0;.00nan;0;0
3734;144705;569;49;20;3;17;.850;3600000;0
3735;190465;578;44;32;6;26;.813;3600000;0
3735;180535;576;0;0;0;0;.00nan;0;0
3735;35520;578;0;0;0;0;.00nan;0;0
3735;67625;576;63;28;3;25;.893;3600000;0
3736;14459;566;0;0;0;0;.00nan;0;0
3736;28453;566;83;27;1;26;.963;3600000;0
3736;59614;562;72;28;2;26;.929;3568000;0
3736;155943;562;0;0;0;0;.00nan;0;0
3737;13033;577;0;0;0;0;.00nan;0;0
3737;-1;573;65;29;3;26;.897;3563000;0
3737;185232;577;79;32;2;30;.938;3600000;0
3737;85395;573;0;0;0;0;.00nan;0;0
3738;13065;564;78;34;2;32;.941;3600000;0
3738;141419;564;0;0;0;0;.00nan;0;0
3738;143523;569;0;0;0;0;.00nan;0;0
3738;144705;569;57;33;4;29;.879;3559000;0
3739;6127;575;66;23;2;21;.913;3600000;0
3739;170963;575;0;0;0;0;.00nan;0;0
3739;152478;572;70;34;3;31;.912;3591000;0
3739;153618;572;0;0;0;0;.00nan;0;0
3740;483;570;61;49;6;43;.878;3900000;0
3740;67614;565;44;30;5;25;.833;2280000;0
3740;68167;570;0;0;0;0;.00nan;0;0
3740;157189;565;54;10;1;9;.900;1620000;0
3741;14459;566;85;41;3;38;.927;3588000;0
3741;-1;573;0;0;0;0;.00nan;0;0
3741;28453;566;0;0;0;0;.00nan;0;0
3741;85395;573;61;21;2;19;.905;3600000;0
3742;170144;574;51;22;4;18;.818;3513000;0
3742;180535;576;0;0;0;0;.00nan;0;0
3742;185220;574;0;0;0;0;.00nan;0;0
3742;67625;576;94;41;2;39;.951;3600000;0
3743;169493;571;0;0;0;0;.00nan;0;0
3743;190465;578;0;0;0;0;.00nan;0;0
3743;35520;578;77;36;3;33;.917;3575000;0
3743;86180;571;57;17;2;15;.882;3600000;0
3744;195646;568;0;0;0;0;.00nan;0;0
3744;59614;562;47;26;5;21;.808;3600000;0
3744;84430;568;100;35;1;34;.971;3600000;0
3744;155943;562;0;0;0;0;.00nan;0;0
3745;13065;564;0;0;0;0;.00nan;0;0
3745;67614;565;87;37;2;35;.946;3585000;0
3745;141419;564;67;20;1;19;.950;3600000;0
3745;157189;565;0;0;0;0;.00nan;0;0
3746;6127;575;0;0;0;0;.00nan;0;0
3746;170963;575;100;28;0;28;1.000;3600000;0
3746;143523;569;72;20;1;19;.950;3600000;0
3746;144705;569;0;0;0;0;.00nan;0;0
3747;13033;577;53;7;1;6;.857;3600000;0
3747;185232;577;0;0;0;0;.00nan;0;0
3747;152478;572;64;37;4;33;.892;3600000;0
3747;153618;572;0;0;0;0;.00nan;0;0
3748;13065;564;0;0;0;0;.00nan;0;0
3748;170144;574;94;38;2;36;.947;3543000;0
3748;185220;574;0;0;0;0;.00nan;0;0
3748;141419;564;70;22;1;21;.955;3600000;0
3749;14459;566;0;0;0;0;.00nan;0;0
3749;28453;566;67;18;1;17;.944;3600000;0
3749;180535;576;61;40;4;36;.900;3600000;0
3749;67625;576;0;0;0;0;.00nan;0;0
3750;13033;577;0;0;0;0;.00nan;0;0
3750;190465;578;0;0;0;0;.00nan;0;0
3750;185232;577;73;21;1;20;.952;3600000;0
3750;35520;578;59;52;6;46;.885;3600000;0
3751;-1;573;0;0;0;0;.00nan;0;0
3751;170144;574;94;37;2;35;.946;3583000;0
3751;185220;574;0;0;0;0;.00nan;0;0
3751;85395;573;65;37;3;34;.919;3600000;0
3752;13065;564;61;21;2;19;.905;3600000;0
3752;141419;564;0;0;0;0;.00nan;0;0
3752;152478;572;88;38;3;35;.921;3589000;0
3752;153618;572;0;0;0;0;.00nan;0;0
3753;6127;575;0;0;0;0;.00nan;0;0
3753;169493;571;47;19;3;16;.842;3600000;0
3753;170963;575;78;33;2;31;.939;3600000;0
3753;86180;571;0;0;0;0;.00nan;0;0
3754;195646;568;63;22;2;20;.909;3900000;0
3754;67614;565;87;34;2;32;.941;3900000;0
3754;84430;568;0;0;0;0;.00nan;0;0
3754;157189;565;0;0;0;0;.00nan;0;0
3755;180535;576;0;0;0;0;.00nan;0;0
3755;67625;576;71;30;2;28;.933;3590000;0
3755;143523;569;0;0;0;0;.00nan;0;0
3755;144705;569;99;34;1;33;.971;3600000;0
3756;-1;573;85;29;1;28;.966;3600000;0
3756;169493;571;80;45;3;42;.933;3573000;0
3756;85395;573;0;0;0;0;.00nan;0;0
3756;86180;571;0;0;0;0;.00nan;0;0
3757;59614;562;69;30;3;27;.900;3600000;0
3757;152478;572;28;42;8;34;.810;3600000;0
3757;153618;572;0;0;0;0;.00nan;0;0
3757;155943;562;0;0;0;0;.00nan;0;0
3758;190465;578;0;0;0;0;.00nan;0;0
3758;35520;578;63;20;1;19;.950;3600000;0
3758;67614;565;0;0;0;0;.00nan;0;0
3758;157189;565;75;28;2;26;.929;3593000;0
3759;6127;575;33;37;7;30;.811;3600000;0
3759;13033;577;0;0;0;0;.00nan;0;0
3759;170963;575;0;0;0;0;.00nan;0;0
3759;185232;577;72;18;1;17;.944;3600000;0
3760;195646;568;0;0;0;0;.00nan;0;0
3760;84430;568;41;28;5;23;.821;3600000;0
3760;143523;569;100;29;0;29;1.000;3600000;0
3760;144705;569;0;0;0;0;.00nan;0;0
3761;483;570;0;0;0;0;.00nan;0;0
3761;170144;574;0;0;0;0;.00nan;0;0
3761;185220;574;73;23;1;22;.957;3600000;0
3761;68167;570;45;29;5;24;.828;3600000;0
3762;483;570;0;0;0;0;.00nan;0;0
3762;59614;562;0;0;0;0;.00nan;0;0
3762;68167;570;75;23;1;22;.957;3600000;0
3762;155943;562;77;47;4;43;.915;3600000;0
3763;13033;577;0;0;0;0;.00nan;0;0
3763;169493;571;84;33;2;31;.939;3599000;0
3763;185232;577;100;28;0;28;1.000;3600000;0
3763;86180;571;0;0;0;0;.00nan;0;0
3764;195646;568;88;33;1;32;.970;3600000;0
3764;180535;576;33;30;6;24;.800;3600000;0
3764;67625;576;0;0;0;0;.00nan;0;0
3764;84430;568;0;0;0;0;.00nan;0;0
3765;13065;564;0;0;0;0;.00nan;0;0
3765;59614;562;76;55;5;50;.909;3600000;0
3765;141419;564;86;15;0;15;1.000;3600000;0
3765;155943;562;0;0;0;0;.00nan;0;0
3766;14459;566;52;21;3;18;.857;3600000;0
3766;28453;566;0;0;0;0;.00nan;0;0
3766;67614;565;47;35;6;29;.829;3600000;0
3766;157189;565;0;0;0;0;.00nan;0;0
3767;190465;578;0;0;0;0;.00nan;0;0
3767;35520;578;88;44;3;41;.932;3600000;0
3767;143523;569;90;16;0;16;1.000;3600000;0
3767;144705;569;0;0;0;0;.00nan;0;0
3768;483;570;0;0;0;0;.00nan;0;0
3768;6127;575;0;0;0;0;.00nan;0;0
3768;170963;575;67;40;4;36;.900;3600000;0
3768;68167;570;98;25;0;25;1.000;3600000;0
3769;169493;571;78;38;2;36;.947;3618000;0
3769;86180;571;0;0;0;0;.00nan;0;0
3769;143523;569;67;27;3;24;.889;3618000;0
3769;144705;569;0;0;0;0;.00nan;0;0
3770;6127;575;0;0;0;0;.00nan;0;0
3770;14459;566;0;0;0;0;.00nan;0;0
3770;170963;575;99;38;1;37;.974;3600000;0
3770;28453;566;53;25;3;22;.880;3532000;0
3771;59614;562;93;26;0;26;1.000;3600000;0
3771;67614;565;66;39;4;35;.897;3600000;0
3771;155943;562;0;0;0;0;.00nan;0;0
3771;157189;565;0;0;0;0;.00nan;0;0
3772;13033;577;0;0;0;0;.00nan;0;0
3772;170144;574;88;14;0;14;1.000;3600000;0
3772;185220;574;0;0;0;0;.00nan;0;0
3772;185232;577;98;36;1;35;.972;3600000;0
3773;180535;576;0;0;0;0;.00nan;0;0
3773;67625;576;71;20;1;19;.950;3600000;0
3773;152478;572;76;26;2;24;.923;3600000;0
3773;153618;572;0;0;0;0;.00nan;0;0
3774;-1;573;0;0;0;0;.00nan;0;0
3774;190465;578;0;0;0;0;.00nan;0;0
3774;35520;578;74;37;3;34;.919;3540000;0
3774;85395;573;76;24;1;23;.958;3600000;0
3775;180535;576;43;26;4;22;.846;3576000;0
3775;59614;562;58;27;3;24;.889;3600000;0
3775;67625;576;0;0;0;0;.00nan;0;0
3775;155943;562;0;0;0;0;.00nan;0;0
3776;-1;573;57;16;1;15;.938;3900000;0
3776;190465;578;100;41;1;40;.976;3900000;0
3776;35520;578;0;0;0;0;.00nan;0;0
3776;85395;573;0;0;0;0;.00nan;0;0
3777;6127;575;97;53;3;50;.943;3582000;0
3777;14459;566;78;21;1;20;.952;3600000;0
3777;170963;575;0;0;0;0;.00nan;0;0
3777;28453;566;0;0;0;0;.00nan;0;0
3778;13065;564;0;0;0;0;.00nan;0;0
3778;195646;568;36;29;6;23;.793;3116000;0
3778;84430;568;53;4;0;4;1.000;484000;0
3778;141419;564;87;37;2;35;.946;3600000;0
3779;67614;565;0;0;0;0;.00nan;0;0
3779;152478;572;0;0;0;0;.00nan;0;0
3779;153618;572;65;19;1;18;.947;3600000;0
3779;157189;565;73;29;3;26;.897;3549000;0
3780;483;570;0;0;0;0;.00nan;0;0
3780;169493;571;55;23;3;20;.870;3900000;0
3780;68167;570;68;34;3;31;.912;3900000;0
3780;86180;571;0;0;0;0;.00nan;0;0
3781;13033;577;49;26;4;22;.846;3600000;0
3781;170144;574;79;29;1;28;.966;3600000;0
3781;185220;574;0;0;0;0;.00nan;0;0
3781;185232;577;0;0;0;0;.00nan;0;0
3782;169493;571;95;33;2;31;.939;3900000;0
3782;170144;574;56;20;2;18;.900;3900000;0
3782;185220;574;0;0;0;0;.00nan;0;0
3782;86180;571;0;0;0;0;.00nan;0;0
3783;195646;568;68;23;2;21;.913;3731000;0
3783;84430;568;0;0;0;0;.00nan;0;0
3783;152478;572;93;54;3;51;.944;3731000;0
3783;153618;572;0;0;0;0;.00nan;0;0
3784;-1;573;0;0;0;0;.00nan;0;0
3784;190465;578;87;43;3;40;.930;3625000;0
3784;35520;578;0;0;0;0;.00nan;0;0
3784;85395;573;53;17;2;15;.882;3625000;0
3785;13033;577;0;0;0;0;.00nan;0;0
3785;185232;577;74;33;3;30;.909;3563000;0
3785;143523;569;0;0;0;0;.00nan;0;0
3785;144705;569;71;21;1;20;.952;3600000;0
3786;170144;574;0;0;0;0;.00nan;0;0
3786;185220;574;79;23;1;22;.957;3600000;0
3786;59614;562;66;37;5;32;.865;3600000;0
3786;155943;562;0;0;0;0;.00nan;0;0
3787;6127;575;0;0;0;0;.00nan;0;0
3787;170963;575;90;25;1;24;.960;3600000;0
3787;67614;565;76;43;4;39;.907;3600000;0
3787;157189;565;0;0;0;0;.00nan;0;0
3788;13065;564;0;0;0;0;.00nan;0;0
3788;14459;566;0;0;0;0;.00nan;0;0
3788;28453;566;71;51;5;46;.902;3600000;0
3788;141419;564;60;21;2;19;.905;3600000;0
3789;-1;573;57;29;3;26;.897;3900000;0
3789;180535;576;0;0;0;0;.00nan;0;0
3789;67625;576;84;43;3;40;.930;3900000;0
3789;85395;573;0;0;0;0;.00nan;0;0
3790;190465;578;0;0;0;0;.00nan;0;0
3790;35520;578;100;36;0;36;1.000;3600000;0
3790;59614;562;0;0;0;0;.00nan;0;0
3790;155943;562;75;30;2;28;.933;3532000;0
3791;483;570;0;0;0;0;.00nan;0;0
3791;68167;570;98;19;0;19;1.000;3600000;0
3791;152478;572;97;60;1;59;.983;3600000;0
3791;153618;572;0;0;0;0;.00nan;0;0
3792;6127;575;54;41;5;36;.878;3546000;0
3792;13065;564;34;15;4;11;.733;3600000;0
3792;170963;575;0;0;0;0;.00nan;0;0
3792;141419;564;0;0;0;0;.00nan;0;0
3793;169493;571;0;0;0;0;.00nan;0;0
3793;195646;568;59;22;3;19;.864;3600000;0
3793;84430;568;0;0;0;0;.00nan;0;0
3793;86180;571;53;23;4;19;.826;3572000;0
3794;67614;565;97;36;1;35;.972;3600000;0
3794;143523;569;0;0;0;0;.00nan;0;0
3794;144705;569;38;12;3;9;.750;3566000;0
3794;157189;565;0;0;0;0;.00nan;0;0
3795;6127;575;0;0;0;0;.00nan;0;0
3795;-1;573;70;25;2;23;.920;3600000;0
3795;170963;575;66;30;4;26;.867;3533000;0
3795;85395;573;0;0;0;0;.00nan;0;0
3796;13033;577;0;0;0;0;.00nan;0;0
3796;190465;578;0;0;0;0;.00nan;0;0
3796;185232;577;37;17;3;14;.824;3569000;0
3796;35520;578;99;35;1;34;.971;3600000;0
3797;169493;571;77;21;1;20;.952;3600000;0
3797;86180;571;0;0;0;0;.00nan;0;0
3797;152478;572;75;29;2;27;.931;3564000;0
3797;153618;572;0;0;0;0;.00nan;0;0
3798;14459;566;0;0;0;0;.00nan;0;0
3798;170144;574;75;26;1;25;.962;3600000;0
3798;28453;566;37;22;4;18;.818;3600000;0
3798;185220;574;0;0;0;0;.00nan;0;0
3799;13065;564;0;0;0;0;.00nan;0;0
3799;180535;576;0;0;0;0;.00nan;0;0
3799;67625;576;99;26;0;26;1.000;3600000;0
3799;141419;564;85;33;2;31;.939;3600000;0
3800;195646;568;0;0;0;0;.00nan;0;0
3800;67614;565;0;0;0;0;.00nan;0;0
3800;84430;568;87;16;0;16;1.000;3600000;0
3800;157189;565;46;31;4;27;.871;3600000;0
3801;483;570;0;0;0;0;.00nan;0;0
3801;59614;562;74;35;3;32;.914;3600000;0
3801;68167;570;80;24;1;23;.958;3600000;0
3801;155943;562;0;0;0;0;.00nan;0;0
3802;483;570;0;0;0;0;.00nan;0;0
3802;14459;566;88;49;3;46;.939;3600000;0
3802;28453;566;0;0;0;0;.00nan;0;0
3802;68167;570;100;26;0;26;1.000;3600000;0
3803;-1;573;0;0;0;0;.00nan;0;0
3803;170144;574;67;18;1;17;.944;3900000;0
3803;185220;574;0;0;0;0;.00nan;0;0
3803;85395;573;91;34;1;33;.971;3900000;0
3804;180535;576;0;0;0;0;.00nan;0;0
3804;67625;576;85;42;2;40;.952;3900000;0
3804;152478;572;59;21;2;19;.905;3900000;0
3804;153618;572;0;0;0;0;.00nan;0;0
3805;13065;564;0;0;0;0;.00nan;0;0
3805;190465;578;57;40;5;35;.875;3600000;0
3805;35520;578;0;0;0;0;.00nan;0;0
3805;141419;564;55;16;2;14;.875;3600000;0
3806;195646;568;97;48;2;46;.958;3900000;0
3806;84430;568;0;0;0;0;.00nan;0;0
3806;143523;569;66;18;2;16;.889;3900000;0
3806;144705;569;0;0;0;0;.00nan;0;0
3807;13033;577;0;0;0;0;.00nan;0;0
3807;185232;577;73;10;0;10;1.000;3600000;0
3807;152478;572;97;51;4;47;.922;3600000;0
3807;153618;572;0;0;0;0;.00nan;0;0
3808;170144;574;61;17;1;16;.941;3600000;0
3808;190465;578;68;41;4;37;.902;3600000;0
3808;185220;574;0;0;0;0;.00nan;0;0
3808;35520;578;0;0;0;0;.00nan;0;0
3809;14459;566;0;0;0;0;.00nan;0;0
3809;169493;571;80;34;3;31;.912;3900000;0
3809;28453;566;82;34;3;31;.912;3900000;0
3809;86180;571;0;0;0;0;.00nan;0;0
3810;195646;568;100;35;0;35;1.000;3600000;0
3810;180535;576;0;0;0;0;.00nan;0;0
3810;67625;576;67;28;3;25;.893;3600000;0
3810;84430;568;0;0;0;0;.00nan;0;0
3811;59614;562;45;26;4;22;.846;3600000;0
3811;67614;565;57;35;5;30;.857;3600000;0
3811;155943;562;0;0;0;0;.00nan;0;0
3811;157189;565;0;0;0;0;.00nan;0;0
3812;483;570;0;0;0;0;.00nan;0;0
3812;68167;570;50;28;4;24;.857;3514000;0
3812;143523;569;0;0;0;0;.00nan;0;0
3812;144705;569;74;30;2;28;.933;3600000;0
3813;14459;566;91;39;2;37;.949;3675000;0
3813;28453;566;0;0;0;0;.00nan;0;0
3813;143523;569;65;27;3;24;.889;3675000;0
3813;144705;569;0;0;0;0;.00nan;0;0
3814;483;570;0;0;0;0;.00nan;0;0
3814;-1;573;85;38;2;36;.947;3900000;0
3814;68167;570;75;30;2;28;.933;3900000;0
3814;85395;573;0;0;0;0;.00nan;0;0
3815;180535;576;73;34;3;31;.912;3890000;0
3815;67614;565;0;0;0;0;.00nan;0;0
3815;67625;576;0;0;0;0;.00nan;0;0
3815;157189;565;57;30;4;26;.867;3890000;0
3816;195646;568;94;25;0;25;1.000;3600000;0
3816;59614;562;24;10;4;6;.600;537000;0
3816;84430;568;0;0;0;0;.00nan;0;0
3816;155943;562;81;28;2;26;.929;3063000;0
3817;6127;575;0;0;0;0;.00nan;0;0
3817;13033;577;0;0;0;0;.00nan;0;0
3817;170963;575;71;37;3;34;.919;3600000;0
3817;185232;577;53;24;4;20;.833;3589000;0
3818;170144;574;50;1;0;1;1.000;523000;0
3818;190465;578;86;34;2;32;.941;3600000;0
3818;185220;574;11;21;6;15;.714;3077000;0
3818;35520;578;0;0;0;0;.00nan;0;0
3819;13065;564;0;0;0;0;.00nan;0;0
3819;169493;571;0;0;0;0;.00nan;0;0
3819;86180;571;98;44;2;42;.955;3548000;0
3819;141419;564;70;20;1;19;.950;3600000;0
3820;13033;577;0;0;0;0;.00nan;0;0
3820;185232;577;60;34;4;30;.882;3882000;0
3820;143523;569;0;0;0;0;.00nan;0;0
3820;144705;569;72;32;3;29;.906;3882000;0
3821;483;570;0;0;0;0;.00nan;0;0
3821;13065;564;0;0;0;0;.00nan;0;0
3821;68167;570;62;46;5;41;.891;3600000;0
3821;141419;564;58;21;2;19;.905;3600000;0
3822;13033;577;60;26;3;23;.885;3600000;0
3822;185232;577;0;0;0;0;.00nan;0;0
3822;59614;562;90;51;4;47;.922;3567000;0
3822;155943;562;0;0;0;0;.00nan;0;0
3823;170144;574;72;30;2;28;.933;3900000;0
3823;185220;574;0;0;0;0;.00nan;0;0
3823;152478;572;96;43;2;41;.953;3900000;0
3823;153618;572;0;0;0;0;.00nan;0;0
3824;14459;566;0;0;0;0;.00nan;0;0
3824;28453;566;82;21;1;20;.952;3600000;0
3824;190465;578;0;0;0;0;.00nan;0;0
3824;35520;578;57;30;3;27;.900;3528000;0
3825;-1;573;60;22;2;20;.909;3600000;0
3825;169493;571;0;0;0;0;.00nan;0;0
3825;85395;573;0;0;0;0;.00nan;0;0
3825;86180;571;43;28;4;24;.857;3553000;0
3826;180535;576;0;0;0;0;.00nan;0;0
3826;67625;576;82;33;2;31;.939;3600000;0
3826;143523;569;0;0;0;0;.00nan;0;0
3826;144705;569;85;27;1;26;.963;3600000;0
3827;170144;574;0;0;0;0;.00nan;0;0
3827;185220;574;48;17;2;15;.882;3600000;0
3827;152478;572;85;38;3;35;.921;3585000;0
3827;153618;572;0;0;0;0;.00nan;0;0
3828;6127;575;0;0;0;0;.00nan;0;0
3828;170963;575;100;33;0;33;1.000;3600000;0
3828;195646;568;86;32;1;31;.969;3600000;0
3828;84430;568;0;0;0;0;.00nan;0;0
3829;483;570;0;0;0;0;.00nan;0;0
3829;67614;565;65;26;3;23;.885;3600000;0
3829;68167;570;100;32;0;32;1.000;3600000;0
3829;157189;565;0;0;0;0;.00nan;0;0
3830;169493;571;0;0;0;0;.00nan;0;0
3830;180535;576;48;25;4;21;.840;3587000;0
3830;67625;576;0;0;0;0;.00nan;0;0
3830;86180;571;70;19;2;17;.895;3600000;0
3831;13065;564;0;0;0;0;.00nan;0;0
3831;-1;573;0;0;0;0;.00nan;0;0
3831;85395;573;75;33;4;29;.879;3600000;0
3831;141419;564;69;28;3;25;.893;3600000;0
3832;13033;577;0;0;0;0;.00nan;0;0
3832;185232;577;100;43;0;43;1.000;3900000;0
3832;59614;562;85;24;0;24;1.000;3900000;0
3832;155943;562;0;0;0;0;.00nan;0;0
3833;483;570;0;0;0;0;.00nan;0;0
3833;190465;578;0;0;0;0;.00nan;0;0
3833;35520;578;40;40;6;34;.850;3600000;0
3833;68167;570;86;25;1;24;.960;3600000;0
3834;67614;565;62;9;0;9;1.000;440000;0
3834;143523;569;80;11;0;11;1.000;3600000;0
3834;144705;569;0;0;0;0;.00nan;0;0
3834;157189;565;61;41;6;35;.854;3160000;0
3835;59614;562;47;26;4;22;.846;3600000;0
3835;152478;572;96;25;0;25;1.000;3600000;0
3835;153618;572;0;0;0;0;.00nan;0;0
3835;155943;562;0;0;0;0;.00nan;0;0
3836;169493;571;0;0;0;0;.00nan;0;0
3836;195646;568;0;0;0;0;.00nan;0;0
3836;84430;568;91;32;1;31;.969;3600000;0
3836;86180;571;100;27;0;27;1.000;3600000;0
3837;-1;573;61;26;3;23;.885;3600000;0
3837;85395;573;0;0;0;0;.00nan;0;0
3837;143523;569;43;25;4;21;.840;3590000;0
3837;144705;569;0;0;0;0;.00nan;0;0
3838;13033;577;0;0;0;0;.00nan;0;0
3838;180535;576;0;0;0;0;.00nan;0;0
3838;185232;577;90;20;0;20;1.000;3600000;0
3838;67625;576;62;33;4;29;.879;3600000;0
3839;169493;571;0;0;0;0;.00nan;0;0
3839;170144;574;77;38;3;35;.921;3900000;0
3839;185220;574;0;0;0;0;.00nan;0;0
3839;86180;571;100;46;3;43;.935;3900000;0
3840;13065;564;0;0;0;0;.00nan;0;0
3840;14459;566;0;0;0;0;.00nan;0;0
3840;28453;566;71;38;4;34;.895;3589000;0
3840;141419;564;69;24;2;22;.917;3600000;0
3841;483;570;0;0;0;0;.00nan;0;0
3841;6127;575;0;0;0;0;.00nan;0;0
3841;170963;575;95;23;0;23;1.000;3600000;0
3841;68167;570;90;34;1;33;.971;3564000;0
3842;190465;578;86;40;2;38;.950;3529000;0
3842;35520;578;0;0;0;0;.00nan;0;0
3842;67614;565;83;25;1;24;.960;3600000;0
3842;157189;565;0;0;0;0;.00nan;0;0
3843;-1;573;0;0;0;0;.00nan;0;0
3843;59614;562;62;32;4;28;.875;3900000;0
3843;85395;573;46;21;4;17;.810;3900000;0
3843;155943;562;0;0;0;0;.00nan;0;0
3844;6127;575;0;0;0;0;.00nan;0;0
3844;14459;566;96;23;0;23;1.000;3600000;0
3844;170963;575;97;38;1;37;.974;3578000;0
3844;28453;566;0;0;0;0;.00nan;0;0
3845;190465;578;95;31;1;30;.968;3900000;0
3845;180535;576;0;0;0;0;.00nan;0;0
3845;35520;578;0;0;0;0;.00nan;0;0
3845;67625;576;61;15;1;14;.933;3900000;0
3846;59614;562;0;0;0;0;.00nan;0;0
3846;143523;569;0;0;0;0;.00nan;0;0
3846;144705;569;51;13;2;11;.846;3600000;0
3846;155943;562;46;44;6;38;.864;3600000;0
3847;170144;574;52;13;1;12;.923;3600000;0
3847;185220;574;0;0;0;0;.00nan;0;0
3847;67614;565;84;49;4;45;.918;3600000;0
3847;157189;565;0;0;0;0;.00nan;0;0
3848;13033;577;0;0;0;0;.00nan;0;0
3848;13065;564;0;0;0;0;.00nan;0;0
3848;185232;577;58;37;4;33;.892;3600000;0
3848;141419;564;100;27;0;27;1.000;3600000;0
3849;483;570;0;0;0;0;.00nan;0;0
3849;195646;568;78;42;3;39;.929;3600000;0
3849;68167;570;68;32;4;28;.875;3547000;0
3849;84430;568;0;0;0;0;.00nan;0;0
3850;14459;566;65;37;4;33;.892;3600000;0
3850;195646;568;0;0;0;0;.00nan;0;0
3850;28453;566;0;0;0;0;.00nan;0;0
3850;84430;568;83;17;0;17;1.000;3600000;0
3851;13033;577;0;0;0;0;.00nan;0;0
3851;170144;574;88;33;1;32;.970;3586000;0
3851;185220;574;0;0;0;0;.00nan;0;0
3851;185232;577;88;18;0;18;1.000;3600000;0
3852;190465;578;0;0;0;0;.00nan;0;0
3852;180535;576;60;13;1;12;.923;3579000;0
3852;35520;578;99;26;0;26;1.000;3600000;0
3852;67625;576;0;0;0;0;.00nan;0;0
3853;6127;575;64;52;6;46;.885;3600000;0
3853;170963;575;0;0;0;0;.00nan;0;0
3853;143523;569;69;19;1;18;.947;3600000;0
3853;144705;569;0;0;0;0;.00nan;0;0
3854;169493;571;0;0;0;0;.00nan;0;0
3854;86180;571;67;17;1;16;.941;3600000;0
3854;152478;572;84;37;3;34;.919;3568000;0
3854;153618;572;0;0;0;0;.00nan;0;0
3855;483;570;0;0;0;0;.00nan;0;0
3855;67614;565;0;0;0;0;.00nan;0;0
3855;68167;570;98;46;2;44;.957;3544000;0
3855;157189;565;100;27;0;27;1.000;3600000;0
3856;14459;566;0;0;0;0;.00nan;0;0
3856;28453;566;56;29;4;25;.862;3545000;0
3856;190465;578;0;0;0;0;.00nan;0;0
3856;35520;578;90;36;2;34;.944;3600000;0
3857;170144;574;74;17;1;16;.941;3900000;0
3857;180535;576;0;0;0;0;.00nan;0;0
3857;185220;574;0;0;0;0;.00nan;0;0
3857;67625;576;95;34;1;33;.971;3900000;0
3858;59614;562;68;22;2;20;.909;3600000;0
3858;67614;565;0;0;0;0;.00nan;0;0
3858;155943;562;0;0;0;0;.00nan;0;0
3858;157189;565;75;41;3;38;.927;3600000;0
3859;13033;577;0;0;0;0;.00nan;0;0
3859;195646;568;0;0;0;0;.00nan;0;0
3859;185232;577;88;31;1;30;.968;3600000;0
3859;84430;568;65;26;2;24;.923;3556000;0
3860;-1;573;0;0;0;0;.00nan;0;0
3860;85395;573;92;22;0;22;1.000;3695000;0
3860;152478;572;93;55;1;54;.982;3695000;0
3860;153618;572;0;0;0;0;.00nan;0;0
3861;13065;564;68;25;2;23;.920;3600000;0
3861;169493;571;84;32;1;31;.969;2758000;0
3861;86180;571;32;15;4;11;.733;842000;0
3861;141419;564;0;0;0;0;.00nan;0;0
3862;6127;575;0;0;0;0;.00nan;0;0
3862;170963;575;69;41;4;37;.902;3600000;0
3862;143523;569;0;0;0;0;.00nan;0;0
3862;144705;569;53;31;5;26;.839;3544000;0
3863;-1;573;59;26;3;23;.885;3900000;0
3863;67614;565;79;42;3;39;.929;3900000;0
3863;85395;573;0;0;0;0;.00nan;0;0
3863;157189;565;0;0;0;0;.00nan;0;0
3864;6127;575;0;0;0;0;.00nan;0;0
3864;170963;575;54;16;2;14;.875;3600000;0
3864;190465;578;63;46;6;40;.870;3600000;0
3864;35520;578;0;0;0;0;.00nan;0;0
3865;169493;571;0;0;0;0;.00nan;0;0
3865;59614;562;39;1;1;0;.000;329000;0
3865;86180;571;65;17;2;15;.882;3600000;0
3865;155943;562;66;41;5;36;.878;3271000;0
3866;13033;577;0;0;0;0;.00nan;0;0
3866;195646;568;100;35;1;34;.971;3600000;0
3866;185232;577;77;28;2;26;.929;3600000;0
3866;84430;568;0;0;0;0;.00nan;0;0
3867;14459;566;65;26;3;23;.885;3600000;0
3867;28453;566;0;0;0;0;.00nan;0;0
3867;143523;569;52;28;4;24;.857;3545000;0
3867;144705;569;0;0;0;0;.00nan;0;0
3868;483;570;74;25;2;23;.920;3600000;0
3868;68167;570;0;0;0;0;.00nan;0;0
3868;152478;572;82;56;6;50;.893;3284000;0
3868;153618;572;52;3;0;3;1.000;316000;0
3869;13065;564;0;0;0;0;.00nan;0;0
3869;170144;574;0;0;0;0;.00nan;0;0
3869;185220;574;85;30;1;29;.967;3600000;0
3869;141419;564;56;25;3;22;.880;3533000;0
3870;14459;566;0;0;0;0;.00nan;0;0
3870;28453;566;62;20;1;19;.950;3600000;0
3870;152478;572;79;35;2;33;.943;3600000;0
3870;153618;572;0;0;0;0;.00nan;0;0
3871;483;570;0;0;0;0;.00nan;0;0
3871;180535;576;91;40;2;38;.950;3900000;0
3871;67625;576;0;0;0;0;.00nan;0;0
3871;68167;570;62;25;2;23;.920;3900000;0
3872;14459;566;84;16;0;16;1.000;3600000;0
3872;169493;571;0;0;0;0;.00nan;0;0
3872;28453;566;0;0;0;0;.00nan;0;0
3872;86180;571;77;32;2;30;.938;3569000;0
3873;483;570;0;0;0;0;.00nan;0;0
3873;59614;562;60;37;4;33;.892;3600000;0
3873;68167;570;67;31;3;28;.903;3600000;0
3873;155943;562;0;0;0;0;.00nan;0;0
3874;13033;577;0;0;0;0;.00nan;0;0
3874;185232;577;70;30;2;28;.933;3546000;0
3874;67614;565;82;34;1;33;.971;3600000;0
3874;157189;565;0;0;0;0;.00nan;0;0
3875;170144;574;86;41;2;39;.951;3600000;0
3875;185220;574;0;0;0;0;.00nan;0;0
3875;143523;569;0;0;0;0;.00nan;0;0
3875;144705;569;41;24;4;20;.833;3517000;0
3876;13065;564;0;0;0;0;.00nan;0;0
3876;190465;578;68;33;3;30;.909;3600000;0
3876;35520;578;0;0;0;0;.00nan;0;0
3876;141419;564;95;25;0;25;1.000;3600000;0
3877;6127;575;0;0;0;0;.00nan;0;0
3877;170963;575;81;27;1;26;.963;3898000;0
3877;152478;572;94;38;2;36;.947;3898000;0
3877;153618;572;0;0;0;0;.00nan;0;0
3878;-1;573;0;0;0;0;.00nan;0;0
3878;195646;568;80;34;2;32;.941;3600000;0
3878;84430;568;0;0;0;0;.00nan;0;0
3878;85395;573;58;30;4;26;.867;3592000;0
3879;13033;577;0;0;0;0;.00nan;0;0
3879;-1;573;90;21;0;21;1.000;3600000;0
3879;185232;577;80;36;2;34;.944;3600000;0
3879;85395;573;0;0;0;0;.00nan;0;0
3880;14459;566;72;22;1;21;.955;3600000;0
3880;28453;566;0;0;0;0;.00nan;0;0
3880;152478;572;83;35;2;33;.943;3600000;0
3880;153618;572;0;0;0;0;.00nan;0;0
3881;6127;575;0;0;0;0;.00nan;0;0
3881;170963;575;77;28;1;27;.964;3600000;0
3881;59614;562;86;39;2;37;.949;3575000;0
3881;155943;562;0;0;0;0;.00nan;0;0
3882;169493;571;100;27;0;27;1.000;3600000;0
3882;180535;576;76;32;2;30;.938;3564000;0
3882;67625;576;0;0;0;0;.00nan;0;0
3882;86180;571;0;0;0;0;.00nan;0;0
3883;13065;564;0;0;0;0;.00nan;0;0
3883;67614;565;0;0;0;0;.00nan;0;0
3883;141419;564;87;32;1;31;.969;3600000;0
3883;157189;565;80;44;3;41;.932;3591000;0
3884;170144;574;75;32;3;29;.906;3726000;0
3884;185220;574;0;0;0;0;.00nan;0;0
3884;143523;569;0;0;0;0;.00nan;0;0
3884;144705;569;90;45;4;41;.911;3726000;0
3885;483;570;0;0;0;0;.00nan;0;0
3885;190465;578;52;35;4;31;.886;3566000;0
3885;35520;578;0;0;0;0;.00nan;0;0
3885;68167;570;65;22;2;20;.909;3600000;0
3886;6127;575;0;0;0;0;.00nan;0;0
3886;170963;575;64;27;3;24;.889;3900000;0
3886;180535;576;0;0;0;0;.00nan;0;0
3886;67625;576;79;41;3;38;.927;3900000;0
3887;14459;566;0;0;0;0;.00nan;0;0
3887;28453;566;65;22;2;20;.909;3600000;0
3887;59614;562;82;43;4;39;.907;3535000;0
3887;155943;562;0;0;0;0;.00nan;0;0
3888;13033;577;0;0;0;0;.00nan;0;0
3888;185232;577;89;16;0;16;1.000;3600000;0
3888;152478;572;75;33;2;31;.939;3536000;0
3888;153618;572;0;0;0;0;.00nan;0;0
3889;169493;571;49;21;3;18;.857;3570000;0
3889;190465;578;0;0;0;0;.00nan;0;0
3889;35520;578;96;32;1;31;.969;3600000;0
3889;86180;571;0;0;0;0;.00nan;0;0
3890;170144;574;78;30;2;28;.933;3590000;0
3890;195646;568;0;0;0;0;.00nan;0;0
3890;185220;574;0;0;0;0;.00nan;0;0
3890;84430;568;85;25;1;24;.960;3600000;0
3891;13065;564;0;0;0;0;.00nan;0;0
3891;141419;564;63;29;4;25;.862;3660000;0
3891;143523;569;0;0;0;0;.00nan;0;0
3891;144705;569;68;40;5;35;.875;3660000;0
3892;483;570;0;0;0;0;.00nan;0;0
3892;-1;573;47;21;3;18;.857;3557000;0
3892;68167;570;98;43;1;42;.977;3600000;0
3892;85395;573;0;0;0;0;.00nan;0;0
3893;14459;566;0;0;0;0;.00nan;0;0
3893;28453;566;44;16;3;13;.813;3563000;0
3893;67614;565;87;32;2;30;.938;3600000;0
3893;157189;565;0;0;0;0;.00nan;0;0
3894;-1;573;79;15;0;15;1.000;3600000;0
3894;180535;576;80;29;1;28;.966;3594000;0
3894;67625;576;0;0;0;0;.00nan;0;0
3894;85395;573;0;0;0;0;.00nan;0;0
3895;59614;562;100;36;1;35;.972;3900000;0
3895;143523;569;0;0;0;0;.00nan;0;0
3895;144705;569;55;14;1;13;.929;3900000;0
3895;155943;562;0;0;0;0;.00nan;0;0
3896;13033;577;0;0;0;0;.00nan;0;0
3896;169493;571;0;0;0;0;.00nan;0;0
3896;185232;577;79;27;1;26;.963;3566000;0
3896;86180;571;100;23;0;23;1.000;3600000;0
3897;190465;578;92;22;0;22;1.000;3600000;0
3897;35520;578;0;0;0;0;.00nan;0;0
3897;152478;572;47;41;6;35;.854;3081000;0
3897;153618;572;50;8;1;7;.875;519000;0
3898;13065;564;0;0;0;0;.00nan;0;0
3898;195646;568;93;49;4;45;.918;3540000;0
3898;84430;568;0;0;0;0;.00nan;0;0
3898;141419;564;62;23;2;21;.913;3600000;0
3899;483;570;0;0;0;0;.00nan;0;0
3899;6127;575;0;0;0;0;.00nan;0;0
3899;170963;575;79;27;1;26;.963;3578000;0
3899;68167;570;100;23;0;23;1.000;3600000;0
3900;13033;577;0;0;0;0;.00nan;0;0
3900;13065;564;0;0;0;0;.00nan;0;0
3900;185232;577;73;29;2;27;.931;3598000;0
3900;141419;564;76;22;1;21;.955;3600000;0
3901;-1;573;37;13;3;10;.769;3585000;0
3901;85395;573;0;0;0;0;.00nan;0;0
3901;152478;572;99;34;2;32;.941;3600000;0
3901;153618;572;0;0;0;0;.00nan;0;0
3902;6127;575;0;0;0;0;.00nan;0;0
3902;170963;575;81;27;1;26;.963;3600000;0
3902;180535;576;0;0;0;0;.00nan;0;0
3902;67625;576;96;42;2;40;.952;3544000;0
3903;14459;566;68;40;4;36;.900;3600000;0
3903;169493;571;0;0;0;0;.00nan;0;0
3903;28453;566;0;0;0;0;.00nan;0;0
3903;86180;571;23;30;7;23;.767;3600000;0
3904;195646;568;75;32;2;30;.938;3900000;0
3904;59614;562;100;42;2;40;.952;3900000;0
3904;84430;568;0;0;0;0;.00nan;0;0
3904;155943;562;0;0;0;0;.00nan;0;0
3905;483;570;0;0;0;0;.00nan;0;0
3905;67614;565;89;48;3;45;.938;3600000;0
3905;68167;570;44;21;4;17;.810;3575000;0
3905;157189;565;0;0;0;0;.00nan;0;0
3906;190465;578;72;40;3;37;.925;3517000;0
3906;35520;578;0;0;0;0;.00nan;0;0
3906;143523;569;68;12;1;11;.917;3600000;0
3906;144705;569;0;0;0;0;.00nan;0;0
3907;190465;578;0;0;0;0;.00nan;0;0
3907;35520;578;57;21;2;19;.905;3600000;0
3907;67614;565;100;30;0;30;1.000;3600000;0
3907;157189;565;0;0;0;0;.00nan;0;0
3908;13033;577;0;0;0;0;.00nan;0;0
3908;14459;566;0;0;0;0;.00nan;0;0
3908;28453;566;76;34;2;32;.941;3823000;0
3908;185232;577;60;17;1;16;.941;3823000;0
3909;-1;573;0;0;0;0;.00nan;0;0
3909;195646;568;83;39;3;36;.923;3582000;0
3909;84430;568;0;0;0;0;.00nan;0;0
3909;85395;573;83;29;1;28;.966;3600000;0
3910;483;570;0;0;0;0;.00nan;0;0
3910;180535;576;0;0;0;0;.00nan;0;0
3910;67625;576;49;39;6;33;.846;3600000;0
3910;68167;570;88;16;0;16;1.000;3600000;0
3911;13065;564;0;0;0;0;.00nan;0;0
3911;59614;562;54;33;5;28;.848;3600000;0
3911;141419;564;85;25;1;24;.960;3600000;0
3911;155943;562;0;0;0;0;.00nan;0;0
3912;6127;575;0;0;0;0;.00nan;0;0
3912;169493;571;71;30;2;28;.933;3600000;0
3912;170963;575;98;47;3;44;.936;3548000;0
3912;86180;571;0;0;0;0;.00nan;0;0
3913;143523;569;0;0;0;0;.00nan;0;0
3913;144705;569;98;16;0;16;1.000;3600000;0
3913;152478;572;97;45;2;43;.956;3516000;0
3913;153618;572;0;0;0;0;.00nan;0;0
3914;-1;573;63;25;2;23;.920;3600000;0
3914;59614;562;77;35;3;32;.914;3544000;0
3914;85395;573;0;0;0;0;.00nan;0;0
3914;155943;562;0;0;0;0;.00nan;0;0
3915;13033;577;85;36;2;34;.944;3600000;0
3915;185232;577;0;0;0;0;.00nan;0;0
3915;143523;569;0;0;0;0;.00nan;0;0
3915;144705;569;57;29;4;25;.862;3563000;0
3916;190465;578;64;16;2;14;.875;3600000;0
3916;35520;578;0;0;0;0;.00nan;0;0
3916;152478;572;59;26;3;23;.885;3579000;0
3916;153618;572;0;0;0;0;.00nan;0;0
3917;6127;575;0;0;0;0;.00nan;0;0
3917;13065;564;54;25;3;22;.880;3520000;0
3917;170963;575;100;36;1;35;.972;3600000;0
3917;141419;564;0;0;0;0;.00nan;0;0
3918;195646;568;61;12;1;11;.917;3600000;0
3918;180535;576;0;0;0;0;.00nan;0;0
3918;67625;576;70;41;4;37;.902;3600000;0
3918;84430;568;0;0;0;0;.00nan;0;0
3919;14459;566;54;40;5;35;.875;3600000;0
3919;-1;573;0;0;0;0;.00nan;0;0
3919;28453;566;0;0;0;0;.00nan;0;0
3919;85395;573;87;30;2;28;.933;3600000;0
3920;14459;566;0;0;0;0;.00nan;0;0
3920;28453;566;71;19;1;18;.947;3600000;0
3920;190465;578;54;39;5;34;.872;3600000;0
3920;35520;578;0;0;0;0;.00nan;0;0
3921;13033;577;0;0;0;0;.00nan;0;0
3921;185232;577;67;27;3;24;.889;3718000;0
3921;59614;562;54;26;4;22;.846;3718000;0
3921;155943;562;0;0;0;0;.00nan;0;0
3922;170144;574;85;15;0;15;1.000;3600000;0
3922;185220;574;0;0;0;0;.00nan;0;0
3922;152478;572;0;0;0;0;.00nan;0;0
3922;153618;572;84;50;3;47;.940;3600000;0
3923;13065;564;0;0;0;0;.00nan;0;0
3923;180535;576;0;0;0;0;.00nan;0;0
3923;67625;576;99;32;1;31;.969;3600000;0
3923;141419;564;41;22;4;18;.818;3600000;0
3924;483;570;0;0;0;0;.00nan;0;0
3924;67614;565;100;42;1;41;.976;3600000;0
3924;68167;570;66;26;2;24;.923;3560000;0
3924;157189;565;0;0;0;0;.00nan;0;0
3925;195646;568;99;42;1;41;.976;3900000;0
3925;84430;568;0;0;0;0;.00nan;0;0
3925;143523;569;0;0;0;0;.00nan;0;0
3925;144705;569;62;17;1;16;.941;3900000;0
3926;13033;577;60;19;2;17;.895;3600000;0
3926;180535;576;60;37;5;32;.865;3600000;0
3926;185232;577;0;0;0;0;.00nan;0;0
3926;67625;576;0;0;0;0;.00nan;0;0
3927;59614;562;0;0;0;0;.00nan;0;0
3927;152478;572;95;37;2;35;.946;3600000;0
3927;153618;572;0;0;0;0;.00nan;0;0
3927;155943;562;89;28;1;27;.964;3600000;0
3928;-1;573;95;36;1;35;.972;3900000;0
3928;170144;574;100;31;1;30;.968;3900000;0
3928;185220;574;0;0;0;0;.00nan;0;0
3928;85395;573;0;0;0;0;.00nan;0;0
3929;6127;575;0;0;0;0;.00nan;0;0
3929;170963;575;53;24;3;21;.875;3578000;0
3929;190465;578;0;0;0;0;.00nan;0;0
3929;35520;578;93;44;1;43;.977;3600000;0
3930;13065;564;0;0;0;0;.00nan;0;0
3930;169493;571;60;6;0;6;1.000;1159000;0
3930;86180;571;37;35;6;29;.829;2441000;0
3930;141419;564;77;30;2;28;.933;3600000;0
3931;483;570;100;44;1;43;.977;3858000;0
3931;68167;570;0;0;0;0;.00nan;0;0
3931;143523;569;51;12;2;10;.833;3858000;0
3931;144705;569;0;0;0;0;.00nan;0;0
3932;14459;566;95;30;1;29;.967;3900000;0
3932;28453;566;0;0;0;0;.00nan;0;0
3932;180535;576;0;0;0;0;.00nan;0;0
3932;67625;576;87;33;1;32;.970;3900000;0
3933;6127;575;0;0;0;0;.00nan;0;0
3933;170963;575;66;21;2;19;.905;3600000;0
3933;59614;562;68;43;5;38;.884;3600000;0
3933;155943;562;0;0;0;0;.00nan;0;0
3934;13033;577;0;0;0;0;.00nan;0;0
3934;190465;578;68;46;6;40;.870;3241000;0
3934;185232;577;51;20;4;16;.800;3600000;0
3934;35520;578;43;5;1;4;.800;359000;0
3935;169493;571;43;20;4;16;.800;3798000;0
3935;195646;568;57;23;3;20;.870;3798000;0
3935;84430;568;0;0;0;0;.00nan;0;0
3935;86180;571;0;0;0;0;.00nan;0;0
3936;483;570;0;0;0;0;.00nan;0;0
3936;170144;574;64;26;2;24;.923;3900000;0
3936;185220;574;0;0;0;0;.00nan;0;0
3936;68167;570;51;18;2;16;.889;3900000;0
3937;13065;564;0;0;0;0;.00nan;0;0
3937;141419;564;91;33;1;32;.970;3600000;0
3937;143523;569;0;0;0;0;.00nan;0;0
3937;144705;569;90;40;2;38;.950;3558000;0
3938;483;570;0;0;0;0;.00nan;0;0
3938;-1;573;66;30;4;26;.867;3665000;0
3938;68167;570;88;52;5;47;.904;3665000;0
3938;85395;573;0;0;0;0;.00nan;0;0
3939;169493;571;82;29;2;27;.931;3600000;0
3939;59614;562;83;40;3;37;.925;3569000;0
3939;86180;571;0;0;0;0;.00nan;0;0
3939;155943;562;0;0;0;0;.00nan;0;0
3940;180535;576;0;0;0;0;.00nan;0;0
3940;67625;576;85;33;2;31;.939;3571000;0
3940;152478;572;100;33;1;32;.970;3600000;0
3940;153618;572;0;0;0;0;.00nan;0;0
3941;170144;574;85;29;1;28;.966;3900000;0
3941;195646;568;100;39;1;38;.974;3900000;0
3941;185220;574;0;0;0;0;.00nan;0;0
3941;84430;568;0;0;0;0;.00nan;0;0
3942;6127;575;58;28;4;24;.857;3794000;0
3942;170963;575;0;0;0;0;.00nan;0;0
3942;67614;565;85;48;3;45;.938;3794000;0
3942;157189;565;0;0;0;0;.00nan;0;0
3943;13033;577;0;0;0;0;.00nan;0;0
3943;185232;577;62;16;2;14;.875;3600000;0
3943;152478;572;0;0;0;0;.00nan;0;0
3943;153618;572;74;46;5;41;.891;3600000;0
3944;190465;578;0;0;0;0;.00nan;0;0
3944;180535;576;85;29;2;27;.931;3900000;0
3944;35520;578;55;21;2;19;.905;3900000;0
3944;67625;576;0;0;0;0;.00nan;0;0
3945;13065;564;0;0;0;0;.00nan;0;0
3945;-1;573;0;0;0;0;.00nan;0;0
3945;85395;573;87;39;2;37;.949;3599000;0
3945;141419;564;73;21;1;20;.952;3600000;0
3946;169493;571;0;0;0;0;.00nan;0;0
3946;195646;568;0;0;0;0;.00nan;0;0
3946;84430;568;42;24;4;20;.833;3600000;0
3946;86180;571;73;30;2;28;.933;3600000;0
3947;170144;574;0;0;0;0;.00nan;0;0
3947;185220;574;89;35;2;33;.943;3600000;0
3947;67614;565;0;0;0;0;.00nan;0;0
3947;157189;565;76;38;3;35;.921;3576000;0
3948;483;570;0;0;0;0;.00nan;0;0
3948;59614;562;76;51;6;45;.882;3097000;0
3948;68167;570;78;31;2;29;.935;3600000;0
3948;155943;562;59;3;0;3;1.000;503000;0
3949;14459;566;0;0;0;0;.00nan;0;0
3949;28453;566;51;33;4;29;.879;3600000;0
3949;143523;569;0;0;0;0;.00nan;0;0
3949;144705;569;100;18;0;18;1.000;3600000;0
3950;483;570;0;0;0;0;.00nan;0;0
3950;14459;566;0;0;0;0;.00nan;0;0
3950;28453;566;100;32;0;32;1.000;3900000;0
3950;68167;570;89;28;0;28;1.000;3900000;0
3951;6127;575;0;0;0;0;.00nan;0;0
3951;-1;573;35;25;5;20;.800;3695000;0
3951;170963;575;77;49;4;45;.918;3695000;0
3951;85395;573;0;0;0;0;.00nan;0;0
3952;195646;568;36;17;4;13;.765;3545000;0
3952;180535;576;0;0;0;0;.00nan;0;0
3952;67625;576;84;39;3;36;.923;3600000;0
3952;84430;568;0;0;0;0;.00nan;0;0
3953;169493;571;100;31;0;31;1.000;3600000;0
3953;86180;571;0;0;0;0;.00nan;0;0
3953;143523;569;0;0;0;0;.00nan;0;0
3953;144705;569;57;12;1;11;.917;3544000;0
3954;67614;565;51;27;4;23;.852;3600000;0
3954;152478;572;94;32;1;31;.969;3600000;0
3954;153618;572;0;0;0;0;.00nan;0;0
3954;157189;565;0;0;0;0;.00nan;0;0
3955;13065;564;0;0;0;0;.00nan;0;0
3955;141419;564;30;23;5;18;.783;3554000;0
3955;152478;572;0;0;0;0;.00nan;0;0
3955;153618;572;90;50;4;46;.920;3600000;0
3956;6127;575;89;35;3;32;.914;3600000;0
3956;13033;577;0;0;0;0;.00nan;0;0
3956;170963;575;0;0;0;0;.00nan;0;0
3956;185232;577;95;21;0;21;1.000;3600000;0
3957;-1;573;89;18;0;18;1.000;3600000;0
3957;190465;578;20;32;7;25;.781;3328000;0
3957;35520;578;49;2;0;2;1.000;272000;0
3957;85395;573;0;0;0;0;.00nan;0;0
3958;14459;566;0;0;0;0;.00nan;0;0
3958;28453;566;91;13;0;13;1.000;3600000;0
3958;180535;576;0;0;0;0;.00nan;0;0
3958;67625;576;93;34;2;32;.941;3567000;0
3959;170144;574;59;20;2;18;.900;3900000;0
3959;185220;574;0;0;0;0;.00nan;0;0
3959;67614;565;100;48;2;46;.958;3900000;0
3959;157189;565;0;0;0;0;.00nan;0;0
3960;483;570;0;0;0;0;.00nan;0;0
3960;195646;568;66;18;1;17;.944;3600000;0
3960;68167;570;66;35;3;32;.914;3600000;0
3960;84430;568;0;0;0;0;.00nan;0;0
3961;6127;575;0;0;0;0;.00nan;0;0
3961;170963;575;91;36;2;34;.944;3556000;0
3961;143523;569;0;0;0;0;.00nan;0;0
3961;144705;569;76;24;1;23;.958;3600000;0
3962;-1;573;59;20;2;18;.900;3859000;0
3962;190465;578;0;0;0;0;.00nan;0;0
3962;35520;578;64;35;3;32;.914;3859000;0
3962;85395;573;0;0;0;0;.00nan;0;0
3963;180535;576;43;39;6;33;.846;3600000;0
3963;59614;562;66;20;2;18;.900;3600000;0
3963;67625;576;0;0;0;0;.00nan;0;0
3963;155943;562;0;0;0;0;.00nan;0;0
3964;483;570;0;0;0;0;.00nan;0;0
3964;13033;577;0;0;0;0;.00nan;0;0
3964;185232;577;70;18;1;17;.944;3600000;0
3964;68167;570;56;46;7;39;.848;3600000;0
3965;13065;564;100;27;0;27;1.000;3600000;0
3965;170144;574;0;0;0;0;.00nan;0;0
3965;185220;574;57;29;3;26;.897;3600000;0
3965;141419;564;0;0;0;0;.00nan;0;0
3966;169493;571;37;19;4;15;.789;3546000;0
3966;67614;565;0;0;0;0;.00nan;0;0
3966;86180;571;0;0;0;0;.00nan;0;0
3966;157189;565;85;30;3;27;.900;3600000;0
3967;195646;568;53;3;0;3;1.000;238000;0
3967;84430;568;31;30;6;24;.800;3362000;0
3967;152478;572;62;25;3;22;.880;3600000;0
3967;153618;572;0;0;0;0;.00nan;0;0
3968;13033;577;0;0;0;0;.00nan;0;0
3968;185232;577;48;14;2;12;.857;3600000;0
3968;67614;565;80;38;3;35;.921;3600000;0
3968;157189;565;0;0;0;0;.00nan;0;0
3969;14459;566;0;0;0;0;.00nan;0;0
3969;169493;571;0;0;0;0;.00nan;0;0
3969;28453;566;87;33;1;32;.970;3600000;0
3969;86180;571;47;24;4;20;.833;3600000;0
3970;170963;575;0;0;0;0;.00nan;0;0
3970;180535;576;0;0;0;0;.00nan;0;0
3970;59614;575;79;26;1;25;.962;3600000;0
3970;67625;576;61;20;2;18;.900;3545000;0
3971;13065;564;69;20;1;19;.950;3900000;0
3971;141419;564;0;0;0;0;.00nan;0;0
3971;152478;572;100;41;1;40;.976;3900000;0
3971;153618;572;0;0;0;0;.00nan;0;0
3972;170144;574;71;26;2;24;.923;3600000;0
3972;211908;562;0;0;0;0;.00nan;0;0
3972;185220;574;0;0;0;0;.00nan;0;0
3972;-1;562;71;41;4;37;.902;3600000;0
3973;195646;568;67;21;1;20;.952;3900000;0
3973;190465;578;91;36;1;35;.972;3900000;0
3973;35520;578;0;0;0;0;.00nan;0;0
3973;84430;568;0;0;0;0;.00nan;0;0
3974;180535;576;62;52;6;46;.885;3600000;0
3974;67625;576;0;0;0;0;.00nan;0;0
3974;143523;569;0;0;0;0;.00nan;0;0
3974;144705;569;64;18;2;16;.889;3600000;0
3975;13033;577;0;0;0;0;.00nan;0;0
3975;170144;574;0;0;0;0;.00nan;0;0
3975;185220;574;64;24;2;22;.917;3600000;0
3975;185232;577;55;25;3;22;.880;3591000;0
3976;13065;564;0;0;0;0;.00nan;0;0
3976;195646;568;65;41;5;36;.878;3600000;0
3976;84430;568;0;0;0;0;.00nan;0;0
3976;141419;564;100;23;0;23;1.000;3600000;0
3977;14459;566;50;9;1;8;.889;1207000;0
3977;170963;575;86;31;1;30;.968;3600000;0
3977;28453;566;19;21;6;15;.714;2393000;0
3977;59614;575;0;0;0;0;.00nan;0;0
3978;-1;573;68;38;4;34;.895;3578000;0
3978;169493;571;58;29;3;26;.897;3600000;0
3978;85395;573;0;0;0;0;.00nan;0;0
3978;86180;571;0;0;0;0;.00nan;0;0
3979;211908;562;0;0;0;0;.00nan;0;0
3979;-1;562;84;36;2;34;.944;3600000;0
3979;67614;565;60;36;4;32;.889;3513000;0
3979;157189;565;0;0;0;0;.00nan;0;0
3980;483;570;0;0;0;0;.00nan;0;0
3980;68167;570;51;20;3;17;.850;3600000;0
3980;152478;572;59;30;4;26;.867;3243000;0
3980;153618;572;56;5;0;5;1.000;314000;0
3981;180535;576;0;0;0;0;.00nan;0;0
3981;67614;565;0;0;0;0;.00nan;0;0
3981;67625;576;81;33;2;31;.939;3900000;0
3981;157189;565;58;22;2;20;.909;3900000;0
3982;14459;566;43;18;4;14;.778;1139000;0
3982;170963;575;0;0;0;0;.00nan;0;0
3982;28453;566;38;9;2;7;.778;2461000;0
3982;59614;575;91;31;1;30;.968;3600000;0
3983;483;570;0;0;0;0;.00nan;0;0
3983;211908;562;83;35;2;33;.943;3600000;0
3983;-1;562;0;0;0;0;.00nan;0;0
3983;68167;570;56;27;4;23;.852;3534000;0
3984;13033;577;79;29;2;27;.931;3600000;0
3984;170144;574;38;25;5;20;.800;3600000;0
3984;185220;574;0;0;0;0;.00nan;0;0
3984;185232;577;0;0;0;0;.00nan;0;0
3985;190465;578;73;62;6;56;.903;3600000;0
3985;35520;578;0;0;0;0;.00nan;0;0
3985;143523;569;0;0;0;0;.00nan;0;0
3985;144705;569;48;6;1;5;.833;3600000;0
3986;13065;564;0;0;0;0;.00nan;0;0
3986;195646;568;75;19;1;18;.947;3163000;0
3986;84430;568;32;8;3;5;.625;437000;0
3986;141419;564;97;31;1;30;.968;3600000;0
3987;169493;571;0;0;0;0;.00nan;0;0
3987;86180;571;81;19;1;18;.947;3600000;0
3987;152478;572;45;5;1;4;.800;611000;0
3987;153618;572;34;30;6;24;.800;2989000;0
3988;13033;577;0;0;0;0;.00nan;0;0
3988;14459;566;61;32;3;29;.906;3600000;0
3988;28453;566;0;0;0;0;.00nan;0;0
3988;185232;577;63;30;2;28;.933;3600000;0
3989;-1;573;98;25;0;25;1.000;3600000;0
3989;211908;562;0;0;0;0;.00nan;0;0
3989;-1;562;98;43;2;41;.953;3525000;0
3989;85395;573;0;0;0;0;.00nan;0;0
3990;170963;575;61;15;1;14;.933;3600000;0
3990;190465;578;0;0;0;0;.00nan;0;0
3990;35520;578;75;38;3;35;.921;3574000;0
3990;59614;575;0;0;0;0;.00nan;0;0
3991;169493;571;100;20;0;20;1.000;3600000;0
3991;195646;568;53;34;4;30;.882;3600000;0
3991;84430;568;0;0;0;0;.00nan;0;0
3991;86180;571;0;0;0;0;.00nan;0;0
3992;170144;574;17;6;4;2;.333;784000;0
3992;185220;574;43;9;2;7;.778;2816000;0
3992;152478;572;86;39;2;37;.949;3600000;0
3992;153618;572;0;0;0;0;.00nan;0;0
3993;13065;564;0;0;0;0;.00nan;0;0
3993;211908;562;38;38;6;32;.842;3284000;0
3993;-1;562;50;7;1;6;.857;316000;0
3993;141419;564;65;17;1;16;.941;3600000;0
3994;67614;565;91;44;2;42;.955;3900000;0
3994;143523;569;0;0;0;0;.00nan;0;0
3994;144705;569;63;22;2;20;.909;3900000;0
3994;157189;565;0;0;0;0;.00nan;0;0
3995;13033;577;0;0;0;0;.00nan;0;0
3995;-1;573;36;20;4;16;.800;2029000;0
3995;185232;577;55;28;4;24;.857;3600000;0
3995;85395;573;69;19;1;18;.947;1535000;0
3996;13065;564;67;27;3;24;.889;3593000;0
3996;169493;571;0;0;0;0;.00nan;0;0
3996;86180;571;89;27;1;26;.963;3600000;0
3996;141419;564;0;0;0;0;.00nan;0;0
3997;483;570;0;0;0;0;.00nan;0;0
3997;68167;570;93;39;2;37;.949;3900000;0
3997;143523;569;72;26;2;24;.923;3900000;0
3997;144705;569;0;0;0;0;.00nan;0;0
3998;14459;566;88;16;0;16;1.000;3600000;0
3998;28453;566;0;0;0;0;.00nan;0;0
3998;67614;565;67;39;4;35;.897;3600000;0
3998;157189;565;0;0;0;0;.00nan;0;0
3999;211908;562;0;0;0;0;.00nan;0;0
3999;190465;578;0;0;0;0;.00nan;0;0
3999;35520;578;52;37;5;32;.865;3564000;0
3999;-1;562;59;21;3;18;.857;3600000;0
4000;170144;574;87;35;2;33;.943;3900000;0
4000;195646;568;96;53;2;51;.962;3900000;0
4000;185220;574;0;0;0;0;.00nan;0;0
4000;84430;568;0;0;0;0;.00nan;0;0
4001;-1;573;53;19;3;16;.842;3544000;0
4001;67614;565;0;0;0;0;.00nan;0;0
4001;85395;573;0;0;0;0;.00nan;0;0
4001;157189;565;95;44;2;42;.955;3600000;0
4002;143523;569;0;0;0;0;.00nan;0;0
4002;144705;569;75;10;0;10;1.000;3600000;0
4002;152478;572;80;43;3;40;.930;3600000;0
4002;153618;572;0;0;0;0;.00nan;0;0
4003;170144;574;0;0;0;0;.00nan;0;0
4003;180535;576;0;0;0;0;.00nan;0;0
4003;185220;574;65;25;2;23;.920;3600000;0
4003;67625;576;70;32;3;29;.906;3569000;0
4004;211908;562;0;0;0;0;.00nan;0;0
4004;190465;578;73;35;3;32;.914;3720000;0
4004;35520;578;0;0;0;0;.00nan;0;0
4004;-1;562;59;32;4;28;.875;3720000;0
4005;13033;577;0;0;0;0;.00nan;0;0
4005;13065;564;0;0;0;0;.00nan;0;0
4005;185232;577;81;35;2;33;.943;3600000;0
4005;141419;564;56;27;3;24;.889;3567000;0
4006;170963;575;86;30;1;29;.967;3600000;0
4006;195646;568;0;0;0;0;.00nan;0;0
4006;59614;575;0;0;0;0;.00nan;0;0
4006;84430;568;53;16;2;14;.875;3554000;0
4007;483;570;0;0;0;0;.00nan;0;0
4007;169493;571;60;39;5;34;.872;3600000;0
4007;68167;570;98;20;0;20;1.000;3600000;0
4007;86180;571;0;0;0;0;.00nan;0;0
4008;-1;573;59;33;4;29;.879;3600000;0
4008;85395;573;0;0;0;0;.00nan;0;0
4008;143523;569;0;0;0;0;.00nan;0;0
4008;144705;569;69;20;1;19;.950;3600000;0
4009;180535;576;90;22;1;21;.955;3874000;0
4009;67625;576;0;0;0;0;.00nan;0;0
4009;152478;572;92;47;2;45;.957;3874000;0
4009;153618;572;0;0;0;0;.00nan;0;0
4010;13033;577;0;0;0;0;.00nan;0;0
4010;185232;577;63;16;1;15;.938;3600000;0
4010;67614;565;66;51;6;45;.882;2556000;0
4010;157189;565;63;15;1;14;.933;1044000;0
4011;14459;566;65;24;3;21;.875;3600000;0
4011;28453;566;0;0;0;0;.00nan;0;0
4011;190465;578;75;25;2;23;.920;3600000;0
4011;35520;578;0;0;0;0;.00nan;0;0
4012;13065;564;0;0;0;0;.00nan;0;0
4012;170963;575;0;0;0;0;.00nan;0;0
4012;59614;575;84;38;2;36;.947;3543000;0
4012;141419;564;66;19;1;18;.947;3600000;0
4013;169493;571;0;0;0;0;.00nan;0;0
4013;170144;574;46;21;3;18;.857;3513000;0
4013;185220;574;0;0;0;0;.00nan;0;0
4013;86180;571;85;27;1;26;.963;3600000;0
4014;483;570;75;34;3;31;.912;3555000;0
4014;206148;570;0;0;0;0;.00nan;0;0
4014;195646;568;71;26;2;24;.923;3600000;0
4014;84430;568;0;0;0;0;.00nan;0;0
4015;-1;573;57;27;3;24;.889;3600000;0
4015;180535;576;0;0;0;0;.00nan;0;0
4015;67625;576;42;33;5;28;.848;3587000;0
4015;85395;573;0;0;0;0;.00nan;0;0
4016;190465;578;91;29;1;28;.966;3600000;0
4016;35520;578;0;0;0;0;.00nan;0;0
4016;152478;572;71;28;3;25;.893;3543000;0
4016;153618;572;0;0;0;0;.00nan;0;0
4017;14459;566;0;0;0;0;.00nan;0;0
4017;170144;574;100;33;0;33;1.000;3600000;0
4017;28453;566;63;43;5;38;.884;3600000;0
4017;185220;574;0;0;0;0;.00nan;0;0
4018;483;570;82;44;3;41;.932;3600000;0
4018;13065;564;56;28;4;24;.857;3568000;0
4018;206148;570;0;0;0;0;.00nan;0;0
4018;141419;564;0;0;0;0;.00nan;0;0
4019;169493;571;95;38;1;37;.974;3900000;0
4019;211908;562;0;0;0;0;.00nan;0;0
4019;-1;562;90;32;1;31;.969;3900000;0
4019;86180;571;0;0;0;0;.00nan;0;0
4020;195646;568;70;19;1;18;.947;3600000;0
4020;67614;565;72;41;4;37;.902;3600000;0
4020;84430;568;0;0;0;0;.00nan;0;0
4020;157189;565;0;0;0;0;.00nan;0;0
4021;13033;577;0;0;0;0;.00nan;0;0
4021;185232;577;90;47;3;44;.936;3600000;0
4021;143523;569;0;0;0;0;.00nan;0;0
4021;144705;569;94;21;0;21;1.000;3600000;0
4022;14459;566;52;29;4;25;.862;3574000;0
4022;195646;568;76;27;2;25;.926;3600000;0
4022;28453;566;0;0;0;0;.00nan;0;0
4022;84430;568;0;0;0;0;.00nan;0;0
4023;13033;577;0;0;0;0;.00nan;0;0
4023;211908;562;0;0;0;0;.00nan;0;0
4023;185232;577;61;30;3;27;.900;3600000;0
4023;-1;562;56;37;4;33;.892;3553000;0
4024;170963;575;46;18;3;15;.833;3600000;0
4024;59614;575;0;0;0;0;.00nan;0;0
4024;152478;572;52;29;4;25;.862;3547000;0
4024;153618;572;0;0;0;0;.00nan;0;0
4025;211908;562;0;0;0;0;.00nan;0;0
4025;180535;576;64;25;2;23;.920;3600000;0
4025;-1;562;55;40;5;35;.875;3600000;0
4025;67625;576;0;0;0;0;.00nan;0;0
4026;170144;574;97;24;0;24;1.000;3600000;0
4026;170963;575;0;0;0;0;.00nan;0;0
4026;185220;574;0;0;0;0;.00nan;0;0
4026;59614;575;63;30;4;26;.867;3600000;0
4027;195646;568;0;0;0;0;.00nan;0;0
4027;67614;565;95;44;0;44;1.000;3900000;0
4027;84430;568;89;17;0;17;1.000;3900000;0
4027;157189;565;0;0;0;0;.00nan;0;0
4028;483;570;0;0;0;0;.00nan;0;0
4028;13033;577;0;0;0;0;.00nan;0;0
4028;185232;577;65;18;1;17;.944;3600000;0
4028;68167;570;81;32;2;30;.938;3547000;0
4029;14459;566;0;0;0;0;.00nan;0;0
4029;-1;573;77;32;2;30;.938;3575000;0
4029;28453;566;96;32;1;31;.969;3600000;0
4029;85395;573;0;0;0;0;.00nan;0;0
4030;141419;564;0;0;0;0;.00nan;0;0
4030;141496;564;92;34;1;33;.971;3600000;0
4030;143523;569;0;0;0;0;.00nan;0;0
4030;144705;569;71;26;2;24;.923;3600000;0
4031;13033;577;0;0;0;0;.00nan;0;0
4031;180535;576;0;0;0;0;.00nan;0;0
4031;185232;577;47;26;4;22;.846;3600000;0
4031;67625;576;70;27;2;25;.926;3600000;0
4032;67614;565;67;18;1;17;.944;3600000;0
4032;152478;572;52;7;1;6;.857;1200000;0
4032;153618;572;40;25;5;20;.800;2400000;0
4032;157189;565;0;0;0;0;.00nan;0;0
4033;170144;574;56;16;2;14;.875;3600000;0
4033;190465;578;66;45;5;40;.889;3600000;0
4033;185220;574;0;0;0;0;.00nan;0;0
4033;35520;578;0;0;0;0;.00nan;0;0
4034;483;570;0;0;0;0;.00nan;0;0
4034;169493;571;0;0;0;0;.00nan;0;0
4034;68167;570;85;28;1;27;.964;3586000;0
4034;86180;571;100;32;0;32;1.000;3600000;0
4035;-1;573;71;31;3;28;.903;3558000;0
4035;85395;573;0;0;0;0;.00nan;0;0
4035;141419;564;0;0;0;0;.00nan;0;0
4035;141496;564;75;29;2;27;.931;3600000;0
4036;170144;574;0;0;0;0;.00nan;0;0
4036;190465;578;0;0;0;0;.00nan;0;0
4036;185220;574;40;15;3;12;.800;3514000;0
4036;35520;578;100;36;1;35;.972;3600000;0
4037;14459;566;52;24;3;21;.875;3565000;0
4037;170963;575;62;17;2;15;.882;3600000;0
4037;28453;566;0;0;0;0;.00nan;0;0
4037;59614;575;0;0;0;0;.00nan;0;0
4038;195646;568;93;20;0;20;1.000;3600000;0
4038;84430;568;0;0;0;0;.00nan;0;0
4038;152478;572;68;41;4;37;.902;3600000;0
4038;153618;572;0;0;0;0;.00nan;0;0
4039;180535;576;50;31;4;27;.871;3568000;0
4039;67614;565;0;0;0;0;.00nan;0;0
4039;67625;576;0;0;0;0;.00nan;0;0
4039;157189;565;67;35;3;32;.914;3600000;0
4040;169493;571;0;0;0;0;.00nan;0;0
4040;86180;571;79;44;4;40;.909;3600000;0
4040;143523;569;0;0;0;0;.00nan;0;0
4040;144705;569;69;23;2;21;.913;3600000;0
4041;483;570;0;0;0;0;.00nan;0;0
4041;211908;562;0;0;0;0;.00nan;0;0
4041;-1;562;74;42;5;37;.881;3555000;0
4041;68167;570;66;32;3;29;.906;3600000;0
4042;170144;574;59;18;2;16;.889;3549000;0
4042;185220;574;0;0;0;0;.00nan;0;0
4042;152478;572;100;53;1;52;.981;3600000;0
4042;153618;572;0;0;0;0;.00nan;0;0
4043;-1;573;63;16;1;15;.938;3600000;0
4043;190465;578;95;47;2;45;.957;3600000;0
4043;35520;578;0;0;0;0;.00nan;0;0
4043;85395;573;0;0;0;0;.00nan;0;0
4044;13033;577;0;0;0;0;.00nan;0;0
4044;169493;571;90;46;2;44;.957;3550000;0
4044;185232;577;98;22;0;22;1.000;3600000;0
4044;86180;571;0;0;0;0;.00nan;0;0
4045;195646;568;93;44;1;43;.977;3600000;0
4045;84430;568;0;0;0;0;.00nan;0;0
4045;143523;569;0;0;0;0;.00nan;0;0
4045;144705;569;49;13;2;11;.846;3543000;0
4046;483;570;0;0;0;0;.00nan;0;0
4046;68167;570;96;39;2;37;.949;3600000;0
4046;141419;564;0;0;0;0;.00nan;0;0
4046;141496;564;50;28;4;24;.857;3536000;0
4047;14459;566;0;0;0;0;.00nan;0;0
4047;170144;574;0;0;0;0;.00nan;0;0
4047;28453;566;99;31;1;30;.968;3600000;0
4047;185220;574;57;24;3;21;.875;3528000;0
4048;180535;576;0;0;0;0;.00nan;0;0
4048;67625;576;93;41;2;39;.951;3600000;0
4048;141419;564;0;0;0;0;.00nan;0;0
4048;141496;564;70;19;1;18;.947;3600000;0
4049;195646;568;50;18;3;15;.833;3900000;0
4049;211908;562;88;43;3;40;.930;3900000;0
4049;-1;562;0;0;0;0;.00nan;0;0
4049;84430;568;0;0;0;0;.00nan;0;0
4050;13033;577;0;0;0;0;.00nan;0;0
4050;170963;575;0;0;0;0;.00nan;0;0
4050;185232;577;70;24;2;22;.917;3600000;0
4050;59614;575;70;47;5;42;.894;3600000;0
4051;169493;571;0;0;0;0;.00nan;0;0
4051;190465;578;59;29;3;26;.897;3600000;0
4051;35520;578;0;0;0;0;.00nan;0;0
4051;86180;571;76;33;2;31;.939;3600000;0
4052;143523;569;0;0;0;0;.00nan;0;0
4052;144705;569;70;8;0;8;1.000;3600000;0
4052;152478;572;98;46;2;44;.957;3520000;0
4052;153618;572;0;0;0;0;.00nan;0;0
4053;483;570;0;0;0;0;.00nan;0;0
4053;67614;565;93;38;2;36;.947;3600000;0
4053;68167;570;49;33;5;28;.848;3600000;0
4053;157189;565;0;0;0;0;.00nan;0;0
4054;-1;573;0;0;0;0;.00nan;0;0
4054;169493;571;66;30;3;27;.900;3600000;0
4054;85395;573;79;29;1;28;.966;3600000;0
4054;86180;571;0;0;0;0;.00nan;0;0
4055;483;570;0;0;0;0;.00nan;0;0
4055;170144;574;64;31;3;28;.903;3545000;0
4055;185220;574;0;0;0;0;.00nan;0;0
4055;68167;570;56;20;2;18;.900;3600000;0
4056;190465;578;0;0;0;0;.00nan;0;0
4056;35520;578;82;29;1;28;.966;3900000;0
4056;141419;564;83;27;1;26;.963;3900000;0
4056;141496;564;0;0;0;0;.00nan;0;0
4057;170963;575;88;40;3;37;.925;3575000;0
4057;195646;568;0;0;0;0;.00nan;0;0
4057;59614;575;0;0;0;0;.00nan;0;0
4057;84430;568;96;24;1;23;.958;3600000;0
4058;14459;566;78;26;1;25;.962;3600000;0
4058;28453;566;0;0;0;0;.00nan;0;0
4058;67614;565;0;0;0;0;.00nan;0;0
4058;157189;565;80;44;4;40;.909;3600000;0
4059;13033;577;0;0;0;0;.00nan;0;0
4059;185232;577;63;16;2;14;.875;3600000;0
4059;152478;572;62;48;7;41;.854;2928000;0
4059;153618;572;40;7;2;5;.714;672000;0
4060;14459;566;0;0;0;0;.00nan;0;0
4060;28453;566;48;32;4;28;.875;3543000;0
4060;143523;569;0;0;0;0;.00nan;0;0
4060;144705;569;48;16;2;14;.875;3600000;0
4061;14459;566;53;27;3;24;.889;3900000;0
4061;28453;566;0;0;0;0;.00nan;0;0
4061;211908;562;0;0;0;0;.00nan;0;0
4061;-1;562;85;41;3;38;.927;3900000;0
4062;169493;571;29;20;5;15;.750;3900000;0
4062;180535;576;44;39;5;34;.872;3900000;0
4062;67625;576;0;0;0;0;.00nan;0;0
4062;86180;571;0;0;0;0;.00nan;0;0
4063;170144;574;89;43;3;40;.930;3547000;0
4063;185220;574;0;0;0;0;.00nan;0;0
4063;143523;569;0;0;0;0;.00nan;0;0
4063;144705;569;47;12;2;10;.833;3600000;0
4064;195646;568;74;21;1;20;.952;3600000;0
4064;190465;578;37;32;6;26;.813;3600000;0
4064;35520;578;0;0;0;0;.00nan;0;0
4064;84430;568;0;0;0;0;.00nan;0;0
4065;67614;565;69;53;6;47;.887;3305000;0
4065;141419;564;0;0;0;0;.00nan;0;0
4065;141496;564;93;23;0;23;1.000;3600000;0
4065;157189;565;46;5;1;4;.800;295000;0
4066;-1;573;65;26;3;23;.885;3600000;0
4066;170963;575;37;38;6;32;.842;3600000;0
4066;59614;575;0;0;0;0;.00nan;0;0
4066;85395;573;0;0;0;0;.00nan;0;0
4067;169493;571;0;0;0;0;.00nan;0;0
4067;67614;565;82;27;1;26;.963;3600000;0
4067;86180;571;64;28;2;26;.929;3545000;0
4067;157189;565;0;0;0;0;.00nan;0;0
4068;190465;578;78;31;2;29;.935;3600000;0
4068;180535;576;35;22;4;18;.818;3534000;0
4068;35520;578;0;0;0;0;.00nan;0;0
4068;67625;576;0;0;0;0;.00nan;0;0
4069;211908;562;0;0;0;0;.00nan;0;0
4069;-1;562;45;36;5;31;.861;3600000;0
4069;152478;572;100;34;0;34;1.000;3600000;0
4069;153618;572;0;0;0;0;.00nan;0;0
4070;170144;574;72;27;2;25;.926;3900000;0
4070;170963;575;0;0;0;0;.00nan;0;0
4070;185220;574;0;0;0;0;.00nan;0;0
4070;59614;575;79;32;2;30;.938;3900000;0
4071;13033;577;0;0;0;0;.00nan;0;0
4071;195646;568;95;23;0;23;1.000;3600000;0
4071;185232;577;63;23;2;21;.913;3600000;0
4071;84430;568;0;0;0;0;.00nan;0;0
4072;483;570;0;0;0;0;.00nan;0;0
4072;-1;573;100;28;0;28;1.000;3600000;0
4072;68167;570;72;29;3;26;.897;3600000;0
4072;85395;573;0;0;0;0;.00nan;0;0
4073;67614;565;91;54;4;50;.926;3600000;0
4073;143523;569;0;0;0;0;.00nan;0;0
4073;144705;569;76;12;0;12;1.000;3600000;0
4073;157189;565;0;0;0;0;.00nan;0;0
4074;-1;573;58;19;2;17;.895;3600000;0
4074;85395;573;0;0;0;0;.00nan;0;0
4074;152478;572;89;52;4;48;.923;3600000;0
4074;153618;572;0;0;0;0;.00nan;0;0
4075;170144;574;59;37;4;33;.892;3600000;0
4075;211908;562;53;41;5;36;.878;3600000;0
4075;185220;574;0;0;0;0;.00nan;0;0
4075;-1;562;0;0;0;0;.00nan;0;0
4076;13033;577;75;26;1;25;.962;3600000;0
4076;195646;568;50;42;6;36;.857;3219000;0
4076;185232;577;0;0;0;0;.00nan;0;0
4076;84430;568;53;3;0;3;1.000;381000;0
4077;190465;578;0;0;0;0;.00nan;0;0
4077;180535;576;0;0;0;0;.00nan;0;0
4077;35520;578;79;39;3;36;.923;3581000;0
4077;67625;576;68;29;2;27;.931;3600000;0
4078;14459;566;0;0;0;0;.00nan;0;0
4078;28453;566;60;14;1;13;.929;3600000;0
4078;141419;564;0;0;0;0;.00nan;0;0
4078;141496;564;50;18;2;16;.889;3556000;0
4079;169493;571;0;0;0;0;.00nan;0;0
4079;170963;575;73;31;2;29;.935;3900000;0
4079;59614;575;0;0;0;0;.00nan;0;0
4079;86180;571;95;34;2;32;.941;3900000;0
4080;483;570;0;0;0;0;.00nan;0;0
4080;68167;570;61;24;3;21;.875;3586000;0
4080;152478;572;99;46;2;44;.957;3600000;0
4080;153618;572;0;0;0;0;.00nan;0;0
4081;14459;566;64;20;2;18;.900;3600000;0
4081;195646;568;82;39;3;36;.923;3588000;0
4081;28453;566;0;0;0;0;.00nan;0;0
4081;84430;568;0;0;0;0;.00nan;0;0
4082;170963;575;0;0;0;0;.00nan;0;0
4082;59614;575;76;25;2;23;.920;3600000;0
4082;67614;565;26;6;3;3;.500;438000;0
4082;157189;565;57;28;3;25;.893;3162000;0
4083;-1;573;82;24;1;23;.958;3600000;0
4083;180535;576;83;26;2;24;.923;3565000;0
4083;67625;576;0;0;0;0;.00nan;0;0
4083;85395;573;0;0;0;0;.00nan;0;0
4084;13033;577;0;0;0;0;.00nan;0;0
4084;14459;566;0;0;0;0;.00nan;0;0
4084;28453;566;45;34;5;29;.853;3600000;0
4084;185232;577;63;22;2;20;.909;3600000;0
4085;170144;574;49;23;3;20;.870;3547000;0
4085;185220;574;0;0;0;0;.00nan;0;0
4085;141419;564;0;0;0;0;.00nan;0;0
4085;141496;564;96;34;2;32;.941;3600000;0
4086;190465;578;87;45;3;42;.933;3600000;0
4086;35520;578;0;0;0;0;.00nan;0;0
4086;141419;564;20;18;5;13;.722;3522000;0
4086;141496;564;0;0;0;0;.00nan;0;0
4087;483;570;0;0;0;0;.00nan;0;0
4087;170963;575;50;2;0;2;1.000;302000;0
4087;59614;575;28;31;6;25;.806;3298000;0
4087;68167;570;79;32;2;30;.938;3600000;0
4088;-1;573;100;37;2;35;.946;3900000;0
4088;170144;574;86;32;2;30;.938;3900000;0
4088;185220;574;0;0;0;0;.00nan;0;0
4088;85395;573;0;0;0;0;.00nan;0;0
4089;180535;576;88;41;2;39;.951;3598000;0
4089;67625;576;0;0;0;0;.00nan;0;0
4089;143523;569;0;0;0;0;.00nan;0;0
4089;144705;569;86;19;0;19;1.000;3600000;0
4090;211908;562;0;0;0;0;.00nan;0;0
4090;-1;562;81;36;3;33;.917;3600000;0
4090;67614;565;66;44;5;39;.886;3535000;0
4090;157189;565;0;0;0;0;.00nan;0;0
4091;169493;571;67;28;3;25;.893;3900000;0
4091;86180;571;0;0;0;0;.00nan;0;0
4091;152478;572;92;48;3;45;.938;3900000;0
4091;153618;572;0;0;0;0;.00nan;0;0
4092;190465;578;65;29;3;26;.897;3600000;0
4092;35520;578;0;0;0;0;.00nan;0;0
4092;67614;565;0;0;0;0;.00nan;0;0
4092;157189;565;25;22;5;17;.773;3535000;0
4093;14459;566;0;0;0;0;.00nan;0;0
4093;28453;566;94;32;1;31;.969;3551000;0
4093;152478;572;92;22;0;22;1.000;3600000;0
4093;153618;572;0;0;0;0;.00nan;0;0
4094;13033;577;0;0;0;0;.00nan;0;0
4094;170144;574;58;10;0;10;1.000;1201000;0
4094;185220;574;44;26;4;22;.846;2394000;0
4094;185232;577;69;30;3;27;.900;3600000;0
4095;169493;571;0;0;0;0;.00nan;0;0
4095;86180;571;70;38;4;34;.895;3857000;0
4095;141419;564;0;0;0;0;.00nan;0;0
4095;141496;564;66;30;3;27;.900;3857000;0
4096;170963;575;63;38;4;34;.895;3600000;0
4096;59614;575;0;0;0;0;.00nan;0;0
4096;143523;569;0;0;0;0;.00nan;0;0
4096;144705;569;49;17;3;14;.824;3600000;0
4097;-1;573;44;16;3;13;.813;3568000;0
4097;195646;568;99;44;1;43;.977;3600000;0
4097;84430;568;0;0;0;0;.00nan;0;0
4097;85395;573;0;0;0;0;.00nan;0;0
4098;483;570;0;0;0;0;.00nan;0;0
4098;180535;576;0;0;0;0;.00nan;0;0
4098;67625;576;67;38;3;35;.921;3594000;0
4098;68167;570;91;29;1;28;.966;3600000;0
4099;170144;574;73;28;2;26;.929;3600000;0
4099;180535;576;32;36;7;29;.806;3600000;0
4099;185220;574;0;0;0;0;.00nan;0;0
4099;67625;576;0;0;0;0;.00nan;0;0
4100;13033;577;0;0;0;0;.00nan;0;0
4100;190465;578;38;37;6;31;.838;3600000;0
4100;185232;577;90;27;1;26;.963;3600000;0
4100;35520;578;0;0;0;0;.00nan;0;0
4101;170963;575;91;22;0;22;1.000;3600000;0
4101;59614;575;0;0;0;0;.00nan;0;0
4101;152478;572;98;34;1;33;.971;3549000;0
4101;153618;572;0;0;0;0;.00nan;0;0
4102;169493;571;92;22;0;22;1.000;3900000;0
4102;195646;568;95;34;0;34;1.000;3900000;0
4102;84430;568;0;0;0;0;.00nan;0;0
4102;86180;571;0;0;0;0;.00nan;0;0
4103;-1;573;53;17;2;15;.882;3600000;0
4103;67614;565;59;36;5;31;.861;3586000;0
4103;85395;573;0;0;0;0;.00nan;0;0
4103;157189;565;0;0;0;0;.00nan;0;0
4104;211908;562;0;0;0;0;.00nan;0;0
4104;-1;562;90;34;2;32;.941;3600000;0
4104;143523;569;0;0;0;0;.00nan;0;0
4104;144705;569;88;29;1;28;.966;3600000;0
4105;483;570;0;0;0;0;.00nan;0;0
4105;14459;566;76;27;2;25;.926;3600000;0
4105;28453;566;0;0;0;0;.00nan;0;0
4105;68167;570;74;24;1;23;.958;3600000;0
4109;13033;577;0;0;0;0;.00nan;0;0
4109;190465;578;85;39;2;37;.949;3600000;0
4109;185232;577;78;39;3;36;.923;3546000;0
4109;35520;578;0;0;0;0;.00nan;0;0
4111;-1;573;85;24;1;23;.958;3600000;0
4111;67626;573;0;0;0;0;.00nan;0;0
4111;152478;572;93;56;4;52;.929;3600000;0
4111;153618;572;0;0;0;0;.00nan;0;0
4117;14459;566;55;16;2;14;.875;3600000;0
4117;28453;566;0;0;0;0;.00nan;0;0
4117;143523;569;51;22;3;19;.864;3565000;0
4117;144705;569;0;0;0;0;.00nan;0;0
4119;6127;575;100;39;1;38;.974;3600000;0
4119;14191;575;0;0;0;0;.00nan;0;0
4119;59614;562;53;32;4;28;.875;3600000;0
4119;155943;562;0;0;0;0;.00nan;0;0
4121;-1;573;80;28;1;27;.964;3900000;0
4121;190465;578;94;36;1;35;.972;3900000;0
4121;35520;578;0;0;0;0;.00nan;0;0
4121;67626;573;0;0;0;0;.00nan;0;0
4123;143523;569;87;16;0;16;1.000;3600000;0
4123;144705;569;0;0;0;0;.00nan;0;0
4123;152478;572;84;51;4;47;.922;3600000;0
4123;153618;572;0;0;0;0;.00nan;0;0
4125;180535;576;0;0;0;0;.00nan;0;0
4125;59614;562;100;25;0;25;1.000;3600000;0
4125;67625;576;73;28;2;26;.929;3528000;0
4125;155943;562;0;0;0;0;.00nan;0;0
4131;169493;571;0;0;0;0;.00nan;0;0
4131;67614;565;74;48;5;43;.896;3600000;0
4131;86180;571;64;23;2;21;.913;3600000;0
4131;157189;565;0;0;0;0;.00nan;0;0
4137;180535;576;100;43;0;43;1.000;3600000;0
4137;67625;576;0;0;0;0;.00nan;0;0
4137;143523;569;78;27;1;26;.963;3600000;0
4137;144705;569;0;0;0;0;.00nan;0;0
4139;6127;575;65;27;2;25;.926;3600000;0
4139;14191;575;0;0;0;0;.00nan;0;0
4139;190465;578;0;0;0;0;.00nan;0;0
4139;35520;578;40;34;6;28;.824;3600000;0
4141;-1;573;0;0;0;0;.00nan;0;0
4141;67626;573;61;16;2;14;.875;3600000;0
4141;152478;572;0;0;0;0;.00nan;0;0
4141;153618;572;84;40;3;37;.925;3587000;0
4147;14459;566;0;0;0;0;.00nan;0;0
4147;169493;571;91;52;2;50;.962;3900000;0
4147;28453;566;66;20;2;18;.900;3889000;0
4147;86180;571;0;0;0;0;.00nan;0;0
4149;67614;565;73;21;1;20;.952;3546000;0
4149;152478;572;90;19;0;19;1.000;3600000;0
4149;153618;572;0;0;0;0;.00nan;0;0
4149;157189;565;0;0;0;0;.00nan;0;0
4151;14459;566;0;0;0;0;.00nan;0;0
4151;169493;571;96;48;3;45;.938;3600000;0
4151;28453;566;46;29;4;25;.862;3546000;0
4151;86180;571;0;0;0;0;.00nan;0;0
4153;-1;573;58;21;2;19;.905;3600000;0
4153;190465;578;80;43;3;40;.930;3545000;0
4153;35520;578;0;0;0;0;.00nan;0;0
4153;67626;573;0;0;0;0;.00nan;0;0
4155;170144;574;55;27;3;24;.889;3549000;0
4155;180535;576;93;40;2;38;.950;3600000;0
4155;185220;574;0;0;0;0;.00nan;0;0
4155;67625;576;0;0;0;0;.00nan;0;0
4157;6127;575;91;25;1;24;.960;3600000;0
4157;14191;575;0;0;0;0;.00nan;0;0
4157;143523;569;0;0;0;0;.00nan;0;0
4157;144705;569;51;23;4;19;.826;3600000;0
4159;483;570;0;0;0;0;.00nan;0;0
4159;59614;562;52;52;6;46;.885;3600000;0
4159;68167;570;63;22;2;20;.909;3600000;0
4159;155943;562;0;0;0;0;.00nan;0;0
4161;13033;577;0;0;0;0;.00nan;0;0
4161;13065;564;0;0;0;0;.00nan;0;0
4161;185232;577;90;42;2;40;.952;3600000;0
4161;141419;564;44;26;4;22;.846;3554000;0
4163;6127;575;0;0;0;0;.00nan;0;0
4163;14191;575;80;43;4;39;.907;3600000;0
4163;143523;569;72;18;1;17;.944;3600000;0
4163;144705;569;0;0;0;0;.00nan;0;0
4169;13033;577;83;29;1;28;.966;3600000;0
4169;185232;577;0;0;0;0;.00nan;0;0
4169;59614;562;50;4;1;3;.750;482000;0
4169;155943;562;33;29;6;23;.793;3118000;0
4171;-1;573;0;0;0;0;.00nan;0;0
4171;180535;576;0;0;0;0;.00nan;0;0
4171;67625;576;68;43;4;39;.907;3578000;0
4171;67626;573;61;22;3;19;.864;3600000;0
4175;14459;566;82;13;0;13;1.000;3600000;0
4175;169493;571;0;0;0;0;.00nan;0;0
4175;28453;566;0;0;0;0;.00nan;0;0
4175;86180;571;78;38;2;36;.947;3572000;0
4181;190465;578;89;48;3;45;.938;3585000;0
4181;35520;578;0;0;0;0;.00nan;0;0
4181;143523;569;62;18;2;16;.889;3600000;0
4181;144705;569;0;0;0;0;.00nan;0;0
4183;14459;566;75;29;3;26;.897;3600000;0
4183;28453;566;0;0;0;0;.00nan;0;0
4183;59614;562;45;26;4;22;.846;3600000;0
4183;155943;562;0;0;0;0;.00nan;0;0
4185;6127;575;77;30;2;28;.933;3541000;0
4185;14191;575;0;0;0;0;.00nan;0;0
4185;152478;572;91;22;0;22;1.000;3600000;0
4185;153618;572;0;0;0;0;.00nan;0;0
4189;-1;573;68;24;2;22;.917;3900000;0
4189;67614;565;90;45;2;43;.956;3900000;0
4189;67626;573;0;0;0;0;.00nan;0;0
4189;157189;565;0;0;0;0;.00nan;0;0
4191;6127;575;0;0;0;0;.00nan;0;0
4191;14191;575;87;42;2;40;.952;3600000;0
4191;143523;569;0;0;0;0;.00nan;0;0
4191;144705;569;61;26;3;23;.885;3578000;0
4193;59614;562;100;27;0;27;1.000;3600000;0
4193;67614;565;0;0;0;0;.00nan;0;0
4193;155943;562;0;0;0;0;.00nan;0;0
4193;157189;565;79;34;3;31;.912;3600000;0
4197;190465;578;95;43;0;43;1.000;3900000;0
4197;180535;576;100;24;0;24;1.000;3900000;0
4197;35520;578;0;0;0;0;.00nan;0;0
4197;67625;576;0;0;0;0;.00nan;0;0
1348;14459;566;79;38;3;35;.921;3600000;0
1348;170144;574;42;22;4;18;.818;3561000;0
1348;28453;566;0;0;0;0;.00nan;0;0
1348;185220;574;0;0;0;0;.00nan;0;0
1349;169493;571;77;25;2;23;.920;3765000;0
1349;170963;575;68;32;3;29;.906;3765000;0
1349;59614;575;0;0;0;0;.00nan;0;0
1349;86180;571;0;0;0;0;.00nan;0;0
1350;14459;566;0;0;0;0;.00nan;0;0
1350;170144;574;49;18;3;15;.833;3600000;0
1350;28453;566;50;31;4;27;.871;3581000;0
1350;185220;574;0;0;0;0;.00nan;0;0
1351;169493;571;0;0;0;0;.00nan;0;0
1351;170963;575;69;25;2;23;.920;3676000;0
1351;59614;575;0;0;0;0;.00nan;0;0
1351;86180;571;83;23;1;22;.957;3676000;0
1490;14459;566;0;0;0;0;.00nan;0;0
1490;170144;574;100;28;0;28;1.000;3600000;0
1490;28453;566;63;17;1;16;.941;3549000;0
1490;185220;574;0;0;0;0;.00nan;0;0
1519;169493;571;0;0;0;0;.00nan;0;0
1519;86180;571;88;36;2;34;.944;4079000;0
1519;141419;564;72;26;1;25;.962;4079000;0
1519;141496;564;0;0;0;0;.00nan;0;0
1520;13033;577;0;0;0;0;.00nan;0;0
1520;170144;574;93;33;1;32;.970;3960000;0
1520;185220;574;0;0;0;0;.00nan;0;0
1520;185232;577;85;23;0;23;1.000;3960000;0
1521;483;570;0;0;0;0;.00nan;0;0
1521;68167;570;64;41;5;36;.878;3600000;0
1521;143523;569;0;0;0;0;.00nan;0;0
1521;144705;569;63;19;1;18;.947;3600000;0
1522;-1;573;59;30;3;27;.900;3951000;0
1522;195646;568;66;35;4;31;.886;3951000;0
1522;84430;568;0;0;0;0;.00nan;0;0
1522;85395;573;0;0;0;0;.00nan;0;0
1523;169493;571;0;0;0;0;.00nan;0;0
1523;86180;571;59;32;3;29;.906;3544000;0
1523;141419;564;58;20;2;18;.900;3600000;0
1523;141496;564;0;0;0;0;.00nan;0;0
1524;13033;577;0;0;0;0;.00nan;0;0
1524;170144;574;87;28;1;27;.964;3600000;0
1524;185220;574;0;0;0;0;.00nan;0;0
1524;185232;577;69;27;2;25;.926;3559000;0
1525;483;570;0;0;0;0;.00nan;0;0
1525;68167;570;92;43;3;40;.930;3547000;0
1525;143523;569;0;0;0;0;.00nan;0;0
1525;144705;569;79;34;2;32;.941;3600000;0
1526;-1;573;59;12;1;11;.917;3600000;0
1526;195646;568;73;39;3;36;.923;3600000;0
1526;84430;568;0;0;0;0;.00nan;0;0
1526;85395;573;0;0;0;0;.00nan;0;0
1527;169493;571;0;0;0;0;.00nan;0;0
1527;86180;571;97;35;1;34;.971;4015000;0
1527;141419;564;60;21;2;19;.905;4015000;0
1527;141496;564;0;0;0;0;.00nan;0;0
1528;13033;577;0;0;0;0;.00nan;0;0
1528;170144;574;49;39;5;34;.872;3600000;0
1528;185220;574;0;0;0;0;.00nan;0;0
1528;185232;577;59;19;2;17;.895;3600000;0
1529;483;570;0;0;0;0;.00nan;0;0
1529;68167;570;100;41;0;41;1.000;3600000;0
1529;143523;569;0;0;0;0;.00nan;0;0
1529;144705;569;67;21;1;20;.952;3560000;0
1530;-1;573;62;32;3;29;.906;3576000;0
1530;195646;568;74;30;2;28;.933;3600000;0
1530;84430;568;0;0;0;0;.00nan;0;0
1530;85395;573;0;0;0;0;.00nan;0;0
1531;169493;571;0;0;0;0;.00nan;0;0
1531;86180;571;48;35;5;30;.857;3600000;0
1531;141419;564;98;25;0;25;1.000;3600000;0
1531;141496;564;0;0;0;0;.00nan;0;0
1532;13033;577;0;0;0;0;.00nan;0;0
1532;170144;574;82;25;1;24;.960;3600000;0
1532;185220;574;0;0;0;0;.00nan;0;0
1532;185232;577;81;34;2;32;.941;3600000;0
1533;483;570;0;0;0;0;.00nan;0;0
1533;68167;570;53;48;6;42;.875;3600000;0
1533;143523;569;0;0;0;0;.00nan;0;0
1533;144705;569;73;20;1;19;.950;3600000;0
1534;-1;573;48;21;3;18;.857;3600000;0
1534;195646;568;89;36;2;34;.944;3600000;0
1534;84430;568;0;0;0;0;.00nan;0;0
1534;85395;573;0;0;0;0;.00nan;0;0
1830;169493;571;0;0;0;0;.00nan;0;0
1830;86180;571;91;56;3;53;.946;3600000;0
1830;141419;564;66;17;1;16;.941;3600000;0
1830;141496;564;0;0;0;0;.00nan;0;0
1831;13033;577;0;0;0;0;.00nan;0;0
1831;170144;574;89;26;1;25;.962;3600000;0
1831;185220;574;0;0;0;0;.00nan;0;0
1831;185232;577;61;31;4;27;.871;3600000;0
1832;483;570;0;0;0;0;.00nan;0;0
1832;68167;570;87;38;3;35;.921;3542000;0
1832;143523;569;0;0;0;0;.00nan;0;0
1832;144705;569;58;12;1;11;.917;3600000;0
1833;-1;573;74;31;2;29;.935;3565000;0
1833;195646;568;100;26;0;26;1.000;3600000;0
1833;84430;568;0;0;0;0;.00nan;0;0
1833;85395;573;0;0;0;0;.00nan;0;0
1861;13033;577;0;0;0;0;.00nan;0;0
1861;170144;574;76;41;3;38;.927;4352000;0
1861;185220;574;0;0;0;0;.00nan;0;0
1861;185232;577;78;41;4;37;.902;4341000;0
1862;-1;573;78;25;1;24;.960;3600000;0
1862;195646;568;67;44;5;39;.886;3600000;0
1862;84430;568;0;0;0;0;.00nan;0;0
1862;85395;573;0;0;0;0;.00nan;0;0
1888;-1;573;42;21;3;18;.857;3780000;0
1888;195646;568;78;40;4;36;.900;3780000;0
1888;84430;568;0;0;0;0;.00nan;0;0
1888;85395;573;0;0;0;0;.00nan;0;0
1935;170144;574;77;30;2;28;.933;3548000;0
1935;185220;574;0;0;0;0;.00nan;0;0
1935;141419;564;76;24;1;23;.958;3600000;0
1935;141496;564;0;0;0;0;.00nan;0;0
1936;-1;573;93;47;3;44;.936;3582000;0
1936;85395;573;0;0;0;0;.00nan;0;0
1936;143523;569;0;0;0;0;.00nan;0;0
1936;144705;569;69;22;2;20;.909;3600000;0
1937;170144;574;90;36;1;35;.972;3600000;0
1937;185220;574;0;0;0;0;.00nan;0;0
1937;141419;564;42;26;4;22;.846;3600000;0
1937;141496;564;0;0;0;0;.00nan;0;0
1938;-1;573;68;32;3;29;.906;3792000;0
1938;85395;573;0;0;0;0;.00nan;0;0
1938;143523;569;0;0;0;0;.00nan;0;0
1938;144705;569;81;32;2;30;.938;3792000;0
1939;170144;574;100;39;0;39;1.000;3600000;0
1939;185220;574;0;0;0;0;.00nan;0;0
1939;141419;564;73;28;2;26;.929;3541000;0
1939;141496;564;0;0;0;0;.00nan;0;0
1940;-1;573;100;31;0;31;1.000;3600000;0
1940;85395;573;0;0;0;0;.00nan;0;0
1940;143523;569;0;0;0;0;.00nan;0;0
1940;144705;569;48;26;4;22;.846;3600000;0
1941;170144;574;59;31;4;27;.871;3600000;0
1941;185220;574;0;0;0;0;.00nan;0;0
1941;141419;564;96;23;0;23;1.000;3600000;0
1941;141496;564;0;0;0;0;.00nan;0;0
1942;-1;573;90;43;2;41;.953;3929000;0
1942;85395;573;0;0;0;0;.00nan;0;0
1942;143523;569;0;0;0;0;.00nan;0;0
1942;144705;569;45;20;3;17;.850;3929000;0
2180;170144;574;88;35;1;34;.971;3584000;0
2180;185220;574;0;0;0;0;.00nan;0;0
2180;141419;564;87;18;0;18;1.000;3600000;0
2180;141496;564;0;0;0;0;.00nan;0;0
2181;-1;573;100;31;0;31;1.000;3600000;0
2181;85395;573;0;0;0;0;.00nan;0;0
2181;143523;569;0;0;0;0;.00nan;0;0
2181;144705;569;49;16;3;13;.813;3600000;0
2270;170144;574;100;39;1;38;.974;3600000;0
2270;185220;574;0;0;0;0;.00nan;0;0
2270;141419;564;65;30;3;27;.900;3600000;0
2270;141496;564;0;0;0;0;.00nan;0;0
2271;-1;573;63;31;3;28;.903;3536000;0
2271;85395;573;0;0;0;0;.00nan;0;0
2271;143523;569;0;0;0;0;.00nan;0;0
2271;144705;569;75;22;1;21;.955;3600000;0
2311;170144;574;72;22;1;21;.955;3600000;0
2311;185220;574;0;0;0;0;.00nan;0;0
2311;141419;564;41;20;3;17;.850;3596000;0
2311;141496;564;0;0;0;0;.00nan;0;0
2312;-1;573;66;33;3;30;.909;3600000;0
2312;85395;573;0;0;0;0;.00nan;0;0
2312;143523;569;0;0;0;0;.00nan;0;0
2312;144705;569;71;23;2;21;.913;3600000;0
2381;-1;573;100;31;0;31;1.000;3600000;0
2381;85395;573;0;0;0;0;.00nan;0;0
2381;141419;564;85;29;1;28;.966;3555000;0
2381;141496;564;0;0;0;0;.00nan;0;0
2382;170144;574;99;37;1;36;.973;3600000;0
2382;185220;574;0;0;0;0;.00nan;0;0
2382;143523;569;0;0;0;0;.00nan;0;0
2382;144705;569;66;35;4;31;.886;3600000;0
2383;170144;574;92;58;4;54;.931;4706000;0
2383;185220;574;0;0;0;0;.00nan;0;0
2383;143523;569;0;0;0;0;.00nan;0;0
2383;144705;569;55;33;3;30;.909;4712000;0
2384;170144;574;89;70;5;65;.929;4913000;0
2384;185220;574;0;0;0;0;.00nan;0;0
2384;143523;569;0;0;0;0;.00nan;0;0
2384;144705;569;48;32;4;28;.875;4895000;0
2385;170144;574;81;26;1;25;.962;3600000;0
2385;185220;574;0;0;0;0;.00nan;0;0
2385;143523;569;0;0;0;0;.00nan;0;0
2385;144705;569;57;19;2;17;.895;3599000;0
2537;170144;574;78;31;3;28;.903;3667000;0
2537;185220;574;0;0;0;0;.00nan;0;0
2537;143523;569;0;0;0;0;.00nan;0;0
2537;144705;569;43;23;4;19;.826;3667000;0
2563;170144;574;84;50;4;46;.920;3600000;0
2563;185220;574;0;0;0;0;.00nan;0;0
2563;143523;569;0;0;0;0;.00nan;0;0
2563;144705;569;68;16;1;15;.938;3600000;0
2578;170144;574;89;33;1;32;.970;3600000;0
2578;185220;574;0;0;0;0;.00nan;0;0
2578;143523;569;57;16;2;14;.875;3555000;0
2578;155917;569;0;0;0;0;.00nan;0;0
4204;175084;881;97;48;2;46;.958;3600000;0
4204;180316;876;84;28;1;27;.964;3600000;0
4204;181123;876;0;0;0;0;.00nan;0;0
4204;78348;881;0;0;0;0;.00nan;0;0
4205;183775;893;20;25;6;19;.760;2423000;0
4205;28833;1415;100;27;0;27;1.000;3600000;0
4205;63402;893;75;16;0;16;1.000;1177000;0
4205;78920;1415;0;0;0;0;.00nan;0;0
4206;11716;875;71;20;1;19;.950;3600000;0
4206;168712;878;79;37;3;34;.919;3564000;0
4206;62829;875;0;0;0;0;.00nan;0;0
4206;82245;878;0;0;0;0;.00nan;0;0
4207;166751;883;94;33;1;32;.970;3600000;0
4207;11851;892;0;0;0;0;.00nan;0;0
4207;192461;892;58;41;5;36;.878;3600000;0
4207;80834;883;0;0;0;0;.00nan;0;0
4208;8519;873;0;0;0;0;.00nan;0;0
4208;184398;887;0;0;0;0;.00nan;0;0
4208;69536;873;58;31;4;27;.871;3558000;0
4208;91742;887;71;29;2;27;.931;3600000;0
4209;162945;886;83;36;2;34;.944;3600000;0
4209;184648;886;0;0;0;0;.00nan;0;0
4209;180731;877;43;20;4;16;.800;2029000;0
4209;85749;877;60;8;0;8;1.000;1497000;0
4210;183755;882;79;36;2;34;.944;3900000;0
4210;179602;872;0;0;0;0;.00nan;0;0
4210;77084;872;76;32;2;30;.938;3900000;0
4210;147567;882;0;0;0;0;.00nan;0;0
4211;180316;876;0;0;0;0;.00nan;0;0
4211;180731;877;66;33;3;30;.909;3571000;0
4211;181123;876;76;25;1;24;.960;3600000;0
4211;85749;877;0;0;0;0;.00nan;0;0
4212;11716;875;62;27;3;24;.889;3600000;0
4212;179602;872;51;28;4;24;.857;3578000;0
4212;62829;875;0;0;0;0;.00nan;0;0
4212;77084;872;0;0;0;0;.00nan;0;0
4213;11851;892;79;26;1;25;.962;3600000;0
4213;183775;893;0;0;0;0;.00nan;0;0
4213;192461;892;0;0;0;0;.00nan;0;0
4213;63402;893;92;31;2;29;.935;3600000;0
4214;166751;883;100;40;1;39;.975;3900000;0
4214;183755;882;80;30;1;29;.967;3900000;0
4214;80834;883;0;0;0;0;.00nan;0;0
4214;147567;882;0;0;0;0;.00nan;0;0
4215;168712;878;84;46;3;43;.935;3745000;0
4215;184398;887;59;33;4;29;.879;3745000;0
4215;82245;878;0;0;0;0;.00nan;0;0
4215;91742;887;0;0;0;0;.00nan;0;0
4216;8519;873;0;0;0;0;.00nan;0;0
4216;175084;881;87;34;2;32;.941;3673000;0
4216;69536;873;66;16;1;15;.938;3673000;0
4216;78348;881;0;0;0;0;.00nan;0;0
4217;28833;1415;72;23;1;22;.957;3900000;0
4217;180316;876;0;0;0;0;.00nan;0;0
4217;181123;876;89;35;1;34;.971;3900000;0
4217;78920;1415;0;0;0;0;.00nan;0;0
4218;11716;875;0;0;0;0;.00nan;0;0
4218;184398;887;88;46;4;42;.913;3600000;0
4218;62829;875;73;20;1;19;.950;3600000;0
4218;91742;887;0;0;0;0;.00nan;0;0
4219;166751;883;70;18;1;17;.944;3600000;0
4219;168712;878;83;39;3;36;.923;3518000;0
4219;80834;883;0;0;0;0;.00nan;0;0
4219;82245;878;0;0;0;0;.00nan;0;0
4220;8519;873;0;0;0;0;.00nan;0;0
4220;179602;872;74;21;1;20;.952;3600000;0
4220;69536;873;75;43;4;39;.907;3600000;0
4220;77084;872;0;0;0;0;.00nan;0;0
4221;162945;886;100;34;0;34;1.000;3600000;0
4221;183775;893;50;8;1;7;.875;1473000;0
4221;184648;886;0;0;0;0;.00nan;0;0
4221;63402;893;19;14;5;9;.643;2127000;0
4222;11851;892;77;36;3;33;.917;3900000;0
4222;175084;881;70;33;3;30;.909;3900000;0
4222;192461;892;0;0;0;0;.00nan;0;0
4222;78348;881;0;0;0;0;.00nan;0;0
4223;183755;882;43;32;6;26;.813;3600000;0
4223;180731;877;0;0;0;0;.00nan;0;0
4223;85749;877;78;30;2;28;.933;3600000;0
4223;147567;882;0;0;0;0;.00nan;0;0
4224;166751;883;64;31;4;27;.871;3576000;0
4224;179602;872;53;20;3;17;.850;3600000;0
4224;77084;872;0;0;0;0;.00nan;0;0
4224;80834;883;0;0;0;0;.00nan;0;0
4225;11851;892;99;49;2;47;.959;3600000;0
4225;28833;1415;0;0;0;0;.00nan;0;0
4225;192461;892;0;0;0;0;.00nan;0;0
4225;78920;1415;67;28;3;25;.893;3553000;0
4226;11716;875;29;25;5;20;.800;3600000;0
4226;183775;893;0;0;0;0;.00nan;0;0
4226;62829;875;0;0;0;0;.00nan;0;0
4226;63402;893;80;25;1;24;.960;3600000;0
4227;8519;873;0;0;0;0;.00nan;0;0
4227;180316;876;0;0;0;0;.00nan;0;0
4227;181123;876;94;33;1;32;.970;3600000;0
4227;69536;873;75;29;2;27;.931;3576000;0
4228;184398;887;84;47;4;43;.915;3520000;0
4228;175084;881;72;28;2;26;.929;3600000;0
4228;78348;881;0;0;0;0;.00nan;0;0
4228;91742;887;0;0;0;0;.00nan;0;0
4229;168712;878;98;46;1;45;.978;3900000;0
4229;180731;877;65;16;1;15;.938;3900000;0
4229;82245;878;0;0;0;0;.00nan;0;0
4229;85749;877;0;0;0;0;.00nan;0;0
4230;162945;886;70;36;4;32;.889;3600000;0
4230;183755;882;0;0;0;0;.00nan;0;0
4230;184648;886;0;0;0;0;.00nan;0;0
4230;147567;882;52;26;3;23;.885;3600000;0
4231;183775;893;0;0;0;0;.00nan;0;0
4231;179602;872;67;21;1;20;.952;3600000;0
4231;63402;893;38;33;6;27;.818;3600000;0
4231;77084;872;0;0;0;0;.00nan;0;0
4232;162945;886;94;37;1;36;.973;3600000;0
4232;184648;886;0;0;0;0;.00nan;0;0
4232;28833;1415;85;41;2;39;.951;3588000;0
4232;78920;1415;0;0;0;0;.00nan;0;0
4233;183775;893;0;0;0;0;.00nan;0;0
4233;180316;876;0;0;0;0;.00nan;0;0
4233;181123;876;76;22;1;21;.955;3600000;0
4233;63402;893;67;38;4;34;.895;3600000;0
4234;11716;875;0;0;0;0;.00nan;0;0
4234;180731;877;76;34;3;31;.912;3900000;0
4234;62829;875;80;40;3;37;.925;3900000;0
4234;85749;877;0;0;0;0;.00nan;0;0
4235;166751;883;23;4;3;1;.250;418000;0
4235;28833;1415;90;41;3;38;.927;3600000;0
4235;78920;1415;0;0;0;0;.00nan;0;0
4235;80834;883;81;20;1;19;.950;3141000;0
4236;162945;886;98;23;0;23;1.000;3600000;0
4236;184398;887;87;32;1;31;.969;3567000;0
4236;184648;886;0;0;0;0;.00nan;0;0
4236;91742;887;0;0;0;0;.00nan;0;0
4237;8519;873;0;0;0;0;.00nan;0;0
4237;168712;878;100;42;0;42;1.000;3600000;0
4237;69536;873;70;22;1;21;.955;3557000;0
4237;82245;878;0;0;0;0;.00nan;0;0
4238;11851;892;58;15;1;14;.933;850000;0
4238;183755;882;84;15;0;15;1.000;3600000;0
4238;192461;892;60;42;6;36;.857;2750000;0
4238;147567;882;0;0;0;0;.00nan;0;0
4239;175084;881;39;38;6;32;.842;3600000;0
4239;179602;872;62;28;3;25;.893;3600000;0
4239;77084;872;0;0;0;0;.00nan;0;0
4239;78348;881;0;0;0;0;.00nan;0;0
4240;11716;875;87;45;3;42;.933;3600000;0
4240;180316;876;94;18;0;18;1.000;3600000;0
4240;181123;876;0;0;0;0;.00nan;0;0
4240;62829;875;0;0;0;0;.00nan;0;0
4241;184398;887;55;36;5;31;.861;3600000;0
4241;179602;872;0;0;0;0;.00nan;0;0
4241;77084;872;100;35;0;35;1.000;3600000;0
4241;91742;887;0;0;0;0;.00nan;0;0
4242;166751;883;0;0;0;0;.00nan;0;0
4242;183775;893;0;0;0;0;.00nan;0;0
4242;63402;893;81;31;1;30;.968;3900000;0
4242;80834;883;78;23;1;22;.957;3900000;0
4243;162945;886;75;40;4;36;.900;3600000;0
4243;8519;873;0;0;0;0;.00nan;0;0
4243;184648;886;0;0;0;0;.00nan;0;0
4243;69536;873;42;25;5;20;.800;3600000;0
4244;11851;892;53;28;3;25;.893;3592000;0
4244;168712;878;89;34;2;32;.941;3600000;0
4244;192461;892;0;0;0;0;.00nan;0;0
4244;82245;878;0;0;0;0;.00nan;0;0
4245;28833;1415;71;21;1;20;.952;3600000;0
4245;180731;877;0;0;0;0;.00nan;0;0
4245;78920;1415;0;0;0;0;.00nan;0;0
4245;85749;877;75;30;2;28;.933;3552000;0
4246;183755;882;83;25;1;24;.960;3600000;0
4246;175084;881;63;41;4;37;.902;3600000;0
4246;78348;881;0;0;0;0;.00nan;0;0
4246;147567;882;0;0;0;0;.00nan;0;0
4247;162945;886;84;29;2;27;.931;3600000;0
4247;11716;875;0;0;0;0;.00nan;0;0
4247;184648;886;0;0;0;0;.00nan;0;0
4247;62829;875;54;35;5;30;.857;3600000;0
4248;168712;878;100;31;0;31;1.000;3600000;0
4248;179602;872;0;0;0;0;.00nan;0;0
4248;77084;872;74;27;2;25;.926;3549000;0
4248;82245;878;0;0;0;0;.00nan;0;0
4249;175084;881;73;44;4;40;.909;3600000;0
4249;28833;1415;71;20;1;19;.950;3600000;0
4249;78348;881;0;0;0;0;.00nan;0;0
4249;78920;1415;0;0;0;0;.00nan;0;0
4250;8519;873;0;0;0;0;.00nan;0;0
4250;183775;893;0;0;0;0;.00nan;0;0
4250;63402;893;72;34;3;31;.912;3600000;0
4250;69536;873;56;26;4;22;.846;3578000;0
4251;11851;892;77;40;3;37;.925;3555000;0
4251;180731;877;99;31;2;29;.935;3600000;0
4251;192461;892;0;0;0;0;.00nan;0;0
4251;85749;877;0;0;0;0;.00nan;0;0
4252;166751;883;64;41;5;36;.878;3600000;0
4252;184398;887;73;23;2;21;.913;3600000;0
4252;80834;883;0;0;0;0;.00nan;0;0
4252;91742;887;0;0;0;0;.00nan;0;0
4253;183755;882;0;0;0;0;.00nan;0;0
4253;180316;876;70;31;2;29;.935;3565000;0
4253;181123;876;0;0;0;0;.00nan;0;0
4253;147567;882;84;28;1;27;.964;3600000;0
4254;11716;875;16;23;6;17;.739;3539000;0
4254;28833;1415;72;46;4;42;.913;3600000;0
4254;62829;875;0;0;0;0;.00nan;0;0
4254;78920;1415;0;0;0;0;.00nan;0;0
4255;166751;883;89;33;1;32;.970;3900000;0
4255;8519;873;0;0;0;0;.00nan;0;0
4255;69536;873;73;25;1;24;.960;3900000;0
4255;80834;883;0;0;0;0;.00nan;0;0
4256;162945;886;49;20;3;17;.850;3544000;0
4256;184648;886;0;0;0;0;.00nan;0;0
4256;179602;872;98;38;2;36;.947;3600000;0
4256;77084;872;0;0;0;0;.00nan;0;0
4257;168712;878;100;29;0;29;1.000;3600000;0
4257;180316;876;0;0;0;0;.00nan;0;0
4257;181123;876;71;27;2;25;.926;3600000;0
4257;82245;878;0;0;0;0;.00nan;0;0
4258;11851;892;2;22;8;14;.636;2902000;0
4258;184398;887;84;33;1;32;.970;3600000;0
4258;192461;892;43;4;1;3;.750;698000;0
4258;91742;887;0;0;0;0;.00nan;0;0
4259;183755;882;54;36;4;32;.889;3551000;0
4259;183775;893;0;0;0;0;.00nan;0;0
4259;63402;893;66;25;2;23;.920;3600000;0
4259;147567;882;0;0;0;0;.00nan;0;0
4260;175084;881;69;40;4;36;.900;3554000;0
4260;180731;877;65;30;3;27;.900;3600000;0
4260;78348;881;0;0;0;0;.00nan;0;0
4260;85749;877;0;0;0;0;.00nan;0;0
4261;11851;892;86;53;3;50;.943;3539000;0
4261;180316;876;68;17;1;16;.941;3600000;0
4261;181123;876;0;0;0;0;.00nan;0;0
4261;192461;892;0;0;0;0;.00nan;0;0
4262;184398;887;80;30;2;28;.933;3600000;0
4262;28833;1415;0;0;0;0;.00nan;0;0
4262;78920;1415;63;30;3;27;.900;3576000;0
4262;91742;887;0;0;0;0;.00nan;0;0
4263;183775;893;100;30;1;29;.967;3600000;0
4263;175084;881;20;28;7;21;.750;3600000;0
4263;63402;893;0;0;0;0;.00nan;0;0
4263;78348;881;0;0;0;0;.00nan;0;0
4264;166751;883;83;35;3;32;.914;3555000;0
4264;162945;886;69;27;2;25;.926;3600000;0
4264;184648;886;0;0;0;0;.00nan;0;0
4264;80834;883;0;0;0;0;.00nan;0;0
4265;8519;873;62;32;3;29;.906;3900000;0
4265;11716;875;0;0;0;0;.00nan;0;0
4265;62829;875;64;27;3;24;.889;3900000;0
4265;69536;873;0;0;0;0;.00nan;0;0
4266;183755;882;95;16;0;16;1.000;3600000;0
4266;168712;878;87;44;3;41;.932;3600000;0
4266;82245;878;0;0;0;0;.00nan;0;0
4266;147567;882;0;0;0;0;.00nan;0;0
4267;179602;872;63;30;3;27;.900;3600000;0
4267;180731;877;0;0;0;0;.00nan;0;0
4267;77084;872;0;0;0;0;.00nan;0;0
4267;85749;877;44;41;6;35;.854;3600000;0
4268;184398;887;84;28;1;27;.964;3600000;0
4268;180316;876;0;0;0;0;.00nan;0;0
4268;181123;876;73;34;2;32;.941;3589000;0
4268;85633;887;0;0;0;0;.00nan;0;0
4269;28833;1415;41;25;4;21;.840;3600000;0
4269;179602;872;96;32;1;31;.969;3600000;0
4269;77084;872;0;0;0;0;.00nan;0;0
4269;78920;1415;0;0;0;0;.00nan;0;0
4270;162945;886;67;31;3;28;.903;3600000;0
4270;168712;878;67;39;4;35;.897;3550000;0
4270;184648;886;0;0;0;0;.00nan;0;0
4270;82245;878;0;0;0;0;.00nan;0;0
4271;8519;873;0;0;0;0;.00nan;0;0
4271;11851;892;24;21;5;16;.762;2146000;0
4271;192461;892;64;13;0;13;1.000;1454000;0
4271;69536;873;78;24;2;22;.917;3600000;0
4272;183775;893;38;7;2;5;.714;389000;0
4272;180731;877;59;33;4;29;.879;3600000;0
4272;63402;893;18;26;7;19;.731;3211000;0
4272;91202;877;0;0;0;0;.00nan;0;0
4273;11716;875;0;0;0;0;.00nan;0;0
4273;183755;882;0;0;0;0;.00nan;0;0
4273;78775;875;68;32;3;29;.906;3600000;0
4273;147567;882;44;24;4;20;.833;3597000;0
4274;166751;883;81;25;1;24;.960;3600000;0
4274;175084;881;23;30;6;24;.800;3600000;0
4274;78348;881;0;0;0;0;.00nan;0;0
4274;80834;883;0;0;0;0;.00nan;0;0
4275;11716;875;0;0;0;0;.00nan;0;0
4275;11851;892;97;51;3;48;.941;3600000;0
4275;192461;892;0;0;0;0;.00nan;0;0
4275;78775;875;100;29;0;29;1.000;3600000;0
4276;183775;893;0;0;0;0;.00nan;0;0
4276;179602;872;81;23;1;22;.957;3600000;0
4276;63402;893;41;29;5;24;.828;3600000;0
4276;77084;872;0;0;0;0;.00nan;0;0
4277;166751;883;0;0;0;0;.00nan;0;0
4277;180316;876;79;24;2;22;.917;3600000;0
4277;181123;876;0;0;0;0;.00nan;0;0
4277;80834;883;82;25;1;24;.960;3600000;0
4278;8519;873;0;0;0;0;.00nan;0;0
4278;183755;882;64;30;3;27;.900;3900000;0
4278;69536;873;74;28;3;25;.893;3900000;0
4278;147567;882;0;0;0;0;.00nan;0;0
4279;168712;878;0;0;0;0;.00nan;0;0
4279;28833;1415;84;29;2;27;.931;3600000;0
4279;78920;1415;0;0;0;0;.00nan;0;0
4279;82245;878;50;27;4;23;.852;3558000;0
4280;184398;887;77;43;4;39;.907;3600000;0
4280;180731;877;0;0;0;0;.00nan;0;0
4280;85633;887;0;0;0;0;.00nan;0;0
4280;91202;877;89;31;1;30;.968;3600000;0
4281;162945;886;100;35;0;35;1.000;3600000;0
4281;184648;886;0;0;0;0;.00nan;0;0
4281;175084;881;0;0;0;0;.00nan;0;0
4281;78348;881;92;40;2;38;.950;3570000;0
4282;179602;872;78;30;2;28;.933;3600000;0
4282;180316;876;0;0;0;0;.00nan;0;0
4282;181123;876;65;37;4;33;.892;3600000;0
4282;77084;872;0;0;0;0;.00nan;0;0
4283;8519;873;0;0;0;0;.00nan;0;0
4283;28833;1415;63;40;5;35;.875;3600000;0
4283;69536;873;76;26;2;24;.923;3600000;0
4283;78920;1415;0;0;0;0;.00nan;0;0
4284;11716;875;0;0;0;0;.00nan;0;0
4284;175084;881;0;0;0;0;.00nan;0;0
4284;78348;881;67;30;2;28;.933;3517000;0
4284;78775;875;100;26;0;26;1.000;3600000;0
4285;183775;893;43;23;4;19;.826;2202000;0
4285;168712;878;88;39;3;36;.923;3600000;0
4285;63402;893;59;15;1;14;.933;1355000;0
4285;82245;878;0;0;0;0;.00nan;0;0
4286;162945;886;70;27;2;25;.926;3600000;0
4286;11851;892;56;34;5;29;.853;3600000;0
4286;184648;886;0;0;0;0;.00nan;0;0
4286;192461;892;0;0;0;0;.00nan;0;0
4287;183755;882;66;39;3;36;.923;3589000;0
4287;184398;887;91;35;1;34;.971;3600000;0
4287;85633;887;0;0;0;0;.00nan;0;0
4287;147567;882;0;0;0;0;.00nan;0;0
4288;166751;883;100;39;0;39;1.000;3600000;0
4288;180731;877;63;17;1;16;.941;3600000;0
4288;80834;883;0;0;0;0;.00nan;0;0
4288;91202;877;0;0;0;0;.00nan;0;0
4289;183775;893;0;0;0;0;.00nan;0;0
4289;184398;887;52;27;4;23;.852;3600000;0
4289;63402;893;92;44;3;41;.932;3600000;0
4289;85633;887;0;0;0;0;.00nan;0;0
4290;175084;881;0;0;0;0;.00nan;0;0
4290;179602;872;35;30;6;24;.800;2366000;0
4290;77084;872;51;9;1;8;.889;1178000;0
4290;78348;881;50;39;6;33;.846;3600000;0
4291;11851;892;99;39;1;38;.974;3600000;0
4291;179602;872;63;27;3;24;.889;3527000;0
4291;192461;892;0;0;0;0;.00nan;0;0
4291;77084;872;0;0;0;0;.00nan;0;0
4292;166751;883;90;43;3;40;.930;3600000;0
4292;11716;875;0;0;0;0;.00nan;0;0
4292;78775;875;44;30;5;25;.833;3527000;0
4292;80834;883;0;0;0;0;.00nan;0;0
4293;8519;873;0;0;0;0;.00nan;0;0
4293;180731;877;74;28;2;26;.929;3900000;0
4293;69536;873;89;31;2;29;.935;3900000;0
4293;91202;877;0;0;0;0;.00nan;0;0
4294;162945;886;100;28;0;28;1.000;3705000;0
4294;184648;886;0;0;0;0;.00nan;0;0
4294;180316;876;0;0;0;0;.00nan;0;0
4294;181123;876;82;29;1;28;.966;3705000;0
4295;183755;882;0;0;0;0;.00nan;0;0
4295;28833;1415;54;39;4;35;.897;3600000;0
4295;78920;1415;0;0;0;0;.00nan;0;0
4295;147567;882;88;16;0;16;1.000;3600000;0
4296;168712;878;66;27;3;24;.889;3627000;0
4296;175084;881;0;0;0;0;.00nan;0;0
4296;78348;881;56;29;4;25;.862;3627000;0
4296;82245;878;0;0;0;0;.00nan;0;0
4297;183755;882;78;39;3;36;.923;3600000;0
4297;183775;893;0;0;0;0;.00nan;0;0
4297;63402;893;100;21;0;21;1.000;3600000;0
4297;147567;882;0;0;0;0;.00nan;0;0
4298;8519;873;0;0;0;0;.00nan;0;0
4298;175084;881;0;0;0;0;.00nan;0;0
4298;69536;873;87;41;4;37;.902;3562000;0
4298;78348;881;79;36;3;33;.917;3600000;0
4299;166751;883;19;20;6;14;.700;2375000;0
4299;162945;886;73;29;2;27;.931;3600000;0
4299;184648;886;0;0;0;0;.00nan;0;0
4299;80834;883;61;8;0;8;1.000;1225000;0
4300;168712;878;93;36;2;34;.944;3600000;0
4300;179602;872;0;0;0;0;.00nan;0;0
4300;77084;872;49;18;3;15;.833;3586000;0
4300;82245;878;0;0;0;0;.00nan;0;0
4301;11851;892;62;32;4;28;.875;3555000;0
4301;28833;1415;62;27;3;24;.889;3600000;0
4301;192461;892;0;0;0;0;.00nan;0;0
4301;78920;1415;0;0;0;0;.00nan;0;0
4302;184398;887;66;45;5;40;.889;3600000;0
4302;180316;876;0;0;0;0;.00nan;0;0
4302;181123;876;64;19;2;17;.895;3600000;0
4302;85633;887;0;0;0;0;.00nan;0;0
4303;11716;875;0;0;0;0;.00nan;0;0
4303;180731;877;55;6;0;6;1.000;1357000;0
4303;78775;875;75;36;4;32;.889;3600000;0
4303;91202;877;30;23;5;18;.783;2243000;0
4304;11716;875;0;0;0;0;.00nan;0;0
4304;183755;882;15;21;6;15;.714;2088000;0
4304;78775;875;56;23;3;20;.870;3600000;0
4304;147567;882;59;12;1;11;.917;1512000;0
4305;166751;883;74;40;4;36;.900;3600000;0
4305;180316;876;0;0;0;0;.00nan;0;0
4305;181123;876;41;25;5;20;.800;3597000;0
4305;80834;883;0;0;0;0;.00nan;0;0
4306;162945;886;18;33;7;26;.788;3356000;0
4306;184648;886;48;0;0;0;.00nan;244000;0
4306;179602;872;98;24;0;24;1.000;3600000;0
4306;77084;872;0;0;0;0;.00nan;0;0
4307;28833;1415;78;22;1;21;.955;3600000;0
4307;180731;877;0;0;0;0;.00nan;0;0
4307;78920;1415;0;0;0;0;.00nan;0;0
4307;91202;877;52;24;3;21;.875;3600000;0
4308;8519;873;0;0;0;0;.00nan;0;0
4308;11716;875;86;18;0;18;1.000;3387000;0
4308;69536;873;81;38;3;35;.921;3900000;0
4308;78775;875;26;5;3;2;.400;513000;0
4309;11851;892;0;0;0;0;.00nan;0;0
4309;183775;893;0;0;0;0;.00nan;0;0
4309;192461;892;87;27;1;26;.963;3600000;0
4309;63402;893;60;25;3;22;.880;3536000;0
4310;168712;878;61;25;2;23;.920;3516000;0
4310;184398;887;100;35;0;35;1.000;3600000;0
4310;82245;878;0;0;0;0;.00nan;0;0
4310;85633;887;0;0;0;0;.00nan;0;0
4311;183755;882;35;28;5;23;.821;3600000;0
4311;175084;881;0;0;0;0;.00nan;0;0
4311;78348;881;88;21;0;21;1.000;3600000;0
4311;147567;882;0;0;0;0;.00nan;0;0
4312;179602;872;47;41;6;35;.854;3124000;0
4312;180316;876;0;0;0;0;.00nan;0;0
4312;181123;876;67;30;3;27;.900;3600000;0
4312;77084;872;55;5;0;5;1.000;476000;0
4313;162945;886;91;41;2;39;.951;3600000;0
4313;184648;886;0;0;0;0;.00nan;0;0
4313;28833;1415;56;25;3;22;.880;3586000;0
4313;78920;1415;0;0;0;0;.00nan;0;0
4314;183775;893;0;0;0;0;.00nan;0;0
4314;180731;877;82;22;1;21;.955;3600000;0
4314;63402;893;43;29;5;24;.828;3600000;0
4314;91202;877;0;0;0;0;.00nan;0;0
4315;166751;883;0;0;0;0;.00nan;0;0
4315;184398;887;75;42;3;39;.929;3548000;0
4315;80834;883;80;24;1;23;.958;3600000;0
4315;85633;887;0;0;0;0;.00nan;0;0
4316;8519;873;43;23;4;19;.826;3555000;0
4316;168712;878;90;43;3;40;.930;3600000;0
4316;69536;873;0;0;0;0;.00nan;0;0
4316;82245;878;0;0;0;0;.00nan;0;0
4317;11851;892;94;35;2;33;.943;3600000;0
4317;175084;881;0;0;0;0;.00nan;0;0
4317;192461;892;0;0;0;0;.00nan;0;0
4317;78348;881;77;39;3;36;.923;3566000;0
4318;8519;873;0;0;0;0;.00nan;0;0
4318;179602;872;74;26;2;24;.923;3900000;0
4318;69536;873;85;35;2;33;.943;3900000;0
4318;77084;872;0;0;0;0;.00nan;0;0
4319;183775;893;0;0;0;0;.00nan;0;0
4319;180316;876;0;0;0;0;.00nan;0;0
4319;181123;876;100;25;0;25;1.000;3600000;0
4319;63402;893;75;33;3;30;.909;3600000;0
4320;162945;886;83;24;1;23;.958;3600000;0
4320;11851;892;63;49;6;43;.878;3600000;0
4320;184648;886;0;0;0;0;.00nan;0;0
4320;192461;892;0;0;0;0;.00nan;0;0
4321;11716;875;0;0;0;0;.00nan;0;0
4321;168712;878;93;45;3;42;.933;3600000;0
4321;78775;875;27;22;5;17;.773;3552000;0
4321;82245;878;0;0;0;0;.00nan;0;0
4322;184398;887;0;0;0;0;.00nan;0;0
4322;28833;1415;94;22;0;22;1.000;3600000;0
4322;78920;1415;0;0;0;0;.00nan;0;0
4322;85633;887;79;35;3;32;.914;3600000;0
4323;175084;881;0;0;0;0;.00nan;0;0
4323;180731;877;56;34;4;30;.882;3547000;0
4323;78348;881;77;36;3;33;.917;3600000;0
4323;91202;877;0;0;0;0;.00nan;0;0
4324;166751;883;65;23;2;21;.913;3600000;0
4324;183755;882;36;30;5;25;.833;3600000;0
4324;80834;883;0;0;0;0;.00nan;0;0
4324;147567;882;0;0;0;0;.00nan;0;0
4325;168712;878;80;45;4;41;.911;3734000;0
4325;180316;876;0;0;0;0;.00nan;0;0
4325;181123;876;43;18;3;15;.833;3734000;0
4325;82245;878;0;0;0;0;.00nan;0;0
4326;11716;875;0;0;0;0;.00nan;0;0
4326;28833;1415;64;20;2;18;.900;3557000;0
4326;78775;875;100;33;0;33;1.000;3600000;0
4326;78920;1415;0;0;0;0;.00nan;0;0
4327;166751;883;79;33;2;31;.939;3600000;0
4327;179602;872;39;16;3;13;.813;3566000;0
4327;77084;872;0;0;0;0;.00nan;0;0
4327;80834;883;0;0;0;0;.00nan;0;0
4328;162945;886;28;22;5;17;.773;3537000;0
4328;8519;873;0;0;0;0;.00nan;0;0
4328;184648;886;0;0;0;0;.00nan;0;0
4328;69536;873;77;29;2;27;.931;3600000;0
4329;11851;892;17;15;5;10;.667;1191000;0
4329;184398;887;25;35;7;28;.800;3774000;0
4329;192461;892;73;17;1;16;.941;2583000;0
4329;85633;887;0;0;0;0;.00nan;0;0
4330;183755;882;0;0;0;0;.00nan;0;0
4330;180731;877;58;21;3;18;.857;3600000;0
4330;91202;877;0;0;0;0;.00nan;0;0
4330;147567;882;65;31;4;27;.871;3560000;0
4331;183775;893;0;0;0;0;.00nan;0;0
4331;175084;881;0;0;0;0;.00nan;0;0
4331;63402;893;43;34;5;29;.853;3571000;0
4331;78348;881;65;34;4;30;.882;3600000;0
4332;8519;873;0;0;0;0;.00nan;0;0
4332;180316;876;0;0;0;0;.00nan;0;0
4332;181123;876;96;38;2;36;.947;3900000;0
4332;69536;873;86;23;2;21;.913;3900000;0
4333;175084;881;0;0;0;0;.00nan;0;0
4333;179602;872;0;0;0;0;.00nan;0;0
4333;77084;872;79;31;2;29;.935;3600000;0
4333;78348;881;75;33;3;30;.909;3600000;0
4334;183755;882;100;27;0;27;1.000;3600000;0
4334;28833;1415;0;0;0;0;.00nan;0;0
4334;78920;1415;41;24;4;20;.833;3600000;0
4334;147567;882;0;0;0;0;.00nan;0;0
4335;166751;883;34;17;4;13;.765;1150000;0
4335;11716;875;0;0;0;0;.00nan;0;0
4335;78775;875;49;31;5;26;.839;3600000;0
4335;80834;883;37;15;3;12;.800;2450000;0
4336;162945;886;81;27;1;26;.963;3600000;0
4336;168712;878;57;39;5;34;.872;3600000;0
4336;184648;886;0;0;0;0;.00nan;0;0
4336;82245;878;0;0;0;0;.00nan;0;0
4337;183775;893;0;0;0;0;.00nan;0;0
4337;184398;887;65;26;2;24;.923;3544000;0
4337;63402;893;79;24;1;23;.958;3600000;0
4337;85633;887;0;0;0;0;.00nan;0;0
4338;11851;892;0;0;0;0;.00nan;0;0
4338;180731;877;0;0;0;0;.00nan;0;0
4338;192461;892;93;37;1;36;.973;3900000;0
4338;91202;877;86;29;1;28;.966;3900000;0
4339;183755;882;67;40;5;35;.875;3600000;0
4339;179602;872;45;22;4;18;.818;3600000;0
4339;77084;872;0;0;0;0;.00nan;0;0
4339;147567;882;0;0;0;0;.00nan;0;0
4340;11716;875;80;22;1;21;.955;3600000;0
4340;180316;876;0;0;0;0;.00nan;0;0
4340;181123;876;69;31;3;28;.903;3540000;0
4340;78775;875;0;0;0;0;.00nan;0;0
4341;183775;893;79;33;3;30;.909;3600000;0
4341;168712;878;39;28;5;23;.821;3594000;0
4341;63402;893;0;0;0;0;.00nan;0;0
4341;82245;878;0;0;0;0;.00nan;0;0
4342;166751;883;0;0;0;0;.00nan;0;0
4342;11851;892;83;40;3;37;.925;3592000;0
4342;192461;892;0;0;0;0;.00nan;0;0
4342;80834;883;54;15;2;13;.867;3600000;0
4343;162945;886;0;0;0;0;.00nan;0;0
4343;184648;886;84;37;3;34;.919;3776000;0
4343;180731;877;67;33;4;29;.879;3776000;0
4343;91202;877;0;0;0;0;.00nan;0;0
4344;175084;881;0;0;0;0;.00nan;0;0
4344;28833;1415;93;28;1;27;.964;3600000;0
4344;78348;881;63;30;3;27;.900;3522000;0
4344;78920;1415;0;0;0;0;.00nan;0;0
4345;8519;873;0;0;0;0;.00nan;0;0
4345;184398;887;90;49;3;46;.939;3600000;0
4345;69536;873;80;26;1;25;.962;3600000;0
4345;85633;887;0;0;0;0;.00nan;0;0
4346;183775;893;0;0;0;0;.00nan;0;0
4346;179602;872;78;26;1;25;.962;3600000;0
4346;63402;893;58;31;4;27;.871;3600000;0
4346;77084;872;0;0;0;0;.00nan;0;0
4347;162945;886;76;30;3;27;.900;3600000;0
4347;184648;886;0;0;0;0;.00nan;0;0
4347;175084;881;0;0;0;0;.00nan;0;0
4347;78348;881;70;43;5;38;.884;3579000;0
4348;166751;883;66;27;3;24;.889;3837000;0
4348;168712;878;99;42;2;40;.952;3837000;0
4348;80834;883;0;0;0;0;.00nan;0;0
4348;82245;878;0;0;0;0;.00nan;0;0
4349;11716;875;0;0;0;0;.00nan;0;0
4349;11851;892;81;36;3;33;.917;3558000;0
4349;192461;892;0;0;0;0;.00nan;0;0
4349;78775;875;83;33;2;31;.939;3600000;0
4350;180316;876;0;0;0;0;.00nan;0;0
4350;180731;877;55;31;4;27;.871;3782000;0
4350;181123;876;70;31;3;28;.903;3782000;0
4350;91202;877;0;0;0;0;.00nan;0;0
4351;183755;882;84;24;1;23;.958;3600000;0
4351;184398;887;46;40;6;34;.850;3152000;0
4351;85633;887;55;4;0;4;1.000;448000;0
4351;147567;882;0;0;0;0;.00nan;0;0
4352;183755;882;73;40;4;36;.900;3600000;0
4352;180316;876;100;31;0;31;1.000;3600000;0
4352;181123;876;0;0;0;0;.00nan;0;0
4352;147567;882;0;0;0;0;.00nan;0;0
4353;168712;878;40;33;6;27;.818;2898000;0
4353;28833;1415;98;22;0;22;1.000;3600000;0
4353;78920;1415;0;0;0;0;.00nan;0;0
4353;82245;878;63;9;0;9;1.000;702000;0
4354;162945;886;66;35;5;30;.857;3577000;0
4354;183775;893;0;0;0;0;.00nan;0;0
4354;184648;886;0;0;0;0;.00nan;0;0
4354;63402;893;65;32;3;29;.906;3600000;0
4355;166751;883;0;0;0;0;.00nan;0;0
4355;180731;877;77;28;2;26;.929;3600000;0
4355;80834;883;83;39;3;36;.923;3583000;0
4355;91202;877;0;0;0;0;.00nan;0;0
4356;8519;873;0;0;0;0;.00nan;0;0
4356;11851;892;82;36;2;34;.944;3600000;0
4356;192461;892;0;0;0;0;.00nan;0;0
4356;69536;873;71;23;1;22;.957;3600000;0
4357;184398;887;98;44;3;41;.932;3600000;0
4357;179602;872;99;33;1;32;.970;3600000;0
4357;77084;872;0;0;0;0;.00nan;0;0
4357;85633;887;0;0;0;0;.00nan;0;0
4358;11716;875;0;0;0;0;.00nan;0;0
4358;175084;881;0;0;0;0;.00nan;0;0
4358;78348;881;83;24;1;23;.958;3600000;0
4358;78775;875;69;32;2;30;.938;3578000;0
4359;28833;1415;53;32;4;28;.875;3600000;0
4359;180316;876;62;15;1;14;.933;3600000;0
4359;181123;876;0;0;0;0;.00nan;0;0
4359;78920;1415;0;0;0;0;.00nan;0;0
4360;11716;875;55;26;4;22;.846;3557000;0
4360;183775;893;0;0;0;0;.00nan;0;0
4360;63402;893;66;26;3;23;.885;3600000;0
4360;78775;875;0;0;0;0;.00nan;0;0
4361;166751;883;0;0;0;0;.00nan;0;0
4361;175084;881;0;0;0;0;.00nan;0;0
4361;78348;881;62;25;2;23;.920;3587000;0
4361;80834;883;73;21;1;20;.952;3600000;0
4362;168712;878;65;31;3;28;.903;3551000;0
4362;180731;877;0;0;0;0;.00nan;0;0
4362;82245;878;0;0;0;0;.00nan;0;0
4362;91202;877;100;35;1;34;.971;3600000;0
4363;11851;892;0;0;0;0;.00nan;0;0
4363;179602;872;75;30;2;28;.933;3597000;0
4363;192461;892;100;37;0;37;1.000;3600000;0
4363;77084;872;0;0;0;0;.00nan;0;0
4364;162945;886;56;18;2;16;.889;3600000;0
4364;184398;887;55;30;4;26;.867;3519000;0
4364;184648;886;0;0;0;0;.00nan;0;0
4364;85633;887;0;0;0;0;.00nan;0;0
4365;8519;873;0;0;0;0;.00nan;0;0
4365;183755;882;58;33;5;28;.848;3600000;0
4365;69536;873;76;25;1;24;.960;3600000;0
4365;147567;882;0;0;0;0;.00nan;0;0
4366;166751;883;83;39;3;36;.923;3570000;0
4366;28833;1415;66;22;2;20;.909;3600000;0
4366;78920;1415;0;0;0;0;.00nan;0;0
4366;80834;883;0;0;0;0;.00nan;0;0
4367;11716;875;0;0;0;0;.00nan;0;0
4367;179602;872;65;30;4;26;.867;3900000;0
4367;77084;872;0;0;0;0;.00nan;0;0
4367;78775;875;63;31;4;27;.871;3900000;0
4368;8519;873;0;0;0;0;.00nan;0;0
4368;183775;893;0;0;0;0;.00nan;0;0
4368;63402;893;97;24;0;24;1.000;3600000;0
4368;69536;873;66;33;3;30;.909;3600000;0
4369;162945;886;86;28;1;27;.964;3600000;0
4369;183755;882;47;28;4;24;.857;3600000;0
4369;184648;886;0;0;0;0;.00nan;0;0
4369;147567;882;0;0;0;0;.00nan;0;0
4370;11851;892;74;26;2;24;.923;3600000;0
4370;168712;878;72;33;3;30;.909;3600000;0
4370;192461;892;0;0;0;0;.00nan;0;0
4370;82245;878;0;0;0;0;.00nan;0;0
4371;184398;887;59;41;5;36;.878;3600000;0
4371;180731;877;48;29;4;25;.862;3600000;0
4371;85633;887;0;0;0;0;.00nan;0;0
4371;91202;877;0;0;0;0;.00nan;0;0
4372;175084;881;100;25;0;25;1.000;3600000;0
4372;180316;876;0;0;0;0;.00nan;0;0
4372;181123;876;97;45;2;43;.956;3540000;0
4372;78348;881;0;0;0;0;.00nan;0;0
4373;162945;886;83;22;1;21;.955;3600000;0
4373;184648;886;0;0;0;0;.00nan;0;0
4373;180316;876;0;0;0;0;.00nan;0;0
4373;181123;876;68;35;3;32;.914;3559000;0
4374;28833;1415;0;0;0;0;.00nan;0;0
4374;179602;872;57;24;3;21;.875;3600000;0
4374;77084;872;0;0;0;0;.00nan;0;0
4374;78920;1415;59;38;4;34;.895;3576000;0
4375;166751;883;0;0;0;0;.00nan;0;0
4375;183775;893;0;0;0;0;.00nan;0;0
4375;63402;893;48;34;5;29;.853;3600000;0
4375;80834;883;88;37;2;35;.946;3600000;0
4376;168712;878;100;25;0;25;1.000;3600000;0
4376;175084;881;0;0;0;0;.00nan;0;0
4376;78348;881;65;24;2;22;.917;3513000;0
4376;82245;878;0;0;0;0;.00nan;0;0
4377;11716;875;0;0;0;0;.00nan;0;0
4377;184398;887;0;0;0;0;.00nan;0;0
4377;78775;875;31;34;6;28;.824;3600000;0
4377;85633;887;100;35;2;33;.943;3600000;0
4378;8519;873;0;0;0;0;.00nan;0;0
4378;180731;877;0;0;0;0;.00nan;0;0
4378;69536;873;61;32;4;28;.875;3600000;0
4378;91202;877;67;25;3;22;.880;3600000;0
4379;11851;892;50;21;3;18;.857;3543000;0
4379;183755;882;77;28;2;26;.929;3600000;0
4379;192461;892;0;0;0;0;.00nan;0;0
4379;147567;882;0;0;0;0;.00nan;0;0
4380;162945;886;84;28;2;26;.929;3600000;0
4380;184648;886;0;0;0;0;.00nan;0;0
4380;180316;876;0;0;0;0;.00nan;0;0
4380;181123;876;57;33;4;29;.879;3538000;0
4381;179602;872;0;0;0;0;.00nan;0;0
4381;180731;877;70;24;1;23;.958;3763000;0
4381;77084;872;94;43;2;41;.953;3763000;0
4381;91202;877;0;0;0;0;.00nan;0;0
4382;11716;875;48;28;4;24;.857;3518000;0
4382;183775;893;0;0;0;0;.00nan;0;0
4382;63402;893;71;29;2;27;.931;3600000;0
4382;78775;875;0;0;0;0;.00nan;0;0
4383;11851;892;0;0;0;0;.00nan;0;0
4383;28833;1415;52;34;4;30;.882;3579000;0
4383;192461;892;71;24;2;22;.917;3600000;0
4383;78920;1415;0;0;0;0;.00nan;0;0
4384;184398;887;60;31;4;27;.871;3774000;0
4384;175084;881;0;0;0;0;.00nan;0;0
4384;78348;881;67;42;5;37;.881;3774000;0
4384;85633;887;0;0;0;0;.00nan;0;0
4385;162945;886;77;35;2;33;.943;3546000;0
4385;11716;875;0;0;0;0;.00nan;0;0
4385;184648;886;0;0;0;0;.00nan;0;0
4385;78775;875;78;25;1;24;.960;3600000;0
4386;183775;893;48;24;4;20;.833;3900000;0
4386;28833;1415;74;35;4;31;.886;3900000;0
4386;63402;893;0;0;0;0;.00nan;0;0
4386;78920;1415;0;0;0;0;.00nan;0;0
4387;166751;883;85;45;4;41;.911;3600000;0
4387;164661;873;0;0;0;0;.00nan;0;0
4387;28831;873;60;19;2;17;.895;3600000;0
4387;80834;883;0;0;0;0;.00nan;0;0
4388;11851;892;0;0;0;0;.00nan;0;0
4388;180316;876;0;0;0;0;.00nan;0;0
4388;181123;876;91;35;1;34;.971;3600000;0
4388;192461;892;54;20;2;18;.900;3600000;0
4389;183755;882;98;22;0;22;1.000;3600000;0
4389;168712;878;70;28;2;26;.929;3549000;0
4389;82245;878;0;0;0;0;.00nan;0;0
4389;147567;882;0;0;0;0;.00nan;0;0
4390;184398;887;99;31;1;30;.968;3900000;0
4390;175084;881;77;28;1;27;.964;3900000;0
4390;78348;881;0;0;0;0;.00nan;0;0
4390;85633;887;0;0;0;0;.00nan;0;0
4391;166751;883;8;17;6;11;.647;2327000;0
4391;180316;876;0;0;0;0;.00nan;0;0
4391;181123;876;84;16;0;16;1.000;3600000;0
4391;80834;883;51;8;1;7;.875;1273000;0
4392;8519;873;0;0;0;0;.00nan;0;0
4392;11716;875;0;0;0;0;.00nan;0;0
4392;69536;873;63;24;3;21;.875;3588000;0
4392;78775;875;82;29;2;27;.931;3600000;0
4393;162945;886;100;27;0;27;1.000;3600000;0
4393;184648;886;0;0;0;0;.00nan;0;0
4393;28833;1415;83;34;2;32;.941;3600000;0
4393;78920;1415;0;0;0;0;.00nan;0;0
4394;183775;893;48;0;0;0;.00nan;786000;0
4394;168712;878;91;33;2;31;.939;3600000;0
4394;63402;893;36;31;6;25;.806;2814000;0
4394;82245;878;0;0;0;0;.00nan;0;0
4395;11851;892;0;0;0;0;.00nan;0;0
4395;184398;887;100;36;0;36;1.000;3600000;0
4395;192461;892;67;38;4;34;.895;3600000;0
4395;85633;887;0;0;0;0;.00nan;0;0
4396;183755;882;95;43;2;41;.953;3900000;0
4396;180731;877;0;0;0;0;.00nan;0;0
4396;91202;877;76;26;2;24;.923;3900000;0
4396;147567;882;0;0;0;0;.00nan;0;0
4397;11851;892;0;0;0;0;.00nan;0;0
4397;180316;876;66;29;3;26;.897;3900000;0
4397;181123;876;0;0;0;0;.00nan;0;0
4397;192461;892;68;36;3;33;.917;3900000;0
4398;175084;881;0;0;0;0;.00nan;0;0
4398;28833;1415;0;0;0;0;.00nan;0;0
4398;78348;881;75;35;3;32;.914;3537000;0
4398;78920;1415;69;29;2;27;.931;3600000;0
4399;162945;886;54;17;2;15;.882;3544000;0
4399;168712;878;100;50;1;49;.980;3600000;0
4399;184648;886;0;0;0;0;.00nan;0;0
4399;82245;878;0;0;0;0;.00nan;0;0
4400;8519;873;0;0;0;0;.00nan;0;0
4400;184398;887;68;38;4;34;.895;3561000;0
4400;69536;873;89;39;3;36;.923;3600000;0
4400;85633;887;0;0;0;0;.00nan;0;0
4401;166751;883;0;0;0;0;.00nan;0;0
4401;180731;877;54;25;4;21;.840;3566000;0
4401;80834;883;62;24;2;22;.917;3600000;0
4401;91202;877;0;0;0;0;.00nan;0;0
4402;11716;875;0;0;0;0;.00nan;0;0
4402;183755;882;57;30;4;26;.867;3900000;0
4402;78775;875;51;28;4;24;.857;3900000;0
4402;147567;882;0;0;0;0;.00nan;0;0
4403;8519;873;0;0;0;0;.00nan;0;0
4403;180731;877;79;31;2;29;.935;3600000;0
4403;69536;873;62;30;4;26;.867;3514000;0
4403;91202;877;0;0;0;0;.00nan;0;0
4404;179602;872;62;34;4;30;.882;3561000;0
4404;180316;876;0;0;0;0;.00nan;0;0
4404;181123;876;81;28;2;26;.929;3600000;0
4404;77084;872;0;0;0;0;.00nan;0;0
4405;11716;875;75;28;3;25;.893;3588000;0
4405;184398;887;80;33;2;31;.939;3600000;0
4405;78775;875;0;0;0;0;.00nan;0;0
4405;85633;887;0;0;0;0;.00nan;0;0
4406;166751;883;0;0;0;0;.00nan;0;0
4406;162945;886;67;18;1;17;.944;3600000;0
4406;184648;886;0;0;0;0;.00nan;0;0
4406;80834;883;82;37;2;35;.946;3567000;0
4407;168712;878;0;0;0;0;.00nan;0;0
4407;28833;1415;65;19;2;17;.895;3900000;0
4407;78920;1415;0;0;0;0;.00nan;0;0
4407;82245;878;88;45;2;43;.956;3900000;0
4408;11851;892;0;0;0;0;.00nan;0;0
4408;180731;877;83;22;1;21;.955;3600000;0
4408;192461;892;74;31;2;29;.935;3566000;0
4408;91202;877;0;0;0;0;.00nan;0;0
4409;183755;882;78;24;1;23;.958;3600000;0
4409;183775;893;0;0;0;0;.00nan;0;0
4409;63402;893;68;31;3;28;.903;3600000;0
4409;147567;882;0;0;0;0;.00nan;0;0
4410;8519;873;0;0;0;0;.00nan;0;0
4410;175084;881;0;0;0;0;.00nan;0;0
4410;69536;873;97;45;1;44;.978;3600000;0
4410;78348;881;100;26;0;26;1.000;3600000;0
4411;183775;893;0;0;0;0;.00nan;0;0
4411;28833;1415;99;24;0;24;1.000;3600000;0
4411;63402;893;60;23;2;21;.913;3600000;0
4411;78920;1415;0;0;0;0;.00nan;0;0
4412;11716;875;0;0;0;0;.00nan;0;0
4412;11851;892;0;0;0;0;.00nan;0;0
4412;192461;892;68;48;6;42;.875;3829000;0
4412;78775;875;42;32;5;27;.844;3829000;0
4413;166751;883;49;12;2;10;.833;1307000;0
4413;183755;882;86;38;3;35;.921;3600000;0
4413;80834;883;34;18;4;14;.778;2293000;0
4413;147567;882;0;0;0;0;.00nan;0;0
4414;8519;873;89;41;3;38;.927;3600000;0
4414;179602;872;73;27;2;25;.926;3600000;0
4414;69536;873;0;0;0;0;.00nan;0;0
4414;77084;872;0;0;0;0;.00nan;0;0
4415;162945;886;67;24;2;22;.917;3694000;0
4415;184398;887;84;30;1;29;.967;3694000;0
4415;184648;886;0;0;0;0;.00nan;0;0
4415;85633;887;0;0;0;0;.00nan;0;0
4416;168712;878;100;41;0;41;1.000;3600000;0
4416;180316;876;0;0;0;0;.00nan;0;0
4416;181123;876;66;26;2;24;.923;3600000;0
4416;82245;878;0;0;0;0;.00nan;0;0
4417;175084;881;0;0;0;0;.00nan;0;0
4417;180731;877;0;0;0;0;.00nan;0;0
4417;78348;881;100;23;0;23;1.000;3600000;0
4417;91202;877;67;35;3;32;.914;3600000;0
4418;183755;882;0;0;0;0;.00nan;0;0
4418;184398;887;84;29;2;27;.931;3900000;0
4418;85633;887;0;0;0;0;.00nan;0;0
4418;147567;882;85;38;2;36;.947;3900000;0
4419;175084;881;0;0;0;0;.00nan;0;0
4419;180316;876;0;0;0;0;.00nan;0;0
4419;181123;876;55;32;5;27;.844;3600000;0
4419;78348;881;34;35;6;29;.829;3600000;0
4420;168712;878;100;44;0;44;1.000;3600000;0
4420;179602;872;52;20;2;18;.900;3579000;0
4420;77084;872;0;0;0;0;.00nan;0;0
4420;82245;878;0;0;0;0;.00nan;0;0
4421;8519;873;0;0;0;0;.00nan;0;0
4421;183775;893;0;0;0;0;.00nan;0;0
4421;63402;893;86;36;3;33;.917;3600000;0
4421;69536;873;54;29;4;25;.862;3600000;0
4422;162945;886;59;26;3;23;.885;3600000;0
4422;11716;875;68;39;4;35;.897;3558000;0
4422;184648;886;0;0;0;0;.00nan;0;0
4422;78775;875;0;0;0;0;.00nan;0;0
4423;166751;883;71;26;1;25;.962;3600000;0
4423;11851;892;0;0;0;0;.00nan;0;0
4423;192461;892;80;38;3;35;.921;3587000;0
4423;80834;883;0;0;0;0;.00nan;0;0
4424;183755;882;76;30;2;28;.933;3549000;0
4424;184398;887;92;33;1;32;.970;3600000;0
4424;85633;887;0;0;0;0;.00nan;0;0
4424;147567;882;0;0;0;0;.00nan;0;0
4425;28833;1415;77;26;2;24;.923;3560000;0
4425;180731;877;86;31;1;30;.968;3600000;0
4425;78920;1415;0;0;0;0;.00nan;0;0
4425;91202;877;0;0;0;0;.00nan;0;0
4426;184398;887;90;27;1;26;.963;3900000;0
4426;179602;872;79;34;1;33;.971;3900000;0
4426;77084;872;0;0;0;0;.00nan;0;0
4426;85633;887;0;0;0;0;.00nan;0;0
4427;166751;883;0;0;0;0;.00nan;0;0
4427;28833;1415;26;15;4;11;.733;3537000;0
4427;78920;1415;0;0;0;0;.00nan;0;0
4427;80834;883;70;27;2;25;.926;3600000;0
4428;8519;873;0;0;0;0;.00nan;0;0
4428;168712;878;63;35;4;31;.886;3569000;0
4428;69536;873;50;14;2;12;.857;3600000;0
4428;82245;878;0;0;0;0;.00nan;0;0
4429;162945;886;69;21;1;20;.952;3600000;0
4429;11851;892;72;16;0;16;1.000;742000;0
4429;184648;886;0;0;0;0;.00nan;0;0
4429;192461;892;32;30;6;24;.800;2858000;0
4430;183775;893;0;0;0;0;.00nan;0;0
4430;180731;877;0;0;0;0;.00nan;0;0
4430;63402;893;95;31;1;30;.968;3600000;0
4430;91202;877;83;33;2;31;.939;3541000;0
4431;183755;882;58;29;4;25;.862;3600000;0
4431;180316;876;0;0;0;0;.00nan;0;0
4431;181123;876;80;38;3;35;.921;3600000;0
4431;147567;882;0;0;0;0;.00nan;0;0
4432;11716;875;0;0;0;0;.00nan;0;0
4432;175084;881;0;0;0;0;.00nan;0;0
4432;78348;881;62;32;3;29;.906;3545000;0
4432;78775;875;91;37;2;35;.946;3600000;0
4433;8519;873;0;0;0;0;.00nan;0;0
4433;28833;1415;91;18;0;18;1.000;3600000;0
4433;69536;873;71;38;3;35;.921;3600000;0
4433;78920;1415;0;0;0;0;.00nan;0;0
4434;180316;876;0;0;0;0;.00nan;0;0
4434;180731;877;87;39;2;37;.949;3600000;0
4434;181123;876;57;25;3;22;.880;3549000;0
4434;91202;877;0;0;0;0;.00nan;0;0
4435;8519;873;0;0;0;0;.00nan;0;0
4435;28833;1415;61;17;2;15;.882;3668000;0
4435;69536;873;89;42;3;39;.929;3668000;0
4435;78920;1415;0;0;0;0;.00nan;0;0
4436;11716;875;0;0;0;0;.00nan;0;0
4436;183775;893;0;0;0;0;.00nan;0;0
4436;63402;893;72;26;2;24;.923;3600000;0
4436;78775;875;66;38;4;34;.895;3584000;0
4437;11851;892;0;0;0;0;.00nan;0;0
4437;168712;878;91;40;3;37;.925;3600000;0
4437;192461;892;43;22;4;18;.818;3562000;0
4437;82245;878;0;0;0;0;.00nan;0;0
4438;166751;883;47;22;3;19;.864;3747000;0
4438;184398;887;71;44;4;40;.909;3747000;0
4438;80834;883;0;0;0;0;.00nan;0;0
4438;85633;887;0;0;0;0;.00nan;0;0
4439;183755;882;100;38;1;37;.974;3900000;0
4439;179602;872;96;43;1;42;.977;3900000;0
4439;77084;872;0;0;0;0;.00nan;0;0
4439;147567;882;0;0;0;0;.00nan;0;0
4440;162945;886;49;29;5;24;.828;3006000;0
4440;184648;886;51;3;0;3;1.000;594000;0
4440;175084;881;78;25;1;24;.960;3600000;0
4440;78348;881;0;0;0;0;.00nan;0;0
4441;184398;887;95;38;1;37;.974;3567000;0
4441;180316;876;0;0;0;0;.00nan;0;0
4441;181123;876;100;28;0;28;1.000;3600000;0
4441;85633;887;0;0;0;0;.00nan;0;0
4442;11716;875;0;0;0;0;.00nan;0;0
4442;28833;1415;44;24;5;19;.792;3600000;0
4442;78775;875;80;35;2;33;.943;3600000;0
4442;78920;1415;0;0;0;0;.00nan;0;0
4443;166751;883;61;29;3;26;.897;3900000;0
4443;8519;873;0;0;0;0;.00nan;0;0
4443;69536;873;78;36;3;33;.917;3900000;0
4443;80834;883;0;0;0;0;.00nan;0;0
4444;162945;886;0;0;0;0;.00nan;0;0
4444;183775;893;0;0;0;0;.00nan;0;0
4444;184648;886;59;21;2;19;.905;3600000;0
4444;63402;893;72;47;5;42;.894;3600000;0
4445;11851;892;100;42;2;40;.952;3600000;0
4445;183755;882;51;23;3;20;.870;3561000;0
4445;192461;892;0;0;0;0;.00nan;0;0
4445;147567;882;0;0;0;0;.00nan;0;0
4446;179602;872;46;31;6;25;.806;3795000;0
4446;180731;877;0;0;0;0;.00nan;0;0
4446;77084;872;0;0;0;0;.00nan;0;0
4446;91202;877;31;26;5;21;.808;3799000;0
4447;168712;878;88;45;3;42;.933;3560000;0
4447;175084;881;0;0;0;0;.00nan;0;0
4447;78348;881;70;17;1;16;.941;3600000;0
4447;82245;878;0;0;0;0;.00nan;0;0
4448;183755;882;78;31;2;29;.935;3900000;0
4448;180316;876;0;0;0;0;.00nan;0;0
4448;181123;876;67;24;2;22;.917;3900000;0
4448;147567;882;0;0;0;0;.00nan;0;0
4449;166751;883;53;32;5;27;.844;3600000;0
4449;175084;881;0;0;0;0;.00nan;0;0
4449;78348;881;73;24;1;23;.958;3600000;0
4449;80834;883;0;0;0;0;.00nan;0;0
4450;168712;878;77;42;4;38;.905;3600000;0
4450;179602;872;0;0;0;0;.00nan;0;0
4450;77084;872;19;15;5;10;.667;3575000;0
4450;82245;878;0;0;0;0;.00nan;0;0
4451;11851;892;100;21;0;21;1.000;3600000;0
4451;179602;872;0;0;0;0;.00nan;0;0
4451;192461;892;0;0;0;0;.00nan;0;0
4451;77084;872;50;30;4;26;.867;3600000;0
4452;184398;887;100;28;0;28;1.000;3600000;0
4452;28833;1415;73;34;3;31;.912;3600000;0
4452;78920;1415;0;0;0;0;.00nan;0;0
4452;85633;887;0;0;0;0;.00nan;0;0
4453;183775;893;67;18;1;17;.944;3600000;0
4453;175084;881;0;0;0;0;.00nan;0;0
4453;63402;893;0;0;0;0;.00nan;0;0
4453;78348;881;100;34;0;34;1.000;3600000;0
4454;166751;883;0;0;0;0;.00nan;0;0
4454;11716;875;0;0;0;0;.00nan;0;0
4454;78775;875;60;22;2;20;.909;3543000;0
4454;80834;883;98;36;1;35;.972;3600000;0
4455;8519;873;0;0;0;0;.00nan;0;0
4455;180316;876;0;0;0;0;.00nan;0;0
4455;181123;876;67;20;2;18;.900;3600000;0
4455;69536;873;100;40;1;39;.975;3600000;0
4456;168712;878;86;31;2;29;.935;3587000;0
4456;180731;877;82;27;1;26;.963;3600000;0
4456;82245;878;0;0;0;0;.00nan;0;0
4456;91202;877;0;0;0;0;.00nan;0;0
4457;162945;886;57;25;3;22;.880;3600000;0
4457;183755;882;37;42;7;35;.833;3600000;0
4457;184648;886;0;0;0;0;.00nan;0;0
4457;147567;882;0;0;0;0;.00nan;0;0
4458;11716;875;0;0;0;0;.00nan;0;0
4458;180316;876;0;0;0;0;.00nan;0;0
4458;181123;876;59;32;4;28;.875;3900000;0
4458;78775;875;72;38;4;34;.895;3900000;0
4459;28833;1415;87;27;1;26;.963;3545000;0
4459;179602;872;100;34;0;34;1.000;3600000;0
4459;77084;872;0;0;0;0;.00nan;0;0
4459;78920;1415;0;0;0;0;.00nan;0;0
4460;166751;883;0;0;0;0;.00nan;0;0
4460;183775;893;0;0;0;0;.00nan;0;0
4460;63402;893;53;33;4;29;.879;3600000;0
4460;80834;883;69;20;1;19;.950;3600000;0
4461;162945;886;99;25;0;25;1.000;3600000;0
4461;8519;873;0;0;0;0;.00nan;0;0
4461;184648;886;0;0;0;0;.00nan;0;0
4461;69536;873;58;29;3;26;.897;3600000;0
4462;183755;882;59;18;3;15;.833;3900000;0
4462;168712;878;61;29;3;26;.897;3900000;0
4462;82245;878;0;0;0;0;.00nan;0;0
4462;147567;882;0;0;0;0;.00nan;0;0
4463;11851;892;100;25;0;25;1.000;3600000;0
4463;175084;881;0;0;0;0;.00nan;0;0
4463;192461;892;0;0;0;0;.00nan;0;0
4463;78348;881;54;52;6;46;.885;3600000;0
4464;184398;887;82;32;2;30;.938;3900000;0
4464;180731;877;99;44;2;42;.955;3900000;0
4464;85633;887;0;0;0;0;.00nan;0;0
4464;91202;877;0;0;0;0;.00nan;0;0
4465;28833;1415;88;29;2;27;.931;3551000;0
4465;180316;876;0;0;0;0;.00nan;0;0
4465;181123;876;61;16;1;15;.938;3600000;0
4465;78920;1415;0;0;0;0;.00nan;0;0
4466;11716;875;0;0;0;0;.00nan;0;0
4466;180731;877;73;36;3;33;.917;3900000;0
4466;78775;875;69;30;3;27;.900;3900000;0
4466;91202;877;0;0;0;0;.00nan;0;0
4467;11851;892;96;22;0;22;1.000;3600000;0
4467;183775;893;0;0;0;0;.00nan;0;0
4467;192461;892;0;0;0;0;.00nan;0;0
4467;63402;893;97;38;1;37;.974;3558000;0
4468;8519;873;0;0;0;0;.00nan;0;0
4468;183755;882;73;26;2;24;.923;3545000;0
4468;69536;873;92;34;1;33;.971;3600000;0
4468;147567;882;0;0;0;0;.00nan;0;0
4469;162945;886;52;30;4;26;.867;3900000;0
4469;184648;886;0;0;0;0;.00nan;0;0
4469;179602;872;70;46;4;42;.913;3900000;0
4469;77084;872;0;0;0;0;.00nan;0;0
4470;168712;878;75;43;3;40;.930;3600000;0
4470;184398;887;65;18;2;16;.889;3600000;0
4470;82245;878;0;0;0;0;.00nan;0;0
4470;85633;887;0;0;0;0;.00nan;0;0
4471;166751;883;74;28;2;26;.929;3900000;0
4471;175084;881;0;0;0;0;.00nan;0;0
4471;78348;881;91;43;2;41;.953;3900000;0
4471;80834;883;0;0;0;0;.00nan;0;0
4472;183775;893;0;0;0;0;.00nan;0;0
4472;180316;876;0;0;0;0;.00nan;0;0
4472;181123;876;47;26;4;22;.846;3600000;0
4472;63402;893;51;32;5;27;.844;3557000;0
4473;11716;875;58;6;0;6;1.000;289000;0
4473;179602;872;38;15;3;12;.800;3600000;0
4473;77084;872;0;0;0;0;.00nan;0;0
4473;78775;875;28;26;6;20;.769;3311000;0
4474;166751;883;67;18;2;16;.889;3600000;0
4474;168712;878;84;44;3;41;.932;3575000;0
4474;80834;883;0;0;0;0;.00nan;0;0
4474;82245;878;0;0;0;0;.00nan;0;0
4475;8519;873;0;0;0;0;.00nan;0;0
4475;11851;892;100;30;0;30;1.000;3600000;0
4475;192461;892;0;0;0;0;.00nan;0;0
4475;69536;873;85;26;1;25;.962;3600000;0
4476;184398;887;71;27;2;25;.926;3600000;0
4476;175084;881;0;0;0;0;.00nan;0;0
4476;78348;881;74;33;3;30;.909;3600000;0
4476;85633;887;0;0;0;0;.00nan;0;0
4477;162945;886;88;38;2;36;.947;3531000;0
4477;184648;886;0;0;0;0;.00nan;0;0
4477;180731;877;100;35;0;35;1.000;3600000;0
4477;91202;877;0;0;0;0;.00nan;0;0
4478;183755;882;0;0;0;0;.00nan;0;0
4478;28833;1415;80;25;1;24;.960;3600000;0
4478;78920;1415;0;0;0;0;.00nan;0;0
4478;147567;882;54;23;3;20;.870;3542000;0
4479;166751;883;91;34;2;32;.941;3600000;0
4479;179602;872;64;27;3;24;.889;3550000;0
4479;77084;872;0;0;0;0;.00nan;0;0
4479;80834;883;0;0;0;0;.00nan;0;0
4480;11851;892;43;25;4;21;.840;3593000;0
4480;28833;1415;0;0;0;0;.00nan;0;0
4480;192461;892;0;0;0;0;.00nan;0;0
4480;78920;1415;86;28;2;26;.929;3600000;0
4481;11716;875;75;24;3;21;.875;3900000;0
4481;168712;878;73;29;3;26;.897;3900000;0
4481;78775;875;0;0;0;0;.00nan;0;0
4481;82245;878;0;0;0;0;.00nan;0;0
4482;183775;893;0;0;0;0;.00nan;0;0
4482;184398;887;40;27;5;22;.815;3600000;0
4482;63402;893;92;40;2;38;.950;3600000;0
4482;85633;887;0;0;0;0;.00nan;0;0
4483;8519;873;0;0;0;0;.00nan;0;0
4483;180731;877;100;24;0;24;1.000;3600000;0
4483;69536;873;79;36;2;34;.944;3593000;0
4483;91202;877;0;0;0;0;.00nan;0;0
4484;162945;886;86;29;1;28;.966;3600000;0
4484;184648;886;0;0;0;0;.00nan;0;0
4484;180316;876;0;0;0;0;.00nan;0;0
4484;181123;876;61;36;4;32;.889;3600000;0
4485;183755;882;97;43;1;42;.977;3600000;0
4485;175084;881;57;16;2;14;.875;3570000;0
4485;78348;881;0;0;0;0;.00nan;0;0
4485;147567;882;0;0;0;0;.00nan;0;0
4486;28833;1415;100;37;1;36;.973;3600000;0
4486;180316;876;0;0;0;0;.00nan;0;0
4486;181123;876;76;27;2;25;.926;3553000;0
4486;78920;1415;0;0;0;0;.00nan;0;0
4487;183755;882;97;50;2;48;.960;3593000;0
4487;179602;872;76;24;1;23;.958;3600000;0
4487;77084;872;0;0;0;0;.00nan;0;0
4487;147567;882;0;0;0;0;.00nan;0;0
4488;166751;883;65;35;3;32;.914;3524000;0
4488;28831;873;0;0;0;0;.00nan;0;0
4488;69536;873;92;23;1;22;.957;3600000;0
4488;80834;883;0;0;0;0;.00nan;0;0
4489;162945;886;76;24;2;22;.917;3600000;0
4489;168712;878;88;36;3;33;.917;3542000;0
4489;184648;886;0;0;0;0;.00nan;0;0
4489;82245;878;0;0;0;0;.00nan;0;0
4490;11851;892;0;0;0;0;.00nan;0;0
4490;183775;893;0;0;0;0;.00nan;0;0
4490;192461;892;96;21;0;21;1.000;3600000;0
4490;63402;893;81;25;1;24;.960;3581000;0
4491;11716;875;0;0;0;0;.00nan;0;0
4491;180731;877;17;23;7;16;.696;2668000;0
4491;78775;875;75;44;4;40;.909;3600000;0
4491;91202;877;35;9;3;6;.667;932000;0
4492;175084;881;0;0;0;0;.00nan;0;0
4492;179602;872;0;0;0;0;.00nan;0;0
4492;77084;872;72;42;3;39;.929;3550000;0
4492;78348;881;86;36;2;34;.944;3600000;0
4493;166751;883;65;30;3;27;.900;3900000;0
4493;28833;1415;79;34;3;31;.912;3900000;0
4493;78920;1415;0;0;0;0;.00nan;0;0
4493;80834;883;0;0;0;0;.00nan;0;0
4494;11716;875;88;53;3;50;.943;3600000;0
4494;180316;876;0;0;0;0;.00nan;0;0
4494;181123;876;37;29;5;24;.828;3558000;0
4494;78775;875;0;0;0;0;.00nan;0;0
4495;183775;893;61;30;4;26;.867;3600000;0
4495;180731;877;100;36;0;36;1.000;3600000;0
4495;63402;893;0;0;0;0;.00nan;0;0
4495;91202;877;0;0;0;0;.00nan;0;0
4496;162945;886;68;17;1;16;.941;3600000;0
4496;11851;892;0;0;0;0;.00nan;0;0
4496;184648;886;0;0;0;0;.00nan;0;0
4496;192461;892;72;34;3;31;.912;3600000;0
4497;168712;878;57;30;4;26;.867;3575000;0
4497;184398;887;58;22;2;20;.909;3600000;0
4497;82245;878;0;0;0;0;.00nan;0;0
4497;85633;887;0;0;0;0;.00nan;0;0
4498;183755;882;69;37;3;34;.919;3600000;0
4498;28831;873;0;0;0;0;.00nan;0;0
4498;69536;873;100;25;0;25;1.000;3600000;0
4498;147567;882;0;0;0;0;.00nan;0;0
4499;28833;1415;49;28;3;25;.893;3900000;0
4499;180731;877;81;31;3;28;.903;3896000;0
4499;78920;1415;0;0;0;0;.00nan;0;0
4499;91202;877;0;0;0;0;.00nan;0;0
4500;11716;875;85;42;4;38;.905;3583000;0
4500;175084;881;0;0;0;0;.00nan;0;0
4500;78348;881;95;46;3;43;.935;3600000;0
4500;78775;875;0;0;0;0;.00nan;0;0
4501;166751;883;0;0;0;0;.00nan;0;0
4501;183775;893;0;0;0;0;.00nan;0;0
4501;63402;893;79;36;2;34;.944;3600000;0
4501;80834;883;59;34;3;31;.912;3600000;0
4502;168712;878;86;38;3;35;.921;3575000;0
4502;28831;873;0;0;0;0;.00nan;0;0
4502;69536;873;63;20;2;18;.900;3600000;0
4502;82245;878;0;0;0;0;.00nan;0;0
4503;162945;886;68;21;2;19;.905;3600000;0
4503;183755;882;79;41;3;38;.927;3600000;0
4503;184648;886;0;0;0;0;.00nan;0;0
4503;147567;882;0;0;0;0;.00nan;0;0
4504;11851;892;77;38;4;34;.895;3585000;0
4504;179602;872;71;27;2;25;.926;3600000;0
4504;192461;892;0;0;0;0;.00nan;0;0
4504;77084;872;0;0;0;0;.00nan;0;0
4505;184398;887;42;20;4;16;.800;2154000;0
4505;180316;876;0;0;0;0;.00nan;0;0
4505;181123;876;61;30;3;27;.900;3600000;0
4505;85633;887;61;13;1;12;.923;1434000;0
4506;183755;882;66;25;2;23;.920;3543000;0
4506;28833;1415;100;27;0;27;1.000;3600000;0
4506;78920;1415;0;0;0;0;.00nan;0;0
4506;147567;882;0;0;0;0;.00nan;0;0
4507;166751;883;0;0;0;0;.00nan;0;0
4507;11851;892;61;30;3;27;.900;3600000;0
4507;192461;892;0;0;0;0;.00nan;0;0
4507;80834;883;89;19;0;19;1.000;3600000;0
4508;183775;893;0;0;0;0;.00nan;0;0
4508;28831;873;0;0;0;0;.00nan;0;0
4508;63402;893;77;35;3;32;.914;3900000;0
4508;69536;873;75;32;3;29;.906;3900000;0
4509;162945;886;82;28;1;27;.964;3600000;0
4509;184648;886;0;0;0;0;.00nan;0;0
4509;180731;877;67;36;4;32;.889;3600000;0
4509;91202;877;0;0;0;0;.00nan;0;0
4510;11716;875;0;0;0;0;.00nan;0;0
4510;168712;878;0;0;0;0;.00nan;0;0
4510;78775;875;60;22;2;20;.909;3600000;0
4510;82245;878;58;50;6;44;.880;3600000;0
4511;184398;887;96;33;1;32;.970;3600000;0
4511;179602;872;65;31;3;28;.903;3516000;0
4511;77084;872;0;0;0;0;.00nan;0;0
4511;85633;887;0;0;0;0;.00nan;0;0
4512;175084;881;0;0;0;0;.00nan;0;0
4512;180316;876;0;0;0;0;.00nan;0;0
4512;181123;876;80;32;2;30;.938;3583000;0
4512;78348;881;87;12;0;12;1.000;3600000;0
4513;168712;878;88;22;1;21;.955;3600000;0
4513;180316;876;0;0;0;0;.00nan;0;0
4513;181123;876;69;22;2;20;.909;3545000;0
4513;82245;878;0;0;0;0;.00nan;0;0
4514;28833;1415;58;39;5;34;.872;3600000;0
4514;179602;872;65;18;1;17;.944;3600000;0
4514;77084;872;0;0;0;0;.00nan;0;0
4514;78920;1415;0;0;0;0;.00nan;0;0
4515;166751;883;0;0;0;0;.00nan;0;0
4515;11716;875;0;0;0;0;.00nan;0;0
4515;78775;875;86;27;1;26;.963;3600000;0
4515;80834;883;80;29;2;27;.931;3566000;0
4516;162945;886;64;20;2;18;.900;3600000;0
4516;183775;893;51;37;5;32;.865;3600000;0
4516;184648;886;0;0;0;0;.00nan;0;0
4516;63402;893;0;0;0;0;.00nan;0;0
4517;184398;887;83;39;2;37;.949;3600000;0
4517;28831;873;0;0;0;0;.00nan;0;0
4517;69536;873;50;34;5;29;.853;3600000;0
4517;85633;887;0;0;0;0;.00nan;0;0
4518;11851;892;80;36;3;33;.917;3590000;0
4518;180731;877;0;0;0;0;.00nan;0;0
4518;192461;892;0;0;0;0;.00nan;0;0
4518;91202;877;74;29;2;27;.931;3600000;0
4519;183755;882;0;0;0;0;.00nan;0;0
4519;175084;881;0;0;0;0;.00nan;0;0
4519;78348;881;77;36;4;32;.889;3566000;0
4519;147567;882;54;26;3;23;.885;3600000;0
4520;28831;873;0;0;0;0;.00nan;0;0
4520;179602;872;0;0;0;0;.00nan;0;0
4520;69536;873;72;39;4;35;.897;3599000;0
4520;77084;872;85;36;2;34;.944;3600000;0
4521;183775;893;48;0;0;0;.00nan;341000;0
4521;180316;876;0;0;0;0;.00nan;0;0
4521;181123;876;57;23;3;20;.870;3600000;0
4521;63402;893;71;47;6;41;.872;3259000;0
4522;166751;883;0;0;0;0;.00nan;0;0
4522;180731;877;91;28;1;27;.964;3600000;0
4522;80834;883;81;35;2;33;.943;3600000;0
4522;91202;877;0;0;0;0;.00nan;0;0
4523;162945;886;49;18;3;15;.833;3600000;0
4523;184648;886;0;0;0;0;.00nan;0;0
4523;175084;881;0;0;0;0;.00nan;0;0
4523;78348;881;53;27;4;23;.852;3600000;0
4524;11716;875;0;0;0;0;.00nan;0;0
4524;11851;892;0;0;0;0;.00nan;0;0
4524;192461;892;61;21;2;19;.905;3553000;0
4524;78775;875;86;28;1;27;.964;3600000;0
4525;184398;887;69;38;4;34;.895;3517000;0
4525;28833;1415;68;24;2;22;.917;3600000;0
4525;78920;1415;0;0;0;0;.00nan;0;0
4525;85633;887;0;0;0;0;.00nan;0;0
4526;183755;882;79;13;0;13;1.000;3900000;0
4526;168712;878;98;32;0;32;1.000;3900000;0
4526;82245;878;0;0;0;0;.00nan;0;0
4526;147567;882;0;0;0;0;.00nan;0;0
4527;162945;886;53;24;3;21;.875;3515000;0
4527;184648;886;0;0;0;0;.00nan;0;0
4527;28833;1415;100;41;1;40;.976;3600000;0
4527;78920;1415;0;0;0;0;.00nan;0;0
4528;11716;875;0;0;0;0;.00nan;0;0
4528;179602;872;0;0;0;0;.00nan;0;0
4528;77084;872;76;29;2;27;.931;3600000;0
4528;78775;875;48;31;5;26;.839;3600000;0
4529;11851;892;43;27;4;23;.852;3600000;0
4529;28831;873;0;0;0;0;.00nan;0;0
4529;192461;892;0;0;0;0;.00nan;0;0
4529;69536;873;100;45;0;45;1.000;3600000;0
4530;166751;883;0;0;0;0;.00nan;0;0
4530;168712;878;64;46;5;41;.891;3600000;0
4530;80834;883;88;18;0;18;1.000;3600000;0
4530;82245;878;0;0;0;0;.00nan;0;0
4531;184398;887;71;46;4;42;.913;3600000;0
4531;180731;877;98;22;0;22;1.000;3600000;0
4531;85633;887;0;0;0;0;.00nan;0;0
4531;91202;877;0;0;0;0;.00nan;0;0
4532;183775;893;70;32;3;29;.906;3561000;0
4532;175084;881;0;0;0;0;.00nan;0;0
4532;63402;893;0;0;0;0;.00nan;0;0
4532;78348;881;64;21;2;19;.905;3600000;0
4533;162945;886;74;8;0;8;1.000;3600000;0
4533;184648;886;0;0;0;0;.00nan;0;0
4533;179602;872;92;43;2;41;.953;3588000;0
4533;77084;872;0;0;0;0;.00nan;0;0
4534;11716;875;0;0;0;0;.00nan;0;0
4534;28831;873;0;0;0;0;.00nan;0;0
4534;69536;873;97;39;2;37;.949;3562000;0
4534;78775;875;93;29;1;28;.966;3600000;0
4535;183775;893;0;0;0;0;.00nan;0;0
4535;28833;1415;76;31;3;28;.903;3900000;0
4535;63402;893;55;26;3;23;.885;3900000;0
4535;78920;1415;0;0;0;0;.00nan;0;0
4536;166751;883;0;0;0;0;.00nan;0;0
4536;184398;887;83;27;1;26;.963;3600000;0
4536;80834;883;72;27;2;25;.926;3549000;0
4536;85633;887;0;0;0;0;.00nan;0;0
4537;168712;878;84;29;1;28;.966;3600000;0
4537;175084;881;0;0;0;0;.00nan;0;0
4537;78348;881;66;31;3;28;.903;3552000;0
4537;82245;878;0;0;0;0;.00nan;0;0
4538;11851;892;78;42;4;38;.905;3617000;0
4538;180316;876;0;0;0;0;.00nan;0;0
4538;181123;876;58;21;3;18;.857;3617000;0
4538;192461;892;0;0;0;0;.00nan;0;0
4539;183755;882;52;37;4;33;.892;3600000;0
4539;180731;877;45;30;5;25;.833;3593000;0
4539;91202;877;0;0;0;0;.00nan;0;0
4539;147567;882;0;0;0;0;.00nan;0;0
4540;183775;893;0;0;0;0;.00nan;0;0
4540;179602;872;0;0;0;0;.00nan;0;0
4540;63402;893;62;32;4;28;.875;3600000;0
4540;77084;872;72;16;1;15;.938;3600000;0
4541;168712;878;74;40;3;37;.925;3546000;0
4541;28833;1415;74;20;1;19;.950;3600000;0
4541;78920;1415;0;0;0;0;.00nan;0;0
4541;82245;878;0;0;0;0;.00nan;0;0
4542;175084;881;0;0;0;0;.00nan;0;0
4542;28831;873;0;0;0;0;.00nan;0;0
4542;69536;873;100;34;0;34;1.000;3900000;0
4542;78348;881;97;40;0;40;1.000;3900000;0
4543;166751;883;0;0;0;0;.00nan;0;0
4543;162945;886;60;20;3;17;.850;3600000;0
4543;184648;886;0;0;0;0;.00nan;0;0
4543;80834;883;87;49;4;45;.918;3547000;0
4544;11716;875;0;0;0;0;.00nan;0;0
4544;184398;887;0;0;0;0;.00nan;0;0
4544;78775;875;100;29;0;29;1.000;3600000;0
4544;85633;887;50;21;3;18;.857;3600000;0
4545;180316;876;0;0;0;0;.00nan;0;0
4545;180731;877;96;41;2;39;.951;3600000;0
4545;181123;876;76;24;1;23;.958;3600000;0
4545;91202;877;0;0;0;0;.00nan;0;0
4546;11851;892;47;30;4;26;.867;3600000;0
4546;183755;882;90;31;1;30;.968;3600000;0
4546;192461;892;0;0;0;0;.00nan;0;0
4546;147567;882;0;0;0;0;.00nan;0;0
4547;28831;873;0;0;0;0;.00nan;0;0
4547;180316;876;48;24;4;20;.833;3747000;0
4547;181123;876;0;0;0;0;.00nan;0;0
4547;69536;873;91;43;3;40;.930;3747000;0
4548;162945;886;68;34;5;29;.853;3600000;0
4548;11716;875;40;3;1;2;.667;401000;0
4548;184648;886;0;0;0;0;.00nan;0;0
4548;78775;875;29;35;6;29;.829;3179000;0
4549;183755;882;27;6;3;3;.500;388000;0
4549;183775;893;87;28;1;27;.964;3600000;0
4549;63402;893;0;0;0;0;.00nan;0;0
4549;147567;882;97;25;0;25;1.000;3149000;0
4550;166751;883;0;0;0;0;.00nan;0;0
4550;179602;872;62;21;2;19;.905;3600000;0
4550;77084;872;0;0;0;0;.00nan;0;0
4550;80834;883;65;44;5;39;.886;3600000;0
4551;168712;878;68;33;3;30;.909;3579000;0
4551;180731;877;78;30;2;28;.933;3600000;0
4551;82245;878;0;0;0;0;.00nan;0;0
4551;91202;877;0;0;0;0;.00nan;0;0
4552;11851;892;31;39;7;32;.821;3529000;0
4552;184398;887;26;5;3;2;.400;464000;0
4552;192461;892;0;0;0;0;.00nan;0;0
4552;85633;887;56;23;3;20;.870;3136000;0
4553;175084;881;0;0;0;0;.00nan;0;0
4553;28833;1415;84;38;2;36;.947;3900000;0
4553;78348;881;75;27;2;25;.926;3900000;0
4553;78920;1415;0;0;0;0;.00nan;0;0
4554;179602;872;0;0;0;0;.00nan;0;0
4554;180316;876;0;0;0;0;.00nan;0;0
4554;181123;876;56;31;4;27;.871;3600000;0
4554;77084;872;100;23;0;23;1.000;3600000;0
4555;11716;875;0;0;0;0;.00nan;0;0
4555;28833;1415;28;21;5;16;.762;3559000;0
4555;78775;875;59;34;3;31;.912;3600000;0
4555;78920;1415;0;0;0;0;.00nan;0;0
4556;162945;886;92;29;1;28;.966;3900000;0
4556;184648;886;0;0;0;0;.00nan;0;0
4556;28831;873;0;0;0;0;.00nan;0;0
4556;69536;873;96;44;1;43;.977;3900000;0
4557;11851;892;83;33;2;31;.939;3571000;0
4557;168712;878;100;31;1;30;.968;3600000;0
4557;192461;892;0;0;0;0;.00nan;0;0
4557;82245;878;0;0;0;0;.00nan;0;0
4558;183775;893;0;0;0;0;.00nan;0;0
4558;184398;887;31;9;3;6;.667;380000;0
4558;63402;893;81;27;1;26;.963;3600000;0
4558;85633;887;63;29;3;26;.897;3220000;0
4559;175084;881;0;0;0;0;.00nan;0;0
4559;180731;877;98;46;3;43;.935;3600000;0
4559;78348;881;100;38;0;38;1.000;3600000;0
4559;91202;877;0;0;0;0;.00nan;0;0
4560;166751;883;0;0;0;0;.00nan;0;0
4560;183755;882;66;16;1;15;.938;3600000;0
4560;80834;883;60;19;2;17;.895;3544000;0
4560;147567;882;0;0;0;0;.00nan;0;0
4561;166751;883;0;0;0;0;.00nan;0;0
4561;180316;876;0;0;0;0;.00nan;0;0
4561;181123;876;77;24;1;23;.958;3600000;0
4561;80834;883;29;35;7;28;.800;3600000;0
4562;179602;872;0;0;0;0;.00nan;0;0
4562;180731;877;66;39;4;35;.897;3584000;0
4562;77084;872;60;21;2;19;.905;3600000;0
4562;91202;877;0;0;0;0;.00nan;0;0
4563;11716;875;79;12;0;12;1.000;3600000;0
4563;183755;882;76;56;5;51;.911;3600000;0
4563;78775;875;0;0;0;0;.00nan;0;0
4563;147567;882;0;0;0;0;.00nan;0;0
4564;183775;893;54;27;3;24;.889;3592000;0
4564;168712;878;85;35;2;33;.943;3600000;0
4564;63402;893;0;0;0;0;.00nan;0;0
4564;82245;878;0;0;0;0;.00nan;0;0
4565;28831;873;0;0;0;0;.00nan;0;0
4565;28833;1415;75;30;2;28;.933;3543000;0
4565;69536;873;100;32;1;31;.969;3600000;0
4565;78920;1415;0;0;0;0;.00nan;0;0
4566;162945;886;99;36;1;35;.972;3900000;0
4566;184398;887;96;39;1;38;.974;3900000;0
4566;184648;886;0;0;0;0;.00nan;0;0
4566;85633;887;0;0;0;0;.00nan;0;0
4567;11851;892;92;36;2;34;.944;3743000;0
4567;175084;881;0;0;0;0;.00nan;0;0
4567;192461;892;0;0;0;0;.00nan;0;0
4567;78348;881;67;18;1;17;.944;3743000;0
4571;8519;873;0;0;0;0;.00nan;0;0
4571;11670;887;0;0;0;0;.00nan;0;0
4571;184398;887;71;34;3;31;.912;3900000;0
4571;69536;873;56;25;3;22;.880;3900000;0
4575;11851;892;0;0;0;0;.00nan;0;0
4575;183755;882;82;25;1;24;.960;3600000;0
4575;192461;892;48;33;5;28;.848;3600000;0
4575;147567;882;0;0;0;0;.00nan;0;0
4579;166751;883;73;31;3;28;.903;3627000;0
4579;183775;893;61;26;2;24;.923;3627000;0
4579;63402;893;0;0;0;0;.00nan;0;0
4579;80834;883;0;0;0;0;.00nan;0;0
4581;11716;875;0;0;0;0;.00nan;0;0
4581;179602;872;85;38;3;35;.921;3545000;0
4581;62829;875;72;29;2;27;.931;3600000;0
4581;77084;872;0;0;0;0;.00nan;0;0
4583;183755;882;0;0;0;0;.00nan;0;0
4583;179602;872;0;0;0;0;.00nan;0;0
4583;77084;872;76;20;1;19;.950;3600000;0
4583;147567;882;96;34;2;32;.941;3555000;0
4587;11670;887;99;45;2;43;.956;3600000;0
4587;184398;887;0;0;0;0;.00nan;0;0
4587;180316;876;46;26;4;22;.846;3527000;0
4587;76885;876;0;0;0;0;.00nan;0;0
4589;11716;875;62;21;1;20;.952;3600000;0
4589;168712;878;100;29;0;29;1.000;3600000;0
4589;62829;875;0;0;0;0;.00nan;0;0
4589;82245;878;0;0;0;0;.00nan;0;0
4595;183775;893;0;0;0;0;.00nan;0;0
4595;180731;877;60;23;2;21;.913;3600000;0
4595;63402;893;93;47;3;44;.936;3552000;0
4595;149858;877;0;0;0;0;.00nan;0;0
4597;28833;1415;33;17;4;13;.765;3514000;0
4597;179602;872;98;39;2;37;.949;3600000;0
4597;77084;872;0;0;0;0;.00nan;0;0
4597;83678;1415;0;0;0;0;.00nan;0;0
4599;166751;883;62;35;4;31;.886;3515000;0
4599;8519;873;0;0;0;0;.00nan;0;0
4599;69536;873;62;19;2;17;.895;3600000;0
4599;80834;883;0;0;0;0;.00nan;0;0
4601;162945;886;0;0;0;0;.00nan;0;0
4601;183755;882;59;30;3;27;.900;3561000;0
4601;184648;886;81;28;1;27;.964;3600000;0
4601;147567;882;0;0;0;0;.00nan;0;0
4603;11670;887;0;0;0;0;.00nan;0;0
4603;184398;887;67;24;2;22;.917;3584000;0
4603;175084;881;94;22;0;22;1.000;3600000;0
4603;78348;881;0;0;0;0;.00nan;0;0
4605;180316;876;0;0;0;0;.00nan;0;0
4605;180731;877;63;26;2;24;.923;3549000;0
4605;76885;876;83;29;1;28;.966;3600000;0
4605;149858;877;0;0;0;0;.00nan;0;0
4607;11716;875;50;24;3;21;.875;3560000;0
4607;11851;892;83;31;2;29;.935;3600000;0
4607;192461;892;0;0;0;0;.00nan;0;0
4607;62829;875;0;0;0;0;.00nan;0;0
4609;183775;893;77;42;3;39;.929;3600000;0
4609;168712;878;39;30;5;25;.833;3538000;0
4609;63402;893;0;0;0;0;.00nan;0;0
4609;82245;878;0;0;0;0;.00nan;0;0
4611;11716;875;0;0;0;0;.00nan;0;0
4611;183755;882;0;0;0;0;.00nan;0;0
4611;62829;875;75;32;2;30;.938;3600000;0
4611;147567;882;69;17;1;16;.941;3600000;0
4613;11851;892;69;12;0;12;1.000;1283000;0
4613;180316;876;51;22;3;19;.864;3600000;0
4613;192461;892;55;27;4;23;.852;2317000;0
4613;76885;876;0;0;0;0;.00nan;0;0
4617;166751;883;0;0;0;0;.00nan;0;0
4617;168712;878;0;0;0;0;.00nan;0;0
4617;80834;883;79;45;3;42;.933;3590000;0
4617;82245;878;72;21;1;20;.952;3600000;0
4623;11670;887;97;46;4;42;.913;3552000;0
4623;184398;887;0;0;0;0;.00nan;0;0
4623;180731;877;0;0;0;0;.00nan;0;0
4623;149858;877;63;31;3;28;.903;3600000;0
4625;166751;883;62;23;2;21;.913;3600000;0
4625;179602;872;49;25;4;21;.840;3540000;0
4625;77084;872;0;0;0;0;.00nan;0;0
4625;80834;883;0;0;0;0;.00nan;0;0
4633;8519;873;0;0;0;0;.00nan;0;0
4633;11716;875;71;33;3;30;.909;3600000;0
4633;62829;875;0;0;0;0;.00nan;0;0
4633;69536;873;65;31;4;27;.871;3600000;0
4635;183755;882;55;21;3;18;.857;3900000;0
4635;168712;878;66;33;3;30;.909;3900000;0
4635;82245;878;0;0;0;0;.00nan;0;0
4635;147567;882;0;0;0;0;.00nan;0;0
4637;11670;887;0;0;0;0;.00nan;0;0
4637;183775;893;0;0;0;0;.00nan;0;0
4637;184398;887;86;32;2;30;.938;3600000;0
4637;63402;893;81;35;3;32;.914;3600000;0
4641;11716;875;0;0;0;0;.00nan;0;0
4641;183755;882;0;0;0;0;.00nan;0;0
4641;62829;875;83;44;3;41;.932;3546000;0
4641;147567;882;60;20;2;18;.900;3600000;0
4643;11851;892;100;32;0;32;1.000;3600000;0
4643;183775;893;98;40;1;39;.975;3560000;0
4643;192461;892;0;0;0;0;.00nan;0;0
4643;63402;893;0;0;0;0;.00nan;0;0
4647;168712;878;0;0;0;0;.00nan;0;0
4647;180731;877;75;21;1;20;.952;3600000;0
4647;82245;878;76;40;4;36;.900;3600000;0
4647;149858;877;0;0;0;0;.00nan;0;0
4651;8519;873;91;36;2;34;.944;3900000;0
4651;180316;876;66;26;2;24;.923;3900000;0
4651;69536;873;0;0;0;0;.00nan;0;0
4651;76885;876;0;0;0;0;.00nan;0;0
4653;166751;883;97;34;1;33;.971;3564000;0
4653;11851;892;100;29;0;29;1.000;3600000;0
4653;192461;892;0;0;0;0;.00nan;0;0
4653;80834;883;0;0;0;0;.00nan;0;0
4657;8519;873;0;0;0;0;.00nan;0;0
4657;168712;878;98;44;2;42;.955;3600000;0
4657;69536;873;77;41;4;37;.902;3559000;0
4657;82245;878;0;0;0;0;.00nan;0;0
4661;180316;876;0;0;0;0;.00nan;0;0
4661;180731;877;99;38;1;37;.974;3600000;0
4661;76885;876;86;46;4;42;.913;3600000;0
4661;149858;877;0;0;0;0;.00nan;0;0
4665;11716;875;39;28;5;23;.821;3600000;0
4665;179602;872;65;21;2;19;.905;3600000;0
4665;62829;875;0;0;0;0;.00nan;0;0
4665;77084;872;0;0;0;0;.00nan;0;0
1352;168712;878;52;34;5;29;.853;3600000;0
1352;28833;1415;71;18;1;17;.944;3600000;0
1352;78920;1415;0;0;0;0;.00nan;0;0
1352;82245;878;0;0;0;0;.00nan;0;0
1353;184398;887;98;58;2;56;.966;3600000;0
1353;28831;873;0;0;0;0;.00nan;0;0
1353;69536;873;88;29;1;28;.966;3600000;0
1353;85633;887;0;0;0;0;.00nan;0;0
1354;168712;878;47;27;4;23;.852;3600000;0
1354;28833;1415;90;32;1;31;.969;3600000;0
1354;78920;1415;0;0;0;0;.00nan;0;0
1354;82245;878;0;0;0;0;.00nan;0;0
1355;184398;887;94;74;4;70;.946;5433000;0
1355;28831;873;0;0;0;0;.00nan;0;0
1355;69536;873;61;32;3;29;.906;5433000;0
1355;85633;887;0;0;0;0;.00nan;0;0
1470;162945;886;60;21;3;18;.857;3527000;0
1470;184648;886;0;0;0;0;.00nan;0;0
1470;28831;873;0;0;0;0;.00nan;0;0
1470;69536;873;99;42;1;41;.976;3600000;0
1471;28833;1415;62;40;4;36;.900;3593000;0
1471;179602;872;76;34;3;31;.912;3600000;0
1471;77084;872;0;0;0;0;.00nan;0;0
1471;78920;1415;0;0;0;0;.00nan;0;0
1472;166751;883;78;27;1;26;.963;3600000;0
1472;11716;875;47;26;4;22;.846;3600000;0
1472;78775;875;0;0;0;0;.00nan;0;0
1472;80834;883;0;0;0;0;.00nan;0;0
1473;180316;876;0;0;0;0;.00nan;0;0
1473;180731;877;100;34;1;33;.971;3600000;0
1473;181123;876;88;43;2;41;.953;3562000;0
1473;91202;877;0;0;0;0;.00nan;0;0
1474;162945;886;87;33;1;32;.970;3755000;0
1474;184648;886;0;0;0;0;.00nan;0;0
1474;28831;873;0;0;0;0;.00nan;0;0
1474;69536;873;91;36;2;34;.944;3755000;0
1475;28833;1415;92;43;2;41;.953;3600000;0
1475;179602;872;58;29;3;26;.897;3600000;0
1475;77084;872;0;0;0;0;.00nan;0;0
1475;78920;1415;0;0;0;0;.00nan;0;0
1476;166751;883;76;42;4;38;.905;4038000;0
1476;11716;875;0;0;0;0;.00nan;0;0
1476;78775;875;44;17;3;14;.824;4038000;0
1476;80834;883;0;0;0;0;.00nan;0;0
1477;180316;876;0;0;0;0;.00nan;0;0
1477;180731;877;49;29;4;25;.862;4069000;0
1477;181123;876;39;31;5;26;.839;4069000;0
1477;91202;877;0;0;0;0;.00nan;0;0
1478;162945;886;89;40;3;37;.925;3964000;0
1478;184648;886;0;0;0;0;.00nan;0;0
1478;28831;873;0;0;0;0;.00nan;0;0
1478;69536;873;88;33;2;31;.939;3964000;0
1479;28833;1415;34;29;6;23;.793;3304000;0
1479;179602;872;47;18;3;15;.833;3600000;0
1479;77084;872;0;0;0;0;.00nan;0;0
1479;78920;1415;44;4;1;3;.750;296000;0
1480;166751;883;71;45;4;41;.911;3600000;0
1480;11716;875;0;0;0;0;.00nan;0;0
1480;78775;875;72;24;1;23;.958;3600000;0
1480;80834;883;0;0;0;0;.00nan;0;0
1481;180316;876;28;14;4;10;.714;616000;0
1481;180731;877;53;29;4;25;.862;3600000;0
1481;181123;876;27;32;7;25;.781;2984000;0
1481;91202;877;0;0;0;0;.00nan;0;0
1482;162945;886;18;23;6;17;.739;3600000;0
1482;184648;886;0;0;0;0;.00nan;0;0
1482;28831;873;0;0;0;0;.00nan;0;0
1482;69536;873;98;49;3;46;.939;3600000;0
1483;28833;1415;77;33;2;31;.939;3557000;0
1483;179602;872;90;32;1;31;.969;3600000;0
1483;77084;872;0;0;0;0;.00nan;0;0
1483;78920;1415;0;0;0;0;.00nan;0;0
1484;166751;883;72;26;2;24;.923;3557000;0
1484;11716;875;0;0;0;0;.00nan;0;0
1484;78775;875;96;35;1;34;.971;3600000;0
1484;80834;883;0;0;0;0;.00nan;0;0
1485;180316;876;0;0;0;0;.00nan;0;0
1485;180731;877;74;37;4;33;.892;3600000;0
1485;181123;876;60;30;3;27;.900;3600000;0
1485;91202;877;0;0;0;0;.00nan;0;0
1685;162945;886;68;27;2;25;.926;3600000;0
1685;184648;886;0;0;0;0;.00nan;0;0
1685;28831;873;0;0;0;0;.00nan;0;0
1685;69536;873;47;26;4;22;.846;3600000;0
1686;28833;1415;88;38;2;36;.947;3600000;0
1686;179602;872;69;34;3;31;.912;3547000;0
1686;77084;872;0;0;0;0;.00nan;0;0
1686;78920;1415;0;0;0;0;.00nan;0;0
1687;166751;883;84;35;2;33;.943;3543000;0
1687;11716;875;0;0;0;0;.00nan;0;0
1687;78775;875;58;15;1;14;.933;3600000;0
1687;80834;883;0;0;0;0;.00nan;0;0
1688;180316;876;0;0;0;0;.00nan;0;0
1688;180731;877;52;36;5;31;.861;3123000;0
1688;181123;876;100;37;1;36;.973;3600000;0
1688;91202;877;56;5;0;5;1.000;477000;0
1789;162945;886;62;28;3;25;.893;3608000;0
1789;184648;886;0;0;0;0;.00nan;0;0
1789;28831;873;0;0;0;0;.00nan;0;0
1789;69536;873;62;31;4;27;.871;3608000;0
1790;28833;1415;100;27;0;27;1.000;3600000;0
1790;179602;872;50;32;5;27;.844;3600000;0
1790;77084;872;0;0;0;0;.00nan;0;0
1790;78920;1415;0;0;0;0;.00nan;0;0
1791;180316;876;0;0;0;0;.00nan;0;0
1791;180731;877;74;29;2;27;.931;3597000;0
1791;181123;876;100;25;0;25;1.000;3600000;0
1791;91202;877;0;0;0;0;.00nan;0;0
1834;162945;886;81;24;1;23;.958;3600000;0
1834;184648;886;0;0;0;0;.00nan;0;0
1834;28831;873;0;0;0;0;.00nan;0;0
1834;69536;873;89;31;2;29;.935;3589000;0
1835;28833;1415;58;41;5;36;.878;3600000;0
1835;179602;872;75;22;1;21;.955;3600000;0
1835;77084;872;0;0;0;0;.00nan;0;0
1835;78920;1415;0;0;0;0;.00nan;0;0
1836;180316;876;0;0;0;0;.00nan;0;0
1836;180731;877;85;51;4;47;.922;3600000;0
1836;181123;876;74;22;1;21;.955;3600000;0
1836;91202;877;0;0;0;0;.00nan;0;0
1863;162945;886;37;22;4;18;.818;3535000;0
1863;184648;886;0;0;0;0;.00nan;0;0
1863;180316;876;0;0;0;0;.00nan;0;0
1863;181123;876;90;34;2;32;.941;3600000;0
1864;11716;875;0;0;0;0;.00nan;0;0
1864;179602;872;75;35;3;32;.914;3600000;0
1864;77084;872;0;0;0;0;.00nan;0;0
1864;78775;875;34;26;5;21;.808;3558000;0
1865;162945;886;75;31;2;29;.935;3600000;0
1865;184648;886;0;0;0;0;.00nan;0;0
1865;180316;876;0;0;0;0;.00nan;0;0
1865;181123;876;75;36;3;33;.917;3593000;0
1866;11716;875;0;0;0;0;.00nan;0;0
1866;179602;872;68;33;3;30;.909;3600000;0
1866;77084;872;0;0;0;0;.00nan;0;0
1866;78775;875;68;38;4;34;.895;3600000;0
1867;162945;886;57;31;4;27;.871;3564000;0
1867;184648;886;0;0;0;0;.00nan;0;0
1867;180316;876;0;0;0;0;.00nan;0;0
1867;181123;876;76;35;2;33;.943;3600000;0
1868;11716;875;0;0;0;0;.00nan;0;0
1868;179602;872;70;18;1;17;.944;3580000;0
1868;77084;872;0;0;0;0;.00nan;0;0
1868;78775;875;100;41;0;41;1.000;3600000;0
1869;162945;886;52;22;3;19;.864;3567000;0
1869;184648;886;0;0;0;0;.00nan;0;0
1869;180316;876;0;0;0;0;.00nan;0;0
1869;181123;876;82;32;2;30;.938;3600000;0
1870;11716;875;0;0;0;0;.00nan;0;0
1870;179602;872;64;26;2;24;.923;3600000;0
1870;77084;872;0;0;0;0;.00nan;0;0
1870;78775;875;81;39;3;36;.923;3543000;0
2054;162945;886;69;22;1;21;.955;3600000;0
2054;184648;886;0;0;0;0;.00nan;0;0
2054;180316;876;0;0;0;0;.00nan;0;0
2054;181123;876;55;25;3;22;.880;3551000;0
2055;11716;875;0;0;0;0;.00nan;0;0
2055;179602;872;60;24;3;21;.875;3600000;0
2055;77084;872;0;0;0;0;.00nan;0;0
2055;78775;875;61;37;4;33;.892;3549000;0
2140;162945;886;94;33;1;32;.970;3600000;0
2140;184648;886;0;0;0;0;.00nan;0;0
2140;180316;876;0;0;0;0;.00nan;0;0
2140;181123;876;69;27;3;24;.889;3581000;0
2163;162945;886;80;28;1;27;.964;4203000;0
2163;184648;886;0;0;0;0;.00nan;0;0
2163;180316;876;0;0;0;0;.00nan;0;0
2163;181123;876;93;44;2;42;.955;4203000;0
2182;162945;886;87;40;2;38;.950;3566000;0
2182;184648;886;0;0;0;0;.00nan;0;0
2182;179602;872;75;25;1;24;.960;3600000;0
2182;77084;872;0;0;0;0;.00nan;0;0
2183;162945;886;76;26;1;25;.962;3600000;0
2183;184648;886;0;0;0;0;.00nan;0;0
2183;179602;872;56;29;4;25;.862;3600000;0
2183;77084;872;0;0;0;0;.00nan;0;0
2184;162945;886;68;28;3;25;.893;3582000;0
2184;184648;886;0;0;0;0;.00nan;0;0
2184;179602;872;82;34;2;32;.941;3600000;0
2184;77084;872;0;0;0;0;.00nan;0;0
2185;162945;886;75;28;2;26;.929;3600000;0
2185;184648;886;0;0;0;0;.00nan;0;0
2185;179602;872;78;38;3;35;.921;3600000;0
2185;77084;872;0;0;0;0;.00nan;0;0
2430;162945;886;68;18;1;17;.944;3600000;0
2430;184648;886;0;0;0;0;.00nan;0;0
2430;179602;872;59;30;3;27;.900;3551000;0
2430;77084;872;0;0;0;0;.00nan;0;0
2465;162945;886;100;47;1;46;.979;3600000;0
2465;184648;886;0;0;0;0;.00nan;0;0
2465;179602;872;52;26;3;23;.885;3563000;0
2465;77084;872;0;0;0;0;.00nan;0;0
4666;190258;521;0;0;0;0;.00nan;0;0
4666;62287;521;33;21;5;16;.762;3600000;0
4666;142911;515;90;24;1;23;.958;3600000;0
4666;143083;515;0;0;0;0;.00nan;0;0
4667;68565;513;66;24;2;22;.917;3515000;0
4667;142929;1872;0;0;0;0;.00nan;0;0
4667;143412;1872;99;22;0;22;1.000;3600000;0
4667;143421;513;0;0;0;0;.00nan;0;0
4668;13613;520;0;0;0;0;.00nan;0;0
4668;-1;511;100;22;0;22;1.000;3900000;0
4668;67764;511;0;0;0;0;.00nan;0;0
4668;143191;520;85;25;0;25;1.000;3900000;0
4669;54290;516;0;0;0;0;.00nan;0;0
4669;63107;1876;96;33;0;33;1.000;3900000;0
4669;143100;516;96;17;0;17;1.000;3900000;0
4669;155465;1876;0;0;0;0;.00nan;0;0
4670;167047;512;0;0;0;0;.00nan;0;0
4670;11925;512;89;34;2;32;.941;3600000;0
4670;76951;517;77;34;4;30;.882;3557000;0
4670;152202;517;0;0;0;0;.00nan;0;0
4671;169325;518;53;20;2;18;.900;3600000;0
4671;185028;518;0;0;0;0;.00nan;0;0
4671;68425;519;90;43;3;40;.930;3109000;0
4671;143330;519;19;8;4;4;.500;491000;0
4672;200775;1472;0;0;0;0;.00nan;0;0
4672;216464;1472;92;61;3;58;.951;3600000;0
4672;143307;514;0;0;0;0;.00nan;0;0
4672;155529;514;61;11;1;10;.909;3600000;0
4673;13613;520;0;0;0;0;.00nan;0;0
4673;68425;519;0;0;0;0;.00nan;0;0
4673;143191;520;85;27;1;26;.963;3793000;0
4673;143330;519;75;27;2;25;.926;3793000;0
4674;200775;1472;0;0;0;0;.00nan;0;0
4674;216464;1472;70;37;3;34;.919;3600000;0
4674;190258;521;0;0;0;0;.00nan;0;0
4674;62287;521;67;21;1;20;.952;3600000;0
4675;-1;511;58;31;4;27;.871;3600000;0
4675;54290;516;0;0;0;0;.00nan;0;0
4675;67764;511;0;0;0;0;.00nan;0;0
4675;143100;516;72;48;5;43;.896;3543000;0
4676;63107;1876;68;25;2;23;.920;3600000;0
4676;76951;517;48;23;4;19;.826;3571000;0
4676;152202;517;0;0;0;0;.00nan;0;0
4676;155465;1876;0;0;0;0;.00nan;0;0
4677;142929;1872;64;10;0;10;1.000;900000;0
4677;143307;514;80;22;1;21;.955;3600000;0
4677;143412;1872;19;25;6;19;.760;2700000;0
4677;155529;514;0;0;0;0;.00nan;0;0
4678;68565;513;19;24;6;18;.750;2886000;0
4678;142911;515;89;40;3;37;.925;3600000;0
4678;143083;515;0;0;0;0;.00nan;0;0
4678;143421;513;49;5;1;4;.800;714000;0
4679;167047;512;0;0;0;0;.00nan;0;0
4679;11925;512;50;36;5;31;.861;3600000;0
4679;169325;518;58;26;3;23;.885;3600000;0
4679;185028;518;0;0;0;0;.00nan;0;0
4680;169325;518;100;30;0;30;1.000;3600000;0
4680;185028;518;0;0;0;0;.00nan;0;0
4680;54290;516;0;0;0;0;.00nan;0;0
4680;143100;516;70;28;2;26;.929;3600000;0
4681;190258;521;0;0;0;0;.00nan;0;0
4681;62287;521;60;17;2;15;.882;3706000;0
4681;63107;1876;75;21;1;20;.952;3706000;0
4681;155465;1876;0;0;0;0;.00nan;0;0
4682;167047;512;0;0;0;0;.00nan;0;0
4682;11925;512;91;31;1;30;.968;3680000;0
4682;68565;513;0;0;0;0;.00nan;0;0
4682;143421;513;100;19;0;19;1.000;3680000;0
4683;142911;515;0;0;0;0;.00nan;0;0
4683;142929;1872;42;3;1;2;.667;360000;0
4683;143083;515;65;19;1;18;.947;3600000;0
4683;143412;1872;48;45;6;39;.867;3240000;0
4684;13613;520;0;0;0;0;.00nan;0;0
4684;200775;1472;0;0;0;0;.00nan;0;0
4684;216464;1472;63;48;5;43;.896;3556000;0
4684;143191;520;56;23;3;20;.870;3600000;0
4685;68425;519;0;0;0;0;.00nan;0;0
4685;76951;517;0;0;0;0;.00nan;0;0
4685;143330;519;81;24;2;22;.917;3600000;0
4685;152202;517;100;33;1;32;.970;3600000;0
4686;-1;511;50;39;6;33;.846;3272000;0
4686;67764;511;57;5;0;5;1.000;328000;0
4686;143307;514;75;27;2;25;.926;3600000;0
4686;155529;514;0;0;0;0;.00nan;0;0
4687;68425;519;0;0;0;0;.00nan;0;0
4687;142911;515;63;26;4;22;.846;3900000;0
4687;143083;515;0;0;0;0;.00nan;0;0
4687;143330;519;46;26;4;22;.846;3900000;0
4688;200775;1472;66;38;4;34;.895;3600000;0
4688;216464;1472;0;0;0;0;.00nan;0;0
4688;76951;517;24;18;5;13;.722;3565000;0
4688;152202;517;0;0;0;0;.00nan;0;0
4689;169325;518;71;18;1;17;.944;3600000;0
4689;185028;518;0;0;0;0;.00nan;0;0
4689;-1;511;0;0;0;0;.00nan;0;0
4689;67764;511;50;32;4;28;.875;3600000;0
4690;63107;1876;0;0;0;0;.00nan;0;0
4690;68565;513;57;20;2;18;.900;3549000;0
4690;143421;513;0;0;0;0;.00nan;0;0
4690;155465;1876;99;38;1;37;.974;3600000;0
4691;190258;521;0;0;0;0;.00nan;0;0
4691;62287;521;69;25;2;23;.920;3600000;0
4691;142929;1872;55;32;4;28;.875;3546000;0
4691;143412;1872;0;0;0;0;.00nan;0;0
4692;13613;520;0;0;0;0;.00nan;0;0
4692;54290;516;0;0;0;0;.00nan;0;0
4692;143100;516;100;31;0;31;1.000;3893000;0
4692;143191;520;91;37;1;36;.973;3893000;0
4693;167047;512;0;0;0;0;.00nan;0;0
4693;11925;512;58;33;4;29;.879;3600000;0
4693;143307;514;51;20;2;18;.900;3600000;0
4693;155529;514;0;0;0;0;.00nan;0;0
4694;190258;521;67;22;1;21;.955;3900000;0
4694;62287;521;0;0;0;0;.00nan;0;0
4694;68425;519;0;0;0;0;.00nan;0;0
4694;143330;519;100;35;1;34;.971;3900000;0
4695;-1;511;67;17;1;16;.941;3600000;0
4695;67764;511;0;0;0;0;.00nan;0;0
4695;68565;513;70;32;2;30;.938;3590000;0
4695;143421;513;0;0;0;0;.00nan;0;0
4696;200775;1472;0;0;0;0;.00nan;0;0
4696;216464;1472;58;35;4;31;.886;3553000;0
4696;142929;1872;0;0;0;0;.00nan;0;0
4696;143412;1872;60;20;2;18;.900;3600000;0
4697;63107;1876;97;35;1;34;.971;3900000;0
4697;142911;515;0;0;0;0;.00nan;0;0
4697;143083;515;68;18;1;17;.944;3900000;0
4697;155465;1876;0;0;0;0;.00nan;0;0
4698;167047;512;0;0;0;0;.00nan;0;0
4698;11925;512;67;27;2;25;.926;3600000;0
4698;13613;520;0;0;0;0;.00nan;0;0
4698;143191;520;90;16;0;16;1.000;3600000;0
4699;169325;518;74;33;3;30;.909;3552000;0
4699;185028;518;0;0;0;0;.00nan;0;0
4699;76951;517;93;31;1;30;.968;3600000;0
4699;152202;517;0;0;0;0;.00nan;0;0
4700;54290;516;0;0;0;0;.00nan;0;0
4700;143100;516;74;33;3;30;.909;3600000;0
4700;143307;514;92;19;0;19;1.000;3600000;0
4700;155529;514;0;0;0;0;.00nan;0;0
4701;68425;519;0;0;0;0;.00nan;0;0
4701;143307;514;61;21;2;19;.905;3600000;0
4701;143330;519;75;68;6;62;.912;3600000;0
4701;155529;514;0;0;0;0;.00nan;0;0
4702;200775;1472;65;38;5;33;.868;3600000;0
4702;216464;1472;0;0;0;0;.00nan;0;0
4702;68565;513;0;0;0;0;.00nan;0;0
4702;143421;513;68;18;2;16;.889;3600000;0
4703;190258;521;0;0;0;0;.00nan;0;0
4703;-1;511;58;30;3;27;.900;3600000;0
4703;62287;521;49;32;5;27;.844;3600000;0
4703;67764;511;0;0;0;0;.00nan;0;0
4704;63107;1876;97;20;0;20;1.000;3600000;0
4704;142929;1872;0;0;0;0;.00nan;0;0
4704;143412;1872;39;30;5;25;.833;3600000;0
4704;155465;1876;0;0;0;0;.00nan;0;0
4705;54290;516;52;11;1;10;.909;1578000;0
4705;76951;517;100;26;0;26;1.000;3600000;0
4705;143100;516;15;20;6;14;.700;2022000;0
4705;152202;517;0;0;0;0;.00nan;0;0
4706;13613;520;0;0;0;0;.00nan;0;0
4706;169325;518;89;41;2;39;.951;3600000;0
4706;185028;518;0;0;0;0;.00nan;0;0
4706;143191;520;59;34;5;29;.853;3600000;0
4707;167047;512;0;0;0;0;.00nan;0;0
4707;11925;512;76;34;2;32;.941;3864000;0
4707;142911;515;75;39;3;36;.923;3864000;0
4707;143083;515;0;0;0;0;.00nan;0;0
4708;54290;516;0;0;0;0;.00nan;0;0
4708;68565;513;0;0;0;0;.00nan;0;0
4708;143100;516;58;22;3;19;.864;3860000;0
4708;143421;513;79;38;2;36;.947;3860000;0
4709;167047;512;0;0;0;0;.00nan;0;0
4709;11925;512;67;18;1;17;.944;3900000;0
4709;63107;1876;94;36;1;35;.972;3900000;0
4709;155465;1876;0;0;0;0;.00nan;0;0
4710;68425;519;0;0;0;0;.00nan;0;0
4710;142929;1872;61;46;5;41;.891;3537000;0
4710;143330;519;48;22;3;19;.864;3600000;0
4710;143412;1872;0;0;0;0;.00nan;0;0
4711;200775;1472;0;0;0;0;.00nan;0;0
4711;216464;1472;85;36;2;34;.944;3600000;0
4711;142911;515;58;12;1;11;.917;3600000;0
4711;143083;515;0;0;0;0;.00nan;0;0
4712;-1;511;29;22;5;17;.773;3600000;0
4712;67764;511;0;0;0;0;.00nan;0;0
4712;76951;517;63;35;4;31;.886;3600000;0
4712;152202;517;0;0;0;0;.00nan;0;0
4713;169325;518;0;0;0;0;.00nan;0;0
4713;190258;521;0;0;0;0;.00nan;0;0
4713;185028;518;100;24;0;24;1.000;3600000;0
4713;62287;521;65;38;3;35;.921;3600000;0
4714;13613;520;0;0;0;0;.00nan;0;0
4714;143191;520;96;48;2;46;.958;3900000;0
4714;143307;514;0;0;0;0;.00nan;0;0
4714;155529;514;74;23;2;21;.913;3900000;0
4715;68425;519;0;0;0;0;.00nan;0;0
4715;68565;513;43;19;3;16;.842;3600000;0
4715;143330;519;100;31;0;31;1.000;3600000;0
4715;143421;513;0;0;0;0;.00nan;0;0
4716;200775;1472;0;0;0;0;.00nan;0;0
4716;216464;1472;57;40;4;36;.900;3600000;0
4716;63107;1876;74;20;1;19;.950;3600000;0
4716;155465;1876;0;0;0;0;.00nan;0;0
4717;-1;511;73;26;2;24;.923;3600000;0
4717;67764;511;0;0;0;0;.00nan;0;0
4717;142911;515;77;22;1;21;.955;3600000;0
4717;143083;515;0;0;0;0;.00nan;0;0
4718;13613;520;0;0;0;0;.00nan;0;0
4718;76951;517;85;33;2;31;.939;3561000;0
4718;143191;520;100;34;0;34;1.000;3600000;0
4718;152202;517;0;0;0;0;.00nan;0;0
4719;190258;521;0;0;0;0;.00nan;0;0
4719;54290;516;78;28;2;26;.929;3661000;0
4719;62287;521;58;23;3;20;.870;3661000;0
4719;143100;516;0;0;0;0;.00nan;0;0
4720;169325;518;0;0;0;0;.00nan;0;0
4720;185028;518;53;30;4;26;.867;3612000;0
4720;143307;514;49;33;5;28;.848;3612000;0
4720;155529;514;0;0;0;0;.00nan;0;0
4721;167047;512;0;0;0;0;.00nan;0;0
4721;11925;512;45;32;6;26;.813;3672000;0
4721;142929;1872;20;10;4;6;.600;1098000;0
4721;143412;1872;58;18;3;15;.833;2574000;0
4722;13613;520;0;0;0;0;.00nan;0;0
4722;190258;521;62;18;2;16;.889;3600000;0
4722;62287;521;0;0;0;0;.00nan;0;0
4722;143191;520;67;37;3;34;.919;3600000;0
4723;169325;518;73;26;2;24;.923;3600000;0
4723;185028;518;0;0;0;0;.00nan;0;0
4723;68565;513;0;0;0;0;.00nan;0;0
4723;143421;513;77;35;3;32;.914;3588000;0
4724;63107;1876;88;17;0;17;1.000;3600000;0
4724;68425;519;0;0;0;0;.00nan;0;0
4724;143330;519;64;42;5;37;.881;3600000;0
4724;155465;1876;0;0;0;0;.00nan;0;0
4725;-1;511;57;29;4;25;.862;3600000;0
4725;67764;511;0;0;0;0;.00nan;0;0
4725;142929;1872;0;0;0;0;.00nan;0;0
4725;143412;1872;81;40;2;38;.950;3600000;0
4726;54290;516;0;0;0;0;.00nan;0;0
4726;142911;515;0;0;0;0;.00nan;0;0
4726;143083;515;53;30;4;26;.867;3600000;0
4726;143100;516;71;38;3;35;.921;3600000;0
4727;76951;517;0;0;0;0;.00nan;0;0
4727;143307;514;51;18;3;15;.833;3550000;0
4727;152202;517;93;38;2;36;.947;3600000;0
4727;155529;514;0;0;0;0;.00nan;0;0
4728;167047;512;0;0;0;0;.00nan;0;0
4728;11925;512;74;31;2;29;.935;3600000;0
4728;200775;1472;0;0;0;0;.00nan;0;0
4728;216464;1472;72;38;3;35;.921;3590000;0
4729;200775;1472;0;0;0;0;.00nan;0;0
4729;216464;1472;49;24;4;20;.833;3556000;0
4729;68425;519;0;0;0;0;.00nan;0;0
4729;143330;519;79;31;2;29;.935;3600000;0
4730;167047;512;0;0;0;0;.00nan;0;0
4730;11925;512;60;28;3;25;.893;3544000;0
4730;-1;511;99;45;2;43;.956;3600000;0
4730;67764;511;0;0;0;0;.00nan;0;0
4731;169325;518;89;30;1;29;.967;3600000;0
4731;185028;518;0;0;0;0;.00nan;0;0
4731;63107;1876;76;50;4;46;.920;3600000;0
4731;155465;1876;0;0;0;0;.00nan;0;0
4732;13613;520;0;0;0;0;.00nan;0;0
4732;142911;515;91;39;2;37;.949;3571000;0
4732;143083;515;0;0;0;0;.00nan;0;0
4732;143191;520;100;25;0;25;1.000;3600000;0
4733;54290;516;0;0;0;0;.00nan;0;0
4733;142929;1872;0;0;0;0;.00nan;0;0
4733;143100;516;78;32;2;30;.938;3600000;0
4733;143412;1872;75;37;3;34;.919;3600000;0
4734;190258;521;0;0;0;0;.00nan;0;0
4734;62287;521;62;22;2;20;.909;3600000;0
4734;76951;517;27;29;6;23;.793;2889000;0
4734;152202;517;59;9;0;9;1.000;711000;0
4735;68565;513;75;31;2;29;.935;3600000;0
4735;143307;514;0;0;0;0;.00nan;0;0
4735;143421;513;0;0;0;0;.00nan;0;0
4735;155529;514;58;24;3;21;.875;3559000;0
4736;200775;1472;85;54;3;51;.944;3600000;0
4736;216464;1472;0;0;0;0;.00nan;0;0
4736;54290;516;0;0;0;0;.00nan;0;0
4736;143100;516;59;16;2;14;.875;3600000;0
4737;190258;521;0;0;0;0;.00nan;0;0
4737;62287;521;41;22;3;19;.864;3552000;0
4737;78806;514;73;30;2;28;.933;3600000;0
4737;143307;514;0;0;0;0;.00nan;0;0
4738;13613;520;0;0;0;0;.00nan;0;0
4738;68565;513;0;0;0;0;.00nan;0;0
4738;143191;520;65;27;3;24;.889;3888000;0
4738;143421;513;66;29;3;26;.897;3900000;0
4739;-1;511;0;0;0;0;.00nan;0;0
4739;63107;1876;96;25;0;25;1.000;3600000;0
4739;86344;511;62;30;3;27;.900;3600000;0
4739;155465;1876;0;0;0;0;.00nan;0;0
4740;76951;517;47;22;4;18;.818;3567000;0
4740;142929;1872;0;0;0;0;.00nan;0;0
4740;143412;1872;85;35;3;32;.914;3600000;0
4740;152202;517;0;0;0;0;.00nan;0;0
4741;168926;518;0;0;0;0;.00nan;0;0
4741;169325;518;99;39;1;38;.974;3600000;0
4741;142911;515;0;0;0;0;.00nan;0;0
4741;143083;515;59;23;3;20;.870;3586000;0
4742;167047;512;0;0;0;0;.00nan;0;0
4742;11925;512;85;14;0;14;1.000;3600000;0
4742;68425;519;0;0;0;0;.00nan;0;0
4742;143330;519;90;43;3;40;.930;3600000;0
4743;-1;511;0;0;0;0;.00nan;0;0
4743;68425;519;0;0;0;0;.00nan;0;0
4743;86344;511;98;22;0;22;1.000;3600000;0
4743;143330;519;98;47;2;45;.957;3600000;0
4744;190258;521;0;0;0;0;.00nan;0;0
4744;62287;521;84;31;1;30;.968;3600000;0
4744;68565;513;0;0;0;0;.00nan;0;0
4744;143421;513;72;26;2;24;.923;3577000;0
4745;13613;520;0;0;0;0;.00nan;0;0
4745;142929;1872;0;0;0;0;.00nan;0;0
4745;143191;520;67;20;1;19;.950;3600000;0
4745;143412;1872;85;50;4;46;.920;3600000;0
4746;167047;512;0;0;0;0;.00nan;0;0
4746;11925;512;76;26;2;24;.923;3600000;0
4746;54290;516;46;29;5;24;.828;3600000;0
4746;143100;516;0;0;0;0;.00nan;0;0
4747;76951;517;0;0;0;0;.00nan;0;0
4747;142911;515;71;20;1;19;.950;3600000;0
4747;143083;515;0;0;0;0;.00nan;0;0
4747;152202;517;68;28;3;25;.893;3541000;0
4748;168926;518;65;16;1;15;.938;3600000;0
4748;169325;518;0;0;0;0;.00nan;0;0
4748;200775;1472;0;0;0;0;.00nan;0;0
4748;216464;1472;74;52;5;47;.904;3600000;0
4749;63107;1876;81;44;5;39;.886;3600000;0
4749;78806;514;64;16;1;15;.938;3600000;0
4749;143307;514;0;0;0;0;.00nan;0;0
4749;155465;1876;0;0;0;0;.00nan;0;0
4750;54290;516;0;0;0;0;.00nan;0;0
4750;68425;519;0;0;0;0;.00nan;0;0
4750;143100;516;62;37;4;33;.892;3600000;0
4750;143330;519;100;39;0;39;1.000;3600000;0
4751;200775;1472;0;0;0;0;.00nan;0;0
4751;216464;1472;65;38;4;34;.895;3600000;0
4751;-1;511;0;0;0;0;.00nan;0;0
4751;86344;511;80;25;1;24;.960;3600000;0
4752;68565;513;0;0;0;0;.00nan;0;0
4752;76951;517;33;29;5;24;.828;3600000;0
4752;143421;513;75;20;1;19;.950;3600000;0
4752;152202;517;0;0;0;0;.00nan;0;0
4753;13613;520;0;0;0;0;.00nan;0;0
4753;63107;1876;100;42;2;40;.952;3900000;0
4753;143191;520;50;14;2;12;.857;3900000;0
4753;155465;1876;0;0;0;0;.00nan;0;0
4754;78806;514;88;36;2;34;.944;3596000;0
4754;142911;515;85;24;1;23;.958;3600000;0
4754;143083;515;0;0;0;0;.00nan;0;0
4754;143307;514;0;0;0;0;.00nan;0;0
4755;168926;518;0;0;0;0;.00nan;0;0
4755;169325;518;74;33;3;30;.909;3600000;0
4755;142929;1872;0;0;0;0;.00nan;0;0
4755;143412;1872;100;30;0;30;1.000;3600000;0
4756;167047;512;0;0;0;0;.00nan;0;0
4756;11925;512;85;26;1;25;.962;3900000;0
4756;190258;521;0;0;0;0;.00nan;0;0
4756;62287;521;81;28;1;27;.964;3900000;0
4757;168926;518;0;0;0;0;.00nan;0;0
4757;169325;518;45;36;6;30;.833;3514000;0
4757;68425;519;0;0;0;0;.00nan;0;0
4757;143330;519;66;36;4;32;.889;3600000;0
4758;200775;1472;0;0;0;0;.00nan;0;0
4758;216464;1472;81;52;4;48;.923;3600000;0
4758;78806;514;71;22;1;21;.955;3600000;0
4758;143307;514;0;0;0;0;.00nan;0;0
4759;13613;520;0;0;0;0;.00nan;0;0
4759;-1;511;0;0;0;0;.00nan;0;0
4759;86344;511;70;31;3;28;.903;3600000;0
4759;143191;520;33;26;5;21;.808;3600000;0
4760;54290;516;0;0;0;0;.00nan;0;0
4760;63107;1876;82;27;2;25;.926;3600000;0
4760;143100;516;85;43;5;38;.884;3600000;0
4760;155465;1876;0;0;0;0;.00nan;0;0
4761;68565;513;0;0;0;0;.00nan;0;0
4761;142929;1872;0;0;0;0;.00nan;0;0
4761;143412;1872;74;26;2;24;.923;3600000;0
4761;143421;513;33;10;3;7;.700;3585000;0
4762;190258;521;0;0;0;0;.00nan;0;0
4762;62287;521;70;36;4;32;.889;3600000;0
4762;142911;515;0;0;0;0;.00nan;0;0
4762;143083;515;65;16;1;15;.938;3600000;0
4763;167047;512;0;0;0;0;.00nan;0;0
4763;11925;512;77;34;2;32;.941;3900000;0
4763;76951;517;75;27;2;25;.926;3900000;0
4763;152202;517;0;0;0;0;.00nan;0;0
4764;200775;1472;0;0;0;0;.00nan;0;0
4764;216464;1472;67;26;3;23;.885;3583000;0
4764;190258;521;71;20;1;19;.950;3600000;0
4764;62287;521;0;0;0;0;.00nan;0;0
4765;68565;513;0;0;0;0;.00nan;0;0
4765;142911;515;57;11;1;10;.909;3600000;0
4765;143083;515;0;0;0;0;.00nan;0;0
4765;143421;513;63;41;4;37;.902;3600000;0
4766;13613;520;0;0;0;0;.00nan;0;0
4766;68425;519;0;0;0;0;.00nan;0;0
4766;143191;520;62;18;2;16;.889;3600000;0
4766;143330;519;76;37;4;33;.892;3518000;0
4767;-1;511;0;0;0;0;.00nan;0;0
4767;54290;516;0;0;0;0;.00nan;0;0
4767;86344;511;51;17;2;15;.882;3600000;0
4767;143100;516;63;35;5;30;.857;3600000;0
4768;63107;1876;75;27;2;25;.926;3600000;0
4768;76951;517;0;0;0;0;.00nan;0;0
4768;152202;517;76;24;1;23;.958;3600000;0
4768;155465;1876;0;0;0;0;.00nan;0;0
4769;167047;512;0;0;0;0;.00nan;0;0
4769;11925;512;100;37;2;35;.946;3900000;0
4769;168926;518;70;25;2;23;.920;3900000;0
4769;169325;518;0;0;0;0;.00nan;0;0
4770;78806;514;89;33;2;31;.939;3546000;0
4770;142929;1872;0;0;0;0;.00nan;0;0
4770;143307;514;0;0;0;0;.00nan;0;0
4770;143412;1872;94;33;1;32;.970;3600000;0
4771;68425;519;76;32;2;30;.938;3141000;0
4771;76951;517;20;29;6;23;.793;3553000;0
4771;143330;519;24;5;3;2;.400;459000;0
4771;152202;517;0;0;0;0;.00nan;0;0
4772;-1;511;0;0;0;0;.00nan;0;0
4772;78806;514;72;28;2;26;.929;3551000;0
4772;86344;511;81;24;1;23;.958;3600000;0
4772;143307;514;0;0;0;0;.00nan;0;0
4773;190258;521;0;0;0;0;.00nan;0;0
4773;62287;521;62;28;3;25;.893;3555000;0
4773;63107;1876;85;26;1;25;.962;3600000;0
4773;155465;1876;0;0;0;0;.00nan;0;0
4774;142911;515;76;16;1;15;.938;3600000;0
4774;142929;1872;0;0;0;0;.00nan;0;0
4774;143083;515;0;0;0;0;.00nan;0;0
4774;143412;1872;81;41;4;37;.902;3600000;0
4775;168926;518;0;0;0;0;.00nan;0;0
4775;169325;518;80;34;2;32;.941;3600000;0
4775;54290;516;0;0;0;0;.00nan;0;0
4775;143100;516;69;30;3;27;.900;3600000;0
4776;167047;512;0;0;0;0;.00nan;0;0
4776;11925;512;100;32;1;31;.969;3600000;0
4776;68565;513;0;0;0;0;.00nan;0;0
4776;143421;513;64;22;2;20;.909;3558000;0
4777;13613;520;0;0;0;0;.00nan;0;0
4777;200775;1472;60;29;3;26;.897;3600000;0
4777;216464;1472;0;0;0;0;.00nan;0;0
4777;143191;520;100;23;0;23;1.000;3600000;0
4778;190258;521;0;0;0;0;.00nan;0;0
4778;62287;521;87;17;0;17;1.000;3600000;0
4778;142929;1872;53;2;0;2;1.000;526000;0
4778;143412;1872;38;30;6;24;.800;3074000;0
4779;63107;1876;80;46;5;41;.891;3600000;0
4779;68565;513;64;21;2;19;.905;3600000;0
4779;143421;513;0;0;0;0;.00nan;0;0
4779;155465;1876;0;0;0;0;.00nan;0;0
4780;68425;519;0;0;0;0;.00nan;0;0
4780;142911;515;45;20;3;17;.850;3600000;0
4780;143083;515;0;0;0;0;.00nan;0;0
4780;143330;519;82;44;4;40;.909;3562000;0
4781;13613;520;0;0;0;0;.00nan;0;0
4781;54290;516;0;0;0;0;.00nan;0;0
4781;143100;516;74;30;3;27;.900;3900000;0
4781;143191;520;89;35;3;32;.914;3900000;0
4782;200775;1472;0;0;0;0;.00nan;0;0
4782;216464;1472;40;35;5;30;.857;3600000;0
4782;76951;517;0;0;0;0;.00nan;0;0
4782;152202;517;98;24;0;24;1.000;3600000;0
4783;168926;518;53;9;1;8;.889;954000;0
4783;169325;518;38;30;6;24;.800;2646000;0
4783;-1;511;0;0;0;0;.00nan;0;0
4783;86344;511;57;20;2;18;.900;3600000;0
4784;167047;512;0;0;0;0;.00nan;0;0
4784;11925;512;68;33;3;30;.909;3592000;0
4784;78806;514;77;31;2;29;.935;3600000;0
4784;143307;514;0;0;0;0;.00nan;0;0
4785;190258;521;0;0;0;0;.00nan;0;0
4785;62287;521;100;23;0;23;1.000;3600000;0
4785;68425;519;0;0;0;0;.00nan;0;0
4785;143330;519;68;23;2;21;.913;3591000;0
4786;200775;1472;91;37;2;35;.946;3797000;0
4786;216464;1472;0;0;0;0;.00nan;0;0
4786;142929;1872;0;0;0;0;.00nan;0;0
4786;143412;1872;82;26;1;25;.962;3797000;0
4787;-1;511;0;0;0;0;.00nan;0;0
4787;68565;513;0;0;0;0;.00nan;0;0
4787;86344;511;57;31;4;27;.871;3581000;0
4787;143421;513;85;34;2;32;.941;3600000;0
4788;63107;1876;0;0;0;0;.00nan;0;0
4788;142911;515;75;6;0;6;1.000;3600000;0
4788;143083;515;0;0;0;0;.00nan;0;0
4788;155465;1876;89;39;2;37;.949;3581000;0
4789;54290;516;0;0;0;0;.00nan;0;0
4789;78806;514;54;23;3;20;.870;3600000;0
4789;143100;516;84;28;1;27;.964;3600000;0
4789;143307;514;0;0;0;0;.00nan;0;0
4790;168926;518;0;0;0;0;.00nan;0;0
4790;169325;518;81;33;2;31;.939;3557000;0
4790;76951;517;0;0;0;0;.00nan;0;0
4790;152202;517;81;28;1;27;.964;3600000;0
4791;167047;512;0;0;0;0;.00nan;0;0
4791;11925;512;65;32;3;29;.906;3900000;0
4791;13613;520;0;0;0;0;.00nan;0;0
4791;143191;520;78;37;3;34;.919;3900000;0
4792;190258;521;0;0;0;0;.00nan;0;0
4792;-1;511;0;0;0;0;.00nan;0;0
4792;62287;521;99;27;0;27;1.000;3600000;0
4792;86344;511;48;29;4;25;.862;3600000;0
4793;200775;1472;0;0;0;0;.00nan;0;0
4793;216464;1472;84;46;3;43;.935;3600000;0
4793;68565;513;0;0;0;0;.00nan;0;0
4793;143421;513;91;17;0;17;1.000;3600000;0
4794;63107;1876;90;36;2;34;.944;3729000;0
4794;142929;1872;88;27;1;26;.963;3729000;0
4794;143412;1872;0;0;0;0;.00nan;0;0
4794;155465;1876;0;0;0;0;.00nan;0;0
4795;167047;512;0;0;0;0;.00nan;0;0
4795;11925;512;98;50;2;48;.960;3600000;0
4795;142911;515;76;23;1;22;.957;3600000;0
4795;143083;515;0;0;0;0;.00nan;0;0
4796;13613;520;0;0;0;0;.00nan;0;0
4796;168926;518;0;0;0;0;.00nan;0;0
4796;169325;518;57;25;3;22;.880;3600000;0
4796;143191;520;61;35;4;31;.886;3578000;0
4797;54290;516;0;0;0;0;.00nan;0;0
4797;76951;517;0;0;0;0;.00nan;0;0
4797;143100;516;67;18;1;17;.944;3600000;0
4797;152202;517;69;36;3;33;.917;3600000;0
4798;68425;519;0;0;0;0;.00nan;0;0
4798;74734;514;0;0;0;0;.00nan;0;0
4798;78806;514;71;22;2;20;.909;3900000;0
4798;143330;519;100;47;2;45;.957;3900000;0
4799;68425;519;73;20;1;19;.950;3600000;0
4799;142929;1872;0;0;0;0;.00nan;0;0
4799;143330;519;0;0;0;0;.00nan;0;0
4799;143412;1872;68;29;2;27;.931;3600000;0
4800;200775;1472;0;0;0;0;.00nan;0;0
4800;216464;1472;96;65;4;61;.938;3600000;0
4800;142911;515;63;16;1;15;.938;3600000;0
4800;143083;515;0;0;0;0;.00nan;0;0
4801;-1;511;0;0;0;0;.00nan;0;0
4801;76951;517;68;18;1;17;.944;2560000;0
4801;86344;511;85;26;1;25;.962;3600000;0
4801;152202;517;26;15;4;11;.733;1040000;0
4802;168926;518;0;0;0;0;.00nan;0;0
4802;169325;518;64;28;3;25;.893;3600000;0
4802;190258;521;0;0;0;0;.00nan;0;0
4802;62287;521;50;28;4;24;.857;3600000;0
4803;13613;520;0;0;0;0;.00nan;0;0
4803;74734;514;75;29;2;27;.931;3566000;0
4803;78806;514;0;0;0;0;.00nan;0;0
4803;143191;520;96;36;1;35;.972;3600000;0
4804;54290;516;0;0;0;0;.00nan;0;0
4804;68565;513;72;32;3;29;.906;3600000;0
4804;143100;516;46;22;4;18;.818;3556000;0
4804;143421;513;0;0;0;0;.00nan;0;0
4805;167047;512;0;0;0;0;.00nan;0;0
4805;11925;512;51;21;3;18;.857;3900000;0
4805;63107;1876;100;46;3;43;.935;3895000;0
4805;155465;1876;0;0;0;0;.00nan;0;0
4806;190258;521;0;0;0;0;.00nan;0;0
4806;54290;516;0;0;0;0;.00nan;0;0
4806;62287;521;82;21;1;20;.952;3600000;0
4806;143100;516;67;25;2;23;.920;3596000;0
4807;68425;519;0;0;0;0;.00nan;0;0
4807;68565;513;82;16;0;16;1.000;3600000;0
4807;143330;519;79;28;2;26;.929;3600000;0
4807;143421;513;0;0;0;0;.00nan;0;0
4808;200775;1472;0;0;0;0;.00nan;0;0
4808;216464;1472;86;30;1;29;.967;3600000;0
4808;63107;1876;64;23;2;21;.913;3580000;0
4808;155465;1876;0;0;0;0;.00nan;0;0
4809;167047;512;0;0;0;0;.00nan;0;0
4809;11925;512;100;31;1;30;.968;3600000;0
4809;142929;1872;0;0;0;0;.00nan;0;0
4809;143412;1872;91;42;3;39;.929;3517000;0
4810;-1;511;0;0;0;0;.00nan;0;0
4810;86344;511;63;35;3;32;.914;3572000;0
4810;142911;515;93;34;1;33;.971;3600000;0
4810;143083;515;0;0;0;0;.00nan;0;0
4811;13613;520;0;0;0;0;.00nan;0;0
4811;76951;517;0;0;0;0;.00nan;0;0
4811;143191;520;37;24;5;19;.792;3600000;0
4811;152202;517;100;26;0;26;1.000;3600000;0
4812;168926;518;55;39;5;34;.872;3600000;0
4812;169325;518;0;0;0;0;.00nan;0;0
4812;74734;514;0;0;0;0;.00nan;0;0
4812;78806;514;75;21;1;20;.952;3600000;0
4813;63107;1876;38;20;4;16;.800;3600000;0
4813;68425;519;0;0;0;0;.00nan;0;0
4813;143330;519;58;9;1;8;.889;3600000;0
4813;155465;1876;0;0;0;0;.00nan;0;0
4814;167047;512;0;0;0;0;.00nan;0;0
4814;11925;512;67;15;1;14;.933;3600000;0
4814;200775;1472;81;47;3;44;.936;3562000;0
4814;216464;1472;0;0;0;0;.00nan;0;0
4815;-1;511;0;0;0;0;.00nan;0;0
4815;86344;511;80;12;0;12;1.000;3600000;0
4815;142929;1872;0;0;0;0;.00nan;0;0
4815;143412;1872;97;49;2;47;.959;3556000;0
4816;13613;520;0;0;0;0;.00nan;0;0
4816;190258;521;0;0;0;0;.00nan;0;0
4816;62287;521;100;37;1;36;.973;3600000;0
4816;143191;520;68;29;3;26;.897;3514000;0
4817;54290;516;0;0;0;0;.00nan;0;0
4817;142911;515;58;17;2;15;.882;3900000;0
4817;143083;515;0;0;0;0;.00nan;0;0
4817;143100;516;100;43;2;41;.953;3900000;0
4818;168926;518;0;0;0;0;.00nan;0;0
4818;169325;518;89;27;1;26;.963;3600000;0
4818;68565;513;45;37;6;31;.838;3600000;0
4818;143421;513;0;0;0;0;.00nan;0;0
4819;74734;514;70;35;3;32;.914;3600000;0
4819;76951;517;0;0;0;0;.00nan;0;0
4819;78806;514;0;0;0;0;.00nan;0;0
4819;152202;517;47;26;4;22;.846;3567000;0
4820;200775;1472;0;0;0;0;.00nan;0;0
4820;216464;1472;49;39;5;34;.872;3600000;0
4820;68425;519;0;0;0;0;.00nan;0;0
4820;143330;519;80;26;2;24;.923;3600000;0
4821;190258;521;0;0;0;0;.00nan;0;0
4821;62287;521;86;17;1;16;.941;3600000;0
4821;76951;517;63;24;2;22;.917;3554000;0
4821;152202;517;0;0;0;0;.00nan;0;0
4822;68565;513;94;39;1;38;.974;3600000;0
4822;74734;514;0;0;0;0;.00nan;0;0
4822;78806;514;47;20;3;17;.850;3517000;0
4822;143421;513;0;0;0;0;.00nan;0;0
4823;54290;516;0;0;0;0;.00nan;0;0
4823;142929;1872;0;0;0;0;.00nan;0;0
4823;143100;516;45;18;3;15;.833;3640000;0
4823;143412;1872;77;34;2;32;.941;3640000;0
4824;13613;520;0;0;0;0;.00nan;0;0
4824;142911;515;54;16;2;14;.875;3900000;0
4824;143083;515;0;0;0;0;.00nan;0;0
4824;143191;520;81;31;2;29;.935;3900000;0
4825;168926;518;72;19;1;18;.947;3600000;0
4825;169325;518;0;0;0;0;.00nan;0;0
4825;63107;1876;66;43;5;38;.884;3600000;0
4825;155465;1876;0;0;0;0;.00nan;0;0
4826;167047;512;0;0;0;0;.00nan;0;0
4826;11925;512;89;34;2;32;.941;3900000;0
4826;-1;511;0;0;0;0;.00nan;0;0
4826;86344;511;71;30;2;28;.933;3900000;0
4827;167047;512;0;0;0;0;.00nan;0;0
4827;11925;512;40;34;5;29;.853;3600000;0
4827;68425;519;0;0;0;0;.00nan;0;0
4827;143330;519;91;31;1;30;.968;3600000;0
4828;-1;511;100;29;0;29;1.000;3600000;0
4828;63107;1876;74;41;4;37;.902;3600000;0
4828;86344;511;0;0;0;0;.00nan;0;0
4828;155465;1876;0;0;0;0;.00nan;0;0
4829;13613;520;57;17;2;15;.882;3900000;0
4829;68565;513;83;36;2;34;.944;3900000;0
4829;143191;520;0;0;0;0;.00nan;0;0
4829;143421;513;0;0;0;0;.00nan;0;0
4830;200775;1472;0;0;0;0;.00nan;0;0
4830;216464;1472;94;45;4;41;.911;3600000;0
4830;54290;516;65;13;1;12;.923;3600000;0
4830;143100;516;0;0;0;0;.00nan;0;0
4831;142929;1872;0;0;0;0;.00nan;0;0
4831;143307;517;77;25;1;24;.960;3600000;0
4831;143412;1872;73;37;4;33;.892;3600000;0
4831;152202;517;0;0;0;0;.00nan;0;0
4832;168926;518;71;34;3;31;.912;3600000;0
4832;169325;518;0;0;0;0;.00nan;0;0
4832;76951;515;0;0;0;0;.00nan;0;0
4832;142911;515;26;23;5;18;.783;3525000;0
4833;190258;521;0;0;0;0;.00nan;0;0
4833;62287;521;63;30;4;26;.867;3600000;0
4833;74734;514;81;30;1;29;.967;3600000;0
4833;78806;514;0;0;0;0;.00nan;0;0
4834;-1;511;53;20;3;17;.850;3600000;0
4834;68425;519;0;0;0;0;.00nan;0;0
4834;86344;511;0;0;0;0;.00nan;0;0
4834;143330;519;71;33;4;29;.879;3547000;0
4835;168926;518;0;0;0;0;.00nan;0;0
4835;169325;518;88;17;0;17;1.000;3600000;0
4835;200775;1472;88;67;5;62;.925;3600000;0
4835;216464;1472;0;0;0;0;.00nan;0;0
4836;190258;521;0;0;0;0;.00nan;0;0
4836;62287;521;61;39;4;35;.897;3600000;0
4836;68565;513;86;33;1;32;.970;3600000;0
4836;143421;513;0;0;0;0;.00nan;0;0
4837;63107;1876;31;13;4;9;.692;776000;0
4837;74734;514;0;0;0;0;.00nan;0;0
4837;78806;514;57;14;1;13;.929;3600000;0
4837;155465;1876;79;30;1;29;.967;2824000;0
4838;13613;520;0;0;0;0;.00nan;0;0
4838;142929;1872;73;32;2;30;.938;3900000;0
4838;143191;520;100;40;2;38;.950;3900000;0
4838;143412;1872;0;0;0;0;.00nan;0;0
4839;76951;515;0;0;0;0;.00nan;0;0
4839;142911;515;69;15;1;14;.933;3600000;0
4839;143307;517;0;0;0;0;.00nan;0;0
4839;152202;517;89;41;2;39;.951;3596000;0
4840;167047;512;67;21;1;20;.952;3571000;0
4840;11925;512;0;0;0;0;.00nan;0;0
4840;54290;516;0;0;0;0;.00nan;0;0
4840;143100;516;97;23;0;23;1.000;3600000;0
4841;200775;1472;84;50;4;46;.920;3600000;0
4841;216464;1472;0;0;0;0;.00nan;0;0
4841;-1;511;0;0;0;0;.00nan;0;0
4841;86344;511;64;24;2;22;.917;3600000;0
4842;167047;512;0;0;0;0;.00nan;0;0
4842;11925;512;91;30;2;28;.933;3600000;0
4842;190258;521;0;0;0;0;.00nan;0;0
4842;62287;521;61;26;3;23;.885;3572000;0
4843;168926;518;0;0;0;0;.00nan;0;0
4843;169325;518;77;24;1;23;.958;3600000;0
4843;142929;1872;0;0;0;0;.00nan;0;0
4843;143412;1872;93;37;2;35;.946;3555000;0
4844;13613;520;0;0;0;0;.00nan;0;0
4844;63107;1876;71;33;3;30;.909;3555000;0
4844;143191;520;94;26;1;25;.962;3600000;0
4844;155465;1876;0;0;0;0;.00nan;0;0
4845;54290;516;0;0;0;0;.00nan;0;0
4845;68425;519;0;0;0;0;.00nan;0;0
4845;143100;516;89;27;1;26;.963;3600000;0
4845;143330;519;63;33;5;28;.848;3600000;0
4846;68565;513;44;31;5;26;.839;3600000;0
4846;143307;517;0;0;0;0;.00nan;0;0
4846;143421;513;0;0;0;0;.00nan;0;0
4846;152202;517;70;30;3;27;.900;3600000;0
4847;74734;514;100;18;0;18;1.000;3600000;0
4847;76951;515;0;0;0;0;.00nan;0;0
4847;78806;514;0;0;0;0;.00nan;0;0
4847;142911;515;81;36;2;34;.944;3550000;0
4848;190258;521;59;20;2;18;.900;3600000;0
4848;62287;521;0;0;0;0;.00nan;0;0
4848;76951;515;0;0;0;0;.00nan;0;0
4848;142911;515;61;27;3;24;.889;3600000;0
4849;68565;513;64;16;1;15;.938;3600000;0
4849;142929;1872;0;0;0;0;.00nan;0;0
4849;143412;1872;75;43;3;40;.930;3600000;0
4849;143421;513;0;0;0;0;.00nan;0;0
4850;13613;520;0;0;0;0;.00nan;0;0
4850;-1;511;0;0;0;0;.00nan;0;0
4850;86344;511;84;29;1;28;.966;3600000;0
4850;143191;520;43;35;6;29;.829;3600000;0
4851;54290;516;0;0;0;0;.00nan;0;0
4851;63107;1876;97;41;1;40;.976;3600000;0
4851;143100;516;55;17;2;15;.882;3562000;0
4851;155465;1876;0;0;0;0;.00nan;0;0
4852;167047;512;0;0;0;0;.00nan;0;0
4852;11925;512;85;38;3;35;.921;3558000;0
4852;143307;517;0;0;0;0;.00nan;0;0
4852;152202;517;85;29;1;28;.966;3600000;0
4853;168926;518;97;19;0;19;1.000;3600000;0
4853;169325;518;0;0;0;0;.00nan;0;0
4853;68425;519;0;0;0;0;.00nan;0;0
4853;143330;519;89;35;2;33;.943;3573000;0
4854;200775;1472;0;0;0;0;.00nan;0;0
4854;216464;1472;89;68;4;64;.941;3584000;0
4854;74734;514;56;18;3;15;.833;3600000;0
4854;78806;514;0;0;0;0;.00nan;0;0
4855;13613;520;0;0;0;0;.00nan;0;0
4855;54290;516;0;0;0;0;.00nan;0;0
4855;143100;516;92;37;1;36;.973;3900000;0
4855;143191;520;91;27;1;26;.963;3900000;0
4856;13613;520;0;0;0;0;.00nan;0;0
4856;68425;519;0;0;0;0;.00nan;0;0
4856;143191;520;75;33;2;31;.939;3899000;0
4856;143330;519;90;42;2;40;.952;3900000;0
4857;200775;1472;45;32;5;27;.844;3600000;0
4857;216464;1472;0;0;0;0;.00nan;0;0
4857;190258;521;0;0;0;0;.00nan;0;0
4857;62287;521;82;24;1;23;.958;3600000;0
4858;-1;511;0;0;0;0;.00nan;0;0
4858;54290;516;0;0;0;0;.00nan;0;0
4858;86344;511;79;23;1;22;.957;3600000;0
4858;143100;516;72;36;4;32;.889;3533000;0
4859;63107;1876;49;32;5;27;.844;3600000;0
4859;143307;517;0;0;0;0;.00nan;0;0
4859;152202;517;66;15;1;14;.933;3600000;0
4859;155465;1876;0;0;0;0;.00nan;0;0
4860;74734;514;86;17;0;17;1.000;3600000;0
4860;78806;514;0;0;0;0;.00nan;0;0
4860;142929;1872;0;0;0;0;.00nan;0;0
4860;143412;1872;91;39;3;36;.923;3600000;0
4861;68565;513;100;32;1;31;.969;3600000;0
4861;76951;515;0;0;0;0;.00nan;0;0
4861;142911;515;55;24;3;21;.875;3562000;0
4861;143421;513;0;0;0;0;.00nan;0;0
4862;167047;512;0;0;0;0;.00nan;0;0
4862;11925;512;82;36;2;34;.944;3732000;0
4862;168926;518;64;31;3;28;.903;3732000;0
4862;169325;518;0;0;0;0;.00nan;0;0
4863;190258;521;0;0;0;0;.00nan;0;0
4863;62287;521;87;18;0;18;1.000;3900000;0
4863;63107;1876;97;60;0;60;1.000;3900000;0
4863;155465;1876;0;0;0;0;.00nan;0;0
4864;167047;512;0;0;0;0;.00nan;0;0
4864;11925;512;67;26;2;24;.923;3900000;0
4864;68565;513;0;0;0;0;.00nan;0;0
4864;143421;513;96;33;2;31;.939;3900000;0
4865;76951;515;0;0;0;0;.00nan;0;0
4865;142911;515;44;23;4;19;.826;3600000;0
4865;142929;1872;0;0;0;0;.00nan;0;0
4865;143412;1872;93;31;1;30;.968;3600000;0
4866;13613;520;72;26;2;24;.923;3600000;0
4866;200775;1472;0;0;0;0;.00nan;0;0
4866;216464;1472;58;30;4;26;.867;3576000;0
4866;143191;520;0;0;0;0;.00nan;0;0
4867;68425;519;0;0;0;0;.00nan;0;0
4867;143307;517;0;0;0;0;.00nan;0;0
4867;143330;519;100;28;0;28;1.000;3600000;0
4867;152202;517;80;31;2;29;.935;3576000;0
4868;168926;518;0;0;0;0;.00nan;0;0
4868;169325;518;89;34;1;33;.971;3600000;0
4868;54290;516;0;0;0;0;.00nan;0;0
4868;143100;516;31;41;8;33;.805;3600000;0
4869;-1;511;0;0;0;0;.00nan;0;0
4869;74734;514;84;13;0;13;1.000;3600000;0
4869;78806;514;0;0;0;0;.00nan;0;0
4869;86344;511;80;45;3;42;.933;3600000;0
4870;68425;519;0;0;0;0;.00nan;0;0
4870;76951;515;0;0;0;0;.00nan;0;0
4870;142911;515;85;23;1;22;.957;3600000;0
4870;143330;519;62;36;5;31;.861;3600000;0
4871;200775;1472;95;48;4;44;.917;3600000;0
4871;216464;1472;0;0;0;0;.00nan;0;0
4871;143307;517;0;0;0;0;.00nan;0;0
4871;152202;517;83;18;0;18;1.000;3600000;0
4872;168926;518;50;34;4;30;.882;3593000;0
4872;169325;518;0;0;0;0;.00nan;0;0
4872;-1;511;0;0;0;0;.00nan;0;0
4872;86344;511;55;17;3;14;.824;3600000;0
4873;63107;1876;94;38;1;37;.974;3876000;0
4873;68565;513;93;11;0;11;1.000;3876000;0
4873;143421;513;0;0;0;0;.00nan;0;0
4873;155465;1876;0;0;0;0;.00nan;0;0
4874;190258;521;0;0;0;0;.00nan;0;0
4874;62287;521;71;35;2;33;.943;3900000;0
4874;142929;1872;0;0;0;0;.00nan;0;0
4874;143412;1872;93;36;2;34;.944;3900000;0
4875;167047;512;0;0;0;0;.00nan;0;0
4875;11925;512;83;30;1;29;.967;3600000;0
4875;74734;514;47;28;4;24;.857;3600000;0
4875;78806;514;0;0;0;0;.00nan;0;0
4876;190258;521;0;0;0;0;.00nan;0;0
4876;62287;521;66;27;3;24;.889;3600000;0
4876;68425;519;31;3;2;1;.333;368000;0
4876;143330;519;37;37;6;31;.838;3232000;0
4877;-1;511;0;0;0;0;.00nan;0;0
4877;68565;513;98;38;2;36;.947;3579000;0
4877;86344;511;100;39;0;39;1.000;3600000;0
4877;143421;513;0;0;0;0;.00nan;0;0
4878;200775;1472;19;26;6;20;.769;2729000;0
4878;216464;1472;80;15;0;15;1.000;871000;0
4878;142929;1872;0;0;0;0;.00nan;0;0
4878;143412;1872;54;12;1;11;.917;3600000;0
4879;63107;1876;100;50;2;48;.960;3887000;0
4879;76951;515;0;0;0;0;.00nan;0;0
4879;142911;515;66;22;2;20;.909;3900000;0
4879;155465;1876;0;0;0;0;.00nan;0;0
4880;167047;512;0;0;0;0;.00nan;0;0
4880;11925;512;89;30;1;29;.967;3590000;0
4880;13613;520;0;0;0;0;.00nan;0;0
4880;143191;520;93;23;0;23;1.000;3600000;0
4881;168926;518;100;30;0;30;1.000;3600000;0
4881;169325;518;0;0;0;0;.00nan;0;0
4881;143307;517;0;0;0;0;.00nan;0;0
4881;152202;517;77;36;3;33;.917;3600000;0
4882;54290;516;0;0;0;0;.00nan;0;0
4882;74734;514;87;20;1;19;.950;3600000;0
4882;78806;514;0;0;0;0;.00nan;0;0
4882;143100;516;60;38;6;32;.842;3600000;0
4883;68425;519;0;0;0;0;.00nan;0;0
4883;74734;514;62;30;3;27;.900;3821000;0
4883;78806;514;0;0;0;0;.00nan;0;0
4883;143330;519;90;44;4;40;.909;3842000;0
4884;200775;1472;0;0;0;0;.00nan;0;0
4884;216464;1472;64;39;4;35;.897;3518000;0
4884;68565;513;82;25;2;23;.920;3600000;0
4884;143421;513;0;0;0;0;.00nan;0;0
4885;190258;521;0;0;0;0;.00nan;0;0
4885;-1;511;0;0;0;0;.00nan;0;0
4885;62287;521;87;29;1;28;.966;3900000;0
4885;86344;511;75;26;1;25;.962;3900000;0
4886;63107;1876;76;26;1;25;.962;3600000;0
4886;142929;1872;0;0;0;0;.00nan;0;0
4886;143412;1872;79;33;2;31;.939;3551000;0
4886;155465;1876;0;0;0;0;.00nan;0;0
4887;54290;516;89;35;2;33;.943;3573000;0
4887;143100;516;0;0;0;0;.00nan;0;0
4887;143307;517;0;0;0;0;.00nan;0;0
4887;152202;517;89;30;1;29;.967;3600000;0
4888;13613;520;0;0;0;0;.00nan;0;0
4888;168926;518;76;33;2;31;.939;3900000;0
4888;169325;518;0;0;0;0;.00nan;0;0
4888;143191;520;100;44;2;42;.955;3900000;0
4889;167047;512;0;0;0;0;.00nan;0;0
4889;11925;512;74;26;1;25;.962;3600000;0
4889;76951;515;0;0;0;0;.00nan;0;0
4889;142911;515;40;22;4;18;.818;3600000;0
4890;190258;521;57;17;2;15;.882;3814000;0
4890;54290;516;0;0;0;0;.00nan;0;0
4890;62287;521;0;0;0;0;.00nan;0;0
4890;143100;516;99;50;1;49;.980;3814000;0
4891;68425;519;0;0;0;0;.00nan;0;0
4891;68565;513;0;0;0;0;.00nan;0;0
4891;143330;519;89;41;2;39;.951;3900000;0
4891;143421;513;55;16;2;14;.875;3900000;0
4892;200775;1472;0;0;0;0;.00nan;0;0
4892;216464;1472;45;28;5;23;.821;3600000;0
4892;63107;1876;67;11;1;10;.909;3600000;0
4892;155465;1876;0;0;0;0;.00nan;0;0
4893;167047;512;0;0;0;0;.00nan;0;0
4893;11925;512;65;33;4;29;.879;3552000;0
4893;142929;1872;0;0;0;0;.00nan;0;0
4893;143412;1872;73;28;2;26;.929;3600000;0
4894;-1;511;0;0;0;0;.00nan;0;0
4894;76951;515;85;34;2;32;.941;3900000;0
4894;86344;511;74;28;2;26;.929;3900000;0
4894;142911;515;0;0;0;0;.00nan;0;0
4895;13613;520;0;0;0;0;.00nan;0;0
4895;143191;520;77;22;1;21;.955;3600000;0
4895;143307;517;0;0;0;0;.00nan;0;0
4895;152202;517;72;27;2;25;.926;3600000;0
4896;168926;518;71;31;2;29;.935;3600000;0
4896;169325;518;0;0;0;0;.00nan;0;0
4896;74734;514;0;0;0;0;.00nan;0;0
4896;78806;514;49;28;5;23;.821;3600000;0
4897;168926;518;64;23;2;21;.913;3600000;0
4897;169325;518;0;0;0;0;.00nan;0;0
4897;190258;521;0;0;0;0;.00nan;0;0
4897;62287;521;44;29;5;24;.828;3600000;0
4898;54290;516;0;0;0;0;.00nan;0;0
4898;68565;513;60;21;2;19;.905;3593000;0
4898;143100;516;99;44;1;43;.977;3600000;0
4898;143421;513;0;0;0;0;.00nan;0;0
4899;167047;512;0;0;0;0;.00nan;0;0
4899;11925;512;76;21;1;20;.952;3600000;0
4899;63107;1876;70;42;4;38;.905;3600000;0
4899;155465;1876;0;0;0;0;.00nan;0;0
4900;68425;519;0;0;0;0;.00nan;0;0
4900;142929;1872;0;0;0;0;.00nan;0;0
4900;143330;519;77;41;3;38;.927;3600000;0
4900;143412;1872;73;25;2;23;.920;3600000;0
4901;200775;1472;0;0;0;0;.00nan;0;0
4901;216464;1472;94;53;4;49;.925;3559000;0
4901;76951;515;0;0;0;0;.00nan;0;0
4901;142911;515;45;11;2;9;.818;3600000;0
4902;-1;511;0;0;0;0;.00nan;0;0
4902;86344;511;35;18;4;14;.778;3669000;0
4902;143307;517;0;0;0;0;.00nan;0;0
4902;152202;517;67;34;3;31;.912;3669000;0
4903;13613;520;52;9;1;8;.889;839000;0
4903;74734;514;75;22;1;21;.955;3600000;0
4903;78806;514;0;0;0;0;.00nan;0;0
4903;143191;520;42;37;6;31;.838;2761000;0
4904;68425;519;89;36;2;34;.944;3600000;0
4904;68565;513;47;22;4;18;.818;3534000;0
4904;143330;519;0;0;0;0;.00nan;0;0
4904;143421;513;0;0;0;0;.00nan;0;0
4905;200775;1472;55;4;0;4;1.000;473000;0
4905;216464;1472;45;36;6;30;.833;3127000;0
4905;63107;1876;92;28;1;27;.964;3600000;0
4905;155465;1876;0;0;0;0;.00nan;0;0
4906;-1;511;91;30;1;29;.967;3600000;0
4906;76951;515;0;0;0;0;.00nan;0;0
4906;86344;511;0;0;0;0;.00nan;0;0
4906;142911;515;44;18;3;15;.833;3522000;0
4907;13613;520;68;17;1;16;.941;3600000;0
4907;143191;520;0;0;0;0;.00nan;0;0
4907;143307;517;0;0;0;0;.00nan;0;0
4907;152202;517;94;41;2;39;.951;3572000;0
4908;190258;521;0;0;0;0;.00nan;0;0
4908;54290;516;0;0;0;0;.00nan;0;0
4908;62287;521;51;29;4;25;.862;3557000;0
4908;143100;516;81;37;3;34;.919;3600000;0
4909;167047;512;0;0;0;0;.00nan;0;0
4909;11925;512;86;24;1;23;.958;3600000;0
4909;142929;1872;0;0;0;0;.00nan;0;0
4909;143412;1872;87;41;3;38;.927;3574000;0
4910;168926;518;83;32;2;30;.938;3900000;0
4910;169325;518;0;0;0;0;.00nan;0;0
4910;74734;514;0;0;0;0;.00nan;0;0
4910;78806;514;91;34;2;32;.941;3900000;0
4911;13613;520;0;0;0;0;.00nan;0;0
4911;190258;521;0;0;0;0;.00nan;0;0
4911;62287;521;83;31;1;30;.968;3900000;0
4911;143191;520;95;36;1;35;.972;3900000;0
4912;168926;518;83;27;1;26;.963;3546000;0
4912;169325;518;0;0;0;0;.00nan;0;0
4912;68565;513;100;24;0;24;1.000;3600000;0
4912;143421;513;0;0;0;0;.00nan;0;0
4913;63107;1876;74;29;2;27;.931;3600000;0
4913;68425;519;0;0;0;0;.00nan;0;0
4913;143330;519;87;28;1;27;.964;3600000;0
4913;155465;1876;0;0;0;0;.00nan;0;0
4914;-1;511;0;0;0;0;.00nan;0;0
4914;86344;511;100;24;0;24;1.000;3600000;0
4914;142929;1872;90;41;1;40;.976;3590000;0
4914;143412;1872;0;0;0;0;.00nan;0;0
4915;54290;516;0;0;0;0;.00nan;0;0
4915;76951;515;0;0;0;0;.00nan;0;0
4915;142911;515;82;29;2;27;.931;3600000;0
4915;143100;516;69;28;3;25;.893;3600000;0
4916;74734;514;86;16;0;16;1.000;3600000;0
4916;78806;514;0;0;0;0;.00nan;0;0
4916;143307;517;0;0;0;0;.00nan;0;0
4916;152202;517;66;43;4;39;.907;3600000;0
4917;167047;512;0;0;0;0;.00nan;0;0
4917;11925;512;50;19;3;16;.842;3600000;0
4917;200775;1472;0;0;0;0;.00nan;0;0
4917;216464;1472;58;43;4;39;.907;3600000;0
4918;200775;1472;0;0;0;0;.00nan;0;0
4918;216464;1472;93;39;2;37;.949;3548000;0
4918;68425;519;0;0;0;0;.00nan;0;0
4918;143330;519;52;10;1;9;.900;3600000;0
4919;167047;512;0;0;0;0;.00nan;0;0
4919;11925;512;93;45;2;43;.956;3722000;0
4919;-1;511;0;0;0;0;.00nan;0;0
4919;86344;511;89;29;1;28;.966;3722000;0
4920;13613;520;0;0;0;0;.00nan;0;0
4920;76951;515;0;0;0;0;.00nan;0;0
4920;142911;515;33;36;6;30;.833;3600000;0
4920;143191;520;73;31;3;28;.903;3600000;0
4921;54290;516;0;0;0;0;.00nan;0;0
4921;142929;1872;0;0;0;0;.00nan;0;0
4921;143100;516;64;17;1;16;.941;3600000;0
4921;143412;1872;85;38;3;35;.921;3526000;0
4922;190258;521;0;0;0;0;.00nan;0;0
4922;62287;521;100;28;0;28;1.000;3600000;0
4922;143307;517;0;0;0;0;.00nan;0;0
4922;152202;517;97;36;1;35;.972;3600000;0
4923;168926;518;71;20;1;19;.950;3600000;0
4923;169325;518;0;0;0;0;.00nan;0;0
4923;63107;1876;38;35;6;29;.829;3600000;0
4923;155465;1876;0;0;0;0;.00nan;0;0
4924;68565;513;69;32;3;29;.906;3600000;0
4924;74734;514;0;0;0;0;.00nan;0;0
4924;78806;514;71;20;1;19;.950;3600000;0
4924;143421;513;0;0;0;0;.00nan;0;0
4925;200775;1472;0;0;0;0;.00nan;0;0
4925;216464;1472;69;52;5;47;.904;3600000;0
4925;54290;516;0;0;0;0;.00nan;0;0
4925;143100;516;65;16;1;15;.938;3600000;0
4926;190258;521;0;0;0;0;.00nan;0;0
4926;62287;521;73;31;4;27;.871;3894000;0
4926;74734;514;88;38;3;35;.921;3894000;0
4926;78806;514;0;0;0;0;.00nan;0;0
4927;13613;520;0;0;0;0;.00nan;0;0
4927;68565;513;98;50;3;47;.940;3571000;0
4927;143191;520;65;21;2;19;.905;3600000;0
4927;143421;513;0;0;0;0;.00nan;0;0
4928;-1;511;0;0;0;0;.00nan;0;0
4928;63107;1876;100;31;0;31;1.000;3600000;0
4928;86344;511;75;26;1;25;.962;3551000;0
4928;155465;1876;0;0;0;0;.00nan;0;0
4929;142929;1872;0;0;0;0;.00nan;0;0
4929;143307;517;0;0;0;0;.00nan;0;0
4929;143412;1872;76;39;5;34;.872;3600000;0
4929;152202;517;77;18;1;17;.944;3600000;0
4930;168926;518;100;27;0;27;1.000;3600000;0
4930;169325;518;0;0;0;0;.00nan;0;0
4930;76951;515;0;0;0;0;.00nan;0;0
4930;142911;515;82;28;2;26;.929;3585000;0
4931;167047;512;0;0;0;0;.00nan;0;0
4931;11925;512;85;17;0;17;1.000;3600000;0
4931;68425;519;0;0;0;0;.00nan;0;0
4931;143330;519;58;41;5;36;.878;3600000;0
4932;-1;511;0;0;0;0;.00nan;0;0
4932;68425;519;0;0;0;0;.00nan;0;0
4932;86344;511;52;18;3;15;.833;3839000;0
4932;143330;519;93;33;2;31;.939;3839000;0
4933;190258;521;57;27;4;23;.852;3600000;0
4933;62287;521;0;0;0;0;.00nan;0;0
4933;68565;513;40;30;5;25;.833;3600000;0
4933;143421;513;0;0;0;0;.00nan;0;0
4934;13613;520;100;35;1;34;.971;3600000;0
4934;142929;1872;0;0;0;0;.00nan;0;0
4934;143191;520;0;0;0;0;.00nan;0;0
4934;143412;1872;56;38;5;33;.868;3600000;0
4935;167047;512;0;0;0;0;.00nan;0;0
4935;11925;512;83;30;2;28;.933;3900000;0
4935;54290;516;0;0;0;0;.00nan;0;0
4935;143100;516;86;38;2;36;.947;3900000;0
4936;76951;515;0;0;0;0;.00nan;0;0
4936;142911;515;80;24;1;23;.958;3600000;0
4936;143307;517;82;38;3;35;.921;3587000;0
4936;152202;517;0;0;0;0;.00nan;0;0
4937;168926;518;83;13;0;13;1.000;3600000;0
4937;169325;518;0;0;0;0;.00nan;0;0
4937;200775;1472;0;0;0;0;.00nan;0;0
4937;216464;1472;98;52;1;51;.981;3588000;0
4938;63107;1876;63;33;4;29;.879;3600000;0
4938;74734;514;0;0;0;0;.00nan;0;0
4938;78806;514;76;18;1;17;.944;3600000;0
4938;155465;1876;0;0;0;0;.00nan;0;0
4939;54290;516;0;0;0;0;.00nan;0;0
4939;68425;519;100;27;0;27;1.000;2537000;0
4939;143100;516;60;35;5;30;.857;3547000;0
4939;143330;519;35;17;4;13;.765;1063000;0
4940;200775;1472;55;37;5;32;.865;2347000;0
4940;216464;1472;50;15;2;13;.867;1253000;0
4940;-1;511;0;0;0;0;.00nan;0;0
4940;86344;511;95;24;0;24;1.000;3600000;0
4941;68565;513;0;0;0;0;.00nan;0;0
4941;143307;517;0;0;0;0;.00nan;0;0
4941;143421;513;56;26;3;23;.885;3600000;0
4941;152202;517;53;32;4;28;.875;3600000;0
4942;13613;520;0;0;0;0;.00nan;0;0
4942;63107;1876;71;52;5;47;.904;3600000;0
4942;143191;520;94;18;0;18;1.000;3600000;0
4942;155465;1876;0;0;0;0;.00nan;0;0
4943;168926;518;58;20;2;18;.900;3600000;0
4943;169325;518;0;0;0;0;.00nan;0;0
4943;142929;1872;0;0;0;0;.00nan;0;0
4943;143412;1872;45;37;5;32;.865;3600000;0
4944;74734;514;67;29;2;27;.931;3600000;0
4944;76951;515;78;41;3;38;.927;3569000;0
4944;78806;514;0;0;0;0;.00nan;0;0
4944;142911;515;0;0;0;0;.00nan;0;0
4945;167047;512;0;0;0;0;.00nan;0;0
4945;11925;512;99;38;1;37;.974;3600000;0
4945;190258;521;0;0;0;0;.00nan;0;0
4945;62287;521;46;27;4;23;.852;3600000;0
4946;168926;518;91;20;0;20;1.000;3600000;0
4946;169325;518;0;0;0;0;.00nan;0;0
4946;68425;519;0;0;0;0;.00nan;0;0
4946;143330;519;37;33;6;27;.818;3600000;0
4947;200775;1472;0;0;0;0;.00nan;0;0
4947;216464;1472;80;50;4;46;.920;3600000;0
4947;74734;514;0;0;0;0;.00nan;0;0
4947;78806;514;75;21;1;20;.952;3600000;0
4948;13613;520;0;0;0;0;.00nan;0;0
4948;-1;511;0;0;0;0;.00nan;0;0
4948;86344;511;54;32;4;28;.875;3753000;0
4948;143191;520;48;38;5;33;.868;3753000;0
4949;54290;516;0;0;0;0;.00nan;0;0
4949;63107;1876;55;37;5;32;.865;3545000;0
4949;143100;516;63;32;4;28;.875;3600000;0
4949;155465;1876;0;0;0;0;.00nan;0;0
4950;68565;513;55;19;2;17;.895;3600000;0
4950;142929;1872;0;0;0;0;.00nan;0;0
4950;143412;1872;84;37;3;34;.919;3563000;0
4950;143421;513;0;0;0;0;.00nan;0;0
4951;190258;521;0;0;0;0;.00nan;0;0
4951;62287;521;69;27;2;25;.926;3600000;0
4951;76951;515;0;0;0;0;.00nan;0;0
4951;142911;515;52;30;4;26;.867;3512000;0
4952;167047;512;0;0;0;0;.00nan;0;0
4952;11925;512;80;15;0;15;1.000;3600000;0
4952;143307;517;0;0;0;0;.00nan;0;0
4952;152202;517;36;23;4;19;.826;3600000;0
4953;200775;1472;0;0;0;0;.00nan;0;0
4953;216464;1472;87;54;2;52;.963;3900000;0
4953;190258;521;0;0;0;0;.00nan;0;0
4953;62287;521;53;17;2;15;.882;3900000;0
4954;68565;513;70;33;3;30;.909;3517000;0
4954;76951;515;0;0;0;0;.00nan;0;0
4954;142911;515;86;26;1;25;.962;3600000;0
4954;143421;513;0;0;0;0;.00nan;0;0
4955;13613;520;100;29;0;29;1.000;3600000;0
4955;68425;519;0;0;0;0;.00nan;0;0
4955;143191;520;0;0;0;0;.00nan;0;0
4955;143330;519;58;23;3;20;.870;3600000;0
4956;-1;511;0;0;0;0;.00nan;0;0
4956;54290;516;0;0;0;0;.00nan;0;0
4956;86344;511;65;21;2;19;.905;3600000;0
4956;143100;516;64;38;4;34;.895;3516000;0
4957;63107;1876;98;45;2;43;.956;3600000;0
4957;143307;517;0;0;0;0;.00nan;0;0
4957;152202;517;68;20;1;19;.950;3600000;0
4957;155465;1876;0;0;0;0;.00nan;0;0
4958;167047;512;0;0;0;0;.00nan;0;0
4958;11925;512;70;43;4;39;.907;3566000;0
4958;168926;518;0;0;0;0;.00nan;0;0
4958;169325;518;76;36;3;33;.917;3600000;0
4959;74734;514;88;28;1;27;.964;3900000;0
4959;78806;514;0;0;0;0;.00nan;0;0
4959;142929;1872;0;0;0;0;.00nan;0;0
4959;143412;1872;86;39;1;38;.974;3900000;0
4960;68425;519;0;0;0;0;.00nan;0;0
4960;143307;517;0;0;0;0;.00nan;0;0
4960;143330;519;72;27;2;25;.926;3900000;0
4960;152202;517;78;25;2;23;.920;3900000;0
4961;13613;520;70;8;0;8;1.000;3600000;0
4961;200775;1472;0;0;0;0;.00nan;0;0
4961;216464;1472;98;54;3;51;.944;3600000;0
4961;143191;520;0;0;0;0;.00nan;0;0
4962;-1;511;0;0;0;0;.00nan;0;0
4962;74734;514;0;0;0;0;.00nan;0;0
4962;78806;514;38;21;4;17;.810;3600000;0
4962;86344;511;45;39;5;34;.872;3600000;0
4963;190258;521;0;0;0;0;.00nan;0;0
4963;62287;521;44;19;3;16;.842;3560000;0
4963;63107;1876;0;0;0;0;.00nan;0;0
4963;155465;1876;92;33;1;32;.970;3600000;0
4964;76951;515;0;0;0;0;.00nan;0;0
4964;142911;515;85;15;0;15;1.000;3600000;0
4964;142929;1872;0;0;0;0;.00nan;0;0
4964;143412;1872;66;49;6;43;.878;3600000;0
4965;168926;518;44;26;4;22;.846;3565000;0
4965;169325;518;0;0;0;0;.00nan;0;0
4965;54290;516;0;0;0;0;.00nan;0;0
4965;143100;516;88;43;3;40;.930;3600000;0
4966;167047;512;0;0;0;0;.00nan;0;0
4966;11925;512;85;25;1;24;.960;3900000;0
4966;68565;513;96;44;1;43;.977;3900000;0
4966;143421;513;0;0;0;0;.00nan;0;0
4967;190258;521;89;22;0;22;1.000;3600000;0
4967;62287;521;0;0;0;0;.00nan;0;0
4967;142929;1872;0;0;0;0;.00nan;0;0
4967;143412;1872;82;29;2;27;.931;3568000;0
4968;63107;1876;46;27;4;23;.852;3600000;0
4968;68565;513;0;0;0;0;.00nan;0;0
4968;143421;513;94;33;1;32;.970;3600000;0
4968;155465;1876;0;0;0;0;.00nan;0;0
4969;68425;519;0;0;0;0;.00nan;0;0
4969;76951;515;0;0;0;0;.00nan;0;0
4969;142911;515;61;24;2;22;.917;3600000;0
4969;143330;519;86;45;3;42;.933;3595000;0
4970;13613;520;85;37;2;35;.946;3900000;0
4970;54290;516;0;0;0;0;.00nan;0;0
4970;143100;516;98;38;2;36;.947;3900000;0
4970;143191;520;0;0;0;0;.00nan;0;0
4971;200775;1472;59;39;5;34;.872;3535000;0
4971;216464;1472;0;0;0;0;.00nan;0;0
4971;143307;517;0;0;0;0;.00nan;0;0
4971;152202;517;68;24;2;22;.917;3600000;0
4972;168926;518;92;47;2;45;.957;3722000;0
4972;169325;518;0;0;0;0;.00nan;0;0
4972;-1;511;0;0;0;0;.00nan;0;0
4972;86344;511;87;28;1;27;.964;3722000;0
4973;167047;512;0;0;0;0;.00nan;0;0
4973;11925;512;82;29;2;27;.931;3600000;0
4973;74734;514;86;26;1;25;.962;3600000;0
4973;78806;514;0;0;0;0;.00nan;0;0
4974;190258;521;65;22;2;20;.909;3600000;0
4974;62287;521;0;0;0;0;.00nan;0;0
4974;68425;519;0;0;0;0;.00nan;0;0
4974;143330;519;59;32;4;28;.875;3600000;0
4975;200775;1472;0;0;0;0;.00nan;0;0
4975;216464;1472;47;29;4;25;.862;3600000;0
4975;142929;1872;0;0;0;0;.00nan;0;0
4975;143412;1872;57;22;3;19;.864;3600000;0
4976;-1;511;51;2;0;2;1.000;409000;0
4976;68565;513;60;13;1;12;.923;3600000;0
4976;86344;511;31;33;7;26;.788;3191000;0
4976;143421;513;0;0;0;0;.00nan;0;0
4977;63107;1876;39;34;6;28;.824;3117000;0
4977;76951;515;0;0;0;0;.00nan;0;0
4977;142911;515;86;28;1;27;.964;3600000;0
4977;155465;1876;38;8;2;6;.750;483000;0
4978;54290;516;0;0;0;0;.00nan;0;0
4978;74734;514;0;0;0;0;.00nan;0;0
4978;78806;514;40;27;4;23;.852;3587000;0
4978;143100;516;91;36;2;34;.944;3600000;0
4979;168926;518;47;24;4;20;.833;3550000;0
4979;169325;518;0;0;0;0;.00nan;0;0
4979;143307;517;0;0;0;0;.00nan;0;0
4979;152202;517;69;26;3;23;.885;3600000;0
4980;167047;512;85;30;1;29;.967;3083000;0
4980;11925;512;29;11;3;8;.727;493000;0
4980;13613;520;0;0;0;0;.00nan;0;0
4980;143191;520;69;31;3;28;.903;3600000;0
4981;190258;521;0;0;0;0;.00nan;0;0
4981;-1;511;0;0;0;0;.00nan;0;0
4981;62287;521;68;26;2;24;.923;3600000;0
4981;86344;511;70;16;1;15;.938;3600000;0
4982;200775;1472;0;0;0;0;.00nan;0;0
4982;216464;1472;58;37;5;32;.865;3565000;0
4982;68565;513;43;23;4;19;.826;3600000;0
4982;143421;513;0;0;0;0;.00nan;0;0
4983;63107;1876;92;32;1;31;.969;3600000;0
4983;142929;1872;55;29;5;24;.828;3600000;0
4983;143412;1872;0;0;0;0;.00nan;0;0
4983;155465;1876;0;0;0;0;.00nan;0;0
4984;167047;512;0;0;0;0;.00nan;0;0
4984;11925;512;47;30;5;25;.833;3600000;0
4984;76951;515;92;17;0;17;1.000;3600000;0
4984;142911;515;0;0;0;0;.00nan;0;0
4985;13613;520;53;39;5;34;.872;3531000;0
4985;168926;518;55;26;3;23;.885;3600000;0
4985;169325;518;0;0;0;0;.00nan;0;0
4985;143191;520;0;0;0;0;.00nan;0;0
4986;54290;516;0;0;0;0;.00nan;0;0
4986;143100;516;63;23;2;21;.913;3600000;0
4986;143307;517;32;19;4;15;.789;3600000;0
4986;152202;517;0;0;0;0;.00nan;0;0
4987;68425;519;0;0;0;0;.00nan;0;0
4987;74734;514;85;24;1;23;.958;3600000;0
4987;78806;514;0;0;0;0;.00nan;0;0
4987;143330;519;78;32;2;30;.938;3573000;0
4988;68425;519;0;0;0;0;.00nan;0;0
4988;142929;1872;0;0;0;0;.00nan;0;0
4988;143330;519;71;26;2;24;.923;3511000;0
4988;143412;1872;100;37;0;37;1.000;3600000;0
4989;200775;1472;0;0;0;0;.00nan;0;0
4989;216464;1472;60;35;5;30;.857;3600000;0
4989;76951;515;79;13;0;13;1.000;3600000;0
4989;142911;515;0;0;0;0;.00nan;0;0
4990;-1;511;0;0;0;0;.00nan;0;0
4990;86344;511;91;33;1;32;.970;3600000;0
4990;143307;517;0;0;0;0;.00nan;0;0
4990;152202;517;63;27;3;24;.889;3600000;0
4991;13613;520;0;0;0;0;.00nan;0;0
4991;74734;514;0;0;0;0;.00nan;0;0
4991;78806;514;63;17;1;16;.941;3600000;0
4991;143191;520;81;36;2;34;.944;3566000;0
4992;54290;516;0;0;0;0;.00nan;0;0
4992;68565;513;94;43;3;40;.930;3585000;0
4992;143100;516;74;21;2;19;.905;3600000;0
4992;143421;513;0;0;0;0;.00nan;0;0
4993;168926;518;0;0;0;0;.00nan;0;0
4993;169325;518;97;21;0;21;1.000;3600000;0
4993;190258;521;83;28;1;27;.964;3600000;0
4993;62287;521;0;0;0;0;.00nan;0;0
4994;167047;512;0;0;0;0;.00nan;0;0
4994;11925;512;54;23;3;20;.870;3549000;0
4994;63107;1876;80;33;2;31;.939;3600000;0
4994;155465;1876;0;0;0;0;.00nan;0;0
4995;63107;1876;98;42;2;40;.952;3578000;0
4995;68425;519;100;21;0;21;1.000;3600000;0
4995;143330;519;0;0;0;0;.00nan;0;0
4995;155465;1876;0;0;0;0;.00nan;0;0
4996;167047;512;0;0;0;0;.00nan;0;0
4996;11925;512;66;23;2;21;.913;3600000;0
4996;200775;1472;47;43;7;36;.837;3600000;0
4996;216464;1472;0;0;0;0;.00nan;0;0
4997;-1;511;0;0;0;0;.00nan;0;0
4997;86344;511;81;26;1;25;.962;3600000;0
4997;142929;1872;0;0;0;0;.00nan;0;0
4997;143412;1872;98;55;4;51;.927;3600000;0
4998;13613;520;0;0;0;0;.00nan;0;0
4998;190258;521;0;0;0;0;.00nan;0;0
4998;62287;521;70;29;2;27;.931;3600000;0
4998;143191;520;61;27;3;24;.889;3600000;0
4999;54290;516;0;0;0;0;.00nan;0;0
4999;76951;515;89;26;1;25;.962;3600000;0
4999;142911;515;0;0;0;0;.00nan;0;0
4999;143100;516;64;36;4;32;.889;3600000;0
5000;168926;518;0;0;0;0;.00nan;0;0
5000;169325;518;65;22;2;20;.909;3600000;0
5000;68565;513;66;30;3;27;.900;3586000;0
5000;143421;513;0;0;0;0;.00nan;0;0
5001;74734;514;0;0;0;0;.00nan;0;0
5001;78806;514;71;31;2;29;.935;3600000;0
5001;143307;517;0;0;0;0;.00nan;0;0
5001;152202;517;66;43;4;39;.907;3534000;0
5002;200775;1472;0;0;0;0;.00nan;0;0
5002;216464;1472;37;28;5;23;.821;3600000;0
5002;68425;519;66;22;2;20;.909;3600000;0
5002;143330;519;0;0;0;0;.00nan;0;0
5003;190258;521;94;25;1;24;.960;3600000;0
5003;62287;521;0;0;0;0;.00nan;0;0
5003;143307;517;0;0;0;0;.00nan;0;0
5003;152202;517;82;33;2;31;.939;3575000;0
5004;68565;513;76;21;1;20;.952;2458000;0
5004;74734;514;0;0;0;0;.00nan;0;0
5004;78806;514;66;20;2;18;.900;3600000;0
5004;143421;513;22;9;4;5;.556;1142000;0
5005;168926;518;39;27;5;22;.815;3600000;0
5005;169325;518;0;0;0;0;.00nan;0;0
5005;63107;1876;90;34;1;33;.971;3600000;0
5005;155465;1876;0;0;0;0;.00nan;0;0
5006;54290;516;0;0;0;0;.00nan;0;0
5006;142929;1872;0;0;0;0;.00nan;0;0
5006;143100;516;91;36;2;34;.944;3900000;0
5006;143412;1872;100;50;2;48;.960;3900000;0
5007;13613;520;73;34;2;32;.941;3682000;0
5007;76951;515;0;0;0;0;.00nan;0;0
5007;142911;515;80;23;1;22;.957;3682000;0
5007;143191;520;0;0;0;0;.00nan;0;0
5008;167047;512;0;0;0;0;.00nan;0;0
5008;11925;512;89;44;3;41;.932;3544000;0
5008;-1;511;0;0;0;0;.00nan;0;0
5008;86344;511;78;26;1;25;.962;3600000;0
5009;167047;512;0;0;0;0;.00nan;0;0
5009;11925;512;53;22;3;19;.864;3574000;0
5009;68425;519;0;0;0;0;.00nan;0;0
5009;143330;519;86;37;2;35;.946;3600000;0
5010;-1;511;0;0;0;0;.00nan;0;0
5010;63107;1876;86;39;2;37;.949;3543000;0
5010;86344;511;66;14;1;13;.929;3600000;0
5010;155465;1876;0;0;0;0;.00nan;0;0
5011;13613;520;0;0;0;0;.00nan;0;0
5011;68565;513;69;25;2;23;.920;3600000;0
5011;143191;520;49;26;4;22;.846;3515000;0
5011;143421;513;0;0;0;0;.00nan;0;0
5012;200775;1472;55;5;0;5;1.000;709000;0
5012;216464;1472;37;34;6;28;.824;2891000;0
5012;54290;516;0;0;0;0;.00nan;0;0
5012;143100;516;65;23;2;21;.913;3600000;0
5013;142929;1872;0;0;0;0;.00nan;0;0
5013;143307;517;0;0;0;0;.00nan;0;0
5013;143412;1872;98;36;1;35;.972;3900000;0
5013;152202;517;81;33;1;32;.970;3900000;0
5014;168926;518;73;22;1;21;.955;3588000;0
5014;169325;518;0;0;0;0;.00nan;0;0
5014;76951;515;0;0;0;0;.00nan;0;0
5014;142911;515;100;35;0;35;1.000;3600000;0
5015;190258;521;0;0;0;0;.00nan;0;0
5015;62287;521;63;38;4;34;.895;3600000;0
5015;74734;514;100;29;0;29;1.000;3600000;0
5015;78806;514;0;0;0;0;.00nan;0;0
5016;-1;511;0;0;0;0;.00nan;0;0
5016;68425;519;0;0;0;0;.00nan;0;0
5016;86344;511;66;30;3;27;.900;3563000;0
5016;143330;519;99;54;2;52;.963;3600000;0
5017;168926;518;53;15;2;13;.867;3600000;0
5017;169325;518;0;0;0;0;.00nan;0;0
5017;200775;1472;0;0;0;0;.00nan;0;0
5017;216464;1472;78;46;4;42;.913;3593000;0
5018;190258;521;0;0;0;0;.00nan;0;0
5018;62287;521;57;18;2;16;.889;3600000;0
5018;68565;513;69;20;1;19;.950;3600000;0
5018;143421;513;0;0;0;0;.00nan;0;0
5019;63107;1876;26;26;6;20;.769;2711000;0
5019;74734;514;76;17;1;16;.941;3600000;0
5019;78806;514;0;0;0;0;.00nan;0;0
5019;155465;1876;56;13;1;12;.923;889000;0
5020;13613;520;0;0;0;0;.00nan;0;0
5020;142929;1872;0;0;0;0;.00nan;0;0
5020;143191;520;63;15;1;14;.933;3600000;0
5020;143412;1872;83;30;2;28;.933;3552000;0
5021;76951;515;0;0;0;0;.00nan;0;0
5021;142911;515;82;31;2;29;.935;3600000;0
5021;143307;517;63;8;0;8;1.000;1349000;0
5021;152202;517;41;27;4;23;.852;2181000;0
5022;167047;512;83;30;1;29;.967;3600000;0
5022;11925;512;0;0;0;0;.00nan;0;0
5022;54290;516;0;0;0;0;.00nan;0;0
5022;143100;516;90;39;3;36;.923;3580000;0
5023;200775;1472;0;0;0;0;.00nan;0;0
5023;216464;1472;75;31;3;28;.903;3600000;0
5023;-1;511;0;0;0;0;.00nan;0;0
5023;86344;511;86;25;1;24;.960;3600000;0
5024;167047;512;0;0;0;0;.00nan;0;0
5024;11925;512;86;30;1;29;.967;3600000;0
5024;190258;521;0;0;0;0;.00nan;0;0
5024;62287;521;69;27;2;25;.926;3563000;0
5025;13613;520;77;24;1;23;.958;3600000;0
5025;63107;1876;57;44;6;38;.864;3600000;0
5025;143191;520;0;0;0;0;.00nan;0;0
5025;155465;1876;0;0;0;0;.00nan;0;0
5026;54290;516;90;28;1;27;.964;3600000;0
5026;68425;519;0;0;0;0;.00nan;0;0
5026;143100;516;0;0;0;0;.00nan;0;0
5026;143330;519;81;36;2;34;.944;3543000;0
5027;68565;513;74;27;2;25;.926;3600000;0
5027;143307;517;0;0;0;0;.00nan;0;0
5027;143421;513;0;0;0;0;.00nan;0;0
5027;152202;517;61;43;5;38;.884;3600000;0
5028;168926;518;0;0;0;0;.00nan;0;0
5028;169325;518;100;23;0;23;1.000;3600000;0
5028;142929;1872;0;0;0;0;.00nan;0;0
5028;143412;1872;87;46;4;42;.913;3600000;0
5029;74734;514;0;0;0;0;.00nan;0;0
5029;76951;515;0;0;0;0;.00nan;0;0
5029;78806;514;56;29;4;25;.862;3553000;0
5029;142911;515;68;30;3;27;.900;3600000;0
5031;167047;512;0;0;0;0;.00nan;0;0
5031;11925;512;75;27;1;26;.963;3600000;0
5031;68425;519;0;0;0;0;.00nan;0;0
5031;143330;519;91;42;3;39;.929;3566000;0
5033;13613;520;0;0;0;0;.00nan;0;0
5033;190258;521;0;0;0;0;.00nan;0;0
5033;62287;521;71;22;1;21;.955;3600000;0
5033;143191;520;58;31;3;28;.903;3531000;0
5035;63107;1876;60;44;5;39;.886;3600000;0
5035;142929;1872;66;24;2;22;.917;3600000;0
5035;143412;1872;0;0;0;0;.00nan;0;0
5035;155465;1876;0;0;0;0;.00nan;0;0
5037;-1;511;29;29;6;23;.793;2908000;0
5037;67764;511;55;1;0;1;1.000;656000;0
5037;76951;517;73;34;4;30;.882;3600000;0
5037;152202;517;0;0;0;0;.00nan;0;0
5039;169325;518;71;26;1;25;.962;3600000;0
5039;185028;518;0;0;0;0;.00nan;0;0
5039;68565;513;70;27;3;24;.889;3571000;0
5039;143421;513;0;0;0;0;.00nan;0;0
5045;200775;1472;0;0;0;0;.00nan;0;0
5045;216464;1472;81;52;4;48;.923;3600000;0
5045;54290;516;0;0;0;0;.00nan;0;0
5045;143100;516;80;12;0;12;1.000;3600000;0
5047;13613;520;48;21;3;18;.857;3600000;0
5047;76951;517;58;39;5;34;.872;3538000;0
5047;143191;520;0;0;0;0;.00nan;0;0
5047;152202;517;0;0;0;0;.00nan;0;0
5049;169325;518;34;19;4;15;.789;3600000;0
5049;185028;518;0;0;0;0;.00nan;0;0
5049;63107;1876;49;35;6;29;.829;3572000;0
5049;155465;1876;0;0;0;0;.00nan;0;0
5051;142911;515;0;0;0;0;.00nan;0;0
5051;142929;1872;0;0;0;0;.00nan;0;0
5051;143083;515;86;18;0;18;1.000;3600000;0
5051;143412;1872;81;31;1;30;.968;3570000;0
5053;68425;519;0;0;0;0;.00nan;0;0
5053;143307;514;0;0;0;0;.00nan;0;0
5053;143330;519;99;50;2;48;.960;3739000;0
5053;155529;514;83;33;3;30;.909;3739000;0
5055;167047;512;0;0;0;0;.00nan;0;0
5055;11925;512;43;40;6;34;.850;3600000;0
5055;-1;511;17;26;7;19;.731;3085000;0
5055;67764;511;46;4;1;3;.750;515000;0
5057;190258;521;69;33;3;30;.909;3600000;0
5057;62287;521;0;0;0;0;.00nan;0;0
5057;68565;513;53;38;5;33;.868;3560000;0
5057;143421;513;0;0;0;0;.00nan;0;0
5061;-1;511;0;0;0;0;.00nan;0;0
5061;67764;511;58;25;3;22;.880;3600000;0
5061;76951;517;0;0;0;0;.00nan;0;0
5061;152202;517;58;33;4;29;.879;3545000;0
5063;13613;520;0;0;0;0;.00nan;0;0
5063;200775;1472;92;59;4;55;.932;3600000;0
5063;216464;1472;0;0;0;0;.00nan;0;0
5063;143191;520;69;7;0;7;1.000;3600000;0
5065;167047;512;47;32;5;27;.844;3600000;0
5065;11925;512;0;0;0;0;.00nan;0;0
5065;68565;513;45;12;2;10;.833;1333000;0
5065;143421;513;12;16;5;11;.688;2267000;0
5067;63107;1876;0;0;0;0;.00nan;0;0
5067;68425;519;94;39;2;37;.949;3553000;0
5067;143330;519;0;0;0;0;.00nan;0;0
5067;155465;1876;78;27;1;26;.963;3600000;0
5069;169325;518;0;0;0;0;.00nan;0;0
5069;190258;521;0;0;0;0;.00nan;0;0
5069;185028;518;100;25;0;25;1.000;3600000;0
5069;62287;521;69;34;2;32;.941;3516000;0
5075;-1;511;54;19;2;17;.895;3600000;0
5075;67764;511;0;0;0;0;.00nan;0;0
5075;142929;1872;0;0;0;0;.00nan;0;0
5075;143412;1872;72;39;5;34;.872;3600000;0
5077;167047;512;0;0;0;0;.00nan;0;0
5077;11925;512;67;16;1;15;.938;3600000;0
5077;68565;513;0;0;0;0;.00nan;0;0
5077;143421;513;53;31;4;27;.871;3600000;0
5081;63107;1876;89;30;2;28;.933;3600000;0
5081;76951;517;54;21;3;18;.857;3583000;0
5081;152202;517;0;0;0;0;.00nan;0;0
5081;155465;1876;0;0;0;0;.00nan;0;0
5085;13613;520;0;0;0;0;.00nan;0;0
5085;68425;519;0;0;0;0;.00nan;0;0
5085;143191;520;54;10;1;9;.900;3600000;0
5085;143330;519;65;42;5;37;.881;3600000;0
5091;167047;512;81;30;2;28;.933;3656000;0
5091;11925;512;0;0;0;0;.00nan;0;0
5091;68565;513;49;19;3;16;.842;3656000;0
5091;143421;513;0;0;0;0;.00nan;0;0
5095;-1;511;0;0;0;0;.00nan;0;0
5095;67764;511;72;17;1;16;.941;3600000;0
5095;68425;519;44;39;6;33;.846;3600000;0
5095;143330;519;0;0;0;0;.00nan;0;0
5097;200775;1472;0;0;0;0;.00nan;0;0
5097;216464;1472;96;44;2;42;.955;3580000;0
5097;63107;1876;0;0;0;0;.00nan;0;0
5097;155465;1876;76;24;1;23;.958;3600000;0
5099;169325;518;0;0;0;0;.00nan;0;0
5099;190258;521;88;33;2;31;.939;3549000;0
5099;185028;518;79;23;1;22;.957;3600000;0
5099;62287;521;0;0;0;0;.00nan;0;0
5101;169325;518;63;16;1;15;.938;3600000;0
5101;185028;518;0;0;0;0;.00nan;0;0
5101;142929;1872;84;39;2;37;.949;3565000;0
5101;143412;1872;0;0;0;0;.00nan;0;0
5103;167047;512;0;0;0;0;.00nan;0;0
5103;11925;512;52;20;3;17;.850;3600000;0
5103;68565;513;0;0;0;0;.00nan;0;0
5103;143421;513;95;35;1;34;.971;3600000;0
5109;190258;521;0;0;0;0;.00nan;0;0
5109;62287;521;79;22;1;21;.955;3600000;0
5109;63107;1876;97;43;2;41;.953;3548000;0
5109;155465;1876;0;0;0;0;.00nan;0;0
5111;200775;1472;61;38;4;34;.895;3527000;0
5111;216464;1472;0;0;0;0;.00nan;0;0
5111;68425;519;0;0;0;0;.00nan;0;0
5111;143330;519;82;27;2;25;.926;3600000;0
5115;63107;1876;0;0;0;0;.00nan;0;0
5115;142929;1872;0;0;0;0;.00nan;0;0
5115;143412;1872;79;29;2;27;.931;3600000;0
5115;155465;1876;66;32;3;29;.906;3600000;0
5117;-1;511;82;38;3;35;.921;3900000;0
5117;67764;511;0;0;0;0;.00nan;0;0
5117;143307;514;67;24;3;21;.875;3900000;0
5117;155529;514;0;0;0;0;.00nan;0;0
5119;167047;512;34;23;5;18;.783;3785000;0
5119;11925;512;0;0;0;0;.00nan;0;0
5119;142911;515;0;0;0;0;.00nan;0;0
5119;143083;515;48;39;6;33;.846;3785000;0
5121;68565;513;79;32;2;30;.938;3600000;0
5121;76951;517;0;0;0;0;.00nan;0;0
5121;143421;513;0;0;0;0;.00nan;0;0
5121;152202;517;51;28;4;24;.857;3584000;0
5123;200775;1472;0;0;0;0;.00nan;0;0
5123;216464;1472;78;43;4;39;.907;3600000;0
5123;68425;519;74;22;1;21;.955;3600000;0
5123;143330;519;0;0;0;0;.00nan;0;0
5125;169325;518;0;0;0;0;.00nan;0;0
5125;185028;518;86;27;1;26;.963;3600000;0
5125;54290;516;0;0;0;0;.00nan;0;0
5125;143100;516;98;43;2;41;.953;3580000;0
5127;13613;520;100;34;1;33;.971;3617000;0
5127;190258;521;79;23;2;21;.913;3617000;0
5127;62287;521;0;0;0;0;.00nan;0;0
5127;143191;520;0;0;0;0;.00nan;0;0
995;13613;520;0;0;0;0;.00nan;0;0
995;143191;520;57;18;2;16;.889;3554000;0
995;143307;517;0;0;0;0;.00nan;0;0
995;152202;517;87;30;1;29;.967;3600000;0
996;167047;512;0;0;0;0;.00nan;0;0
996;11925;512;32;18;4;14;.778;3514000;0
996;63107;1876;80;27;2;25;.926;3600000;0
996;155465;1876;0;0;0;0;.00nan;0;0
997;68425;519;0;0;0;0;.00nan;0;0
997;68565;513;70;36;3;33;.917;3917000;0
997;143330;519;57;29;4;25;.862;3917000;0
997;143421;513;0;0;0;0;.00nan;0;0
998;190258;521;0;0;0;0;.00nan;0;0
998;54290;516;0;0;0;0;.00nan;0;0
998;62287;521;68;18;1;17;.944;3600000;0
998;143100;516;44;37;6;31;.838;3600000;0
999;13613;520;0;0;0;0;.00nan;0;0
999;143191;520;95;27;1;26;.963;3600000;0
999;143307;517;0;0;0;0;.00nan;0;0
999;152202;517;64;35;4;31;.886;3600000;0
1000;167047;512;0;0;0;0;.00nan;0;0
1000;11925;512;71;29;3;26;.897;3600000;0
1000;63107;1876;57;35;4;31;.886;3575000;0
1000;155465;1876;0;0;0;0;.00nan;0;0
1001;68425;519;0;0;0;0;.00nan;0;0
1001;68565;513;89;32;2;30;.938;3600000;0
1001;143330;519;40;28;5;23;.821;3600000;0
1001;143421;513;0;0;0;0;.00nan;0;0
1002;190258;521;0;0;0;0;.00nan;0;0
1002;54290;516;0;0;0;0;.00nan;0;0
1002;62287;521;73;38;5;33;.868;4846000;0
1002;143100;516;63;44;4;40;.909;4846000;0
1003;13613;520;0;0;0;0;.00nan;0;0
1003;143191;520;30;19;4;15;.789;3600000;0
1003;143307;517;0;0;0;0;.00nan;0;0
1003;152202;517;79;26;1;25;.962;3600000;0
1004;167047;512;0;0;0;0;.00nan;0;0
1004;11925;512;99;44;1;43;.977;3600000;0
1004;63107;1876;28;32;7;25;.781;3600000;0
1004;155465;1876;0;0;0;0;.00nan;0;0
1005;68425;519;0;0;0;0;.00nan;0;0
1005;68565;513;63;31;3;28;.903;3559000;0
1005;143330;519;87;34;2;32;.941;3600000;0
1005;143421;513;0;0;0;0;.00nan;0;0
1006;190258;521;0;0;0;0;.00nan;0;0
1006;54290;516;0;0;0;0;.00nan;0;0
1006;62287;521;78;22;1;21;.955;3600000;0
1006;143100;516;81;36;3;33;.917;3537000;0
1195;13613;520;0;0;0;0;.00nan;0;0
1195;143191;520;64;26;2;24;.923;3600000;0
1195;143307;517;54;17;2;15;.882;2446000;0
1195;152202;517;13;8;5;3;.375;1154000;0
1196;167047;512;0;0;0;0;.00nan;0;0
1196;11925;512;73;30;2;28;.933;3600000;0
1196;63107;1876;82;45;4;41;.911;3573000;0
1196;155465;1876;0;0;0;0;.00nan;0;0
1197;68425;519;0;0;0;0;.00nan;0;0
1197;68565;513;64;22;2;20;.909;3600000;0
1197;143330;519;82;29;1;28;.966;3600000;0
1197;143421;513;0;0;0;0;.00nan;0;0
1198;190258;521;0;0;0;0;.00nan;0;0
1198;54290;516;0;0;0;0;.00nan;0;0
1198;62287;521;52;17;2;15;.882;3558000;0
1198;143100;516;100;42;1;41;.976;3600000;0
1300;13613;520;0;0;0;0;.00nan;0;0
1300;143191;520;95;17;0;17;1.000;3600000;0
1300;143307;517;0;0;0;0;.00nan;0;0
1300;152202;517;62;31;3;28;.903;3600000;0
1301;68425;519;0;0;0;0;.00nan;0;0
1301;68565;513;63;25;2;23;.920;3545000;0
1301;143330;519;88;30;1;29;.967;3600000;0
1301;143421;513;0;0;0;0;.00nan;0;0
1302;190258;521;0;0;0;0;.00nan;0;0
1302;54290;516;0;0;0;0;.00nan;0;0
1302;62287;521;48;26;4;22;.846;3596000;0
1302;143100;516;75;27;2;25;.926;3600000;0
1356;68425;519;0;0;0;0;.00nan;0;0
1356;74734;514;77;23;1;22;.957;3600000;0
1356;78806;514;0;0;0;0;.00nan;0;0
1356;143330;519;37;42;7;35;.833;3600000;0
1357;167047;512;0;0;0;0;.00nan;0;0
1357;11925;512;37;24;5;19;.792;3600000;0
1357;76951;515;0;0;0;0;.00nan;0;0
1357;142911;515;85;33;2;31;.939;3600000;0
1358;13613;520;0;0;0;0;.00nan;0;0
1358;-1;511;0;0;0;0;.00nan;0;0
1358;86344;511;60;28;3;25;.893;3600000;0
1358;143191;520;40;21;4;17;.810;3566000;0
1359;168926;518;0;0;0;0;.00nan;0;0
1359;169325;518;50;26;3;23;.885;3559000;0
1359;54290;516;0;0;0;0;.00nan;0;0
1359;143100;516;73;28;2;26;.929;3600000;0
1360;68425;519;0;0;0;0;.00nan;0;0
1360;74734;514;0;0;0;0;.00nan;0;0
1360;78806;514;99;21;0;21;1.000;3600000;0
1360;143330;519;84;33;1;32;.970;3559000;0
1361;167047;512;0;0;0;0;.00nan;0;0
1361;11925;512;100;39;1;38;.974;3600000;0
1361;76951;515;0;0;0;0;.00nan;0;0
1361;142911;515;38;24;4;20;.833;3600000;0
1362;13613;520;0;0;0;0;.00nan;0;0
1362;-1;511;0;0;0;0;.00nan;0;0
1362;86344;511;57;35;4;31;.886;3600000;0
1362;143191;520;83;27;1;26;.963;3600000;0
1363;168926;518;0;0;0;0;.00nan;0;0
1363;169325;518;65;26;3;23;.885;3545000;0
1363;54290;516;0;0;0;0;.00nan;0;0
1363;143100;516;73;27;2;25;.926;3600000;0
1364;68425;519;0;0;0;0;.00nan;0;0
1364;74734;514;0;0;0;0;.00nan;0;0
1364;78806;514;51;20;3;17;.850;3600000;0
1364;143330;519;81;51;5;46;.902;3600000;0
1365;167047;512;0;0;0;0;.00nan;0;0
1365;11925;512;87;28;1;27;.964;3550000;0
1365;76951;515;0;0;0;0;.00nan;0;0
1365;142911;515;100;25;0;25;1.000;3600000;0
1366;13613;520;0;0;0;0;.00nan;0;0
1366;-1;511;0;0;0;0;.00nan;0;0
1366;86344;511;61;32;4;28;.875;3600000;0
1366;143191;520;87;28;1;27;.964;3600000;0
1367;168926;518;51;7;1;6;.857;414000;0
1367;169325;518;20;31;7;24;.774;3186000;0
1367;54290;516;0;0;0;0;.00nan;0;0
1367;143100;516;91;38;2;36;.947;3600000;0
1368;68425;519;0;0;0;0;.00nan;0;0
1368;74734;514;0;0;0;0;.00nan;0;0
1368;78806;514;92;17;0;17;1.000;3600000;0
1368;143330;519;98;45;2;43;.956;3522000;0
1369;167047;512;0;0;0;0;.00nan;0;0
1369;11925;512;72;25;2;23;.920;3600000;0
1369;76951;515;0;0;0;0;.00nan;0;0
1369;142911;515;47;21;3;18;.857;3550000;0
1370;13613;520;0;0;0;0;.00nan;0;0
1370;-1;511;0;0;0;0;.00nan;0;0
1370;86344;511;34;27;5;22;.815;3600000;0
1370;143191;520;67;23;2;21;.913;3600000;0
1371;168926;518;0;0;0;0;.00nan;0;0
1371;169325;518;100;32;0;32;1.000;3600000;0
1371;54290;516;0;0;0;0;.00nan;0;0
1371;143100;516;69;20;1;19;.950;3600000;0
1617;167047;512;0;0;0;0;.00nan;0;0
1617;11925;512;81;40;3;37;.925;3543000;0
1617;76951;515;0;0;0;0;.00nan;0;0
1617;142911;515;78;21;1;20;.952;3600000;0
1618;13613;520;0;0;0;0;.00nan;0;0
1618;-1;511;0;0;0;0;.00nan;0;0
1618;86344;511;56;29;4;25;.862;3514000;0
1618;143191;520;88;39;2;37;.949;3600000;0
1619;168926;518;0;0;0;0;.00nan;0;0
1619;169325;518;90;22;0;22;1.000;3600000;0
1619;54290;516;0;0;0;0;.00nan;0;0
1619;143100;516;70;32;3;29;.906;3600000;0
1689;167047;512;0;0;0;0;.00nan;0;0
1689;11925;512;92;41;2;39;.951;3543000;0
1689;76951;515;0;0;0;0;.00nan;0;0
1689;142911;515;74;20;1;19;.950;3600000;0
1690;168926;518;0;0;0;0;.00nan;0;0
1690;169325;518;55;16;2;14;.875;3600000;0
1690;54290;516;0;0;0;0;.00nan;0;0
1690;143100;516;66;36;4;32;.889;3535000;0
1792;168926;518;0;0;0;0;.00nan;0;0
1792;169325;518;72;36;4;32;.889;3587000;0
1792;54290;516;0;0;0;0;.00nan;0;0
1792;143100;516;82;36;2;34;.944;3600000;0
1837;54290;516;0;0;0;0;.00nan;0;0
1837;74734;514;0;0;0;0;.00nan;0;0
1837;78806;514;77;22;1;21;.955;3600000;0
1837;143100;516;74;37;4;33;.892;3600000;0
1838;13613;520;0;0;0;0;.00nan;0;0
1838;76951;515;0;0;0;0;.00nan;0;0
1838;142911;515;68;30;2;28;.933;3600000;0
1838;143191;520;55;23;3;20;.870;3539000;0
1839;54290;516;0;0;0;0;.00nan;0;0
1839;74734;514;0;0;0;0;.00nan;0;0
1839;78806;514;88;16;0;16;1.000;3600000;0
1839;143100;516;75;45;4;41;.911;3600000;0
1840;13613;520;0;0;0;0;.00nan;0;0
1840;76951;515;0;0;0;0;.00nan;0;0
1840;142911;515;100;55;2;53;.964;6546000;0
1840;143191;520;92;58;3;55;.948;6546000;0
1841;54290;516;0;0;0;0;.00nan;0;0
1841;74734;514;0;0;0;0;.00nan;0;0
1841;78806;514;40;24;4;20;.833;3534000;0
1841;143100;516;93;38;2;36;.947;3600000;0
1842;13613;520;0;0;0;0;.00nan;0;0
1842;76951;515;0;0;0;0;.00nan;0;0
1842;142911;515;79;34;2;32;.941;3600000;0
1842;143191;520;64;30;3;27;.900;3567000;0
1843;54290;516;0;0;0;0;.00nan;0;0
1843;74734;514;0;0;0;0;.00nan;0;0
1843;78806;514;84;15;0;15;1.000;3600000;0
1843;143100;516;69;28;3;25;.893;3600000;0
1844;13613;520;0;0;0;0;.00nan;0;0
1844;76951;515;0;0;0;0;.00nan;0;0
1844;142911;515;73;29;2;27;.931;3600000;0
1844;143191;520;67;27;3;24;.889;3600000;0
2011;54290;516;0;0;0;0;.00nan;0;0
2011;74734;514;0;0;0;0;.00nan;0;0
2011;78806;514;50;15;2;13;.867;3600000;0
2011;143100;516;72;42;5;37;.881;3600000;0
2056;74734;514;0;0;0;0;.00nan;0;0
2056;76951;515;0;0;0;0;.00nan;0;0
2056;78806;514;82;42;3;39;.929;3587000;0
2056;142911;515;85;36;2;34;.944;3600000;0
2057;74734;514;0;0;0;0;.00nan;0;0
2057;76951;515;0;0;0;0;.00nan;0;0
2057;78806;514;80;35;2;33;.943;3600000;0
2057;142911;515;59;30;4;26;.867;3549000;0
2058;74734;514;0;0;0;0;.00nan;0;0
2058;76951;515;0;0;0;0;.00nan;0;0
2058;78806;514;61;22;2;20;.909;3600000;0
2058;142911;515;50;23;3;20;.870;3564000;0
2059;74734;514;0;0;0;0;.00nan;0;0
2059;76951;515;0;0;0;0;.00nan;0;0
2059;78806;514;52;28;4;24;.857;3568000;0
2059;142911;515;78;35;2;33;.943;3600000;0
2313;74734;514;0;0;0;0;.00nan;0;0
2313;76951;515;0;0;0;0;.00nan;0;0
2313;78806;514;43;21;4;17;.810;3600000;0
2313;142911;515;66;31;3;28;.903;3600000;0
2386;74734;514;0;0;0;0;.00nan;0;0
2386;76951;515;0;0;0;0;.00nan;0;0
2386;78806;514;77;22;1;21;.955;3722000;0
2386;142911;515;84;43;2;41;.953;3722000;0
2431;74734;514;0;0;0;0;.00nan;0;0
2431;76951;515;0;0;0;0;.00nan;0;0
2431;78806;514;93;31;1;30;.968;3600000;0
2431;142911;515;57;28;3;25;.893;3570000;0
5128;186641;625;96;19;0;19;1.000;3600000;0
5128;-1;625;0;0;0;0;.00nan;0;0
5128;-1;1814;57;21;2;19;.905;2417000;0
5128;67362;1814;43;22;4;18;.818;1183000;0
5129;183905;627;0;0;0;0;.00nan;0;0
5129;22684;632;85;33;2;31;.939;2430000;0
5129;176963;627;30;22;5;17;.773;3600000;0
5129;197595;632;46;23;4;19;.826;1159000;0
5130;-1;642;57;8;0;8;1.000;414000;0
5130;87603;628;26;12;4;8;.667;3600000;0
5130;151728;642;41;36;6;30;.833;3164000;0
5130;161336;628;0;0;0;0;.00nan;0;0
5131;17625;644;72;40;3;37;.925;3590000;0
5131;206235;639;0;0;0;0;.00nan;0;0
5131;86099;644;0;0;0;0;.00nan;0;0
5131;149969;639;76;24;1;23;.958;3600000;0
5132;169552;1836;0;0;0;0;.00nan;0;0
5132;174209;631;0;0;0;0;.00nan;0;0
5132;-1;631;73;28;2;26;.929;3900000;0
5132;148956;1836;100;43;2;41;.953;3900000;0
5133;11068;641;35;39;7;32;.821;3256000;0
5133;190508;626;75;33;3;30;.909;3600000;0
5133;-1;641;50;3;0;3;1.000;344000;0
5133;145079;626;0;0;0;0;.00nan;0;0
5134;182872;636;0;0;0;0;.00nan;0;0
5134;-1;637;70;29;2;27;.931;3135000;0
5134;181431;636;94;20;0;20;1.000;3600000;0
5134;73274;637;31;6;3;3;.500;465000;0
5135;190508;626;60;37;4;33;.892;3600000;0
5135;186641;625;74;18;1;17;.944;3600000;0
5135;-1;625;0;0;0;0;.00nan;0;0
5135;145079;626;0;0;0;0;.00nan;0;0
5136;17625;644;0;0;0;0;.00nan;0;0
5136;-1;642;0;0;0;0;.00nan;0;0
5136;86099;644;54;23;3;20;.870;3600000;0
5136;151728;642;47;27;4;23;.852;3587000;0
5137;206235;639;0;0;0;0;.00nan;0;0
5137;-1;637;0;0;0;0;.00nan;0;0
5137;73274;637;67;43;4;39;.907;3600000;0
5137;149969;639;55;20;3;17;.850;3600000;0
5138;22684;632;0;0;0;0;.00nan;0;0
5138;197595;632;43;36;5;31;.861;3900000;0
5138;-1;1814;0;0;0;0;.00nan;0;0
5138;67362;1814;57;36;5;31;.861;3900000;0
5139;11068;641;46;30;6;24;.800;2771000;0
5139;-1;641;59;18;2;16;.889;829000;0
5139;87603;628;0;0;0;0;.00nan;0;0
5139;161336;628;99;20;0;20;1.000;3600000;0
5140;183905;627;0;0;0;0;.00nan;0;0
5140;174209;631;68;42;5;37;.881;3529000;0
5140;176963;627;80;40;3;37;.925;3600000;0
5140;-1;631;0;0;0;0;.00nan;0;0
5141;182872;636;0;0;0;0;.00nan;0;0
5141;169552;1836;0;0;0;0;.00nan;0;0
5141;181431;636;86;45;3;42;.933;3900000;0
5141;148956;1836;88;38;3;35;.921;3900000;0
5142;-1;637;0;0;0;0;.00nan;0;0
5142;-1;642;0;0;0;0;.00nan;0;0
5142;73274;637;67;18;1;17;.944;3600000;0
5142;151728;642;92;44;3;41;.932;3549000;0
5143;190508;626;65;37;4;33;.892;3600000;0
5143;87603;628;0;0;0;0;.00nan;0;0
5143;145079;626;0;0;0;0;.00nan;0;0
5143;161336;628;78;26;1;25;.962;3600000;0
5144;17625;644;0;0;0;0;.00nan;0;0
5144;22684;632;0;0;0;0;.00nan;0;0
5144;197595;632;66;36;4;32;.889;3587000;0
5144;86099;644;58;26;3;23;.885;3600000;0
5145;11068;641;19;29;7;22;.759;1873000;0
5145;183905;627;0;0;0;0;.00nan;0;0
5145;176963;627;43;12;2;10;.833;3600000;0
5145;-1;641;41;34;6;28;.824;1727000;0
5146;182872;636;0;0;0;0;.00nan;0;0
5146;206235;639;0;0;0;0;.00nan;0;0
5146;181431;636;84;28;1;27;.964;3600000;0
5146;149969;639;97;42;2;40;.952;3547000;0
5147;174209;631;82;48;4;44;.917;3546000;0
5147;186641;625;49;19;3;16;.842;3600000;0
5147;-1;625;0;0;0;0;.00nan;0;0
5147;-1;631;0;0;0;0;.00nan;0;0
5148;169552;1836;0;0;0;0;.00nan;0;0
5148;-1;1814;23;13;4;9;.692;2121000;0
5148;67362;1814;28;26;6;20;.769;1479000;0
5148;148956;1836;77;28;2;26;.929;3600000;0
5149;22684;632;0;0;0;0;.00nan;0;0
5149;190508;626;75;28;2;26;.929;3600000;0
5149;197595;632;68;50;5;45;.900;3600000;0
5149;145079;626;0;0;0;0;.00nan;0;0
5150;17625;644;0;0;0;0;.00nan;0;0
5150;169552;1836;0;0;0;0;.00nan;0;0
5150;86099;644;60;31;4;27;.871;3600000;0
5150;148956;1836;66;49;7;42;.857;3600000;0
5151;-1;637;96;51;1;50;.980;3900000;0
5151;186641;625;64;19;1;18;.947;3900000;0
5151;-1;625;0;0;0;0;.00nan;0;0
5151;73274;637;0;0;0;0;.00nan;0;0
5152;183905;627;0;0;0;0;.00nan;0;0
5152;176963;627;51;36;5;31;.861;3600000;0
5152;87603;628;0;0;0;0;.00nan;0;0
5152;161336;628;35;33;6;27;.818;3575000;0
5153;174209;631;36;30;5;25;.833;3600000;0
5153;-1;631;0;0;0;0;.00nan;0;0
5153;-1;1814;0;0;0;0;.00nan;0;0
5153;67362;1814;95;42;2;40;.952;3600000;0
5154;11068;641;0;0;0;0;.00nan;0;0
5154;206235;639;0;0;0;0;.00nan;0;0
5154;-1;641;85;43;3;40;.930;3585000;0
5154;149969;639;58;20;2;18;.900;3600000;0
5155;182872;636;0;0;0;0;.00nan;0;0
5155;181431;636;48;22;3;19;.864;3600000;0
5155;-1;642;0;0;0;0;.00nan;0;0
5155;151728;642;74;46;4;42;.913;3583000;0
5156;190508;626;78;11;0;11;1.000;3600000;0
5156;-1;642;0;0;0;0;.00nan;0;0
5156;145079;626;0;0;0;0;.00nan;0;0
5156;151728;642;78;38;3;35;.921;3600000;0
5157;174209;631;65;18;1;17;.944;3900000;0
5157;-1;631;0;0;0;0;.00nan;0;0
5157;87603;628;75;21;1;20;.952;3900000;0
5157;161336;628;0;0;0;0;.00nan;0;0
5158;17625;644;0;0;0;0;.00nan;0;0
5158;-1;1814;59;25;3;22;.880;3600000;0
5158;67362;1814;0;0;0;0;.00nan;0;0
5158;86099;644;52;49;6;43;.878;3600000;0
5159;183905;627;0;0;0;0;.00nan;0;0
5159;206235;639;0;0;0;0;.00nan;0;0
5159;176963;627;68;23;2;21;.913;3600000;0
5159;149969;639;28;29;6;23;.793;3600000;0
5160;169552;1836;0;0;0;0;.00nan;0;0
5160;-1;637;0;0;0;0;.00nan;0;0
5160;73274;637;79;39;4;35;.897;3547000;0
5160;148956;1836;91;42;3;39;.929;3600000;0
5161;11068;641;0;0;0;0;.00nan;0;0
5161;22684;632;49;1;0;1;1.000;614000;0
5161;-1;641;69;38;3;35;.921;3600000;0
5161;197595;632;19;20;6;14;.700;2986000;0
5162;182872;636;0;0;0;0;.00nan;0;0
5162;181431;636;83;34;2;32;.941;3546000;0
5162;186641;625;73;23;1;22;.957;3600000;0
5162;-1;625;0;0;0;0;.00nan;0;0
5163;174209;631;0;0;0;0;.00nan;0;0
5163;190508;626;96;40;1;39;.975;3600000;0
5163;-1;631;52;19;3;16;.842;3556000;0
5163;145079;626;0;0;0;0;.00nan;0;0
5164;182872;636;0;0;0;0;.00nan;0;0
5164;17625;644;0;0;0;0;.00nan;0;0
5164;181431;636;45;27;4;23;.852;3548000;0
5164;86099;644;91;41;2;39;.951;3600000;0
5165;11068;641;63;33;3;30;.909;3568000;0
5165;-1;637;0;0;0;0;.00nan;0;0
5165;-1;641;0;0;0;0;.00nan;0;0
5165;73274;637;75;22;1;21;.955;3600000;0
5166;169552;1836;0;0;0;0;.00nan;0;0
5166;22684;632;85;34;2;32;.941;3600000;0
5166;197595;632;0;0;0;0;.00nan;0;0
5166;148956;1836;35;26;5;21;.808;3600000;0
5167;183905;627;69;31;2;29;.935;3900000;0
5167;176963;627;0;0;0;0;.00nan;0;0
5167;-1;1814;0;0;0;0;.00nan;0;0
5167;67362;1814;95;48;2;46;.958;3900000;0
5168;206235;639;0;0;0;0;.00nan;0;0
5168;87603;628;0;0;0;0;.00nan;0;0
5168;149969;639;75;43;4;39;.907;3600000;0
5168;161336;628;73;34;3;31;.912;3600000;0
5169;186641;625;61;15;1;14;.933;3600000;0
5169;-1;642;0;0;0;0;.00nan;0;0
5169;-1;625;0;0;0;0;.00nan;0;0
5169;151728;642;80;45;2;43;.956;3600000;0
5170;182872;636;0;0;0;0;.00nan;0;0
5170;190508;626;70;43;5;38;.884;3735000;0
5170;181431;636;42;21;4;17;.810;3735000;0
5170;145079;626;0;0;0;0;.00nan;0;0
5171;183905;627;0;0;0;0;.00nan;0;0
5171;176963;627;56;11;1;10;.909;3600000;0
5171;-1;637;45;56;9;47;.839;3600000;0
5171;73274;637;0;0;0;0;.00nan;0;0
5172;206235;639;0;0;0;0;.00nan;0;0
5172;-1;1814;0;0;0;0;.00nan;0;0
5172;67362;1814;82;40;3;37;.925;3600000;0
5172;149969;639;52;31;4;27;.871;3563000;0
5173;11068;641;0;0;0;0;.00nan;0;0
5173;-1;641;85;39;2;37;.949;3600000;0
5173;-1;642;70;31;3;28;.903;3600000;0
5173;151728;642;0;0;0;0;.00nan;0;0
5174;22684;632;0;0;0;0;.00nan;0;0
5174;197595;632;87;48;3;45;.938;3600000;0
5174;87603;628;57;16;2;14;.875;3600000;0
5174;161336;628;0;0;0;0;.00nan;0;0
5175;17625;644;0;0;0;0;.00nan;0;0
5175;174209;631;96;34;1;33;.971;3600000;0
5175;-1;631;0;0;0;0;.00nan;0;0
5175;86099;644;71;35;2;33;.943;3543000;0
5176;169552;1836;56;7;0;7;1.000;459000;0
5176;186641;625;88;29;1;28;.966;3600000;0
5176;-1;625;0;0;0;0;.00nan;0;0
5176;148956;1836;35;32;6;26;.813;3141000;0
5177;186641;625;59;30;4;26;.867;3556000;0
5177;-1;625;0;0;0;0;.00nan;0;0
5177;87603;628;0;0;0;0;.00nan;0;0
5177;161336;628;72;33;3;30;.909;3600000;0
5178;17625;644;0;0;0;0;.00nan;0;0
5178;-1;637;0;0;0;0;.00nan;0;0
5178;73274;637;75;40;3;37;.925;3544000;0
5178;86099;644;72;29;2;27;.931;3600000;0
5179;-1;642;0;0;0;0;.00nan;0;0
5179;-1;1814;0;0;0;0;.00nan;0;0
5179;67362;1814;62;21;2;19;.905;3594000;0
5179;151728;642;92;36;1;35;.972;3600000;0
5180;206235;639;0;0;0;0;.00nan;0;0
5180;190508;626;72;31;2;29;.935;3570000;0
5180;145079;626;0;0;0;0;.00nan;0;0
5180;149969;639;100;30;0;30;1.000;3600000;0
5181;22684;632;0;0;0;0;.00nan;0;0
5181;174209;631;0;0;0;0;.00nan;0;0
5181;197595;632;81;55;5;50;.909;3600000;0
5181;-1;631;71;24;2;22;.917;3600000;0
5182;11068;641;58;47;6;41;.872;3059000;0
5182;169552;1836;61;22;2;20;.909;3600000;0
5182;-1;641;46;6;1;5;.833;541000;0
5182;148956;1836;0;0;0;0;.00nan;0;0
5183;182872;636;0;0;0;0;.00nan;0;0
5183;183905;627;0;0;0;0;.00nan;0;0
5183;176963;627;53;35;5;30;.857;3552000;0
5183;181431;636;69;31;3;28;.903;3600000;0
5184;17625;644;0;0;0;0;.00nan;0;0
5184;190508;626;0;0;0;0;.00nan;0;0
5184;86099;644;50;35;7;28;.800;3600000;0
5184;145079;626;74;29;3;26;.897;3600000;0
5185;174209;631;57;23;3;20;.870;3547000;0
5185;-1;637;0;0;0;0;.00nan;0;0
5185;-1;631;0;0;0;0;.00nan;0;0
5185;73274;637;61;22;2;20;.909;3600000;0
5186;183905;627;51;3;0;3;1.000;334000;0
5186;176963;627;43;35;6;29;.829;3266000;0
5186;186641;625;52;22;3;19;.864;3600000;0
5186;-1;625;0;0;0;0;.00nan;0;0
5187;169552;1836;0;0;0;0;.00nan;0;0
5187;-1;642;0;0;0;0;.00nan;0;0
5187;148956;1836;100;32;1;31;.969;3600000;0
5187;151728;642;56;25;3;22;.880;3575000;0
5188;22684;632;96;38;1;37;.974;3600000;0
5188;206235;639;0;0;0;0;.00nan;0;0
5188;197595;632;0;0;0;0;.00nan;0;0
5188;149969;639;61;33;3;30;.909;3570000;0
5189;-1;1814;0;0;0;0;.00nan;0;0
5189;67362;1814;81;45;4;41;.911;3551000;0
5189;87603;628;0;0;0;0;.00nan;0;0
5189;161336;628;65;27;3;24;.889;3600000;0
5190;182872;636;0;0;0;0;.00nan;0;0
5190;11068;641;90;55;4;51;.927;3576000;0
5190;181431;636;59;23;3;20;.870;3600000;0
5190;-1;641;0;0;0;0;.00nan;0;0
5191;-1;637;0;0;0;0;.00nan;0;0
5191;190508;626;76;37;3;34;.919;3600000;0
5191;73274;637;52;37;5;32;.865;3548000;0
5191;145079;626;0;0;0;0;.00nan;0;0
5192;182872;636;0;0;0;0;.00nan;0;0
5192;22684;632;0;0;0;0;.00nan;0;0
5192;181431;636;100;22;0;22;1.000;3600000;0
5192;197595;632;97;48;3;45;.938;3600000;0
5193;183905;627;0;0;0;0;.00nan;0;0
5193;169552;1836;43;11;2;9;.818;1225000;0
5193;176963;627;93;35;1;34;.971;3600000;0
5193;148956;1836;55;29;4;25;.862;2375000;0
5194;174209;631;0;0;0;0;.00nan;0;0
5194;-1;642;76;16;0;16;1.000;1908000;0
5194;-1;631;51;24;3;21;.875;3600000;0
5194;151728;642;15;21;6;15;.714;1692000;0
5195;17625;644;0;0;0;0;.00nan;0;0
5195;86099;644;49;34;5;29;.853;3600000;0
5195;87603;628;88;24;1;23;.958;3600000;0
5195;161336;628;0;0;0;0;.00nan;0;0
5196;206235;639;51;3;0;3;1.000;264000;0
5196;186641;625;66;18;1;17;.944;3600000;0
5196;-1;625;0;0;0;0;.00nan;0;0
5196;149969;639;79;50;6;44;.880;3336000;0
5197;11068;641;0;0;0;0;.00nan;0;0
5197;-1;641;33;43;7;36;.837;3600000;0
5197;-1;1814;0;0;0;0;.00nan;0;0
5197;67362;1814;70;24;2;22;.917;3600000;0
5198;183905;627;0;0;0;0;.00nan;0;0
5198;176963;627;97;34;1;33;.971;3600000;0
5198;190508;626;95;42;3;39;.929;3600000;0
5198;145079;626;0;0;0;0;.00nan;0;0
5199;11068;641;0;0;0;0;.00nan;0;0
5199;17625;644;96;24;0;24;1.000;3600000;0
5199;-1;641;90;31;1;30;.968;3588000;0
5199;86099;644;0;0;0;0;.00nan;0;0
5200;-1;637;41;10;2;8;.800;1022000;0
5200;-1;1814;70;28;2;26;.929;3600000;0
5200;67362;1814;0;0;0;0;.00nan;0;0
5200;73274;637;29;26;6;20;.769;2578000;0
5201;22684;632;72;36;4;32;.889;2173000;0
5201;186641;625;86;14;0;14;1.000;3600000;0
5201;-1;625;0;0;0;0;.00nan;0;0
5201;197595;632;17;22;6;16;.727;1427000;0
5202;206235;639;0;0;0;0;.00nan;0;0
5202;-1;642;62;9;0;9;1.000;599000;0
5202;149969;639;61;15;1;14;.933;3600000;0
5202;151728;642;37;35;6;29;.829;3001000;0
5203;169552;1836;0;0;0;0;.00nan;0;0
5203;87603;628;0;0;0;0;.00nan;0;0
5203;148956;1836;38;32;6;26;.813;3600000;0
5203;161336;628;70;23;2;21;.913;3600000;0
5204;182872;636;0;0;0;0;.00nan;0;0
5204;174209;631;44;27;4;23;.852;3600000;0
5204;181431;636;70;22;1;21;.955;3600000;0
5204;-1;631;0;0;0;0;.00nan;0;0
5205;-1;637;86;37;2;35;.946;3600000;0
5205;73274;637;0;0;0;0;.00nan;0;0
5205;87603;628;0;0;0;0;.00nan;0;0
5205;161336;628;49;18;3;15;.833;3600000;0
5206;169552;1836;0;0;0;0;.00nan;0;0
5206;190508;626;90;32;1;31;.969;3600000;0
5206;145079;626;0;0;0;0;.00nan;0;0
5206;148956;1836;30;30;6;24;.800;3600000;0
5207;183905;627;0;0;0;0;.00nan;0;0
5207;17625;644;46;31;6;25;.806;3600000;0
5207;176963;627;73;33;3;30;.909;3600000;0
5207;86099;644;0;0;0;0;.00nan;0;0
5208;22684;632;0;0;0;0;.00nan;0;0
5208;-1;642;0;0;0;0;.00nan;0;0
5208;197595;632;55;28;3;25;.893;3600000;0
5208;151728;642;48;26;4;22;.846;3600000;0
5209;174209;631;79;44;4;40;.909;3600000;0
5209;206235;639;62;38;5;33;.868;3566000;0
5209;-1;631;0;0;0;0;.00nan;0;0
5209;149969;639;0;0;0;0;.00nan;0;0
5210;11068;641;98;57;3;54;.947;3577000;0
5210;-1;641;0;0;0;0;.00nan;0;0
5210;186641;625;66;19;1;18;.947;3600000;0
5210;-1;625;0;0;0;0;.00nan;0;0
5211;182872;636;0;0;0;0;.00nan;0;0
5211;181431;636;55;31;3;28;.903;3545000;0
5211;-1;1814;0;0;0;0;.00nan;0;0
5211;67362;1814;70;25;2;23;.920;3600000;0
5212;190508;626;88;37;3;34;.919;3667000;0
5212;-1;1814;0;0;0;0;.00nan;0;0
5212;67362;1814;91;34;2;32;.941;3667000;0
5212;145079;626;0;0;0;0;.00nan;0;0
5213;22684;632;89;39;2;37;.949;3900000;0
5213;-1;637;0;0;0;0;.00nan;0;0
5213;197595;632;0;0;0;0;.00nan;0;0
5213;73274;637;60;24;2;22;.917;3900000;0
5214;183905;627;0;0;0;0;.00nan;0;0
5214;176963;627;51;17;3;14;.824;3561000;0
5214;-1;642;0;0;0;0;.00nan;0;0
5214;151728;642;85;40;3;37;.925;3600000;0
5215;182872;636;0;0;0;0;.00nan;0;0
5215;181431;636;77;28;2;26;.929;3600000;0
5215;87603;628;69;40;4;36;.900;3521000;0
5215;161336;628;0;0;0;0;.00nan;0;0
5216;17625;644;0;0;0;0;.00nan;0;0
5216;186641;625;81;12;0;12;1.000;3600000;0
5216;-1;625;0;0;0;0;.00nan;0;0
5216;86099;644;97;47;2;45;.957;3600000;0
5217;169552;1836;26;36;7;29;.806;3600000;0
5217;206235;639;0;0;0;0;.00nan;0;0
5217;148956;1836;0;0;0;0;.00nan;0;0
5217;149969;639;68;24;2;22;.917;3600000;0
5218;11068;641;100;37;0;37;1.000;3600000;0
5218;174209;631;0;0;0;0;.00nan;0;0
5218;-1;641;0;0;0;0;.00nan;0;0
5218;-1;631;66;35;3;32;.914;3600000;0
5219;17625;644;0;0;0;0;.00nan;0;0
5219;-1;642;0;0;0;0;.00nan;0;0
5219;86099;644;69;29;3;26;.897;3600000;0
5219;151728;642;63;43;6;37;.860;3600000;0
5220;190508;626;63;45;5;40;.889;3600000;0
5220;87603;628;28;15;4;11;.733;3600000;0
5220;145079;626;0;0;0;0;.00nan;0;0
5220;161336;628;0;0;0;0;.00nan;0;0
5221;206235;639;0;0;0;0;.00nan;0;0
5221;-1;1814;50;17;2;15;.882;2462000;0
5221;67362;1814;14;10;5;5;.500;1138000;0
5221;149969;639;79;22;1;21;.955;3600000;0
5222;11068;641;73;26;2;24;.923;3600000;0
5222;22684;632;0;0;0;0;.00nan;0;0
5222;-1;641;0;0;0;0;.00nan;0;0
5222;197595;632;62;33;3;30;.909;3581000;0
5223;183905;627;0;0;0;0;.00nan;0;0
5223;176963;627;33;30;6;24;.800;3543000;0
5223;-1;637;0;0;0;0;.00nan;0;0
5223;73274;637;54;31;4;27;.871;3600000;0
5224;174209;631;77;47;5;42;.894;3887000;0
5224;186641;625;65;31;4;27;.871;3887000;0
5224;-1;625;0;0;0;0;.00nan;0;0
5224;-1;631;0;0;0;0;.00nan;0;0
5225;182872;636;0;0;0;0;.00nan;0;0
5225;169552;1836;0;0;0;0;.00nan;0;0
5225;181431;636;94;37;2;35;.946;3600000;0
5225;148956;1836;74;34;3;31;.912;3561000;0
5226;17625;644;0;0;0;0;.00nan;0;0
5226;190508;626;71;33;3;30;.909;3600000;0
5226;86099;644;100;30;0;30;1.000;3600000;0
5226;145079;626;0;0;0;0;.00nan;0;0
5227;-1;637;85;35;3;32;.914;3876000;0
5227;-1;1814;0;0;0;0;.00nan;0;0
5227;67362;1814;73;38;3;35;.921;3900000;0
5227;73274;637;0;0;0;0;.00nan;0;0
5228;182872;636;0;0;0;0;.00nan;0;0
5228;22684;632;97;48;2;46;.958;3573000;0
5228;181431;636;65;17;1;16;.941;3600000;0
5228;197595;632;0;0;0;0;.00nan;0;0
5229;174209;631;0;0;0;0;.00nan;0;0
5229;-1;642;0;0;0;0;.00nan;0;0
5229;-1;631;73;27;2;25;.926;3600000;0
5229;151728;642;91;51;4;47;.922;3582000;0
5230;206235;639;0;0;0;0;.00nan;0;0
5230;87603;628;64;34;4;30;.882;3585000;0
5230;149969;639;60;14;1;13;.929;3600000;0
5230;161336;628;0;0;0;0;.00nan;0;0
5231;169552;1836;0;0;0;0;.00nan;0;0
5231;186641;625;60;22;3;19;.864;3600000;0
5231;-1;625;0;0;0;0;.00nan;0;0
5231;148956;1836;80;45;4;41;.911;3600000;0
5232;11068;641;68;57;6;51;.895;3079000;0
5232;183905;627;0;0;0;0;.00nan;0;0
5232;176963;627;52;24;3;21;.875;3600000;0
5232;-1;641;26;6;3;3;.500;521000;0
5233;190508;626;67;20;2;18;.900;3600000;0
5233;-1;642;0;0;0;0;.00nan;0;0
5233;145079;626;0;0;0;0;.00nan;0;0
5233;151728;642;75;52;5;47;.904;3600000;0
5234;17625;644;0;0;0;0;.00nan;0;0
5234;-1;1814;0;0;0;0;.00nan;0;0
5234;67362;1814;89;26;1;25;.962;3600000;0
5234;86099;644;54;41;6;35;.854;3600000;0
5235;186641;625;72;26;2;24;.923;3600000;0
5235;-1;625;0;0;0;0;.00nan;0;0
5235;87603;628;72;13;0;13;1.000;1208000;0
5235;161336;628;45;29;4;25;.862;2388000;0
5236;169552;1836;65;31;3;28;.903;3600000;0
5236;22684;632;0;0;0;0;.00nan;0;0
5236;197595;632;74;36;2;34;.944;3600000;0
5236;148956;1836;0;0;0;0;.00nan;0;0
5237;182872;636;0;0;0;0;.00nan;0;0
5237;11068;641;27;44;9;35;.795;3600000;0
5237;181431;636;60;32;4;28;.875;3600000;0
5237;-1;641;0;0;0;0;.00nan;0;0
5238;183905;627;0;0;0;0;.00nan;0;0
5238;206235;639;0;0;0;0;.00nan;0;0
5238;176963;627;63;34;3;31;.912;3600000;0
5238;149969;639;99;21;0;21;1.000;3600000;0
5239;174209;631;57;17;2;15;.882;3600000;0
5239;-1;637;50;1;0;1;1.000;867000;0
5239;-1;631;0;0;0;0;.00nan;0;0
5239;73274;637;11;24;7;17;.708;2733000;0
5240;17625;644;0;0;0;0;.00nan;0;0
5240;-1;637;0;0;0;0;.00nan;0;0
5240;73274;637;80;33;2;31;.939;3600000;0
5240;86099;644;88;42;3;39;.929;3572000;0
5241;190508;626;79;39;3;36;.923;3600000;0
5241;-1;1814;54;10;1;9;.900;1444000;0
5241;67362;1814;24;20;6;14;.700;2156000;0
5241;145079;626;0;0;0;0;.00nan;0;0
5242;22684;632;57;37;5;32;.865;3536000;0
5242;174209;631;0;0;0;0;.00nan;0;0
5242;197595;632;0;0;0;0;.00nan;0;0
5242;-1;631;81;24;3;21;.875;3600000;0
5243;183905;627;0;0;0;0;.00nan;0;0
5243;176963;627;50;23;3;20;.870;3600000;0
5243;-1;642;49;39;6;33;.846;2785000;0
5243;151728;642;64;17;1;16;.941;815000;0
5244;169552;1836;0;0;0;0;.00nan;0;0
5244;206235;639;0;0;0;0;.00nan;0;0
5244;148956;1836;73;39;4;35;.897;3622000;0
5244;149969;639;52;34;5;29;.853;3622000;0
5245;11068;641;59;40;4;36;.900;3600000;0
5245;-1;641;0;0;0;0;.00nan;0;0
5245;87603;628;68;18;1;17;.944;3600000;0
5245;161336;628;0;0;0;0;.00nan;0;0
5246;182872;636;0;0;0;0;.00nan;0;0
5246;181431;636;94;49;3;46;.939;3584000;0
5246;186641;625;99;26;1;25;.962;3600000;0
5246;-1;625;0;0;0;0;.00nan;0;0
5247;182872;636;0;0;0;0;.00nan;0;0
5247;190508;626;88;27;1;26;.963;3600000;0
5247;181431;636;89;43;2;41;.953;3552000;0
5247;145079;626;0;0;0;0;.00nan;0;0
5248;17625;644;0;0;0;0;.00nan;0;0
5248;169552;1836;0;0;0;0;.00nan;0;0
5248;86099;644;91;34;2;32;.941;3600000;0
5248;148956;1836;51;31;4;27;.871;3547000;0
5249;183905;627;0;0;0;0;.00nan;0;0
5249;22684;632;72;40;3;37;.925;1651000;0
5249;176963;627;87;15;0;15;1.000;3600000;0
5249;197595;632;25;29;6;23;.793;1949000;0
5250;206235;639;0;0;0;0;.00nan;0;0
5250;-1;642;50;1;0;1;1.000;254000;0
5250;149969;639;64;19;2;17;.895;3600000;0
5250;151728;642;44;50;8;42;.840;3346000;0
5251;-1;637;0;0;0;0;.00nan;0;0
5251;73274;637;32;43;7;36;.837;3600000;0
5251;87603;628;0;0;0;0;.00nan;0;0
5251;161336;628;71;27;2;25;.926;3600000;0
5252;186641;625;0;0;0;0;.00nan;0;0
5252;-1;625;55;19;3;16;.842;3600000;0
5252;-1;1814;68;24;1;23;.958;1480000;0
5252;67362;1814;40;34;6;28;.824;2120000;0
5253;11068;641;80;46;4;42;.913;3600000;0
5253;174209;631;79;22;1;21;.955;3600000;0
5253;-1;641;0;0;0;0;.00nan;0;0
5253;-1;631;0;0;0;0;.00nan;0;0
5254;17625;644;0;0;0;0;.00nan;0;0
5254;22684;632;0;0;0;0;.00nan;0;0
5254;197595;632;60;30;3;27;.900;3540000;0
5254;86099;644;93;33;1;32;.970;3600000;0
5255;11068;641;53;36;5;31;.861;3568000;0
5255;206235;639;0;0;0;0;.00nan;0;0
5255;-1;641;0;0;0;0;.00nan;0;0
5255;149969;639;52;22;3;19;.864;3600000;0
5256;-1;637;0;0;0;0;.00nan;0;0
5256;190508;626;73;30;3;27;.900;3900000;0
5256;73274;637;91;46;3;43;.935;3900000;0
5256;145079;626;0;0;0;0;.00nan;0;0
5257;-1;1814;0;0;0;0;.00nan;0;0
5257;67362;1814;74;30;2;28;.933;3600000;0
5257;87603;628;94;37;1;36;.973;3600000;0
5257;161336;628;0;0;0;0;.00nan;0;0
5258;182872;636;0;0;0;0;.00nan;0;0
5258;181431;636;60;13;1;12;.923;3600000;0
5258;-1;642;0;0;0;0;.00nan;0;0
5258;151728;642;68;47;5;42;.894;3600000;0
5259;183905;627;0;0;0;0;.00nan;0;0
5259;176963;627;87;49;3;46;.939;3719000;0
5259;186641;625;58;32;4;28;.875;3719000;0
5259;-1;625;0;0;0;0;.00nan;0;0
5260;169552;1836;0;0;0;0;.00nan;0;0
5260;174209;631;79;30;2;28;.933;3600000;0
5260;-1;631;0;0;0;0;.00nan;0;0
5260;148956;1836;79;37;3;34;.919;3543000;0
5261;22684;632;72;35;3;32;.914;3900000;0
5261;206235;639;0;0;0;0;.00nan;0;0
5261;197595;632;0;0;0;0;.00nan;0;0
5261;149969;639;94;33;3;30;.909;3900000;0
5262;-1;637;66;16;1;15;.938;3600000;0
5262;-1;642;0;0;0;0;.00nan;0;0
5262;73274;637;0;0;0;0;.00nan;0;0
5262;151728;642;60;40;5;35;.875;3600000;0
5263;183905;627;0;0;0;0;.00nan;0;0
5263;176963;627;74;35;3;32;.914;3900000;0
5263;190508;626;68;38;3;35;.921;3900000;0
5263;145079;626;0;0;0;0;.00nan;0;0
5264;169552;1836;0;0;0;0;.00nan;0;0
5264;87603;628;0;0;0;0;.00nan;0;0
5264;148956;1836;93;43;3;40;.930;3568000;0
5264;161336;628;67;27;2;25;.926;3600000;0
5265;17625;644;0;0;0;0;.00nan;0;0
5265;174209;631;84;29;2;27;.931;3600000;0
5265;-1;631;0;0;0;0;.00nan;0;0
5265;86099;644;48;30;4;26;.867;3518000;0
5266;11068;641;100;54;2;52;.963;3600000;0
5266;-1;641;0;0;0;0;.00nan;0;0
5266;186641;625;55;26;4;22;.846;3515000;0
5266;-1;625;0;0;0;0;.00nan;0;0
5267;182872;636;0;0;0;0;.00nan;0;0
5267;181431;636;93;33;1;32;.970;3600000;0
5267;-1;1814;87;44;2;42;.955;3581000;0
5267;67362;1814;0;0;0;0;.00nan;0;0
5268;183905;627;0;0;0;0;.00nan;0;0
5268;176963;627;64;31;4;27;.871;3657000;0
5268;87603;628;0;0;0;0;.00nan;0;0
5268;161336;628;57;26;3;23;.885;3657000;0
5269;206235;639;0;0;0;0;.00nan;0;0
5269;190508;626;96;56;5;51;.911;3900000;0
5269;145079;626;0;0;0;0;.00nan;0;0
5269;149969;639;40;22;5;17;.773;3900000;0
5270;17625;644;0;0;0;0;.00nan;0;0
5270;186641;625;97;31;1;30;.968;3600000;0
5270;-1;625;0;0;0;0;.00nan;0;0
5270;86099;644;82;54;4;50;.926;3600000;0
5271;169552;1836;0;0;0;0;.00nan;0;0
5271;-1;637;0;0;0;0;.00nan;0;0
5271;73274;637;65;31;3;28;.903;3600000;0
5271;148956;1836;67;19;1;18;.947;3600000;0
5272;22684;632;0;0;0;0;.00nan;0;0
5272;197595;632;90;49;4;45;.918;3885000;0
5272;-1;1814;0;0;0;0;.00nan;0;0
5272;67362;1814;64;37;4;33;.892;3900000;0
5273;11068;641;69;36;3;33;.917;3600000;0
5273;-1;641;0;0;0;0;.00nan;0;0
5273;-1;642;0;0;0;0;.00nan;0;0
5273;151728;642;53;29;4;25;.862;3548000;0
5274;182872;636;0;0;0;0;.00nan;0;0
5274;174209;631;0;0;0;0;.00nan;0;0
5274;181431;636;46;26;4;22;.846;3600000;0
5274;-1;631;94;40;2;38;.950;3600000;0
5275;183905;627;0;0;0;0;.00nan;0;0
5275;176963;627;77;29;2;27;.931;3600000;0
5275;-1;1814;86;43;3;40;.930;3578000;0
5275;67362;1814;0;0;0;0;.00nan;0;0
5276;22684;632;96;47;4;43;.915;3600000;0
5276;197595;632;0;0;0;0;.00nan;0;0
5276;87603;628;71;17;1;16;.941;3600000;0
5276;161336;628;0;0;0;0;.00nan;0;0
5277;190508;626;94;46;2;44;.957;3600000;0
5277;186641;625;65;28;3;25;.893;3581000;0
5277;-1;625;0;0;0;0;.00nan;0;0
5277;145079;626;0;0;0;0;.00nan;0;0
5278;169552;1836;80;14;0;14;1.000;3600000;0
5278;-1;642;0;0;0;0;.00nan;0;0
5278;148956;1836;0;0;0;0;.00nan;0;0
5278;151728;642;89;39;2;37;.949;3547000;0
5279;11068;641;60;33;4;29;.879;3600000;0
5279;17625;644;0;0;0;0;.00nan;0;0
5279;-1;641;0;0;0;0;.00nan;0;0
5279;86099;644;77;9;0;9;1.000;3600000;0
5280;182872;636;0;0;0;0;.00nan;0;0
5280;-1;637;0;0;0;0;.00nan;0;0
5280;181431;636;55;23;3;20;.870;3557000;0
5280;73274;637;91;44;2;42;.955;3600000;0
5281;174209;631;72;46;5;41;.891;3867000;0
5281;206235;639;0;0;0;0;.00nan;0;0
5281;-1;631;0;0;0;0;.00nan;0;0
5281;149969;639;55;32;4;28;.875;3867000;0
5282;11068;641;0;0;0;0;.00nan;0;0
5282;190508;626;94;25;0;25;1.000;3600000;0
5282;-1;641;75;37;3;34;.919;3600000;0
5282;145079;626;0;0;0;0;.00nan;0;0
5283;169552;1836;59;19;2;17;.895;3600000;0
5283;-1;1814;0;0;0;0;.00nan;0;0
5283;67362;1814;90;52;5;47;.904;3600000;0
5283;148956;1836;0;0;0;0;.00nan;0;0
5284;22684;632;0;0;0;0;.00nan;0;0
5284;-1;642;0;0;0;0;.00nan;0;0
5284;197595;632;47;13;2;11;.846;3600000;0
5284;151728;642;69;43;4;39;.907;3549000;0
5285;182872;636;0;0;0;0;.00nan;0;0
5285;183905;627;93;42;1;41;.976;3549000;0
5285;176963;627;0;0;0;0;.00nan;0;0
5285;181431;636;100;31;0;31;1.000;3600000;0
5286;17625;644;0;0;0;0;.00nan;0;0
5286;206235;639;0;0;0;0;.00nan;0;0
5286;86099;644;69;38;4;34;.895;3600000;0
5286;149969;639;100;31;0;31;1.000;3600000;0
5287;174209;631;50;23;3;20;.870;3600000;0
5287;-1;631;0;0;0;0;.00nan;0;0
5287;87603;628;0;0;0;0;.00nan;0;0
5287;161336;628;43;36;6;30;.833;3600000;0
5288;-1;637;49;20;3;17;.850;1262000;0
5288;186641;625;80;24;1;23;.958;3600000;0
5288;-1;625;0;0;0;0;.00nan;0;0
5288;73274;637;30;29;6;23;.793;2338000;0
5289;22684;632;44;20;4;16;.800;1137000;0
5289;190508;626;58;28;4;24;.857;3600000;0
5289;197595;632;94;37;1;36;.973;2416000;0
5289;145079;626;0;0;0;0;.00nan;0;0
5290;17625;644;0;0;0;0;.00nan;0;0
5290;86099;644;84;48;4;44;.917;3600000;0
5290;87603;628;96;25;0;25;1.000;3600000;0
5290;161336;628;0;0;0;0;.00nan;0;0
5291;11068;641;81;31;2;29;.935;3600000;0
5291;-1;637;71;16;0;16;1.000;1596000;0
5291;-1;641;0;0;0;0;.00nan;0;0
5291;73274;637;11;18;6;12;.667;2004000;0
5292;174209;631;0;0;0;0;.00nan;0;0
5292;-1;631;96;35;1;34;.971;3543000;0
5292;-1;1814;0;0;0;0;.00nan;0;0
5292;67362;1814;100;38;0;38;1.000;3600000;0
5293;186641;625;85;26;1;25;.962;3600000;0
5293;-1;642;0;0;0;0;.00nan;0;0
5293;-1;625;0;0;0;0;.00nan;0;0
5293;151728;642;77;53;5;48;.906;3600000;0
5294;183905;627;0;0;0;0;.00nan;0;0
5294;169552;1836;54;5;0;5;1.000;388000;0
5294;176963;627;66;24;2;22;.917;3600000;0
5294;148956;1836;36;33;6;27;.818;3212000;0
5295;182872;636;0;0;0;0;.00nan;0;0
5295;206235;639;0;0;0;0;.00nan;0;0
5295;181431;636;82;26;1;25;.962;3600000;0
5295;149969;639;77;32;2;30;.938;3591000;0
5296;183905;627;0;0;0;0;.00nan;0;0
5296;174209;631;75;21;1;20;.952;3600000;0
5296;176963;627;61;27;3;24;.889;3549000;0
5296;-1;631;0;0;0;0;.00nan;0;0
5297;182872;636;0;0;0;0;.00nan;0;0
5297;17625;644;0;0;0;0;.00nan;0;0
5297;181431;636;85;28;1;27;.964;3600000;0
5297;86099;644;71;25;2;23;.920;3571000;0
5298;22684;632;0;0;0;0;.00nan;0;0
5298;-1;637;76;31;2;29;.935;3600000;0
5298;197595;632;43;24;4;20;.833;3600000;0
5298;73274;637;0;0;0;0;.00nan;0;0
5299;11068;641;36;16;4;12;.750;1056000;0
5299;-1;641;68;37;3;34;.919;2544000;0
5299;-1;1814;0;0;0;0;.00nan;0;0
5299;67362;1814;60;17;2;15;.882;3600000;0
5300;-1;642;0;0;0;0;.00nan;0;0
5300;87603;628;0;0;0;0;.00nan;0;0
5300;151728;642;59;34;4;30;.882;3600000;0
5300;161336;628;72;23;2;21;.913;3600000;0
5301;206235;639;0;0;0;0;.00nan;0;0
5301;186641;625;94;21;0;21;1.000;3600000;0
5301;-1;625;0;0;0;0;.00nan;0;0
5301;149969;639;85;38;2;36;.947;3543000;0
5302;169552;1836;0;0;0;0;.00nan;0;0
5302;190508;626;100;42;2;40;.952;3600000;0
5302;145079;626;0;0;0;0;.00nan;0;0
5302;148956;1836;66;24;3;21;.875;3580000;0
5303;174209;631;88;37;1;36;.973;3600000;0
5303;190508;626;0;0;0;0;.00nan;0;0
5303;-1;631;0;0;0;0;.00nan;0;0
5303;145079;626;93;21;0;21;1.000;3600000;0
5304;22684;632;47;21;3;18;.857;1519000;0
5304;186641;625;96;18;0;18;1.000;3600000;0
5304;-1;625;0;0;0;0;.00nan;0;0
5304;197595;632;33;23;5;18;.783;2081000;0
5305;183905;627;0;0;0;0;.00nan;0;0
5305;17625;644;0;0;0;0;.00nan;0;0
5305;176963;627;53;28;4;24;.857;3542000;0
5305;86099;644;79;36;3;33;.917;3600000;0
5306;-1;642;0;0;0;0;.00nan;0;0
5306;-1;1814;0;0;0;0;.00nan;0;0
5306;67362;1814;68;24;2;22;.917;3600000;0
5306;151728;642;79;39;3;36;.923;3556000;0
5307;206235;639;48;15;2;13;.867;3600000;0
5307;-1;637;0;0;0;0;.00nan;0;0
5307;73274;637;92;52;4;48;.923;3600000;0
5307;149969;639;0;0;0;0;.00nan;0;0
5308;11068;641;53;50;6;44;.880;3533000;0
5308;169552;1836;0;0;0;0;.00nan;0;0
5308;-1;641;0;0;0;0;.00nan;0;0
5308;148956;1836;68;34;4;30;.882;3600000;0
5309;182872;636;51;24;4;20;.833;3834000;0
5309;181431;636;0;0;0;0;.00nan;0;0
5309;87603;628;46;32;5;27;.844;3834000;0
5309;161336;628;0;0;0;0;.00nan;0;0
5310;183905;627;0;0;0;0;.00nan;0;0
5310;176963;627;94;40;1;39;.975;3745000;0
5310;186641;625;77;28;2;26;.929;3745000;0
5310;-1;625;0;0;0;0;.00nan;0;0
5311;190508;626;0;0;0;0;.00nan;0;0
5311;-1;1814;57;22;2;20;.909;2407000;0
5311;67362;1814;39;20;4;16;.800;1193000;0
5311;145079;626;82;29;2;27;.931;3600000;0
5312;17625;644;65;10;0;10;1.000;1450000;0
5312;-1;637;0;0;0;0;.00nan;0;0
5312;73274;637;100;62;2;60;.968;3600000;0
5312;86099;644;31;13;4;9;.692;2117000;0
5313;169552;1836;0;0;0;0;.00nan;0;0
5313;206235;639;0;0;0;0;.00nan;0;0
5313;148956;1836;82;31;2;29;.935;3721000;0
5313;149969;639;62;25;3;22;.880;3693000;0
5314;22684;632;0;0;0;0;.00nan;0;0
5314;197595;632;69;40;4;36;.900;3600000;0
5314;87603;628;0;0;0;0;.00nan;0;0
5314;161336;628;60;16;2;14;.875;3600000;0
5315;182872;636;0;0;0;0;.00nan;0;0
5315;174209;631;0;0;0;0;.00nan;0;0
5315;181431;636;58;31;3;28;.903;3754000;0
5315;-1;631;86;31;2;29;.935;3754000;0
5316;11068;641;0;0;0;0;.00nan;0;0
5316;-1;641;65;25;2;23;.920;3600000;0
5316;-1;642;0;0;0;0;.00nan;0;0
5316;151728;642;97;43;3;40;.930;3570000;0
5317;182872;636;0;0;0;0;.00nan;0;0
5317;-1;637;0;0;0;0;.00nan;0;0
5317;181431;636;98;25;0;25;1.000;3600000;0
5317;73274;637;49;40;6;34;.850;3600000;0
5318;-1;1814;51;38;4;34;.895;3900000;0
5318;67362;1814;0;0;0;0;.00nan;0;0
5318;87603;628;73;41;4;37;.902;3900000;0
5318;161336;628;0;0;0;0;.00nan;0;0
5319;22684;632;77;40;3;37;.925;3600000;0
5319;190508;626;52;28;4;24;.857;3567000;0
5319;197595;632;0;0;0;0;.00nan;0;0
5319;145079;626;0;0;0;0;.00nan;0;0
5320;17625;644;0;0;0;0;.00nan;0;0
5320;-1;642;69;34;3;31;.912;2740000;0
5320;86099;644;90;16;0;16;1.000;3600000;0
5320;151728;642;29;14;4;10;.714;860000;0
5321;183905;627;0;0;0;0;.00nan;0;0
5321;206235;639;80;17;0;17;1.000;2838000;0
5321;176963;627;79;44;4;40;.909;3900000;0
5321;149969;639;42;21;4;17;.810;1062000;0
5322;169552;1836;0;0;0;0;.00nan;0;0
5322;174209;631;0;0;0;0;.00nan;0;0
5322;-1;631;75;29;1;28;.966;3900000;0
5322;148956;1836;92;27;1;26;.963;3900000;0
5323;11068;641;92;47;2;45;.957;3568000;0
5323;-1;641;0;0;0;0;.00nan;0;0
5323;186641;625;0;0;0;0;.00nan;0;0
5323;-1;625;68;18;1;17;.944;3600000;0
5324;190508;626;67;28;3;25;.893;3600000;0
5324;-1;642;54;23;3;20;.870;2437000;0
5324;145079;626;0;0;0;0;.00nan;0;0
5324;151728;642;31;17;4;13;.765;1163000;0
5325;-1;637;0;0;0;0;.00nan;0;0
5325;186641;625;63;24;2;22;.917;3600000;0
5325;-1;625;0;0;0;0;.00nan;0;0
5325;73274;637;51;53;6;47;.887;3600000;0
5326;183905;627;0;0;0;0;.00nan;0;0
5326;176963;627;60;27;3;24;.889;3545000;0
5326;-1;1814;99;62;2;60;.968;3600000;0
5326;67362;1814;0;0;0;0;.00nan;0;0
5327;17625;644;0;0;0;0;.00nan;0;0
5327;22684;632;0;0;0;0;.00nan;0;0
5327;197595;632;66;34;3;31;.912;3556000;0
5327;86099;644;79;28;2;26;.929;3600000;0
5328;174209;631;47;18;3;15;.833;3600000;0
5328;206235;639;0;0;0;0;.00nan;0;0
5328;-1;631;0;0;0;0;.00nan;0;0
5328;149969;639;53;37;5;32;.865;3556000;0
5329;169552;1836;0;0;0;0;.00nan;0;0
5329;87603;628;36;21;5;16;.762;1934000;0
5329;148956;1836;86;31;2;29;.935;3600000;0
5329;161336;628;20;19;6;13;.684;1666000;0
5330;182872;636;0;0;0;0;.00nan;0;0
5330;11068;641;78;41;3;38;.927;3600000;0
5330;181431;636;60;21;2;19;.905;3600000;0
5330;-1;641;0;0;0;0;.00nan;0;0
5331;17625;644;0;0;0;0;.00nan;0;0
5331;174209;631;23;32;7;25;.781;3594000;0
5331;-1;631;0;0;0;0;.00nan;0;0
5331;86099;644;38;28;5;23;.821;3600000;0
5332;169552;1836;0;0;0;0;.00nan;0;0
5332;22684;632;79;43;4;39;.907;3600000;0
5332;197595;632;0;0;0;0;.00nan;0;0
5332;148956;1836;100;25;0;25;1.000;3600000;0
5333;182872;636;0;0;0;0;.00nan;0;0
5333;183905;627;0;0;0;0;.00nan;0;0
5333;176963;627;49;39;6;33;.846;3546000;0
5333;181431;636;59;39;5;34;.872;3600000;0
5334;-1;642;0;0;0;0;.00nan;0;0
5334;-1;1814;45;29;4;25;.862;3600000;0
5334;67362;1814;0;0;0;0;.00nan;0;0
5334;151728;642;86;37;2;35;.946;3600000;0
5335;206235;639;0;0;0;0;.00nan;0;0
5335;190508;626;42;29;5;24;.828;3600000;0
5335;145079;626;0;0;0;0;.00nan;0;0
5335;149969;639;100;33;0;33;1.000;3600000;0
5336;186641;625;69;17;1;16;.941;3600000;0
5336;-1;625;0;0;0;0;.00nan;0;0
5336;87603;628;50;44;6;38;.864;2965000;0
5336;161336;628;53;5;0;5;1.000;635000;0
5337;11068;641;0;0;0;0;.00nan;0;0
5337;-1;637;0;0;0;0;.00nan;0;0
5337;-1;641;57;29;4;25;.862;3636000;0
5337;73274;637;60;26;3;23;.885;3636000;0
5338;11068;641;75;47;4;43;.915;3600000;0
5338;190508;626;92;19;0;19;1.000;3600000;0
5338;-1;641;0;0;0;0;.00nan;0;0
5338;145079;626;0;0;0;0;.00nan;0;0
5339;17625;644;0;0;0;0;.00nan;0;0
5339;-1;1814;58;33;4;29;.879;3600000;0
5339;67362;1814;0;0;0;0;.00nan;0;0
5339;86099;644;96;24;0;24;1.000;3600000;0
5340;22684;632;0;0;0;0;.00nan;0;0
5340;206235;639;0;0;0;0;.00nan;0;0
5340;197595;632;48;28;4;24;.857;3559000;0
5340;149969;639;61;26;3;23;.885;3600000;0
5341;-1;637;95;40;2;38;.950;3600000;0
5341;73274;637;0;0;0;0;.00nan;0;0
5341;87603;628;61;26;3;23;.885;3600000;0
5341;161336;628;0;0;0;0;.00nan;0;0
5342;174209;631;0;0;0;0;.00nan;0;0
5342;-1;642;0;0;0;0;.00nan;0;0
5342;-1;631;65;20;2;18;.900;3600000;0
5342;151728;642;70;33;3;30;.909;3600000;0
5343;182872;636;0;0;0;0;.00nan;0;0
5343;181431;636;79;27;1;26;.963;3600000;0
5343;186641;625;53;31;4;27;.871;3600000;0
5343;-1;625;0;0;0;0;.00nan;0;0
5344;183905;627;0;0;0;0;.00nan;0;0
5344;169552;1836;0;0;0;0;.00nan;0;0
5344;176963;627;45;20;4;16;.800;3600000;0
5344;148956;1836;100;37;0;37;1.000;3600000;0
5345;183905;627;0;0;0;0;.00nan;0;0
5345;176963;627;56;17;2;15;.882;3600000;0
5345;-1;637;0;0;0;0;.00nan;0;0
5345;73274;637;97;53;4;49;.925;3600000;0
5346;22684;632;69;21;1;20;.952;3900000;0
5346;-1;642;80;33;1;32;.970;3900000;0
5346;197595;632;0;0;0;0;.00nan;0;0
5346;151728;642;0;0;0;0;.00nan;0;0
5347;206235;639;0;0;0;0;.00nan;0;0
5347;186641;625;78;37;2;35;.946;3577000;0
5347;-1;625;0;0;0;0;.00nan;0;0
5347;149969;639;100;30;0;30;1.000;3600000;0
5348;174209;631;72;23;1;22;.957;3600000;0
5348;-1;631;0;0;0;0;.00nan;0;0
5348;-1;1814;0;0;0;0;.00nan;0;0
5348;67362;1814;42;19;3;16;.842;3553000;0
5349;17625;644;0;0;0;0;.00nan;0;0
5349;169552;1836;0;0;0;0;.00nan;0;0
5349;86099;644;97;44;2;42;.955;3900000;0
5349;148956;1836;73;26;2;24;.923;3900000;0
5350;11068;641;0;0;0;0;.00nan;0;0
5350;-1;641;98;55;1;54;.982;3600000;0
5350;147945;628;42;21;4;17;.810;3600000;0
5350;161336;628;0;0;0;0;.00nan;0;0
5351;182872;636;0;0;0;0;.00nan;0;0
5351;190508;626;32;30;6;24;.800;2666000;0
5351;181431;636;75;27;2;25;.926;3600000;0
5351;145079;626;31;10;3;7;.700;934000;0
5352;174209;631;50;37;6;31;.838;3600000;0
5352;190508;626;71;23;2;21;.913;3600000;0
5352;-1;631;0;0;0;0;.00nan;0;0
5352;145079;626;0;0;0;0;.00nan;0;0
5353;11068;641;36;36;6;30;.833;3600000;0
5353;17625;644;0;0;0;0;.00nan;0;0
5353;-1;641;0;0;0;0;.00nan;0;0
5353;86099;644;57;23;3;20;.870;3600000;0
5354;206235;639;0;0;0;0;.00nan;0;0
5354;-1;637;0;0;0;0;.00nan;0;0
5354;73274;637;73;34;2;32;.941;3541000;0
5354;149969;639;99;23;0;23;1.000;3600000;0
5355;186641;625;53;20;3;17;.850;3600000;0
5355;-1;625;0;0;0;0;.00nan;0;0
5355;-1;1814;88;51;4;47;.922;3559000;0
5355;67362;1814;0;0;0;0;.00nan;0;0
5356;183905;627;0;0;0;0;.00nan;0;0
5356;22684;632;0;0;0;0;.00nan;0;0
5356;176963;627;56;28;3;25;.893;3600000;0
5356;197595;632;78;46;5;41;.891;3576000;0
5357;-1;642;0;0;0;0;.00nan;0;0
5357;147945;628;57;15;2;13;.867;3892000;0
5357;151728;642;90;44;2;42;.955;3900000;0
5357;161336;628;0;0;0;0;.00nan;0;0
5358;182872;636;0;0;0;0;.00nan;0;0
5358;169552;1836;0;0;0;0;.00nan;0;0
5358;181431;636;78;26;2;24;.923;3600000;0
5358;148956;1836;67;31;3;28;.903;3573000;0
5359;22684;632;33;32;6;26;.813;2016000;0
5359;197595;632;36;13;3;10;.769;1584000;0
5359;-1;1814;0;0;0;0;.00nan;0;0
5359;67362;1814;76;28;3;25;.893;3600000;0
5360;174209;631;83;33;3;30;.909;3600000;0
5360;-1;631;0;0;0;0;.00nan;0;0
5360;87603;628;52;2;0;2;1.000;393000;0
5360;161336;628;45;37;6;31;.838;3207000;0
5361;190508;626;93;41;3;38;.927;3600000;0
5361;186641;625;49;27;4;23;.852;3545000;0
5361;-1;625;0;0;0;0;.00nan;0;0
5361;145079;626;0;0;0;0;.00nan;0;0
5362;169552;1836;66;25;2;23;.920;3600000;0
5362;-1;637;0;0;0;0;.00nan;0;0
5362;73274;637;69;30;3;27;.900;3543000;0
5362;148956;1836;0;0;0;0;.00nan;0;0
5363;11068;641;55;17;2;15;.882;1161000;0
5363;183905;627;0;0;0;0;.00nan;0;0
5363;176963;627;69;19;1;18;.947;3600000;0
5363;-1;641;43;38;6;32;.842;2439000;0
5364;206235;639;0;0;0;0;.00nan;0;0
5364;-1;642;51;2;0;2;1.000;366000;0
5364;149969;639;74;24;2;22;.917;3600000;0
5364;151728;642;56;47;6;41;.872;3234000;0
5365;182872;636;0;0;0;0;.00nan;0;0
5365;17625;644;0;0;0;0;.00nan;0;0
5365;181431;636;49;23;3;20;.870;3900000;0
5365;86099;644;73;38;3;35;.921;3900000;0
5366;11068;641;66;49;6;43;.878;3600000;0
5366;22684;632;0;0;0;0;.00nan;0;0
5366;-1;641;0;0;0;0;.00nan;0;0
5366;197595;632;93;31;1;30;.968;3600000;0
5367;182872;636;0;0;0;0;.00nan;0;0
5367;181431;636;88;41;2;39;.951;3600000;0
5367;-1;1814;96;41;3;38;.927;3573000;0
5367;67362;1814;0;0;0;0;.00nan;0;0
5368;17625;644;0;0;0;0;.00nan;0;0
5368;211484;627;0;0;0;0;.00nan;0;0
5368;176963;627;76;37;3;34;.919;3600000;0
5368;86099;644;57;28;4;24;.857;3544000;0
5369;-1;637;0;0;0;0;.00nan;0;0
5369;-1;642;0;0;0;0;.00nan;0;0
5369;73274;637;79;25;1;24;.960;3600000;0
5369;151728;642;63;40;4;36;.900;3600000;0
5370;206235;639;0;0;0;0;.00nan;0;0
5370;87603;628;30;13;4;9;.692;1136000;0
5370;149969;639;98;43;2;41;.953;3600000;0
5370;161336;628;67;21;2;19;.905;2464000;0
5371;174209;631;0;0;0;0;.00nan;0;0
5371;186641;625;71;26;2;24;.923;3600000;0
5371;-1;625;0;0;0;0;.00nan;0;0
5371;-1;631;37;35;6;29;.829;3600000;0
5372;169552;1836;0;0;0;0;.00nan;0;0
5372;190508;626;90;39;3;36;.923;3562000;0
5372;145079;626;0;0;0;0;.00nan;0;0
5372;148956;1836;66;20;2;18;.900;3600000;0
5373;17625;644;52;39;5;34;.872;3600000;0
5373;190508;626;73;34;3;31;.912;3600000;0
5373;86099;644;0;0;0;0;.00nan;0;0
5373;145079;626;0;0;0;0;.00nan;0;0
5374;22684;632;100;29;0;29;1.000;3681000;0
5374;-1;637;87;30;1;29;.967;3681000;0
5374;197595;632;0;0;0;0;.00nan;0;0
5374;73274;637;0;0;0;0;.00nan;0;0
5375;174209;631;46;25;4;21;.840;3900000;0
5375;211484;627;0;0;0;0;.00nan;0;0
5375;176963;627;88;47;4;43;.915;3900000;0
5375;-1;631;0;0;0;0;.00nan;0;0
5376;206235;639;0;0;0;0;.00nan;0;0
5376;-1;1814;0;0;0;0;.00nan;0;0
5376;67362;1814;70;26;2;24;.923;3600000;0
5376;149969;639;49;29;4;25;.862;3550000;0
5377;186641;625;67;19;2;17;.895;3600000;0
5377;-1;642;0;0;0;0;.00nan;0;0
5377;-1;625;0;0;0;0;.00nan;0;0
5377;151728;642;69;42;3;39;.929;3600000;0
5378;11068;641;89;36;2;34;.944;3532000;0
5378;169552;1836;0;0;0;0;.00nan;0;0
5378;-1;641;0;0;0;0;.00nan;0;0
5378;148956;1836;91;26;1;25;.962;3600000;0
5379;182872;636;0;0;0;0;.00nan;0;0
5379;181431;636;78;34;3;31;.912;3600000;0
5379;87603;628;0;0;0;0;.00nan;0;0
5379;161336;628;45;25;4;21;.840;3597000;0
5380;211484;627;0;0;0;0;.00nan;0;0
5380;176963;627;76;30;2;28;.933;3600000;0
5380;-1;642;0;0;0;0;.00nan;0;0
5380;151728;642;76;57;6;51;.895;3600000;0
5381;17625;644;0;0;0;0;.00nan;0;0
5381;206235;639;0;0;0;0;.00nan;0;0
5381;86099;644;91;29;1;28;.966;3600000;0
5381;149969;639;46;34;6;28;.824;3600000;0
5382;174209;631;69;31;2;29;.935;3600000;0
5382;-1;637;0;0;0;0;.00nan;0;0
5382;-1;631;0;0;0;0;.00nan;0;0
5382;73274;637;70;29;3;26;.897;3581000;0
5383;190508;626;99;38;1;37;.974;3600000;0
5383;87603;628;0;0;0;0;.00nan;0;0
5383;145079;626;0;0;0;0;.00nan;0;0
5383;161336;628;56;24;3;21;.875;3524000;0
5384;169552;1836;0;0;0;0;.00nan;0;0
5384;186641;625;59;26;3;23;.885;3568000;0
5384;-1;625;0;0;0;0;.00nan;0;0
5384;148956;1836;88;36;2;34;.944;3600000;0
5385;11068;641;100;43;0;43;1.000;3600000;0
5385;-1;641;0;0;0;0;.00nan;0;0
5385;-1;1814;0;0;0;0;.00nan;0;0
5385;67362;1814;64;38;4;34;.895;3600000;0
5386;182872;636;0;0;0;0;.00nan;0;0
5386;22684;632;0;0;0;0;.00nan;0;0
5386;181431;636;82;25;1;24;.960;3600000;0
5386;197595;632;54;45;5;40;.889;3600000;0
5387;-1;637;0;0;0;0;.00nan;0;0
5387;-1;1814;53;28;5;23;.821;3600000;0
5387;67362;1814;0;0;0;0;.00nan;0;0
5387;73274;637;82;38;2;36;.947;3600000;0
5388;211484;627;0;0;0;0;.00nan;0;0
5388;176963;627;47;26;4;22;.846;3519000;0
5388;190508;626;86;36;2;34;.944;3600000;0
5388;145079;626;0;0;0;0;.00nan;0;0
5389;182872;636;0;0;0;0;.00nan;0;0
5389;206235;639;0;0;0;0;.00nan;0;0
5389;181431;636;74;40;4;36;.900;3595000;0
5389;149969;639;54;21;3;18;.857;3600000;0
5390;17625;644;0;0;0;0;.00nan;0;0
5390;86099;644;55;19;3;16;.842;3600000;0
5390;147945;628;62;40;6;34;.850;3600000;0
5390;161336;628;0;0;0;0;.00nan;0;0
5391;11068;641;94;44;3;41;.932;3600000;0
5391;174209;631;26;13;4;9;.692;2191000;0
5391;-1;641;0;0;0;0;.00nan;0;0
5391;-1;631;60;9;0;9;1.000;1354000;0
5392;22684;632;62;47;5;42;.894;3600000;0
5392;186641;625;89;23;1;22;.957;3600000;0
5392;-1;625;0;0;0;0;.00nan;0;0
5392;197595;632;0;0;0;0;.00nan;0;0
5393;169552;1836;0;0;0;0;.00nan;0;0
5393;-1;642;0;0;0;0;.00nan;0;0
5393;148956;1836;65;18;2;16;.889;3900000;0
5393;151728;642;94;45;2;43;.956;3900000;0
5394;17625;644;0;0;0;0;.00nan;0;0
5394;186641;625;51;18;3;15;.833;3539000;0
5394;-1;625;0;0;0;0;.00nan;0;0
5394;86099;644;100;38;1;37;.974;3600000;0
5395;-1;637;0;0;0;0;.00nan;0;0
5395;190508;626;83;34;2;32;.941;3638000;0
5395;73274;637;79;37;3;34;.919;3638000;0
5395;145079;626;0;0;0;0;.00nan;0;0
5396;169552;1836;0;0;0;0;.00nan;0;0
5396;-1;1814;0;0;0;0;.00nan;0;0
5396;67362;1814;42;38;6;32;.842;3600000;0
5396;148956;1836;100;31;1;30;.968;3600000;0
5397;22684;632;0;0;0;0;.00nan;0;0
5397;174209;631;71;19;1;18;.947;3600000;0
5397;197595;632;63;26;2;24;.923;3551000;0
5397;-1;631;0;0;0;0;.00nan;0;0
5398;211484;627;0;0;0;0;.00nan;0;0
5398;176963;627;100;41;1;40;.976;3600000;0
5398;147945;628;69;31;3;28;.903;3516000;0
5398;161336;628;0;0;0;0;.00nan;0;0
5399;182872;636;0;0;0;0;.00nan;0;0
5399;181431;636;82;13;0;13;1.000;3600000;0
5399;-1;642;74;21;1;20;.952;1599000;0
5399;151728;642;59;34;4;30;.882;2001000;0
5400;11068;641;95;54;3;51;.944;3900000;0
5400;206235;639;0;0;0;0;.00nan;0;0
5400;-1;641;0;0;0;0;.00nan;0;0
5400;149969;639;52;24;3;21;.875;3900000;0
5401;190508;626;76;29;3;26;.897;3900000;0
5401;-1;1814;82;44;3;41;.932;3900000;0
5401;67362;1814;0;0;0;0;.00nan;0;0
5401;145079;626;0;0;0;0;.00nan;0;0
5402;22684;632;61;24;3;21;.875;3600000;0
5402;-1;642;0;0;0;0;.00nan;0;0
5402;197595;632;0;0;0;0;.00nan;0;0
5402;151728;642;67;39;4;35;.897;3570000;0
5403;11068;641;94;62;5;57;.919;3550000;0
5403;211484;627;0;0;0;0;.00nan;0;0
5403;176963;627;48;24;4;20;.833;3600000;0
5403;-1;641;0;0;0;0;.00nan;0;0
5404;206235;639;0;0;0;0;.00nan;0;0
5404;147945;628;71;28;3;25;.893;3549000;0
5404;149969;639;72;28;2;26;.929;3600000;0
5404;161336;628;0;0;0;0;.00nan;0;0
5405;-1;637;0;0;0;0;.00nan;0;0
5405;186641;625;71;24;2;22;.917;3600000;0
5405;-1;625;0;0;0;0;.00nan;0;0
5405;73274;637;96;50;3;47;.940;3571000;0
5406;169552;1836;0;0;0;0;.00nan;0;0
5406;174209;631;84;34;3;31;.912;3600000;0
5406;-1;631;0;0;0;0;.00nan;0;0
5406;148956;1836;60;28;4;24;.857;3575000;0
5407;182872;636;0;0;0;0;.00nan;0;0
5407;17625;644;0;0;0;0;.00nan;0;0
5407;181431;636;90;36;1;35;.972;3600000;0
5407;86099;644;68;36;4;32;.889;3600000;0
5408;182872;636;0;0;0;0;.00nan;0;0
5408;181431;636;60;24;3;21;.875;3600000;0
5408;-1;1814;43;30;4;26;.867;3588000;0
5408;67362;1814;0;0;0;0;.00nan;0;0
5409;190508;626;58;38;5;33;.868;3600000;0
5409;145079;626;0;0;0;0;.00nan;0;0
5409;147945;628;58;35;4;31;.886;3600000;0
5409;161336;628;0;0;0;0;.00nan;0;0
5410;17625;644;0;0;0;0;.00nan;0;0
5410;211484;627;0;0;0;0;.00nan;0;0
5410;176963;627;74;25;2;23;.920;3845000;0
5410;86099;644;98;47;1;46;.979;3845000;0
5411;169552;1836;0;0;0;0;.00nan;0;0
5411;-1;637;0;0;0;0;.00nan;0;0
5411;73274;637;87;48;3;45;.938;3600000;0
5411;148956;1836;50;14;2;12;.857;3600000;0
5412;22684;632;72;28;3;25;.893;3790000;0
5412;206235;639;0;0;0;0;.00nan;0;0
5412;197595;632;0;0;0;0;.00nan;0;0
5412;149969;639;68;21;2;19;.905;3786000;0
5413;174209;631;84;41;3;38;.927;3550000;0
5413;186641;625;65;15;1;14;.933;3600000;0
5413;-1;625;0;0;0;0;.00nan;0;0
5413;-1;631;0;0;0;0;.00nan;0;0
5414;11068;641;0;0;0;0;.00nan;0;0
5414;-1;641;38;29;5;24;.828;3590000;0
5414;-1;642;0;0;0;0;.00nan;0;0
5414;151728;642;46;17;3;14;.824;3600000;0
5415;190508;626;71;40;3;37;.925;3900000;0
5415;186641;625;68;29;3;26;.897;3900000;0
5415;-1;625;0;0;0;0;.00nan;0;0
5415;145079;626;0;0;0;0;.00nan;0;0
5416;206235;639;0;0;0;0;.00nan;0;0
5416;-1;642;0;0;0;0;.00nan;0;0
5416;149969;639;58;23;3;20;.870;3578000;0
5416;151728;642;71;30;2;28;.933;3600000;0
5417;-1;1814;0;0;0;0;.00nan;0;0
5417;67362;1814;73;54;6;48;.889;3600000;0
5417;147945;628;79;20;1;19;.950;3600000;0
5417;161336;628;0;0;0;0;.00nan;0;0
5418;169552;1836;87;27;1;26;.963;3600000;0
5418;22684;632;0;0;0;0;.00nan;0;0
5418;197595;632;98;49;2;47;.959;3565000;0
5418;148956;1836;0;0;0;0;.00nan;0;0
5419;11068;641;47;31;5;26;.839;3600000;0
5419;17625;644;0;0;0;0;.00nan;0;0
5419;-1;641;0;0;0;0;.00nan;0;0
5419;86099;644;62;21;2;19;.905;3600000;0
5420;182872;636;0;0;0;0;.00nan;0;0
5420;211484;627;0;0;0;0;.00nan;0;0
5420;176963;627;99;31;0;31;1.000;3600000;0
5420;181431;636;69;24;1;23;.958;3594000;0
5421;22684;632;0;0;0;0;.00nan;0;0
5421;197595;632;65;40;4;36;.900;3582000;0
5421;-1;1814;68;27;2;25;.926;3600000;0
5421;67362;1814;0;0;0;0;.00nan;0;0
5422;174209;631;58;24;3;21;.875;3556000;0
5422;-1;637;0;0;0;0;.00nan;0;0
5422;-1;631;0;0;0;0;.00nan;0;0
5422;73274;637;90;38;1;37;.974;3600000;0
5423;182872;636;0;0;0;0;.00nan;0;0
5423;181431;636;46;33;6;27;.818;3600000;0
5423;186641;625;91;42;2;40;.952;3600000;0
5423;-1;625;0;0;0;0;.00nan;0;0
5424;17625;644;0;0;0;0;.00nan;0;0
5424;174209;631;100;43;1;42;.977;3600000;0
5424;-1;631;0;0;0;0;.00nan;0;0
5424;86099;644;45;17;2;15;.882;3563000;0
5425;-1;637;35;38;6;32;.842;3515000;0
5425;73274;637;0;0;0;0;.00nan;0;0
5425;147945;628;64;35;4;31;.886;3600000;0
5425;161336;628;0;0;0;0;.00nan;0;0
5426;11068;641;88;36;2;34;.944;3554000;0
5426;-1;641;0;0;0;0;.00nan;0;0
5426;-1;1814;0;0;0;0;.00nan;0;0
5426;67362;1814;75;20;1;19;.950;3600000;0
5427;22684;632;75;33;2;31;.939;3600000;0
5427;190508;626;57;28;3;25;.893;3600000;0
5427;197595;632;0;0;0;0;.00nan;0;0
5427;145079;626;0;0;0;0;.00nan;0;0
5428;169552;1836;0;0;0;0;.00nan;0;0
5428;-1;642;0;0;0;0;.00nan;0;0
5428;148956;1836;100;21;0;21;1.000;3600000;0
5428;151728;642;88;42;3;39;.929;3600000;0
5429;206235;639;56;37;5;32;.865;3550000;0
5429;211484;627;0;0;0;0;.00nan;0;0
5429;176963;627;80;39;3;36;.923;3600000;0
5429;149969;639;0;0;0;0;.00nan;0;0
5430;-1;637;0;0;0;0;.00nan;0;0
5430;-1;642;0;0;0;0;.00nan;0;0
5430;73274;637;47;16;3;13;.813;3600000;0
5430;151728;642;70;48;5;43;.896;3538000;0
5431;206235;639;0;0;0;0;.00nan;0;0
5431;186641;625;52;17;2;15;.882;3600000;0
5431;-1;625;0;0;0;0;.00nan;0;0
5431;149969;639;78;43;4;39;.907;3525000;0
5432;211484;627;0;0;0;0;.00nan;0;0
5432;176963;627;41;35;6;29;.829;3600000;0
5432;147945;628;73;28;2;26;.929;3600000;0
5432;161336;628;0;0;0;0;.00nan;0;0
5433;17625;644;0;0;0;0;.00nan;0;0
5433;169552;1836;0;0;0;0;.00nan;0;0
5433;86099;644;64;25;3;22;.880;3788000;0
5433;148956;1836;80;31;2;29;.935;3788000;0
5434;11068;641;0;0;0;0;.00nan;0;0
5434;174209;631;82;26;1;25;.962;3600000;0
5434;-1;641;69;37;4;33;.892;3600000;0
5434;-1;631;0;0;0;0;.00nan;0;0
5435;182872;636;100;35;1;34;.971;3600000;0
5435;190508;626;84;36;3;33;.917;3542000;0
5435;181431;636;0;0;0;0;.00nan;0;0
5435;145079;626;0;0;0;0;.00nan;0;0
5436;174209;631;0;0;0;0;.00nan;0;0
5436;-1;631;26;30;6;24;.800;3600000;0
5436;147945;628;56;20;2;18;.900;3600000;0
5436;161336;628;0;0;0;0;.00nan;0;0
5437;182872;636;0;0;0;0;.00nan;0;0
5437;169552;1836;0;0;0;0;.00nan;0;0
5437;181431;636;96;31;1;30;.968;3900000;0
5437;148956;1836;97;31;1;30;.968;3900000;0
5438;11068;641;68;18;1;17;.944;3600000;0
5438;22684;632;68;32;3;29;.906;3161000;0
5438;-1;641;0;0;0;0;.00nan;0;0
5438;197595;632;28;7;3;4;.571;439000;0
5439;206235;639;0;0;0;0;.00nan;0;0
5439;190508;626;63;32;3;29;.906;3600000;0
5439;145079;626;0;0;0;0;.00nan;0;0
5439;149969;639;33;25;5;20;.800;3521000;0
5440;211484;627;69;34;3;31;.912;3600000;0
5440;176963;627;0;0;0;0;.00nan;0;0
5440;-1;1814;53;35;5;30;.857;3563000;0
5440;67362;1814;0;0;0;0;.00nan;0;0
5441;11068;641;88;54;4;50;.926;3600000;0
5441;-1;641;0;0;0;0;.00nan;0;0
5441;186641;625;52;10;1;9;.900;3600000;0
5441;-1;625;0;0;0;0;.00nan;0;0
5442;182872;636;0;0;0;0;.00nan;0;0
5442;-1;637;0;0;0;0;.00nan;0;0
5442;181431;636;26;21;5;16;.762;3600000;0
5442;73274;637;39;37;6;31;.838;3600000;0
5443;17625;644;0;0;0;0;.00nan;0;0
5443;22684;632;64;34;3;31;.912;3556000;0
5443;197595;632;0;0;0;0;.00nan;0;0
5443;86099;644;80;31;2;29;.935;3600000;0
5444;169552;1836;0;0;0;0;.00nan;0;0
5444;147945;628;90;35;2;33;.943;3600000;0
5444;148956;1836;29;33;7;26;.788;3600000;0
5444;161336;628;0;0;0;0;.00nan;0;0
5445;174209;631;61;14;1;13;.929;3600000;0
5445;-1;642;0;0;0;0;.00nan;0;0
5445;-1;631;0;0;0;0;.00nan;0;0
5445;151728;642;98;65;4;61;.938;3600000;0
5446;186641;625;67;25;2;23;.920;3600000;0
5446;-1;625;0;0;0;0;.00nan;0;0
5446;-1;1814;0;0;0;0;.00nan;0;0
5446;67362;1814;83;50;3;47;.940;3599000;0
5447;17625;644;32;22;5;17;.773;2164000;0
5447;86099;644;54;12;1;11;.917;1436000;0
5447;147945;628;100;41;2;39;.951;3600000;0
5447;161336;628;0;0;0;0;.00nan;0;0
5448;22684;632;51;10;1;9;.900;1319000;0
5448;211484;627;0;0;0;0;.00nan;0;0
5448;176963;627;94;21;0;21;1.000;3600000;0
5448;197595;632;56;35;5;30;.857;2281000;0
5449;190508;626;70;20;1;19;.950;3558000;0
5449;-1;642;0;0;0;0;.00nan;0;0
5449;145079;626;0;0;0;0;.00nan;0;0
5449;151728;642;100;45;0;45;1.000;3600000;0
5450;206235;639;0;0;0;0;.00nan;0;0
5450;-1;637;0;0;0;0;.00nan;0;0
5450;73274;637;92;47;3;44;.936;3557000;0
5450;149969;639;56;17;2;15;.882;3600000;0
5451;11068;641;97;42;2;40;.952;3554000;0
5451;169552;1836;0;0;0;0;.00nan;0;0
5451;-1;641;0;0;0;0;.00nan;0;0
5451;148956;1836;100;25;0;25;1.000;3600000;0
5452;182872;636;0;0;0;0;.00nan;0;0
5452;174209;631;81;32;2;30;.938;3900000;0
5452;181431;636;100;47;2;45;.957;3900000;0
5452;-1;631;0;0;0;0;.00nan;0;0
5453;206235;639;0;0;0;0;.00nan;0;0
5453;-1;1814;72;29;2;27;.931;3784000;0
5453;67362;1814;0;0;0;0;.00nan;0;0
5453;149969;639;61;26;3;23;.885;3784000;0
5454;22684;632;0;0;0;0;.00nan;0;0
5454;174209;631;51;30;4;26;.867;3600000;0
5454;197595;632;94;40;1;39;.975;3600000;0
5454;-1;631;0;0;0;0;.00nan;0;0
5455;182872;636;36;7;2;5;.714;787000;0
5455;181431;636;39;31;6;25;.806;2813000;0
5455;147945;628;90;26;1;25;.962;3600000;0
5455;161336;628;0;0;0;0;.00nan;0;0
5456;169552;1836;0;0;0;0;.00nan;0;0
5456;190508;626;67;41;4;37;.902;3600000;0
5456;145079;626;0;0;0;0;.00nan;0;0
5456;148956;1836;73;29;2;27;.931;3600000;0
5457;-1;637;0;0;0;0;.00nan;0;0
5457;-1;1814;0;0;0;0;.00nan;0;0
5457;67362;1814;87;19;0;19;1.000;3600000;0
5457;73274;637;79;33;2;31;.939;3523000;0
5458;17625;644;0;0;0;0;.00nan;0;0
5458;-1;642;0;0;0;0;.00nan;0;0
5458;86099;644;77;12;0;12;1.000;3600000;0
5458;151728;642;79;35;3;32;.914;3600000;0
5459;211484;627;39;8;2;6;.750;715000;0
5459;176963;627;43;37;6;31;.838;2885000;0
5459;186641;625;74;22;1;21;.955;3600000;0
5459;-1;625;0;0;0;0;.00nan;0;0
5460;11068;641;0;0;0;0;.00nan;0;0
5460;206235;639;0;0;0;0;.00nan;0;0
5460;-1;641;57;36;4;32;.889;3600000;0
5460;149969;639;91;15;0;15;1.000;3600000;0
5461;211484;627;0;0;0;0;.00nan;0;0
5461;176963;627;54;42;5;37;.881;3570000;0
5461;190508;626;57;32;4;28;.875;3600000;0
5461;145079;626;0;0;0;0;.00nan;0;0
5462;17625;644;74;26;1;25;.962;2487000;0
5462;206235;639;0;0;0;0;.00nan;0;0
5462;86099;644;46;22;4;18;.818;1113000;0
5462;149969;639;58;20;2;18;.900;3600000;0
5463;174209;631;81;34;2;32;.941;3873000;0
5463;-1;631;0;0;0;0;.00nan;0;0
5463;-1;1814;0;0;0;0;.00nan;0;0
5463;67362;1814;78;35;2;33;.943;3900000;0
5464;22684;632;61;39;4;35;.897;3900000;0
5464;197595;632;0;0;0;0;.00nan;0;0
5464;147945;628;56;28;4;24;.857;3881000;0
5464;161336;628;0;0;0;0;.00nan;0;0
5465;169552;1836;0;0;0;0;.00nan;0;0
5465;186641;625;34;19;4;15;.789;3600000;0
5465;-1;625;0;0;0;0;.00nan;0;0
5465;148956;1836;100;41;1;40;.976;3600000;0
5466;11068;641;72;28;2;26;.929;3600000;0
5466;-1;637;0;0;0;0;.00nan;0;0
5466;-1;641;0;0;0;0;.00nan;0;0
5466;73274;637;47;31;5;26;.839;3600000;0
5467;182872;636;0;0;0;0;.00nan;0;0
5467;181431;636;97;19;0;19;1.000;3600000;0
5467;-1;642;0;0;0;0;.00nan;0;0
5467;151728;642;80;52;5;47;.904;3600000;0
5468;211484;627;0;0;0;0;.00nan;0;0
5468;176963;627;72;19;1;18;.947;3600000;0
5468;-1;637;0;0;0;0;.00nan;0;0
5468;73274;637;87;61;4;57;.934;3600000;0
5469;186641;625;86;16;0;16;1.000;3600000;0
5469;-1;642;0;0;0;0;.00nan;0;0
5469;-1;625;0;0;0;0;.00nan;0;0
5469;151728;642;98;71;2;69;.972;3600000;0
5470;17625;644;0;0;0;0;.00nan;0;0
5470;190508;626;88;27;1;26;.963;3900000;0
5470;86099;644;97;55;1;54;.982;3900000;0
5470;145079;626;0;0;0;0;.00nan;0;0
5471;11068;641;98;52;3;49;.942;3600000;0
5471;190508;626;0;0;0;0;.00nan;0;0
5471;-1;641;0;0;0;0;.00nan;0;0
5471;145079;626;66;24;2;22;.917;3600000;0
5472;17625;644;0;0;0;0;.00nan;0;0
5472;-1;637;0;0;0;0;.00nan;0;0
5472;73274;637;100;25;0;25;1.000;3600000;0
5472;86099;644;52;31;4;27;.871;3600000;0
5473;211484;627;0;0;0;0;.00nan;0;0
5473;176963;627;88;13;0;13;1.000;3600000;0
5473;-1;642;0;0;0;0;.00nan;0;0
5473;151728;642;84;42;3;39;.929;3600000;0
5474;174209;631;78;30;3;27;.900;3900000;0
5474;206235;639;0;0;0;0;.00nan;0;0
5474;-1;631;0;0;0;0;.00nan;0;0
5474;149969;639;63;31;3;28;.903;3900000;0
5475;186641;625;92;34;1;33;.971;3600000;0
5475;-1;625;0;0;0;0;.00nan;0;0
5475;147945;628;68;31;3;28;.903;3518000;0
5475;161336;628;0;0;0;0;.00nan;0;0
5476;169552;1836;0;0;0;0;.00nan;0;0
5476;-1;1814;0;0;0;0;.00nan;0;0
5476;67362;1814;96;41;2;39;.951;3558000;0
5476;148956;1836;86;19;0;19;1.000;3600000;0
5477;182872;636;0;0;0;0;.00nan;0;0
5477;22684;632;0;0;0;0;.00nan;0;0
5477;181431;636;88;37;2;35;.946;3900000;0
5477;197595;632;100;45;2;43;.956;3900000;0
5478;17625;644;0;0;0;0;.00nan;0;0
5478;-1;1814;82;38;2;36;.947;3600000;0
5478;67362;1814;0;0;0;0;.00nan;0;0
5478;86099;644;30;37;7;30;.811;3600000;0
5479;-1;637;0;0;0;0;.00nan;0;0
5479;190508;626;53;29;5;24;.828;3572000;0
5479;73274;637;61;35;4;31;.886;3600000;0
5479;145079;626;0;0;0;0;.00nan;0;0
5480;174209;631;0;0;0;0;.00nan;0;0
5480;211484;627;0;0;0;0;.00nan;0;0
5480;176963;627;79;35;2;33;.943;3600000;0
5480;-1;631;64;36;4;32;.889;3600000;0
5481;-1;642;0;0;0;0;.00nan;0;0
5481;147945;628;63;23;2;21;.913;3531000;0
5481;151728;642;100;50;0;50;1.000;3600000;0
5481;161336;628;0;0;0;0;.00nan;0;0
5482;169552;1836;0;0;0;0;.00nan;0;0
5482;206235;639;0;0;0;0;.00nan;0;0
5482;148956;1836;73;29;3;26;.897;3600000;0
5482;149969;639;50;35;5;30;.857;3575000;0
5483;22684;632;98;62;5;57;.919;3537000;0
5483;186641;625;0;0;0;0;.00nan;0;0
5483;-1;625;40;14;3;11;.786;3600000;0
5483;197595;632;0;0;0;0;.00nan;0;0
5484;182872;636;0;0;0;0;.00nan;0;0
5484;11068;641;73;49;4;45;.918;3580000;0
5484;181431;636;82;24;2;22;.917;3600000;0
5484;-1;641;0;0;0;0;.00nan;0;0
5485;-1;642;0;0;0;0;.00nan;0;0
5485;-1;1814;0;0;0;0;.00nan;0;0
5485;67362;1814;100;28;0;28;1.000;3600000;0
5485;151728;642;98;60;2;58;.967;3558000;0
5486;22684;632;0;0;0;0;.00nan;0;0
5486;-1;637;0;0;0;0;.00nan;0;0
5486;197595;632;65;31;3;28;.903;3600000;0
5486;73274;637;58;43;5;38;.884;3600000;0
5487;169552;1836;0;0;0;0;.00nan;0;0
5487;211484;627;0;0;0;0;.00nan;0;0
5487;176963;627;68;33;3;30;.909;3727000;0
5487;148956;1836;99;43;2;41;.953;3727000;0
5488;11068;641;42;24;4;20;.833;765000;0
5488;-1;641;40;39;6;33;.846;2835000;0
5488;147945;628;69;23;2;21;.913;3600000;0
5488;161336;628;0;0;0;0;.00nan;0;0
5489;174209;631;57;20;2;18;.900;3558000;0
5489;190508;626;94;29;1;28;.966;3600000;0
5489;-1;631;0;0;0;0;.00nan;0;0
5489;145079;626;0;0;0;0;.00nan;0;0
5490;17625;644;0;0;0;0;.00nan;0;0
5490;186641;625;88;47;4;43;.915;3802000;0
5490;-1;625;0;0;0;0;.00nan;0;0
5490;86099;644;70;44;5;39;.886;3802000;0
5491;182872;636;0;0;0;0;.00nan;0;0
5491;206235;639;0;0;0;0;.00nan;0;0
5491;181431;636;89;27;1;26;.963;3600000;0
5491;149969;639;93;39;2;37;.949;3583000;0
5493;182872;636;0;0;0;0;.00nan;0;0
5493;17625;644;0;0;0;0;.00nan;0;0
5493;181431;636;74;29;2;27;.931;3900000;0
5493;86099;644;74;30;2;28;.933;3900000;0
5497;174209;631;0;0;0;0;.00nan;0;0
5497;-1;642;0;0;0;0;.00nan;0;0
5497;-1;631;65;22;2;20;.909;3600000;0
5497;151728;642;72;37;4;33;.892;3518000;0
5503;-1;637;0;0;0;0;.00nan;0;0
5503;190508;626;71;32;3;29;.906;3600000;0
5503;73274;637;73;24;2;22;.917;3600000;0
5503;145079;626;0;0;0;0;.00nan;0;0
5505;169552;1836;0;0;0;0;.00nan;0;0
5505;206235;639;0;0;0;0;.00nan;0;0
5505;148956;1836;67;19;1;18;.947;3600000;0
5505;149969;639;98;51;2;49;.961;3581000;0
5507;206235;639;0;0;0;0;.00nan;0;0
5507;-1;642;73;37;2;35;.946;3900000;0
5507;149969;639;69;25;2;23;.920;3900000;0
5507;151728;642;0;0;0;0;.00nan;0;0
5509;22684;632;0;0;0;0;.00nan;0;0
5509;174209;631;58;26;3;23;.885;3600000;0
5509;197595;632;44;34;5;29;.853;3600000;0
5509;-1;631;0;0;0;0;.00nan;0;0
5511;182872;636;70;33;3;30;.909;3596000;0
5511;190508;626;0;0;0;0;.00nan;0;0
5511;181431;636;0;0;0;0;.00nan;0;0
5511;145079;626;75;28;2;26;.929;3600000;0
5517;17625;644;96;30;1;29;.967;3600000;0
5517;169552;1836;45;29;4;25;.862;3600000;0
5517;86099;644;0;0;0;0;.00nan;0;0
5517;148956;1836;0;0;0;0;.00nan;0;0
5521;169552;1836;0;0;0;0;.00nan;0;0
5521;-1;642;0;0;0;0;.00nan;0;0
5521;148956;1836;71;17;1;16;.941;3600000;0
5521;151728;642;98;66;3;63;.955;3559000;0
5523;17625;644;0;0;0;0;.00nan;0;0
5523;-1;1814;0;0;0;0;.00nan;0;0
5523;67362;1814;46;34;5;29;.853;3900000;0
5523;86099;644;53;32;5;27;.844;3900000;0
5525;174209;631;66;34;3;31;.912;3600000;0
5525;-1;631;0;0;0;0;.00nan;0;0
5525;87603;628;0;0;0;0;.00nan;0;0
5525;161336;628;100;20;0;20;1.000;3600000;0
5527;182872;636;59;6;0;6;1.000;957000;0
5527;181431;636;41;33;6;27;.818;2643000;0
5527;186641;625;77;27;2;25;.926;3600000;0
5527;-1;625;0;0;0;0;.00nan;0;0
5529;176963;627;100;29;0;29;1.000;3600000;0
5529;-1;637;54;31;4;27;.871;3158000;0
5529;73274;637;30;9;3;6;.667;442000;0
5529;145038;627;0;0;0;0;.00nan;0;0
5531;22684;632;83;31;2;29;.935;3541000;0
5531;190508;626;100;30;0;30;1.000;3600000;0
5531;197595;632;0;0;0;0;.00nan;0;0
5531;145079;626;0;0;0;0;.00nan;0;0
5533;11068;641;97;51;1;50;.980;3555000;0
5533;206235;639;0;0;0;0;.00nan;0;0
5533;-1;641;0;0;0;0;.00nan;0;0
5533;149969;639;92;18;0;18;1.000;3600000;0
5537;169552;1836;56;39;5;34;.872;3600000;0
5537;87603;628;99;42;1;41;.976;3600000;0
5537;148956;1836;0;0;0;0;.00nan;0;0
5537;161336;628;0;0;0;0;.00nan;0;0
5539;182872;636;20;19;5;14;.737;3534000;0
5539;190508;626;0;0;0;0;.00nan;0;0
5539;181431;636;0;0;0;0;.00nan;0;0
5539;145079;626;77;41;3;38;.927;3600000;0
5541;17625;644;49;24;3;21;.875;3900000;0
5541;22684;632;0;0;0;0;.00nan;0;0
5541;197595;632;81;41;3;38;.927;3900000;0
5541;86099;644;0;0;0;0;.00nan;0;0
5545;11068;641;0;0;0;0;.00nan;0;0
5545;206235;639;0;0;0;0;.00nan;0;0
5545;-1;641;46;20;3;17;.850;3595000;0
5545;149969;639;61;17;1;16;.941;3600000;0
5549;206235;639;0;0;0;0;.00nan;0;0
5549;190508;626;69;23;1;22;.957;3600000;0
5549;145079;626;0;0;0;0;.00nan;0;0
5549;149969;639;52;37;5;32;.865;3600000;0
5551;182872;636;0;0;0;0;.00nan;0;0
5551;174209;631;0;0;0;0;.00nan;0;0
5551;181431;636;100;37;0;37;1.000;3600000;0
5551;-1;631;57;29;4;25;.862;3600000;0
5557;11068;641;92;39;2;37;.949;3670000;0
5557;-1;641;0;0;0;0;.00nan;0;0
5557;-1;642;0;0;0;0;.00nan;0;0
5557;151728;642;84;30;1;29;.967;3670000;0
5559;17625;644;0;0;0;0;.00nan;0;0
5559;-1;637;77;31;2;29;.935;3600000;0
5559;73274;637;0;0;0;0;.00nan;0;0
5559;86099;644;42;25;4;21;.840;3566000;0
5561;169552;1836;0;0;0;0;.00nan;0;0
5561;87603;628;73;23;2;21;.913;3600000;0
5561;148956;1836;74;38;4;34;.895;3600000;0
5561;161336;628;0;0;0;0;.00nan;0;0
5563;11068;641;0;0;0;0;.00nan;0;0
5563;-1;641;64;28;2;26;.929;3600000;0
5563;-1;642;82;44;3;41;.932;3553000;0
5563;151728;642;0;0;0;0;.00nan;0;0
5565;174209;631;69;32;3;29;.906;3600000;0
5565;206235;639;58;29;4;25;.862;3545000;0
5565;-1;631;0;0;0;0;.00nan;0;0
5565;149969;639;0;0;0;0;.00nan;0;0
5567;190508;626;0;0;0;0;.00nan;0;0
5567;87603;628;0;0;0;0;.00nan;0;0
5567;145079;626;84;48;4;44;.917;3564000;0
5567;161336;628;62;21;3;18;.857;3600000;0
5569;17625;644;100;32;0;32;1.000;3600000;0
5569;169552;1836;48;29;4;25;.862;3600000;0
5569;86099;644;0;0;0;0;.00nan;0;0
5569;148956;1836;0;0;0;0;.00nan;0;0
5579;11068;641;0;0;0;0;.00nan;0;0
5579;22684;632;0;0;0;0;.00nan;0;0
5579;-1;641;62;41;5;36;.878;3600000;0
5579;197595;632;54;24;3;21;.875;3600000;0
5581;174209;631;66;21;1;20;.952;3600000;0
5581;-1;642;0;0;0;0;.00nan;0;0
5581;-1;631;0;0;0;0;.00nan;0;0
5581;151728;642;78;37;4;33;.892;3600000;0
5585;-1;637;0;0;0;0;.00nan;0;0
5585;73274;637;84;47;4;43;.915;3600000;0
5585;87603;628;0;0;0;0;.00nan;0;0
5585;161336;628;97;22;0;22;1.000;3600000;0
5589;182872;636;0;0;0;0;.00nan;0;0
5589;169552;1836;0;0;0;0;.00nan;0;0
5589;181431;636;70;29;3;26;.897;3900000;0
5589;148956;1836;41;16;3;13;.813;3900000;0
1199;206235;639;0;0;0;0;.00nan;0;0
1199;-1;1814;0;0;0;0;.00nan;0;0
1199;67362;1814;97;42;2;40;.952;3566000;0
1199;149969;639;83;26;1;25;.962;3600000;0
1200;17625;644;0;0;0;0;.00nan;0;0
1200;174209;631;99;33;1;32;.970;3600000;0
1200;-1;631;0;0;0;0;.00nan;0;0
1200;86099;644;69;25;2;23;.920;3567000;0
1201;206235;639;0;0;0;0;.00nan;0;0
1201;-1;1814;0;0;0;0;.00nan;0;0
1201;67362;1814;73;24;2;22;.917;3600000;0
1201;149969;639;73;37;3;34;.919;3600000;0
1202;17625;644;0;0;0;0;.00nan;0;0
1202;174209;631;58;26;3;23;.885;3600000;0
1202;-1;631;0;0;0;0;.00nan;0;0
1202;86099;644;53;35;6;29;.829;3600000;0
1316;206235;639;0;0;0;0;.00nan;0;0
1316;-1;1814;0;0;0;0;.00nan;0;0
1316;67362;1814;79;31;1;30;.968;4182000;0
1316;149969;639;91;33;2;31;.939;4182000;0
1408;186641;625;74;27;2;25;.926;3600000;0
1408;-1;625;0;0;0;0;.00nan;0;0
1408;-1;1814;0;0;0;0;.00nan;0;0
1408;67362;1814;79;37;3;34;.919;3600000;0
1409;169552;1836;0;0;0;0;.00nan;0;0
1409;211484;627;0;0;0;0;.00nan;0;0
1409;176963;627;88;38;2;36;.947;3585000;0
1409;148956;1836;100;30;0;30;1.000;3600000;0
1410;190508;626;28;38;8;30;.789;2827000;0
1410;145079;626;60;8;0;8;1.000;773000;0
1410;147945;628;58;23;2;21;.913;3600000;0
1410;161336;628;0;0;0;0;.00nan;0;0
1411;182872;636;0;0;0;0;.00nan;0;0
1411;174209;631;86;32;2;30;.938;3600000;0
1411;181431;636;66;31;3;28;.903;3600000;0
1411;-1;631;0;0;0;0;.00nan;0;0
1412;186641;625;78;26;2;24;.923;3600000;0
1412;-1;625;0;0;0;0;.00nan;0;0
1412;-1;1814;0;0;0;0;.00nan;0;0
1412;67362;1814;71;42;5;37;.881;3600000;0
1413;169552;1836;0;0;0;0;.00nan;0;0
1413;211484;627;0;0;0;0;.00nan;0;0
1413;176963;627;49;31;5;26;.839;4168000;0
1413;148956;1836;74;41;4;37;.902;4168000;0
1414;190508;626;96;34;1;33;.971;3600000;0
1414;145079;626;0;0;0;0;.00nan;0;0
1414;147945;628;65;23;2;21;.913;3600000;0
1414;161336;628;0;0;0;0;.00nan;0;0
1415;182872;636;0;0;0;0;.00nan;0;0
1415;174209;631;82;29;1;28;.966;3600000;0
1415;181431;636;37;29;5;24;.828;3600000;0
1415;-1;631;0;0;0;0;.00nan;0;0
1416;186641;625;68;27;2;25;.926;4427000;0
1416;-1;625;0;0;0;0;.00nan;0;0
1416;-1;1814;0;0;0;0;.00nan;0;0
1416;67362;1814;93;46;3;43;.935;4427000;0
1417;169552;1836;0;0;0;0;.00nan;0;0
1417;211484;627;0;0;0;0;.00nan;0;0
1417;176963;627;78;36;3;33;.917;3600000;0
1417;148956;1836;53;33;5;28;.848;3536000;0
1418;190508;626;75;39;4;35;.897;3600000;0
1418;145079;626;0;0;0;0;.00nan;0;0
1418;147945;628;87;26;1;25;.962;3600000;0
1418;161336;628;0;0;0;0;.00nan;0;0
1419;182872;636;0;0;0;0;.00nan;0;0
1419;174209;631;60;17;2;15;.882;3600000;0
1419;181431;636;78;40;4;36;.900;3567000;0
1419;-1;631;0;0;0;0;.00nan;0;0
1420;186641;625;81;40;4;36;.900;4167000;0
1420;-1;625;0;0;0;0;.00nan;0;0
1420;-1;1814;0;0;0;0;.00nan;0;0
1420;67362;1814;89;43;3;40;.930;4167000;0
1421;169552;1836;0;0;0;0;.00nan;0;0
1421;211484;627;0;0;0;0;.00nan;0;0
1421;176963;627;73;31;2;29;.935;3805000;0
1421;148956;1836;83;42;3;39;.929;3850000;0
1422;190508;626;99;44;1;43;.977;3600000;0
1422;145079;626;0;0;0;0;.00nan;0;0
1422;147945;628;73;26;2;24;.923;3550000;0
1422;161336;628;0;0;0;0;.00nan;0;0
1423;182872;636;0;0;0;0;.00nan;0;0
1423;174209;631;86;35;1;34;.971;3553000;0
1423;181431;636;100;26;0;26;1.000;3600000;0
1423;-1;631;0;0;0;0;.00nan;0;0
1633;186641;625;75;23;1;22;.957;3600000;0
1633;-1;625;0;0;0;0;.00nan;0;0
1633;-1;1814;0;0;0;0;.00nan;0;0
1633;67362;1814;58;30;4;26;.867;3600000;0
1634;169552;1836;0;0;0;0;.00nan;0;0
1634;211484;627;0;0;0;0;.00nan;0;0
1634;176963;627;85;44;3;41;.932;3923000;0
1634;148956;1836;85;35;2;33;.943;3923000;0
1635;190508;626;67;32;3;29;.906;3600000;0
1635;145079;626;0;0;0;0;.00nan;0;0
1635;147945;628;95;18;0;18;1.000;3600000;0
1635;161336;628;0;0;0;0;.00nan;0;0
1636;182872;636;0;0;0;0;.00nan;0;0
1636;174209;631;100;24;0;24;1.000;3600000;0
1636;181431;636;51;27;4;23;.852;3600000;0
1636;-1;631;0;0;0;0;.00nan;0;0
1783;169552;1836;0;0;0;0;.00nan;0;0
1783;211484;627;0;0;0;0;.00nan;0;0
1783;176963;627;85;44;3;41;.932;3600000;0
1783;148956;1836;75;26;2;24;.923;3600000;0
1784;190508;626;67;43;5;38;.884;3600000;0
1784;145079;626;0;0;0;0;.00nan;0;0
1784;147945;628;100;29;0;29;1.000;3600000;0
1784;161336;628;0;0;0;0;.00nan;0;0
1812;174209;631;67;55;6;49;.891;4351000;0
1812;186641;625;41;26;5;21;.808;4351000;0
1812;-1;625;0;0;0;0;.00nan;0;0
1812;-1;631;0;0;0;0;.00nan;0;0
1813;169552;1836;0;0;0;0;.00nan;0;0
1813;147945;628;56;32;5;27;.844;3600000;0
1813;148956;1836;97;31;1;30;.968;3600000;0
1813;161336;628;0;0;0;0;.00nan;0;0
1814;174209;631;31;23;5;18;.783;1164000;0
1814;186641;625;65;18;2;16;.889;3600000;0
1814;-1;625;0;0;0;0;.00nan;0;0
1814;-1;631;73;25;1;24;.960;2436000;0
1815;169552;1836;0;0;0;0;.00nan;0;0
1815;147945;628;74;41;4;37;.902;4033000;0
1815;148956;1836;65;36;3;33;.917;4068000;0
1815;161336;628;0;0;0;0;.00nan;0;0
1816;174209;631;0;0;0;0;.00nan;0;0
1816;186641;625;81;26;2;24;.923;3600000;0
1816;-1;625;0;0;0;0;.00nan;0;0
1816;-1;631;65;42;5;37;.881;3600000;0
1817;169552;1836;0;0;0;0;.00nan;0;0
1817;147945;628;73;24;2;22;.917;3600000;0
1817;148956;1836;79;40;3;37;.925;3543000;0
1817;161336;628;0;0;0;0;.00nan;0;0
1818;174209;631;0;0;0;0;.00nan;0;0
1818;186641;625;41;22;4;18;.818;3545000;0
1818;-1;625;0;0;0;0;.00nan;0;0
1818;-1;631;69;27;2;25;.926;3600000;0
1819;169552;1836;0;0;0;0;.00nan;0;0
1819;147945;628;100;45;2;43;.956;3600000;0
1819;148956;1836;57;36;5;31;.861;3600000;0
1819;161336;628;0;0;0;0;.00nan;0;0
1995;174209;631;0;0;0;0;.00nan;0;0
1995;186641;625;83;30;2;28;.933;3555000;0
1995;-1;625;0;0;0;0;.00nan;0;0
1995;-1;631;100;29;0;29;1.000;3600000;0
1996;169552;1836;0;0;0;0;.00nan;0;0
1996;147945;628;77;37;4;33;.892;4602000;0
1996;148956;1836;100;63;3;60;.952;4602000;0
1996;161336;628;0;0;0;0;.00nan;0;0
2060;174209;631;0;0;0;0;.00nan;0;0
2060;186641;625;49;11;2;9;.818;3600000;0
2060;-1;625;0;0;0;0;.00nan;0;0
2060;-1;631;84;48;4;44;.917;3600000;0
2061;169552;1836;0;0;0;0;.00nan;0;0
2061;147945;628;88;37;2;35;.946;3580000;0
2061;148956;1836;83;25;1;24;.960;3600000;0
2061;161336;628;0;0;0;0;.00nan;0;0
2141;169552;1836;0;0;0;0;.00nan;0;0
2141;186641;625;83;35;3;32;.914;3616000;0
2141;-1;625;0;0;0;0;.00nan;0;0
2141;148956;1836;77;32;4;28;.875;3616000;0
2142;169552;1836;82;31;2;29;.935;2764000;0
2142;186641;625;59;24;3;21;.875;3600000;0
2142;-1;625;0;0;0;0;.00nan;0;0
2142;148956;1836;16;8;4;4;.500;836000;0
2143;169552;1836;0;0;0;0;.00nan;0;0
2143;186641;625;56;30;4;26;.867;4140000;0
2143;-1;625;0;0;0;0;.00nan;0;0
2143;148956;1836;87;40;3;37;.925;4140000;0
2144;169552;1836;40;2;1;1;.500;358000;0
2144;186641;625;54;29;4;25;.862;3600000;0
2144;-1;625;0;0;0;0;.00nan;0;0
2144;148956;1836;44;37;6;31;.838;3242000;0
2387;169552;1836;0;0;0;0;.00nan;0;0
2387;186641;625;65;28;3;25;.893;4396000;0
2387;-1;625;0;0;0;0;.00nan;0;0
2387;148956;1836;73;40;2;38;.950;4396000;0
2436;169552;1836;0;0;0;0;.00nan;0;0
2436;186641;625;77;39;4;35;.897;3600000;0
2436;-1;625;0;0;0;0;.00nan;0;0
2436;148956;1836;43;33;5;28;.848;3563000;0
5590;193985;830;0;0;0;0;.00nan;0;0
5590;16838;830;82;30;2;28;.933;3600000;0
5590;26336;829;43;25;4;21;.840;3567000;0
5590;-1;829;0;0;0;0;.00nan;0;0
5591;173073;847;0;0;0;0;.00nan;0;0
5591;-1;847;100;48;1;47;.979;3600000;0
5591;53867;828;67;26;2;24;.923;3554000;0
5591;68390;828;0;0;0;0;.00nan;0;0
5592;183545;842;98;39;1;38;.974;3569000;0
5592;26336;829;90;25;0;25;1.000;3600000;0
5592;180279;842;0;0;0;0;.00nan;0;0
5592;-1;829;0;0;0;0;.00nan;0;0
5593;167824;839;74;23;1;22;.957;3600000;0
5593;193985;830;52;10;1;9;.900;1168000;0
5593;16838;830;43;39;6;33;.846;2432000;0
5593;148041;839;0;0;0;0;.00nan;0;0
5594;-1;833;0;0;0;0;.00nan;0;0
5594;180287;833;85;33;3;30;.909;3900000;0
5594;89190;832;91;48;3;45;.938;3900000;0
5594;147901;832;0;0;0;0;.00nan;0;0
5595;13373;837;0;0;0;0;.00nan;0;0
5595;-1;836;0;0;0;0;.00nan;0;0
5595;180929;837;67;35;4;31;.886;3600000;0
5595;-1;836;40;29;5;24;.828;3573000;0
5596;5565;834;0;0;0;0;.00nan;0;0
5596;165582;848;75;29;2;27;.931;3600000;0
5596;23433;848;0;0;0;0;.00nan;0;0
5596;67287;834;71;36;4;32;.889;3587000;0
5597;2410;838;0;0;0;0;.00nan;0;0
5597;174334;838;51;47;7;40;.851;3600000;0
5597;185506;831;48;26;4;22;.846;3600000;0
5597;89874;831;0;0;0;0;.00nan;0;0
5598;167824;839;65;30;3;27;.900;3600000;0
5598;185506;831;56;36;4;32;.889;3600000;0
5598;89874;831;0;0;0;0;.00nan;0;0
5598;148041;839;0;0;0;0;.00nan;0;0
5599;13373;837;0;0;0;0;.00nan;0;0
5599;165582;848;48;28;4;24;.857;3544000;0
5599;23433;848;0;0;0;0;.00nan;0;0
5599;180929;837;81;28;2;26;.929;3600000;0
5600;5565;834;0;0;0;0;.00nan;0;0
5600;173073;847;0;0;0;0;.00nan;0;0
5600;-1;847;99;56;3;53;.946;3600000;0
5600;67287;834;41;25;4;21;.840;3556000;0
5601;193985;830;0;0;0;0;.00nan;0;0
5601;16838;830;56;45;6;39;.867;3600000;0
5601;-1;836;54;23;3;20;.870;3600000;0
5601;-1;836;0;0;0;0;.00nan;0;0
5602;26336;829;47;36;5;31;.861;3565000;0
5602;-1;829;0;0;0;0;.00nan;0;0
5602;89190;832;0;0;0;0;.00nan;0;0
5602;147901;832;47;25;4;21;.840;3600000;0
5603;2410;838;0;0;0;0;.00nan;0;0
5603;174334;838;99;57;1;56;.982;3600000;0
5603;-1;833;0;0;0;0;.00nan;0;0
5603;180287;833;34;20;4;16;.800;3600000;0
5604;183545;842;30;25;5;20;.800;3600000;0
5604;180279;842;0;0;0;0;.00nan;0;0
5604;53867;828;0;0;0;0;.00nan;0;0
5604;68390;828;78;33;2;31;.939;3600000;0
5605;193985;830;0;0;0;0;.00nan;0;0
5605;173073;847;73;35;3;32;.914;3570000;0
5605;16838;830;92;38;2;36;.947;3600000;0
5605;-1;847;0;0;0;0;.00nan;0;0
5606;5565;834;0;0;0;0;.00nan;0;0
5606;183545;842;77;30;2;28;.933;3900000;0
5606;180279;842;0;0;0;0;.00nan;0;0
5606;67287;834;75;27;2;25;.926;3900000;0
5607;167824;839;78;43;3;40;.930;3582000;0
5607;89190;832;0;0;0;0;.00nan;0;0
5607;147901;832;90;28;1;27;.964;3600000;0
5607;148041;839;0;0;0;0;.00nan;0;0
5608;26336;829;54;41;6;35;.854;3600000;0
5608;-1;833;0;0;0;0;.00nan;0;0
5608;180287;833;59;20;2;18;.900;3600000;0
5608;-1;829;0;0;0;0;.00nan;0;0
5609;-1;836;80;36;3;33;.917;3599000;0
5609;185506;831;90;39;2;37;.949;3600000;0
5609;-1;836;0;0;0;0;.00nan;0;0
5609;89874;831;0;0;0;0;.00nan;0;0
5610;165582;848;65;29;3;26;.897;3555000;0
5610;23433;848;0;0;0;0;.00nan;0;0
5610;53867;828;0;0;0;0;.00nan;0;0
5610;68390;828;100;31;1;30;.968;3600000;0
5611;2410;838;60;49;6;43;.878;3600000;0
5611;13373;837;0;0;0;0;.00nan;0;0
5611;174334;838;0;0;0;0;.00nan;0;0
5611;180929;837;100;23;0;23;1.000;3600000;0
5612;13373;837;0;0;0;0;.00nan;0;0
5612;180929;837;29;13;4;9;.692;3793000;0
5612;185506;831;0;0;0;0;.00nan;0;0
5612;89874;831;75;46;5;41;.891;3793000;0
5613;173073;847;0;0;0;0;.00nan;0;0
5613;165582;848;82;25;2;23;.920;3843000;0
5613;23433;848;0;0;0;0;.00nan;0;0
5613;-1;847;93;40;2;38;.950;3900000;0
5614;183545;842;0;0;0;0;.00nan;0;0
5614;180279;842;100;40;0;40;1.000;3600000;0
5614;89190;832;0;0;0;0;.00nan;0;0
5614;147901;832;44;22;4;18;.818;3600000;0
5615;167824;839;0;0;0;0;.00nan;0;0
5615;53867;828;0;0;0;0;.00nan;0;0
5615;68390;828;99;38;1;37;.974;3600000;0
5615;148041;839;53;44;6;38;.864;3600000;0
5616;5565;834;0;0;0;0;.00nan;0;0
5616;26336;829;68;32;3;29;.906;3578000;0
5616;-1;829;0;0;0;0;.00nan;0;0
5616;67287;834;69;26;2;24;.923;3600000;0
5617;193985;830;0;0;0;0;.00nan;0;0
5617;16838;830;73;43;4;39;.907;3600000;0
5617;-1;833;0;0;0;0;.00nan;0;0
5617;180287;833;39;28;5;23;.821;3550000;0
5618;167824;839;53;40;6;34;.850;1982000;0
5618;13373;837;100;21;0;21;1.000;3600000;0
5618;180929;837;0;0;0;0;.00nan;0;0
5618;148041;839;45;20;3;17;.850;1618000;0
5619;173073;847;93;41;3;38;.927;3600000;0
5619;-1;847;0;0;0;0;.00nan;0;0
5619;89190;832;89;19;0;19;1.000;3600000;0
5619;147901;832;0;0;0;0;.00nan;0;0
5620;26336;829;86;16;0;16;1.000;3600000;0
5620;-1;836;0;0;0;0;.00nan;0;0
5620;-1;836;64;18;1;17;.944;3600000;0
5620;-1;829;0;0;0;0;.00nan;0;0
5621;5565;834;0;0;0;0;.00nan;0;0
5621;53867;828;91;34;1;33;.971;3600000;0
5621;67287;834;75;36;3;33;.917;3574000;0
5621;68390;828;0;0;0;0;.00nan;0;0
5622;-1;833;62;21;2;19;.905;3600000;0
5622;180287;833;0;0;0;0;.00nan;0;0
5622;185506;831;47;45;6;39;.867;2886000;0
5622;89874;831;51;3;0;3;1.000;714000;0
5623;183545;842;0;0;0;0;.00nan;0;0
5623;165582;848;0;0;0;0;.00nan;0;0
5623;23433;848;29;20;5;15;.750;3513000;0
5623;180279;842;78;45;3;42;.933;3600000;0
5624;2410;838;0;0;0;0;.00nan;0;0
5624;193985;830;0;0;0;0;.00nan;0;0
5624;16838;830;80;38;2;36;.947;3900000;0
5624;174334;838;78;27;2;25;.926;3900000;0
5625;2410;838;54;36;4;32;.889;3600000;0
5625;174334;838;0;0;0;0;.00nan;0;0
5625;-1;836;81;26;1;25;.962;3600000;0
5625;-1;836;0;0;0;0;.00nan;0;0
5626;173073;847;0;0;0;0;.00nan;0;0
5626;26336;829;75;39;3;36;.923;3589000;0
5626;-1;847;82;35;2;33;.943;3600000;0
5626;-1;829;0;0;0;0;.00nan;0;0
5627;2410;838;0;0;0;0;.00nan;0;0
5627;183545;842;69;17;1;16;.941;3600000;0
5627;174334;838;57;40;5;35;.875;3600000;0
5627;180279;842;0;0;0;0;.00nan;0;0
5628;167824;839;0;0;0;0;.00nan;0;0
5628;-1;833;0;0;0;0;.00nan;0;0
5628;180287;833;75;19;1;18;.947;3600000;0
5628;148041;839;37;46;7;39;.848;3600000;0
5629;5565;834;0;0;0;0;.00nan;0;0
5629;185506;831;96;39;1;38;.974;3900000;0
5629;67287;834;85;22;1;21;.955;3900000;0
5629;89874;831;0;0;0;0;.00nan;0;0
5630;193985;830;0;0;0;0;.00nan;0;0
5630;13373;837;80;26;1;25;.962;3900000;0
5630;16838;830;100;41;1;40;.976;3900000;0
5630;180929;837;0;0;0;0;.00nan;0;0
5631;53867;828;0;0;0;0;.00nan;0;0
5631;68390;828;76;20;1;19;.950;3600000;0
5631;89190;832;58;31;3;28;.903;3579000;0
5631;147901;832;0;0;0;0;.00nan;0;0
5632;165582;848;64;16;1;15;.938;3600000;0
5632;23433;848;0;0;0;0;.00nan;0;0
5632;-1;836;0;0;0;0;.00nan;0;0
5632;-1;836;81;37;2;35;.946;3566000;0
5633;2410;838;0;0;0;0;.00nan;0;0
5633;174334;838;91;31;1;30;.968;3600000;0
5633;26336;829;63;23;2;21;.913;3550000;0
5633;-1;829;0;0;0;0;.00nan;0;0
5634;183545;842;91;42;2;40;.952;3550000;0
5634;180279;842;0;0;0;0;.00nan;0;0
5634;185506;831;0;0;0;0;.00nan;0;0
5634;89874;831;82;23;1;22;.957;3600000;0
5635;13373;837;0;0;0;0;.00nan;0;0
5635;180929;837;61;20;2;18;.900;3600000;0
5635;89190;832;0;0;0;0;.00nan;0;0
5635;147901;832;85;52;4;48;.923;3568000;0
5636;193985;830;0;0;0;0;.00nan;0;0
5636;165582;848;89;20;0;20;1.000;3600000;0
5636;16838;830;95;37;2;35;.946;3549000;0
5636;23433;848;0;0;0;0;.00nan;0;0
5637;173073;847;61;33;4;29;.879;3569000;0
5637;-1;836;74;29;2;27;.931;3600000;0
5637;-1;836;0;0;0;0;.00nan;0;0
5637;-1;847;0;0;0;0;.00nan;0;0
5638;-1;833;0;0;0;0;.00nan;0;0
5638;180287;833;66;19;2;17;.895;3600000;0
5638;53867;828;0;0;0;0;.00nan;0;0
5638;68390;828;64;42;4;38;.905;3600000;0
5639;2410;838;72;49;4;45;.918;3600000;0
5639;5565;834;0;0;0;0;.00nan;0;0
5639;174334;838;0;0;0;0;.00nan;0;0
5639;67287;834;63;16;1;15;.938;3600000;0
5640;167824;839;83;26;1;25;.962;3600000;0
5640;173073;847;0;0;0;0;.00nan;0;0
5640;-1;847;67;37;3;34;.919;3600000;0
5640;148041;839;0;0;0;0;.00nan;0;0
5641;183545;842;0;0;0;0;.00nan;0;0
5641;13373;837;91;21;0;21;1.000;3600000;0
5641;180279;842;97;48;2;46;.958;3600000;0
5641;180929;837;0;0;0;0;.00nan;0;0
5642;5565;834;83;37;3;34;.919;3900000;0
5642;-1;836;0;0;0;0;.00nan;0;0
5642;-1;836;82;46;3;43;.935;3900000;0
5642;67287;834;0;0;0;0;.00nan;0;0
5643;193985;830;41;26;4;22;.846;2291000;0
5643;16838;830;24;7;3;4;.571;1309000;0
5643;89190;832;0;0;0;0;.00nan;0;0
5643;147901;832;100;36;1;35;.972;3600000;0
5644;185506;831;97;33;1;32;.970;3600000;0
5644;53867;828;77;34;3;31;.912;3514000;0
5644;68390;828;0;0;0;0;.00nan;0;0
5644;89874;831;0;0;0;0;.00nan;0;0
5645;167824;839;0;0;0;0;.00nan;0;0
5645;26336;829;61;19;2;17;.895;3600000;0
5645;-1;829;0;0;0;0;.00nan;0;0
5645;148041;839;59;37;4;33;.892;3542000;0
5646;165582;848;88;48;3;45;.938;3600000;0
5646;23433;848;0;0;0;0;.00nan;0;0
5646;-1;833;0;0;0;0;.00nan;0;0
5646;180287;833;40;22;5;17;.773;3529000;0
5647;185506;831;83;23;1;22;.957;3600000;0
5647;89190;832;37;44;8;36;.818;3600000;0
5647;89874;831;0;0;0;0;.00nan;0;0
5647;147901;832;0;0;0;0;.00nan;0;0
5648;13373;837;57;17;2;15;.882;3600000;0
5648;173073;847;0;0;0;0;.00nan;0;0
5648;180929;837;0;0;0;0;.00nan;0;0
5648;-1;847;58;50;6;44;.880;3600000;0
5649;167824;839;99;25;0;25;1.000;3600000;0
5649;183545;842;96;52;4;48;.923;3600000;0
5649;180279;842;0;0;0;0;.00nan;0;0
5649;148041;839;0;0;0;0;.00nan;0;0
5650;193985;830;0;0;0;0;.00nan;0;0
5650;16838;830;80;41;3;38;.927;3577000;0
5650;26336;829;0;0;0;0;.00nan;0;0
5650;-1;829;68;24;2;22;.917;3600000;0
5651;-1;836;67;36;3;33;.917;3871000;0
5651;-1;836;0;0;0;0;.00nan;0;0
5651;53867;828;0;0;0;0;.00nan;0;0
5651;68390;828;75;35;3;32;.914;3900000;0
5652;5565;834;0;0;0;0;.00nan;0;0
5652;-1;833;0;0;0;0;.00nan;0;0
5652;180287;833;46;30;4;26;.867;3543000;0
5652;67287;834;85;32;2;30;.938;3600000;0
5653;2410;838;0;0;0;0;.00nan;0;0
5653;165582;848;30;15;4;11;.733;3600000;0
5653;23433;848;0;0;0;0;.00nan;0;0
5653;174334;838;46;48;7;41;.854;3540000;0
5654;193985;830;0;0;0;0;.00nan;0;0
5654;16838;830;80;45;4;41;.911;3600000;0
5654;185506;831;77;24;1;23;.958;3600000;0
5654;89874;831;0;0;0;0;.00nan;0;0
5655;183545;842;75;34;4;30;.882;3900000;0
5655;173073;847;0;0;0;0;.00nan;0;0
5655;180279;842;0;0;0;0;.00nan;0;0
5655;-1;847;85;38;4;34;.895;3900000;0
5656;5565;834;0;0;0;0;.00nan;0;0
5656;13373;837;0;0;0;0;.00nan;0;0
5656;180929;837;83;15;0;15;1.000;3600000;0
5656;67287;834;69;28;3;25;.893;3600000;0
5657;165582;848;75;22;1;21;.955;3600000;0
5657;23433;848;0;0;0;0;.00nan;0;0
5657;89190;832;0;0;0;0;.00nan;0;0
5657;147901;832;75;28;2;26;.929;3551000;0
5658;26336;829;55;30;4;26;.867;3542000;0
5658;-1;829;0;0;0;0;.00nan;0;0
5658;53867;828;0;0;0;0;.00nan;0;0
5658;68390;828;94;43;2;41;.953;3600000;0
5659;-1;836;83;42;4;38;.905;3546000;0
5659;-1;833;0;0;0;0;.00nan;0;0
5659;180287;833;66;32;3;29;.906;3600000;0
5659;-1;836;0;0;0;0;.00nan;0;0
5660;167824;839;93;35;2;33;.943;3900000;0
5660;-1;836;98;45;2;43;.956;3900000;0
5660;-1;836;0;0;0;0;.00nan;0;0
5660;148041;839;0;0;0;0;.00nan;0;0
5661;5565;834;68;22;2;20;.909;3600000;0
5661;67287;834;0;0;0;0;.00nan;0;0
5661;89190;832;70;39;3;36;.923;3548000;0
5661;147901;832;0;0;0;0;.00nan;0;0
5662;193985;830;59;34;3;31;.912;3542000;0
5662;183545;842;0;0;0;0;.00nan;0;0
5662;16838;830;0;0;0;0;.00nan;0;0
5662;180279;842;90;40;2;38;.950;3600000;0
5663;2410;838;94;41;2;39;.951;3554000;0
5663;174334;838;0;0;0;0;.00nan;0;0
5663;53867;828;64;18;1;17;.944;3600000;0
5663;68390;828;0;0;0;0;.00nan;0;0
5664;13373;837;0;0;0;0;.00nan;0;0
5664;-1;833;0;0;0;0;.00nan;0;0
5664;180287;833;97;44;2;42;.955;3585000;0
5664;180929;837;74;24;1;23;.958;3600000;0
5665;165582;848;0;0;0;0;.00nan;0;0
5665;23433;848;32;20;4;16;.800;3600000;0
5665;26336;829;99;37;1;36;.973;3600000;0
5665;-1;829;0;0;0;0;.00nan;0;0
5666;2410;838;0;0;0;0;.00nan;0;0
5666;167824;839;0;0;0;0;.00nan;0;0
5666;174334;838;88;62;4;58;.935;3560000;0
5666;148041;839;64;18;2;16;.889;3600000;0
5667;26336;829;67;26;2;24;.923;3600000;0
5667;185506;831;47;28;5;23;.821;3600000;0
5667;-1;829;0;0;0;0;.00nan;0;0
5667;89874;831;0;0;0;0;.00nan;0;0
5668;13373;837;0;0;0;0;.00nan;0;0
5668;180929;837;56;26;3;23;.885;3600000;0
5668;53867;828;0;0;0;0;.00nan;0;0
5668;68390;828;55;41;5;36;.878;3600000;0
5669;5565;834;0;0;0;0;.00nan;0;0
5669;193985;830;58;14;1;13;.929;1606000;0
5669;16838;830;28;22;6;16;.727;1994000;0
5669;67287;834;92;23;0;23;1.000;3600000;0
5670;183545;842;55;40;5;35;.875;3763000;0
5670;-1;836;0;0;0;0;.00nan;0;0
5670;180279;842;0;0;0;0;.00nan;0;0
5670;-1;836;58;27;4;23;.852;3763000;0
5671;2410;838;0;0;0;0;.00nan;0;0
5671;174334;838;89;38;2;36;.947;3600000;0
5671;89190;832;0;0;0;0;.00nan;0;0
5671;147901;832;54;20;3;17;.850;3568000;0
5672;2410;838;68;47;5;42;.894;3600000;0
5672;173073;847;0;0;0;0;.00nan;0;0
5672;174334;838;0;0;0;0;.00nan;0;0
5672;-1;847;52;15;2;13;.867;3600000;0
5673;183545;842;0;0;0;0;.00nan;0;0
5673;-1;833;0;0;0;0;.00nan;0;0
5673;180279;842;87;49;4;45;.918;3513000;0
5673;180287;833;66;23;2;21;.913;3600000;0
5674;5565;834;0;0;0;0;.00nan;0;0
5674;167824;839;93;28;1;27;.964;3600000;0
5674;67287;834;78;30;2;28;.933;3549000;0
5674;148041;839;0;0;0;0;.00nan;0;0
5675;-1;836;85;34;3;31;.912;3900000;0
5675;-1;836;0;0;0;0;.00nan;0;0
5675;89190;832;72;37;3;34;.919;3900000;0
5675;147901;832;0;0;0;0;.00nan;0;0
5676;193985;830;0;0;0;0;.00nan;0;0
5676;16838;830;97;51;2;49;.961;3900000;0
5676;53867;828;79;29;2;27;.931;3900000;0
5676;68390;828;0;0;0;0;.00nan;0;0
5677;165582;848;35;20;4;16;.800;3516000;0
5677;23433;848;0;0;0;0;.00nan;0;0
5677;185506;831;0;0;0;0;.00nan;0;0
5677;89874;831;74;26;2;24;.923;3600000;0
5678;167824;839;100;39;1;38;.974;3900000;0
5678;165582;848;61;15;1;14;.933;3900000;0
5678;23433;848;0;0;0;0;.00nan;0;0
5678;148041;839;0;0;0;0;.00nan;0;0
5679;173073;847;0;0;0;0;.00nan;0;0
5679;-1;833;0;0;0;0;.00nan;0;0
5679;180287;833;76;25;2;23;.920;3600000;0
5679;-1;847;82;57;4;53;.930;3530000;0
5680;183545;842;99;46;1;45;.978;3600000;0
5680;180279;842;0;0;0;0;.00nan;0;0
5680;89190;832;0;0;0;0;.00nan;0;0
5680;147901;832;40;21;4;17;.810;3600000;0
5681;2410;838;64;12;0;12;1.000;684000;0
5681;174334;838;42;39;6;33;.846;2916000;0
5681;185506;831;70;20;1;19;.950;3600000;0
5681;89874;831;0;0;0;0;.00nan;0;0
5682;13373;837;0;0;0;0;.00nan;0;0
5682;-1;836;55;26;3;23;.885;3572000;0
5682;180929;837;69;26;2;24;.923;3600000;0
5682;-1;836;0;0;0;0;.00nan;0;0
5683;5565;834;0;0;0;0;.00nan;0;0
5683;165582;848;89;32;2;30;.938;3600000;0
5683;23433;848;0;0;0;0;.00nan;0;0
5683;67287;834;47;40;6;34;.850;3600000;0
5684;167824;839;70;18;2;16;.889;3900000;0
5684;193985;830;0;0;0;0;.00nan;0;0
5684;16838;830;78;31;2;29;.935;3900000;0
5684;148041;839;0;0;0;0;.00nan;0;0
5685;173073;847;0;0;0;0;.00nan;0;0
5685;-1;847;85;43;3;40;.930;3600000;0
5685;53867;828;0;0;0;0;.00nan;0;0
5685;68390;828;100;25;0;25;1.000;3600000;0
5686;-1;833;72;16;0;16;1.000;3070000;0
5686;180287;833;15;6;4;2;.333;830000;0
5686;89190;832;0;0;0;0;.00nan;0;0
5686;147901;832;89;47;4;43;.915;3900000;0
5687;5565;834;47;25;4;21;.840;3545000;0
5687;173073;847;96;49;3;46;.939;3600000;0
5687;-1;847;0;0;0;0;.00nan;0;0
5687;67287;834;0;0;0;0;.00nan;0;0
5688;183545;842;0;0;0;0;.00nan;0;0
5688;180279;842;82;44;3;41;.932;3516000;0
5688;53867;828;0;0;0;0;.00nan;0;0
5688;68390;828;69;18;1;17;.944;3600000;0
5689;167824;839;0;0;0;0;.00nan;0;0
5689;185506;831;0;0;0;0;.00nan;0;0
5689;89874;831;99;35;1;34;.971;3600000;0
5689;148041;839;46;24;4;20;.833;3600000;0
5690;26336;829;66;32;3;29;.906;3556000;0
5690;-1;829;0;0;0;0;.00nan;0;0
5690;89190;832;80;31;2;29;.935;3600000;0
5690;147901;832;0;0;0;0;.00nan;0;0
5691;13373;837;77;27;1;26;.963;3600000;0
5691;165582;848;0;0;0;0;.00nan;0;0
5691;23433;848;61;33;3;30;.909;3533000;0
5691;180929;837;0;0;0;0;.00nan;0;0
5692;183545;842;69;32;3;29;.906;3545000;0
5692;26336;829;0;0;0;0;.00nan;0;0
5692;180279;842;0;0;0;0;.00nan;0;0
5692;-1;829;82;29;2;27;.931;3600000;0
5693;193985;830;0;0;0;0;.00nan;0;0
5693;16838;830;59;36;5;31;.861;3600000;0
5693;-1;836;0;0;0;0;.00nan;0;0
5693;-1;836;68;21;1;20;.952;3600000;0
5694;2410;838;52;39;6;33;.846;3012000;0
5694;174334;838;31;3;2;1;.333;588000;0
5694;-1;833;0;0;0;0;.00nan;0;0
5694;180287;833;53;19;3;16;.842;3600000;0
5695;-1;836;40;31;5;26;.839;3600000;0
5695;185506;831;66;25;2;23;.920;3600000;0
5695;-1;836;0;0;0;0;.00nan;0;0
5695;89874;831;0;0;0;0;.00nan;0;0
5696;2410;838;0;0;0;0;.00nan;0;0
5696;13373;837;0;0;0;0;.00nan;0;0
5696;174334;838;65;39;4;35;.897;3600000;0
5696;180929;837;69;17;1;16;.941;3600000;0
5697;167824;839;70;39;4;35;.897;3598000;0
5697;89190;832;0;0;0;0;.00nan;0;0
5697;147901;832;62;27;3;24;.889;3600000;0
5697;148041;839;0;0;0;0;.00nan;0;0
5698;5565;834;0;0;0;0;.00nan;0;0
5698;183545;842;60;9;0;9;1.000;613000;0
5698;180279;842;53;36;6;30;.833;2987000;0
5698;67287;834;60;18;2;16;.889;3600000;0
5699;193985;830;48;0;0;0;.00nan;334000;0
5699;173073;847;0;0;0;0;.00nan;0;0
5699;16838;830;44;37;6;31;.838;3266000;0
5699;-1;847;90;32;2;30;.938;3600000;0
5700;165582;848;59;34;4;30;.882;3572000;0
5700;23433;848;0;0;0;0;.00nan;0;0
5700;53867;828;0;0;0;0;.00nan;0;0
5700;68390;828;67;28;3;25;.893;3600000;0
5701;26336;829;53;37;5;32;.865;3600000;0
5701;-1;833;0;0;0;0;.00nan;0;0
5701;180287;833;91;23;0;23;1.000;3600000;0
5701;-1;829;0;0;0;0;.00nan;0;0
5702;13373;837;0;0;0;0;.00nan;0;0
5702;180929;837;58;30;5;25;.833;3600000;0
5702;185506;831;39;34;6;28;.824;2832000;0
5702;89874;831;57;12;1;11;.917;683000;0
5703;5565;834;0;0;0;0;.00nan;0;0
5703;26336;829;69;35;3;32;.914;3793000;0
5703;-1;829;0;0;0;0;.00nan;0;0
5703;67287;834;66;21;2;19;.905;3793000;0
5704;167824;839;77;26;1;25;.962;3600000;0
5704;53867;828;0;0;0;0;.00nan;0;0
5704;68390;828;57;26;3;23;.885;3600000;0
5704;148041;839;0;0;0;0;.00nan;0;0
5705;193985;830;0;0;0;0;.00nan;0;0
5705;16838;830;62;53;7;46;.868;3600000;0
5705;-1;833;0;0;0;0;.00nan;0;0
5705;180287;833;73;18;1;17;.944;3600000;0
5706;173073;847;0;0;0;0;.00nan;0;0
5706;165582;848;79;10;0;10;1.000;3600000;0
5706;23433;848;0;0;0;0;.00nan;0;0
5706;-1;847;84;60;5;55;.917;3600000;0
5707;2410;838;86;40;3;37;.925;3541000;0
5707;174334;838;0;0;0;0;.00nan;0;0
5707;-1;836;83;24;1;23;.958;3600000;0
5707;-1;836;0;0;0;0;.00nan;0;0
5708;173073;847;45;23;4;19;.826;3585000;0
5708;-1;847;0;0;0;0;.00nan;0;0
5708;89190;832;0;0;0;0;.00nan;0;0
5708;147901;832;61;30;3;27;.900;3600000;0
5709;183545;842;58;46;6;40;.870;3218000;0
5709;165582;848;0;0;0;0;.00nan;0;0
5709;23433;848;62;9;1;8;.889;3600000;0
5709;180279;842;52;3;0;3;1.000;382000;0
5710;167824;839;0;0;0;0;.00nan;0;0
5710;13373;837;80;23;1;22;.957;3600000;0
5710;180929;837;0;0;0;0;.00nan;0;0
5710;148041;839;51;27;4;23;.852;3583000;0
5711;5565;834;0;0;0;0;.00nan;0;0
5711;53867;828;0;0;0;0;.00nan;0;0
5711;67287;834;66;27;2;25;.926;3600000;0
5711;68390;828;95;35;1;34;.971;3600000;0
5712;2410;838;0;0;0;0;.00nan;0;0
5712;193985;830;64;30;3;27;.900;3553000;0
5712;16838;830;0;0;0;0;.00nan;0;0
5712;174334;838;91;37;2;35;.946;3600000;0
5713;26336;829;0;0;0;0;.00nan;0;0
5713;-1;836;0;0;0;0;.00nan;0;0
5713;-1;836;36;20;4;16;.800;3600000;0
5713;-1;829;88;34;1;33;.971;3600000;0
5714;5565;834;0;0;0;0;.00nan;0;0
5714;185506;831;0;0;0;0;.00nan;0;0
5714;67287;834;50;28;4;24;.857;3522000;0
5714;89874;831;82;34;2;32;.941;3600000;0
5715;193985;830;0;0;0;0;.00nan;0;0
5715;13373;837;0;0;0;0;.00nan;0;0
5715;16838;830;91;49;3;46;.939;3541000;0
5715;180929;837;67;24;2;22;.917;3600000;0
5716;53867;828;0;0;0;0;.00nan;0;0
5716;68390;828;69;26;2;24;.923;3600000;0
5716;89190;832;67;31;3;28;.903;3562000;0
5716;147901;832;0;0;0;0;.00nan;0;0
5717;173073;847;0;0;0;0;.00nan;0;0
5717;26336;829;100;26;0;26;1.000;3600000;0
5717;-1;847;65;23;2;21;.913;3572000;0
5717;-1;829;0;0;0;0;.00nan;0;0
5718;165582;848;13;20;6;14;.700;1927000;0
5718;23433;848;58;7;0;7;1.000;1647000;0
5718;-1;836;64;34;4;30;.882;3600000;0
5718;-1;836;0;0;0;0;.00nan;0;0
5719;2410;838;43;3;1;2;.667;331000;0
5719;183545;842;84;30;2;28;.933;3600000;0
5719;174334;838;47;44;6;38;.864;3269000;0
5719;180279;842;0;0;0;0;.00nan;0;0
5720;167824;839;85;50;4;46;.920;3551000;0
5720;-1;833;44;17;3;14;.824;3600000;0
5720;180287;833;0;0;0;0;.00nan;0;0
5720;148041;839;0;0;0;0;.00nan;0;0
5721;167824;839;0;0;0;0;.00nan;0;0
5721;26336;829;75;21;1;20;.952;3600000;0
5721;-1;829;0;0;0;0;.00nan;0;0
5721;148041;839;60;25;3;22;.880;3513000;0
5722;173073;847;0;0;0;0;.00nan;0;0
5722;-1;836;85;35;2;33;.943;3600000;0
5722;-1;836;0;0;0;0;.00nan;0;0
5722;-1;847;67;39;4;35;.897;3578000;0
5723;183545;842;0;0;0;0;.00nan;0;0
5723;180279;842;100;29;0;29;1.000;3600000;0
5723;185506;831;74;31;2;29;.935;3557000;0
5723;89874;831;0;0;0;0;.00nan;0;0
5724;2410;838;0;0;0;0;.00nan;0;0
5724;5565;834;0;0;0;0;.00nan;0;0
5724;174334;838;74;53;5;48;.906;3600000;0
5724;67287;834;95;22;0;22;1.000;3600000;0
5725;13373;837;0;0;0;0;.00nan;0;0
5725;180929;837;55;24;3;21;.875;3767000;0
5725;89190;832;0;0;0;0;.00nan;0;0
5725;147901;832;73;28;2;26;.929;3767000;0
5726;-1;833;0;0;0;0;.00nan;0;0
5726;180287;833;80;30;1;29;.967;3900000;0
5726;53867;828;92;26;1;25;.962;3900000;0
5726;68390;828;0;0;0;0;.00nan;0;0
5727;185506;831;0;0;0;0;.00nan;0;0
5727;53867;828;0;0;0;0;.00nan;0;0
5727;68390;828;45;20;3;17;.850;3600000;0
5727;89874;831;49;43;7;36;.837;3600000;0
5728;183545;842;0;0;0;0;.00nan;0;0
5728;13373;837;42;20;4;16;.800;3875000;0
5728;180279;842;68;32;3;29;.906;3875000;0
5728;180929;837;0;0;0;0;.00nan;0;0
5729;167824;839;87;24;1;23;.958;3600000;0
5729;173073;847;56;36;5;31;.861;3600000;0
5729;-1;847;0;0;0;0;.00nan;0;0
5729;148041;839;0;0;0;0;.00nan;0;0
5730;193985;830;0;0;0;0;.00nan;0;0
5730;16838;830;90;25;1;24;.960;3900000;0
5730;89190;832;84;25;1;24;.960;3900000;0
5730;147901;832;0;0;0;0;.00nan;0;0
5731;5565;834;0;0;0;0;.00nan;0;0
5731;-1;836;0;0;0;0;.00nan;0;0
5731;-1;836;80;42;3;39;.929;3600000;0
5731;67287;834;98;29;0;29;1.000;3600000;0
5732;165582;848;100;34;1;33;.971;3600000;0
5732;23433;848;0;0;0;0;.00nan;0;0
5732;-1;833;49;28;4;24;.857;3600000;0
5732;180287;833;0;0;0;0;.00nan;0;0
5733;2410;838;57;32;3;29;.906;3593000;0
5733;174334;838;0;0;0;0;.00nan;0;0
5733;26336;829;68;20;1;19;.950;3600000;0
5733;-1;829;0;0;0;0;.00nan;0;0
5734;193985;830;0;0;0;0;.00nan;0;0
5734;165582;848;58;21;3;18;.857;3600000;0
5734;16838;830;68;41;5;36;.878;3597000;0
5734;23433;848;0;0;0;0;.00nan;0;0
5735;183545;842;0;0;0;0;.00nan;0;0
5735;173073;847;0;0;0;0;.00nan;0;0
5735;180279;842;85;31;1;30;.968;3600000;0
5735;-1;847;73;30;2;28;.933;3600000;0
5736;5565;834;0;0;0;0;.00nan;0;0
5736;13373;837;0;0;0;0;.00nan;0;0
5736;180929;837;96;46;2;44;.957;3900000;0
5736;67287;834;90;35;2;33;.943;3900000;0
5737;193985;830;0;0;0;0;.00nan;0;0
5737;16838;830;76;34;2;32;.941;3600000;0
5737;185506;831;40;38;6;32;.842;3600000;0
5737;89874;831;0;0;0;0;.00nan;0;0
5738;26336;829;85;38;2;36;.947;3562000;0
5738;-1;829;0;0;0;0;.00nan;0;0
5738;53867;828;0;0;0;0;.00nan;0;0
5738;68390;828;67;18;1;17;.944;3600000;0
5739;-1;836;64;14;1;13;.929;1318000;0
5739;-1;833;0;0;0;0;.00nan;0;0
5739;180287;833;47;17;3;14;.824;3600000;0
5739;-1;836;28;32;7;25;.781;2282000;0
5740;165582;848;92;17;0;17;1.000;3600000;0
5740;23433;848;0;0;0;0;.00nan;0;0
5740;89190;832;0;0;0;0;.00nan;0;0
5740;147901;832;63;48;6;42;.875;3600000;0
5741;173073;847;78;36;3;33;.917;3600000;0
5741;185506;831;0;0;0;0;.00nan;0;0
5741;-1;847;0;0;0;0;.00nan;0;0
5741;89874;831;91;32;1;31;.969;3600000;0
5742;13373;837;0;0;0;0;.00nan;0;0
5742;-1;833;0;0;0;0;.00nan;0;0
5742;180287;833;62;27;3;24;.889;3900000;0
5742;180929;837;83;37;3;34;.919;3900000;0
5743;5565;834;0;0;0;0;.00nan;0;0
5743;67287;834;76;24;2;22;.917;3900000;0
5743;89190;832;60;29;2;27;.931;3900000;0
5743;147901;832;0;0;0;0;.00nan;0;0
5744;165582;848;93;21;0;21;1.000;3600000;0
5744;23433;848;0;0;0;0;.00nan;0;0
5744;26336;829;0;0;0;0;.00nan;0;0
5744;-1;829;75;37;3;34;.919;3600000;0
5745;167824;839;85;34;2;32;.941;3600000;0
5745;-1;836;65;37;5;32;.865;3600000;0
5745;-1;836;0;0;0;0;.00nan;0;0
5745;148041;839;0;0;0;0;.00nan;0;0
5746;2410;838;0;0;0;0;.00nan;0;0
5746;174334;838;84;30;2;28;.933;3600000;0
5746;53867;828;0;0;0;0;.00nan;0;0
5746;68390;828;84;33;3;30;.909;3600000;0
5747;193985;830;0;0;0;0;.00nan;0;0
5747;183545;842;85;38;2;36;.947;3552000;0
5747;16838;830;78;30;1;29;.967;3600000;0
5747;180279;842;0;0;0;0;.00nan;0;0
5748;2410;838;52;40;5;35;.875;3600000;0
5748;167824;839;0;0;0;0;.00nan;0;0
5748;174334;838;0;0;0;0;.00nan;0;0
5748;148041;839;48;23;4;19;.826;3600000;0
5749;193985;830;0;0;0;0;.00nan;0;0
5749;16838;830;58;40;5;35;.875;3600000;0
5749;26336;829;74;27;2;25;.926;3600000;0
5749;-1;829;0;0;0;0;.00nan;0;0
5750;-1;836;0;0;0;0;.00nan;0;0
5750;-1;836;100;34;0;34;1.000;3600000;0
5750;89190;832;0;0;0;0;.00nan;0;0
5750;147901;832;70;36;3;33;.917;3600000;0
5751;173073;847;0;0;0;0;.00nan;0;0
5751;-1;833;0;0;0;0;.00nan;0;0
5751;180287;833;74;21;1;20;.952;3600000;0
5751;-1;847;72;45;4;41;.911;3600000;0
5752;183545;842;0;0;0;0;.00nan;0;0
5752;-1;836;0;0;0;0;.00nan;0;0
5752;180279;842;100;39;0;39;1.000;3682000;0
5752;-1;836;92;26;1;25;.962;3682000;0
5753;5565;834;0;0;0;0;.00nan;0;0
5753;193985;830;0;0;0;0;.00nan;0;0
5753;16838;830;90;34;1;33;.971;3600000;0
5753;67287;834;76;29;2;27;.931;3600000;0
5754;2410;838;0;0;0;0;.00nan;0;0
5754;174334;838;69;39;4;35;.897;3566000;0
5754;89190;832;65;34;3;31;.912;3600000;0
5754;147901;832;0;0;0;0;.00nan;0;0
5755;13373;837;0;0;0;0;.00nan;0;0
5755;180929;837;66;32;3;29;.906;3600000;0
5755;53867;828;0;0;0;0;.00nan;0;0
5755;68390;828;73;36;4;32;.889;3565000;0
5756;167824;839;93;48;3;45;.938;3836000;0
5756;165582;848;68;25;2;23;.920;3836000;0
5756;23433;848;0;0;0;0;.00nan;0;0
5756;148041;839;0;0;0;0;.00nan;0;0
5757;165582;848;0;0;0;0;.00nan;0;0
5757;23433;848;46;27;4;23;.852;3600000;0
5757;185506;831;99;42;1;41;.976;3600000;0
5757;89874;831;0;0;0;0;.00nan;0;0
5758;13373;837;76;20;1;19;.950;3600000;0
5758;26336;829;45;29;4;25;.862;3600000;0
5758;180929;837;0;0;0;0;.00nan;0;0
5758;-1;829;0;0;0;0;.00nan;0;0
5759;5565;834;60;26;3;23;.885;3250000;0
5759;167824;839;40;2;1;1;.500;295000;0
5759;67287;834;34;11;3;8;.727;350000;0
5759;148041;839;36;32;6;26;.813;3245000;0
5760;193985;830;66;39;4;35;.897;3551000;0
5760;16838;830;0;0;0;0;.00nan;0;0
5760;53867;828;0;0;0;0;.00nan;0;0
5760;68390;828;72;28;2;26;.929;3600000;0
5761;183545;842;54;35;5;30;.857;3556000;0
5761;-1;833;44;18;3;15;.833;3600000;0
5761;180279;842;0;0;0;0;.00nan;0;0
5761;180287;833;0;0;0;0;.00nan;0;0
5762;2410;838;0;0;0;0;.00nan;0;0
5762;173073;847;66;32;3;29;.906;3600000;0
5762;174334;838;87;29;2;27;.931;3600000;0
5762;-1;847;0;0;0;0;.00nan;0;0
5763;26336;829;0;0;0;0;.00nan;0;0
5763;185506;831;0;0;0;0;.00nan;0;0
5763;-1;829;78;22;1;21;.955;3600000;0
5763;89874;831;80;42;3;39;.929;3546000;0
5764;13373;837;0;0;0;0;.00nan;0;0
5764;173073;847;0;0;0;0;.00nan;0;0
5764;180929;837;87;22;1;21;.955;3600000;0
5764;-1;847;69;41;4;37;.902;3600000;0
5765;167824;839;58;18;2;16;.889;3600000;0
5765;183545;842;0;0;0;0;.00nan;0;0
5765;180279;842;50;30;5;25;.833;3600000;0
5765;148041;839;0;0;0;0;.00nan;0;0
5766;5565;834;0;0;0;0;.00nan;0;0
5766;-1;833;0;0;0;0;.00nan;0;0
5766;180287;833;64;30;3;27;.900;3568000;0
5766;67287;834;87;29;1;28;.966;3600000;0
5767;26336;829;86;36;3;33;.917;3532000;0
5767;-1;829;0;0;0;0;.00nan;0;0
5767;89190;832;0;0;0;0;.00nan;0;0
5767;147901;832;79;26;1;25;.962;3600000;0
5768;-1;836;0;0;0;0;.00nan;0;0
5768;-1;836;64;23;2;21;.913;3600000;0
5768;53867;828;42;40;6;34;.850;2310000;0
5768;68390;828;62;9;0;9;1.000;1290000;0
5769;2410;838;0;0;0;0;.00nan;0;0
5769;165582;848;61;15;1;14;.933;3600000;0
5769;23433;848;0;0;0;0;.00nan;0;0
5769;174334;838;97;57;4;53;.930;3600000;0
5770;26336;829;81;32;2;30;.938;3600000;0
5770;185506;831;71;37;3;34;.919;3600000;0
5770;-1;829;0;0;0;0;.00nan;0;0
5770;89874;831;0;0;0;0;.00nan;0;0
5771;2410;838;0;0;0;0;.00nan;0;0
5771;13373;837;0;0;0;0;.00nan;0;0
5771;174334;838;69;39;4;35;.897;3600000;0
5771;180929;837;76;26;2;24;.923;3600000;0
5772;167824;839;80;19;1;18;.947;3600000;0
5772;183545;842;39;41;7;34;.829;2954000;0
5772;180279;842;51;10;1;9;.900;646000;0
5772;148041;839;0;0;0;0;.00nan;0;0
5773;173073;847;0;0;0;0;.00nan;0;0
5773;-1;836;0;0;0;0;.00nan;0;0
5773;-1;836;54;19;2;17;.895;3600000;0
5773;-1;847;87;56;4;52;.929;3600000;0
5774;193985;830;0;0;0;0;.00nan;0;0
5774;16838;830;73;26;2;24;.923;3600000;0
5774;53867;828;0;0;0;0;.00nan;0;0
5774;68390;828;57;30;3;27;.900;3549000;0
5775;-1;833;0;0;0;0;.00nan;0;0
5775;180287;833;61;20;2;18;.900;3600000;0
5775;89190;832;0;0;0;0;.00nan;0;0
5775;147901;832;64;32;4;28;.875;3574000;0
5776;5565;834;0;0;0;0;.00nan;0;0
5776;165582;848;100;34;1;33;.971;3600000;0
5776;23433;848;0;0;0;0;.00nan;0;0
5776;67287;834;76;40;3;37;.925;3573000;0
5777;173073;847;32;34;6;28;.824;2174000;0
5777;165582;848;71;21;1;20;.952;3600000;0
5777;23433;848;0;0;0;0;.00nan;0;0
5777;-1;847;47;6;1;5;.833;1426000;0
5778;183545;842;0;0;0;0;.00nan;0;0
5778;180279;842;91;38;2;36;.947;3600000;0
5778;53867;828;65;34;3;31;.912;3579000;0
5778;68390;828;0;0;0;0;.00nan;0;0
5779;5565;834;78;32;3;29;.906;3900000;0
5779;185506;831;76;36;3;33;.917;3900000;0
5779;67287;834;0;0;0;0;.00nan;0;0
5779;89874;831;0;0;0;0;.00nan;0;0
5780;13373;837;85;17;0;17;1.000;3600000;0
5780;180929;837;0;0;0;0;.00nan;0;0
5780;89190;832;0;0;0;0;.00nan;0;0
5780;147901;832;98;39;1;38;.974;3557000;0
5781;26336;829;74;27;2;25;.926;3600000;0
5781;-1;836;68;26;3;23;.885;3591000;0
5781;-1;836;0;0;0;0;.00nan;0;0
5781;-1;829;0;0;0;0;.00nan;0;0
5782;2410;838;97;47;2;45;.957;3558000;0
5782;174334;838;0;0;0;0;.00nan;0;0
5782;-1;833;0;0;0;0;.00nan;0;0
5782;180287;833;58;13;1;12;.923;3600000;0
5783;167824;839;98;22;0;22;1.000;3600000;0
5783;193985;830;0;0;0;0;.00nan;0;0
5783;16838;830;69;45;5;40;.889;3600000;0
5783;148041;839;0;0;0;0;.00nan;0;0
5784;173073;847;0;0;0;0;.00nan;0;0
5784;185506;831;0;0;0;0;.00nan;0;0
5784;-1;847;52;24;3;21;.875;3600000;0
5784;89874;831;56;43;6;37;.860;3600000;0
5785;183545;842;93;42;2;40;.952;3600000;0
5785;13373;837;67;19;1;18;.947;3600000;0
5785;180279;842;0;0;0;0;.00nan;0;0
5785;180929;837;0;0;0;0;.00nan;0;0
5786;26336;829;69;33;4;29;.879;3600000;0
5786;-1;829;0;0;0;0;.00nan;0;0
5786;53867;828;0;0;0;0;.00nan;0;0
5786;68390;828;48;31;5;26;.839;3571000;0
5787;2410;838;0;0;0;0;.00nan;0;0
5787;174334;838;83;36;3;33;.917;3900000;0
5787;-1;836;0;0;0;0;.00nan;0;0
5787;-1;836;66;29;3;26;.897;3900000;0
5788;5565;834;0;0;0;0;.00nan;0;0
5788;-1;833;0;0;0;0;.00nan;0;0
5788;180287;833;62;27;3;24;.889;3600000;0
5788;67287;834;66;46;5;41;.891;3554000;0
5789;173073;847;94;33;1;32;.970;3600000;0
5789;26336;829;65;35;3;32;.914;3543000;0
5789;-1;847;0;0;0;0;.00nan;0;0
5789;-1;829;0;0;0;0;.00nan;0;0
5790;183545;842;0;0;0;0;.00nan;0;0
5790;165582;848;100;25;0;25;1.000;3600000;0
5790;23433;848;0;0;0;0;.00nan;0;0
5790;180279;842;89;44;1;43;.977;3568000;0
5791;5565;834;0;0;0;0;.00nan;0;0
5791;167824;839;54;26;4;22;.846;3566000;0
5791;67287;834;86;38;3;35;.921;3600000;0
5791;148041;839;0;0;0;0;.00nan;0;0
5792;193985;830;0;0;0;0;.00nan;0;0
5792;13373;837;0;0;0;0;.00nan;0;0
5792;16838;830;89;40;2;38;.950;3585000;0
5792;180929;837;92;20;0;20;1.000;3600000;0
5793;-1;836;82;37;3;34;.919;3900000;0
5793;-1;836;0;0;0;0;.00nan;0;0
5793;89190;832;0;0;0;0;.00nan;0;0
5793;147901;832;64;31;3;28;.903;3900000;0
5794;-1;833;0;0;0;0;.00nan;0;0
5794;180287;833;72;31;3;28;.903;3600000;0
5794;53867;828;68;37;4;33;.892;3600000;0
5794;68390;828;0;0;0;0;.00nan;0;0
5795;2410;838;39;11;2;9;.818;1244000;0
5795;174334;838;36;31;5;26;.839;2356000;0
5795;185506;831;55;18;3;15;.833;3600000;0
5795;89874;831;0;0;0;0;.00nan;0;0
5796;167824;839;0;0;0;0;.00nan;0;0
5796;89190;832;34;25;5;20;.800;3600000;0
5796;147901;832;0;0;0;0;.00nan;0;0
5796;148041;839;71;26;2;24;.923;3600000;0
5797;193985;830;0;0;0;0;.00nan;0;0
5797;16838;830;99;39;1;38;.974;3600000;0
5797;185506;831;56;30;4;26;.867;3600000;0
5797;89874;831;0;0;0;0;.00nan;0;0
5798;13373;837;0;0;0;0;.00nan;0;0
5798;180929;837;100;26;0;26;1.000;3600000;0
5798;53867;828;0;0;0;0;.00nan;0;0
5798;68390;828;57;38;5;33;.868;3600000;0
5799;167824;839;84;26;1;25;.962;3600000;0
5799;173073;847;0;0;0;0;.00nan;0;0
5799;-1;847;60;27;3;24;.889;3518000;0
5799;148041;839;0;0;0;0;.00nan;0;0
5800;2410;838;0;0;0;0;.00nan;0;0
5800;174334;838;95;44;2;42;.955;3600000;0
5800;26336;829;47;23;4;19;.826;3563000;0
5800;-1;829;0;0;0;0;.00nan;0;0
5801;5565;834;0;0;0;0;.00nan;0;0
5801;-1;836;0;0;0;0;.00nan;0;0
5801;-1;836;85;42;3;39;.929;3600000;0
5801;67287;834;98;19;0;19;1.000;3600000;0
5802;183545;842;99;43;1;42;.977;3600000;0
5802;-1;833;0;0;0;0;.00nan;0;0
5802;180279;842;0;0;0;0;.00nan;0;0
5802;180287;833;48;20;4;16;.800;3600000;0
5803;165582;848;67;18;2;16;.889;3600000;0
5803;23433;848;0;0;0;0;.00nan;0;0
5803;89190;832;0;0;0;0;.00nan;0;0
5803;147901;832;93;41;3;38;.927;3600000;0
5804;173073;847;0;0;0;0;.00nan;0;0
5804;-1;833;0;0;0;0;.00nan;0;0
5804;180287;833;81;21;1;20;.952;3600000;0
5804;-1;847;54;27;4;23;.852;3600000;0
5805;183545;842;0;0;0;0;.00nan;0;0
5805;180279;842;59;20;2;18;.900;3600000;0
5805;185506;831;46;37;5;32;.865;3600000;0
5805;89874;831;0;0;0;0;.00nan;0;0
5806;167824;839;84;51;4;47;.922;3545000;0
5806;13373;837;0;0;0;0;.00nan;0;0
5806;180929;837;55;17;3;14;.824;3600000;0
5806;148041;839;0;0;0;0;.00nan;0;0
5807;193985;830;0;0;0;0;.00nan;0;0
5807;16838;830;46;30;5;25;.833;3600000;0
5807;-1;836;0;0;0;0;.00nan;0;0
5807;-1;836;72;23;1;22;.957;3600000;0
5808;26336;829;65;36;4;32;.889;3600000;0
5808;-1;829;0;0;0;0;.00nan;0;0
5808;89190;832;0;0;0;0;.00nan;0;0
5808;147901;832;86;25;1;24;.960;3600000;0
5809;5565;834;0;0;0;0;.00nan;0;0
5809;53867;828;0;0;0;0;.00nan;0;0
5809;67287;834;84;35;2;33;.943;3587000;0
5809;68390;828;93;37;1;36;.973;3600000;0
5810;2410;838;0;0;0;0;.00nan;0;0
5810;165582;848;55;19;2;17;.895;3600000;0
5810;23433;848;0;0;0;0;.00nan;0;0
5810;174334;838;61;41;5;36;.878;3600000;0
5811;13373;837;33;29;6;23;.793;3004000;0
5811;165582;848;82;43;4;39;.907;3600000;0
5811;23433;848;0;0;0;0;.00nan;0;0
5811;180929;837;53;3;0;3;1.000;580000;0
5812;5565;834;0;0;0;0;.00nan;0;0
5812;183545;842;93;41;2;39;.951;3580000;0
5812;180279;842;0;0;0;0;.00nan;0;0
5812;67287;834;100;26;0;26;1.000;3600000;0
5813;173073;847;0;0;0;0;.00nan;0;0
5813;-1;847;79;40;3;37;.925;3600000;0
5813;89190;832;0;0;0;0;.00nan;0;0
5813;147901;832;98;24;0;24;1.000;3600000;0
5814;-1;836;0;0;0;0;.00nan;0;0
5814;185506;831;89;52;3;49;.942;3600000;0
5814;-1;836;89;23;0;23;1.000;3600000;0
5814;89874;831;0;0;0;0;.00nan;0;0
5815;167824;839;88;33;1;32;.970;3600000;0
5815;53867;828;0;0;0;0;.00nan;0;0
5815;68390;828;78;31;3;28;.903;3542000;0
5815;148041;839;0;0;0;0;.00nan;0;0
5816;26336;829;64;32;3;29;.906;3563000;0
5816;-1;833;0;0;0;0;.00nan;0;0
5816;180287;833;82;23;1;22;.957;3600000;0
5816;-1;829;0;0;0;0;.00nan;0;0
5817;2410;838;0;0;0;0;.00nan;0;0
5817;193985;830;0;0;0;0;.00nan;0;0
5817;16838;830;48;31;4;27;.871;3600000;0
5817;174334;838;80;36;3;33;.917;3600000;0
5818;-1;833;0;0;0;0;.00nan;0;0
5818;180287;833;54;23;3;20;.870;3600000;0
5818;185506;831;0;0;0;0;.00nan;0;0
5818;89874;831;29;36;7;29;.806;3600000;0
5819;2410;838;0;0;0;0;.00nan;0;0
5819;173073;847;0;0;0;0;.00nan;0;0
5819;174334;838;63;41;5;36;.878;3533000;0
5819;-1;847;49;16;3;13;.813;3600000;0
5820;183545;842;0;0;0;0;.00nan;0;0
5820;180279;842;58;27;3;24;.889;3544000;0
5820;89190;832;0;0;0;0;.00nan;0;0
5820;147901;832;92;29;1;28;.966;3600000;0
5821;167824;839;0;0;0;0;.00nan;0;0
5821;-1;836;0;0;0;0;.00nan;0;0
5821;-1;836;92;39;2;37;.949;3567000;0
5821;148041;839;77;25;1;24;.960;3600000;0
5822;193985;830;0;0;0;0;.00nan;0;0
5822;16838;830;59;28;3;25;.893;3600000;0
5822;-1;834;0;0;0;0;.00nan;0;0
5822;67287;834;34;28;5;23;.821;3570000;0
5823;13373;837;0;0;0;0;.00nan;0;0
5823;26336;829;52;41;7;34;.829;2935000;0
5823;180929;837;71;29;3;26;.897;3600000;0
5823;68390;829;56;5;0;5;1.000;665000;0
5824;165582;848;61;25;2;23;.920;3600000;0
5824;23433;848;0;0;0;0;.00nan;0;0
5824;53867;828;73;35;4;31;.886;3514000;0
5824;147845;828;0;0;0;0;.00nan;0;0
5825;-1;836;51;2;0;2;1.000;458000;0
5825;-1;833;0;0;0;0;.00nan;0;0
5825;180287;833;66;30;3;27;.900;3600000;0
5825;-1;836;38;34;6;28;.824;3142000;0
5826;167824;839;85;44;3;41;.932;3650000;0
5826;165582;848;76;26;2;24;.923;3650000;0
5826;23433;848;0;0;0;0;.00nan;0;0
5826;148041;839;0;0;0;0;.00nan;0;0
5827;185506;831;0;0;0;0;.00nan;0;0
5827;89190;832;0;0;0;0;.00nan;0;0
5827;89874;831;39;31;5;26;.839;3600000;0
5827;147901;832;83;32;2;30;.938;3600000;0
5828;2410;838;0;0;0;0;.00nan;0;0
5828;183545;842;80;26;1;25;.962;3600000;0
5828;174334;838;79;46;3;43;.935;3600000;0
5828;180279;842;0;0;0;0;.00nan;0;0
5829;13373;837;0;0;0;0;.00nan;0;0
5829;180929;837;93;41;3;38;.927;3900000;0
5829;-1;834;0;0;0;0;.00nan;0;0
5829;67287;834;72;31;3;28;.903;3900000;0
5830;193985;830;25;13;4;9;.692;1110000;0
5830;16838;830;58;27;3;24;.889;2490000;0
5830;26336;829;0;0;0;0;.00nan;0;0
5830;68390;829;92;34;1;33;.971;3600000;0
5831;173073;847;0;0;0;0;.00nan;0;0
5831;-1;847;73;37;4;33;.892;3600000;0
5831;53867;828;23;6;3;3;.500;409000;0
5831;147845;828;42;19;3;16;.842;3150000;0
5832;13373;837;0;0;0;0;.00nan;0;0
5832;180929;837;93;29;1;28;.966;3600000;0
5832;185506;831;67;47;5;42;.894;3600000;0
5832;89874;831;0;0;0;0;.00nan;0;0
5833;167824;839;53;27;4;23;.852;3600000;0
5833;-1;833;0;0;0;0;.00nan;0;0
5833;180287;833;43;33;5;28;.848;3596000;0
5833;148041;839;0;0;0;0;.00nan;0;0
5834;193985;830;84;37;3;34;.919;3600000;0
5834;16838;830;0;0;0;0;.00nan;0;0
5834;89190;832;100;29;0;29;1.000;3600000;0
5834;147901;832;0;0;0;0;.00nan;0;0
5835;183545;842;0;0;0;0;.00nan;0;0
5835;173073;847;43;22;4;18;.818;3585000;0
5835;180279;842;68;24;2;22;.917;3600000;0
5835;-1;847;0;0;0;0;.00nan;0;0
5836;26336;829;0;0;0;0;.00nan;0;0
5836;-1;834;46;6;1;5;.833;723000;0
5836;67287;834;18;23;6;17;.739;2853000;0
5836;68390;829;34;36;6;30;.833;3600000;0
5837;165582;848;49;23;4;19;.826;3600000;0
5837;23433;848;0;0;0;0;.00nan;0;0
5837;-1;836;0;0;0;0;.00nan;0;0
5837;-1;836;63;43;5;38;.884;3564000;0
5838;2410;838;0;0;0;0;.00nan;0;0
5838;174334;838;76;32;2;30;.938;3556000;0
5838;53867;828;98;31;1;30;.968;3600000;0
5838;147845;828;0;0;0;0;.00nan;0;0
5839;185506;831;0;0;0;0;.00nan;0;0
5839;53867;828;87;36;2;34;.944;3600000;0
5839;89874;831;47;30;5;25;.833;3600000;0
5839;147845;828;0;0;0;0;.00nan;0;0
5840;-1;834;0;0;0;0;.00nan;0;0
5840;67287;834;86;32;2;30;.938;3600000;0
5840;89190;832;68;41;4;37;.902;3538000;0
5840;147901;832;0;0;0;0;.00nan;0;0
5841;193985;830;0;0;0;0;.00nan;0;0
5841;173073;847;0;0;0;0;.00nan;0;0
5841;16838;830;42;30;5;25;.833;3521000;0
5841;-1;847;58;28;3;25;.893;3600000;0
5842;183545;842;91;31;1;30;.968;3600000;0
5842;26336;829;0;0;0;0;.00nan;0;0
5842;180279;842;0;0;0;0;.00nan;0;0
5842;68390;829;74;37;3;34;.919;3549000;0
5843;13373;837;0;0;0;0;.00nan;0;0
5843;-1;836;0;0;0;0;.00nan;0;0
5843;180929;837;81;29;1;28;.966;3600000;0
5843;-1;836;35;36;6;30;.833;3600000;0
5844;165582;848;78;24;1;23;.958;3600000;0
5844;23433;848;0;0;0;0;.00nan;0;0
5844;-1;833;0;0;0;0;.00nan;0;0
5844;180287;833;53;28;4;24;.857;3600000;0
5845;2410;838;0;0;0;0;.00nan;0;0
5845;167824;839;100;37;1;36;.973;3843000;0
5845;174334;838;92;40;2;38;.950;3843000;0
5845;148041;839;0;0;0;0;.00nan;0;0
5846;173073;847;86;39;2;37;.949;3600000;0
5846;-1;847;0;0;0;0;.00nan;0;0
5846;-1;834;0;0;0;0;.00nan;0;0
5846;67287;834;82;35;3;32;.914;3600000;0
5847;193985;830;19;7;4;3;.429;441000;0
5847;183545;842;0;0;0;0;.00nan;0;0
5847;16838;830;54;31;4;27;.871;3159000;0
5847;180279;842;83;23;1;22;.957;3600000;0
5848;13373;837;54;15;2;13;.867;3600000;0
5848;-1;833;0;0;0;0;.00nan;0;0
5848;180287;833;58;40;6;34;.850;3600000;0
5848;180929;837;0;0;0;0;.00nan;0;0
5849;2410;838;0;0;0;0;.00nan;0;0
5849;174334;838;75;34;2;32;.941;3545000;0
5849;89190;832;0;0;0;0;.00nan;0;0
5849;147901;832;99;20;0;20;1.000;3600000;0
5850;-1;836;50;25;4;21;.840;3541000;0
5850;-1;836;0;0;0;0;.00nan;0;0
5850;53867;828;0;0;0;0;.00nan;0;0
5850;147845;828;62;21;2;19;.905;3600000;0
5851;165582;848;91;28;1;27;.964;3600000;0
5851;23433;848;0;0;0;0;.00nan;0;0
5851;26336;829;0;0;0;0;.00nan;0;0
5851;68390;829;83;34;2;32;.941;3600000;0
5852;13373;837;0;0;0;0;.00nan;0;0
5852;173073;847;0;0;0;0;.00nan;0;0
5852;180929;837;49;29;5;24;.828;3600000;0
5852;-1;847;100;43;2;41;.953;3600000;0
5853;183545;842;1;11;6;5;.455;790000;0
5853;-1;836;38;29;6;23;.793;3270000;0
5853;180279;842;66;24;2;22;.917;2726000;0
5853;-1;836;54;3;0;3;1.000;330000;0
5854;193985;830;0;0;0;0;.00nan;0;0
5854;16838;830;43;35;7;28;.800;3600000;0
5854;-1;833;0;0;0;0;.00nan;0;0
5854;180287;833;77;20;1;19;.950;3600000;0
5855;53867;828;60;34;4;30;.882;3559000;0
5855;89190;832;0;0;0;0;.00nan;0;0
5855;147845;828;0;0;0;0;.00nan;0;0
5855;147901;832;54;30;4;26;.867;3600000;0
5856;165582;848;69;19;1;18;.947;3600000;0
5856;23433;848;0;0;0;0;.00nan;0;0
5856;185506;831;50;9;1;8;.889;480000;0
5856;89874;831;44;35;6;29;.829;3120000;0
5857;165582;848;0;0;0;0;.00nan;0;0
5857;23433;848;46;25;4;21;.840;3597000;0
5857;185506;831;92;43;2;41;.953;3600000;0
5857;89874;831;0;0;0;0;.00nan;0;0
5858;13373;837;0;0;0;0;.00nan;0;0
5858;173073;847;85;46;3;43;.935;3546000;0
5858;180929;837;68;24;2;22;.917;3600000;0
5858;-1;847;0;0;0;0;.00nan;0;0
5859;183545;842;65;48;5;43;.896;3600000;0
5859;-1;836;74;22;1;21;.955;3600000;0
5859;180279;842;0;0;0;0;.00nan;0;0
5859;147962;836;0;0;0;0;.00nan;0;0
5860;193985;830;34;37;7;30;.811;3600000;0
5860;16838;830;0;0;0;0;.00nan;0;0
5860;-1;833;44;26;4;22;.846;3600000;0
5860;180287;833;0;0;0;0;.00nan;0;0
5861;2410;838;0;0;0;0;.00nan;0;0
5861;174334;838;52;23;4;19;.826;3600000;0
5861;-1;834;0;0;0;0;.00nan;0;0
5861;67287;834;64;26;2;24;.923;3600000;0
5862;2410;838;45;45;7;38;.844;3523000;0
5862;174334;838;0;0;0;0;.00nan;0;0
5862;-1;834;67;18;1;17;.944;2692000;0
5862;67287;834;24;13;4;9;.692;908000;0
5863;53867;828;53;21;3;18;.857;3673000;0
5863;89190;832;0;0;0;0;.00nan;0;0
5863;147845;828;0;0;0;0;.00nan;0;0
5863;147901;832;83;48;4;44;.917;3673000;0
5864;185506;831;44;24;4;20;.833;3600000;0
5864;89190;832;90;27;1;26;.963;3600000;0
5864;89874;831;0;0;0;0;.00nan;0;0
5864;147901;832;0;0;0;0;.00nan;0;0
5865;167824;839;81;34;2;32;.941;3600000;0
5865;26336;829;0;0;0;0;.00nan;0;0
5865;68390;829;71;36;4;32;.889;3561000;0
5865;148041;839;0;0;0;0;.00nan;0;0
5866;-1;836;0;0;0;0;.00nan;0;0
5866;-1;833;0;0;0;0;.00nan;0;0
5866;180287;833;80;25;1;24;.960;3600000;0
5866;147962;836;75;35;2;33;.943;3569000;0
5867;173073;847;65;28;3;25;.893;2846000;0
5867;-1;836;34;19;4;15;.789;3600000;0
5867;-1;847;28;16;4;12;.750;754000;0
5867;147962;836;0;0;0;0;.00nan;0;0
5868;167824;839;51;29;3;26;.897;3869000;0
5868;183545;842;0;0;0;0;.00nan;0;0
5868;180279;842;70;43;4;39;.907;3869000;0
5868;148041;839;0;0;0;0;.00nan;0;0
5869;165582;848;76;29;3;26;.897;3600000;0
5869;23433;848;0;0;0;0;.00nan;0;0
5869;-1;834;0;0;0;0;.00nan;0;0
5869;67287;834;61;38;4;34;.895;3593000;0
5870;193985;830;53;3;0;3;1.000;627000;0
5870;16838;830;38;37;6;31;.838;2973000;0
5870;53867;828;92;23;0;23;1.000;3600000;0
5870;147845;828;0;0;0;0;.00nan;0;0
5871;-1;833;0;0;0;0;.00nan;0;0
5871;180287;833;91;35;2;33;.943;3600000;0
5871;89190;832;85;39;3;36;.923;3597000;0
5871;147901;832;0;0;0;0;.00nan;0;0
5872;26336;829;0;0;0;0;.00nan;0;0
5872;185506;831;45;26;4;22;.846;3574000;0
5872;68390;829;74;36;3;33;.917;3600000;0
5872;89874;831;0;0;0;0;.00nan;0;0
5873;2410;838;0;0;0;0;.00nan;0;0
5873;13373;837;0;0;0;0;.00nan;0;0
5873;174334;838;99;59;1;58;.983;3600000;0
5873;180929;837;55;19;3;16;.842;3527000;0
5874;185506;831;0;0;0;0;.00nan;0;0
5874;-1;834;0;0;0;0;.00nan;0;0
5874;67287;834;77;23;1;22;.957;3600000;0
5874;89874;831;54;35;5;30;.857;3600000;0
5875;167824;839;0;0;0;0;.00nan;0;0
5875;193985;830;20;37;8;29;.784;3600000;0
5875;16838;830;0;0;0;0;.00nan;0;0
5875;148041;839;39;27;5;22;.815;3600000;0
5876;26336;829;0;0;0;0;.00nan;0;0
5876;-1;836;37;8;2;6;.750;1280000;0
5876;68390;829;47;33;5;28;.848;3600000;0
5876;147962;836;14;20;6;14;.700;2320000;0
5877;183545;842;62;39;4;35;.897;3600000;0
5877;180279;842;0;0;0;0;.00nan;0;0
5877;53867;828;92;35;1;34;.971;3600000;0
5877;147845;828;0;0;0;0;.00nan;0;0
5878;2410;838;0;0;0;0;.00nan;0;0
5878;174334;838;77;46;4;42;.913;3600000;0
5878;-1;833;41;18;3;15;.833;3600000;0
5878;180287;833;0;0;0;0;.00nan;0;0
5879;173073;847;18;20;6;14;.700;1672000;0
5879;165582;848;0;0;0;0;.00nan;0;0
5879;23433;848;79;25;1;24;.960;3600000;0
5879;-1;847;27;22;5;17;.773;1928000;0
5880;13373;837;0;0;0;0;.00nan;0;0
5880;180929;837;32;21;5;16;.762;3658000;0
5880;89190;832;72;39;4;35;.897;3658000;0
5880;147901;832;0;0;0;0;.00nan;0;0
5881;-1;847;60;31;3;28;.903;3808000;0
5881;185506;831;61;33;4;29;.879;3808000;0
5881;-1;847;0;0;0;0;.00nan;0;0
5881;89874;831;0;0;0;0;.00nan;0;0
5882;183545;842;0;0;0;0;.00nan;0;0
5882;13373;837;0;0;0;0;.00nan;0;0
5882;180279;842;59;31;4;27;.871;3597000;0
5882;180929;837;62;26;3;23;.885;3600000;0
5883;180287;833;77;33;3;30;.909;3900000;0
5883;-1;834;0;0;0;0;.00nan;0;0
5883;-1;833;0;0;0;0;.00nan;0;0
5883;67287;834;75;33;3;30;.909;3900000;0
5884;193985;830;0;0;0;0;.00nan;0;0
5884;165582;848;81;20;1;19;.950;3600000;0
5884;16838;830;90;45;3;42;.933;3585000;0
5884;23433;848;0;0;0;0;.00nan;0;0
5885;167824;839;100;28;0;28;1.000;3600000;0
5885;89190;832;0;0;0;0;.00nan;0;0
5885;147901;832;97;43;1;42;.977;3557000;0
5885;148041;839;0;0;0;0;.00nan;0;0
5886;26336;829;0;0;0;0;.00nan;0;0
5886;53867;828;69;34;4;30;.882;3860000;0
5886;68390;829;45;34;5;29;.853;3860000;0
5886;147845;828;0;0;0;0;.00nan;0;0
5887;2410;838;0;0;0;0;.00nan;0;0
5887;174334;838;88;46;3;43;.935;3600000;0
5887;-1;836;79;17;1;16;.941;3600000;0
5887;147962;836;0;0;0;0;.00nan;0;0
5888;-1;847;87;29;1;28;.966;3600000;0
5888;-1;847;0;0;0;0;.00nan;0;0
5888;89190;832;0;0;0;0;.00nan;0;0
5888;147901;832;82;27;2;25;.926;3600000;0
5889;183545;842;86;38;2;36;.947;3600000;0
5889;180279;842;0;0;0;0;.00nan;0;0
5889;-1;834;0;0;0;0;.00nan;0;0
5889;67287;834;75;31;3;28;.903;3545000;0
5890;2410;838;0;0;0;0;.00nan;0;0
5890;193985;830;0;0;0;0;.00nan;0;0
5890;16838;830;71;26;2;24;.923;3843000;0
5890;174334;838;71;31;3;28;.903;3843000;0
5891;13373;837;0;0;0;0;.00nan;0;0
5891;165582;848;97;51;2;49;.961;3600000;0
5891;23433;848;0;0;0;0;.00nan;0;0
5891;180929;837;100;32;1;31;.969;3600000;0
5892;13373;837;62;20;2;18;.900;3600000;0
5892;26336;829;65;16;1;15;.938;1281000;0
5892;180929;837;0;0;0;0;.00nan;0;0
5892;68390;829;27;29;6;23;.793;2319000;0
5893;193985;830;77;38;3;35;.921;3583000;0
5893;16838;830;0;0;0;0;.00nan;0;0
5893;-1;834;76;19;1;18;.947;3600000;0
5893;67287;834;0;0;0;0;.00nan;0;0
5894;183545;842;0;0;0;0;.00nan;0;0
5894;180279;842;39;30;5;25;.833;3600000;0
5894;89190;832;89;25;1;24;.960;3600000;0
5894;147901;832;0;0;0;0;.00nan;0;0
5895;167824;839;68;34;3;31;.912;3600000;0
5895;-1;836;100;23;0;23;1.000;3600000;0
5895;147962;836;0;0;0;0;.00nan;0;0
5895;148041;839;0;0;0;0;.00nan;0;0
5896;165582;848;25;25;6;19;.760;2729000;0
5896;23433;848;62;11;0;11;1.000;871000;0
5896;53867;828;0;0;0;0;.00nan;0;0
5896;147845;828;69;31;3;28;.903;3600000;0
5897;180287;833;99;23;0;23;1.000;3600000;0
5897;185506;831;0;0;0;0;.00nan;0;0
5897;-1;833;0;0;0;0;.00nan;0;0
5897;89874;831;55;46;6;40;.870;3600000;0
5898;-1;836;47;28;4;24;.857;3577000;0
5898;185506;831;71;33;3;30;.909;3600000;0
5898;89874;831;0;0;0;0;.00nan;0;0
5898;147962;836;0;0;0;0;.00nan;0;0
5899;167824;839;0;0;0;0;.00nan;0;0
5899;53867;828;71;26;2;24;.923;3600000;0
5899;147845;828;0;0;0;0;.00nan;0;0
5899;148041;839;69;32;3;29;.906;3565000;0
5900;2410;838;0;0;0;0;.00nan;0;0
5900;174334;838;74;23;1;22;.957;3600000;0
5900;-1;847;67;26;2;24;.923;3542000;0
5900;-1;847;0;0;0;0;.00nan;0;0
5901;180287;833;60;32;4;28;.875;3600000;0
5901;185506;831;0;0;0;0;.00nan;0;0
5901;-1;833;0;0;0;0;.00nan;0;0
5901;89874;831;98;44;2;42;.955;3600000;0
5902;167824;839;94;39;2;37;.949;3724000;0
5902;165582;848;76;22;1;21;.955;3724000;0
5902;23433;848;0;0;0;0;.00nan;0;0
5902;148041;839;0;0;0;0;.00nan;0;0
5903;13373;837;0;0;0;0;.00nan;0;0
5903;26336;829;0;0;0;0;.00nan;0;0
5903;180929;837;63;28;3;25;.893;3600000;0
5903;68390;829;53;39;5;34;.872;3600000;0
5904;167824;839;86;40;3;37;.925;3535000;0
5904;180287;833;82;25;1;24;.960;3600000;0
5904;-1;833;0;0;0;0;.00nan;0;0
5904;148041;839;0;0;0;0;.00nan;0;0
5905;193985;830;0;0;0;0;.00nan;0;0
5905;165582;848;59;23;3;20;.870;3600000;0
5905;16838;830;58;53;7;46;.868;3600000;0
5905;23433;848;0;0;0;0;.00nan;0;0
5906;-1;847;94;38;1;37;.974;3600000;0
5906;-1;847;0;0;0;0;.00nan;0;0
5906;53867;828;82;19;0;19;1.000;3600000;0
5906;147845;828;0;0;0;0;.00nan;0;0
5907;13373;837;52;21;3;18;.857;3565000;0
5907;180929;837;0;0;0;0;.00nan;0;0
5907;-1;834;0;0;0;0;.00nan;0;0
5907;67287;834;76;26;1;25;.962;3600000;0
5908;185506;831;61;23;3;20;.870;3091000;0
5908;89190;832;42;31;5;26;.839;3600000;0
5908;89874;831;22;5;3;2;.400;509000;0
5908;147901;832;0;0;0;0;.00nan;0;0
5909;2410;838;86;52;4;48;.923;3621000;0
5909;183545;842;38;21;5;16;.762;3621000;0
5909;174334;838;0;0;0;0;.00nan;0;0
5909;180279;842;0;0;0;0;.00nan;0;0
5910;13373;837;0;0;0;0;.00nan;0;0
5910;180929;837;43;20;3;17;.850;3545000;0
5910;185506;831;100;56;2;54;.964;3600000;0
5910;89874;831;0;0;0;0;.00nan;0;0
5911;183545;842;0;0;0;0;.00nan;0;0
5911;-1;847;89;41;3;38;.927;3600000;0
5911;180279;842;100;24;0;24;1.000;3600000;0
5911;-1;847;0;0;0;0;.00nan;0;0
5912;26336;829;0;0;0;0;.00nan;0;0
5912;-1;834;0;0;0;0;.00nan;0;0
5912;67287;834;64;24;3;21;.875;3600000;0
5912;68390;829;58;35;4;31;.886;3570000;0
5913;193985;830;0;0;0;0;.00nan;0;0
5913;16838;830;99;37;1;36;.973;3600000;0
5913;89190;832;0;0;0;0;.00nan;0;0
5913;147901;832;58;30;4;26;.867;3600000;0
5914;2410;838;0;0;0;0;.00nan;0;0
5914;174334;838;56;27;3;24;.889;3544000;0
5914;53867;828;70;27;2;25;.926;3600000;0
5914;147845;828;0;0;0;0;.00nan;0;0
5915;165582;848;70;25;2;23;.920;3600000;0
5915;23433;848;0;0;0;0;.00nan;0;0
5915;-1;836;43;48;7;41;.854;3600000;0
5915;147962;836;0;0;0;0;.00nan;0;0
5916;167824;839;64;30;3;27;.900;3569000;0
5916;26336;829;0;0;0;0;.00nan;0;0
5916;68390;829;68;32;2;30;.938;3600000;0
5916;148041;839;0;0;0;0;.00nan;0;0
5917;-1;847;77;41;4;37;.902;3575000;0
5917;185506;831;66;32;3;29;.906;3600000;0
5917;-1;847;0;0;0;0;.00nan;0;0
5917;89874;831;0;0;0;0;.00nan;0;0
5918;2410;838;0;0;0;0;.00nan;0;0
5918;174334;838;64;39;4;35;.897;3562000;0
5918;185506;831;62;21;3;18;.857;3600000;0
5918;89874;831;0;0;0;0;.00nan;0;0
5919;193985;830;0;0;0;0;.00nan;0;0
5919;13373;837;92;23;0;23;1.000;3346000;0
5919;16838;830;66;42;4;38;.905;3600000;0
5919;180929;837;28;6;3;3;.500;254000;0
5920;167824;839;0;0;0;0;.00nan;0;0
5920;-1;834;0;0;0;0;.00nan;0;0
5920;67287;834;79;46;4;42;.913;3552000;0
5920;148041;839;69;30;3;27;.900;3600000;0
5921;26336;829;0;0;0;0;.00nan;0;0
5921;-1;847;38;29;5;24;.828;3600000;0
5921;-1;847;0;0;0;0;.00nan;0;0
5921;68390;829;78;22;1;21;.955;3600000;0
5922;-1;836;0;0;0;0;.00nan;0;0
5922;89190;832;56;10;1;9;.900;685000;0
5922;147901;832;23;27;6;21;.778;2915000;0
5922;147962;836;73;28;2;26;.929;3600000;0
5923;183545;842;97;44;3;41;.932;3600000;0
5923;165582;848;40;27;5;22;.815;3556000;0
5923;23433;848;0;0;0;0;.00nan;0;0
5923;180279;842;0;0;0;0;.00nan;0;0
5924;167824;839;94;20;0;20;1.000;3600000;0
5924;-1;847;62;34;4;30;.882;3600000;0
5924;-1;847;0;0;0;0;.00nan;0;0
5924;148041;839;0;0;0;0;.00nan;0;0
5925;183545;842;0;0;0;0;.00nan;0;0
5925;180279;842;79;44;3;41;.932;3894000;0
5925;180287;833;64;22;2;20;.909;3894000;0
5925;-1;833;0;0;0;0;.00nan;0;0
5926;-1;836;23;36;8;28;.778;3600000;0
5926;-1;834;0;0;0;0;.00nan;0;0
5926;67287;834;99;44;1;43;.977;3600000;0
5926;147962;836;0;0;0;0;.00nan;0;0
5927;193985;830;73;34;2;32;.941;3557000;0
5927;16838;830;0;0;0;0;.00nan;0;0
5927;185506;831;77;28;1;27;.964;3600000;0
5927;89874;831;0;0;0;0;.00nan;0;0
5928;13373;837;0;0;0;0;.00nan;0;0
5928;180929;837;98;40;3;37;.925;3600000;0
5928;53867;828;67;26;4;22;.846;3566000;0
5928;147845;828;0;0;0;0;.00nan;0;0
5929;2410;838;29;31;6;25;.806;3600000;0
5929;174334;838;0;0;0;0;.00nan;0;0
5929;26336;829;0;0;0;0;.00nan;0;0
5929;68390;829;71;32;3;29;.906;3600000;0
5930;165582;848;38;20;4;16;.800;3527000;0
5930;23433;848;0;0;0;0;.00nan;0;0
5930;89190;832;99;47;2;45;.957;3600000;0
5930;147901;832;0;0;0;0;.00nan;0;0
5931;180287;833;95;23;0;23;1.000;3600000;0
5931;-1;833;0;0;0;0;.00nan;0;0
5931;53867;828;0;0;0;0;.00nan;0;0
5931;147845;828;45;43;7;36;.837;3600000;0
5932;167824;839;56;35;5;30;.857;3583000;0
5932;185506;831;0;0;0;0;.00nan;0;0
5932;89874;831;58;25;3;22;.880;3600000;0
5932;148041;839;0;0;0;0;.00nan;0;0
5933;26336;829;0;0;0;0;.00nan;0;0
5933;180287;833;92;20;0;20;1.000;3600000;0
5933;-1;833;0;0;0;0;.00nan;0;0
5933;68390;829;59;35;4;31;.886;3600000;0
5934;183545;842;68;28;2;26;.929;3600000;0
5934;180279;842;0;0;0;0;.00nan;0;0
5934;185506;831;75;32;3;29;.906;3543000;0
5934;89874;831;0;0;0;0;.00nan;0;0
5935;167824;839;28;8;3;5;.625;450000;0
5935;13373;837;0;0;0;0;.00nan;0;0
5935;180929;837;70;13;1;12;.923;3600000;0
5935;148041;839;79;40;2;38;.950;3150000;0
5936;-1;834;0;0;0;0;.00nan;0;0
5936;53867;828;59;36;4;32;.889;3900000;0
5936;67287;834;58;37;4;33;.892;3900000;0
5936;147845;828;0;0;0;0;.00nan;0;0
5937;193985;830;0;0;0;0;.00nan;0;0
5937;16838;830;63;35;4;31;.886;3600000;0
5937;-1;836;0;0;0;0;.00nan;0;0
5937;147962;836;72;33;3;30;.909;3600000;0
5938;-1;847;74;46;4;42;.913;3590000;0
5938;180287;833;67;22;2;20;.909;3600000;0
5938;-1;847;0;0;0;0;.00nan;0;0
5938;-1;833;0;0;0;0;.00nan;0;0
5939;2410;838;0;0;0;0;.00nan;0;0
5939;165582;848;25;15;4;11;.733;3766000;0
5939;23433;848;0;0;0;0;.00nan;0;0
5939;174334;838;76;51;5;46;.902;3766000;0
5940;193985;830;0;0;0;0;.00nan;0;0
5940;16838;830;24;20;5;15;.750;3566000;0
5940;-1;847;95;46;4;42;.913;3600000;0
5940;-1;847;0;0;0;0;.00nan;0;0
5941;183545;842;99;35;1;34;.971;3600000;0
5941;26336;829;0;0;0;0;.00nan;0;0
5941;180279;842;0;0;0;0;.00nan;0;0
5941;68390;829;78;37;2;35;.946;3587000;0
5942;13373;837;0;0;0;0;.00nan;0;0
5942;-1;836;25;41;8;33;.805;3600000;0
5942;180929;837;53;22;4;18;.818;3600000;0
5942;147962;836;0;0;0;0;.00nan;0;0
5943;2410;838;0;0;0;0;.00nan;0;0
5943;167824;839;91;29;1;28;.966;3900000;0
5943;174334;838;94;37;1;36;.973;3900000;0
5943;148041;839;0;0;0;0;.00nan;0;0
5944;-1;834;0;0;0;0;.00nan;0;0
5944;67287;834;65;34;3;31;.912;3600000;0
5944;89190;832;0;0;0;0;.00nan;0;0
5944;147901;832;92;57;5;52;.912;3556000;0
5945;185506;831;48;45;6;39;.867;3600000;0
5945;53867;828;65;18;1;17;.944;3600000;0
5945;89874;831;0;0;0;0;.00nan;0;0
5945;147845;828;0;0;0;0;.00nan;0;0
5946;165582;848;65;41;5;36;.878;3569000;0
5946;23433;848;0;0;0;0;.00nan;0;0
5946;180287;833;67;28;4;24;.857;3600000;0
5946;-1;833;0;0;0;0;.00nan;0;0
5947;167824;839;90;17;0;17;1.000;3600000;0
5947;185506;831;0;0;0;0;.00nan;0;0
5947;89874;831;92;51;3;48;.941;3600000;0
5947;148041;839;0;0;0;0;.00nan;0;0
5948;-1;847;59;39;4;35;.897;3558000;0
5948;-1;847;0;0;0;0;.00nan;0;0
5948;-1;834;0;0;0;0;.00nan;0;0
5948;67287;834;50;19;3;16;.842;3600000;0
5949;193985;830;0;0;0;0;.00nan;0;0
5949;183545;842;0;0;0;0;.00nan;0;0
5949;16838;830;68;35;4;31;.886;3600000;0
5949;180279;842;48;33;5;28;.848;3543000;0
5950;165582;848;63;19;1;18;.947;3600000;0
5950;23433;848;0;0;0;0;.00nan;0;0
5950;26336;829;0;0;0;0;.00nan;0;0
5950;68390;829;76;37;3;34;.919;3560000;0
5951;-1;836;87;28;1;27;.964;3600000;0
5951;53867;828;72;44;4;40;.909;3600000;0
5951;147845;828;0;0;0;0;.00nan;0;0
5951;147962;836;0;0;0;0;.00nan;0;0
5952;13373;837;0;0;0;0;.00nan;0;0
5952;180287;833;72;30;2;28;.933;3566000;0
5952;180929;837;100;34;0;34;1.000;3600000;0
5952;-1;833;0;0;0;0;.00nan;0;0
5953;2410;838;0;0;0;0;.00nan;0;0
5953;174334;838;46;26;5;21;.808;3600000;0
5953;89190;832;0;0;0;0;.00nan;0;0
5953;147901;832;91;40;1;39;.975;3600000;0
5955;193985;830;0;0;0;0;.00nan;0;0
5955;183545;842;92;32;1;31;.969;3600000;0
5955;16838;830;77;37;3;34;.919;3550000;0
5955;180279;842;0;0;0;0;.00nan;0;0
5959;5565;834;0;0;0;0;.00nan;0;0
5959;67287;834;50;23;4;19;.826;3600000;0
5959;89190;832;0;0;0;0;.00nan;0;0
5959;147901;832;83;29;1;28;.966;3600000;0
5961;-1;836;35;27;5;22;.815;3544000;0
5961;185506;831;78;35;3;32;.914;3600000;0
5961;-1;836;0;0;0;0;.00nan;0;0
5961;89874;831;0;0;0;0;.00nan;0;0
5967;173073;847;0;0;0;0;.00nan;0;0
5967;-1;847;52;40;5;35;.875;3600000;0
5967;53867;828;83;21;1;20;.952;3600000;0
5967;68390;828;0;0;0;0;.00nan;0;0
5971;5565;834;76;11;0;11;1.000;3600000;0
5971;193985;830;1;19;7;12;.632;1649000;0
5971;16838;830;47;23;3;20;.870;1951000;0
5971;67287;834;0;0;0;0;.00nan;0;0
5973;173073;847;79;51;4;47;.922;3600000;0
5973;-1;847;0;0;0;0;.00nan;0;0
5973;53867;828;0;0;0;0;.00nan;0;0
5973;68390;828;61;16;2;14;.875;3600000;0
5977;26336;829;72;36;3;33;.917;3600000;0
5977;-1;836;51;4;0;4;1.000;415000;0
5977;-1;836;39;38;6;32;.842;3185000;0
5977;-1;829;0;0;0;0;.00nan;0;0
5981;2410;838;0;0;0;0;.00nan;0;0
5981;183545;842;0;0;0;0;.00nan;0;0
5981;174334;838;100;45;1;44;.978;3600000;0
5981;180279;842;53;18;2;16;.889;3556000;0
5983;193985;830;0;0;0;0;.00nan;0;0
5983;16838;830;86;43;3;40;.930;3568000;0
5983;-1;836;0;0;0;0;.00nan;0;0
5983;-1;836;77;34;2;32;.941;3600000;0
5985;53867;828;57;23;3;20;.870;3768000;0
5985;68390;828;0;0;0;0;.00nan;0;0
5985;89190;832;81;38;2;36;.947;3768000;0
5985;147901;832;0;0;0;0;.00nan;0;0
5989;2410;838;0;0;0;0;.00nan;0;0
5989;173073;847;0;0;0;0;.00nan;0;0
5989;174334;838;91;31;1;30;.968;3900000;0
5989;-1;847;76;17;1;16;.941;3900000;0
5991;183545;842;72;26;2;24;.923;3554000;0
5991;165582;848;74;21;1;20;.952;3600000;0
5991;23433;848;0;0;0;0;.00nan;0;0
5991;180279;842;0;0;0;0;.00nan;0;0
5997;183545;842;0;0;0;0;.00nan;0;0
5997;-1;833;0;0;0;0;.00nan;0;0
5997;180279;842;73;41;5;36;.878;3600000;0
5997;180287;833;64;21;2;19;.905;3600000;0
5999;26336;829;57;23;2;21;.913;3600000;0
5999;185506;831;54;36;5;31;.861;3600000;0
5999;-1;829;0;0;0;0;.00nan;0;0
5999;89874;831;0;0;0;0;.00nan;0;0
6001;5565;834;47;25;4;21;.840;3600000;0
6001;-1;836;62;48;5;43;.896;3600000;0
6001;-1;836;0;0;0;0;.00nan;0;0
6001;67287;834;0;0;0;0;.00nan;0;0
6003;13373;837;63;21;2;19;.905;3572000;0
6003;165582;848;0;0;0;0;.00nan;0;0
6003;23433;848;100;31;1;30;.968;3600000;0
6003;180929;837;0;0;0;0;.00nan;0;0
6005;2410;838;51;38;5;33;.868;3563000;0
6005;174334;838;0;0;0;0;.00nan;0;0
6005;53867;828;0;0;0;0;.00nan;0;0
6005;68390;828;42;21;4;17;.810;3600000;0
6007;173073;847;62;52;6;46;.885;3600000;0
6007;-1;847;0;0;0;0;.00nan;0;0
6007;89190;832;0;0;0;0;.00nan;0;0
6007;147901;832;85;21;1;20;.952;3600000;0
6009;167824;839;0;0;0;0;.00nan;0;0
6009;193985;830;84;30;1;29;.967;3600000;0
6009;16838;830;0;0;0;0;.00nan;0;0
6009;148041;839;79;31;2;29;.935;3600000;0
6011;173073;847;0;0;0;0;.00nan;0;0
6011;165582;848;68;21;2;19;.905;3600000;0
6011;23433;848;0;0;0;0;.00nan;0;0
6011;-1;847;47;35;5;30;.857;3600000;0
6017;193985;830;0;0;0;0;.00nan;0;0
6017;16838;830;84;31;2;29;.935;3600000;0
6017;-1;836;63;28;3;25;.893;3600000;0
6017;-1;836;0;0;0;0;.00nan;0;0
6019;2410;838;46;13;2;11;.846;872000;0
6019;174334;838;31;29;6;23;.793;2728000;0
6019;185506;831;0;0;0;0;.00nan;0;0
6019;89874;831;82;24;1;23;.958;3600000;0
6021;183545;842;72;36;3;33;.917;3600000;0
6021;26336;829;31;20;4;16;.800;3563000;0
6021;180279;842;0;0;0;0;.00nan;0;0
6021;-1;829;0;0;0;0;.00nan;0;0
6025;173073;847;0;0;0;0;.00nan;0;0
6025;165582;848;61;20;2;18;.900;3565000;0
6025;23433;848;0;0;0;0;.00nan;0;0
6025;-1;847;100;50;1;49;.980;3600000;0
6031;193985;830;0;0;0;0;.00nan;0;0
6031;16838;830;69;43;5;38;.884;3600000;0
6031;53867;828;81;11;0;11;1.000;3600000;0
6031;68390;828;0;0;0;0;.00nan;0;0
6033;2410;838;0;0;0;0;.00nan;0;0
6033;5565;834;0;0;0;0;.00nan;0;0
6033;174334;838;96;56;4;52;.929;3600000;0
6033;67287;834;73;17;1;16;.941;3600000;0
6035;183545;842;56;31;4;27;.871;3600000;0
6035;-1;836;87;35;1;34;.971;3600000;0
6035;180279;842;0;0;0;0;.00nan;0;0
6035;-1;836;0;0;0;0;.00nan;0;0
6037;185506;831;58;29;3;26;.897;3565000;0
6037;89190;832;88;31;1;30;.968;3600000;0
6037;89874;831;0;0;0;0;.00nan;0;0
6037;147901;832;0;0;0;0;.00nan;0;0
6041;193985;830;87;36;2;34;.944;3900000;0
6041;173073;847;100;41;2;39;.951;3900000;0
6041;16838;830;0;0;0;0;.00nan;0;0
6041;-1;847;0;0;0;0;.00nan;0;0
6043;183545;842;0;0;0;0;.00nan;0;0
6043;180279;842;74;46;4;42;.913;3594000;0
6043;89190;832;0;0;0;0;.00nan;0;0
6043;147901;832;51;20;3;17;.850;3600000;0
6045;2410;838;66;51;5;46;.902;3600000;0
6045;174334;838;0;0;0;0;.00nan;0;0
6045;26336;829;83;25;1;24;.960;3600000;0
6045;-1;829;0;0;0;0;.00nan;0;0
6049;5565;834;45;22;4;18;.818;3900000;0
6049;185506;831;0;0;0;0;.00nan;0;0
6049;67287;834;0;0;0;0;.00nan;0;0
6049;89874;831;52;29;4;25;.862;3900000;0
1107;26336;829;0;0;0;0;.00nan;0;0
1107;68390;829;63;22;2;20;.909;3600000;0
1107;89190;832;0;0;0;0;.00nan;0;0
1107;147901;832;63;48;5;43;.896;3600000;0
1108;-1;836;57;38;5;33;.868;3600000;0
1108;185506;831;70;30;3;27;.900;3600000;0
1108;89874;831;0;0;0;0;.00nan;0;0
1108;147962;836;0;0;0;0;.00nan;0;0
1109;26336;829;0;0;0;0;.00nan;0;0
1109;68390;829;77;29;1;28;.966;4703000;0
1109;89190;832;0;0;0;0;.00nan;0;0
1109;147901;832;87;43;2;41;.953;4703000;0
1110;-1;836;96;21;0;21;1.000;3600000;0
1110;185506;831;48;39;6;33;.846;3600000;0
1110;89874;831;0;0;0;0;.00nan;0;0
1110;147962;836;0;0;0;0;.00nan;0;0
1240;-1;836;48;35;5;30;.857;3983000;0
1240;185506;831;62;34;4;30;.882;3983000;0
1240;89874;831;0;0;0;0;.00nan;0;0
1240;147962;836;0;0;0;0;.00nan;0;0
1317;185506;831;48;38;5;33;.868;3600000;0
1317;89190;832;0;0;0;0;.00nan;0;0
1317;89874;831;0;0;0;0;.00nan;0;0
1317;147901;832;51;18;3;15;.833;3600000;0
1318;185506;831;58;28;3;25;.893;3600000;0
1318;89190;832;0;0;0;0;.00nan;0;0
1318;89874;831;0;0;0;0;.00nan;0;0
1318;147901;832;100;20;0;20;1.000;3600000;0
1442;13373;837;0;0;0;0;.00nan;0;0
1442;26336;829;53;2;0;2;1.000;626000;0
1442;180929;837;100;23;0;23;1.000;3600000;0
1442;68390;829;44;34;6;28;.824;2974000;0
1443;165582;848;78;19;1;18;.947;3600000;0
1443;23433;848;0;0;0;0;.00nan;0;0
1443;-1;834;0;0;0;0;.00nan;0;0
1443;67287;834;93;45;3;42;.933;3552000;0
1444;167824;839;55;34;4;30;.882;3270000;0
1444;53867;828;73;20;1;19;.950;3600000;0
1444;147845;828;0;0;0;0;.00nan;0;0
1444;148041;839;39;1;1;0;.000;330000;0
1445;180287;833;47;26;4;22;.846;3600000;0
1445;-1;833;0;0;0;0;.00nan;0;0
1445;89190;832;69;22;2;20;.909;1842000;0
1445;147901;832;44;31;6;25;.806;1758000;0
1446;13373;837;0;0;0;0;.00nan;0;0
1446;26336;829;0;0;0;0;.00nan;0;0
1446;180929;837;89;19;0;19;1.000;3600000;0
1446;68390;829;75;32;2;30;.938;3571000;0
1447;165582;848;81;28;1;27;.964;3600000;0
1447;23433;848;0;0;0;0;.00nan;0;0
1447;-1;834;0;0;0;0;.00nan;0;0
1447;67287;834;75;28;2;26;.929;3600000;0
1448;167824;839;84;35;2;33;.943;3600000;0
1448;53867;828;46;24;4;20;.833;3525000;0
1448;147845;828;0;0;0;0;.00nan;0;0
1448;148041;839;0;0;0;0;.00nan;0;0
1449;180287;833;61;26;3;23;.885;3600000;0
1449;-1;833;0;0;0;0;.00nan;0;0
1449;89190;832;0;0;0;0;.00nan;0;0
1449;147901;832;83;56;5;51;.911;3600000;0
1450;13373;837;0;0;0;0;.00nan;0;0
1450;26336;829;0;0;0;0;.00nan;0;0
1450;180929;837;41;14;3;11;.786;3600000;0
1450;68390;829;66;45;5;40;.889;3586000;0
1451;165582;848;63;27;3;24;.889;3516000;0
1451;23433;848;0;0;0;0;.00nan;0;0
1451;-1;834;0;0;0;0;.00nan;0;0
1451;67287;834;87;29;1;28;.966;3600000;0
1452;167824;839;72;34;3;31;.912;3849000;0
1452;53867;828;79;29;2;27;.931;3869000;0
1452;147845;828;0;0;0;0;.00nan;0;0
1452;148041;839;0;0;0;0;.00nan;0;0
1453;180287;833;79;24;1;23;.958;3600000;0
1453;-1;833;0;0;0;0;.00nan;0;0
1453;89190;832;0;0;0;0;.00nan;0;0
1453;147901;832;70;28;2;26;.929;3575000;0
1454;13373;837;0;0;0;0;.00nan;0;0
1454;26336;829;0;0;0;0;.00nan;0;0
1454;180929;837;50;25;4;21;.840;3746000;0
1454;68390;829;80;54;5;49;.907;3746000;0
1455;165582;848;70;25;2;23;.920;3600000;0
1455;23433;848;0;0;0;0;.00nan;0;0
1455;-1;834;0;0;0;0;.00nan;0;0
1455;67287;834;47;29;5;24;.828;3600000;0
1456;167824;839;65;41;5;36;.878;3600000;0
1456;53867;828;89;29;1;28;.966;3600000;0
1456;147845;828;0;0;0;0;.00nan;0;0
1456;148041;839;0;0;0;0;.00nan;0;0
1457;180287;833;72;26;2;24;.923;3600000;0
1457;-1;833;0;0;0;0;.00nan;0;0
1457;89190;832;0;0;0;0;.00nan;0;0
1457;147901;832;89;55;3;52;.945;3550000;0
1691;165582;848;60;29;3;26;.897;3600000;0
1691;23433;848;0;0;0;0;.00nan;0;0
1691;-1;834;51;5;0;5;1.000;900000;0
1691;67287;834;51;40;6;34;.850;2700000;0
1692;167824;839;80;29;2;27;.931;3570000;0
1692;53867;828;84;29;1;28;.966;3600000;0
1692;147845;828;0;0;0;0;.00nan;0;0
1692;148041;839;0;0;0;0;.00nan;0;0
1793;13373;837;0;0;0;0;.00nan;0;0
1793;180929;837;52;29;4;25;.862;3573000;0
1793;53867;828;59;26;3;23;.885;3600000;0
1793;147845;828;0;0;0;0;.00nan;0;0
1794;165582;848;71;19;1;18;.947;3600000;0
1794;23433;848;0;0;0;0;.00nan;0;0
1794;180287;833;70;36;3;33;.917;3565000;0
1794;-1;833;0;0;0;0;.00nan;0;0
1795;13373;837;0;0;0;0;.00nan;0;0
1795;180929;837;59;26;3;23;.885;3529000;0
1795;53867;828;100;31;1;30;.968;3600000;0
1795;147845;828;0;0;0;0;.00nan;0;0
1796;165582;848;87;31;1;30;.968;3544000;0
1796;23433;848;0;0;0;0;.00nan;0;0
1796;180287;833;94;22;0;22;1.000;3600000;0
1796;-1;833;0;0;0;0;.00nan;0;0
1797;13373;837;0;0;0;0;.00nan;0;0
1797;180929;837;56;33;4;29;.879;3795000;0
1797;53867;828;76;36;3;33;.917;3795000;0
1797;147845;828;0;0;0;0;.00nan;0;0
1798;165582;848;100;28;0;28;1.000;3600000;0
1798;23433;848;0;0;0;0;.00nan;0;0
1798;180287;833;85;34;2;32;.941;3600000;0
1798;-1;833;0;0;0;0;.00nan;0;0
1799;13373;837;0;0;0;0;.00nan;0;0
1799;180929;837;91;28;0;28;1.000;3600000;0
1799;53867;828;45;31;4;27;.871;3600000;0
1799;147845;828;0;0;0;0;.00nan;0;0
1800;165582;848;44;24;4;20;.833;3600000;0
1800;23433;848;0;0;0;0;.00nan;0;0
1800;180287;833;100;41;2;39;.951;3600000;0
1800;-1;833;0;0;0;0;.00nan;0;0
1984;13373;837;0;0;0;0;.00nan;0;0
1984;180929;837;89;29;1;28;.966;3600000;0
1984;53867;828;52;24;3;21;.875;3547000;0
1984;147845;828;0;0;0;0;.00nan;0;0
1985;165582;848;50;21;3;18;.857;3892000;0
1985;23433;848;0;0;0;0;.00nan;0;0
1985;180287;833;52;30;4;26;.867;3892000;0
1985;-1;833;0;0;0;0;.00nan;0;0
2012;13373;837;0;0;0;0;.00nan;0;0
2012;180929;837;86;52;3;49;.942;5916000;0
2012;53867;828;99;58;2;56;.966;5916000;0
2012;147845;828;0;0;0;0;.00nan;0;0
2013;165582;848;94;29;1;28;.966;3600000;0
2013;23433;848;0;0;0;0;.00nan;0;0
2013;180287;833;60;32;4;28;.875;3600000;0
2013;-1;833;0;0;0;0;.00nan;0;0
2130;165582;848;68;18;1;17;.944;3600000;0
2130;23433;848;0;0;0;0;.00nan;0;0
2130;53867;828;63;42;5;37;.881;3600000;0
2130;147845;828;0;0;0;0;.00nan;0;0
2131;165582;848;29;29;6;23;.793;3123000;0
2131;23433;848;53;3;0;3;1.000;477000;0
2131;53867;828;70;34;3;31;.912;3600000;0
2131;147845;828;0;0;0;0;.00nan;0;0
2132;165582;848;78;30;2;28;.933;3597000;0
2132;23433;848;0;0;0;0;.00nan;0;0
2132;53867;828;82;23;1;22;.957;3600000;0
2132;147845;828;0;0;0;0;.00nan;0;0
2133;165582;848;53;24;3;21;.875;3707000;0
2133;23433;848;0;0;0;0;.00nan;0;0
2133;53867;828;100;41;2;39;.951;3707000;0
2133;147845;828;0;0;0;0;.00nan;0;0
2356;165582;848;50;41;5;36;.878;3600000;0
2356;23433;848;0;0;0;0;.00nan;0;0
2356;53867;828;100;43;0;43;1.000;3600000;0
2356;147845;828;0;0;0;0;.00nan;0;0
6052;183377;904;74;35;3;32;.914;3600000;0
6052;165867;777;96;23;0;23;1.000;3600000;0
6052;66924;904;0;0;0;0;.00nan;0;0
6052;149847;777;0;0;0;0;.00nan;0;0
6053;209564;776;0;0;0;0;.00nan;0;0
6053;24177;2182;0;0;0;0;.00nan;0;0
6053;95405;776;70;27;2;25;.926;3600000;0
6053;146164;2182;44;28;4;24;.857;3541000;0
6054;62279;778;0;0;0;0;.00nan;0;0
6054;76486;778;84;25;1;24;.960;3600000;0
6054;152201;794;73;52;5;47;.904;3600000;0
6054;158512;794;0;0;0;0;.00nan;0;0
6055;209571;798;100;41;1;40;.976;3900000;0
6055;-1;3737;0;0;0;0;.00nan;0;0
6055;-1;798;0;0;0;0;.00nan;0;0
6055;78587;3737;86;30;1;29;.967;3900000;0
6056;190702;784;63;31;4;27;.871;3682000;0
6056;212959;780;0;0;0;0;.00nan;0;0
6056;-1;784;0;0;0;0;.00nan;0;0
6056;-1;780;68;32;3;29;.906;3682000;0
6057;-1;783;0;0;0;0;.00nan;0;0
6057;-1;796;49;11;2;9;.818;1280000;0
6057;62884;796;27;22;5;17;.773;2320000;0
6057;86422;783;61;33;4;29;.879;3600000;0
6058;24177;2182;0;0;0;0;.00nan;0;0
6058;-1;3737;0;0;0;0;.00nan;0;0
6058;78587;3737;50;32;5;27;.844;3600000;0
6058;146164;2182;99;26;0;26;1.000;3600000;0
6059;212959;780;0;0;0;0;.00nan;0;0
6059;-1;780;66;34;3;31;.912;3600000;0
6059;62279;778;80;20;1;19;.950;3600000;0
6059;76486;778;0;0;0;0;.00nan;0;0
6060;165867;777;47;18;3;15;.833;3569000;0
6060;-1;796;0;0;0;0;.00nan;0;0
6060;62884;796;87;36;2;34;.944;3600000;0
6060;149847;777;0;0;0;0;.00nan;0;0
6061;183377;904;80;40;3;37;.925;3900000;0
6061;209564;776;0;0;0;0;.00nan;0;0
6061;66924;904;0;0;0;0;.00nan;0;0
6061;95405;776;63;27;3;24;.889;3900000;0
6062;190702;784;83;48;4;44;.917;3598000;0
6062;-1;784;0;0;0;0;.00nan;0;0
6062;-1;783;0;0;0;0;.00nan;0;0
6062;86422;783;79;28;2;26;.929;3600000;0
6063;209571;798;70;29;2;27;.931;3600000;0
6063;-1;798;0;0;0;0;.00nan;0;0
6063;152201;794;37;31;5;26;.839;3600000;0
6063;158512;794;0;0;0;0;.00nan;0;0
6064;190702;784;81;35;3;32;.914;3600000;0
6064;-1;784;0;0;0;0;.00nan;0;0
6064;-1;796;0;0;0;0;.00nan;0;0
6064;62884;796;21;28;6;22;.786;3600000;0
6065;183377;904;32;30;6;24;.800;3018000;0
6065;-1;3737;0;0;0;0;.00nan;0;0
6065;66924;904;48;0;0;0;.00nan;582000;0
6065;78587;3737;62;29;3;26;.897;3600000;0
6066;209564;776;0;0;0;0;.00nan;0;0
6066;165867;777;76;21;1;20;.952;3600000;0
6066;95405;776;69;35;3;32;.914;3567000;0
6066;149847;777;0;0;0;0;.00nan;0;0
6067;24177;2182;0;0;0;0;.00nan;0;0
6067;146164;2182;67;20;1;19;.950;3600000;0
6067;152201;794;94;46;3;43;.935;3597000;0
6067;158512;794;0;0;0;0;.00nan;0;0
6068;209571;798;50;36;5;31;.861;3589000;0
6068;212959;780;55;27;3;24;.889;3600000;0
6068;-1;780;0;0;0;0;.00nan;0;0
6068;-1;798;0;0;0;0;.00nan;0;0
6069;-1;783;0;0;0;0;.00nan;0;0
6069;62279;778;54;41;6;35;.854;3600000;0
6069;76486;778;0;0;0;0;.00nan;0;0
6069;86422;783;69;28;2;26;.929;3600000;0
6070;24177;2182;100;29;0;29;1.000;3600000;0
6070;212959;780;0;0;0;0;.00nan;0;0
6070;-1;780;86;51;5;46;.902;3600000;0
6070;146164;2182;0;0;0;0;.00nan;0;0
6071;-1;796;0;0;0;0;.00nan;0;0
6071;62279;778;63;35;4;31;.886;3522000;0
6071;62884;796;61;17;2;15;.882;3600000;0
6071;76486;778;0;0;0;0;.00nan;0;0
6072;165867;777;0;0;0;0;.00nan;0;0
6072;190702;784;71;32;2;30;.938;3900000;0
6072;-1;784;0;0;0;0;.00nan;0;0
6072;149847;777;78;26;2;24;.923;3900000;0
6073;183377;904;48;0;0;0;.00nan;274000;0
6073;66924;904;46;40;6;34;.850;3326000;0
6073;152201;794;93;38;2;36;.947;3600000;0
6073;158512;794;0;0;0;0;.00nan;0;0
6074;209571;798;53;33;4;29;.879;3600000;0
6074;-1;783;0;0;0;0;.00nan;0;0
6074;-1;798;0;0;0;0;.00nan;0;0
6074;86422;783;80;21;1;20;.952;3600000;0
6075;209564;776;0;0;0;0;.00nan;0;0
6075;-1;3737;61;16;1;15;.938;3600000;0
6075;78587;3737;0;0;0;0;.00nan;0;0
6075;95405;776;59;37;5;32;.865;3600000;0
6076;190702;784;0;0;0;0;.00nan;0;0
6076;-1;784;55;33;5;28;.848;3549000;0
6076;62279;778;78;33;3;30;.909;3600000;0
6076;76486;778;0;0;0;0;.00nan;0;0
6077;209564;776;0;0;0;0;.00nan;0;0
6077;95405;776;91;20;0;20;1.000;3600000;0
6077;152201;794;43;30;5;25;.833;3600000;0
6077;158512;794;0;0;0;0;.00nan;0;0
6078;209571;798;0;0;0;0;.00nan;0;0
6078;-1;798;85;31;1;30;.968;3600000;0
6078;-1;796;35;5;2;3;.600;336000;0
6078;62884;796;47;35;6;29;.829;3264000;0
6079;183377;904;64;27;2;25;.926;3573000;0
6079;212959;780;0;0;0;0;.00nan;0;0
6079;-1;780;99;34;1;33;.971;3600000;0
6079;66924;904;0;0;0;0;.00nan;0;0
6080;165867;777;75;19;1;18;.947;3600000;0
6080;-1;3737;0;0;0;0;.00nan;0;0
6080;78587;3737;68;22;2;20;.909;3600000;0
6080;149847;777;0;0;0;0;.00nan;0;0
6081;24177;2182;61;28;3;25;.893;3574000;0
6081;-1;783;0;0;0;0;.00nan;0;0
6081;86422;783;74;19;1;18;.947;3600000;0
6081;146164;2182;0;0;0;0;.00nan;0;0
6082;24177;2182;0;0;0;0;.00nan;0;0
6082;-1;796;69;45;4;41;.911;3600000;0
6082;62884;796;0;0;0;0;.00nan;0;0
6082;146164;2182;70;36;3;33;.917;3600000;0
6083;209564;776;0;0;0;0;.00nan;0;0
6083;212959;780;32;27;6;21;.778;1746000;0
6083;-1;780;62;19;1;18;.947;1854000;0
6083;95405;776;90;18;0;18;1.000;3600000;0
6084;165867;777;77;25;2;23;.920;3600000;0
6084;62279;778;29;24;5;19;.792;2294000;0
6084;76486;778;54;4;0;4;1.000;1306000;0
6084;149847;777;0;0;0;0;.00nan;0;0
6085;183377;904;66;31;4;27;.871;3570000;0
6085;-1;783;0;0;0;0;.00nan;0;0
6085;66924;904;0;0;0;0;.00nan;0;0
6085;86422;783;67;24;2;22;.917;3600000;0
6086;209571;798;71;29;2;27;.931;3600000;0
6086;190702;784;42;31;5;26;.839;3600000;0
6086;-1;784;0;0;0;0;.00nan;0;0
6086;-1;798;0;0;0;0;.00nan;0;0
6087;-1;3737;0;0;0;0;.00nan;0;0
6087;78587;3737;56;25;3;22;.880;3600000;0
6087;152201;794;38;30;6;24;.800;2801000;0
6087;158512;794;50;2;0;2;1.000;799000;0
6088;24177;2182;0;0;0;0;.00nan;0;0
6088;190702;784;71;32;3;29;.906;3600000;0
6088;-1;784;0;0;0;0;.00nan;0;0
6088;146164;2182;54;36;5;31;.861;3570000;0
6089;183377;904;75;40;3;37;.925;3561000;0
6089;-1;796;90;38;2;36;.947;3600000;0
6089;62884;796;0;0;0;0;.00nan;0;0
6089;66924;904;0;0;0;0;.00nan;0;0
6090;209564;776;0;0;0;0;.00nan;0;0
6090;-1;783;0;0;0;0;.00nan;0;0
6090;86422;783;52;23;3;20;.870;3600000;0
6090;95405;776;100;29;0;29;1.000;3600000;0
6091;165867;777;28;21;5;16;.762;3600000;0
6091;149847;777;0;0;0;0;.00nan;0;0
6091;152201;794;97;39;1;38;.974;3600000;0
6091;158512;794;0;0;0;0;.00nan;0;0
6092;209571;798;37;31;6;25;.806;2540000;0
6092;-1;798;60;8;0;8;1.000;1060000;0
6092;62279;778;53;21;3;18;.857;3600000;0
6092;76486;778;0;0;0;0;.00nan;0;0
6093;212959;780;0;0;0;0;.00nan;0;0
6093;-1;3737;0;0;0;0;.00nan;0;0
6093;-1;780;67;40;4;36;.900;3537000;0
6093;78587;3737;89;31;2;29;.935;3600000;0
6094;209564;776;0;0;0;0;.00nan;0;0
6094;-1;796;73;26;2;24;.923;3600000;0
6094;62884;796;0;0;0;0;.00nan;0;0
6094;95405;776;55;38;5;33;.868;3600000;0
6095;212959;780;57;39;6;33;.846;3600000;0
6095;-1;780;0;0;0;0;.00nan;0;0
6095;152201;794;80;37;3;34;.919;3600000;0
6095;158512;794;0;0;0;0;.00nan;0;0
6096;24177;2182;0;0;0;0;.00nan;0;0
6096;62279;778;0;0;0;0;.00nan;0;0
6096;76486;778;53;45;7;38;.844;3600000;0
6096;146164;2182;79;31;2;29;.935;3600000;0
6097;209571;798;94;50;3;47;.940;3569000;0
6097;165867;777;0;0;0;0;.00nan;0;0
6097;-1;798;0;0;0;0;.00nan;0;0
6097;149847;777;67;11;1;10;.909;3600000;0
6098;183377;904;0;0;0;0;.00nan;0;0
6098;190702;784;84;27;1;26;.963;3600000;0
6098;-1;784;0;0;0;0;.00nan;0;0
6098;66924;904;59;22;2;20;.909;3543000;0
6099;-1;3737;0;0;0;0;.00nan;0;0
6099;-1;783;0;0;0;0;.00nan;0;0
6099;78587;3737;82;37;3;34;.919;3584000;0
6099;86422;783;79;21;1;20;.952;3600000;0
6100;209564;776;52;10;1;9;.900;1361000;0
6100;190702;784;89;26;1;25;.962;3600000;0
6100;-1;784;0;0;0;0;.00nan;0;0
6100;95405;776;22;26;6;20;.769;2239000;0
6101;209571;798;52;42;6;36;.857;3600000;0
6101;24177;2182;0;0;0;0;.00nan;0;0
6101;-1;798;0;0;0;0;.00nan;0;0
6101;146164;2182;82;12;0;12;1.000;3600000;0
6102;183377;904;81;40;3;37;.925;3600000;0
6102;62279;778;40;29;5;24;.828;3600000;0
6102;66924;904;0;0;0;0;.00nan;0;0
6102;76486;778;0;0;0;0;.00nan;0;0
6103;165867;777;48;19;4;15;.789;3561000;0
6103;212959;780;0;0;0;0;.00nan;0;0
6103;-1;780;75;32;3;29;.906;3600000;0
6103;149847;777;0;0;0;0;.00nan;0;0
6104;-1;3737;0;0;0;0;.00nan;0;0
6104;-1;796;0;0;0;0;.00nan;0;0
6104;62884;796;99;19;0;19;1.000;3600000;0
6104;78587;3737;66;31;3;28;.903;3600000;0
6105;-1;783;0;0;0;0;.00nan;0;0
6105;86422;783;99;23;0;23;1.000;3600000;0
6105;152201;794;98;52;2;50;.962;3513000;0
6105;158512;794;0;0;0;0;.00nan;0;0
6106;209564;776;0;0;0;0;.00nan;0;0
6106;191813;776;86;24;1;23;.958;3600000;0
6106;62279;778;39;23;4;19;.826;3600000;0
6106;76486;778;0;0;0;0;.00nan;0;0
6107;-1;796;0;0;0;0;.00nan;0;0
6107;62884;796;68;28;2;26;.929;3600000;0
6107;152201;794;39;28;5;23;.821;3600000;0
6107;158512;794;0;0;0;0;.00nan;0;0
6108;165867;777;74;29;2;27;.931;3600000;0
6108;24177;2182;42;3;1;2;.667;439000;0
6108;146164;2182;49;41;6;35;.854;3161000;0
6108;149847;777;0;0;0;0;.00nan;0;0
6109;183377;904;93;40;1;39;.975;3600000;0
6109;209571;798;0;0;0;0;.00nan;0;0
6109;-1;798;69;25;2;23;.920;3600000;0
6109;66924;904;0;0;0;0;.00nan;0;0
6110;174017;780;71;46;4;42;.913;3578000;0
6110;-1;780;0;0;0;0;.00nan;0;0
6110;-1;783;0;0;0;0;.00nan;0;0
6110;86422;783;71;24;2;22;.917;3600000;0
6111;190702;784;47;34;5;29;.853;3517000;0
6111;-1;3737;0;0;0;0;.00nan;0;0
6111;-1;784;0;0;0;0;.00nan;0;0
6111;78587;3737;94;40;3;37;.925;3600000;0
6112;183377;904;92;45;3;42;.933;3600000;0
6112;24177;2182;0;0;0;0;.00nan;0;0
6112;66924;904;0;0;0;0;.00nan;0;0
6112;146164;2182;36;17;4;13;.765;3600000;0
6113;190702;784;58;30;4;26;.867;3600000;0
6113;-1;784;0;0;0;0;.00nan;0;0
6113;152201;794;78;52;5;47;.904;3551000;0
6113;158512;794;0;0;0;0;.00nan;0;0
6114;165867;777;41;24;5;19;.792;3626000;0
6114;-1;783;0;0;0;0;.00nan;0;0
6114;86422;783;79;42;4;38;.905;3626000;0
6114;149847;777;0;0;0;0;.00nan;0;0
6115;-1;3737;0;0;0;0;.00nan;0;0
6115;62279;778;72;24;1;23;.958;3600000;0
6115;76486;778;0;0;0;0;.00nan;0;0
6115;78587;3737;81;32;2;30;.938;3551000;0
6116;209564;776;0;0;0;0;.00nan;0;0
6116;209571;798;87;51;4;47;.922;3600000;0
6116;191813;776;97;24;0;24;1.000;3600000;0
6116;-1;798;0;0;0;0;.00nan;0;0
6117;174017;780;38;34;6;28;.824;2241000;0
6117;-1;780;64;10;0;10;1.000;1359000;0
6117;-1;796;0;0;0;0;.00nan;0;0
6117;62884;796;63;23;2;21;.913;3600000;0
6118;209564;776;0;0;0;0;.00nan;0;0
6118;24177;2182;0;0;0;0;.00nan;0;0
6118;191813;776;77;36;3;33;.917;3600000;0
6118;146164;2182;94;36;1;35;.972;3600000;0
6119;62279;778;82;12;0;12;1.000;3600000;0
6119;76486;778;0;0;0;0;.00nan;0;0
6119;152201;794;80;30;2;28;.933;3584000;0
6119;158512;794;0;0;0;0;.00nan;0;0
6120;183377;904;57;39;5;34;.872;2207000;0
6120;165867;777;63;14;1;13;.929;3600000;0
6120;66924;904;57;18;2;16;.889;1393000;0
6120;149847;777;0;0;0;0;.00nan;0;0
6121;174017;780;43;23;4;19;.826;3683000;0
6121;190702;784;78;35;3;32;.914;3683000;0
6121;-1;784;0;0;0;0;.00nan;0;0
6121;-1;780;0;0;0;0;.00nan;0;0
6122;209571;798;33;47;8;39;.830;3600000;0
6122;-1;3737;0;0;0;0;.00nan;0;0
6122;-1;798;0;0;0;0;.00nan;0;0
6122;78587;3737;61;15;1;14;.933;3600000;0
6123;-1;783;0;0;0;0;.00nan;0;0
6123;-1;796;0;0;0;0;.00nan;0;0
6123;62884;796;83;51;4;47;.922;3530000;0
6123;86422;783;80;26;2;24;.923;3600000;0
6124;24177;2182;0;0;0;0;.00nan;0;0
6124;-1;3737;0;0;0;0;.00nan;0;0
6124;78587;3737;57;26;3;23;.885;3600000;0
6124;146164;2182;100;24;0;24;1.000;3600000;0
6125;183377;904;49;39;5;34;.872;3541000;0
6125;209564;776;67;33;3;30;.909;3600000;0
6125;191813;776;0;0;0;0;.00nan;0;0
6125;66924;904;0;0;0;0;.00nan;0;0
6126;165867;777;86;27;1;26;.963;3600000;0
6126;-1;796;0;0;0;0;.00nan;0;0
6126;62884;796;83;44;3;41;.932;3600000;0
6126;149847;777;0;0;0;0;.00nan;0;0
6127;209571;798;63;37;4;33;.892;3556000;0
6127;-1;798;0;0;0;0;.00nan;0;0
6127;152201;794;71;38;3;35;.921;3600000;0
6127;158512;794;0;0;0;0;.00nan;0;0
6128;174017;780;56;33;4;29;.879;3900000;0
6128;-1;780;0;0;0;0;.00nan;0;0
6128;62279;778;67;38;4;34;.895;3863000;0
6128;76486;778;0;0;0;0;.00nan;0;0
6129;190702;784;87;34;2;32;.941;3600000;0
6129;-1;784;0;0;0;0;.00nan;0;0
6129;-1;783;0;0;0;0;.00nan;0;0
6129;86422;783;55;27;4;23;.852;3533000;0
6130;24177;2182;0;0;0;0;.00nan;0;0
6130;146164;2182;55;17;2;15;.882;3600000;0
6130;152201;794;97;62;4;58;.935;3516000;0
6130;158512;794;0;0;0;0;.00nan;0;0
6131;-1;783;0;0;0;0;.00nan;0;0
6131;62279;778;38;27;5;22;.815;3549000;0
6131;76486;778;0;0;0;0;.00nan;0;0
6131;86422;783;51;20;3;17;.850;3600000;0
6132;209564;776;0;0;0;0;.00nan;0;0
6132;165867;777;59;31;4;27;.871;3600000;0
6132;191813;776;100;28;0;28;1.000;3600000;0
6132;149847;777;0;0;0;0;.00nan;0;0
6133;183377;904;0;0;0;0;.00nan;0;0
6133;-1;3737;0;0;0;0;.00nan;0;0
6133;66924;904;61;39;5;34;.872;3530000;0
6133;78587;3737;31;18;4;14;.778;3600000;0
6134;190702;784;63;33;4;29;.879;3724000;0
6134;-1;784;0;0;0;0;.00nan;0;0
6134;-1;796;0;0;0;0;.00nan;0;0
6134;62884;796;69;25;3;22;.880;3724000;0
6135;209571;798;60;27;3;24;.889;3547000;0
6135;174017;780;92;44;2;42;.955;3600000;0
6135;-1;780;0;0;0;0;.00nan;0;0
6135;-1;798;0;0;0;0;.00nan;0;0
6136;165867;777;55;27;4;23;.852;3600000;0
6136;190702;784;55;38;5;33;.868;3544000;0
6136;-1;784;0;0;0;0;.00nan;0;0
6136;149847;777;0;0;0;0;.00nan;0;0
6137;209564;776;0;0;0;0;.00nan;0;0
6137;-1;3737;0;0;0;0;.00nan;0;0
6137;191813;776;80;39;3;36;.923;3600000;0
6137;78587;3737;59;31;4;27;.871;3583000;0
6138;183377;904;66;27;2;25;.926;3600000;0
6138;66924;904;0;0;0;0;.00nan;0;0
6138;152201;794;59;33;4;29;.879;3543000;0
6138;158512;794;0;0;0;0;.00nan;0;0
6139;-1;796;0;0;0;0;.00nan;0;0
6139;62279;778;64;32;3;29;.906;3600000;0
6139;62884;796;90;32;1;31;.969;3600000;0
6139;76486;778;0;0;0;0;.00nan;0;0
6140;174017;780;67;21;2;19;.905;3600000;0
6140;24177;2182;0;0;0;0;.00nan;0;0
6140;-1;780;0;0;0;0;.00nan;0;0
6140;146164;2182;57;33;4;29;.879;3530000;0
6141;209571;798;41;34;5;29;.853;3600000;0
6141;-1;783;0;0;0;0;.00nan;0;0
6141;-1;798;0;0;0;0;.00nan;0;0
6141;86422;783;100;31;1;30;.968;3600000;0
6142;24177;2182;64;27;2;25;.926;3900000;0
6142;-1;783;0;0;0;0;.00nan;0;0
6142;86422;783;95;33;2;31;.939;3900000;0
6142;146164;2182;0;0;0;0;.00nan;0;0
6143;209564;776;0;0;0;0;.00nan;0;0
6143;191813;776;55;24;3;21;.875;3600000;0
6143;152201;794;57;37;4;33;.892;3600000;0
6143;158512;794;0;0;0;0;.00nan;0;0
6144;190702;784;86;31;1;30;.968;3588000;0
6144;-1;784;0;0;0;0;.00nan;0;0
6144;62279;778;95;21;0;21;1.000;3600000;0
6144;76486;778;0;0;0;0;.00nan;0;0
6145;165867;777;0;0;0;0;.00nan;0;0
6145;-1;3737;0;0;0;0;.00nan;0;0
6145;78587;3737;51;31;4;27;.871;3600000;0
6145;149847;777;100;31;0;31;1.000;3600000;0
6146;209571;798;0;0;0;0;.00nan;0;0
6146;-1;798;76;33;2;31;.939;3900000;0
6146;-1;796;0;0;0;0;.00nan;0;0
6146;62884;796;65;19;2;17;.895;3900000;0
6147;183377;904;61;23;3;20;.870;3900000;0
6147;174017;780;93;51;3;48;.941;3900000;0
6147;-1;780;0;0;0;0;.00nan;0;0
6147;66924;904;0;0;0;0;.00nan;0;0
6148;209571;798;0;0;0;0;.00nan;0;0
6148;190702;784;0;0;0;0;.00nan;0;0
6148;-1;784;80;38;3;35;.921;3900000;0
6148;-1;798;58;29;3;26;.897;3900000;0
6149;24177;2182;0;0;0;0;.00nan;0;0
6149;-1;796;0;0;0;0;.00nan;0;0
6149;62884;796;92;32;2;30;.938;3600000;0
6149;146164;2182;52;33;4;29;.879;3525000;0
6150;-1;3737;0;0;0;0;.00nan;0;0
6150;78587;3737;59;21;2;19;.905;3600000;0
6150;152201;794;0;0;0;0;.00nan;0;0
6150;158512;794;82;48;4;44;.917;3586000;0
6151;165867;777;0;0;0;0;.00nan;0;0
6151;62279;778;89;30;1;29;.967;3600000;0
6151;76486;778;0;0;0;0;.00nan;0;0
6151;149847;777;77;26;2;24;.923;3565000;0
6152;209564;776;0;0;0;0;.00nan;0;0
6152;174017;780;81;29;2;27;.931;3600000;0
6152;191813;776;97;39;3;36;.923;3600000;0
6152;-1;780;0;0;0;0;.00nan;0;0
6153;183377;904;55;37;5;32;.865;3600000;0
6153;-1;783;61;22;2;20;.909;2631000;0
6153;66924;904;0;0;0;0;.00nan;0;0
6153;86422;783;16;6;4;2;.333;933000;0
6154;24177;2182;0;0;0;0;.00nan;0;0
6154;190702;784;51;30;4;26;.867;3557000;0
6154;-1;784;0;0;0;0;.00nan;0;0
6154;146164;2182;54;14;2;12;.857;3600000;0
6155;209564;776;0;0;0;0;.00nan;0;0
6155;191813;776;86;37;2;35;.946;3600000;0
6155;-1;783;0;0;0;0;.00nan;0;0
6155;86422;783;59;27;3;24;.889;3600000;0
6156;183377;904;29;27;6;21;.778;3600000;0
6156;-1;796;0;0;0;0;.00nan;0;0
6156;62884;796;64;23;2;21;.913;3600000;0
6156;66924;904;0;0;0;0;.00nan;0;0
6157;209571;798;54;22;3;19;.864;3547000;0
6157;-1;798;0;0;0;0;.00nan;0;0
6157;62279;778;73;25;2;23;.920;3600000;0
6157;76486;778;0;0;0;0;.00nan;0;0
6158;174017;780;55;33;5;28;.848;3888000;0
6158;-1;3737;56;35;4;31;.886;3888000;0
6158;-1;780;0;0;0;0;.00nan;0;0
6158;78587;3737;0;0;0;0;.00nan;0;0
6159;165867;777;86;15;0;15;1.000;3600000;0
6159;149847;777;0;0;0;0;.00nan;0;0
6159;152201;794;55;29;3;26;.897;3600000;0
6159;158512;794;0;0;0;0;.00nan;0;0
6160;209564;776;0;0;0;0;.00nan;0;0
6160;191813;776;41;35;7;28;.800;3600000;0
6160;-1;796;38;22;4;18;.818;1928000;0
6160;62884;796;23;11;4;7;.636;1670000;0
6161;24177;2182;0;0;0;0;.00nan;0;0
6161;62279;778;0;0;0;0;.00nan;0;0
6161;76486;778;66;37;3;34;.919;3600000;0
6161;146164;2182;93;21;0;21;1.000;3600000;0
6162;183377;904;0;0;0;0;.00nan;0;0
6162;190702;784;54;24;3;21;.875;3600000;0
6162;-1;784;0;0;0;0;.00nan;0;0
6162;66924;904;56;29;4;25;.862;3572000;0
6163;209571;798;82;44;2;42;.955;3900000;0
6163;165867;777;56;14;2;12;.857;3900000;0
6163;-1;798;0;0;0;0;.00nan;0;0
6163;149847;777;0;0;0;0;.00nan;0;0
6164;174017;780;27;31;6;25;.806;3575000;0
6164;-1;780;0;0;0;0;.00nan;0;0
6164;152201;794;73;47;5;42;.894;3600000;0
6164;158512;794;0;0;0;0;.00nan;0;0
6165;-1;3737;0;0;0;0;.00nan;0;0
6165;-1;783;0;0;0;0;.00nan;0;0
6165;78587;3737;63;35;3;32;.914;3570000;0
6165;86422;783;79;29;2;27;.931;3600000;0
6166;209564;776;0;0;0;0;.00nan;0;0
6166;190702;784;71;30;3;27;.900;3600000;0
6166;191813;776;55;38;5;33;.868;3571000;0
6166;-1;784;0;0;0;0;.00nan;0;0
6167;183377;904;0;0;0;0;.00nan;0;0
6167;62279;778;68;15;1;14;.933;3600000;0
6167;66924;904;67;42;5;37;.881;3600000;0
6167;76486;778;0;0;0;0;.00nan;0;0
6168;209571;798;67;32;2;30;.938;3564000;0
6168;24177;2182;0;0;0;0;.00nan;0;0
6168;-1;798;0;0;0;0;.00nan;0;0
6168;146164;2182;66;14;1;13;.929;3600000;0
6169;165867;777;64;22;2;20;.909;3600000;0
6169;174017;780;37;30;6;24;.800;2059000;0
6169;-1;780;56;18;2;16;.889;1541000;0
6169;149847;777;0;0;0;0;.00nan;0;0
6170;-1;783;0;0;0;0;.00nan;0;0
6170;86422;783;97;28;1;27;.964;3600000;0
6170;152201;794;78;33;2;31;.939;3556000;0
6170;158512;794;0;0;0;0;.00nan;0;0
6171;-1;3737;0;0;0;0;.00nan;0;0
6171;-1;796;65;35;3;32;.914;3600000;0
6171;62884;796;0;0;0;0;.00nan;0;0
6171;78587;3737;49;40;5;35;.875;3600000;0
6172;165867;777;50;21;3;18;.857;3555000;0
6172;24177;2182;0;0;0;0;.00nan;0;0
6172;146164;2182;85;32;2;30;.938;3600000;0
6172;149847;777;0;0;0;0;.00nan;0;0
6173;-1;796;0;0;0;0;.00nan;0;0
6173;62884;796;67;33;3;30;.909;3600000;0
6173;152201;794;86;55;4;51;.927;3600000;0
6173;158512;794;0;0;0;0;.00nan;0;0
6174;209564;776;0;0;0;0;.00nan;0;0
6174;191813;776;98;49;2;47;.959;3852000;0
6174;62279;778;59;24;3;21;.875;3852000;0
6174;76486;778;0;0;0;0;.00nan;0;0
6175;190702;784;100;46;1;45;.978;3600000;0
6175;-1;3737;0;0;0;0;.00nan;0;0
6175;-1;784;0;0;0;0;.00nan;0;0
6175;78587;3737;59;30;4;26;.867;3600000;0
6176;183377;904;59;34;4;30;.882;3900000;0
6176;209571;798;0;0;0;0;.00nan;0;0
6176;-1;798;70;34;4;30;.882;3900000;0
6176;66924;904;0;0;0;0;.00nan;0;0
6177;174017;780;76;30;2;28;.933;3572000;0
6177;-1;780;0;0;0;0;.00nan;0;0
6177;-1;783;0;0;0;0;.00nan;0;0
6177;86422;783;80;25;1;24;.960;3600000;0
6178;183377;904;70;39;3;36;.923;3600000;0
6178;24177;2182;0;0;0;0;.00nan;0;0
6178;66924;904;0;0;0;0;.00nan;0;0
6178;146164;2182;79;25;2;23;.920;3600000;0
6179;209564;776;0;0;0;0;.00nan;0;0
6179;209571;798;84;34;3;31;.912;3900000;0
6179;-1;798;0;0;0;0;.00nan;0;0
6179;95405;776;65;30;3;27;.900;3900000;0
6180;190702;784;69;29;3;26;.897;3600000;0
6180;-1;784;0;0;0;0;.00nan;0;0
6180;152201;794;78;45;5;40;.889;3597000;0
6180;158512;794;0;0;0;0;.00nan;0;0
6181;174017;780;56;6;0;6;1.000;897000;0
6181;-1;780;19;24;6;18;.750;2703000;0
6181;-1;796;74;26;2;24;.923;3600000;0
6181;62884;796;0;0;0;0;.00nan;0;0
6182;-1;3737;0;0;0;0;.00nan;0;0
6182;62279;778;95;56;2;54;.964;3900000;0
6182;76486;778;0;0;0;0;.00nan;0;0
6182;78587;3737;58;19;2;17;.895;3900000;0
6183;165867;777;65;21;2;19;.905;3600000;0
6183;-1;783;73;41;3;38;.927;3545000;0
6183;86422;783;0;0;0;0;.00nan;0;0
6183;149847;777;0;0;0;0;.00nan;0;0
6184;209564;776;0;0;0;0;.00nan;0;0
6184;24177;2182;0;0;0;0;.00nan;0;0
6184;95405;776;97;38;1;37;.974;3900000;0
6184;146164;2182;87;30;1;29;.967;3900000;0
6185;62279;778;67;24;2;22;.917;3600000;0
6185;76486;778;0;0;0;0;.00nan;0;0
6185;152201;794;39;30;5;25;.833;2150000;0
6185;158512;794;46;15;2;13;.867;1450000;0
6186;183377;904;65;20;1;19;.950;1507000;0
6186;165867;777;54;25;4;21;.840;3600000;0
6186;66924;904;30;27;6;21;.778;2093000;0
6186;149847;777;0;0;0;0;.00nan;0;0
6187;-1;783;0;0;0;0;.00nan;0;0
6187;-1;796;0;0;0;0;.00nan;0;0
6187;62884;796;72;33;3;30;.909;3600000;0
6187;86422;783;66;37;4;33;.892;3544000;0
6188;209571;798;67;25;2;23;.920;3600000;0
6188;-1;3737;0;0;0;0;.00nan;0;0
6188;-1;798;0;0;0;0;.00nan;0;0
6188;78587;3737;61;34;3;31;.912;3547000;0
6189;174017;780;76;34;3;31;.912;3586000;0
6189;190702;784;91;25;1;24;.960;3600000;0
6189;-1;784;0;0;0;0;.00nan;0;0
6189;-1;780;0;0;0;0;.00nan;0;0
6190;190702;784;0;0;0;0;.00nan;0;0
6190;-1;784;53;35;4;31;.886;3600000;0
6190;-1;783;0;0;0;0;.00nan;0;0
6190;86422;783;88;18;0;18;1.000;3600000;0
6191;183377;904;65;29;3;26;.897;3600000;0
6191;209564;776;0;0;0;0;.00nan;0;0
6191;66924;904;0;0;0;0;.00nan;0;0
6191;95405;776;93;40;2;38;.950;3600000;0
6192;165867;777;68;32;3;29;.906;3900000;0
6192;-1;796;0;0;0;0;.00nan;0;0
6192;62884;796;68;26;3;23;.885;3900000;0
6192;149847;777;0;0;0;0;.00nan;0;0
6193;174017;780;63;36;4;32;.889;3600000;0
6193;-1;780;0;0;0;0;.00nan;0;0
6193;62279;778;90;34;1;33;.971;3600000;0
6193;76486;778;0;0;0;0;.00nan;0;0
6194;209571;798;0;0;0;0;.00nan;0;0
6194;-1;798;59;39;5;34;.872;3600000;0
6194;152201;794;80;24;1;23;.958;3600000;0
6194;158512;794;0;0;0;0;.00nan;0;0
6195;24177;2182;0;0;0;0;.00nan;0;0
6195;-1;3737;0;0;0;0;.00nan;0;0
6195;78587;3737;79;21;1;20;.952;3643000;0
6195;146164;2182;81;33;2;31;.939;3643000;0
6196;209564;776;0;0;0;0;.00nan;0;0
6196;165867;777;74;24;2;22;.917;3600000;0
6196;95405;776;72;43;4;39;.907;3578000;0
6196;149847;777;0;0;0;0;.00nan;0;0
6197;24177;2182;0;0;0;0;.00nan;0;0
6197;146164;2182;80;22;1;21;.955;3600000;0
6197;152201;794;93;48;3;45;.938;3595000;0
6197;158512;794;0;0;0;0;.00nan;0;0
6198;190702;784;87;45;3;42;.933;3855000;0
6198;-1;784;0;0;0;0;.00nan;0;0
6198;-1;796;0;0;0;0;.00nan;0;0
6198;62884;796;90;39;2;37;.949;3855000;0
6199;209571;798;48;34;5;29;.853;3600000;0
6199;174017;780;58;24;3;21;.875;3600000;0
6199;-1;780;0;0;0;0;.00nan;0;0
6199;-1;798;0;0;0;0;.00nan;0;0
6200;183377;904;57;35;5;30;.857;3783000;0
6200;-1;3737;0;0;0;0;.00nan;0;0
6200;66924;904;0;0;0;0;.00nan;0;0
6200;78587;3737;53;36;6;30;.833;3758000;0
6201;-1;783;0;0;0;0;.00nan;0;0
6201;62279;778;59;30;3;27;.900;3600000;0
6201;76486;778;0;0;0;0;.00nan;0;0
6201;86422;783;93;31;2;29;.935;3600000;0
6202;209564;776;0;0;0;0;.00nan;0;0
6202;174017;780;45;26;5;21;.808;1975000;0
6202;-1;780;63;19;1;18;.947;1625000;0
6202;95405;776;69;27;2;25;.926;3600000;0
6203;165867;777;71;33;3;30;.909;3600000;0
6203;24177;2182;0;0;0;0;.00nan;0;0
6203;146164;2182;44;31;5;26;.839;3570000;0
6203;149847;777;0;0;0;0;.00nan;0;0
6204;-1;796;0;0;0;0;.00nan;0;0
6204;62884;796;67;37;4;33;.892;3600000;0
6204;152201;794;74;44;5;39;.886;3584000;0
6204;158512;794;0;0;0;0;.00nan;0;0
6205;183377;904;0;0;0;0;.00nan;0;0
6205;209571;798;61;27;2;25;.926;3900000;0
6205;-1;798;0;0;0;0;.00nan;0;0
6205;66924;904;81;31;2;29;.935;3900000;0
6206;-1;3737;0;0;0;0;.00nan;0;0
6206;62279;778;48;25;3;22;.880;3540000;0
6206;76486;778;0;0;0;0;.00nan;0;0
6206;78587;3737;89;33;1;32;.970;3600000;0
6207;190702;784;79;40;3;37;.925;3600000;0
6207;-1;784;0;0;0;0;.00nan;0;0
6207;-1;783;0;0;0;0;.00nan;0;0
6207;86422;783;42;29;5;24;.828;3553000;0
6208;183377;904;84;32;1;31;.969;3600000;0
6208;190702;784;31;9;3;6;.667;594000;0
6208;-1;784;49;22;3;19;.864;3006000;0
6208;66924;904;0;0;0;0;.00nan;0;0
6209;174017;780;79;30;2;28;.933;3600000;0
6209;24177;2182;66;24;3;21;.875;3578000;0
6209;-1;780;0;0;0;0;.00nan;0;0
6209;146164;2182;0;0;0;0;.00nan;0;0
6210;209564;776;0;0;0;0;.00nan;0;0
6210;165867;777;0;0;0;0;.00nan;0;0
6210;95405;776;55;24;3;21;.875;3600000;0
6210;149847;777;91;18;0;18;1.000;3600000;0
6211;-1;796;0;0;0;0;.00nan;0;0
6211;62279;778;100;43;2;41;.953;3600000;0
6211;62884;796;43;24;4;20;.833;3600000;0
6211;76486;778;0;0;0;0;.00nan;0;0
6212;209571;798;0;0;0;0;.00nan;0;0
6212;-1;783;0;0;0;0;.00nan;0;0
6212;-1;798;83;27;1;26;.963;3600000;0
6212;86422;783;58;27;3;24;.889;3545000;0
6213;-1;3737;0;0;0;0;.00nan;0;0
6213;78587;3737;54;26;3;23;.885;3588000;0
6213;152201;794;100;43;2;41;.953;3600000;0
6213;158512;794;0;0;0;0;.00nan;0;0
6214;24177;2182;0;0;0;0;.00nan;0;0
6214;-1;776;0;0;0;0;.00nan;0;0
6214;95405;776;56;31;4;27;.871;3574000;0
6214;146164;2182;67;31;3;28;.903;3600000;0
6215;62279;778;63;14;1;13;.929;3600000;0
6215;76486;778;0;0;0;0;.00nan;0;0
6215;152201;794;66;51;6;45;.882;3600000;0
6215;158512;794;0;0;0;0;.00nan;0;0
6216;-1;3737;0;0;0;0;.00nan;0;0
6216;-1;796;67;28;2;26;.929;3900000;0
6216;62884;796;0;0;0;0;.00nan;0;0
6216;78587;3737;57;24;2;22;.917;3900000;0
6217;190702;784;94;43;2;41;.953;3600000;0
6217;-1;784;0;0;0;0;.00nan;0;0
6217;-1;798;39;9;2;7;.778;1255000;0
6217;146192;798;31;25;5;20;.800;2345000;0
6218;165867;777;0;0;0;0;.00nan;0;0
6218;174017;780;94;59;4;55;.932;3600000;0
6218;-1;780;0;0;0;0;.00nan;0;0
6218;149847;777;71;18;1;17;.944;3600000;0
6219;183377;904;91;45;3;42;.933;3586000;0
6219;-1;783;0;0;0;0;.00nan;0;0
6219;66924;904;0;0;0;0;.00nan;0;0
6219;86422;783;73;26;2;24;.923;3600000;0
6220;190702;784;81;49;5;44;.898;3600000;0
6220;-1;784;0;0;0;0;.00nan;0;0
6220;-1;783;0;0;0;0;.00nan;0;0
6220;86422;783;100;28;0;28;1.000;3600000;0
6221;183377;904;87;26;1;25;.962;3600000;0
6221;-1;798;0;0;0;0;.00nan;0;0
6221;66924;904;0;0;0;0;.00nan;0;0
6221;146192;798;75;29;2;27;.931;3600000;0
6222;165867;777;72;22;2;20;.909;3900000;0
6222;24177;2182;0;0;0;0;.00nan;0;0
6222;146164;2182;97;37;2;35;.946;3900000;0
6222;149847;777;0;0;0;0;.00nan;0;0
6223;-1;796;0;0;0;0;.00nan;0;0
6223;62884;796;82;25;1;24;.960;3600000;0
6223;152201;794;48;39;6;33;.846;3192000;0
6223;158512;794;42;3;1;2;.667;408000;0
6224;-1;3737;0;0;0;0;.00nan;0;0
6224;62279;778;28;12;4;8;.667;3683000;0
6224;76486;778;0;0;0;0;.00nan;0;0
6224;78587;3737;62;45;5;40;.889;3683000;0
6225;174017;780;30;32;6;26;.813;3600000;0
6225;-1;776;0;0;0;0;.00nan;0;0
6225;-1;780;0;0;0;0;.00nan;0;0
6225;95405;776;67;27;3;24;.889;3600000;0
6226;183377;904;71;20;1;19;.950;3600000;0
6226;190702;784;100;36;0;36;1.000;3600000;0
6226;-1;784;0;0;0;0;.00nan;0;0
6226;66924;904;0;0;0;0;.00nan;0;0
6227;165867;777;74;33;2;31;.939;3564000;0
6227;-1;776;0;0;0;0;.00nan;0;0
6227;95405;776;83;31;1;30;.968;3600000;0
6227;149847;777;0;0;0;0;.00nan;0;0
6228;-1;796;0;0;0;0;.00nan;0;0
6228;62279;778;53;37;5;32;.865;3600000;0
6228;62884;796;83;32;2;30;.938;3600000;0
6228;76486;778;0;0;0;0;.00nan;0;0
6229;-1;3737;0;0;0;0;.00nan;0;0
6229;78587;3737;72;23;2;21;.913;3600000;0
6229;152201;794;0;0;0;0;.00nan;0;0
6229;158512;794;82;40;3;37;.925;3578000;0
6230;174017;780;96;40;2;38;.950;3600000;0
6230;24177;2182;0;0;0;0;.00nan;0;0
6230;-1;780;0;0;0;0;.00nan;0;0
6230;146164;2182;70;31;3;28;.903;3546000;0
6231;-1;783;0;0;0;0;.00nan;0;0
6231;-1;798;0;0;0;0;.00nan;0;0
6231;86422;783;66;27;3;24;.889;3600000;0
6231;146192;798;53;40;5;35;.875;3594000;0
6232;183377;904;91;38;2;36;.947;3600000;0
6232;-1;783;0;0;0;0;.00nan;0;0
6232;66924;904;0;0;0;0;.00nan;0;0
6232;86422;783;76;23;1;22;.957;3600000;0
6233;24177;2182;0;0;0;0;.00nan;0;0
6233;-1;776;0;0;0;0;.00nan;0;0
6233;95405;776;46;29;4;25;.862;3600000;0
6233;146164;2182;75;18;1;17;.944;3600000;0
6234;165867;777;50;23;3;20;.870;3600000;0
6234;174017;780;49;42;7;35;.833;3600000;0
6234;-1;780;0;0;0;0;.00nan;0;0
6234;149847;777;0;0;0;0;.00nan;0;0
6235;62279;778;0;0;0;0;.00nan;0;0
6235;76486;778;90;15;0;15;1.000;3600000;0
6235;152201;794;86;40;3;37;.925;3600000;0
6235;158512;794;0;0;0;0;.00nan;0;0
6236;190702;784;100;33;0;33;1.000;3600000;0
6236;-1;784;0;0;0;0;.00nan;0;0
6236;-1;798;0;0;0;0;.00nan;0;0
6236;146192;798;70;23;1;22;.957;3588000;0
6237;-1;3737;61;26;3;23;.885;3547000;0
6237;-1;796;0;0;0;0;.00nan;0;0
6237;62884;796;62;17;2;15;.882;3600000;0
6237;78587;3737;0;0;0;0;.00nan;0;0
6238;174017;780;26;33;7;26;.788;2202000;0
6238;24177;2182;48;19;3;16;.842;3600000;0
6238;-1;780;55;19;2;17;.895;1398000;0
6238;146164;2182;0;0;0;0;.00nan;0;0
6239;-1;3737;0;0;0;0;.00nan;0;0
6239;-1;776;0;0;0;0;.00nan;0;0
6239;78587;3737;77;28;3;25;.893;3600000;0
6239;95405;776;60;30;4;26;.867;3561000;0
6240;183377;904;0;0;0;0;.00nan;0;0
6240;66924;904;60;29;3;26;.897;3600000;0
6240;152201;794;85;26;1;25;.962;3600000;0
6240;158512;794;0;0;0;0;.00nan;0;0
6241;-1;796;0;0;0;0;.00nan;0;0
6241;62279;778;100;22;0;22;1.000;3600000;0
6241;62884;796;79;42;4;38;.905;3600000;0
6241;76486;778;0;0;0;0;.00nan;0;0
6242;209571;798;0;0;0;0;.00nan;0;0
6242;-1;783;0;0;0;0;.00nan;0;0
6242;86422;783;92;26;1;25;.962;3600000;0
6242;146192;798;36;31;6;25;.806;3600000;0
6243;165867;777;100;24;0;24;1.000;3600000;0
6243;190702;784;47;37;6;31;.838;2510000;0
6243;-1;784;64;17;1;16;.941;1090000;0
6243;149847;777;0;0;0;0;.00nan;0;0
6244;-1;776;0;0;0;0;.00nan;0;0
6244;95405;776;66;21;2;19;.905;3900000;0
6244;152201;794;76;30;2;28;.933;3900000;0
6244;158512;794;0;0;0;0;.00nan;0;0
6245;183377;904;46;21;3;18;.857;3600000;0
6245;174017;780;60;38;4;34;.895;3598000;0
6245;-1;780;0;0;0;0;.00nan;0;0
6245;66924;904;0;0;0;0;.00nan;0;0
6246;209571;798;0;0;0;0;.00nan;0;0
6246;-1;796;20;26;6;20;.769;2848000;0
6246;62884;796;59;7;0;7;1.000;677000;0
6246;146192;798;59;35;4;31;.886;3600000;0
6247;190702;784;78;35;3;32;.914;3790000;0
6247;-1;784;0;0;0;0;.00nan;0;0
6247;62279;778;58;29;4;25;.862;3790000;0
6247;76486;778;0;0;0;0;.00nan;0;0
6248;165867;777;53;27;3;24;.889;3575000;0
6248;-1;3737;0;0;0;0;.00nan;0;0
6248;78587;3737;87;37;2;35;.946;3600000;0
6248;149847;777;0;0;0;0;.00nan;0;0
6249;24177;2182;0;0;0;0;.00nan;0;0
6249;-1;783;0;0;0;0;.00nan;0;0
6249;86422;783;71;35;4;31;.886;3551000;0
6249;146164;2182;47;12;2;10;.833;3600000;0
6250;183377;904;0;0;0;0;.00nan;0;0
6250;-1;783;0;0;0;0;.00nan;0;0
6250;66924;904;73;39;3;36;.923;3550000;0
6250;86422;783;73;24;2;22;.917;3600000;0
6251;174017;780;64;19;1;18;.947;3600000;0
6251;-1;776;0;0;0;0;.00nan;0;0
6251;-1;780;0;0;0;0;.00nan;0;0
6251;95405;776;43;25;5;20;.800;3600000;0
6252;165867;777;92;33;1;32;.970;3600000;0
6252;62279;778;65;54;6;48;.889;3600000;0
6252;76486;778;0;0;0;0;.00nan;0;0
6252;149847;777;0;0;0;0;.00nan;0;0
6253;24177;2182;0;0;0;0;.00nan;0;0
6253;-1;796;0;0;0;0;.00nan;0;0
6253;62884;796;84;30;2;28;.933;3600000;0
6253;146164;2182;63;30;3;27;.900;3543000;0
6254;209571;798;0;0;0;0;.00nan;0;0
6254;190702;784;89;54;4;50;.926;3576000;0
6254;-1;784;0;0;0;0;.00nan;0;0
6254;146192;798;80;27;3;24;.889;3600000;0
6255;-1;3737;0;0;0;0;.00nan;0;0
6255;78587;3737;90;25;1;24;.960;3600000;0
6255;152201;794;65;31;3;28;.903;3538000;0
6255;158512;794;0;0;0;0;.00nan;0;0
6256;165867;777;34;12;3;9;.750;3600000;0
6256;149847;777;0;0;0;0;.00nan;0;0
6256;152201;794;58;49;6;43;.878;2565000;0
6256;158512;794;61;17;1;16;.941;1035000;0
6257;209571;798;0;0;0;0;.00nan;0;0
6257;62279;778;62;17;1;16;.941;3600000;0
6257;76486;778;0;0;0;0;.00nan;0;0
6257;146192;798;61;42;5;37;.881;3600000;0
6258;183377;904;88;34;3;31;.912;3600000;0
6258;-1;796;64;13;1;12;.923;686000;0
6258;62884;796;36;28;5;23;.821;2914000;0
6258;66924;904;0;0;0;0;.00nan;0;0
6259;24177;2182;0;0;0;0;.00nan;0;0
6259;190702;784;39;19;4;15;.789;930000;0
6259;-1;784;66;27;3;24;.889;2670000;0
6259;146164;2182;80;37;3;34;.919;3600000;0
6260;174017;780;0;0;0;0;.00nan;0;0
6260;-1;3737;0;0;0;0;.00nan;0;0
6260;-1;780;62;39;4;35;.897;3900000;0
6260;78587;3737;52;31;4;27;.871;3900000;0
6261;-1;776;0;0;0;0;.00nan;0;0
6261;-1;783;0;0;0;0;.00nan;0;0
6261;86422;783;48;28;4;24;.857;3572000;0
6261;95405;776;44;22;3;19;.864;3600000;0
6262;183377;904;0;0;0;0;.00nan;0;0
6262;190702;784;52;24;3;21;.875;3600000;0
6262;-1;784;0;0;0;0;.00nan;0;0
6262;66924;904;64;32;4;28;.875;3600000;0
6263;24177;2182;0;0;0;0;.00nan;0;0
6263;62279;778;81;42;4;38;.905;3555000;0
6263;76486;778;0;0;0;0;.00nan;0;0
6263;146164;2182;73;28;2;26;.929;3600000;0
6264;209571;798;0;0;0;0;.00nan;0;0
6264;165867;777;77;27;3;24;.889;3621000;0
6264;146192;798;75;23;2;21;.913;3621000;0
6264;149847;777;0;0;0;0;.00nan;0;0
6265;-1;776;0;0;0;0;.00nan;0;0
6265;-1;796;0;0;0;0;.00nan;0;0
6265;62884;796;81;29;2;27;.931;3600000;0
6265;95405;776;47;38;5;33;.868;3600000;0
6266;174017;780;64;25;2;23;.920;3600000;0
6266;-1;780;0;0;0;0;.00nan;0;0
6266;152201;794;67;39;4;35;.897;3582000;0
6266;158512;794;0;0;0;0;.00nan;0;0
6267;-1;3737;0;0;0;0;.00nan;0;0
6267;-1;783;0;0;0;0;.00nan;0;0
6267;78587;3737;39;24;4;20;.833;3574000;0
6267;86422;783;58;18;2;16;.889;3600000;0
6268;190702;784;75;36;3;33;.917;3600000;0
6268;-1;784;0;0;0;0;.00nan;0;0
6268;-1;776;78;24;2;22;.917;3600000;0
6268;95405;776;0;0;0;0;.00nan;0;0
6269;-1;3737;0;0;0;0;.00nan;0;0
6269;-1;796;84;34;2;32;.941;3600000;0
6269;62884;796;0;0;0;0;.00nan;0;0
6269;78587;3737;99;48;1;47;.979;3600000;0
6270;183377;904;82;39;3;36;.923;3900000;0
6270;62279;778;68;30;3;27;.900;3900000;0
6270;66924;904;0;0;0;0;.00nan;0;0
6270;76486;778;0;0;0;0;.00nan;0;0
6271;209571;798;0;0;0;0;.00nan;0;0
6271;24177;2182;0;0;0;0;.00nan;0;0
6271;146164;2182;69;22;2;20;.909;3900000;0
6271;146192;798;93;42;2;40;.952;3900000;0
6272;165867;777;95;27;1;26;.963;3900000;0
6272;174017;780;96;44;1;43;.977;3900000;0
6272;-1;780;0;0;0;0;.00nan;0;0
6272;149847;777;0;0;0;0;.00nan;0;0
6273;-1;783;0;0;0;0;.00nan;0;0
6273;86422;783;45;37;6;31;.838;3600000;0
6273;152201;794;85;42;3;39;.929;3600000;0
6273;158512;794;0;0;0;0;.00nan;0;0
6274;-1;776;0;0;0;0;.00nan;0;0
6274;62279;778;76;40;4;36;.900;3600000;0
6274;76486;778;0;0;0;0;.00nan;0;0
6274;95405;776;74;24;1;23;.958;3600000;0
6275;165867;777;74;20;1;19;.950;3600000;0
6275;24177;2182;0;0;0;0;.00nan;0;0
6275;146164;2182;72;39;3;36;.923;3558000;0
6275;149847;777;0;0;0;0;.00nan;0;0
6276;183377;904;66;21;2;19;.905;3559000;0
6276;209571;798;0;0;0;0;.00nan;0;0
6276;66924;904;0;0;0;0;.00nan;0;0
6276;146192;798;100;40;0;40;1.000;3600000;0
6277;-1;796;0;0;0;0;.00nan;0;0
6277;62884;796;89;21;0;21;1.000;3600000;0
6277;152201;794;86;35;2;33;.943;3556000;0
6277;158512;794;0;0;0;0;.00nan;0;0
6278;174017;780;68;43;4;39;.907;3599000;0
6278;-1;780;0;0;0;0;.00nan;0;0
6278;-1;783;0;0;0;0;.00nan;0;0
6278;86422;783;59;21;2;19;.905;3600000;0
6279;190702;784;63;21;2;19;.905;3558000;0
6279;-1;3737;78;28;1;27;.964;3600000;0
6279;-1;784;0;0;0;0;.00nan;0;0
6279;78587;3737;0;0;0;0;.00nan;0;0
6280;190702;784;34;36;7;29;.806;3248000;0
6280;-1;784;49;2;0;2;1.000;352000;0
6280;152201;794;70;30;3;27;.900;3600000;0
6280;158512;794;0;0;0;0;.00nan;0;0
6281;183377;904;60;33;4;29;.879;3585000;0
6281;24177;2182;58;26;3;23;.885;3600000;0
6281;62884;2182;0;0;0;0;.00nan;0;0
6281;66924;904;0;0;0;0;.00nan;0;0
6282;174017;780;54;41;6;35;.854;3600000;0
6282;-1;780;0;0;0;0;.00nan;0;0
6282;-1;796;0;0;0;0;.00nan;0;0
6282;146164;796;68;25;2;23;.920;3600000;0
6283;-1;3737;0;0;0;0;.00nan;0;0
6283;62279;778;72;35;3;32;.914;3544000;0
6283;76486;778;0;0;0;0;.00nan;0;0
6283;78587;3737;88;29;1;28;.966;3600000;0
6284;209571;798;0;0;0;0;.00nan;0;0
6284;-1;776;0;0;0;0;.00nan;0;0
6284;95405;776;53;20;3;17;.850;3600000;0
6284;146192;798;57;35;4;31;.886;3600000;0
6285;165867;777;50;18;3;15;.833;3600000;0
6285;-1;783;61;34;4;30;.882;2046000;0
6285;86422;783;67;10;0;10;1.000;1554000;0
6285;149847;777;0;0;0;0;.00nan;0;0
6286;24177;2182;0;0;0;0;.00nan;0;0
6286;-1;776;0;0;0;0;.00nan;0;0
6286;62884;2182;51;27;4;23;.852;3600000;0
6286;95405;776;96;39;1;38;.974;3600000;0
6287;62279;778;0;0;0;0;.00nan;0;0
6287;76486;778;63;17;1;16;.941;3600000;0
6287;152201;794;67;50;6;44;.880;3083000;0
6287;158512;794;44;6;1;5;.833;517000;0
6288;183377;904;89;46;3;43;.935;3544000;0
6288;165867;777;0;0;0;0;.00nan;0;0
6288;66924;904;0;0;0;0;.00nan;0;0
6288;149847;777;64;16;1;15;.938;3600000;0
6289;-1;783;0;0;0;0;.00nan;0;0
6289;-1;796;0;0;0;0;.00nan;0;0
6289;86422;783;74;31;3;28;.903;3691000;0
6289;146164;796;59;20;2;18;.900;3691000;0
6290;174017;780;69;26;2;24;.923;3600000;0
6290;190702;784;70;32;3;29;.906;3558000;0
6290;-1;784;0;0;0;0;.00nan;0;0
6290;-1;780;0;0;0;0;.00nan;0;0
6291;209571;798;0;0;0;0;.00nan;0;0
6291;-1;3737;0;0;0;0;.00nan;0;0
6291;78587;3737;45;37;6;31;.838;3600000;0
6291;146192;798;83;23;1;22;.957;3600000;0
6292;183377;904;51;34;5;29;.853;3559000;0
6292;-1;776;0;0;0;0;.00nan;0;0
6292;66924;904;0;0;0;0;.00nan;0;0
6292;95405;776;56;24;3;21;.875;3600000;0
6293;165867;777;62;31;4;27;.871;3600000;0
6293;-1;796;0;0;0;0;.00nan;0;0
6293;146164;796;93;35;1;34;.971;3600000;0
6293;149847;777;0;0;0;0;.00nan;0;0
6294;209571;798;0;0;0;0;.00nan;0;0
6294;146192;798;57;11;1;10;.909;3600000;0
6294;152201;794;80;48;4;44;.917;3600000;0
6294;158512;794;0;0;0;0;.00nan;0;0
6295;174017;780;83;45;3;42;.933;3900000;0
6295;-1;780;0;0;0;0;.00nan;0;0
6295;62279;778;70;33;3;30;.909;3900000;0
6295;76486;778;0;0;0;0;.00nan;0;0
6296;24177;2182;0;0;0;0;.00nan;0;0
6296;-1;3737;0;0;0;0;.00nan;0;0
6296;62884;2182;33;19;4;15;.789;3528000;0
6296;78587;3737;71;26;2;24;.923;3600000;0
6297;190702;784;51;28;4;24;.857;3535000;0
6297;-1;784;0;0;0;0;.00nan;0;0
6297;-1;783;0;0;0;0;.00nan;0;0
6297;86422;783;87;33;2;31;.939;3600000;0
6298;24177;2182;0;0;0;0;.00nan;0;0
6298;62884;2182;54;21;3;18;.857;3900000;0
6298;152201;794;98;49;3;46;.939;3900000;0
6298;158512;794;0;0;0;0;.00nan;0;0
6299;-1;783;0;0;0;0;.00nan;0;0
6299;62279;778;66;33;4;29;.879;3558000;0
6299;76486;778;0;0;0;0;.00nan;0;0
6299;86422;783;60;27;3;24;.889;3600000;0
6300;165867;777;81;28;2;26;.929;3600000;0
6300;-1;776;0;0;0;0;.00nan;0;0
6300;95405;776;39;46;7;39;.848;3600000;0
6300;149847;777;0;0;0;0;.00nan;0;0
6301;190702;784;52;22;2;20;.909;3900000;0
6301;-1;784;0;0;0;0;.00nan;0;0
6301;-1;796;0;0;0;0;.00nan;0;0
6301;146164;796;87;34;2;32;.941;3900000;0
6302;209571;798;0;0;0;0;.00nan;0;0
6302;174017;780;64;40;4;36;.900;3515000;0
6302;-1;780;0;0;0;0;.00nan;0;0
6302;146192;798;64;20;2;18;.900;3600000;0
6303;183377;904;66;35;4;31;.886;3600000;0
6303;-1;3737;0;0;0;0;.00nan;0;0
6303;66924;904;0;0;0;0;.00nan;0;0
6303;78587;3737;84;23;1;22;.957;3600000;0
6304;165867;777;94;27;1;26;.963;3600000;0
6304;190702;784;76;43;3;40;.930;3518000;0
6304;207726;777;0;0;0;0;.00nan;0;0
6304;-1;784;0;0;0;0;.00nan;0;0
6305;62279;778;67;31;4;27;.871;3600000;0
6305;76486;778;0;0;0;0;.00nan;0;0
6305;146164;796;0;0;0;0;.00nan;0;0
6305;149847;796;100;30;0;30;1.000;3600000;0
6306;183377;904;75;23;1;22;.957;3600000;0
6306;66924;904;0;0;0;0;.00nan;0;0
6306;152201;794;77;40;3;37;.925;3516000;0
6306;158512;794;0;0;0;0;.00nan;0;0
6307;174017;780;0;0;0;0;.00nan;0;0
6307;24177;2182;0;0;0;0;.00nan;0;0
6307;-1;780;73;27;2;25;.926;3600000;0
6307;62884;2182;43;27;4;23;.852;3553000;0
6308;-1;3737;0;0;0;0;.00nan;0;0
6308;-1;776;44;4;1;3;.750;404000;0
6308;78587;3737;72;29;3;26;.897;3600000;0
6308;95405;776;42;33;6;27;.818;3196000;0
6309;209571;798;0;0;0;0;.00nan;0;0
6309;-1;783;0;0;0;0;.00nan;0;0
6309;86422;783;85;24;1;23;.958;3600000;0
6309;146192;798;72;41;4;37;.902;3600000;0
6310;183377;904;0;0;0;0;.00nan;0;0
6310;174017;780;82;35;2;33;.943;3565000;0
6310;-1;780;0;0;0;0;.00nan;0;0
6310;66924;904;85;25;1;24;.960;3600000;0
6311;24177;2182;0;0;0;0;.00nan;0;0
6311;-1;783;0;0;0;0;.00nan;0;0
6311;62884;2182;100;31;0;31;1.000;3600000;0
6311;86422;783;55;16;2;14;.875;3565000;0
6312;-1;776;0;0;0;0;.00nan;0;0
6312;95405;776;74;27;2;25;.926;3600000;0
6312;152201;794;74;38;3;35;.921;3579000;0
6312;158512;794;0;0;0;0;.00nan;0;0
6313;165867;777;69;18;1;17;.944;3600000;0
6313;207726;777;0;0;0;0;.00nan;0;0
6313;-1;3737;0;0;0;0;.00nan;0;0
6313;78587;3737;97;43;2;41;.953;3563000;0
6314;209571;798;0;0;0;0;.00nan;0;0
6314;146164;796;0;0;0;0;.00nan;0;0
6314;146192;798;68;32;3;29;.906;3600000;0
6314;149847;796;75;29;2;27;.931;3600000;0
6315;190702;784;51;31;4;27;.871;3549000;0
6315;-1;784;0;0;0;0;.00nan;0;0
6315;62279;778;71;27;2;25;.926;3600000;0
6315;76486;778;0;0;0;0;.00nan;0;0
6316;-1;3737;0;0;0;0;.00nan;0;0
6316;78587;3737;96;19;0;19;1.000;3600000;0
6316;152201;794;88;40;3;37;.925;3600000;0
6316;158512;794;0;0;0;0;.00nan;0;0
6317;165867;777;54;17;2;15;.882;3600000;0
6317;207726;777;0;0;0;0;.00nan;0;0
6317;62279;778;49;37;5;32;.865;3600000;0
6317;76486;778;0;0;0;0;.00nan;0;0
6318;24177;2182;0;0;0;0;.00nan;0;0
6318;62884;2182;89;27;1;26;.963;3600000;0
6318;146164;796;0;0;0;0;.00nan;0;0
6318;149847;796;46;17;3;14;.824;3565000;0
6319;209571;798;0;0;0;0;.00nan;0;0
6319;190702;784;0;0;0;0;.00nan;0;0
6319;-1;784;54;28;4;24;.857;3814000;0
6319;146192;798;60;28;3;25;.893;3814000;0
6320;174017;780;81;26;1;25;.962;3600000;0
6320;-1;776;0;0;0;0;.00nan;0;0
6320;-1;780;0;0;0;0;.00nan;0;0
6320;95405;776;52;27;4;23;.852;3600000;0
6321;183377;904;84;29;1;28;.966;3600000;0
6321;-1;783;0;0;0;0;.00nan;0;0
6321;66924;904;0;0;0;0;.00nan;0;0
6321;86422;783;69;26;3;23;.885;3519000;0
6322;24177;2182;0;0;0;0;.00nan;0;0
6322;190702;784;55;33;4;29;.879;3600000;0
6322;-1;784;0;0;0;0;.00nan;0;0
6322;62884;2182;100;22;0;22;1.000;3600000;0
6323;165867;777;60;13;1;12;.923;3600000;0
6323;207726;777;0;0;0;0;.00nan;0;0
6323;152201;794;26;6;3;3;.500;425000;0
6323;158512;794;84;44;3;41;.932;3175000;0
6324;183377;904;0;0;0;0;.00nan;0;0
6324;66924;904;54;29;4;25;.862;3548000;0
6324;146164;796;0;0;0;0;.00nan;0;0
6324;149847;796;71;25;2;23;.920;3600000;0
6325;209571;798;0;0;0;0;.00nan;0;0
6325;62279;778;100;36;0;36;1.000;3600000;0
6325;76486;778;0;0;0;0;.00nan;0;0
6325;146192;798;71;23;2;21;.913;3565000;0
6326;174017;780;29;24;6;18;.750;2021000;0
6326;-1;3737;0;0;0;0;.00nan;0;0
6326;-1;780;45;15;2;13;.867;1563000;0
6326;78587;3737;27;26;6;20;.769;3600000;0
6327;-1;776;55;13;1;12;.923;674000;0
6327;-1;783;0;0;0;0;.00nan;0;0
6327;86422;783;73;26;2;24;.923;3600000;0
6327;95405;776;22;25;6;19;.760;2926000;0
6328;183377;904;6;23;7;16;.696;2445000;0
6328;190702;784;91;43;2;41;.953;3600000;0
6328;-1;784;0;0;0;0;.00nan;0;0
6328;66924;904;62;8;0;8;1.000;1155000;0
6329;24177;2182;0;0;0;0;.00nan;0;0
6329;62279;778;79;46;3;43;.935;3600000;0
6329;62884;2182;34;25;5;20;.800;3544000;0
6329;76486;778;0;0;0;0;.00nan;0;0
6330;-1;776;0;0;0;0;.00nan;0;0
6330;95405;776;40;27;4;23;.852;3543000;0
6330;146164;796;0;0;0;0;.00nan;0;0
6330;149847;796;62;31;3;28;.903;3600000;0
6331;209571;798;0;0;0;0;.00nan;0;0
6331;165867;777;60;28;4;24;.857;3610000;0
6331;207726;777;0;0;0;0;.00nan;0;0
6331;146192;798;65;32;3;29;.906;3610000;0
6332;174017;780;100;43;0;43;1.000;3600000;0
6332;-1;780;0;0;0;0;.00nan;0;0
6332;152201;794;71;37;4;33;.892;3600000;0
6332;158512;794;0;0;0;0;.00nan;0;0
6333;-1;3737;0;0;0;0;.00nan;0;0
6333;-1;783;0;0;0;0;.00nan;0;0
6333;78587;3737;81;26;1;25;.962;3861000;0
6333;86422;783;96;35;1;34;.971;3900000;0
6334;190702;784;51;27;4;23;.852;3600000;0
6334;-1;784;0;0;0;0;.00nan;0;0
6334;-1;776;43;27;5;22;.815;3589000;0
6334;95405;776;0;0;0;0;.00nan;0;0
6335;-1;783;0;0;0;0;.00nan;0;0
6335;86422;783;58;14;2;12;.857;3600000;0
6335;152201;794;81;44;4;40;.909;3517000;0
6335;158512;794;0;0;0;0;.00nan;0;0
6336;165867;777;74;20;1;19;.950;3600000;0
6336;174017;780;68;44;4;40;.909;3600000;0
6336;207726;777;0;0;0;0;.00nan;0;0
6336;-1;780;0;0;0;0;.00nan;0;0
6337;183377;904;0;0;0;0;.00nan;0;0
6337;62279;778;54;33;5;28;.848;2872000;0
6337;66924;904;71;38;3;35;.921;3600000;0
6337;76486;778;35;5;2;3;.600;728000;0
6338;-1;3737;0;0;0;0;.00nan;0;0
6338;78587;3737;58;30;4;26;.867;3549000;0
6338;146164;796;0;0;0;0;.00nan;0;0
6338;149847;796;79;34;2;32;.941;3600000;0
6339;209571;798;0;0;0;0;.00nan;0;0
6339;24177;2182;0;0;0;0;.00nan;0;0
6339;62884;2182;82;27;1;26;.963;3600000;0
6339;146192;798;78;38;3;35;.921;3574000;0
6340;146164;796;0;0;0;0;.00nan;0;0
6340;149847;796;61;18;2;16;.889;3600000;0
6340;152201;794;59;35;5;30;.857;3600000;0
6340;158512;794;0;0;0;0;.00nan;0;0
6341;193859;777;0;0;0;0;.00nan;0;0
6341;24177;2182;69;42;4;38;.905;3900000;0
6341;207726;777;72;43;4;39;.907;3900000;0
6341;62884;2182;0;0;0;0;.00nan;0;0
6342;190702;784;74;33;3;30;.909;3900000;0
6342;-1;3737;0;0;0;0;.00nan;0;0
6342;-1;784;0;0;0;0;.00nan;0;0
6342;78587;3737;79;38;3;35;.921;3900000;0
6343;165867;778;58;30;3;27;.900;3561000;0
6343;-1;776;0;0;0;0;.00nan;0;0
6343;62279;778;0;0;0;0;.00nan;0;0
6343;95405;776;64;25;2;23;.920;3600000;0
6344;183377;904;22;22;6;16;.727;2151000;0
6344;209571;798;0;0;0;0;.00nan;0;0
6344;66924;904;51;7;1;6;.857;1449000;0
6344;146192;798;86;34;1;33;.971;3600000;0
6345;174017;780;81;38;3;35;.921;3544000;0
6345;-1;780;0;0;0;0;.00nan;0;0
6345;-1;783;0;0;0;0;.00nan;0;0
6345;86422;783;66;22;2;20;.909;3600000;0
6346;183377;904;97;43;2;41;.953;3900000;0
6346;24177;2182;0;0;0;0;.00nan;0;0
6346;62884;2182;83;25;2;23;.920;3900000;0
6346;66924;904;0;0;0;0;.00nan;0;0
6347;174017;780;97;38;2;36;.947;3900000;0
6347;-1;780;0;0;0;0;.00nan;0;0
6347;146164;796;87;31;2;29;.935;3890000;0
6347;149847;796;0;0;0;0;.00nan;0;0
6348;209571;798;0;0;0;0;.00nan;0;0
6348;-1;776;0;0;0;0;.00nan;0;0
6348;95405;776;72;21;1;20;.952;3846000;0
6348;146192;798;77;32;2;30;.938;3846000;0
6349;190702;784;57;23;3;20;.870;3600000;0
6349;-1;784;0;0;0;0;.00nan;0;0
6349;152201;794;0;0;0;0;.00nan;0;0
6349;158512;794;58;34;4;30;.882;3565000;0
6350;165867;778;76;33;2;31;.939;3583000;0
6350;-1;3737;73;21;1;20;.952;3600000;0
6350;62279;778;0;0;0;0;.00nan;0;0
6350;78587;3737;0;0;0;0;.00nan;0;0
6351;193859;777;0;0;0;0;.00nan;0;0
6351;207726;777;73;22;1;21;.955;3600000;0
6351;-1;783;0;0;0;0;.00nan;0;0
6351;86422;783;73;34;3;31;.912;3576000;0
6355;209564;776;0;0;0;0;.00nan;0;0
6355;-1;783;0;0;0;0;.00nan;0;0
6355;86422;783;92;33;2;31;.939;3599000;0
6355;95405;776;76;25;1;24;.960;3600000;0
6357;190702;784;73;41;3;38;.927;3600000;0
6357;-1;3737;0;0;0;0;.00nan;0;0
6357;-1;784;0;0;0;0;.00nan;0;0
6357;78587;3737;55;34;4;30;.882;3591000;0
6359;209571;798;44;10;2;8;.800;1199000;0
6359;165867;777;52;31;5;26;.839;3600000;0
6359;-1;798;54;26;4;22;.846;2334000;0
6359;149847;777;0;0;0;0;.00nan;0;0
6361;183377;904;60;26;3;23;.885;3567000;0
6361;62279;778;96;44;2;42;.955;3600000;0
6361;66924;904;0;0;0;0;.00nan;0;0
6361;76486;778;0;0;0;0;.00nan;0;0
6363;24177;2182;96;27;0;27;1.000;3600000;0
6363;212959;780;0;0;0;0;.00nan;0;0
6363;-1;780;53;26;4;22;.846;3600000;0
6363;146164;2182;0;0;0;0;.00nan;0;0
6365;190702;784;47;30;5;25;.833;3521000;0
6365;-1;3737;0;0;0;0;.00nan;0;0
6365;-1;784;0;0;0;0;.00nan;0;0
6365;78587;3737;62;25;3;22;.880;3600000;0
6367;183377;904;0;0;0;0;.00nan;0;0
6367;209571;798;76;35;3;32;.914;3600000;0
6367;-1;798;0;0;0;0;.00nan;0;0
6367;66924;904;93;37;2;35;.946;3600000;0
6369;209564;776;0;0;0;0;.00nan;0;0
6369;212959;780;75;43;4;39;.907;3600000;0
6369;-1;780;0;0;0;0;.00nan;0;0
6369;95405;776;72;20;1;19;.950;3600000;0
6371;-1;783;0;0;0;0;.00nan;0;0
6371;62279;778;57;25;3;22;.880;3600000;0
6371;76486;778;0;0;0;0;.00nan;0;0
6371;86422;783;81;39;4;35;.897;3549000;0
6373;165867;777;79;25;1;24;.960;3600000;0
6373;149847;777;0;0;0;0;.00nan;0;0
6373;152201;794;87;38;2;36;.947;3578000;0
6373;158512;794;0;0;0;0;.00nan;0;0
6375;24177;2182;50;28;4;24;.857;3600000;0
6375;-1;796;49;37;5;32;.865;3567000;0
6375;62884;796;0;0;0;0;.00nan;0;0
6375;146164;2182;0;0;0;0;.00nan;0;0
6377;183377;904;53;33;4;29;.879;3600000;0
6377;24177;2182;0;0;0;0;.00nan;0;0
6377;66924;904;0;0;0;0;.00nan;0;0
6377;146164;2182;96;24;0;24;1.000;3600000;0
6379;209564;776;58;40;5;35;.875;3600000;0
6379;62279;778;0;0;0;0;.00nan;0;0
6379;76486;778;68;24;2;22;.917;3600000;0
6379;95405;776;0;0;0;0;.00nan;0;0
6381;190702;784;0;0;0;0;.00nan;0;0
6381;-1;3737;75;27;1;26;.963;3600000;0
6381;-1;784;82;33;2;31;.939;3557000;0
6381;78587;3737;0;0;0;0;.00nan;0;0
6385;209571;798;0;0;0;0;.00nan;0;0
6385;165867;777;0;0;0;0;.00nan;0;0
6385;-1;798;87;51;3;48;.941;3600000;0
6385;149847;777;54;20;2;18;.900;3600000;0
6387;-1;783;0;0;0;0;.00nan;0;0
6387;86422;783;34;16;4;12;.750;3600000;0
6387;152201;794;0;0;0;0;.00nan;0;0
6387;158512;794;72;23;1;22;.957;3600000;0
6389;209571;798;99;32;1;31;.969;3600000;0
6389;212959;780;0;0;0;0;.00nan;0;0
6389;-1;780;60;22;2;20;.909;3560000;0
6389;-1;798;0;0;0;0;.00nan;0;0
6391;209564;776;58;36;4;32;.889;3108000;0
6391;-1;783;0;0;0;0;.00nan;0;0
6391;86422;783;100;31;0;31;1.000;3600000;0
6391;95405;776;31;6;3;3;.500;492000;0
6395;183377;904;100;27;0;27;1.000;3600000;0
6395;24177;2182;0;0;0;0;.00nan;0;0
6395;66924;904;0;0;0;0;.00nan;0;0
6395;146164;2182;66;17;1;16;.941;3578000;0
6397;-1;3737;0;0;0;0;.00nan;0;0
6397;78587;3737;58;17;2;15;.882;3600000;0
6397;152201;794;98;54;3;51;.944;3567000;0
6397;158512;794;0;0;0;0;.00nan;0;0
6399;165867;777;74;24;1;23;.958;3600000;0
6399;62279;778;70;36;3;33;.917;3566000;0
6399;76486;778;0;0;0;0;.00nan;0;0
6399;149847;777;0;0;0;0;.00nan;0;0
6403;209564;776;0;0;0;0;.00nan;0;0
6403;24177;2182;76;31;2;29;.935;3600000;0
6403;95405;776;45;32;5;27;.844;3600000;0
6403;146164;2182;0;0;0;0;.00nan;0;0
6405;209571;798;0;0;0;0;.00nan;0;0
6405;-1;783;0;0;0;0;.00nan;0;0
6405;-1;798;83;32;2;30;.938;3900000;0
6405;86422;783;70;26;2;24;.923;3900000;0
6407;183377;904;57;27;3;24;.889;3600000;0
6407;190702;784;81;35;2;33;.943;3600000;0
6407;-1;784;0;0;0;0;.00nan;0;0
6407;66924;904;0;0;0;0;.00nan;0;0
6409;165867;777;0;0;0;0;.00nan;0;0
6409;62279;778;0;0;0;0;.00nan;0;0
6409;76486;778;85;33;2;31;.939;3900000;0
6409;149847;777;67;24;2;22;.917;3900000;0
6411;212959;780;47;35;5;30;.857;3600000;0
6411;-1;3737;40;34;6;28;.824;3545000;0
6411;-1;780;0;0;0;0;.00nan;0;0
6411;78587;3737;0;0;0;0;.00nan;0;0
6413;183377;904;89;46;4;42;.913;3900000;0
6413;209564;776;0;0;0;0;.00nan;0;0
6413;66924;904;0;0;0;0;.00nan;0;0
6413;95405;776;34;24;4;20;.833;3900000;0
6417;24177;2182;61;19;2;17;.895;3600000;0
6417;212959;780;47;38;6;32;.842;3600000;0
6417;-1;780;0;0;0;0;.00nan;0;0
6417;146164;2182;0;0;0;0;.00nan;0;0
6419;209571;798;33;39;7;32;.821;3600000;0
6419;190702;784;78;31;2;29;.935;3600000;0
6419;-1;784;0;0;0;0;.00nan;0;0
6419;-1;798;0;0;0;0;.00nan;0;0
6421;165867;777;54;30;4;26;.867;3600000;0
6421;-1;3737;0;0;0;0;.00nan;0;0
6421;78587;3737;100;31;0;31;1.000;3600000;0
6421;149847;777;0;0;0;0;.00nan;0;0
6423;-1;783;0;0;0;0;.00nan;0;0
6423;62279;778;77;42;4;38;.905;3600000;0
6423;76486;778;0;0;0;0;.00nan;0;0
6423;86422;783;67;18;1;17;.944;3600000;0
6425;24177;2182;0;0;0;0;.00nan;0;0
6425;-1;3737;0;0;0;0;.00nan;0;0
6425;78587;3737;100;41;0;41;1.000;3600000;0
6425;146164;2182;66;15;1;14;.933;3544000;0
6427;209564;776;53;31;4;27;.871;3600000;0
6427;-1;796;85;24;1;23;.958;3600000;0
6427;62884;796;0;0;0;0;.00nan;0;0
6427;95405;776;0;0;0;0;.00nan;0;0
6429;190702;784;0;0;0;0;.00nan;0;0
6429;212959;780;0;0;0;0;.00nan;0;0
6429;-1;784;63;25;2;23;.920;3600000;0
6429;-1;780;72;44;4;40;.909;3600000;0
6431;165867;777;0;0;0;0;.00nan;0;0
6431;-1;783;68;37;3;34;.919;3537000;0
6431;86422;783;0;0;0;0;.00nan;0;0
6431;149847;777;85;22;1;21;.955;3600000;0
6433;183377;904;0;0;0;0;.00nan;0;0
6433;62279;778;0;0;0;0;.00nan;0;0
6433;66924;904;55;29;4;25;.862;3600000;0
6433;76486;778;100;27;0;27;1.000;3600000;0
6435;209571;798;61;12;1;11;.917;1002000;0
6435;-1;798;37;33;6;27;.818;2598000;0
6435;152201;794;58;26;4;22;.846;3600000;0
6435;158512;794;0;0;0;0;.00nan;0;0
1007;209571;798;0;0;0;0;.00nan;0;0
1007;165867;778;95;46;3;43;.935;3600000;0
1007;62279;778;0;0;0;0;.00nan;0;0
1007;146192;798;63;37;4;33;.892;3554000;0
1008;174017;780;32;33;6;27;.818;3600000;0
1008;190702;784;80;34;4;30;.882;3600000;0
1008;-1;784;0;0;0;0;.00nan;0;0
1008;-1;780;0;0;0;0;.00nan;0;0
1009;209571;798;0;0;0;0;.00nan;0;0
1009;165867;778;80;20;1;19;.950;3600000;0
1009;62279;778;0;0;0;0;.00nan;0;0
1009;146192;798;69;40;4;36;.900;3600000;0
1010;174017;780;72;34;4;30;.882;3798000;0
1010;190702;784;63;23;3;20;.870;3798000;0
1010;-1;784;0;0;0;0;.00nan;0;0
1010;-1;780;0;0;0;0;.00nan;0;0
1154;193859;777;0;0;0;0;.00nan;0;0
1154;190702;784;92;51;2;49;.961;3990000;0
1154;207726;777;69;19;1;18;.947;3990000;0
1154;-1;784;0;0;0;0;.00nan;0;0
1155;-1;3737;0;0;0;0;.00nan;0;0
1155;-1;783;0;0;0;0;.00nan;0;0
1155;78587;3737;85;31;1;30;.968;3600000;0
1155;86422;783;46;29;5;24;.828;3600000;0
1156;24177;2182;0;0;0;0;.00nan;0;0
1156;-1;776;0;0;0;0;.00nan;0;0
1156;62884;2182;58;30;3;27;.900;3600000;0
1156;95405;776;55;33;4;29;.879;3549000;0
1157;165867;778;64;33;3;30;.909;3558000;0
1157;62279;778;0;0;0;0;.00nan;0;0
1157;146164;796;0;0;0;0;.00nan;0;0
1157;149847;796;60;14;1;13;.929;3600000;0
1158;193859;777;0;0;0;0;.00nan;0;0
1158;190702;784;85;47;4;43;.915;3600000;0
1158;207726;777;86;15;0;15;1.000;3600000;0
1158;-1;784;0;0;0;0;.00nan;0;0
1159;-1;3737;0;0;0;0;.00nan;0;0
1159;-1;783;0;0;0;0;.00nan;0;0
1159;78587;3737;68;31;3;28;.903;3564000;0
1159;86422;783;93;33;1;32;.970;3600000;0
1160;24177;2182;0;0;0;0;.00nan;0;0
1160;-1;776;0;0;0;0;.00nan;0;0
1160;62884;2182;89;16;0;16;1.000;3600000;0
1160;95405;776;88;38;2;36;.947;3535000;0
1161;165867;778;69;29;2;27;.931;4196000;0
1161;62279;778;0;0;0;0;.00nan;0;0
1161;146164;796;0;0;0;0;.00nan;0;0
1161;149847;796;90;41;3;38;.927;4196000;0
1162;193859;777;0;0;0;0;.00nan;0;0
1162;190702;784;88;47;2;45;.957;3569000;0
1162;207726;777;69;21;1;20;.952;3600000;0
1162;-1;784;0;0;0;0;.00nan;0;0
1163;-1;3737;0;0;0;0;.00nan;0;0
1163;-1;783;0;0;0;0;.00nan;0;0
1163;78587;3737;82;34;2;32;.941;3600000;0
1163;86422;783;50;17;3;14;.824;3595000;0
1164;24177;2182;53;3;0;3;1.000;437000;0
1164;-1;776;0;0;0;0;.00nan;0;0
1164;62884;2182;33;30;6;24;.800;3163000;0
1164;95405;776;80;39;3;36;.923;3600000;0
1165;165867;778;75;37;3;34;.919;3600000;0
1165;62279;778;0;0;0;0;.00nan;0;0
1165;146164;796;0;0;0;0;.00nan;0;0
1165;149847;796;76;41;4;37;.902;3600000;0
1166;193859;777;0;0;0;0;.00nan;0;0
1166;190702;784;98;55;4;51;.927;3600000;0
1166;207726;777;79;12;0;12;1.000;3600000;0
1166;-1;784;0;0;0;0;.00nan;0;0
1167;-1;3737;0;0;0;0;.00nan;0;0
1167;-1;783;0;0;0;0;.00nan;0;0
1167;78587;3737;43;22;4;18;.818;3550000;0
1167;86422;783;81;29;2;27;.931;3600000;0
1168;24177;2182;0;0;0;0;.00nan;0;0
1168;-1;776;0;0;0;0;.00nan;0;0
1168;62884;2182;74;38;3;35;.921;4200000;0
1168;95405;776;68;35;3;32;.914;4200000;0
1169;165867;778;77;25;1;24;.960;4134000;0
1169;62279;778;0;0;0;0;.00nan;0;0
1169;146164;796;0;0;0;0;.00nan;0;0
1169;149847;796;94;46;2;44;.957;4134000;0
1491;-1;3737;0;0;0;0;.00nan;0;0
1491;-1;783;0;0;0;0;.00nan;0;0
1491;78587;3737;81;28;1;27;.964;3600000;0
1491;86422;783;71;33;3;30;.909;3559000;0
1492;24177;2182;0;0;0;0;.00nan;0;0
1492;-1;776;0;0;0;0;.00nan;0;0
1492;62884;2182;66;18;1;17;.944;3681000;0
1492;95405;776;94;43;2;41;.953;3681000;0
1493;165867;778;90;33;2;31;.939;4200000;0
1493;62279;778;0;0;0;0;.00nan;0;0
1493;146164;796;0;0;0;0;.00nan;0;0
1493;149847;796;72;34;2;32;.941;4200000;0
1535;-1;3737;0;0;0;0;.00nan;0;0
1535;-1;783;0;0;0;0;.00nan;0;0
1535;78587;3737;60;21;3;18;.857;3997000;0
1535;86422;783;95;36;2;34;.944;3997000;0
1536;24177;2182;0;0;0;0;.00nan;0;0
1536;-1;776;0;0;0;0;.00nan;0;0
1536;62884;2182;69;40;4;36;.900;4187000;0
1536;95405;776;66;32;3;29;.906;4187000;0
1574;-1;3737;0;0;0;0;.00nan;0;0
1574;-1;783;0;0;0;0;.00nan;0;0
1574;78587;3737;81;41;3;38;.927;4200000;0
1574;86422;783;57;24;3;21;.875;4200000;0
1575;24177;2182;0;0;0;0;.00nan;0;0
1575;-1;776;0;0;0;0;.00nan;0;0
1575;62884;2182;81;24;1;23;.958;3600000;0
1575;95405;776;72;37;3;34;.919;3600000;0
1620;193859;777;0;0;0;0;.00nan;0;0
1620;165867;778;75;39;3;36;.923;3531000;0
1620;207726;777;65;18;1;17;.944;3600000;0
1620;62279;778;0;0;0;0;.00nan;0;0
1621;24177;2182;0;0;0;0;.00nan;0;0
1621;-1;3737;0;0;0;0;.00nan;0;0
1621;62884;2182;69;28;3;25;.893;4200000;0
1621;78587;3737;73;31;3;28;.903;4200000;0
1622;193859;777;0;0;0;0;.00nan;0;0
1622;165867;778;48;45;7;38;.844;3155000;0
1622;207726;777;81;16;0;16;1.000;3600000;0
1622;62279;778;56;4;0;4;1.000;445000;0
1623;24177;2182;0;0;0;0;.00nan;0;0
1623;-1;3737;0;0;0;0;.00nan;0;0
1623;62884;2182;82;21;1;20;.952;3600000;0
1623;78587;3737;71;41;4;37;.902;3600000;0
1624;193859;777;0;0;0;0;.00nan;0;0
1624;165867;778;75;23;1;22;.957;3600000;0
1624;207726;777;63;17;2;15;.882;3543000;0
1624;62279;778;0;0;0;0;.00nan;0;0
1625;24177;2182;0;0;0;0;.00nan;0;0
1625;-1;3737;61;9;0;9;1.000;1144000;0
1625;62884;2182;71;18;1;17;.944;3600000;0
1625;78587;3737;5;22;7;15;.682;2456000;0
1626;193859;777;0;0;0;0;.00nan;0;0
1626;165867;778;62;48;6;42;.875;3600000;0
1626;207726;777;66;25;2;23;.920;3600000;0
1626;62279;778;0;0;0;0;.00nan;0;0
1627;24177;2182;0;0;0;0;.00nan;0;0
1627;-1;3737;0;0;0;0;.00nan;0;0
1627;62884;2182;61;27;3;24;.889;3524000;0
1627;78587;3737;87;30;1;29;.967;3600000;0
1879;193859;777;0;0;0;0;.00nan;0;0
1879;165867;778;69;36;3;33;.917;3600000;0
1879;207726;777;37;17;4;13;.765;3549000;0
1879;62279;778;0;0;0;0;.00nan;0;0
1880;24177;2182;0;0;0;0;.00nan;0;0
1880;-1;3737;0;0;0;0;.00nan;0;0
1880;62884;2182;79;23;1;22;.957;3600000;0
1880;78587;3737;71;40;4;36;.900;3600000;0
1900;193859;777;0;0;0;0;.00nan;0;0
1900;165867;778;98;52;3;49;.942;3600000;0
1900;207726;777;79;11;0;11;1.000;3600000;0
1900;62279;778;0;0;0;0;.00nan;0;0
1901;24177;2182;0;0;0;0;.00nan;0;0
1901;-1;3737;48;8;1;7;.875;590000;0
1901;62884;2182;57;18;2;16;.889;3600000;0
1901;78587;3737;15;25;7;18;.720;3010000;0
1962;193859;777;0;0;0;0;.00nan;0;0
1962;24177;2182;0;0;0;0;.00nan;0;0
1962;207726;777;59;24;3;21;.875;3600000;0
1962;62884;2182;100;41;0;41;1.000;3600000;0
1963;193859;777;0;0;0;0;.00nan;0;0
1963;24177;2182;0;0;0;0;.00nan;0;0
1963;207726;777;47;27;4;23;.852;3591000;0
1963;62884;2182;65;30;3;27;.900;3600000;0
1964;193859;777;0;0;0;0;.00nan;0;0
1964;24177;2182;0;0;0;0;.00nan;0;0
1964;207726;777;67;20;2;18;.900;3600000;0
1964;62884;2182;81;48;4;44;.917;3552000;0
1965;193859;777;0;0;0;0;.00nan;0;0
1965;24177;2182;0;0;0;0;.00nan;0;0
1965;207726;777;94;26;0;26;1.000;3600000;0
1965;62884;2182;71;19;1;18;.947;3563000;0
2169;193859;777;0;0;0;0;.00nan;0;0
2169;24177;2182;0;0;0;0;.00nan;0;0
2169;207726;777;85;29;2;27;.931;3600000;0
2169;62884;2182;51;34;5;29;.853;3600000;0
2218;193859;777;0;0;0;0;.00nan;0;0
2218;24177;2182;0;0;0;0;.00nan;0;0
2218;207726;777;100;34;1;33;.971;3600000;0
2218;62884;2182;22;23;6;17;.739;3600000;0
6436;167061;2626;72;35;3;32;.914;3537000;0
6436;28989;2626;0;0;0;0;.00nan;0;0
6436;77086;552;80;22;1;21;.955;3600000;0
6436;146213;552;0;0;0;0;.00nan;0;0
6437;196812;1423;30;37;7;30;.811;3600000;0
6437;-1;1423;0;0;0;0;.00nan;0;0
6437;77086;552;76;21;1;20;.952;3600000;0
6437;146213;552;0;0;0;0;.00nan;0;0
6438;169615;554;93;31;1;30;.968;3900000;0
6438;-1;554;0;0;0;0;.00nan;0;0
6438;-1;555;100;43;1;42;.977;3900000;0
6438;68961;555;0;0;0;0;.00nan;0;0
6439;192739;556;42;21;5;16;.762;3588000;0
6439;4379;560;0;0;0;0;.00nan;0;0
6439;-1;560;62;33;4;29;.879;3600000;0
6439;85349;556;0;0;0;0;.00nan;0;0
6440;192895;553;0;0;0;0;.00nan;0;0
6440;201876;553;88;17;0;17;1.000;3600000;0
6440;-1;555;0;0;0;0;.00nan;0;0
6440;68961;555;50;29;4;25;.862;3600000;0
6441;167061;2626;67;31;3;28;.903;3589000;0
6441;194531;558;84;31;2;29;.935;3600000;0
6441;28989;2626;0;0;0;0;.00nan;0;0
6441;186810;558;0;0;0;0;.00nan;0;0
6442;192895;553;97;29;1;28;.966;3600000;0
6442;201876;553;0;0;0;0;.00nan;0;0
6442;-1;555;37;33;6;27;.818;3600000;0
6442;68961;555;0;0;0;0;.00nan;0;0
6443;169615;554;59;27;4;23;.852;3799000;0
6443;-1;554;0;0;0;0;.00nan;0;0
6443;196812;1423;74;29;3;26;.897;3799000;0
6443;-1;1423;0;0;0;0;.00nan;0;0
6444;4379;560;87;48;3;45;.938;3746000;0
6444;-1;560;0;0;0;0;.00nan;0;0
6444;77086;552;0;0;0;0;.00nan;0;0
6444;146213;552;68;19;2;17;.895;3746000;0
6445;196812;1423;99;24;0;24;1.000;3600000;0
6445;-1;555;86;41;3;38;.927;3600000;0
6445;-1;1423;0;0;0;0;.00nan;0;0
6445;68961;555;0;0;0;0;.00nan;0;0
6446;192739;556;64;34;4;30;.882;3900000;0
6446;167061;2626;75;40;4;36;.900;3900000;0
6446;28989;2626;0;0;0;0;.00nan;0;0
6446;85349;556;0;0;0;0;.00nan;0;0
6447;196812;1423;51;35;5;30;.857;3600000;0
6447;-1;561;0;0;0;0;.00nan;0;0
6447;-1;1423;0;0;0;0;.00nan;0;0
6447;65324;561;72;24;2;22;.917;3600000;0
6448;4379;560;57;38;5;33;.868;3600000;0
6448;169615;554;83;27;2;25;.926;3600000;0
6448;-1;554;0;0;0;0;.00nan;0;0
6448;-1;560;0;0;0;0;.00nan;0;0
6449;4379;560;0;0;0;0;.00nan;0;0
6449;-1;561;0;0;0;0;.00nan;0;0
6449;-1;560;81;32;2;30;.938;3725000;0
6449;65324;561;62;25;3;22;.880;3725000;0
6450;167061;2626;97;46;3;43;.935;3585000;0
6450;28989;2626;0;0;0;0;.00nan;0;0
6450;77086;552;72;25;1;24;.960;3600000;0
6450;146213;552;0;0;0;0;.00nan;0;0
6451;194531;558;0;0;0;0;.00nan;0;0
6451;186810;558;58;21;2;19;.905;3900000;0
6451;-1;561;0;0;0;0;.00nan;0;0
6451;65324;561;100;46;2;44;.957;3900000;0
6452;192895;553;0;0;0;0;.00nan;0;0
6452;169615;554;59;19;2;17;.895;3600000;0
6452;-1;554;0;0;0;0;.00nan;0;0
6452;201876;553;84;50;4;46;.920;3549000;0
6453;192739;556;100;29;0;29;1.000;3600000;0
6453;169615;554;61;35;4;31;.886;3600000;0
6453;-1;554;0;0;0;0;.00nan;0;0
6453;196445;556;0;0;0;0;.00nan;0;0
6454;192895;553;43;34;6;28;.824;3600000;0
6454;201876;553;0;0;0;0;.00nan;0;0
6454;77086;552;14;21;6;15;.714;2610000;0
6454;146213;552;55;9;1;8;.889;986000;0
6455;192895;553;86;28;1;27;.964;3600000;0
6455;4379;560;31;28;6;22;.786;2114000;0
6455;201876;553;0;0;0;0;.00nan;0;0
6455;-1;560;52;18;2;16;.889;1486000;0
6456;192739;556;85;35;3;32;.914;3565000;0
6456;196445;556;0;0;0;0;.00nan;0;0
6456;77086;552;87;39;2;37;.949;3600000;0
6456;146213;552;0;0;0;0;.00nan;0;0
6457;4379;560;0;0;0;0;.00nan;0;0
6457;-1;555;0;0;0;0;.00nan;0;0
6457;-1;560;77;21;1;20;.952;3600000;0
6457;68961;555;86;42;3;39;.929;3531000;0
6458;167061;2626;73;24;1;23;.958;3600000;0
6458;28989;2626;0;0;0;0;.00nan;0;0
6458;-1;561;56;37;5;32;.865;3600000;0
6458;65324;561;0;0;0;0;.00nan;0;0
6459;194531;558;52;33;5;28;.848;3553000;0
6459;196812;1423;78;36;3;33;.917;3600000;0
6459;186810;558;0;0;0;0;.00nan;0;0
6459;-1;1423;0;0;0;0;.00nan;0;0
6460;192895;553;80;41;4;37;.902;3900000;0
6460;169615;554;75;43;4;39;.907;3900000;0
6460;-1;554;0;0;0;0;.00nan;0;0
6460;201876;553;0;0;0;0;.00nan;0;0
6461;4379;560;64;25;2;23;.920;3567000;0
6461;-1;555;100;50;1;49;.980;3600000;0
6461;-1;560;0;0;0;0;.00nan;0;0
6461;68961;555;0;0;0;0;.00nan;0;0
6462;194531;558;100;52;2;50;.962;3900000;0
6462;186810;558;0;0;0;0;.00nan;0;0
6462;77086;552;0;0;0;0;.00nan;0;0
6462;146213;552;53;19;2;17;.895;3900000;0
6463;194531;558;55;22;3;19;.864;3600000;0
6463;169615;554;0;0;0;0;.00nan;0;0
6463;-1;554;100;45;2;43;.956;3600000;0
6463;186810;558;0;0;0;0;.00nan;0;0
6464;194531;558;0;0;0;0;.00nan;0;0
6464;186810;558;62;19;2;17;.895;3600000;0
6464;-1;555;71;60;6;54;.900;3001000;0
6464;68961;555;35;5;2;3;.600;599000;0
6465;192895;553;0;0;0;0;.00nan;0;0
6465;201876;553;48;21;3;18;.857;3600000;0
6465;-1;561;0;0;0;0;.00nan;0;0
6465;65324;561;37;37;6;31;.838;3600000;0
6466;192739;556;46;18;3;15;.833;3600000;0
6466;196445;556;0;0;0;0;.00nan;0;0
6466;196812;1423;66;38;4;34;.895;3600000;0
6466;-1;1423;0;0;0;0;.00nan;0;0
6467;192895;553;49;31;5;26;.839;3600000;0
6467;201876;553;0;0;0;0;.00nan;0;0
6467;-1;561;64;19;2;17;.895;3600000;0
6467;65324;561;0;0;0;0;.00nan;0;0
6468;194531;558;67;51;6;45;.882;3600000;0
6468;186810;558;0;0;0;0;.00nan;0;0
6468;77086;552;95;32;1;31;.969;3600000;0
6468;146213;552;0;0;0;0;.00nan;0;0
6469;192739;556;0;0;0;0;.00nan;0;0
6469;196445;556;74;25;2;23;.920;3600000;0
6469;196812;1423;64;6;0;6;1.000;859000;0
6469;-1;1423;41;38;6;32;.842;2741000;0
6470;192739;556;83;46;3;43;.935;3550000;0
6470;169615;554;82;30;2;28;.933;3600000;0
6470;-1;554;0;0;0;0;.00nan;0;0
6470;196445;556;0;0;0;0;.00nan;0;0
6471;192895;553;0;0;0;0;.00nan;0;0
6471;4379;560;100;27;0;27;1.000;3600000;0
6471;201876;553;83;36;3;33;.917;3600000;0
6471;-1;560;0;0;0;0;.00nan;0;0
6472;167061;2626;59;15;2;13;.867;3600000;0
6472;28989;2626;0;0;0;0;.00nan;0;0
6472;-1;555;44;39;6;33;.846;3600000;0
6472;68961;555;0;0;0;0;.00nan;0;0
6473;196812;1423;64;35;4;31;.886;3570000;0
6473;-1;561;0;0;0;0;.00nan;0;0
6473;-1;1423;0;0;0;0;.00nan;0;0
6473;65324;561;71;31;3;28;.903;3600000;0
6474;192895;553;71;38;3;35;.921;3694000;0
6474;167061;2626;74;39;4;35;.897;3694000;0
6474;28989;2626;0;0;0;0;.00nan;0;0
6474;201876;553;0;0;0;0;.00nan;0;0
6475;192739;556;59;30;3;27;.900;3600000;0
6475;194531;558;82;29;2;27;.931;3600000;0
6475;196445;556;0;0;0;0;.00nan;0;0
6475;186810;558;0;0;0;0;.00nan;0;0
6476;4379;560;71;37;3;34;.919;3600000;0
6476;169615;554;0;0;0;0;.00nan;0;0
6476;-1;554;71;16;1;15;.938;3600000;0
6476;-1;560;0;0;0;0;.00nan;0;0
6477;4379;560;46;31;4;27;.871;3600000;0
6477;-1;560;0;0;0;0;.00nan;0;0
6477;77086;552;100;25;0;25;1.000;3600000;0
6477;146213;552;0;0;0;0;.00nan;0;0
6478;192895;553;66;33;4;29;.879;3600000;0
6478;167061;2626;100;26;0;26;1.000;3600000;0
6478;28989;2626;0;0;0;0;.00nan;0;0
6478;201876;553;0;0;0;0;.00nan;0;0
6479;192739;556;92;44;3;41;.932;3600000;0
6479;169615;554;50;31;4;27;.871;3565000;0
6479;-1;554;0;0;0;0;.00nan;0;0
6479;196445;556;0;0;0;0;.00nan;0;0
6480;194531;558;0;0;0;0;.00nan;0;0
6480;196812;1423;88;45;3;42;.933;3900000;0
6480;186810;558;70;33;3;30;.909;3900000;0
6480;-1;1423;0;0;0;0;.00nan;0;0
6481;-1;555;0;0;0;0;.00nan;0;0
6481;-1;561;0;0;0;0;.00nan;0;0
6481;65324;561;68;18;1;17;.944;3600000;0
6481;68961;555;97;62;4;58;.935;3600000;0
6482;4379;560;100;25;0;25;1.000;3600000;0
6482;-1;555;74;42;3;39;.929;3600000;0
6482;-1;560;0;0;0;0;.00nan;0;0
6482;68961;555;0;0;0;0;.00nan;0;0
6483;4379;560;67;27;2;25;.926;3600000;0
6483;-1;561;0;0;0;0;.00nan;0;0
6483;-1;560;0;0;0;0;.00nan;0;0
6483;65324;561;31;25;5;20;.800;3600000;0
6484;192895;553;0;0;0;0;.00nan;0;0
6484;169615;554;74;34;3;31;.912;3600000;0
6484;-1;554;0;0;0;0;.00nan;0;0
6484;201876;553;57;37;5;32;.865;3600000;0
6485;192739;556;100;25;0;25;1.000;3600000;0
6485;194531;558;97;41;1;40;.976;3554000;0
6485;196445;556;0;0;0;0;.00nan;0;0
6485;186810;558;0;0;0;0;.00nan;0;0
6486;194531;558;0;0;0;0;.00nan;0;0
6486;169615;554;60;37;5;32;.865;3590000;0
6486;-1;554;0;0;0;0;.00nan;0;0
6486;186810;558;78;44;4;40;.909;3600000;0
6487;196812;1423;84;31;2;29;.935;3600000;0
6487;-1;561;0;0;0;0;.00nan;0;0
6487;-1;1423;0;0;0;0;.00nan;0;0
6487;65324;561;37;21;4;17;.810;3598000;0
6488;167061;2626;86;50;4;46;.920;3600000;0
6488;28989;2626;0;0;0;0;.00nan;0;0
6488;77086;552;74;23;1;22;.957;3600000;0
6488;146213;552;0;0;0;0;.00nan;0;0
6489;192739;556;45;23;4;19;.826;3600000;0
6489;196445;556;0;0;0;0;.00nan;0;0
6489;196812;1423;41;24;5;19;.792;3600000;0
6489;-1;1423;0;0;0;0;.00nan;0;0
6490;167061;2626;80;34;3;31;.912;3600000;0
6490;194531;558;45;33;5;28;.848;3545000;0
6490;28989;2626;0;0;0;0;.00nan;0;0
6490;186810;558;0;0;0;0;.00nan;0;0
6491;192895;553;0;0;0;0;.00nan;0;0
6491;201876;553;52;27;4;23;.852;3600000;0
6491;196812;1423;46;30;5;25;.833;3600000;0
6491;-1;1423;0;0;0;0;.00nan;0;0
6492;-1;561;0;0;0;0;.00nan;0;0
6492;65324;561;84;39;3;36;.923;3600000;0
6492;77086;552;0;0;0;0;.00nan;0;0
6492;146213;552;79;24;1;23;.958;3600000;0
6493;167061;2626;86;31;2;29;.935;3600000;0
6493;194531;558;65;27;3;24;.889;3587000;0
6493;28989;2626;0;0;0;0;.00nan;0;0
6493;186810;558;0;0;0;0;.00nan;0;0
6494;192895;553;96;34;1;33;.971;3600000;0
6494;201876;553;0;0;0;0;.00nan;0;0
6494;196812;1423;80;30;2;28;.933;3545000;0
6494;-1;1423;0;0;0;0;.00nan;0;0
6495;-1;555;82;44;3;41;.932;3580000;0
6495;-1;561;0;0;0;0;.00nan;0;0
6495;65324;561;72;25;2;23;.920;3600000;0
6495;68961;555;0;0;0;0;.00nan;0;0
6496;192739;556;38;33;6;27;.818;2624000;0
6496;196445;556;51;3;0;3;1.000;976000;0
6496;77086;552;73;22;1;21;.955;3600000;0
6496;146213;552;0;0;0;0;.00nan;0;0
6497;167061;2626;46;24;3;21;.875;3542000;0
6497;28989;2626;0;0;0;0;.00nan;0;0
6497;196812;1423;67;23;1;22;.957;3600000;0
6497;-1;1423;0;0;0;0;.00nan;0;0
6498;192895;553;0;0;0;0;.00nan;0;0
6498;201876;553;52;24;4;20;.833;3600000;0
6498;-1;555;49;38;6;32;.842;2981000;0
6498;68961;555;45;4;1;3;.750;619000;0
6499;192739;556;92;32;1;31;.969;3600000;0
6499;196445;556;0;0;0;0;.00nan;0;0
6499;-1;561;0;0;0;0;.00nan;0;0
6499;65324;561;79;35;3;32;.914;3570000;0
6500;192895;553;52;29;4;25;.862;3600000;0
6500;167061;2626;92;37;1;36;.973;3600000;0
6500;28989;2626;0;0;0;0;.00nan;0;0
6500;201876;553;0;0;0;0;.00nan;0;0
6501;194531;558;0;0;0;0;.00nan;0;0
6501;186810;558;77;20;1;19;.950;3600000;0
6501;-1;555;0;0;0;0;.00nan;0;0
6501;68961;555;88;71;6;65;.915;3600000;0
6502;4379;560;65;33;4;29;.879;3600000;0
6502;194531;558;100;33;0;33;1.000;3600000;0
6502;186810;558;0;0;0;0;.00nan;0;0
6502;-1;560;0;0;0;0;.00nan;0;0
6503;192739;556;0;0;0;0;.00nan;0;0
6503;196445;556;49;21;3;18;.857;3600000;0
6503;-1;555;71;46;4;42;.913;3595000;0
6503;68961;555;0;0;0;0;.00nan;0;0
6504;196812;1423;68;34;3;31;.912;3546000;0
6504;-1;1423;0;0;0;0;.00nan;0;0
6504;77086;552;60;19;2;17;.895;3600000;0
6504;146213;552;0;0;0;0;.00nan;0;0
6505;169615;554;66;24;3;21;.875;3600000;0
6505;-1;554;0;0;0;0;.00nan;0;0
6505;-1;561;53;38;4;34;.895;3546000;0
6505;65324;561;0;0;0;0;.00nan;0;0
6506;192739;556;58;23;3;20;.870;3600000;0
6506;196445;556;0;0;0;0;.00nan;0;0
6506;-1;561;0;0;0;0;.00nan;0;0
6506;65324;561;83;48;4;44;.917;3578000;0
6507;4379;560;0;0;0;0;.00nan;0;0
6507;169615;554;89;29;2;27;.931;3600000;0
6507;-1;554;0;0;0;0;.00nan;0;0
6507;-1;560;72;41;4;37;.902;3532000;0
6508;192895;553;99;42;1;41;.976;3600000;0
6508;201876;553;0;0;0;0;.00nan;0;0
6508;77086;552;48;19;2;17;.895;3547000;0
6508;146213;552;0;0;0;0;.00nan;0;0
6509;167061;2626;80;38;3;35;.921;3600000;0
6509;194531;558;58;34;4;30;.882;3543000;0
6509;28989;2626;0;0;0;0;.00nan;0;0
6509;186810;558;0;0;0;0;.00nan;0;0
6510;192739;556;56;10;1;9;.900;3600000;0
6510;196445;556;0;0;0;0;.00nan;0;0
6510;-1;555;81;44;3;41;.932;3566000;0
6510;68961;555;0;0;0;0;.00nan;0;0
6511;-1;561;0;0;0;0;.00nan;0;0
6511;65324;561;81;35;2;33;.943;3539000;0
6511;77086;552;0;0;0;0;.00nan;0;0
6511;146213;552;97;23;0;23;1.000;3600000;0
6512;4379;560;58;29;4;25;.862;3573000;0
6512;167061;2626;0;0;0;0;.00nan;0;0
6512;28989;2626;79;31;2;29;.935;3600000;0
6512;-1;560;0;0;0;0;.00nan;0;0
6513;194531;558;0;0;0;0;.00nan;0;0
6513;196812;1423;73;33;2;31;.939;3600000;0
6513;186810;558;58;36;4;32;.889;3576000;0
6513;-1;1423;0;0;0;0;.00nan;0;0
6514;192895;553;0;0;0;0;.00nan;0;0
6514;169615;554;59;26;3;23;.885;3600000;0
6514;-1;554;0;0;0;0;.00nan;0;0
6514;201876;553;49;26;4;22;.846;3563000;0
6515;169615;554;65;28;3;25;.893;3554000;0
6515;-1;554;0;0;0;0;.00nan;0;0
6515;-1;561;0;0;0;0;.00nan;0;0
6515;65324;561;71;30;2;28;.933;3600000;0
6516;167061;2626;80;44;4;40;.909;3591000;0
6516;28989;2626;0;0;0;0;.00nan;0;0
6516;-1;561;0;0;0;0;.00nan;0;0
6516;65324;561;86;29;1;28;.966;3600000;0
6517;192895;553;81;28;1;27;.964;3600000;0
6517;4379;560;62;35;3;32;.914;3513000;0
6517;201876;553;0;0;0;0;.00nan;0;0
6517;148402;560;0;0;0;0;.00nan;0;0
6518;194531;558;50;20;3;17;.850;3600000;0
6518;186810;558;0;0;0;0;.00nan;0;0
6518;-1;555;0;0;0;0;.00nan;0;0
6518;68961;555;65;50;5;45;.900;3566000;0
6519;196812;1423;68;30;3;27;.900;3600000;0
6519;77086;552;0;0;0;0;.00nan;0;0
6519;142292;1423;0;0;0;0;.00nan;0;0
6519;146213;552;78;28;2;26;.929;3600000;0
6520;167061;2626;93;41;3;38;.927;3900000;0
6520;169615;554;63;28;3;25;.893;3900000;0
6520;-1;554;0;0;0;0;.00nan;0;0
6520;28989;2626;0;0;0;0;.00nan;0;0
6521;194531;558;68;32;3;29;.906;3567000;0
6521;186810;558;0;0;0;0;.00nan;0;0
6521;77086;552;61;19;2;17;.895;3600000;0
6521;146213;552;0;0;0;0;.00nan;0;0
6522;192739;556;41;20;4;16;.800;3600000;0
6522;4379;560;44;43;6;37;.860;3156000;0
6522;196445;556;0;0;0;0;.00nan;0;0
6522;148402;560;57;6;0;6;1.000;437000;0
6523;-1;555;40;52;9;43;.827;3600000;0
6523;-1;561;0;0;0;0;.00nan;0;0
6523;65324;561;93;23;0;23;1.000;3600000;0
6523;68961;555;0;0;0;0;.00nan;0;0
6524;-1;555;0;0;0;0;.00nan;0;0
6524;-1;561;0;0;0;0;.00nan;0;0
6524;65324;561;100;18;0;18;1.000;3600000;0
6524;68961;555;75;45;4;41;.911;3600000;0
6525;192895;553;87;35;2;33;.943;3900000;0
6525;4379;560;73;27;2;25;.926;3900000;0
6525;201876;553;0;0;0;0;.00nan;0;0
6525;148402;560;0;0;0;0;.00nan;0;0
6526;192739;556;40;21;4;17;.810;3568000;0
6526;167061;2626;73;35;3;32;.914;3600000;0
6526;28989;2626;0;0;0;0;.00nan;0;0
6526;196445;556;0;0;0;0;.00nan;0;0
6527;169615;554;60;27;4;23;.852;3641000;0
6527;-1;554;0;0;0;0;.00nan;0;0
6527;196812;1423;76;47;5;42;.894;3641000;0
6527;142292;1423;0;0;0;0;.00nan;0;0
6528;194531;558;0;0;0;0;.00nan;0;0
6528;186810;558;41;25;5;20;.800;3600000;0
6528;77086;552;0;0;0;0;.00nan;0;0
6528;146213;552;87;33;2;31;.939;3600000;0
6529;192739;556;75;21;1;20;.952;3600000;0
6529;167061;2626;86;44;4;40;.909;3600000;0
6529;28989;2626;0;0;0;0;.00nan;0;0
6529;196445;556;0;0;0;0;.00nan;0;0
6530;192895;553;0;0;0;0;.00nan;0;0
6530;201876;553;68;41;5;36;.878;3900000;0
6530;77086;552;34;24;5;19;.792;3900000;0
6530;146213;552;0;0;0;0;.00nan;0;0
6531;4379;560;55;52;6;46;.885;3600000;0
6531;194531;558;56;11;1;10;.909;3600000;0
6531;186810;558;0;0;0;0;.00nan;0;0
6531;-1;560;0;0;0;0;.00nan;0;0
6532;169615;554;40;30;6;24;.800;3900000;0
6532;-1;554;0;0;0;0;.00nan;0;0
6532;196812;1423;19;9;4;5;.556;806000;0
6532;-1;1423;71;35;2;33;.943;3094000;0
6533;194531;558;0;0;0;0;.00nan;0;0
6533;186810;558;68;24;2;22;.917;3600000;0
6533;-1;561;0;0;0;0;.00nan;0;0
6533;65324;561;70;40;4;36;.900;3552000;0
6534;192739;556;100;29;0;29;1.000;3600000;0
6534;4379;560;22;24;6;18;.750;2135000;0
6534;196445;556;0;0;0;0;.00nan;0;0
6534;-1;560;51;19;3;16;.842;1465000;0
6535;167061;2626;88;15;0;15;1.000;3600000;0
6535;28989;2626;0;0;0;0;.00nan;0;0
6535;196812;1423;86;40;3;37;.925;3600000;0
6535;-1;1423;0;0;0;0;.00nan;0;0
6536;169615;554;66;32;3;29;.906;3600000;0
6536;-1;554;0;0;0;0;.00nan;0;0
6536;-1;555;0;0;0;0;.00nan;0;0
6536;68961;555;87;55;4;51;.927;3555000;0
6537;194531;558;0;0;0;0;.00nan;0;0
6537;186810;558;47;27;4;23;.852;3562000;0
6537;-1;561;0;0;0;0;.00nan;0;0
6537;65324;561;77;35;2;33;.943;3600000;0
6538;192739;556;73;26;3;23;.885;3900000;0
6538;192895;553;77;39;3;36;.923;3900000;0
6538;201876;553;0;0;0;0;.00nan;0;0
6538;196445;556;0;0;0;0;.00nan;0;0
6539;167061;2626;63;21;1;20;.952;3600000;0
6539;28989;2626;0;0;0;0;.00nan;0;0
6539;196812;1423;0;0;0;0;.00nan;0;0
6539;-1;1423;11;20;6;14;.700;3600000;0
6540;169615;554;0;0;0;0;.00nan;0;0
6540;-1;554;61;18;2;16;.889;3600000;0
6540;-1;555;54;46;6;40;.870;1795000;0
6540;68961;555;31;27;6;21;.778;1805000;0
6541;4379;560;56;22;2;20;.909;1217000;0
6541;-1;560;39;34;6;28;.824;2383000;0
6541;77086;552;39;13;3;10;.769;3600000;0
6541;146213;552;0;0;0;0;.00nan;0;0
6542;4379;560;51;37;5;32;.865;3600000;0
6542;167061;2626;92;29;1;28;.966;3600000;0
6542;28989;2626;0;0;0;0;.00nan;0;0
6542;-1;560;0;0;0;0;.00nan;0;0
6543;192895;553;82;32;1;31;.969;3600000;0
6543;194531;558;0;0;0;0;.00nan;0;0
6543;201876;553;0;0;0;0;.00nan;0;0
6543;186810;558;56;30;4;26;.867;3600000;0
6544;192739;556;61;38;4;34;.895;3600000;0
6544;196445;556;0;0;0;0;.00nan;0;0
6544;-1;561;0;0;0;0;.00nan;0;0
6544;65324;561;56;37;5;32;.865;3546000;0
6545;196812;1423;54;22;3;19;.864;3518000;0
6545;-1;555;0;0;0;0;.00nan;0;0
6545;-1;1423;0;0;0;0;.00nan;0;0
6545;68961;555;100;55;1;54;.982;3600000;0
6546;169615;554;99;43;1;42;.977;3600000;0
6546;-1;554;0;0;0;0;.00nan;0;0
6546;77086;552;0;0;0;0;.00nan;0;0
6546;146213;552;78;35;2;33;.943;3553000;0
6547;4379;560;0;0;0;0;.00nan;0;0
6547;167061;2626;0;0;0;0;.00nan;0;0
6547;28989;2626;72;32;3;29;.906;3600000;0
6547;-1;560;56;34;4;30;.882;3600000;0
6548;192895;553;0;0;0;0;.00nan;0;0
6548;194531;558;45;19;3;16;.842;2439000;0
6548;201876;553;94;35;1;34;.971;3600000;0
6548;186810;558;23;11;4;7;.636;1161000;0
6549;196812;1423;0;0;0;0;.00nan;0;0
6549;-1;555;64;20;1;19;.950;3900000;0
6549;-1;1423;79;24;1;23;.958;3900000;0
6549;68961;555;0;0;0;0;.00nan;0;0
6550;169615;554;58;25;3;22;.880;3543000;0
6550;-1;554;0;0;0;0;.00nan;0;0
6550;77086;552;72;19;2;17;.895;3600000;0
6550;146213;552;0;0;0;0;.00nan;0;0
6551;192739;556;38;25;5;20;.800;3900000;0
6551;196445;556;0;0;0;0;.00nan;0;0
6551;-1;561;26;19;5;14;.737;3256000;0
6551;65324;561;69;10;0;10;1.000;644000;0
6552;192895;553;48;28;4;24;.857;3535000;0
6552;201876;553;0;0;0;0;.00nan;0;0
6552;-1;561;0;0;0;0;.00nan;0;0
6552;65324;561;72;27;2;25;.926;3600000;0
6553;167061;2626;70;36;3;33;.917;3600000;0
6553;169615;554;60;34;4;30;.882;3561000;0
6553;-1;554;0;0;0;0;.00nan;0;0
6553;28989;2626;0;0;0;0;.00nan;0;0
6554;192739;556;85;41;3;38;.927;3900000;0
6554;194531;558;0;0;0;0;.00nan;0;0
6554;196445;556;0;0;0;0;.00nan;0;0
6554;186810;558;85;38;3;35;.921;3900000;0
6555;4379;560;62;39;4;35;.897;3554000;0
6555;196812;1423;77;29;2;27;.931;3600000;0
6555;-1;560;0;0;0;0;.00nan;0;0
6555;-1;1423;0;0;0;0;.00nan;0;0
6556;-1;555;56;23;3;20;.870;1894000;0
6556;68961;555;36;29;5;24;.828;1706000;0
6556;77086;552;0;0;0;0;.00nan;0;0
6556;146213;552;88;20;0;20;1.000;3600000;0
6557;4379;560;0;0;0;0;.00nan;0;0
6557;196812;1423;65;25;3;22;.880;3549000;0
6557;-1;560;89;33;1;32;.970;3600000;0
6557;-1;1423;0;0;0;0;.00nan;0;0
6558;192895;553;0;0;0;0;.00nan;0;0
6558;201876;553;44;34;5;29;.853;3600000;0
6558;-1;561;0;0;0;0;.00nan;0;0
6558;65324;561;79;30;2;28;.933;3600000;0
6559;192739;556;95;31;2;29;.935;3900000;0
6559;194531;558;0;0;0;0;.00nan;0;0
6559;196445;556;0;0;0;0;.00nan;0;0
6559;186810;558;83;30;2;28;.933;3900000;0
6560;167061;2626;90;44;3;41;.932;3600000;0
6560;169615;554;100;23;0;23;1.000;3600000;0
6560;-1;554;0;0;0;0;.00nan;0;0
6560;28989;2626;0;0;0;0;.00nan;0;0
6561;-1;555;84;57;4;53;.930;3600000;0
6561;68961;555;0;0;0;0;.00nan;0;0
6561;77086;552;0;0;0;0;.00nan;0;0
6561;146213;552;73;18;1;17;.944;3600000;0
6562;192739;556;82;25;1;24;.960;3600000;0
6562;192895;553;32;27;6;21;.778;3201000;0
6562;201876;553;46;7;1;6;.857;399000;0
6562;196445;556;0;0;0;0;.00nan;0;0
6563;192739;556;0;0;0;0;.00nan;0;0
6563;196445;556;64;39;4;35;.897;3600000;0
6563;77086;552;0;0;0;0;.00nan;0;0
6563;146213;552;72;21;1;20;.952;3600000;0
6564;194531;558;0;0;0;0;.00nan;0;0
6564;186810;558;77;31;2;29;.935;3600000;0
6564;-1;561;0;0;0;0;.00nan;0;0
6564;65324;561;63;33;4;29;.879;3517000;0
6565;192895;553;81;28;1;27;.964;3600000;0
6565;167061;2626;80;45;3;42;.933;3513000;0
6565;28989;2626;0;0;0;0;.00nan;0;0
6565;201876;553;0;0;0;0;.00nan;0;0
6566;4379;560;60;24;2;22;.917;3900000;0
6566;-1;555;0;0;0;0;.00nan;0;0
6566;-1;560;0;0;0;0;.00nan;0;0
6566;68961;555;100;44;2;42;.955;3900000;0
6567;169615;554;84;26;1;25;.962;3600000;0
6567;-1;554;0;0;0;0;.00nan;0;0
6567;196812;1423;88;42;2;40;.952;3600000;0
6567;-1;1423;0;0;0;0;.00nan;0;0
6568;192739;556;31;32;6;26;.813;3600000;0
6568;196445;556;0;0;0;0;.00nan;0;0
6568;77086;552;71;24;2;22;.917;3600000;0
6568;146213;552;0;0;0;0;.00nan;0;0
6569;4379;560;0;0;0;0;.00nan;0;0
6569;-1;561;0;0;0;0;.00nan;0;0
6569;-1;560;49;34;5;29;.853;3600000;0
6569;65324;561;85;31;1;30;.968;3600000;0
6570;167061;2626;79;31;2;29;.935;3600000;0
6570;28989;2626;0;0;0;0;.00nan;0;0
6570;-1;555;56;29;4;25;.862;3600000;0
6570;68961;555;0;0;0;0;.00nan;0;0
6571;194531;558;0;0;0;0;.00nan;0;0
6571;169615;554;59;31;4;27;.871;3600000;0
6571;-1;554;0;0;0;0;.00nan;0;0
6571;186810;558;88;35;1;34;.971;3600000;0
6572;192895;553;0;0;0;0;.00nan;0;0
6572;201876;553;72;27;2;25;.926;3600000;0
6572;196812;1423;55;21;3;18;.857;3581000;0
6572;-1;1423;0;0;0;0;.00nan;0;0
6573;169615;554;55;24;3;21;.875;3900000;0
6573;-1;554;0;0;0;0;.00nan;0;0
6573;-1;561;0;0;0;0;.00nan;0;0
6573;65324;561;84;41;3;38;.927;3900000;0
6574;169615;554;100;24;0;24;1.000;3600000;0
6574;-1;554;0;0;0;0;.00nan;0;0
6574;-1;561;86;30;1;29;.967;3568000;0
6574;65324;561;0;0;0;0;.00nan;0;0
6575;192739;556;41;23;4;19;.826;3600000;0
6575;192895;553;99;42;1;41;.976;3600000;0
6575;201876;553;0;0;0;0;.00nan;0;0
6575;196445;556;0;0;0;0;.00nan;0;0
6576;194531;558;0;0;0;0;.00nan;0;0
6576;196812;1423;47;23;4;19;.826;2110000;0
6576;186810;558;67;18;1;17;.944;3600000;0
6576;-1;1423;51;16;2;14;.875;1490000;0
6577;-1;555;59;17;1;16;.941;1451000;0
6577;68961;555;51;41;6;35;.854;2149000;0
6577;77086;552;0;0;0;0;.00nan;0;0
6577;146213;552;44;9;2;7;.778;3600000;0
6578;167061;2626;94;42;3;39;.929;3600000;0
6578;194531;558;49;2;0;2;1.000;338000;0
6578;28989;2626;0;0;0;0;.00nan;0;0
6578;186810;558;30;30;6;24;.800;3262000;0
6579;196812;1423;89;27;1;26;.963;3600000;0
6579;-1;555;70;43;4;39;.907;3600000;0
6579;-1;1423;0;0;0;0;.00nan;0;0
6579;68961;555;0;0;0;0;.00nan;0;0
6580;192895;553;0;0;0;0;.00nan;0;0
6580;201876;553;80;56;5;51;.911;3600000;0
6580;77086;552;46;12;2;10;.833;3600000;0
6580;146213;552;0;0;0;0;.00nan;0;0
6581;192895;553;50;29;4;25;.862;3600000;0
6581;4379;560;21;21;6;15;.714;3119000;0
6581;201876;553;0;0;0;0;.00nan;0;0
6581;-1;560;56;12;1;11;.917;465000;0
6582;194531;558;43;31;5;26;.839;3546000;0
6582;186810;558;0;0;0;0;.00nan;0;0
6582;77086;552;56;31;4;27;.871;3600000;0
6582;146213;552;0;0;0;0;.00nan;0;0
6583;192739;556;75;26;1;25;.962;3600000;0
6583;196445;556;0;0;0;0;.00nan;0;0
6583;196812;1423;31;17;4;13;.765;993000;0
6583;-1;1423;59;26;2;24;.923;2607000;0
6584;167061;2626;67;17;1;16;.941;3600000;0
6584;28989;2626;0;0;0;0;.00nan;0;0
6584;-1;555;63;48;6;42;.875;3600000;0
6584;68961;555;0;0;0;0;.00nan;0;0
6585;169615;554;71;19;1;18;.947;3600000;0
6585;-1;554;0;0;0;0;.00nan;0;0
6585;-1;561;0;0;0;0;.00nan;0;0
6585;65324;561;88;45;3;42;.933;3573000;0
6586;167061;2626;65;28;3;25;.893;3639000;0
6586;28989;2626;0;0;0;0;.00nan;0;0
6586;-1;561;0;0;0;0;.00nan;0;0
6586;65324;561;62;31;4;27;.871;3639000;0
6587;192895;553;0;0;0;0;.00nan;0;0
6587;169615;554;60;27;3;24;.889;3583000;0
6587;-1;554;0;0;0;0;.00nan;0;0
6587;201876;553;88;38;2;36;.947;3600000;0
6588;4379;560;0;0;0;0;.00nan;0;0
6588;196812;1423;64;17;1;16;.941;3600000;0
6588;-1;560;97;50;3;47;.940;3599000;0
6588;-1;1423;0;0;0;0;.00nan;0;0
6589;192739;556;0;0;0;0;.00nan;0;0
6589;196445;556;91;18;0;18;1.000;3600000;0
6589;-1;555;0;0;0;0;.00nan;0;0
6589;68961;555;97;49;1;48;.980;3600000;0
6590;194531;558;0;0;0;0;.00nan;0;0
6590;186810;558;97;51;3;48;.941;3600000;0
6590;77086;552;0;0;0;0;.00nan;0;0
6590;146213;552;74;25;2;23;.920;3600000;0
6591;167061;2626;92;35;1;34;.971;3600000;0
6591;28989;2626;0;0;0;0;.00nan;0;0
6591;-1;561;0;0;0;0;.00nan;0;0
6591;65324;561;53;28;4;24;.857;3600000;0
6592;4379;560;59;35;4;31;.886;3600000;0
6592;196812;1423;75;30;2;28;.933;3600000;0
6592;-1;560;0;0;0;0;.00nan;0;0
6592;-1;1423;0;0;0;0;.00nan;0;0
6593;192895;553;79;35;2;33;.943;3600000;0
6593;194531;558;0;0;0;0;.00nan;0;0
6593;201876;553;0;0;0;0;.00nan;0;0
6593;186810;558;76;39;3;36;.923;3580000;0
6594;192739;556;0;0;0;0;.00nan;0;0
6594;196445;556;57;13;1;12;.923;3600000;0
6594;-1;555;0;0;0;0;.00nan;0;0
6594;68961;555;38;46;7;39;.848;3600000;0
6595;169615;554;79;42;3;39;.929;3600000;0
6595;-1;554;0;0;0;0;.00nan;0;0
6595;77086;552;0;0;0;0;.00nan;0;0
6595;146213;552;69;37;4;33;.892;3544000;0
6596;192739;556;52;22;3;19;.864;3600000;0
6596;167061;2626;77;39;2;37;.949;3600000;0
6596;28989;2626;0;0;0;0;.00nan;0;0
6596;196445;556;0;0;0;0;.00nan;0;0
6597;4379;560;0;0;0;0;.00nan;0;0
6597;194531;558;66;40;4;36;.900;3600000;0
6597;186810;558;0;0;0;0;.00nan;0;0
6597;-1;560;86;33;2;31;.939;3600000;0
6598;196812;1423;0;0;0;0;.00nan;0;0
6598;-1;561;0;0;0;0;.00nan;0;0
6598;-1;1423;77;38;2;36;.947;3543000;0
6598;65324;561;81;22;1;21;.955;3600000;0
6599;169615;554;75;29;2;27;.931;3900000;0
6599;-1;554;0;0;0;0;.00nan;0;0
6599;-1;555;100;41;2;39;.951;3879000;0
6599;68961;555;0;0;0;0;.00nan;0;0
6600;192895;553;0;0;0;0;.00nan;0;0
6600;201876;553;79;34;3;31;.912;3525000;0
6600;77086;552;66;15;1;14;.933;3600000;0
6600;146213;552;0;0;0;0;.00nan;0;0
6601;192739;556;59;39;5;34;.872;3600000;0
6601;196445;556;0;0;0;0;.00nan;0;0
6601;77086;552;0;0;0;0;.00nan;0;0
6601;146213;552;90;32;2;30;.938;3600000;0
6602;4379;560;66;34;3;31;.912;3600000;0
6602;-1;561;41;9;2;7;.778;1488000;0
6602;-1;560;0;0;0;0;.00nan;0;0
6602;65324;561;47;25;4;21;.840;2112000;0
6603;192895;553;100;36;1;35;.972;3900000;0
6603;201876;553;0;0;0;0;.00nan;0;0
6603;196812;1423;83;28;1;27;.964;3900000;0
6603;-1;1423;0;0;0;0;.00nan;0;0
6604;194531;558;0;0;0;0;.00nan;0;0
6604;186810;558;32;14;4;10;.714;3600000;0
6604;-1;555;35;22;4;18;.818;669000;0
6604;68961;555;77;39;3;36;.923;2931000;0
6605;167061;2626;50;30;5;25;.833;3600000;0
6605;169615;554;76;32;3;29;.906;3600000;0
6605;-1;554;0;0;0;0;.00nan;0;0
6605;28989;2626;0;0;0;0;.00nan;0;0
6606;192739;556;0;0;0;0;.00nan;0;0
6606;196445;556;69;28;2;26;.929;3549000;0
6606;77086;552;100;24;0;24;1.000;3600000;0
6606;146213;552;0;0;0;0;.00nan;0;0
6607;4379;560;0;0;0;0;.00nan;0;0
6607;-1;561;99;40;1;39;.975;3600000;0
6607;-1;560;54;28;4;24;.857;3600000;0
6607;65324;561;0;0;0;0;.00nan;0;0
6608;167061;2626;100;48;1;47;.979;3900000;0
6608;169615;554;97;28;1;27;.964;3900000;0
6608;-1;554;0;0;0;0;.00nan;0;0
6608;28989;2626;0;0;0;0;.00nan;0;0
6609;194531;558;61;12;1;11;.917;3600000;0
6609;186810;558;0;0;0;0;.00nan;0;0
6609;-1;555;0;0;0;0;.00nan;0;0
6609;68961;555;95;49;2;47;.959;3567000;0
6610;4379;560;92;33;1;32;.970;3900000;0
6610;167061;2626;91;30;1;29;.967;3900000;0
6610;28989;2626;0;0;0;0;.00nan;0;0
6610;-1;560;0;0;0;0;.00nan;0;0
6611;194531;558;0;0;0;0;.00nan;0;0
6611;169615;554;65;37;5;32;.865;3600000;0
6611;-1;554;0;0;0;0;.00nan;0;0
6611;186810;558;71;18;1;17;.944;3600000;0
6612;192739;556;85;31;2;29;.935;3600000;0
6612;196445;556;0;0;0;0;.00nan;0;0
6612;-1;561;0;0;0;0;.00nan;0;0
6612;65324;561;39;36;6;30;.833;3600000;0
6613;192895;553;12;19;6;13;.684;2252000;0
6613;201876;553;53;12;1;11;.917;1348000;0
6613;196812;1423;55;20;2;18;.900;3600000;0
6613;-1;1423;0;0;0;0;.00nan;0;0
6614;-1;555;73;18;0;18;1.000;850000;0
6614;68961;555;49;47;7;40;.851;2750000;0
6614;77086;552;88;12;0;12;1.000;3600000;0
6614;146213;552;0;0;0;0;.00nan;0;0
6615;167061;2626;71;45;5;40;.889;3600000;0
6615;28989;2626;0;0;0;0;.00nan;0;0
6615;77086;552;58;23;3;20;.870;3600000;0
6615;146213;552;0;0;0;0;.00nan;0;0
6616;192895;553;91;32;1;31;.969;3674000;0
6616;201876;553;0;0;0;0;.00nan;0;0
6616;-1;561;85;30;2;28;.933;3674000;0
6616;65324;561;0;0;0;0;.00nan;0;0
6617;194531;558;98;25;0;25;1.000;3600000;0
6617;196812;1423;0;0;0;0;.00nan;0;0
6617;186810;558;0;0;0;0;.00nan;0;0
6617;-1;1423;77;32;2;30;.938;3575000;0
6618;4379;560;0;0;0;0;.00nan;0;0
6618;-1;555;66;25;2;23;.920;3600000;0
6618;-1;560;52;22;3;19;.864;3600000;0
6618;68961;555;0;0;0;0;.00nan;0;0
6619;192739;556;0;0;0;0;.00nan;0;0
6619;169615;554;0;0;0;0;.00nan;0;0
6619;-1;554;86;31;1;30;.968;3579000;0
6619;196445;556;100;37;0;37;1.000;3600000;0
6620;4379;560;50;36;5;31;.861;3600000;0
6620;194531;558;0;0;0;0;.00nan;0;0
6620;186810;558;57;28;3;25;.893;3600000;0
6620;-1;560;0;0;0;0;.00nan;0;0
6621;192739;556;0;0;0;0;.00nan;0;0
6621;167061;2626;94;35;2;33;.943;3600000;0
6621;28989;2626;0;0;0;0;.00nan;0;0
6621;196445;556;32;27;6;21;.778;3600000;0
6622;192895;553;94;57;3;54;.947;3600000;0
6622;169615;554;87;17;0;17;1.000;3600000;0
6622;-1;554;0;0;0;0;.00nan;0;0
6622;201876;553;0;0;0;0;.00nan;0;0
6623;196812;1423;63;45;5;40;.889;3600000;0
6623;-1;1423;0;0;0;0;.00nan;0;0
6623;77086;552;0;0;0;0;.00nan;0;0
6623;146213;552;57;14;1;13;.929;3600000;0
6624;192739;556;80;25;1;24;.960;3600000;0
6624;167061;2626;62;29;3;26;.897;3535000;0
6624;28989;2626;0;0;0;0;.00nan;0;0
6624;196445;556;0;0;0;0;.00nan;0;0
6625;167061;2626;0;0;0;0;.00nan;0;0
6625;28989;2626;72;25;2;23;.920;3600000;0
6625;196812;1423;47;18;3;15;.833;3600000;0
6625;-1;1423;0;0;0;0;.00nan;0;0
6626;4379;560;0;0;0;0;.00nan;0;0
6626;194531;558;75;27;2;25;.926;3600000;0
6626;186810;558;0;0;0;0;.00nan;0;0
6626;-1;560;82;40;3;37;.925;3553000;0
6627;192895;553;64;15;1;14;.933;3600000;0
6627;201876;553;0;0;0;0;.00nan;0;0
6627;-1;555;0;0;0;0;.00nan;0;0
6627;68961;555;59;41;4;37;.902;3600000;0
6628;169615;554;49;40;6;34;.850;3352000;0
6628;-1;554;49;1;0;1;1.000;248000;0
6628;77086;552;67;27;3;24;.889;3600000;0
6628;146213;552;0;0;0;0;.00nan;0;0
6629;-1;555;0;0;0;0;.00nan;0;0
6629;-1;561;0;0;0;0;.00nan;0;0
6629;65324;561;69;32;3;29;.906;3600000;0
6629;68961;555;76;44;4;40;.909;3591000;0
6630;192895;553;100;28;0;28;1.000;3600000;0
6630;4379;560;59;34;4;30;.882;3600000;0
6630;201876;553;0;0;0;0;.00nan;0;0
6630;-1;560;0;0;0;0;.00nan;0;0
6631;196812;1423;0;0;0;0;.00nan;0;0
6631;-1;1423;70;31;2;29;.935;3549000;0
6631;77086;552;0;0;0;0;.00nan;0;0
6631;146213;552;85;19;1;18;.947;3600000;0
6632;194531;558;0;0;0;0;.00nan;0;0
6632;169615;554;71;25;2;23;.920;3600000;0
6632;-1;554;0;0;0;0;.00nan;0;0
6632;186810;558;77;35;3;32;.914;3579000;0
6633;194531;558;65;17;1;16;.941;3600000;0
6633;186810;558;0;0;0;0;.00nan;0;0
6633;-1;555;0;0;0;0;.00nan;0;0
6633;68961;555;98;49;2;47;.959;3543000;0
6634;194531;558;0;0;0;0;.00nan;0;0
6634;186810;558;89;15;0;15;1.000;3600000;0
6634;-1;561;0;0;0;0;.00nan;0;0
6634;65324;561;71;24;2;22;.917;3515000;0
6635;4379;560;52;28;3;25;.893;3514000;0
6635;-1;560;0;0;0;0;.00nan;0;0
6635;77086;552;80;31;1;30;.968;3600000;0
6635;146213;552;0;0;0;0;.00nan;0;0
6636;192895;553;86;22;1;21;.955;3702000;0
6636;167061;2626;92;45;2;43;.956;3702000;0
6636;28989;2626;0;0;0;0;.00nan;0;0
6636;201876;553;0;0;0;0;.00nan;0;0
6637;192739;556;24;25;6;19;.760;3077000;0
6637;169615;554;76;24;1;23;.958;3600000;0
6637;-1;554;0;0;0;0;.00nan;0;0
6637;196445;556;59;7;0;7;1.000;523000;0
6638;196812;1423;51;22;3;19;.864;3600000;0
6638;-1;555;71;49;5;44;.898;3580000;0
6638;-1;1423;0;0;0;0;.00nan;0;0
6638;68961;555;0;0;0;0;.00nan;0;0
6639;192739;556;0;0;0;0;.00nan;0;0
6639;192895;553;86;38;3;35;.921;3600000;0
6639;201876;553;0;0;0;0;.00nan;0;0
6639;196445;556;74;26;2;24;.923;3600000;0
6640;4379;560;0;0;0;0;.00nan;0;0
6640;196812;1423;0;0;0;0;.00nan;0;0
6640;-1;560;52;24;3;21;.875;3600000;0
6640;-1;1423;51;32;4;28;.875;3557000;0
6641;169615;554;72;8;0;8;1.000;3600000;0
6641;-1;554;0;0;0;0;.00nan;0;0
6641;-1;561;69;55;5;50;.909;3600000;0
6641;65324;561;0;0;0;0;.00nan;0;0
6642;167061;2626;75;54;5;49;.907;3600000;0
6642;28989;2626;0;0;0;0;.00nan;0;0
6642;77086;552;0;0;0;0;.00nan;0;0
6642;146213;552;85;16;0;16;1.000;3600000;0
6643;167061;2626;92;41;1;40;.976;3600000;0
6643;28989;2626;0;0;0;0;.00nan;0;0
6643;-1;561;0;0;0;0;.00nan;0;0
6643;65324;561;44;16;3;13;.813;3514000;0
6644;4379;560;0;0;0;0;.00nan;0;0
6644;196812;1423;68;26;2;24;.923;3900000;0
6644;-1;560;90;37;2;35;.946;3900000;0
6644;-1;1423;0;0;0;0;.00nan;0;0
6645;192739;556;83;37;4;33;.892;3599000;0
6645;194531;558;52;23;3;20;.870;3600000;0
6645;196445;556;0;0;0;0;.00nan;0;0
6645;186810;558;0;0;0;0;.00nan;0;0
6646;192895;553;83;30;2;28;.933;3600000;0
6646;201876;553;0;0;0;0;.00nan;0;0
6646;-1;555;33;34;6;28;.824;3600000;0
6646;68961;555;0;0;0;0;.00nan;0;0
6647;167061;2626;78;40;3;37;.925;3900000;0
6647;28989;2626;0;0;0;0;.00nan;0;0
6647;-1;561;84;39;3;36;.923;3900000;0
6647;65324;561;0;0;0;0;.00nan;0;0
6648;192739;556;0;0;0;0;.00nan;0;0
6648;194531;558;96;37;1;36;.973;3600000;0
6648;196445;556;57;22;2;20;.909;3575000;0
6648;186810;558;0;0;0;0;.00nan;0;0
6649;4379;560;60;44;6;38;.864;3600000;0
6649;169615;554;90;17;0;17;1.000;3600000;0
6649;-1;554;0;0;0;0;.00nan;0;0
6649;-1;560;0;0;0;0;.00nan;0;0
6650;-1;555;0;0;0;0;.00nan;0;0
6650;68961;555;92;62;3;59;.952;3600000;0
6650;77086;552;0;0;0;0;.00nan;0;0
6650;146213;552;55;14;2;12;.857;3600000;0
6651;192895;553;0;0;0;0;.00nan;0;0
6651;201876;553;72;31;2;29;.935;3550000;0
6651;77086;552;98;24;0;24;1.000;3600000;0
6651;146213;552;0;0;0;0;.00nan;0;0
6652;169615;554;40;12;2;10;.833;3600000;0
6652;-1;554;0;0;0;0;.00nan;0;0
6652;196812;1423;62;45;5;40;.889;3600000;0
6652;-1;1423;0;0;0;0;.00nan;0;0
6653;4379;560;50;37;4;33;.892;3535000;0
6653;167061;2626;79;32;2;30;.938;3600000;0
6653;28989;2626;0;0;0;0;.00nan;0;0
6653;-1;560;0;0;0;0;.00nan;0;0
6654;169615;554;53;18;3;15;.833;3600000;0
6654;-1;554;0;0;0;0;.00nan;0;0
6654;196812;1423;64;49;6;43;.878;3600000;0
6654;-1;1423;0;0;0;0;.00nan;0;0
6655;4379;560;48;23;3;20;.870;1235000;0
6655;169615;554;32;41;8;33;.805;3600000;0
6655;-1;554;0;0;0;0;.00nan;0;0
6655;-1;560;20;22;6;16;.727;2353000;0
6656;167061;2626;66;43;6;37;.860;3600000;0
6656;194531;558;79;27;2;25;.926;3600000;0
6656;28989;2626;0;0;0;0;.00nan;0;0
6656;186810;558;0;0;0;0;.00nan;0;0
6657;192739;556;50;13;2;11;.846;3600000;0
6657;196445;556;0;0;0;0;.00nan;0;0
6657;-1;555;79;57;5;52;.912;3600000;0
6657;68961;555;0;0;0;0;.00nan;0;0
6658;-1;561;0;0;0;0;.00nan;0;0
6658;65324;561;69;45;5;40;.889;3600000;0
6658;77086;552;70;21;1;20;.952;3600000;0
6658;146213;552;0;0;0;0;.00nan;0;0
6659;192895;553;68;18;1;17;.944;3600000;0
6659;167061;2626;31;27;5;22;.815;3600000;0
6659;28989;2626;0;0;0;0;.00nan;0;0
6659;201876;553;0;0;0;0;.00nan;0;0
6660;192739;556;0;0;0;0;.00nan;0;0
6660;4379;560;65;39;4;35;.897;3579000;0
6660;196445;556;63;24;3;21;.875;3600000;0
6660;-1;560;0;0;0;0;.00nan;0;0
6661;196812;1423;52;20;3;17;.850;3846000;0
6661;-1;555;0;0;0;0;.00nan;0;0
6661;-1;1423;0;0;0;0;.00nan;0;0
6661;68961;555;80;53;3;50;.943;3900000;0
6662;-1;561;86;55;4;51;.927;3794000;0
6662;65324;561;0;0;0;0;.00nan;0;0
6662;77086;552;0;0;0;0;.00nan;0;0
6662;146213;552;46;19;3;16;.842;3794000;0
6663;194531;558;41;39;6;33;.846;3600000;0
6663;169615;554;83;41;2;39;.951;3600000;0
6663;-1;554;0;0;0;0;.00nan;0;0
6663;186810;558;0;0;0;0;.00nan;0;0
6664;196812;1423;73;40;3;37;.925;3514000;0
6664;-1;561;0;0;0;0;.00nan;0;0
6664;-1;1423;0;0;0;0;.00nan;0;0
6664;65324;561;85;31;1;30;.968;3600000;0
6665;192895;553;85;42;4;38;.905;3515000;0
6665;194531;558;54;18;2;16;.889;3600000;0
6665;201876;553;0;0;0;0;.00nan;0;0
6665;186810;558;0;0;0;0;.00nan;0;0
6666;167061;2626;46;23;4;19;.826;3600000;0
6666;28989;2626;0;0;0;0;.00nan;0;0
6666;-1;555;84;32;1;31;.969;3600000;0
6666;68961;555;0;0;0;0;.00nan;0;0
6667;196812;1423;0;0;0;0;.00nan;0;0
6667;-1;561;69;33;3;30;.909;3576000;0
6667;-1;1423;85;29;1;28;.966;3600000;0
6667;65324;561;0;0;0;0;.00nan;0;0
6668;4379;560;96;39;1;38;.974;3600000;0
6668;194531;558;57;22;3;19;.864;3565000;0
6668;186810;558;0;0;0;0;.00nan;0;0
6668;-1;560;0;0;0;0;.00nan;0;0
6669;192739;556;57;16;2;14;.875;3600000;0
6669;196445;556;0;0;0;0;.00nan;0;0
6669;-1;555;48;17;2;15;.882;637000;0
6669;68961;555;51;41;6;35;.854;2963000;0
6670;169615;554;47;24;4;20;.833;3600000;0
6670;-1;554;0;0;0;0;.00nan;0;0
6670;77086;552;91;49;3;46;.939;3600000;0
6670;146213;552;0;0;0;0;.00nan;0;0
6671;192739;556;0;0;0;0;.00nan;0;0
6671;4379;560;0;0;0;0;.00nan;0;0
6671;196445;556;100;26;0;26;1.000;3600000;0
6671;-1;560;82;37;2;35;.946;3600000;0
6672;167061;2626;98;62;4;58;.935;3600000;0
6672;28989;2626;0;0;0;0;.00nan;0;0
6672;77086;552;0;0;0;0;.00nan;0;0
6672;146213;552;73;17;1;16;.941;3600000;0
6673;4379;560;89;39;2;37;.949;3575000;0
6673;-1;560;0;0;0;0;.00nan;0;0
6673;77086;552;86;26;1;25;.962;3600000;0
6673;146213;552;0;0;0;0;.00nan;0;0
6674;192895;553;100;36;0;36;1.000;3600000;0
6674;201876;553;0;0;0;0;.00nan;0;0
6674;196812;1423;66;34;3;31;.912;3600000;0
6674;-1;1423;0;0;0;0;.00nan;0;0
6675;192739;556;0;0;0;0;.00nan;0;0
6675;192895;553;85;38;3;35;.921;3528000;0
6675;201876;553;0;0;0;0;.00nan;0;0
6675;196445;556;85;26;1;25;.962;3600000;0
6676;192895;553;0;0;0;0;.00nan;0;0
6676;201876;553;68;36;4;32;.889;3900000;0
6676;-1;561;0;0;0;0;.00nan;0;0
6676;65324;561;55;33;4;29;.879;3900000;0
6677;192739;556;42;17;4;13;.765;3540000;0
6677;196445;556;0;0;0;0;.00nan;0;0
6677;196812;1423;89;41;2;39;.951;3600000;0
6677;-1;1423;0;0;0;0;.00nan;0;0
6678;167061;2626;89;25;0;25;1.000;3900000;0
6678;28989;2626;0;0;0;0;.00nan;0;0
6678;-1;555;100;34;0;34;1.000;3900000;0
6678;68961;555;0;0;0;0;.00nan;0;0
6679;169615;554;100;34;2;32;.941;3600000;0
6679;-1;554;0;0;0;0;.00nan;0;0
6679;77086;552;63;28;3;25;.893;3544000;0
6679;146213;552;0;0;0;0;.00nan;0;0
6680;4379;560;95;46;2;44;.957;3600000;0
6680;169615;554;41;16;4;12;.750;3561000;0
6680;-1;554;0;0;0;0;.00nan;0;0
6680;-1;560;0;0;0;0;.00nan;0;0
6681;167061;2626;52;17;2;15;.882;3600000;0
6681;28989;2626;0;0;0;0;.00nan;0;0
6681;-1;555;27;28;6;22;.786;2924000;0
6681;68961;555;60;9;0;9;1.000;676000;0
6682;194531;558;69;20;1;19;.950;3600000;0
6682;186810;558;0;0;0;0;.00nan;0;0
6682;-1;561;79;44;4;40;.909;3600000;0
6682;65324;561;0;0;0;0;.00nan;0;0
6683;196812;1423;29;47;9;38;.809;3600000;0
6683;-1;1423;0;0;0;0;.00nan;0;0
6683;77086;552;0;0;0;0;.00nan;0;0
6683;146213;552;81;15;0;15;1.000;3600000;0
6684;192739;556;92;20;0;20;1.000;3600000;0
6684;192895;553;84;41;3;38;.927;3600000;0
6684;201876;553;0;0;0;0;.00nan;0;0
6684;196445;556;0;0;0;0;.00nan;0;0
6685;192739;556;73;26;2;24;.923;3694000;0
6685;196445;556;0;0;0;0;.00nan;0;0
6685;-1;561;0;0;0;0;.00nan;0;0
6685;65324;561;99;42;1;41;.976;3694000;0
6686;192895;553;0;0;0;0;.00nan;0;0
6686;201876;553;80;14;0;14;1.000;3600000;0
6686;-1;555;78;40;3;37;.925;3600000;0
6686;68961;555;0;0;0;0;.00nan;0;0
6687;194531;558;71;18;1;17;.944;3600000;0
6687;196812;1423;97;48;2;46;.958;3600000;0
6687;186810;558;0;0;0;0;.00nan;0;0
6687;-1;1423;0;0;0;0;.00nan;0;0
6688;167061;2626;87;41;3;38;.927;3538000;0
6688;169615;554;0;0;0;0;.00nan;0;0
6688;-1;554;89;25;1;24;.960;3600000;0
6688;28989;2626;0;0;0;0;.00nan;0;0
6689;4379;560;66;40;3;37;.925;3547000;0
6689;-1;560;0;0;0;0;.00nan;0;0
6689;77086;552;0;0;0;0;.00nan;0;0
6689;146213;552;68;20;2;18;.900;3600000;0
6690;4379;560;0;0;0;0;.00nan;0;0
6690;-1;561;31;30;6;24;.800;3600000;0
6690;-1;560;93;34;1;33;.971;3600000;0
6690;65324;561;0;0;0;0;.00nan;0;0
6691;167061;2626;100;37;1;36;.973;3900000;0
6691;28989;2626;0;0;0;0;.00nan;0;0
6691;196812;1423;0;0;0;0;.00nan;0;0
6691;-1;1423;88;31;1;30;.968;3900000;0
6692;-1;555;0;0;0;0;.00nan;0;0
6692;68961;555;85;49;5;44;.898;3600000;0
6692;77086;552;55;15;2;13;.867;3600000;0
6692;146213;552;0;0;0;0;.00nan;0;0
6693;192739;556;49;40;6;34;.850;3600000;0
6693;169615;554;67;30;3;27;.900;3600000;0
6693;-1;554;0;0;0;0;.00nan;0;0
6693;196445;556;0;0;0;0;.00nan;0;0
6694;4379;560;52;25;3;22;.880;3541000;0
6694;-1;555;99;42;1;41;.976;3600000;0
6694;-1;560;0;0;0;0;.00nan;0;0
6694;68961;555;0;0;0;0;.00nan;0;0
6695;-1;561;0;0;0;0;.00nan;0;0
6695;65324;561;95;48;3;45;.938;3600000;0
6695;77086;552;66;17;1;16;.941;3600000;0
6695;146213;552;0;0;0;0;.00nan;0;0
6696;-1;561;94;33;1;32;.970;3600000;0
6696;65324;561;0;0;0;0;.00nan;0;0
6696;77086;552;0;0;0;0;.00nan;0;0
6696;146213;552;64;21;2;19;.905;3541000;0
6697;4379;560;94;36;1;35;.972;3568000;0
6697;167061;2626;100;37;0;37;1.000;3600000;0
6697;28989;2626;0;0;0;0;.00nan;0;0
6697;-1;560;0;0;0;0;.00nan;0;0
6698;192895;553;0;0;0;0;.00nan;0;0
6698;194531;558;62;34;4;30;.882;3600000;0
6698;201876;553;88;43;3;40;.930;3600000;0
6698;186810;558;0;0;0;0;.00nan;0;0
6699;192739;556;60;25;4;21;.840;3600000;0
6699;196445;556;0;0;0;0;.00nan;0;0
6699;196812;1423;92;32;1;31;.969;3600000;0
6699;-1;1423;0;0;0;0;.00nan;0;0
6700;169615;554;76;23;1;22;.957;3600000;0
6700;-1;554;0;0;0;0;.00nan;0;0
6700;-1;555;91;41;2;39;.951;3577000;0
6700;68961;555;0;0;0;0;.00nan;0;0
6701;167061;2626;69;35;3;32;.914;3555000;0
6701;28989;2626;0;0;0;0;.00nan;0;0
6701;196812;1423;84;36;2;34;.944;3600000;0
6701;-1;1423;0;0;0;0;.00nan;0;0
6702;192895;553;19;26;6;20;.769;2577000;0
6702;194531;558;51;8;1;7;.875;846000;0
6702;201876;553;53;15;2;13;.867;1023000;0
6702;186810;558;49;38;6;32;.842;2754000;0
6703;192739;556;0;0;0;0;.00nan;0;0
6703;4379;560;0;0;0;0;.00nan;0;0
6703;196445;556;60;14;1;13;.929;3600000;0
6703;-1;560;68;43;5;38;.884;3600000;0
6704;169615;554;75;18;1;17;.944;3600000;0
6704;-1;554;0;0;0;0;.00nan;0;0
6704;-1;555;0;0;0;0;.00nan;0;0
6704;68961;555;96;48;3;45;.938;3588000;0
6705;-1;555;48;31;5;26;.839;3739000;0
6705;-1;561;0;0;0;0;.00nan;0;0
6705;65324;561;74;36;4;32;.889;3739000;0
6705;68961;555;0;0;0;0;.00nan;0;0
6727;167061;2626;88;19;1;18;.947;3600000;0
6727;28989;2626;0;0;0;0;.00nan;0;0
6727;-1;555;65;37;4;33;.892;3600000;0
6727;68961;555;0;0;0;0;.00nan;0;0
6729;4379;560;26;6;3;3;.500;518000;0
6729;-1;560;94;41;1;40;.976;3082000;0
6729;77086;552;61;18;1;17;.944;3600000;0
6729;146213;552;0;0;0;0;.00nan;0;0
6731;192739;556;57;42;5;37;.881;3574000;0
6731;-1;561;0;0;0;0;.00nan;0;0
6731;65324;561;85;41;3;38;.927;3600000;0
6731;85349;556;0;0;0;0;.00nan;0;0
6733;192895;553;75;38;3;35;.921;3035000;0
6733;194531;558;0;0;0;0;.00nan;0;0
6733;201876;553;28;8;3;5;.625;565000;0
6733;186810;558;72;24;2;22;.917;3600000;0
6735;169615;554;75;25;2;23;.920;3600000;0
6735;-1;554;0;0;0;0;.00nan;0;0
6735;196812;1423;83;38;3;35;.921;3600000;0
6735;-1;1423;0;0;0;0;.00nan;0;0
6737;169615;554;80;51;5;46;.902;3566000;0
6737;-1;554;0;0;0;0;.00nan;0;0
6737;77086;552;50;16;3;13;.813;3600000;0
6737;146213;552;0;0;0;0;.00nan;0;0
6739;192895;553;53;14;2;12;.857;3600000;0
6739;201876;553;0;0;0;0;.00nan;0;0
6739;-1;555;75;49;5;44;.898;3600000;0
6739;68961;555;0;0;0;0;.00nan;0;0
6741;192739;556;96;23;0;23;1.000;3600000;0
6741;167061;2626;57;28;3;25;.893;3600000;0
6741;28989;2626;0;0;0;0;.00nan;0;0
6741;85349;556;0;0;0;0;.00nan;0;0
6743;196812;1423;79;28;1;27;.964;3600000;0
6743;-1;561;0;0;0;0;.00nan;0;0
6743;-1;1423;0;0;0;0;.00nan;0;0
6743;65324;561;58;22;2;20;.909;3584000;0
6745;4379;560;0;0;0;0;.00nan;0;0
6745;194531;558;58;31;3;28;.903;3559000;0
6745;186810;558;0;0;0;0;.00nan;0;0
6745;-1;560;100;58;2;56;.966;3600000;0
6753;169615;554;0;0;0;0;.00nan;0;0
6753;-1;554;79;29;2;27;.931;3600000;0
6753;196812;1423;0;0;0;0;.00nan;0;0
6753;-1;1423;86;27;1;26;.963;3600000;0
6769;4379;560;0;0;0;0;.00nan;0;0
6769;-1;560;66;52;5;47;.904;3600000;0
6769;77086;552;0;0;0;0;.00nan;0;0
6769;146213;552;62;15;1;14;.933;3600000;0
2062;196812;1423;50;52;8;44;.846;3600000;0
2062;-1;1423;0;0;0;0;.00nan;0;0
2062;77086;552;85;11;0;11;1.000;3600000;0
2062;146213;552;0;0;0;0;.00nan;0;0
2063;169615;554;78;25;1;24;.960;3600000;0
2063;-1;554;0;0;0;0;.00nan;0;0
2063;-1;561;0;0;0;0;.00nan;0;0
2063;65324;561;74;37;4;33;.892;3600000;0
2064;192739;556;93;50;4;46;.920;3542000;0
2064;194531;558;67;30;3;27;.900;3600000;0
2064;196445;556;0;0;0;0;.00nan;0;0
2064;186810;558;0;0;0;0;.00nan;0;0
2065;192895;553;74;21;1;20;.952;3600000;0
2065;167061;2626;86;40;2;38;.950;3600000;0
2065;28989;2626;0;0;0;0;.00nan;0;0
2065;201876;553;0;0;0;0;.00nan;0;0
2066;196812;1423;83;37;2;35;.946;3600000;0
2066;-1;1423;0;0;0;0;.00nan;0;0
2066;77086;552;75;23;1;22;.957;3600000;0
2066;146213;552;0;0;0;0;.00nan;0;0
2067;169615;554;60;16;1;15;.938;3600000;0
2067;-1;554;0;0;0;0;.00nan;0;0
2067;-1;561;58;6;0;6;1.000;940000;0
2067;65324;561;22;31;7;24;.774;2660000;0
2068;192739;556;100;43;1;42;.977;3600000;0
2068;194531;558;85;24;1;23;.958;3600000;0
2068;196445;556;0;0;0;0;.00nan;0;0
2068;186810;558;0;0;0;0;.00nan;0;0
2069;192895;553;86;39;2;37;.949;3600000;0
2069;167061;2626;46;25;4;21;.840;3555000;0
2069;28989;2626;0;0;0;0;.00nan;0;0
2069;201876;553;0;0;0;0;.00nan;0;0
2187;194531;558;100;42;1;41;.976;3600000;0
2187;186810;558;0;0;0;0;.00nan;0;0
2187;77086;552;64;26;2;24;.923;3600000;0
2187;146213;552;0;0;0;0;.00nan;0;0
2188;192895;553;89;34;2;32;.941;3562000;0
2188;169615;554;83;26;1;25;.962;3600000;0
2188;-1;554;0;0;0;0;.00nan;0;0
2188;201876;553;0;0;0;0;.00nan;0;0
2290;194531;558;91;27;1;26;.963;3600000;0
2290;169615;554;86;33;2;31;.939;3552000;0
2290;-1;554;0;0;0;0;.00nan;0;0
2290;186810;558;0;0;0;0;.00nan;0;0
2291;192895;553;71;51;5;46;.902;3600000;0
2291;201876;553;0;0;0;0;.00nan;0;0
2291;77086;552;59;19;2;17;.895;3600000;0
2291;146213;552;0;0;0;0;.00nan;0;0
6776;203276;82;88;51;4;47;.922;3572000;0
6776;194219;76;59;22;2;20;.909;3600000;0
6776;205469;82;0;0;0;0;.00nan;0;0
6776;184175;76;0;0;0;0;.00nan;0;0
6777;163989;149;53;24;4;20;.833;3543000;0
6777;200572;157;59;16;2;14;.875;3600000;0
6777;191518;157;0;0;0;0;.00nan;0;0
6777;85546;149;0;0;0;0;.00nan;0;0
6778;184069;73;35;36;7;29;.806;3600000;0
6778;173961;73;0;0;0;0;.00nan;0;0
6778;78581;71;0;0;0;0;.00nan;0;0
6778;91403;71;62;33;4;29;.879;3600000;0
6779;189885;4921;0;0;0;0;.00nan;0;0
6779;174386;81;0;0;0;0;.00nan;0;0
6779;176770;81;62;25;2;23;.920;3600000;0
6779;197912;4921;50;21;3;18;.857;3545000;0
6780;161535;4245;62;32;4;28;.875;3900000;0
6780;204668;78;76;49;4;45;.918;3900000;0
6780;-1;4245;0;0;0;0;.00nan;0;0
6780;189902;78;0;0;0;0;.00nan;0;0
6781;189081;1097;0;0;0;0;.00nan;0;0
6781;176136;74;37;31;6;25;.806;3226000;0
6781;-1;74;56;8;0;8;1.000;374000;0
6781;192629;1097;60;25;3;22;.880;3600000;0
6782;203179;4620;0;0;0;0;.00nan;0;0
6782;200233;4620;41;16;3;13;.813;3600000;0
6782;195251;85;83;44;4;40;.909;3570000;0
6782;-1;85;0;0;0;0;.00nan;0;0
6783;-1;158;0;0;0;0;.00nan;0;0
6783;196414;152;0;0;0;0;.00nan;0;0
6783;86862;158;70;34;3;31;.912;3600000;0
6783;86875;152;29;16;4;12;.750;3560000;0
6784;189081;1097;0;0;0;0;.00nan;0;0
6784;200390;1096;45;30;4;26;.867;3600000;0
6784;-1;1096;0;0;0;0;.00nan;0;0
6784;192629;1097;47;33;5;28;.848;3567000;0
6785;183737;72;0;0;0;0;.00nan;0;0
6785;178394;1095;0;0;0;0;.00nan;0;0
6785;186451;1095;63;40;4;36;.900;3600000;0
6785;91212;72;78;32;3;29;.906;3600000;0
6786;184069;73;85;43;3;40;.930;3900000;0
6786;173961;73;0;0;0;0;.00nan;0;0
6786;78581;71;77;33;3;30;.909;3900000;0
6786;91403;71;0;0;0;0;.00nan;0;0
6787;199437;77;64;17;1;16;.941;3600000;0
6787;190034;77;0;0;0;0;.00nan;0;0
6787;176136;74;55;49;6;43;.878;3156000;0
6787;-1;74;52;4;0;4;1.000;444000;0
6788;163989;149;94;37;1;36;.973;3600000;0
6788;200572;157;0;0;0;0;.00nan;0;0
6788;191518;157;51;16;2;14;.875;3546000;0
6788;85546;149;0;0;0;0;.00nan;0;0
6789;189885;4921;0;0;0;0;.00nan;0;0
6789;174386;81;0;0;0;0;.00nan;0;0
6789;176770;81;49;33;4;29;.879;3600000;0
6789;197912;4921;84;38;3;35;.921;3600000;0
6790;203276;82;66;28;3;25;.893;3511000;0
6790;182467;4922;0;0;0;0;.00nan;0;0
6790;205121;4922;100;39;1;38;.974;3600000;0
6790;185800;82;0;0;0;0;.00nan;0;0
6791;174407;69;86;34;2;32;.941;3600000;0
6791;192547;2564;48;31;4;27;.871;3513000;0
6791;78479;69;0;0;0;0;.00nan;0;0
6791;79141;2564;0;0;0;0;.00nan;0;0
6792;-1;158;0;0;0;0;.00nan;0;0
6792;196414;152;61;24;2;22;.917;3558000;0
6792;86862;158;82;27;1;26;.963;3600000;0
6792;86875;152;0;0;0;0;.00nan;0;0
6793;203179;4620;0;0;0;0;.00nan;0;0
6793;200233;4620;51;21;3;18;.857;3900000;0
6793;195251;85;65;34;3;31;.912;3900000;0
6793;-1;85;0;0;0;0;.00nan;0;0
6794;161535;4245;86;32;2;30;.938;3600000;0
6794;204668;78;79;42;4;38;.905;3540000;0
6794;-1;4245;0;0;0;0;.00nan;0;0
6794;189902;78;0;0;0;0;.00nan;0;0
6795;194219;76;92;49;3;46;.939;3600000;0
6795;184175;76;0;0;0;0;.00nan;0;0
6795;78820;75;0;0;0;0;.00nan;0;0
6795;86394;75;45;21;4;17;.810;3549000;0
6796;170598;80;0;0;0;0;.00nan;0;0
6796;184788;151;0;0;0;0;.00nan;0;0
6796;-1;80;42;18;3;15;.833;3600000;0
6796;65014;151;85;30;1;29;.967;3600000;0
6797;179344;67;0;0;0;0;.00nan;0;0
6797;-1;67;31;34;6;28;.824;3600000;0
6797;191574;4920;50;14;2;12;.857;3600000;0
6797;-1;4920;0;0;0;0;.00nan;0;0
6798;161535;4245;0;0;0;0;.00nan;0;0
6798;204668;78;0;0;0;0;.00nan;0;0
6798;-1;4245;58;20;2;18;.900;3546000;0
6798;189902;78;92;32;1;31;.969;3600000;0
6799;170598;80;100;26;0;26;1.000;3600000;0
6799;184788;151;52;3;0;3;1.000;939000;0
6799;-1;80;0;0;0;0;.00nan;0;0
6799;65014;151;20;29;7;22;.759;2661000;0
6800;195251;85;0;0;0;0;.00nan;0;0
6800;179344;67;58;15;2;13;.867;3900000;0
6800;-1;85;72;32;2;30;.938;3900000;0
6800;-1;67;0;0;0;0;.00nan;0;0
6801;-1;158;0;0;0;0;.00nan;0;0
6801;196414;152;76;37;3;34;.919;3660000;0
6801;86862;158;68;34;4;30;.882;3660000;0
6801;86875;152;0;0;0;0;.00nan;0;0
6802;184069;73;47;27;4;23;.852;3900000;0
6802;173961;73;0;0;0;0;.00nan;0;0
6802;174407;69;40;24;4;20;.833;3900000;0
6802;78479;69;0;0;0;0;.00nan;0;0
6803;179344;67;43;42;6;36;.857;3600000;0
6803;176136;74;90;29;1;28;.966;3600000;0
6803;-1;67;0;0;0;0;.00nan;0;0
6803;-1;74;0;0;0;0;.00nan;0;0
6804;204668;78;74;43;4;39;.907;3668000;0
6804;189902;78;0;0;0;0;.00nan;0;0
6804;78820;75;0;0;0;0;.00nan;0;0
6804;86394;75;35;16;5;11;.688;3668000;0
6805;192547;2564;92;46;2;44;.957;3600000;0
6805;78581;71;64;29;3;26;.897;3570000;0
6805;79141;2564;0;0;0;0;.00nan;0;0
6805;91403;71;0;0;0;0;.00nan;0;0
6806;199437;77;59;34;3;31;.912;3600000;0
6806;189081;1097;0;0;0;0;.00nan;0;0
6806;190034;77;0;0;0;0;.00nan;0;0
6806;192629;1097;59;35;4;31;.886;3546000;0
6807;183737;72;0;0;0;0;.00nan;0;0
6807;174407;69;0;0;0;0;.00nan;0;0
6807;78479;69;43;31;6;25;.806;3589000;0
6807;91212;72;73;40;4;36;.900;3600000;0
6808;203179;4620;74;40;3;37;.925;3600000;0
6808;200233;4620;0;0;0;0;.00nan;0;0
6808;191574;4920;53;29;4;25;.862;3561000;0
6808;-1;4920;0;0;0;0;.00nan;0;0
6809;179344;67;59;25;3;22;.880;3600000;0
6809;176136;74;50;32;4;28;.875;3599000;0
6809;-1;67;0;0;0;0;.00nan;0;0
6809;-1;74;0;0;0;0;.00nan;0;0
6810;174386;81;92;19;0;19;1.000;3600000;0
6810;176770;81;0;0;0;0;.00nan;0;0
6810;196414;152;0;0;0;0;.00nan;0;0
6810;86875;152;70;28;2;26;.929;3575000;0
6811;200572;157;0;0;0;0;.00nan;0;0
6811;184788;151;43;28;4;24;.857;3600000;0
6811;191518;157;86;28;1;27;.964;3600000;0
6811;65014;151;0;0;0;0;.00nan;0;0
6812;178394;1095;0;0;0;0;.00nan;0;0
6812;-1;158;74;28;2;26;.929;3600000;0
6812;186451;1095;53;37;5;32;.865;3600000;0
6812;86862;158;0;0;0;0;.00nan;0;0
6813;203179;4620;0;0;0;0;.00nan;0;0
6813;200233;4620;72;41;4;37;.902;3600000;0
6813;191574;4920;0;0;0;0;.00nan;0;0
6813;-1;4920;91;19;0;19;1.000;3600000;0
6814;163989;149;57;28;4;24;.857;3900000;0
6814;200390;1096;70;30;4;26;.867;3900000;0
6814;-1;1096;0;0;0;0;.00nan;0;0
6814;85546;149;0;0;0;0;.00nan;0;0
6815;203276;82;55;33;4;29;.879;3870000;0
6815;182467;4922;0;0;0;0;.00nan;0;0
6815;205121;4922;48;33;5;28;.848;3870000;0
6815;185800;82;0;0;0;0;.00nan;0;0
6816;183737;72;95;35;1;34;.971;3600000;0
6816;78581;71;68;44;4;40;.909;3600000;0
6816;91212;72;0;0;0;0;.00nan;0;0
6816;91403;71;0;0;0;0;.00nan;0;0
6817;184069;73;0;0;0;0;.00nan;0;0
6817;173961;73;45;28;5;23;.821;3600000;0
6817;174407;69;23;32;7;25;.781;3141000;0
6817;78479;69;71;13;0;13;1.000;429000;0
6818;204668;78;0;0;0;0;.00nan;0;0
6818;189902;78;68;46;5;41;.891;3600000;0
6818;78820;75;35;17;4;13;.765;3600000;0
6818;86394;75;0;0;0;0;.00nan;0;0
6819;174386;81;0;0;0;0;.00nan;0;0
6819;176770;81;68;31;3;28;.903;3553000;0
6819;196414;152;75;27;2;25;.926;3600000;0
6819;86875;152;0;0;0;0;.00nan;0;0
6820;161535;4245;68;18;1;17;.944;3600000;0
6820;-1;4245;0;0;0;0;.00nan;0;0
6820;195251;85;74;42;5;37;.881;3600000;0
6820;-1;85;0;0;0;0;.00nan;0;0
6821;178394;1095;81;45;4;41;.911;3755000;0
6821;170598;80;60;29;3;26;.897;3755000;0
6821;186451;1095;0;0;0;0;.00nan;0;0
6821;-1;80;0;0;0;0;.00nan;0;0
6822;200572;157;0;0;0;0;.00nan;0;0
6822;184788;151;0;0;0;0;.00nan;0;0
6822;191518;157;41;26;5;21;.808;3600000;0
6822;65014;151;67;26;2;24;.923;3600000;0
6823;189885;4921;0;0;0;0;.00nan;0;0
6823;-1;158;0;0;0;0;.00nan;0;0
6823;197912;4921;88;40;3;37;.925;3556000;0
6823;86862;158;66;16;1;15;.938;3600000;0
6824;163989;149;0;0;0;0;.00nan;0;0
6824;200390;1096;0;0;0;0;.00nan;0;0
6824;-1;1096;83;37;2;35;.946;3600000;0
6824;85546;149;45;25;5;20;.800;3600000;0
6825;204668;78;62;38;5;33;.868;3600000;0
6825;189902;78;0;0;0;0;.00nan;0;0
6825;78820;75;0;0;0;0;.00nan;0;0
6825;86394;75;78;24;1;23;.958;3600000;0
6826;179344;67;0;0;0;0;.00nan;0;0
6826;176136;74;63;38;4;34;.895;3660000;0
6826;-1;67;77;39;3;36;.923;3660000;0
6826;-1;74;0;0;0;0;.00nan;0;0
6827;182467;4922;82;50;4;46;.920;3600000;0
6827;194219;76;49;21;3;18;.857;3600000;0
6827;205121;4922;0;0;0;0;.00nan;0;0
6827;184175;76;0;0;0;0;.00nan;0;0
6828;161535;4245;0;0;0;0;.00nan;0;0
6828;-1;4245;58;27;3;24;.889;3600000;0
6828;195251;85;0;0;0;0;.00nan;0;0
6828;-1;85;47;31;5;26;.839;3600000;0
6829;178394;1095;0;0;0;0;.00nan;0;0
6829;170598;80;86;23;1;22;.957;3600000;0
6829;186451;1095;74;39;4;35;.897;3600000;0
6829;-1;80;0;0;0;0;.00nan;0;0
6830;189885;4921;76;28;2;26;.929;3600000;0
6830;-1;158;49;19;3;16;.842;3565000;0
6830;197912;4921;0;0;0;0;.00nan;0;0
6830;86862;158;0;0;0;0;.00nan;0;0
6831;174386;81;0;0;0;0;.00nan;0;0
6831;176770;81;37;34;6;28;.824;3600000;0
6831;196414;152;0;0;0;0;.00nan;0;0
6831;86875;152;75;31;2;29;.935;3600000;0
6832;199437;77;68;24;2;22;.917;3566000;0
6832;200390;1096;99;42;1;41;.976;3600000;0
6832;190034;77;0;0;0;0;.00nan;0;0
6832;-1;1096;0;0;0;0;.00nan;0;0
6833;203276;82;89;49;3;46;.939;3574000;0
6833;194219;76;73;25;1;24;.960;3600000;0
6833;184175;76;0;0;0;0;.00nan;0;0
6833;185800;82;0;0;0;0;.00nan;0;0
6834;200572;157;82;26;1;25;.962;3600000;0
6834;-1;158;40;3;1;2;.667;441000;0
6834;191518;157;0;0;0;0;.00nan;0;0
6834;86862;158;45;31;6;25;.806;3159000;0
6835;182467;4922;0;0;0;0;.00nan;0;0
6835;205121;4922;42;43;6;37;.860;3600000;0
6835;78820;75;0;0;0;0;.00nan;0;0
6835;86394;75;40;8;2;6;.750;3600000;0
6836;163989;149;47;39;6;33;.846;3600000;0
6836;170598;80;0;0;0;0;.00nan;0;0
6836;-1;80;44;21;4;17;.810;3600000;0
6836;85546;149;0;0;0;0;.00nan;0;0
6837;182467;4922;89;27;2;25;.926;3600000;0
6837;205121;4922;0;0;0;0;.00nan;0;0
6837;200390;1096;0;0;0;0;.00nan;0;0
6837;-1;1096;47;26;4;22;.846;3547000;0
6838;178394;1095;79;31;2;29;.935;3600000;0
6838;189885;4921;0;0;0;0;.00nan;0;0
6838;186451;1095;0;0;0;0;.00nan;0;0
6838;197912;4921;52;33;4;29;.879;3527000;0
6839;203276;82;30;14;4;10;.714;1013000;0
6839;194219;76;49;19;3;16;.842;3600000;0
6839;184175;76;0;0;0;0;.00nan;0;0
6839;185800;82;66;35;4;31;.886;2587000;0
6840;199437;77;59;31;3;28;.903;3900000;0
6840;189081;1097;0;0;0;0;.00nan;0;0
6840;190034;77;0;0;0;0;.00nan;0;0
6840;192629;1097;72;31;3;28;.903;3900000;0
6841;200572;157;0;0;0;0;.00nan;0;0
6841;-1;158;0;0;0;0;.00nan;0;0
6841;191518;157;61;24;2;22;.917;3600000;0
6841;86862;158;84;55;5;50;.909;3600000;0
6842;184069;73;63;30;4;26;.867;3600000;0
6842;173961;73;0;0;0;0;.00nan;0;0
6842;174407;69;99;34;1;33;.971;3600000;0
6842;78479;69;0;0;0;0;.00nan;0;0
6843;174386;81;35;39;6;33;.846;3600000;0
6843;176770;81;0;0;0;0;.00nan;0;0
6843;196414;152;0;0;0;0;.00nan;0;0
6843;86875;152;76;29;2;27;.931;3600000;0
6844;203179;4620;0;0;0;0;.00nan;0;0
6844;200233;4620;72;23;1;22;.957;3600000;0
6844;176136;74;98;44;2;42;.955;3558000;0
6844;-1;74;0;0;0;0;.00nan;0;0
6845;161535;4245;86;31;1;30;.968;3900000;0
6845;-1;4245;0;0;0;0;.00nan;0;0
6845;192547;2564;90;27;1;26;.963;3900000;0
6845;79141;2564;0;0;0;0;.00nan;0;0
6846;204668;78;52;29;5;24;.828;3559000;0
6846;195251;85;76;37;3;34;.919;3600000;0
6846;189902;78;0;0;0;0;.00nan;0;0
6846;-1;85;0;0;0;0;.00nan;0;0
6847;163989;149;0;0;0;0;.00nan;0;0
6847;170598;80;70;30;2;28;.933;3563000;0
6847;-1;80;0;0;0;0;.00nan;0;0
6847;85546;149;84;27;1;26;.963;3600000;0
6848;179344;67;66;33;4;29;.879;3544000;0
6848;-1;67;0;0;0;0;.00nan;0;0
6848;191574;4920;50;15;3;12;.800;3600000;0
6848;-1;4920;0;0;0;0;.00nan;0;0
6849;178394;1095;0;0;0;0;.00nan;0;0
6849;189885;4921;57;27;3;24;.889;3600000;0
6849;186451;1095;75;27;2;25;.926;3600000;0
6849;197912;4921;0;0;0;0;.00nan;0;0
6850;203276;82;91;40;2;38;.950;3600000;0
6850;194219;76;0;0;0;0;.00nan;0;0
6850;184175;76;51;21;3;18;.857;3578000;0
6850;185800;82;0;0;0;0;.00nan;0;0
6851;182467;4922;0;0;0;0;.00nan;0;0
6851;199437;77;0;0;0;0;.00nan;0;0
6851;205121;4922;45;36;6;30;.833;3600000;0
6851;190034;77;84;30;2;28;.933;3600000;0
6852;200572;157;88;33;1;32;.970;3600000;0
6852;-1;158;72;34;3;31;.912;3511000;0
6852;191518;157;0;0;0;0;.00nan;0;0
6852;86862;158;0;0;0;0;.00nan;0;0
6853;174407;69;0;0;0;0;.00nan;0;0
6853;78479;69;37;32;5;27;.844;3600000;0
6853;78581;71;53;16;2;14;.875;3600000;0
6853;91403;71;0;0;0;0;.00nan;0;0
6854;174386;81;0;0;0;0;.00nan;0;0
6854;176770;81;69;38;3;35;.921;3600000;0
6854;196414;152;99;25;0;25;1.000;3600000;0
6854;86875;152;0;0;0;0;.00nan;0;0
6855;203179;4620;59;25;3;22;.880;3600000;0
6855;200233;4620;0;0;0;0;.00nan;0;0
6855;176136;74;76;28;2;26;.929;3355000;0
6855;-1;74;28;11;3;8;.727;206000;0
6856;189081;1097;27;31;6;25;.806;2048000;0
6856;192629;1097;88;33;1;32;.970;1552000;0
6856;78820;75;0;0;0;0;.00nan;0;0
6856;86394;75;75;26;2;24;.923;3600000;0
6857;184069;73;0;0;0;0;.00nan;0;0
6857;173961;73;25;29;6;23;.793;3600000;0
6857;192547;2564;0;0;0;0;.00nan;0;0
6857;79141;2564;69;39;4;35;.897;3600000;0
6858;204668;78;0;0;0;0;.00nan;0;0
6858;195251;85;0;0;0;0;.00nan;0;0
6858;189902;78;69;46;5;41;.891;3600000;0
6858;-1;85;68;20;1;19;.950;3600000;0
6859;161535;4245;0;0;0;0;.00nan;0;0
6859;183737;72;0;0;0;0;.00nan;0;0
6859;-1;4245;57;38;4;34;.895;3600000;0
6859;91212;72;71;27;2;25;.926;3600000;0
6860;179344;67;46;11;2;9;.818;944000;0
6860;-1;67;52;46;7;39;.848;2656000;0
6860;191574;4920;0;0;0;0;.00nan;0;0
6860;-1;4920;24;19;5;14;.737;3600000;0
6861;200390;1096;71;47;5;42;.894;3600000;0
6861;-1;1096;0;0;0;0;.00nan;0;0
6861;78820;75;59;18;2;16;.889;3600000;0
6861;86394;75;0;0;0;0;.00nan;0;0
6862;203179;4620;0;0;0;0;.00nan;0;0
6862;200233;4620;66;23;3;20;.870;3645000;0
6862;176136;74;80;38;4;34;.895;3645000;0
6862;-1;74;0;0;0;0;.00nan;0;0
6863;199437;77;95;35;1;34;.971;3900000;0
6863;189081;1097;0;0;0;0;.00nan;0;0
6863;190034;77;0;0;0;0;.00nan;0;0
6863;192629;1097;94;31;1;30;.968;3900000;0
6864;204668;78;67;24;3;21;.875;3900000;0
6864;195251;85;75;38;3;35;.921;3900000;0
6864;189902;78;0;0;0;0;.00nan;0;0
6864;-1;85;0;0;0;0;.00nan;0;0
6865;170598;80;61;22;2;20;.909;3600000;0
6865;174386;81;97;51;3;48;.941;3578000;0
6865;176770;81;0;0;0;0;.00nan;0;0
6865;-1;80;0;0;0;0;.00nan;0;0
6866;161535;4245;73;33;3;30;.909;3552000;0
6866;183737;72;87;33;2;31;.939;3600000;0
6866;-1;4245;0;0;0;0;.00nan;0;0
6866;91212;72;0;0;0;0;.00nan;0;0
6867;163989;149;41;34;5;29;.853;3551000;0
6867;196414;152;79;41;4;37;.902;3600000;0
6867;85546;149;0;0;0;0;.00nan;0;0
6867;86875;152;0;0;0;0;.00nan;0;0
6868;194219;76;85;44;3;41;.932;3600000;0
6868;184175;76;0;0;0;0;.00nan;0;0
6868;78820;75;36;21;5;16;.762;3548000;0
6868;86394;75;0;0;0;0;.00nan;0;0
6869;179344;67;0;0;0;0;.00nan;0;0
6869;-1;67;88;40;2;38;.950;3600000;0
6869;191574;4920;39;18;4;14;.778;3521000;0
6869;-1;4920;0;0;0;0;.00nan;0;0
6870;189885;4921;0;0;0;0;.00nan;0;0
6870;174407;69;100;26;0;26;1.000;3600000;0
6870;197912;4921;74;46;4;42;.913;3600000;0
6870;78479;69;0;0;0;0;.00nan;0;0
6871;161535;4245;73;22;1;21;.955;3600000;0
6871;-1;4245;0;0;0;0;.00nan;0;0
6871;176136;74;47;21;3;18;.857;3520000;0
6871;-1;74;0;0;0;0;.00nan;0;0
6872;184788;151;71;34;4;30;.882;3900000;0
6872;-1;158;0;0;0;0;.00nan;0;0
6872;65014;151;0;0;0;0;.00nan;0;0
6872;86862;158;73;36;4;32;.889;3900000;0
6873;189885;4921;67;36;4;32;.889;3900000;0
6873;174407;69;63;35;4;31;.886;3900000;0
6873;197912;4921;0;0;0;0;.00nan;0;0
6873;78479;69;0;0;0;0;.00nan;0;0
6874;204668;78;52;31;4;27;.871;3600000;0
6874;189902;78;0;0;0;0;.00nan;0;0
6874;179344;67;0;0;0;0;.00nan;0;0
6874;-1;67;100;34;0;34;1.000;3600000;0
6875;170598;80;84;23;1;22;.957;3600000;0
6875;174386;81;76;33;2;31;.939;3570000;0
6875;176770;81;0;0;0;0;.00nan;0;0
6875;-1;80;0;0;0;0;.00nan;0;0
6876;176136;74;81;37;2;35;.946;3600000;0
6876;-1;74;0;0;0;0;.00nan;0;0
6876;191574;4920;65;14;1;13;.929;3600000;0
6876;-1;4920;0;0;0;0;.00nan;0;0
6877;163989;149;92;41;3;38;.927;3800000;0
6877;196414;152;76;29;2;27;.931;3800000;0
6877;85546;149;0;0;0;0;.00nan;0;0
6877;86875;152;0;0;0;0;.00nan;0;0
6878;192547;2564;62;46;6;40;.870;3600000;0
6878;78581;71;0;0;0;0;.00nan;0;0
6878;79141;2564;0;0;0;0;.00nan;0;0
6878;91403;71;66;22;2;20;.909;3600000;0
6879;203276;82;0;0;0;0;.00nan;0;0
6879;199437;77;68;18;2;16;.889;3585000;0
6879;190034;77;0;0;0;0;.00nan;0;0
6879;185800;82;95;35;1;34;.971;3600000;0
6880;178394;1095;0;0;0;0;.00nan;0;0
6880;184069;73;69;25;2;23;.920;3600000;0
6880;173961;73;0;0;0;0;.00nan;0;0
6880;186451;1095;32;32;6;26;.813;3600000;0
6881;203179;4620;42;22;4;18;.818;3786000;0
6881;200233;4620;0;0;0;0;.00nan;0;0
6881;195251;85;98;46;3;43;.935;3786000;0
6881;-1;85;0;0;0;0;.00nan;0;0
6882;204668;78;0;0;0;0;.00nan;0;0
6882;189902;78;72;31;3;28;.903;3900000;0
6882;179344;67;97;48;3;45;.938;3900000;0
6882;-1;67;0;0;0;0;.00nan;0;0
6883;170598;80;51;14;2;12;.857;2492000;0
6883;174386;81;0;0;0;0;.00nan;0;0
6883;176770;81;65;29;3;26;.897;3600000;0
6883;-1;80;20;11;4;7;.636;1108000;0
6884;194219;76;81;31;2;29;.935;3600000;0
6884;189081;1097;94;48;3;45;.938;3542000;0
6884;184175;76;0;0;0;0;.00nan;0;0
6884;192629;1097;0;0;0;0;.00nan;0;0
6885;200390;1096;33;36;6;30;.833;3165000;0
6885;-1;1096;53;3;0;3;1.000;435000;0
6885;78820;75;0;0;0;0;.00nan;0;0
6885;86394;75;39;27;5;22;.815;3600000;0
6886;184788;151;0;0;0;0;.00nan;0;0
6886;-1;158;0;0;0;0;.00nan;0;0
6886;65014;151;70;38;4;34;.895;3577000;0
6886;86862;158;55;21;3;18;.857;3600000;0
6887;183737;72;0;0;0;0;.00nan;0;0
6887;200572;157;60;7;0;7;1.000;1297000;0
6887;191518;157;36;19;4;15;.789;2261000;0
6887;91212;72;74;30;2;28;.933;3600000;0
6888;163989;149;0;0;0;0;.00nan;0;0
6888;196414;152;0;0;0;0;.00nan;0;0
6888;85546;149;56;32;5;27;.844;3599000;0
6888;86875;152;61;29;3;26;.897;3600000;0
6889;203276;82;71;37;3;34;.919;3600000;0
6889;200390;1096;0;0;0;0;.00nan;0;0
6889;-1;1096;27;22;5;17;.773;3516000;0
6889;185800;82;0;0;0;0;.00nan;0;0
6890;178394;1095;83;37;3;34;.919;3555000;0
6890;184069;73;0;0;0;0;.00nan;0;0
6890;173961;73;75;29;2;27;.931;3600000;0
6890;186451;1095;0;0;0;0;.00nan;0;0
6891;182467;4922;0;0;0;0;.00nan;0;0
6891;199437;77;52;16;2;14;.875;3598000;0
6891;205121;4922;96;36;1;35;.972;3600000;0
6891;190034;77;0;0;0;0;.00nan;0;0
6892;189885;4921;0;0;0;0;.00nan;0;0
6892;174407;69;68;24;2;22;.917;3600000;0
6892;197912;4921;72;26;1;25;.962;3600000;0
6892;78479;69;0;0;0;0;.00nan;0;0
6893;203179;4620;0;0;0;0;.00nan;0;0
6893;200233;4620;61;40;4;36;.900;3600000;0
6893;191574;4920;0;0;0;0;.00nan;0;0
6893;-1;4920;69;18;1;17;.944;3600000;0
6894;194219;76;0;0;0;0;.00nan;0;0
6894;189081;1097;0;0;0;0;.00nan;0;0
6894;184175;76;77;32;2;30;.938;3600000;0
6894;192629;1097;68;29;3;26;.897;3584000;0
6895;170598;80;0;0;0;0;.00nan;0;0
6895;174386;81;59;34;5;29;.853;3600000;0
6895;176770;81;0;0;0;0;.00nan;0;0
6895;-1;80;67;26;2;24;.923;3600000;0
6896;161535;4245;20;18;5;13;.722;3550000;0
6896;-1;4245;0;0;0;0;.00nan;0;0
6896;176136;74;67;33;3;30;.909;3600000;0
6896;-1;74;0;0;0;0;.00nan;0;0
6897;192547;2564;0;0;0;0;.00nan;0;0
6897;78581;71;79;31;3;28;.903;3599000;0
6897;79141;2564;81;31;1;30;.968;3600000;0
6897;91403;71;0;0;0;0;.00nan;0;0
6898;184788;151;82;31;2;29;.935;3600000;0
6898;-1;158;59;31;4;27;.871;3600000;0
6898;65014;151;0;0;0;0;.00nan;0;0
6898;86862;158;0;0;0;0;.00nan;0;0
6899;183737;72;66;23;2;21;.913;3600000;0
6899;200572;157;0;0;0;0;.00nan;0;0
6899;191518;157;53;40;6;34;.850;3600000;0
6899;91212;72;0;0;0;0;.00nan;0;0
6900;195251;85;99;50;1;49;.980;3896000;0
6900;-1;85;0;0;0;0;.00nan;0;0
6900;191574;4920;51;17;2;15;.882;3896000;0
6900;-1;4920;0;0;0;0;.00nan;0;0
6901;163989;149;74;22;1;21;.955;3600000;0
6901;196414;152;48;17;3;14;.824;3511000;0
6901;85546;149;0;0;0;0;.00nan;0;0
6901;86875;152;0;0;0;0;.00nan;0;0
6902;203276;82;0;0;0;0;.00nan;0;0
6902;200390;1096;73;37;3;34;.919;3552000;0
6902;-1;1096;0;0;0;0;.00nan;0;0
6902;185800;82;61;18;2;16;.889;3600000;0
6903;182467;4922;52;30;4;26;.867;3900000;0
6903;199437;77;0;0;0;0;.00nan;0;0
6903;205121;4922;0;0;0;0;.00nan;0;0
6903;190034;77;54;33;4;29;.879;3900000;0
6904;204668;78;90;34;2;32;.941;3600000;0
6904;189902;78;0;0;0;0;.00nan;0;0
6904;179344;67;0;0;0;0;.00nan;0;0
6904;-1;67;85;31;1;30;.968;3600000;0
6905;192547;2564;69;34;3;31;.912;3537000;0
6905;78581;71;0;0;0;0;.00nan;0;0
6905;79141;2564;0;0;0;0;.00nan;0;0
6905;91403;71;68;15;1;14;.933;3600000;0
6906;183737;72;0;0;0;0;.00nan;0;0
6906;200572;157;33;24;5;19;.792;1359000;0
6906;191518;157;49;20;2;18;.900;2241000;0
6906;91212;72;69;24;2;22;.917;3600000;0
6907;199437;77;74;29;2;27;.931;3600000;0
6907;200390;1096;0;0;0;0;.00nan;0;0
6907;190034;77;0;0;0;0;.00nan;0;0
6907;-1;1096;95;48;4;44;.917;3563000;0
6908;178394;1095;78;33;2;31;.939;3600000;0
6908;186451;1095;0;0;0;0;.00nan;0;0
6908;78581;71;53;25;3;22;.880;3600000;0
6908;91403;71;0;0;0;0;.00nan;0;0
6909;203276;82;71;45;5;40;.889;3600000;0
6909;194219;76;60;13;1;12;.923;3600000;0
6909;184175;76;0;0;0;0;.00nan;0;0
6909;185800;82;0;0;0;0;.00nan;0;0
6910;163989;149;71;48;5;43;.896;3600000;0
6910;200572;157;100;24;0;24;1.000;3600000;0
6910;191518;157;0;0;0;0;.00nan;0;0
6910;85546;149;0;0;0;0;.00nan;0;0
6911;189885;4921;0;0;0;0;.00nan;0;0
6911;184788;151;0;0;0;0;.00nan;0;0
6911;197912;4921;69;30;3;27;.900;3600000;0
6911;65014;151;93;21;0;21;1.000;3600000;0
6912;182467;4922;0;0;0;0;.00nan;0;0
6912;205121;4922;49;47;6;41;.872;3600000;0
6912;78820;75;0;0;0;0;.00nan;0;0
6912;86394;75;74;19;1;18;.947;3600000;0
6913;183737;72;0;0;0;0;.00nan;0;0
6913;192547;2564;50;25;4;21;.840;3558000;0
6913;79141;2564;0;0;0;0;.00nan;0;0
6913;91212;72;71;25;2;23;.920;3600000;0
6914;199437;77;66;40;5;35;.875;3600000;0
6914;189081;1097;80;30;2;28;.933;3600000;0
6914;190034;77;0;0;0;0;.00nan;0;0
6914;192629;1097;0;0;0;0;.00nan;0;0
6915;203276;82;0;0;0;0;.00nan;0;0
6915;200390;1096;0;0;0;0;.00nan;0;0
6915;-1;1096;44;27;5;22;.815;3600000;0
6915;185800;82;74;26;2;24;.923;3600000;0
6916;163989;149;97;53;2;51;.962;3900000;0
6916;200572;157;0;0;0;0;.00nan;0;0
6916;191518;157;67;21;2;19;.905;3900000;0
6916;85546;149;0;0;0;0;.00nan;0;0
6917;183737;72;0;0;0;0;.00nan;0;0
6917;184069;73;69;29;3;26;.897;3569000;0
6917;173961;73;0;0;0;0;.00nan;0;0
6917;91212;72;99;42;1;41;.976;3600000;0
6918;189885;4921;69;11;0;11;1.000;1123000;0
6918;184788;151;0;0;0;0;.00nan;0;0
6918;197912;4921;22;27;6;21;.778;2428000;0
6918;65014;151;50;25;5;20;.800;3600000;0
6919;182467;4922;0;0;0;0;.00nan;0;0
6919;199437;77;100;39;1;38;.974;3600000;0
6919;205121;4922;57;22;2;20;.909;3555000;0
6919;190034;77;0;0;0;0;.00nan;0;0
6920;176136;74;71;35;3;32;.914;3600000;0
6920;-1;74;0;0;0;0;.00nan;0;0
6920;191574;4920;0;0;0;0;.00nan;0;0
6920;-1;4920;47;25;4;21;.840;3572000;0
6921;161535;4245;0;0;0;0;.00nan;0;0
6921;204668;78;44;19;3;16;.842;3600000;0
6921;-1;4245;64;39;5;34;.872;3546000;0
6921;189902;78;0;0;0;0;.00nan;0;0
6922;189081;1097;0;0;0;0;.00nan;0;0
6922;192629;1097;75;36;3;33;.917;3600000;0
6922;78820;75;0;0;0;0;.00nan;0;0
6922;86394;75;65;21;2;19;.905;3600000;0
6923;174407;69;82;31;2;29;.935;3812000;0
6923;192547;2564;80;41;3;38;.927;3812000;0
6923;78479;69;0;0;0;0;.00nan;0;0
6923;79141;2564;0;0;0;0;.00nan;0;0
6924;203179;4620;0;0;0;0;.00nan;0;0
6924;200233;4620;33;21;5;16;.762;3900000;0
6924;195251;85;73;45;5;40;.889;3900000;0
6924;-1;85;0;0;0;0;.00nan;0;0
6925;170598;80;93;21;0;21;1.000;3600000;0
6925;196414;152;32;36;6;30;.833;3600000;0
6925;-1;80;0;0;0;0;.00nan;0;0
6925;86875;152;0;0;0;0;.00nan;0;0
6926;176770;81;0;0;0;0;.00nan;0;0
6926;176860;81;84;33;2;31;.939;3900000;0
6926;-1;158;0;0;0;0;.00nan;0;0
6926;86862;158;80;36;2;34;.944;3900000;0
6927;178394;1095;0;0;0;0;.00nan;0;0
6927;179344;67;0;0;0;0;.00nan;0;0
6927;-1;67;67;38;4;34;.895;3600000;0
6927;186451;1095;79;25;1;24;.960;3600000;0
6928;203276;82;58;47;6;41;.872;3032000;0
6928;200390;1096;68;29;2;27;.931;3600000;0
6928;-1;1096;0;0;0;0;.00nan;0;0
6928;185800;82;52;3;0;3;1.000;568000;0
6929;192547;2564;0;0;0;0;.00nan;0;0
6929;78581;71;0;0;0;0;.00nan;0;0
6929;79141;2564;54;36;5;31;.861;3600000;0
6929;91403;71;100;44;0;44;1.000;3600000;0
6930;163989;149;0;0;0;0;.00nan;0;0
6930;200572;157;54;22;3;19;.864;3600000;0
6930;191518;157;0;0;0;0;.00nan;0;0
6930;85546;149;61;38;4;34;.895;3554000;0
6931;184069;73;0;0;0;0;.00nan;0;0
6931;173961;73;60;32;4;28;.875;3578000;0
6931;174407;69;0;0;0;0;.00nan;0;0
6931;78479;69;66;32;3;29;.906;3600000;0
6932;189885;4921;36;20;4;16;.800;2290000;0
6932;184788;151;0;0;0;0;.00nan;0;0
6932;197912;4921;66;12;0;12;1.000;1263000;0
6932;65014;151;84;33;2;31;.939;3600000;0
6933;182467;4922;33;22;5;17;.773;3600000;0
6933;199437;77;100;47;1;46;.979;3600000;0
6933;205121;4922;0;0;0;0;.00nan;0;0
6933;190034;77;0;0;0;0;.00nan;0;0
6934;161535;4245;80;27;2;25;.926;3600000;0
6934;204668;78;0;0;0;0;.00nan;0;0
6934;-1;4245;0;0;0;0;.00nan;0;0
6934;189902;78;56;34;5;29;.853;3600000;0
6935;194219;76;70;35;3;32;.914;3811000;0
6935;189081;1097;72;45;4;41;.911;3811000;0
6935;184175;76;0;0;0;0;.00nan;0;0
6935;192629;1097;0;0;0;0;.00nan;0;0
6936;203179;4620;37;27;4;23;.852;3567000;0
6936;200233;4620;0;0;0;0;.00nan;0;0
6936;195251;85;0;0;0;0;.00nan;0;0
6936;-1;85;78;39;3;36;.923;3600000;0
6937;170598;80;62;19;2;17;.895;3600000;0
6937;196414;152;0;0;0;0;.00nan;0;0
6937;-1;80;0;0;0;0;.00nan;0;0
6937;86875;152;70;39;4;35;.897;3545000;0
6938;176770;81;0;0;0;0;.00nan;0;0
6938;176860;81;62;31;4;27;.871;3806000;0
6938;-1;158;65;36;3;33;.917;3806000;0
6938;86862;158;0;0;0;0;.00nan;0;0
6939;178394;1095;49;20;3;17;.850;3811000;0
6939;179344;67;71;33;2;31;.939;3811000;0
6939;-1;67;0;0;0;0;.00nan;0;0
6939;186451;1095;0;0;0;0;.00nan;0;0
6940;183737;72;86;32;2;30;.938;3558000;0
6940;78581;71;0;0;0;0;.00nan;0;0
6940;91212;72;0;0;0;0;.00nan;0;0
6940;91403;71;100;20;0;20;1.000;3600000;0
6941;184069;73;87;34;2;32;.941;3600000;0
6941;173961;73;0;0;0;0;.00nan;0;0
6941;192547;2564;79;41;4;37;.902;3574000;0
6941;79141;2564;0;0;0;0;.00nan;0;0
6942;176136;74;67;51;6;45;.882;3545000;0
6942;-1;74;0;0;0;0;.00nan;0;0
6942;191574;4920;24;16;5;11;.688;3600000;0
6942;-1;4920;0;0;0;0;.00nan;0;0
6943;194219;76;0;0;0;0;.00nan;0;0
6943;184175;76;82;38;4;34;.895;3600000;0
6943;78820;75;21;25;7;18;.720;3047000;0
6943;86394;75;49;7;1;6;.857;553000;0
6944;176770;81;0;0;0;0;.00nan;0;0
6944;176860;81;61;42;6;36;.857;3600000;0
6944;-1;158;0;0;0;0;.00nan;0;0
6944;86862;158;64;27;3;24;.889;3600000;0
6945;203179;4620;0;0;0;0;.00nan;0;0
6945;200233;4620;84;26;2;24;.923;3600000;0
6945;179344;67;52;4;0;4;1.000;267000;0
6945;-1;67;36;33;6;27;.818;3333000;0
6946;161535;4245;83;34;3;31;.912;3600000;0
6946;-1;4245;0;0;0;0;.00nan;0;0
6946;191574;4920;81;30;2;28;.933;3600000;0
6946;-1;4920;0;0;0;0;.00nan;0;0
6947;199437;77;54;23;3;20;.870;3595000;0
6947;200390;1096;82;34;2;32;.941;3600000;0
6947;190034;77;0;0;0;0;.00nan;0;0
6947;-1;1096;0;0;0;0;.00nan;0;0
6948;178394;1095;0;0;0;0;.00nan;0;0
6948;184069;73;56;25;4;21;.840;3600000;0
6948;173961;73;0;0;0;0;.00nan;0;0
6948;186451;1095;69;47;5;42;.894;3600000;0
6949;182467;4922;49;19;3;16;.842;1913000;0
6949;205121;4922;28;14;4;10;.714;1687000;0
6949;78820;75;65;27;3;24;.889;3600000;0
6949;86394;75;0;0;0;0;.00nan;0;0
6950;189885;4921;0;0;0;0;.00nan;0;0
6950;174407;69;98;19;0;19;1.000;3600000;0
6950;197912;4921;50;29;4;25;.862;3600000;0
6950;78479;69;0;0;0;0;.00nan;0;0
6951;195251;85;57;27;3;24;.889;3835000;0
6951;176136;74;0;0;0;0;.00nan;0;0
6951;-1;85;0;0;0;0;.00nan;0;0
6951;-1;74;67;33;4;29;.879;3835000;0
6952;194219;76;53;27;4;23;.852;3900000;0
6952;189081;1097;70;37;4;33;.892;3897000;0
6952;184175;76;0;0;0;0;.00nan;0;0
6952;192629;1097;0;0;0;0;.00nan;0;0
6953;200572;157;93;24;0;24;1.000;3600000;0
6953;176770;81;0;0;0;0;.00nan;0;0
6953;176860;81;59;41;5;36;.878;3600000;0
6953;191518;157;0;0;0;0;.00nan;0;0
6954;170598;80;61;18;2;16;.889;3600000;0
6954;196414;152;0;0;0;0;.00nan;0;0
6954;-1;80;0;0;0;0;.00nan;0;0
6954;86875;152;68;40;4;36;.900;3550000;0
6955;204668;78;93;38;2;36;.947;3600000;0
6955;189902;78;0;0;0;0;.00nan;0;0
6955;184788;151;82;29;1;28;.966;3600000;0
6955;65014;151;0;0;0;0;.00nan;0;0
6956;183737;72;0;0;0;0;.00nan;0;0
6956;192547;2564;100;48;1;47;.979;3600000;0
6956;79141;2564;0;0;0;0;.00nan;0;0
6956;91212;72;61;23;2;21;.913;3571000;0
6957;163989;149;48;42;6;36;.857;3600000;0
6957;-1;158;0;0;0;0;.00nan;0;0
6957;85546;149;0;0;0;0;.00nan;0;0
6957;86862;158;63;19;2;17;.895;3600000;0
6958;189885;4921;69;46;4;42;.913;3600000;0
6958;197912;4921;0;0;0;0;.00nan;0;0
6958;78581;71;90;27;1;26;.963;3600000;0
6958;91403;71;0;0;0;0;.00nan;0;0
6959;179344;67;0;0;0;0;.00nan;0;0
6959;-1;67;90;51;4;47;.922;3600000;0
6959;191574;4920;85;30;1;29;.967;3600000;0
6959;-1;4920;0;0;0;0;.00nan;0;0
6960;189081;1097;42;22;4;18;.818;3557000;0
6960;200390;1096;99;44;2;42;.955;3600000;0
6960;-1;1096;0;0;0;0;.00nan;0;0
6960;192629;1097;0;0;0;0;.00nan;0;0
6961;183737;72;90;41;3;38;.927;3600000;0
6961;178394;1095;0;0;0;0;.00nan;0;0
6961;186451;1095;57;45;5;40;.889;3600000;0
6961;91212;72;0;0;0;0;.00nan;0;0
6962;184069;73;72;42;4;38;.905;3600000;0
6962;173961;73;0;0;0;0;.00nan;0;0
6962;78581;71;0;0;0;0;.00nan;0;0
6962;91403;71;57;21;3;18;.857;3600000;0
6963;203276;82;73;17;0;17;1.000;1676000;0
6963;182467;4922;0;0;0;0;.00nan;0;0
6963;205121;4922;61;31;4;27;.871;3900000;0
6963;185800;82;63;30;4;26;.867;2224000;0
6964;-1;158;0;0;0;0;.00nan;0;0
6964;196414;152;54;22;3;19;.864;3543000;0
6964;86862;158;90;36;2;34;.944;3600000;0
6964;86875;152;0;0;0;0;.00nan;0;0
6965;203179;4620;0;0;0;0;.00nan;0;0
6965;161535;4245;61;30;3;27;.900;3546000;0
6965;200233;4620;79;36;2;34;.944;3600000;0
6965;-1;4245;0;0;0;0;.00nan;0;0
6966;195251;85;98;40;1;39;.975;3900000;0
6966;176136;74;93;31;1;30;.968;3900000;0
6966;-1;85;0;0;0;0;.00nan;0;0
6966;-1;74;0;0;0;0;.00nan;0;0
6967;200572;157;49;22;3;19;.864;3555000;0
6967;176770;81;0;0;0;0;.00nan;0;0
6967;176860;81;71;26;2;24;.923;3600000;0
6967;191518;157;0;0;0;0;.00nan;0;0
6968;199437;77;52;41;6;35;.854;3600000;0
6968;190034;77;0;0;0;0;.00nan;0;0
6968;78820;75;62;30;3;27;.900;3600000;0
6968;86394;75;0;0;0;0;.00nan;0;0
6969;174407;69;100;22;0;22;1.000;3600000;0
6969;192547;2564;98;52;1;51;.981;3545000;0
6969;78479;69;0;0;0;0;.00nan;0;0
6969;79141;2564;0;0;0;0;.00nan;0;0
6970;163989;149;32;18;4;14;.778;995000;0
6970;170598;80;67;21;2;19;.905;3600000;0
6970;-1;80;0;0;0;0;.00nan;0;0
6970;85546;149;66;24;2;22;.917;2605000;0
6971;204668;78;91;31;1;30;.968;3600000;0
6971;189902;78;0;0;0;0;.00nan;0;0
6971;184788;151;0;0;0;0;.00nan;0;0
6971;65014;151;66;39;5;34;.872;3600000;0
6972;179344;67;80;40;3;37;.925;3600000;0
6972;-1;67;0;0;0;0;.00nan;0;0
6972;191574;4920;0;0;0;0;.00nan;0;0
6972;-1;4920;70;24;2;22;.917;3600000;0
6973;199437;77;88;29;1;28;.966;3900000;0
6973;200390;1096;0;0;0;0;.00nan;0;0
6973;190034;77;0;0;0;0;.00nan;0;0
6973;-1;1096;95;36;1;35;.972;3900000;0
6974;192547;2564;91;55;4;51;.927;3600000;0
6974;78581;71;84;30;1;29;.967;3600000;0
6974;79141;2564;0;0;0;0;.00nan;0;0
6974;91403;71;0;0;0;0;.00nan;0;0
6975;182467;4922;75;41;3;38;.927;3560000;0
6975;189081;1097;0;0;0;0;.00nan;0;0
6975;205121;4922;0;0;0;0;.00nan;0;0
6975;192629;1097;79;18;1;17;.944;3600000;0
6976;178394;1095;33;31;6;25;.806;3600000;0
6976;174407;69;81;24;1;23;.958;3600000;0
6976;186451;1095;0;0;0;0;.00nan;0;0
6976;78479;69;0;0;0;0;.00nan;0;0
6977;-1;158;47;34;5;29;.853;3600000;0
6977;196414;152;46;5;1;4;.800;609000;0
6977;86862;158;0;0;0;0;.00nan;0;0
6977;86875;152;31;28;6;22;.786;2965000;0
6978;203179;4620;60;28;3;25;.893;3900000;0
6978;161535;4245;0;0;0;0;.00nan;0;0
6978;200233;4620;0;0;0;0;.00nan;0;0
6978;-1;4245;54;23;3;20;.870;3900000;0
6979;195251;85;22;21;6;15;.714;2411000;0
6979;176136;74;85;36;3;33;.917;3600000;0
6979;-1;85;49;7;1;6;.857;1189000;0
6979;-1;74;0;0;0;0;.00nan;0;0
6980;203276;82;68;35;3;32;.914;3600000;0
6980;194219;76;93;21;0;21;1.000;3600000;0
6980;184175;76;0;0;0;0;.00nan;0;0
6980;185800;82;0;0;0;0;.00nan;0;0
6981;200572;157;0;0;0;0;.00nan;0;0
6981;176770;81;52;11;1;10;.909;1277000;0
6981;176860;81;14;23;7;16;.696;2323000;0
6981;191518;157;46;34;5;29;.853;3600000;0
6982;163989;149;64;29;3;26;.897;3525000;0
6982;170598;80;0;0;0;0;.00nan;0;0
6982;-1;80;58;12;1;11;.917;3600000;0
6982;85546;149;0;0;0;0;.00nan;0;0
6983;204668;78;0;0;0;0;.00nan;0;0
6983;189902;78;99;53;3;50;.943;3600000;0
6983;184788;151;13;19;6;13;.684;1962000;0
6983;65014;151;66;10;0;10;1.000;1638000;0
6984;183737;72;0;0;0;0;.00nan;0;0
6984;189885;4921;0;0;0;0;.00nan;0;0
6984;197912;4921;58;43;6;37;.860;3600000;0
6984;91212;72;67;16;1;15;.938;3600000;0
6985;184069;73;69;17;1;16;.941;3702000;0
6985;173961;73;0;0;0;0;.00nan;0;0
6985;174407;69;0;0;0;0;.00nan;0;0
6985;78479;69;100;38;0;38;1.000;3702000;0
6986;194219;76;68;27;2;25;.926;3900000;0
6986;189081;1097;87;42;2;40;.952;3900000;0
6986;184175;76;0;0;0;0;.00nan;0;0
6986;192629;1097;0;0;0;0;.00nan;0;0
6987;170598;80;79;27;1;26;.963;3600000;0
6987;-1;158;0;0;0;0;.00nan;0;0
6987;-1;80;0;0;0;0;.00nan;0;0
6987;86862;158;66;25;2;23;.920;3551000;0
6988;183737;72;91;17;0;17;1.000;3600000;0
6988;189885;4921;57;32;5;27;.844;3600000;0
6988;197912;4921;0;0;0;0;.00nan;0;0
6988;91212;72;0;0;0;0;.00nan;0;0
6989;203276;82;0;0;0;0;.00nan;0;0
6989;185800;82;98;68;5;63;.926;3600000;0
6989;191574;4920;61;12;1;11;.917;3600000;0
6989;-1;4920;0;0;0;0;.00nan;0;0
6990;204668;78;26;8;3;5;.625;213000;0
6990;200572;157;82;27;1;26;.963;3600000;0
6990;189902;78;67;22;2;20;.909;3387000;0
6990;191518;157;0;0;0;0;.00nan;0;0
6991;183737;72;100;30;1;29;.967;3600000;0
6991;184069;73;90;40;2;38;.950;3600000;0
6991;173961;73;0;0;0;0;.00nan;0;0
6991;91212;72;0;0;0;0;.00nan;0;0
6992;182467;4922;0;0;0;0;.00nan;0;0
6992;194219;76;90;16;0;16;1.000;3600000;0
6992;205121;4922;88;40;2;38;.950;3555000;0
6992;184175;76;0;0;0;0;.00nan;0;0
6993;195251;85;69;41;4;37;.902;3600000;0
6993;-1;85;0;0;0;0;.00nan;0;0
6993;78820;75;45;16;3;13;.813;3600000;0
6993;86394;75;0;0;0;0;.00nan;0;0
6994;170598;80;43;29;5;24;.828;3600000;0
6994;-1;158;0;0;0;0;.00nan;0;0
6994;-1;80;0;0;0;0;.00nan;0;0
6994;86862;158;88;14;0;14;1.000;3600000;0
6995;179344;67;58;18;2;16;.889;1472000;0
6995;196414;152;86;28;1;27;.964;3600000;0
6995;-1;67;24;29;7;22;.759;2128000;0
6995;86875;152;0;0;0;0;.00nan;0;0
6996;189081;1097;0;0;0;0;.00nan;0;0
6996;195251;85;0;0;0;0;.00nan;0;0
6996;-1;85;59;52;6;46;.885;3600000;0
6996;192629;1097;70;22;1;21;.955;3600000;0
6997;203276;82;98;52;3;49;.942;3900000;0
6997;185800;82;0;0;0;0;.00nan;0;0
6997;191574;4920;47;19;3;16;.842;3900000;0
6997;-1;4920;0;0;0;0;.00nan;0;0
6998;163989;149;71;35;3;32;.914;3585000;0
6998;184788;151;0;0;0;0;.00nan;0;0
6998;65014;151;90;28;1;27;.964;3600000;0
6998;85546;149;0;0;0;0;.00nan;0;0
6999;178394;1095;0;0;0;0;.00nan;0;0
6999;189885;4921;0;0;0;0;.00nan;0;0
6999;186451;1095;64;26;2;24;.923;3900000;0
6999;197912;4921;78;31;2;29;.935;3900000;0
7000;184069;73;56;34;4;30;.882;3568000;0
7000;173961;73;0;0;0;0;.00nan;0;0
7000;78581;71;0;0;0;0;.00nan;0;0
7000;91403;71;61;29;3;26;.897;3600000;0
7001;199437;77;63;16;1;15;.938;3600000;0
7001;200390;1096;55;47;6;41;.872;2972000;0
7001;190034;77;0;0;0;0;.00nan;0;0
7001;-1;1096;61;8;0;8;1.000;628000;0
7002;204668;78;0;0;0;0;.00nan;0;0
7002;200572;157;100;29;0;29;1.000;3600000;0
7002;189902;78;97;42;2;40;.952;3600000;0
7002;191518;157;0;0;0;0;.00nan;0;0
7003;203179;4620;52;39;5;34;.872;3600000;0
7003;196414;152;0;0;0;0;.00nan;0;0
7003;-1;4620;0;0;0;0;.00nan;0;0
7003;86875;152;71;35;3;32;.914;3600000;0
7004;182467;4922;86;42;3;39;.929;3715000;0
7004;194219;76;55;21;2;19;.905;3715000;0
7004;205121;4922;0;0;0;0;.00nan;0;0
7004;184175;76;0;0;0;0;.00nan;0;0
7005;161535;4245;53;25;3;22;.880;3832000;0
7005;200233;4245;0;0;0;0;.00nan;0;0
7005;-1;69;0;0;0;0;.00nan;0;0
7005;78479;69;59;34;4;30;.882;3832000;0
7006;189081;1097;86;35;2;33;.943;3900000;0
7006;192629;1097;0;0;0;0;.00nan;0;0
7006;78820;75;0;0;0;0;.00nan;0;0
7006;86394;75;84;32;2;30;.938;3900000;0
7007;183737;72;0;0;0;0;.00nan;0;0
7007;192547;2564;58;42;6;36;.857;3600000;0
7007;79141;2564;0;0;0;0;.00nan;0;0
7007;91212;72;75;23;1;22;.957;3600000;0
7008;179344;67;96;37;1;36;.973;3868000;0
7008;176136;74;59;15;2;13;.867;3868000;0
7008;-1;67;0;0;0;0;.00nan;0;0
7008;-1;74;0;0;0;0;.00nan;0;0
7009;203276;82;0;0;0;0;.00nan;0;0
7009;185800;82;97;49;3;46;.939;3600000;0
7009;191574;4920;0;0;0;0;.00nan;0;0
7009;-1;4920;81;17;1;16;.941;3600000;0
7010;163989;149;0;0;0;0;.00nan;0;0
7010;-1;158;0;0;0;0;.00nan;0;0
7010;85546;149;87;30;1;29;.967;3600000;0
7010;86862;158;39;35;6;29;.829;3600000;0
7011;189081;1097;0;0;0;0;.00nan;0;0
7011;200390;1096;0;0;0;0;.00nan;0;0
7011;-1;1096;53;31;4;27;.871;3878000;0
7011;192629;1097;55;31;4;27;.871;3900000;0
7012;178394;1095;64;45;5;40;.889;3600000;0
7012;186451;1095;0;0;0;0;.00nan;0;0
7012;78581;71;45;24;4;20;.833;3600000;0
7012;91403;71;0;0;0;0;.00nan;0;0
7013;199437;77;0;0;0;0;.00nan;0;0
7013;190034;77;77;40;4;36;.900;3600000;0
7013;78820;75;99;20;0;20;1.000;3600000;0
7013;86394;75;0;0;0;0;.00nan;0;0
7014;204668;78;83;36;2;34;.944;3550000;0
7014;200572;157;94;29;1;28;.966;3600000;0
7014;189902;78;0;0;0;0;.00nan;0;0
7014;191518;157;0;0;0;0;.00nan;0;0
7015;183737;72;81;47;4;43;.915;3600000;0
7015;184069;73;0;0;0;0;.00nan;0;0
7015;173961;73;90;29;1;28;.966;3600000;0
7015;91212;72;0;0;0;0;.00nan;0;0
7016;182467;4922;0;0;0;0;.00nan;0;0
7016;205121;4922;100;31;0;31;1.000;3600000;0
7016;195251;85;71;27;2;25;.926;3523000;0
7016;-1;85;0;0;0;0;.00nan;0;0
7017;203179;4620;0;0;0;0;.00nan;0;0
7017;196414;152;35;41;7;34;.829;3243000;0
7017;-1;4620;77;24;1;23;.958;3600000;0
7017;86875;152;48;0;0;0;.00nan;357000;0
7018;161535;4245;0;0;0;0;.00nan;0;0
7018;200233;4245;47;19;3;16;.842;3600000;0
7018;-1;69;40;33;6;27;.818;3151000;0
7018;78479;69;53;10;1;9;.900;449000;0
7019;189885;4921;35;28;5;23;.821;3600000;0
7019;192547;2564;0;0;0;0;.00nan;0;0
7019;197912;4921;0;0;0;0;.00nan;0;0
7019;79141;2564;64;22;2;20;.909;3600000;0
7020;170598;80;90;27;1;26;.963;3600000;0
7020;184788;151;77;31;2;29;.935;3600000;0
7020;-1;80;0;0;0;0;.00nan;0;0
7020;65014;151;0;0;0;0;.00nan;0;0
7021;179344;67;0;0;0;0;.00nan;0;0
7021;176136;74;63;26;2;24;.923;3900000;0
7021;-1;67;85;38;2;36;.947;3900000;0
7021;-1;74;0;0;0;0;.00nan;0;0
7022;194219;76;0;0;0;0;.00nan;0;0
7022;200390;1096;73;30;2;28;.933;3600000;0
7022;184175;76;58;10;1;9;.900;3600000;0
7022;-1;1096;0;0;0;0;.00nan;0;0
7023;184069;73;33;36;6;30;.833;3600000;0
7023;173961;73;0;0;0;0;.00nan;0;0
7023;78581;71;0;0;0;0;.00nan;0;0
7023;91403;71;88;17;0;17;1.000;3600000;0
7024;195251;85;0;0;0;0;.00nan;0;0
7024;-1;85;95;52;3;49;.942;3557000;0
7024;78820;75;0;0;0;0;.00nan;0;0
7024;86394;75;84;30;1;29;.967;3600000;0
7025;189885;4921;0;0;0;0;.00nan;0;0
7025;192547;2564;43;35;6;29;.829;3274000;0
7025;197912;4921;76;44;4;40;.909;3600000;0
7025;79141;2564;56;4;0;4;1.000;298000;0
7026;170598;80;0;0;0;0;.00nan;0;0
7026;184788;151;0;0;0;0;.00nan;0;0
7026;-1;80;77;28;2;26;.929;3600000;0
7026;65014;151;63;28;3;25;.893;3548000;0
7027;183737;72;0;0;0;0;.00nan;0;0
7027;-1;69;100;39;0;39;1.000;3600000;0
7027;78479;69;0;0;0;0;.00nan;0;0
7027;91212;72;76;35;3;32;.914;3600000;0
7028;176770;81;0;0;0;0;.00nan;0;0
7028;176860;81;95;30;1;29;.967;3600000;0
7028;-1;158;81;40;3;37;.925;3553000;0
7028;86862;158;0;0;0;0;.00nan;0;0
7029;182467;4922;0;0;0;0;.00nan;0;0
7029;189081;1097;80;28;1;27;.964;3600000;0
7029;205121;4922;56;40;5;35;.875;3600000;0
7029;192629;1097;0;0;0;0;.00nan;0;0
7030;161535;4245;0;0;0;0;.00nan;0;0
7030;200233;4245;42;34;6;28;.824;3600000;0
7030;191574;4920;88;27;1;26;.963;3600000;0
7030;-1;4920;0;0;0;0;.00nan;0;0
7031;203276;82;96;51;2;49;.961;3900000;0
7031;185800;82;0;0;0;0;.00nan;0;0
7031;78820;75;0;0;0;0;.00nan;0;0
7031;86394;75;68;22;2;20;.909;3900000;0
7032;199437;77;55;25;3;22;.880;3520000;0
7032;178394;1095;0;0;0;0;.00nan;0;0
7032;190034;77;0;0;0;0;.00nan;0;0
7032;186451;1095;100;37;1;36;.973;3600000;0
7033;200572;157;66;28;3;25;.893;3900000;0
7033;196414;152;96;44;3;41;.932;3900000;0
7033;191518;157;0;0;0;0;.00nan;0;0
7033;86875;152;0;0;0;0;.00nan;0;0
7034;-1;69;78;26;2;24;.923;3600000;0
7034;192547;2564;19;35;7;28;.800;3274000;0
7034;78479;69;0;0;0;0;.00nan;0;0
7034;79141;2564;48;6;1;5;.833;326000;0
7035;203179;4620;75;25;1;24;.960;3600000;0
7035;195251;85;55;52;7;45;.865;3600000;0
7035;-1;85;0;0;0;0;.00nan;0;0
7035;-1;4620;0;0;0;0;.00nan;0;0
7036;163989;149;66;33;3;30;.909;3547000;0
7036;184788;151;0;0;0;0;.00nan;0;0
7036;65014;151;90;45;1;44;.978;3600000;0
7036;85546;149;0;0;0;0;.00nan;0;0
7037;176770;81;0;0;0;0;.00nan;0;0
7037;176860;81;65;23;2;21;.913;3600000;0
7037;-1;158;0;0;0;0;.00nan;0;0
7037;86862;158;64;32;3;29;.906;3553000;0
7038;203276;82;65;42;5;37;.881;3600000;0
7038;185800;82;0;0;0;0;.00nan;0;0
7038;78820;75;65;22;2;20;.909;3600000;0
7038;86394;75;0;0;0;0;.00nan;0;0
7039;170598;80;1;21;8;13;.619;1275000;0
7039;-1;80;46;11;2;9;.818;2325000;0
7039;78581;71;79;22;1;21;.955;3600000;0
7039;91403;71;0;0;0;0;.00nan;0;0
7040;183737;72;0;0;0;0;.00nan;0;0
7040;184069;73;85;36;2;34;.944;3600000;0
7040;173961;73;0;0;0;0;.00nan;0;0
7040;91212;72;39;29;5;24;.828;3600000;0
7041;189885;4921;0;0;0;0;.00nan;0;0
7041;-1;69;75;22;1;21;.955;3900000;0
7041;197912;4921;80;35;1;34;.971;3900000;0
7041;78479;69;0;0;0;0;.00nan;0;0
7042;200572;157;83;40;4;36;.900;3643000;0
7042;196414;152;84;36;3;33;.917;3643000;0
7042;191518;157;0;0;0;0;.00nan;0;0
7042;86875;152;0;0;0;0;.00nan;0;0
7043;203179;4620;70;18;1;17;.944;3600000;0
7043;204668;78;0;0;0;0;.00nan;0;0
7043;189902;78;59;38;4;34;.895;3600000;0
7043;-1;4620;0;0;0;0;.00nan;0;0
7044;182467;4922;0;0;0;0;.00nan;0;0
7044;205121;4922;54;33;4;29;.879;3555000;0
7044;176136;74;65;25;2;23;.920;3600000;0
7044;-1;74;0;0;0;0;.00nan;0;0
7045;199437;77;44;36;5;31;.861;3600000;0
7045;194219;76;68;31;4;27;.871;3600000;0
7045;184175;76;0;0;0;0;.00nan;0;0
7045;190034;77;0;0;0;0;.00nan;0;0
7046;176770;81;77;25;1;24;.960;3600000;0
7046;176860;81;0;0;0;0;.00nan;0;0
7046;-1;158;0;0;0;0;.00nan;0;0
7046;86862;158;28;35;8;27;.771;3600000;0
7047;161535;4245;0;0;0;0;.00nan;0;0
7047;200233;4245;60;21;2;19;.905;3600000;0
7047;195251;85;74;32;3;29;.906;3575000;0
7047;-1;85;0;0;0;0;.00nan;0;0
7048;189081;1097;0;0;0;0;.00nan;0;0
7048;200390;1096;0;0;0;0;.00nan;0;0
7048;-1;1096;46;31;5;26;.839;3600000;0
7048;192629;1097;71;28;2;26;.929;3600000;0
7049;178394;1095;0;0;0;0;.00nan;0;0
7049;186451;1095;72;36;3;33;.917;3600000;0
7049;192547;2564;92;21;0;21;1.000;3600000;0
7049;79141;2564;0;0;0;0;.00nan;0;0
7050;163989;149;51;35;5;30;.857;3789000;0
7050;184788;151;0;0;0;0;.00nan;0;0
7050;65014;151;55;31;4;27;.871;3789000;0
7050;85546;149;0;0;0;0;.00nan;0;0
7051;179344;67;0;0;0;0;.00nan;0;0
7051;-1;67;68;48;5;43;.896;3576000;0
7051;191574;4920;37;14;3;11;.786;3600000;0
7051;-1;4920;0;0;0;0;.00nan;0;0
7052;178394;1095;87;18;0;18;1.000;3600000;0
7052;186451;1095;0;0;0;0;.00nan;0;0
7052;192547;2564;45;31;5;26;.839;3600000;0
7052;79141;2564;0;0;0;0;.00nan;0;0
7053;203276;82;72;12;0;12;1.000;820000;0
7053;185800;82;46;38;6;32;.842;2780000;0
7053;78820;75;0;0;0;0;.00nan;0;0
7053;86394;75;31;10;3;7;.700;3600000;0
7054;184069;73;0;0;0;0;.00nan;0;0
7054;173961;73;66;27;3;24;.889;3600000;0
7054;78581;71;0;0;0;0;.00nan;0;0
7054;91403;71;54;32;4;28;.875;3558000;0
7055;189885;4921;0;0;0;0;.00nan;0;0
7055;-1;69;56;17;2;15;.882;3600000;0
7055;197912;4921;79;37;3;34;.919;3554000;0
7055;78479;69;0;0;0;0;.00nan;0;0
7056;200572;157;45;31;5;26;.839;3600000;0
7056;196414;152;57;5;0;5;1.000;1262000;0
7056;191518;157;0;0;0;0;.00nan;0;0
7056;86875;152;40;19;4;15;.789;2338000;0
7057;203179;4620;0;0;0;0;.00nan;0;0
7057;204668;78;98;50;2;48;.960;3545000;0
7057;189902;78;0;0;0;0;.00nan;0;0
7057;-1;4620;73;20;1;19;.950;3600000;0
7058;182467;4922;42;38;6;32;.842;2935000;0
7058;205121;4922;51;2;0;2;1.000;665000;0
7058;176136;74;75;22;1;21;.955;3600000;0
7058;-1;74;0;0;0;0;.00nan;0;0
7059;194219;76;0;0;0;0;.00nan;0;0
7059;200390;1096;55;45;6;39;.867;3322000;0
7059;184175;76;67;21;2;19;.905;3600000;0
7059;-1;1096;54;3;0;3;1.000;278000;0
7060;176770;81;0;0;0;0;.00nan;0;0
7060;176860;81;82;45;4;41;.911;3900000;0
7060;-1;158;55;30;4;26;.867;3900000;0
7060;86862;158;0;0;0;0;.00nan;0;0
7061;161535;4245;0;0;0;0;.00nan;0;0
7061;200233;4245;58;17;2;15;.882;3600000;0
7061;195251;85;0;0;0;0;.00nan;0;0
7061;-1;85;53;42;6;36;.857;3600000;0
7062;199437;77;0;0;0;0;.00nan;0;0
7062;189081;1097;0;0;0;0;.00nan;0;0
7062;190034;77;68;27;2;25;.926;3600000;0
7062;192629;1097;51;27;4;23;.852;3543000;0
7063;163989;149;0;0;0;0;.00nan;0;0
7063;184788;151;90;35;0;35;1.000;3900000;0
7063;65014;151;0;0;0;0;.00nan;0;0
7063;85546;149;100;23;0;23;1.000;3900000;0
7064;183737;72;74;20;1;19;.950;3600000;0
7064;170598;80;81;43;3;40;.930;3552000;0
7064;-1;80;0;0;0;0;.00nan;0;0
7064;91212;72;0;0;0;0;.00nan;0;0
7065;179344;67;85;45;3;42;.933;3600000;0
7065;-1;67;0;0;0;0;.00nan;0;0
7065;191574;4920;0;0;0;0;.00nan;0;0
7065;-1;4920;84;16;0;16;1.000;3600000;0
7066;189885;4921;29;35;7;28;.800;2842000;0
7066;197912;4921;31;19;4;15;.789;758000;0
7066;78581;71;69;18;1;17;.944;3600000;0
7066;91403;71;0;0;0;0;.00nan;0;0
7067;199437;77;53;30;5;25;.833;3749000;0
7067;189081;1097;55;27;4;23;.852;3749000;0
7067;190034;77;0;0;0;0;.00nan;0;0
7067;192629;1097;0;0;0;0;.00nan;0;0
7068;178394;1095;75;33;3;30;.909;3600000;0
7068;-1;69;23;24;6;18;.750;3113000;0
7068;186451;1095;0;0;0;0;.00nan;0;0
7068;78479;69;53;3;0;3;1.000;487000;0
7069;203179;4620;81;27;2;25;.926;3600000;0
7069;204668;78;0;0;0;0;.00nan;0;0
7069;189902;78;46;31;4;27;.871;3570000;0
7069;-1;4620;0;0;0;0;.00nan;0;0
7070;194219;76;67;19;1;18;.947;3600000;0
7070;200390;1096;0;0;0;0;.00nan;0;0
7070;184175;76;0;0;0;0;.00nan;0;0
7070;-1;1096;87;48;3;45;.938;3515000;0
7071;183737;72;0;0;0;0;.00nan;0;0
7071;170598;80;0;0;0;0;.00nan;0;0
7071;-1;80;66;38;4;34;.895;3589000;0
7071;91212;72;38;14;3;11;.786;3600000;0
7072;204668;78;100;56;2;54;.964;3900000;0
7072;189902;78;0;0;0;0;.00nan;0;0
7072;191574;4920;0;0;0;0;.00nan;0;0
7072;-1;4920;60;29;2;27;.931;3900000;0
7073;178394;1095;79;17;0;17;1.000;2985000;0
7073;184788;151;79;30;2;28;.933;3600000;0
7073;186451;1095;14;5;4;1;.200;577000;0
7073;65014;151;0;0;0;0;.00nan;0;0
7074;199437;77;76;28;2;26;.929;3900000;0
7074;200390;1096;0;0;0;0;.00nan;0;0
7074;190034;77;0;0;0;0;.00nan;0;0
7074;-1;1096;78;27;2;25;.926;3900000;0
7075;200572;157;0;0;0;0;.00nan;0;0
7075;176770;81;0;0;0;0;.00nan;0;0
7075;176860;81;40;27;5;22;.815;3600000;0
7075;191518;157;65;34;4;30;.882;3600000;0
7076;163989;149;0;0;0;0;.00nan;0;0
7076;196414;152;74;38;3;35;.921;3900000;0
7076;85546;149;70;31;3;28;.903;3900000;0
7076;86875;152;0;0;0;0;.00nan;0;0
7077;195251;85;46;39;6;33;.846;3600000;0
7077;176136;74;73;19;1;18;.947;3600000;0
7077;-1;85;0;0;0;0;.00nan;0;0
7077;-1;74;0;0;0;0;.00nan;0;0
7078;182467;4922;0;0;0;0;.00nan;0;0
7078;189081;1097;0;0;0;0;.00nan;0;0
7078;205121;4922;50;22;3;19;.864;3600000;0
7078;192629;1097;75;33;2;31;.939;3600000;0
7079;204668;78;71;39;5;34;.872;3600000;0
7079;189902;78;0;0;0;0;.00nan;0;0
7079;191574;4920;65;14;1;13;.929;3600000;0
7079;-1;4920;0;0;0;0;.00nan;0;0
7080;182467;4922;80;28;2;26;.929;3836000;0
7080;205121;4922;0;0;0;0;.00nan;0;0
7080;200390;1096;74;34;3;31;.912;3836000;0
7080;-1;1096;0;0;0;0;.00nan;0;0
7081;178394;1095;56;25;3;22;.880;3600000;0
7081;-1;69;77;28;1;27;.964;3600000;0
7081;186451;1095;0;0;0;0;.00nan;0;0
7081;78479;69;0;0;0;0;.00nan;0;0
7082;184788;151;0;0;0;0;.00nan;0;0
7082;65014;151;96;41;1;40;.976;3600000;0
7082;78581;71;20;25;6;19;.760;2217000;0
7082;91403;71;60;11;1;10;.909;1383000;0
7083;200572;157;64;26;3;23;.885;3547000;0
7083;176770;81;0;0;0;0;.00nan;0;0
7083;176860;81;82;25;1;24;.960;3600000;0
7083;191518;157;0;0;0;0;.00nan;0;0
7084;189885;4921;0;0;0;0;.00nan;0;0
7084;192547;2564;69;24;2;22;.917;3600000;0
7084;197912;4921;47;27;4;23;.852;3550000;0
7084;79141;2564;0;0;0;0;.00nan;0;0
7085;163989;149;56;36;5;31;.861;3600000;0
7085;196414;152;62;23;3;20;.870;3600000;0
7085;85546;149;0;0;0;0;.00nan;0;0
7085;86875;152;0;0;0;0;.00nan;0;0
7086;203276;82;62;31;3;28;.903;3533000;0
7086;194219;76;81;27;1;26;.963;3600000;0
7086;184175;76;0;0;0;0;.00nan;0;0
7086;185800;82;0;0;0;0;.00nan;0;0
7087;161535;4245;0;0;0;0;.00nan;0;0
7087;200233;4245;70;38;4;34;.895;3600000;0
7087;179344;67;84;25;1;24;.960;3600000;0
7087;-1;67;0;0;0;0;.00nan;0;0
7088;199437;77;54;41;5;36;.878;3600000;0
7088;190034;77;0;0;0;0;.00nan;0;0
7088;78820;75;0;0;0;0;.00nan;0;0
7088;86394;75;41;16;3;13;.813;3600000;0
7089;195251;85;64;41;4;37;.902;3544000;0
7089;176136;74;73;34;3;31;.912;3600000;0
7089;-1;85;0;0;0;0;.00nan;0;0
7089;-1;74;0;0;0;0;.00nan;0;0
7090;183737;72;0;0;0;0;.00nan;0;0
7090;184069;73;65;35;4;31;.886;3574000;0
7090;173961;73;0;0;0;0;.00nan;0;0
7090;91212;72;72;29;3;26;.897;3600000;0
7091;179344;67;40;10;2;8;.800;1073000;0
7091;-1;67;43;37;6;31;.838;2527000;0
7091;191574;4920;0;0;0;0;.00nan;0;0
7091;-1;4920;66;17;1;16;.941;3600000;0
7092;199437;77;71;19;1;18;.947;3600000;0
7092;200390;1096;0;0;0;0;.00nan;0;0
7092;190034;77;0;0;0;0;.00nan;0;0
7092;-1;1096;69;45;4;41;.911;3600000;0
7093;203276;82;0;0;0;0;.00nan;0;0
7093;194219;76;0;0;0;0;.00nan;0;0
7093;184175;76;53;30;5;25;.833;3600000;0
7093;185800;82;99;43;1;42;.977;3600000;0
7094;184788;151;74;52;5;47;.904;3600000;0
7094;65014;151;0;0;0;0;.00nan;0;0
7094;78581;71;0;0;0;0;.00nan;0;0
7094;91403;71;18;25;6;19;.760;3600000;0
7095;200572;157;0;0;0;0;.00nan;0;0
7095;176770;81;92;36;1;35;.972;3600000;0
7095;176860;81;0;0;0;0;.00nan;0;0
7095;191518;157;59;19;2;17;.895;3600000;0
7096;184069;73;0;0;0;0;.00nan;0;0
7096;173961;73;44;24;4;20;.833;3600000;0
7096;-1;69;0;0;0;0;.00nan;0;0
7096;78479;69;100;28;0;28;1.000;3600000;0
7097;189885;4921;64;38;5;33;.868;3804000;0
7097;192547;2564;0;0;0;0;.00nan;0;0
7097;197912;4921;0;0;0;0;.00nan;0;0
7097;79141;2564;31;15;4;11;.733;3804000;0
7098;182467;4922;0;0;0;0;.00nan;0;0
7098;189081;1097;0;0;0;0;.00nan;0;0
7098;205121;4922;64;26;3;23;.885;3600000;0
7098;192629;1097;42;34;6;28;.824;3600000;0
7099;163989;149;0;0;0;0;.00nan;0;0
7099;196414;152;0;0;0;0;.00nan;0;0
7099;85546;149;45;28;4;24;.857;3900000;0
7099;86875;152;70;35;4;31;.886;3900000;0
7100;203179;4620;78;25;1;24;.960;3600000;0
7100;204668;78;0;0;0;0;.00nan;0;0
7100;189902;78;58;48;6;42;.875;3600000;0
7100;-1;4620;0;0;0;0;.00nan;0;0
7101;195251;85;0;0;0;0;.00nan;0;0
7101;176136;74;31;14;4;10;.714;1200000;0
7101;-1;85;71;34;3;31;.912;3600000;0
7101;-1;74;51;14;2;12;.857;2400000;0
7102;183737;72;59;22;3;19;.864;3600000;0
7102;178394;1095;62;9;0;9;1.000;783000;0
7102;186451;1095;15;29;7;22;.759;2817000;0
7102;91212;72;0;0;0;0;.00nan;0;0
7103;184788;151;0;0;0;0;.00nan;0;0
7103;65014;151;59;43;6;37;.860;3736000;0
7103;78581;71;47;29;5;24;.828;3751000;0
7103;91403;71;0;0;0;0;.00nan;0;0
7104;189885;4921;0;0;0;0;.00nan;0;0
7104;192547;2564;72;28;3;25;.893;3544000;0
7104;197912;4921;67;22;2;20;.909;3600000;0
7104;79141;2564;0;0;0;0;.00nan;0;0
7105;203179;4620;0;0;0;0;.00nan;0;0
7105;191574;4920;48;21;3;18;.857;3802000;0
7105;-1;4920;0;0;0;0;.00nan;0;0
7105;-1;4620;100;49;2;47;.959;3802000;0
7106;199437;77;90;57;4;53;.930;3600000;0
7106;189081;1097;93;33;1;32;.970;3600000;0
7106;190034;77;0;0;0;0;.00nan;0;0
7106;192629;1097;0;0;0;0;.00nan;0;0
7107;187699;158;0;0;0;0;.00nan;0;0
7107;170598;80;89;24;1;23;.958;3900000;0
7107;-1;80;0;0;0;0;.00nan;0;0
7107;86862;158;86;35;1;34;.971;3900000;0
7108;163989;149;86;26;1;25;.962;3600000;0
7108;176770;81;0;0;0;0;.00nan;0;0
7108;176860;81;33;30;6;24;.800;3600000;0
7108;85546;149;0;0;0;0;.00nan;0;0
7109;199437;77;82;27;1;26;.963;3755000;0
7109;200390;1096;71;29;2;27;.931;3755000;0
7109;190034;77;0;0;0;0;.00nan;0;0
7109;-1;1096;0;0;0;0;.00nan;0;0
7110;203276;82;97;41;2;39;.951;3600000;0
7110;182467;4922;0;0;0;0;.00nan;0;0
7110;205121;4922;100;33;0;33;1.000;3600000;0
7110;185800;82;0;0;0;0;.00nan;0;0
7111;170598;80;83;33;2;31;.939;3511000;0
7111;196414;152;100;34;0;34;1.000;3600000;0
7111;-1;80;0;0;0;0;.00nan;0;0
7111;86875;152;0;0;0;0;.00nan;0;0
7112;161535;4245;0;0;0;0;.00nan;0;0
7112;200233;4245;41;20;3;17;.850;3580000;0
7112;176136;74;79;33;2;31;.939;3600000;0
7112;-1;74;0;0;0;0;.00nan;0;0
7113;195251;85;0;0;0;0;.00nan;0;0
7113;-1;85;86;55;5;50;.909;3600000;0
7113;191574;4920;0;0;0;0;.00nan;0;0
7113;-1;4920;58;20;2;18;.900;3600000;0
7114;189885;4921;0;0;0;0;.00nan;0;0
7114;197912;4921;84;46;3;43;.935;3900000;0
7114;78581;71;0;0;0;0;.00nan;0;0
7114;91403;71;64;27;3;24;.889;3900000;0
7115;194219;76;91;27;1;26;.963;3600000;0
7115;189081;1097;56;26;3;23;.885;3571000;0
7115;184175;76;0;0;0;0;.00nan;0;0
7115;192629;1097;0;0;0;0;.00nan;0;0
7116;203179;4620;0;0;0;0;.00nan;0;0
7116;191574;4920;82;33;2;31;.939;3600000;0
7116;-1;4920;0;0;0;0;.00nan;0;0
7116;-1;4620;71;35;3;32;.914;3558000;0
7117;163989;149;100;24;0;24;1.000;3600000;0
7117;176770;81;0;0;0;0;.00nan;0;0
7117;176860;81;61;29;4;25;.862;3600000;0
7117;85546;149;0;0;0;0;.00nan;0;0
7118;183737;72;0;0;0;0;.00nan;0;0
7118;178394;1095;77;22;1;21;.955;3580000;0
7118;186451;1095;0;0;0;0;.00nan;0;0
7118;91212;72;100;31;0;31;1.000;3600000;0
7119;199437;77;90;44;3;41;.932;3600000;0
7119;194219;76;68;12;0;12;1.000;2509000;0
7119;184175;76;26;17;4;13;.765;1059000;0
7119;190034;77;0;0;0;0;.00nan;0;0
7120;200572;157;98;34;1;33;.971;3600000;0
7120;184788;151;0;0;0;0;.00nan;0;0
7120;191518;157;0;0;0;0;.00nan;0;0
7120;65014;151;71;27;2;25;.926;3600000;0
7121;189885;4921;35;19;5;14;.737;1833000;0
7121;197912;4921;20;21;6;15;.714;1767000;0
7121;78581;71;62;22;2;20;.909;3600000;0
7121;91403;71;0;0;0;0;.00nan;0;0
7122;182467;4922;0;0;0;0;.00nan;0;0
7122;205121;4922;59;39;5;34;.872;3600000;0
7122;78820;75;0;0;0;0;.00nan;0;0
7122;86394;75;94;21;0;21;1.000;3600000;0
7123;184069;73;72;42;4;38;.905;3600000;0
7123;173961;73;0;0;0;0;.00nan;0;0
7123;-1;69;38;31;5;26;.839;3600000;0
7123;78479;69;0;0;0;0;.00nan;0;0
7124;161535;4245;0;0;0;0;.00nan;0;0
7124;200233;4245;79;32;3;29;.906;3526000;0
7124;176136;74;94;34;1;33;.971;3600000;0
7124;-1;74;0;0;0;0;.00nan;0;0
7125;203276;82;84;49;4;45;.918;3600000;0
7125;189081;1097;71;21;1;20;.952;3600000;0
7125;185800;82;0;0;0;0;.00nan;0;0
7125;192629;1097;0;0;0;0;.00nan;0;0
7126;170598;80;80;22;1;21;.955;3600000;0
7126;196414;152;83;42;3;39;.929;3575000;0
7126;-1;80;0;0;0;0;.00nan;0;0
7126;86875;152;0;0;0;0;.00nan;0;0
7127;195251;85;0;0;0;0;.00nan;0;0
7127;179344;67;0;0;0;0;.00nan;0;0
7127;-1;85;59;33;4;29;.879;3881000;0
7127;-1;67;70;31;3;28;.903;3881000;0
7128;195251;85;66;49;6;43;.878;2347000;0
7128;-1;85;62;20;2;18;.900;1253000;0
7128;191574;4920;0;0;0;0;.00nan;0;0
7128;-1;4920;47;21;3;18;.857;3600000;0
7129;163989;149;67;32;3;29;.906;3600000;0
7129;176770;81;37;28;5;23;.821;3526000;0
7129;176860;81;0;0;0;0;.00nan;0;0
7129;85546;149;0;0;0;0;.00nan;0;0
7130;194219;76;49;1;0;1;1.000;288000;0
7130;200390;1096;0;0;0;0;.00nan;0;0
7130;184175;76;39;29;5;24;.828;3312000;0
7130;-1;1096;76;36;2;34;.944;3600000;0
7131;199437;77;0;0;0;0;.00nan;0;0
7131;189081;1097;53;19;3;16;.842;3600000;0
7131;190034;77;59;47;6;41;.872;3600000;0
7131;192629;1097;0;0;0;0;.00nan;0;0
7132;189885;4921;0;0;0;0;.00nan;0;0
7132;197912;4921;52;39;5;34;.872;3697000;0
7132;78581;71;0;0;0;0;.00nan;0;0
7132;91403;71;38;18;4;14;.778;3697000;0
7133;184069;73;0;0;0;0;.00nan;0;0
7133;173961;73;90;36;1;35;.972;3600000;0
7133;-1;69;0;0;0;0;.00nan;0;0
7133;78479;69;70;43;4;39;.907;3600000;0
7134;161535;4245;0;0;0;0;.00nan;0;0
7134;200233;4245;54;25;3;22;.880;3545000;0
7134;176136;74;99;39;1;38;.974;3600000;0
7134;-1;74;0;0;0;0;.00nan;0;0
7135;203276;82;40;8;2;6;.750;634000;0
7135;185800;82;56;45;6;39;.867;2966000;0
7135;78820;75;0;0;0;0;.00nan;0;0
7135;86394;75;54;10;1;9;.900;3600000;0
7136;178394;1095;0;0;0;0;.00nan;0;0
7136;186451;1095;74;33;4;29;.879;3600000;0
7136;192547;2564;80;27;1;26;.963;3600000;0
7136;79141;2564;0;0;0;0;.00nan;0;0
7137;200572;157;0;0;0;0;.00nan;0;0
7137;184788;151;63;38;4;34;.895;3600000;0
7137;191518;157;52;40;5;35;.875;3545000;0
7137;65014;151;0;0;0;0;.00nan;0;0
7138;187699;158;67;31;3;28;.903;3600000;0
7138;170598;80;0;0;0;0;.00nan;0;0
7138;-1;80;68;36;4;32;.889;3600000;0
7138;86862;158;0;0;0;0;.00nan;0;0
7139;203179;4620;0;0;0;0;.00nan;0;0
7139;179344;67;84;38;2;36;.947;3600000;0
7139;-1;67;0;0;0;0;.00nan;0;0
7139;-1;4620;58;27;3;24;.889;3581000;0
7140;183737;72;0;0;0;0;.00nan;0;0
7140;184069;73;64;36;4;32;.889;3874000;0
7140;173961;73;0;0;0;0;.00nan;0;0
7140;91212;72;59;32;5;27;.844;3874000;0
7141;-1;69;93;52;4;48;.923;3531000;0
7141;78479;69;0;0;0;0;.00nan;0;0
7141;78581;71;62;33;3;30;.909;3600000;0
7141;91403;71;0;0;0;0;.00nan;0;0
7142;178394;1095;54;33;5;28;.848;3600000;0
7142;186451;1095;0;0;0;0;.00nan;0;0
7142;192547;2564;50;23;4;19;.826;3600000;0
7142;79141;2564;0;0;0;0;.00nan;0;0
7143;204668;78;69;33;4;29;.879;3553000;0
7143;195251;85;0;0;0;0;.00nan;0;0
7143;189902;78;0;0;0;0;.00nan;0;0
7143;-1;85;77;28;2;26;.929;3600000;0
7144;203179;4620;0;0;0;0;.00nan;0;0
7144;179344;67;85;41;4;37;.902;3600000;0
7144;-1;67;0;0;0;0;.00nan;0;0
7144;-1;4620;80;25;1;24;.960;3600000;0
7145;182467;4922;0;0;0;0;.00nan;0;0
7145;178394;1095;0;0;0;0;.00nan;0;0
7145;205121;4922;69;28;3;25;.893;3600000;0
7145;186451;1095;35;20;4;16;.800;3546000;0
7146;203276;82;60;32;4;28;.875;3572000;0
7146;199437;77;76;27;2;25;.926;3600000;0
7146;190034;77;0;0;0;0;.00nan;0;0
7146;185800;82;0;0;0;0;.00nan;0;0
7147;194219;76;51;37;6;31;.838;3548000;0
7147;184175;76;0;0;0;0;.00nan;0;0
7147;78820;75;0;0;0;0;.00nan;0;0
7147;86394;75;40;25;5;20;.800;3600000;0
7148;163989;149;89;36;3;33;.917;3785000;0
7148;200572;157;87;41;4;37;.902;3785000;0
7148;191518;157;0;0;0;0;.00nan;0;0
7148;85546;149;0;0;0;0;.00nan;0;0
7149;189081;1097;80;46;4;42;.913;3817000;0
7149;200390;1096;72;28;3;25;.893;3817000;0
7149;-1;1096;0;0;0;0;.00nan;0;0
7149;192629;1097;0;0;0;0;.00nan;0;0
7150;203276;82;0;0;0;0;.00nan;0;0
7150;199437;77;80;29;2;27;.931;3581000;0
7150;190034;77;0;0;0;0;.00nan;0;0
7150;185800;82;99;37;1;36;.973;3600000;0
7151;176136;74;92;63;4;59;.937;3736000;0
7151;-1;74;0;0;0;0;.00nan;0;0
7151;78581;71;0;0;0;0;.00nan;0;0
7151;91403;71;50;21;3;18;.857;3736000;0
7152;182467;4922;76;37;3;34;.919;3600000;0
7152;205121;4922;0;0;0;0;.00nan;0;0
7152;184069;73;0;0;0;0;.00nan;0;0
7152;173961;73;60;21;2;19;.905;3600000;0
7153;-1;69;45;30;6;24;.800;3600000;0
7153;192547;2564;80;35;2;33;.943;3600000;0
7153;78479;69;0;0;0;0;.00nan;0;0
7153;79141;2564;0;0;0;0;.00nan;0;0
7154;203179;4620;0;0;0;0;.00nan;0;0
7154;191574;4920;72;23;2;21;.913;3600000;0
7154;-1;4920;0;0;0;0;.00nan;0;0
7154;-1;4620;66;41;4;37;.902;3600000;0
7155;194219;76;100;51;1;50;.980;3900000;0
7155;184175;76;0;0;0;0;.00nan;0;0
7155;78820;75;78;22;1;21;.955;3900000;0
7155;86394;75;0;0;0;0;.00nan;0;0
7156;189885;4921;0;0;0;0;.00nan;0;0
7156;176770;81;54;9;1;8;.889;1032000;0
7156;176860;81;28;22;6;16;.727;2568000;0
7156;197912;4921;43;26;5;21;.808;3600000;0
7157;161535;4245;0;0;0;0;.00nan;0;0
7157;200233;4245;65;20;1;19;.950;3600000;0
7157;179344;67;0;0;0;0;.00nan;0;0
7157;-1;67;98;45;2;43;.956;3545000;0
7158;204668;78;40;18;4;14;.778;3600000;0
7158;195251;85;63;7;0;7;1.000;297000;0
7158;189902;78;0;0;0;0;.00nan;0;0
7158;-1;85;43;31;6;25;.806;3303000;0
7159;170598;80;87;31;1;30;.968;3600000;0
7159;184788;151;58;24;3;21;.875;3556000;0
7159;176915;151;0;0;0;0;.00nan;0;0
7159;-1;80;0;0;0;0;.00nan;0;0
7160;187699;158;83;36;2;34;.944;3538000;0
7160;196414;152;88;32;1;31;.969;3600000;0
7160;86862;158;0;0;0;0;.00nan;0;0
7160;86875;152;0;0;0;0;.00nan;0;0
7161;204668;78;0;0;0;0;.00nan;0;0
7161;189902;78;19;31;7;24;.774;3600000;0
7161;191574;4920;0;0;0;0;.00nan;0;0
7161;-1;4920;40;22;4;18;.818;3600000;0
7162;163989;149;0;0;0;0;.00nan;0;0
7162;200572;157;66;24;3;21;.875;3600000;0
7162;191518;157;0;0;0;0;.00nan;0;0
7162;85546;149;67;35;4;31;.886;3550000;0
7163;189081;1097;78;26;1;25;.962;3600000;0
7163;200390;1096;0;0;0;0;.00nan;0;0
7163;-1;1096;56;31;4;27;.871;3600000;0
7163;192629;1097;0;0;0;0;.00nan;0;0
7164;184069;73;70;31;3;28;.903;3586000;0
7164;173961;73;0;0;0;0;.00nan;0;0
7164;78581;71;77;22;1;21;.955;3600000;0
7164;91403;71;0;0;0;0;.00nan;0;0
7165;203179;4620;0;0;0;0;.00nan;0;0
7165;195251;85;87;56;5;51;.911;3600000;0
7165;-1;85;0;0;0;0;.00nan;0;0
7165;-1;4620;75;19;1;18;.947;3600000;0
7166;189885;4921;33;13;4;9;.692;1074000;0
7166;176770;81;84;29;2;27;.931;3600000;0
7166;176860;81;0;0;0;0;.00nan;0;0
7166;197912;4921;75;28;2;26;.929;2526000;0
7167;161535;4245;0;0;0;0;.00nan;0;0
7167;200233;4245;85;15;0;15;1.000;3600000;0
7167;179344;67;50;29;4;25;.862;3600000;0
7167;-1;67;0;0;0;0;.00nan;0;0
7168;194219;76;0;0;0;0;.00nan;0;0
7168;184175;76;70;36;3;33;.917;3675000;0
7168;78820;75;0;0;0;0;.00nan;0;0
7168;86394;75;85;41;4;37;.902;3675000;0
7169;178394;1095;26;17;4;13;.765;3600000;0
7169;186451;1095;0;0;0;0;.00nan;0;0
7169;192547;2564;0;0;0;0;.00nan;0;0
7169;79141;2564;77;24;1;23;.958;3600000;0
7170;170598;80;0;0;0;0;.00nan;0;0
7170;184788;151;0;0;0;0;.00nan;0;0
7170;176915;151;77;35;2;33;.943;3900000;0
7170;-1;80;60;28;2;26;.929;3889000;0
7171;183737;72;64;27;3;24;.889;3608000;0
7171;176136;74;64;32;4;28;.875;3608000;0
7171;-1;74;0;0;0;0;.00nan;0;0
7171;91212;72;0;0;0;0;.00nan;0;0
7172;187699;158;63;26;2;24;.923;3560000;0
7172;196414;152;0;0;0;0;.00nan;0;0
7172;86862;158;0;0;0;0;.00nan;0;0
7172;86875;152;72;21;1;20;.952;3600000;0
7173;204668;78;86;48;3;45;.938;3600000;0
7173;189902;78;0;0;0;0;.00nan;0;0
7173;191574;4920;48;20;4;16;.800;3568000;0
7173;-1;4920;0;0;0;0;.00nan;0;0
7174;163989;149;95;44;2;42;.955;3900000;0
7174;200572;157;0;0;0;0;.00nan;0;0
7174;191518;157;85;33;2;31;.939;3900000;0
7174;85546;149;0;0;0;0;.00nan;0;0
7175;182467;4922;0;0;0;0;.00nan;0;0
7175;178394;1095;0;0;0;0;.00nan;0;0
7175;205121;4922;89;38;2;36;.947;3541000;0
7175;186451;1095;70;20;1;19;.950;3600000;0
7176;192547;2564;67;39;5;34;.872;3658000;0
7176;78581;71;0;0;0;0;.00nan;0;0
7176;79141;2564;0;0;0;0;.00nan;0;0
7176;91403;71;46;24;4;20;.833;3658000;0
7177;203276;82;64;31;3;28;.903;3525000;0
7177;199437;77;72;23;1;22;.957;3600000;0
7177;190034;77;0;0;0;0;.00nan;0;0
7177;185800;82;0;0;0;0;.00nan;0;0
7178;184069;73;76;32;3;29;.906;3561000;0
7178;173961;73;0;0;0;0;.00nan;0;0
7178;-1;69;0;0;0;0;.00nan;0;0
7178;78479;69;80;34;2;32;.941;3600000;0
7179;187699;158;77;30;3;27;.900;3584000;0
7179;196414;152;66;26;2;24;.923;3600000;0
7179;86862;158;0;0;0;0;.00nan;0;0
7179;86875;152;0;0;0;0;.00nan;0;0
7180;189885;4921;53;36;5;31;.861;3573000;0
7180;176770;81;0;0;0;0;.00nan;0;0
7180;176860;81;73;36;3;33;.917;3600000;0
7180;197912;4921;0;0;0;0;.00nan;0;0
7181;161535;4245;0;0;0;0;.00nan;0;0
7181;200233;4245;64;18;2;16;.889;3600000;0
7181;179344;67;0;0;0;0;.00nan;0;0
7181;-1;67;97;48;3;45;.938;3600000;0
7182;189081;1097;40;20;4;16;.800;3600000;0
7182;200390;1096;100;41;0;41;1.000;3600000;0
7182;-1;1096;0;0;0;0;.00nan;0;0
7182;192629;1097;0;0;0;0;.00nan;0;0
7183;170598;80;91;31;1;30;.968;3600000;0
7183;184788;151;0;0;0;0;.00nan;0;0
7183;176915;151;67;22;2;20;.909;3567000;0
7183;-1;80;0;0;0;0;.00nan;0;0
7184;183737;72;0;0;0;0;.00nan;0;0
7184;176136;74;4;25;8;17;.680;2833000;0
7184;-1;74;35;8;2;6;.750;767000;0
7184;91212;72;62;24;2;22;.917;3600000;0
7185;163989;149;80;30;3;27;.900;3900000;0
7185;170598;80;61;26;3;23;.885;3900000;0
7185;-1;80;0;0;0;0;.00nan;0;0
7185;85546;149;0;0;0;0;.00nan;0;0
7186;203276;82;29;27;6;21;.778;3600000;0
7186;200390;1096;79;29;1;28;.966;3600000;0
7186;-1;1096;0;0;0;0;.00nan;0;0
7186;185800;82;0;0;0;0;.00nan;0;0
7187;161535;4245;0;0;0;0;.00nan;0;0
7187;200233;4245;72;24;1;23;.958;3600000;0
7187;200572;157;47;49;7;42;.857;3600000;0
7187;191518;157;0;0;0;0;.00nan;0;0
7188;182467;4922;0;0;0;0;.00nan;0;0
7188;194219;76;73;26;2;24;.923;3900000;0
7188;205121;4922;80;33;2;31;.939;3900000;0
7188;184175;76;0;0;0;0;.00nan;0;0
7189;-1;69;0;0;0;0;.00nan;0;0
7189;78479;69;41;26;4;22;.846;3544000;0
7189;78581;71;79;45;3;42;.933;3600000;0
7189;91403;71;0;0;0;0;.00nan;0;0
7190;195251;85;77;46;4;42;.913;3550000;0
7190;-1;85;0;0;0;0;.00nan;0;0
7190;191574;4920;80;27;2;25;.926;3600000;0
7190;-1;4920;0;0;0;0;.00nan;0;0
7191;203179;4620;0;0;0;0;.00nan;0;0
7191;191574;4920;63;28;3;25;.893;3545000;0
7191;-1;4920;0;0;0;0;.00nan;0;0
7191;-1;4620;91;33;2;31;.939;3600000;0
7192;203276;82;63;34;4;30;.882;3545000;0
7192;200390;1096;69;35;3;32;.914;3600000;0
7192;-1;1096;0;0;0;0;.00nan;0;0
7192;185800;82;0;0;0;0;.00nan;0;0
7193;199437;77;57;30;3;27;.900;3600000;0
7193;190034;77;0;0;0;0;.00nan;0;0
7193;78820;75;0;0;0;0;.00nan;0;0
7193;86394;75;88;18;0;18;1.000;3600000;0
7194;161535;4245;0;0;0;0;.00nan;0;0
7194;200233;4245;69;21;1;20;.952;3600000;0
7194;200572;157;0;0;0;0;.00nan;0;0
7194;191518;157;59;26;2;24;.923;3543000;0
7195;182467;4922;47;21;3;18;.857;3600000;0
7195;189081;1097;97;22;0;22;1.000;3600000;0
7195;205121;4922;0;0;0;0;.00nan;0;0
7195;192629;1097;0;0;0;0;.00nan;0;0
7196;178394;1095;0;0;0;0;.00nan;0;0
7196;-1;69;58;31;4;27;.871;3581000;0
7196;186451;1095;69;29;3;26;.897;3600000;0
7196;78479;69;0;0;0;0;.00nan;0;0
7197;204668;78;70;33;4;29;.879;3600000;0
7197;189902;78;0;0;0;0;.00nan;0;0
7197;184788;151;0;0;0;0;.00nan;0;0
7197;176915;151;69;34;3;31;.912;3600000;0
7198;184069;73;40;19;4;15;.789;3600000;0
7198;173961;73;0;0;0;0;.00nan;0;0
7198;176136;74;62;7;0;7;1.000;1609000;0
7198;-1;74;29;25;5;20;.800;1991000;0
7199;194219;76;60;27;3;24;.889;3600000;0
7199;183737;72;0;0;0;0;.00nan;0;0
7199;184175;76;0;0;0;0;.00nan;0;0
7199;91212;72;61;31;4;27;.871;3552000;0
7200;192547;2564;92;42;2;40;.952;3600000;0
7200;78581;71;0;0;0;0;.00nan;0;0
7200;79141;2564;0;0;0;0;.00nan;0;0
7200;91403;71;94;37;1;36;.973;3600000;0
7201;170598;80;67;36;4;32;.889;3600000;0
7201;176770;81;0;0;0;0;.00nan;0;0
7201;176860;81;78;24;1;23;.958;3600000;0
7201;-1;80;0;0;0;0;.00nan;0;0
7202;187699;158;97;24;0;24;1.000;3600000;0
7202;163989;149;44;38;6;32;.842;3324000;0
7202;85546;149;50;1;0;1;1.000;276000;0
7202;86862;158;0;0;0;0;.00nan;0;0
7203;195251;85;0;0;0;0;.00nan;0;0
7203;179344;67;75;34;3;31;.912;3600000;0
7203;-1;85;54;39;5;34;.872;3583000;0
7203;-1;67;0;0;0;0;.00nan;0;0
7204;178394;1095;71;35;4;31;.886;3600000;0
7204;186451;1095;0;0;0;0;.00nan;0;0
7204;192547;2564;0;0;0;0;.00nan;0;0
7204;79141;2564;44;32;6;26;.813;3600000;0
7205;189885;4921;40;15;3;12;.800;1220000;0
7205;197912;4921;54;43;6;37;.860;2380000;0
7205;78581;71;52;25;4;21;.840;3600000;0
7205;91403;71;0;0;0;0;.00nan;0;0
7206;203276;82;60;22;2;20;.909;1931000;0
7206;199437;77;0;0;0;0;.00nan;0;0
7206;190034;77;61;16;1;15;.938;3600000;0
7206;185800;82;46;26;4;22;.846;1669000;0
7207;161535;4245;0;0;0;0;.00nan;0;0
7207;200233;4245;74;25;2;23;.920;3900000;0
7207;200572;157;67;22;2;20;.909;3900000;0
7207;191518;157;0;0;0;0;.00nan;0;0
7208;203179;4620;20;25;6;19;.760;2972000;0
7208;191574;4920;0;0;0;0;.00nan;0;0
7208;-1;4920;73;25;2;23;.920;3600000;0
7208;-1;4620;32;18;4;14;.778;628000;0
7209;204668;78;0;0;0;0;.00nan;0;0
7209;189902;78;65;34;3;31;.912;3522000;0
7209;184788;151;0;0;0;0;.00nan;0;0
7209;176915;151;96;31;1;30;.968;3600000;0
7210;184069;73;79;39;3;36;.923;3600000;0
7210;173961;73;0;0;0;0;.00nan;0;0
7210;176136;74;76;26;2;24;.923;3600000;0
7210;-1;74;0;0;0;0;.00nan;0;0
7211;194219;76;0;0;0;0;.00nan;0;0
7211;183737;72;55;23;3;20;.870;3600000;0
7211;184175;76;49;37;5;32;.865;3600000;0
7211;91212;72;0;0;0;0;.00nan;0;0
7212;182467;4922;0;0;0;0;.00nan;0;0
7212;189081;1097;0;0;0;0;.00nan;0;0
7212;205121;4922;89;41;1;40;.976;3600000;0
7212;192629;1097;92;20;0;20;1.000;3600000;0
7213;200390;1096;0;0;0;0;.00nan;0;0
7213;-1;1096;68;55;7;48;.873;3600000;0
7213;78820;75;0;0;0;0;.00nan;0;0
7213;86394;75;93;16;0;16;1.000;3600000;0
7214;170598;80;0;0;0;0;.00nan;0;0
7214;176770;81;31;24;5;19;.792;3600000;0
7214;176860;81;0;0;0;0;.00nan;0;0
7214;-1;80;69;31;3;28;.903;3600000;0
7215;187699;158;89;17;0;17;1.000;3600000;0
7215;163989;149;37;34;6;28;.824;2882000;0
7215;85546;149;40;3;1;2;.667;718000;0
7215;86862;158;0;0;0;0;.00nan;0;0
7216;195251;85;55;38;6;32;.842;3099000;0
7216;179344;67;0;0;0;0;.00nan;0;0
7216;-1;85;52;3;0;3;1.000;501000;0
7216;-1;67;58;24;3;21;.875;3600000;0
7217;195251;85;0;0;0;0;.00nan;0;0
7217;-1;85;79;47;4;43;.915;3558000;0
7217;191574;4920;60;20;2;18;.900;3600000;0
7217;-1;4920;0;0;0;0;.00nan;0;0
7218;182467;4922;26;29;6;23;.793;3600000;0
7218;205121;4922;0;0;0;0;.00nan;0;0
7218;200390;1096;96;39;2;37;.949;3600000;0
7218;-1;1096;0;0;0;0;.00nan;0;0
7219;189885;4921;44;23;4;19;.826;2463000;0
7219;197912;4921;29;17;4;13;.765;1137000;0
7219;78581;71;0;0;0;0;.00nan;0;0
7219;91403;71;61;17;2;15;.882;3600000;0
7220;203179;4620;0;0;0;0;.00nan;0;0
7220;179344;67;100;40;1;39;.975;3600000;0
7220;-1;67;0;0;0;0;.00nan;0;0
7220;-1;4620;69;32;3;29;.906;3580000;0
7221;204668;78;93;38;2;36;.947;3600000;0
7221;189902;78;0;0;0;0;.00nan;0;0
7221;184788;151;0;0;0;0;.00nan;0;0
7221;176915;151;32;29;5;24;.828;3600000;0
7222;184069;73;0;0;0;0;.00nan;0;0
7222;173961;73;46;20;3;17;.850;3600000;0
7222;176136;74;96;41;2;39;.951;3600000;0
7222;-1;74;0;0;0;0;.00nan;0;0
7223;194219;76;98;52;4;48;.923;3561000;0
7223;183737;72;0;0;0;0;.00nan;0;0
7223;184175;76;0;0;0;0;.00nan;0;0
7223;91212;72;79;34;3;31;.912;3600000;0
7224;199437;77;92;33;1;32;.970;3560000;0
7224;190034;77;0;0;0;0;.00nan;0;0
7224;78820;75;0;0;0;0;.00nan;0;0
7224;86394;75;97;16;0;16;1.000;3600000;0
7225;178394;1095;0;0;0;0;.00nan;0;0
7225;186451;1095;100;23;0;23;1.000;3600000;0
7225;192547;2564;75;34;3;31;.912;3600000;0
7225;79141;2564;0;0;0;0;.00nan;0;0
7226;170598;80;30;28;6;22;.786;3600000;0
7226;176770;81;0;0;0;0;.00nan;0;0
7226;176860;81;86;27;1;26;.963;3600000;0
7226;-1;80;0;0;0;0;.00nan;0;0
7227;187699;158;64;24;2;22;.917;3594000;0
7227;163989;149;100;42;0;42;1.000;3600000;0
7227;85546;149;0;0;0;0;.00nan;0;0
7227;86862;158;0;0;0;0;.00nan;0;0
7228;163989;149;23;35;7;28;.800;3029000;0
7228;184788;151;0;0;0;0;.00nan;0;0
7228;176915;151;47;18;3;15;.833;3600000;0
7228;85546;149;48;0;0;0;.00nan;571000;0
7229;203276;82;98;46;2;44;.957;3600000;0
7229;189081;1097;0;0;0;0;.00nan;0;0
7229;185800;82;0;0;0;0;.00nan;0;0
7229;192629;1097;38;26;4;22;.846;3516000;0
7230;199437;77;62;41;4;37;.902;3600000;0
7230;194219;76;72;31;3;28;.903;3600000;0
7230;184175;76;0;0;0;0;.00nan;0;0
7230;190034;77;0;0;0;0;.00nan;0;0
7231;200572;157;77;27;1;26;.963;3600000;0
7231;196414;152;72;26;3;23;.885;3539000;0
7231;191518;157;0;0;0;0;.00nan;0;0
7231;86875;152;0;0;0;0;.00nan;0;0
7232;184069;73;80;25;1;24;.960;3600000;0
7232;173961;73;0;0;0;0;.00nan;0;0
7232;192547;2564;32;41;7;34;.829;3600000;0
7232;79141;2564;0;0;0;0;.00nan;0;0
7233;203179;4620;0;0;0;0;.00nan;0;0
7233;195251;85;0;0;0;0;.00nan;0;0
7233;-1;85;88;54;4;50;.926;3600000;0
7233;-1;4620;73;24;1;23;.958;3600000;0
7234;176770;81;0;0;0;0;.00nan;0;0
7234;176860;81;67;26;3;23;.885;3558000;0
7234;78581;71;80;24;1;23;.958;3600000;0
7234;91403;71;0;0;0;0;.00nan;0;0
7235;204668;78;93;50;4;46;.920;3600000;0
7235;189902;78;0;0;0;0;.00nan;0;0
7235;191574;4920;100;21;0;21;1.000;3600000;0
7235;-1;4920;0;0;0;0;.00nan;0;0
7236;163989;149;35;14;3;11;.786;1028000;0
7236;184788;151;0;0;0;0;.00nan;0;0
7236;176915;151;68;22;2;20;.909;3600000;0
7236;85546;149;43;32;6;26;.813;2572000;0
7237;203276;82;0;0;0;0;.00nan;0;0
7237;189081;1097;71;25;2;23;.920;3600000;0
7237;185800;82;65;28;3;25;.893;3600000;0
7237;192629;1097;0;0;0;0;.00nan;0;0
7238;199437;77;74;35;3;32;.914;3600000;0
7238;194219;76;0;0;0;0;.00nan;0;0
7238;184175;76;76;20;1;19;.950;3600000;0
7238;190034;77;0;0;0;0;.00nan;0;0
7239;200572;157;0;0;0;0;.00nan;0;0
7239;196414;152;82;32;2;30;.938;3588000;0
7239;191518;157;100;28;0;28;1.000;3600000;0
7239;86875;152;0;0;0;0;.00nan;0;0
7240;182467;4922;41;16;3;13;.813;1224000;0
7240;205121;4922;61;48;6;42;.875;2376000;0
7240;78820;75;0;0;0;0;.00nan;0;0
7240;86394;75;56;14;2;12;.857;3600000;0
7241;-1;69;66;22;2;20;.909;3600000;0
7241;192547;2564;84;42;3;39;.929;3571000;0
7241;78479;69;0;0;0;0;.00nan;0;0
7241;79141;2564;0;0;0;0;.00nan;0;0
7242;176770;81;0;0;0;0;.00nan;0;0
7242;176860;81;55;42;7;35;.833;3600000;0
7242;78581;71;0;0;0;0;.00nan;0;0
7242;91403;71;51;27;4;23;.852;3600000;0
7243;203179;4620;0;0;0;0;.00nan;0;0
7243;161535;4245;58;25;3;22;.880;3600000;0
7243;200233;4245;0;0;0;0;.00nan;0;0
7243;-1;4620;69;42;4;38;.905;3594000;0
7244;200390;1096;92;30;1;29;.967;3600000;0
7244;195251;85;0;0;0;0;.00nan;0;0
7244;-1;85;63;41;5;36;.878;3600000;0
7244;-1;1096;0;0;0;0;.00nan;0;0
7245;170598;80;75;23;1;22;.957;3600000;0
7245;189885;4921;43;4;1;3;.750;895000;0
7245;-1;80;0;0;0;0;.00nan;0;0
7245;197912;4921;24;29;6;23;.793;2705000;0
7246;183737;72;0;0;0;0;.00nan;0;0
7246;184069;73;55;23;3;20;.870;3558000;0
7246;173961;73;0;0;0;0;.00nan;0;0
7246;91212;72;75;28;2;26;.929;3600000;0
7247;187699;158;100;25;0;25;1.000;3600000;0
7247;178394;1095;0;0;0;0;.00nan;0;0
7247;186451;1095;54;20;2;18;.900;3520000;0
7247;86862;158;0;0;0;0;.00nan;0;0
7248;179344;67;86;28;1;27;.964;3600000;0
7248;176136;74;64;22;2;20;.909;3584000;0
7248;-1;67;0;0;0;0;.00nan;0;0
7248;-1;74;0;0;0;0;.00nan;0;0
7249;163989;149;87;54;4;50;.926;3600000;0
7249;184788;151;0;0;0;0;.00nan;0;0
7249;176915;151;91;19;0;19;1.000;3600000;0
7249;85546;149;0;0;0;0;.00nan;0;0
7250;203276;82;76;30;2;28;.933;3555000;0
7250;189081;1097;0;0;0;0;.00nan;0;0
7250;200572;1097;59;13;1;12;.923;3600000;0
7250;185800;82;0;0;0;0;.00nan;0;0
7251;179830;157;0;0;0;0;.00nan;0;0
7251;196414;152;0;0;0;0;.00nan;0;0
7251;191518;157;66;21;2;19;.905;3600000;0
7251;86875;152;75;48;5;43;.896;3600000;0
7252;182467;4922;0;0;0;0;.00nan;0;0
7252;199437;77;0;0;0;0;.00nan;0;0
7252;205121;4922;53;24;4;20;.833;3600000;0
7252;190034;77;61;45;5;40;.889;3577000;0
7253;204668;78;91;42;3;39;.929;3600000;0
7253;189902;78;0;0;0;0;.00nan;0;0
7253;191574;4920;74;28;2;26;.929;3600000;0
7253;-1;4920;0;0;0;0;.00nan;0;0
7254;176770;81;77;51;5;46;.902;3632000;0
7254;176860;81;0;0;0;0;.00nan;0;0
7254;78581;71;44;31;6;25;.806;3632000;0
7254;91403;71;0;0;0;0;.00nan;0;0
7255;203179;4620;62;21;3;18;.857;3900000;0
7255;161535;4245;0;0;0;0;.00nan;0;0
7255;200233;4245;75;33;3;30;.909;3900000;0
7255;-1;4620;0;0;0;0;.00nan;0;0
7256;194219;76;10;29;8;21;.724;2301000;0
7256;184175;76;67;15;1;14;.933;1299000;0
7256;78820;75;86;28;1;27;.964;3600000;0
7256;86394;75;0;0;0;0;.00nan;0;0
7257;-1;69;0;0;0;0;.00nan;0;0
7257;192547;2564;0;0;0;0;.00nan;0;0
7257;78479;69;66;23;2;21;.913;3600000;0
7257;79141;2564;82;49;4;45;.918;3549000;0
7258;200390;1096;0;0;0;0;.00nan;0;0
7258;195251;85;65;30;4;26;.867;3600000;0
7258;-1;85;0;0;0;0;.00nan;0;0
7258;-1;1096;85;26;1;25;.962;3600000;0
7259;170598;80;0;0;0;0;.00nan;0;0
7259;189885;4921;71;38;3;35;.921;3622000;0
7259;-1;80;60;31;4;27;.871;3642000;0
7259;197912;4921;0;0;0;0;.00nan;0;0
7260;183737;72;88;24;1;23;.958;3600000;0
7260;184069;73;0;0;0;0;.00nan;0;0
7260;173961;73;34;27;6;21;.778;3600000;0
7260;91212;72;0;0;0;0;.00nan;0;0
7261;187699;158;69;24;2;22;.917;3600000;0
7261;178394;1095;54;29;3;26;.897;3600000;0
7261;186451;1095;0;0;0;0;.00nan;0;0
7261;86862;158;0;0;0;0;.00nan;0;0
7262;179344;67;0;0;0;0;.00nan;0;0
7262;176136;74;55;21;3;18;.857;3600000;0
7262;-1;67;100;42;0;42;1.000;3600000;0
7262;-1;74;0;0;0;0;.00nan;0;0
7263;204668;78;0;0;0;0;.00nan;0;0
7263;189902;78;78;44;4;40;.909;3600000;0
7263;191574;4920;0;0;0;0;.00nan;0;0
7263;-1;4920;29;30;6;24;.800;3545000;0
7264;182467;4922;50;52;8;44;.846;3600000;0
7264;205121;4922;0;0;0;0;.00nan;0;0
7264;78820;75;0;0;0;0;.00nan;0;0
7264;86394;75;63;13;1;12;.923;3600000;0
7265;184069;73;87;20;0;20;1.000;3600000;0
7265;173961;73;0;0;0;0;.00nan;0;0
7265;192547;2564;57;36;4;32;.889;3600000;0
7265;79141;2564;0;0;0;0;.00nan;0;0
7266;183737;72;0;0;0;0;.00nan;0;0
7266;-1;69;96;37;1;36;.973;3600000;0
7266;78479;69;0;0;0;0;.00nan;0;0
7266;91212;72;94;21;0;21;1.000;3600000;0
7267;187699;158;99;40;1;39;.975;3600000;0
7267;184788;151;0;0;0;0;.00nan;0;0
7267;176915;151;53;22;3;19;.864;3530000;0
7267;86862;158;0;0;0;0;.00nan;0;0
7268;179344;67;0;0;0;0;.00nan;0;0
7268;176136;74;51;36;5;31;.861;3598000;0
7268;-1;67;53;29;4;25;.862;3600000;0
7268;-1;74;0;0;0;0;.00nan;0;0
7269;163989;149;94;32;1;31;.969;3600000;0
7269;170598;80;84;30;2;28;.933;3600000;0
7269;-1;80;0;0;0;0;.00nan;0;0
7269;85546;149;0;0;0;0;.00nan;0;0
7270;178394;1095;0;0;0;0;.00nan;0;0
7270;189885;4921;0;0;0;0;.00nan;0;0
7270;186451;1095;50;19;3;16;.842;3600000;0
7270;197912;4921;88;39;2;37;.949;3600000;0
7271;203179;4620;0;0;0;0;.00nan;0;0
7271;161535;4245;58;6;0;6;1.000;740000;0
7271;200233;4245;32;27;6;21;.778;2860000;0
7271;-1;4620;97;37;2;35;.946;3600000;0
7272;182467;4922;0;0;0;0;.00nan;0;0
7272;205121;4922;85;28;1;27;.964;3900000;0
7272;200390;1096;81;27;1;26;.963;3900000;0
7272;-1;1096;0;0;0;0;.00nan;0;0
7273;178394;1095;89;31;1;30;.968;3600000;0
7273;186451;1095;0;0;0;0;.00nan;0;0
7273;192547;2564;72;26;2;24;.923;3544000;0
7273;79141;2564;0;0;0;0;.00nan;0;0
7274;179344;67;49;37;6;31;.838;1968000;0
7274;-1;67;53;16;2;14;.875;1632000;0
7274;78581;71;0;0;0;0;.00nan;0;0
7274;91403;71;43;22;5;17;.773;3600000;0
7275;184069;73;59;27;3;24;.889;3568000;0
7275;173961;73;0;0;0;0;.00nan;0;0
7275;-1;69;93;32;1;31;.969;3600000;0
7275;78479;69;0;0;0;0;.00nan;0;0
7276;183737;72;0;0;0;0;.00nan;0;0
7276;189885;4921;0;0;0;0;.00nan;0;0
7276;197912;4921;79;32;3;29;.906;3845000;0
7276;91212;72;84;27;2;25;.926;3845000;0
7277;184788;151;0;0;0;0;.00nan;0;0
7277;176915;151;66;25;2;23;.920;3900000;0
7277;196414;152;95;38;2;36;.947;3900000;0
7277;86875;152;0;0;0;0;.00nan;0;0
7278;203179;4620;0;0;0;0;.00nan;0;0
7278;161535;4245;0;0;0;0;.00nan;0;0
7278;200233;4245;78;23;1;22;.957;3600000;0
7278;-1;4620;76;37;3;34;.919;3514000;0
7279;204668;78;90;42;3;39;.929;3600000;0
7279;189902;78;0;0;0;0;.00nan;0;0
7279;176136;74;100;30;0;30;1.000;3600000;0
7279;-1;74;0;0;0;0;.00nan;0;0
7280;203276;82;97;58;3;55;.948;3600000;0
7280;194219;76;61;18;2;16;.889;3600000;0
7280;184175;76;0;0;0;0;.00nan;0;0
7280;185800;82;0;0;0;0;.00nan;0;0
7281;176770;81;0;0;0;0;.00nan;0;0
7281;176860;81;76;39;4;35;.897;3900000;0
7281;179830;157;0;0;0;0;.00nan;0;0
7281;191518;157;66;34;4;30;.882;3900000;0
7282;199437;77;7;31;8;23;.742;3121000;0
7282;190034;77;43;5;1;4;.800;479000;0
7282;78820;75;0;0;0;0;.00nan;0;0
7282;86394;75;79;37;2;35;.946;3600000;0
7283;195251;85;77;20;0;20;1.000;1286000;0
7283;-1;85;41;37;6;31;.838;2314000;0
7283;191574;4920;40;9;2;7;.778;3600000;0
7283;-1;4920;0;0;0;0;.00nan;0;0
7284;187699;158;63;37;4;33;.892;3600000;0
7284;170598;80;68;21;1;20;.952;3600000;0
7284;-1;80;0;0;0;0;.00nan;0;0
7284;86862;158;0;0;0;0;.00nan;0;0
7285;200390;1096;0;0;0;0;.00nan;0;0
7285;-1;1096;45;42;6;36;.857;3515000;0
7285;78820;75;37;22;4;18;.818;3600000;0
7285;86394;75;0;0;0;0;.00nan;0;0
7286;179344;67;60;5;0;5;1.000;875000;0
7286;-1;67;37;32;6;26;.813;2725000;0
7286;78581;71;57;19;2;17;.895;3600000;0
7286;91403;71;0;0;0;0;.00nan;0;0
7287;182467;4922;36;30;6;24;.800;3600000;0
7287;199437;77;0;0;0;0;.00nan;0;0
7287;205121;4922;0;0;0;0;.00nan;0;0
7287;190034;77;55;38;5;33;.868;3600000;0
7288;184069;73;0;0;0;0;.00nan;0;0
7288;173961;73;55;17;2;15;.882;3600000;0
7288;192547;2564;0;0;0;0;.00nan;0;0
7288;79141;2564;89;44;3;41;.932;3544000;0
7289;183737;72;56;15;2;13;.867;3600000;0
7289;189885;4921;74;55;6;49;.891;3600000;0
7289;197912;4921;0;0;0;0;.00nan;0;0
7289;91212;72;0;0;0;0;.00nan;0;0
7290;178394;1095;0;0;0;0;.00nan;0;0
7290;-1;69;0;0;0;0;.00nan;0;0
7290;186451;1095;56;38;4;34;.895;3585000;0
7290;78479;69;69;21;2;19;.905;3600000;0
7291;184788;151;0;0;0;0;.00nan;0;0
7291;176915;151;65;34;3;31;.912;3596000;0
7291;196414;152;83;24;1;23;.958;3600000;0
7291;86875;152;0;0;0;0;.00nan;0;0
7292;203179;4620;55;33;5;28;.848;3600000;0
7292;161535;4245;78;20;1;19;.950;3600000;0
7292;200233;4245;0;0;0;0;.00nan;0;0
7292;-1;4620;0;0;0;0;.00nan;0;0
7293;204668;78;74;31;3;28;.903;3600000;0
7293;189902;78;0;0;0;0;.00nan;0;0
7293;176136;74;64;22;2;20;.909;3600000;0
7293;-1;74;0;0;0;0;.00nan;0;0
7294;176770;81;86;57;4;53;.930;3600000;0
7294;176860;81;0;0;0;0;.00nan;0;0
7294;179830;157;93;19;0;19;1.000;3600000;0
7294;191518;157;0;0;0;0;.00nan;0;0
7295;203276;82;0;0;0;0;.00nan;0;0
7295;189081;1097;0;0;0;0;.00nan;0;0
7295;200572;1097;59;27;3;24;.889;3600000;0
7295;185800;82;62;42;5;37;.881;3600000;0
7296;195251;85;0;0;0;0;.00nan;0;0
7296;-1;85;80;51;4;47;.922;3600000;0
7296;191574;4920;0;0;0;0;.00nan;0;0
7296;-1;4920;81;13;0;13;1.000;3600000;0
7297;179344;67;89;27;1;26;.963;3600000;0
7297;-1;67;0;0;0;0;.00nan;0;0
7297;78581;71;86;45;4;41;.911;3600000;0
7297;91403;71;0;0;0;0;.00nan;0;0
7298;182467;4922;0;0;0;0;.00nan;0;0
7298;199437;77;100;29;0;29;1.000;3600000;0
7298;205121;4922;93;38;2;36;.947;3519000;0
7298;190034;77;0;0;0;0;.00nan;0;0
7299;203179;4620;0;0;0;0;.00nan;0;0
7299;161535;4245;0;0;0;0;.00nan;0;0
7299;200233;4245;42;26;4;22;.846;3600000;0
7299;-1;4620;64;19;2;17;.895;3600000;0
7300;204668;78;0;0;0;0;.00nan;0;0
7300;189902;78;66;43;5;38;.884;3600000;0
7300;176136;74;38;14;3;11;.786;3600000;0
7300;-1;74;0;0;0;0;.00nan;0;0
7301;203276;82;51;45;6;39;.867;3600000;0
7301;189081;1097;0;0;0;0;.00nan;0;0
7301;200572;1097;57;16;2;14;.875;3600000;0
7301;185800;82;0;0;0;0;.00nan;0;0
7302;194219;76;76;40;4;36;.900;3900000;0
7302;184175;76;0;0;0;0;.00nan;0;0
7302;78820;75;0;0;0;0;.00nan;0;0
7302;86394;75;62;32;4;28;.875;3900000;0
7303;178394;1095;0;0;0;0;.00nan;0;0
7303;189885;4921;0;0;0;0;.00nan;0;0
7303;186451;1095;100;35;0;35;1.000;3600000;0
7303;197912;4921;87;32;2;30;.938;3551000;0
7304;203276;82;72;48;5;43;.896;3565000;0
7304;200390;1096;77;38;3;35;.921;3600000;0
7304;-1;1096;0;0;0;0;.00nan;0;0
7304;185800;82;0;0;0;0;.00nan;0;0
7305;163989;149;88;31;2;29;.935;3591000;0
7305;57215;152;83;26;1;25;.962;3600000;0
7305;85546;149;0;0;0;0;.00nan;0;0
7305;86875;152;0;0;0;0;.00nan;0;0
7306;204668;78;51;24;3;21;.875;3600000;0
7306;189902;78;0;0;0;0;.00nan;0;0
7306;176136;74;47;27;4;23;.852;3546000;0
7306;-1;74;0;0;0;0;.00nan;0;0
7307;161535;4245;0;0;0;0;.00nan;0;0
7307;183737;72;0;0;0;0;.00nan;0;0
7307;200233;4245;68;27;1;26;.963;3900000;0
7307;91212;72;81;28;1;27;.964;3900000;0
7308;184788;151;0;0;0;0;.00nan;0;0
7308;176770;81;56;36;4;32;.889;3600000;0
7308;176860;81;0;0;0;0;.00nan;0;0
7308;176915;151;62;18;1;17;.944;3600000;0
7309;194219;76;52;20;2;18;.900;3600000;0
7309;189081;1097;0;0;0;0;.00nan;0;0
7309;200572;1097;69;35;3;32;.914;3561000;0
7309;184175;76;0;0;0;0;.00nan;0;0
7310;204668;78;43;34;6;28;.824;3600000;0
7310;189902;78;0;0;0;0;.00nan;0;0
7310;191574;4920;0;0;0;0;.00nan;0;0
7310;-1;4920;70;27;2;25;.926;3600000;0
7311;178394;1095;0;0;0;0;.00nan;0;0
7311;186451;1095;62;23;2;21;.913;3600000;0
7311;192547;2564;83;41;3;38;.927;3576000;0
7311;79141;2564;0;0;0;0;.00nan;0;0
7312;203276;82;66;45;5;40;.889;3600000;0
7312;199437;77;83;19;0;19;1.000;3600000;0
7312;190034;77;0;0;0;0;.00nan;0;0
7312;185800;82;0;0;0;0;.00nan;0;0
7313;184069;73;41;14;3;11;.786;3600000;0
7313;173961;73;0;0;0;0;.00nan;0;0
7313;189885;4921;0;0;0;0;.00nan;0;0
7313;197912;4921;64;45;6;39;.867;3600000;0
7314;-1;69;43;16;4;12;.750;1907000;0
7314;78479;69;36;12;3;9;.750;1693000;0
7314;78581;71;45;6;1;5;.833;611000;0
7314;91403;71;21;32;7;25;.781;2989000;0
7315;163989;149;64;36;4;32;.889;3900000;0
7315;57215;152;0;0;0;0;.00nan;0;0
7315;85546;149;0;0;0;0;.00nan;0;0
7315;86875;152;47;27;4;23;.852;3900000;0
7316;194219;76;0;0;0;0;.00nan;0;0
7316;200390;1096;83;41;4;37;.902;3600000;0
7316;184175;76;100;22;0;22;1.000;3600000;0
7316;-1;1096;0;0;0;0;.00nan;0;0
7317;161535;4245;0;0;0;0;.00nan;0;0
7317;183737;72;0;0;0;0;.00nan;0;0
7317;200233;4245;70;28;2;26;.929;3577000;0
7317;91212;72;97;33;1;32;.970;3600000;0
7318;182467;4922;0;0;0;0;.00nan;0;0
7318;189081;1097;0;0;0;0;.00nan;0;0
7318;205121;4922;48;32;5;27;.844;3600000;0
7318;200572;1097;65;34;4;30;.882;3600000;0
7319;187699;158;73;32;3;29;.906;3810000;0
7319;78820;75;0;0;0;0;.00nan;0;0
7319;86394;75;41;23;4;19;.826;3810000;0
7319;86862;158;0;0;0;0;.00nan;0;0
7320;203179;4620;0;0;0;0;.00nan;0;0
7320;195251;85;0;0;0;0;.00nan;0;0
7320;-1;85;100;40;0;40;1.000;3600000;0
7320;-1;4620;59;13;1;12;.923;3571000;0
7321;170598;80;69;38;4;34;.895;3519000;0
7321;179830;157;86;31;2;29;.935;3600000;0
7321;-1;80;0;0;0;0;.00nan;0;0
7321;191518;157;0;0;0;0;.00nan;0;0
7322;184788;151;0;0;0;0;.00nan;0;0
7322;176770;81;29;8;3;5;.625;274000;0
7322;176860;81;41;15;3;12;.800;3326000;0
7322;176915;151;86;33;1;32;.970;3600000;0
7323;179344;67;0;0;0;0;.00nan;0;0
7323;176136;74;50;27;4;23;.852;3600000;0
7323;-1;67;78;26;1;25;.962;3600000;0
7323;-1;74;0;0;0;0;.00nan;0;0
7324;195251;85;93;51;4;47;.922;3600000;0
7324;-1;85;0;0;0;0;.00nan;0;0
7324;191574;4920;74;16;1;15;.938;3600000;0
7324;-1;4920;0;0;0;0;.00nan;0;0
7325;178394;1095;32;37;7;30;.811;3600000;0
7325;186451;1095;0;0;0;0;.00nan;0;0
7325;78581;71;81;21;1;20;.952;3600000;0
7325;91403;71;0;0;0;0;.00nan;0;0
7326;203276;82;0;0;0;0;.00nan;0;0
7326;199437;77;30;14;4;10;.714;3579000;0
7326;190034;77;0;0;0;0;.00nan;0;0
7326;185800;82;86;34;2;32;.941;3600000;0
7327;184069;73;0;0;0;0;.00nan;0;0
7327;173961;73;55;28;4;24;.857;3600000;0
7327;189885;4921;50;47;6;41;.872;3600000;0
7327;197912;4921;0;0;0;0;.00nan;0;0
7328;163989;149;80;26;1;25;.962;3600000;0
7328;57215;152;70;30;3;27;.900;3519000;0
7328;85546;149;0;0;0;0;.00nan;0;0
7328;86875;152;0;0;0;0;.00nan;0;0
7329;203179;4620;93;21;0;21;1.000;3600000;0
7329;204668;78;70;8;0;8;1.000;706000;0
7329;189902;78;44;36;6;30;.833;2894000;0
7329;-1;4620;0;0;0;0;.00nan;0;0
7330;194219;76;0;0;0;0;.00nan;0;0
7330;200390;1096;0;0;0;0;.00nan;0;0
7330;184175;76;86;30;2;28;.933;3600000;0
7330;-1;1096;71;37;3;34;.919;3558000;0
7331;161535;4245;65;30;3;27;.900;3600000;0
7331;183737;72;75;23;1;22;.957;3600000;0
7331;200233;4245;0;0;0;0;.00nan;0;0
7331;91212;72;0;0;0;0;.00nan;0;0
7332;182467;4922;53;45;6;39;.867;3600000;0
7332;189081;1097;0;0;0;0;.00nan;0;0
7332;205121;4922;0;0;0;0;.00nan;0;0
7332;200572;1097;71;21;1;20;.952;3600000;0
7333;187699;158;67;45;5;40;.889;3600000;0
7333;78820;75;97;22;0;22;1.000;3600000;0
7333;86394;75;0;0;0;0;.00nan;0;0
7333;86862;158;0;0;0;0;.00nan;0;0
7334;-1;69;79;37;3;34;.919;3840000;0
7334;192547;2564;0;0;0;0;.00nan;0;0
7334;78479;69;0;0;0;0;.00nan;0;0
7334;79141;2564;87;32;2;30;.938;3840000;0
7335;170598;80;0;0;0;0;.00nan;0;0
7335;179830;157;0;0;0;0;.00nan;0;0
7335;-1;80;100;34;0;34;1.000;3600000;0
7335;191518;157;66;17;1;16;.941;3600000;0
7336;184788;151;0;0;0;0;.00nan;0;0
7336;176770;81;91;32;2;30;.938;3723000;0
7336;176860;81;0;0;0;0;.00nan;0;0
7336;176915;151;85;31;1;30;.968;3723000;0
7337;179344;67;57;31;4;27;.871;3661000;0
7337;176136;74;58;28;3;25;.893;3661000;0
7337;-1;67;0;0;0;0;.00nan;0;0
7337;-1;74;0;0;0;0;.00nan;0;0
7338;176136;74;55;51;7;44;.863;2999000;0
7338;-1;74;50;10;1;9;.900;601000;0
7338;191574;4920;0;0;0;0;.00nan;0;0
7338;-1;4920;71;8;0;8;1.000;3600000;0
7339;184069;73;81;35;2;33;.943;3600000;0
7339;173961;73;0;0;0;0;.00nan;0;0
7339;-1;69;0;0;0;0;.00nan;0;0
7339;78479;69;70;32;3;29;.906;3555000;0
7340;203179;4620;54;22;3;19;.864;3900000;0
7340;204668;78;93;50;3;47;.940;3900000;0
7340;189902;78;0;0;0;0;.00nan;0;0
7340;-1;4620;0;0;0;0;.00nan;0;0
7341;187699;158;79;40;3;37;.925;3591000;0
7341;78820;75;79;22;1;21;.955;3600000;0
7341;86394;75;0;0;0;0;.00nan;0;0
7341;86862;158;0;0;0;0;.00nan;0;0
7342;178394;1095;0;0;0;0;.00nan;0;0
7342;186451;1095;46;26;4;22;.846;3896000;0
7342;192547;2564;49;30;4;26;.867;3900000;0
7342;79141;2564;0;0;0;0;.00nan;0;0
7343;170598;80;0;0;0;0;.00nan;0;0
7343;179830;157;46;24;4;20;.833;3581000;0
7343;-1;80;64;25;2;23;.920;3600000;0
7343;191518;157;0;0;0;0;.00nan;0;0
7344;195251;85;0;0;0;0;.00nan;0;0
7344;179344;67;0;0;0;0;.00nan;0;0
7344;-1;85;85;36;3;33;.917;3600000;0
7344;-1;67;35;28;5;23;.821;3543000;0
7345;184788;151;0;0;0;0;.00nan;0;0
7345;176915;151;41;36;6;30;.833;3600000;0
7345;57215;152;0;0;0;0;.00nan;0;0
7345;86875;152;88;40;3;37;.925;3600000;0
7346;183737;72;0;0;0;0;.00nan;0;0
7346;178394;1095;70;30;2;28;.933;3600000;0
7346;186451;1095;0;0;0;0;.00nan;0;0
7346;91212;72;74;44;4;40;.909;3552000;0
7347;163989;149;81;32;2;30;.938;3618000;0
7347;179830;157;96;33;1;32;.970;3618000;0
7347;191518;157;0;0;0;0;.00nan;0;0
7347;85546;149;0;0;0;0;.00nan;0;0
7348;203276;82;39;26;4;22;.846;3560000;0
7348;182467;4922;0;0;0;0;.00nan;0;0
7348;205121;4922;89;31;2;29;.935;3600000;0
7348;185800;82;0;0;0;0;.00nan;0;0
7349;161535;4245;0;0;0;0;.00nan;0;0
7349;200233;4245;70;29;3;26;.897;3766000;0
7349;191574;4920;0;0;0;0;.00nan;0;0
7349;-1;4920;76;33;2;31;.939;3766000;0
7350;178394;1095;55;4;0;4;1.000;466000;0
7350;186451;1095;75;50;6;44;.880;3134000;0
7350;78581;71;0;0;0;0;.00nan;0;0
7350;91403;71;48;12;2;10;.833;3600000;0
7351;199437;77;89;37;2;35;.946;3600000;0
7351;190034;77;0;0;0;0;.00nan;0;0
7351;78820;75;0;0;0;0;.00nan;0;0
7351;86394;75;66;33;3;30;.909;3546000;0
7352;163989;149;61;42;5;37;.881;3600000;0
7352;179830;157;0;0;0;0;.00nan;0;0
7352;191518;157;100;27;0;27;1.000;3600000;0
7352;85546;149;0;0;0;0;.00nan;0;0
7353;182467;4922;0;0;0;0;.00nan;0;0
7353;205121;4922;62;26;3;23;.885;3600000;0
7353;200390;1096;21;26;6;20;.769;3600000;0
7353;-1;1096;0;0;0;0;.00nan;0;0
7354;189885;4921;0;0;0;0;.00nan;0;0
7354;-1;69;53;14;2;12;.857;3600000;0
7354;197912;4921;64;52;6;46;.885;3600000;0
7354;78479;69;0;0;0;0;.00nan;0;0
7355;203179;4620;0;0;0;0;.00nan;0;0
7355;176770;81;0;0;0;0;.00nan;0;0
7355;176860;81;76;34;3;31;.912;3600000;0
7355;-1;4620;56;28;4;24;.857;3590000;0
7356;204668;78;0;0;0;0;.00nan;0;0
7356;184069;73;77;32;3;29;.906;3600000;0
7356;173961;73;0;0;0;0;.00nan;0;0
7356;189902;78;85;47;4;43;.915;3580000;0
7357;203276;82;88;41;2;39;.951;3600000;0
7357;189081;1097;0;0;0;0;.00nan;0;0
7357;200572;1097;53;23;3;20;.870;3577000;0
7357;185800;82;0;0;0;0;.00nan;0;0
7358;176136;74;53;34;5;29;.853;3600000;0
7358;-1;74;0;0;0;0;.00nan;0;0
7358;192547;2564;0;0;0;0;.00nan;0;0
7358;79141;2564;14;34;7;27;.794;3566000;0
7359;195251;85;67;33;4;29;.879;3578000;0
7359;179344;67;74;35;3;32;.914;3600000;0
7359;-1;85;0;0;0;0;.00nan;0;0
7359;-1;67;0;0;0;0;.00nan;0;0
7360;170598;80;100;25;0;25;1.000;3600000;0
7360;184788;151;68;22;1;21;.955;3554000;0
7360;176915;151;0;0;0;0;.00nan;0;0
7360;-1;80;0;0;0;0;.00nan;0;0
7361;194219;76;85;41;3;38;.927;3600000;0
7361;183737;72;0;0;0;0;.00nan;0;0
7361;184175;76;0;0;0;0;.00nan;0;0
7361;91212;72;84;27;1;26;.963;3600000;0
7362;187699;158;100;25;0;25;1.000;3600000;0
7362;57215;152;0;0;0;0;.00nan;0;0
7362;86862;158;0;0;0;0;.00nan;0;0
7362;86875;152;73;21;1;20;.952;3557000;0
7363;200390;1096;31;39;7;32;.821;3093000;0
7363;-1;1096;36;11;3;8;.727;507000;0
7363;78820;75;57;13;1;12;.923;3600000;0
7363;86394;75;0;0;0;0;.00nan;0;0
7364;178394;1095;39;18;4;14;.778;1196000;0
7364;186451;1095;59;16;2;14;.875;2404000;0
7364;78581;71;69;19;1;18;.947;3600000;0
7364;91403;71;0;0;0;0;.00nan;0;0
7365;182467;4922;100;52;0;52;1.000;3600000;0
7365;199437;77;72;21;1;20;.952;3584000;0
7365;205121;4922;0;0;0;0;.00nan;0;0
7365;190034;77;0;0;0;0;.00nan;0;0
7366;163989;149;68;29;3;26;.897;3544000;0
7366;179830;157;0;0;0;0;.00nan;0;0
7366;191518;157;58;21;2;19;.905;3600000;0
7366;85546;149;0;0;0;0;.00nan;0;0
7367;189885;4921;91;41;1;40;.976;3600000;0
7367;-1;69;0;0;0;0;.00nan;0;0
7367;197912;4921;0;0;0;0;.00nan;0;0
7367;78479;69;59;18;2;16;.889;3570000;0
7368;187699;158;80;32;2;30;.938;3600000;0
7368;57215;152;49;31;4;27;.871;3530000;0
7368;86862;158;0;0;0;0;.00nan;0;0
7368;86875;152;0;0;0;0;.00nan;0;0
7369;203179;4620;46;31;5;26;.839;3600000;0
7369;176770;81;61;10;0;10;1.000;1105000;0
7369;176860;81;27;30;6;24;.800;2474000;0
7369;-1;4620;0;0;0;0;.00nan;0;0
7370;204668;78;86;37;2;35;.946;3600000;0
7370;184069;73;0;0;0;0;.00nan;0;0
7370;173961;73;49;19;3;16;.842;3543000;0
7370;189902;78;0;0;0;0;.00nan;0;0
7371;161535;4245;38;39;6;33;.846;2591000;0
7371;200233;4245;62;16;1;15;.938;1009000;0
7371;191574;4920;57;15;2;13;.867;3600000;0
7371;-1;4920;0;0;0;0;.00nan;0;0
7372;203276;82;71;44;4;40;.909;3600000;0
7372;189081;1097;0;0;0;0;.00nan;0;0
7372;200572;1097;86;11;0;11;1.000;3600000;0
7372;185800;82;0;0;0;0;.00nan;0;0
7373;176136;74;40;8;2;6;.750;1316000;0
7373;-1;74;30;30;6;24;.800;2284000;0
7373;192547;2564;68;29;3;26;.897;3600000;0
7373;79141;2564;0;0;0;0;.00nan;0;0
7374;195251;85;52;3;0;3;1.000;354000;0
7374;179344;67;0;0;0;0;.00nan;0;0
7374;-1;85;37;34;6;28;.824;3246000;0
7374;-1;67;69;27;2;25;.926;3600000;0
7375;170598;80;63;34;4;30;.882;3600000;0
7375;184788;151;0;0;0;0;.00nan;0;0
7375;176915;151;100;26;0;26;1.000;3600000;0
7375;-1;80;0;0;0;0;.00nan;0;0
7376;194219;76;74;38;3;35;.921;3586000;0
7376;183737;72;86;32;2;30;.938;3600000;0
7376;184175;76;0;0;0;0;.00nan;0;0
7376;91212;72;0;0;0;0;.00nan;0;0
7377;200390;1096;0;0;0;0;.00nan;0;0
7377;-1;1096;72;41;4;37;.902;3600000;0
7377;78820;75;0;0;0;0;.00nan;0;0
7377;86394;75;56;10;1;9;.900;3600000;0
7378;-1;69;32;27;6;21;.778;3600000;0
7378;78479;69;0;0;0;0;.00nan;0;0
7378;78581;71;0;0;0;0;.00nan;0;0
7378;91403;71;67;20;2;18;.900;3600000;0
7379;199437;77;0;0;0;0;.00nan;0;0
7379;189081;1097;0;0;0;0;.00nan;0;0
7379;200572;1097;37;17;3;14;.824;3600000;0
7379;190034;77;61;21;2;19;.905;3600000;0
7380;203179;4620;0;0;0;0;.00nan;0;0
7380;176770;81;83;38;2;36;.947;3600000;0
7380;176860;81;0;0;0;0;.00nan;0;0
7380;-1;4620;46;28;4;24;.857;3515000;0
7381;204668;78;47;6;1;5;.833;617000;0
7381;184069;73;43;24;4;20;.833;3600000;0
7381;173961;73;0;0;0;0;.00nan;0;0
7381;189902;78;53;43;6;37;.860;2983000;0
7382;161535;4245;0;0;0;0;.00nan;0;0
7382;200233;4245;78;35;3;32;.914;3584000;0
7382;191574;4920;0;0;0;0;.00nan;0;0
7382;-1;4920;74;25;1;24;.960;3600000;0
7383;176136;74;98;37;1;36;.973;3570000;0
7383;-1;74;0;0;0;0;.00nan;0;0
7383;192547;2564;0;0;0;0;.00nan;0;0
7383;79141;2564;98;21;0;21;1.000;3600000;0
7384;170598;80;0;0;0;0;.00nan;0;0
7384;184788;151;0;0;0;0;.00nan;0;0
7384;176915;151;75;34;3;31;.912;3576000;0
7384;-1;80;88;32;2;30;.938;3600000;0
7385;194219;76;77;40;4;36;.900;3600000;0
7385;183737;72;0;0;0;0;.00nan;0;0
7385;184175;76;0;0;0;0;.00nan;0;0
7385;91212;72;51;18;3;15;.833;3600000;0
7386;187699;158;39;28;5;23;.821;3600000;0
7386;57215;152;0;0;0;0;.00nan;0;0
7386;86862;158;0;0;0;0;.00nan;0;0
7386;86875;152;75;22;1;21;.955;3600000;0
7387;161535;4245;0;0;0;0;.00nan;0;0
7387;183737;72;0;0;0;0;.00nan;0;0
7387;200233;4245;88;34;2;32;.941;3600000;0
7387;91212;72;49;32;5;27;.844;3600000;0
7388;163989;149;0;0;0;0;.00nan;0;0
7388;170598;80;84;33;3;30;.909;3586000;0
7388;-1;80;0;0;0;0;.00nan;0;0
7388;85546;149;81;29;1;28;.966;3600000;0
7389;203276;82;75;45;4;41;.911;3600000;0
7389;185800;82;0;0;0;0;.00nan;0;0
7389;191574;4920;79;14;0;14;1.000;3600000;0
7389;-1;4920;0;0;0;0;.00nan;0;0
7390;189885;4921;0;0;0;0;.00nan;0;0
7390;-1;69;44;34;5;29;.853;3600000;0
7390;197912;4921;70;26;2;24;.923;3600000;0
7390;78479;69;0;0;0;0;.00nan;0;0
7391;182467;4922;66;36;4;32;.889;3530000;0
7391;194219;76;55;28;3;25;.893;3600000;0
7391;205121;4922;0;0;0;0;.00nan;0;0
7391;184175;76;0;0;0;0;.00nan;0;0
7392;57215;152;0;0;0;0;.00nan;0;0
7392;78581;71;92;29;1;28;.966;3600000;0
7392;86875;152;43;22;5;17;.773;3600000;0
7392;91403;71;0;0;0;0;.00nan;0;0
7393;200390;1096;89;37;2;35;.946;3600000;0
7393;184069;73;0;0;0;0;.00nan;0;0
7393;173961;73;49;22;3;19;.864;3565000;0
7393;-1;1096;0;0;0;0;.00nan;0;0
7394;199437;77;78;34;3;31;.912;3900000;0
7394;204668;78;90;39;3;36;.923;3900000;0
7394;189902;78;0;0;0;0;.00nan;0;0
7394;190034;77;0;0;0;0;.00nan;0;0
7395;189081;1097;0;0;0;0;.00nan;0;0
7395;200572;1097;85;43;3;40;.930;3568000;0
7395;78820;75;0;0;0;0;.00nan;0;0
7395;86394;75;70;22;1;21;.955;3600000;0
7396;187699;158;85;27;1;26;.963;3600000;0
7396;78581;71;0;0;0;0;.00nan;0;0
7396;86862;158;0;0;0;0;.00nan;0;0
7396;91403;71;53;28;4;24;.857;3600000;0
7397;163989;149;80;29;2;27;.931;3600000;0
7397;170598;80;0;0;0;0;.00nan;0;0
7397;-1;80;63;32;3;29;.906;3574000;0
7397;85546;149;0;0;0;0;.00nan;0;0
7398;203276;82;77;63;6;57;.905;3600000;0
7398;185800;82;0;0;0;0;.00nan;0;0
7398;191574;4920;46;12;2;10;.833;3600000;0
7398;-1;4920;0;0;0;0;.00nan;0;0
7399;200390;1096;0;0;0;0;.00nan;0;0
7399;184069;73;44;27;4;23;.852;3600000;0
7399;173961;73;0;0;0;0;.00nan;0;0
7399;-1;1096;70;36;3;33;.917;3600000;0
7400;178394;1095;83;30;2;28;.933;3600000;0
7400;189885;4921;0;0;0;0;.00nan;0;0
7400;186451;1095;0;0;0;0;.00nan;0;0
7400;197912;4921;75;34;3;31;.912;3600000;0
7401;199437;77;86;34;1;33;.971;3600000;0
7401;204668;78;0;0;0;0;.00nan;0;0
7401;189902;78;80;31;2;29;.935;3569000;0
7401;190034;77;0;0;0;0;.00nan;0;0
7402;195251;85;80;41;4;37;.902;3578000;0
7402;176136;74;80;27;2;25;.926;3600000;0
7402;-1;85;0;0;0;0;.00nan;0;0
7402;-1;74;0;0;0;0;.00nan;0;0
7403;182467;4922;0;0;0;0;.00nan;0;0
7403;194219;76;37;22;4;18;.818;3599000;0
7403;205121;4922;88;47;3;44;.936;3600000;0
7403;184175;76;0;0;0;0;.00nan;0;0
7404;176770;81;0;0;0;0;.00nan;0;0
7404;176860;81;100;35;0;35;1.000;3600000;0
7404;57215;152;0;0;0;0;.00nan;0;0
7404;86875;152;48;22;3;19;.864;3600000;0
7405;189081;1097;0;0;0;0;.00nan;0;0
7405;200572;1097;70;25;2;23;.920;3600000;0
7405;78820;75;42;17;3;14;.824;3600000;0
7405;86394;75;0;0;0;0;.00nan;0;0
7406;-1;69;0;0;0;0;.00nan;0;0
7406;192547;2564;0;0;0;0;.00nan;0;0
7406;78479;69;72;35;3;32;.914;3553000;0
7406;79141;2564;71;26;2;24;.923;3600000;0
7407;184788;151;0;0;0;0;.00nan;0;0
7407;176915;151;61;33;3;30;.909;3600000;0
7407;179830;157;0;0;0;0;.00nan;0;0
7407;191518;157;99;21;0;21;1.000;3600000;0
7408;161535;4245;0;0;0;0;.00nan;0;0
7408;183737;72;95;48;3;45;.938;3544000;0
7408;200233;4245;50;14;2;12;.857;3600000;0
7408;91212;72;0;0;0;0;.00nan;0;0
7409;203179;4620;0;0;0;0;.00nan;0;0
7409;179344;67;86;36;2;34;.944;3600000;0
7409;-1;67;0;0;0;0;.00nan;0;0
7409;-1;4620;58;29;3;26;.897;3570000;0
7410;163989;149;43;18;3;15;.833;3515000;0
7410;170598;80;92;30;1;29;.967;3600000;0
7410;-1;80;0;0;0;0;.00nan;0;0
7410;85546;149;0;0;0;0;.00nan;0;0
7411;203276;82;43;32;5;27;.844;2474000;0
7411;185800;82;37;17;4;13;.765;1126000;0
7411;191574;4920;0;0;0;0;.00nan;0;0
7411;-1;4920;60;20;2;18;.900;3600000;0
7412;184788;151;75;39;3;36;.923;3900000;0
7412;176915;151;0;0;0;0;.00nan;0;0
7412;179830;157;0;0;0;0;.00nan;0;0
7412;191518;157;81;39;3;36;.923;3900000;0
7413;200390;1096;89;42;3;39;.929;3767000;0
7413;184069;73;0;0;0;0;.00nan;0;0
7413;173961;73;55;22;4;18;.818;3767000;0
7413;-1;1096;0;0;0;0;.00nan;0;0
7414;178394;1095;0;0;0;0;.00nan;0;0
7414;189885;4921;100;55;3;52;.945;3762000;0
7414;186451;1095;45;24;4;20;.833;3762000;0
7414;197912;4921;0;0;0;0;.00nan;0;0
7415;182467;4922;72;61;6;55;.902;3600000;0
7415;194219;76;73;21;2;19;.905;3600000;0
7415;205121;4922;0;0;0;0;.00nan;0;0
7415;184175;76;0;0;0;0;.00nan;0;0
7416;-1;69;65;23;3;20;.870;3600000;0
7416;192547;2564;29;34;6;28;.824;3600000;0
7416;78479;69;0;0;0;0;.00nan;0;0
7416;79141;2564;0;0;0;0;.00nan;0;0
7417;199437;77;99;31;1;30;.968;3600000;0
7417;204668;78;58;30;4;26;.867;3600000;0
7417;189902;78;0;0;0;0;.00nan;0;0
7417;190034;77;0;0;0;0;.00nan;0;0
7418;195251;85;0;0;0;0;.00nan;0;0
7418;176136;74;0;0;0;0;.00nan;0;0
7418;-1;85;37;28;5;23;.821;3600000;0
7418;-1;74;99;39;1;38;.974;3600000;0
7419;176770;81;0;0;0;0;.00nan;0;0
7419;176860;81;54;32;4;28;.875;3600000;0
7419;57215;152;97;27;1;26;.963;3600000;0
7419;86875;152;0;0;0;0;.00nan;0;0
7420;189081;1097;0;0;0;0;.00nan;0;0
7420;200572;1097;74;29;2;27;.931;3566000;0
7420;78820;75;0;0;0;0;.00nan;0;0
7420;86394;75;78;19;1;18;.947;3600000;0
7421;161535;4245;68;30;3;27;.900;3569000;0
7421;183737;72;0;0;0;0;.00nan;0;0
7421;200233;4245;0;0;0;0;.00nan;0;0
7421;91212;72;64;25;2;23;.920;3600000;0
7422;187699;158;10;15;6;9;.600;2178000;0
7422;78581;71;74;37;3;34;.919;3600000;0
7422;86862;158;53;9;1;8;.889;1422000;0
7422;91403;71;0;0;0;0;.00nan;0;0
7423;203179;4620;66;31;3;28;.903;3900000;0
7423;179344;67;0;0;0;0;.00nan;0;0
7423;-1;67;81;45;3;42;.933;3900000;0
7423;-1;4620;0;0;0;0;.00nan;0;0
7424;200390;1096;0;0;0;0;.00nan;0;0
7424;-1;1096;65;38;4;34;.895;3564000;0
7424;78820;75;0;0;0;0;.00nan;0;0
7424;86394;75;35;12;3;9;.750;3600000;0
7425;187699;158;66;17;3;14;.824;3600000;0
7425;163989;149;40;25;5;20;.800;3600000;0
7425;85546;149;0;0;0;0;.00nan;0;0
7425;86862;158;0;0;0;0;.00nan;0;0
7426;184069;73;0;0;0;0;.00nan;0;0
7426;173961;73;44;18;3;15;.833;3600000;0
7426;189885;4921;75;19;0;19;1.000;1565000;0
7426;197912;4921;44;24;4;20;.833;2027000;0
7427;176770;81;0;0;0;0;.00nan;0;0
7427;176860;81;52;28;4;24;.857;3584000;0
7427;179830;157;0;0;0;0;.00nan;0;0
7427;191518;157;63;23;2;21;.913;3600000;0
7428;170598;80;0;0;0;0;.00nan;0;0
7428;-1;80;45;19;3;16;.842;3569000;0
7428;57215;152;0;0;0;0;.00nan;0;0
7428;86875;152;90;43;2;41;.953;3600000;0
7429;161535;4245;61;6;0;6;1.000;440000;0
7429;200233;4245;33;36;7;29;.806;3160000;0
7429;191574;4920;55;29;5;24;.828;3600000;0
7429;-1;4920;0;0;0;0;.00nan;0;0
7430;189081;1097;0;0;0;0;.00nan;0;0
7430;200390;1096;96;42;2;40;.952;3600000;0
7430;200572;1097;68;21;1;20;.952;3600000;0
7430;-1;1096;0;0;0;0;.00nan;0;0
7431;178394;1095;0;0;0;0;.00nan;0;0
7431;186451;1095;81;32;2;30;.938;3600000;0
7431;192547;2564;55;34;5;29;.853;3600000;0
7431;79141;2564;0;0;0;0;.00nan;0;0
7432;199437;77;59;48;7;41;.854;2762000;0
7432;190034;77;58;6;0;6;1.000;838000;0
7432;78820;75;0;0;0;0;.00nan;0;0
7432;86394;75;50;20;3;17;.850;3600000;0
7433;184069;73;56;36;5;31;.861;3900000;0
7433;173961;73;0;0;0;0;.00nan;0;0
7433;189885;4921;0;0;0;0;.00nan;0;0
7433;197912;4921;53;40;5;35;.875;3900000;0
7434;203276;82;27;29;7;22;.759;3110000;0
7434;182467;4922;0;0;0;0;.00nan;0;0
7434;205121;4922;52;19;2;17;.895;3600000;0
7434;185800;82;47;8;1;7;.875;490000;0
7435;-1;69;0;0;0;0;.00nan;0;0
7435;78479;69;89;28;1;27;.964;3600000;0
7435;78581;71;69;26;2;24;.923;3588000;0
7435;91403;71;0;0;0;0;.00nan;0;0
7436;203179;4620;0;0;0;0;.00nan;0;0
7436;176136;74;70;46;5;41;.891;3600000;0
7436;-1;74;0;0;0;0;.00nan;0;0
7436;-1;4620;55;23;3;20;.870;3600000;0
7437;194219;76;45;25;4;21;.840;3600000;0
7437;184175;76;0;0;0;0;.00nan;0;0
7437;179344;67;76;38;3;35;.921;3600000;0
7437;-1;67;0;0;0;0;.00nan;0;0
7438;176770;81;0;0;0;0;.00nan;0;0
7438;176860;81;87;47;4;43;.915;3559000;0
7438;179830;157;0;0;0;0;.00nan;0;0
7438;191518;157;64;30;3;27;.900;3600000;0
7439;163989;149;79;30;1;29;.967;3900000;0
7439;170598;80;89;34;1;33;.971;3900000;0
7439;-1;80;0;0;0;0;.00nan;0;0
7439;85546;149;0;0;0;0;.00nan;0;0
7440;183737;72;0;0;0;0;.00nan;0;0
7440;184788;151;0;0;0;0;.00nan;0;0
7440;176915;151;91;39;3;36;.923;3600000;0
7440;91212;72;64;39;5;34;.872;3585000;0
7441;187699;158;55;30;4;26;.867;3600000;0
7441;57215;152;0;0;0;0;.00nan;0;0
7441;86862;158;0;0;0;0;.00nan;0;0
7441;86875;152;65;37;5;32;.865;3570000;0
7442;195251;85;94;54;2;52;.963;3900000;0
7442;-1;85;0;0;0;0;.00nan;0;0
7442;191574;4920;0;0;0;0;.00nan;0;0
7442;-1;4920;51;24;2;22;.917;3855000;0
7443;163989;149;0;0;0;0;.00nan;0;0
7443;170598;80;0;0;0;0;.00nan;0;0
7443;-1;80;69;44;5;39;.886;3600000;0
7443;85546;149;82;33;2;31;.939;3600000;0
7444;178394;1095;70;37;3;34;.919;3600000;0
7444;186451;1095;0;0;0;0;.00nan;0;0
7444;78581;71;0;0;0;0;.00nan;0;0
7444;91403;71;98;27;0;27;1.000;3600000;0
7445;199437;77;50;24;4;20;.833;3600000;0
7445;200390;1096;0;0;0;0;.00nan;0;0
7445;190034;77;0;0;0;0;.00nan;0;0
7445;-1;1096;39;34;6;28;.824;3528000;0
7446;184069;73;0;0;0;0;.00nan;0;0
7446;173961;73;49;23;3;20;.870;3553000;0
7446;189885;4921;77;31;2;29;.935;3600000;0
7446;197912;4921;0;0;0;0;.00nan;0;0
7447;182467;4922;63;42;4;38;.905;3600000;0
7447;189081;1097;0;0;0;0;.00nan;0;0
7447;205121;4922;0;0;0;0;.00nan;0;0
7447;200572;1097;100;36;1;35;.972;3600000;0
7448;-1;69;60;32;3;29;.906;3587000;0
7448;192547;2564;0;0;0;0;.00nan;0;0
7448;78479;69;0;0;0;0;.00nan;0;0
7448;79141;2564;78;31;2;29;.935;3600000;0
7449;187699;158;75;24;2;22;.917;3900000;0
7449;57215;152;68;28;2;26;.929;3900000;0
7449;86862;158;0;0;0;0;.00nan;0;0
7449;86875;152;0;0;0;0;.00nan;0;0
7450;203179;4620;39;17;4;13;.765;3600000;0
7450;176136;74;0;0;0;0;.00nan;0;0
7450;-1;74;50;34;5;29;.853;3600000;0
7450;-1;4620;0;0;0;0;.00nan;0;0
7451;194219;76;0;0;0;0;.00nan;0;0
7451;184175;76;94;28;1;27;.964;3600000;0
7451;179344;67;0;0;0;0;.00nan;0;0
7451;-1;67;71;31;2;29;.935;3549000;0
7452;176770;81;69;46;6;40;.870;3600000;0
7452;176860;81;0;0;0;0;.00nan;0;0
7452;179830;157;0;0;0;0;.00nan;0;0
7452;191518;157;78;27;1;26;.963;3600000;0
7453;161535;4245;78;22;1;21;.955;3588000;0
7453;204668;78;100;29;0;29;1.000;3600000;0
7453;200233;4245;0;0;0;0;.00nan;0;0
7453;189902;78;0;0;0;0;.00nan;0;0
7454;203276;82;96;54;2;52;.963;3584000;0
7454;185800;82;0;0;0;0;.00nan;0;0
7454;78820;75;77;21;1;20;.952;3600000;0
7454;86394;75;0;0;0;0;.00nan;0;0
7455;183737;72;36;25;5;20;.800;3600000;0
7455;184788;151;83;36;2;34;.944;3600000;0
7455;176915;151;0;0;0;0;.00nan;0;0
7455;91212;72;0;0;0;0;.00nan;0;0
7456;199437;77;30;34;6;28;.824;3600000;0
7456;200390;1096;76;35;3;32;.914;3600000;0
7456;190034;77;0;0;0;0;.00nan;0;0
7456;-1;1096;0;0;0;0;.00nan;0;0
7457;178394;1095;0;0;0;0;.00nan;0;0
7457;186451;1095;55;34;4;30;.882;3563000;0
7457;78581;71;0;0;0;0;.00nan;0;0
7457;91403;71;59;27;3;24;.889;3600000;0
7458;182467;4922;0;0;0;0;.00nan;0;0
7458;189081;1097;0;0;0;0;.00nan;0;0
7458;205121;4922;69;32;3;29;.906;3600000;0
7458;200572;1097;70;27;2;25;.926;3600000;0
7459;203179;4620;0;0;0;0;.00nan;0;0
7459;176136;74;61;32;3;29;.906;3526000;0
7459;-1;74;0;0;0;0;.00nan;0;0
7459;-1;4620;93;32;1;31;.969;3600000;0
7460;194219;76;75;17;1;16;.941;3600000;0
7460;184175;76;0;0;0;0;.00nan;0;0
7460;179344;67;74;35;3;32;.914;3526000;0
7460;-1;67;0;0;0;0;.00nan;0;0
7461;203276;82;95;44;2;42;.955;3577000;0
7461;185800;82;0;0;0;0;.00nan;0;0
7461;78820;75;0;0;0;0;.00nan;0;0
7461;86394;75;89;19;0;19;1.000;3600000;0
7462;187699;158;0;0;0;0;.00nan;0;0
7462;170598;80;65;40;3;37;.925;3893000;0
7462;-1;80;0;0;0;0;.00nan;0;0
7462;86862;158;51;17;3;14;.824;3900000;0
7463;161535;4245;0;0;0;0;.00nan;0;0
7463;204668;78;49;40;6;34;.850;2938000;0
7463;200233;4245;60;23;2;21;.913;3600000;0
7463;189902;78;53;2;0;2;1.000;662000;0
7464;183737;72;0;0;0;0;.00nan;0;0
7464;184788;151;0;0;0;0;.00nan;0;0
7464;176915;151;91;38;2;36;.947;3545000;0
7464;91212;72;87;20;0;20;1.000;3600000;0
7465;203276;82;96;22;0;22;1.000;3600000;0
7465;179344;67;62;27;2;25;.926;3556000;0
7465;-1;67;0;0;0;0;.00nan;0;0
7465;185800;82;0;0;0;0;.00nan;0;0
7466;187699;158;88;32;1;31;.969;3900000;0
7466;189885;4921;0;0;0;0;.00nan;0;0
7466;197912;4921;96;35;1;34;.971;3900000;0
7466;86862;158;0;0;0;0;.00nan;0;0
7467;203179;4620;27;28;6;22;.786;2855000;0
7467;-1;69;0;0;0;0;.00nan;0;0
7467;-1;4620;37;8;2;6;.750;745000;0
7467;78479;69;87;34;3;31;.912;3600000;0
7468;161535;4245;0;0;0;0;.00nan;0;0
7468;204668;78;40;37;6;31;.838;3600000;0
7468;200233;4245;31;24;5;19;.792;3600000;0
7468;189902;78;0;0;0;0;.00nan;0;0
7469;200390;1096;0;0;0;0;.00nan;0;0
7469;-1;1096;63;38;4;34;.895;3567000;0
7469;84945;75;0;0;0;0;.00nan;0;0
7469;86394;75;51;19;3;16;.842;3600000;0
7470;199437;77;65;26;2;24;.923;3600000;0
7470;190034;77;0;0;0;0;.00nan;0;0
7470;176770;81;0;0;0;0;.00nan;0;0
7470;176860;81;63;33;4;29;.879;3519000;0
7471;161535;4245;0;0;0;0;.00nan;0;0
7471;200233;4245;83;44;3;41;.932;3600000;0
7471;191574;4920;79;23;1;22;.957;3600000;0
7471;-1;4920;0;0;0;0;.00nan;0;0
7472;178394;1095;0;0;0;0;.00nan;0;0
7472;189885;4921;0;0;0;0;.00nan;0;0
7472;186451;1095;86;20;0;20;1.000;3600000;0
7472;197912;4921;90;46;3;43;.935;3600000;0
7473;203276;82;45;38;6;32;.842;3600000;0
7473;179344;67;0;0;0;0;.00nan;0;0
7473;-1;67;85;16;0;16;1.000;3600000;0
7473;185800;82;0;0;0;0;.00nan;0;0
7474;187699;158;57;34;4;30;.882;3557000;0
7474;184069;73;80;27;2;25;.926;3600000;0
7474;173961;73;0;0;0;0;.00nan;0;0
7474;86862;158;0;0;0;0;.00nan;0;0
7475;184788;151;0;0;0;0;.00nan;0;0
7475;176915;151;59;23;2;21;.913;3551000;0
7475;57215;152;0;0;0;0;.00nan;0;0
7475;86875;152;100;34;1;33;.971;3600000;0
7476;176136;74;38;36;6;30;.833;3600000;0
7476;-1;74;0;0;0;0;.00nan;0;0
7476;84945;75;0;0;0;0;.00nan;0;0
7476;86394;75;80;22;1;21;.955;3600000;0
7477;182467;4922;0;0;0;0;.00nan;0;0
7477;194219;76;89;30;2;28;.933;3600000;0
7477;205121;4922;83;31;3;28;.903;3570000;0
7477;184175;76;0;0;0;0;.00nan;0;0
7478;189081;1097;0;0;0;0;.00nan;0;0
7478;200390;1096;70;46;5;41;.891;3600000;0
7478;200572;1097;65;20;2;18;.900;3600000;0
7478;-1;1096;0;0;0;0;.00nan;0;0
7479;203179;4620;0;0;0;0;.00nan;0;0
7479;192547;2564;0;0;0;0;.00nan;0;0
7479;-1;4620;87;28;1;27;.964;3600000;0
7479;79141;2564;69;32;3;29;.906;3600000;0
7480;204668;78;0;0;0;0;.00nan;0;0
7480;195251;85;0;0;0;0;.00nan;0;0
7480;189902;78;67;17;1;16;.941;3600000;0
7480;-1;85;86;46;3;43;.935;3563000;0
7481;170598;80;75;42;3;39;.929;3600000;0
7481;179830;157;0;0;0;0;.00nan;0;0
7481;-1;80;0;0;0;0;.00nan;0;0
7481;191518;157;92;18;0;18;1.000;3600000;0
7482;183737;72;0;0;0;0;.00nan;0;0
7482;78820;71;59;25;3;22;.880;3585000;0
7482;91212;72;72;24;2;22;.917;3600000;0
7482;91403;71;0;0;0;0;.00nan;0;0
7483;161535;4245;73;36;2;34;.944;3569000;0
7483;200233;4245;0;0;0;0;.00nan;0;0
7483;191574;4920;0;0;0;0;.00nan;0;0
7483;-1;4920;61;13;1;12;.923;3600000;0
7484;178394;1095;0;0;0;0;.00nan;0;0
7484;189885;4921;49;45;6;39;.867;3585000;0
7484;186451;1095;38;19;4;15;.789;3600000;0
7484;197912;4921;0;0;0;0;.00nan;0;0
7485;203276;82;0;0;0;0;.00nan;0;0
7485;179344;67;0;0;0;0;.00nan;0;0
7485;-1;67;80;13;0;13;1.000;3600000;0
7485;185800;82;78;40;4;36;.900;3600000;0
7486;199437;77;45;19;3;16;.842;3600000;0
7486;190034;77;0;0;0;0;.00nan;0;0
7486;176770;81;0;0;0;0;.00nan;0;0
7486;176860;81;62;38;5;33;.868;3581000;0
7487;187699;158;0;0;0;0;.00nan;0;0
7487;184069;73;0;0;0;0;.00nan;0;0
7487;173961;73;100;29;0;29;1.000;3600000;0
7487;86862;158;59;27;3;24;.889;3600000;0
7488;184788;151;0;0;0;0;.00nan;0;0
7488;176915;151;33;26;5;21;.808;3546000;0
7488;57215;152;57;30;4;26;.867;2251000;0
7488;86875;152;61;7;0;7;1.000;1349000;0
7489;176136;74;0;0;0;0;.00nan;0;0
7489;-1;74;93;37;1;36;.973;3600000;0
7489;84945;75;62;31;3;28;.903;3567000;0
7489;86394;75;0;0;0;0;.00nan;0;0
7490;194219;76;48;31;4;27;.871;3600000;0
7490;200390;1096;0;0;0;0;.00nan;0;0
7490;184175;76;0;0;0;0;.00nan;0;0
7490;-1;1096;100;27;0;27;1.000;3600000;0
7491;182467;4922;97;40;2;38;.950;3600000;0
7491;189081;1097;0;0;0;0;.00nan;0;0
7491;205121;4922;0;0;0;0;.00nan;0;0
7491;200572;1097;45;23;4;19;.826;3519000;0
7492;203179;4620;64;24;3;21;.875;3825000;0
7492;192547;2564;75;37;4;33;.892;3825000;0
7492;-1;4620;0;0;0;0;.00nan;0;0
7492;79141;2564;0;0;0;0;.00nan;0;0
7493;204668;78;83;37;3;34;.919;3562000;0
7493;195251;85;73;22;1;21;.955;3600000;0
7493;189902;78;0;0;0;0;.00nan;0;0
7493;-1;85;0;0;0;0;.00nan;0;0
7494;170598;80;0;0;0;0;.00nan;0;0
7494;179830;157;0;0;0;0;.00nan;0;0
7494;-1;80;57;57;7;50;.877;3600000;0
7494;191518;157;55;20;2;18;.900;3600000;0
7495;183737;72;80;29;2;27;.931;3600000;0
7495;-1;69;51;34;5;29;.853;3600000;0
7495;78479;69;0;0;0;0;.00nan;0;0
7495;91212;72;0;0;0;0;.00nan;0;0
7496;203179;4620;0;0;0;0;.00nan;0;0
7496;178394;1095;71;28;2;26;.929;3600000;0
7496;186451;1095;0;0;0;0;.00nan;0;0
7496;-1;4620;65;35;3;32;.914;3600000;0
7497;199437;77;0;0;0;0;.00nan;0;0
7497;190034;77;54;23;3;20;.870;3600000;0
7497;176770;81;0;0;0;0;.00nan;0;0
7497;176860;81;67;37;4;33;.892;3575000;0
7498;184788;151;49;30;4;26;.867;3860000;0
7498;176915;151;0;0;0;0;.00nan;0;0
7498;57215;152;0;0;0;0;.00nan;0;0
7498;86875;152;80;40;3;37;.925;3860000;0
7499;194219;76;0;0;0;0;.00nan;0;0
7499;200390;1096;58;32;4;28;.875;3600000;0
7499;184175;76;96;21;0;21;1.000;3600000;0
7499;-1;1096;0;0;0;0;.00nan;0;0
7500;192547;2564;0;0;0;0;.00nan;0;0
7500;78820;71;100;23;0;23;1.000;3900000;0
7500;79141;2564;97;32;0;32;1.000;3900000;0
7500;91403;71;0;0;0;0;.00nan;0;0
7501;170598;80;74;30;2;28;.933;3600000;0
7501;179830;157;0;0;0;0;.00nan;0;0
7501;-1;80;0;0;0;0;.00nan;0;0
7501;191518;157;77;24;1;23;.958;3600000;0
7502;183737;72;0;0;0;0;.00nan;0;0
7502;-1;69;0;0;0;0;.00nan;0;0
7502;78479;69;68;33;3;30;.909;3547000;0
7502;91212;72;93;30;1;29;.967;3600000;0
7503;182467;4922;0;0;0;0;.00nan;0;0
7503;205121;4922;69;32;3;29;.906;3900000;0
7503;200390;1096;0;0;0;0;.00nan;0;0
7503;-1;1096;46;19;3;16;.842;3900000;0
7504;178394;1095;0;0;0;0;.00nan;0;0
7504;184069;73;0;0;0;0;.00nan;0;0
7504;173961;73;75;28;2;26;.929;3876000;0
7504;186451;1095;90;39;2;37;.949;3900000;0
7505;184788;151;0;0;0;0;.00nan;0;0
7505;176915;151;72;30;3;27;.900;3900000;0
7505;179830;157;0;0;0;0;.00nan;0;0
7505;191518;157;70;36;3;33;.917;3900000;0
7506;176136;74;79;32;2;30;.938;3610000;0
7506;-1;74;0;0;0;0;.00nan;0;0
7506;191574;4920;62;28;3;25;.893;3610000;0
7506;-1;4920;0;0;0;0;.00nan;0;0
7507;189081;1097;0;0;0;0;.00nan;0;0
7507;200572;1097;78;31;2;29;.935;3623000;0
7507;176770;81;0;0;0;0;.00nan;0;0
7507;176860;81;78;36;3;33;.917;3623000;0
7508;161535;4245;33;29;6;23;.793;3584000;0
7508;183737;72;0;0;0;0;.00nan;0;0
7508;200233;4245;0;0;0;0;.00nan;0;0
7508;91212;72;42;29;5;24;.828;3600000;0
7509;163989;149;72;32;3;29;.906;3600000;0
7509;170598;80;43;27;5;22;.815;3600000;0
7509;-1;80;0;0;0;0;.00nan;0;0
7509;85546;149;0;0;0;0;.00nan;0;0
7510;183737;72;0;0;0;0;.00nan;0;0
7510;178394;1095;0;0;0;0;.00nan;0;0
7510;186451;1095;90;42;2;40;.952;3600000;0
7510;91212;72;71;16;1;15;.938;3600000;0
7511;184788;151;0;0;0;0;.00nan;0;0
7511;176915;151;34;26;5;21;.808;3600000;0
7511;179830;157;0;0;0;0;.00nan;0;0
7511;191518;157;57;15;2;13;.867;3600000;0
7512;184069;73;54;23;3;20;.870;3600000;0
7512;173961;73;0;0;0;0;.00nan;0;0
7512;189885;4921;0;0;0;0;.00nan;0;0
7512;197912;4921;79;54;5;49;.907;3538000;0
7513;187699;158;81;42;5;37;.881;3900000;0
7513;57215;152;0;0;0;0;.00nan;0;0
7513;86862;158;0;0;0;0;.00nan;0;0
7513;86875;152;67;37;5;32;.865;3900000;0
7514;204668;78;48;29;5;24;.828;3511000;0
7514;-1;69;0;0;0;0;.00nan;0;0
7514;189902;78;0;0;0;0;.00nan;0;0
7514;78479;69;78;37;3;34;.919;3600000;0
7515;203179;4620;0;0;0;0;.00nan;0;0
7515;176136;74;97;35;1;34;.971;3600000;0
7515;-1;74;0;0;0;0;.00nan;0;0
7515;-1;4620;54;25;3;22;.880;3530000;0
7516;203276;82;82;39;2;37;.949;3900000;0
7516;194219;76;0;0;0;0;.00nan;0;0
7516;184175;76;77;25;2;23;.920;3900000;0
7516;185800;82;0;0;0;0;.00nan;0;0
7517;189081;1097;0;0;0;0;.00nan;0;0
7517;200572;1097;83;41;3;38;.927;3600000;0
7517;176860;81;49;37;6;31;.838;3600000;0
7517;86228;81;0;0;0;0;.00nan;0;0
7518;161535;4245;59;45;5;40;.889;3600000;0
7518;200233;4245;0;0;0;0;.00nan;0;0
7518;191574;4920;89;28;1;27;.964;3600000;0
7518;-1;4920;0;0;0;0;.00nan;0;0
7519;182467;4922;0;0;0;0;.00nan;0;0
7519;205121;4922;54;48;6;42;.875;3600000;0
7519;84945;75;0;0;0;0;.00nan;0;0
7519;86394;75;89;16;0;16;1.000;3600000;0
7520;192547;2564;0;0;0;0;.00nan;0;0
7520;78820;71;43;17;3;14;.824;3550000;0
7520;79141;2564;100;36;2;34;.944;3600000;0
7520;91403;71;0;0;0;0;.00nan;0;0
7521;199437;77;77;31;2;29;.935;3600000;0
7521;200390;1096;0;0;0;0;.00nan;0;0
7521;190034;77;0;0;0;0;.00nan;0;0
7521;-1;1096;52;22;3;19;.864;3598000;0
7522;178394;1095;86;36;2;34;.944;3600000;0
7522;184069;73;0;0;0;0;.00nan;0;0
7522;173961;73;15;24;6;18;.750;3600000;0
7522;186451;1095;0;0;0;0;.00nan;0;0
7523;183737;72;37;19;4;15;.789;3600000;0
7523;78820;71;93;26;1;25;.962;3600000;0
7523;91212;72;0;0;0;0;.00nan;0;0
7523;91403;71;0;0;0;0;.00nan;0;0
7524;184788;151;82;17;0;17;1.000;3600000;0
7524;176915;151;0;0;0;0;.00nan;0;0
7524;179830;157;66;37;4;33;.892;3600000;0
7524;191518;157;0;0;0;0;.00nan;0;0
7525;182467;4922;0;0;0;0;.00nan;0;0
7525;194219;76;66;18;1;17;.944;3600000;0
7525;205121;4922;75;43;4;39;.907;3600000;0
7525;184175;76;0;0;0;0;.00nan;0;0
7526;204668;78;0;0;0;0;.00nan;0;0
7526;-1;69;19;26;6;20;.769;3600000;0
7526;189902;78;31;23;5;18;.783;3600000;0
7526;78479;69;0;0;0;0;.00nan;0;0
7527;203179;4620;55;28;4;24;.857;3563000;0
7527;176136;74;77;46;3;43;.935;3600000;0
7527;-1;74;0;0;0;0;.00nan;0;0
7527;-1;4620;0;0;0;0;.00nan;0;0
7528;189081;1097;0;0;0;0;.00nan;0;0
7528;200572;1097;87;28;1;27;.964;3600000;0
7528;176860;81;58;10;1;9;.900;1139000;0
7528;86228;81;26;21;6;15;.714;2461000;0
7529;161535;4245;0;0;0;0;.00nan;0;0
7529;200233;4245;55;42;5;37;.881;3600000;0
7529;191574;4920;0;0;0;0;.00nan;0;0
7529;-1;4920;89;18;0;18;1.000;3600000;0
7530;203276;82;0;0;0;0;.00nan;0;0
7530;185800;82;65;39;4;35;.897;3600000;0
7530;84945;75;0;0;0;0;.00nan;0;0
7530;86394;75;92;15;0;15;1.000;3600000;0
7531;189885;4921;53;30;5;25;.833;3600000;0
7531;192547;2564;94;36;1;35;.972;3600000;0
7531;197912;4921;0;0;0;0;.00nan;0;0
7531;79141;2564;0;0;0;0;.00nan;0;0
7532;170598;80;0;0;0;0;.00nan;0;0
7532;57215;152;36;20;4;16;.800;3542000;0
7532;58100;80;96;47;2;45;.957;3600000;0
7532;86875;152;0;0;0;0;.00nan;0;0
7533;187699;158;56;16;2;14;.875;3600000;0
7533;163989;149;0;0;0;0;.00nan;0;0
7533;85546;149;29;29;6;23;.793;3600000;0
7533;86862;158;0;0;0;0;.00nan;0;0
7534;195251;85;0;0;0;0;.00nan;0;0
7534;179344;67;0;0;0;0;.00nan;0;0
7534;-1;85;99;40;1;39;.975;3600000;0
7534;-1;67;14;29;7;22;.759;3600000;0
7535;187699;158;60;8;0;8;1.000;1226000;0
7535;163989;149;68;23;2;21;.913;3600000;0
7535;85546;149;0;0;0;0;.00nan;0;0
7535;86862;158;10;11;5;6;.545;2374000;0
7536;199437;77;69;31;3;28;.903;3600000;0
7536;200390;1096;41;29;5;24;.828;3544000;0
7536;190034;77;0;0;0;0;.00nan;0;0
7536;-1;1096;0;0;0;0;.00nan;0;0
7537;184069;73;33;25;5;20;.800;3600000;0
7537;173961;73;0;0;0;0;.00nan;0;0
7537;78820;71;100;24;0;24;1.000;3600000;0
7537;91403;71;0;0;0;0;.00nan;0;0
7538;182467;4922;53;28;4;24;.857;3577000;0
7538;194219;76;0;0;0;0;.00nan;0;0
7538;205121;4922;0;0;0;0;.00nan;0;0
7538;184175;76;58;21;3;18;.857;3600000;0
7539;204668;78;98;29;1;28;.966;3600000;0
7539;-1;69;0;0;0;0;.00nan;0;0
7539;189902;78;0;0;0;0;.00nan;0;0
7539;78479;69;72;42;4;38;.905;3600000;0
7540;203276;82;97;54;4;50;.926;3600000;0
7540;185800;82;0;0;0;0;.00nan;0;0
7540;84945;75;0;0;0;0;.00nan;0;0
7540;86394;75;66;19;1;18;.947;3600000;0
7541;189885;4921;0;0;0;0;.00nan;0;0
7541;192547;2564;0;0;0;0;.00nan;0;0
7541;197912;4921;85;40;3;37;.925;3900000;0
7541;79141;2564;53;17;3;14;.824;3900000;0
7542;170598;80;86;39;2;37;.949;3600000;0
7542;57215;152;0;0;0;0;.00nan;0;0
7542;58100;80;0;0;0;0;.00nan;0;0
7542;86875;152;100;30;0;30;1.000;3600000;0
7543;183737;72;0;0;0;0;.00nan;0;0
7543;178394;1095;0;0;0;0;.00nan;0;0
7543;186451;1095;47;33;4;29;.879;3600000;0
7543;91212;72;91;39;1;38;.974;3600000;0
7544;195251;85;94;30;1;29;.967;3600000;0
7544;179344;67;38;29;5;24;.828;3600000;0
7544;-1;85;0;0;0;0;.00nan;0;0
7544;-1;67;0;0;0;0;.00nan;0;0
7545;203179;4620;0;0;0;0;.00nan;0;0
7545;179344;67;0;0;0;0;.00nan;0;0
7545;-1;67;87;41;3;38;.927;3575000;0
7545;-1;4620;73;21;1;20;.952;3600000;0
7546;203276;82;60;19;2;17;.895;3600000;0
7546;182467;4922;0;0;0;0;.00nan;0;0
7546;205121;4922;63;32;3;29;.906;3562000;0
7546;185800;82;0;0;0;0;.00nan;0;0
7547;161535;4245;0;0;0;0;.00nan;0;0
7547;200233;4245;65;15;1;14;.933;3600000;0
7547;176136;74;55;39;5;34;.872;3600000;0
7547;-1;74;0;0;0;0;.00nan;0;0
7548;195251;85;94;46;2;44;.957;3900000;0
7548;-1;85;0;0;0;0;.00nan;0;0
7548;191574;4920;0;0;0;0;.00nan;0;0
7548;-1;4920;67;29;2;27;.931;3900000;0
7549;187699;158;62;28;3;25;.893;3819000;0
7549;170598;80;63;34;4;30;.882;3819000;0
7549;58100;80;0;0;0;0;.00nan;0;0
7549;86862;158;0;0;0;0;.00nan;0;0
7550;163989;149;57;26;3;23;.885;3528000;0
7550;57215;152;0;0;0;0;.00nan;0;0
7550;85546;149;0;0;0;0;.00nan;0;0
7550;86875;152;86;32;1;31;.969;3600000;0
7551;203276;82;97;69;5;64;.928;3600000;0
7551;194219;76;61;13;1;12;.923;3600000;0
7551;184175;76;0;0;0;0;.00nan;0;0
7551;185800;82;0;0;0;0;.00nan;0;0
7552;183737;72;0;0;0;0;.00nan;0;0
7552;78820;71;43;16;3;13;.813;551000;0
7552;91212;72;78;44;5;39;.886;3900000;0
7552;91403;71;55;23;2;21;.913;3349000;0
7553;184069;73;40;17;3;14;.824;3543000;0
7553;173961;73;0;0;0;0;.00nan;0;0
7553;-1;69;0;0;0;0;.00nan;0;0
7553;78479;69;85;29;1;28;.966;3600000;0
7554;203179;4620;0;0;0;0;.00nan;0;0
7554;191574;4920;41;25;4;21;.840;3552000;0
7554;-1;4920;0;0;0;0;.00nan;0;0
7554;-1;4620;62;37;4;33;.892;3600000;0
7555;204668;78;86;31;1;30;.968;3900000;0
7555;189902;78;0;0;0;0;.00nan;0;0
7555;179830;157;0;0;0;0;.00nan;0;0
7555;191518;157;96;33;1;32;.970;3900000;0
7556;161535;4245;80;23;1;22;.957;3600000;0
7556;200233;4245;0;0;0;0;.00nan;0;0
7556;176136;74;47;35;6;29;.829;3600000;0
7556;-1;74;0;0;0;0;.00nan;0;0
7557;199437;77;61;29;4;25;.862;3600000;0
7557;189081;1097;0;0;0;0;.00nan;0;0
7557;200572;1097;37;25;5;20;.800;3558000;0
7557;184788;77;0;0;0;0;.00nan;0;0
7558;200390;1096;0;0;0;0;.00nan;0;0
7558;-1;1096;80;32;2;30;.938;3550000;0
7558;192552;75;0;0;0;0;.00nan;0;0
7558;86394;75;63;15;1;14;.933;3600000;0
7559;178394;1095;0;0;0;0;.00nan;0;0
7559;186451;1095;65;16;1;15;.938;3600000;0
7559;192547;2564;68;35;3;32;.914;3555000;0
7559;79141;2564;0;0;0;0;.00nan;0;0
7560;195251;85;0;0;0;0;.00nan;0;0
7560;179344;67;0;0;0;0;.00nan;0;0
7560;-1;85;77;34;3;31;.912;3712000;0
7560;-1;67;56;28;4;24;.857;3712000;0
7561;178695;81;65;44;5;39;.886;3600000;0
7561;173918;151;0;0;0;0;.00nan;0;0
7561;176915;151;100;34;1;33;.971;3600000;0
7561;86228;81;0;0;0;0;.00nan;0;0
7562;187699;158;41;22;4;18;.818;3600000;0
7562;189885;4921;0;0;0;0;.00nan;0;0
7562;197912;4921;80;26;1;25;.962;3600000;0
7562;86862;158;0;0;0;0;.00nan;0;0
7563;203179;4620;90;34;1;33;.971;3600000;0
7563;191574;4920;0;0;0;0;.00nan;0;0
7563;-1;4920;56;24;3;21;.875;3597000;0
7563;-1;4620;0;0;0;0;.00nan;0;0
7564;163989;149;0;0;0;0;.00nan;0;0
7564;57215;152;49;22;3;19;.864;3563000;0
7564;85546;149;86;37;2;35;.946;3600000;0
7564;86875;152;0;0;0;0;.00nan;0;0
7565;203276;82;0;0;0;0;.00nan;0;0
7565;194219;76;0;0;0;0;.00nan;0;0
7565;184175;76;58;14;1;13;.929;3600000;0
7565;185800;82;53;53;7;46;.868;3600000;0
7566;183737;72;39;33;6;27;.818;3600000;0
7566;78820;71;49;19;3;16;.842;3600000;0
7566;91212;72;0;0;0;0;.00nan;0;0
7566;91403;71;0;0;0;0;.00nan;0;0
7567;204668;78;0;0;0;0;.00nan;0;0
7567;189902;78;71;36;4;32;.889;3600000;0
7567;179830;157;0;0;0;0;.00nan;0;0
7567;191518;157;77;24;1;23;.958;3600000;0
7568;161535;4245;0;0;0;0;.00nan;0;0
7568;200233;4245;70;28;2;26;.929;3600000;0
7568;176136;74;0;0;0;0;.00nan;0;0
7568;-1;74;56;49;6;43;.878;3600000;0
7569;189081;1097;0;0;0;0;.00nan;0;0
7569;200572;1097;51;39;5;34;.872;3600000;0
7569;192552;75;0;0;0;0;.00nan;0;0
7569;86394;75;86;30;2;28;.933;3600000;0
7570;-1;69;47;28;4;24;.857;3600000;0
7570;192547;2564;0;0;0;0;.00nan;0;0
7570;78479;69;0;0;0;0;.00nan;0;0
7570;79141;2564;88;32;1;31;.969;3600000;0
7571;195251;85;100;36;0;36;1.000;3600000;0
7571;179344;67;89;39;1;38;.974;3545000;0
7571;-1;85;0;0;0;0;.00nan;0;0
7571;-1;67;0;0;0;0;.00nan;0;0
7572;178695;81;98;44;3;41;.932;3600000;0
7572;173918;151;80;15;0;15;1.000;3600000;0
7572;176915;151;0;0;0;0;.00nan;0;0
7572;86228;81;0;0;0;0;.00nan;0;0
7573;187699;158;88;34;2;32;.941;3551000;0
7573;189885;4921;100;33;0;33;1.000;3600000;0
7573;197912;4921;0;0;0;0;.00nan;0;0
7573;86862;158;0;0;0;0;.00nan;0;0
7574;163989;149;21;27;6;21;.778;2190000;0
7574;170598;80;61;22;2;20;.909;3600000;0
7574;58100;80;0;0;0;0;.00nan;0;0
7574;85546;149;54;12;1;11;.917;1410000;0
7575;200390;1096;70;37;4;33;.892;3685000;0
7575;-1;1096;0;0;0;0;.00nan;0;0
7575;192552;75;0;0;0;0;.00nan;0;0
7575;86394;75;56;25;3;22;.880;3685000;0
7576;184069;73;44;28;5;23;.821;3566000;0
7576;173961;73;0;0;0;0;.00nan;0;0
7576;78820;71;78;40;4;36;.900;3600000;0
7576;91403;71;0;0;0;0;.00nan;0;0
7577;-1;69;0;0;0;0;.00nan;0;0
7577;192547;2564;64;34;4;30;.882;3600000;0
7577;78479;69;90;31;1;30;.968;3600000;0
7577;79141;2564;0;0;0;0;.00nan;0;0
7578;204668;78;56;21;2;19;.905;3600000;0
7578;189902;78;0;0;0;0;.00nan;0;0
7578;179830;157;0;0;0;0;.00nan;0;0
7578;191518;157;37;23;5;18;.783;3600000;0
7579;182467;4922;0;0;0;0;.00nan;0;0
7579;194219;76;65;24;3;21;.875;3600000;0
7579;205121;4922;82;55;5;50;.909;3599000;0
7579;184175;76;0;0;0;0;.00nan;0;0
7580;187699;158;0;0;0;0;.00nan;0;0
7580;57215;152;0;0;0;0;.00nan;0;0
7580;86862;158;68;45;5;40;.889;3595000;0
7580;86875;152;69;28;3;25;.893;3600000;0
7581;178695;81;68;43;5;38;.884;3559000;0
7581;173918;151;48;20;3;17;.850;3600000;0
7581;176915;151;0;0;0;0;.00nan;0;0
7581;86228;81;0;0;0;0;.00nan;0;0
7582;183737;72;0;0;0;0;.00nan;0;0
7582;189885;4921;0;0;0;0;.00nan;0;0
7582;197912;4921;86;61;5;56;.918;3600000;0
7582;91212;72;73;19;1;18;.947;3600000;0
7583;192547;2564;89;37;2;35;.946;3600000;0
7583;192552;75;0;0;0;0;.00nan;0;0
7583;79141;2564;0;0;0;0;.00nan;0;0
7583;86394;75;72;18;1;17;.944;3600000;0
7584;195251;85;83;28;2;26;.929;3600000;0
7584;-1;85;0;0;0;0;.00nan;0;0
7584;179830;157;0;0;0;0;.00nan;0;0
7584;191518;157;88;24;1;23;.958;3600000;0
7585;187699;158;100;39;2;37;.949;3600000;0
7585;170598;80;53;24;3;21;.875;3548000;0
7585;58100;80;0;0;0;0;.00nan;0;0
7585;86862;158;0;0;0;0;.00nan;0;0
7586;161535;4245;0;0;0;0;.00nan;0;0
7586;200233;4245;45;28;4;24;.857;3525000;0
7586;179344;67;66;27;3;24;.889;3600000;0
7586;-1;67;0;0;0;0;.00nan;0;0
7587;178394;1095;0;0;0;0;.00nan;0;0
7587;186451;1095;64;15;1;14;.933;3600000;0
7587;78820;71;82;41;3;38;.927;3563000;0
7587;91403;71;0;0;0;0;.00nan;0;0
7588;199437;77;55;38;5;33;.868;3600000;0
7588;184788;77;0;0;0;0;.00nan;0;0
7588;192547;2564;84;21;1;20;.952;3600000;0
7588;79141;2564;0;0;0;0;.00nan;0;0
7589;184069;73;0;0;0;0;.00nan;0;0
7589;173961;73;54;12;1;11;.917;3600000;0
7589;170598;80;64;29;3;26;.897;3555000;0
7589;58100;80;0;0;0;0;.00nan;0;0
7590;183737;72;0;0;0;0;.00nan;0;0
7590;189885;4921;0;0;0;0;.00nan;0;0
7590;197912;4921;85;52;3;49;.942;3600000;0
7590;91212;72;26;20;5;15;.750;3560000;0
7591;203276;82;21;27;6;21;.778;3600000;0
7591;182467;4922;0;0;0;0;.00nan;0;0
7591;205121;4922;76;37;3;34;.919;3600000;0
7591;185800;82;0;0;0;0;.00nan;0;0
7592;163989;149;26;28;6;22;.786;2781000;0
7592;-1;69;63;44;5;39;.886;3600000;0
7592;78479;69;0;0;0;0;.00nan;0;0
7592;85546;149;58;7;0;7;1.000;819000;0
7593;178695;81;56;33;4;29;.879;3562000;0
7593;57215;152;0;0;0;0;.00nan;0;0
7593;86228;81;0;0;0;0;.00nan;0;0
7593;86875;152;65;30;3;27;.900;3600000;0
7594;203179;4620;0;0;0;0;.00nan;0;0
7594;191574;4920;85;35;2;33;.943;3600000;0
7594;-1;4920;0;0;0;0;.00nan;0;0
7594;-1;4620;61;47;6;41;.872;3600000;0
7595;189081;1097;49;2;0;2;1.000;691000;0
7595;200390;1096;0;0;0;0;.00nan;0;0
7595;200572;1097;52;43;6;37;.860;2909000;0
7595;-1;1096;95;26;0;26;1.000;3600000;0
7596;194219;76;92;42;3;39;.929;3600000;0
7596;184175;76;0;0;0;0;.00nan;0;0
7596;192552;75;0;0;0;0;.00nan;0;0
7596;86394;75;62;27;4;23;.852;3547000;0
7597;195251;85;0;0;0;0;.00nan;0;0
7597;-1;85;32;37;6;31;.838;3600000;0
7597;179830;157;0;0;0;0;.00nan;0;0
7597;191518;157;49;25;4;21;.840;3600000;0
7598;173918;151;0;0;0;0;.00nan;0;0
7598;176136;74;88;46;2;44;.957;3551000;0
7598;176915;151;90;34;1;33;.971;3600000;0
7598;-1;74;0;0;0;0;.00nan;0;0
7599;161535;4245;0;0;0;0;.00nan;0;0
7599;200233;4245;67;26;3;23;.885;3900000;0
7599;179344;67;0;0;0;0;.00nan;0;0
7599;-1;67;100;54;3;51;.944;3900000;0
7600;178394;1095;88;47;3;44;.936;3771000;0
7600;186451;1095;0;0;0;0;.00nan;0;0
7600;78820;71;59;30;4;26;.867;3771000;0
7600;91403;71;0;0;0;0;.00nan;0;0
7601;199437;77;37;32;6;26;.813;3837000;0
7601;184788;77;0;0;0;0;.00nan;0;0
7601;192547;2564;0;0;0;0;.00nan;0;0
7601;79141;2564;60;40;5;35;.875;3837000;0
7602;184069;73;20;16;5;11;.688;3600000;0
7602;173961;73;0;0;0;0;.00nan;0;0
7602;170598;80;0;0;0;0;.00nan;0;0
7602;58100;80;80;34;2;32;.941;3600000;0
7603;183737;72;75;21;1;20;.952;3600000;0
7603;189885;4921;70;36;3;33;.917;3600000;0
7603;197912;4921;0;0;0;0;.00nan;0;0
7603;91212;72;0;0;0;0;.00nan;0;0
7604;182467;4922;0;0;0;0;.00nan;0;0
7604;205121;4922;100;50;2;48;.960;3900000;0
7604;192552;75;0;0;0;0;.00nan;0;0
7604;86394;75;55;18;2;16;.889;3900000;0
7605;163989;149;0;0;0;0;.00nan;0;0
7605;-1;69;0;0;0;0;.00nan;0;0
7605;78479;69;34;24;4;20;.833;3600000;0
7605;85546;149;84;27;1;26;.963;3600000;0
7606;178695;81;90;34;1;33;.971;3600000;0
7606;57215;152;77;36;3;33;.917;3558000;0
7606;86228;81;0;0;0;0;.00nan;0;0
7606;86875;152;0;0;0;0;.00nan;0;0
7607;203179;4620;60;26;2;24;.923;3900000;0
7607;161535;4245;88;39;2;37;.949;3900000;0
7607;200233;4245;0;0;0;0;.00nan;0;0
7607;-1;4620;0;0;0;0;.00nan;0;0
7608;203276;82;0;0;0;0;.00nan;0;0
7608;194219;76;0;0;0;0;.00nan;0;0
7608;184175;76;57;18;2;16;.889;3553000;0
7608;185800;82;100;36;1;35;.972;3600000;0
7609;189081;1097;75;33;3;30;.909;3600000;0
7609;200390;1096;75;38;4;34;.895;3554000;0
7609;200572;1097;0;0;0;0;.00nan;0;0
7609;-1;1096;0;0;0;0;.00nan;0;0
7610;195251;85;94;50;4;46;.920;3825000;0
7610;-1;85;0;0;0;0;.00nan;0;0
7610;179830;157;0;0;0;0;.00nan;0;0
7610;191518;157;63;26;3;23;.885;3825000;0
7611;173918;151;66;23;2;21;.913;3600000;0
7611;176136;74;99;47;1;46;.979;3600000;0
7611;176915;151;0;0;0;0;.00nan;0;0
7611;-1;74;0;0;0;0;.00nan;0;0
7612;179344;67;89;41;2;39;.951;3600000;0
7612;-1;67;0;0;0;0;.00nan;0;0
7612;191574;4920;48;0;0;0;.00nan;293000;0
7612;-1;4920;16;14;6;8;.571;3307000;0
7613;200390;1096;0;0;0;0;.00nan;0;0
7613;-1;1096;47;33;5;28;.848;3600000;0
7613;192547;2564;21;31;7;24;.774;3031000;0
7613;79141;2564;49;2;0;2;1.000;557000;0
7614;178394;1095;0;0;0;0;.00nan;0;0
7614;184069;73;0;0;0;0;.00nan;0;0
7614;173961;73;49;40;6;34;.850;3687000;0
7614;186451;1095;65;42;5;37;.881;3687000;0
7615;182467;4922;63;38;5;33;.868;3600000;0
7615;199437;77;0;0;0;0;.00nan;0;0
7615;205121;4922;0;0;0;0;.00nan;0;0
7615;184788;77;93;32;1;31;.969;3600000;0
7616;163989;149;83;38;3;35;.921;3548000;0
7616;-1;69;71;25;2;23;.920;3600000;0
7616;78479;69;0;0;0;0;.00nan;0;0
7616;85546;149;0;0;0;0;.00nan;0;0
7617;203179;4620;0;0;0;0;.00nan;0;0
7617;161535;4245;0;0;0;0;.00nan;0;0
7617;200233;4245;94;53;3;50;.943;3702000;0
7617;-1;4620;75;26;2;24;.923;3702000;0
7618;203276;82;24;27;6;21;.778;1854000;0
7618;194219;76;38;15;4;11;.733;3600000;0
7618;184175;76;0;0;0;0;.00nan;0;0
7618;185800;82;58;13;1;12;.923;1746000;0
7619;189081;1097;0;0;0;0;.00nan;0;0
7619;200572;1097;62;35;4;31;.886;3558000;0
7619;192552;75;0;0;0;0;.00nan;0;0
7619;86394;75;59;18;2;16;.889;3600000;0
7620;173918;151;0;0;0;0;.00nan;0;0
7620;176136;74;61;40;5;35;.875;3600000;0
7620;176915;151;75;28;1;27;.964;3600000;0
7620;-1;74;0;0;0;0;.00nan;0;0
7621;183737;72;0;0;0;0;.00nan;0;0
7621;184069;73;77;39;3;36;.923;3600000;0
7621;173961;73;0;0;0;0;.00nan;0;0
7621;91212;72;100;34;0;34;1.000;3600000;0
7622;179344;67;93;47;3;44;.936;3600000;0
7622;-1;67;0;0;0;0;.00nan;0;0
7622;191574;4920;64;16;1;15;.938;3600000;0
7622;-1;4920;0;0;0;0;.00nan;0;0
7623;163989;149;57;28;3;25;.893;3600000;0
7623;57215;152;0;0;0;0;.00nan;0;0
7623;85546;149;0;0;0;0;.00nan;0;0
7623;86875;152;70;29;2;27;.931;3600000;0
7624;178394;1095;42;25;4;21;.840;3530000;0
7624;186451;1095;0;0;0;0;.00nan;0;0
7624;192547;2564;0;0;0;0;.00nan;0;0
7624;79141;2564;95;38;2;36;.947;3600000;0
7625;203276;82;43;40;7;33;.825;2964000;0
7625;189081;1097;0;0;0;0;.00nan;0;0
7625;200572;1097;28;12;4;8;.667;3600000;0
7625;185800;82;63;9;0;9;1.000;636000;0
7626;-1;69;0;0;0;0;.00nan;0;0
7626;78479;69;90;45;3;42;.933;3566000;0
7626;78820;71;60;16;1;15;.938;3600000;0
7626;91403;71;0;0;0;0;.00nan;0;0
7627;170598;80;0;0;0;0;.00nan;0;0
7627;179830;157;0;0;0;0;.00nan;0;0
7627;191518;157;84;27;1;26;.963;3600000;0
7627;58100;80;61;28;3;25;.893;3583000;0
7628;182467;4922;0;0;0;0;.00nan;0;0
7628;205121;4922;84;39;3;36;.923;3600000;0
7628;195251;85;0;0;0;0;.00nan;0;0
7628;-1;85;52;27;4;23;.852;3541000;0
7629;176136;74;71;49;5;44;.898;3600000;0
7629;-1;74;0;0;0;0;.00nan;0;0
7629;191574;4920;87;27;1;26;.963;3600000;0
7629;-1;4920;0;0;0;0;.00nan;0;0
7630;163989;149;88;41;3;38;.927;3808000;0
7630;57215;152;0;0;0;0;.00nan;0;0
7630;85546;149;0;0;0;0;.00nan;0;0
7630;86875;152;65;26;2;24;.923;3808000;0
7631;200390;1096;61;24;2;22;.917;3600000;0
7631;195251;85;51;48;7;41;.854;3600000;0
7631;-1;85;0;0;0;0;.00nan;0;0
7631;-1;1096;0;0;0;0;.00nan;0;0
7632;203276;82;69;40;4;36;.900;3542000;0
7632;189081;1097;0;0;0;0;.00nan;0;0
7632;200572;1097;56;13;2;11;.846;3600000;0
7632;185800;82;0;0;0;0;.00nan;0;0
7633;170598;80;74;23;1;22;.957;3600000;0
7633;179830;157;0;0;0;0;.00nan;0;0
7633;191518;157;69;32;3;29;.906;3546000;0
7633;58100;80;0;0;0;0;.00nan;0;0
7634;178394;1095;0;0;0;0;.00nan;0;0
7634;184069;73;44;29;5;24;.828;3600000;0
7634;173961;73;0;0;0;0;.00nan;0;0
7634;186451;1095;77;26;2;24;.923;3600000;0
7635;187699;158;100;27;0;27;1.000;3600000;0
7635;189885;4921;0;0;0;0;.00nan;0;0
7635;197912;4921;81;37;3;34;.919;3600000;0
7635;86862;158;0;0;0;0;.00nan;0;0
7636;182467;4922;0;0;0;0;.00nan;0;0
7636;199437;77;28;24;5;19;.792;3600000;0
7636;205121;4922;86;38;2;36;.947;3600000;0
7636;184788;77;0;0;0;0;.00nan;0;0
7637;203179;4620;0;0;0;0;.00nan;0;0
7637;204668;78;0;0;0;0;.00nan;0;0
7637;189902;78;87;34;2;32;.941;3600000;0
7637;-1;4620;57;27;3;24;.889;3543000;0
7638;178695;81;36;15;4;11;.733;956000;0
7638;173918;151;0;0;0;0;.00nan;0;0
7638;176915;151;56;42;6;36;.857;3869000;0
7638;86228;81;97;38;1;37;.974;2913000;0
7639;161535;4245;0;0;0;0;.00nan;0;0
7639;200233;4245;58;19;2;17;.895;3600000;0
7639;179344;67;75;47;3;44;.936;3583000;0
7639;-1;67;0;0;0;0;.00nan;0;0
7640;194219;76;80;40;3;37;.925;3571000;0
7640;184175;76;0;0;0;0;.00nan;0;0
7640;192552;75;0;0;0;0;.00nan;0;0
7640;86394;75;74;25;2;23;.920;3600000;0
7641;192547;2564;72;30;3;27;.900;3547000;0
7641;78820;71;91;40;2;38;.950;3600000;0
7641;79141;2564;0;0;0;0;.00nan;0;0
7641;91403;71;0;0;0;0;.00nan;0;0
7642;183737;72;0;0;0;0;.00nan;0;0
7642;-1;69;100;37;1;36;.973;3600000;0
7642;78479;69;0;0;0;0;.00nan;0;0
7642;91212;72;58;34;4;30;.882;3600000;0
7643;176136;74;78;31;2;29;.935;3600000;0
7643;-1;74;0;0;0;0;.00nan;0;0
7643;191574;4920;0;0;0;0;.00nan;0;0
7643;-1;4920;73;23;1;22;.957;3600000;0
7644;163989;149;0;0;0;0;.00nan;0;0
7644;57215;152;47;24;4;20;.833;3576000;0
7644;85546;149;99;49;3;46;.939;3600000;0
7644;86875;152;0;0;0;0;.00nan;0;0
7645;194219;76;0;0;0;0;.00nan;0;0
7645;200390;1096;0;0;0;0;.00nan;0;0
7645;184175;76;89;28;1;27;.964;3600000;0
7645;-1;1096;81;39;3;36;.923;3576000;0
7646;178394;1095;77;14;0;14;1.000;3600000;0
7646;-1;69;0;0;0;0;.00nan;0;0
7646;186451;1095;0;0;0;0;.00nan;0;0
7646;78479;69;87;44;2;42;.955;3577000;0
7647;203276;82;54;14;1;13;.929;1379000;0
7647;189081;1097;88;18;0;18;1.000;3600000;0
7647;200572;1097;0;0;0;0;.00nan;0;0
7647;185800;82;24;26;6;20;.769;2221000;0
7648;170598;80;0;0;0;0;.00nan;0;0
7648;179830;157;78;16;1;15;.938;3600000;0
7648;191518;157;0;0;0;0;.00nan;0;0
7648;58100;80;76;41;3;38;.927;3600000;0
7649;184069;73;0;0;0;0;.00nan;0;0
7649;173961;73;50;15;2;13;.867;3600000;0
7649;192547;2564;0;0;0;0;.00nan;0;0
7649;79141;2564;95;57;4;53;.930;3600000;0
7650;187699;158;69;30;4;26;.867;3627000;0
7650;189885;4921;77;38;3;35;.921;3627000;0
7650;197912;4921;0;0;0;0;.00nan;0;0
7650;86862;158;0;0;0;0;.00nan;0;0
7651;182467;4922;97;37;1;36;.973;3900000;0
7651;199437;77;70;18;1;17;.944;3900000;0
7651;205121;4922;0;0;0;0;.00nan;0;0
7651;184788;77;0;0;0;0;.00nan;0;0
7652;203179;4620;10;17;6;11;.647;1321000;0
7652;204668;78;44;32;6;26;.813;3600000;0
7652;189902;78;0;0;0;0;.00nan;0;0
7652;-1;4620;66;12;1;11;.917;2250000;0
7653;178695;81;95;52;4;48;.923;3600000;0
7653;173918;151;94;23;0;23;1.000;3600000;0
7653;176915;151;0;0;0;0;.00nan;0;0
7653;86228;81;0;0;0;0;.00nan;0;0
7654;161535;4245;77;30;2;28;.933;3600000;0
7654;200233;4245;0;0;0;0;.00nan;0;0
7654;179344;67;0;0;0;0;.00nan;0;0
7654;-1;67;75;37;5;32;.865;3600000;0
7655;195251;85;0;0;0;0;.00nan;0;0
7655;-1;85;80;50;5;45;.900;3600000;0
7655;192552;75;53;27;4;23;.852;3600000;0
7655;86394;75;0;0;0;0;.00nan;0;0
7656;183737;72;65;29;3;26;.897;3600000;0
7656;78820;71;56;30;4;26;.867;3561000;0
7656;91212;72;0;0;0;0;.00nan;0;0
7656;91403;71;0;0;0;0;.00nan;0;0
7657;176136;74;84;42;3;39;.929;3579000;0
7657;-1;74;0;0;0;0;.00nan;0;0
7657;191574;4920;63;21;2;19;.905;3600000;0
7657;-1;4920;0;0;0;0;.00nan;0;0
7658;184069;73;57;19;2;17;.895;3600000;0
7658;173961;73;0;0;0;0;.00nan;0;0
7658;-1;69;84;51;4;47;.922;3562000;0
7658;78479;69;0;0;0;0;.00nan;0;0
7659;187699;158;0;0;0;0;.00nan;0;0
7659;189885;4921;0;0;0;0;.00nan;0;0
7659;197912;4921;60;41;5;36;.878;3900000;0
7659;86862;158;64;36;5;31;.861;3900000;0
7660;203179;4620;0;0;0;0;.00nan;0;0
7660;204668;78;0;0;0;0;.00nan;0;0
7660;189902;78;64;26;3;23;.885;3692000;0
7660;-1;4620;88;37;2;35;.946;3692000;0
7661;178695;81;89;25;1;24;.960;3600000;0
7661;173918;151;60;29;3;26;.897;3571000;0
7661;176915;151;0;0;0;0;.00nan;0;0
7661;86228;81;0;0;0;0;.00nan;0;0
7662;161535;4245;0;0;0;0;.00nan;0;0
7662;200233;4245;36;20;4;16;.800;3600000;0
7662;179344;67;41;36;6;30;.833;3600000;0
7662;-1;67;0;0;0;0;.00nan;0;0
7663;195251;85;91;65;4;61;.938;3600000;0
7663;-1;85;0;0;0;0;.00nan;0;0
7663;192552;75;0;0;0;0;.00nan;0;0
7663;86394;75;89;14;0;14;1.000;3600000;0
7664;183737;72;0;0;0;0;.00nan;0;0
7664;178394;1095;76;49;5;44;.898;3600000;0
7664;186451;1095;0;0;0;0;.00nan;0;0
7664;91212;72;62;23;2;21;.913;3600000;0
7665;184069;73;56;11;1;10;.909;3600000;0
7665;173961;73;0;0;0;0;.00nan;0;0
7665;192547;2564;0;0;0;0;.00nan;0;0
7665;79141;2564;89;53;4;49;.925;3600000;0
7666;189885;4921;0;0;0;0;.00nan;0;0
7666;197912;4921;84;29;2;27;.931;3600000;0
7666;57215;152;0;0;0;0;.00nan;0;0
7666;86875;152;64;25;3;22;.880;3600000;0
7667;163989;149;63;25;3;22;.880;3600000;0
7667;178695;81;84;46;4;42;.913;3598000;0
7667;85546;149;0;0;0;0;.00nan;0;0
7667;86228;81;0;0;0;0;.00nan;0;0
7668;161535;4245;0;0;0;0;.00nan;0;0
7668;200233;4245;68;28;3;25;.893;3600000;0
7668;195251;85;0;0;0;0;.00nan;0;0
7668;-1;85;88;58;5;53;.914;3551000;0
7669;173918;151;0;0;0;0;.00nan;0;0
7669;176915;151;34;37;6;31;.838;3900000;0
7669;179830;157;58;4;0;4;1.000;1126000;0
7669;191518;157;26;25;6;19;.760;2774000;0
7670;204668;78;0;0;0;0;.00nan;0;0
7670;189902;78;52;14;2;12;.857;3600000;0
7670;179344;67;67;34;3;31;.912;3544000;0
7670;-1;67;0;0;0;0;.00nan;0;0
7671;199437;77;51;20;3;17;.850;3600000;0
7671;189081;1097;52;41;6;35;.854;3600000;0
7671;200572;1097;0;0;0;0;.00nan;0;0
7671;184788;77;0;0;0;0;.00nan;0;0
7672;182467;4922;0;0;0;0;.00nan;0;0
7672;194219;76;45;11;2;9;.818;3600000;0
7672;205121;4922;78;52;4;48;.923;3583000;0
7672;184175;76;0;0;0;0;.00nan;0;0
7673;161535;4245;0;0;0;0;.00nan;0;0
7673;200233;4245;95;48;2;46;.958;3600000;0
7673;191574;4920;37;15;3;12;.800;3600000;0
7673;-1;4920;0;0;0;0;.00nan;0;0
7674;203276;82;81;36;3;33;.917;3600000;0
7674;182467;4922;0;0;0;0;.00nan;0;0
7674;205121;4922;52;30;4;26;.867;3548000;0
7674;185800;82;0;0;0;0;.00nan;0;0
7675;184069;73;32;33;6;27;.818;3600000;0
7675;173961;73;0;0;0;0;.00nan;0;0
7675;78820;71;81;36;3;33;.917;3600000;0
7675;91403;71;0;0;0;0;.00nan;0;0
7676;199437;77;72;38;4;34;.895;3900000;0
7676;184788;77;0;0;0;0;.00nan;0;0
7676;192552;75;0;0;0;0;.00nan;0;0
7676;86394;75;55;26;4;22;.846;3900000;0
7677;178394;1095;50;20;3;17;.850;3544000;0
7677;-1;69;100;41;2;39;.951;3600000;0
7677;186451;1095;0;0;0;0;.00nan;0;0
7677;78479;69;0;0;0;0;.00nan;0;0
7678;189885;4921;0;0;0;0;.00nan;0;0
7678;197912;4921;14;37;8;29;.784;3600000;0
7678;57215;152;0;0;0;0;.00nan;0;0
7678;86875;152;68;25;2;23;.920;3600000;0
7679;200390;1096;64;47;5;42;.894;3600000;0
7679;176136;74;91;31;1;30;.968;3600000;0
7679;-1;1096;0;0;0;0;.00nan;0;0
7679;-1;74;0;0;0;0;.00nan;0;0
7680;163989;149;74;27;2;25;.926;3600000;0
7680;178695;81;46;28;5;23;.821;3600000;0
7680;85546;149;0;0;0;0;.00nan;0;0
7680;86228;81;0;0;0;0;.00nan;0;0
7681;194219;76;0;0;0;0;.00nan;0;0
7681;189081;1097;0;0;0;0;.00nan;0;0
7681;200572;1097;65;36;4;32;.889;3600000;0
7681;184175;76;99;38;1;37;.974;3600000;0
7682;183737;72;0;0;0;0;.00nan;0;0
7682;192547;2564;67;26;2;24;.923;3589000;0
7682;79141;2564;0;0;0;0;.00nan;0;0
7682;91212;72;72;21;1;20;.952;3600000;0
7683;203179;4620;0;0;0;0;.00nan;0;0
7683;195251;85;51;39;6;33;.846;3030000;0
7683;-1;85;55;4;0;4;1.000;570000;0
7683;-1;4620;70;21;2;19;.905;3600000;0
7684;187699;158;56;24;4;20;.833;3701000;0
7684;170598;80;0;0;0;0;.00nan;0;0
7684;58100;80;60;30;3;27;.900;3701000;0
7684;86862;158;0;0;0;0;.00nan;0;0
7685;173918;151;69;27;3;24;.889;3557000;0
7685;176915;151;0;0;0;0;.00nan;0;0
7685;179830;157;0;0;0;0;.00nan;0;0
7685;191518;157;87;33;1;32;.970;3600000;0
7686;204668;78;39;15;4;11;.733;2047000;0
7686;189902;78;52;17;2;15;.882;1553000;0
7686;179344;67;82;33;2;31;.939;3600000;0
7686;-1;67;0;0;0;0;.00nan;0;0
7687;161535;4245;53;46;6;40;.870;3600000;0
7687;200233;4245;0;0;0;0;.00nan;0;0
7687;191574;4920;0;0;0;0;.00nan;0;0
7687;-1;4920;70;34;3;31;.912;3600000;0
7688;183737;72;73;27;2;25;.926;3900000;0
7688;178394;1095;0;0;0;0;.00nan;0;0
7688;186451;1095;73;25;2;23;.920;3900000;0
7688;91212;72;0;0;0;0;.00nan;0;0
7689;203276;82;65;42;5;37;.881;3530000;0
7689;182467;4922;58;30;3;27;.900;3600000;0
7689;205121;4922;0;0;0;0;.00nan;0;0
7689;185800;82;0;0;0;0;.00nan;0;0
7690;-1;69;0;0;0;0;.00nan;0;0
7690;78479;69;90;44;3;41;.932;3580000;0
7690;78820;71;72;19;1;18;.947;3600000;0
7690;91403;71;0;0;0;0;.00nan;0;0
7691;189885;4921;41;29;5;24;.828;3600000;0
7691;197912;4921;0;0;0;0;.00nan;0;0
7691;57215;152;24;27;6;21;.778;3244000;0
7691;86875;152;54;4;0;4;1.000;336000;0
7692;200390;1096;48;0;0;0;.00nan;387000;0
7692;176136;74;0;0;0;0;.00nan;0;0
7692;-1;1096;44;37;6;31;.838;3213000;0
7692;-1;74;63;20;2;18;.900;3600000;0
7693;194219;76;61;32;4;28;.875;3865000;0
7693;189081;1097;81;49;4;45;.918;3900000;0
7693;200572;1097;0;0;0;0;.00nan;0;0
7693;184175;76;0;0;0;0;.00nan;0;0
7694;163989;149;90;42;3;39;.929;3680000;0
7694;178695;81;0;0;0;0;.00nan;0;0
7694;85546;149;0;0;0;0;.00nan;0;0
7694;86228;81;56;24;4;20;.833;3680000;0
7695;199437;77;0;0;0;0;.00nan;0;0
7695;184788;77;47;28;4;24;.857;3523000;0
7695;192552;75;0;0;0;0;.00nan;0;0
7695;86394;75;66;26;2;24;.923;3600000;0
7696;184069;73;0;0;0;0;.00nan;0;0
7696;173961;73;71;25;2;23;.920;3543000;0
7696;192547;2564;0;0;0;0;.00nan;0;0
7696;79141;2564;73;23;1;22;.957;3600000;0
7697;203179;4620;75;17;1;16;.941;3600000;0
7697;195251;85;35;26;6;20;.769;1775000;0
7697;-1;85;40;31;6;25;.806;1825000;0
7697;-1;4620;0;0;0;0;.00nan;0;0
7698;173918;151;0;0;0;0;.00nan;0;0
7698;176915;151;65;36;4;32;.889;3553000;0
7698;179830;157;0;0;0;0;.00nan;0;0
7698;191518;157;60;31;3;28;.903;3600000;0
7699;187699;158;0;0;0;0;.00nan;0;0
7699;170598;80;82;27;1;26;.963;3600000;0
7699;58100;80;0;0;0;0;.00nan;0;0
7699;86862;158;64;28;3;25;.893;3555000;0
7700;204668;78;0;0;0;0;.00nan;0;0
7700;189902;78;97;22;0;22;1.000;3600000;0
7700;179344;67;0;0;0;0;.00nan;0;0
7700;-1;67;88;36;2;34;.944;3514000;0
7701;178394;1095;61;24;4;20;.833;3600000;0
7701;-1;69;40;28;5;23;.821;2372000;0
7701;186451;1095;0;0;0;0;.00nan;0;0
7701;78479;69;54;12;1;11;.917;1211000;0
7702;178695;81;63;33;4;29;.879;3546000;0
7702;179830;157;0;0;0;0;.00nan;0;0
7702;191518;157;64;32;3;29;.906;3600000;0
7702;86228;81;0;0;0;0;.00nan;0;0
7703;183737;72;0;0;0;0;.00nan;0;0
7703;184069;73;81;29;2;27;.931;3600000;0
7703;173961;73;0;0;0;0;.00nan;0;0
7703;91212;72;53;37;4;33;.892;3514000;0
7704;189885;4921;0;0;0;0;.00nan;0;0
7704;192547;2564;45;26;4;22;.846;3546000;0
7704;197912;4921;76;36;3;33;.917;3600000;0
7704;79141;2564;0;0;0;0;.00nan;0;0
7705;161535;4245;0;0;0;0;.00nan;0;0
7705;200233;4245;72;37;3;34;.919;3600000;0
7705;176136;74;59;45;5;40;.889;3600000;0
7705;-1;74;0;0;0;0;.00nan;0;0
7706;203179;4620;0;0;0;0;.00nan;0;0
7706;195251;85;69;14;0;14;1.000;1162000;0
7706;-1;85;35;34;6;28;.824;2410000;0
7706;-1;4620;25;17;5;12;.706;3600000;0
7707;173918;151;0;0;0;0;.00nan;0;0
7707;176915;151;74;21;1;20;.952;3600000;0
7707;57215;152;0;0;0;0;.00nan;0;0
7707;86875;152;80;34;2;32;.941;3563000;0
7708;187699;158;77;31;3;28;.903;3900000;0
7708;163989;149;58;30;3;27;.900;3900000;0
7708;85546;149;0;0;0;0;.00nan;0;0
7708;86862;158;0;0;0;0;.00nan;0;0
7709;203276;82;40;22;4;18;.818;1462000;0
7709;200390;1096;73;8;0;8;1.000;3600000;0
7709;-1;1096;0;0;0;0;.00nan;0;0
7709;185800;82;18;28;7;21;.750;2138000;0
7710;189081;1097;0;0;0;0;.00nan;0;0
7710;200572;1097;62;27;3;24;.889;3576000;0
7710;192552;75;0;0;0;0;.00nan;0;0
7710;86394;75;88;30;2;28;.933;3600000;0
7711;163989;149;56;37;5;32;.865;3600000;0
7711;191574;4920;81;13;0;13;1.000;3600000;0
7711;-1;4920;0;0;0;0;.00nan;0;0
7711;85546;149;0;0;0;0;.00nan;0;0
7712;203276;82;51;39;6;33;.846;2236000;0
7712;200390;1096;56;26;4;22;.846;3600000;0
7712;-1;1096;0;0;0;0;.00nan;0;0
7712;185800;82;53;17;2;15;.882;1364000;0
7713;178394;1095;61;14;1;13;.929;3600000;0
7713;-1;69;0;0;0;0;.00nan;0;0
7713;186451;1095;0;0;0;0;.00nan;0;0
7713;78479;69;94;46;3;43;.935;3540000;0
7714;178695;81;62;34;4;30;.882;3556000;0
7714;179830;157;0;0;0;0;.00nan;0;0
7714;191518;157;74;25;2;23;.920;3600000;0
7714;86228;81;0;0;0;0;.00nan;0;0
7715;189885;4921;0;0;0;0;.00nan;0;0
7715;192547;2564;0;0;0;0;.00nan;0;0
7715;197912;4921;75;44;5;39;.886;3600000;0
7715;79141;2564;47;15;2;13;.867;3600000;0
7716;203179;4620;0;0;0;0;.00nan;0;0
7716;179344;67;54;32;4;28;.875;3581000;0
7716;-1;67;0;0;0;0;.00nan;0;0
7716;-1;4620;57;19;2;17;.895;3600000;0
7717;204668;78;0;0;0;0;.00nan;0;0
7717;195251;85;100;62;2;60;.968;3900000;0
7717;189902;78;58;17;2;15;.882;3900000;0
7717;-1;85;0;0;0;0;.00nan;0;0
7718;161535;4245;0;0;0;0;.00nan;0;0
7718;200233;4245;54;35;5;30;.857;3600000;0
7718;176136;74;100;31;0;31;1.000;3600000;0
7718;-1;74;0;0;0;0;.00nan;0;0
7719;199437;77;92;50;2;48;.960;3600000;0
7719;194219;76;44;19;3;16;.842;3570000;0
7719;184175;76;0;0;0;0;.00nan;0;0
7719;184788;77;0;0;0;0;.00nan;0;0
7720;189081;1097;71;41;4;37;.902;3600000;0
7720;200572;1097;0;0;0;0;.00nan;0;0
7720;192552;75;58;14;2;12;.857;3600000;0
7720;86394;75;0;0;0;0;.00nan;0;0
7721;187699;158;61;18;2;16;.889;3600000;0
7721;170598;80;73;35;3;32;.914;3584000;0
7721;58100;80;0;0;0;0;.00nan;0;0
7721;86862;158;0;0;0;0;.00nan;0;0
7722;173918;151;0;0;0;0;.00nan;0;0
7722;176915;151;50;27;4;23;.852;3547000;0
7722;57215;152;0;0;0;0;.00nan;0;0
7722;86875;152;78;34;3;31;.912;3600000;0
7723;183737;72;0;0;0;0;.00nan;0;0
7723;78820;71;93;35;2;33;.943;3600000;0
7723;91212;72;52;44;6;38;.864;3600000;0
7723;91403;71;0;0;0;0;.00nan;0;0
7724;163989;149;0;0;0;0;.00nan;0;0
7724;191574;4920;0;0;0;0;.00nan;0;0
7724;-1;4920;57;21;2;19;.905;3600000;0
7724;85546;149;70;46;4;42;.913;3588000;0
7725;184069;73;51;31;4;27;.871;3600000;0
7725;173961;73;0;0;0;0;.00nan;0;0
7725;78820;71;75;27;2;25;.926;3600000;0
7725;91403;71;0;0;0;0;.00nan;0;0
7726;178695;81;37;32;6;26;.813;3600000;0
7726;179830;157;48;21;3;18;.857;3600000;0
7726;191518;157;0;0;0;0;.00nan;0;0
7726;86228;81;0;0;0;0;.00nan;0;0
7727;189885;4921;87;45;3;42;.933;3559000;0
7727;192547;2564;54;16;2;14;.875;3600000;0
7727;197912;4921;0;0;0;0;.00nan;0;0
7727;79141;2564;0;0;0;0;.00nan;0;0
7728;178394;1095;0;0;0;0;.00nan;0;0
7728;-1;69;95;47;3;44;.936;3572000;0
7728;186451;1095;77;21;1;20;.952;3600000;0
7728;78479;69;0;0;0;0;.00nan;0;0
7729;204668;78;44;26;4;22;.846;3551000;0
7729;195251;85;0;0;0;0;.00nan;0;0
7729;189902;78;0;0;0;0;.00nan;0;0
7729;-1;85;97;48;3;45;.938;3600000;0
7730;161535;4245;71;38;5;33;.868;3600000;0
7730;200233;4245;0;0;0;0;.00nan;0;0
7730;176136;74;60;34;5;29;.853;2638000;0
7730;-1;74;8;16;6;10;.625;962000;0
7731;199437;77;0;0;0;0;.00nan;0;0
7731;194219;76;0;0;0;0;.00nan;0;0
7731;184175;76;93;30;1;29;.967;3600000;0
7731;184788;77;63;28;2;26;.929;3569000;0
7732;203276;82;51;46;6;40;.870;3600000;0
7732;189081;1097;0;0;0;0;.00nan;0;0
7732;200572;1097;54;13;2;11;.846;3600000;0
7732;185800;82;0;0;0;0;.00nan;0;0
7733;182467;4922;64;12;0;12;1.000;1438000;0
7733;205121;4922;38;25;5;20;.800;2124000;0
7733;192552;75;0;0;0;0;.00nan;0;0
7733;86394;75;68;40;4;36;.900;3600000;0
7734;173918;151;70;33;3;30;.909;3534000;0
7734;176915;151;0;0;0;0;.00nan;0;0
7734;57215;152;99;37;1;36;.973;3600000;0
7734;86875;152;0;0;0;0;.00nan;0;0
7735;187699;158;0;0;0;0;.00nan;0;0
7735;170598;80;0;0;0;0;.00nan;0;0
7735;58100;80;100;31;0;31;1.000;3600000;0
7735;86862;158;62;40;5;35;.875;3600000;0
7736;203179;4620;40;20;4;16;.800;3671000;0
7736;179344;67;0;0;0;0;.00nan;0;0
7736;-1;67;51;36;5;31;.861;3671000;0
7736;-1;4620;0;0;0;0;.00nan;0;0
7737;163989;149;38;39;6;33;.846;3600000;0
7737;191574;4920;93;21;0;21;1.000;3600000;0
7737;-1;4920;0;0;0;0;.00nan;0;0
7737;85546;149;0;0;0;0;.00nan;0;0
7738;182467;4922;0;0;0;0;.00nan;0;0
7738;205121;4922;85;49;4;45;.918;3591000;0
7738;200390;1096;66;24;2;22;.917;3600000;0
7738;-1;1096;0;0;0;0;.00nan;0;0
7739;-1;69;0;0;0;0;.00nan;0;0
7739;78479;69;62;49;6;43;.878;3600000;0
7739;78820;71;79;28;1;27;.964;3600000;0
7739;91403;71;0;0;0;0;.00nan;0;0
7740;204668;78;0;0;0;0;.00nan;0;0
7740;195251;85;32;17;4;13;.765;847000;0
7740;189902;78;77;23;1;22;.957;3600000;0
7740;-1;85;63;27;3;24;.889;2753000;0
7741;199437;77;83;44;5;39;.886;3600000;0
7741;194219;76;27;6;3;3;.500;424000;0
7741;184175;76;77;16;0;16;1.000;3176000;0
7741;184788;77;0;0;0;0;.00nan;0;0
7742;183737;72;0;0;0;0;.00nan;0;0
7742;184069;73;0;0;0;0;.00nan;0;0
7742;173961;73;61;42;5;37;.881;3517000;0
7742;91212;72;60;21;3;18;.857;3600000;0
7743;187699;158;85;32;1;31;.969;3900000;0
7743;170598;80;92;31;1;30;.968;3900000;0
7743;58100;80;0;0;0;0;.00nan;0;0
7743;86862;158;0;0;0;0;.00nan;0;0
7744;203179;4620;0;0;0;0;.00nan;0;0
7744;179344;67;90;31;1;30;.968;3600000;0
7744;-1;67;0;0;0;0;.00nan;0;0
7744;-1;4620;50;15;2;13;.867;3599000;0
7745;178394;1095;93;33;1;32;.970;3600000;0
7745;186451;1095;0;0;0;0;.00nan;0;0
7745;57215;152;0;0;0;0;.00nan;0;0
7745;86875;152;87;36;2;34;.944;3581000;0
7746;203276;82;98;37;2;35;.946;3900000;0
7746;182467;4922;0;0;0;0;.00nan;0;0
7746;205121;4922;69;26;2;24;.923;3900000;0
7746;185800;82;0;0;0;0;.00nan;0;0
7747;189885;4921;0;0;0;0;.00nan;0;0
7747;-1;69;91;38;2;36;.947;3900000;0
7747;197912;4921;81;29;2;27;.931;3900000;0
7747;78479;69;0;0;0;0;.00nan;0;0
7748;178394;1095;0;0;0;0;.00nan;0;0
7748;186451;1095;51;40;5;35;.875;3600000;0
7748;57215;152;82;31;2;29;.935;3600000;0
7748;86875;152;0;0;0;0;.00nan;0;0
7749;204668;78;0;0;0;0;.00nan;0;0
7749;189902;78;78;25;1;24;.960;3600000;0
7749;176136;74;71;29;2;27;.931;3544000;0
7749;-1;74;0;0;0;0;.00nan;0;0
7750;187699;158;97;51;3;48;.941;3600000;0
7750;178695;81;33;24;5;19;.792;3520000;0
7750;86228;81;0;0;0;0;.00nan;0;0
7750;86862;158;0;0;0;0;.00nan;0;0
7751;203276;82;86;58;4;54;.931;3517000;0
7751;185800;82;0;0;0;0;.00nan;0;0
7751;192552;75;0;0;0;0;.00nan;0;0
7751;86394;75;66;20;2;18;.900;3600000;0
7752;184069;73;100;30;0;30;1.000;3600000;0
7752;173961;73;0;0;0;0;.00nan;0;0
7752;78820;71;77;38;4;34;.895;3600000;0
7752;91403;71;0;0;0;0;.00nan;0;0
7753;199437;77;53;37;5;32;.865;3600000;0
7753;200390;1096;91;33;2;31;.939;3600000;0
7753;184788;77;0;0;0;0;.00nan;0;0
7753;-1;1096;0;0;0;0;.00nan;0;0
7754;173918;151;0;0;0;0;.00nan;0;0
7754;176915;151;40;33;5;28;.848;3600000;0
7754;179830;157;0;0;0;0;.00nan;0;0
7754;191518;157;80;25;1;24;.960;3600000;0
7755;189885;4921;0;0;0;0;.00nan;0;0
7755;-1;69;0;0;0;0;.00nan;0;0
7755;197912;4921;64;30;3;27;.900;3600000;0
7755;78479;69;73;43;4;39;.907;3600000;0
7756;182467;4922;79;56;6;50;.893;3754000;0
7756;189081;1097;0;0;0;0;.00nan;0;0
7756;205121;4922;0;0;0;0;.00nan;0;0
7756;200572;1097;64;37;5;32;.865;3754000;0
7757;203179;4620;0;0;0;0;.00nan;0;0
7757;191574;4920;57;23;3;20;.870;3600000;0
7757;-1;4920;0;0;0;0;.00nan;0;0
7757;-1;4620;67;43;4;39;.907;3600000;0
7758;187699;158;0;0;0;0;.00nan;0;0
7758;178695;81;0;0;0;0;.00nan;0;0
7758;86228;81;69;27;2;25;.926;3600000;0
7758;86862;158;86;39;3;36;.923;3544000;0
7759;161535;4245;59;7;0;7;1.000;721000;0
7759;194219;76;100;39;1;38;.974;3600000;0
7759;200233;4245;49;38;6;32;.842;2879000;0
7759;184175;76;0;0;0;0;.00nan;0;0
7760;195251;85;80;33;2;31;.939;3575000;0
7760;179344;67;0;0;0;0;.00nan;0;0
7760;-1;85;0;0;0;0;.00nan;0;0
7760;-1;67;100;28;0;28;1.000;3600000;0
7761;163989;149;38;26;4;22;.846;3551000;0
7761;170598;80;0;0;0;0;.00nan;0;0
7761;58100;80;83;40;3;37;.925;3600000;0
7761;85546;149;0;0;0;0;.00nan;0;0
7762;183737;72;0;0;0;0;.00nan;0;0
7762;192547;2564;51;25;3;22;.880;3577000;0
7762;79141;2564;0;0;0;0;.00nan;0;0
7762;91212;72;74;28;2;26;.929;3600000;0
7763;203179;4620;82;48;4;44;.917;3600000;0
7763;191574;4920;0;0;0;0;.00nan;0;0
7763;-1;4920;82;27;1;26;.963;3600000;0
7763;-1;4620;0;0;0;0;.00nan;0;0
7764;163989;149;72;32;3;29;.906;3600000;0
7764;170598;80;62;24;2;22;.917;3600000;0
7764;58100;80;0;0;0;0;.00nan;0;0
7764;85546;149;0;0;0;0;.00nan;0;0
7765;203276;82;98;45;3;42;.933;2605000;0
7765;185800;82;32;17;4;13;.765;995000;0
7765;192552;75;0;0;0;0;.00nan;0;0
7765;86394;75;54;11;2;9;.818;3600000;0
7766;173918;151;68;35;4;31;.886;3600000;0
7766;176915;151;0;0;0;0;.00nan;0;0
7766;179830;157;0;0;0;0;.00nan;0;0
7766;191518;157;27;28;6;22;.786;3600000;0
7767;184069;73;50;19;3;16;.842;3600000;0
7767;173961;73;0;0;0;0;.00nan;0;0
7767;-1;69;48;38;6;32;.842;2773000;0
7767;78479;69;66;16;1;15;.938;827000;0
7768;189885;4921;57;33;4;29;.879;3555000;0
7768;197912;4921;0;0;0;0;.00nan;0;0
7768;57215;152;0;0;0;0;.00nan;0;0
7768;86875;152;58;19;3;16;.842;3600000;0
7769;182467;4922;0;0;0;0;.00nan;0;0
7769;205121;4922;50;33;5;28;.848;3809000;0
7769;200390;1096;0;0;0;0;.00nan;0;0
7769;-1;1096;53;28;4;24;.857;3809000;0
7770;204668;78;0;0;0;0;.00nan;0;0
7770;189902;78;66;25;3;22;.880;3767000;0
7770;176136;74;80;30;2;28;.933;3767000;0
7770;-1;74;0;0;0;0;.00nan;0;0
7771;187699;158;57;28;4;24;.857;3577000;0
7771;178695;81;56;25;3;22;.880;3600000;0
7771;86228;81;0;0;0;0;.00nan;0;0
7771;86862;158;0;0;0;0;.00nan;0;0
7772;161535;4245;95;38;2;36;.947;3670000;0
7772;194219;76;0;0;0;0;.00nan;0;0
7772;200233;4245;0;0;0;0;.00nan;0;0
7772;184175;76;62;25;3;22;.880;3670000;0
7773;199437;77;0;0;0;0;.00nan;0;0
7773;189081;1097;66;30;3;27;.900;3533000;0
7773;200572;1097;0;0;0;0;.00nan;0;0
7773;184788;77;84;30;1;29;.967;3600000;0
7774;192547;2564;0;0;0;0;.00nan;0;0
7774;78820;71;70;29;2;27;.931;3600000;0
7774;79141;2564;75;44;5;39;.886;3600000;0
7774;91403;71;0;0;0;0;.00nan;0;0
7775;195251;85;0;0;0;0;.00nan;0;0
7775;179344;67;0;0;0;0;.00nan;0;0
7775;-1;85;83;40;4;36;.900;3600000;0
7775;-1;67;79;24;1;23;.958;3600000;0
7776;183737;72;32;30;6;24;.800;2966000;0
7776;178394;1095;69;35;3;32;.914;3600000;0
7776;186451;1095;0;0;0;0;.00nan;0;0
7776;91212;72;44;6;1;5;.833;634000;0
7777;203179;4620;0;0;0;0;.00nan;0;0
7777;191574;4920;67;25;3;22;.880;3600000;0
7777;-1;4920;0;0;0;0;.00nan;0;0
7777;-1;4620;54;33;5;28;.848;3569000;0
7778;163989;149;0;0;0;0;.00nan;0;0
7778;170598;80;0;0;0;0;.00nan;0;0
7778;58100;80;76;11;0;11;1.000;3600000;0
7778;85546;149;64;34;4;30;.882;3600000;0
7779;192547;2564;64;38;4;34;.895;3600000;0
7779;78820;71;73;16;1;15;.938;3600000;0
7779;79141;2564;0;0;0;0;.00nan;0;0
7779;91403;71;0;0;0;0;.00nan;0;0
7780;199437;77;92;32;1;31;.969;3600000;0
7780;189081;1097;0;0;0;0;.00nan;0;0
7780;200572;1097;37;27;5;22;.815;3600000;0
7780;184788;77;0;0;0;0;.00nan;0;0
7781;182467;4922;46;30;5;25;.833;3600000;0
7781;205121;4922;0;0;0;0;.00nan;0;0
7781;200390;1096;53;31;4;27;.871;3600000;0
7781;-1;1096;0;0;0;0;.00nan;0;0
7782;204668;78;100;28;0;28;1.000;3600000;0
7782;189902;78;0;0;0;0;.00nan;0;0
7782;176136;74;0;0;0;0;.00nan;0;0
7782;-1;74;76;38;3;35;.921;3600000;0
7783;195251;85;72;46;4;42;.913;3556000;0
7783;179344;67;53;23;3;20;.870;3600000;0
7783;-1;85;0;0;0;0;.00nan;0;0
7783;-1;67;0;0;0;0;.00nan;0;0
7785;203276;82;12;25;7;18;.720;1809000;0
7785;183737;72;0;0;0;0;.00nan;0;0
7785;205469;82;72;22;1;21;.955;1791000;0
7785;91212;72;92;21;0;21;1.000;3600000;0
7787;170598;80;87;31;1;30;.968;3600000;0
7787;189885;4921;0;0;0;0;.00nan;0;0
7787;-1;80;0;0;0;0;.00nan;0;0
7787;197912;4921;89;43;2;41;.953;3580000;0
7789;174407;69;71;20;1;19;.950;3600000;0
7789;179344;67;93;50;3;47;.940;3534000;0
7789;-1;67;0;0;0;0;.00nan;0;0
7789;78479;69;0;0;0;0;.00nan;0;0
7791;200572;157;0;0;0;0;.00nan;0;0
7791;191518;157;91;28;1;27;.964;3600000;0
7791;192547;2564;89;42;2;40;.952;3544000;0
7791;79141;2564;0;0;0;0;.00nan;0;0
7793;200390;1096;0;0;0;0;.00nan;0;0
7793;196414;152;0;0;0;0;.00nan;0;0
7793;-1;1096;65;38;5;33;.868;3572000;0
7793;86875;152;56;28;3;25;.893;3600000;0
7795;184069;73;52;40;5;35;.875;3513000;0
7795;173961;73;0;0;0;0;.00nan;0;0
7795;78820;75;87;45;3;42;.933;3600000;0
7795;86394;75;0;0;0;0;.00nan;0;0
7797;184788;151;0;0;0;0;.00nan;0;0
7797;176136;74;58;31;4;27;.871;3600000;0
7797;-1;74;0;0;0;0;.00nan;0;0
7797;65014;151;98;39;1;38;.974;3600000;0
7799;203179;4620;0;0;0;0;.00nan;0;0
7799;200233;4620;76;29;3;26;.897;3650000;0
7799;195251;85;0;0;0;0;.00nan;0;0
7799;-1;85;100;50;2;48;.960;3650000;0
7801;174386;81;98;51;1;50;.980;3900000;0
7801;176770;81;0;0;0;0;.00nan;0;0
7801;191574;4920;89;30;1;29;.967;3900000;0
7801;-1;4920;0;0;0;0;.00nan;0;0
7803;163989;149;56;33;4;29;.879;3533000;0
7803;178394;1095;0;0;0;0;.00nan;0;0
7803;186451;1095;100;41;2;39;.951;3600000;0
7803;85546;149;0;0;0;0;.00nan;0;0
7805;161535;4245;54;34;5;29;.853;3600000;0
7805;182467;4922;0;0;0;0;.00nan;0;0
7805;205121;4922;100;32;0;32;1.000;3600000;0
7805;-1;4245;0;0;0;0;.00nan;0;0
7807;204668;78;64;35;4;31;.886;3600000;0
7807;189902;78;0;0;0;0;.00nan;0;0
7807;-1;158;86;33;1;32;.970;3600000;0
7807;86862;158;0;0;0;0;.00nan;0;0
7809;194219;76;54;30;4;26;.867;3600000;0
7809;189081;1097;100;38;1;37;.974;3600000;0
7809;184175;76;0;0;0;0;.00nan;0;0
7809;192629;1097;0;0;0;0;.00nan;0;0
7811;199437;77;68;35;3;32;.914;3600000;0
7811;190034;77;0;0;0;0;.00nan;0;0
7811;78581;71;0;0;0;0;.00nan;0;0
7811;91403;71;55;32;4;28;.875;3593000;0
2219;179344;67;79;48;5;43;.896;3600000;0
2219;-1;67;0;0;0;0;.00nan;0;0
2219;191574;4920;47;12;2;10;.833;3600000;0
2219;-1;4920;0;0;0;0;.00nan;0;0
2220;203179;4620;0;0;0;0;.00nan;0;0
2220;161535;4245;0;0;0;0;.00nan;0;0
2220;200233;4245;69;32;3;29;.906;3600000;0
2220;-1;4620;50;30;5;25;.833;3600000;0
2221;199437;77;52;29;5;24;.828;3562000;0
2221;184788;77;0;0;0;0;.00nan;0;0
2221;192552;75;0;0;0;0;.00nan;0;0
2221;86394;75;63;26;3;23;.885;3600000;0
2222;194219;76;48;23;4;19;.826;3681000;0
2222;189081;1097;0;0;0;0;.00nan;0;0
2222;200572;1097;68;29;3;26;.897;3681000;0
2222;184175;76;0;0;0;0;.00nan;0;0
2223;178394;1095;78;43;3;40;.930;4303000;0
2223;186451;1095;0;0;0;0;.00nan;0;0
2223;78820;71;37;18;4;14;.778;4303000;0
2223;91403;71;0;0;0;0;.00nan;0;0
2224;183737;72;0;0;0;0;.00nan;0;0
2224;184069;73;77;38;3;35;.921;3550000;0
2224;173961;73;0;0;0;0;.00nan;0;0
2224;91212;72;63;21;2;19;.905;3600000;0
2225;173918;151;38;9;2;7;.778;820000;0
2225;176915;151;38;30;6;24;.800;2780000;0
2225;179830;157;0;0;0;0;.00nan;0;0
2225;191518;157;72;28;2;26;.929;3600000;0
2226;170598;80;0;0;0;0;.00nan;0;0
2226;57215;152;0;0;0;0;.00nan;0;0
2226;58100;80;68;21;1;20;.952;3600000;0
2226;86875;152;71;30;2;28;.933;3553000;0
2227;179344;67;86;62;4;58;.935;3599000;0
2227;-1;67;0;0;0;0;.00nan;0;0
2227;191574;4920;66;19;2;17;.895;3600000;0
2227;-1;4920;0;0;0;0;.00nan;0;0
2228;203179;4620;0;0;0;0;.00nan;0;0
2228;161535;4245;0;0;0;0;.00nan;0;0
2228;200233;4245;79;28;1;27;.964;3600000;0
2228;-1;4620;61;28;3;25;.893;3564000;0
2229;199437;77;97;44;1;43;.977;3571000;0
2229;184788;77;0;0;0;0;.00nan;0;0
2229;192552;75;0;0;0;0;.00nan;0;0
2229;86394;75;84;18;0;18;1.000;3600000;0
2230;194219;76;30;22;6;16;.727;3600000;0
2230;189081;1097;0;0;0;0;.00nan;0;0
2230;200572;1097;88;30;2;28;.933;3600000;0
2230;184175;76;0;0;0;0;.00nan;0;0
2231;178394;1095;0;0;0;0;.00nan;0;0
2231;186451;1095;64;34;3;31;.912;3600000;0
2231;78820;71;100;26;0;26;1.000;3600000;0
2231;91403;71;0;0;0;0;.00nan;0;0
2232;183737;72;0;0;0;0;.00nan;0;0
2232;184069;73;49;26;4;22;.846;3564000;0
2232;173961;73;0;0;0;0;.00nan;0;0
2232;91212;72;86;46;3;43;.935;3600000;0
2233;173918;151;0;0;0;0;.00nan;0;0
2233;176915;151;81;35;2;33;.943;3566000;0
2233;179830;157;0;0;0;0;.00nan;0;0
2233;191518;157;95;33;1;32;.970;3600000;0
2234;170598;80;94;64;4;60;.938;4564000;0
2234;57215;152;0;0;0;0;.00nan;0;0
2234;58100;80;0;0;0;0;.00nan;0;0
2234;86875;152;57;28;3;25;.893;4564000;0
2235;179344;67;91;48;3;45;.938;3586000;0
2235;-1;67;0;0;0;0;.00nan;0;0
2235;191574;4920;59;14;1;13;.929;3600000;0
2235;-1;4920;0;0;0;0;.00nan;0;0
2236;203179;4620;0;0;0;0;.00nan;0;0
2236;161535;4245;0;0;0;0;.00nan;0;0
2236;200233;4245;34;25;5;20;.800;3553000;0
2236;-1;4620;61;27;4;23;.852;3600000;0
2237;199437;77;34;32;6;26;.813;3600000;0
2237;184788;77;0;0;0;0;.00nan;0;0
2237;192552;75;0;0;0;0;.00nan;0;0
2237;86394;75;67;24;2;22;.917;3600000;0
2238;194219;76;74;26;1;25;.962;3600000;0
2238;189081;1097;0;0;0;0;.00nan;0;0
2238;200572;1097;87;32;2;30;.938;3600000;0
2238;184175;76;0;0;0;0;.00nan;0;0
2239;178394;1095;0;0;0;0;.00nan;0;0
2239;186451;1095;66;35;3;32;.914;3529000;0
2239;78820;71;83;23;1;22;.957;3600000;0
2239;91403;71;0;0;0;0;.00nan;0;0
2240;183737;72;0;0;0;0;.00nan;0;0
2240;184069;73;53;25;3;22;.880;3944000;0
2240;173961;73;0;0;0;0;.00nan;0;0
2240;91212;72;83;47;4;43;.915;3944000;0
2241;173918;151;0;0;0;0;.00nan;0;0
2241;176915;151;46;27;4;23;.852;3543000;0
2241;179830;157;0;0;0;0;.00nan;0;0
2241;191518;157;72;25;2;23;.920;3600000;0
2242;170598;80;84;37;3;34;.919;3600000;0
2242;57215;152;0;0;0;0;.00nan;0;0
2242;58100;80;0;0;0;0;.00nan;0;0
2242;86875;152;61;34;4;30;.882;3547000;0
2243;179344;67;91;58;4;54;.931;5287000;0
2243;-1;67;0;0;0;0;.00nan;0;0
2243;191574;4920;57;27;3;24;.889;5287000;0
2243;-1;4920;0;0;0;0;.00nan;0;0
2244;203179;4620;0;0;0;0;.00nan;0;0
2244;161535;4245;0;0;0;0;.00nan;0;0
2244;200233;4245;36;27;5;22;.815;3600000;0
2244;-1;4620;72;24;1;23;.958;3600000;0
2245;199437;77;86;41;2;39;.951;3600000;0
2245;184788;77;0;0;0;0;.00nan;0;0
2245;192552;75;0;0;0;0;.00nan;0;0
2245;86394;75;41;14;3;11;.786;3551000;0
2246;194219;76;25;27;6;21;.778;3543000;0
2246;189081;1097;0;0;0;0;.00nan;0;0
2246;200572;1097;62;35;5;30;.857;3600000;0
2246;184175;76;0;0;0;0;.00nan;0;0
2247;178394;1095;0;0;0;0;.00nan;0;0
2247;186451;1095;69;36;3;33;.917;3600000;0
2247;78820;71;55;30;4;26;.867;3562000;0
2247;91403;71;0;0;0;0;.00nan;0;0
2248;183737;72;0;0;0;0;.00nan;0;0
2248;184069;73;67;28;2;26;.929;3600000;0
2248;173961;73;0;0;0;0;.00nan;0;0
2248;91212;72;60;37;4;33;.892;3518000;0
2249;173918;151;0;0;0;0;.00nan;0;0
2249;176915;151;82;32;2;30;.938;3600000;0
2249;179830;157;0;0;0;0;.00nan;0;0
2249;191518;157;92;32;1;31;.969;3600000;0
2250;170598;80;64;26;2;24;.923;3600000;0
2250;57215;152;52;2;0;2;1.000;284000;0
2250;58100;80;0;0;0;0;.00nan;0;0
2250;86875;152;35;32;6;26;.813;3316000;0
2466;203179;4620;0;0;0;0;.00nan;0;0
2466;161535;4245;0;0;0;0;.00nan;0;0
2466;200233;4245;51;30;4;26;.867;3600000;0
2466;-1;4620;73;21;1;20;.952;3600000;0
2467;199437;77;63;36;4;32;.889;3600000;0
2467;184788;77;0;0;0;0;.00nan;0;0
2467;192552;75;0;0;0;0;.00nan;0;0
2467;86394;75;97;19;0;19;1.000;3600000;0
2468;194219;76;89;18;0;18;1.000;3600000;0
2468;189081;1097;0;0;0;0;.00nan;0;0
2468;200572;1097;59;38;5;33;.868;3600000;0
2468;184175;76;0;0;0;0;.00nan;0;0
2469;178394;1095;0;0;0;0;.00nan;0;0
2469;186451;1095;64;41;5;36;.878;3600000;0
2469;78820;71;63;25;3;22;.880;3600000;0
2469;91403;71;0;0;0;0;.00nan;0;0
2470;183737;72;0;0;0;0;.00nan;0;0
2470;184069;73;79;27;1;26;.963;3600000;0
2470;173961;73;0;0;0;0;.00nan;0;0
2470;91212;72;49;36;5;31;.861;3600000;0
2471;170598;80;56;31;4;27;.871;3600000;0
2471;57215;152;0;0;0;0;.00nan;0;0
2471;58100;80;0;0;0;0;.00nan;0;0
2471;86875;152;100;29;0;29;1.000;3600000;0
2486;203179;4620;0;0;0;0;.00nan;0;0
2486;161535;4245;0;0;0;0;.00nan;0;0
2486;200233;4245;86;37;3;34;.919;3753000;0
2486;-1;4620;91;36;2;34;.944;3753000;0
2487;194219;76;64;30;3;27;.900;4186000;0
2487;189081;1097;0;0;0;0;.00nan;0;0
2487;200572;1097;80;52;4;48;.923;4186000;0
2487;184175;76;0;0;0;0;.00nan;0;0
2488;178394;1095;0;0;0;0;.00nan;0;0
2488;186451;1095;59;35;4;31;.886;3515000;0
2488;78820;71;62;19;2;17;.895;3600000;0
2488;91403;71;0;0;0;0;.00nan;0;0
2489;183737;72;0;0;0;0;.00nan;0;0
2489;184069;73;93;31;1;30;.968;3600000;0
2489;173961;73;0;0;0;0;.00nan;0;0
2489;91212;72;64;26;2;24;.923;3557000;0
2490;170598;80;76;22;1;21;.955;3600000;0
2490;57215;152;0;0;0;0;.00nan;0;0
2490;58100;80;0;0;0;0;.00nan;0;0
2490;86875;152;38;31;6;25;.806;3600000;0
2528;194219;76;95;25;1;24;.960;3600000;0
2528;189081;1097;48;0;0;0;.00nan;366000;0
2528;200572;1097;44;43;7;36;.837;3234000;0
2528;184175;76;0;0;0;0;.00nan;0;0
2540;203179;4620;0;0;0;0;.00nan;0;0
2540;191574;4920;27;19;5;14;.737;3556000;0
2540;-1;4920;0;0;0;0;.00nan;0;0
2540;-1;4620;99;58;3;55;.948;3600000;0
2541;194219;76;45;31;5;26;.839;3600000;0
2541;184175;76;0;0;0;0;.00nan;0;0
2541;192552;75;0;0;0;0;.00nan;0;0
2541;86394;75;80;28;2;26;.929;3600000;0
2542;184069;73;32;28;6;22;.786;3600000;0
2542;173961;73;0;0;0;0;.00nan;0;0
2542;78820;71;86;35;3;32;.914;3600000;0
2542;91403;71;0;0;0;0;.00nan;0;0
2543;170598;80;46;33;5;28;.848;3598000;0
2543;179830;157;0;0;0;0;.00nan;0;0
2543;191518;157;50;22;4;18;.818;3600000;0
2543;58100;80;0;0;0;0;.00nan;0;0
2544;203179;4620;0;0;0;0;.00nan;0;0
2544;191574;4920;86;24;1;23;.958;3600000;0
2544;-1;4920;0;0;0;0;.00nan;0;0
2544;-1;4620;44;25;4;21;.840;3600000;0
2545;194219;76;63;29;3;26;.897;4208000;0
2545;184175;76;0;0;0;0;.00nan;0;0
2545;192552;75;0;0;0;0;.00nan;0;0
2545;86394;75;82;32;2;30;.938;4208000;0
2546;184069;73;69;19;1;18;.947;3600000;0
2546;173961;73;0;0;0;0;.00nan;0;0
2546;78820;71;63;30;3;27;.900;3518000;0
2546;91403;71;0;0;0;0;.00nan;0;0
2547;170598;80;73;30;2;28;.933;3545000;0
2547;179830;157;0;0;0;0;.00nan;0;0
2547;191518;157;71;16;1;15;.938;3600000;0
2547;58100;80;0;0;0;0;.00nan;0;0
2548;203179;4620;0;0;0;0;.00nan;0;0
2548;191574;4920;75;19;1;18;.947;3600000;0
2548;-1;4920;0;0;0;0;.00nan;0;0
2548;-1;4620;70;32;3;29;.906;3580000;0
2549;194219;76;100;41;0;41;1.000;3600000;0
2549;184175;76;0;0;0;0;.00nan;0;0
2549;192552;75;0;0;0;0;.00nan;0;0
2549;86394;75;50;15;2;13;.867;3513000;0
2550;184069;73;76;37;3;34;.919;4115000;0
2550;173961;73;0;0;0;0;.00nan;0;0
2550;78820;71;75;26;2;24;.923;4115000;0
2550;91403;71;0;0;0;0;.00nan;0;0
2551;170598;80;76;43;4;39;.907;3600000;0
2551;179830;157;0;0;0;0;.00nan;0;0
2551;191518;157;95;21;0;21;1.000;3600000;0
2551;58100;80;0;0;0;0;.00nan;0;0
2552;203179;4620;0;0;0;0;.00nan;0;0
2552;191574;4920;64;41;4;37;.902;5298000;0
2552;-1;4920;0;0;0;0;.00nan;0;0
2552;-1;4620;68;40;3;37;.925;5298000;0
2553;194219;76;83;38;2;36;.947;3514000;0
2553;184175;76;0;0;0;0;.00nan;0;0
2553;192552;75;0;0;0;0;.00nan;0;0
2553;86394;75;99;25;0;25;1.000;3600000;0
2554;184069;73;90;33;1;32;.970;3600000;0
2554;173961;73;0;0;0;0;.00nan;0;0
2554;78820;71;78;31;3;28;.903;3522000;0
2554;91403;71;0;0;0;0;.00nan;0;0
2555;170598;80;90;40;1;39;.975;3600000;0
2555;179830;157;0;0;0;0;.00nan;0;0
2555;191518;157;62;17;2;15;.882;3557000;0
2555;58100;80;0;0;0;0;.00nan;0;0
2699;203179;4620;0;0;0;0;.00nan;0;0
2699;191574;4920;66;26;2;24;.923;3600000;0
2699;-1;4920;0;0;0;0;.00nan;0;0
2699;-1;4620;62;42;4;38;.905;3600000;0
2700;194219;76;71;31;3;28;.903;4258000;0
2700;184175;76;0;0;0;0;.00nan;0;0
2700;192552;75;0;0;0;0;.00nan;0;0
2700;86394;75;77;30;2;28;.933;4258000;0
2701;184069;73;97;44;1;43;.977;5403000;0
2701;173961;73;0;0;0;0;.00nan;0;0
2701;78820;71;92;44;2;42;.955;5403000;0
2701;91403;71;0;0;0;0;.00nan;0;0
2702;170598;80;58;24;3;21;.875;3600000;0
2702;179830;157;0;0;0;0;.00nan;0;0
2702;191518;157;69;29;2;27;.931;3600000;0
2702;58100;80;0;0;0;0;.00nan;0;0
2735;203179;4620;0;0;0;0;.00nan;0;0
2735;191574;4920;69;28;3;25;.893;4899000;0
2735;-1;4920;0;0;0;0;.00nan;0;0
2735;-1;4620;85;37;2;35;.946;4907000;0
2736;184069;73;64;28;4;24;.857;4563000;0
2736;173961;73;0;0;0;0;.00nan;0;0
2736;78820;71;56;39;5;34;.872;4563000;0
2736;91403;71;0;0;0;0;.00nan;0;0
2739;203179;4620;59;6;0;6;1.000;290000;0
2739;191574;4920;54;21;3;18;.857;3600000;0
2739;-1;4920;0;0;0;0;.00nan;0;0
2739;-1;4620;27;31;6;25;.806;3310000;0
2744;191574;4920;88;44;4;40;.909;3600000;0
2744;192552;75;0;0;0;0;.00nan;0;0
2744;-1;4920;0;0;0;0;.00nan;0;0
2744;86394;75;87;18;0;18;1.000;3600000;0
2745;184069;73;46;36;5;31;.861;3600000;0
2745;173961;73;0;0;0;0;.00nan;0;0
2745;179830;157;0;0;0;0;.00nan;0;0
2745;191518;157;95;22;0;22;1.000;3600000;0
2746;191574;4920;77;33;2;31;.939;3600000;0
2746;192552;75;0;0;0;0;.00nan;0;0
2746;-1;4920;0;0;0;0;.00nan;0;0
2746;86394;75;56;19;3;16;.842;3554000;0
2747;184069;73;46;27;4;23;.852;3600000;0
2747;173961;73;0;0;0;0;.00nan;0;0
2747;179830;157;0;0;0;0;.00nan;0;0
2747;191518;157;40;38;6;32;.842;3537000;0
2748;191574;4920;15;6;4;2;.333;469000;0
2748;192552;75;0;0;0;0;.00nan;0;0
2748;-1;4920;54;29;4;25;.862;3131000;0
2748;86394;75;71;26;2;24;.923;3600000;0
2749;184069;73;54;31;4;27;.871;3600000;0
2749;173961;73;0;0;0;0;.00nan;0;0
2749;179830;157;0;0;0;0;.00nan;0;0
2749;191518;157;100;25;0;25;1.000;3600000;0
2750;191574;4920;0;0;0;0;.00nan;0;0
2750;192552;75;0;0;0;0;.00nan;0;0
2750;-1;4920;67;33;3;30;.909;3600000;0
2750;86394;75;78;13;0;13;1.000;3600000;0
2751;184069;73;57;33;4;29;.879;3600000;0
2751;173961;73;0;0;0;0;.00nan;0;0
2751;179830;157;0;0;0;0;.00nan;0;0
2751;191518;157;23;32;7;25;.781;3600000;0
2790;191574;4920;0;0;0;0;.00nan;0;0
2790;192552;75;0;0;0;0;.00nan;0;0
2790;-1;4920;62;32;4;28;.875;3600000;0
2790;86394;75;99;34;1;33;.971;3600000;0
2791;184069;73;26;25;6;19;.760;3030000;0
2791;173961;73;57;5;0;5;1.000;570000;0
2791;179830;157;0;0;0;0;.00nan;0;0
2791;191518;157;73;30;3;27;.900;3600000;0
2796;184069;73;0;0;0;0;.00nan;0;0
2796;173961;73;77;40;2;38;.950;4509000;0
2796;179830;157;0;0;0;0;.00nan;0;0
2796;191518;157;83;38;3;35;.921;4509000;0
2797;184069;73;49;2;0;2;1.000;432000;0
2797;173961;73;21;27;6;21;.778;3123000;0
2797;179830;157;72;18;1;17;.944;2544000;0
2797;191518;157;32;15;4;11;.733;1056000;0
2798;179830;157;69;36;4;32;.889;3187000;0
2798;191518;157;33;13;3;10;.769;413000;0
2798;192552;75;0;0;0;0;.00nan;0;0
2798;86394;75;71;17;1;16;.941;3600000;0
2799;179830;157;68;22;2;20;.909;2524000;0
2799;191518;157;33;15;4;11;.733;1076000;0
2799;192552;75;0;0;0;0;.00nan;0;0
2799;86394;75;58;19;2;17;.895;3600000;0
2800;179830;157;66;35;3;32;.914;3600000;0
2800;191518;157;0;0;0;0;.00nan;0;0
2800;192552;75;0;0;0;0;.00nan;0;0
2800;86394;75;70;17;1;16;.941;3600000;0
2801;179830;157;69;50;5;45;.900;3600000;0
2801;191518;157;0;0;0;0;.00nan;0;0
2801;192552;75;0;0;0;0;.00nan;0;0
2801;86394;75;76;18;1;17;.944;3600000;0
7812;213845;113;28;35;8;27;.771;3600000;0
7812;209921;114;0;0;0;0;.00nan;0;0
7812;210765;113;0;0;0;0;.00nan;0;0
7812;223149;114;51;35;5;30;.857;3600000;0
7813;220332;108;65;31;3;28;.903;3600000;0
7813;215968;110;45;23;4;19;.826;3557000;0
7813;212667;110;0;0;0;0;.00nan;0;0
7813;-1;108;0;0;0;0;.00nan;0;0
7814;208620;112;78;35;3;32;.914;3681000;0
7814;220332;108;0;0;0;0;.00nan;0;0
7814;212052;112;0;0;0;0;.00nan;0;0
7814;-1;108;61;35;4;31;.886;3681000;0
7815;210773;111;100;32;0;32;1.000;3600000;0
7815;215968;110;74;34;4;30;.882;3600000;0
7815;217347;111;0;0;0;0;.00nan;0;0
7815;212667;110;0;0;0;0;.00nan;0;0
7816;213722;116;0;0;0;0;.00nan;0;0
7816;208625;119;35;36;6;30;.833;2734000;0
7816;216028;116;56;26;3;23;.885;3600000;0
7816;218853;119;25;11;4;7;.636;866000;0
7817;213845;113;66;26;2;24;.923;3600000;0
7817;209921;114;0;0;0;0;.00nan;0;0
7817;210765;113;0;0;0;0;.00nan;0;0
7817;223149;114;84;44;3;41;.932;3577000;0
7818;210785;123;99;51;1;50;.980;3600000;0
7818;211935;123;0;0;0;0;.00nan;0;0
7818;212681;122;12;28;7;21;.750;3600000;0
7818;-1;122;0;0;0;0;.00nan;0;0
7819;220601;121;44;34;5;29;.853;3518000;0
7819;222436;115;75;41;3;38;.927;3600000;0
7819;223989;115;0;0;0;0;.00nan;0;0
7819;-1;121;0;0;0;0;.00nan;0;0
7820;204630;109;75;33;3;30;.909;3600000;0
7820;221211;109;0;0;0;0;.00nan;0;0
7820;215983;117;0;0;0;0;.00nan;0;0
7820;213504;117;84;35;2;33;.943;3600000;0
7821;217331;125;0;0;0;0;.00nan;0;0
7821;222609;127;0;0;0;0;.00nan;0;0
7821;212716;127;30;42;7;35;.833;3600000;0
7821;-1;125;72;28;2;26;.929;3600000;0
7822;208652;124;0;0;0;0;.00nan;0;0
7822;221235;126;0;0;0;0;.00nan;0;0
7822;221552;124;45;32;4;28;.875;3600000;0
7822;212039;126;72;17;1;16;.941;3600000;0
7823;212683;118;0;0;0;0;.00nan;0;0
7823;218081;120;0;0;0;0;.00nan;0;0
7823;213613;120;76;35;3;32;.914;3566000;0
7823;218830;118;67;26;2;24;.923;3600000;0
7824;220601;121;0;0;0;0;.00nan;0;0
7824;222436;115;32;36;6;30;.833;3571000;0
7824;223989;115;0;0;0;0;.00nan;0;0
7824;-1;121;52;23;4;19;.826;3600000;0
7825;208652;124;58;35;4;31;.886;3579000;0
7825;221552;124;0;0;0;0;.00nan;0;0
7825;212681;122;0;0;0;0;.00nan;0;0
7825;-1;122;67;27;2;25;.926;3600000;0
7826;213722;116;0;0;0;0;.00nan;0;0
7826;208625;119;24;18;5;13;.722;2396000;0
7826;216028;116;81;35;2;33;.943;3600000;0
7826;218853;119;57;2;0;2;1.000;1204000;0
7827;209921;114;63;42;4;38;.905;3866000;0
7827;218081;120;43;29;5;24;.828;3866000;0
7827;223149;114;0;0;0;0;.00nan;0;0
7827;213613;120;0;0;0;0;.00nan;0;0
7828;217331;125;34;32;6;26;.813;2082000;0
7828;212683;118;0;0;0;0;.00nan;0;0
7828;218830;118;61;13;1;12;.923;3600000;0
7828;-1;125;89;21;1;20;.952;1518000;0
7829;210785;123;51;42;6;36;.857;3600000;0
7829;211935;123;0;0;0;0;.00nan;0;0
7829;222609;127;65;36;3;33;.917;3600000;0
7829;212716;127;0;0;0;0;.00nan;0;0
7830;204630;109;97;40;2;38;.950;3521000;0
7830;221211;109;0;0;0;0;.00nan;0;0
7830;221235;126;0;0;0;0;.00nan;0;0
7830;212039;126;100;24;0;24;1.000;3600000;0
7831;213845;113;0;0;0;0;.00nan;0;0
7831;210765;113;72;37;3;34;.919;3600000;0
7831;215983;117;42;3;1;2;.667;332000;0
7831;213504;117;36;32;6;26;.813;3268000;0
7832;208620;112;37;31;6;25;.806;2418000;0
7832;220332;108;0;0;0;0;.00nan;0;0
7832;212052;112;64;9;0;9;1.000;1182000;0
7832;-1;108;65;29;3;26;.897;3600000;0
7833;222609;127;51;56;8;48;.857;3600000;0
7833;212681;122;75;31;3;28;.903;3600000;0
7833;212716;127;0;0;0;0;.00nan;0;0
7833;-1;122;0;0;0;0;.00nan;0;0
7834;220601;121;76;30;2;28;.933;3600000;0
7834;221235;126;0;0;0;0;.00nan;0;0
7834;212039;126;82;46;4;42;.913;3577000;0
7834;-1;121;0;0;0;0;.00nan;0;0
7835;213722;116;57;11;1;10;.909;1131000;0
7835;216028;116;13;37;9;28;.757;2469000;0
7835;222436;115;0;0;0;0;.00nan;0;0
7835;223989;115;35;40;7;33;.825;3600000;0
7836;215968;110;89;32;1;31;.969;3683000;0
7836;215983;117;0;0;0;0;.00nan;0;0
7836;212667;110;0;0;0;0;.00nan;0;0
7836;213504;117;83;28;2;26;.929;3683000;0
7837;213845;113;78;42;4;38;.905;3900000;0
7837;210765;113;0;0;0;0;.00nan;0;0
7837;217331;125;72;14;0;14;1.000;1674000;0
7837;-1;125;48;22;4;18;.818;2226000;0
7838;220332;108;64;33;4;29;.879;3570000;0
7838;215983;117;72;33;3;30;.909;3600000;0
7838;213504;117;0;0;0;0;.00nan;0;0
7838;-1;108;0;0;0;0;.00nan;0;0
7839;212681;122;80;36;2;34;.944;3865000;0
7839;218081;120;93;47;3;44;.936;3865000;0
7839;213613;120;0;0;0;0;.00nan;0;0
7839;-1;122;0;0;0;0;.00nan;0;0
7840;213845;113;0;0;0;0;.00nan;0;0
7840;220601;121;0;0;0;0;.00nan;0;0
7840;210765;113;33;21;4;17;.810;3600000;0
7840;-1;121;99;26;0;26;1.000;3600000;0
7841;221235;126;0;0;0;0;.00nan;0;0
7841;212039;126;73;30;3;27;.900;3600000;0
7841;222609;127;65;18;1;17;.944;1129000;0
7841;212716;127;18;27;7;20;.741;2471000;0
7842;208625;119;51;31;4;27;.871;3589000;0
7842;212683;118;0;0;0;0;.00nan;0;0
7842;218830;118;62;30;3;27;.900;3600000;0
7842;218853;119;0;0;0;0;.00nan;0;0
7843;213722;116;0;0;0;0;.00nan;0;0
7843;208620;112;0;0;0;0;.00nan;0;0
7843;216028;116;33;29;5;24;.828;3600000;0
7843;212052;112;90;28;1;27;.964;3600000;0
7844;210773;111;60;25;2;23;.920;3600000;0
7844;215983;117;49;1;0;1;1.000;369000;0
7844;217347;111;0;0;0;0;.00nan;0;0
7844;213504;117;27;22;6;16;.727;3231000;0
7845;217331;125;0;0;0;0;.00nan;0;0
7845;222609;127;0;0;0;0;.00nan;0;0
7845;212716;127;44;36;5;31;.861;3900000;0
7845;-1;125;48;35;5;30;.857;3900000;0
7846;208620;112;54;25;4;21;.840;3531000;0
7846;204630;109;72;37;3;34;.919;3600000;0
7846;221211;109;0;0;0;0;.00nan;0;0
7846;212052;112;0;0;0;0;.00nan;0;0
7847;208652;124;43;34;5;29;.853;3600000;0
7847;221235;126;0;0;0;0;.00nan;0;0
7847;221552;124;0;0;0;0;.00nan;0;0
7847;212039;126;62;23;2;21;.913;3600000;0
7848;208625;119;0;0;0;0;.00nan;0;0
7848;218081;120;0;0;0;0;.00nan;0;0
7848;213613;120;82;53;6;47;.887;3600000;0
7848;218853;119;40;8;2;6;.750;3600000;0
7849;220601;121;52;6;1;5;.833;1092000;0
7849;212683;118;19;32;8;24;.750;3820000;0
7849;218830;118;0;0;0;0;.00nan;0;0
7849;-1;121;19;24;6;18;.750;2728000;0
7850;210785;123;51;30;4;26;.867;3600000;0
7850;211935;123;0;0;0;0;.00nan;0;0
7850;212681;122;0;0;0;0;.00nan;0;0
7850;-1;122;43;29;5;24;.828;3580000;0
7851;209921;114;0;0;0;0;.00nan;0;0
7851;222436;115;33;32;6;26;.813;3568000;0
7851;223149;114;50;28;4;24;.857;3600000;0
7851;223989;115;0;0;0;0;.00nan;0;0
7852;220332;108;0;0;0;0;.00nan;0;0
7852;210773;111;0;0;0;0;.00nan;0;0
7852;217347;111;87;50;3;47;.940;3900000;0
7852;-1;108;64;26;3;23;.885;3900000;0
7853;213722;116;35;37;6;31;.838;3600000;0
7853;204630;109;0;0;0;0;.00nan;0;0
7853;221211;109;79;34;2;32;.941;3600000;0
7853;216028;116;0;0;0;0;.00nan;0;0
7854;213845;113;56;32;4;28;.875;3804000;0
7854;210765;113;0;0;0;0;.00nan;0;0
7854;218081;120;65;30;3;27;.900;3804000;0
7854;213613;120;0;0;0;0;.00nan;0;0
7855;221235;126;0;0;0;0;.00nan;0;0
7855;212039;126;65;36;4;32;.889;3600000;0
7855;217331;125;18;5;4;1;.200;1030000;0
7855;-1;125;47;20;3;17;.850;2570000;0
7856;208652;124;0;0;0;0;.00nan;0;0
7856;210785;123;43;20;4;16;.800;3543000;0
7856;221552;124;81;44;3;41;.932;3600000;0
7856;211935;123;0;0;0;0;.00nan;0;0
7857;213845;113;41;13;3;10;.769;3600000;0
7857;210765;113;0;0;0;0;.00nan;0;0
7857;210773;111;58;36;4;32;.889;3549000;0
7857;217347;111;0;0;0;0;.00nan;0;0
7858;208625;119;43;26;4;22;.846;3572000;0
7858;222436;115;63;31;3;28;.903;3600000;0
7858;223989;115;0;0;0;0;.00nan;0;0
7858;218853;119;0;0;0;0;.00nan;0;0
7859;220601;121;0;0;0;0;.00nan;0;0
7859;215968;110;36;27;5;22;.815;3295000;0
7859;212667;110;44;3;1;2;.667;232000;0
7859;-1;121;43;27;4;23;.852;3600000;0
7860;220332;108;58;47;6;41;.872;3018000;0
7860;217331;125;58;14;1;13;.929;3600000;0
7860;-1;125;0;0;0;0;.00nan;0;0
7860;-1;108;63;8;0;8;1.000;582000;0
7861;204630;109;60;37;4;33;.892;3595000;0
7861;221211;109;0;0;0;0;.00nan;0;0
7861;215968;110;0;0;0;0;.00nan;0;0
7861;212667;110;73;29;2;27;.931;3600000;0
7862;209921;114;0;0;0;0;.00nan;0;0
7862;212681;122;0;0;0;0;.00nan;0;0
7862;223149;114;51;31;4;27;.871;3550000;0
7862;-1;122;74;32;2;30;.938;3600000;0
7863;220332;108;0;0;0;0;.00nan;0;0
7863;220601;121;100;23;0;23;1.000;3600000;0
7863;-1;121;0;0;0;0;.00nan;0;0
7863;-1;108;72;40;4;36;.900;3600000;0
7864;215983;117;35;33;6;27;.818;3587000;0
7864;218081;120;61;32;4;28;.875;3600000;0
7864;213504;117;0;0;0;0;.00nan;0;0
7864;213613;120;0;0;0;0;.00nan;0;0
7865;208652;124;0;0;0;0;.00nan;0;0
7865;221552;124;100;35;0;35;1.000;3600000;0
7865;222609;127;60;19;2;17;.895;3600000;0
7865;212716;127;0;0;0;0;.00nan;0;0
7866;210773;111;30;19;4;15;.789;939000;0
7866;221235;126;0;0;0;0;.00nan;0;0
7866;212039;126;73;21;1;20;.952;3600000;0
7866;217347;111;46;31;5;26;.839;2661000;0
7867;213722;116;0;0;0;0;.00nan;0;0
7867;216028;116;60;45;7;38;.844;3600000;0
7867;212683;118;0;0;0;0;.00nan;0;0
7867;218830;118;43;28;4;24;.857;3600000;0
7868;208620;112;0;0;0;0;.00nan;0;0
7868;210785;123;41;36;6;30;.833;2966000;0
7868;211935;123;48;7;1;6;.857;634000;0
7868;212052;112;69;27;2;25;.926;3600000;0
7869;213722;116;66;28;3;25;.893;3747000;0
7869;210785;123;63;37;4;33;.892;3747000;0
7869;216028;116;0;0;0;0;.00nan;0;0
7869;211935;123;0;0;0;0;.00nan;0;0
7870;220332;108;0;0;0;0;.00nan;0;0
7870;222436;115;0;0;0;0;.00nan;0;0
7870;223989;115;87;37;4;33;.892;3600000;0
7870;-1;108;20;28;7;21;.750;3566000;0
7871;208652;124;51;3;0;3;1.000;331000;0
7871;221552;124;50;31;5;26;.839;3220000;0
7871;212683;118;54;29;4;25;.862;3600000;0
7871;218830;118;0;0;0;0;.00nan;0;0
7872;208625;119;0;0;0;0;.00nan;0;0
7872;217331;125;0;0;0;0;.00nan;0;0
7872;-1;125;63;41;4;37;.902;3590000;0
7872;218853;119;44;20;3;17;.850;3600000;0
7873;204630;109;65;16;1;15;.938;1449000;0
7873;221211;109;17;20;6;14;.700;2151000;0
7873;215968;110;84;39;3;36;.923;3600000;0
7873;212667;110;0;0;0;0;.00nan;0;0
7874;220601;121;37;26;5;21;.808;3568000;0
7874;222609;127;0;0;0;0;.00nan;0;0
7874;212716;127;75;43;4;39;.907;3600000;0
7874;-1;121;0;0;0;0;.00nan;0;0
7875;221235;126;0;0;0;0;.00nan;0;0
7875;212039;126;73;46;5;41;.891;3900000;0
7875;218081;120;0;0;0;0;.00nan;0;0
7875;213613;120;43;31;5;26;.839;3900000;0
7876;208620;112;79;30;2;28;.933;3600000;0
7876;209921;114;67;36;4;32;.889;3530000;0
7876;212052;112;0;0;0;0;.00nan;0;0
7876;223149;114;0;0;0;0;.00nan;0;0
7877;217331;125;45;41;6;35;.854;2822000;0
7877;212681;122;31;12;4;8;.667;471000;0
7877;-1;125;58;11;1;10;.909;1078000;0
7877;-1;122;67;26;3;23;.885;3429000;0
7878;210773;111;79;39;3;36;.923;3600000;0
7878;215983;117;0;0;0;0;.00nan;0;0
7878;217347;111;0;0;0;0;.00nan;0;0
7878;213504;117;31;29;6;23;.793;3600000;0
7879;213722;116;0;0;0;0;.00nan;0;0
7879;208625;119;35;20;4;16;.800;2279000;0
7879;216028;116;65;41;5;36;.878;3643000;0
7879;218853;119;68;16;0;16;1.000;1364000;0
7880;213845;113;35;27;6;21;.778;3600000;0
7880;208620;112;43;3;1;2;.667;368000;0
7880;210765;113;0;0;0;0;.00nan;0;0
7880;212052;112;43;38;6;32;.842;3232000;0
7881;204630;109;33;40;8;32;.800;2838000;0
7881;220601;121;0;0;0;0;.00nan;0;0
7881;221211;109;51;11;1;10;.909;762000;0
7881;-1;121;51;23;3;20;.870;3600000;0
7882;222436;115;87;59;3;56;.949;3600000;0
7882;212681;122;54;31;4;27;.871;3525000;0
7882;223989;115;0;0;0;0;.00nan;0;0
7882;-1;122;0;0;0;0;.00nan;0;0
7883;213722;116;0;0;0;0;.00nan;0;0
7883;215983;117;0;0;0;0;.00nan;0;0
7883;216028;116;49;31;5;26;.839;3600000;0
7883;213504;117;94;25;0;25;1.000;3600000;0
7884;215968;110;67;29;4;25;.862;3600000;0
7884;221235;126;0;0;0;0;.00nan;0;0
7884;212039;126;91;33;1;32;.970;3600000;0
7884;212667;110;0;0;0;0;.00nan;0;0
7885;208652;124;0;0;0;0;.00nan;0;0
7885;209921;114;0;0;0;0;.00nan;0;0
7885;221552;124;21;32;6;26;.813;3600000;0
7885;223149;114;57;31;4;27;.871;3600000;0
7886;213722;116;42;30;5;25;.833;3176000;0
7886;213845;113;0;0;0;0;.00nan;0;0
7886;210765;113;51;25;3;22;.880;3600000;0
7886;216028;116;36;13;3;10;.769;424000;0
7887;220332;108;71;30;2;28;.933;3600000;0
7887;221235;126;0;0;0;0;.00nan;0;0
7887;212039;126;77;34;3;31;.912;3551000;0
7887;-1;108;0;0;0;0;.00nan;0;0
7888;210773;111;0;0;0;0;.00nan;0;0
7888;215968;110;38;12;3;9;.750;1082000;0
7888;217347;111;56;31;4;27;.871;3600000;0
7888;212667;110;32;32;6;26;.813;2518000;0
7889;222436;115;0;0;0;0;.00nan;0;0
7889;222609;127;0;0;0;0;.00nan;0;0
7889;212716;127;71;43;4;39;.907;3682000;0
7889;223989;115;82;39;3;36;.923;3682000;0
7890;212681;122;76;37;3;34;.919;3600000;0
7890;218081;120;43;22;4;18;.818;3546000;0
7890;213613;120;0;0;0;0;.00nan;0;0
7890;-1;122;0;0;0;0;.00nan;0;0
7891;208625;119;69;38;4;34;.895;3547000;0
7891;220601;121;0;0;0;0;.00nan;0;0
7891;-1;121;61;20;2;18;.900;3600000;0
7891;218853;119;0;0;0;0;.00nan;0;0
7892;208652;124;48;32;5;27;.844;3592000;0
7892;215983;117;0;0;0;0;.00nan;0;0
7892;221552;124;0;0;0;0;.00nan;0;0
7892;213504;117;54;28;4;24;.857;3600000;0
7893;209921;114;49;30;4;26;.867;3600000;0
7893;212683;118;0;0;0;0;.00nan;0;0
7893;223149;114;0;0;0;0;.00nan;0;0
7893;218830;118;34;26;5;21;.808;3577000;0
7894;208620;112;62;17;2;15;.882;3600000;0
7894;204630;109;34;38;7;31;.816;2892000;0
7894;221211;109;37;8;2;6;.750;708000;0
7894;212052;112;0;0;0;0;.00nan;0;0
7895;213722;116;0;0;0;0;.00nan;0;0
7895;216028;116;46;30;5;25;.833;3559000;0
7895;212681;122;0;0;0;0;.00nan;0;0
7895;-1;122;56;29;4;25;.862;3600000;0
7896;208625;119;0;0;0;0;.00nan;0;0
7896;222609;127;65;41;4;37;.902;3541000;0
7896;212716;127;0;0;0;0;.00nan;0;0
7896;218853;119;61;24;2;22;.917;3600000;0
7897;220332;108;0;0;0;0;.00nan;0;0
7897;212683;118;71;27;2;25;.926;3900000;0
7897;218830;118;0;0;0;0;.00nan;0;0
7897;-1;108;77;43;2;41;.953;3900000;0
7898;204630;109;0;0;0;0;.00nan;0;0
7898;221211;109;86;38;2;36;.947;3600000;0
7898;218081;120;0;0;0;0;.00nan;0;0
7898;213613;120;63;31;3;28;.903;3552000;0
7899;208620;112;0;0;0;0;.00nan;0;0
7899;215968;110;71;42;4;38;.905;3592000;0
7899;212052;112;41;14;3;11;.786;3600000;0
7899;212667;110;0;0;0;0;.00nan;0;0
7900;210785;123;92;35;1;34;.971;3600000;0
7900;211935;123;0;0;0;0;.00nan;0;0
7900;217331;125;0;0;0;0;.00nan;0;0
7900;-1;125;36;20;4;16;.800;3600000;0
7901;209921;114;0;0;0;0;.00nan;0;0
7901;215983;117;59;21;2;19;.905;3600000;0
7901;223149;114;63;31;3;28;.903;3577000;0
7901;213504;117;0;0;0;0;.00nan;0;0
7902;210773;111;66;27;2;25;.926;3600000;0
7902;221235;126;0;0;0;0;.00nan;0;0
7902;212039;126;68;36;3;33;.917;3575000;0
7902;217347;111;0;0;0;0;.00nan;0;0
7903;213845;113;52;14;2;12;.857;3600000;0
7903;208652;124;53;3;0;3;1.000;521000;0
7903;210765;113;0;0;0;0;.00nan;0;0
7903;221552;124;45;41;7;34;.829;3079000;0
7904;220332;108;58;24;3;21;.875;3600000;0
7904;218081;120;27;28;6;22;.786;3600000;0
7904;213613;120;0;0;0;0;.00nan;0;0
7904;-1;108;0;0;0;0;.00nan;0;0
7905;208625;119;54;47;6;41;.872;3600000;0
7905;222436;115;77;23;1;22;.957;3600000;0
7905;223989;115;0;0;0;0;.00nan;0;0
7905;218853;119;0;0;0;0;.00nan;0;0
7906;220601;121;66;30;3;27;.900;3600000;0
7906;210785;123;0;0;0;0;.00nan;0;0
7906;211935;123;52;31;4;27;.871;3547000;0
7906;-1;121;0;0;0;0;.00nan;0;0
7907;208620;112;96;38;2;36;.947;3673000;0
7907;212052;112;0;0;0;0;.00nan;0;0
7907;212683;118;0;0;0;0;.00nan;0;0
7907;218830;118;58;21;3;18;.857;3673000;0
7908;222609;127;0;0;0;0;.00nan;0;0
7908;212681;122;66;16;1;15;.938;3600000;0
7908;212716;127;88;41;2;39;.951;3590000;0
7908;-1;122;0;0;0;0;.00nan;0;0
7909;208652;124;0;0;0;0;.00nan;0;0
7909;221235;126;0;0;0;0;.00nan;0;0
7909;221552;124;50;36;6;30;.833;3600000;0
7909;212039;126;77;37;3;34;.919;3600000;0
7910;208625;119;41;29;5;24;.828;3575000;0
7910;209921;114;0;0;0;0;.00nan;0;0
7910;223149;114;55;26;4;22;.846;3600000;0
7910;218853;119;0;0;0;0;.00nan;0;0
7911;213845;113;21;27;6;21;.778;2230000;0
7911;210765;113;53;18;2;16;.889;1370000;0
7911;212683;118;0;0;0;0;.00nan;0;0
7911;218830;118;81;31;2;29;.935;3600000;0
7912;210773;111;75;42;4;38;.905;3600000;0
7912;217331;125;22;23;6;17;.739;2193000;0
7912;217347;111;0;0;0;0;.00nan;0;0
7912;-1;125;53;10;1;9;.900;1407000;0
7913;213845;113;82;34;3;31;.912;3900000;0
7913;204630;109;72;32;3;29;.906;3900000;0
7913;210765;113;0;0;0;0;.00nan;0;0
7913;221211;109;0;0;0;0;.00nan;0;0
7914;208620;112;63;31;3;28;.903;3576000;0
7914;220332;108;0;0;0;0;.00nan;0;0
7914;212052;112;0;0;0;0;.00nan;0;0
7914;-1;108;97;33;1;32;.970;3600000;0
7915;213722;116;0;0;0;0;.00nan;0;0
7915;209921;114;76;28;2;26;.929;3600000;0
7915;216028;116;73;38;3;35;.921;3600000;0
7915;223149;114;0;0;0;0;.00nan;0;0
7916;215968;110;79;30;2;28;.933;3600000;0
7916;222436;115;0;0;0;0;.00nan;0;0
7916;212667;110;0;0;0;0;.00nan;0;0
7916;223989;115;69;35;3;32;.914;3562000;0
7917;208625;119;0;0;0;0;.00nan;0;0
7917;212681;122;47;25;5;20;.800;3600000;0
7917;-1;122;0;0;0;0;.00nan;0;0
7917;218853;119;42;51;7;44;.863;3515000;0
7918;220601;121;62;21;2;19;.905;3600000;0
7918;210773;111;0;0;0;0;.00nan;0;0
7918;217347;111;52;32;4;28;.875;3564000;0
7918;-1;121;0;0;0;0;.00nan;0;0
7919;215983;117;0;0;0;0;.00nan;0;0
7919;212683;118;59;25;3;22;.880;3569000;0
7919;213504;117;89;35;2;33;.943;3600000;0
7919;218830;118;0;0;0;0;.00nan;0;0
7920;217331;125;0;0;0;0;.00nan;0;0
7920;222609;127;63;27;3;24;.889;3600000;0
7920;212716;127;0;0;0;0;.00nan;0;0
7920;-1;125;48;30;4;26;.867;3545000;0
7921;210785;123;89;33;2;31;.939;3612000;0
7921;221235;126;0;0;0;0;.00nan;0;0
7921;211935;123;0;0;0;0;.00nan;0;0
7921;212039;126;84;30;3;27;.900;3612000;0
7922;213722;116;27;8;3;5;.625;524000;0
7922;220332;108;68;27;3;24;.889;3600000;0
7922;216028;116;26;24;5;19;.792;3076000;0
7922;-1;108;0;0;0;0;.00nan;0;0
7923;212681;122;0;0;0;0;.00nan;0;0
7923;218081;120;78;35;2;33;.943;3600000;0
7923;213613;120;0;0;0;0;.00nan;0;0
7923;-1;122;50;25;4;21;.840;3533000;0
7924;208652;124;0;0;0;0;.00nan;0;0
7924;221235;126;0;0;0;0;.00nan;0;0
7924;221552;124;82;34;3;31;.912;3575000;0
7924;212039;126;72;29;2;27;.931;3600000;0
7925;208625;119;36;30;5;25;.833;3600000;0
7925;215968;110;0;0;0;0;.00nan;0;0
7925;212667;110;96;38;2;36;.947;3600000;0
7925;218853;119;0;0;0;0;.00nan;0;0
7926;222436;115;70;37;3;34;.919;3585000;0
7926;217331;125;87;35;2;33;.943;3600000;0
7926;223989;115;0;0;0;0;.00nan;0;0
7926;-1;125;0;0;0;0;.00nan;0;0
7927;210785;123;0;0;0;0;.00nan;0;0
7927;211935;123;64;35;3;32;.914;3900000;0
7927;222609;127;0;0;0;0;.00nan;0;0
7927;212716;127;72;37;3;34;.919;3900000;0
7928;204630;109;0;0;0;0;.00nan;0;0
7928;209921;114;0;0;0;0;.00nan;0;0
7928;221211;109;52;36;5;31;.861;3600000;0
7928;223149;114;71;21;1;20;.952;3600000;0
7929;213845;113;0;0;0;0;.00nan;0;0
7929;210765;113;93;42;2;40;.952;3600000;0
7929;215983;117;0;0;0;0;.00nan;0;0
7929;213504;117;39;40;7;33;.825;3600000;0
7930;210773;111;74;37;3;34;.919;3600000;0
7930;217347;111;0;0;0;0;.00nan;0;0
7930;212683;118;0;0;0;0;.00nan;0;0
7930;218830;118;35;22;4;18;.818;3560000;0
7931;222436;115;0;0;0;0;.00nan;0;0
7931;222609;127;0;0;0;0;.00nan;0;0
7931;212716;127;70;40;4;36;.900;3592000;0
7931;223989;115;58;26;3;23;.885;3600000;0
7932;208652;124;57;24;3;21;.875;3592000;0
7932;210785;123;66;19;1;18;.947;3600000;0
7932;221552;124;0;0;0;0;.00nan;0;0
7932;211935;123;0;0;0;0;.00nan;0;0
7933;208620;112;0;0;0;0;.00nan;0;0
7933;212052;112;45;29;4;25;.862;3516000;0
7933;218081;120;0;0;0;0;.00nan;0;0
7933;213613;120;92;37;2;35;.946;3600000;0
7934;204630;109;76;38;4;34;.895;3600000;0
7934;221211;109;0;0;0;0;.00nan;0;0
7934;212683;118;0;0;0;0;.00nan;0;0
7934;218830;118;73;28;2;26;.929;3600000;0
7935;208652;124;0;0;0;0;.00nan;0;0
7935;221552;124;70;19;2;17;.895;3900000;0
7935;218081;120;90;36;2;34;.944;3900000;0
7935;213613;120;0;0;0;0;.00nan;0;0
7936;213845;113;20;21;6;15;.714;2003000;0
7936;210765;113;74;21;1;20;.952;1597000;0
7936;215983;117;0;0;0;0;.00nan;0;0
7936;213504;117;74;25;2;23;.920;3600000;0
7937;208620;112;26;41;8;33;.805;3600000;0
7937;215968;110;63;44;5;39;.886;3600000;0
7937;212052;112;0;0;0;0;.00nan;0;0
7937;212667;110;0;0;0;0;.00nan;0;0
7938;217331;125;0;0;0;0;.00nan;0;0
7938;212681;122;58;19;2;17;.895;3600000;0
7938;-1;125;59;33;4;29;.879;3581000;0
7938;-1;122;0;0;0;0;.00nan;0;0
7939;208625;119;0;0;0;0;.00nan;0;0
7939;210785;123;100;46;0;46;1.000;3600000;0
7939;211935;123;0;0;0;0;.00nan;0;0
7939;218853;119;58;19;2;17;.895;3512000;0
7940;220332;108;54;25;3;22;.880;3600000;0
7940;209921;114;0;0;0;0;.00nan;0;0
7940;223149;114;42;27;5;22;.815;3552000;0
7940;-1;108;0;0;0;0;.00nan;0;0
7941;210773;111;84;53;4;49;.925;3900000;0
7941;217347;111;0;0;0;0;.00nan;0;0
7941;212683;118;0;0;0;0;.00nan;0;0
7941;218830;118;60;30;4;26;.867;3900000;0
7942;208625;119;64;26;2;24;.923;3600000;0
7942;208652;124;52;9;1;8;.889;815000;0
7942;221552;124;24;26;6;20;.769;2785000;0
7942;218853;119;0;0;0;0;.00nan;0;0
7943;213845;113;91;31;2;29;.935;3600000;0
7943;210765;113;0;0;0;0;.00nan;0;0
7943;212681;122;0;0;0;0;.00nan;0;0
7943;-1;122;78;46;3;43;.935;3585000;0
7944;204630;109;46;48;7;41;.854;3600000;0
7944;220601;121;69;18;1;17;.944;3600000;0
7944;221211;109;0;0;0;0;.00nan;0;0
7944;-1;121;0;0;0;0;.00nan;0;0
7945;215983;117;67;44;5;39;.886;3540000;0
7945;222436;115;69;32;4;28;.875;3600000;0
7945;213504;117;0;0;0;0;.00nan;0;0
7945;223989;115;0;0;0;0;.00nan;0;0
7946;222609;127;0;0;0;0;.00nan;0;0
7946;212716;127;67;35;3;32;.914;3554000;0
7946;218081;120;0;0;0;0;.00nan;0;0
7946;213613;120;80;38;2;36;.947;3600000;0
7947;213722;116;0;0;0;0;.00nan;0;0
7947;210785;123;67;27;2;25;.926;3600000;0
7947;216028;116;51;31;4;27;.871;3573000;0
7947;211935;123;0;0;0;0;.00nan;0;0
7948;208620;112;0;0;0;0;.00nan;0;0
7948;215968;110;0;0;0;0;.00nan;0;0
7948;212052;112;60;27;4;23;.852;3548000;0
7948;212667;110;86;43;3;40;.930;3600000;0
7949;220332;108;56;4;0;4;1.000;375000;0
7949;212683;118;61;19;2;17;.895;3600000;0
7949;218830;118;0;0;0;0;.00nan;0;0
7949;-1;108;41;40;7;33;.825;3225000;0
7950;213845;113;0;0;0;0;.00nan;0;0
7950;210765;113;78;25;1;24;.960;3600000;0
7950;222436;115;0;0;0;0;.00nan;0;0
7950;223989;115;74;50;5;45;.900;3600000;0
7951;213722;116;52;29;4;25;.862;3600000;0
7951;208652;124;84;30;1;29;.967;3600000;0
7951;216028;116;0;0;0;0;.00nan;0;0
7951;221552;124;0;0;0;0;.00nan;0;0
7952;220601;121;0;0;0;0;.00nan;0;0
7952;218081;120;53;33;5;28;.848;3600000;0
7952;213613;120;0;0;0;0;.00nan;0;0
7952;-1;121;74;27;2;25;.926;3600000;0
7953;221235;126;0;0;0;0;.00nan;0;0
7953;212039;126;89;40;3;37;.925;3600000;0
7953;217331;125;0;0;0;0;.00nan;0;0
7953;-1;125;47;25;4;21;.840;3560000;0
7954;209921;114;0;0;0;0;.00nan;0;0
7954;210773;111;61;25;3;22;.880;3539000;0
7954;217347;111;0;0;0;0;.00nan;0;0
7954;223149;114;75;26;2;24;.923;3600000;0
7955;208625;119;77;46;4;42;.913;3900000;0
7955;222609;127;62;40;4;36;.900;3900000;0
7955;212716;127;0;0;0;0;.00nan;0;0
7955;218853;119;0;0;0;0;.00nan;0;0
7956;221235;126;0;0;0;0;.00nan;0;0
7956;212039;126;79;25;1;24;.960;3600000;0
7956;217331;125;73;25;2;23;.920;3573000;0
7956;-1;125;0;0;0;0;.00nan;0;0
7957;220601;121;59;31;3;28;.903;3900000;0
7957;212681;122;71;35;3;32;.914;3898000;0
7957;-1;121;0;0;0;0;.00nan;0;0
7957;-1;122;0;0;0;0;.00nan;0;0
7958;208620;112;65;27;3;24;.889;3600000;0
7958;204630;109;70;44;5;39;.886;3551000;0
7958;221211;109;0;0;0;0;.00nan;0;0
7958;212052;112;0;0;0;0;.00nan;0;0
7959;210785;123;85;37;2;35;.946;3600000;0
7959;211935;123;0;0;0;0;.00nan;0;0
7959;222609;127;0;0;0;0;.00nan;0;0
7959;212716;127;64;31;3;28;.903;3600000;0
7960;212681;122;65;30;4;26;.867;3600000;0
7960;218081;120;100;25;0;25;1.000;3600000;0
7960;213613;120;0;0;0;0;.00nan;0;0
7960;-1;122;0;0;0;0;.00nan;0;0
7961;208652;124;80;29;1;28;.966;3600000;0
7961;210785;123;0;0;0;0;.00nan;0;0
7961;221552;124;0;0;0;0;.00nan;0;0
7961;211935;123;54;34;5;29;.853;3600000;0
7962;220332;108;56;27;4;23;.852;3600000;0
7962;209921;114;89;29;1;28;.966;3600000;0
7962;223149;114;0;0;0;0;.00nan;0;0
7962;-1;108;0;0;0;0;.00nan;0;0
7963;213845;113;45;24;4;20;.833;3600000;0
7963;210765;113;0;0;0;0;.00nan;0;0
7963;221235;126;0;0;0;0;.00nan;0;0
7963;212039;126;92;51;3;48;.941;3600000;0
7964;215983;117;0;0;0;0;.00nan;0;0
7964;222436;115;51;30;4;26;.867;3600000;0
7964;213504;117;42;30;5;25;.833;3561000;0
7964;223989;115;0;0;0;0;.00nan;0;0
7965;215968;110;68;21;2;19;.905;3600000;0
7965;222609;127;61;42;5;37;.881;3600000;0
7965;212667;110;0;0;0;0;.00nan;0;0
7965;212716;127;0;0;0;0;.00nan;0;0
7966;220601;121;0;0;0;0;.00nan;0;0
7966;217331;125;0;0;0;0;.00nan;0;0
7966;-1;125;87;41;3;38;.927;3600000;0
7966;-1;121;43;30;5;25;.833;3600000;0
7967;204630;109;0;0;0;0;.00nan;0;0
7967;221211;109;72;51;4;47;.922;3900000;0
7967;222436;115;0;0;0;0;.00nan;0;0
7967;223989;115;97;49;4;45;.918;3900000;0
7968;220332;108;46;7;1;6;.857;820000;0
7968;222609;127;0;0;0;0;.00nan;0;0
7968;212716;127;49;33;5;28;.848;3600000;0
7968;-1;108;47;35;6;29;.829;2765000;0
7969;208620;112;49;29;5;24;.828;3600000;0
7969;210773;111;0;0;0;0;.00nan;0;0
7969;212052;112;0;0;0;0;.00nan;0;0
7969;217347;111;40;36;6;30;.833;3584000;0
7970;213722;116;91;36;1;35;.972;3372000;0
7970;209921;114;0;0;0;0;.00nan;0;0
7970;216028;116;27;6;3;3;.500;273000;0
7970;223149;114;53;39;5;34;.872;3645000;0
7971;208625;119;58;29;3;26;.897;3600000;0
7971;215983;117;79;30;2;28;.933;3600000;0
7971;213504;117;0;0;0;0;.00nan;0;0
7971;218853;119;0;0;0;0;.00nan;0;0
7972;215968;110;0;0;0;0;.00nan;0;0
7972;212667;110;80;41;4;37;.902;3591000;0
7972;212681;122;69;24;2;22;.917;3600000;0
7972;-1;122;0;0;0;0;.00nan;0;0
7973;220601;121;74;25;2;23;.920;3600000;0
7973;218081;120;75;43;3;40;.930;3561000;0
7973;213613;120;0;0;0;0;.00nan;0;0
7973;-1;121;0;0;0;0;.00nan;0;0
7974;208652;124;0;0;0;0;.00nan;0;0
7974;221552;124;68;32;3;29;.906;3600000;0
7974;212683;118;0;0;0;0;.00nan;0;0
7974;218830;118;74;27;1;26;.963;3600000;0
7975;204630;109;35;21;4;17;.810;3571000;0
7975;221211;109;0;0;0;0;.00nan;0;0
7975;215983;117;0;0;0;0;.00nan;0;0
7975;213504;117;58;26;3;23;.885;3600000;0
7976;221235;126;0;0;0;0;.00nan;0;0
7976;212039;126;68;39;5;34;.872;3600000;0
7976;222436;115;73;37;4;33;.892;3600000;0
7976;223989;115;0;0;0;0;.00nan;0;0
7977;208625;119;0;0;0;0;.00nan;0;0
7977;208652;124;50;44;6;38;.864;3600000;0
7977;221552;124;0;0;0;0;.00nan;0;0
7977;218853;119;48;16;3;13;.813;3600000;0
7978;213722;116;0;0;0;0;.00nan;0;0
7978;216028;116;88;38;4;34;.895;3563000;0
7978;218081;120;0;0;0;0;.00nan;0;0
7978;213613;120;60;22;2;20;.909;3600000;0
7979;220601;121;0;0;0;0;.00nan;0;0
7979;212683;118;76;21;1;20;.952;3600000;0
7979;218830;118;0;0;0;0;.00nan;0;0
7979;-1;121;44;30;5;25;.833;3600000;0
7980;208620;112;0;0;0;0;.00nan;0;0
7980;210773;111;94;48;2;46;.958;3600000;0
7980;212052;112;51;22;3;19;.864;3600000;0
7980;217347;111;0;0;0;0;.00nan;0;0
7981;210785;123;63;33;4;29;.879;3697000;0
7981;211935;123;0;0;0;0;.00nan;0;0
7981;217331;125;0;0;0;0;.00nan;0;0
7981;-1;125;61;31;3;28;.903;3697000;0
7982;213845;113;46;18;3;15;.833;3600000;0
7982;209921;114;42;32;5;27;.844;3571000;0
7982;210765;113;0;0;0;0;.00nan;0;0
7982;223149;114;0;0;0;0;.00nan;0;0
7983;210773;111;0;0;0;0;.00nan;0;0
7983;217347;111;55;31;4;27;.871;3600000;0
7983;222609;127;52;44;6;38;.864;3359000;0
7983;212716;127;52;3;0;3;1.000;230000;0
7984;221235;126;0;0;0;0;.00nan;0;0
7984;212039;126;95;52;5;47;.904;3600000;0
7984;212681;122;68;26;2;24;.923;3600000;0
7984;-1;122;0;0;0;0;.00nan;0;0
7985;204630;109;0;0;0;0;.00nan;0;0
7985;221211;109;54;42;5;37;.881;3600000;0
7985;215968;110;73;17;1;16;.941;3600000;0
7985;212667;110;0;0;0;0;.00nan;0;0
7986;210785;123;73;22;1;21;.955;2635000;0
7986;211935;123;17;12;5;7;.583;965000;0
7986;217331;125;76;28;3;25;.893;3600000;0
7986;-1;125;0;0;0;0;.00nan;0;0
7987;208620;112;61;30;3;27;.900;3600000;0
7987;220332;108;28;25;6;19;.760;1871000;0
7987;212052;112;0;0;0;0;.00nan;0;0
7987;-1;108;69;17;1;16;.941;1729000;0
7988;220332;108;65;27;3;24;.889;3600000;0
7988;210773;111;49;40;6;34;.850;3600000;0
7988;217347;111;0;0;0;0;.00nan;0;0
7988;-1;108;0;0;0;0;.00nan;0;0
7989;220601;121;63;40;4;36;.900;3600000;0
7989;212683;118;75;36;2;34;.944;3600000;0
7989;218830;118;0;0;0;0;.00nan;0;0
7989;-1;121;0;0;0;0;.00nan;0;0
7990;204630;109;71;35;3;32;.914;3548000;0
7990;221211;109;0;0;0;0;.00nan;0;0
7990;222609;127;0;0;0;0;.00nan;0;0
7990;212716;127;95;31;1;30;.968;3600000;0
7991;221235;126;0;0;0;0;.00nan;0;0
7991;215983;117;0;0;0;0;.00nan;0;0
7991;212039;126;68;39;4;35;.897;3600000;0
7991;213504;117;42;41;6;35;.854;3591000;0
7992;213845;113;81;26;1;25;.962;3600000;0
7992;210765;113;0;0;0;0;.00nan;0;0
7992;215968;110;72;41;4;37;.902;3600000;0
7992;212667;110;0;0;0;0;.00nan;0;0
7993;209921;114;0;0;0;0;.00nan;0;0
7993;222436;115;49;33;5;28;.848;3543000;0
7993;223149;114;50;31;4;27;.871;3600000;0
7993;223989;115;0;0;0;0;.00nan;0;0
7994;217331;125;60;11;0;11;1.000;877000;0
7994;218081;120;56;26;3;23;.885;3600000;0
7994;213613;120;0;0;0;0;.00nan;0;0
7994;-1;125;39;36;6;30;.833;2723000;0
7995;213722;116;0;0;0;0;.00nan;0;0
7995;220332;108;75;23;1;22;.957;3600000;0
7995;216028;116;53;27;3;24;.889;3600000;0
7995;-1;108;0;0;0;0;.00nan;0;0
7996;204630;109;61;32;4;28;.875;3559000;0
7996;210773;111;60;26;3;23;.885;3600000;0
7996;221211;109;0;0;0;0;.00nan;0;0
7996;217347;111;0;0;0;0;.00nan;0;0
7997;208625;119;62;23;2;21;.913;3600000;0
7997;210785;123;79;42;3;39;.929;3600000;0
7997;211935;123;0;0;0;0;.00nan;0;0
7997;218853;119;0;0;0;0;.00nan;0;0
7998;217331;125;79;33;3;30;.909;3600000;0
7998;212681;122;46;24;4;20;.833;3567000;0
7998;-1;125;0;0;0;0;.00nan;0;0
7998;-1;122;0;0;0;0;.00nan;0;0
7999;208652;124;0;0;0;0;.00nan;0;0
7999;220601;121;0;0;0;0;.00nan;0;0
7999;221552;124;73;36;3;33;.917;3567000;0
7999;-1;121;75;21;1;20;.952;3600000;0
8000;215968;110;0;0;0;0;.00nan;0;0
8000;215983;117;44;36;7;29;.806;3543000;0
8000;212667;110;58;40;6;34;.850;3600000;0
8000;213504;117;0;0;0;0;.00nan;0;0
8001;222609;127;37;33;6;27;.818;1953000;0
8001;212716;127;82;25;0;25;1.000;1647000;0
8001;218081;120;0;0;0;0;.00nan;0;0
8001;213613;120;55;19;3;16;.842;3600000;0
8002;213845;113;59;20;2;18;.900;1606000;0
8002;210765;113;22;22;6;16;.727;1994000;0
8002;221235;126;0;0;0;0;.00nan;0;0
8002;212039;126;72;28;2;26;.929;3600000;0
8003;222436;115;0;0;0;0;.00nan;0;0
8003;212683;118;0;0;0;0;.00nan;0;0
8003;223989;115;72;34;4;30;.882;3592000;0
8003;218830;118;73;35;3;32;.914;3600000;0
8004;213722;116;34;26;5;21;.808;3600000;0
8004;210773;111;58;5;0;5;1.000;556000;0
8004;216028;116;0;0;0;0;.00nan;0;0
8004;217347;111;47;34;6;28;.824;3044000;0
8005;220332;108;0;0;0;0;.00nan;0;0
8005;204630;109;0;0;0;0;.00nan;0;0
8005;221211;109;66;39;5;34;.872;3607000;0
8005;-1;108;44;34;6;28;.824;3607000;0
8006;210785;123;0;0;0;0;.00nan;0;0
8006;211935;123;78;32;2;30;.938;3600000;0
8006;222436;115;54;32;5;27;.844;3600000;0
8006;223989;115;0;0;0;0;.00nan;0;0
8007;208652;124;59;40;5;35;.875;3600000;0
8007;221552;124;0;0;0;0;.00nan;0;0
8007;218081;120;81;27;1;26;.963;3600000;0
8007;213613;120;0;0;0;0;.00nan;0;0
8008;208625;119;0;0;0;0;.00nan;0;0
8008;220601;121;23;29;7;22;.759;3572000;0
8008;-1;121;0;0;0;0;.00nan;0;0
8008;218853;119;54;35;5;30;.857;3600000;0
8009;217331;125;44;4;1;3;.750;637000;0
8009;212681;122;0;0;0;0;.00nan;0;0
8009;-1;125;86;61;6;55;.902;2963000;0
8009;-1;122;58;12;1;11;.917;3600000;0
8010;209921;114;0;0;0;0;.00nan;0;0
8010;212683;118;24;24;6;18;.750;3600000;0
8010;223149;114;77;53;5;48;.906;3600000;0
8010;218830;118;0;0;0;0;.00nan;0;0
8011;213845;113;89;36;2;34;.944;3600000;0
8011;210765;113;0;0;0;0;.00nan;0;0
8011;215983;117;0;0;0;0;.00nan;0;0
8011;213504;117;59;30;4;26;.867;3570000;0
8012;208620;112;71;26;2;24;.923;3600000;0
8012;215968;110;72;41;4;37;.902;3599000;0
8012;212052;112;0;0;0;0;.00nan;0;0
8012;212667;110;0;0;0;0;.00nan;0;0
8013;208652;124;0;0;0;0;.00nan;0;0
8013;221552;124;32;31;6;25;.806;3600000;0
8013;222609;127;0;0;0;0;.00nan;0;0
8013;212716;127;66;26;2;24;.923;3600000;0
8014;208625;119;43;40;6;34;.850;3600000;0
8014;212681;122;74;28;2;26;.929;3600000;0
8014;-1;122;0;0;0;0;.00nan;0;0
8014;218853;119;0;0;0;0;.00nan;0;0
8015;208652;124;68;42;4;38;.905;3600000;0
8015;210785;123;62;22;2;20;.909;3600000;0
8015;221552;124;0;0;0;0;.00nan;0;0
8015;211935;123;0;0;0;0;.00nan;0;0
8016;209921;114;72;30;3;27;.900;3600000;0
8016;218081;120;0;0;0;0;.00nan;0;0
8016;223149;114;0;0;0;0;.00nan;0;0
8016;213613;120;49;27;4;23;.852;3596000;0
8017;213845;113;64;32;4;28;.875;3576000;0
8017;220601;121;0;0;0;0;.00nan;0;0
8017;210765;113;0;0;0;0;.00nan;0;0
8017;-1;121;66;31;3;28;.903;3600000;0
8018;204630;109;80;34;3;31;.912;3600000;0
8018;221211;109;0;0;0;0;.00nan;0;0
8018;222436;115;7;27;8;19;.704;3600000;0
8018;223989;115;0;0;0;0;.00nan;0;0
8019;208625;119;73;30;3;27;.900;3600000;0
8019;221235;126;0;0;0;0;.00nan;0;0
8019;212039;126;90;46;4;42;.913;3597000;0
8019;218853;119;0;0;0;0;.00nan;0;0
8020;215968;110;63;35;4;31;.886;3600000;0
8020;217331;125;0;0;0;0;.00nan;0;0
8020;212667;110;0;0;0;0;.00nan;0;0
8020;-1;125;57;38;5;33;.868;3576000;0
8021;204630;109;0;0;0;0;.00nan;0;0
8021;221211;109;99;34;1;33;.971;3600000;0
8021;221235;126;0;0;0;0;.00nan;0;0
8021;212039;126;87;31;2;29;.935;3546000;0
8022;220332;108;56;27;4;23;.852;3600000;0
8022;217331;125;53;39;6;33;.846;3231000;0
8022;-1;125;50;1;0;1;1.000;342000;0
8022;-1;108;0;0;0;0;.00nan;0;0
8023;213722;116;0;0;0;0;.00nan;0;0
8023;215968;110;0;0;0;0;.00nan;0;0
8023;216028;116;56;18;2;16;.889;3559000;0
8023;212667;110;100;35;0;35;1.000;3600000;0
8024;212681;122;79;40;3;37;.925;3600000;0
8024;218081;120;50;1;0;1;1.000;590000;0
8024;213613;120;26;32;6;26;.813;3010000;0
8024;-1;122;0;0;0;0;.00nan;0;0
8025;220601;121;72;23;1;22;.957;3600000;0
8025;215983;117;0;0;0;0;.00nan;0;0
8025;213504;117;62;22;2;20;.909;3566000;0
8025;-1;121;0;0;0;0;.00nan;0;0
8026;213845;113;0;0;0;0;.00nan;0;0
8026;210765;113;56;35;4;31;.886;3873000;0
8026;212683;118;0;0;0;0;.00nan;0;0
8026;218830;118;52;24;3;21;.875;3873000;0
8027;208620;112;94;30;2;28;.933;3600000;0
8027;210773;111;66;35;3;32;.914;3546000;0
8027;212052;112;0;0;0;0;.00nan;0;0
8027;217347;111;0;0;0;0;.00nan;0;0
8028;208620;112;0;0;0;0;.00nan;0;0
8028;210773;111;40;35;6;29;.829;3255000;0
8028;212052;112;65;32;3;29;.906;3600000;0
8028;217347;111;55;3;0;3;1.000;345000;0
8029;212681;122;0;0;0;0;.00nan;0;0
8029;212683;118;91;40;2;38;.950;3600000;0
8029;218830;118;0;0;0;0;.00nan;0;0
8029;-1;122;77;34;3;31;.912;3554000;0
8030;208652;124;0;0;0;0;.00nan;0;0
8030;221552;124;37;35;6;29;.829;3600000;0
8030;222436;115;90;38;1;37;.974;3600000;0
8030;223989;115;0;0;0;0;.00nan;0;0
8031;213722;116;67;36;3;33;.917;3770000;0
8031;208625;119;0;0;0;0;.00nan;0;0
8031;216028;116;0;0;0;0;.00nan;0;0
8031;218853;119;54;18;2;16;.889;3770000;0
8032;213845;113;79;28;1;27;.964;3600000;0
8032;210765;113;0;0;0;0;.00nan;0;0
8032;218081;120;61;8;0;8;1.000;1096000;0
8032;213613;120;35;33;6;27;.818;2504000;0
8033;210785;123;26;29;6;23;.793;3600000;0
8033;211935;123;0;0;0;0;.00nan;0;0
8033;222609;127;0;0;0;0;.00nan;0;0
8033;212716;127;71;33;3;30;.909;3600000;0
8034;209921;114;0;0;0;0;.00nan;0;0
8034;220601;121;0;0;0;0;.00nan;0;0
8034;223149;114;72;38;3;35;.921;3543000;0
8034;-1;121;79;24;1;23;.958;3600000;0
8035;220332;108;36;26;5;21;.808;3600000;0
8035;204630;109;87;31;2;29;.935;3600000;0
8035;221211;109;0;0;0;0;.00nan;0;0
8035;-1;108;0;0;0;0;.00nan;0;0
8036;210773;111;0;0;0;0;.00nan;0;0
8036;217331;125;0;0;0;0;.00nan;0;0
8036;217347;111;58;34;4;30;.882;3549000;0
8036;-1;125;67;32;3;29;.906;3600000;0
8037;222609;127;70;36;3;33;.917;3900000;0
8037;212683;118;0;0;0;0;.00nan;0;0
8037;212716;127;0;0;0;0;.00nan;0;0
8037;218830;118;65;32;3;29;.906;3900000;0
8038;213722;116;0;0;0;0;.00nan;0;0
8038;221235;126;0;0;0;0;.00nan;0;0
8038;216028;116;81;42;3;39;.929;3543000;0
8038;212039;126;65;21;2;19;.905;3600000;0
8039;208652;124;79;53;4;49;.925;3600000;0
8039;221552;124;0;0;0;0;.00nan;0;0
8039;212681;122;83;24;1;23;.958;3600000;0
8039;-1;122;0;0;0;0;.00nan;0;0
8040;210785;123;0;0;0;0;.00nan;0;0
8040;211935;123;74;34;3;31;.912;3600000;0
8040;222436;115;41;2;1;1;.500;251000;0
8040;223989;115;20;23;6;17;.739;3349000;0
8041;208620;112;85;31;1;30;.968;3600000;0
8041;215983;117;0;0;0;0;.00nan;0;0
8041;212052;112;0;0;0;0;.00nan;0;0
8041;213504;117;56;36;5;31;.861;3600000;0
8042;215968;110;0;0;0;0;.00nan;0;0
8042;215983;117;49;33;5;28;.848;3578000;0
8042;212667;110;70;33;3;30;.909;3600000;0
8042;213504;117;0;0;0;0;.00nan;0;0
8043;220332;108;81;24;1;23;.958;3600000;0
8043;210773;111;75;42;3;39;.929;3592000;0
8043;217347;111;0;0;0;0;.00nan;0;0
8043;-1;108;0;0;0;0;.00nan;0;0
8044;213722;116;0;0;0;0;.00nan;0;0
8044;216028;116;70;37;3;34;.919;3600000;0
8044;212683;118;0;0;0;0;.00nan;0;0
8044;218830;118;74;25;2;23;.920;3600000;0
8045;204630;109;54;45;6;39;.867;3724000;0
8045;221211;109;0;0;0;0;.00nan;0;0
8045;222436;115;31;30;6;24;.800;2886000;0
8045;223989;115;46;2;1;1;.500;838000;0
8046;208625;119;100;29;0;29;1.000;3600000;0
8046;212681;122;83;29;1;28;.966;3600000;0
8046;-1;122;0;0;0;0;.00nan;0;0
8046;218853;119;0;0;0;0;.00nan;0;0
8047;210785;123;70;41;4;37;.902;3600000;0
8047;221235;126;38;14;3;11;.786;1260000;0
8047;211935;123;0;0;0;0;.00nan;0;0
8047;212039;126;28;27;6;21;.778;2340000;0
8048;209921;114;0;0;0;0;.00nan;0;0
8048;217331;125;32;35;7;28;.800;3218000;0
8048;223149;114;47;27;4;23;.852;3600000;0
8048;-1;125;51;3;0;3;1.000;382000;0
8049;208652;124;0;0;0;0;.00nan;0;0
8049;215968;110;66;19;1;18;.947;3600000;0
8049;221552;124;81;27;2;25;.926;3572000;0
8049;212667;110;0;0;0;0;.00nan;0;0
8050;213845;113;49;39;6;33;.846;3228000;0
8050;220332;108;0;0;0;0;.00nan;0;0
8050;210765;113;60;7;0;7;1.000;353000;0
8050;-1;108;32;24;5;19;.792;3600000;0
8051;222436;115;64;45;6;39;.867;3554000;0
8051;212681;122;73;19;1;18;.947;2877000;0
8051;223989;115;0;0;0;0;.00nan;0;0
8051;-1;122;19;7;4;3;.429;723000;0
8052;213722;116;0;0;0;0;.00nan;0;0
8052;220601;121;68;22;2;20;.909;3600000;0
8052;216028;116;77;41;4;37;.902;3546000;0
8052;-1;121;0;0;0;0;.00nan;0;0
8053;209921;114;44;41;6;35;.854;3600000;0
8053;215983;117;0;0;0;0;.00nan;0;0
8053;223149;114;0;0;0;0;.00nan;0;0
8053;213504;117;83;20;1;19;.950;3600000;0
8054;204630;109;49;26;4;22;.846;3556000;0
8054;221211;109;0;0;0;0;.00nan;0;0
8054;222609;127;0;0;0;0;.00nan;0;0
8054;212716;127;69;30;3;27;.900;3600000;0
8055;210785;123;37;29;5;24;.828;3539000;0
8055;221235;126;65;37;3;34;.919;3600000;0
8055;211935;123;0;0;0;0;.00nan;0;0
8055;212039;126;0;0;0;0;.00nan;0;0
8056;217331;125;0;0;0;0;.00nan;0;0
8056;212683;118;0;0;0;0;.00nan;0;0
8056;218830;118;56;11;1;10;.909;3600000;0
8056;-1;125;81;37;2;35;.946;3579000;0
8057;208652;124;59;27;4;23;.852;3600000;0
8057;210773;111;81;37;3;34;.919;3600000;0
8057;221552;124;0;0;0;0;.00nan;0;0
8057;217347;111;0;0;0;0;.00nan;0;0
8058;208620;112;53;26;3;23;.885;3600000;0
8058;204630;109;67;39;4;35;.897;3573000;0
8058;221211;109;0;0;0;0;.00nan;0;0
8058;212052;112;0;0;0;0;.00nan;0;0
8059;208625;119;94;41;2;39;.951;3600000;0
8059;218081;120;0;0;0;0;.00nan;0;0
8059;213613;120;65;33;3;30;.909;3546000;0
8059;218853;119;0;0;0;0;.00nan;0;0
8060;213845;113;0;0;0;0;.00nan;0;0
8060;210765;113;31;22;4;18;.818;3568000;0
8060;215968;110;81;45;3;42;.933;3600000;0
8060;212667;110;0;0;0;0;.00nan;0;0
8061;220601;121;0;0;0;0;.00nan;0;0
8061;210785;123;0;0;0;0;.00nan;0;0
8061;211935;123;64;46;5;41;.891;3600000;0
8061;-1;121;57;17;2;15;.882;3600000;0
8062;209921;114;0;0;0;0;.00nan;0;0
8062;221235;126;0;0;0;0;.00nan;0;0
8062;212039;126;59;24;3;21;.875;3600000;0
8062;223149;114;44;23;4;19;.826;3600000;0
8063;208652;124;0;0;0;0;.00nan;0;0
8063;220332;108;0;0;0;0;.00nan;0;0
8063;221552;124;67;28;2;26;.929;3545000;0
8063;-1;108;80;26;1;25;.962;3600000;0
8064;213845;113;59;30;3;27;.900;3900000;0
8064;210765;113;0;0;0;0;.00nan;0;0
8064;210773;111;0;0;0;0;.00nan;0;0
8064;217347;111;79;47;3;44;.936;3900000;0
8065;213722;116;93;30;1;29;.967;3663000;0
8065;215983;117;0;0;0;0;.00nan;0;0
8065;216028;116;0;0;0;0;.00nan;0;0
8065;213504;117;89;28;2;26;.929;3663000;0
8066;215968;110;42;20;4;16;.800;2485000;0
8066;222436;115;0;0;0;0;.00nan;0;0
8066;212667;110;19;10;4;6;.600;1115000;0
8066;223989;115;55;27;3;24;.889;3600000;0
8067;208620;112;0;0;0;0;.00nan;0;0
8067;212052;112;93;51;3;48;.941;3900000;0
8067;212683;118;73;32;3;29;.906;3900000;0
8067;218830;118;0;0;0;0;.00nan;0;0
8068;208625;119;0;0;0;0;.00nan;0;0
8068;218081;120;0;0;0;0;.00nan;0;0
8068;213613;120;63;41;4;37;.902;3515000;0
8068;218853;119;81;32;2;30;.938;3600000;0
8069;222609;127;0;0;0;0;.00nan;0;0
8069;212681;122;0;0;0;0;.00nan;0;0
8069;212716;127;55;43;5;38;.884;3600000;0
8069;-1;122;42;20;4;16;.800;3600000;0
8070;212681;122;60;14;1;13;.929;828000;0
8070;212683;118;0;0;0;0;.00nan;0;0
8070;218830;118;56;29;3;26;.897;3600000;0
8070;-1;122;38;38;6;32;.842;2772000;0
8071;220601;121;0;0;0;0;.00nan;0;0
8071;222609;127;0;0;0;0;.00nan;0;0
8071;212716;127;38;27;5;22;.815;3600000;0
8071;-1;121;63;30;3;27;.900;3600000;0
8072;208620;112;17;27;6;21;.778;3126000;0
8072;210773;111;42;27;5;22;.815;3600000;0
8072;212052;112;57;4;0;4;1.000;422000;0
8072;217347;111;0;0;0;0;.00nan;0;0
8073;221235;126;0;0;0;0;.00nan;0;0
8073;215983;117;19;29;7;22;.759;3600000;0
8073;212039;126;70;43;4;39;.907;3600000;0
8073;213504;117;0;0;0;0;.00nan;0;0
8074;209921;114;0;0;0;0;.00nan;0;0
8074;222609;127;95;30;1;29;.967;3600000;0
8074;212716;127;0;0;0;0;.00nan;0;0
8074;223149;114;68;36;4;32;.889;3600000;0
8075;213845;113;97;40;2;38;.950;3600000;0
8075;220332;108;50;1;0;1;1.000;321000;0
8075;210765;113;0;0;0;0;.00nan;0;0
8075;-1;108;25;31;6;25;.806;3279000;0
8076;208625;119;98;38;1;37;.974;3600000;0
8076;222436;115;94;44;3;41;.932;3522000;0
8076;223989;115;0;0;0;0;.00nan;0;0
8076;218853;119;0;0;0;0;.00nan;0;0
8077;204630;109;42;35;6;29;.829;3133000;0
8077;221211;109;55;5;0;5;1.000;467000;0
8077;215968;110;87;34;1;33;.971;3600000;0
8077;212667;110;0;0;0;0;.00nan;0;0
8078;209921;114;67;53;5;48;.906;3600000;0
8078;217331;125;75;24;1;23;.958;3600000;0
8078;223149;114;0;0;0;0;.00nan;0;0
8078;-1;125;0;0;0;0;.00nan;0;0
8079;210773;111;54;36;5;31;.861;3600000;0
8079;215968;110;24;40;8;32;.800;3600000;0
8079;217347;111;0;0;0;0;.00nan;0;0
8079;212667;110;0;0;0;0;.00nan;0;0
8080;213722;116;0;0;0;0;.00nan;0;0
8080;213845;113;0;0;0;0;.00nan;0;0
8080;210765;113;78;29;2;27;.931;3600000;0
8080;216028;116;89;44;3;41;.932;3600000;0
8081;204630;109;48;34;5;29;.853;3600000;0
8081;221211;109;0;0;0;0;.00nan;0;0
8081;212681;122;66;22;1;21;.955;3600000;0
8081;-1;122;0;0;0;0;.00nan;0;0
8082;220601;121;0;0;0;0;.00nan;0;0
8082;210785;123;68;51;5;46;.902;3600000;0
8082;211935;123;0;0;0;0;.00nan;0;0
8082;-1;121;45;22;4;18;.818;3600000;0
8083;215983;117;43;20;3;17;.850;3389000;0
8083;222436;115;0;0;0;0;.00nan;0;0
8083;213504;117;21;3;3;0;.000;211000;0
8083;223989;115;68;29;3;26;.897;3600000;0
8084;220332;108;51;24;3;21;.875;3900000;0
8084;221235;126;0;0;0;0;.00nan;0;0
8084;212039;126;79;39;3;36;.923;3900000;0
8084;-1;108;0;0;0;0;.00nan;0;0
8085;212683;118;0;0;0;0;.00nan;0;0
8085;218081;120;0;0;0;0;.00nan;0;0
8085;213613;120;69;35;3;32;.914;3584000;0
8085;218830;118;76;23;1;22;.957;3600000;0
8086;204630;109;63;37;4;33;.892;3556000;0
8086;221211;109;0;0;0;0;.00nan;0;0
8086;212681;122;0;0;0;0;.00nan;0;0
8086;-1;122;58;27;3;24;.889;3600000;0
8087;208652;124;0;0;0;0;.00nan;0;0
8087;210785;123;0;0;0;0;.00nan;0;0
8087;221552;124;66;23;2;21;.913;3749000;0
8087;211935;123;60;32;3;29;.906;3749000;0
8088;208625;119;100;34;1;33;.971;3600000;0
8088;212683;118;65;20;2;18;.900;3592000;0
8088;218830;118;0;0;0;0;.00nan;0;0
8088;218853;119;0;0;0;0;.00nan;0;0
8089;222609;127;0;0;0;0;.00nan;0;0
8089;212716;127;49;31;5;26;.839;3560000;0
8089;218081;120;0;0;0;0;.00nan;0;0
8089;213613;120;50;25;3;22;.880;3600000;0
8090;208620;112;52;23;3;20;.870;3618000;0
8090;212052;112;0;0;0;0;.00nan;0;0
8090;217331;125;0;0;0;0;.00nan;0;0
8090;-1;125;79;38;2;36;.947;3618000;0
8091;213722;116;54;36;4;32;.889;3600000;0
8091;209921;114;0;0;0;0;.00nan;0;0
8091;216028;116;0;0;0;0;.00nan;0;0
8091;223149;114;86;30;1;29;.967;3600000;0
8092;210773;111;66;26;2;24;.923;3600000;0
8092;215968;110;55;7;0;7;1.000;1092000;0
8092;217347;111;0;0;0;0;.00nan;0;0
8092;212667;110;16;22;6;16;.727;2508000;0
8093;220332;108;0;0;0;0;.00nan;0;0
8093;215983;117;0;0;0;0;.00nan;0;0
8093;213504;117;73;29;2;27;.931;3600000;0
8093;-1;108;63;28;3;25;.893;3600000;0
8094;208620;112;0;0;0;0;.00nan;0;0
8094;212052;112;75;24;1;23;.958;3600000;0
8094;222609;127;52;33;4;29;.879;3600000;0
8094;212716;127;0;0;0;0;.00nan;0;0
8095;220601;121;0;0;0;0;.00nan;0;0
8095;221235;126;0;0;0;0;.00nan;0;0
8095;212039;126;69;31;4;27;.871;3685000;0
8095;-1;121;62;32;3;29;.906;3685000;0
8096;213722;116;0;0;0;0;.00nan;0;0
8096;216028;116;79;37;4;33;.892;3600000;0
8096;222436;115;65;44;5;39;.886;3590000;0
8096;223989;115;0;0;0;0;.00nan;0;0
8097;212681;122;52;45;6;39;.867;3600000;0
8097;212683;118;0;0;0;0;.00nan;0;0
8097;218830;118;65;19;2;17;.895;3600000;0
8097;-1;122;0;0;0;0;.00nan;0;0
8098;208652;124;53;46;6;40;.870;3600000;0
8098;221552;124;0;0;0;0;.00nan;0;0
8098;217331;125;72;19;1;18;.947;3600000;0
8098;-1;125;0;0;0;0;.00nan;0;0
8099;213845;113;72;37;3;34;.919;3600000;0
8099;210765;113;0;0;0;0;.00nan;0;0
8099;221235;126;0;0;0;0;.00nan;0;0
8099;212039;126;32;35;6;29;.829;3600000;0
8100;212683;118;0;0;0;0;.00nan;0;0
8100;218081;120;0;0;0;0;.00nan;0;0
8100;213613;120;74;27;2;25;.926;3556000;0
8100;218830;118;84;33;1;32;.970;3600000;0
8101;213722;116;0;0;0;0;.00nan;0;0
8101;208620;112;45;17;3;14;.824;3699000;0
8101;216028;116;88;49;4;45;.918;3729000;0
8101;212052;112;0;0;0;0;.00nan;0;0
8102;210773;111;35;22;4;18;.818;3565000;0
8102;222436;115;66;32;3;29;.906;3600000;0
8102;217347;111;0;0;0;0;.00nan;0;0
8102;223989;115;0;0;0;0;.00nan;0;0
8103;220332;108;32;29;6;23;.793;2979000;0
8103;215968;110;79;30;2;28;.933;3600000;0
8103;212667;110;0;0;0;0;.00nan;0;0
8103;-1;108;49;1;0;1;1.000;621000;0
8104;220601;121;0;0;0;0;.00nan;0;0
8104;217331;125;0;0;0;0;.00nan;0;0
8104;-1;125;70;54;5;49;.907;3600000;0
8104;-1;121;66;19;1;18;.947;3600000;0
8105;208652;124;0;0;0;0;.00nan;0;0
8105;210785;123;52;30;4;26;.867;3549000;0
8105;221552;124;70;36;3;33;.917;3600000;0
8105;211935;123;0;0;0;0;.00nan;0;0
8106;204630;109;62;45;5;40;.889;3600000;0
8106;209921;114;0;0;0;0;.00nan;0;0
8106;221211;109;0;0;0;0;.00nan;0;0
8106;223149;114;74;31;2;29;.935;3600000;0
8107;220332;108;0;0;0;0;.00nan;0;0
8107;222436;115;0;0;0;0;.00nan;0;0
8107;223989;115;81;32;2;30;.938;3600000;0
8107;-1;108;49;40;6;34;.850;3600000;0
8108;213722;116;0;0;0;0;.00nan;0;0
8108;208620;112;36;19;4;15;.789;3600000;0
8108;216028;116;50;52;7;45;.865;3600000;0
8108;212052;112;0;0;0;0;.00nan;0;0
8109;208652;124;52;24;4;20;.833;3600000;0
8109;215983;117;0;0;0;0;.00nan;0;0
8109;221552;124;0;0;0;0;.00nan;0;0
8109;213504;117;66;14;1;13;.929;3600000;0
8110;213845;113;90;43;2;41;.953;3600000;0
8110;208625;119;69;33;3;30;.909;3571000;0
8110;210765;113;0;0;0;0;.00nan;0;0
8110;218853;119;0;0;0;0;.00nan;0;0
8111;221235;126;0;0;0;0;.00nan;0;0
8111;212039;126;56;32;4;28;.875;3864000;0
8111;212681;122;92;50;3;47;.940;3864000;0
8111;-1;122;0;0;0;0;.00nan;0;0
8112;220601;121;67;25;2;23;.920;3600000;0
8112;218081;120;62;33;4;29;.879;3600000;0
8112;213613;120;0;0;0;0;.00nan;0;0
8112;-1;121;0;0;0;0;.00nan;0;0
8113;210785;123;0;0;0;0;.00nan;0;0
8113;211935;123;94;50;3;47;.940;3600000;0
8113;222609;127;0;0;0;0;.00nan;0;0
8113;212716;127;98;23;0;23;1.000;3600000;0
8114;215968;110;61;43;6;37;.860;3600000;0
8114;212667;110;0;0;0;0;.00nan;0;0
8114;212683;118;69;18;1;17;.944;3600000;0
8114;218830;118;0;0;0;0;.00nan;0;0
8115;221235;126;0;0;0;0;.00nan;0;0
8115;212039;126;67;39;4;35;.897;3538000;0
8115;212683;118;0;0;0;0;.00nan;0;0
8115;218830;118;84;38;2;36;.947;3600000;0
8116;213845;113;0;0;0;0;.00nan;0;0
8116;210765;113;55;38;5;33;.868;3548000;0
8116;222436;115;77;42;4;38;.905;3600000;0
8116;223989;115;0;0;0;0;.00nan;0;0
8117;208652;124;0;0;0;0;.00nan;0;0
8117;221552;124;49;45;7;38;.844;3600000;0
8117;222609;127;0;0;0;0;.00nan;0;0
8117;212716;127;68;17;1;16;.941;3600000;0
8118;208625;119;0;0;0;0;.00nan;0;0
8118;210773;111;50;35;5;30;.857;3570000;0
8118;217347;111;0;0;0;0;.00nan;0;0
8118;218853;119;72;39;4;35;.897;3600000;0
8119;217331;125;0;0;0;0;.00nan;0;0
8119;218081;120;0;0;0;0;.00nan;0;0
8119;213613;120;44;26;4;22;.846;3600000;0
8119;-1;125;45;48;8;40;.833;3600000;0
8120;210785;123;100;38;1;37;.974;3600000;0
8120;215983;117;53;30;4;26;.867;3600000;0
8120;211935;123;0;0;0;0;.00nan;0;0
8120;213504;117;0;0;0;0;.00nan;0;0
8121;209921;114;70;24;1;23;.958;3600000;0
8121;212681;122;0;0;0;0;.00nan;0;0
8121;223149;114;0;0;0;0;.00nan;0;0
8121;-1;122;66;26;3;23;.885;3551000;0
8122;220332;108;0;0;0;0;.00nan;0;0
8122;204630;109;69;43;5;38;.884;3569000;0
8122;221211;109;0;0;0;0;.00nan;0;0
8122;-1;108;53;22;4;18;.818;3600000;0
8123;213722;116;45;4;1;3;.750;804000;0
8123;210773;111;0;0;0;0;.00nan;0;0
8123;216028;116;49;37;6;31;.838;2796000;0
8123;217347;111;60;27;3;24;.889;3600000;0
8124;220601;121;56;4;0;4;1.000;651000;0
8124;215983;117;0;0;0;0;.00nan;0;0
8124;213504;117;100;39;1;38;.974;3600000;0
8124;-1;121;28;29;6;23;.793;2949000;0
8125;208620;112;0;0;0;0;.00nan;0;0
8125;215968;110;31;30;6;24;.800;2709000;0
8125;212052;112;72;34;3;31;.912;3600000;0
8125;212667;110;50;8;1;7;.875;891000;0
8126;220332;108;47;14;2;12;.857;3600000;0
8126;215968;110;49;41;6;35;.854;2233000;0
8126;212667;110;67;19;2;17;.895;1367000;0
8126;-1;108;0;0;0;0;.00nan;0;0
8127;209921;114;0;0;0;0;.00nan;0;0
8127;215983;117;0;0;0;0;.00nan;0;0
8127;223149;114;59;33;4;29;.879;3584000;0
8127;213504;117;92;41;3;38;.927;3600000;0
8128;213722;116;0;0;0;0;.00nan;0;0
8128;216028;116;92;40;2;38;.950;3600000;0
8128;217331;125;0;0;0;0;.00nan;0;0
8128;-1;125;74;26;3;23;.885;3600000;0
8129;213845;113;82;42;3;39;.929;3600000;0
8129;210765;113;0;0;0;0;.00nan;0;0
8129;210773;111;37;19;4;15;.789;3600000;0
8129;217347;111;0;0;0;0;.00nan;0;0
8130;208625;119;68;39;4;35;.897;3600000;0
8130;212683;118;0;0;0;0;.00nan;0;0
8130;218830;118;90;31;1;30;.968;3600000;0
8130;218853;119;0;0;0;0;.00nan;0;0
8131;222436;115;59;41;5;36;.878;3600000;0
8131;218081;120;69;31;2;29;.935;3600000;0
8131;223989;115;0;0;0;0;.00nan;0;0
8131;213613;120;0;0;0;0;.00nan;0;0
8132;208620;112;100;25;0;25;1.000;3600000;0
8132;204630;109;49;40;7;33;.825;2986000;0
8132;221211;109;61;8;0;8;1.000;614000;0
8132;212052;112;0;0;0;0;.00nan;0;0
8133;220601;121;0;0;0;0;.00nan;0;0
8133;222609;127;57;27;4;23;.852;3718000;0
8133;212716;127;0;0;0;0;.00nan;0;0
8133;-1;121;31;22;5;17;.773;3718000;0
8134;221235;126;40;21;4;17;.810;3550000;0
8134;211890;123;0;0;0;0;.00nan;0;0
8134;211935;123;84;31;2;29;.935;3600000;0
8134;218014;126;0;0;0;0;.00nan;0;0
8135;213722;116;32;32;6;26;.813;3163000;0
8135;215968;110;77;31;2;29;.935;3600000;0
8135;216028;116;52;8;1;7;.875;437000;0
8135;212667;110;0;0;0;0;.00nan;0;0
8136;208652;124;69;30;3;27;.900;3850000;0
8136;221552;124;0;0;0;0;.00nan;0;0
8136;212681;122;74;31;2;29;.935;3850000;0
8136;-1;122;0;0;0;0;.00nan;0;0
8137;220601;121;49;21;3;18;.857;3564000;0
8137;222609;127;0;0;0;0;.00nan;0;0
8137;212716;127;94;33;1;32;.970;3600000;0
8137;-1;121;0;0;0;0;.00nan;0;0
8138;213845;113;0;0;0;0;.00nan;0;0
8138;210765;113;37;33;5;28;.848;3600000;0
8138;215983;117;77;32;2;30;.938;3600000;0
8138;213504;117;0;0;0;0;.00nan;0;0
8139;220332;108;0;0;0;0;.00nan;0;0
8139;210773;111;100;31;0;31;1.000;3600000;0
8139;217347;111;0;0;0;0;.00nan;0;0
8139;-1;108;60;17;1;16;.941;3561000;0
8140;204630;109;99;35;1;34;.971;3600000;0
8140;209921;114;0;0;0;0;.00nan;0;0
8140;221211;109;0;0;0;0;.00nan;0;0
8140;223149;114;71;33;3;30;.909;3545000;0
8141;208652;124;31;20;4;16;.800;3209000;0
8141;221552;124;26;7;3;4;.571;391000;0
8141;212683;118;0;0;0;0;.00nan;0;0
8141;218830;118;70;26;2;24;.923;3600000;0
8142;208625;119;49;31;5;26;.839;3554000;0
8142;222436;115;0;0;0;0;.00nan;0;0
8142;223989;115;45;29;4;25;.862;3600000;0
8142;218853;119;0;0;0;0;.00nan;0;0
8143;212681;122;0;0;0;0;.00nan;0;0
8143;218081;120;0;0;0;0;.00nan;0;0
8143;213613;120;35;22;5;17;.773;3600000;0
8143;-1;122;89;39;2;37;.949;3600000;0
8144;211890;123;0;0;0;0;.00nan;0;0
8144;211935;123;59;41;5;36;.878;3600000;0
8144;217331;125;0;0;0;0;.00nan;0;0
8144;-1;125;4;20;8;12;.600;3600000;0
8145;221235;126;0;0;0;0;.00nan;0;0
8145;215983;117;0;0;0;0;.00nan;0;0
8145;218014;126;48;33;5;28;.848;3600000;0
8145;213504;117;80;29;2;27;.931;3600000;0
8146;213845;113;90;41;1;40;.976;3600000;0
8146;208620;112;53;18;2;16;.889;3600000;0
8146;210765;113;0;0;0;0;.00nan;0;0
8146;212052;112;0;0;0;0;.00nan;0;0
8147;213722;116;0;0;0;0;.00nan;0;0
8147;215968;110;38;33;6;27;.818;3600000;0
8147;216028;116;60;20;2;18;.900;3600000;0
8147;212667;110;0;0;0;0;.00nan;0;0
8148;217331;125;60;39;5;34;.872;3600000;0
8148;222609;127;52;17;2;15;.882;981000;0
8148;212716;127;25;27;6;21;.778;2619000;0
8148;-1;125;0;0;0;0;.00nan;0;0
8149;221235;126;88;21;0;21;1.000;3600000;0
8149;211890;123;51;22;3;19;.864;3600000;0
8149;211935;123;0;0;0;0;.00nan;0;0
8149;218014;126;0;0;0;0;.00nan;0;0
8150;208625;119;0;0;0;0;.00nan;0;0
8150;204630;109;59;7;0;7;1.000;751000;0
8150;221211;109;22;26;7;19;.731;2836000;0
8150;218853;119;17;21;6;15;.714;3600000;0
8151;208652;124;0;0;0;0;.00nan;0;0
8151;220601;121;0;0;0;0;.00nan;0;0
8151;221552;124;41;35;5;30;.857;3600000;0
8151;-1;121;62;23;2;21;.913;3600000;0
8152;222436;115;69;41;3;38;.927;3900000;0
8152;212683;118;72;33;3;30;.909;3900000;0
8152;223989;115;0;0;0;0;.00nan;0;0
8152;218830;118;0;0;0;0;.00nan;0;0
8153;209921;114;81;34;2;32;.941;3600000;0
8153;218081;120;35;29;5;24;.828;3600000;0
8153;223149;114;0;0;0;0;.00nan;0;0
8153;213613;120;0;0;0;0;.00nan;0;0
8154;208620;112;0;0;0;0;.00nan;0;0
8154;212052;112;73;32;3;29;.906;3600000;0
8154;212681;122;31;30;6;24;.800;3600000;0
8154;-1;122;0;0;0;0;.00nan;0;0
8155;220332;108;47;25;3;22;.880;3561000;0
8155;210773;111;73;26;2;24;.923;3600000;0
8155;217347;111;0;0;0;0;.00nan;0;0
8155;-1;108;0;0;0;0;.00nan;0;0
8156;208625;119;53;36;5;31;.861;3592000;0
8156;220601;121;0;0;0;0;.00nan;0;0
8156;-1;121;76;31;3;28;.903;3600000;0
8156;218853;119;0;0;0;0;.00nan;0;0
8157;208620;112;34;24;5;19;.792;3600000;0
8157;221235;126;29;28;6;22;.786;2019000;0
8157;212052;112;0;0;0;0;.00nan;0;0
8157;218014;126;59;9;0;9;1.000;1530000;0
8158;215968;110;60;33;4;29;.879;3600000;0
8158;222609;127;74;23;1;22;.957;3600000;0
8158;212667;110;0;0;0;0;.00nan;0;0
8158;212716;127;0;0;0;0;.00nan;0;0
8159;208652;124;0;0;0;0;.00nan;0;0
8159;221552;124;29;27;5;22;.815;3566000;0
8159;217331;125;0;0;0;0;.00nan;0;0
8159;-1;125;56;27;4;23;.852;3600000;0
8160;209921;114;0;0;0;0;.00nan;0;0
8160;222609;127;44;14;2;12;.857;1629000;0
8160;212716;127;23;27;6;21;.778;1971000;0
8160;223149;114;36;25;5;20;.800;3600000;0
8161;213845;113;66;27;3;24;.889;3600000;0
8161;204630;109;72;41;4;37;.902;3544000;0
8161;210765;113;0;0;0;0;.00nan;0;0
8161;221211;109;0;0;0;0;.00nan;0;0
8162;208625;119;0;0;0;0;.00nan;0;0
8162;218081;120;97;37;1;36;.973;3600000;0
8162;213613;120;0;0;0;0;.00nan;0;0
8162;218853;119;35;36;7;29;.806;3600000;0
8163;211890;123;0;0;0;0;.00nan;0;0
8163;211935;123;76;32;2;30;.938;3600000;0
8163;212681;122;59;26;3;23;.885;3549000;0
8163;-1;122;0;0;0;0;.00nan;0;0
8164;213722;116;0;0;0;0;.00nan;0;0
8164;220332;108;47;40;5;35;.875;3348000;0
8164;216028;116;70;29;2;27;.931;3600000;0
8164;-1;108;39;1;1;0;.000;252000;0
8165;213845;113;33;39;6;33;.846;3600000;0
8165;210765;113;0;0;0;0;.00nan;0;0
8165;210773;111;62;29;3;26;.897;3600000;0
8165;217347;111;0;0;0;0;.00nan;0;0
8166;222436;115;47;37;5;32;.865;3600000;0
8166;218081;120;0;0;0;0;.00nan;0;0
8166;223989;115;0;0;0;0;.00nan;0;0
8166;213613;120;93;41;2;39;.951;3600000;0
8167;208652;124;63;23;2;21;.913;3635000;0
8167;215968;110;62;25;3;22;.880;3635000;0
8167;221552;124;0;0;0;0;.00nan;0;0
8167;212667;110;0;0;0;0;.00nan;0;0
8168;209921;114;61;48;6;42;.875;3600000;0
8168;220601;121;0;0;0;0;.00nan;0;0
8168;223149;114;0;0;0;0;.00nan;0;0
8168;-1;121;79;23;1;22;.957;3600000;0
8169;204630;109;68;21;2;19;.905;3600000;0
8169;221211;109;0;0;0;0;.00nan;0;0
8169;215983;117;0;0;0;0;.00nan;0;0
8169;213504;117;84;42;3;39;.929;3600000;0
8170;221235;126;0;0;0;0;.00nan;0;0
8170;212683;118;0;0;0;0;.00nan;0;0
8170;218014;126;58;34;4;30;.882;3588000;0
8170;218830;118;49;20;3;17;.850;3600000;0
8171;220332;108;0;0;0;0;.00nan;0;0
8171;210773;111;0;0;0;0;.00nan;0;0
8171;217347;111;51;34;4;30;.882;3571000;0
8171;-1;108;43;16;3;13;.813;3600000;0
8172;213722;116;49;23;3;20;.870;3600000;0
8172;220601;121;82;32;1;31;.969;3600000;0
8172;216028;116;0;0;0;0;.00nan;0;0
8172;-1;121;0;0;0;0;.00nan;0;0
8173;208620;112;62;39;4;35;.897;3545000;0
8173;208652;124;0;0;0;0;.00nan;0;0
8173;221552;124;76;45;3;42;.933;3600000;0
8173;212052;112;0;0;0;0;.00nan;0;0
8174;208625;119;53;18;2;16;.889;3600000;0
8174;217331;125;40;36;6;30;.833;3600000;0
8174;-1;125;0;0;0;0;.00nan;0;0
8174;218853;119;0;0;0;0;.00nan;0;0
8175;212683;118;59;17;2;15;.882;3600000;0
8175;218081;120;63;35;3;32;.914;3590000;0
8175;213613;120;0;0;0;0;.00nan;0;0
8175;218830;118;0;0;0;0;.00nan;0;0
8176;215983;117;48;31;4;27;.871;3600000;0
8176;212681;122;0;0;0;0;.00nan;0;0
8176;213504;117;0;0;0;0;.00nan;0;0
8176;-1;122;49;23;3;20;.870;3600000;0
8177;215968;110;44;37;6;31;.838;3060000;0
8177;211890;123;51;33;5;28;.848;3600000;0
8177;211935;123;0;0;0;0;.00nan;0;0
8177;212667;110;51;2;0;2;1.000;505000;0
8178;209921;114;0;0;0;0;.00nan;0;0
8178;221235;126;43;17;3;14;.824;3825000;0
8178;218014;126;0;0;0;0;.00nan;0;0
8178;223149;114;66;30;4;26;.867;3825000;0
8179;213722;116;0;0;0;0;.00nan;0;0
8179;204630;109;97;27;0;27;1.000;3600000;0
8179;221211;109;0;0;0;0;.00nan;0;0
8179;216028;116;95;47;4;43;.915;3600000;0
8180;213845;113;83;22;1;21;.955;3600000;0
8180;210765;113;0;0;0;0;.00nan;0;0
8180;212681;122;63;35;5;30;.857;3600000;0
8180;-1;122;0;0;0;0;.00nan;0;0
8181;222436;115;0;0;0;0;.00nan;0;0
8181;217331;125;0;0;0;0;.00nan;0;0
8181;223989;115;67;38;4;34;.895;3600000;0
8181;-1;125;31;28;5;23;.821;3548000;0
8182;222609;127;0;0;0;0;.00nan;0;0
8182;212683;118;0;0;0;0;.00nan;0;0
8182;212716;127;65;42;4;38;.905;3600000;0
8182;218830;118;72;30;3;27;.900;3600000;0
8183;208620;112;0;0;0;0;.00nan;0;0
8183;211890;123;58;6;0;6;1.000;818000;0
8183;211935;123;33;37;7;30;.811;2782000;0
8183;212052;112;49;22;3;19;.864;3600000;0
8184;208652;124;88;47;4;43;.915;3900000;0
8184;221552;124;0;0;0;0;.00nan;0;0
8184;218081;120;63;26;4;22;.846;3900000;0
8184;213613;120;0;0;0;0;.00nan;0;0
8185;208625;119;56;23;3;20;.870;3600000;0
8185;209921;114;0;0;0;0;.00nan;0;0
8185;223149;114;54;36;4;32;.889;3550000;0
8185;218853;119;0;0;0;0;.00nan;0;0
8186;213722;116;0;0;0;0;.00nan;0;0
8186;215983;117;0;0;0;0;.00nan;0;0
8186;216028;116;58;39;5;34;.872;3900000;0
8186;213504;117;66;44;5;39;.886;3900000;0
8187;220601;121;0;0;0;0;.00nan;0;0
8187;222609;127;48;22;4;18;.818;1078000;0
8187;212716;127;85;34;1;33;.971;2822000;0
8187;-1;121;44;20;5;15;.750;3900000;0
8188;210785;123;22;4;3;1;.250;232000;0
8188;211935;123;40;26;5;21;.808;3368000;0
8188;217331;125;0;0;0;0;.00nan;0;0
8188;-1;125;57;23;3;20;.870;3600000;0
8189;213722;116;59;36;4;32;.889;3752000;0
8189;213845;113;64;39;5;34;.872;3752000;0
8189;210765;113;0;0;0;0;.00nan;0;0
8189;216028;116;0;0;0;0;.00nan;0;0
8190;209921;114;31;42;7;35;.833;3600000;0
8190;222436;115;43;16;3;13;.813;3600000;0
8190;223149;114;0;0;0;0;.00nan;0;0
8190;223989;115;0;0;0;0;.00nan;0;0
8191;220332;108;67;32;3;29;.906;3900000;0
8191;215968;110;65;32;3;29;.906;3900000;0
8191;212667;110;0;0;0;0;.00nan;0;0
8191;-1;108;0;0;0;0;.00nan;0;0
8192;204630;109;59;25;3;22;.880;3600000;0
8192;210773;111;38;20;4;16;.800;3552000;0
8192;221211;109;0;0;0;0;.00nan;0;0
8192;217347;111;0;0;0;0;.00nan;0;0
8193;208620;112;67;29;2;27;.931;3600000;0
8193;220332;108;0;0;0;0;.00nan;0;0
8193;212052;112;0;0;0;0;.00nan;0;0
8193;-1;108;77;25;1;24;.960;3600000;0
8194;208652;124;65;41;4;37;.902;3600000;0
8194;221552;124;0;0;0;0;.00nan;0;0
8194;222436;115;0;0;0;0;.00nan;0;0
8194;223989;115;70;22;2;20;.909;3600000;0
8195;208625;119;69;30;2;28;.933;3600000;0
8195;212681;122;64;26;3;23;.885;3600000;0
8195;-1;122;0;0;0;0;.00nan;0;0
8195;218853;119;0;0;0;0;.00nan;0;0
8196;220601;121;0;0;0;0;.00nan;0;0
8196;210785;123;55;37;5;32;.865;3600000;0
8196;211935;123;0;0;0;0;.00nan;0;0
8196;-1;121;69;25;2;23;.920;3600000;0
8197;215983;117;0;0;0;0;.00nan;0;0
8197;222609;127;51;45;5;40;.889;3600000;0
8197;212716;127;0;0;0;0;.00nan;0;0
8197;213504;117;83;28;1;27;.964;3600000;0
8198;221235;126;0;0;0;0;.00nan;0;0
8198;212039;126;72;30;2;28;.933;3591000;0
8198;212683;118;0;0;0;0;.00nan;0;0
8198;218830;118;100;35;0;35;1.000;3600000;0
8199;210773;111;0;0;0;0;.00nan;0;0
8199;217347;111;64;28;2;26;.929;3600000;0
8199;218081;120;72;28;3;25;.893;3566000;0
8199;213613;120;0;0;0;0;.00nan;0;0
8200;208625;119;0;0;0;0;.00nan;0;0
8200;208652;124;0;0;0;0;.00nan;0;0
8200;221552;124;50;44;6;38;.864;3600000;0
8200;218853;119;62;21;2;19;.905;3600000;0
8201;208620;112;0;0;0;0;.00nan;0;0
8201;215968;110;73;36;3;33;.917;3895000;0
8201;212052;112;67;27;2;25;.926;3895000;0
8201;212667;110;0;0;0;0;.00nan;0;0
8202;215983;117;44;33;6;27;.818;3325000;0
8202;217331;125;51;31;4;27;.871;3600000;0
8202;213504;117;48;0;0;0;.00nan;271000;0
8202;-1;125;0;0;0;0;.00nan;0;0
8203;210785;123;79;40;3;37;.925;3600000;0
8203;211935;123;0;0;0;0;.00nan;0;0
8203;212683;118;0;0;0;0;.00nan;0;0
8203;218830;118;62;22;2;20;.909;3600000;0
8204;213845;113;87;28;1;27;.964;3600000;0
8204;210765;113;0;0;0;0;.00nan;0;0
8204;221235;126;0;0;0;0;.00nan;0;0
8204;212039;126;57;29;4;25;.862;3600000;0
8205;204630;109;98;53;3;50;.943;3581000;0
8205;209921;114;0;0;0;0;.00nan;0;0
8205;221211;109;0;0;0;0;.00nan;0;0
8205;223149;114;73;27;2;25;.926;3600000;0
8206;213722;116;0;0;0;0;.00nan;0;0
8206;216028;116;69;31;3;28;.903;3532000;0
8206;222609;127;0;0;0;0;.00nan;0;0
8206;212716;127;72;21;1;20;.952;3600000;0
8207;210773;111;19;26;7;19;.731;3600000;0
8207;217347;111;0;0;0;0;.00nan;0;0
8207;212681;122;73;28;3;25;.893;3600000;0
8207;-1;122;0;0;0;0;.00nan;0;0
8208;220601;121;0;0;0;0;.00nan;0;0
8208;218081;120;0;0;0;0;.00nan;0;0
8208;213613;120;75;32;3;29;.906;3900000;0
8208;-1;121;53;23;3;20;.870;3900000;0
8209;208620;112;43;29;5;24;.828;3533000;0
8209;220332;108;82;46;3;43;.935;3600000;0
8209;212052;112;0;0;0;0;.00nan;0;0
8209;-1;108;0;0;0;0;.00nan;0;0
8210;208625;119;73;22;1;21;.955;3600000;0
8210;222609;127;85;51;3;48;.941;3540000;0
8210;212716;127;0;0;0;0;.00nan;0;0
8210;218853;119;0;0;0;0;.00nan;0;0
8211;212681;122;88;46;3;43;.935;3577000;0
8211;212683;118;73;19;1;18;.947;3600000;0
8211;218830;118;0;0;0;0;.00nan;0;0
8211;-1;122;0;0;0;0;.00nan;0;0
8212;208620;112;25;13;4;9;.692;945000;0
8212;204630;109;91;36;2;34;.944;3600000;0
8212;221211;109;0;0;0;0;.00nan;0;0
8212;212052;112;32;15;4;11;.733;2655000;0
8213;209921;114;0;0;0;0;.00nan;0;0
8213;215983;117;0;0;0;0;.00nan;0;0
8213;223149;114;52;15;2;13;.867;3600000;0
8213;213504;117;43;26;4;22;.846;3600000;0
8214;213845;113;100;29;0;29;1.000;3600000;0
8214;208625;119;70;33;3;30;.909;3600000;0
8214;210765;113;0;0;0;0;.00nan;0;0
8214;218853;119;0;0;0;0;.00nan;0;0
8215;213722;116;0;0;0;0;.00nan;0;0
8215;216028;116;68;41;4;37;.902;3600000;0
8215;222436;115;65;44;5;39;.886;3563000;0
8215;223989;115;0;0;0;0;.00nan;0;0
8216;215968;110;70;29;2;27;.931;3600000;0
8216;212667;110;0;0;0;0;.00nan;0;0
8216;218081;120;56;31;3;28;.903;3546000;0
8216;213613;120;0;0;0;0;.00nan;0;0
8217;221235;126;0;0;0;0;.00nan;0;0
8217;212039;126;65;40;4;36;.900;3600000;0
8217;217331;125;0;0;0;0;.00nan;0;0
8217;-1;125;38;16;3;13;.813;3600000;0
8218;220332;108;67;47;5;42;.894;3584000;0
8218;218081;120;0;0;0;0;.00nan;0;0
8218;213613;120;64;41;4;37;.902;3600000;0
8218;-1;108;0;0;0;0;.00nan;0;0
8219;210773;111;56;20;2;18;.900;3600000;0
8219;210785;123;64;30;3;27;.900;3551000;0
8219;211935;123;0;0;0;0;.00nan;0;0
8219;217347;111;0;0;0;0;.00nan;0;0
8220;213722;116;35;34;6;28;.824;2372000;0
8220;213845;113;30;33;7;26;.788;3600000;0
8220;210765;113;0;0;0;0;.00nan;0;0
8220;216028;116;50;14;2;12;.857;1173000;0
8221;220601;121;0;0;0;0;.00nan;0;0
8221;212681;122;0;0;0;0;.00nan;0;0
8221;-1;121;79;33;2;31;.939;3600000;0
8221;-1;122;67;35;4;31;.886;3589000;0
8222;208625;119;0;0;0;0;.00nan;0;0
8222;215983;117;60;29;3;26;.897;3600000;0
8222;213504;117;0;0;0;0;.00nan;0;0
8222;218853;119;45;30;4;26;.867;3545000;0
8223;221235;126;0;0;0;0;.00nan;0;0
8223;212039;126;73;49;6;43;.878;3600000;0
8223;222609;127;0;0;0;0;.00nan;0;0
8223;212716;127;72;44;5;39;.886;3600000;0
8224;208652;124;0;0;0;0;.00nan;0;0
8224;221552;124;54;47;6;41;.872;3600000;0
8224;212683;118;0;0;0;0;.00nan;0;0
8224;218830;118;52;20;2;18;.900;3600000;0
8225;208620;112;27;26;6;20;.769;3163000;0
8225;215968;110;34;29;6;23;.793;3241000;0
8225;212052;112;53;7;1;6;.857;710000;0
8225;212667;110;61;5;0;5;1.000;632000;0
8226;204630;109;75;23;2;21;.913;3600000;0
8226;221211;109;0;0;0;0;.00nan;0;0
8226;217331;125;55;23;3;20;.870;3576000;0
8226;-1;125;0;0;0;0;.00nan;0;0
8227;220601;121;74;34;2;32;.941;3600000;0
8227;212681;122;65;35;4;31;.886;3521000;0
8227;-1;121;0;0;0;0;.00nan;0;0
8227;-1;122;0;0;0;0;.00nan;0;0
8228;208652;124;62;42;4;38;.905;3900000;0
8228;221552;124;0;0;0;0;.00nan;0;0
8228;222609;127;59;29;4;25;.862;3900000;0
8228;212716;127;0;0;0;0;.00nan;0;0
8229;210785;123;44;35;5;30;.857;3561000;0
8229;215968;110;0;0;0;0;.00nan;0;0
8229;211935;123;0;0;0;0;.00nan;0;0
8229;212667;110;62;37;4;33;.892;3600000;0
8230;209921;114;80;34;2;32;.941;3560000;0
8230;222436;115;100;30;0;30;1.000;3600000;0
8230;223149;114;0;0;0;0;.00nan;0;0
8230;223989;115;0;0;0;0;.00nan;0;0
8231;220332;108;0;0;0;0;.00nan;0;0
8231;210785;123;0;0;0;0;.00nan;0;0
8231;211935;123;42;23;4;19;.826;3535000;0
8231;-1;108;84;33;2;31;.939;3600000;0
8232;210773;111;76;24;2;22;.917;3600000;0
8232;217347;111;0;0;0;0;.00nan;0;0
8232;218081;120;58;37;4;33;.892;3556000;0
8232;213613;120;0;0;0;0;.00nan;0;0
8233;213722;116;0;0;0;0;.00nan;0;0
8233;204630;109;57;23;3;20;.870;3572000;0
8233;221211;109;0;0;0;0;.00nan;0;0
8233;216028;116;84;31;2;29;.935;3600000;0
8234;213845;113;50;32;4;28;.875;3900000;0
8234;210765;113;0;0;0;0;.00nan;0;0
8234;222436;115;0;0;0;0;.00nan;0;0
8234;223989;115;95;44;4;40;.909;3888000;0
8235;209921;114;0;0;0;0;.00nan;0;0
8235;215983;117;0;0;0;0;.00nan;0;0
8235;223149;114;62;28;3;25;.893;3900000;0
8235;213504;117;54;21;3;18;.857;3900000;0
8236;208625;119;82;27;1;26;.963;3600000;0
8236;221235;126;0;0;0;0;.00nan;0;0
8236;212039;126;60;35;4;31;.886;3600000;0
8236;218853;119;0;0;0;0;.00nan;0;0
8237;208620;112;0;0;0;0;.00nan;0;0
8237;212052;112;65;24;3;21;.875;3600000;0
8237;217331;125;0;0;0;0;.00nan;0;0
8237;-1;125;53;35;5;30;.857;3600000;0
8238;209921;114;0;0;0;0;.00nan;0;0
8238;218081;120;68;27;3;24;.889;3549000;0
8238;223149;114;70;28;2;26;.929;3600000;0
8238;213613;120;0;0;0;0;.00nan;0;0
8239;213845;113;51;16;2;14;.875;3600000;0
8239;210765;113;0;0;0;0;.00nan;0;0
8239;215983;117;0;0;0;0;.00nan;0;0
8239;213504;117;72;39;4;35;.897;3533000;0
8240;204630;109;51;37;6;31;.838;3271000;0
8240;221211;109;50;3;0;3;1.000;329000;0
8240;222436;115;85;35;2;33;.943;3600000;0
8240;223989;115;0;0;0;0;.00nan;0;0
8241;210773;111;49;21;3;18;.857;3584000;0
8241;215968;110;85;30;2;28;.933;3600000;0
8241;217347;111;0;0;0;0;.00nan;0;0
8241;212667;110;0;0;0;0;.00nan;0;0
8242;210785;123;89;40;1;39;.975;3856000;0
8242;211935;123;0;0;0;0;.00nan;0;0
8242;217331;125;64;22;2;20;.909;3856000;0
8242;-1;125;0;0;0;0;.00nan;0;0
8243;220332;108;69;37;4;33;.892;3514000;0
8243;222436;115;100;45;2;43;.956;3600000;0
8243;223989;115;0;0;0;0;.00nan;0;0
8243;-1;108;0;0;0;0;.00nan;0;0
8244;213722;116;0;0;0;0;.00nan;0;0
8244;208652;124;0;0;0;0;.00nan;0;0
8244;216028;116;82;33;2;31;.939;3600000;0
8244;221552;124;65;31;3;28;.903;3589000;0
8245;220601;121;0;0;0;0;.00nan;0;0
8245;215968;110;51;2;0;2;1.000;336000;0
8245;212667;110;60;49;6;43;.878;3264000;0
8245;-1;121;73;20;1;19;.950;3600000;0
8246;213845;113;79;30;2;28;.933;3600000;0
8246;210765;113;0;0;0;0;.00nan;0;0
8246;215983;117;57;33;5;28;.848;3600000;0
8246;213504;117;0;0;0;0;.00nan;0;0
8247;221235;126;0;0;0;0;.00nan;0;0
8247;212039;126;43;30;5;25;.833;3750000;0
8247;212681;122;0;0;0;0;.00nan;0;0
8247;-1;122;63;35;4;31;.886;3750000;0
8248;222609;127;40;44;7;37;.841;2931000;0
8248;212683;118;0;0;0;0;.00nan;0;0
8248;212716;127;47;6;1;5;.833;669000;0
8248;218830;118;59;24;2;22;.917;3600000;0
8249;208620;112;42;31;5;26;.839;3600000;0
8249;208625;119;52;47;7;40;.851;3581000;0
8249;212052;112;0;0;0;0;.00nan;0;0
8249;218853;119;0;0;0;0;.00nan;0;0
8250;210773;111;88;16;0;16;1.000;3600000;0
8250;222436;115;0;0;0;0;.00nan;0;0
8250;217347;111;0;0;0;0;.00nan;0;0
8250;223989;115;75;41;4;37;.902;3600000;0
8251;220332;108;0;0;0;0;.00nan;0;0
8251;204630;109;95;31;1;30;.968;3600000;0
8251;221211;109;0;0;0;0;.00nan;0;0
8251;-1;108;66;34;4;30;.882;3600000;0
8252;208625;119;0;0;0;0;.00nan;0;0
8252;220601;121;70;35;3;32;.914;3755000;0
8252;-1;121;0;0;0;0;.00nan;0;0
8252;218853;119;74;30;2;28;.933;3755000;0
8253;208652;124;65;35;3;32;.914;3782000;0
8253;221552;124;0;0;0;0;.00nan;0;0
8253;218081;120;36;15;4;11;.733;3782000;0
8253;213613;120;0;0;0;0;.00nan;0;0
8254;215968;110;68;30;3;27;.900;3900000;0
8254;217331;125;0;0;0;0;.00nan;0;0
8254;212667;110;0;0;0;0;.00nan;0;0
8254;-1;125;75;31;3;28;.903;3900000;0
8255;210785;123;0;0;0;0;.00nan;0;0
8255;211935;123;77;33;2;31;.939;3600000;0
8255;212681;122;0;0;0;0;.00nan;0;0
8255;-1;122;38;28;5;23;.821;3600000;0
8256;208620;112;0;0;0;0;.00nan;0;0
8256;209921;114;66;31;2;29;.935;3900000;0
8256;212052;112;54;12;2;10;.833;3900000;0
8256;223149;114;0;0;0;0;.00nan;0;0
8257;213722;116;0;0;0;0;.00nan;0;0
8257;204630;109;0;0;0;0;.00nan;0;0
8257;221211;109;63;29;3;26;.897;3600000;0
8257;216028;116;71;44;4;40;.909;3555000;0
8258;213845;113;66;25;2;23;.920;3600000;0
8258;209921;114;0;0;0;0;.00nan;0;0
8258;210765;113;0;0;0;0;.00nan;0;0
8258;223149;114;56;28;3;25;.893;3600000;0
8259;212683;118;0;0;0;0;.00nan;0;0
8259;218081;120;0;0;0;0;.00nan;0;0
8259;213613;120;64;46;6;40;.870;3600000;0
8259;218830;118;57;24;3;21;.875;3600000;0
8260;221235;126;0;0;0;0;.00nan;0;0
8260;212039;126;52;27;4;23;.852;3600000;0
8260;222609;127;0;0;0;0;.00nan;0;0
8260;212716;127;83;27;1;26;.963;3600000;0
8261;210785;123;28;29;6;23;.793;2041000;0
8261;211935;123;72;12;0;12;1.000;1559000;0
8261;217331;125;60;19;2;17;.895;3600000;0
8261;-1;125;0;0;0;0;.00nan;0;0
8262;208620;112;50;22;3;19;.864;3600000;0
8262;210773;111;0;0;0;0;.00nan;0;0
8262;212052;112;0;0;0;0;.00nan;0;0
8262;217347;111;63;43;5;38;.884;3600000;0
8263;220601;121;0;0;0;0;.00nan;0;0
8263;212681;122;0;0;0;0;.00nan;0;0
8263;-1;121;37;30;4;26;.867;3543000;0
8263;-1;122;71;35;3;32;.914;3600000;0
8264;209921;114;0;0;0;0;.00nan;0;0
8264;218081;120;46;27;4;23;.852;3600000;0
8264;223149;114;47;37;5;32;.865;3600000;0
8264;213613;120;0;0;0;0;.00nan;0;0
8265;210785;123;80;44;4;40;.909;3600000;0
8265;221235;126;0;0;0;0;.00nan;0;0
8265;211935;123;0;0;0;0;.00nan;0;0
8265;212039;126;68;21;1;20;.952;3600000;0
8266;208625;119;41;27;5;22;.815;3600000;0
8266;212683;118;0;0;0;0;.00nan;0;0
8266;218830;118;75;32;2;30;.938;3600000;0
8266;218853;119;0;0;0;0;.00nan;0;0
8267;213722;116;0;0;0;0;.00nan;0;0
8267;213845;113;0;0;0;0;.00nan;0;0
8267;210765;113;75;38;3;35;.921;3594000;0
8267;216028;116;80;36;2;34;.944;3600000;0
8268;215983;117;0;0;0;0;.00nan;0;0
8268;222436;115;62;35;4;31;.886;3579000;0
8268;213504;117;67;25;2;23;.920;3600000;0
8268;223989;115;0;0;0;0;.00nan;0;0
8269;208620;112;0;0;0;0;.00nan;0;0
8269;215968;110;70;31;3;28;.903;3594000;0
8269;212052;112;86;24;1;23;.958;3600000;0
8269;212667;110;0;0;0;0;.00nan;0;0
8270;217331;125;0;0;0;0;.00nan;0;0
8270;222609;127;0;0;0;0;.00nan;0;0
8270;212716;127;45;29;5;24;.828;3600000;0
8270;-1;125;84;25;1;24;.960;3600000;0
8271;204630;109;77;27;2;25;.926;3900000;0
8271;221211;109;0;0;0;0;.00nan;0;0
8271;215983;117;74;33;2;31;.939;3900000;0
8271;213504;117;0;0;0;0;.00nan;0;0
8272;208620;112;27;24;6;18;.750;2345000;0
8272;220332;108;74;23;1;22;.957;3600000;0
8272;212052;112;45;8;1;7;.875;1255000;0
8272;-1;108;0;0;0;0;.00nan;0;0
8273;208652;124;0;0;0;0;.00nan;0;0
8273;209921;114;0;0;0;0;.00nan;0;0
8273;221552;124;60;32;4;28;.875;3584000;0
8273;223149;114;54;26;3;23;.885;3590000;0
8274;212681;122;46;32;5;27;.844;3600000;0
8274;212683;118;31;34;7;27;.794;3110000;0
8274;218830;118;33;4;2;2;.500;490000;0
8274;-1;122;0;0;0;0;.00nan;0;0
8275;208625;119;31;35;7;28;.800;3600000;0
8275;220601;121;68;29;2;27;.931;3600000;0
8275;-1;121;0;0;0;0;.00nan;0;0
8275;218853;119;0;0;0;0;.00nan;0;0
8276;210773;111;73;38;4;34;.895;3600000;0
8276;217347;111;0;0;0;0;.00nan;0;0
8276;222609;127;53;40;5;35;.875;3546000;0
8276;212716;127;0;0;0;0;.00nan;0;0
8277;213722;116;0;0;0;0;.00nan;0;0
8277;221235;126;0;0;0;0;.00nan;0;0
8277;216028;116;94;53;2;51;.962;3900000;0
8277;212039;126;79;32;2;30;.938;3900000;0
8278;213845;113;61;20;2;18;.900;3600000;0
8278;204630;109;78;48;4;44;.917;3575000;0
8278;210765;113;0;0;0;0;.00nan;0;0
8278;221211;109;0;0;0;0;.00nan;0;0
8279;208652;124;59;37;4;33;.892;3900000;0
8279;210773;111;49;24;4;20;.833;3900000;0
8279;221552;124;0;0;0;0;.00nan;0;0
8279;217347;111;0;0;0;0;.00nan;0;0
8280;208625;119;0;0;0;0;.00nan;0;0
8280;212681;122;0;0;0;0;.00nan;0;0
8280;-1;122;68;36;3;33;.917;3600000;0
8280;218853;119;48;35;5;30;.857;3600000;0
8281;220601;121;0;0;0;0;.00nan;0;0
8281;218081;120;63;38;4;34;.895;3564000;0
8281;213613;120;0;0;0;0;.00nan;0;0
8281;-1;121;57;18;2;16;.889;3600000;0
8282;215968;110;42;24;4;20;.833;3553000;0
8282;222436;115;69;23;2;21;.913;3600000;0
8282;212667;110;0;0;0;0;.00nan;0;0
8282;223989;115;0;0;0;0;.00nan;0;0
8283;209921;114;82;30;2;28;.933;3600000;0
8283;210785;123;73;32;3;29;.906;3582000;0
8283;211935;123;0;0;0;0;.00nan;0;0
8283;223149;114;0;0;0;0;.00nan;0;0
8284;220332;108;85;35;2;33;.943;3600000;0
8284;215968;110;47;26;4;22;.846;3357000;0
8284;212667;110;49;2;0;2;1.000;219000;0
8284;-1;108;0;0;0;0;.00nan;0;0
8285;213722;116;0;0;0;0;.00nan;0;0
8285;215983;117;0;0;0;0;.00nan;0;0
8285;216028;116;100;22;0;22;1.000;3600000;0
8285;213504;117;84;37;3;34;.919;3600000;0
8286;213845;113;0;0;0;0;.00nan;0;0
8286;210765;113;23;34;7;27;.794;3546000;0
8286;222436;115;0;0;0;0;.00nan;0;0
8286;223989;115;48;36;5;31;.861;3600000;0
8287;220601;121;88;45;2;43;.956;3600000;0
8287;212683;118;0;0;0;0;.00nan;0;0
8287;218830;118;55;27;3;24;.889;3548000;0
8287;-1;121;0;0;0;0;.00nan;0;0
8288;210773;111;0;0;0;0;.00nan;0;0
8288;210785;123;53;3;0;3;1.000;707000;0
8288;211935;123;47;40;6;34;.850;2893000;0
8288;217347;111;51;21;3;18;.857;3600000;0
8289;208620;112;0;0;0;0;.00nan;0;0
8289;204630;109;54;35;4;31;.886;3600000;0
8289;221211;109;0;0;0;0;.00nan;0;0
8289;212052;112;92;32;1;31;.969;3600000;0
8290;217331;125;0;0;0;0;.00nan;0;0
8290;222609;127;0;0;0;0;.00nan;0;0
8290;212716;127;63;27;3;24;.889;3560000;0
8290;-1;125;61;23;2;21;.913;3600000;0
8291;208620;112;67;22;2;20;.909;3600000;0
8291;220332;108;48;32;4;28;.875;3512000;0
8291;212052;112;0;0;0;0;.00nan;0;0
8291;-1;108;0;0;0;0;.00nan;0;0
8292;208652;124;49;26;4;22;.846;3578000;0
8292;220601;121;0;0;0;0;.00nan;0;0
8292;221552;124;0;0;0;0;.00nan;0;0
8292;-1;121;86;34;2;32;.941;3600000;0
8293;222609;127;0;0;0;0;.00nan;0;0
8293;212716;127;96;39;3;36;.923;3600000;0
8293;218081;120;52;26;4;22;.846;3547000;0
8293;213613;120;0;0;0;0;.00nan;0;0
8294;221235;126;46;8;1;7;.875;1349000;0
8294;215983;117;0;0;0;0;.00nan;0;0
8294;212039;126;24;24;6;18;.750;2251000;0
8294;213504;117;94;20;0;20;1.000;3600000;0
8295;213845;113;81;30;2;28;.933;3600000;0
8295;210765;113;0;0;0;0;.00nan;0;0
8295;222436;115;50;34;5;29;.853;3600000;0
8295;223989;115;0;0;0;0;.00nan;0;0
8296;213722;116;0;0;0;0;.00nan;0;0
8296;215968;110;66;34;4;30;.882;3600000;0
8296;216028;116;62;51;6;45;.882;3576000;0
8296;212667;110;0;0;0;0;.00nan;0;0
8297;208625;119;54;28;4;24;.857;3829000;0
8297;217331;125;71;33;3;30;.909;3829000;0
8297;-1;125;0;0;0;0;.00nan;0;0
8297;218853;119;0;0;0;0;.00nan;0;0
8298;220332;108;72;49;3;46;.939;3900000;0
8298;212681;122;0;0;0;0;.00nan;0;0
8298;-1;122;74;28;3;25;.893;3900000;0
8298;-1;108;0;0;0;0;.00nan;0;0
8299;210773;111;59;28;4;24;.857;3900000;0
8299;215968;110;94;48;4;44;.917;3894000;0
8299;217347;111;0;0;0;0;.00nan;0;0
8299;212667;110;0;0;0;0;.00nan;0;0
8300;213722;116;0;0;0;0;.00nan;0;0
8300;209921;114;0;0;0;0;.00nan;0;0
8300;216028;116;59;31;4;27;.871;3575000;0
8300;223149;114;58;27;3;24;.889;3600000;0
8301;220601;121;31;21;5;16;.762;3559000;0
8301;217331;125;0;0;0;0;.00nan;0;0
8301;-1;125;90;54;4;50;.926;3600000;0
8301;-1;121;0;0;0;0;.00nan;0;0
8302;215983;117;0;0;0;0;.00nan;0;0
8302;222436;115;26;27;6;21;.778;3551000;0
8302;213504;117;62;34;4;30;.882;3600000;0
8302;223989;115;0;0;0;0;.00nan;0;0
8303;208625;119;0;0;0;0;.00nan;0;0
8303;222609;127;74;32;2;30;.938;3600000;0
8303;212716;127;0;0;0;0;.00nan;0;0
8303;218853;119;35;26;5;21;.808;3600000;0
8304;210785;123;92;49;4;45;.918;3600000;0
8304;211935;123;0;0;0;0;.00nan;0;0
8304;218081;120;67;25;2;23;.920;3600000;0
8304;213613;120;0;0;0;0;.00nan;0;0
8305;204630;109;85;46;4;42;.913;3513000;0
8305;221211;109;0;0;0;0;.00nan;0;0
8305;212683;118;0;0;0;0;.00nan;0;0
8305;218830;118;70;23;2;21;.913;3600000;0
8306;208620;112;0;0;0;0;.00nan;0;0
8306;208652;124;89;49;4;45;.918;3600000;0
8306;221552;124;0;0;0;0;.00nan;0;0
8306;212052;112;86;21;0;21;1.000;3600000;0
8307;210773;111;75;37;3;34;.919;3600000;0
8307;217347;111;0;0;0;0;.00nan;0;0
8307;212681;122;17;8;4;4;.500;984000;0
8307;-1;122;26;20;5;15;.750;2616000;0
8308;208652;124;0;0;0;0;.00nan;0;0
8308;204630;109;69;25;2;23;.920;3900000;0
8308;221211;109;0;0;0;0;.00nan;0;0
8308;221552;124;95;44;2;42;.955;3900000;0
8309;222609;127;0;0;0;0;.00nan;0;0
8309;212683;118;64;37;4;33;.892;3530000;0
8309;212716;127;69;29;2;27;.931;3600000;0
8309;218830;118;0;0;0;0;.00nan;0;0
8310;217331;125;29;8;3;5;.625;548000;0
8310;218081;120;0;0;0;0;.00nan;0;0
8310;213613;120;87;26;1;25;.962;3600000;0
8310;-1;125;49;33;5;28;.848;3052000;0
8311;208625;119;79;29;2;27;.931;3900000;0
8311;210785;123;75;32;2;30;.938;3900000;0
8311;211935;123;0;0;0;0;.00nan;0;0
8311;218853;119;0;0;0;0;.00nan;0;0
8312;221235;126;0;0;0;0;.00nan;0;0
8312;212039;126;82;38;4;34;.895;3600000;0
8312;222436;115;54;40;5;35;.875;3555000;0
8312;223989;115;0;0;0;0;.00nan;0;0
8313;220332;108;0;0;0;0;.00nan;0;0
8313;209921;114;56;43;5;38;.884;3600000;0
8313;223149;114;0;0;0;0;.00nan;0;0
8313;-1;108;74;26;2;24;.923;3600000;0
8314;204630;109;0;0;0;0;.00nan;0;0
8314;221211;109;65;30;3;27;.900;3568000;0
8314;215968;110;99;34;1;33;.971;3600000;0
8314;212667;110;0;0;0;0;.00nan;0;0
8315;213722;116;0;0;0;0;.00nan;0;0
8315;215983;117;56;4;0;4;1.000;691000;0
8315;216028;116;85;47;3;44;.936;3600000;0
8315;213504;117;50;31;6;25;.806;2909000;0
8316;208620;112;0;0;0;0;.00nan;0;0
8316;220601;121;0;0;0;0;.00nan;0;0
8316;212052;112;54;21;3;18;.857;3600000;0
8316;-1;121;44;26;4;22;.846;3582000;0
8317;210785;123;29;15;4;11;.733;884000;0
8317;221235;126;57;26;3;23;.885;3600000;0
8317;211935;123;56;32;4;28;.875;2716000;0
8317;212039;126;0;0;0;0;.00nan;0;0
8318;213845;113;49;27;4;23;.852;3600000;0
8318;220332;108;26;21;5;16;.762;1182000;0
8318;210765;113;0;0;0;0;.00nan;0;0
8318;-1;108;42;23;4;19;.826;2418000;0
8319;212681;122;0;0;0;0;.00nan;0;0
8319;212683;118;0;0;0;0;.00nan;0;0
8319;218830;118;69;38;4;34;.895;3600000;0
8319;-1;122;72;26;2;24;.923;3600000;0
8320;208620;112;56;19;2;17;.895;3600000;0
8320;212052;112;0;0;0;0;.00nan;0;0
8320;218081;120;39;32;5;27;.844;3600000;0
8320;213613;120;0;0;0;0;.00nan;0;0
8321;220332;108;81;32;3;29;.906;3600000;0
8321;210773;111;53;27;4;23;.852;3570000;0
8321;217347;111;0;0;0;0;.00nan;0;0
8321;-1;108;0;0;0;0;.00nan;0;0
8322;208652;124;91;35;1;34;.971;3624000;0
8322;221552;124;0;0;0;0;.00nan;0;0
8322;222609;127;0;0;0;0;.00nan;0;0
8322;212716;127;64;23;2;21;.913;3624000;0
8323;208625;119;100;30;0;30;1.000;3600000;0
8323;222436;115;62;41;5;36;.878;3600000;0
8323;223989;115;0;0;0;0;.00nan;0;0
8323;218853;119;0;0;0;0;.00nan;0;0
8324;204630;109;68;25;3;22;.880;3600000;0
8324;221211;109;0;0;0;0;.00nan;0;0
8324;217331;125;0;0;0;0;.00nan;0;0
8324;-1;125;100;29;0;29;1.000;3600000;0
8325;221235;126;0;0;0;0;.00nan;0;0
8325;215983;117;0;0;0;0;.00nan;0;0
8325;212039;126;76;37;3;34;.919;3568000;0
8325;213504;117;97;43;2;41;.953;3600000;0
8326;209921;114;0;0;0;0;.00nan;0;0
8326;210785;123;78;47;4;43;.915;3600000;0
8326;211935;123;0;0;0;0;.00nan;0;0
8326;223149;114;78;22;1;21;.955;3600000;0
8327;215968;110;82;30;2;28;.933;3600000;0
8327;212667;110;0;0;0;0;.00nan;0;0
8327;212683;118;0;0;0;0;.00nan;0;0
8327;218830;118;55;31;4;27;.871;3600000;0
8328;204630;109;40;34;6;28;.824;3600000;0
8328;221211;109;0;0;0;0;.00nan;0;0
8328;218081;120;83;39;3;36;.923;3600000;0
8328;213613;120;0;0;0;0;.00nan;0;0
8329;220332;108;46;27;4;23;.852;3600000;0
8329;215968;110;0;0;0;0;.00nan;0;0
8329;212667;110;63;41;5;36;.878;3600000;0
8329;-1;108;0;0;0;0;.00nan;0;0
8330;213845;113;94;43;3;40;.930;3600000;0
8330;210765;113;0;0;0;0;.00nan;0;0
8330;210773;111;44;26;4;22;.846;3600000;0
8330;217347;111;0;0;0;0;.00nan;0;0
8331;208620;112;0;0;0;0;.00nan;0;0
8331;212052;112;26;30;6;24;.800;3600000;0
8331;222436;115;99;47;3;44;.936;3600000;0
8331;223989;115;0;0;0;0;.00nan;0;0
8332;213722;116;46;7;1;6;.857;844000;0
8332;216028;116;45;36;6;30;.833;2756000;0
8332;212681;122;0;0;0;0;.00nan;0;0
8332;-1;122;63;37;3;34;.919;3600000;0
8333;220601;121;55;28;4;24;.857;3600000;0
8333;221235;126;36;6;2;4;.667;403000;0
8333;212039;126;24;35;8;27;.771;3197000;0
8333;-1;121;0;0;0;0;.00nan;0;0
8334;210785;123;0;0;0;0;.00nan;0;0
8334;215983;117;35;25;5;20;.800;3600000;0
8334;211935;123;93;29;1;28;.966;3600000;0
8334;213504;117;0;0;0;0;.00nan;0;0
8335;208652;124;86;32;2;30;.938;3600000;0
8335;221552;124;0;0;0;0;.00nan;0;0
8335;222609;127;46;28;5;23;.821;3600000;0
8335;212716;127;0;0;0;0;.00nan;0;0
8336;208625;119;26;11;4;7;.636;1112000;0
8336;212683;118;64;18;1;17;.944;3600000;0
8336;218830;118;0;0;0;0;.00nan;0;0
8336;218853;119;85;22;0;22;1.000;2488000;0
8337;213722;116;61;25;2;23;.920;3600000;0
8337;220332;108;0;0;0;0;.00nan;0;0
8337;216028;116;0;0;0;0;.00nan;0;0
8337;-1;108;51;37;5;32;.865;3600000;0
8338;208652;124;0;0;0;0;.00nan;0;0
8338;221552;124;50;32;5;27;.844;3600000;0
8338;217331;125;0;0;0;0;.00nan;0;0
8338;-1;125;70;25;2;23;.920;3600000;0
8339;208620;112;64;18;1;17;.944;3900000;0
8339;208625;119;96;44;1;43;.977;3900000;0
8339;212052;112;0;0;0;0;.00nan;0;0
8339;218853;119;0;0;0;0;.00nan;0;0
8340;220601;121;0;0;0;0;.00nan;0;0
8340;218081;120;0;0;0;0;.00nan;0;0
8340;213613;120;73;50;5;45;.900;3600000;0
8340;-1;121;41;10;2;8;.800;3600000;0
8341;209921;114;0;0;0;0;.00nan;0;0
8341;210773;111;50;1;0;1;1.000;297000;0
8341;217347;111;26;26;6;20;.769;3249000;0
8341;223149;114;56;40;5;35;.875;3600000;0
8342;213845;113;91;34;1;33;.971;3600000;0
8342;210765;113;0;0;0;0;.00nan;0;0
8342;210785;123;26;28;6;22;.786;1979000;0
8342;211935;123;50;13;1;12;.923;1621000;0
8343;204630;109;51;38;6;32;.842;3600000;0
8343;221211;109;0;0;0;0;.00nan;0;0
8343;222436;115;0;0;0;0;.00nan;0;0
8343;223989;115;86;26;1;25;.962;3600000;0
8344;215983;117;0;0;0;0;.00nan;0;0
8344;212681;122;0;0;0;0;.00nan;0;0
8344;213504;117;88;29;1;28;.966;3600000;0
8344;-1;122;59;33;4;29;.879;3600000;0
8345;221235;126;0;0;0;0;.00nan;0;0
8345;212039;126;55;34;5;29;.853;3900000;0
8345;217331;125;65;42;5;37;.881;3900000;0
8345;-1;125;0;0;0;0;.00nan;0;0
8346;208625;119;55;19;2;17;.895;3600000;0
8346;204630;109;0;0;0;0;.00nan;0;0
8346;221211;109;38;40;6;34;.850;3600000;0
8346;218853;119;0;0;0;0;.00nan;0;0
8347;220332;108;55;40;5;35;.875;3556000;0
8347;209921;114;0;0;0;0;.00nan;0;0
8347;223149;114;48;27;4;23;.852;3600000;0
8347;-1;108;0;0;0;0;.00nan;0;0
8348;213845;113;0;0;0;0;.00nan;0;0
8348;210765;113;38;20;5;15;.750;3883000;0
8348;210773;111;76;46;5;41;.891;3900000;0
8348;217347;111;0;0;0;0;.00nan;0;0
8349;213722;116;48;10;2;8;.800;2157000;0
8349;216028;116;31;25;5;20;.800;1443000;0
8349;218081;120;74;26;2;24;.923;3600000;0
8349;213613;120;0;0;0;0;.00nan;0;0
8350;215983;117;33;32;6;26;.813;3100000;0
8350;212683;118;0;0;0;0;.00nan;0;0
8350;213504;117;64;9;0;9;1.000;500000;0
8350;218830;118;73;27;2;25;.926;3600000;0
8351;220601;121;51;20;3;17;.850;3600000;0
8351;217331;125;0;0;0;0;.00nan;0;0
8351;-1;125;59;37;5;32;.865;3598000;0
8351;-1;121;0;0;0;0;.00nan;0;0
8352;208620;112;0;0;0;0;.00nan;0;0
8352;212052;112;85;30;1;29;.967;3600000;0
8352;222436;115;48;47;7;40;.851;3600000;0
8352;223989;115;0;0;0;0;.00nan;0;0
8353;215968;110;66;38;4;34;.895;3900000;0
8353;212667;110;0;0;0;0;.00nan;0;0
8353;212681;122;49;29;4;25;.862;3900000;0
8353;-1;122;0;0;0;0;.00nan;0;0
8354;221235;126;0;0;0;0;.00nan;0;0
8354;212039;126;62;30;4;26;.867;3900000;0
8354;222609;127;0;0;0;0;.00nan;0;0
8354;212716;127;55;36;4;32;.889;3900000;0
8355;209921;114;0;0;0;0;.00nan;0;0
8355;218081;120;0;0;0;0;.00nan;0;0
8355;223149;114;58;34;5;29;.853;3600000;0
8355;213613;120;60;32;3;29;.906;3600000;0
8356;208652;124;39;28;6;22;.786;3600000;0
8356;210785;123;63;28;3;25;.893;3600000;0
8356;221552;124;0;0;0;0;.00nan;0;0
8356;211935;123;0;0;0;0;.00nan;0;0
8357;220332;108;22;30;6;24;.800;2298000;0
8357;220601;121;68;31;3;28;.903;3600000;0
8357;-1;121;0;0;0;0;.00nan;0;0
8357;-1;108;58;11;1;10;.909;1302000;0
8358;208620;112;0;0;0;0;.00nan;0;0
8358;210773;111;75;39;4;35;.897;3600000;0
8358;212052;112;54;26;5;21;.808;3562000;0
8358;217347;111;0;0;0;0;.00nan;0;0
8359;213722;116;52;17;2;15;.882;1561000;0
8359;216028;116;46;25;4;21;.840;2039000;0
8359;222436;115;97;35;1;34;.971;3600000;0
8359;223989;115;0;0;0;0;.00nan;0;0
8360;208652;124;71;30;2;28;.933;3600000;0
8360;204630;109;83;34;3;31;.912;3576000;0
8360;221211;109;0;0;0;0;.00nan;0;0
8360;221552;124;0;0;0;0;.00nan;0;0
8361;222609;127;0;0;0;0;.00nan;0;0
8361;212681;122;0;0;0;0;.00nan;0;0
8361;212716;127;58;39;5;34;.872;3553000;0
8361;-1;122;54;28;3;25;.893;3600000;0
8362;215968;110;95;43;2;41;.953;3600000;0
8362;215983;117;0;0;0;0;.00nan;0;0
8362;212667;110;0;0;0;0;.00nan;0;0
8362;213504;117;42;32;6;26;.813;3600000;0
8363;213845;113;46;33;5;28;.848;3596000;0
8363;210765;113;0;0;0;0;.00nan;0;0
8363;210785;123;64;39;4;35;.897;3600000;0
8363;211935;123;0;0;0;0;.00nan;0;0
8364;217331;125;47;31;5;26;.839;3600000;0
8364;212683;118;0;0;0;0;.00nan;0;0
8364;218830;118;100;27;0;27;1.000;3600000;0
8364;-1;125;0;0;0;0;.00nan;0;0
8365;220601;121;0;0;0;0;.00nan;0;0
8365;210773;111;0;0;0;0;.00nan;0;0
8365;217347;111;31;42;8;34;.810;3600000;0
8365;-1;121;66;24;2;22;.917;3600000;0
8366;220332;108;47;27;4;23;.852;3600000;0
8366;222436;115;84;35;2;33;.943;3600000;0
8366;223989;115;0;0;0;0;.00nan;0;0
8366;-1;108;0;0;0;0;.00nan;0;0
8367;213845;113;0;0;0;0;.00nan;0;0
8367;208652;124;0;0;0;0;.00nan;0;0
8367;210765;113;88;39;2;37;.949;3600000;0
8367;221552;124;90;25;1;24;.960;3600000;0
8368;208625;119;0;0;0;0;.00nan;0;0
8368;212683;118;0;0;0;0;.00nan;0;0
8368;218830;118;28;28;5;23;.821;3600000;0
8368;218853;119;94;36;2;34;.944;3600000;0
8369;217331;125;59;11;1;10;.909;1154000;0
8369;218081;120;59;32;4;28;.875;3600000;0
8369;213613;120;0;0;0;0;.00nan;0;0
8369;-1;125;15;28;7;21;.750;2446000;0
8370;204630;109;51;29;4;25;.862;3543000;0
8370;210785;123;0;0;0;0;.00nan;0;0
8370;221211;109;0;0;0;0;.00nan;0;0
8370;211935;123;83;34;3;31;.912;3600000;0
8371;215968;110;48;33;5;28;.848;3863000;0
8371;221235;126;0;0;0;0;.00nan;0;0
8371;212039;126;37;23;4;19;.826;3863000;0
8371;212667;110;0;0;0;0;.00nan;0;0
8372;213722;116;0;0;0;0;.00nan;0;0
8372;209921;114;70;20;1;19;.950;3600000;0
8372;216028;116;55;35;4;31;.886;3600000;0
8372;223149;114;0;0;0;0;.00nan;0;0
8373;213845;113;84;25;1;24;.960;3600000;0
8373;210765;113;0;0;0;0;.00nan;0;0
8373;222609;127;0;0;0;0;.00nan;0;0
8373;212716;127;75;40;4;36;.900;3600000;0
8374;221235;126;51;27;4;23;.852;3566000;0
8374;212039;126;0;0;0;0;.00nan;0;0
8374;212681;122;0;0;0;0;.00nan;0;0
8374;-1;122;70;36;3;33;.917;3600000;0
8375;213722;116;0;0;0;0;.00nan;0;0
8375;215983;117;0;0;0;0;.00nan;0;0
8375;216028;116;99;46;3;43;.935;3600000;0
8375;213504;117;56;32;4;28;.875;3584000;0
8376;208625;119;83;26;1;25;.962;3600000;0
8376;220332;108;0;0;0;0;.00nan;0;0
8376;-1;108;66;30;3;27;.900;3586000;0
8376;218853;119;0;0;0;0;.00nan;0;0
8377;208620;112;84;16;0;16;1.000;3600000;0
8377;209921;114;0;0;0;0;.00nan;0;0
8377;212052;112;0;0;0;0;.00nan;0;0
8377;223149;114;63;33;3;30;.909;3600000;0
8378;208620;112;57;31;3;28;.903;3575000;0
8378;220601;121;51;17;2;15;.882;3600000;0
8378;212052;112;0;0;0;0;.00nan;0;0
8378;-1;121;0;0;0;0;.00nan;0;0
8379;209921;114;0;0;0;0;.00nan;0;0
8379;215983;117;0;0;0;0;.00nan;0;0
8379;223149;114;52;27;4;23;.852;3600000;0
8379;213504;117;50;36;5;31;.861;3577000;0
8380;213845;113;62;22;3;19;.864;3600000;0
8380;210765;113;0;0;0;0;.00nan;0;0
8380;222609;127;0;0;0;0;.00nan;0;0
8380;212716;127;36;42;7;35;.833;3600000;0
8381;210773;111;54;28;3;25;.893;3546000;0
8381;222436;115;81;33;2;31;.939;3600000;0
8381;217347;111;0;0;0;0;.00nan;0;0
8381;223989;115;0;0;0;0;.00nan;0;0
8382;208625;119;25;17;5;12;.706;2376000;0
8382;215968;110;25;5;3;2;.400;509000;0
8382;212667;110;52;39;5;34;.872;3025000;0
8382;218853;119;51;13;1;12;.923;1224000;0
8383;208652;124;76;37;3;34;.919;3794000;0
8383;221552;124;0;0;0;0;.00nan;0;0
8383;217331;125;0;0;0;0;.00nan;0;0
8383;-1;125;82;28;2;26;.929;3794000;0
8384;204630;109;99;36;1;35;.972;3600000;0
8384;210785;123;69;33;3;30;.909;3518000;0
8384;221211;109;0;0;0;0;.00nan;0;0
8384;211935;123;0;0;0;0;.00nan;0;0
8385;208625;119;0;0;0;0;.00nan;0;0
8385;220332;108;0;0;0;0;.00nan;0;0
8385;-1;108;62;23;2;21;.913;3547000;0
8385;218853;119;66;21;1;20;.952;3600000;0
8386;213722;116;0;0;0;0;.00nan;0;0
8386;210773;111;0;0;0;0;.00nan;0;0
8386;216028;116;99;39;1;38;.974;3600000;0
8386;217347;111;72;30;2;28;.933;3569000;0
8387;208652;124;64;25;2;23;.920;3600000;0
8387;221552;124;0;0;0;0;.00nan;0;0
8387;217331;125;42;30;5;25;.833;3600000;0
8387;-1;125;0;0;0;0;.00nan;0;0
8388;220601;121;56;4;0;4;1.000;423000;0
8388;212681;122;0;0;0;0;.00nan;0;0
8388;-1;121;27;28;6;22;.786;3160000;0
8388;-1;122;48;27;4;23;.852;3600000;0
8389;215983;117;0;0;0;0;.00nan;0;0
8389;222609;127;96;48;3;45;.938;3900000;0
8389;212716;127;0;0;0;0;.00nan;0;0
8389;213504;117;69;30;3;27;.900;3869000;0
8390;208620;112;55;32;4;28;.875;3600000;0
8390;221235;126;52;2;0;2;1.000;474000;0
8390;212039;126;46;33;6;27;.818;3093000;0
8390;212052;112;0;0;0;0;.00nan;0;0
8391;212683;118;78;23;1;22;.957;3600000;0
8391;218081;120;78;42;3;39;.929;3600000;0
8391;213613;120;0;0;0;0;.00nan;0;0
8391;218830;118;0;0;0;0;.00nan;0;0
8392;220332;108;92;39;2;37;.949;3581000;0
8392;204630;109;0;0;0;0;.00nan;0;0
8392;221211;109;73;20;1;19;.950;3600000;0
8392;-1;108;0;0;0;0;.00nan;0;0
8393;208652;124;98;53;3;50;.943;3600000;0
8393;220601;121;73;10;0;10;1.000;3600000;0
8393;221552;124;0;0;0;0;.00nan;0;0
8393;-1;121;0;0;0;0;.00nan;0;0
8394;210785;123;0;0;0;0;.00nan;0;0
8394;211935;123;40;44;7;37;.841;3600000;0
8394;218081;120;0;0;0;0;.00nan;0;0
8394;213613;120;62;26;3;23;.885;3600000;0
8395;208620;112;0;0;0;0;.00nan;0;0
8395;215983;117;52;40;5;35;.875;3600000;0
8395;212052;112;62;27;4;23;.852;3600000;0
8395;213504;117;0;0;0;0;.00nan;0;0
8396;209921;114;38;23;4;19;.826;2043000;0
8396;222436;115;87;35;2;33;.943;3600000;0
8396;223149;114;42;9;2;7;.778;1557000;0
8396;223989;115;0;0;0;0;.00nan;0;0
8397;208625;119;41;35;5;30;.857;3600000;0
8397;210773;111;68;38;4;34;.895;3600000;0
8397;217347;111;0;0;0;0;.00nan;0;0
8397;218853;119;0;0;0;0;.00nan;0;0
8398;213845;113;65;27;2;25;.926;3600000;0
8398;210765;113;0;0;0;0;.00nan;0;0
8398;222436;115;0;0;0;0;.00nan;0;0
8398;223989;115;68;45;4;41;.911;3572000;0
8399;210785;123;50;29;4;25;.862;2329000;0
8399;211935;123;31;24;5;19;.792;1271000;0
8399;212683;118;0;0;0;0;.00nan;0;0
8399;218830;118;61;16;1;15;.938;3600000;0
8400;220332;108;45;12;2;10;.833;1355000;0
8400;212681;122;0;0;0;0;.00nan;0;0
8400;-1;122;85;29;1;28;.966;3600000;0
8400;-1;108;26;23;5;18;.783;2245000;0
8401;221235;126;0;0;0;0;.00nan;0;0
8401;212039;126;66;24;2;22;.917;3600000;0
8401;222609;127;14;12;5;7;.583;1528000;0
8401;212716;127;34;27;5;22;.815;2072000;0
8402;213722;116;0;0;0;0;.00nan;0;0
8402;216028;116;98;49;2;47;.959;3900000;0
8402;217331;125;0;0;0;0;.00nan;0;0
8402;-1;125;78;28;2;26;.929;3900000;0
8403;215968;110;86;47;4;43;.915;3600000;0
8403;212667;110;0;0;0;0;.00nan;0;0
8403;218081;120;48;37;5;32;.865;3556000;0
8403;213613;120;0;0;0;0;.00nan;0;0
8404;208620;112;76;26;2;24;.923;3600000;0
8404;210773;111;30;15;4;11;.733;1180000;0
8404;212052;112;0;0;0;0;.00nan;0;0
8404;217347;111;43;19;4;15;.789;2420000;0
8405;209921;114;0;0;0;0;.00nan;0;0
8405;215968;110;83;33;2;31;.939;3900000;0
8405;212667;110;0;0;0;0;.00nan;0;0
8405;223149;114;96;44;2;42;.955;3900000;0
8406;213722;116;0;0;0;0;.00nan;0;0
8406;204630;109;65;35;4;31;.886;3531000;0
8406;221211;109;0;0;0;0;.00nan;0;0
8406;216028;116;90;45;2;43;.956;3600000;0
8407;220601;121;86;18;0;18;1.000;3600000;0
8407;212683;118;0;0;0;0;.00nan;0;0
8407;218830;118;69;42;4;38;.905;3600000;0
8407;-1;121;0;0;0;0;.00nan;0;0
8408;208652;124;46;21;3;18;.857;3600000;0
8408;210785;123;80;31;2;29;.935;3572000;0
8408;221552;124;0;0;0;0;.00nan;0;0
8408;211935;123;0;0;0;0;.00nan;0;0
8409;212681;122;0;0;0;0;.00nan;0;0
8409;218081;120;65;40;4;36;.900;3900000;0
8409;213613;120;0;0;0;0;.00nan;0;0
8409;-1;122;64;30;4;26;.867;3900000;0
8410;221235;126;0;0;0;0;.00nan;0;0
8410;215983;117;60;12;1;11;.917;1661000;0
8410;212039;126;62;49;5;44;.898;3753000;0
8410;213504;117;20;21;5;16;.762;2092000;0
8411;213722;116;0;0;0;0;.00nan;0;0
8411;209921;114;0;0;0;0;.00nan;0;0
8411;216028;116;65;42;4;38;.905;3600000;0
8411;223149;114;71;35;3;32;.914;3584000;0
8412;213845;113;39;17;4;13;.765;2214000;0
8412;210765;113;47;16;2;14;.875;1386000;0
8412;217331;125;63;23;2;21;.913;3600000;0
8412;-1;125;0;0;0;0;.00nan;0;0
8413;210773;111;71;29;2;27;.931;3581000;0
8413;215968;110;99;36;1;35;.972;3600000;0
8413;217347;111;0;0;0;0;.00nan;0;0
8413;212667;110;0;0;0;0;.00nan;0;0
8414;208620;112;100;28;0;28;1.000;3600000;0
8414;204630;109;57;34;4;30;.882;3600000;0
8414;221211;109;0;0;0;0;.00nan;0;0
8414;212052;112;0;0;0;0;.00nan;0;0
8415;210773;111;0;0;0;0;.00nan;0;0
8415;222436;115;45;38;6;32;.842;3900000;0
8415;217347;111;54;39;6;33;.846;3900000;0
8415;223989;115;0;0;0;0;.00nan;0;0
8416;208652;124;65;43;5;38;.884;3600000;0
8416;221552;124;0;0;0;0;.00nan;0;0
8416;212681;122;0;0;0;0;.00nan;0;0
8416;-1;122;67;19;1;18;.947;3600000;0
8417;220601;121;83;27;1;26;.963;3600000;0
8417;222609;127;0;0;0;0;.00nan;0;0
8417;212716;127;45;27;4;23;.852;3600000;0
8417;-1;121;0;0;0;0;.00nan;0;0
8418;215983;117;52;6;0;6;1.000;1510000;0
8418;217331;125;0;0;0;0;.00nan;0;0
8418;213504;117;7;22;7;15;.682;2090000;0
8418;-1;125;80;34;2;32;.941;3600000;0
8419;220332;108;0;0;0;0;.00nan;0;0
8419;210785;123;0;0;0;0;.00nan;0;0
8419;211935;123;64;33;2;31;.939;3600000;0
8419;-1;108;43;18;3;15;.833;3596000;0
8420;221235;126;0;0;0;0;.00nan;0;0
8420;212039;126;94;43;3;40;.930;3600000;0
8420;212683;118;0;0;0;0;.00nan;0;0
8420;218830;118;31;18;4;14;.778;3546000;0
8421;220601;121;0;0;0;0;.00nan;0;0
8421;212681;122;86;45;3;42;.933;3600000;0
8421;-1;121;36;23;4;19;.826;3547000;0
8421;-1;122;0;0;0;0;.00nan;0;0
8422;208652;124;100;38;1;37;.974;3600000;0
8422;220332;108;26;31;6;25;.806;3600000;0
8422;221552;124;0;0;0;0;.00nan;0;0
8422;-1;108;0;0;0;0;.00nan;0;0
8423;208625;119;71;36;4;32;.889;3772000;0
8423;218081;120;0;0;0;0;.00nan;0;0
8423;213613;120;65;46;5;41;.891;3772000;0
8423;218853;119;0;0;0;0;.00nan;0;0
8424;215968;110;72;22;1;21;.955;3600000;0
8424;222436;115;0;0;0;0;.00nan;0;0
8424;212667;110;0;0;0;0;.00nan;0;0
8424;223989;115;52;26;3;23;.885;3530000;0
8425;210785;123;21;28;7;21;.750;2828000;0
8425;211935;123;39;13;3;10;.769;772000;0
8425;212683;118;57;32;3;29;.906;3600000;0
8425;218830;118;0;0;0;0;.00nan;0;0
8426;221235;126;71;40;4;36;.900;3600000;0
8426;212039;126;0;0;0;0;.00nan;0;0
8426;217331;125;41;31;5;26;.839;3548000;0
8426;-1;125;0;0;0;0;.00nan;0;0
8427;213845;113;78;22;1;21;.955;3600000;0
8427;209921;114;68;48;5;43;.896;3600000;0
8427;210765;113;0;0;0;0;.00nan;0;0
8427;223149;114;0;0;0;0;.00nan;0;0
8428;213722;116;0;0;0;0;.00nan;0;0
8428;210773;111;76;46;5;41;.891;3600000;0
8428;216028;116;49;19;3;16;.842;3600000;0
8428;217347;111;0;0;0;0;.00nan;0;0
8429;213845;113;0;0;0;0;.00nan;0;0
8429;210765;113;71;36;3;33;.917;3600000;0
8429;215983;117;0;0;0;0;.00nan;0;0
8429;213504;117;57;36;5;31;.861;3513000;0
8430;220332;108;61;9;0;9;1.000;938000;0
8430;222609;127;0;0;0;0;.00nan;0;0
8430;212716;127;72;32;3;29;.906;3600000;0
8430;-1;108;15;22;6;16;.727;2662000;0
8431;204630;109;70;43;4;39;.907;3600000;0
8431;221211;109;0;0;0;0;.00nan;0;0
8431;215968;110;0;0;0;0;.00nan;0;0
8431;212667;110;32;24;5;19;.792;3550000;0
8432;208625;119;0;0;0;0;.00nan;0;0
8432;218081;120;72;34;3;31;.912;3600000;0
8432;213613;120;0;0;0;0;.00nan;0;0
8432;218853;119;61;31;4;27;.871;3547000;0
8433;208620;112;100;25;0;25;1.000;3600000;0
8433;209921;114;0;0;0;0;.00nan;0;0
8433;212052;112;0;0;0;0;.00nan;0;0
8433;223149;114;82;43;3;40;.930;3600000;0
8434;209921;114;70;31;3;28;.903;3600000;0
8434;210773;111;28;20;5;15;.750;3600000;0
8434;217347;111;0;0;0;0;.00nan;0;0
8434;223149;114;0;0;0;0;.00nan;0;0
8435;213722;116;0;0;0;0;.00nan;0;0
8435;208620;112;54;24;4;20;.833;3600000;0
8435;216028;116;64;45;5;40;.889;3600000;0
8435;212052;112;0;0;0;0;.00nan;0;0
8436;208652;124;67;29;3;26;.897;3600000;0
8436;221235;126;67;18;1;17;.944;1164000;0
8436;221552;124;0;0;0;0;.00nan;0;0
8436;212039;126;46;27;4;23;.852;2351000;0
8437;208625;119;73;26;1;25;.962;3900000;0
8437;220601;121;90;32;1;31;.969;3900000;0
8437;-1;121;0;0;0;0;.00nan;0;0
8437;218853;119;0;0;0;0;.00nan;0;0
8438;220332;108;0;0;0;0;.00nan;0;0
8438;215968;110;61;23;2;21;.913;3600000;0
8438;212667;110;0;0;0;0;.00nan;0;0
8438;-1;108;58;30;3;27;.900;3600000;0
8439;213722;116;0;0;0;0;.00nan;0;0
8439;216028;116;64;33;4;29;.879;3635000;0
8439;222609;127;0;0;0;0;.00nan;0;0
8439;212716;127;79;38;3;35;.921;3635000;0
8440;209921;114;0;0;0;0;.00nan;0;0
8440;210773;111;68;32;3;29;.906;3600000;0
8440;217347;111;0;0;0;0;.00nan;0;0
8440;223149;114;59;41;5;36;.878;3558000;0
8441;213845;113;57;18;2;16;.889;3600000;0
8441;204630;109;56;46;6;40;.870;3600000;0
8441;210765;113;0;0;0;0;.00nan;0;0
8441;221211;109;0;0;0;0;.00nan;0;0
8442;208625;119;0;0;0;0;.00nan;0;0
8442;222436;115;70;28;2;26;.929;3600000;0
8442;223989;115;0;0;0;0;.00nan;0;0
8442;218853;119;58;37;4;33;.892;3586000;0
8443;217331;125;69;39;3;36;.923;3573000;0
8443;212683;118;0;0;0;0;.00nan;0;0
8443;218830;118;70;26;2;24;.923;3600000;0
8443;-1;125;0;0;0;0;.00nan;0;0
8444;220332;108;78;28;1;27;.964;3600000;0
8444;215968;110;58;26;2;24;.923;3600000;0
8444;212667;110;0;0;0;0;.00nan;0;0
8444;-1;108;0;0;0;0;.00nan;0;0
8445;213722;116;0;0;0;0;.00nan;0;0
8445;216028;116;67;41;4;37;.902;3600000;0
8445;222436;115;0;0;0;0;.00nan;0;0
8445;223989;115;35;35;6;29;.829;3550000;0
8446;212681;122;0;0;0;0;.00nan;0;0
8446;218081;120;0;0;0;0;.00nan;0;0
8446;213613;120;70;40;5;35;.875;3600000;0
8446;-1;122;91;26;1;25;.962;3600000;0
8447;220601;121;0;0;0;0;.00nan;0;0
8447;221235;126;0;0;0;0;.00nan;0;0
8447;212039;126;32;43;8;35;.814;3523000;0
8447;-1;121;22;26;6;20;.769;3600000;0
8448;208620;112;51;30;4;26;.867;3600000;0
8448;215983;117;39;16;3;13;.813;1298000;0
8448;212052;112;0;0;0;0;.00nan;0;0
8448;213504;117;15;30;7;23;.767;2302000;0
8449;208652;124;81;40;2;38;.950;3600000;0
8449;221552;124;0;0;0;0;.00nan;0;0
8449;222609;127;63;31;3;28;.903;3594000;0
8449;212716;127;0;0;0;0;.00nan;0;0
8450;210785;123;93;43;3;40;.930;3543000;0
8450;211935;123;0;0;0;0;.00nan;0;0
8450;212683;118;82;31;2;29;.935;3600000;0
8450;218830;118;0;0;0;0;.00nan;0;0
8451;204630;109;0;0;0;0;.00nan;0;0
8451;210773;111;100;34;0;34;1.000;3600000;0
8451;221211;109;72;24;2;22;.917;3574000;0
8451;217347;111;0;0;0;0;.00nan;0;0
8452;208652;124;98;34;1;33;.971;3600000;0
8452;221552;124;0;0;0;0;.00nan;0;0
8452;217331;125;45;20;3;17;.850;3533000;0
8452;-1;125;0;0;0;0;.00nan;0;0
8453;208625;119;92;31;2;29;.935;3543000;0
8453;210785;123;0;0;0;0;.00nan;0;0
8453;211935;123;92;33;1;32;.970;3600000;0
8453;218853;119;0;0;0;0;.00nan;0;0
8454;221235;126;64;29;3;26;.897;3600000;0
8454;212039;126;0;0;0;0;.00nan;0;0
8454;218081;120;29;31;6;25;.806;3556000;0
8454;213613;120;0;0;0;0;.00nan;0;0
8455;213845;113;80;27;1;26;.963;3600000;0
8455;210765;113;0;0;0;0;.00nan;0;0
8455;215968;110;53;4;0;4;1.000;425000;0
8455;212667;110;40;39;6;33;.846;3175000;0
8456;209921;114;62;38;4;34;.895;3591000;0
8456;215983;117;0;0;0;0;.00nan;0;0
8456;223149;114;0;0;0;0;.00nan;0;0
8456;213504;117;61;30;3;27;.900;3600000;0
8457;213722;116;0;0;0;0;.00nan;0;0
8457;204630;109;53;24;3;21;.875;3600000;0
8457;221211;109;0;0;0;0;.00nan;0;0
8457;216028;116;100;32;0;32;1.000;3600000;0
8458;213845;113;52;5;0;5;1.000;548000;0
8458;220332;108;0;0;0;0;.00nan;0;0
8458;210765;113;42;35;6;29;.829;3052000;0
8458;-1;108;66;30;3;27;.900;3600000;0
8459;209921;114;0;0;0;0;.00nan;0;0
8459;222436;115;63;25;2;23;.920;3600000;0
8459;223149;114;67;39;5;34;.872;3600000;0
8459;223989;115;0;0;0;0;.00nan;0;0
8460;212681;122;70;11;0;11;1.000;1432000;0
8460;212683;118;0;0;0;0;.00nan;0;0
8460;218830;118;89;32;1;31;.969;3600000;0
8460;-1;122;46;25;4;21;.840;2168000;0
8461;215983;117;68;40;4;36;.900;3563000;0
8461;218081;120;0;0;0;0;.00nan;0;0
8461;213504;117;0;0;0;0;.00nan;0;0
8461;213613;120;48;19;3;16;.842;3600000;0
8462;220601;121;76;35;3;32;.914;3600000;0
8462;217331;125;0;0;0;0;.00nan;0;0
8462;-1;125;60;35;5;30;.857;3559000;0
8462;-1;121;0;0;0;0;.00nan;0;0
8463;208620;112;0;0;0;0;.00nan;0;0
8463;212052;112;72;19;1;18;.947;3600000;0
8463;222609;127;0;0;0;0;.00nan;0;0
8463;212716;127;66;34;4;30;.882;3600000;0
8464;212681;122;0;0;0;0;.00nan;0;0
8464;212683;118;0;0;0;0;.00nan;0;0
8464;218830;118;59;36;4;32;.889;3541000;0
8464;-1;122;69;34;3;31;.912;3600000;0
8465;204630;109;39;55;9;46;.836;3600000;0
8465;221211;109;0;0;0;0;.00nan;0;0
8465;222436;115;59;26;3;23;.885;3600000;0
8465;223989;115;0;0;0;0;.00nan;0;0
8466;213845;113;69;33;3;30;.909;3600000;0
8466;209921;114;70;30;3;27;.900;2639000;0
8466;210765;113;0;0;0;0;.00nan;0;0
8466;223149;114;22;10;4;6;.600;961000;0
8467;208625;119;54;29;4;25;.862;3600000;0
8467;208652;124;14;28;7;21;.750;2741000;0
8467;221552;124;43;10;2;8;.800;859000;0
8467;218853;119;0;0;0;0;.00nan;0;0
8468;221235;126;0;0;0;0;.00nan;0;0
8468;212039;126;81;28;2;26;.929;3600000;0
8468;222609;127;0;0;0;0;.00nan;0;0
8468;212716;127;58;27;4;23;.852;3544000;0
8469;213722;116;0;0;0;0;.00nan;0;0
8469;216028;116;73;32;3;29;.906;3900000;0
8469;222436;115;0;0;0;0;.00nan;0;0
8469;223989;115;76;39;3;36;.923;3900000;0
8470;212683;118;0;0;0;0;.00nan;0;0
8470;218081;120;0;0;0;0;.00nan;0;0
8470;213613;120;89;43;2;41;.953;3600000;0
8470;218830;118;50;25;3;22;.880;3600000;0
8471;210773;111;40;35;5;30;.857;3546000;0
8471;215968;110;64;31;3;28;.903;3600000;0
8471;217347;111;0;0;0;0;.00nan;0;0
8471;212667;110;0;0;0;0;.00nan;0;0
8472;208625;119;0;0;0;0;.00nan;0;0
8472;217331;125;74;25;1;24;.960;3600000;0
8472;-1;125;0;0;0;0;.00nan;0;0
8472;218853;119;79;31;2;29;.935;3555000;0
8473;220332;108;98;36;1;35;.972;3600000;0
8473;210773;111;0;0;0;0;.00nan;0;0
8473;217347;111;75;37;3;34;.919;3525000;0
8473;-1;108;0;0;0;0;.00nan;0;0
8474;213722;116;82;36;2;34;.944;3683000;0
8474;213845;113;66;28;3;25;.893;3683000;0
8474;210765;113;0;0;0;0;.00nan;0;0
8474;216028;116;0;0;0;0;.00nan;0;0
8475;208620;112;12;26;7;19;.731;2718000;0
8475;212052;112;34;6;2;4;.667;882000;0
8475;212681;122;0;0;0;0;.00nan;0;0
8475;-1;122;75;25;2;23;.920;3600000;0
8476;220601;121;65;36;4;32;.889;3551000;0
8476;217331;125;0;0;0;0;.00nan;0;0
8476;-1;125;56;22;2;20;.909;3600000;0
8476;-1;121;0;0;0;0;.00nan;0;0
8477;209921;114;0;0;0;0;.00nan;0;0
8477;215983;117;0;0;0;0;.00nan;0;0
8477;223149;114;72;37;4;33;.892;3570000;0
8477;213504;117;47;20;3;17;.850;3600000;0
8478;210785;123;55;29;3;26;.897;3600000;0
8478;211935;123;0;0;0;0;.00nan;0;0
8478;222609;127;0;0;0;0;.00nan;0;0
8478;212716;127;89;33;2;31;.939;3600000;0
8479;208652;124;52;36;5;31;.861;3559000;0
8479;221235;126;0;0;0;0;.00nan;0;0
8479;221552;124;0;0;0;0;.00nan;0;0
8479;212039;126;46;21;3;18;.857;3600000;0
8480;212683;118;0;0;0;0;.00nan;0;0
8480;218081;120;45;40;6;34;.850;2824000;0
8480;213613;120;51;9;1;8;.889;776000;0
8480;218830;118;55;19;2;17;.895;3600000;0
8481;220332;108;0;0;0;0;.00nan;0;0
8481;204630;109;55;29;4;25;.862;3878000;0
8481;221211;109;0;0;0;0;.00nan;0;0
8481;-1;108;61;32;4;28;.875;3900000;0
8482;215983;117;63;19;2;17;.895;3600000;0
8482;222436;115;64;41;5;36;.878;3600000;0
8482;213504;117;0;0;0;0;.00nan;0;0
8482;223989;115;0;0;0;0;.00nan;0;0
8483;208652;124;0;0;0;0;.00nan;0;0
8483;221552;124;57;33;4;29;.879;3576000;0
8483;222609;127;63;25;2;23;.920;3600000;0
8483;212716;127;0;0;0;0;.00nan;0;0
8484;208625;119;22;17;5;12;.706;1048000;0
8484;212681;122;75;25;2;23;.920;3600000;0
8484;-1;122;0;0;0;0;.00nan;0;0
8484;218853;119;42;18;3;15;.833;2552000;0
8485;210785;123;0;0;0;0;.00nan;0;0
8485;211935;123;42;33;5;28;.848;3839000;0
8485;217331;125;47;31;6;25;.806;3825000;0
8485;-1;125;0;0;0;0;.00nan;0;0
8486;209921;114;67;26;1;25;.962;3600000;0
8486;215968;110;53;29;5;24;.828;3600000;0
8486;212667;110;0;0;0;0;.00nan;0;0
8486;223149;114;0;0;0;0;.00nan;0;0
8487;204630;109;0;0;0;0;.00nan;0;0
8487;210773;111;86;43;2;41;.953;3600000;0
8487;221211;109;63;28;3;25;.893;3581000;0
8487;217347;111;0;0;0;0;.00nan;0;0
8488;213845;113;82;24;1;23;.958;3600000;0
8488;210765;113;0;0;0;0;.00nan;0;0
8488;215968;110;0;0;0;0;.00nan;0;0
8488;212667;110;42;33;5;28;.848;3600000;0
8489;210785;123;84;44;4;40;.909;3533000;0
8489;221235;126;0;0;0;0;.00nan;0;0
8489;211935;123;0;0;0;0;.00nan;0;0
8489;212039;126;56;18;2;16;.889;3600000;0
8490;220601;121;36;20;4;16;.800;3600000;0
8490;212683;118;99;44;1;43;.977;3600000;0
8490;218830;118;0;0;0;0;.00nan;0;0
8490;-1;121;0;0;0;0;.00nan;0;0
8491;208620;112;0;0;0;0;.00nan;0;0
8491;215983;117;0;0;0;0;.00nan;0;0
8491;212052;112;100;38;0;38;1.000;3600000;0
8491;213504;117;47;29;5;24;.828;3600000;0
8493;217331;125;49;29;5;24;.828;3584000;0
8493;222609;127;57;23;3;20;.870;3600000;0
8493;212716;127;0;0;0;0;.00nan;0;0
8493;-1;125;0;0;0;0;.00nan;0;0
8495;215968;110;94;57;3;54;.947;3900000;0
8495;212667;110;0;0;0;0;.00nan;0;0
8495;212683;118;0;0;0;0;.00nan;0;0
8495;218830;118;48;19;3;16;.842;3873000;0
8497;213845;113;43;23;4;19;.826;3600000;0
8497;210765;113;0;0;0;0;.00nan;0;0
8497;221235;126;0;0;0;0;.00nan;0;0
8497;212039;126;58;48;6;42;.875;3591000;0
8499;208625;119;82;42;5;37;.881;3552000;0
8499;212681;122;59;31;4;27;.871;3600000;0
8499;-1;122;0;0;0;0;.00nan;0;0
8499;218853;119;0;0;0;0;.00nan;0;0
8501;220601;121;39;20;4;16;.800;3600000;0
8501;210785;123;50;50;7;43;.860;3600000;0
8501;211935;123;0;0;0;0;.00nan;0;0
8501;-1;121;0;0;0;0;.00nan;0;0
8503;208620;112;0;0;0;0;.00nan;0;0
8503;220332;108;67;21;2;19;.905;3600000;0
8503;212052;112;37;30;5;25;.833;3600000;0
8503;-1;108;0;0;0;0;.00nan;0;0
8505;204630;109;39;27;5;22;.815;3600000;0
8505;209921;114;0;0;0;0;.00nan;0;0
8505;221211;109;0;0;0;0;.00nan;0;0
8505;223149;114;62;31;4;27;.871;3600000;0
8507;208652;124;49;38;6;32;.842;3600000;0
8507;215983;117;0;0;0;0;.00nan;0;0
8507;221552;124;0;0;0;0;.00nan;0;0
8507;213504;117;57;17;2;15;.882;3600000;0
8509;218975;116;0;0;0;0;.00nan;0;0
8509;210773;111;0;0;0;0;.00nan;0;0
8509;216028;116;80;28;1;27;.964;3600000;0
8509;217347;111;86;42;3;39;.929;3551000;0
8511;222436;115;0;0;0;0;.00nan;0;0
8511;218081;120;58;28;3;25;.893;3553000;0
8511;223989;115;73;33;2;31;.939;3600000;0
8511;213613;120;0;0;0;0;.00nan;0;0
8513;222436;115;73;31;4;27;.871;3600000;0
8513;217331;125;0;0;0;0;.00nan;0;0
8513;223989;115;0;0;0;0;.00nan;0;0
8513;-1;125;100;30;0;30;1.000;3600000;0
8515;204630;109;0;0;0;0;.00nan;0;0
8515;221211;109;58;43;5;38;.884;3600000;0
8515;212683;118;60;18;2;16;.889;3600000;0
8515;218830;118;0;0;0;0;.00nan;0;0
8517;208625;119;0;0;0;0;.00nan;0;0
8517;222609;127;0;0;0;0;.00nan;0;0
8517;212716;127;56;43;5;38;.884;3559000;0
8517;218853;119;47;26;4;22;.846;3600000;0
8519;213845;113;0;0;0;0;.00nan;0;0
8519;210765;113;99;17;0;17;1.000;3600000;0
8519;212681;122;66;24;2;22;.917;2419000;0
8519;-1;122;28;18;4;14;.778;1181000;0
8521;213722;116;0;0;0;0;.00nan;0;0
8521;220332;108;0;0;0;0;.00nan;0;0
8521;216028;116;42;15;3;12;.800;3731000;0
8521;-1;108;71;42;4;38;.905;3731000;0
8523;208620;112;51;23;3;20;.870;3550000;0
8523;210785;123;0;0;0;0;.00nan;0;0
8523;211935;123;58;21;2;19;.905;3600000;0
8523;212052;112;0;0;0;0;.00nan;0;0
8525;220601;121;0;0;0;0;.00nan;0;0
8525;215983;117;82;34;2;32;.941;3561000;0
8525;213504;117;0;0;0;0;.00nan;0;0
8525;-1;121;73;22;1;21;.955;3600000;0
8527;221235;126;86;47;4;43;.915;3900000;0
8527;212039;126;0;0;0;0;.00nan;0;0
8527;218081;120;0;0;0;0;.00nan;0;0
8527;213613;120;47;28;4;24;.857;3900000;0
8529;209921;114;55;23;3;20;.870;3543000;0
8529;215968;110;0;0;0;0;.00nan;0;0
8529;212667;110;82;33;2;31;.939;3600000;0
8529;223149;114;0;0;0;0;.00nan;0;0
8531;208652;124;0;0;0;0;.00nan;0;0
8531;210773;111;63;24;2;22;.917;3600000;0
8531;221552;124;40;24;4;20;.833;3579000;0
8531;217347;111;0;0;0;0;.00nan;0;0
8533;208625;119;75;33;2;31;.939;3900000;0
8533;215983;117;0;0;0;0;.00nan;0;0
8533;213504;117;95;38;2;36;.947;3900000;0
8533;218853;119;0;0;0;0;.00nan;0;0
8535;217331;125;0;0;0;0;.00nan;0;0
8535;218081;120;60;15;2;13;.867;3600000;0
8535;213613;120;0;0;0;0;.00nan;0;0
8535;-1;125;54;32;4;28;.875;3540000;0
8537;220601;121;0;0;0;0;.00nan;0;0
8537;222436;115;81;51;4;47;.922;3719000;0
8537;223989;115;0;0;0;0;.00nan;0;0
8537;-1;121;33;21;5;16;.762;3728000;0
8539;215968;110;49;28;4;24;.857;3600000;0
8539;222609;127;32;26;5;21;.808;3554000;0
8539;212667;110;0;0;0;0;.00nan;0;0
8539;212716;127;0;0;0;0;.00nan;0;0
8541;220332;108;23;22;6;16;.727;2259000;0
8541;210785;123;68;23;1;22;.957;3600000;0
8541;211935;123;0;0;0;0;.00nan;0;0
8541;-1;108;49;8;1;7;.875;1341000;0
8543;204630;109;38;36;6;30;.833;2234000;0
8543;210773;111;0;0;0;0;.00nan;0;0
8543;221211;109;58;7;0;7;1.000;1366000;0
8543;217347;111;56;24;3;21;.875;3600000;0
8545;208652;124;0;0;0;0;.00nan;0;0
8545;221552;124;58;40;4;36;.900;3600000;0
8545;212683;118;0;0;0;0;.00nan;0;0
8545;218830;118;95;18;0;18;1.000;3600000;0
8547;213845;113;0;0;0;0;.00nan;0;0
8547;210765;113;42;33;6;27;.818;3600000;0
8547;212681;122;0;0;0;0;.00nan;0;0
8547;-1;122;84;24;1;23;.958;3600000;0
8549;209921;114;0;0;0;0;.00nan;0;0
8549;221235;126;0;0;0;0;.00nan;0;0
8549;212039;126;54;25;3;22;.880;3547000;0
8549;223149;114;72;27;2;25;.926;3600000;0
8551;213722;116;0;0;0;0;.00nan;0;0
8551;208620;112;0;0;0;0;.00nan;0;0
8551;216028;116;65;25;2;23;.920;3600000;0
8551;212052;112;44;21;3;18;.857;3563000;0
8553;220332;108;100;24;0;24;1.000;3600000;0
8553;209921;114;93;41;1;40;.976;3576000;0
8553;223149;114;0;0;0;0;.00nan;0;0
8553;-1;108;0;0;0;0;.00nan;0;0
8555;210785;123;0;0;0;0;.00nan;0;0
8555;215983;117;42;26;5;21;.808;3513000;0
8555;211935;123;73;35;3;32;.914;3600000;0
8555;213504;117;0;0;0;0;.00nan;0;0
8557;212683;118;52;22;4;18;.818;3876000;0
8557;218081;120;0;0;0;0;.00nan;0;0
8557;213613;120;82;36;3;33;.917;3876000;0
8557;218830;118;0;0;0;0;.00nan;0;0
8559;213722;116;36;26;5;21;.808;3600000;0
8559;215968;110;0;0;0;0;.00nan;0;0
8559;216028;116;0;0;0;0;.00nan;0;0
8559;212667;110;74;24;1;23;.958;3600000;0
8561;213845;113;39;40;5;35;.875;3900000;0
8561;210765;113;0;0;0;0;.00nan;0;0
8561;212681;122;60;42;5;37;.881;3900000;0
8561;-1;122;0;0;0;0;.00nan;0;0
8563;204630;109;72;46;4;42;.913;3572000;0
8563;210773;111;59;22;3;19;.864;3600000;0
8563;221211;109;0;0;0;0;.00nan;0;0
8563;217347;111;0;0;0;0;.00nan;0;0
8565;208625;119;54;9;1;8;.889;1127000;0
8565;220601;121;78;32;2;30;.938;3600000;0
8565;-1;121;0;0;0;0;.00nan;0;0
8565;218853;119;18;24;6;18;.750;2473000;0
8567;222436;115;0;0;0;0;.00nan;0;0
8567;222609;127;69;9;0;9;1.000;528000;0
8567;212716;127;61;46;6;40;.870;3072000;0
8567;223989;115;22;34;7;27;.794;3551000;0
8569;208652;124;72;38;4;34;.895;3550000;0
8569;221235;126;55;22;3;19;.864;3600000;0
8569;221552;124;0;0;0;0;.00nan;0;0
8569;212039;126;0;0;0;0;.00nan;0;0
8571;208620;112;57;13;1;12;.923;3600000;0
8571;212052;112;0;0;0;0;.00nan;0;0
8571;217331;125;84;34;2;32;.941;3600000;0
8571;-1;125;0;0;0;0;.00nan;0;0
8573;208652;124;0;0;0;0;.00nan;0;0
8573;209921;114;0;0;0;0;.00nan;0;0
8573;221552;124;64;40;4;36;.900;3600000;0
8573;223149;114;72;19;1;18;.947;3600000;0
8575;208625;119;68;19;1;18;.947;3600000;0
8575;217331;125;0;0;0;0;.00nan;0;0
8575;-1;125;62;40;4;36;.900;3600000;0
8575;218853;119;0;0;0;0;.00nan;0;0
8577;221235;126;0;0;0;0;.00nan;0;0
8577;212039;126;70;29;2;27;.931;3577000;0
8577;212681;122;0;0;0;0;.00nan;0;0
8577;-1;122;82;28;1;27;.964;3600000;0
8579;208620;112;0;0;0;0;.00nan;0;0
8579;212052;112;54;32;3;29;.906;3900000;0
8579;212683;118;0;0;0;0;.00nan;0;0
8579;218830;118;54;19;3;16;.842;3900000;0
8581;213722;116;0;0;0;0;.00nan;0;0
8581;210785;123;76;43;3;40;.930;3597000;0
8581;216028;116;75;28;2;26;.929;3600000;0
8581;211935;123;0;0;0;0;.00nan;0;0
8583;220332;108;77;29;2;27;.931;3600000;0
8583;220601;121;0;0;0;0;.00nan;0;0
8583;-1;121;33;28;5;23;.821;3600000;0
8583;-1;108;0;0;0;0;.00nan;0;0
8585;215968;110;62;32;3;29;.906;3600000;0
8585;222609;127;0;0;0;0;.00nan;0;0
8585;212667;110;0;0;0;0;.00nan;0;0
8585;212716;127;53;28;4;24;.857;3543000;0
8587;210773;111;65;27;2;25;.926;3542000;0
8587;215983;117;0;0;0;0;.00nan;0;0
8587;217347;111;0;0;0;0;.00nan;0;0
8587;213504;117;78;25;1;24;.960;3600000;0
8589;213845;113;52;12;2;10;.833;3600000;0
8589;204630;109;82;50;5;45;.900;3600000;0
8589;210765;113;0;0;0;0;.00nan;0;0
8589;221211;109;0;0;0;0;.00nan;0;0
8591;222436;115;76;26;2;24;.923;3600000;0
8591;218081;120;34;41;7;34;.829;3600000;0
8591;223989;115;0;0;0;0;.00nan;0;0
8591;213613;120;0;0;0;0;.00nan;0;0
8593;208652;124;31;11;3;8;.727;551000;0
8593;220601;121;58;18;2;16;.889;3600000;0
8593;221552;124;60;26;3;23;.885;3049000;0
8593;-1;121;0;0;0;0;.00nan;0;0
8595;215968;110;0;0;0;0;.00nan;0;0
8595;222436;115;0;0;0;0;.00nan;0;0
8595;212667;110;99;37;2;35;.946;3600000;0
8595;223989;115;74;36;3;33;.917;3543000;0
8597;220332;108;0;0;0;0;.00nan;0;0
8597;210773;111;0;0;0;0;.00nan;0;0
8597;217347;111;43;26;4;22;.846;3596000;0
8597;-1;108;62;21;2;19;.905;3600000;0
8599;210785;123;0;0;0;0;.00nan;0;0
8599;211935;123;81;26;1;25;.962;3877000;0
8599;222609;127;97;41;1;40;.976;3900000;0
8599;212716;127;0;0;0;0;.00nan;0;0
8601;213845;113;75;23;1;22;.957;3600000;0
8601;210765;113;0;0;0;0;.00nan;0;0
8601;215983;117;73;32;2;30;.938;3593000;0
8601;213504;117;0;0;0;0;.00nan;0;0
8603;208620;112;10;22;7;15;.682;2146000;0
8603;212052;112;47;12;2;10;.833;1454000;0
8603;212683;118;38;12;3;9;.750;3600000;0
8603;218830;118;0;0;0;0;.00nan;0;0
8605;209921;114;77;45;3;42;.933;3600000;0
8605;221235;126;95;19;0;19;1.000;3600000;0
8605;212039;126;0;0;0;0;.00nan;0;0
8605;223149;114;0;0;0;0;.00nan;0;0
8607;204630;109;0;0;0;0;.00nan;0;0
8607;221211;109;49;44;7;37;.841;3600000;0
8607;212681;122;63;22;2;20;.909;3600000;0
8607;-1;122;0;0;0;0;.00nan;0;0
8609;213722;116;89;39;1;38;.974;3900000;0
8609;216028;116;0;0;0;0;.00nan;0;0
8609;218081;120;0;0;0;0;.00nan;0;0
8609;213613;120;78;26;1;25;.962;3900000;0
8611;208625;119;0;0;0;0;.00nan;0;0
8611;217331;125;68;29;3;26;.897;3900000;0
8611;-1;125;0;0;0;0;.00nan;0;0
8611;218853;119;68;35;3;32;.914;3900000;0
8613;220332;108;92;18;0;18;1.000;3600000;0
8613;209921;114;0;0;0;0;.00nan;0;0
8613;223149;114;49;36;5;31;.861;3600000;0
8613;-1;108;0;0;0;0;.00nan;0;0
8615;208652;124;0;0;0;0;.00nan;0;0
8615;221552;124;87;51;4;47;.922;3600000;0
8615;217331;125;0;0;0;0;.00nan;0;0
8615;-1;125;58;22;2;20;.909;3600000;0
8617;215983;117;0;0;0;0;.00nan;0;0
8617;218081;120;34;26;5;21;.808;3600000;0
8617;213504;117;73;25;2;23;.920;3600000;0
8617;213613;120;0;0;0;0;.00nan;0;0
8619;215968;110;14;22;6;16;.727;2136000;0
8619;221235;126;43;26;5;21;.808;3600000;0
8619;212039;126;0;0;0;0;.00nan;0;0
8619;212667;110;74;17;0;17;1.000;1464000;0
8621;210773;111;52;25;3;22;.880;3580000;0
8621;210785;123;76;30;2;28;.933;3600000;0
8621;211935;123;0;0;0;0;.00nan;0;0
8621;217347;111;0;0;0;0;.00nan;0;0
8623;208625;119;69;21;1;20;.952;3600000;0
8623;222609;127;0;0;0;0;.00nan;0;0
8623;212716;127;45;26;4;22;.846;3600000;0
8623;218853;119;0;0;0;0;.00nan;0;0
8625;213722;116;0;0;0;0;.00nan;0;0
8625;204630;109;63;50;5;45;.900;3600000;0
8625;221211;109;0;0;0;0;.00nan;0;0
8625;216028;116;93;35;1;34;.971;3600000;0
8627;213845;113;70;32;3;29;.906;3600000;0
8627;220601;121;0;0;0;0;.00nan;0;0
8627;210765;113;0;0;0;0;.00nan;0;0
8627;-1;121;56;34;5;29;.853;3559000;0
8629;208620;112;35;18;4;14;.778;994000;0
8629;212052;112;60;39;4;35;.897;2606000;0
8629;212681;122;0;0;0;0;.00nan;0;0
8629;-1;122;80;25;1;24;.960;3600000;0
8631;222436;115;46;31;5;26;.839;3630000;0
8631;212683;118;0;0;0;0;.00nan;0;0
8631;223989;115;0;0;0;0;.00nan;0;0
8631;218830;118;44;29;4;25;.862;3630000;0
1697;208620;112;0;0;0;0;.00nan;0;0
1697;215983;117;0;0;0;0;.00nan;0;0
1697;212052;112;62;21;2;19;.905;3600000;0
1697;213504;117;58;39;5;34;.872;3600000;0
1698;213845;113;97;23;0;23;1.000;3600000;0
1698;220332;108;78;38;3;35;.921;3600000;0
1698;210765;113;0;0;0;0;.00nan;0;0
1698;-1;108;0;0;0;0;.00nan;0;0
1699;210773;111;85;31;2;29;.935;3600000;0
1699;222436;115;61;26;3;23;.885;3583000;0
1699;217347;111;0;0;0;0;.00nan;0;0
1699;223989;115;0;0;0;0;.00nan;0;0
1700;209921;114;73;15;0;15;1.000;1273000;0
1700;215968;110;28;11;4;7;.636;827000;0
1700;212667;110;88;26;1;25;.962;2773000;0
1700;223149;114;21;25;6;19;.760;2268000;0
1701;222609;127;24;13;4;9;.692;1119000;0
1701;212683;118;0;0;0;0;.00nan;0;0
1701;212716;127;79;48;3;45;.938;2481000;0
1701;218830;118;82;14;0;14;1.000;3600000;0
1702;221235;126;80;16;0;16;1.000;2529000;0
1702;212039;126;26;12;4;8;.667;1071000;0
1702;218081;120;77;34;2;32;.941;3340000;0
1702;213613;120;26;6;3;3;.500;260000;0
1703;220601;121;54;29;4;25;.862;3600000;0
1703;217331;125;0;0;0;0;.00nan;0;0
1703;-1;125;96;42;1;41;.976;3600000;0
1703;-1;121;0;0;0;0;.00nan;0;0
1704;208625;119;72;20;1;19;.950;3600000;0
1704;212681;122;0;0;0;0;.00nan;0;0
1704;-1;122;85;35;2;33;.943;3590000;0
1704;218853;119;0;0;0;0;.00nan;0;0
1705;208620;112;82;32;2;30;.938;3600000;0
1705;215983;117;0;0;0;0;.00nan;0;0
1705;212052;112;0;0;0;0;.00nan;0;0
1705;213504;117;24;27;6;21;.778;3600000;0
1706;213845;113;73;38;4;34;.895;3600000;0
1706;220332;108;43;31;5;26;.839;3550000;0
1706;210765;113;0;0;0;0;.00nan;0;0
1706;-1;108;0;0;0;0;.00nan;0;0
1707;210773;111;49;21;3;18;.857;3953000;0
1707;222436;115;89;53;4;49;.925;3953000;0
1707;217347;111;0;0;0;0;.00nan;0;0
1707;223989;115;0;0;0;0;.00nan;0;0
1708;209921;114;0;0;0;0;.00nan;0;0
1708;215968;110;93;35;2;33;.943;3600000;0
1708;212667;110;0;0;0;0;.00nan;0;0
1708;223149;114;51;25;4;21;.840;3600000;0
1709;222609;127;97;52;3;49;.942;3600000;0
1709;212683;118;0;0;0;0;.00nan;0;0
1709;212716;127;0;0;0;0;.00nan;0;0
1709;218830;118;65;25;2;23;.920;3600000;0
1710;221235;126;0;0;0;0;.00nan;0;0
1710;212039;126;75;38;3;35;.921;3543000;0
1710;218081;120;0;0;0;0;.00nan;0;0
1710;213613;120;70;30;2;28;.933;3600000;0
1711;220601;121;0;0;0;0;.00nan;0;0
1711;217331;125;40;21;4;17;.810;1524000;0
1711;-1;125;45;33;5;28;.848;2076000;0
1711;-1;121;65;25;2;23;.920;3600000;0
1712;208625;119;77;40;3;37;.925;3600000;0
1712;212681;122;0;0;0;0;.00nan;0;0
1712;-1;122;37;22;4;18;.818;3600000;0
1712;218853;119;0;0;0;0;.00nan;0;0
1713;208620;112;60;47;5;42;.894;5229000;0
1713;215983;117;0;0;0;0;.00nan;0;0
1713;212052;112;0;0;0;0;.00nan;0;0
1713;213504;117;68;47;4;43;.915;5229000;0
1714;213845;113;60;29;3;26;.897;3545000;0
1714;220332;108;61;24;2;22;.917;3600000;0
1714;210765;113;0;0;0;0;.00nan;0;0
1714;-1;108;0;0;0;0;.00nan;0;0
1715;210773;111;85;15;0;15;1.000;3600000;0
1715;222436;115;81;48;4;44;.917;3600000;0
1715;217347;111;0;0;0;0;.00nan;0;0
1715;223989;115;0;0;0;0;.00nan;0;0
1716;209921;114;56;12;1;11;.917;901000;0
1716;215968;110;77;34;2;32;.941;3600000;0
1716;212667;110;0;0;0;0;.00nan;0;0
1716;223149;114;24;28;6;22;.786;2699000;0
1717;222609;127;82;50;4;46;.920;3590000;0
1717;212683;118;0;0;0;0;.00nan;0;0
1717;212716;127;0;0;0;0;.00nan;0;0
1717;218830;118;54;23;3;20;.870;3600000;0
1718;221235;126;0;0;0;0;.00nan;0;0
1718;212039;126;88;31;1;30;.968;3600000;0
1718;218081;120;0;0;0;0;.00nan;0;0
1718;213613;120;85;15;0;15;1.000;3600000;0
1719;220601;121;0;0;0;0;.00nan;0;0
1719;217331;125;90;35;2;33;.943;3557000;0
1719;-1;125;0;0;0;0;.00nan;0;0
1719;-1;121;96;23;0;23;1.000;3600000;0
1720;208625;119;60;30;3;27;.900;3580000;0
1720;212681;122;0;0;0;0;.00nan;0;0
1720;-1;122;96;34;1;33;.971;3600000;0
1720;218853;119;0;0;0;0;.00nan;0;0
1721;208620;112;52;19;2;17;.895;3543000;0
1721;215983;117;0;0;0;0;.00nan;0;0
1721;212052;112;0;0;0;0;.00nan;0;0
1721;213504;117;100;40;1;39;.975;3600000;0
1722;213845;113;42;32;5;27;.844;3943000;0
1722;220332;108;83;53;4;49;.925;3943000;0
1722;210765;113;0;0;0;0;.00nan;0;0
1722;-1;108;0;0;0;0;.00nan;0;0
1723;210773;111;51;23;3;20;.870;3548000;0
1723;222436;115;86;29;1;28;.966;3600000;0
1723;217347;111;0;0;0;0;.00nan;0;0
1723;223989;115;0;0;0;0;.00nan;0;0
1724;209921;114;0;0;0;0;.00nan;0;0
1724;215968;110;95;34;1;33;.971;3600000;0
1724;212667;110;0;0;0;0;.00nan;0;0
1724;223149;114;77;32;2;30;.938;3544000;0
1725;222609;127;81;44;4;40;.909;3713000;0
1725;212683;118;0;0;0;0;.00nan;0;0
1725;212716;127;0;0;0;0;.00nan;0;0
1725;218830;118;56;26;3;23;.885;3713000;0
1726;221235;126;0;0;0;0;.00nan;0;0
1726;212039;126;64;25;2;23;.920;3600000;0
1726;218081;120;0;0;0;0;.00nan;0;0
1726;213613;120;39;21;4;17;.810;3600000;0
1727;220601;121;0;0;0;0;.00nan;0;0
1727;217331;125;0;0;0;0;.00nan;0;0
1727;-1;125;88;35;2;33;.943;3600000;0
1727;-1;121;47;23;4;19;.826;3569000;0
1728;208625;119;48;35;5;30;.857;3600000;0
1728;212681;122;0;0;0;0;.00nan;0;0
1728;-1;122;62;14;1;13;.929;3600000;0
1728;218853;119;0;0;0;0;.00nan;0;0
1902;208620;112;88;31;2;29;.935;3600000;0
1902;215983;117;0;0;0;0;.00nan;0;0
1902;212052;112;0;0;0;0;.00nan;0;0
1902;213504;117;66;29;3;26;.897;3567000;0
1903;213845;113;66;29;3;26;.897;3600000;0
1903;220332;108;59;45;5;40;.889;3573000;0
1903;210765;113;0;0;0;0;.00nan;0;0
1903;-1;108;0;0;0;0;.00nan;0;0
1904;210773;111;69;35;4;31;.886;4401000;0
1904;222436;115;67;33;3;30;.909;4401000;0
1904;217347;111;0;0;0;0;.00nan;0;0
1904;223989;115;0;0;0;0;.00nan;0;0
1905;221235;126;0;0;0;0;.00nan;0;0
1905;212039;126;44;34;5;29;.853;3522000;0
1905;218081;120;0;0;0;0;.00nan;0;0
1905;213613;120;66;30;3;27;.900;3600000;0
1906;220601;121;0;0;0;0;.00nan;0;0
1906;217331;125;26;40;7;33;.825;2736000;0
1906;-1;125;29;16;4;12;.750;864000;0
1906;-1;121;68;30;3;27;.900;3600000;0
1907;208625;119;75;32;3;29;.906;3600000;0
1907;212681;122;0;0;0;0;.00nan;0;0
1907;-1;122;85;29;1;28;.966;3600000;0
1907;218853;119;0;0;0;0;.00nan;0;0
1966;208620;112;89;18;0;18;1.000;3600000;0
1966;215983;117;0;0;0;0;.00nan;0;0
1966;212052;112;0;0;0;0;.00nan;0;0
1966;213504;117;58;22;2;20;.909;3535000;0
1967;213845;113;68;29;2;27;.931;3600000;0
1967;220332;108;74;21;1;20;.952;3600000;0
1967;210765;113;0;0;0;0;.00nan;0;0
1967;-1;108;0;0;0;0;.00nan;0;0
1968;210773;111;78;40;3;37;.925;3555000;0
1968;222436;115;71;24;1;23;.958;3600000;0
1968;217347;111;0;0;0;0;.00nan;0;0
1968;223989;115;0;0;0;0;.00nan;0;0
1969;221235;126;0;0;0;0;.00nan;0;0
1969;212039;126;55;31;4;27;.871;3600000;0
1969;218081;120;0;0;0;0;.00nan;0;0
1969;213613;120;74;25;2;23;.920;3600000;0
1970;220601;121;0;0;0;0;.00nan;0;0
1970;217331;125;66;27;2;25;.926;3600000;0
1970;-1;125;0;0;0;0;.00nan;0;0
1970;-1;121;93;22;0;22;1.000;3600000;0
1971;208625;119;76;32;3;29;.906;3600000;0
1971;212681;122;0;0;0;0;.00nan;0;0
1971;-1;122;40;29;5;24;.828;3514000;0
1971;218853;119;0;0;0;0;.00nan;0;0
1997;213845;113;77;46;4;42;.913;4025000;0
1997;220332;108;73;47;5;42;.894;4025000;0
1997;210765;113;0;0;0;0;.00nan;0;0
1997;-1;108;0;0;0;0;.00nan;0;0
1998;210773;111;41;32;5;27;.844;3594000;0
1998;222436;115;83;39;3;36;.923;3600000;0
1998;217347;111;0;0;0;0;.00nan;0;0
1998;223989;115;0;0;0;0;.00nan;0;0
1999;208625;119;100;35;1;34;.971;3600000;0
1999;212681;122;0;0;0;0;.00nan;0;0
1999;-1;122;34;30;5;25;.833;3600000;0
1999;218853;119;0;0;0;0;.00nan;0;0
2070;208620;112;97;42;2;40;.952;3600000;0
2070;215968;110;51;26;4;22;.846;3559000;0
2070;212052;112;0;0;0;0;.00nan;0;0
2070;212667;110;0;0;0;0;.00nan;0;0
2071;213845;113;59;30;3;27;.900;3574000;0
2071;210765;113;0;0;0;0;.00nan;0;0
2071;222436;115;80;39;2;37;.949;3600000;0
2071;223989;115;0;0;0;0;.00nan;0;0
2072;212683;118;0;0;0;0;.00nan;0;0
2072;218081;120;0;0;0;0;.00nan;0;0
2072;213613;120;52;41;5;36;.878;3600000;0
2072;218830;118;100;27;0;27;1.000;3600000;0
2073;208625;119;88;48;4;44;.917;3533000;0
2073;220601;121;0;0;0;0;.00nan;0;0
2073;-1;121;62;25;2;23;.920;3600000;0
2073;218853;119;0;0;0;0;.00nan;0;0
2074;208620;112;49;40;6;34;.850;4782000;0
2074;215968;110;74;55;5;50;.909;4782000;0
2074;212052;112;0;0;0;0;.00nan;0;0
2074;212667;110;0;0;0;0;.00nan;0;0
2075;213845;113;51;21;3;18;.857;3600000;0
2075;210765;113;0;0;0;0;.00nan;0;0
2075;222436;115;43;25;4;21;.840;3551000;0
2075;223989;115;0;0;0;0;.00nan;0;0
2076;212683;118;0;0;0;0;.00nan;0;0
2076;218081;120;0;0;0;0;.00nan;0;0
2076;213613;120;95;46;2;44;.957;3600000;0
2076;218830;118;64;17;1;16;.941;3600000;0
2077;208625;119;67;41;6;35;.854;3678000;0
2077;220601;121;0;0;0;0;.00nan;0;0
2077;-1;121;26;24;5;19;.792;3678000;0
2077;218853;119;0;0;0;0;.00nan;0;0
2078;208620;112;31;24;6;18;.750;3004000;0
2078;215968;110;70;31;3;28;.903;3600000;0
2078;212052;112;65;9;0;9;1.000;596000;0
2078;212667;110;0;0;0;0;.00nan;0;0
2079;213845;113;63;25;3;22;.880;3600000;0
2079;210765;113;0;0;0;0;.00nan;0;0
2079;222436;115;32;28;7;21;.750;2821000;0
2079;223989;115;59;7;0;7;1.000;779000;0
2080;212683;118;0;0;0;0;.00nan;0;0
2080;218081;120;0;0;0;0;.00nan;0;0
2080;213613;120;69;30;3;27;.900;3600000;0
2080;218830;118;74;40;4;36;.900;3550000;0
2081;208625;119;61;32;4;28;.875;3600000;0
2081;220601;121;0;0;0;0;.00nan;0;0
2081;-1;121;58;28;3;25;.893;3600000;0
2081;218853;119;0;0;0;0;.00nan;0;0
2082;208620;112;86;30;1;29;.967;3600000;0
2082;215968;110;62;24;2;22;.917;3581000;0
2082;212052;112;0;0;0;0;.00nan;0;0
2082;212667;110;0;0;0;0;.00nan;0;0
2083;213845;113;62;24;2;22;.917;3600000;0
2083;210765;113;0;0;0;0;.00nan;0;0
2083;222436;115;0;0;0;0;.00nan;0;0
2083;223989;115;61;41;5;36;.878;3600000;0
2084;212683;118;0;0;0;0;.00nan;0;0
2084;218081;120;0;0;0;0;.00nan;0;0
2084;213613;120;100;42;1;41;.976;3600000;0
2084;218830;118;40;16;3;13;.813;3528000;0
2085;208625;119;43;43;7;36;.837;3600000;0
2085;220601;121;0;0;0;0;.00nan;0;0
2085;-1;121;60;29;4;25;.862;3600000;0
2085;218853;119;0;0;0;0;.00nan;0;0
2315;208620;112;34;36;7;29;.806;3190000;0
2315;215968;110;34;31;6;25;.806;2803000;0
2315;212052;112;44;1;1;0;.000;479000;0
2315;212667;110;44;3;1;2;.667;874000;0
2316;213845;113;63;24;2;22;.917;3572000;0
2316;210765;113;0;0;0;0;.00nan;0;0
2316;222436;115;0;0;0;0;.00nan;0;0
2316;223989;115;93;17;0;17;1.000;3600000;0
2317;212683;118;0;0;0;0;.00nan;0;0
2317;218081;120;50;16;2;14;.875;1330000;0
2317;213613;120;33;28;6;22;.786;2270000;0
2317;218830;118;50;31;5;26;.839;3600000;0
2388;208620;112;71;28;2;26;.929;3600000;0
2388;215968;110;53;33;5;28;.848;3585000;0
2388;212052;112;0;0;0;0;.00nan;0;0
2388;212667;110;0;0;0;0;.00nan;0;0
2389;213845;113;19;9;4;5;.556;1099000;0
2389;210765;113;46;27;4;23;.852;2416000;0
2389;222436;115;51;2;0;2;1.000;402000;0
2389;223989;115;55;35;6;29;.829;3198000;0
2390;212683;118;0;0;0;0;.00nan;0;0
2390;218081;120;22;12;4;8;.667;919000;0
2390;213613;120;58;41;5;36;.878;2681000;0
2390;218830;118;54;23;3;20;.870;3600000;0
2437;208620;112;38;20;4;16;.800;3600000;0
2437;215968;110;52;49;7;42;.857;3600000;0
2437;212052;112;0;0;0;0;.00nan;0;0
2437;212667;110;0;0;0;0;.00nan;0;0
2438;213845;113;0;0;0;0;.00nan;0;0
2438;210765;113;87;32;2;30;.938;3600000;0
2438;222436;115;49;31;4;27;.871;3554000;0
2438;223989;115;0;0;0;0;.00nan;0;0
2472;213845;113;0;0;0;0;.00nan;0;0
2472;208620;112;79;40;3;37;.925;3600000;0
2472;210765;113;33;21;4;17;.810;3546000;0
2472;212052;112;0;0;0;0;.00nan;0;0
2473;220601;121;58;7;0;7;1.000;1366000;0
2473;212683;118;0;0;0;0;.00nan;0;0
2473;218830;118;81;31;2;29;.935;3600000;0
2473;-1;121;25;26;6;20;.769;2234000;0
2474;213845;113;0;0;0;0;.00nan;0;0
2474;208620;112;25;24;6;18;.750;2739000;0
2474;210765;113;81;41;3;38;.927;3600000;0
2474;212052;112;52;4;0;4;1.000;861000;0
2475;220601;121;0;0;0;0;.00nan;0;0
2475;212683;118;0;0;0;0;.00nan;0;0
2475;218830;118;72;22;1;21;.955;3600000;0
2475;-1;121;38;33;5;28;.848;3600000;0
2476;213845;113;0;0;0;0;.00nan;0;0
2476;208620;112;57;25;3;22;.880;3600000;0
2476;210765;113;78;25;1;24;.960;3600000;0
2476;212052;112;0;0;0;0;.00nan;0;0
2477;220601;121;0;0;0;0;.00nan;0;0
2477;212683;118;70;25;2;23;.920;2640000;0
2477;218830;118;29;16;4;12;.750;957000;0
2477;-1;121;39;27;5;22;.815;3600000;0
2478;213845;113;0;0;0;0;.00nan;0;0
2478;208620;112;57;23;3;20;.870;3600000;0
2478;210765;113;58;31;4;27;.871;3597000;0
2478;212052;112;0;0;0;0;.00nan;0;0
2479;220601;121;0;0;0;0;.00nan;0;0
2479;212683;118;0;0;0;0;.00nan;0;0
2479;218830;118;84;34;3;31;.912;3600000;0
2479;-1;121;61;35;4;31;.886;3547000;0
2579;213845;113;0;0;0;0;.00nan;0;0
2579;208620;112;58;35;5;30;.857;4174000;0
2579;210765;113;34;31;6;25;.806;4174000;0
2579;212052;112;0;0;0;0;.00nan;0;0
2580;220601;121;0;0;0;0;.00nan;0;0
2580;212683;118;0;0;0;0;.00nan;0;0
2580;218830;118;53;30;4;26;.867;3817000;0
2580;-1;121;50;22;3;19;.864;3817000;0
2670;213845;113;0;0;0;0;.00nan;0;0
2670;208620;112;86;34;1;33;.971;3695000;0
2670;210765;113;93;41;2;39;.951;3695000;0
2670;212052;112;0;0;0;0;.00nan;0;0
2671;220601;121;0;0;0;0;.00nan;0;0
2671;212683;118;0;0;0;0;.00nan;0;0
2671;218830;118;70;26;3;23;.885;3600000;0
2671;-1;121;100;26;0;26;1.000;3600000;0
2693;220601;121;0;0;0;0;.00nan;0;0
2693;212683;118;0;0;0;0;.00nan;0;0
2693;218830;118;69;35;4;31;.886;3600000;0
2693;-1;121;86;30;1;29;.967;3600000;0
2703;208620;112;85;38;3;35;.921;3600000;0
2703;220601;121;33;19;4;15;.789;3171000;0
2703;212052;112;0;0;0;0;.00nan;0;0
2703;-1;121;28;7;3;4;.571;429000;0
2704;208620;112;67;41;4;37;.902;3600000;0
2704;220601;121;0;0;0;0;.00nan;0;0
2704;212052;112;0;0;0;0;.00nan;0;0
2704;-1;121;78;31;1;30;.968;3600000;0
2705;208620;112;73;42;4;38;.905;3568000;0
2705;220601;121;64;28;3;25;.893;3600000;0
2705;212052;112;0;0;0;0;.00nan;0;0
2705;-1;121;0;0;0;0;.00nan;0;0
2706;208620;112;95;45;2;43;.956;3600000;0
2706;220601;121;51;21;3;18;.857;3551000;0
2706;212052;112;0;0;0;0;.00nan;0;0
2706;-1;121;0;0;0;0;.00nan;0;0
2772;208620;112;99;36;1;35;.972;3600000;0
2772;220601;121;71;22;2;20;.909;3600000;0
2772;212052;112;0;0;0;0;.00nan;0;0
2772;-1;121;0;0;0;0;.00nan;0;0
2777;208620;112;73;38;3;35;.921;3570000;0
2777;220601;121;71;17;1;16;.941;3600000;0
2777;212052;112;0;0;0;0;.00nan;0;0
2777;-1;121;0;0;0;0;.00nan;0;0
2786;208620;112;25;29;6;23;.793;2941000;0
2786;220601;121;33;32;7;25;.781;3547000;0
2786;212052;112;58;4;0;4;1.000;659000;0
2786;-1;121;0;0;0;0;.00nan;0;0
8632;220924;87;61;25;3;22;.880;3574000;0
8632;217437;88;93;33;1;32;.970;3600000;0
8632;-1;88;0;0;0;0;.00nan;0;0
8632;-1;87;0;0;0;0;.00nan;0;0
8633;212301;92;0;0;0;0;.00nan;0;0
8633;212343;96;69;40;4;36;.900;3600000;0
8633;-1;92;51;32;5;27;.844;3600000;0
8633;-1;96;0;0;0;0;.00nan;0;0
8634;213668;95;0;0;0;0;.00nan;0;0
8634;209784;91;63;20;2;18;.900;3600000;0
8634;205429;91;0;0;0;0;.00nan;0;0
8634;212487;95;73;48;4;44;.917;3544000;0
8635;220831;89;0;0;0;0;.00nan;0;0
8635;210471;89;68;28;3;25;.893;3726000;0
8635;210968;86;0;0;0;0;.00nan;0;0
8635;222755;86;58;17;2;15;.882;3726000;0
8636;213659;93;26;28;6;22;.786;2358000;0
8636;215735;93;41;15;3;12;.800;1242000;0
8636;215769;97;61;12;1;11;.917;3600000;0
8636;212354;97;0;0;0;0;.00nan;0;0
8637;210603;104;20;8;4;4;.500;860000;0
8637;210923;102;100;25;0;25;1.000;3600000;0
8637;210930;104;69;30;3;27;.900;2740000;0
8637;-1;102;0;0;0;0;.00nan;0;0
8638;215733;99;0;0;0;0;.00nan;0;0
8638;215785;94;66;27;2;25;.926;3600000;0
8638;218786;99;52;33;5;28;.848;3600000;0
8638;-1;94;0;0;0;0;.00nan;0;0
8639;209796;107;56;41;6;35;.854;3600000;0
8639;210368;106;54;18;2;16;.889;3600000;0
8639;210426;107;0;0;0;0;.00nan;0;0
8639;-1;106;0;0;0;0;.00nan;0;0
8640;208417;101;60;34;4;30;.882;3600000;0
8640;210439;98;30;33;6;27;.818;3113000;0
8640;210503;98;45;5;1;4;.800;487000;0
8640;216150;101;0;0;0;0;.00nan;0;0
8641;212301;92;0;0;0;0;.00nan;0;0
8641;212343;96;72;28;2;26;.929;3600000;0
8641;-1;92;67;36;3;33;.917;3547000;0
8641;-1;96;0;0;0;0;.00nan;0;0
8642;220831;89;0;0;0;0;.00nan;0;0
8642;210471;89;81;28;2;26;.929;3600000;0
8642;217437;88;0;0;0;0;.00nan;0;0
8642;-1;88;61;36;4;32;.889;3559000;0
8643;215733;99;0;0;0;0;.00nan;0;0
8643;215785;94;99;32;1;31;.969;3600000;0
8643;218786;99;80;28;2;26;.929;3550000;0
8643;-1;94;0;0;0;0;.00nan;0;0
8644;210222;90;37;23;5;18;.783;3824000;0
8644;220924;87;0;0;0;0;.00nan;0;0
8644;-1;90;0;0;0;0;.00nan;0;0
8644;-1;87;100;59;4;55;.932;3824000;0
8645;213668;95;0;0;0;0;.00nan;0;0
8645;209784;91;0;0;0;0;.00nan;0;0
8645;205429;91;84;29;1;28;.966;3600000;0
8645;212487;95;60;46;5;41;.891;3600000;0
8646;209796;107;41;47;7;40;.851;3600000;0
8646;210426;107;0;0;0;0;.00nan;0;0
8646;210428;103;0;0;0;0;.00nan;0;0
8646;-1;103;46;23;4;19;.826;3600000;0
8647;213659;93;0;0;0;0;.00nan;0;0
8647;215735;93;65;36;4;32;.889;3600000;0
8647;215769;97;0;0;0;0;.00nan;0;0
8647;212354;97;64;30;3;27;.900;3600000;0
8648;210271;105;28;20;5;15;.750;3515000;0
8648;210439;98;85;39;3;36;.923;3600000;0
8648;210503;98;0;0;0;0;.00nan;0;0
8648;210521;105;0;0;0;0;.00nan;0;0
8649;210368;106;76;44;4;40;.909;3549000;0
8649;215575;100;0;0;0;0;.00nan;0;0
8649;212368;100;74;27;2;25;.926;3600000;0
8649;-1;106;0;0;0;0;.00nan;0;0
8650;210222;90;34;9;3;6;.667;541000;0
8650;210968;86;28;35;7;28;.800;3589000;0
8650;222755;86;0;0;0;0;.00nan;0;0
8650;-1;90;74;27;2;25;.926;3059000;0
8651;210271;105;30;5;3;2;.400;588000;0
8651;210521;105;66;17;1;16;.941;2925000;0
8651;210603;104;86;33;2;31;.939;3600000;0
8651;210930;104;0;0;0;0;.00nan;0;0
8652;210968;86;46;26;4;22;.846;3542000;0
8652;217437;88;91;35;2;33;.943;3600000;0
8652;222755;86;0;0;0;0;.00nan;0;0
8652;-1;88;0;0;0;0;.00nan;0;0
8653;220831;89;0;0;0;0;.00nan;0;0
8653;210471;89;88;23;1;22;.957;3600000;0
8653;220924;87;46;44;6;38;.864;3600000;0
8653;-1;87;0;0;0;0;.00nan;0;0
8654;220831;89;0;0;0;0;.00nan;0;0
8654;210471;89;83;30;1;29;.967;3600000;0
8654;217437;88;14;22;7;15;.682;1972000;0
8654;-1;88;70;24;1;23;.958;1628000;0
8655;220924;87;88;39;2;37;.949;3600000;0
8655;210968;86;63;32;4;28;.875;3539000;0
8655;222755;86;0;0;0;0;.00nan;0;0
8655;-1;87;0;0;0;0;.00nan;0;0
8656;213659;93;0;0;0;0;.00nan;0;0
8656;215735;93;98;44;2;42;.955;3600000;0
8656;212301;92;0;0;0;0;.00nan;0;0
8656;-1;92;56;25;3;22;.880;3573000;0
8657;213668;95;0;0;0;0;.00nan;0;0
8657;212343;96;60;25;3;22;.880;3563000;0
8657;212487;95;72;28;2;26;.929;3600000;0
8657;-1;96;0;0;0;0;.00nan;0;0
8658;209784;91;0;0;0;0;.00nan;0;0
8658;205429;91;80;37;3;34;.919;3600000;0
8658;215769;97;0;0;0;0;.00nan;0;0
8658;212354;97;73;41;4;37;.902;3551000;0
8659;208417;101;17;21;6;15;.714;3132000;0
8659;210923;102;61;32;4;28;.875;3600000;0
8659;216150;101;54;3;0;3;1.000;393000;0
8659;-1;102;0;0;0;0;.00nan;0;0
8660;209796;107;70;49;6;43;.878;3600000;0
8660;210271;105;0;0;0;0;.00nan;0;0
8660;210426;107;0;0;0;0;.00nan;0;0
8660;210521;105;69;19;2;17;.895;3600000;0
8661;210439;98;37;36;6;30;.833;2749000;0
8661;210503;98;59;7;0;7;1.000;851000;0
8661;215733;99;0;0;0;0;.00nan;0;0
8661;218786;99;72;30;3;27;.900;3600000;0
8662;213668;95;0;0;0;0;.00nan;0;0
8662;212487;95;99;51;2;49;.961;3600000;0
8662;217437;88;0;0;0;0;.00nan;0;0
8662;-1;88;45;20;3;17;.850;3544000;0
8663;210222;90;88;23;0;23;1.000;3600000;0
8663;212301;92;79;39;3;36;.923;3600000;0
8663;-1;90;0;0;0;0;.00nan;0;0
8663;-1;92;0;0;0;0;.00nan;0;0
8664;220831;89;48;18;3;15;.833;3600000;0
8664;210471;89;0;0;0;0;.00nan;0;0
8664;220924;87;61;22;2;20;.909;1668000;0
8664;-1;87;21;25;6;19;.760;1932000;0
8665;210368;106;54;42;6;36;.857;3600000;0
8665;210428;103;48;14;2;12;.857;3600000;0
8665;-1;103;0;0;0;0;.00nan;0;0
8665;-1;106;0;0;0;0;.00nan;0;0
8666;210603;104;88;47;3;44;.936;3600000;0
8666;215785;94;66;14;1;13;.929;3600000;0
8666;210930;104;0;0;0;0;.00nan;0;0
8666;-1;94;0;0;0;0;.00nan;0;0
8667;210271;105;53;30;4;26;.867;3900000;0
8667;210521;105;0;0;0;0;.00nan;0;0
8667;210923;102;0;0;0;0;.00nan;0;0
8667;-1;102;65;39;4;35;.897;3900000;0
8668;210439;98;34;6;2;4;.667;469000;0
8668;210503;98;39;38;6;32;.842;3131000;0
8668;215733;99;67;35;2;33;.943;3600000;0
8668;218786;99;0;0;0;0;.00nan;0;0
8669;209796;107;0;0;0;0;.00nan;0;0
8669;210426;107;49;44;6;38;.864;3600000;0
8669;215575;100;60;13;1;12;.923;3600000;0
8669;212368;100;0;0;0;0;.00nan;0;0
8670;210222;90;33;26;5;21;.808;3570000;0
8670;212343;96;74;44;4;40;.909;3600000;0
8670;-1;90;0;0;0;0;.00nan;0;0
8670;-1;96;0;0;0;0;.00nan;0;0
8671;209784;91;0;0;0;0;.00nan;0;0
8671;205429;91;37;31;5;26;.839;3574000;0
8671;215769;97;0;0;0;0;.00nan;0;0
8671;212354;97;53;23;3;20;.870;3600000;0
8672;208417;101;48;7;1;6;.857;2562000;0
8672;209796;107;57;31;5;26;.839;2179000;0
8672;210426;107;70;24;1;23;.958;1417000;0
8672;216150;101;19;9;4;5;.556;1038000;0
8673;215769;97;0;0;0;0;.00nan;0;0
8673;210968;86;65;46;5;41;.891;3541000;0
8673;212354;97;54;25;3;22;.880;3600000;0
8673;222755;86;0;0;0;0;.00nan;0;0
8674;215575;100;56;23;3;20;.870;3600000;0
8674;215733;99;0;0;0;0;.00nan;0;0
8674;212368;100;0;0;0;0;.00nan;0;0
8674;218786;99;59;34;4;30;.882;3565000;0
8675;213668;95;0;0;0;0;.00nan;0;0
8675;212487;95;54;41;5;36;.878;3600000;0
8675;217437;88;31;9;3;6;.667;1635000;0
8675;-1;88;28;15;4;11;.733;1949000;0
8676;220924;87;94;33;1;32;.970;3585000;0
8676;212301;92;0;0;0;0;.00nan;0;0
8676;-1;92;96;23;0;23;1.000;3600000;0
8676;-1;87;0;0;0;0;.00nan;0;0
8677;210222;90;0;0;0;0;.00nan;0;0
8677;215769;97;64;43;5;38;.884;3600000;0
8677;212354;97;0;0;0;0;.00nan;0;0
8677;-1;90;65;14;1;13;.929;3600000;0
8678;215575;100;0;0;0;0;.00nan;0;0
8678;215733;99;87;32;1;31;.969;3600000;0
8678;212368;100;83;44;4;40;.909;3600000;0
8678;218786;99;0;0;0;0;.00nan;0;0
8679;209784;91;74;33;3;30;.909;3566000;0
8679;220831;89;0;0;0;0;.00nan;0;0
8679;210471;89;80;33;2;31;.939;3600000;0
8679;205429;91;0;0;0;0;.00nan;0;0
8680;213659;93;0;0;0;0;.00nan;0;0
8680;215735;93;100;27;0;27;1.000;3600000;0
8680;210968;86;51;19;3;16;.842;3600000;0
8680;222755;86;0;0;0;0;.00nan;0;0
8681;213668;95;33;22;5;17;.773;3600000;0
8681;212301;92;53;4;0;4;1.000;471000;0
8681;212487;95;0;0;0;0;.00nan;0;0
8681;-1;92;35;43;7;36;.837;3129000;0
8682;210439;98;53;43;6;37;.860;2923000;0
8682;210503;98;25;6;3;3;.500;677000;0
8682;210923;102;60;26;3;23;.885;3600000;0
8682;-1;102;0;0;0;0;.00nan;0;0
8683;210271;105;65;30;3;27;.900;3600000;0
8683;210368;106;86;27;1;26;.963;3600000;0
8683;210521;105;0;0;0;0;.00nan;0;0
8683;-1;106;0;0;0;0;.00nan;0;0
8684;209796;107;0;0;0;0;.00nan;0;0
8684;210426;107;38;48;7;41;.854;3600000;0
8684;215733;99;0;0;0;0;.00nan;0;0
8684;218786;99;66;17;1;16;.941;3600000;0
8685;210428;103;67;24;2;22;.917;3600000;0
8685;210603;104;78;36;3;33;.917;3555000;0
8685;210930;104;0;0;0;0;.00nan;0;0
8685;-1;103;0;0;0;0;.00nan;0;0
8686;212343;96;81;34;2;32;.941;3685000;0
8686;217437;88;87;32;1;31;.969;3685000;0
8686;-1;88;0;0;0;0;.00nan;0;0
8686;-1;96;0;0;0;0;.00nan;0;0
8687;220831;89;69;26;2;24;.923;3600000;0
8687;210471;89;0;0;0;0;.00nan;0;0
8687;212301;92;24;13;4;9;.692;1118000;0
8687;-1;92;49;27;4;23;.852;2482000;0
8688;208417;101;46;26;4;22;.846;3703000;0
8688;210368;106;33;14;4;10;.714;1200000;0
8688;216150;101;0;0;0;0;.00nan;0;0
8688;-1;106;71;18;1;17;.944;2503000;0
8689;209796;107;26;35;7;28;.800;3600000;0
8689;210426;107;0;0;0;0;.00nan;0;0
8689;215733;99;67;18;1;17;.944;3600000;0
8689;218786;99;0;0;0;0;.00nan;0;0
8690;213659;93;47;52;7;45;.865;3600000;0
8690;209784;91;0;0;0;0;.00nan;0;0
8690;205429;91;62;12;1;11;.917;3600000;0
8690;215735;93;0;0;0;0;.00nan;0;0
8691;210222;90;71;33;4;29;.879;3600000;0
8691;220924;87;50;37;5;32;.865;3599000;0
8691;-1;90;0;0;0;0;.00nan;0;0
8691;-1;87;0;0;0;0;.00nan;0;0
8692;215769;97;0;0;0;0;.00nan;0;0
8692;210968;86;0;0;0;0;.00nan;0;0
8692;212354;97;42;31;5;26;.839;3555000;0
8692;222755;86;76;40;4;36;.900;3600000;0
8693;210271;105;0;0;0;0;.00nan;0;0
8693;210521;105;53;34;4;30;.882;3576000;0
8693;215785;94;52;22;3;19;.864;3600000;0
8693;-1;94;0;0;0;0;.00nan;0;0
8694;215575;100;89;27;1;26;.963;3600000;0
8694;210603;104;0;0;0;0;.00nan;0;0
8694;210930;104;35;33;6;27;.818;3600000;0
8694;212368;100;0;0;0;0;.00nan;0;0
8695;209796;107;49;6;1;5;.833;358000;0
8695;210426;107;47;47;7;40;.851;3242000;0
8695;210923;102;69;27;2;25;.926;3600000;0
8695;-1;102;0;0;0;0;.00nan;0;0
8696;210439;98;53;31;4;27;.871;3575000;0
8696;215575;100;0;0;0;0;.00nan;0;0
8696;210503;98;0;0;0;0;.00nan;0;0
8696;212368;100;79;29;2;27;.931;3600000;0
8697;209784;91;52;31;4;27;.871;3600000;0
8697;205429;91;0;0;0;0;.00nan;0;0
8697;215769;97;0;0;0;0;.00nan;0;0
8697;212354;97;80;27;1;26;.963;3600000;0
8698;220831;89;0;0;0;0;.00nan;0;0
8698;210471;89;78;21;1;20;.952;3600000;0
8698;212343;96;40;41;6;35;.854;3070000;0
8698;-1;96;56;5;0;5;1.000;530000;0
8699;209784;91;0;0;0;0;.00nan;0;0
8699;205429;91;69;28;2;26;.929;3725000;0
8699;217437;88;63;27;3;24;.889;3725000;0
8699;-1;88;0;0;0;0;.00nan;0;0
8700;220924;87;63;29;3;26;.897;3900000;0
8700;212343;96;0;0;0;0;.00nan;0;0
8700;-1;87;0;0;0;0;.00nan;0;0
8700;-1;96;70;38;3;35;.921;3900000;0
8701;213668;95;0;0;0;0;.00nan;0;0
8701;215733;99;0;0;0;0;.00nan;0;0
8701;212487;95;45;38;6;32;.842;3600000;0
8701;218786;99;67;20;2;18;.900;3600000;0
8702;210603;104;61;38;4;34;.895;3592000;0
8702;210923;102;72;30;3;27;.900;3600000;0
8702;210930;104;0;0;0;0;.00nan;0;0
8702;-1;102;0;0;0;0;.00nan;0;0
8703;209784;91;62;26;3;23;.885;3600000;0
8703;220831;89;57;37;4;33;.892;3600000;0
8703;210471;89;0;0;0;0;.00nan;0;0
8703;205429;91;0;0;0;0;.00nan;0;0
8704;210968;86;69;22;2;20;.909;3600000;0
8704;212343;96;73;39;3;36;.923;3600000;0
8704;222755;86;0;0;0;0;.00nan;0;0
8704;-1;96;0;0;0;0;.00nan;0;0
8705;213659;93;0;0;0;0;.00nan;0;0
8705;220924;87;85;33;2;31;.939;3600000;0
8705;215735;93;92;48;3;45;.938;3569000;0
8705;-1;87;0;0;0;0;.00nan;0;0
8706;210368;106;85;37;2;35;.946;3600000;0
8706;210923;102;74;20;1;19;.950;3600000;0
8706;-1;102;0;0;0;0;.00nan;0;0
8706;-1;106;0;0;0;0;.00nan;0;0
8707;208417;101;94;19;0;19;1.000;3600000;0
8707;213668;95;0;0;0;0;.00nan;0;0
8707;216150;101;0;0;0;0;.00nan;0;0
8707;212487;95;98;65;3;62;.954;3600000;0
8708;215575;100;70;28;2;26;.929;3600000;0
8708;215733;99;0;0;0;0;.00nan;0;0
8708;212368;100;0;0;0;0;.00nan;0;0
8708;218786;99;60;32;4;28;.875;3600000;0
8709;209796;107;0;0;0;0;.00nan;0;0
8709;210426;107;52;33;4;29;.879;3893000;0
8709;210428;103;48;17;3;14;.824;3893000;0
8709;-1;103;0;0;0;0;.00nan;0;0
8710;215785;94;77;39;3;36;.923;3887000;0
8710;217437;88;79;35;2;33;.943;3887000;0
8710;-1;88;0;0;0;0;.00nan;0;0
8710;-1;94;0;0;0;0;.00nan;0;0
8711;210271;105;68;23;1;22;.957;3600000;0
8711;210439;98;0;0;0;0;.00nan;0;0
8711;210503;98;88;50;3;47;.940;3600000;0
8711;210521;105;0;0;0;0;.00nan;0;0
8712;220831;89;57;9;0;9;1.000;1107000;0
8712;210471;89;37;32;6;26;.813;2493000;0
8712;210968;86;0;0;0;0;.00nan;0;0
8712;222755;86;100;28;0;28;1.000;3600000;0
8713;209784;91;0;0;0;0;.00nan;0;0
8713;220924;87;0;0;0;0;.00nan;0;0
8713;205429;91;89;29;1;28;.966;3600000;0
8713;-1;87;76;39;3;36;.923;3540000;0
8714;210222;90;71;29;3;26;.897;3600000;0
8714;212343;96;0;0;0;0;.00nan;0;0
8714;-1;90;0;0;0;0;.00nan;0;0
8714;-1;96;75;35;4;31;.886;3600000;0
8715;210603;104;89;32;2;30;.938;3591000;0
8715;210930;104;0;0;0;0;.00nan;0;0
8715;217437;88;0;0;0;0;.00nan;0;0
8715;-1;88;76;21;1;20;.952;3600000;0
8716;215785;94;0;0;0;0;.00nan;0;0
8716;210923;102;0;0;0;0;.00nan;0;0
8716;-1;94;32;22;5;17;.773;3558000;0
8716;-1;102;61;35;4;31;.886;3600000;0
8717;213668;95;62;19;2;17;.895;3600000;0
8717;210439;98;75;36;3;33;.917;3563000;0
8717;210503;98;0;0;0;0;.00nan;0;0
8717;212487;95;0;0;0;0;.00nan;0;0
8718;215575;100;0;0;0;0;.00nan;0;0
8718;212301;92;43;5;1;4;.800;399000;0
8718;212368;100;52;21;3;18;.857;3600000;0
8718;-1;92;46;28;5;23;.821;3201000;0
8719;213659;93;0;0;0;0;.00nan;0;0
8719;215735;93;45;29;5;24;.828;3526000;0
8719;215769;97;0;0;0;0;.00nan;0;0
8719;212354;97;71;31;3;28;.903;3600000;0
8720;210368;106;44;38;7;31;.816;3600000;0
8720;215785;94;90;16;0;16;1.000;3600000;0
8720;-1;94;0;0;0;0;.00nan;0;0
8720;-1;106;0;0;0;0;.00nan;0;0
8721;210222;90;31;34;6;28;.824;1929000;0
8721;210968;86;0;0;0;0;.00nan;0;0
8721;222755;86;72;29;2;27;.931;3600000;0
8721;-1;90;55;22;2;20;.909;1671000;0
8722;220831;89;0;0;0;0;.00nan;0;0
8722;210471;89;70;31;3;28;.903;3566000;0
8722;220924;87;86;37;2;35;.946;3600000;0
8722;-1;87;0;0;0;0;.00nan;0;0
8723;213659;93;0;0;0;0;.00nan;0;0
8723;215735;93;77;35;3;32;.914;3600000;0
8723;215769;97;49;25;4;21;.840;3588000;0
8723;212354;97;0;0;0;0;.00nan;0;0
8724;213668;95;0;0;0;0;.00nan;0;0
8724;210923;102;65;16;1;15;.938;3600000;0
8724;212487;95;61;38;5;33;.868;3600000;0
8724;-1;102;0;0;0;0;.00nan;0;0
8725;210428;103;65;31;3;28;.903;3600000;0
8725;217437;88;45;27;4;23;.852;3569000;0
8725;-1;88;0;0;0;0;.00nan;0;0
8725;-1;103;0;0;0;0;.00nan;0;0
8726;210439;98;11;22;7;15;.682;2705000;0
8726;210503;98;39;1;1;0;.000;895000;0
8726;212301;92;0;0;0;0;.00nan;0;0
8726;-1;92;71;33;3;30;.909;3600000;0
8727;209784;91;50;14;2;12;.857;3600000;0
8727;205429;91;0;0;0;0;.00nan;0;0
8727;212343;96;94;46;3;43;.935;3600000;0
8727;-1;96;0;0;0;0;.00nan;0;0
8728;210368;106;41;28;5;23;.821;3561000;0
8728;217437;88;0;0;0;0;.00nan;0;0
8728;-1;88;47;24;4;20;.833;3600000;0
8728;-1;106;0;0;0;0;.00nan;0;0
8729;208417;101;53;28;3;25;.893;3562000;0
8729;216150;101;0;0;0;0;.00nan;0;0
8729;212301;92;71;26;2;24;.923;3600000;0
8729;-1;92;0;0;0;0;.00nan;0;0
8730;213668;95;89;38;2;36;.947;3784000;0
8730;215575;100;98;35;1;34;.971;3784000;0
8730;212368;100;0;0;0;0;.00nan;0;0
8730;212487;95;0;0;0;0;.00nan;0;0
8731;209796;107;85;50;3;47;.940;3600000;0
8731;210426;107;0;0;0;0;.00nan;0;0
8731;215785;94;82;19;1;18;.947;3600000;0
8731;-1;94;0;0;0;0;.00nan;0;0
8732;210222;90;70;19;2;17;.895;3600000;0
8732;215769;97;0;0;0;0;.00nan;0;0
8732;212354;97;75;42;4;38;.905;3600000;0
8732;-1;90;0;0;0;0;.00nan;0;0
8733;210428;103;59;26;3;23;.885;3600000;0
8733;212343;96;90;35;2;33;.943;3600000;0
8733;-1;96;0;0;0;0;.00nan;0;0
8733;-1;103;0;0;0;0;.00nan;0;0
8734;213659;93;0;0;0;0;.00nan;0;0
8734;209784;91;0;0;0;0;.00nan;0;0
8734;205429;91;69;25;2;23;.920;3600000;0
8734;215735;93;89;46;3;43;.935;3563000;0
8735;220924;87;67;43;5;38;.884;3600000;0
8735;210968;86;85;29;1;28;.966;3600000;0
8735;222755;86;0;0;0;0;.00nan;0;0
8735;-1;87;0;0;0;0;.00nan;0;0
8736;210923;102;75;33;2;31;.939;3600000;0
8736;212301;92;72;34;3;31;.912;3556000;0
8736;-1;92;0;0;0;0;.00nan;0;0
8736;-1;102;0;0;0;0;.00nan;0;0
8737;208417;101;44;23;4;19;.826;3517000;0
8737;209796;107;0;0;0;0;.00nan;0;0
8737;210426;107;98;48;2;46;.958;3600000;0
8737;216150;101;0;0;0;0;.00nan;0;0
8738;215575;100;35;14;4;10;.714;1000000;0
8738;215785;94;65;29;3;26;.897;3600000;0
8738;212368;100;85;20;0;20;1.000;2543000;0
8738;-1;94;0;0;0;0;.00nan;0;0
8739;210271;105;53;39;5;34;.872;3600000;0
8739;210521;105;0;0;0;0;.00nan;0;0
8739;217437;88;75;31;2;29;.935;3600000;0
8739;-1;88;0;0;0;0;.00nan;0;0
8740;210439;98;0;0;0;0;.00nan;0;0
8740;210503;98;49;37;5;32;.865;3600000;0
8740;210603;104;65;45;6;39;.867;3600000;0
8740;210930;104;0;0;0;0;.00nan;0;0
8741;220831;89;0;0;0;0;.00nan;0;0
8741;210471;89;68;19;1;18;.947;3600000;0
8741;210968;86;63;8;0;8;1.000;563000;0
8741;222755;86;35;38;7;31;.816;3037000;0
8742;215733;99;42;19;3;16;.842;3600000;0
8742;210923;102;0;0;0;0;.00nan;0;0
8742;218786;99;0;0;0;0;.00nan;0;0
8742;-1;102;46;29;4;25;.862;3600000;0
8743;213659;93;59;43;5;38;.884;3600000;0
8743;210222;90;66;22;2;20;.909;3600000;0
8743;215735;93;0;0;0;0;.00nan;0;0
8743;-1;90;0;0;0;0;.00nan;0;0
8744;209796;107;79;38;2;36;.947;3600000;0
8744;210426;107;0;0;0;0;.00nan;0;0
8744;217437;88;0;0;0;0;.00nan;0;0
8744;-1;88;85;29;1;28;.966;3600000;0
8745;210271;105;0;0;0;0;.00nan;0;0
8745;210368;106;96;31;1;30;.968;3600000;0
8745;210521;105;64;27;2;25;.926;3563000;0
8745;-1;106;0;0;0;0;.00nan;0;0
8746;210439;98;85;40;3;37;.925;3600000;0
8746;210503;98;0;0;0;0;.00nan;0;0
8746;210603;104;0;0;0;0;.00nan;0;0
8746;210930;104;62;35;4;31;.886;3600000;0
8747;208417;101;0;0;0;0;.00nan;0;0
8747;215575;100;99;51;3;48;.941;3600000;0
8747;216150;101;36;23;5;18;.783;3600000;0
8747;212368;100;0;0;0;0;.00nan;0;0
8748;209784;91;97;36;1;35;.972;3600000;0
8748;205429;91;0;0;0;0;.00nan;0;0
8748;212343;96;0;0;0;0;.00nan;0;0
8748;-1;96;83;46;3;43;.935;3531000;0
8749;213668;95;0;0;0;0;.00nan;0;0
8749;220924;87;52;25;3;22;.880;3600000;0
8749;212487;95;94;41;2;39;.951;3600000;0
8749;-1;87;0;0;0;0;.00nan;0;0
8750;210428;103;47;30;5;25;.833;3562000;0
8750;215769;97;74;40;3;37;.925;3600000;0
8750;212354;97;0;0;0;0;.00nan;0;0
8750;-1;103;0;0;0;0;.00nan;0;0
8751;208417;101;61;33;4;29;.879;3629000;0
8751;210603;104;81;45;5;40;.889;3629000;0
8751;210930;104;0;0;0;0;.00nan;0;0
8751;216150;101;0;0;0;0;.00nan;0;0
8752;210271;105;59;37;4;33;.892;3569000;0
8752;210521;105;0;0;0;0;.00nan;0;0
8752;215785;94;56;15;2;13;.867;3600000;0
8752;-1;94;0;0;0;0;.00nan;0;0
8753;215733;99;51;26;4;22;.846;3600000;0
8753;212301;92;0;0;0;0;.00nan;0;0
8753;218786;99;0;0;0;0;.00nan;0;0
8753;-1;92;20;23;6;17;.739;3518000;0
8754;213659;93;82;64;6;58;.906;3560000;0
8754;210428;103;41;23;4;19;.826;3600000;0
8754;215735;93;0;0;0;0;.00nan;0;0
8754;-1;103;0;0;0;0;.00nan;0;0
8755;210222;90;0;0;0;0;.00nan;0;0
8755;220831;89;0;0;0;0;.00nan;0;0
8755;210471;89;90;35;1;34;.971;3716000;0
8755;-1;90;93;21;0;21;1.000;3716000;0
8756;209796;107;0;0;0;0;.00nan;0;0
8756;210426;107;78;45;4;41;.911;3544000;0
8756;210923;102;37;15;3;12;.800;3600000;0
8756;-1;102;0;0;0;0;.00nan;0;0
8757;209784;91;0;0;0;0;.00nan;0;0
8757;210428;103;0;0;0;0;.00nan;0;0
8757;205429;91;49;25;4;21;.840;3600000;0
8757;-1;103;63;46;5;41;.891;3600000;0
8758;213668;95;0;0;0;0;.00nan;0;0
8758;210968;86;61;30;3;27;.900;3600000;0
8758;212487;95;78;45;4;41;.911;3600000;0
8758;222755;86;0;0;0;0;.00nan;0;0
8759;210439;98;0;0;0;0;.00nan;0;0
8759;215575;100;0;0;0;0;.00nan;0;0
8759;210503;98;91;40;2;38;.950;3600000;0
8759;212368;100;47;29;4;25;.862;3578000;0
8760;210271;105;0;0;0;0;.00nan;0;0
8760;210521;105;60;35;4;31;.886;3600000;0
8760;215785;94;44;33;5;28;.848;3548000;0
8760;-1;94;0;0;0;0;.00nan;0;0
8761;220831;89;0;0;0;0;.00nan;0;0
8761;210471;89;56;21;2;19;.905;3600000;0
8761;217437;88;81;38;3;35;.921;3593000;0
8761;-1;88;0;0;0;0;.00nan;0;0
8762;209784;91;0;0;0;0;.00nan;0;0
8762;205429;91;61;35;5;30;.857;3712000;0
8762;212343;96;71;38;4;34;.895;3712000;0
8762;-1;96;0;0;0;0;.00nan;0;0
8763;215769;97;0;0;0;0;.00nan;0;0
8763;212301;92;0;0;0;0;.00nan;0;0
8763;212354;97;30;29;6;23;.793;3600000;0
8763;-1;92;45;42;7;35;.833;3579000;0
8764;213659;93;0;0;0;0;.00nan;0;0
8764;210368;106;51;32;4;28;.875;3600000;0
8764;215735;93;51;36;5;31;.861;3600000;0
8764;-1;106;0;0;0;0;.00nan;0;0
8765;210222;90;0;0;0;0;.00nan;0;0
8765;220924;87;50;30;4;26;.867;3600000;0
8765;-1;90;47;30;5;25;.833;3575000;0
8765;-1;87;0;0;0;0;.00nan;0;0
8766;213668;95;56;30;4;26;.867;3600000;0
8766;210428;103;79;38;3;35;.921;3600000;0
8766;212487;95;0;0;0;0;.00nan;0;0
8766;-1;103;0;0;0;0;.00nan;0;0
8767;215785;94;69;30;3;27;.900;3600000;0
8767;210923;102;69;19;1;18;.947;3600000;0
8767;-1;94;0;0;0;0;.00nan;0;0
8767;-1;102;0;0;0;0;.00nan;0;0
8768;208417;101;56;13;1;12;.923;3188000;0
8768;210439;98;98;46;3;43;.935;3600000;0
8768;210503;98;0;0;0;0;.00nan;0;0
8768;216150;101;13;6;4;2;.333;381000;0
8769;215575;100;62;28;3;25;.893;3600000;0
8769;210603;104;33;37;7;30;.811;3600000;0
8769;210930;104;0;0;0;0;.00nan;0;0
8769;212368;100;0;0;0;0;.00nan;0;0
8770;209796;107;60;45;6;39;.867;3600000;0
8770;210271;105;57;16;1;15;.938;3600000;0
8770;210426;107;0;0;0;0;.00nan;0;0
8770;210521;105;0;0;0;0;.00nan;0;0
8771;210222;90;74;33;3;30;.909;3525000;0
8771;217437;88;75;22;1;21;.955;3600000;0
8771;-1;90;0;0;0;0;.00nan;0;0
8771;-1;88;0;0;0;0;.00nan;0;0
8772;213659;93;42;38;6;32;.842;2258000;0
8772;215735;93;57;16;1;15;.938;1342000;0
8772;212343;96;0;0;0;0;.00nan;0;0
8772;-1;96;58;18;2;16;.889;3600000;0
8773;215785;94;71;24;2;22;.917;3600000;0
8773;210923;102;53;9;1;8;.889;2038000;0
8773;-1;94;0;0;0;0;.00nan;0;0
8773;-1;102;20;32;7;25;.781;1562000;0
8774;210428;103;0;0;0;0;.00nan;0;0
8774;212301;92;33;35;6;29;.829;3066000;0
8774;-1;92;33;5;2;3;.600;534000;0
8774;-1;103;87;29;1;28;.966;3600000;0
8775;220831;89;94;37;1;36;.973;3600000;0
8775;210471;89;0;0;0;0;.00nan;0;0
8775;215733;99;27;25;5;20;.800;3600000;0
8775;218786;99;0;0;0;0;.00nan;0;0
8776;213668;95;0;0;0;0;.00nan;0;0
8776;210968;86;53;9;1;8;.889;3600000;0
8776;212487;95;98;54;3;51;.944;3541000;0
8776;222755;86;0;0;0;0;.00nan;0;0
8777;209796;107;0;0;0;0;.00nan;0;0
8777;210426;107;54;37;6;31;.838;3600000;0
8777;215575;100;0;0;0;0;.00nan;0;0
8777;212368;100;61;19;2;17;.895;3600000;0
8778;210368;106;94;41;2;39;.951;3600000;0
8778;215769;97;48;27;4;23;.852;3561000;0
8778;212354;97;0;0;0;0;.00nan;0;0
8778;-1;106;0;0;0;0;.00nan;0;0
8779;210271;105;0;0;0;0;.00nan;0;0
8779;210521;105;39;23;4;19;.826;3560000;0
8779;210603;104;0;0;0;0;.00nan;0;0
8779;210930;104;67;32;3;29;.906;3600000;0
8780;208417;101;0;0;0;0;.00nan;0;0
8780;210439;98;0;0;0;0;.00nan;0;0
8780;210503;98;79;31;1;30;.968;3600000;0
8780;216150;101;61;21;2;19;.905;3552000;0
8781;220831;89;0;0;0;0;.00nan;0;0
8781;210471;89;80;35;2;33;.943;3600000;0
8781;210968;86;0;0;0;0;.00nan;0;0
8781;222755;86;40;25;4;21;.840;3587000;0
8782;220924;87;43;32;6;26;.813;3870000;0
8782;215733;99;52;38;5;33;.868;3870000;0
8782;218786;99;0;0;0;0;.00nan;0;0
8782;-1;87;0;0;0;0;.00nan;0;0
8783;208417;101;79;33;3;30;.909;3600000;0
8783;210923;102;0;0;0;0;.00nan;0;0
8783;216150;101;0;0;0;0;.00nan;0;0
8783;-1;102;59;32;4;28;.875;3564000;0
8784;210368;106;64;35;4;31;.886;3549000;0
8784;212343;96;85;30;2;28;.933;3600000;0
8784;-1;96;0;0;0;0;.00nan;0;0
8784;-1;106;0;0;0;0;.00nan;0;0
8785;215733;99;39;24;4;20;.833;3570000;0
8785;217437;88;92;38;3;35;.921;3600000;0
8785;218786;99;0;0;0;0;.00nan;0;0
8785;-1;88;0;0;0;0;.00nan;0;0
8786;209784;91;90;40;1;39;.975;3600000;0
8786;210271;105;55;32;3;29;.906;3568000;0
8786;205429;91;0;0;0;0;.00nan;0;0
8786;210521;105;0;0;0;0;.00nan;0;0
8787;210368;106;0;0;0;0;.00nan;0;0
8787;212301;92;67;22;2;20;.909;3600000;0
8787;-1;92;0;0;0;0;.00nan;0;0
8787;-1;106;73;53;5;48;.906;3600000;0
8788;220924;87;0;0;0;0;.00nan;0;0
8788;210968;86;70;23;1;22;.957;3543000;0
8788;222755;86;0;0;0;0;.00nan;0;0
8788;-1;87;100;32;0;32;1.000;3600000;0
8789;208417;101;25;7;3;4;.571;373000;0
8789;215785;94;0;0;0;0;.00nan;0;0
8789;216150;101;44;29;4;25;.862;3226000;0
8789;-1;94;38;30;6;24;.800;3600000;0
8790;210222;90;71;39;4;35;.897;3600000;0
8790;210968;86;0;0;0;0;.00nan;0;0
8790;222755;86;97;32;1;31;.969;3600000;0
8790;-1;90;0;0;0;0;.00nan;0;0
8791;210271;105;24;10;4;6;.600;1037000;0
8791;210521;105;42;22;4;18;.818;2486000;0
8791;212343;96;28;25;6;19;.760;3600000;0
8791;-1;96;0;0;0;0;.00nan;0;0
8792;209784;91;0;0;0;0;.00nan;0;0
8792;205429;91;73;32;2;30;.938;3551000;0
8792;212301;92;0;0;0;0;.00nan;0;0
8792;-1;92;100;43;0;43;1.000;3600000;0
8793;220924;87;0;0;0;0;.00nan;0;0
8793;217437;88;82;25;1;24;.960;3600000;0
8793;-1;88;0;0;0;0;.00nan;0;0
8793;-1;87;67;32;3;29;.906;3600000;0
8794;210222;90;81;16;0;16;1.000;1766000;0
8794;215733;99;29;8;3;5;.625;391000;0
8794;218786;99;94;40;2;38;.950;3509000;0
8794;-1;90;22;17;5;12;.706;2134000;0
8795;213668;95;0;0;0;0;.00nan;0;0
8795;210368;106;84;34;2;32;.941;3600000;0
8795;212487;95;58;26;3;23;.885;3541000;0
8795;-1;106;0;0;0;0;.00nan;0;0
8796;220831;89;0;0;0;0;.00nan;0;0
8796;210471;89;23;20;5;15;.750;3569000;0
8796;215769;97;0;0;0;0;.00nan;0;0
8796;212354;97;97;54;4;50;.926;3600000;0
8797;213659;93;0;0;0;0;.00nan;0;0
8797;215735;93;76;36;3;33;.917;3572000;0
8797;210923;102;76;25;2;23;.920;3600000;0
8797;-1;102;0;0;0;0;.00nan;0;0
8798;208417;101;66;16;1;15;.938;3600000;0
8798;209796;107;43;49;7;42;.857;3600000;0
8798;210426;107;0;0;0;0;.00nan;0;0
8798;216150;101;0;0;0;0;.00nan;0;0
8799;210439;98;0;0;0;0;.00nan;0;0
8799;215575;100;0;0;0;0;.00nan;0;0
8799;210503;98;96;43;3;40;.930;3600000;0
8799;212368;100;37;25;5;20;.800;3572000;0
8800;210428;103;67;33;3;30;.909;3600000;0
8800;210603;104;91;61;6;55;.902;3600000;0
8800;210930;104;0;0;0;0;.00nan;0;0
8800;-1;103;0;0;0;0;.00nan;0;0
8801;209784;91;44;20;3;17;.850;3545000;0
8801;210368;106;0;0;0;0;.00nan;0;0
8801;205429;91;0;0;0;0;.00nan;0;0
8801;-1;106;93;42;2;40;.952;3600000;0
8802;210271;105;80;36;2;34;.944;3600000;0
8802;210521;105;0;0;0;0;.00nan;0;0
8802;212301;92;0;0;0;0;.00nan;0;0
8802;-1;92;73;32;3;29;.906;3583000;0
8803;215733;99;30;25;5;20;.800;3554000;0
8803;210968;86;68;28;3;25;.893;3600000;0
8803;222755;86;0;0;0;0;.00nan;0;0
8803;218786;99;0;0;0;0;.00nan;0;0
8804;209796;107;0;0;0;0;.00nan;0;0
8804;210426;107;40;32;5;27;.844;3600000;0
8804;210439;98;58;36;4;32;.889;3600000;0
8804;210503;98;0;0;0;0;.00nan;0;0
8805;210603;104;0;0;0;0;.00nan;0;0
8805;215785;94;54;22;3;19;.864;3660000;0
8805;210930;104;85;58;4;54;.931;3660000;0
8805;-1;94;0;0;0;0;.00nan;0;0
8806;208417;101;0;0;0;0;.00nan;0;0
8806;210923;102;0;0;0;0;.00nan;0;0
8806;216150;101;68;19;1;18;.947;3600000;0
8806;-1;102;64;35;4;31;.886;3600000;0
8807;213659;93;0;0;0;0;.00nan;0;0
8807;215575;100;47;8;2;6;.750;3600000;0
8807;215735;93;51;51;7;44;.863;3600000;0
8807;212368;100;0;0;0;0;.00nan;0;0
8808;210222;90;83;29;1;28;.966;3600000;0
8808;220924;87;0;0;0;0;.00nan;0;0
8808;-1;90;0;0;0;0;.00nan;0;0
8808;-1;87;61;44;5;39;.886;3600000;0
8809;213668;95;0;0;0;0;.00nan;0;0
8809;210271;105;0;0;0;0;.00nan;0;0
8809;210521;105;56;15;1;14;.933;3600000;0
8809;212487;95;98;44;2;42;.955;3596000;0
8810;220831;89;0;0;0;0;.00nan;0;0
8810;210471;89;56;21;3;18;.857;3600000;0
8810;212343;96;65;37;4;33;.892;3578000;0
8810;-1;96;0;0;0;0;.00nan;0;0
8811;215769;97;0;0;0;0;.00nan;0;0
8811;212301;92;64;52;6;46;.885;3178000;0
8811;212354;97;48;24;4;20;.833;3600000;0
8811;-1;92;52;4;0;4;1.000;374000;0
8812;215575;100;77;39;3;36;.923;3821000;0
8812;215785;94;45;24;4;20;.833;3821000;0
8812;212368;100;0;0;0;0;.00nan;0;0
8812;-1;94;0;0;0;0;.00nan;0;0
8813;213659;93;0;0;0;0;.00nan;0;0
8813;210439;98;0;0;0;0;.00nan;0;0
8813;210503;98;57;17;2;15;.882;3727000;0
8813;215735;93;64;28;3;25;.893;3733000;0
8814;210222;90;63;14;1;13;.929;3600000;0
8814;220924;87;70;31;2;29;.935;3568000;0
8814;-1;90;0;0;0;0;.00nan;0;0
8814;-1;87;0;0;0;0;.00nan;0;0
8815;213668;95;0;0;0;0;.00nan;0;0
8815;209796;107;50;26;4;22;.846;3567000;0
8815;210426;107;0;0;0;0;.00nan;0;0
8815;212487;95;81;35;3;32;.914;3600000;0
8816;209784;91;0;0;0;0;.00nan;0;0
8816;205429;91;58;20;2;18;.900;3900000;0
8816;210968;86;95;45;2;43;.956;3900000;0
8816;222755;86;0;0;0;0;.00nan;0;0
8817;210368;106;80;38;3;35;.921;3600000;0
8817;210923;102;46;31;5;26;.839;3515000;0
8817;-1;102;0;0;0;0;.00nan;0;0
8817;-1;106;0;0;0;0;.00nan;0;0
8818;208417;101;67;14;1;13;.929;3600000;0
8818;213659;93;48;38;5;33;.868;3600000;0
8818;215735;93;0;0;0;0;.00nan;0;0
8818;216150;101;0;0;0;0;.00nan;0;0
8819;220831;89;48;25;4;21;.840;3600000;0
8819;210471;89;0;0;0;0;.00nan;0;0
8819;217437;88;95;36;1;35;.972;3600000;0
8819;-1;88;0;0;0;0;.00nan;0;0
8820;220831;89;0;0;0;0;.00nan;0;0
8820;210471;89;51;27;4;23;.852;3600000;0
8820;212301;92;31;8;3;5;.625;589000;0
8820;-1;92;84;40;4;36;.900;3011000;0
8821;213668;95;0;0;0;0;.00nan;0;0
8821;210222;90;37;18;4;14;.778;3600000;0
8821;212487;95;55;36;5;31;.861;3571000;0
8821;-1;90;0;0;0;0;.00nan;0;0
8822;215769;97;0;0;0;0;.00nan;0;0
8822;212343;96;45;30;5;25;.833;3291000;0
8822;212354;97;52;27;4;23;.852;3600000;0
8822;-1;96;50;1;0;1;1.000;265000;0
8823;209784;91;40;15;3;12;.800;3600000;0
8823;209796;107;68;44;5;39;.886;3513000;0
8823;210426;107;0;0;0;0;.00nan;0;0
8823;205429;91;0;0;0;0;.00nan;0;0
8824;213659;93;68;46;4;42;.913;3600000;0
8824;215733;99;0;0;0;0;.00nan;0;0
8824;215735;93;0;0;0;0;.00nan;0;0
8824;218786;99;80;20;1;19;.950;3600000;0
8825;208417;101;57;13;1;12;.923;3600000;0
8825;210368;106;47;41;6;35;.854;3600000;0
8825;216150;101;0;0;0;0;.00nan;0;0
8825;-1;106;0;0;0;0;.00nan;0;0
8826;210603;104;98;38;2;36;.947;3900000;0
8826;210930;104;0;0;0;0;.00nan;0;0
8826;210968;86;0;0;0;0;.00nan;0;0
8826;222755;86;59;23;2;21;.913;3900000;0
8827;215785;94;70;33;3;30;.909;3600000;0
8827;210923;102;33;28;6;22;.786;2782000;0
8827;-1;94;0;0;0;0;.00nan;0;0
8827;-1;102;47;8;1;7;.875;818000;0
8828;210271;105;51;24;3;21;.875;3600000;0
8828;215575;100;29;28;5;23;.821;3528000;0
8828;210521;105;0;0;0;0;.00nan;0;0
8828;212368;100;0;0;0;0;.00nan;0;0
8829;210428;103;91;40;1;39;.975;3600000;0
8829;210439;98;0;0;0;0;.00nan;0;0
8829;210503;98;35;29;5;24;.828;3600000;0
8829;-1;103;0;0;0;0;.00nan;0;0
8830;220924;87;0;0;0;0;.00nan;0;0
8830;217437;88;52;15;2;13;.867;3600000;0
8830;-1;88;0;0;0;0;.00nan;0;0
8830;-1;87;61;29;3;26;.897;3600000;0
8831;209796;107;0;0;0;0;.00nan;0;0
8831;210426;107;64;41;4;37;.902;3524000;0
8831;212301;92;66;21;2;19;.905;3600000;0
8831;-1;92;0;0;0;0;.00nan;0;0
8832;215769;97;64;23;2;21;.913;3600000;0
8832;212343;96;0;0;0;0;.00nan;0;0
8832;212354;97;0;0;0;0;.00nan;0;0
8832;-1;96;60;35;4;31;.886;3560000;0
8833;210428;103;0;0;0;0;.00nan;0;0
8833;210439;98;98;43;2;41;.953;3600000;0
8833;210503;98;0;0;0;0;.00nan;0;0
8833;-1;103;59;29;3;26;.897;3583000;0
8834;210603;104;63;44;5;39;.886;3137000;0
8834;210923;102;0;0;0;0;.00nan;0;0
8834;210930;104;27;8;3;5;.625;463000;0
8834;-1;102;66;21;1;20;.952;3600000;0
8835;215785;94;0;0;0;0;.00nan;0;0
8835;210968;86;67;28;2;26;.929;3660000;0
8835;222755;86;0;0;0;0;.00nan;0;0
8835;-1;94;79;33;3;30;.909;3660000;0
8836;208417;101;0;0;0;0;.00nan;0;0
8836;210271;105;0;0;0;0;.00nan;0;0
8836;210521;105;52;32;4;28;.875;3600000;0
8836;216150;101;77;55;5;50;.909;3560000;0
8837;220924;87;35;28;6;22;.786;3600000;0
8837;217437;88;0;0;0;0;.00nan;0;0
8837;-1;88;68;26;3;23;.885;3600000;0
8837;-1;87;0;0;0;0;.00nan;0;0
8838;210439;98;0;0;0;0;.00nan;0;0
8838;215575;100;51;30;4;26;.867;3794000;0
8838;210503;98;72;44;5;39;.886;3794000;0
8838;212368;100;0;0;0;0;.00nan;0;0
8839;210222;90;58;22;3;19;.864;3600000;0
8839;220831;89;0;0;0;0;.00nan;0;0
8839;210471;89;94;23;0;23;1.000;3600000;0
8839;-1;90;0;0;0;0;.00nan;0;0
8840;213668;95;0;0;0;0;.00nan;0;0
8840;212301;92;0;0;0;0;.00nan;0;0
8840;212487;95;98;43;3;40;.930;3900000;0
8840;-1;92;73;29;3;26;.897;3900000;0
8841;208417;101;28;28;6;22;.786;3334000;0
8841;215733;99;65;37;3;34;.919;3600000;0
8841;216150;101;53;3;0;3;1.000;266000;0
8841;218786;99;0;0;0;0;.00nan;0;0
8842;210428;103;99;49;2;47;.959;3600000;0
8842;210968;86;31;33;6;27;.818;2517000;0
8842;222755;86;61;9;1;8;.889;1083000;0
8842;-1;103;0;0;0;0;.00nan;0;0
8843;210439;98;89;33;2;31;.939;3544000;0
8843;215575;100;0;0;0;0;.00nan;0;0
8843;210503;98;0;0;0;0;.00nan;0;0
8843;212368;100;89;27;1;26;.963;3600000;0
8844;220924;87;0;0;0;0;.00nan;0;0
8844;215769;97;0;0;0;0;.00nan;0;0
8844;212354;97;31;35;6;29;.829;3600000;0
8844;-1;87;64;33;3;30;.909;3600000;0
8845;209796;107;71;38;4;34;.895;3600000;0
8845;210426;107;0;0;0;0;.00nan;0;0
8845;215785;94;67;21;2;19;.905;3600000;0
8845;-1;94;0;0;0;0;.00nan;0;0
8846;208417;101;0;0;0;0;.00nan;0;0
8846;215733;99;0;0;0;0;.00nan;0;0
8846;216150;101;34;41;7;34;.829;3600000;0
8846;218786;99;74;33;2;31;.939;3600000;0
8847;210271;105;57;34;4;30;.882;3591000;0
8847;210521;105;0;0;0;0;.00nan;0;0
8847;210968;86;0;0;0;0;.00nan;0;0
8847;222755;86;49;26;3;23;.885;3600000;0
8848;215769;97;0;0;0;0;.00nan;0;0
8848;212354;97;88;46;2;44;.957;3600000;0
8848;217437;88;68;18;1;17;.944;3600000;0
8848;-1;88;0;0;0;0;.00nan;0;0
8849;210222;90;71;29;2;27;.931;3900000;0
8849;220831;89;0;0;0;0;.00nan;0;0
8849;210471;89;89;40;2;38;.950;3900000;0
8849;-1;90;0;0;0;0;.00nan;0;0
8850;213668;95;0;0;0;0;.00nan;0;0
8850;220924;87;0;0;0;0;.00nan;0;0
8850;212487;95;94;37;2;35;.946;3900000;0
8850;-1;87;68;28;2;26;.929;3900000;0
8851;213659;93;0;0;0;0;.00nan;0;0
8851;215735;93;68;42;4;38;.905;3600000;0
8851;212343;96;88;29;1;28;.966;3600000;0
8851;-1;96;0;0;0;0;.00nan;0;0
8852;210368;106;61;28;4;24;.857;3591000;0
8852;210968;86;59;26;3;23;.885;3600000;0
8852;222755;86;0;0;0;0;.00nan;0;0
8852;-1;106;0;0;0;0;.00nan;0;0
8853;208417;101;76;30;2;28;.933;3600000;0
8853;215733;99;21;32;7;25;.781;3600000;0
8853;216150;101;0;0;0;0;.00nan;0;0
8853;218786;99;0;0;0;0;.00nan;0;0
8854;209796;107;29;16;4;12;.750;753000;0
8854;210426;107;47;23;4;19;.826;2847000;0
8854;215785;94;89;20;0;20;1.000;3600000;0
8854;-1;94;0;0;0;0;.00nan;0;0
8855;210271;105;73;26;1;25;.962;3600000;0
8855;210428;103;46;41;6;35;.854;3600000;0
8855;210521;105;0;0;0;0;.00nan;0;0
8855;-1;103;0;0;0;0;.00nan;0;0
8856;209784;91;0;0;0;0;.00nan;0;0
8856;210439;98;0;0;0;0;.00nan;0;0
8856;210503;98;75;23;1;22;.957;3600000;0
8856;205429;91;70;29;2;27;.931;3600000;0
8857;212301;92;52;28;5;23;.821;3600000;0
8857;217437;88;0;0;0;0;.00nan;0;0
8857;-1;92;0;0;0;0;.00nan;0;0
8857;-1;88;86;35;2;33;.943;3600000;0
8858;213668;95;75;43;4;39;.907;3600000;0
8858;210222;90;0;0;0;0;.00nan;0;0
8858;212487;95;0;0;0;0;.00nan;0;0
8858;-1;90;73;16;1;15;.938;3600000;0
8859;213659;93;56;40;5;35;.875;3521000;0
8859;215735;93;0;0;0;0;.00nan;0;0
8859;212343;96;0;0;0;0;.00nan;0;0
8859;-1;96;52;23;3;20;.870;3600000;0
8860;210271;105;0;0;0;0;.00nan;0;0
8860;210428;103;0;0;0;0;.00nan;0;0
8860;210521;105;55;27;3;24;.889;3583000;0
8860;-1;103;79;35;2;33;.943;3600000;0
8861;209796;107;60;37;5;32;.865;3900000;0
8861;210426;107;0;0;0;0;.00nan;0;0
8861;210603;104;61;37;5;32;.865;3900000;0
8861;210930;104;0;0;0;0;.00nan;0;0
8862;220831;89;89;35;2;33;.943;3900000;0
8862;210471;89;0;0;0;0;.00nan;0;0
8862;215769;97;73;27;2;25;.926;3900000;0
8862;212354;97;0;0;0;0;.00nan;0;0
8863;208417;101;85;38;2;36;.947;3786000;0
8863;209784;91;61;25;3;22;.880;3786000;0
8863;205429;91;0;0;0;0;.00nan;0;0
8863;216150;101;0;0;0;0;.00nan;0;0
8864;215575;100;83;43;4;39;.907;3600000;0
8864;215733;99;59;7;0;7;1.000;1082000;0
8864;212368;100;0;0;0;0;.00nan;0;0
8864;218786;99;10;15;6;9;.600;2506000;0
8865;209796;107;0;0;0;0;.00nan;0;0
8865;210426;107;93;43;2;41;.953;3600000;0
8865;210968;86;42;21;4;17;.810;3527000;0
8865;222755;86;0;0;0;0;.00nan;0;0
8866;210271;105;72;25;1;24;.960;3600000;0
8866;210368;106;95;41;2;39;.951;3600000;0
8866;210521;105;0;0;0;0;.00nan;0;0
8866;-1;106;0;0;0;0;.00nan;0;0
8867;210603;104;0;0;0;0;.00nan;0;0
8867;210923;102;57;16;2;14;.875;3600000;0
8867;210930;104;81;39;3;36;.923;3563000;0
8867;-1;102;0;0;0;0;.00nan;0;0
8868;209796;107;62;44;4;40;.909;3600000;0
8868;210222;90;54;15;2;13;.867;3600000;0
8868;210426;107;0;0;0;0;.00nan;0;0
8868;-1;90;0;0;0;0;.00nan;0;0
8869;209784;91;0;0;0;0;.00nan;0;0
8869;215575;100;78;49;5;44;.898;3856000;0
8869;205429;91;56;29;4;25;.862;3856000;0
8869;212368;100;0;0;0;0;.00nan;0;0
8870;210428;103;2;25;8;17;.680;3600000;0
8870;215785;94;83;29;1;28;.966;3600000;0
8870;-1;94;0;0;0;0;.00nan;0;0
8870;-1;103;0;0;0;0;.00nan;0;0
8871;210222;90;0;0;0;0;.00nan;0;0
8871;210271;105;82;37;2;35;.946;3900000;0
8871;210521;105;0;0;0;0;.00nan;0;0
8871;-1;90;66;24;2;22;.917;3900000;0
8872;220924;87;99;40;2;38;.950;3600000;0
8872;212301;92;0;0;0;0;.00nan;0;0
8872;-1;92;34;18;4;14;.778;3600000;0
8872;-1;87;0;0;0;0;.00nan;0;0
8873;215769;97;0;0;0;0;.00nan;0;0
8873;212354;97;84;32;1;31;.969;3600000;0
8873;217437;88;81;33;2;31;.939;3544000;0
8873;-1;88;0;0;0;0;.00nan;0;0
8874;209784;91;77;31;2;29;.935;3600000;0
8874;205429;91;0;0;0;0;.00nan;0;0
8874;210923;102;72;38;4;34;.895;3592000;0
8874;-1;102;0;0;0;0;.00nan;0;0
8875;210368;106;56;30;4;26;.867;3600000;0
8875;210439;98;54;37;5;32;.865;3576000;0
8875;210503;98;0;0;0;0;.00nan;0;0
8875;-1;106;0;0;0;0;.00nan;0;0
8876;210428;103;0;0;0;0;.00nan;0;0
8876;215575;100;0;0;0;0;.00nan;0;0
8876;212368;100;57;32;5;27;.844;3590000;0
8876;-1;103;74;37;3;34;.919;3600000;0
8877;208417;101;45;32;5;27;.844;3512000;0
8877;210603;104;73;33;3;30;.909;3600000;0
8877;210930;104;0;0;0;0;.00nan;0;0
8877;216150;101;0;0;0;0;.00nan;0;0
8878;213668;95;0;0;0;0;.00nan;0;0
8878;220831;89;0;0;0;0;.00nan;0;0
8878;210471;89;85;20;1;19;.950;3600000;0
8878;212487;95;62;50;6;44;.880;3600000;0
8879;213659;93;0;0;0;0;.00nan;0;0
8879;215735;93;93;41;2;39;.951;3560000;0
8879;217437;88;89;13;0;13;1.000;3600000;0
8879;-1;88;0;0;0;0;.00nan;0;0
8880;220924;87;0;0;0;0;.00nan;0;0
8880;215769;97;0;0;0;0;.00nan;0;0
8880;212354;97;62;16;1;15;.938;3600000;0
8880;-1;87;93;38;2;36;.947;3556000;0
8881;208417;101;65;34;3;31;.912;3600000;0
8881;210923;102;56;34;4;30;.882;3565000;0
8881;216150;101;0;0;0;0;.00nan;0;0
8881;-1;102;0;0;0;0;.00nan;0;0
8882;209784;91;0;0;0;0;.00nan;0;0
8882;205429;91;98;42;1;41;.976;3556000;0
8882;215733;99;0;0;0;0;.00nan;0;0
8882;218786;99;96;19;0;19;1.000;3600000;0
8883;209796;107;0;0;0;0;.00nan;0;0
8883;210426;107;64;39;4;35;.897;3600000;0
8883;210603;104;32;23;5;18;.783;3600000;0
8883;210930;104;0;0;0;0;.00nan;0;0
8884;210222;90;69;17;1;16;.941;3600000;0
8884;210428;103;75;51;5;46;.902;3600000;0
8884;-1;90;0;0;0;0;.00nan;0;0
8884;-1;103;0;0;0;0;.00nan;0;0
8885;210439;98;0;0;0;0;.00nan;0;0
8885;210503;98;99;35;1;34;.971;3600000;0
8885;215785;94;64;25;2;23;.920;3545000;0
8885;-1;94;0;0;0;0;.00nan;0;0
8886;210271;105;0;0;0;0;.00nan;0;0
8886;210368;106;80;37;3;34;.919;3900000;0
8886;210521;105;71;38;3;35;.921;3900000;0
8886;-1;106;0;0;0;0;.00nan;0;0
8887;220831;89;36;28;5;23;.821;3600000;0
8887;210471;89;0;0;0;0;.00nan;0;0
8887;210968;86;46;43;6;37;.860;3600000;0
8887;222755;86;0;0;0;0;.00nan;0;0
8888;215769;97;82;66;7;59;.894;3600000;0
8888;212343;96;57;24;3;21;.875;3600000;0
8888;212354;97;0;0;0;0;.00nan;0;0
8888;-1;96;0;0;0;0;.00nan;0;0
8889;210271;105;39;48;8;40;.833;3600000;0
8889;210521;105;0;0;0;0;.00nan;0;0
8889;210923;102;0;0;0;0;.00nan;0;0
8889;-1;102;41;24;5;19;.792;3600000;0
8890;212301;92;79;35;2;33;.943;3600000;0
8890;217437;88;60;35;5;30;.857;3600000;0
8890;-1;92;0;0;0;0;.00nan;0;0
8890;-1;88;0;0;0;0;.00nan;0;0
8891;210222;90;0;0;0;0;.00nan;0;0
8891;210368;106;0;0;0;0;.00nan;0;0
8891;-1;90;68;23;2;21;.913;3600000;0
8891;-1;106;64;33;3;30;.909;3588000;0
8892;213659;93;72;31;2;29;.935;3515000;0
8892;220924;87;100;25;0;25;1.000;3600000;0
8892;215735;93;0;0;0;0;.00nan;0;0
8892;-1;87;0;0;0;0;.00nan;0;0
8893;210439;98;55;32;4;28;.875;3162000;0
8893;210503;98;42;3;1;2;.667;394000;0
8893;210603;104;0;0;0;0;.00nan;0;0
8893;210930;104;68;28;3;25;.893;3600000;0
8894;208417;101;33;19;4;15;.789;1750000;0
8894;215785;94;0;0;0;0;.00nan;0;0
8894;216150;101;32;25;5;20;.800;1850000;0
8894;-1;94;55;21;3;18;.857;3600000;0
8895;210428;103;0;0;0;0;.00nan;0;0
8895;215575;100;57;28;3;25;.893;3600000;0
8895;212368;100;0;0;0;0;.00nan;0;0
8895;-1;103;57;32;4;28;.875;3568000;0
8896;210968;86;0;0;0;0;.00nan;0;0
8896;217437;88;0;0;0;0;.00nan;0;0
8896;222755;86;54;28;3;25;.893;3600000;0
8896;-1;88;49;32;4;28;.875;3569000;0
8897;210368;106;67;28;3;25;.893;3600000;0
8897;210603;104;54;32;5;27;.844;3523000;0
8897;210930;104;0;0;0;0;.00nan;0;0
8897;-1;106;0;0;0;0;.00nan;0;0
8898;210271;105;0;0;0;0;.00nan;0;0
8898;210521;105;81;31;2;29;.935;3588000;0
8898;215733;99;0;0;0;0;.00nan;0;0
8898;218786;99;99;38;1;37;.974;3600000;0
8899;213668;95;0;0;0;0;.00nan;0;0
8899;220831;89;0;0;0;0;.00nan;0;0
8899;210471;89;32;20;4;16;.800;3900000;0
8899;212487;95;87;49;4;45;.918;3900000;0
8900;213659;93;0;0;0;0;.00nan;0;0
8900;215735;93;82;47;3;44;.936;3600000;0
8900;212343;96;37;22;4;18;.818;3597000;0
8900;-1;96;0;0;0;0;.00nan;0;0
8901;210271;105;70;62;6;56;.903;3600000;0
8901;210521;105;0;0;0;0;.00nan;0;0
8901;215733;99;0;0;0;0;.00nan;0;0
8901;218786;99;67;14;1;13;.929;3600000;0
8902;210222;90;85;34;1;33;.971;3600000;0
8902;215785;94;26;19;5;14;.737;3600000;0
8902;-1;90;0;0;0;0;.00nan;0;0
8902;-1;94;0;0;0;0;.00nan;0;0
8903;210439;98;0;0;0;0;.00nan;0;0
8903;210503;98;69;42;4;38;.905;3565000;0
8903;210923;102;47;19;3;16;.842;3600000;0
8903;-1;102;0;0;0;0;.00nan;0;0
8904;213668;95;73;43;4;39;.907;3600000;0
8904;212301;92;0;0;0;0;.00nan;0;0
8904;212487;95;0;0;0;0;.00nan;0;0
8904;-1;92;98;21;0;21;1.000;3600000;0
8905;209784;91;100;33;0;33;1.000;3600000;0
8905;205429;91;0;0;0;0;.00nan;0;0
8905;212343;96;0;0;0;0;.00nan;0;0
8905;-1;96;67;25;2;23;.920;3518000;0
8906;209796;107;58;6;0;6;1.000;401000;0
8906;210426;107;37;40;7;33;.825;3199000;0
8906;215575;100;63;20;2;18;.900;3600000;0
8906;212368;100;0;0;0;0;.00nan;0;0
8907;210222;90;0;0;0;0;.00nan;0;0
8907;210603;104;0;0;0;0;.00nan;0;0
8907;210930;104;86;46;3;43;.935;3520000;0
8907;-1;90;84;25;1;24;.960;3600000;0
8908;210439;98;100;47;2;45;.957;3900000;0
8908;210503;98;0;0;0;0;.00nan;0;0
8908;210923;102;0;0;0;0;.00nan;0;0
8908;-1;102;59;20;2;18;.900;3900000;0
8909;220924;87;28;9;3;6;.667;453000;0
8909;217437;88;62;26;3;23;.885;3600000;0
8909;-1;88;0;0;0;0;.00nan;0;0
8909;-1;87;75;33;3;30;.909;3147000;0
8910;213668;95;0;0;0;0;.00nan;0;0
8910;210968;86;48;19;3;16;.842;3600000;0
8910;212487;95;91;55;4;51;.927;3600000;0
8910;222755;86;0;0;0;0;.00nan;0;0
8911;209784;91;0;0;0;0;.00nan;0;0
8911;210222;90;51;34;5;29;.853;3600000;0
8911;205429;91;65;30;3;27;.900;3600000;0
8911;-1;90;0;0;0;0;.00nan;0;0
8912;212301;92;0;0;0;0;.00nan;0;0
8912;212343;96;55;30;4;26;.867;3600000;0
8912;-1;92;25;23;6;17;.739;3589000;0
8912;-1;96;0;0;0;0;.00nan;0;0
8913;213659;93;0;0;0;0;.00nan;0;0
8913;220831;89;0;0;0;0;.00nan;0;0
8913;210471;89;85;26;1;25;.962;3600000;0
8913;215735;93;40;38;6;32;.842;3600000;0
8914;210271;105;77;38;3;35;.921;3600000;0
8914;210521;105;0;0;0;0;.00nan;0;0
8914;215769;97;0;0;0;0;.00nan;0;0
8914;212354;97;42;31;5;26;.839;3570000;0
8915;210439;98;0;0;0;0;.00nan;0;0
8915;210503;98;58;19;2;17;.895;3600000;0
8915;210923;102;71;19;1;18;.947;3600000;0
8915;-1;102;0;0;0;0;.00nan;0;0
8916;209796;107;82;41;3;38;.927;3600000;0
8916;210368;106;35;18;4;14;.778;3600000;0
8916;210426;107;0;0;0;0;.00nan;0;0
8916;-1;106;0;0;0;0;.00nan;0;0
8917;208417;101;75;24;2;22;.917;3900000;0
8917;215575;100;76;31;2;29;.935;3900000;0
8917;216150;101;0;0;0;0;.00nan;0;0
8917;212368;100;0;0;0;0;.00nan;0;0
8918;215733;99;53;13;1;12;.923;1496000;0
8918;215785;94;94;20;0;20;1.000;3600000;0
8918;218786;99;22;23;6;17;.739;2104000;0
8918;-1;94;0;0;0;0;.00nan;0;0
8919;213668;95;73;45;4;41;.911;3527000;0
8919;220924;87;72;27;2;25;.926;3600000;0
8919;212487;95;0;0;0;0;.00nan;0;0
8919;-1;87;0;0;0;0;.00nan;0;0
8920;210968;86;74;25;1;24;.960;3600000;0
8920;212301;92;72;26;2;24;.923;3545000;0
8920;222755;86;0;0;0;0;.00nan;0;0
8920;-1;92;0;0;0;0;.00nan;0;0
8921;209796;107;40;3;1;2;.667;670000;0
8921;210368;106;0;0;0;0;.00nan;0;0
8921;210426;107;29;31;7;24;.774;2930000;0
8921;-1;106;72;20;1;19;.950;3600000;0
8922;213659;93;54;41;5;36;.878;3600000;0
8922;210271;105;0;0;0;0;.00nan;0;0
8922;210521;105;70;22;2;20;.909;3600000;0
8922;215735;93;0;0;0;0;.00nan;0;0
8923;210428;103;63;30;3;27;.900;3677000;0
8923;215575;100;0;0;0;0;.00nan;0;0
8923;212368;100;83;41;4;37;.902;3677000;0
8923;-1;103;0;0;0;0;.00nan;0;0
8924;215733;99;0;0;0;0;.00nan;0;0
8924;210603;104;0;0;0;0;.00nan;0;0
8924;210930;104;76;32;2;30;.938;3600000;0
8924;218786;99;60;25;3;22;.880;3580000;0
8925;208417;101;0;0;0;0;.00nan;0;0
8925;215785;94;64;31;3;28;.903;3537000;0
8925;216150;101;78;29;2;27;.931;3600000;0
8925;-1;94;0;0;0;0;.00nan;0;0
8926;210439;98;32;34;6;28;.824;3163000;0
8926;210503;98;49;1;0;1;1.000;437000;0
8926;210923;102;74;20;1;19;.950;3600000;0
8926;-1;102;0;0;0;0;.00nan;0;0
8927;210968;86;60;22;2;20;.909;3600000;0
8927;212343;96;75;45;4;41;.911;3565000;0
8927;222755;86;0;0;0;0;.00nan;0;0
8927;-1;96;0;0;0;0;.00nan;0;0
8928;220831;89;0;0;0;0;.00nan;0;0
8928;210471;89;91;29;1;28;.966;3600000;0
8928;215769;97;0;0;0;0;.00nan;0;0
8928;212354;97;73;33;2;31;.939;3582000;0
8929;209796;107;51;45;6;39;.867;3061000;0
8929;210426;107;42;4;1;3;.750;539000;0
8929;215785;94;65;15;1;14;.933;3600000;0
8929;-1;94;0;0;0;0;.00nan;0;0
8930;210368;106;23;31;7;24;.774;2307000;0
8930;215733;99;58;21;3;18;.857;3600000;0
8930;218786;99;0;0;0;0;.00nan;0;0
8930;-1;106;44;15;3;12;.800;1293000;0
8931;208417;101;75;22;1;21;.955;3600000;0
8931;210603;104;58;34;4;30;.882;3600000;0
8931;210930;104;0;0;0;0;.00nan;0;0
8931;216150;101;0;0;0;0;.00nan;0;0
8932;213659;93;0;0;0;0;.00nan;0;0
8932;215735;93;61;42;6;36;.857;3600000;0
8932;217437;88;68;21;1;20;.952;3600000;0
8932;-1;88;0;0;0;0;.00nan;0;0
8933;210428;103;79;22;1;21;.955;3600000;0
8933;210439;98;66;38;4;34;.895;2961000;0
8933;210503;98;21;9;4;5;.556;639000;0
8933;-1;103;0;0;0;0;.00nan;0;0
8934;213659;93;66;45;5;40;.889;3600000;0
8934;220831;89;55;14;2;12;.857;3600000;0
8934;210471;89;0;0;0;0;.00nan;0;0
8934;215735;93;0;0;0;0;.00nan;0;0
8935;213668;95;0;0;0;0;.00nan;0;0
8935;212343;96;92;13;0;13;1.000;3665000;0
8935;212487;95;92;51;1;50;.980;3665000;0
8935;-1;96;0;0;0;0;.00nan;0;0
8936;220831;89;0;0;0;0;.00nan;0;0
8936;210471;89;100;34;0;34;1.000;3900000;0
8936;217437;88;97;35;0;35;1.000;3900000;0
8936;-1;88;0;0;0;0;.00nan;0;0
8937;210968;86;71;28;2;26;.929;3564000;0
8937;212343;96;82;27;1;26;.963;3600000;0
8937;222755;86;0;0;0;0;.00nan;0;0
8937;-1;96;0;0;0;0;.00nan;0;0
8938;220924;87;50;37;5;32;.865;3600000;0
8938;210923;102;70;29;3;26;.897;3600000;0
8938;-1;87;0;0;0;0;.00nan;0;0
8938;-1;102;0;0;0;0;.00nan;0;0
8939;213659;93;0;0;0;0;.00nan;0;0
8939;210222;90;100;19;0;19;1.000;3600000;0
8939;215735;93;83;64;6;58;.906;3600000;0
8939;-1;90;0;0;0;0;.00nan;0;0
8940;213668;95;48;0;0;0;.00nan;311000;0
8940;209784;91;0;0;0;0;.00nan;0;0
8940;205429;91;70;22;1;21;.955;3600000;0
8940;212487;95;51;45;6;39;.867;3289000;0
8941;215769;97;0;0;0;0;.00nan;0;0
8941;212301;92;0;0;0;0;.00nan;0;0
8941;212354;97;73;34;3;31;.912;3630000;0
8941;-1;92;73;39;4;35;.897;3630000;0
8942;210368;106;80;38;3;35;.921;3600000;0
8942;210603;104;57;27;4;23;.852;3566000;0
8942;210930;104;0;0;0;0;.00nan;0;0
8942;-1;106;0;0;0;0;.00nan;0;0
8943;210439;98;64;37;4;33;.892;3600000;0
8943;210503;98;0;0;0;0;.00nan;0;0
8943;215733;99;0;0;0;0;.00nan;0;0
8943;218786;99;43;19;3;16;.842;3600000;0
8944;210428;103;77;26;1;25;.962;3741000;0
8944;215785;94;85;34;2;32;.941;3741000;0
8944;-1;94;0;0;0;0;.00nan;0;0
8944;-1;103;0;0;0;0;.00nan;0;0
8945;208417;101;60;25;2;23;.920;3600000;0
8945;210271;105;26;6;3;3;.500;572000;0
8945;210521;105;49;30;5;25;.833;3028000;0
8945;216150;101;0;0;0;0;.00nan;0;0
8946;210923;102;0;0;0;0;.00nan;0;0
8946;217437;88;78;40;4;36;.900;3670000;0
8946;-1;88;0;0;0;0;.00nan;0;0
8946;-1;102;43;17;3;14;.824;3670000;0
8947;210222;90;77;36;3;33;.917;3600000;0
8947;220831;89;0;0;0;0;.00nan;0;0
8947;210471;89;42;31;5;26;.839;3558000;0
8947;-1;90;0;0;0;0;.00nan;0;0
8948;213659;93;88;46;3;43;.935;3600000;0
8948;215735;93;0;0;0;0;.00nan;0;0
8948;210968;86;0;0;0;0;.00nan;0;0
8948;222755;86;22;27;6;21;.778;3600000;0
8949;215575;100;95;31;1;30;.968;3600000;0
8949;220924;87;0;0;0;0;.00nan;0;0
8949;212368;100;0;0;0;0;.00nan;0;0
8949;-1;87;73;40;4;36;.900;3600000;0
8950;213668;95;66;44;5;39;.886;3600000;0
8950;209784;91;80;27;1;26;.963;3600000;0
8950;205429;91;0;0;0;0;.00nan;0;0
8950;212487;95;0;0;0;0;.00nan;0;0
8951;210368;106;0;0;0;0;.00nan;0;0
8951;210428;103;57;29;3;26;.897;3585000;0
8951;222835;103;0;0;0;0;.00nan;0;0
8951;-1;106;91;34;1;33;.971;3600000;0
8952;210439;98;55;18;2;16;.889;2400000;0
8952;210503;98;53;26;4;22;.846;1200000;0
8952;215733;99;63;13;1;12;.923;3600000;0
8952;218786;99;0;0;0;0;.00nan;0;0
8953;215769;97;89;33;1;32;.970;3600000;0
8953;212301;92;35;35;6;29;.829;3600000;0
8953;212354;97;0;0;0;0;.00nan;0;0
8953;-1;92;0;0;0;0;.00nan;0;0
8954;209796;107;78;47;4;43;.915;3594000;0
8954;210426;107;0;0;0;0;.00nan;0;0
8954;215785;94;0;0;0;0;.00nan;0;0
8954;-1;94;48;10;2;8;.800;3600000;0
8955;208417;101;0;0;0;0;.00nan;0;0
8955;210271;105;76;48;5;43;.896;3552000;0
8955;210521;105;0;0;0;0;.00nan;0;0
8955;216150;101;50;17;3;14;.824;3600000;0
8956;210222;90;0;0;0;0;.00nan;0;0
8956;212343;96;89;30;1;29;.967;3600000;0
8956;-1;90;63;31;3;28;.903;3562000;0
8956;-1;96;0;0;0;0;.00nan;0;0
8957;210271;105;0;0;0;0;.00nan;0;0
8957;210368;106;54;26;3;23;.885;3541000;0
8957;210521;105;76;19;1;18;.947;3600000;0
8957;-1;106;0;0;0;0;.00nan;0;0
8958;209796;107;0;0;0;0;.00nan;0;0
8958;210426;107;93;48;2;46;.958;3707000;0
8958;210603;104;0;0;0;0;.00nan;0;0
8958;210930;104;63;22;3;19;.864;3707000;0
8959;220831;89;0;0;0;0;.00nan;0;0
8959;215575;100;32;34;6;28;.824;3600000;0
8959;210471;89;44;17;3;14;.824;3600000;0
8959;212368;100;0;0;0;0;.00nan;0;0
8960;210923;102;25;26;6;20;.769;2333000;0
8960;210968;86;46;30;5;25;.833;3600000;0
8960;222755;86;0;0;0;0;.00nan;0;0
8960;-1;102;65;16;1;15;.938;1265000;0
8961;215575;100;52;3;0;3;1.000;674000;0
8961;212368;100;42;34;6;28;.824;2926000;0
8961;217437;88;80;12;0;12;1.000;3600000;0
8961;-1;88;0;0;0;0;.00nan;0;0
8962;210222;90;100;28;0;28;1.000;3600000;0
8962;210923;102;29;31;7;24;.774;3600000;0
8962;-1;90;0;0;0;0;.00nan;0;0
8962;-1;102;0;0;0;0;.00nan;0;0
8963;213659;93;0;0;0;0;.00nan;0;0
8963;215735;93;48;32;4;28;.875;3600000;0
8963;212343;96;68;17;1;16;.941;3600000;0
8963;-1;96;0;0;0;0;.00nan;0;0
8964;209784;91;9;25;7;18;.720;1929000;0
8964;205429;91;40;20;4;16;.800;1671000;0
8964;212301;92;0;0;0;0;.00nan;0;0
8964;-1;92;64;22;2;20;.909;3600000;0
8965;209796;107;88;32;2;30;.938;3600000;0
8965;210368;106;39;32;6;26;.813;3600000;0
8965;210426;107;0;0;0;0;.00nan;0;0
8965;-1;106;0;0;0;0;.00nan;0;0
8966;210428;103;34;10;3;7;.700;3600000;0
8966;210603;104;0;0;0;0;.00nan;0;0
8966;210930;104;45;33;5;28;.848;3590000;0
8966;222835;103;0;0;0;0;.00nan;0;0
8967;210271;105;77;31;2;29;.935;3627000;0
8967;210521;105;0;0;0;0;.00nan;0;0
8967;215733;99;0;0;0;0;.00nan;0;0
8967;218786;99;76;36;3;33;.917;3627000;0
8968;213659;93;75;40;3;37;.925;3600000;0
8968;213668;95;0;0;0;0;.00nan;0;0
8968;215735;93;0;0;0;0;.00nan;0;0
8968;212487;95;65;26;2;24;.923;3600000;0
8969;220831;89;0;0;0;0;.00nan;0;0
8969;210471;89;64;29;2;27;.931;3558000;0
8969;210923;102;76;21;1;20;.952;3600000;0
8969;-1;102;0;0;0;0;.00nan;0;0
8970;215575;100;96;35;1;34;.971;3900000;0
8970;210968;86;98;37;1;36;.973;3900000;0
8970;212368;100;0;0;0;0;.00nan;0;0
8970;222755;86;0;0;0;0;.00nan;0;0
8971;212301;92;87;43;2;41;.953;3600000;0
8971;212343;96;77;37;4;33;.892;3578000;0
8971;-1;92;0;0;0;0;.00nan;0;0
8971;-1;96;0;0;0;0;.00nan;0;0
8972;209784;91;0;0;0;0;.00nan;0;0
8972;220924;87;0;0;0;0;.00nan;0;0
8972;205429;91;82;30;2;28;.933;3600000;0
8972;-1;87;69;30;3;27;.900;3545000;0
8973;213668;95;60;37;4;33;.892;3900000;0
8973;215769;97;0;0;0;0;.00nan;0;0
8973;212354;97;49;26;4;22;.846;3900000;0
8973;212487;95;0;0;0;0;.00nan;0;0
8974;209796;107;30;15;4;11;.733;1164000;0
8974;210426;107;49;26;4;22;.846;2436000;0
8974;215733;99;0;0;0;0;.00nan;0;0
8974;218786;99;73;18;1;17;.944;3600000;0
8975;208417;101;70;22;1;21;.955;3600000;0
8975;210428;103;77;33;3;30;.909;3530000;0
8975;216150;101;0;0;0;0;.00nan;0;0
8975;222835;103;0;0;0;0;.00nan;0;0
8976;210368;106;90;42;2;40;.952;3600000;0
8976;210603;104;53;20;3;17;.850;3588000;0
8976;210930;104;0;0;0;0;.00nan;0;0
8976;-1;106;0;0;0;0;.00nan;0;0
8977;210439;98;99;39;1;38;.974;3600000;0
8977;210503;98;0;0;0;0;.00nan;0;0
8977;215785;94;82;36;3;33;.917;3514000;0
8977;-1;94;0;0;0;0;.00nan;0;0
8978;220831;89;0;0;0;0;.00nan;0;0
8978;210471;89;78;31;1;30;.968;3600000;0
8978;217437;88;60;26;4;22;.846;3600000;0
8978;-1;88;0;0;0;0;.00nan;0;0
8979;210222;90;55;23;3;20;.870;3900000;0
8979;215575;100;0;0;0;0;.00nan;0;0
8979;212368;100;65;28;3;25;.893;3900000;0
8979;-1;90;0;0;0;0;.00nan;0;0
8980;209784;91;20;24;6;18;.750;1837000;0
8980;205429;91;67;13;0;13;1.000;1733000;0
8980;212301;92;0;0;0;0;.00nan;0;0
8980;-1;92;60;35;4;31;.886;3600000;0
8981;210368;106;0;0;0;0;.00nan;0;0
8981;210603;104;0;0;0;0;.00nan;0;0
8981;210930;104;75;28;2;26;.929;3600000;0
8981;-1;106;49;24;4;20;.833;3571000;0
8982;213659;93;0;0;0;0;.00nan;0;0
8982;220924;87;68;28;2;26;.929;3900000;0
8982;215735;93;58;25;2;23;.920;3900000;0
8982;-1;87;0;0;0;0;.00nan;0;0
8983;210271;105;62;32;4;28;.875;3583000;0
8983;210428;103;0;0;0;0;.00nan;0;0
8983;210521;105;0;0;0;0;.00nan;0;0
8983;222835;103;59;27;3;24;.889;3600000;0
8984;210439;98;0;0;0;0;.00nan;0;0
8984;210503;98;48;35;5;30;.857;3528000;0
8984;215785;94;74;29;3;26;.897;3600000;0
8984;-1;94;0;0;0;0;.00nan;0;0
8985;208417;101;0;0;0;0;.00nan;0;0
8985;215733;99;85;34;2;32;.941;3900000;0
8985;216150;101;85;35;2;33;.943;3900000;0
8985;218786;99;0;0;0;0;.00nan;0;0
8986;213668;95;0;0;0;0;.00nan;0;0
8986;212343;96;100;33;0;33;1.000;3600000;0
8986;212487;95;59;43;5;38;.884;3600000;0
8986;-1;96;0;0;0;0;.00nan;0;0
8987;220924;87;0;0;0;0;.00nan;0;0
8987;215769;97;51;20;2;18;.900;3600000;0
8987;212354;97;0;0;0;0;.00nan;0;0
8987;-1;87;66;40;4;36;.900;3564000;0
8988;209796;107;0;0;0;0;.00nan;0;0
8988;210271;105;0;0;0;0;.00nan;0;0
8988;210426;107;81;41;3;38;.927;3867000;0
8988;210521;105;64;26;2;24;.923;3867000;0
8989;208417;101;73;20;1;19;.950;3600000;0
8989;210428;103;73;41;4;37;.902;3600000;0
8989;216150;101;0;0;0;0;.00nan;0;0
8989;222835;103;0;0;0;0;.00nan;0;0
8990;220924;87;75;48;4;44;.917;3600000;0
8990;217437;88;81;24;1;23;.958;3600000;0
8990;-1;88;0;0;0;0;.00nan;0;0
8990;-1;87;0;0;0;0;.00nan;0;0
8991;210222;90;84;36;2;34;.944;3600000;0
8991;210968;86;63;29;3;26;.897;3564000;0
8991;222755;86;0;0;0;0;.00nan;0;0
8991;-1;90;0;0;0;0;.00nan;0;0
8992;213668;95;0;0;0;0;.00nan;0;0
8992;209784;91;59;22;2;20;.909;2910000;0
8992;205429;91;25;6;3;3;.500;601000;0
8992;212487;95;63;28;3;25;.893;3600000;0
8993;213659;93;53;2;0;2;1.000;269000;0
8993;215735;93;34;33;6;27;.818;3286000;0
8993;212301;92;42;32;5;27;.844;3600000;0
8993;-1;92;0;0;0;0;.00nan;0;0
8994;215498;102;0;0;0;0;.00nan;0;0
8994;215575;100;22;24;6;18;.750;3164000;0
8994;212368;100;55;5;0;5;1.000;436000;0
8994;-1;102;44;31;5;26;.839;3600000;0
8995;215733;99;0;0;0;0;.00nan;0;0
8995;215769;97;0;0;0;0;.00nan;0;0
8995;212354;97;70;34;3;31;.912;3554000;0
8995;218786;99;81;28;1;27;.964;3600000;0
8996;208417;101;83;46;3;43;.935;3568000;0
8996;210439;98;57;19;2;17;.895;3600000;0
8996;210503;98;0;0;0;0;.00nan;0;0
8996;216150;101;0;0;0;0;.00nan;0;0
8997;209796;107;54;38;5;33;.868;3559000;0
8997;210426;107;0;0;0;0;.00nan;0;0
8997;210603;104;66;23;3;20;.870;3600000;0
8997;210930;104;0;0;0;0;.00nan;0;0
8998;210368;106;68;35;3;32;.914;3600000;0
8998;215785;94;52;14;2;12;.857;3600000;0
8998;-1;94;0;0;0;0;.00nan;0;0
8998;-1;106;0;0;0;0;.00nan;0;0
8999;209796;107;0;0;0;0;.00nan;0;0
8999;210426;107;100;43;1;42;.977;3600000;0
8999;210439;98;0;0;0;0;.00nan;0;0
8999;210503;98;66;25;2;23;.920;3545000;0
9000;210368;106;0;0;0;0;.00nan;0;0
9000;222835;103;0;0;0;0;.00nan;0;0
9000;-1;103;80;23;2;21;.913;3600000;0
9000;-1;106;67;50;5;45;.900;3600000;0
9001;215733;99;79;21;1;20;.952;3600000;0
9001;212343;96;71;36;3;33;.917;3560000;0
9001;218786;99;0;0;0;0;.00nan;0;0
9001;-1;96;0;0;0;0;.00nan;0;0
9002;210222;90;54;30;4;26;.867;3600000;0
9002;217437;88;81;28;2;26;.929;3600000;0
9002;-1;90;0;0;0;0;.00nan;0;0
9002;-1;88;0;0;0;0;.00nan;0;0
9003;220831;89;69;29;3;26;.897;3600000;0
9003;210471;89;0;0;0;0;.00nan;0;0
9003;220924;87;41;30;5;25;.833;3600000;0
9003;-1;87;0;0;0;0;.00nan;0;0
9004;213659;93;53;40;5;35;.875;3900000;0
9004;209784;91;53;30;5;25;.833;3900000;0
9004;205429;91;0;0;0;0;.00nan;0;0
9004;215735;93;0;0;0;0;.00nan;0;0
9005;213668;95;55;10;1;9;.900;1641000;0
9005;212301;92;47;30;5;25;.833;3600000;0
9005;212487;95;10;19;6;13;.684;1934000;0
9005;-1;92;0;0;0;0;.00nan;0;0
9006;208417;101;87;37;2;35;.946;3900000;0
9006;215769;97;0;0;0;0;.00nan;0;0
9006;216150;101;0;0;0;0;.00nan;0;0
9006;212354;97;56;17;2;15;.882;3900000;0
9007;215498;102;46;27;4;23;.852;3568000;0
9007;215575;100;0;0;0;0;.00nan;0;0
9007;212368;100;59;24;3;21;.875;3600000;0
9007;-1;102;0;0;0;0;.00nan;0;0
9008;220831;89;0;0;0;0;.00nan;0;0
9008;210471;89;78;45;4;41;.911;3600000;0
9008;210968;86;50;18;3;15;.833;3600000;0
9008;222755;86;0;0;0;0;.00nan;0;0
9009;220924;87;73;30;2;28;.933;3164000;0
9009;217437;88;75;24;1;23;.958;3600000;0
9009;-1;88;0;0;0;0;.00nan;0;0
9009;-1;87;23;5;3;2;.400;436000;0
9010;213659;93;0;0;0;0;.00nan;0;0
9010;213668;95;21;11;4;7;.636;1062000;0
9010;215735;93;66;36;4;32;.889;3600000;0
9010;212487;95;59;21;2;19;.905;2512000;0
9011;215498;102;69;32;3;29;.906;3600000;0
9011;215733;99;59;8;0;8;1.000;1722000;0
9011;218786;99;16;20;6;14;.700;1878000;0
9011;-1;102;0;0;0;0;.00nan;0;0
9012;209784;91;0;0;0;0;.00nan;0;0
9012;205429;91;69;30;2;28;.933;3600000;0
9012;212301;92;0;0;0;0;.00nan;0;0
9012;-1;92;59;41;5;36;.878;3600000;0
9013;210271;105;42;37;5;32;.865;3600000;0
9013;210521;105;0;0;0;0;.00nan;0;0
9013;222835;103;87;26;1;25;.962;3600000;0
9013;-1;103;0;0;0;0;.00nan;0;0
9014;210603;104;0;0;0;0;.00nan;0;0
9014;215785;94;54;39;6;33;.846;3552000;0
9014;210930;104;39;33;5;28;.848;3600000;0
9014;-1;94;0;0;0;0;.00nan;0;0
9015;210439;98;29;32;6;26;.813;3571000;0
9015;210503;98;0;0;0;0;.00nan;0;0
9015;215769;97;52;29;4;25;.862;3600000;0
9015;212354;97;0;0;0;0;.00nan;0;0
9016;215575;100;82;34;3;31;.912;3600000;0
9016;212343;96;41;37;6;31;.838;3249000;0
9016;212368;100;0;0;0;0;.00nan;0;0
9016;-1;96;44;3;1;2;.667;351000;0
9017;209796;107;0;0;0;0;.00nan;0;0
9017;210426;107;64;27;2;25;.926;3900000;0
9017;222835;103;0;0;0;0;.00nan;0;0
9017;-1;103;73;30;2;28;.933;3900000;0
9018;208417;101;64;17;1;16;.941;3600000;0
9018;210368;106;94;44;2;42;.955;3573000;0
9018;216150;101;0;0;0;0;.00nan;0;0
9018;-1;106;0;0;0;0;.00nan;0;0
9019;210603;104;69;49;5;44;.898;3600000;0
9019;215785;94;52;13;2;11;.846;3600000;0
9019;210930;104;0;0;0;0;.00nan;0;0
9019;-1;94;0;0;0;0;.00nan;0;0
9020;220831;89;0;0;0;0;.00nan;0;0
9020;210471;89;53;19;3;16;.842;3600000;0
9020;220924;87;0;0;0;0;.00nan;0;0
9020;-1;87;50;31;5;26;.839;3515000;0
9021;210222;90;75;27;2;25;.926;3600000;0
9021;217437;88;38;19;4;15;.789;1918000;0
9021;-1;90;0;0;0;0;.00nan;0;0
9021;-1;88;36;14;3;11;.786;1682000;0
9022;210439;98;48;31;4;27;.871;3595000;0
9022;210503;98;0;0;0;0;.00nan;0;0
9022;212343;96;71;29;2;27;.931;3600000;0
9022;-1;96;0;0;0;0;.00nan;0;0
9023;210271;105;80;30;2;28;.933;3900000;0
9023;210521;105;0;0;0;0;.00nan;0;0
9023;215769;97;0;0;0;0;.00nan;0;0
9023;212354;97;82;38;2;36;.947;3900000;0
9024;213659;93;0;0;0;0;.00nan;0;0
9024;215735;93;44;28;4;24;.857;3600000;0
9024;212301;92;0;0;0;0;.00nan;0;0
9024;-1;92;74;30;2;28;.933;3600000;0
9025;213668;95;0;0;0;0;.00nan;0;0
9025;209784;91;66;24;2;22;.917;3600000;0
9025;205429;91;0;0;0;0;.00nan;0;0
9025;212487;95;71;37;3;34;.919;3548000;0
9026;209796;107;99;57;4;53;.930;3600000;0
9026;210426;107;0;0;0;0;.00nan;0;0
9026;215733;99;25;17;5;12;.706;3600000;0
9026;218786;99;0;0;0;0;.00nan;0;0
9027;215498;102;67;33;3;30;.909;3554000;0
9027;215769;97;0;0;0;0;.00nan;0;0
9027;212354;97;91;41;2;39;.951;3600000;0
9027;-1;102;0;0;0;0;.00nan;0;0
9028;208417;101;67;26;2;24;.923;3548000;0
9028;216150;101;0;0;0;0;.00nan;0;0
9028;212343;96;75;23;1;22;.957;3600000;0
9028;-1;96;0;0;0;0;.00nan;0;0
9029;220831;89;0;0;0;0;.00nan;0;0
9029;210471;89;76;24;2;22;.917;3600000;0
9029;210968;86;62;38;4;34;.895;3600000;0
9029;222755;86;0;0;0;0;.00nan;0;0
9030;210222;90;54;29;4;25;.862;3600000;0
9030;220924;87;57;42;5;37;.881;3600000;0
9030;-1;90;0;0;0;0;.00nan;0;0
9030;-1;87;0;0;0;0;.00nan;0;0
9031;213668;95;0;0;0;0;.00nan;0;0
9031;210603;104;69;22;1;21;.955;3900000;0
9031;210930;104;0;0;0;0;.00nan;0;0
9031;212487;95;100;46;1;45;.978;3900000;0
9032;209784;91;0;0;0;0;.00nan;0;0
9032;205429;91;70;21;1;20;.952;3600000;0
9032;215785;94;51;23;3;20;.870;3557000;0
9032;-1;94;0;0;0;0;.00nan;0;0
9033;213659;93;82;21;1;20;.952;3600000;0
9033;215735;93;0;0;0;0;.00nan;0;0
9033;212301;92;63;47;5;42;.894;3600000;0
9033;-1;92;0;0;0;0;.00nan;0;0
9034;215498;102;0;0;0;0;.00nan;0;0
9034;212343;96;45;24;4;20;.833;3513000;0
9034;-1;96;0;0;0;0;.00nan;0;0
9034;-1;102;69;25;2;23;.920;3600000;0
9035;210271;105;85;31;2;29;.935;3600000;0
9035;210368;106;59;35;4;31;.886;3600000;0
9035;210521;105;0;0;0;0;.00nan;0;0
9035;-1;106;0;0;0;0;.00nan;0;0
9036;215575;100;0;0;0;0;.00nan;0;0
9036;215769;97;0;0;0;0;.00nan;0;0
9036;212354;97;50;41;5;36;.878;3600000;0
9036;212368;100;58;22;3;19;.864;3600000;0
9037;215733;99;0;0;0;0;.00nan;0;0
9037;222835;103;0;0;0;0;.00nan;0;0
9037;218786;99;53;18;2;16;.889;3600000;0
9037;-1;103;61;34;4;30;.882;3593000;0
9038;208417;101;37;31;5;26;.839;3576000;0
9038;216150;101;0;0;0;0;.00nan;0;0
9038;217437;88;0;0;0;0;.00nan;0;0
9038;-1;88;38;19;4;15;.789;3600000;0
9039;210222;90;18;13;5;8;.615;3594000;0
9039;210968;86;0;0;0;0;.00nan;0;0
9039;222755;86;58;37;4;33;.892;3600000;0
9039;-1;90;0;0;0;0;.00nan;0;0
9040;210439;98;73;45;4;41;.911;3600000;0
9040;220924;87;0;0;0;0;.00nan;0;0
9040;210503;98;0;0;0;0;.00nan;0;0
9040;-1;87;70;46;5;41;.891;3553000;0
9041;213668;95;68;50;5;45;.900;3600000;0
9041;220831;89;70;27;2;25;.926;3600000;0
9041;210471;89;0;0;0;0;.00nan;0;0
9041;212487;95;0;0;0;0;.00nan;0;0
9042;215785;94;0;0;0;0;.00nan;0;0
9042;212301;92;0;0;0;0;.00nan;0;0
9042;-1;92;68;53;6;47;.887;3600000;0
9042;-1;94;51;15;2;13;.867;3600000;0
9043;210368;106;0;0;0;0;.00nan;0;0
9043;215733;99;29;22;5;17;.773;3555000;0
9043;218786;99;0;0;0;0;.00nan;0;0
9043;-1;106;72;34;3;31;.912;3600000;0
9044;209796;107;25;7;3;4;.571;388000;0
9044;210426;107;39;55;8;47;.855;3212000;0
9044;215575;100;75;9;0;9;1.000;3600000;0
9044;212368;100;0;0;0;0;.00nan;0;0
9045;210271;105;0;0;0;0;.00nan;0;0
9045;210521;105;93;27;1;26;.963;3600000;0
9045;222835;103;14;7;4;3;.429;546000;0
9045;-1;103;67;36;3;33;.917;3054000;0
9046;215769;97;74;23;1;22;.957;1602000;0
9046;212343;96;0;0;0;0;.00nan;0;0
9046;212354;97;27;16;4;12;.750;1998000;0
9046;-1;96;100;44;1;43;.977;3600000;0
9047;210603;104;0;0;0;0;.00nan;0;0
9047;210930;104;70;33;3;30;.909;3600000;0
9047;212301;92;65;34;4;30;.882;3547000;0
9047;-1;92;0;0;0;0;.00nan;0;0
9048;210271;105;54;32;5;27;.844;3600000;0
9048;210521;105;0;0;0;0;.00nan;0;0
9048;215733;99;0;0;0;0;.00nan;0;0
9048;218786;99;84;28;1;27;.964;3600000;0
9049;210439;98;49;33;5;28;.848;3900000;0
9049;210503;98;0;0;0;0;.00nan;0;0
9049;217437;88;45;33;5;28;.848;3900000;0
9049;-1;88;0;0;0;0;.00nan;0;0
9050;208417;101;55;22;3;19;.864;3600000;0
9050;210968;86;57;41;5;36;.878;3564000;0
9050;216150;101;0;0;0;0;.00nan;0;0
9050;222755;86;0;0;0;0;.00nan;0;0
9051;209784;91;41;41;6;35;.854;3600000;0
9051;205429;91;0;0;0;0;.00nan;0;0
9051;210603;104;61;24;3;21;.875;3600000;0
9051;210930;104;0;0;0;0;.00nan;0;0
9052;213668;95;0;0;0;0;.00nan;0;0
9052;215785;94;48;18;3;15;.833;3600000;0
9052;212487;95;53;38;5;33;.868;3588000;0
9052;-1;94;0;0;0;0;.00nan;0;0
9053;220699;89;55;23;3;20;.870;3600000;0
9053;210439;98;0;0;0;0;.00nan;0;0
9053;210471;89;0;0;0;0;.00nan;0;0
9053;210503;98;68;42;5;37;.881;3600000;0
9054;208417;101;0;0;0;0;.00nan;0;0
9054;210222;90;0;0;0;0;.00nan;0;0
9054;216150;101;34;21;5;16;.762;3543000;0
9054;-1;90;51;29;4;25;.862;3600000;0
9055;213659;93;69;30;3;27;.900;3600000;0
9055;215735;93;0;0;0;0;.00nan;0;0
9055;210603;104;0;0;0;0;.00nan;0;0
9055;210930;104;25;41;8;33;.805;3600000;0
9056;210428;103;81;30;1;29;.967;3600000;0
9056;215575;100;85;29;2;27;.931;3544000;0
9056;212368;100;0;0;0;0;.00nan;0;0
9056;-1;103;0;0;0;0;.00nan;0;0
9057;215769;97;0;0;0;0;.00nan;0;0
9057;215785;94;80;31;2;29;.935;3600000;0
9057;212354;97;53;35;5;30;.857;3600000;0
9057;-1;94;0;0;0;0;.00nan;0;0
9058;210603;104;61;38;4;34;.895;3900000;0
9058;210930;104;0;0;0;0;.00nan;0;0
9058;212343;96;65;34;4;30;.882;3900000;0
9058;-1;96;0;0;0;0;.00nan;0;0
9059;213668;95;0;0;0;0;.00nan;0;0
9059;212487;95;67;40;4;36;.900;3565000;0
9059;217437;88;51;23;3;20;.870;3600000;0
9059;-1;88;0;0;0;0;.00nan;0;0
9060;210439;98;84;42;3;39;.929;3570000;0
9060;210503;98;0;0;0;0;.00nan;0;0
9060;210968;86;83;27;1;26;.963;3600000;0
9060;222755;86;0;0;0;0;.00nan;0;0
9061;208417;101;22;29;6;23;.793;3600000;0
9061;220924;87;86;31;1;30;.968;3600000;0
9061;216150;101;0;0;0;0;.00nan;0;0
9061;-1;87;0;0;0;0;.00nan;0;0
9062;209784;91;0;0;0;0;.00nan;0;0
9062;205429;91;60;44;6;38;.864;3543000;0
9062;212301;92;0;0;0;0;.00nan;0;0
9062;-1;92;64;46;5;41;.891;3600000;0
9063;213659;93;52;33;4;29;.879;2267000;0
9063;215735;93;29;19;5;14;.737;1333000;0
9063;215785;94;0;0;0;0;.00nan;0;0
9063;-1;94;74;25;1;24;.960;3600000;0
9064;210271;105;0;0;0;0;.00nan;0;0
9064;210521;105;64;33;3;30;.909;3600000;0
9064;210923;102;0;0;0;0;.00nan;0;0
9064;-1;102;44;31;5;26;.839;3535000;0
9065;215575;100;31;23;5;18;.783;1093000;0
9065;215733;99;0;0;0;0;.00nan;0;0
9065;212368;100;62;29;3;26;.897;2507000;0
9065;218786;99;42;24;5;19;.792;3600000;0
9066;210368;106;43;32;5;27;.844;3553000;0
9066;210428;103;54;30;4;26;.867;3600000;0
9066;-1;103;0;0;0;0;.00nan;0;0
9066;-1;106;0;0;0;0;.00nan;0;0
9067;208417;101;0;0;0;0;.00nan;0;0
9067;220699;89;0;0;0;0;.00nan;0;0
9067;210471;89;93;34;2;32;.941;3600000;0
9067;216150;101;66;37;4;33;.892;3511000;0
9068;220924;87;0;0;0;0;.00nan;0;0
9068;210968;86;75;34;3;31;.912;3583000;0
9068;222755;86;0;0;0;0;.00nan;0;0
9068;-1;87;89;45;2;43;.956;3600000;0
9069;210222;90;66;20;2;18;.900;3900000;0
9069;210439;98;0;0;0;0;.00nan;0;0
9069;210503;98;72;28;2;26;.929;3900000;0
9069;-1;90;0;0;0;0;.00nan;0;0
9070;209784;91;0;0;0;0;.00nan;0;0
9070;205429;91;51;32;4;28;.875;3579000;0
9070;212301;92;58;35;3;32;.914;3600000;0
9070;-1;92;0;0;0;0;.00nan;0;0
9071;210368;106;0;0;0;0;.00nan;0;0
9071;210428;103;0;0;0;0;.00nan;0;0
9071;-1;103;100;40;0;40;1.000;3600000;0
9071;-1;106;63;29;3;26;.897;3600000;0
9072;215575;100;74;31;2;29;.935;3600000;0
9072;215733;99;52;25;3;22;.880;3546000;0
9072;212368;100;0;0;0;0;.00nan;0;0
9072;218786;99;0;0;0;0;.00nan;0;0
9073;213659;93;0;0;0;0;.00nan;0;0
9073;215735;93;63;37;4;33;.892;3874000;0
9073;215769;97;0;0;0;0;.00nan;0;0
9073;212354;97;44;27;5;22;.815;3874000;0
9074;210271;105;65;23;2;21;.913;3600000;0
9074;210521;105;0;0;0;0;.00nan;0;0
9074;210923;102;72;39;3;36;.923;3600000;0
9074;-1;102;0;0;0;0;.00nan;0;0
9075;210968;86;81;34;2;32;.941;3600000;0
9075;217437;88;21;29;7;22;.759;3600000;0
9075;222755;86;0;0;0;0;.00nan;0;0
9075;-1;88;0;0;0;0;.00nan;0;0
9076;215785;94;83;40;2;38;.950;3768000;0
9076;212343;96;92;49;3;46;.939;3768000;0
9076;-1;96;0;0;0;0;.00nan;0;0
9076;-1;94;0;0;0;0;.00nan;0;0
9077;210222;90;0;0;0;0;.00nan;0;0
9077;220924;87;59;44;6;38;.864;3600000;0
9077;-1;90;80;31;2;29;.935;3600000;0
9077;-1;87;0;0;0;0;.00nan;0;0
9078;210603;104;77;24;2;22;.917;3600000;0
9078;215769;97;51;38;5;33;.868;3600000;0
9078;210930;104;0;0;0;0;.00nan;0;0
9078;212354;97;0;0;0;0;.00nan;0;0
9079;209796;107;0;0;0;0;.00nan;0;0
9079;210271;105;0;0;0;0;.00nan;0;0
9079;210426;107;90;47;3;44;.936;3566000;0
9079;210521;105;58;16;2;14;.875;3600000;0
9080;210368;106;77;37;3;34;.919;3554000;0
9080;210923;102;0;0;0;0;.00nan;0;0
9080;-1;102;68;18;2;16;.889;3600000;0
9080;-1;106;0;0;0;0;.00nan;0;0
9081;213668;95;0;0;0;0;.00nan;0;0
9081;212301;92;0;0;0;0;.00nan;0;0
9081;212487;95;72;34;3;31;.912;3600000;0
9081;-1;92;81;32;2;30;.938;3600000;0
9082;209796;107;0;0;0;0;.00nan;0;0
9082;210426;107;88;39;2;37;.949;3600000;0
9082;210923;102;68;39;4;35;.897;3581000;0
9082;-1;102;0;0;0;0;.00nan;0;0
9083;209784;91;28;14;4;10;.714;516000;0
9083;220699;89;0;0;0;0;.00nan;0;0
9083;210471;89;63;24;2;22;.917;3600000;0
9083;205429;91;48;38;5;33;.868;3084000;0
9084;213659;93;53;39;5;34;.872;3600000;0
9084;210222;90;83;19;0;19;1.000;3600000;0
9084;215735;93;0;0;0;0;.00nan;0;0
9084;-1;90;0;0;0;0;.00nan;0;0
9085;210368;106;67;31;3;28;.903;3900000;0
9085;215575;100;0;0;0;0;.00nan;0;0
9085;212368;100;71;34;3;31;.912;3900000;0
9085;-1;106;0;0;0;0;.00nan;0;0
9086;209784;91;0;0;0;0;.00nan;0;0
9086;220924;87;0;0;0;0;.00nan;0;0
9086;205429;91;44;38;6;32;.842;3549000;0
9086;-1;87;47;31;5;26;.839;3600000;0
9087;213668;95;0;0;0;0;.00nan;0;0
9087;220699;89;64;14;1;13;.929;3600000;0
9087;210471;89;0;0;0;0;.00nan;0;0
9087;212487;95;75;41;4;37;.902;3600000;0
9088;210222;90;97;54;3;51;.944;3600000;0
9088;212343;96;54;31;4;27;.871;3545000;0
9088;-1;90;0;0;0;0;.00nan;0;0
9088;-1;96;0;0;0;0;.00nan;0;0
9089;213659;93;58;33;4;29;.879;3600000;0
9089;215735;93;0;0;0;0;.00nan;0;0
9089;212301;92;0;0;0;0;.00nan;0;0
9089;-1;92;73;25;1;24;.960;3600000;0
9090;210368;106;85;47;3;44;.936;3900000;0
9090;215733;99;0;0;0;0;.00nan;0;0
9090;218786;99;85;38;3;35;.921;3900000;0
9090;-1;106;0;0;0;0;.00nan;0;0
9091;215769;97;0;0;0;0;.00nan;0;0
9091;210968;86;77;42;4;38;.905;3600000;0
9091;212354;97;31;33;6;27;.818;3578000;0
9091;222755;86;0;0;0;0;.00nan;0;0
9092;208417;101;70;35;3;32;.914;3564000;0
9092;215575;100;82;31;2;29;.935;3600000;0
9092;216150;101;0;0;0;0;.00nan;0;0
9092;212368;100;0;0;0;0;.00nan;0;0
9093;210271;105;55;20;2;18;.900;3600000;0
9093;210521;105;0;0;0;0;.00nan;0;0
9093;210603;104;58;29;4;25;.862;3547000;0
9093;210930;104;0;0;0;0;.00nan;0;0
9094;210428;103;0;0;0;0;.00nan;0;0
9094;215785;94;39;12;3;9;.750;3600000;0
9094;-1;94;0;0;0;0;.00nan;0;0
9094;-1;103;67;49;6;43;.878;3600000;0
9095;210439;98;61;29;3;26;.897;3899000;0
9095;210503;98;0;0;0;0;.00nan;0;0
9095;210923;102;0;0;0;0;.00nan;0;0
9095;-1;102;80;30;3;27;.900;3900000;0
9096;209784;91;55;29;3;26;.897;3543000;0
9096;205429;91;0;0;0;0;.00nan;0;0
9096;217437;88;71;27;2;25;.926;3600000;0
9096;-1;88;0;0;0;0;.00nan;0;0
9097;213668;95;76;48;5;43;.896;3720000;0
9097;220699;89;33;19;4;15;.789;3722000;0
9097;210471;89;0;0;0;0;.00nan;0;0
9097;212487;95;0;0;0;0;.00nan;0;0
9098;220924;87;71;38;3;35;.921;3600000;0
9098;212301;92;43;27;4;23;.852;3600000;0
9098;-1;92;0;0;0;0;.00nan;0;0
9098;-1;87;0;0;0;0;.00nan;0;0
9099;210368;106;0;0;0;0;.00nan;0;0
9099;215733;99;65;25;2;23;.920;3600000;0
9099;218786;99;0;0;0;0;.00nan;0;0
9099;-1;106;72;46;4;42;.913;3523000;0
9100;213659;93;0;0;0;0;.00nan;0;0
9100;215735;93;55;41;5;36;.878;3584000;0
9100;210968;86;52;18;3;15;.833;3600000;0
9100;222755;86;0;0;0;0;.00nan;0;0
9101;209796;107;0;0;0;0;.00nan;0;0
9101;210426;107;63;28;2;26;.929;3600000;0
9101;210603;104;42;3;1;2;.667;426000;0
9101;210930;104;37;32;6;26;.813;3174000;0
9102;210428;103;54;27;3;24;.889;3600000;0
9102;215785;94;64;34;4;30;.882;3541000;0
9102;-1;94;0;0;0;0;.00nan;0;0
9102;-1;103;0;0;0;0;.00nan;0;0
9103;208417;101;0;0;0;0;.00nan;0;0
9103;215575;100;0;0;0;0;.00nan;0;0
9103;216150;101;49;41;6;35;.854;3583000;0
9103;212368;100;54;27;4;23;.852;3600000;0
9104;212301;92;0;0;0;0;.00nan;0;0
9104;217437;88;0;0;0;0;.00nan;0;0
9104;-1;92;41;27;4;23;.852;3561000;0
9104;-1;88;74;35;3;32;.914;3600000;0
9105;210968;86;52;48;6;42;.875;3545000;0
9105;212343;96;43;27;5;22;.815;3600000;0
9105;222755;86;0;0;0;0;.00nan;0;0
9105;-1;96;0;0;0;0;.00nan;0;0
9106;210222;90;69;30;3;27;.900;3600000;0
9106;215769;97;68;30;3;27;.900;2531000;0
9106;212354;97;51;22;4;18;.818;1069000;0
9106;-1;90;0;0;0;0;.00nan;0;0
9107;210439;98;0;0;0;0;.00nan;0;0
9107;210503;98;43;39;6;33;.846;3600000;0
9107;210923;102;76;27;1;26;.963;3600000;0
9107;-1;102;0;0;0;0;.00nan;0;0
9108;210271;105;31;28;5;23;.821;3551000;0
9108;210521;105;0;0;0;0;.00nan;0;0
9108;215785;94;0;0;0;0;.00nan;0;0
9108;-1;94;61;30;4;26;.867;3600000;0
9109;209796;107;54;23;3;20;.870;3862000;0
9109;210426;107;0;0;0;0;.00nan;0;0
9109;210428;103;0;0;0;0;.00nan;0;0
9109;-1;103;82;37;2;35;.946;3862000;0
9110;209796;107;0;0;0;0;.00nan;0;0
9110;210426;107;74;39;3;36;.923;3597000;0
9110;215785;94;75;23;1;22;.957;3600000;0
9110;-1;94;0;0;0;0;.00nan;0;0
9111;210271;105;41;32;6;26;.813;2805000;0
9111;215575;100;64;27;2;25;.926;3600000;0
9111;210521;105;48;0;0;0;.00nan;795000;0
9111;212368;100;0;0;0;0;.00nan;0;0
9112;220699;89;51;36;5;31;.861;3600000;0
9112;210471;89;0;0;0;0;.00nan;0;0
9112;212301;92;62;13;1;12;.923;1290000;0
9112;-1;92;22;20;6;14;.700;2310000;0
9113;210222;90;65;39;4;35;.897;3574000;0
9113;210968;86;0;0;0;0;.00nan;0;0
9113;222755;86;69;25;2;23;.920;3600000;0
9113;-1;90;0;0;0;0;.00nan;0;0
9114;212343;96;86;30;2;28;.933;3600000;0
9114;217437;88;0;0;0;0;.00nan;0;0
9114;-1;88;70;19;1;18;.947;3600000;0
9114;-1;96;0;0;0;0;.00nan;0;0
9115;209784;91;39;1;1;0;.000;160000;0
9115;220924;87;0;0;0;0;.00nan;0;0
9115;205429;91;47;21;4;17;.810;3358000;0
9115;-1;87;73;34;3;31;.912;3600000;0
9116;213659;93;73;45;5;40;.889;3600000;0
9116;215735;93;0;0;0;0;.00nan;0;0
9116;215769;97;0;0;0;0;.00nan;0;0
9116;212354;97;81;26;1;25;.962;3600000;0
9117;209796;107;0;0;0;0;.00nan;0;0
9117;210426;107;79;28;2;26;.929;3594000;0
9117;210428;103;99;37;1;36;.973;3600000;0
9117;-1;103;0;0;0;0;.00nan;0;0
9118;208417;101;46;21;3;18;.857;3600000;0
9118;210439;98;94;51;4;47;.922;3600000;0
9118;210503;98;0;0;0;0;.00nan;0;0
9118;216150;101;0;0;0;0;.00nan;0;0
9119;215575;100;0;0;0;0;.00nan;0;0
9119;210923;102;61;48;5;43;.896;3600000;0
9119;212368;100;82;23;1;22;.957;3600000;0
9119;-1;102;0;0;0;0;.00nan;0;0
9120;215733;99;20;26;6;20;.769;3600000;0
9120;210603;104;81;22;1;21;.955;3600000;0
9120;210930;104;0;0;0;0;.00nan;0;0
9120;218786;99;0;0;0;0;.00nan;0;0
9121;210368;106;95;43;3;40;.930;3900000;0
9121;215785;94;50;30;3;27;.900;3900000;0
9121;-1;94;0;0;0;0;.00nan;0;0
9121;-1;106;0;0;0;0;.00nan;0;0
9122;210222;90;0;0;0;0;.00nan;0;0
9122;210968;86;34;41;7;34;.829;3529000;0
9122;222755;86;0;0;0;0;.00nan;0;0
9122;-1;90;29;22;5;17;.773;3600000;0
9123;215575;100;75;38;3;35;.921;3600000;0
9123;210923;102;0;0;0;0;.00nan;0;0
9123;212368;100;0;0;0;0;.00nan;0;0
9123;-1;102;32;40;7;33;.825;3600000;0
9124;220699;89;100;27;0;27;1.000;3600000;0
9124;210471;89;0;0;0;0;.00nan;0;0
9124;212301;92;65;41;4;37;.902;3600000;0
9124;-1;92;0;0;0;0;.00nan;0;0
9125;213659;93;0;0;0;0;.00nan;0;0
9125;215735;93;87;28;1;27;.964;3600000;0
9125;217437;88;40;29;5;24;.828;3600000;0
9125;-1;88;0;0;0;0;.00nan;0;0
9126;210271;105;0;0;0;0;.00nan;0;0
9126;210428;103;0;0;0;0;.00nan;0;0
9126;210521;105;74;30;3;27;.900;3600000;0
9126;-1;103;71;44;4;40;.909;3547000;0
9127;210368;106;0;0;0;0;.00nan;0;0
9127;210603;104;0;0;0;0;.00nan;0;0
9127;210930;104;89;29;1;28;.966;3600000;0
9127;-1;106;80;40;4;36;.900;3600000;0
9128;215733;99;0;0;0;0;.00nan;0;0
9128;215785;94;0;0;0;0;.00nan;0;0
9128;218786;99;52;28;4;24;.857;3592000;0
9128;-1;94;69;24;2;22;.917;3600000;0
9129;208417;101;0;0;0;0;.00nan;0;0
9129;210439;98;0;0;0;0;.00nan;0;0
9129;210503;98;77;45;3;42;.933;3569000;0
9129;216150;101;53;15;2;13;.867;3600000;0
9130;220924;87;42;35;5;30;.857;3600000;0
9130;212343;96;84;24;2;22;.917;3600000;0
9130;-1;87;0;0;0;0;.00nan;0;0
9130;-1;96;0;0;0;0;.00nan;0;0
9131;213668;95;0;0;0;0;.00nan;0;0
9131;210222;90;77;21;1;20;.952;3600000;0
9131;212487;95;42;27;4;23;.852;3600000;0
9131;-1;90;0;0;0;0;.00nan;0;0
9132;215769;97;0;0;0;0;.00nan;0;0
9132;212354;97;53;34;5;29;.853;3600000;0
9132;217437;88;0;0;0;0;.00nan;0;0
9132;-1;88;84;26;2;24;.923;3600000;0
9133;208417;101;76;27;2;25;.926;3600000;0
9133;210439;98;96;48;3;45;.938;3600000;0
9133;210503;98;0;0;0;0;.00nan;0;0
9133;216150;101;0;0;0;0;.00nan;0;0
9134;209796;107;0;0;0;0;.00nan;0;0
9134;210426;107;99;38;1;37;.974;3600000;0
9134;215733;99;82;34;2;32;.941;3557000;0
9134;218786;99;0;0;0;0;.00nan;0;0
9135;209784;91;52;24;3;21;.875;3600000;0
9135;205429;91;0;0;0;0;.00nan;0;0
9135;215769;97;0;0;0;0;.00nan;0;0
9135;212354;97;44;43;6;37;.860;3600000;0
9136;210428;103;87;44;3;41;.932;3551000;0
9136;215733;99;0;0;0;0;.00nan;0;0
9136;218786;99;79;20;1;19;.950;3600000;0
9136;-1;103;0;0;0;0;.00nan;0;0
9137;210271;105;66;25;2;23;.920;3883000;0
9137;210521;105;0;0;0;0;.00nan;0;0
9137;210603;104;95;59;2;57;.966;3900000;0
9137;210930;104;0;0;0;0;.00nan;0;0
9138;213659;93;0;0;0;0;.00nan;0;0
9138;215735;93;95;36;1;35;.972;3600000;0
9138;210968;86;42;13;3;10;.769;3513000;0
9138;222755;86;0;0;0;0;.00nan;0;0
9139;210222;90;87;42;3;39;.929;3883000;0
9139;220924;87;55;32;4;28;.875;3883000;0
9139;-1;90;0;0;0;0;.00nan;0;0
9139;-1;87;0;0;0;0;.00nan;0;0
9140;213668;95;0;0;0;0;.00nan;0;0
9140;209784;91;0;0;0;0;.00nan;0;0
9140;205429;91;68;20;1;19;.950;3600000;0
9140;212487;95;70;34;3;31;.912;3569000;0
9141;210271;105;0;0;0;0;.00nan;0;0
9141;210521;105;83;34;2;32;.941;3554000;0
9141;215785;94;100;24;0;24;1.000;3600000;0
9141;-1;94;0;0;0;0;.00nan;0;0
9142;210368;106;41;37;6;31;.838;3600000;0
9142;215575;100;71;23;1;22;.957;3600000;0
9142;212368;100;0;0;0;0;.00nan;0;0
9142;-1;106;0;0;0;0;.00nan;0;0
9143;213659;93;68;35;3;32;.914;3596000;0
9143;215735;93;0;0;0;0;.00nan;0;0
9143;217437;88;59;18;2;16;.889;3600000;0
9143;-1;88;0;0;0;0;.00nan;0;0
9144;220699;89;72;34;3;31;.912;3600000;0
9144;210471;89;0;0;0;0;.00nan;0;0
9144;210968;86;64;35;4;31;.886;3543000;0
9144;222755;86;0;0;0;0;.00nan;0;0
9145;213668;95;0;0;0;0;.00nan;0;0
9145;220924;87;0;0;0;0;.00nan;0;0
9145;212487;95;68;50;6;44;.880;3600000;0
9145;-1;87;39;7;2;5;.714;3600000;0
9146;210222;90;67;33;3;30;.909;3600000;0
9146;212301;92;31;32;6;26;.813;3191000;0
9146;-1;90;0;0;0;0;.00nan;0;0
9146;-1;92;56;7;0;7;1.000;409000;0
9147;215769;97;0;0;0;0;.00nan;0;0
9147;212343;96;81;30;2;28;.933;3600000;0
9147;212354;97;57;33;4;29;.879;3583000;0
9147;-1;96;0;0;0;0;.00nan;0;0
9148;209796;107;0;0;0;0;.00nan;0;0
9148;210426;107;71;42;5;37;.881;3582000;0
9148;210923;102;0;0;0;0;.00nan;0;0
9148;-1;102;66;37;4;33;.892;3600000;0
9149;210368;106;53;41;6;35;.854;3600000;0
9149;215575;100;0;0;0;0;.00nan;0;0
9149;212368;100;42;27;5;22;.815;3600000;0
9149;-1;106;0;0;0;0;.00nan;0;0
9150;208417;101;81;27;1;26;.963;3600000;0
9150;215733;99;0;0;0;0;.00nan;0;0
9150;216150;101;0;0;0;0;.00nan;0;0
9150;218786;99;67;30;3;27;.900;3547000;0
9151;210271;105;99;49;2;47;.959;3600000;0
9151;210521;105;0;0;0;0;.00nan;0;0
9151;210603;104;71;31;3;28;.903;3576000;0
9151;210930;104;0;0;0;0;.00nan;0;0
9152;210428;103;50;37;5;32;.865;3521000;0
9152;210439;98;78;41;3;38;.927;3600000;0
9152;210503;98;0;0;0;0;.00nan;0;0
9152;-1;103;0;0;0;0;.00nan;0;0
9153;209784;91;56;25;3;22;.880;3600000;0
9153;205429;91;0;0;0;0;.00nan;0;0
9153;212343;96;0;0;0;0;.00nan;0;0
9153;-1;96;54;32;5;27;.844;3581000;0
9154;213659;93;0;0;0;0;.00nan;0;0
9154;220699;89;66;20;2;18;.900;3672000;0
9154;210471;89;0;0;0;0;.00nan;0;0
9154;215735;93;75;36;3;33;.917;3672000;0
9155;210968;86;0;0;0;0;.00nan;0;0
9155;212301;92;0;0;0;0;.00nan;0;0
9155;222755;86;58;34;4;30;.882;3600000;0
9155;-1;92;54;18;2;16;.889;3600000;0
9156;213668;95;91;38;2;36;.947;3600000;0
9156;212487;95;0;0;0;0;.00nan;0;0
9156;217437;88;0;0;0;0;.00nan;0;0
9156;-1;88;87;19;0;19;1.000;3600000;0
9157;210368;106;76;26;1;25;.962;3600000;0
9157;210428;103;0;0;0;0;.00nan;0;0
9157;-1;103;64;24;2;22;.917;3599000;0
9157;-1;106;0;0;0;0;.00nan;0;0
9158;210603;104;57;28;4;24;.857;1965000;0
9158;215785;94;53;26;4;22;.846;3600000;0
9158;210930;104;46;16;2;14;.875;1564000;0
9158;-1;94;0;0;0;0;.00nan;0;0
9159;208417;101;0;0;0;0;.00nan;0;0
9159;210271;105;0;0;0;0;.00nan;0;0
9159;210521;105;58;36;5;31;.861;3600000;0
9159;216150;101;85;41;2;39;.951;3600000;0
9160;215733;99;86;26;1;25;.962;3600000;0
9160;210923;102;62;29;4;25;.862;3600000;0
9160;218786;99;0;0;0;0;.00nan;0;0
9160;-1;102;0;0;0;0;.00nan;0;0
9161;213659;93;98;55;3;52;.945;3518000;0
9161;220924;87;0;0;0;0;.00nan;0;0
9161;215735;93;0;0;0;0;.00nan;0;0
9161;-1;87;70;16;1;15;.938;3600000;0
9162;210222;90;47;26;4;22;.846;3600000;0
9162;217437;88;0;0;0;0;.00nan;0;0
9162;-1;90;0;0;0;0;.00nan;0;0
9162;-1;88;22;32;7;25;.781;3600000;0
9163;215769;97;0;0;0;0;.00nan;0;0
9163;212343;96;77;32;3;29;.906;3600000;0
9163;212354;97;40;30;5;25;.833;3556000;0
9163;-1;96;0;0;0;0;.00nan;0;0
9164;209796;107;99;51;2;49;.961;3600000;0
9164;210271;105;69;31;3;28;.903;3567000;0
9164;210426;107;0;0;0;0;.00nan;0;0
9164;210521;105;0;0;0;0;.00nan;0;0
9165;210368;106;0;0;0;0;.00nan;0;0
9165;215785;94;0;0;0;0;.00nan;0;0
9165;-1;94;61;17;2;15;.882;3713000;0
9165;-1;106;100;47;1;46;.979;3713000;0
9166;210428;103;57;40;5;35;.875;3600000;0
9166;210439;98;77;32;2;30;.938;3600000;0
9166;210503;98;0;0;0;0;.00nan;0;0
9166;-1;103;0;0;0;0;.00nan;0;0
9167;215575;100;0;0;0;0;.00nan;0;0
9167;210603;104;29;45;9;36;.800;3600000;0
9167;210930;104;0;0;0;0;.00nan;0;0
9167;212368;100;52;17;3;14;.824;3600000;0
9168;220699;89;63;31;3;28;.903;3600000;0
9168;210471;89;0;0;0;0;.00nan;0;0
9168;215769;97;0;0;0;0;.00nan;0;0
9168;212354;97;44;28;4;24;.857;3600000;0
9169;209784;91;0;0;0;0;.00nan;0;0
9169;210222;90;69;35;4;31;.886;3556000;0
9169;205429;91;64;25;2;23;.920;3600000;0
9169;-1;90;0;0;0;0;.00nan;0;0
9170;213659;93;61;30;3;27;.900;3600000;0
9170;213668;95;56;5;0;5;1.000;812000;0
9170;215735;93;0;0;0;0;.00nan;0;0
9170;212487;95;28;25;6;19;.760;2788000;0
9171;220924;87;0;0;0;0;.00nan;0;0
9171;212301;92;0;0;0;0;.00nan;0;0
9171;-1;92;74;39;4;35;.897;3600000;0
9171;-1;87;44;33;5;28;.848;3549000;0
9172;215769;97;54;35;5;30;.857;3600000;0
9172;212354;97;0;0;0;0;.00nan;0;0
9172;217437;88;63;39;4;35;.897;3600000;0
9172;-1;88;0;0;0;0;.00nan;0;0
9173;220924;87;68;41;4;37;.902;3600000;0
9173;212343;96;62;15;1;14;.933;3600000;0
9173;-1;87;0;0;0;0;.00nan;0;0
9173;-1;96;0;0;0;0;.00nan;0;0
9174;209796;107;0;0;0;0;.00nan;0;0
9174;210426;107;99;42;1;41;.976;3600000;0
9174;215785;94;53;18;2;16;.889;3564000;0
9174;-1;94;0;0;0;0;.00nan;0;0
9175;210428;103;35;26;5;21;.808;3545000;0
9175;210923;102;0;0;0;0;.00nan;0;0
9175;-1;102;46;26;4;22;.846;3600000;0
9175;-1;103;0;0;0;0;.00nan;0;0
9176;209784;91;66;23;3;20;.870;3600000;0
9176;205429;91;0;0;0;0;.00nan;0;0
9176;210968;86;24;25;6;19;.760;3297000;0
9176;222755;86;40;2;1;1;.500;303000;0
9177;210439;98;91;44;2;42;.955;3579000;0
9177;215575;100;68;22;1;21;.955;3600000;0
9177;210503;98;0;0;0;0;.00nan;0;0
9177;212368;100;0;0;0;0;.00nan;0;0
9178;209784;91;0;0;0;0;.00nan;0;0
9178;205429;91;89;37;2;35;.946;3600000;0
9178;217437;88;60;33;4;29;.879;3527000;0
9178;-1;88;0;0;0;0;.00nan;0;0
9179;210222;90;60;38;4;34;.895;3571000;0
9179;210968;86;75;32;3;29;.906;3600000;0
9179;222755;86;0;0;0;0;.00nan;0;0
9179;-1;90;0;0;0;0;.00nan;0;0
9180;213668;95;25;5;3;2;.400;792000;0
9180;215769;97;0;0;0;0;.00nan;0;0
9180;212354;97;72;23;1;22;.957;3600000;0
9180;212487;95;40;38;6;32;.842;2808000;0
9181;212301;92;0;0;0;0;.00nan;0;0
9181;212343;96;61;26;3;23;.885;3513000;0
9181;-1;92;87;30;1;29;.967;3600000;0
9181;-1;96;0;0;0;0;.00nan;0;0
9182;213659;93;33;24;5;19;.792;3600000;0
9182;220699;89;88;25;1;24;.960;3600000;0
9182;210471;89;0;0;0;0;.00nan;0;0
9182;215735;93;0;0;0;0;.00nan;0;0
9183;215575;100;0;0;0;0;.00nan;0;0
9183;210923;102;0;0;0;0;.00nan;0;0
9183;212368;100;79;34;2;32;.941;3600000;0
9183;-1;102;78;45;5;40;.889;3600000;0
9184;210439;98;83;37;3;34;.919;3900000;0
9184;210503;98;0;0;0;0;.00nan;0;0
9184;215733;99;0;0;0;0;.00nan;0;0
9184;218786;99;47;20;3;17;.850;3900000;0
9185;209796;107;81;29;1;28;.966;3600000;0
9185;210271;105;88;49;4;45;.918;3600000;0
9185;210426;107;0;0;0;0;.00nan;0;0
9185;210521;105;0;0;0;0;.00nan;0;0
9186;208417;101;100;34;1;33;.971;3600000;0
9186;210428;103;86;45;3;42;.933;3523000;0
9186;216150;101;0;0;0;0;.00nan;0;0
9186;-1;103;0;0;0;0;.00nan;0;0
9187;210603;104;91;42;2;40;.952;3600000;0
9187;215785;94;60;9;0;9;1.000;553000;0
9187;210930;104;0;0;0;0;.00nan;0;0
9187;-1;94;22;23;6;17;.739;3047000;0
9188;220699;89;74;25;3;22;.880;3600000;0
9188;210471;89;0;0;0;0;.00nan;0;0
9188;212343;96;0;0;0;0;.00nan;0;0
9188;-1;96;68;38;4;34;.895;3600000;0
9189;210968;86;0;0;0;0;.00nan;0;0
9189;217437;88;0;0;0;0;.00nan;0;0
9189;222755;86;47;18;3;15;.833;3600000;0
9189;-1;88;41;31;5;26;.839;3515000;0
9190;220924;87;30;29;6;23;.793;2435000;0
9190;215769;97;35;26;5;21;.808;3600000;0
9190;212354;97;0;0;0;0;.00nan;0;0
9190;-1;87;29;16;4;12;.750;1165000;0
9191;213668;95;67;41;3;38;.927;3600000;0
9191;210222;90;0;0;0;0;.00nan;0;0
9191;212487;95;0;0;0;0;.00nan;0;0
9191;-1;90;43;25;4;21;.840;3600000;0
9192;213659;93;0;0;0;0;.00nan;0;0
9192;215735;93;87;52;2;50;.962;3600000;0
9192;212301;92;43;17;3;14;.824;3593000;0
9192;-1;92;0;0;0;0;.00nan;0;0
9193;210368;106;82;22;1;21;.955;3600000;0
9193;210428;103;0;0;0;0;.00nan;0;0
9193;-1;103;56;35;4;31;.886;3600000;0
9193;-1;106;0;0;0;0;.00nan;0;0
9194;210439;98;0;0;0;0;.00nan;0;0
9194;210503;98;44;36;5;31;.861;3597000;0
9194;215733;99;62;25;3;22;.880;3600000;0
9194;218786;99;0;0;0;0;.00nan;0;0
9195;210271;105;0;0;0;0;.00nan;0;0
9195;210521;105;91;19;0;19;1.000;3600000;0
9195;210603;104;45;43;7;36;.837;3600000;0
9195;210930;104;0;0;0;0;.00nan;0;0
9196;208417;101;0;0;0;0;.00nan;0;0
9196;209796;107;0;0;0;0;.00nan;0;0
9196;210426;107;55;35;5;30;.857;3578000;0
9196;216150;101;60;29;3;26;.897;3600000;0
9197;215575;100;50;22;3;19;.864;3514000;0
9197;210923;102;88;34;1;33;.971;3600000;0
9197;212368;100;0;0;0;0;.00nan;0;0
9197;-1;102;0;0;0;0;.00nan;0;0
9198;220924;87;0;0;0;0;.00nan;0;0
9198;212301;92;0;0;0;0;.00nan;0;0
9198;-1;92;73;49;6;43;.878;3574000;0
9198;-1;87;63;31;4;27;.871;3600000;0
9199;213659;93;84;43;3;40;.930;3600000;0
9199;215735;93;0;0;0;0;.00nan;0;0
9199;212343;96;82;14;0;14;1.000;3600000;0
9199;-1;96;0;0;0;0;.00nan;0;0
9200;210271;105;0;0;0;0;.00nan;0;0
9200;210368;106;95;45;2;43;.956;3600000;0
9200;210521;105;91;16;0;16;1.000;3600000;0
9200;-1;106;0;0;0;0;.00nan;0;0
9201;215575;100;0;0;0;0;.00nan;0;0
9201;210603;104;87;50;4;46;.920;3571000;0
9201;210930;104;0;0;0;0;.00nan;0;0
9201;212368;100;51;20;3;17;.850;3600000;0
9202;210428;103;77;35;2;33;.943;3900000;0
9202;215785;94;61;24;2;22;.917;3900000;0
9202;-1;94;0;0;0;0;.00nan;0;0
9202;-1;103;0;0;0;0;.00nan;0;0
9203;213668;95;0;0;0;0;.00nan;0;0
9203;209784;91;0;0;0;0;.00nan;0;0
9203;205429;91;54;18;2;16;.889;3600000;0
9203;212487;95;85;32;1;31;.969;3600000;0
9204;209796;107;0;0;0;0;.00nan;0;0
9204;210426;107;55;20;2;18;.900;3600000;0
9204;210428;103;0;0;0;0;.00nan;0;0
9204;-1;103;88;34;1;33;.971;3600000;0
9205;208417;101;34;20;4;16;.800;3680000;0
9205;210439;98;30;8;3;5;.625;489000;0
9205;210503;98;94;39;2;37;.949;3191000;0
9205;216150;101;0;0;0;0;.00nan;0;0
9206;220699;89;44;24;4;20;.833;3574000;0
9206;210471;89;0;0;0;0;.00nan;0;0
9206;217437;88;92;35;2;33;.943;3600000;0
9206;-1;88;0;0;0;0;.00nan;0;0
9207;212343;96;60;31;4;27;.871;3544000;0
9207;217437;88;0;0;0;0;.00nan;0;0
9207;-1;88;89;37;2;35;.946;3600000;0
9207;-1;96;0;0;0;0;.00nan;0;0
9208;213668;95;0;0;0;0;.00nan;0;0
9208;220924;87;57;39;5;34;.872;3623000;0
9208;212487;95;29;31;6;25;.806;3623000;0
9208;-1;87;0;0;0;0;.00nan;0;0
9209;209784;91;57;50;5;45;.900;3600000;0
9209;210222;90;71;20;2;18;.900;3600000;0
9209;205429;91;0;0;0;0;.00nan;0;0
9209;-1;90;0;0;0;0;.00nan;0;0
9210;210968;86;60;28;3;25;.893;3600000;0
9210;212301;92;0;0;0;0;.00nan;0;0
9210;222755;86;0;0;0;0;.00nan;0;0
9210;-1;92;58;38;5;33;.868;3577000;0
9211;213659;93;0;0;0;0;.00nan;0;0
9211;215735;93;77;48;5;43;.896;3704000;0
9211;215769;97;0;0;0;0;.00nan;0;0
9211;212354;97;50;28;4;24;.857;3704000;0
9212;215733;99;49;24;4;20;.833;3900000;0
9212;210923;102;75;42;4;38;.905;3900000;0
9212;218786;99;0;0;0;0;.00nan;0;0
9212;-1;102;0;0;0;0;.00nan;0;0
9213;209796;107;42;8;2;6;.750;1271000;0
9213;210271;105;0;0;0;0;.00nan;0;0
9213;210426;107;45;22;4;18;.818;2329000;0
9213;210521;105;80;28;1;27;.964;3600000;0
9214;208417;101;0;0;0;0;.00nan;0;0
9214;210368;106;97;34;1;33;.971;3900000;0
9214;216150;101;77;21;1;20;.952;3900000;0
9214;-1;106;0;0;0;0;.00nan;0;0
9215;210603;104;77;46;4;42;.913;3560000;0
9215;215785;94;58;25;3;22;.880;3600000;0
9215;210930;104;0;0;0;0;.00nan;0;0
9215;-1;94;0;0;0;0;.00nan;0;0
9216;210439;98;92;54;3;51;.944;3900000;0
9216;215575;100;74;22;2;20;.909;3900000;0
9216;210503;98;0;0;0;0;.00nan;0;0
9216;212368;100;0;0;0;0;.00nan;0;0
9217;209784;91;0;0;0;0;.00nan;0;0
9217;205429;91;85;28;1;27;.964;3600000;0
9217;210968;86;0;0;0;0;.00nan;0;0
9217;222755;86;48;32;5;27;.844;3600000;0
9218;220699;89;60;32;4;28;.875;3763000;0
9218;210471;89;0;0;0;0;.00nan;0;0
9218;212343;96;0;0;0;0;.00nan;0;0
9218;-1;96;73;37;3;34;.919;3763000;0
9219;213668;95;96;50;2;48;.960;3588000;0
9219;220924;87;0;0;0;0;.00nan;0;0
9219;212487;95;0;0;0;0;.00nan;0;0
9219;-1;87;87;15;0;15;1.000;3600000;0
9220;215733;99;0;0;0;0;.00nan;0;0
9220;210923;102;0;0;0;0;.00nan;0;0
9220;218786;99;69;29;3;26;.897;3600000;0
9220;-1;102;49;29;4;25;.862;3555000;0
9221;210222;90;67;20;2;18;.900;3600000;0
9221;212301;92;80;56;5;51;.911;3600000;0
9221;-1;90;0;0;0;0;.00nan;0;0
9221;-1;92;0;0;0;0;.00nan;0;0
9222;208417;101;65;18;2;16;.889;3600000;0
9222;210368;106;0;0;0;0;.00nan;0;0
9222;216150;101;0;0;0;0;.00nan;0;0
9222;-1;106;73;38;3;35;.921;3600000;0
9223;213659;93;83;43;3;40;.930;3900000;0
9223;215735;93;0;0;0;0;.00nan;0;0
9223;215769;97;42;19;3;16;.842;3900000;0
9223;212354;97;0;0;0;0;.00nan;0;0
9224;210603;104;0;0;0;0;.00nan;0;0
9224;215785;94;0;0;0;0;.00nan;0;0
9224;210930;104;64;42;4;38;.905;3564000;0
9224;-1;94;69;22;2;20;.909;3600000;0
9225;210271;105;39;18;4;14;.778;3600000;0
9225;210428;103;64;60;7;53;.883;3600000;0
9225;210521;105;0;0;0;0;.00nan;0;0
9225;-1;103;0;0;0;0;.00nan;0;0
9226;210439;98;0;0;0;0;.00nan;0;0
9226;215575;100;0;0;0;0;.00nan;0;0
9226;210503;98;67;40;4;36;.900;3531000;0
9226;212368;100;69;20;2;18;.900;3600000;0
9227;210271;105;0;0;0;0;.00nan;0;0
9227;210368;106;38;34;6;28;.824;3600000;0
9227;210521;105;41;23;4;19;.826;3600000;0
9227;-1;106;0;0;0;0;.00nan;0;0
9228;210222;90;46;22;4;18;.818;3612000;0
9228;217437;88;73;38;3;35;.921;3612000;0
9228;-1;90;0;0;0;0;.00nan;0;0
9228;-1;88;0;0;0;0;.00nan;0;0
9229;220924;87;0;0;0;0;.00nan;0;0
9229;212343;96;70;33;4;29;.879;3542000;0
9229;-1;87;62;27;3;24;.889;3600000;0
9229;-1;96;0;0;0;0;.00nan;0;0
9230;213659;93;0;0;0;0;.00nan;0;0
9230;209784;91;77;22;1;21;.955;3600000;0
9230;205429;91;0;0;0;0;.00nan;0;0
9230;215735;93;85;37;2;35;.946;3552000;0
9231;215769;97;0;0;0;0;.00nan;0;0
9231;212301;92;0;0;0;0;.00nan;0;0
9231;212354;97;86;16;0;16;1.000;3600000;0
9231;-1;92;82;45;3;42;.933;3600000;0
9232;210439;98;73;31;2;29;.935;3600000;0
9232;210503;98;0;0;0;0;.00nan;0;0
9232;210923;102;39;25;5;20;.800;3600000;0
9232;-1;102;0;0;0;0;.00nan;0;0
9233;208417;101;57;22;3;19;.864;3600000;0
9233;210603;104;52;28;4;24;.857;3600000;0
9233;210930;104;0;0;0;0;.00nan;0;0
9233;216150;101;0;0;0;0;.00nan;0;0
9234;215575;100;44;28;5;23;.821;3540000;0
9234;215785;94;55;25;3;22;.880;3600000;0
9234;212368;100;0;0;0;0;.00nan;0;0
9234;-1;94;0;0;0;0;.00nan;0;0
9235;210428;103;43;39;6;33;.846;3518000;0
9235;215733;99;43;25;4;21;.840;3600000;0
9235;218786;99;0;0;0;0;.00nan;0;0
9235;-1;103;0;0;0;0;.00nan;0;0
9236;213668;95;24;6;3;3;.500;480000;0
9236;220699;89;46;12;2;10;.833;3600000;0
9236;210471;89;0;0;0;0;.00nan;0;0
9236;212487;95;83;44;3;41;.932;3120000;0
9237;209796;107;75;22;1;21;.955;3600000;0
9237;210426;107;0;0;0;0;.00nan;0;0
9237;210603;104;47;20;4;16;.800;3600000;0
9237;210930;104;0;0;0;0;.00nan;0;0
9238;210428;103;0;0;0;0;.00nan;0;0
9238;215733;99;0;0;0;0;.00nan;0;0
9238;218786;99;19;21;6;15;.714;3600000;0
9238;-1;103;91;39;2;37;.949;3600000;0
9239;215769;97;0;0;0;0;.00nan;0;0
9239;212343;96;61;39;4;35;.897;3573000;0
9239;212354;97;79;35;2;33;.943;3600000;0
9239;-1;96;0;0;0;0;.00nan;0;0
9240;209784;91;0;0;0;0;.00nan;0;0
9240;220699;89;52;23;3;20;.870;3600000;0
9240;210471;89;0;0;0;0;.00nan;0;0
9240;205429;91;49;38;5;33;.868;3590000;0
9241;210968;86;58;18;2;16;.889;3600000;0
9241;217437;88;0;0;0;0;.00nan;0;0
9241;222755;86;0;0;0;0;.00nan;0;0
9241;-1;88;41;42;7;35;.833;3600000;0
9242;210222;90;78;36;2;34;.944;3600000;0
9242;217437;88;27;29;6;23;.793;3023000;0
9242;-1;90;0;0;0;0;.00nan;0;0
9242;-1;88;40;11;2;9;.818;577000;0
9243;213668;95;0;0;0;0;.00nan;0;0
9243;212301;92;0;0;0;0;.00nan;0;0
9243;212487;95;98;42;1;41;.976;3600000;0
9243;-1;92;49;23;3;20;.870;3513000;0
9244;209796;107;52;37;5;32;.865;3600000;0
9244;210426;107;0;0;0;0;.00nan;0;0
9244;212343;96;71;19;1;18;.947;3600000;0
9244;-1;96;0;0;0;0;.00nan;0;0
9245;209784;91;21;17;5;12;.706;1746000;0
9245;205429;91;46;18;3;15;.833;1832000;0
9245;215769;97;49;20;3;17;.850;2564000;0
9245;212354;97;33;17;4;13;.765;1036000;0
9246;215733;99;0;0;0;0;.00nan;0;0
9246;210923;102;74;23;1;22;.957;3551000;0
9246;218786;99;100;34;0;34;1.000;3600000;0
9246;-1;102;0;0;0;0;.00nan;0;0
9247;208417;101;63;24;2;22;.917;3600000;0
9247;215575;100;54;35;5;30;.857;3600000;0
9247;216150;101;0;0;0;0;.00nan;0;0
9247;212368;100;0;0;0;0;.00nan;0;0
9248;220924;87;0;0;0;0;.00nan;0;0
9248;210603;104;84;50;4;46;.920;3544000;0
9248;210930;104;0;0;0;0;.00nan;0;0
9248;-1;87;64;30;3;27;.900;3600000;0
9249;220699;89;51;25;4;21;.840;2280000;0
9249;210471;89;60;8;0;8;1.000;1570000;0
9249;215785;94;49;35;5;30;.857;3850000;0
9249;-1;94;0;0;0;0;.00nan;0;0
9250;210368;106;24;26;7;19;.731;3600000;0
9250;210439;98;68;30;2;28;.933;3600000;0
9250;210503;98;0;0;0;0;.00nan;0;0
9250;-1;106;0;0;0;0;.00nan;0;0
9251;210968;86;0;0;0;0;.00nan;0;0
9251;217437;88;43;10;2;8;.800;1086000;0
9251;222755;86;49;23;3;20;.870;3600000;0
9251;-1;88;28;26;6;20;.769;2514000;0
9252;213668;95;80;42;3;39;.929;3600000;0
9252;212301;92;73;20;1;19;.950;3600000;0
9252;212487;95;0;0;0;0;.00nan;0;0
9252;-1;92;0;0;0;0;.00nan;0;0
9253;213659;93;73;39;3;36;.923;3900000;0
9253;209796;107;0;0;0;0;.00nan;0;0
9253;210426;107;50;24;3;21;.875;3900000;0
9253;215735;93;0;0;0;0;.00nan;0;0
9254;210271;105;69;27;2;25;.926;3600000;0
9254;210428;103;60;39;5;34;.872;3600000;0
9254;210521;105;0;0;0;0;.00nan;0;0
9254;-1;103;0;0;0;0;.00nan;0;0
9255;220699;89;65;30;3;27;.900;3600000;0
9255;210471;89;0;0;0;0;.00nan;0;0
9255;210603;104;58;20;2;18;.900;1603000;0
9255;210930;104;23;27;6;21;.778;1997000;0
9256;220924;87;66;38;4;34;.895;3600000;0
9256;215785;94;0;0;0;0;.00nan;0;0
9256;-1;87;0;0;0;0;.00nan;0;0
9256;-1;94;27;27;5;22;.815;3565000;0
9257;210368;106;0;0;0;0;.00nan;0;0
9257;210439;98;0;0;0;0;.00nan;0;0
9257;210503;98;41;32;5;27;.844;3561000;0
9257;-1;106;71;32;3;29;.906;3600000;0
9258;208417;101;0;0;0;0;.00nan;0;0
9258;210923;102;57;9;1;8;.889;882000;0
9258;216150;101;58;26;3;23;.885;3600000;0
9258;-1;102;21;25;6;19;.760;2718000;0
9259;215575;100;0;0;0;0;.00nan;0;0
9259;215733;99;0;0;0;0;.00nan;0;0
9259;212368;100;57;18;2;16;.889;3600000;0
9259;218786;99;73;44;4;40;.909;3523000;0
9260;209784;91;91;23;1;22;.957;3600000;0
9260;205429;91;0;0;0;0;.00nan;0;0
9260;212343;96;59;41;5;36;.878;3600000;0
9260;-1;96;0;0;0;0;.00nan;0;0
9261;209796;107;44;34;5;29;.853;3563000;0
9261;210426;107;0;0;0;0;.00nan;0;0
9261;215769;97;0;0;0;0;.00nan;0;0
9261;212354;97;60;25;3;22;.880;3600000;0
9262;210428;103;0;0;0;0;.00nan;0;0
9262;210923;102;83;31;2;29;.935;3600000;0
9262;-1;102;0;0;0;0;.00nan;0;0
9262;-1;103;41;44;6;38;.864;3600000;0
9263;213659;93;0;0;0;0;.00nan;0;0
9263;210222;90;62;26;3;23;.885;3578000;0
9263;215735;93;82;38;2;36;.947;3600000;0
9263;-1;90;0;0;0;0;.00nan;0;0
9264;210428;103;85;26;1;25;.962;3600000;0
9264;220924;87;59;28;3;25;.893;3514000;0
9264;-1;87;0;0;0;0;.00nan;0;0
9264;-1;103;0;0;0;0;.00nan;0;0
9265;215769;97;0;0;0;0;.00nan;0;0
9265;212343;96;0;0;0;0;.00nan;0;0
9265;212354;97;72;26;3;23;.885;3600000;0
9265;-1;96;65;39;4;35;.897;3582000;0
9266;213659;93;0;0;0;0;.00nan;0;0
9266;215735;93;100;31;0;31;1.000;3600000;0
9266;210968;86;65;28;3;25;.893;3600000;0
9266;222755;86;0;0;0;0;.00nan;0;0
9267;209796;107;0;0;0;0;.00nan;0;0
9267;210426;107;100;28;0;28;1.000;3600000;0
9267;220924;87;0;0;0;0;.00nan;0;0
9267;-1;87;73;44;4;40;.909;3600000;0
9268;210603;104;41;21;4;17;.810;1168000;0
9268;210923;102;64;17;2;15;.882;3600000;0
9268;210930;104;52;19;3;16;.842;2432000;0
9268;-1;102;0;0;0;0;.00nan;0;0
9269;220699;89;51;22;3;19;.864;3600000;0
9269;210368;106;73;40;4;36;.900;3600000;0
9269;210471;89;0;0;0;0;.00nan;0;0
9269;-1;106;0;0;0;0;.00nan;0;0
9270;210968;86;70;24;1;23;.958;3544000;0
9270;217437;88;100;40;0;40;1.000;3600000;0
9270;222755;86;0;0;0;0;.00nan;0;0
9270;-1;88;0;0;0;0;.00nan;0;0
9271;209784;91;0;0;0;0;.00nan;0;0
9271;210222;90;74;28;3;25;.893;3600000;0
9271;205429;91;73;47;5;42;.894;3563000;0
9271;-1;90;0;0;0;0;.00nan;0;0
9272;215769;97;0;0;0;0;.00nan;0;0
9272;212301;92;0;0;0;0;.00nan;0;0
9272;212354;97;73;39;4;35;.897;3600000;0
9272;-1;92;66;27;2;25;.926;3600000;0
9273;213659;93;0;0;0;0;.00nan;0;0
9273;213668;95;0;0;0;0;.00nan;0;0
9273;215735;93;83;42;3;39;.929;3600000;0
9273;212487;95;31;25;5;20;.800;3600000;0
9274;210428;103;23;33;7;26;.788;3600000;0
9274;210923;102;0;0;0;0;.00nan;0;0
9274;-1;102;69;23;2;21;.913;3600000;0
9274;-1;103;0;0;0;0;.00nan;0;0
9275;210368;106;43;17;3;14;.824;3569000;0
9275;220924;87;0;0;0;0;.00nan;0;0
9275;-1;87;81;30;1;29;.967;3600000;0
9275;-1;106;0;0;0;0;.00nan;0;0
9276;215733;99;0;0;0;0;.00nan;0;0
9276;210603;104;64;50;5;45;.900;3600000;0
9276;210930;104;0;0;0;0;.00nan;0;0
9276;218786;99;67;24;2;22;.917;3600000;0
9277;208417;101;72;39;3;36;.923;3900000;0
9277;215575;100;65;27;3;24;.889;3900000;0
9277;216150;101;0;0;0;0;.00nan;0;0
9277;212368;100;0;0;0;0;.00nan;0;0
9278;210439;98;21;13;4;9;.692;1060000;0
9278;210503;98;46;25;4;21;.840;2540000;0
9278;215785;94;68;27;2;25;.926;3600000;0
9278;-1;94;0;0;0;0;.00nan;0;0
9279;220699;89;43;28;5;23;.821;3589000;0
9279;210271;105;0;0;0;0;.00nan;0;0
9279;210471;89;0;0;0;0;.00nan;0;0
9279;210521;105;65;39;4;35;.897;3600000;0
9280;210222;90;20;20;6;14;.700;2767000;0
9280;217437;88;50;26;4;22;.846;3600000;0
9280;-1;90;48;0;0;0;.00nan;778000;0
9280;-1;88;0;0;0;0;.00nan;0;0
9281;209784;91;0;0;0;0;.00nan;0;0
9281;205429;91;84;40;3;37;.925;3600000;0
9281;210968;86;0;0;0;0;.00nan;0;0
9281;222755;86;62;37;4;33;.892;3560000;0
9282;208417;101;50;1;0;1;1.000;565000;0
9282;210923;102;83;41;3;38;.927;3600000;0
9282;216150;101;13;19;6;13;.684;3035000;0
9282;-1;102;0;0;0;0;.00nan;0;0
9283;210368;106;0;0;0;0;.00nan;0;0
9283;210439;98;58;34;4;30;.882;3600000;0
9283;210503;98;0;0;0;0;.00nan;0;0
9283;-1;106;76;21;1;20;.952;3600000;0
9284;215733;99;69;16;1;15;.938;3600000;0
9284;210603;104;0;0;0;0;.00nan;0;0
9284;210930;104;76;34;3;31;.912;3578000;0
9284;218786;99;0;0;0;0;.00nan;0;0
9285;213659;93;61;35;4;31;.886;3600000;0
9285;215735;93;0;0;0;0;.00nan;0;0
9285;212343;96;43;30;5;25;.833;3543000;0
9285;-1;96;0;0;0;0;.00nan;0;0
9286;213668;95;65;53;5;48;.906;3600000;0
9286;215769;97;67;15;1;14;.933;3600000;0
9286;212354;97;0;0;0;0;.00nan;0;0
9286;212487;95;0;0;0;0;.00nan;0;0
9287;220699;89;42;29;5;24;.828;3600000;0
9287;210428;103;0;0;0;0;.00nan;0;0
9287;210471;89;0;0;0;0;.00nan;0;0
9287;-1;103;79;23;1;22;.957;3600000;0
9288;215575;100;0;0;0;0;.00nan;0;0
9288;215785;94;0;0;0;0;.00nan;0;0
9288;212368;100;22;27;6;21;.778;3600000;0
9288;-1;94;62;25;3;22;.880;3600000;0
9289;210271;105;62;21;2;19;.905;3600000;0
9289;220924;87;61;48;6;42;.875;3600000;0
9289;210521;105;0;0;0;0;.00nan;0;0
9289;-1;87;0;0;0;0;.00nan;0;0
9290;212301;92;66;37;4;33;.892;3600000;0
9290;212343;96;0;0;0;0;.00nan;0;0
9290;-1;92;0;0;0;0;.00nan;0;0
9290;-1;96;71;35;3;32;.914;3600000;0
9291;209796;107;0;0;0;0;.00nan;0;0
9291;220699;89;72;28;2;26;.929;3600000;0
9291;210426;107;66;46;5;41;.891;3600000;0
9291;210471;89;0;0;0;0;.00nan;0;0
9292;208417;101;93;23;0;23;1.000;3600000;0
9292;210428;103;73;42;4;38;.905;3600000;0
9292;216150;101;0;0;0;0;.00nan;0;0
9292;-1;103;0;0;0;0;.00nan;0;0
9293;212301;92;0;0;0;0;.00nan;0;0
9293;217437;88;76;38;3;35;.921;3600000;0
9293;-1;92;50;36;6;30;.833;3600000;0
9293;-1;88;0;0;0;0;.00nan;0;0
9294;210439;98;32;26;6;20;.769;2334000;0
9294;210503;98;49;16;2;14;.875;1266000;0
9294;210603;104;64;28;3;25;.893;3600000;0
9294;210930;104;0;0;0;0;.00nan;0;0
9295;213668;95;0;0;0;0;.00nan;0;0
9295;215769;97;0;0;0;0;.00nan;0;0
9295;212354;97;54;40;5;35;.875;3565000;0
9295;212487;95;99;46;3;43;.935;3600000;0
9296;212343;96;51;26;4;22;.846;3900000;0
9296;217437;88;0;0;0;0;.00nan;0;0
9296;-1;88;67;48;4;44;.917;3900000;0
9296;-1;96;0;0;0;0;.00nan;0;0
9297;209784;91;64;51;6;45;.882;3600000;0
9297;205429;91;0;0;0;0;.00nan;0;0
9297;212301;92;92;43;2;41;.953;3600000;0
9297;-1;92;0;0;0;0;.00nan;0;0
9298;210368;106;77;52;5;47;.904;3539000;0
9298;210923;102;56;26;3;23;.885;3600000;0
9298;-1;102;0;0;0;0;.00nan;0;0
9298;-1;106;0;0;0;0;.00nan;0;0
9299;215575;100;63;25;3;22;.880;3600000;0
9299;215785;94;66;39;5;34;.872;3600000;0
9299;212368;100;0;0;0;0;.00nan;0;0
9299;-1;94;0;0;0;0;.00nan;0;0
9300;220699;89;64;41;4;37;.902;3568000;0
9300;210471;89;0;0;0;0;.00nan;0;0
9300;220924;87;68;33;3;30;.909;3600000;0
9300;-1;87;0;0;0;0;.00nan;0;0
9301;215769;97;0;0;0;0;.00nan;0;0
9301;210968;86;73;27;1;26;.963;3600000;0
9301;212354;97;23;33;8;25;.758;3600000;0
9301;222755;86;0;0;0;0;.00nan;0;0
9302;210222;90;37;23;5;18;.783;3900000;0
9302;212301;92;0;0;0;0;.00nan;0;0
9302;-1;90;0;0;0;0;.00nan;0;0
9302;-1;92;77;47;5;42;.894;3900000;0
9303;213659;93;51;2;0;2;1.000;504000;0
9303;215735;93;44;35;6;29;.829;3096000;0
9303;212343;96;71;27;2;25;.926;3600000;0
9303;-1;96;0;0;0;0;.00nan;0;0
9304;209784;91;0;0;0;0;.00nan;0;0
9304;205429;91;85;31;2;29;.935;3600000;0
9304;217437;88;75;36;3;33;.917;3600000;0
9304;-1;88;0;0;0;0;.00nan;0;0
9305;208417;101;71;20;1;19;.950;3600000;0
9305;215733;99;86;30;1;29;.967;2461000;0
9305;216150;101;0;0;0;0;.00nan;0;0
9305;218786;99;21;11;4;7;.636;1139000;0
9306;215575;100;75;36;3;33;.917;3600000;0
9306;210923;102;66;47;4;43;.915;3560000;0
9306;212368;100;0;0;0;0;.00nan;0;0
9306;-1;102;0;0;0;0;.00nan;0;0
9307;210428;103;100;28;0;28;1.000;3600000;0
9307;210603;104;79;43;4;39;.907;3600000;0
9307;210930;104;0;0;0;0;.00nan;0;0
9307;-1;103;0;0;0;0;.00nan;0;0
9308;209796;107;0;0;0;0;.00nan;0;0
9308;210426;107;91;44;3;41;.932;3600000;0
9308;215785;94;67;15;1;14;.933;3600000;0
9308;-1;94;0;0;0;0;.00nan;0;0
9309;210271;105;0;0;0;0;.00nan;0;0
9309;210439;98;34;32;6;26;.813;3033000;0
9309;210503;98;60;7;0;7;1.000;567000;0
9309;210521;105;66;27;3;24;.889;3600000;0
9310;209784;91;65;51;6;45;.882;3600000;0
9310;220699;89;58;25;3;22;.880;3600000;0
9310;210471;89;0;0;0;0;.00nan;0;0
9310;205429;91;0;0;0;0;.00nan;0;0
9311;210968;86;0;0;0;0;.00nan;0;0
9311;212301;92;67;41;5;36;.878;3566000;0
9311;222755;86;43;16;3;13;.813;3600000;0
9311;-1;92;0;0;0;0;.00nan;0;0
9312;210222;90;61;9;0;9;1.000;2136000;0
9312;215769;97;65;32;4;28;.875;3600000;0
9312;212354;97;0;0;0;0;.00nan;0;0
9312;-1;90;14;15;6;9;.600;1439000;0
9313;213668;95;90;49;5;44;.898;3600000;0
9313;212487;95;0;0;0;0;.00nan;0;0
9313;217437;88;0;0;0;0;.00nan;0;0
9313;-1;88;44;18;3;15;.833;3600000;0
9314;215575;100;0;0;0;0;.00nan;0;0
9314;210923;102;0;0;0;0;.00nan;0;0
9314;212368;100;58;38;5;33;.868;3565000;0
9314;-1;102;72;37;3;34;.919;3600000;0
9315;209796;107;70;38;5;33;.868;3600000;0
9315;210368;106;35;27;6;21;.778;3245000;0
9315;210426;107;0;0;0;0;.00nan;0;0
9315;-1;106;42;4;1;3;.750;355000;0
9316;208417;101;53;30;3;27;.900;3900000;0
9316;215733;99;0;0;0;0;.00nan;0;0
9316;216150;101;0;0;0;0;.00nan;0;0
9316;218786;99;79;35;3;32;.914;3900000;0
9317;213659;93;74;38;3;35;.921;3600000;0
9317;215735;93;0;0;0;0;.00nan;0;0
9317;212343;96;0;0;0;0;.00nan;0;0
9317;-1;96;56;16;2;14;.875;3600000;0
9318;210428;103;96;41;3;38;.927;3520000;0
9318;210603;104;0;0;0;0;.00nan;0;0
9318;210930;104;76;20;1;19;.950;3600000;0
9318;-1;103;0;0;0;0;.00nan;0;0
9319;210271;105;32;19;5;14;.737;3900000;0
9319;210439;98;0;0;0;0;.00nan;0;0
9319;210503;98;44;36;5;31;.861;3874000;0
9319;210521;105;0;0;0;0;.00nan;0;0
9320;210428;103;0;0;0;0;.00nan;0;0
9320;215785;94;29;14;4;10;.714;3570000;0
9320;-1;94;0;0;0;0;.00nan;0;0
9320;-1;103;88;46;3;43;.935;3600000;0
9321;213668;95;0;0;0;0;.00nan;0;0
9321;210968;86;99;20;0;20;1.000;3600000;0
9321;212487;95;76;54;5;49;.907;3600000;0
9321;222755;86;0;0;0;0;.00nan;0;0
9322;210222;90;49;37;5;32;.865;3600000;0
9322;217437;88;95;32;2;30;.938;3600000;0
9322;-1;90;0;0;0;0;.00nan;0;0
9322;-1;88;0;0;0;0;.00nan;0;0
9323;208417;101;100;38;1;37;.974;3600000;0
9323;215785;94;24;5;3;2;.400;478000;0
9323;216150;101;0;0;0;0;.00nan;0;0
9323;-1;94;31;26;6;20;.769;3122000;0
9324;210368;106;70;31;3;28;.903;3600000;0
9324;210603;104;61;30;4;26;.867;3600000;0
9324;210930;104;0;0;0;0;.00nan;0;0
9324;-1;106;0;0;0;0;.00nan;0;0
9325;209784;91;40;2;1;1;.500;318000;0
9325;205429;91;70;56;6;50;.893;3282000;0
9325;215769;97;0;0;0;0;.00nan;0;0
9325;212354;97;53;20;3;17;.850;3600000;0
9326;215575;100;43;22;4;18;.818;3671000;0
9326;215733;99;0;0;0;0;.00nan;0;0
9326;212368;100;0;0;0;0;.00nan;0;0
9326;218786;99;44;32;5;27;.844;3671000;0
9327;213659;93;0;0;0;0;.00nan;0;0
9327;209784;91;84;15;0;15;1.000;3600000;0
9327;205429;91;0;0;0;0;.00nan;0;0
9327;215735;93;68;28;2;26;.929;3524000;0
9328;220924;87;77;43;4;39;.907;3879000;0
9328;210968;86;57;45;5;40;.889;3879000;0
9328;222755;86;0;0;0;0;.00nan;0;0
9328;-1;87;0;0;0;0;.00nan;0;0
9329;220699;89;43;43;6;37;.860;3600000;0
9329;210222;90;74;31;3;28;.903;3600000;0
9329;210471;89;0;0;0;0;.00nan;0;0
9329;-1;90;0;0;0;0;.00nan;0;0
9330;213668;95;0;0;0;0;.00nan;0;0
9330;212301;92;0;0;0;0;.00nan;0;0
9330;212487;95;98;55;2;53;.964;3566000;0
9330;-1;92;75;22;1;21;.955;3600000;0
9331;215769;97;0;0;0;0;.00nan;0;0
9331;212343;96;64;31;4;27;.871;3600000;0
9331;212354;97;41;30;5;25;.833;3589000;0
9331;-1;96;0;0;0;0;.00nan;0;0
9332;210368;106;83;46;3;43;.935;3600000;0
9332;215785;94;99;25;0;25;1.000;3600000;0
9332;-1;94;0;0;0;0;.00nan;0;0
9332;-1;106;0;0;0;0;.00nan;0;0
9333;209796;107;0;0;0;0;.00nan;0;0
9333;210426;107;80;27;2;25;.926;3600000;0
9333;210603;104;57;28;4;24;.857;3528000;0
9333;210930;104;0;0;0;0;.00nan;0;0
9334;208417;101;79;30;1;29;.967;3900000;0
9334;210923;102;89;28;1;27;.964;3900000;0
9334;216150;101;0;0;0;0;.00nan;0;0
9334;-1;102;0;0;0;0;.00nan;0;0
9335;210271;105;64;37;4;33;.892;3554000;0
9335;215575;100;82;27;2;25;.926;3600000;0
9335;210521;105;0;0;0;0;.00nan;0;0
9335;212368;100;0;0;0;0;.00nan;0;0
9336;210439;98;52;3;0;3;1.000;407000;0
9336;210503;98;32;33;6;27;.818;3193000;0
9336;215733;99;0;0;0;0;.00nan;0;0
9336;218786;99;41;24;4;20;.833;3600000;0
9337;210968;86;0;0;0;0;.00nan;0;0
9337;217437;88;45;33;5;28;.848;3215000;0
9337;222755;86;62;39;4;35;.897;3600000;0
9337;-1;88;48;0;0;0;.00nan;363000;0
9338;208417;101;0;0;0;0;.00nan;0;0
9338;210923;102;57;35;4;31;.886;3774000;0
9338;216150;101;52;22;3;19;.864;3774000;0
9338;-1;102;0;0;0;0;.00nan;0;0
9339;213668;95;14;19;6;13;.684;2053000;0
9339;212301;92;52;21;3;18;.857;3600000;0
9339;212487;95;66;13;0;13;1.000;1547000;0
9339;-1;92;0;0;0;0;.00nan;0;0
9340;220699;89;14;17;6;11;.647;1502000;0
9340;210222;90;65;43;6;37;.860;3179000;0
9340;210471;89;48;14;2;12;.857;2096000;0
9340;-1;90;43;2;1;1;.500;421000;0
9341;213659;93;51;38;4;34;.895;3600000;0
9341;209784;91;0;0;0;0;.00nan;0;0
9341;205429;91;91;21;0;21;1.000;3600000;0
9341;215735;93;0;0;0;0;.00nan;0;0
9342;209796;107;44;27;4;23;.852;3900000;0
9342;210368;106;0;0;0;0;.00nan;0;0
9342;210426;107;0;0;0;0;.00nan;0;0
9342;-1;106;67;32;4;28;.875;3900000;0
9343;210603;104;0;0;0;0;.00nan;0;0
9343;215785;94;58;22;3;19;.864;3600000;0
9343;210930;104;93;51;4;47;.922;3600000;0
9343;-1;94;0;0;0;0;.00nan;0;0
9344;210439;98;64;31;4;27;.871;3600000;0
9344;210503;98;0;0;0;0;.00nan;0;0
9344;215733;99;33;29;5;24;.828;3554000;0
9344;218786;99;0;0;0;0;.00nan;0;0
9345;210271;105;67;18;1;17;.944;1762000;0
9345;215575;100;0;0;0;0;.00nan;0;0
9345;210521;105;18;21;6;15;.714;1838000;0
9345;212368;100;73;26;2;24;.923;3600000;0
9346;209784;91;0;0;0;0;.00nan;0;0
9346;205429;91;42;34;5;29;.853;3600000;0
9346;212343;96;65;24;2;22;.917;3600000;0
9346;-1;96;0;0;0;0;.00nan;0;0
9347;220699;89;30;26;5;21;.808;3562000;0
9347;210471;89;0;0;0;0;.00nan;0;0
9347;220924;87;80;47;4;43;.915;3600000;0
9347;-1;87;0;0;0;0;.00nan;0;0
9348;208417;101;97;31;1;30;.968;3600000;0
9348;215733;99;0;0;0;0;.00nan;0;0
9348;216150;101;0;0;0;0;.00nan;0;0
9348;218786;99;97;40;2;38;.950;3565000;0
9349;213668;95;62;51;5;46;.902;3600000;0
9349;215769;97;69;17;1;16;.941;3600000;0
9349;212354;97;0;0;0;0;.00nan;0;0
9349;212487;95;0;0;0;0;.00nan;0;0
9350;210368;106;50;30;4;26;.867;3518000;0
9350;210428;103;52;19;3;16;.842;3600000;0
9350;-1;103;0;0;0;0;.00nan;0;0
9350;-1;106;0;0;0;0;.00nan;0;0
9351;209796;107;0;0;0;0;.00nan;0;0
9351;210426;107;61;41;5;36;.878;3600000;0
9351;210603;104;88;21;1;20;.952;3600000;0
9351;210930;104;0;0;0;0;.00nan;0;0
9352;210428;103;44;27;5;22;.815;3600000;0
9352;210923;102;27;27;6;21;.778;2637000;0
9352;-1;102;65;10;0;10;1.000;906000;0
9352;-1;103;0;0;0;0;.00nan;0;0
9353;220924;87;65;36;4;32;.889;3600000;0
9353;210968;86;40;27;5;22;.815;3543000;0
9353;222755;86;0;0;0;0;.00nan;0;0
9353;-1;87;0;0;0;0;.00nan;0;0
9354;210222;90;85;34;1;33;.971;3600000;0
9354;212343;96;86;43;4;39;.907;3600000;0
9354;-1;90;0;0;0;0;.00nan;0;0
9354;-1;96;0;0;0;0;.00nan;0;0
9355;213659;93;0;0;0;0;.00nan;0;0
9355;213668;95;0;0;0;0;.00nan;0;0
9355;215735;93;80;30;2;28;.933;3600000;0
9355;212487;95;53;44;6;38;.864;3600000;0
9356;209796;107;0;0;0;0;.00nan;0;0
9356;210426;107;67;36;4;32;.889;3600000;0
9356;210439;98;78;24;1;23;.958;3600000;0
9356;210503;98;0;0;0;0;.00nan;0;0
9357;220699;89;32;18;4;14;.778;3600000;0
9357;210471;89;0;0;0;0;.00nan;0;0
9357;217437;88;0;0;0;0;.00nan;0;0
9357;-1;88;90;33;1;32;.970;3600000;0
9358;209784;91;80;23;2;21;.913;3600000;0
9358;205429;91;0;0;0;0;.00nan;0;0
9358;212301;92;0;0;0;0;.00nan;0;0
9358;-1;92;60;51;7;44;.863;3600000;0
9359;210222;90;48;23;4;19;.826;3600000;0
9359;210968;86;84;26;1;25;.962;3600000;0
9359;222755;86;0;0;0;0;.00nan;0;0
9359;-1;90;0;0;0;0;.00nan;0;0
9360;220924;87;83;31;1;30;.968;3600000;0
9360;217437;88;74;39;4;35;.897;3600000;0
9360;-1;88;0;0;0;0;.00nan;0;0
9360;-1;87;0;0;0;0;.00nan;0;0
9361;213668;95;33;31;6;25;.806;2399000;0
9361;212343;96;61;18;2;16;.889;3600000;0
9361;212487;95;55;14;1;13;.929;1201000;0
9361;-1;96;0;0;0;0;.00nan;0;0
9362;215733;99;52;7;1;6;.857;1228000;0
9362;210923;102;87;42;3;39;.929;3600000;0
9362;218786;99;41;21;4;17;.810;2351000;0
9362;-1;102;0;0;0;0;.00nan;0;0
9363;208417;101;84;44;4;40;.909;3598000;0
9363;215575;100;63;24;2;22;.917;3600000;0
9363;216150;101;0;0;0;0;.00nan;0;0
9363;212368;100;0;0;0;0;.00nan;0;0
9364;210428;103;43;31;6;25;.806;3256000;0
9364;210603;104;99;42;1;41;.976;3600000;0
9364;210930;104;0;0;0;0;.00nan;0;0
9364;-1;103;52;2;0;2;1.000;344000;0
9365;210368;106;82;36;2;34;.944;3600000;0
9365;215785;94;0;0;0;0;.00nan;0;0
9365;-1;94;91;22;0;22;1.000;3600000;0
9365;-1;106;0;0;0;0;.00nan;0;0
9366;209796;107;0;0;0;0;.00nan;0;0
9366;210426;107;49;34;5;29;.853;3600000;0
9366;210439;98;78;28;1;27;.964;3600000;0
9366;210503;98;0;0;0;0;.00nan;0;0
9367;209784;91;78;26;1;25;.962;3145000;0
9367;205429;91;32;8;3;5;.625;455000;0
9367;212301;92;83;25;1;24;.960;3600000;0
9367;-1;92;0;0;0;0;.00nan;0;0
9368;220699;89;0;0;0;0;.00nan;0;0
9368;210471;89;38;28;5;23;.821;3600000;0
9368;220924;87;0;0;0;0;.00nan;0;0
9368;-1;87;85;38;2;36;.947;3600000;0
9369;210368;106;0;0;0;0;.00nan;0;0
9369;210428;103;0;0;0;0;.00nan;0;0
9369;-1;103;76;23;1;22;.957;3600000;0
9369;-1;106;45;34;5;29;.853;3600000;0
9370;215733;99;0;0;0;0;.00nan;0;0
9370;210923;102;0;0;0;0;.00nan;0;0
9370;218786;99;69;24;2;22;.917;3600000;0
9370;-1;102;58;29;4;25;.862;3556000;0
9371;213659;93;0;0;0;0;.00nan;0;0
9371;215735;93;58;26;3;23;.885;3900000;0
9371;215769;97;0;0;0;0;.00nan;0;0
9371;212354;97;57;24;3;21;.875;3900000;0
9372;210222;90;0;0;0;0;.00nan;0;0
9372;210968;86;0;0;0;0;.00nan;0;0
9372;222755;86;35;44;7;37;.841;3600000;0
9372;-1;90;75;20;1;19;.950;3600000;0
9373;210603;104;47;13;2;11;.846;1653000;0
9373;215785;94;30;20;4;16;.800;3600000;0
9373;210930;104;39;32;5;27;.844;1947000;0
9373;-1;94;0;0;0;0;.00nan;0;0
9374;209796;107;88;55;4;51;.927;3549000;0
9374;210271;105;47;18;3;15;.833;3600000;0
9374;210426;107;0;0;0;0;.00nan;0;0
9374;210521;105;0;0;0;0;.00nan;0;0
9375;208417;101;46;40;6;34;.850;3600000;0
9375;215575;100;0;0;0;0;.00nan;0;0
9375;216150;101;0;0;0;0;.00nan;0;0
9375;212368;100;51;19;2;17;.895;3600000;0
9376;213668;95;0;0;0;0;.00nan;0;0
9376;212343;96;0;0;0;0;.00nan;0;0
9376;212487;95;44;41;7;34;.829;3600000;0
9376;-1;96;70;21;2;19;.905;3600000;0
9377;213659;93;40;33;5;28;.848;3600000;0
9377;215735;93;0;0;0;0;.00nan;0;0
9377;215769;97;61;24;2;22;.917;3600000;0
9377;212354;97;0;0;0;0;.00nan;0;0
9378;210271;105;0;0;0;0;.00nan;0;0
9378;210521;105;71;30;3;27;.900;3600000;0
9378;215785;94;0;0;0;0;.00nan;0;0
9378;-1;94;33;28;5;23;.821;3559000;0
9379;210368;106;61;39;5;34;.872;3600000;0
9379;210428;103;31;33;6;27;.818;3578000;0
9379;-1;103;0;0;0;0;.00nan;0;0
9379;-1;106;0;0;0;0;.00nan;0;0
9381;215733;99;0;0;0;0;.00nan;0;0
9381;212343;96;85;41;3;38;.927;3573000;0
9381;218786;99;61;22;2;20;.909;3600000;0
9381;-1;96;0;0;0;0;.00nan;0;0
9383;209784;91;46;42;6;36;.857;3572000;0
9383;205429;91;0;0;0;0;.00nan;0;0
9383;212301;92;0;0;0;0;.00nan;0;0
9383;-1;92;68;36;5;31;.861;3600000;0
9385;208417;101;26;19;6;13;.684;3600000;0
9385;210439;98;79;41;2;39;.951;3600000;0
9385;210503;98;0;0;0;0;.00nan;0;0
9385;216150;101;0;0;0;0;.00nan;0;0
9387;209796;107;72;48;4;44;.917;3600000;0
9387;210426;107;0;0;0;0;.00nan;0;0
9387;210923;102;66;15;1;14;.933;3600000;0
9387;-1;102;0;0;0;0;.00nan;0;0
9389;213659;93;0;0;0;0;.00nan;0;0
9389;220831;89;0;0;0;0;.00nan;0;0
9389;210471;89;74;17;1;16;.941;3600000;0
9389;215735;93;97;57;4;53;.930;3600000;0
9391;210428;103;86;36;2;34;.944;3600000;0
9391;210968;86;75;22;1;21;.955;3600000;0
9391;222755;86;0;0;0;0;.00nan;0;0
9391;-1;103;0;0;0;0;.00nan;0;0
9393;210368;106;33;26;5;21;.808;3559000;0
9393;217437;88;0;0;0;0;.00nan;0;0
9393;-1;88;69;38;4;34;.895;3600000;0
9393;-1;106;0;0;0;0;.00nan;0;0
9395;213668;95;0;0;0;0;.00nan;0;0
9395;210222;90;60;37;5;32;.865;3600000;0
9395;212487;95;61;52;6;46;.885;3597000;0
9395;-1;90;0;0;0;0;.00nan;0;0
9397;215769;97;0;0;0;0;.00nan;0;0
9397;215785;94;78;30;1;29;.967;3600000;0
9397;212354;97;75;37;3;34;.919;3563000;0
9397;-1;94;0;0;0;0;.00nan;0;0
9399;215575;100;50;30;5;25;.833;3600000;0
9399;220924;87;7;15;6;9;.600;1416000;0
9399;212368;100;0;0;0;0;.00nan;0;0
9399;-1;87;39;22;4;18;.818;2184000;0
9401;210271;105;79;27;1;26;.963;3600000;0
9401;210521;105;0;0;0;0;.00nan;0;0
9401;210603;104;51;25;3;22;.880;3554000;0
9401;210930;104;0;0;0;0;.00nan;0;0
9403;210222;90;59;32;4;28;.875;3525000;0
9403;220924;87;75;36;2;34;.944;3600000;0
9403;-1;90;0;0;0;0;.00nan;0;0
9403;-1;87;0;0;0;0;.00nan;0;0
9405;220831;89;0;0;0;0;.00nan;0;0
9405;210471;89;94;32;1;31;.969;3600000;0
9405;210923;102;65;25;2;23;.920;3546000;0
9405;-1;102;0;0;0;0;.00nan;0;0
9407;215785;94;43;16;3;13;.813;3600000;0
9407;217437;88;0;0;0;0;.00nan;0;0
9407;-1;88;55;52;7;45;.865;3600000;0
9407;-1;94;0;0;0;0;.00nan;0;0
9409;215575;100;0;0;0;0;.00nan;0;0
9409;215733;99;0;0;0;0;.00nan;0;0
9409;212368;100;28;27;6;21;.778;3600000;0
9409;218786;99;44;25;4;21;.840;3600000;0
9411;213668;95;0;0;0;0;.00nan;0;0
9411;212301;92;61;25;3;22;.880;3578000;0
9411;212487;95;86;36;2;34;.944;3600000;0
9411;-1;92;0;0;0;0;.00nan;0;0
9413;209784;91;0;0;0;0;.00nan;0;0
9413;205429;91;62;25;2;23;.920;3556000;0
9413;210603;104;100;32;1;31;.969;3600000;0
9413;210930;104;0;0;0;0;.00nan;0;0
9415;209796;107;58;10;0;10;1.000;1264000;0
9415;210426;107;23;26;6;20;.769;2336000;0
9415;212343;96;47;22;3;19;.864;3600000;0
9415;-1;96;0;0;0;0;.00nan;0;0
9417;210368;106;23;12;4;8;.667;1158000;0
9417;210428;103;52;30;4;26;.867;3600000;0
9417;-1;103;0;0;0;0;.00nan;0;0
9417;-1;106;66;18;1;17;.944;2417000;0
9419;210271;105;0;0;0;0;.00nan;0;0
9419;210521;105;62;32;3;29;.906;3561000;0
9419;215769;97;71;32;2;30;.938;3600000;0
9419;212354;97;0;0;0;0;.00nan;0;0
9421;208417;101;0;0;0;0;.00nan;0;0
9421;213659;93;85;38;2;36;.947;3600000;0
9421;215735;93;0;0;0;0;.00nan;0;0
9421;216150;101;54;20;3;17;.850;3572000;0
9423;210439;98;0;0;0;0;.00nan;0;0
9423;210503;98;90;43;2;41;.953;3600000;0
9423;210968;86;0;0;0;0;.00nan;0;0
9423;222755;86;57;14;1;13;.929;3600000;0
9425;208417;101;88;33;1;32;.970;3600000;0
9425;220924;87;0;0;0;0;.00nan;0;0
9425;216150;101;0;0;0;0;.00nan;0;0
9425;-1;87;66;40;4;36;.900;3600000;0
9427;210368;106;100;42;1;41;.976;3600000;0
9427;215575;100;72;33;2;31;.939;3600000;0
9427;212368;100;0;0;0;0;.00nan;0;0
9427;-1;106;0;0;0;0;.00nan;0;0
9429;215769;97;0;0;0;0;.00nan;0;0
9429;212301;92;0;0;0;0;.00nan;0;0
9429;212354;97;35;22;4;18;.818;3589000;0
9429;-1;92;77;38;3;35;.921;3600000;0
9431;213668;95;49;25;3;22;.880;3551000;0
9431;209796;107;88;34;2;32;.941;3600000;0
9431;210426;107;0;0;0;0;.00nan;0;0
9431;212487;95;0;0;0;0;.00nan;0;0
9433;210271;105;62;29;3;26;.897;3572000;0
9433;210428;103;0;0;0;0;.00nan;0;0
9433;210521;105;0;0;0;0;.00nan;0;0
9433;-1;103;85;29;1;28;.966;3600000;0
9435;215733;99;81;34;2;32;.941;3576000;0
9435;215785;94;0;0;0;0;.00nan;0;0
9435;218786;99;0;0;0;0;.00nan;0;0
9435;-1;94;70;24;1;23;.958;3600000;0
9437;220831;89;66;22;2;20;.909;3600000;0
9437;210471;89;0;0;0;0;.00nan;0;0
9437;210603;104;43;7;2;5;.714;702000;0
9437;210930;104;68;44;5;39;.886;2898000;0
9439;209784;91;56;26;3;23;.885;3600000;0
9439;205429;91;0;0;0;0;.00nan;0;0
9439;210923;102;0;0;0;0;.00nan;0;0
9439;-1;102;64;37;4;33;.892;3548000;0
9441;213659;93;0;0;0;0;.00nan;0;0
9441;215735;93;60;27;3;24;.889;3577000;0
9441;212343;96;0;0;0;0;.00nan;0;0
9441;-1;96;67;28;2;26;.929;3600000;0
9443;210439;98;74;35;3;32;.914;3600000;0
9443;210503;98;0;0;0;0;.00nan;0;0
9443;217437;88;39;27;5;22;.815;3554000;0
9443;-1;88;0;0;0;0;.00nan;0;0
9445;210222;90;0;0;0;0;.00nan;0;0
9445;210968;86;77;26;1;25;.962;3600000;0
9445;222755;86;0;0;0;0;.00nan;0;0
9445;-1;90;93;45;2;43;.956;3582000;0
9447;215769;97;0;0;0;0;.00nan;0;0
9447;212354;97;67;42;4;38;.905;3558000;0
9447;217437;88;75;28;2;26;.929;3600000;0
9447;-1;88;0;0;0;0;.00nan;0;0
9449;208417;101;77;44;4;40;.909;3599000;0
9449;213668;95;0;0;0;0;.00nan;0;0
9449;216150;101;0;0;0;0;.00nan;0;0
9449;212487;95;53;19;2;17;.895;3600000;0
9451;209784;91;99;52;1;51;.981;3600000;0
9451;215575;100;0;0;0;0;.00nan;0;0
9451;205429;91;0;0;0;0;.00nan;0;0
9451;212368;100;67;23;2;21;.913;3571000;0
9453;220924;87;0;0;0;0;.00nan;0;0
9453;215733;99;0;0;0;0;.00nan;0;0
9453;218786;99;49;20;3;17;.850;3542000;0
9453;-1;87;87;35;1;34;.971;3600000;0
9455;220831;89;0;0;0;0;.00nan;0;0
9455;210471;89;61;28;3;25;.893;3600000;0
9455;210923;102;47;41;6;35;.854;3177000;0
9455;-1;102;54;4;0;4;1.000;423000;0
9457;213659;93;36;33;6;27;.818;2987000;0
9457;210222;90;32;15;4;11;.733;3600000;0
9457;215735;93;45;5;1;4;.800;613000;0
9457;-1;90;0;0;0;0;.00nan;0;0
9459;210368;106;63;40;4;36;.900;3900000;0
9459;210428;103;60;29;4;25;.862;3900000;0
9459;-1;103;0;0;0;0;.00nan;0;0
9459;-1;106;0;0;0;0;.00nan;0;0
9461;215785;94;71;23;2;21;.913;3600000;0
9461;212343;96;60;36;4;32;.889;3518000;0
9461;-1;96;0;0;0;0;.00nan;0;0
9461;-1;94;0;0;0;0;.00nan;0;0
9463;210271;105;0;0;0;0;.00nan;0;0
9463;210521;105;61;23;2;21;.913;3600000;0
9463;212301;92;0;0;0;0;.00nan;0;0
9463;-1;92;66;32;3;29;.906;3600000;0
9465;210603;104;84;48;3;45;.938;3900000;0
9465;210930;104;0;0;0;0;.00nan;0;0
9465;210968;86;0;0;0;0;.00nan;0;0
9465;222755;86;59;27;3;24;.889;3900000;0
9467;209796;107;75;39;3;36;.923;3835000;0
9467;210426;107;0;0;0;0;.00nan;0;0
9467;210439;98;60;28;2;26;.929;3835000;0
9467;210503;98;0;0;0;0;.00nan;0;0
9469;215769;97;65;26;2;24;.923;3600000;0
9469;212354;97;0;0;0;0;.00nan;0;0
9469;217437;88;0;0;0;0;.00nan;0;0
9469;-1;88;59;37;4;33;.892;3539000;0
9471;209796;107;0;0;0;0;.00nan;0;0
9471;210368;106;0;0;0;0;.00nan;0;0
9471;210426;107;35;27;5;22;.815;3600000;0
9471;-1;106;84;25;1;24;.960;3600000;0
9473;213668;95;81;42;3;39;.929;3600000;0
9473;210968;86;83;19;0;19;1.000;3600000;0
9473;212487;95;0;0;0;0;.00nan;0;0
9473;222755;86;0;0;0;0;.00nan;0;0
9475;208417;101;48;8;1;7;.875;1227000;0
9475;215733;99;40;26;5;21;.808;3600000;0
9475;216150;101;47;35;6;29;.829;2331000;0
9475;218786;99;0;0;0;0;.00nan;0;0
9477;210222;90;0;0;0;0;.00nan;0;0
9477;210923;102;0;0;0;0;.00nan;0;0
9477;-1;90;32;25;5;20;.800;3600000;0
9477;-1;102;97;34;1;33;.971;3600000;0
9479;210271;105;76;20;1;19;.950;3600000;0
9479;220924;87;39;40;6;34;.850;3331000;0
9479;210521;105;0;0;0;0;.00nan;0;0
9479;-1;87;58;6;0;6;1.000;269000;0
9481;215575;100;100;29;0;29;1.000;3600000;0
9481;215785;94;0;0;0;0;.00nan;0;0
9481;212368;100;0;0;0;0;.00nan;0;0
9481;-1;94;63;36;4;32;.889;3600000;0
9483;220831;89;61;27;3;24;.889;3600000;0
9483;210471;89;0;0;0;0;.00nan;0;0
9483;212343;96;0;0;0;0;.00nan;0;0
9483;-1;96;39;33;6;27;.818;3600000;0
9485;209784;91;0;0;0;0;.00nan;0;0
9485;210428;103;0;0;0;0;.00nan;0;0
9485;205429;91;45;26;4;22;.846;3600000;0
9485;-1;103;67;29;3;26;.897;3600000;0
9487;210439;98;0;0;0;0;.00nan;0;0
9487;210503;98;35;30;5;25;.833;3519000;0
9487;210603;104;0;0;0;0;.00nan;0;0
9487;210930;104;69;35;3;32;.914;3600000;0
9489;213659;93;61;31;3;28;.903;3061000;0
9489;215735;93;30;11;3;8;.727;539000;0
9489;212301;92;81;26;1;25;.962;3600000;0
9489;-1;92;0;0;0;0;.00nan;0;0
9491;215733;99;0;0;0;0;.00nan;0;0
9491;212301;92;0;0;0;0;.00nan;0;0
9491;218786;99;71;8;0;8;1.000;3600000;0
9491;-1;92;97;51;1;50;.980;3589000;0
9493;210271;105;0;0;0;0;.00nan;0;0
9493;210439;98;19;25;6;19;.760;2609000;0
9493;210503;98;38;7;2;5;.714;991000;0
9493;210521;105;93;30;1;29;.967;3600000;0
9495;210222;90;44;28;5;23;.821;3584000;0
9495;220924;87;0;0;0;0;.00nan;0;0
9495;-1;90;0;0;0;0;.00nan;0;0
9495;-1;87;95;46;3;43;.935;3600000;0
9497;215575;100;71;36;3;33;.917;3553000;0
9497;215785;94;66;23;2;21;.913;3600000;0
9497;212368;100;0;0;0;0;.00nan;0;0
9497;-1;94;0;0;0;0;.00nan;0;0
9499;209784;91;65;33;3;30;.909;3600000;0
9499;210368;106;74;40;4;36;.900;3600000;0
9499;205429;91;0;0;0;0;.00nan;0;0
9499;-1;106;0;0;0;0;.00nan;0;0
9501;210428;103;51;41;6;35;.854;3600000;0
9501;210603;104;53;23;3;20;.870;3600000;0
9501;210930;104;0;0;0;0;.00nan;0;0
9501;-1;103;0;0;0;0;.00nan;0;0
9503;215769;97;0;0;0;0;.00nan;0;0
9503;210923;102;48;28;4;24;.857;3900000;0
9503;212354;97;77;45;4;41;.911;3900000;0
9503;-1;102;0;0;0;0;.00nan;0;0
9505;208417;101;89;50;3;47;.940;3595000;0
9505;210968;86;62;14;1;13;.929;3600000;0
9505;216150;101;0;0;0;0;.00nan;0;0
9505;222755;86;0;0;0;0;.00nan;0;0
9507;213659;93;67;40;4;36;.900;3600000;0
9507;220831;89;24;13;4;9;.692;1215000;0
9507;210471;89;44;19;4;15;.789;2385000;0
9507;215735;93;0;0;0;0;.00nan;0;0
9509;212343;96;27;17;4;13;.765;822000;0
9509;217437;88;99;24;0;24;1.000;3600000;0
9509;-1;88;0;0;0;0;.00nan;0;0
9509;-1;96;50;26;3;23;.885;2778000;0
9511;213668;95;0;0;0;0;.00nan;0;0
9511;209796;107;57;37;5;32;.865;3853000;0
9511;210426;107;0;0;0;0;.00nan;0;0
9511;212487;95;63;42;4;38;.905;3853000;0
9513;213668;95;75;42;3;39;.929;3600000;0
9513;210968;86;0;0;0;0;.00nan;0;0
9513;212487;95;0;0;0;0;.00nan;0;0
9513;222755;86;86;17;0;17;1.000;3600000;0
9515;209796;107;0;0;0;0;.00nan;0;0
9515;220831;89;0;0;0;0;.00nan;0;0
9515;210426;107;89;68;5;63;.926;3600000;0
9515;210471;89;53;12;1;11;.917;3600000;0
9517;215575;100;0;0;0;0;.00nan;0;0
9517;220924;87;66;33;2;31;.939;3515000;0
9517;212368;100;98;27;0;27;1.000;3600000;0
9517;-1;87;0;0;0;0;.00nan;0;0
9519;208417;101;0;0;0;0;.00nan;0;0
9519;210428;103;0;0;0;0;.00nan;0;0
9519;216150;101;54;27;3;24;.889;3600000;0
9519;-1;103;88;17;0;17;1.000;3600000;0
9521;215733;99;65;22;2;20;.909;3900000;0
9521;212343;96;88;38;2;36;.947;3900000;0
9521;218786;99;0;0;0;0;.00nan;0;0
9521;-1;96;0;0;0;0;.00nan;0;0
9523;210603;104;0;0;0;0;.00nan;0;0
9523;210930;104;44;31;5;26;.839;3600000;0
9523;212301;92;72;31;2;29;.935;3600000;0
9523;-1;92;0;0;0;0;.00nan;0;0
9525;215785;94;0;0;0;0;.00nan;0;0
9525;217437;88;45;40;7;33;.825;3127000;0
9525;-1;88;55;4;0;4;1.000;473000;0
9525;-1;94;56;16;2;14;.875;3600000;0
9527;209784;91;0;0;0;0;.00nan;0;0
9527;205429;91;74;29;2;27;.931;3558000;0
9527;210923;102;0;0;0;0;.00nan;0;0
9527;-1;102;99;37;1;36;.973;3600000;0
9529;210222;90;0;0;0;0;.00nan;0;0
9529;210439;98;0;0;0;0;.00nan;0;0
9529;210503;98;93;37;1;36;.973;3600000;0
9529;-1;90;32;10;3;7;.700;3542000;0
9531;213659;93;0;0;0;0;.00nan;0;0
9531;210368;106;0;0;0;0;.00nan;0;0
9531;215735;93;59;35;4;31;.886;3558000;0
9531;-1;106;54;17;2;15;.882;3600000;0
9533;210271;105;72;42;4;38;.905;3600000;0
9533;210521;105;0;0;0;0;.00nan;0;0
9533;215769;97;100;43;0;43;1.000;3600000;0
9533;212354;97;0;0;0;0;.00nan;0;0
1729;220699;89;69;21;1;20;.952;3600000;0
1729;210471;89;0;0;0;0;.00nan;0;0
1729;220924;87;0;0;0;0;.00nan;0;0
1729;-1;87;74;30;2;28;.933;3547000;0
1730;210222;90;44;26;5;21;.808;3600000;0
1730;217437;88;47;36;6;30;.833;3600000;0
1730;-1;90;0;0;0;0;.00nan;0;0
1730;-1;88;0;0;0;0;.00nan;0;0
1731;209784;91;45;31;5;26;.839;3600000;0
1731;205429;91;0;0;0;0;.00nan;0;0
1731;210968;86;75;27;2;25;.926;3600000;0
1731;222755;86;0;0;0;0;.00nan;0;0
1732;215769;97;0;0;0;0;.00nan;0;0
1732;212343;96;90;39;2;37;.949;3600000;0
1732;212354;97;14;37;8;29;.784;3600000;0
1732;-1;96;0;0;0;0;.00nan;0;0
1733;210439;98;66;42;5;37;.881;3578000;0
1733;215575;100;55;16;3;13;.813;3600000;0
1733;210503;98;0;0;0;0;.00nan;0;0
1733;212368;100;0;0;0;0;.00nan;0;0
1734;208417;101;56;34;4;30;.882;3564000;0
1734;210923;102;82;39;3;36;.923;3600000;0
1734;216150;101;0;0;0;0;.00nan;0;0
1734;-1;102;0;0;0;0;.00nan;0;0
1735;215733;99;0;0;0;0;.00nan;0;0
1735;215785;94;31;26;6;20;.769;3561000;0
1735;218786;99;76;42;4;38;.905;3600000;0
1735;-1;94;0;0;0;0;.00nan;0;0
1736;210271;105;69;25;2;23;.920;3600000;0
1736;210428;103;53;44;6;38;.864;3600000;0
1736;210521;105;0;0;0;0;.00nan;0;0
1736;-1;103;0;0;0;0;.00nan;0;0
1737;220699;89;51;23;3;20;.870;3600000;0
1737;210471;89;0;0;0;0;.00nan;0;0
1737;220924;87;0;0;0;0;.00nan;0;0
1737;-1;87;66;40;4;36;.900;3546000;0
1738;210222;90;72;26;2;24;.923;3600000;0
1738;217437;88;79;35;3;32;.914;3543000;0
1738;-1;90;0;0;0;0;.00nan;0;0
1738;-1;88;0;0;0;0;.00nan;0;0
1739;209784;91;47;18;3;15;.833;1037000;0
1739;205429;91;24;33;6;27;.818;2563000;0
1739;210968;86;45;27;4;23;.852;3600000;0
1739;222755;86;0;0;0;0;.00nan;0;0
1740;215769;97;77;22;1;21;.955;2487000;0
1740;212343;96;31;29;6;23;.793;3546000;0
1740;212354;97;27;14;4;10;.714;1113000;0
1740;-1;96;0;0;0;0;.00nan;0;0
1741;210439;98;100;46;2;44;.957;3600000;0
1741;215575;100;67;29;3;26;.897;3572000;0
1741;210503;98;0;0;0;0;.00nan;0;0
1741;212368;100;0;0;0;0;.00nan;0;0
1742;208417;101;18;28;6;22;.786;3088000;0
1742;210923;102;73;39;3;36;.923;3600000;0
1742;216150;101;53;3;0;3;1.000;512000;0
1742;-1;102;0;0;0;0;.00nan;0;0
1743;215733;99;0;0;0;0;.00nan;0;0
1743;215785;94;78;28;2;26;.929;3600000;0
1743;218786;99;43;37;6;31;.838;3600000;0
1743;-1;94;0;0;0;0;.00nan;0;0
1744;210271;105;78;28;2;26;.929;3600000;0
1744;210428;103;100;48;1;47;.979;3600000;0
1744;210521;105;0;0;0;0;.00nan;0;0
1744;-1;103;0;0;0;0;.00nan;0;0
1745;220699;89;45;27;4;23;.852;3600000;0
1745;210471;89;0;0;0;0;.00nan;0;0
1745;220924;87;0;0;0;0;.00nan;0;0
1745;-1;87;100;43;1;42;.977;3600000;0
1746;210222;90;68;30;3;27;.900;3600000;0
1746;217437;88;76;23;1;22;.957;3600000;0
1746;-1;90;0;0;0;0;.00nan;0;0
1746;-1;88;0;0;0;0;.00nan;0;0
1747;209784;91;0;0;0;0;.00nan;0;0
1747;205429;91;58;25;2;23;.920;3600000;0
1747;210968;86;54;38;4;34;.895;3557000;0
1747;222755;86;0;0;0;0;.00nan;0;0
1748;215769;97;0;0;0;0;.00nan;0;0
1748;212343;96;57;32;4;28;.875;3559000;0
1748;212354;97;95;39;2;37;.949;3600000;0
1748;-1;96;0;0;0;0;.00nan;0;0
1749;210439;98;80;46;5;41;.891;3600000;0
1749;215575;100;53;23;3;20;.870;3600000;0
1749;210503;98;0;0;0;0;.00nan;0;0
1749;212368;100;0;0;0;0;.00nan;0;0
1750;208417;101;85;27;1;26;.963;3600000;0
1750;210923;102;46;23;4;19;.826;3600000;0
1750;216150;101;0;0;0;0;.00nan;0;0
1750;-1;102;0;0;0;0;.00nan;0;0
1751;215733;99;0;0;0;0;.00nan;0;0
1751;215785;94;41;27;5;22;.815;3600000;0
1751;218786;99;79;32;2;30;.938;3600000;0
1751;-1;94;0;0;0;0;.00nan;0;0
1752;210271;105;65;25;2;23;.920;3600000;0
1752;210428;103;45;35;6;29;.829;3600000;0
1752;210521;105;0;0;0;0;.00nan;0;0
1752;-1;103;0;0;0;0;.00nan;0;0
1753;220699;89;54;15;2;13;.867;3562000;0
1753;210471;89;0;0;0;0;.00nan;0;0
1753;220924;87;0;0;0;0;.00nan;0;0
1753;-1;87;83;26;1;25;.962;3600000;0
1754;210222;90;25;20;5;15;.750;3563000;0
1754;217437;88;80;45;4;41;.911;3600000;0
1754;-1;90;0;0;0;0;.00nan;0;0
1754;-1;88;0;0;0;0;.00nan;0;0
1755;209784;91;0;0;0;0;.00nan;0;0
1755;205429;91;41;37;6;31;.838;3584000;0
1755;210968;86;59;34;5;29;.853;3600000;0
1755;222755;86;0;0;0;0;.00nan;0;0
1756;215769;97;0;0;0;0;.00nan;0;0
1756;212343;96;50;28;4;24;.857;3529000;0
1756;212354;97;75;32;2;30;.938;3600000;0
1756;-1;96;0;0;0;0;.00nan;0;0
1757;210439;98;40;30;5;25;.833;3600000;0
1757;215575;100;65;24;2;22;.917;3600000;0
1757;210503;98;0;0;0;0;.00nan;0;0
1757;212368;100;0;0;0;0;.00nan;0;0
1758;208417;101;44;27;4;23;.852;3600000;0
1758;210923;102;90;31;1;30;.968;3600000;0
1758;216150;101;0;0;0;0;.00nan;0;0
1758;-1;102;0;0;0;0;.00nan;0;0
1759;215733;99;0;0;0;0;.00nan;0;0
1759;215785;94;69;34;4;30;.882;3565000;0
1759;218786;99;72;27;3;24;.889;3600000;0
1759;-1;94;0;0;0;0;.00nan;0;0
1760;210271;105;76;28;2;26;.929;3600000;0
1760;210428;103;23;21;5;16;.762;2128000;0
1760;210521;105;0;0;0;0;.00nan;0;0
1760;-1;103;47;22;3;19;.864;1472000;0
1908;220699;89;72;24;2;22;.917;3600000;0
1908;210471;89;0;0;0;0;.00nan;0;0
1908;220924;87;0;0;0;0;.00nan;0;0
1908;-1;87;40;31;5;26;.839;3600000;0
1909;210222;90;76;23;1;22;.957;3600000;0
1909;217437;88;75;41;4;37;.902;3600000;0
1909;-1;90;0;0;0;0;.00nan;0;0
1909;-1;88;0;0;0;0;.00nan;0;0
1910;209784;91;0;0;0;0;.00nan;0;0
1910;205429;91;73;24;2;22;.917;3600000;0
1910;210968;86;51;34;5;29;.853;3600000;0
1910;222755;86;0;0;0;0;.00nan;0;0
1911;215769;97;0;0;0;0;.00nan;0;0
1911;212343;96;47;37;5;32;.865;3590000;0
1911;212354;97;91;45;3;42;.933;3600000;0
1911;-1;96;0;0;0;0;.00nan;0;0
1912;210439;98;65;43;5;38;.884;3600000;0
1912;215575;100;56;18;2;16;.889;3600000;0
1912;210503;98;0;0;0;0;.00nan;0;0
1912;212368;100;0;0;0;0;.00nan;0;0
1913;208417;101;64;30;3;27;.900;3600000;0
1913;210923;102;59;31;4;27;.871;3600000;0
1913;216150;101;0;0;0;0;.00nan;0;0
1913;-1;102;0;0;0;0;.00nan;0;0
1914;215733;99;0;0;0;0;.00nan;0;0
1914;215785;94;63;38;5;33;.868;3551000;0
1914;218786;99;79;41;4;37;.902;3600000;0
1914;-1;94;0;0;0;0;.00nan;0;0
1915;210271;105;81;29;2;27;.931;3715000;0
1915;210428;103;60;26;3;23;.885;3715000;0
1915;210521;105;0;0;0;0;.00nan;0;0
1915;-1;103;0;0;0;0;.00nan;0;0
1972;220699;89;62;20;2;18;.900;3600000;0
1972;210471;89;0;0;0;0;.00nan;0;0
1972;220924;87;0;0;0;0;.00nan;0;0
1972;-1;87;31;25;5;20;.800;3600000;0
1973;210222;90;63;33;3;30;.909;4884000;0
1973;217437;88;82;44;2;42;.955;4884000;0
1973;-1;90;0;0;0;0;.00nan;0;0
1973;-1;88;0;0;0;0;.00nan;0;0
1974;209784;91;49;14;2;12;.857;1537000;0
1974;205429;91;19;25;6;19;.760;2063000;0
1974;210968;86;52;32;4;28;.875;3600000;0
1974;222755;86;0;0;0;0;.00nan;0;0
1975;208417;101;32;23;5;18;.783;3551000;0
1975;210923;102;88;42;3;39;.929;3600000;0
1975;216150;101;0;0;0;0;.00nan;0;0
1975;-1;102;0;0;0;0;.00nan;0;0
2000;210222;90;13;14;5;9;.643;1847000;0
2000;217437;88;59;32;4;28;.875;3600000;0
2000;-1;90;63;16;1;15;.938;1666000;0
2000;-1;88;0;0;0;0;.00nan;0;0
2086;220699;89;59;17;2;15;.882;3600000;0
2086;210471;89;0;0;0;0;.00nan;0;0
2086;217437;88;48;38;6;32;.842;3600000;0
2086;-1;88;0;0;0;0;.00nan;0;0
2087;215769;97;0;0;0;0;.00nan;0;0
2087;210968;86;27;27;6;21;.778;3600000;0
2087;212354;97;57;24;3;21;.875;3600000;0
2087;222755;86;0;0;0;0;.00nan;0;0
2088;215575;100;56;22;3;19;.864;3553000;0
2088;210923;102;74;32;2;30;.938;3600000;0
2088;212368;100;0;0;0;0;.00nan;0;0
2088;-1;102;0;0;0;0;.00nan;0;0
2089;210271;105;62;32;3;29;.906;3554000;0
2089;210521;105;0;0;0;0;.00nan;0;0
2089;215733;99;0;0;0;0;.00nan;0;0
2089;218786;99;63;24;2;22;.917;3600000;0
2090;220699;89;61;24;2;22;.917;3600000;0
2090;210471;89;0;0;0;0;.00nan;0;0
2090;217437;88;65;38;5;33;.868;3600000;0
2090;-1;88;0;0;0;0;.00nan;0;0
2091;215769;97;0;0;0;0;.00nan;0;0
2091;210968;86;93;46;3;43;.935;3600000;0
2091;212354;97;41;34;5;29;.853;3552000;0
2091;222755;86;0;0;0;0;.00nan;0;0
2092;215575;100;74;18;1;17;.944;3600000;0
2092;210923;102;57;48;6;42;.875;3600000;0
2092;212368;100;0;0;0;0;.00nan;0;0
2092;-1;102;0;0;0;0;.00nan;0;0
2093;210271;105;73;41;4;37;.902;3550000;0
2093;210521;105;0;0;0;0;.00nan;0;0
2093;215733;99;0;0;0;0;.00nan;0;0
2093;218786;99;65;27;3;24;.889;3600000;0
2094;220699;89;48;23;4;19;.826;3573000;0
2094;210471;89;0;0;0;0;.00nan;0;0
2094;217437;88;80;33;2;31;.939;3600000;0
2094;-1;88;0;0;0;0;.00nan;0;0
2095;215769;97;0;0;0;0;.00nan;0;0
2095;210968;86;36;36;6;30;.833;3600000;0
2095;212354;97;65;30;3;27;.900;3600000;0
2095;222755;86;0;0;0;0;.00nan;0;0
2096;215575;100;54;35;4;31;.886;3553000;0
2096;210923;102;55;21;2;19;.905;3600000;0
2096;212368;100;0;0;0;0;.00nan;0;0
2096;-1;102;0;0;0;0;.00nan;0;0
2097;210271;105;68;35;4;31;.886;3530000;0
2097;210521;105;0;0;0;0;.00nan;0;0
2097;215733;99;0;0;0;0;.00nan;0;0
2097;218786;99;65;25;2;23;.920;3600000;0
2098;220699;89;76;30;2;28;.933;3600000;0
2098;210471;89;0;0;0;0;.00nan;0;0
2098;217437;88;73;37;3;34;.919;3600000;0
2098;-1;88;0;0;0;0;.00nan;0;0
2099;215769;97;0;0;0;0;.00nan;0;0
2099;210968;86;85;35;2;33;.943;3600000;0
2099;212354;97;54;26;3;23;.885;3551000;0
2099;222755;86;0;0;0;0;.00nan;0;0
2100;215575;100;87;26;1;25;.962;3600000;0
2100;210923;102;88;40;2;38;.950;3600000;0
2100;212368;100;0;0;0;0;.00nan;0;0
2100;-1;102;0;0;0;0;.00nan;0;0
2101;210271;105;86;34;2;32;.941;3600000;0
2101;210521;105;0;0;0;0;.00nan;0;0
2101;215733;99;0;0;0;0;.00nan;0;0
2101;218786;99;74;38;3;35;.921;3544000;0
2318;220699;89;73;25;2;23;.920;3600000;0
2318;210471;89;0;0;0;0;.00nan;0;0
2318;217437;88;1;39;10;29;.744;2899000;0
2318;-1;88;54;3;0;3;1.000;701000;0
2319;215769;97;0;0;0;0;.00nan;0;0
2319;210968;86;52;33;4;29;.879;4175000;0
2319;212354;97;62;32;3;29;.906;4194000;0
2319;222755;86;0;0;0;0;.00nan;0;0
2320;215575;100;79;19;1;18;.947;3600000;0
2320;210923;102;66;38;4;34;.895;3600000;0
2320;212368;100;0;0;0;0;.00nan;0;0
2320;-1;102;0;0;0;0;.00nan;0;0
2321;210271;105;66;30;3;27;.900;3515000;0
2321;210521;105;0;0;0;0;.00nan;0;0
2321;215733;99;0;0;0;0;.00nan;0;0
2321;218786;99;76;25;1;24;.960;3600000;0
2391;215769;97;0;0;0;0;.00nan;0;0
2391;210968;86;50;25;3;22;.880;3596000;0
2391;212354;97;65;23;2;21;.913;3600000;0
2391;222755;86;0;0;0;0;.00nan;0;0
2392;215575;100;29;25;6;19;.760;4065000;0
2392;210923;102;56;51;7;44;.863;4065000;0
2392;212368;100;0;0;0;0;.00nan;0;0
2392;-1;102;0;0;0;0;.00nan;0;0
2439;220699;89;99;35;1;34;.971;3600000;0
2439;210471;89;0;0;0;0;.00nan;0;0
2439;215769;97;0;0;0;0;.00nan;0;0
2439;212354;97;72;28;2;26;.929;3585000;0
2440;215575;100;69;17;1;16;.941;3600000;0
2440;215733;99;0;0;0;0;.00nan;0;0
2440;212368;100;0;0;0;0;.00nan;0;0
2440;218786;99;63;27;2;25;.926;3547000;0
2441;220699;89;26;27;6;21;.778;2471000;0
2441;210471;89;48;6;1;5;.833;1129000;0
2441;215769;97;0;0;0;0;.00nan;0;0
2441;212354;97;78;36;2;34;.944;3600000;0
2442;215575;100;59;25;3;22;.880;3600000;0
2442;215733;99;51;2;0;2;1.000;303000;0
2442;212368;100;0;0;0;0;.00nan;0;0
2442;218786;99;18;37;8;29;.784;3297000;0
2443;220699;89;1;17;7;10;.588;3567000;0
2443;210471;89;0;0;0;0;.00nan;0;0
2443;215769;97;0;0;0;0;.00nan;0;0
2443;212354;97;80;45;4;41;.911;3600000;0
2444;215575;100;67;23;2;21;.913;3600000;0
2444;215733;99;55;28;3;25;.893;3600000;0
2444;212368;100;0;0;0;0;.00nan;0;0
2444;218786;99;0;0;0;0;.00nan;0;0
2445;220699;89;47;32;4;28;.875;4164000;0
2445;210471;89;0;0;0;0;.00nan;0;0
2445;215769;97;0;0;0;0;.00nan;0;0
2445;212354;97;68;49;5;44;.898;4164000;0
2446;215575;100;57;21;2;19;.905;3600000;0
2446;215733;99;59;41;5;36;.878;3600000;0
2446;212368;100;0;0;0;0;.00nan;0;0
2446;218786;99;0;0;0;0;.00nan;0;0
2564;220699;89;54;28;4;24;.857;3600000;0
2564;210471;89;0;0;0;0;.00nan;0;0
2564;215769;97;0;0;0;0;.00nan;0;0
2564;212354;97;45;31;5;26;.839;3563000;0
2569;220699;89;42;25;4;21;.840;3671000;0
2569;210471;89;0;0;0;0;.00nan;0;0
2569;215769;97;0;0;0;0;.00nan;0;0
2569;212354;97;58;35;5;30;.857;3671000;0
2581;220699;89;46;32;5;27;.844;3587000;0
2581;215575;100;47;25;4;21;.840;3600000;0
2581;210471;89;0;0;0;0;.00nan;0;0
2581;212368;100;0;0;0;0;.00nan;0;0
2582;220699;89;25;28;6;22;.786;3600000;0
2582;215575;100;89;40;2;38;.950;3600000;0
2582;210471;89;0;0;0;0;.00nan;0;0
2582;212368;100;0;0;0;0;.00nan;0;0
2583;220699;89;77;24;1;23;.958;3583000;0
2583;215575;100;95;22;0;22;1.000;3600000;0
2583;210471;89;0;0;0;0;.00nan;0;0
2583;212368;100;0;0;0;0;.00nan;0;0
2584;220699;89;48;33;4;29;.879;3600000;0
2584;215575;100;25;25;6;19;.760;3512000;0
2584;210471;89;0;0;0;0;.00nan;0;0
2584;212368;100;0;0;0;0;.00nan;0;0
2737;220699;89;100;36;1;35;.972;3600000;0
2737;215575;100;68;35;4;31;.886;3600000;0
2737;210471;89;0;0;0;0;.00nan;0;0
2737;212368;100;0;0;0;0;.00nan;0;0
2752;220699;89;63;25;3;22;.880;3600000;0
2752;215575;100;73;36;4;32;.889;3579000;0
2752;210471;89;0;0;0;0;.00nan;0;0
2752;212368;100;0;0;0;0;.00nan;0;0
2765;220699;89;70;32;3;29;.906;3600000;0
2765;215575;100;51;32;4;28;.875;3568000;0
2765;210471;89;0;0;0;0;.00nan;0;0
2765;212368;100;0;0;0;0;.00nan;0;0
9534;213799;140;55;22;3;19;.864;3600000;0
9534;215246;143;0;0;0;0;.00nan;0;0
9534;220672;140;0;0;0;0;.00nan;0;0
9534;216130;143;77;45;4;41;.911;3600000;0
9535;215128;141;0;0;0;0;.00nan;0;0
9535;210004;141;77;49;4;45;.918;3600000;0
9535;210213;139;0;0;0;0;.00nan;0;0
9535;221361;139;81;25;1;24;.960;3600000;0
9536;208575;142;0;0;0;0;.00nan;0;0
9536;215331;144;52;9;1;8;.889;723000;0
9536;217769;142;70;24;1;23;.958;3600000;0
9536;223946;144;39;33;6;27;.818;2877000;0
9537;220575;134;67;35;4;31;.886;3600000;0
9537;225725;136;67;46;5;41;.891;3582000;0
9537;210876;134;0;0;0;0;.00nan;0;0
9537;-1;136;0;0;0;0;.00nan;0;0
9538;215217;1340;64;33;3;30;.909;3600000;0
9538;225734;131;66;33;4;29;.879;3600000;0
9538;211984;131;0;0;0;0;.00nan;0;0
9538;-1;1340;0;0;0;0;.00nan;0;0
9539;212166;128;90;35;2;33;.943;3600000;0
9539;212529;128;0;0;0;0;.00nan;0;0
9539;-1;130;39;19;4;15;.789;3517000;0
9539;-1;130;0;0;0;0;.00nan;0;0
9540;220566;138;0;0;0;0;.00nan;0;0
9540;210060;137;0;0;0;0;.00nan;0;0
9540;223929;138;68;25;3;22;.880;3600000;0
9540;-1;137;95;53;4;49;.925;3600000;0
9541;208556;135;100;29;1;28;.966;3900000;0
9541;210060;137;0;0;0;0;.00nan;0;0
9541;-1;135;0;0;0;0;.00nan;0;0
9541;-1;137;98;35;1;34;.971;3900000;0
9542;213756;132;0;0;0;0;.00nan;0;0
9542;220511;132;59;17;2;15;.882;3600000;0
9542;209998;129;44;23;4;19;.826;899000;0
9542;215319;129;77;32;2;30;.938;2701000;0
9543;219003;133;0;0;0;0;.00nan;0;0
9543;212166;128;80;30;2;28;.933;2948000;0
9543;212529;128;32;7;3;4;.571;566000;0
9543;-1;133;53;24;3;21;.875;3600000;0
9544;215128;141;0;0;0;0;.00nan;0;0
9544;210004;141;59;32;4;28;.875;3519000;0
9544;210213;139;86;36;2;34;.944;3600000;0
9544;221361;139;0;0;0;0;.00nan;0;0
9545;208575;142;71;25;1;24;.960;3600000;0
9545;215331;144;48;0;0;0;.00nan;370000;0
9545;217769;142;0;0;0;0;.00nan;0;0
9545;223946;144;23;32;7;25;.781;3230000;0
9546;213799;140;48;0;0;0;.00nan;537000;0
9546;215246;143;61;37;4;33;.892;3600000;0
9546;220672;140;34;33;6;27;.818;3001000;0
9546;216130;143;0;0;0;0;.00nan;0;0
9547;208556;135;0;0;0;0;.00nan;0;0
9547;225725;136;38;31;6;25;.806;2810000;0
9547;-1;136;60;9;0;9;1.000;790000;0
9547;-1;135;47;23;3;20;.870;3600000;0
9548;219003;133;33;21;4;17;.810;2591000;0
9548;-1;133;37;19;4;15;.789;1009000;0
9548;-1;130;0;0;0;0;.00nan;0;0
9548;-1;130;76;33;2;31;.939;3600000;0
9549;213756;132;85;25;1;24;.960;3600000;0
9549;220511;132;0;0;0;0;.00nan;0;0
9549;209998;129;58;45;5;40;.889;3600000;0
9549;215319;129;0;0;0;0;.00nan;0;0
9550;220566;138;0;0;0;0;.00nan;0;0
9550;225734;131;0;0;0;0;.00nan;0;0
9550;211984;131;77;42;3;39;.929;3900000;0
9550;223929;138;51;25;3;22;.880;3900000;0
9551;220575;134;56;33;4;29;.879;3552000;0
9551;215217;1340;75;33;3;30;.909;3600000;0
9551;210876;134;0;0;0;0;.00nan;0;0
9551;-1;1340;0;0;0;0;.00nan;0;0
9552;215246;143;37;35;6;29;.829;3600000;0
9552;210213;139;0;0;0;0;.00nan;0;0
9552;221361;139;70;37;3;34;.919;3600000;0
9552;216130;143;0;0;0;0;.00nan;0;0
9553;215128;141;0;0;0;0;.00nan;0;0
9553;210004;141;75;32;4;28;.875;3705000;0
9553;215331;144;0;0;0;0;.00nan;0;0
9553;223946;144;32;28;5;23;.821;3705000;0
9554;225725;136;0;0;0;0;.00nan;0;0
9554;210060;137;53;15;2;13;.867;3600000;0
9554;-1;136;56;38;5;33;.868;3600000;0
9554;-1;137;0;0;0;0;.00nan;0;0
9555;209998;129;18;22;6;16;.727;2882000;0
9555;225734;131;51;10;1;9;.900;1010000;0
9555;215319;129;59;8;0;8;1.000;1003000;0
9555;211984;131;39;38;6;32;.842;2875000;0
9556;213756;132;78;32;3;29;.906;3600000;0
9556;219003;133;32;26;5;21;.808;3514000;0
9556;220511;132;0;0;0;0;.00nan;0;0
9556;-1;133;0;0;0;0;.00nan;0;0
9557;220566;138;0;0;0;0;.00nan;0;0
9557;220575;134;35;48;8;40;.833;3600000;0
9557;210876;134;0;0;0;0;.00nan;0;0
9557;223929;138;64;17;1;16;.941;3600000;0
9558;215217;1340;0;0;0;0;.00nan;0;0
9558;212166;128;0;0;0;0;.00nan;0;0
9558;212529;128;60;32;5;27;.844;3595000;0
9558;-1;1340;68;31;4;27;.871;3600000;0
9559;208556;135;59;30;3;27;.900;2516000;0
9559;-1;130;0;0;0;0;.00nan;0;0
9559;-1;135;38;18;4;14;.778;1084000;0
9559;-1;130;66;16;1;15;.938;3600000;0
9560;225725;136;75;38;3;35;.921;3876000;0
9560;210060;137;0;0;0;0;.00nan;0;0
9560;-1;136;0;0;0;0;.00nan;0;0
9560;-1;137;61;27;2;25;.926;3876000;0
9561;213756;132;0;0;0;0;.00nan;0;0
9561;220511;132;36;33;6;27;.818;3600000;0
9561;225734;131;0;0;0;0;.00nan;0;0
9561;211984;131;82;29;1;28;.966;3600000;0
9562;208575;142;0;0;0;0;.00nan;0;0
9562;215128;141;81;35;2;33;.943;3597000;0
9562;210004;141;0;0;0;0;.00nan;0;0
9562;217769;142;80;23;1;22;.957;3600000;0
9563;213799;140;0;0;0;0;.00nan;0;0
9563;220672;140;68;34;3;31;.912;3600000;0
9563;215331;144;45;30;5;25;.833;3574000;0
9563;223946;144;0;0;0;0;.00nan;0;0
9564;215246;143;74;42;3;39;.929;3600000;0
9564;210213;139;48;36;5;31;.861;3550000;0
9564;221361;139;0;0;0;0;.00nan;0;0
9564;216130;143;0;0;0;0;.00nan;0;0
9565;219003;133;0;0;0;0;.00nan;0;0
9565;209998;129;0;0;0;0;.00nan;0;0
9565;215319;129;67;45;5;40;.889;3513000;0
9565;-1;133;58;24;3;21;.875;3600000;0
9566;213799;140;0;0;0;0;.00nan;0;0
9566;208575;142;53;23;3;20;.870;3600000;0
9566;220672;140;47;35;5;30;.857;3563000;0
9566;217769;142;0;0;0;0;.00nan;0;0
9567;215217;1340;72;43;3;40;.930;3900000;0
9567;212166;128;0;0;0;0;.00nan;0;0
9567;212529;128;60;27;3;24;.889;3900000;0
9567;-1;1340;0;0;0;0;.00nan;0;0
9568;208556;135;49;11;1;10;.909;1361000;0
9568;220566;138;0;0;0;0;.00nan;0;0
9568;223929;138;76;24;1;23;.958;3600000;0
9568;-1;135;29;27;6;21;.778;2239000;0
9569;220575;134;78;33;2;31;.939;3583000;0
9569;210876;134;0;0;0;0;.00nan;0;0
9569;-1;130;0;0;0;0;.00nan;0;0
9569;-1;130;74;23;1;22;.957;3600000;0
9570;213799;140;86;27;1;26;.963;3600000;0
9570;220672;140;0;0;0;0;.00nan;0;0
9570;215331;144;0;0;0;0;.00nan;0;0
9570;223946;144;70;29;3;26;.897;3567000;0
9571;208575;142;67;37;4;33;.892;3600000;0
9571;210213;139;0;0;0;0;.00nan;0;0
9571;221361;139;87;36;1;35;.972;3600000;0
9571;217769;142;0;0;0;0;.00nan;0;0
9572;225725;136;95;36;2;34;.944;3600000;0
9572;-1;130;0;0;0;0;.00nan;0;0
9572;-1;136;0;0;0;0;.00nan;0;0
9572;-1;130;21;21;5;16;.762;3600000;0
9573;209998;129;65;31;3;28;.903;3585000;0
9573;215217;1340;89;34;2;32;.941;3600000;0
9573;215319;129;0;0;0;0;.00nan;0;0
9573;-1;1340;0;0;0;0;.00nan;0;0
9574;220566;138;0;0;0;0;.00nan;0;0
9574;210060;137;0;0;0;0;.00nan;0;0
9574;223929;138;42;23;4;19;.826;3550000;0
9574;-1;137;81;40;3;37;.925;3600000;0
9575;215128;141;0;0;0;0;.00nan;0;0
9575;210004;141;100;27;0;27;1.000;3600000;0
9575;220575;134;96;43;2;41;.953;3532000;0
9575;210876;134;0;0;0;0;.00nan;0;0
9576;209998;129;0;0;0;0;.00nan;0;0
9576;225734;131;0;0;0;0;.00nan;0;0
9576;215319;129;99;49;1;48;.980;3600000;0
9576;211984;131;74;29;2;27;.931;3545000;0
9577;213799;140;0;0;0;0;.00nan;0;0
9577;215246;143;37;28;5;23;.821;3548000;0
9577;220672;140;73;35;3;32;.914;3600000;0
9577;216130;143;0;0;0;0;.00nan;0;0
9578;210213;139;79;37;2;35;.946;3600000;0
9578;221361;139;0;0;0;0;.00nan;0;0
9578;-1;130;0;0;0;0;.00nan;0;0
9578;-1;130;43;23;4;19;.826;3576000;0
9579;208575;142;0;0;0;0;.00nan;0;0
9579;220575;134;89;59;5;54;.915;3600000;0
9579;210876;134;0;0;0;0;.00nan;0;0
9579;217769;142;75;29;2;27;.931;3600000;0
9580;213756;132;60;26;3;23;.885;3600000;0
9580;208556;135;66;38;4;34;.895;3553000;0
9580;220511;132;0;0;0;0;.00nan;0;0
9580;-1;135;0;0;0;0;.00nan;0;0
9581;210060;137;0;0;0;0;.00nan;0;0
9581;215331;144;39;20;4;16;.800;3600000;0
9581;223946;144;0;0;0;0;.00nan;0;0
9581;-1;137;39;29;5;24;.828;3600000;0
9582;225725;136;64;38;4;34;.895;3600000;0
9582;212166;128;0;0;0;0;.00nan;0;0
9582;212529;128;56;23;3;20;.870;3600000;0
9582;-1;136;0;0;0;0;.00nan;0;0
9583;219003;133;75;26;1;25;.962;3900000;0
9583;220566;138;89;29;1;28;.966;3900000;0
9583;223929;138;0;0;0;0;.00nan;0;0
9583;-1;133;0;0;0;0;.00nan;0;0
9584;215217;1340;0;0;0;0;.00nan;0;0
9584;225734;131;82;43;4;39;.907;3679000;0
9584;211984;131;0;0;0;0;.00nan;0;0
9584;-1;1340;65;29;3;26;.897;3679000;0
9585;213756;132;0;0;0;0;.00nan;0;0
9585;208556;135;0;0;0;0;.00nan;0;0
9585;220511;132;36;24;4;20;.833;3599000;0
9585;-1;135;88;42;3;39;.929;3600000;0
9586;220566;138;0;0;0;0;.00nan;0;0
9586;215331;144;49;10;1;9;.900;452000;0
9586;223929;138;65;27;2;25;.926;3600000;0
9586;223946;144;35;31;6;25;.806;3148000;0
9587;219003;133;0;0;0;0;.00nan;0;0
9587;209998;129;30;9;3;6;.667;504000;0
9587;215319;129;52;44;6;38;.864;3096000;0
9587;-1;133;85;28;1;27;.964;3600000;0
9588;208575;142;58;44;6;38;.864;3600000;0
9588;217769;142;0;0;0;0;.00nan;0;0
9588;-1;130;78;34;3;31;.912;3600000;0
9588;-1;130;0;0;0;0;.00nan;0;0
9589;215128;141;0;0;0;0;.00nan;0;0
9589;210004;141;76;32;2;30;.938;3657000;0
9589;215246;143;0;0;0;0;.00nan;0;0
9589;216130;143;66;26;3;23;.885;3657000;0
9590;213799;140;68;32;3;29;.906;3600000;0
9590;225725;136;36;29;5;24;.828;3560000;0
9590;220672;140;0;0;0;0;.00nan;0;0
9590;-1;136;0;0;0;0;.00nan;0;0
9591;220575;134;98;67;3;64;.955;3558000;0
9591;210213;139;0;0;0;0;.00nan;0;0
9591;210876;134;0;0;0;0;.00nan;0;0
9591;221361;139;69;27;2;25;.926;3600000;0
9592;215217;1340;43;19;3;16;.842;3600000;0
9592;210060;137;0;0;0;0;.00nan;0;0
9592;-1;137;81;33;2;31;.939;3600000;0
9592;-1;1340;0;0;0;0;.00nan;0;0
9593;225734;131;0;0;0;0;.00nan;0;0
9593;211984;131;50;37;5;32;.865;3600000;0
9593;212166;128;0;0;0;0;.00nan;0;0
9593;212529;128;68;22;1;21;.955;3600000;0
9594;215128;141;84;39;3;36;.923;3563000;0
9594;210004;141;0;0;0;0;.00nan;0;0
9594;-1;130;0;0;0;0;.00nan;0;0
9594;-1;130;75;19;1;18;.947;3600000;0
9595;225725;136;0;0;0;0;.00nan;0;0
9595;215331;144;0;0;0;0;.00nan;0;0
9595;223946;144;64;39;4;35;.897;3569000;0
9595;-1;136;84;38;2;36;.947;3600000;0
9596;215217;1340;0;0;0;0;.00nan;0;0
9596;210060;137;32;33;6;27;.818;2938000;0
9596;-1;137;61;8;0;8;1.000;662000;0
9596;-1;1340;59;25;4;21;.840;3600000;0
9597;213756;132;50;24;3;21;.875;3900000;0
9597;220511;132;0;0;0;0;.00nan;0;0
9597;209998;129;94;44;3;41;.932;3890000;0
9597;215319;129;0;0;0;0;.00nan;0;0
9598;219003;133;0;0;0;0;.00nan;0;0
9598;212166;128;25;20;5;15;.750;3897000;0
9598;212529;128;0;0;0;0;.00nan;0;0
9598;-1;133;35;34;6;28;.824;3897000;0
9599;208609;131;55;31;4;27;.871;3891000;0
9599;215128;141;0;0;0;0;.00nan;0;0
9599;210004;141;74;31;3;28;.903;3891000;0
9599;211984;131;0;0;0;0;.00nan;0;0
9600;208575;142;0;0;0;0;.00nan;0;0
9600;210060;137;0;0;0;0;.00nan;0;0
9600;217769;142;69;28;3;25;.893;3647000;0
9600;-1;137;84;48;4;44;.917;3647000;0
9601;215217;1340;62;31;3;28;.903;3600000;0
9601;210213;139;43;26;4;22;.846;3558000;0
9601;221361;139;0;0;0;0;.00nan;0;0
9601;-1;1340;0;0;0;0;.00nan;0;0
9602;215246;143;49;39;6;33;.846;2801000;0
9602;216130;143;10;15;6;9;.600;799000;0
9602;-1;130;0;0;0;0;.00nan;0;0
9602;-1;130;65;22;2;20;.909;3600000;0
9603;208556;135;74;32;2;30;.938;3555000;0
9603;212166;128;0;0;0;0;.00nan;0;0
9603;212529;128;71;19;1;18;.947;3600000;0
9603;-1;135;0;0;0;0;.00nan;0;0
9604;208609;131;68;34;4;30;.882;3600000;0
9604;215331;144;0;0;0;0;.00nan;0;0
9604;211984;131;0;0;0;0;.00nan;0;0
9604;223946;144;59;25;3;22;.880;3600000;0
9605;213799;140;0;0;0;0;.00nan;0;0
9605;225725;136;59;31;4;27;.871;3587000;0
9605;220672;140;65;27;3;24;.889;3600000;0
9605;-1;136;0;0;0;0;.00nan;0;0
9606;219003;133;45;21;3;18;.857;3600000;0
9606;208556;135;0;0;0;0;.00nan;0;0
9606;-1;133;0;0;0;0;.00nan;0;0
9606;-1;135;74;52;5;47;.904;3530000;0
9607;220575;134;60;36;4;32;.889;3900000;0
9607;215217;1340;0;0;0;0;.00nan;0;0
9607;210876;134;0;0;0;0;.00nan;0;0
9607;-1;1340;67;43;4;39;.907;3900000;0
9608;208575;142;44;34;5;29;.853;3600000;0
9608;220566;138;66;18;1;17;.944;3600000;0
9608;217769;142;0;0;0;0;.00nan;0;0
9608;223929;138;0;0;0;0;.00nan;0;0
9609;213799;140;91;25;0;25;1.000;3600000;0
9609;208609;131;77;31;2;29;.935;3600000;0
9609;220672;140;0;0;0;0;.00nan;0;0
9609;211984;131;0;0;0;0;.00nan;0;0
9610;213756;132;51;32;4;28;.875;3600000;0
9610;220511;132;0;0;0;0;.00nan;0;0
9610;215246;143;81;55;5;50;.909;3600000;0
9610;216130;143;0;0;0;0;.00nan;0;0
9611;210060;137;0;0;0;0;.00nan;0;0
9611;212166;128;0;0;0;0;.00nan;0;0
9611;212529;128;100;28;0;28;1.000;3600000;0
9611;-1;137;66;28;2;26;.929;3578000;0
9612;215128;141;0;0;0;0;.00nan;0;0
9612;210004;141;78;30;2;28;.933;3600000;0
9612;215331;144;49;38;6;32;.842;3600000;0
9612;223946;144;0;0;0;0;.00nan;0;0
9613;209998;129;53;6;1;5;.833;439000;0
9613;215319;129;17;26;6;20;.769;3161000;0
9613;210213;139;0;0;0;0;.00nan;0;0
9613;221361;139;83;36;3;33;.917;3600000;0
9614;208556;135;82;49;4;45;.918;3600000;0
9614;220566;138;56;24;3;21;.875;3600000;0
9614;223929;138;0;0;0;0;.00nan;0;0
9614;-1;135;0;0;0;0;.00nan;0;0
9615;208575;142;0;0;0;0;.00nan;0;0
9615;225725;136;0;0;0;0;.00nan;0;0
9615;217769;142;52;24;3;21;.875;3600000;0
9615;-1;136;70;37;4;33;.892;3600000;0
9616;213756;132;0;0;0;0;.00nan;0;0
9616;220511;132;95;33;1;32;.970;3600000;0
9616;210213;139;35;34;6;28;.824;2451000;0
9616;221361;139;42;11;2;9;.818;1149000;0
9617;215217;1340;49;45;6;39;.867;3600000;0
9617;-1;130;70;29;2;27;.931;3600000;0
9617;-1;130;0;0;0;0;.00nan;0;0
9617;-1;1340;0;0;0;0;.00nan;0;0
9618;219003;133;0;0;0;0;.00nan;0;0
9618;212166;128;0;0;0;0;.00nan;0;0
9618;212529;128;62;43;5;38;.884;3608000;0
9618;-1;133;43;21;4;17;.810;3608000;0
9619;213799;140;0;0;0;0;.00nan;0;0
9619;215128;141;59;40;5;35;.875;3568000;0
9619;210004;141;0;0;0;0;.00nan;0;0
9619;220672;140;49;22;4;18;.818;3600000;0
9620;209998;129;40;37;6;31;.838;3600000;0
9620;215246;143;0;0;0;0;.00nan;0;0
9620;215319;129;0;0;0;0;.00nan;0;0
9620;216130;143;78;34;3;31;.912;3600000;0
9621;220575;134;38;32;6;26;.813;3750000;0
9621;210060;137;36;23;5;18;.783;3051000;0
9621;210876;134;0;0;0;0;.00nan;0;0
9621;-1;137;58;6;0;6;1.000;699000;0
9622;208556;135;0;0;0;0;.00nan;0;0
9622;-1;130;0;0;0;0;.00nan;0;0
9622;-1;135;45;30;5;25;.833;3600000;0
9622;-1;130;37;21;4;17;.810;3600000;0
9623;219003;133;39;34;6;28;.824;3600000;0
9623;215217;1340;0;0;0;0;.00nan;0;0
9623;-1;133;0;0;0;0;.00nan;0;0
9623;-1;1340;75;22;1;21;.955;3600000;0
9624;213799;140;50;45;6;39;.867;2863000;0
9624;220672;140;47;4;1;3;.750;874000;0
9624;210213;139;0;0;0;0;.00nan;0;0
9624;221361;139;25;26;6;20;.769;3737000;0
9625;209998;129;68;50;6;44;.880;3883000;0
9625;215319;129;0;0;0;0;.00nan;0;0
9625;215331;144;0;0;0;0;.00nan;0;0
9625;223946;144;54;39;5;34;.872;3883000;0
9626;208609;131;100;39;1;38;.974;3600000;0
9626;220575;134;20;28;6;22;.786;3237000;0
9626;210876;134;56;5;0;5;1.000;363000;0
9626;211984;131;0;0;0;0;.00nan;0;0
9627;220566;138;0;0;0;0;.00nan;0;0
9627;225725;136;0;0;0;0;.00nan;0;0
9627;223929;138;60;17;2;15;.882;3600000;0
9627;-1;136;40;30;5;25;.833;3600000;0
9628;213756;132;76;39;3;36;.923;3900000;0
9628;220511;132;0;0;0;0;.00nan;0;0
9628;210213;139;87;41;3;38;.927;3900000;0
9628;221361;139;0;0;0;0;.00nan;0;0
9629;208575;142;0;0;0;0;.00nan;0;0
9629;209998;129;0;0;0;0;.00nan;0;0
9629;215319;129;80;39;2;37;.949;3600000;0
9629;217769;142;91;28;1;27;.964;3600000;0
9630;208556;135;79;28;2;26;.929;3600000;0
9630;225725;136;34;28;5;23;.821;3600000;0
9630;-1;136;0;0;0;0;.00nan;0;0
9630;-1;135;0;0;0;0;.00nan;0;0
9631;219003;133;0;0;0;0;.00nan;0;0
9631;210060;137;0;0;0;0;.00nan;0;0
9631;-1;133;76;35;2;33;.943;3600000;0
9631;-1;137;51;28;4;24;.857;3547000;0
9632;215217;1340;68;31;3;28;.903;3574000;0
9632;212166;128;0;0;0;0;.00nan;0;0
9632;212529;128;100;37;1;36;.973;3600000;0
9632;-1;1340;0;0;0;0;.00nan;0;0
9633;208609;131;49;28;4;24;.857;3600000;0
9633;211984;131;0;0;0;0;.00nan;0;0
9633;-1;130;99;23;0;23;1.000;3600000;0
9633;-1;130;0;0;0;0;.00nan;0;0
9634;213799;140;27;31;7;24;.774;3197000;0
9634;220672;140;44;3;1;2;.667;360000;0
9634;215331;144;76;12;0;12;1.000;1431000;0
9634;223946;144;29;33;6;27;.818;2169000;0
9635;208556;135;50;24;4;20;.833;3524000;0
9635;220575;134;63;21;2;19;.905;3600000;0
9635;210876;134;0;0;0;0;.00nan;0;0
9635;-1;135;0;0;0;0;.00nan;0;0
9636;219003;133;57;34;4;30;.882;3900000;0
9636;220566;138;57;34;4;30;.882;3900000;0
9636;223929;138;0;0;0;0;.00nan;0;0
9636;-1;133;0;0;0;0;.00nan;0;0
9637;213756;132;0;0;0;0;.00nan;0;0
9637;208575;142;37;27;5;22;.815;3600000;0
9637;220511;132;51;38;5;33;.868;3590000;0
9637;217769;142;0;0;0;0;.00nan;0;0
9638;215128;141;0;0;0;0;.00nan;0;0
9638;210004;141;55;20;3;17;.850;3600000;0
9638;215246;143;100;47;0;47;1.000;3600000;0
9638;216130;143;0;0;0;0;.00nan;0;0
9639;209998;129;98;43;3;40;.930;3600000;0
9639;215319;129;0;0;0;0;.00nan;0;0
9639;210213;139;45;27;4;23;.852;3600000;0
9639;221361;139;0;0;0;0;.00nan;0;0
9640;213799;140;45;23;4;19;.826;3816000;0
9640;215246;143;80;46;3;43;.935;3816000;0
9640;220672;140;0;0;0;0;.00nan;0;0
9640;216130;143;0;0;0;0;.00nan;0;0
9641;215217;1340;0;0;0;0;.00nan;0;0
9641;-1;130;46;30;5;25;.833;3600000;0
9641;-1;130;0;0;0;0;.00nan;0;0
9641;-1;1340;62;36;4;32;.889;3600000;0
9642;213756;132;61;24;3;21;.875;3530000;0
9642;215128;141;93;39;1;38;.974;3600000;0
9642;220511;132;0;0;0;0;.00nan;0;0
9642;210004;141;0;0;0;0;.00nan;0;0
9643;220566;138;0;0;0;0;.00nan;0;0
9643;210060;137;0;0;0;0;.00nan;0;0
9643;223929;138;62;21;2;19;.905;3600000;0
9643;-1;137;77;46;4;42;.913;3588000;0
9644;208609;131;86;39;2;37;.949;3562000;0
9644;211984;131;0;0;0;0;.00nan;0;0
9644;212166;128;0;0;0;0;.00nan;0;0
9644;212529;128;68;17;1;16;.941;3600000;0
9645;220575;134;0;0;0;0;.00nan;0;0
9645;225725;136;0;0;0;0;.00nan;0;0
9645;210876;134;63;26;3;23;.885;3900000;0
9645;-1;136;68;32;3;29;.906;3900000;0
9646;208575;142;0;0;0;0;.00nan;0;0
9646;215128;141;0;0;0;0;.00nan;0;0
9646;210004;141;38;25;4;21;.840;3543000;0
9646;217769;142;80;37;3;34;.919;3600000;0
9647;220575;134;49;36;5;31;.861;3553000;0
9647;210060;137;0;0;0;0;.00nan;0;0
9647;210876;134;0;0;0;0;.00nan;0;0
9647;-1;137;61;33;4;29;.879;3600000;0
9648;220566;138;91;27;1;26;.963;3600000;0
9648;225725;136;72;35;3;32;.914;3595000;0
9648;223929;138;0;0;0;0;.00nan;0;0
9648;-1;136;0;0;0;0;.00nan;0;0
9649;215246;143;56;34;5;29;.853;3106000;0
9649;215331;144;0;0;0;0;.00nan;0;0
9649;216130;143;29;9;3;6;.667;494000;0
9649;223946;144;50;26;4;22;.846;3600000;0
9650;208609;131;85;43;4;39;.907;3571000;0
9650;210213;139;0;0;0;0;.00nan;0;0
9650;221361;139;56;25;3;22;.880;3600000;0
9650;211984;131;0;0;0;0;.00nan;0;0
9651;215128;141;0;0;0;0;.00nan;0;0
9651;210004;141;65;21;2;19;.905;3600000;0
9651;215246;143;0;0;0;0;.00nan;0;0
9651;216130;143;65;41;5;36;.878;3600000;0
9652;213799;140;86;28;1;27;.964;3600000;0
9652;208556;135;57;40;5;35;.875;3600000;0
9652;220672;140;0;0;0;0;.00nan;0;0
9652;-1;135;0;0;0;0;.00nan;0;0
9653;208575;142;0;0;0;0;.00nan;0;0
9653;215331;144;88;49;3;46;.939;3553000;0
9653;217769;142;84;29;2;27;.931;3600000;0
9653;223946;144;0;0;0;0;.00nan;0;0
9654;225725;136;68;31;3;28;.903;3600000;0
9654;210060;137;0;0;0;0;.00nan;0;0
9654;-1;136;0;0;0;0;.00nan;0;0
9654;-1;137;34;38;7;31;.816;3600000;0
9655;209998;129;22;30;7;23;.767;3600000;0
9655;215217;1340;0;0;0;0;.00nan;0;0
9655;215319;129;0;0;0;0;.00nan;0;0
9655;-1;1340;54;28;3;25;.893;3600000;0
9656;219003;133;49;13;2;11;.846;3600000;0
9656;220575;134;65;47;5;42;.894;3600000;0
9656;210876;134;0;0;0;0;.00nan;0;0
9656;-1;133;0;0;0;0;.00nan;0;0
9657;210213;139;58;38;4;34;.895;3579000;0
9657;221361;139;0;0;0;0;.00nan;0;0
9657;212166;128;0;0;0;0;.00nan;0;0
9657;212529;128;68;27;2;25;.926;3600000;0
9658;220566;138;62;22;2;20;.909;3600000;0
9658;223929;138;0;0;0;0;.00nan;0;0
9658;-1;130;0;0;0;0;.00nan;0;0
9658;-1;130;65;36;5;31;.861;3600000;0
9659;213799;140;0;0;0;0;.00nan;0;0
9659;208575;142;18;34;7;27;.794;3516000;0
9659;220672;140;36;26;5;21;.808;3600000;0
9659;217769;142;0;0;0;0;.00nan;0;0
9660;225725;136;0;0;0;0;.00nan;0;0
9660;210060;137;94;19;0;19;1.000;3600000;0
9660;-1;136;85;37;2;35;.946;3598000;0
9660;-1;137;0;0;0;0;.00nan;0;0
9661;213756;132;89;32;1;31;.969;3600000;0
9661;220511;132;0;0;0;0;.00nan;0;0
9661;215217;1340;75;41;4;37;.902;3600000;0
9661;-1;1340;0;0;0;0;.00nan;0;0
9662;210213;139;0;0;0;0;.00nan;0;0
9662;221361;139;98;52;2;50;.962;3600000;0
9662;-1;130;90;20;0;20;1.000;3600000;0
9662;-1;130;0;0;0;0;.00nan;0;0
9663;219003;133;0;0;0;0;.00nan;0;0
9663;220575;134;24;12;4;8;.667;452000;0
9663;210876;134;29;31;6;25;.806;3148000;0
9663;-1;133;64;21;2;19;.905;3600000;0
9664;220566;138;0;0;0;0;.00nan;0;0
9664;212166;128;20;32;7;25;.781;3106000;0
9664;212529;128;46;10;2;8;.800;494000;0
9664;223929;138;75;25;1;24;.960;3600000;0
9665;208556;135;81;31;2;29;.935;3900000;0
9665;215128;141;70;28;2;26;.929;3900000;0
9665;210004;141;0;0;0;0;.00nan;0;0
9665;-1;135;0;0;0;0;.00nan;0;0
9666;208609;131;0;0;0;0;.00nan;0;0
9666;209998;129;43;29;5;24;.828;3204000;0
9666;215319;129;25;6;3;3;.500;396000;0
9666;211984;131;70;21;2;19;.905;3600000;0
9667;208556;135;0;0;0;0;.00nan;0;0
9667;215246;143;61;26;3;23;.885;3600000;0
9667;216130;143;0;0;0;0;.00nan;0;0
9667;-1;135;75;27;2;25;.926;3600000;0
9668;213756;132;0;0;0;0;.00nan;0;0
9668;208609;131;75;36;3;33;.917;3600000;0
9668;220511;132;62;39;4;35;.897;3597000;0
9668;211984;131;0;0;0;0;.00nan;0;0
9669;213799;140;51;40;5;35;.875;3900000;0
9669;208575;142;0;0;0;0;.00nan;0;0
9669;220672;140;0;0;0;0;.00nan;0;0
9669;217769;142;40;28;5;23;.821;3900000;0
9670;215217;1340;82;20;0;20;1.000;2626000;0
9670;215331;144;0;0;0;0;.00nan;0;0
9670;223946;144;80;25;1;24;.960;3600000;0
9670;-1;1340;30;13;4;9;.692;974000;0
9671;213756;132;71;43;3;40;.930;3600000;0
9671;215128;141;46;35;5;30;.857;3554000;0
9671;220511;132;0;0;0;0;.00nan;0;0
9671;210004;141;0;0;0;0;.00nan;0;0
9672;219003;133;56;19;2;17;.895;3600000;0
9672;210060;137;90;40;3;37;.925;3581000;0
9672;-1;133;0;0;0;0;.00nan;0;0
9672;-1;137;0;0;0;0;.00nan;0;0
9673;220566;138;0;0;0;0;.00nan;0;0
9673;223929;138;75;22;1;21;.955;3600000;0
9673;-1;130;50;41;6;35;.854;2740000;0
9673;-1;130;49;2;0;2;1.000;860000;0
9674;210213;139;44;3;1;2;.667;407000;0
9674;221361;139;37;33;6;27;.818;3193000;0
9674;212166;128;0;0;0;0;.00nan;0;0
9674;212529;128;55;25;3;22;.880;3600000;0
9675;215128;141;0;0;0;0;.00nan;0;0
9675;209998;129;54;44;6;38;.864;3600000;0
9675;210004;141;80;34;2;32;.941;3600000;0
9675;215319;129;0;0;0;0;.00nan;0;0
9676;208575;142;64;28;3;25;.893;3600000;0
9676;225725;136;0;0;0;0;.00nan;0;0
9676;217769;142;0;0;0;0;.00nan;0;0
9676;-1;136;39;34;6;28;.824;3600000;0
9677;213799;140;0;0;0;0;.00nan;0;0
9677;215246;143;0;0;0;0;.00nan;0;0
9677;220672;140;100;31;0;31;1.000;3600000;0
9677;216130;143;54;37;4;33;.892;3600000;0
9678;219003;133;0;0;0;0;.00nan;0;0
9678;208556;135;53;32;4;28;.875;3571000;0
9678;-1;133;56;25;3;22;.880;3600000;0
9678;-1;135;0;0;0;0;.00nan;0;0
9679;209998;129;49;40;6;34;.850;3600000;0
9679;215319;129;0;0;0;0;.00nan;0;0
9679;215331;144;79;28;2;26;.929;3600000;0
9679;223946;144;0;0;0;0;.00nan;0;0
9680;208609;131;74;29;2;27;.931;3600000;0
9680;220575;134;60;29;3;26;.897;3575000;0
9680;210876;134;0;0;0;0;.00nan;0;0
9680;211984;131;0;0;0;0;.00nan;0;0
9681;210060;137;96;41;3;38;.927;3595000;0
9681;-1;130;0;0;0;0;.00nan;0;0
9681;-1;137;0;0;0;0;.00nan;0;0
9681;-1;130;45;14;2;12;.857;3600000;0
9682;213799;140;32;33;7;26;.788;3185000;0
9682;215246;143;52;29;4;25;.862;3600000;0
9682;220672;140;53;5;0;5;1.000;415000;0
9682;216130;143;0;0;0;0;.00nan;0;0
9683;220566;138;58;27;3;24;.889;3600000;0
9683;220575;134;60;9;0;9;1.000;1348000;0
9683;210876;134;47;38;6;32;.842;2252000;0
9683;223929;138;0;0;0;0;.00nan;0;0
9684;215128;141;0;0;0;0;.00nan;0;0
9684;210004;141;87;37;2;35;.946;3900000;0
9684;215217;1340;74;30;2;28;.933;3886000;0
9684;-1;1340;0;0;0;0;.00nan;0;0
9685;213756;132;0;0;0;0;.00nan;0;0
9685;220511;132;46;36;6;30;.833;3600000;0
9685;215331;144;43;11;2;9;.818;1290000;0
9685;223946;144;26;28;6;22;.786;2271000;0
9686;210060;137;44;10;2;8;.800;1127000;0
9686;-1;130;66;20;1;19;.950;3600000;0
9686;-1;137;35;37;6;31;.838;2473000;0
9686;-1;130;0;0;0;0;.00nan;0;0
9687;219003;133;48;27;4;23;.852;3600000;0
9687;208609;131;0;0;0;0;.00nan;0;0
9687;211984;131;33;31;6;25;.806;3523000;0
9687;-1;133;0;0;0;0;.00nan;0;0
9688;208575;142;0;0;0;0;.00nan;0;0
9688;212166;128;0;0;0;0;.00nan;0;0
9688;212529;128;84;37;2;35;.946;3600000;0
9688;217769;142;34;26;5;21;.808;3600000;0
9689;225725;136;25;28;6;22;.786;1586000;0
9689;210213;139;0;0;0;0;.00nan;0;0
9689;221361;139;44;21;4;17;.810;3600000;0
9689;-1;136;51;21;3;18;.857;2014000;0
9690;215246;143;0;0;0;0;.00nan;0;0
9690;216130;143;56;38;5;33;.868;3613000;0
9690;212166;128;0;0;0;0;.00nan;0;0
9690;212529;128;40;38;6;32;.842;3613000;0
9691;208556;135;52;32;5;27;.844;3627000;0
9691;220566;138;0;0;0;0;.00nan;0;0
9691;223929;138;56;29;4;25;.862;3627000;0
9691;-1;135;0;0;0;0;.00nan;0;0
9692;208556;135;0;0;0;0;.00nan;0;0
9692;209998;129;54;44;6;38;.864;3589000;0
9692;215319;129;0;0;0;0;.00nan;0;0
9692;-1;135;39;17;4;13;.765;3600000;0
9693;220566;138;78;32;2;30;.938;3600000;0
9693;210060;137;50;44;6;38;.864;3269000;0
9693;223929;138;0;0;0;0;.00nan;0;0
9693;-1;137;57;6;0;6;1.000;331000;0
9694;208609;131;79;32;2;30;.938;3587000;0
9694;225725;136;77;26;1;25;.962;3600000;0
9694;211984;131;0;0;0;0;.00nan;0;0
9694;-1;136;0;0;0;0;.00nan;0;0
9695;215128;141;53;34;5;29;.853;3900000;0
9695;210004;141;0;0;0;0;.00nan;0;0
9695;215331;144;0;0;0;0;.00nan;0;0
9695;223946;144;54;47;5;42;.894;3900000;0
9696;219003;133;75;41;4;37;.902;3600000;0
9696;210213;139;0;0;0;0;.00nan;0;0
9696;221361;139;52;31;5;26;.839;3562000;0
9696;-1;133;0;0;0;0;.00nan;0;0
9697;208575;142;0;0;0;0;.00nan;0;0
9697;215246;143;93;43;3;40;.930;3600000;0
9697;216130;143;0;0;0;0;.00nan;0;0
9697;217769;142;61;37;4;33;.892;3558000;0
9698;209998;129;81;31;2;29;.935;3600000;0
9698;225725;136;0;0;0;0;.00nan;0;0
9698;215319;129;0;0;0;0;.00nan;0;0
9698;-1;136;43;33;5;28;.848;3600000;0
9699;208556;135;41;25;4;21;.840;1437000;0
9699;215217;1340;0;0;0;0;.00nan;0;0
9699;-1;135;30;23;5;18;.783;2163000;0
9699;-1;1340;91;40;2;38;.950;3600000;0
9700;208609;131;66;36;4;32;.889;3529000;0
9700;210060;137;0;0;0;0;.00nan;0;0
9700;211984;131;0;0;0;0;.00nan;0;0
9700;-1;137;69;29;2;27;.931;3600000;0
9701;220575;134;52;27;3;24;.889;3545000;0
9701;210876;134;0;0;0;0;.00nan;0;0
9701;212166;128;0;0;0;0;.00nan;0;0
9701;212529;128;83;34;2;32;.941;3600000;0
9702;213756;132;0;0;0;0;.00nan;0;0
9702;220511;132;45;49;7;42;.857;3600000;0
9702;220566;138;78;34;2;32;.941;3600000;0
9702;223929;138;0;0;0;0;.00nan;0;0
9703;213799;140;0;0;0;0;.00nan;0;0
9703;220672;140;100;49;2;47;.959;3900000;0
9703;-1;130;0;0;0;0;.00nan;0;0
9703;-1;130;76;27;2;25;.926;3900000;0
9704;213756;132;45;40;6;34;.850;3031000;0
9704;220511;132;64;11;0;11;1.000;569000;0
9704;220566;138;0;0;0;0;.00nan;0;0
9704;223929;138;51;25;3;22;.880;3600000;0
9705;209998;129;0;0;0;0;.00nan;0;0
9705;225725;136;46;19;4;15;.789;3600000;0
9705;215319;129;59;42;5;37;.881;3597000;0
9705;-1;136;0;0;0;0;.00nan;0;0
9706;208556;135;55;29;4;25;.862;3717000;0
9706;215217;1340;54;26;3;23;.885;3717000;0
9706;-1;135;0;0;0;0;.00nan;0;0
9706;-1;1340;0;0;0;0;.00nan;0;0
9707;213799;140;27;25;5;20;.800;2989000;0
9707;220575;134;0;0;0;0;.00nan;0;0
9707;220672;140;56;10;1;9;.900;565000;0
9707;210876;134;55;30;4;26;.867;3600000;0
9708;208609;131;0;0;0;0;.00nan;0;0
9708;211984;131;84;45;3;42;.933;3600000;0
9708;-1;130;75;24;1;23;.958;3600000;0
9708;-1;130;0;0;0;0;.00nan;0;0
9709;219003;133;0;0;0;0;.00nan;0;0
9709;208575;142;90;56;4;52;.929;3600000;0
9709;217769;142;0;0;0;0;.00nan;0;0
9709;-1;133;59;22;2;20;.909;3600000;0
9710;208575;142;0;0;0;0;.00nan;0;0
9710;210213;139;0;0;0;0;.00nan;0;0
9710;221361;139;36;28;5;23;.821;3769000;0
9710;217769;142;83;37;4;33;.892;3769000;0
9711;215246;143;0;0;0;0;.00nan;0;0
9711;215331;144;60;37;4;33;.892;3600000;0
9711;216130;143;69;51;6;45;.882;3546000;0
9711;223946;144;0;0;0;0;.00nan;0;0
9712;215217;1340;42;31;5;26;.839;3600000;0
9712;-1;130;51;2;0;2;1.000;317000;0
9712;-1;130;27;27;6;21;.778;3233000;0
9712;-1;1340;0;0;0;0;.00nan;0;0
9713;213799;140;98;53;3;50;.943;3563000;0
9713;220672;140;0;0;0;0;.00nan;0;0
9713;212166;128;54;17;2;15;.882;3600000;0
9713;212529;128;0;0;0;0;.00nan;0;0
9714;219003;133;83;28;1;27;.964;3760000;0
9714;215128;141;0;0;0;0;.00nan;0;0
9714;210004;141;90;36;2;34;.944;3760000;0
9714;-1;133;0;0;0;0;.00nan;0;0
9715;213756;132;0;0;0;0;.00nan;0;0
9715;220511;132;93;45;3;42;.933;3900000;0
9715;210060;137;46;27;3;24;.889;3900000;0
9715;-1;137;0;0;0;0;.00nan;0;0
9716;215246;143;66;34;3;31;.912;3600000;0
9716;210213;139;53;35;5;30;.857;3527000;0
9716;221361;139;0;0;0;0;.00nan;0;0
9716;216130;143;0;0;0;0;.00nan;0;0
9717;215331;144;0;0;0;0;.00nan;0;0
9717;210213;139;0;0;0;0;.00nan;0;0
9717;221361;139;61;43;6;37;.860;3600000;0
9717;223946;144;100;39;0;39;1.000;3600000;0
9718;213799;140;0;0;0;0;.00nan;0;0
9718;215128;141;0;0;0;0;.00nan;0;0
9718;210004;141;64;35;4;31;.886;3682000;0
9718;220672;140;61;22;3;19;.864;3682000;0
9719;210060;137;0;0;0;0;.00nan;0;0
9719;215246;143;56;32;4;28;.875;3900000;0
9719;216130;143;0;0;0;0;.00nan;0;0
9719;-1;137;46;19;4;15;.789;3900000;0
9720;225725;136;64;39;4;35;.897;3600000;0
9720;212166;128;0;0;0;0;.00nan;0;0
9720;212529;128;100;28;0;28;1.000;3600000;0
9720;-1;136;0;0;0;0;.00nan;0;0
9721;220566;138;57;21;3;18;.857;3785000;0
9721;215217;1340;0;0;0;0;.00nan;0;0
9721;223929;138;0;0;0;0;.00nan;0;0
9721;-1;1340;83;35;2;33;.943;3785000;0
9722;208575;142;0;0;0;0;.00nan;0;0
9722;215331;144;0;0;0;0;.00nan;0;0
9722;217769;142;32;37;7;30;.811;3511000;0
9722;223946;144;64;43;5;38;.884;3600000;0
9723;208556;135;100;33;0;33;1.000;3600000;0
9723;212166;128;0;0;0;0;.00nan;0;0
9723;212529;128;65;37;5;32;.865;3600000;0
9723;-1;135;0;0;0;0;.00nan;0;0
9724;208609;131;57;33;4;29;.879;3896000;0
9724;209998;129;44;22;4;18;.818;3900000;0
9724;215319;129;0;0;0;0;.00nan;0;0
9724;211984;131;0;0;0;0;.00nan;0;0
9725;213756;132;0;0;0;0;.00nan;0;0
9725;220511;132;74;49;5;44;.898;3565000;0
9725;-1;130;0;0;0;0;.00nan;0;0
9725;-1;130;56;25;3;22;.880;3600000;0
9726;219003;133;62;8;0;8;1.000;1764000;0
9726;220575;134;42;39;6;33;.846;3900000;0
9726;210876;134;0;0;0;0;.00nan;0;0
9726;-1;133;18;19;6;13;.684;2121000;0
9727;220566;138;0;0;0;0;.00nan;0;0
9727;215246;143;0;0;0;0;.00nan;0;0
9727;216130;143;92;56;4;52;.929;3802000;0
9727;223929;138;32;22;5;17;.773;3778000;0
9728;215217;1340;58;25;3;22;.880;3900000;0
9728;210060;137;0;0;0;0;.00nan;0;0
9728;-1;137;63;41;3;38;.927;3900000;0
9728;-1;1340;0;0;0;0;.00nan;0;0
9729;213756;132;71;35;3;32;.914;3568000;0
9729;208609;131;0;0;0;0;.00nan;0;0
9729;220511;132;0;0;0;0;.00nan;0;0
9729;211984;131;88;33;2;31;.939;3600000;0
9730;219003;133;63;26;2;24;.923;3600000;0
9730;220575;134;84;40;3;37;.925;3580000;0
9730;210876;134;0;0;0;0;.00nan;0;0
9730;-1;133;0;0;0;0;.00nan;0;0
9731;208556;135;50;23;4;19;.826;3591000;0
9731;212166;128;0;0;0;0;.00nan;0;0
9731;212529;128;67;25;2;23;.920;3600000;0
9731;-1;135;0;0;0;0;.00nan;0;0
9732;213799;140;79;27;1;26;.963;3600000;0
9732;208575;142;72;47;5;42;.894;3600000;0
9732;220672;140;0;0;0;0;.00nan;0;0
9732;217769;142;0;0;0;0;.00nan;0;0
9733;215128;141;0;0;0;0;.00nan;0;0
9733;210004;141;69;34;4;30;.882;3600000;0
9733;210213;139;0;0;0;0;.00nan;0;0
9733;221361;139;85;28;1;27;.964;3600000;0
9734;215331;144;0;0;0;0;.00nan;0;0
9734;210213;139;44;36;5;31;.861;3566000;0
9734;221361;139;0;0;0;0;.00nan;0;0
9734;223946;144;59;37;4;33;.892;3600000;0
9735;225725;136;56;39;5;34;.872;3561000;0
9735;215246;143;60;32;4;28;.875;3600000;0
9735;216130;143;0;0;0;0;.00nan;0;0
9735;-1;136;0;0;0;0;.00nan;0;0
9736;215217;1340;0;0;0;0;.00nan;0;0
9736;210060;137;73;39;3;36;.923;3867000;0
9736;-1;137;0;0;0;0;.00nan;0;0
9736;-1;1340;70;31;2;29;.935;3867000;0
9737;209998;129;38;38;6;32;.842;3600000;0
9737;215319;129;0;0;0;0;.00nan;0;0
9737;-1;130;0;0;0;0;.00nan;0;0
9737;-1;130;68;18;1;17;.944;3600000;0
9738;208556;135;0;0;0;0;.00nan;0;0
9738;208609;131;80;32;3;29;.906;3600000;0
9738;211984;131;0;0;0;0;.00nan;0;0
9738;-1;135;37;27;5;22;.815;3560000;0
9739;210060;137;0;0;0;0;.00nan;0;0
9739;215331;144;47;27;5;22;.815;3552000;0
9739;223946;144;0;0;0;0;.00nan;0;0
9739;-1;137;66;36;4;32;.889;3600000;0
9740;213756;132;49;23;3;20;.870;3600000;0
9740;220511;132;0;0;0;0;.00nan;0;0
9740;225725;136;0;0;0;0;.00nan;0;0
9740;-1;136;51;33;4;29;.879;3600000;0
9741;215128;141;0;0;0;0;.00nan;0;0
9741;210004;141;86;45;4;41;.911;3900000;0
9741;215331;144;0;0;0;0;.00nan;0;0
9741;223946;144;45;28;4;24;.857;3900000;0
9742;208575;142;0;0;0;0;.00nan;0;0
9742;210060;137;74;36;3;33;.917;3548000;0
9742;217769;142;69;20;1;19;.950;3600000;0
9742;-1;137;0;0;0;0;.00nan;0;0
9743;208556;135;0;0;0;0;.00nan;0;0
9743;220566;138;50;25;4;21;.840;3600000;0
9743;223929;138;0;0;0;0;.00nan;0;0
9743;-1;135;32;40;8;32;.800;3600000;0
9744;215217;1340;76;32;3;29;.906;3900000;0
9744;212166;128;0;0;0;0;.00nan;0;0
9744;212529;128;55;28;3;25;.893;3843000;0
9744;-1;1340;0;0;0;0;.00nan;0;0
9745;208609;131;74;38;3;35;.921;3600000;0
9745;211984;131;0;0;0;0;.00nan;0;0
9745;-1;130;68;24;2;22;.917;3600000;0
9745;-1;130;0;0;0;0;.00nan;0;0
9746;215128;141;74;25;2;23;.920;3600000;0
9746;209998;129;29;7;3;4;.571;575000;0
9746;210004;141;0;0;0;0;.00nan;0;0
9746;215319;129;64;24;2;22;.917;2999000;0
9747;213756;132;0;0;0;0;.00nan;0;0
9747;213799;140;0;0;0;0;.00nan;0;0
9747;220511;132;43;25;4;21;.840;3600000;0
9747;220672;140;77;37;3;34;.919;3600000;0
9748;208575;142;68;33;3;30;.909;3600000;0
9748;210213;139;0;0;0;0;.00nan;0;0
9748;221361;139;96;38;2;36;.947;3600000;0
9748;217769;142;0;0;0;0;.00nan;0;0
9749;220575;134;76;33;2;31;.939;3900000;0
9749;215217;1340;0;0;0;0;.00nan;0;0
9749;210876;134;0;0;0;0;.00nan;0;0
9749;-1;1340;71;30;2;28;.933;3900000;0
9750;219003;133;60;21;2;19;.905;3600000;0
9750;225725;136;28;28;6;22;.786;1917000;0
9750;-1;133;0;0;0;0;.00nan;0;0
9750;-1;136;50;20;3;17;.850;1683000;0
9751;220566;138;0;0;0;0;.00nan;0;0
9751;223929;138;78;30;3;27;.900;3827000;0
9751;-1;130;0;0;0;0;.00nan;0;0
9751;-1;130;66;40;4;36;.900;3827000;0
9752;220575;134;74;28;2;26;.929;3600000;0
9752;210876;134;0;0;0;0;.00nan;0;0
9752;212166;128;0;0;0;0;.00nan;0;0
9752;212529;128;45;27;4;23;.852;3535000;0
9753;210060;137;0;0;0;0;.00nan;0;0
9753;210213;139;52;22;3;19;.864;3600000;0
9753;221361;139;0;0;0;0;.00nan;0;0
9753;-1;137;69;54;6;48;.889;3600000;0
9754;213756;132;74;40;4;36;.900;3600000;0
9754;220511;132;0;0;0;0;.00nan;0;0
9754;215331;144;0;0;0;0;.00nan;0;0
9754;223946;144;100;38;1;37;.974;3600000;0
9755;209998;129;9;24;7;17;.708;2255000;0
9755;215246;143;0;0;0;0;.00nan;0;0
9755;215319;129;53;18;3;15;.833;1345000;0
9755;216130;143;36;26;5;21;.808;3600000;0
9756;213799;140;0;0;0;0;.00nan;0;0
9756;209998;129;17;26;6;20;.769;1893000;0
9756;215319;129;58;15;1;14;.933;1707000;0
9756;220672;140;58;25;3;22;.880;3600000;0
9757;213756;132;53;5;0;5;1.000;557000;0
9757;220511;132;28;31;7;24;.774;3043000;0
9757;215246;143;81;29;1;28;.966;3600000;0
9757;216130;143;0;0;0;0;.00nan;0;0
9758;212166;128;0;0;0;0;.00nan;0;0
9758;212529;128;47;33;5;28;.848;3541000;0
9758;-1;130;0;0;0;0;.00nan;0;0
9758;-1;130;71;39;4;35;.897;3600000;0
9759;208575;142;0;0;0;0;.00nan;0;0
9759;215128;141;0;0;0;0;.00nan;0;0
9759;210004;141;99;41;2;39;.951;3600000;0
9759;217769;142;47;29;4;25;.862;3588000;0
9760;220566;138;16;21;6;15;.714;2740000;0
9760;225725;136;76;36;3;33;.917;3600000;0
9760;223929;138;48;9;1;8;.889;860000;0
9760;-1;136;0;0;0;0;.00nan;0;0
9761;219003;133;0;0;0;0;.00nan;0;0
9761;208609;131;71;43;4;39;.907;3600000;0
9761;211984;131;0;0;0;0;.00nan;0;0
9761;-1;133;95;26;1;25;.962;3600000;0
9762;208556;135;29;27;6;21;.778;2315000;0
9762;220575;134;0;0;0;0;.00nan;0;0
9762;210876;134;84;43;3;40;.930;3600000;0
9762;-1;135;66;13;0;13;1.000;1285000;0
9763;213799;140;0;0;0;0;.00nan;0;0
9763;220672;140;43;36;6;30;.833;3600000;0
9763;210213;139;0;0;0;0;.00nan;0;0
9763;221361;139;80;28;1;27;.964;3600000;0
9764;220566;138;64;20;1;19;.950;3600000;0
9764;225725;136;64;32;3;29;.906;3561000;0
9764;223929;138;0;0;0;0;.00nan;0;0
9764;-1;136;0;0;0;0;.00nan;0;0
9765;208575;142;50;1;0;1;1.000;223000;0
9765;217769;142;30;28;6;22;.786;3329000;0
9765;-1;130;87;25;0;25;1.000;2622000;0
9765;-1;130;28;10;4;6;.600;978000;0
9766;215128;141;0;0;0;0;.00nan;0;0
9766;210004;141;59;27;3;24;.889;3600000;0
9766;215246;143;68;37;4;33;.892;3600000;0
9766;216130;143;0;0;0;0;.00nan;0;0
9767;219003;133;63;21;2;19;.905;3600000;0
9767;220575;134;60;40;5;35;.875;3600000;0
9767;210876;134;0;0;0;0;.00nan;0;0
9767;-1;133;0;0;0;0;.00nan;0;0
9768;208609;131;0;0;0;0;.00nan;0;0
9768;215217;1340;58;35;4;31;.886;3600000;0
9768;211984;131;85;24;1;23;.958;3600000;0
9768;-1;1340;0;0;0;0;.00nan;0;0
9769;215331;144;0;0;0;0;.00nan;0;0
9769;212166;128;84;26;1;25;.962;3600000;0
9769;212529;128;0;0;0;0;.00nan;0;0
9769;223946;144;69;49;7;42;.857;3600000;0
9770;213799;140;0;0;0;0;.00nan;0;0
9770;220566;138;76;12;0;12;1.000;3600000;0
9770;220672;140;97;46;2;44;.957;3556000;0
9770;223929;138;0;0;0;0;.00nan;0;0
9771;210060;137;67;49;5;44;.898;3059000;0
9771;-1;130;0;0;0;0;.00nan;0;0
9771;-1;137;22;5;3;2;.400;541000;0
9771;-1;130;52;29;4;25;.862;3600000;0
9772;215217;1340;0;0;0;0;.00nan;0;0
9772;225725;136;0;0;0;0;.00nan;0;0
9772;-1;136;74;19;1;18;.947;3600000;0
9772;-1;1340;49;33;5;28;.848;3600000;0
9773;213756;132;58;32;3;29;.906;3553000;0
9773;208575;142;0;0;0;0;.00nan;0;0
9773;220511;132;0;0;0;0;.00nan;0;0
9773;217769;142;60;14;1;13;.929;3600000;0
9774;219003;133;0;0;0;0;.00nan;0;0
9774;215331;144;99;27;0;27;1.000;3600000;0
9774;223946;144;0;0;0;0;.00nan;0;0
9774;-1;133;72;30;2;28;.933;3600000;0
9775;208609;131;49;27;5;22;.815;3545000;0
9775;211984;131;0;0;0;0;.00nan;0;0
9775;212166;128;0;0;0;0;.00nan;0;0
9775;212529;128;55;32;4;28;.875;3600000;0
9776;208556;135;35;28;5;23;.821;3600000;0
9776;215331;144;100;45;1;44;.978;3600000;0
9776;223946;144;0;0;0;0;.00nan;0;0
9776;-1;135;0;0;0;0;.00nan;0;0
9777;210060;137;0;0;0;0;.00nan;0;0
9777;-1;130;35;20;4;16;.800;3900000;0
9777;-1;137;71;43;4;39;.907;3900000;0
9777;-1;130;0;0;0;0;.00nan;0;0
9778;215217;1340;93;36;3;33;.917;3600000;0
9778;225725;136;67;42;4;38;.905;3600000;0
9778;-1;136;0;0;0;0;.00nan;0;0
9778;-1;1340;0;0;0;0;.00nan;0;0
9779;213756;132;0;0;0;0;.00nan;0;0
9779;220511;132;58;28;3;25;.893;3600000;0
9779;220575;134;47;42;6;36;.857;3351000;0
9779;210876;134;50;1;0;1;1.000;249000;0
9780;219003;133;58;34;4;30;.882;3900000;0
9780;212166;128;77;46;4;42;.913;3900000;0
9780;212529;128;0;0;0;0;.00nan;0;0
9780;-1;133;0;0;0;0;.00nan;0;0
9781;215128;141;0;0;0;0;.00nan;0;0
9781;210004;141;79;31;3;28;.903;3728000;0
9781;220566;138;78;28;2;26;.929;3728000;0
9781;223929;138;0;0;0;0;.00nan;0;0
9782;215246;143;0;0;0;0;.00nan;0;0
9782;210213;139;85;41;3;38;.927;3900000;0
9782;221361;139;0;0;0;0;.00nan;0;0
9782;216130;143;74;38;3;35;.921;3900000;0
9783;208575;142;68;26;2;24;.923;3600000;0
9783;209998;129;0;0;0;0;.00nan;0;0
9783;215319;129;65;39;4;35;.897;3600000;0
9783;217769;142;0;0;0;0;.00nan;0;0
9784;213799;140;0;0;0;0;.00nan;0;0
9784;220672;140;89;17;0;17;1.000;3600000;0
9784;210213;139;0;0;0;0;.00nan;0;0
9784;221361;139;73;48;5;43;.896;3600000;0
9785;220566;138;59;20;2;18;.900;3600000;0
9785;215246;143;28;33;6;27;.818;2320000;0
9785;216130;143;48;12;2;10;.833;1280000;0
9785;223929;138;0;0;0;0;.00nan;0;0
9786;209998;129;94;44;1;43;.977;3600000;0
9786;220575;134;62;33;3;30;.909;3551000;0
9786;215319;129;0;0;0;0;.00nan;0;0
9786;210876;134;0;0;0;0;.00nan;0;0
9787;208556;135;0;0;0;0;.00nan;0;0
9787;208609;131;0;0;0;0;.00nan;0;0
9787;211984;131;70;29;2;27;.931;3600000;0
9787;-1;135;59;30;4;26;.867;3550000;0
9788;215331;144;0;0;0;0;.00nan;0;0
9788;210213;139;46;22;3;19;.864;3547000;0
9788;221361;139;0;0;0;0;.00nan;0;0
9788;223946;144;78;37;2;35;.946;3600000;0
9789;208609;131;64;26;2;24;.923;3600000;0
9789;215246;143;64;34;3;31;.912;3577000;0
9789;216130;143;0;0;0;0;.00nan;0;0
9789;211984;131;0;0;0;0;.00nan;0;0
9790;213799;140;0;0;0;0;.00nan;0;0
9790;208556;135;0;0;0;0;.00nan;0;0
9790;220672;140;60;21;2;19;.905;3600000;0
9790;-1;135;58;28;3;25;.893;3590000;0
9791;213756;132;68;25;2;23;.920;3633000;0
9791;220511;132;0;0;0;0;.00nan;0;0
9791;220575;134;81;43;3;40;.930;3633000;0
9791;210876;134;0;0;0;0;.00nan;0;0
9792;208575;142;0;0;0;0;.00nan;0;0
9792;208609;131;0;0;0;0;.00nan;0;0
9792;211984;131;82;34;2;32;.941;3600000;0
9792;217769;142;66;25;3;22;.880;3573000;0
9793;215217;1340;56;38;5;33;.868;3520000;0
9793;215331;144;66;34;3;31;.912;3600000;0
9793;223946;144;0;0;0;0;.00nan;0;0
9793;-1;1340;0;0;0;0;.00nan;0;0
9794;219003;133;51;33;5;28;.848;3549000;0
9794;225725;136;45;28;4;24;.857;3600000;0
9794;-1;133;0;0;0;0;.00nan;0;0
9794;-1;136;0;0;0;0;.00nan;0;0
9795;215128;141;0;0;0;0;.00nan;0;0
9795;210004;141;67;44;4;40;.909;3600000;0
9795;212166;128;0;0;0;0;.00nan;0;0
9795;212529;128;91;28;1;27;.964;3600000;0
9796;208575;142;24;35;8;27;.771;3600000;0
9796;215217;1340;0;0;0;0;.00nan;0;0
9796;217769;142;0;0;0;0;.00nan;0;0
9796;-1;1340;45;25;4;21;.840;3600000;0
9797;215246;143;0;0;0;0;.00nan;0;0
9797;215331;144;0;0;0;0;.00nan;0;0
9797;216130;143;100;42;1;41;.976;3600000;0
9797;223946;144;39;30;5;25;.833;3600000;0
9798;208556;135;54;47;6;41;.872;3551000;0
9798;215128;141;0;0;0;0;.00nan;0;0
9798;210004;141;68;29;4;25;.862;3600000;0
9798;-1;135;0;0;0;0;.00nan;0;0
9799;213799;140;0;0;0;0;.00nan;0;0
9799;210060;137;69;32;3;29;.906;3600000;0
9799;220672;140;71;44;4;40;.909;3545000;0
9799;-1;137;0;0;0;0;.00nan;0;0
9800;213756;132;62;28;4;24;.857;3550000;0
9800;220511;132;0;0;0;0;.00nan;0;0
9800;212166;128;75;31;2;29;.935;3600000;0
9800;212529;128;0;0;0;0;.00nan;0;0
9801;209998;129;87;51;4;47;.922;3573000;0
9801;215319;129;0;0;0;0;.00nan;0;0
9801;-1;130;0;0;0;0;.00nan;0;0
9801;-1;130;63;23;2;21;.913;3600000;0
9802;213799;140;92;42;3;39;.929;3900000;0
9802;220566;138;62;26;3;23;.885;3900000;0
9802;220672;140;0;0;0;0;.00nan;0;0
9802;223929;138;0;0;0;0;.00nan;0;0
9803;208556;135;42;11;3;8;.727;992000;0
9803;225725;136;80;29;2;27;.931;3600000;0
9803;-1;136;0;0;0;0;.00nan;0;0
9803;-1;135;43;39;6;33;.846;2608000;0
9804;213756;132;35;6;2;4;.667;713000;0
9804;220511;132;21;37;8;29;.784;2887000;0
9804;-1;130;39;19;4;15;.789;3600000;0
9804;-1;130;0;0;0;0;.00nan;0;0
9805;219003;133;0;0;0;0;.00nan;0;0
9805;215128;141;82;36;2;34;.944;3600000;0
9805;210004;141;0;0;0;0;.00nan;0;0
9805;-1;133;36;31;5;26;.839;3600000;0
9806;209998;129;0;0;0;0;.00nan;0;0
9806;220575;134;9;18;6;12;.667;2848000;0
9806;215319;129;88;39;2;37;.949;3600000;0
9806;210876;134;51;4;0;4;1.000;752000;0
9807;208609;131;32;33;6;27;.818;2792000;0
9807;210213;139;37;20;4;16;.800;3600000;0
9807;221361;139;0;0;0;0;.00nan;0;0
9807;211984;131;64;18;1;17;.944;808000;0
9808;208575;142;0;0;0;0;.00nan;0;0
9808;215246;143;68;37;3;34;.919;3600000;0
9808;216130;143;0;0;0;0;.00nan;0;0
9808;217769;142;70;17;1;16;.941;3600000;0
9809;215217;1340;59;20;2;18;.900;3600000;0
9809;210213;139;0;0;0;0;.00nan;0;0
9809;221361;139;73;38;3;35;.921;3564000;0
9809;-1;1340;0;0;0;0;.00nan;0;0
9810;220575;134;80;52;5;47;.904;3600000;0
9810;210876;134;0;0;0;0;.00nan;0;0
9810;212166;128;0;0;0;0;.00nan;0;0
9810;212529;128;84;17;0;17;1.000;3600000;0
9811;220566;138;0;0;0;0;.00nan;0;0
9811;210060;137;0;0;0;0;.00nan;0;0
9811;223929;138;97;35;1;34;.971;3600000;0
9811;-1;137;84;48;4;44;.917;3600000;0
9812;219003;133;45;32;5;27;.844;3600000;0
9812;209998;129;93;43;1;42;.977;3600000;0
9812;215319;129;0;0;0;0;.00nan;0;0
9812;-1;133;0;0;0;0;.00nan;0;0
9813;213799;140;0;0;0;0;.00nan;0;0
9813;208575;142;0;0;0;0;.00nan;0;0
9813;220672;140;83;36;2;34;.944;3900000;0
9813;217769;142;74;28;2;26;.929;3900000;0
9814;213756;132;68;30;2;28;.933;3600000;0
9814;220511;132;0;0;0;0;.00nan;0;0
9814;209998;129;54;39;5;34;.872;3600000;0
9814;215319;129;0;0;0;0;.00nan;0;0
9815;219003;133;100;35;0;35;1.000;3600000;0
9815;225725;136;98;43;1;42;.977;3561000;0
9815;-1;133;0;0;0;0;.00nan;0;0
9815;-1;136;0;0;0;0;.00nan;0;0
9816;208556;135;49;39;5;34;.872;3600000;0
9816;220566;138;67;20;2;18;.900;3600000;0
9816;223929;138;0;0;0;0;.00nan;0;0
9816;-1;135;0;0;0;0;.00nan;0;0
9817;213799;140;0;0;0;0;.00nan;0;0
9817;215128;141;0;0;0;0;.00nan;0;0
9817;210004;141;91;31;2;29;.935;3600000;0
9817;220672;140;58;40;5;35;.875;3600000;0
9818;208575;142;0;0;0;0;.00nan;0;0
9818;215246;143;87;40;3;37;.925;3579000;0
9818;216130;143;0;0;0;0;.00nan;0;0
9818;217769;142;79;21;1;20;.952;3600000;0
9819;215331;144;84;42;3;39;.929;3591000;0
9819;210213;139;73;25;2;23;.920;3600000;0
9819;221361;139;0;0;0;0;.00nan;0;0
9819;223946;144;0;0;0;0;.00nan;0;0
9820;208556;135;69;35;3;32;.914;3545000;0
9820;210060;137;0;0;0;0;.00nan;0;0
9820;-1;135;0;0;0;0;.00nan;0;0
9820;-1;137;84;36;2;34;.944;3600000;0
9821;209998;129;37;16;4;12;.750;1007000;0
9821;215319;129;42;26;4;22;.846;2593000;0
9821;212166;128;0;0;0;0;.00nan;0;0
9821;212529;128;44;16;3;13;.813;3600000;0
9822;220566;138;42;26;5;21;.808;3900000;0
9822;215217;1340;70;44;5;39;.886;3900000;0
9822;223929;138;0;0;0;0;.00nan;0;0
9822;-1;1340;0;0;0;0;.00nan;0;0
9823;213756;132;83;40;3;37;.925;3600000;0
9823;220511;132;0;0;0;0;.00nan;0;0
9823;-1;130;46;27;4;23;.852;3595000;0
9823;-1;130;0;0;0;0;.00nan;0;0
9824;208609;131;0;0;0;0;.00nan;0;0
9824;225725;136;61;21;3;18;.857;3600000;0
9824;211984;131;98;34;1;33;.971;3600000;0
9824;-1;136;0;0;0;0;.00nan;0;0
9825;219003;133;78;26;1;25;.962;3600000;0
9825;220575;134;57;26;3;23;.885;3546000;0
9825;210876;134;0;0;0;0;.00nan;0;0
9825;-1;133;0;0;0;0;.00nan;0;0
9826;208556;135;0;0;0;0;.00nan;0;0
9826;210060;137;72;26;2;24;.923;3600000;0
9826;-1;135;60;27;3;24;.889;3549000;0
9826;-1;137;0;0;0;0;.00nan;0;0
9827;219003;133;0;0;0;0;.00nan;0;0
9827;215217;1340;0;0;0;0;.00nan;0;0
9827;-1;133;79;22;1;21;.955;3600000;0
9827;-1;1340;69;27;2;25;.926;3574000;0
9828;213756;132;44;2;1;1;.500;1135000;0
9828;220511;132;40;44;6;38;.864;2728000;0
9828;212166;128;53;38;6;32;.842;3863000;0
9828;212529;128;0;0;0;0;.00nan;0;0
9829;208609;131;51;27;4;23;.852;3853000;0
9829;220566;138;58;27;3;24;.889;3853000;0
9829;211984;131;0;0;0;0;.00nan;0;0
9829;223929;138;0;0;0;0;.00nan;0;0
9830;220575;134;0;0;0;0;.00nan;0;0
9830;225725;136;87;37;2;35;.946;3600000;0
9830;210876;134;48;25;3;22;.880;3558000;0
9830;-1;136;0;0;0;0;.00nan;0;0
9831;215128;141;51;25;4;21;.840;3551000;0
9831;210004;141;0;0;0;0;.00nan;0;0
9831;210213;139;0;0;0;0;.00nan;0;0
9831;221361;139;67;29;3;26;.897;3600000;0
9832;213799;140;72;28;2;26;.929;3600000;0
9832;220672;140;0;0;0;0;.00nan;0;0
9832;215331;144;60;16;1;15;.938;1549000;0
9832;223946;144;38;23;4;19;.826;2051000;0
9833;208575;142;41;32;5;27;.844;3590000;0
9833;215246;143;0;0;0;0;.00nan;0;0
9833;216130;143;78;40;3;37;.925;3600000;0
9833;217769;142;0;0;0;0;.00nan;0;0
9834;209998;129;49;41;6;35;.854;3600000;0
9834;215319;129;0;0;0;0;.00nan;0;0
9834;-1;130;0;0;0;0;.00nan;0;0
9834;-1;130;91;19;0;19;1.000;3600000;0
9835;213799;140;0;0;0;0;.00nan;0;0
9835;215128;141;88;43;3;40;.930;3541000;0
9835;220672;140;69;24;2;22;.917;3600000;0
9835;-1;141;0;0;0;0;.00nan;0;0
9836;215246;143;69;32;3;29;.906;3574000;0
9836;210213;139;0;0;0;0;.00nan;0;0
9836;221361;139;74;30;2;28;.933;3600000;0
9836;216130;143;0;0;0;0;.00nan;0;0
9837;208575;142;42;2;1;1;.500;1259000;0
9837;215331;144;65;12;0;12;1.000;283000;0
9837;217769;142;26;13;4;9;.692;2341000;0
9837;223946;144;32;36;7;29;.806;3283000;0
9838;208556;135;0;0;0;0;.00nan;0;0
9838;212166;128;43;24;4;20;.833;2618000;0
9838;212529;128;22;10;4;6;.600;982000;0
9838;-1;135;89;35;1;34;.971;3600000;0
9839;220575;134;51;28;4;24;.857;3600000;0
9839;225725;136;78;20;1;19;.950;3600000;0
9839;210876;134;0;0;0;0;.00nan;0;0
9839;-1;136;0;0;0;0;.00nan;0;0
9840;209998;129;87;34;1;33;.971;3600000;0
9840;215217;1340;92;20;0;20;1.000;3600000;0
9840;215319;129;0;0;0;0;.00nan;0;0
9840;-1;1340;0;0;0;0;.00nan;0;0
9841;219003;133;50;1;0;1;1.000;426000;0
9841;210060;137;0;0;0;0;.00nan;0;0
9841;-1;133;30;30;6;24;.800;3174000;0
9841;-1;137;68;25;2;23;.920;3600000;0
9842;220566;138;36;7;2;5;.714;1262000;0
9842;211984;131;64;37;4;33;.892;3600000;0
9842;212526;131;0;0;0;0;.00nan;0;0
9842;223929;138;35;21;5;16;.762;2338000;0
9843;213799;140;40;27;4;23;.852;3600000;0
9843;220672;140;0;0;0;0;.00nan;0;0
9843;215331;144;19;19;6;13;.684;1533000;0
9843;223946;144;44;28;4;24;.857;2067000;0
9844;219003;133;62;24;2;22;.917;3600000;0
9844;215217;1340;48;32;4;28;.875;3535000;0
9844;-1;133;0;0;0;0;.00nan;0;0
9844;-1;1340;0;0;0;0;.00nan;0;0
9845;208575;142;91;30;1;29;.967;3600000;0
9845;210213;139;89;49;3;46;.939;3542000;0
9845;221361;139;0;0;0;0;.00nan;0;0
9845;217769;142;0;0;0;0;.00nan;0;0
9846;220566;138;0;0;0;0;.00nan;0;0
9846;210060;137;0;0;0;0;.00nan;0;0
9846;223929;138;37;22;5;17;.773;3736000;0
9846;-1;137;59;47;6;41;.872;3736000;0
9847;208556;135;0;0;0;0;.00nan;0;0
9847;225725;136;93;28;1;27;.964;3600000;0
9847;-1;136;0;0;0;0;.00nan;0;0
9847;-1;135;64;47;5;42;.894;3600000;0
9848;213756;132;0;0;0;0;.00nan;0;0
9848;220511;132;71;29;3;26;.897;3600000;0
9848;209998;129;45;39;6;33;.846;3600000;0
9848;215319;129;0;0;0;0;.00nan;0;0
9849;211984;131;45;29;5;24;.828;2299000;0
9849;212526;131;39;15;3;12;.800;1301000;0
9849;-1;130;0;0;0;0;.00nan;0;0
9849;-1;130;68;16;1;15;.938;3600000;0
9850;220575;134;55;14;2;12;.857;3600000;0
9850;210876;134;0;0;0;0;.00nan;0;0
9850;212166;128;0;0;0;0;.00nan;0;0
9850;212529;128;53;26;3;23;.885;3561000;0
9851;215128;141;64;35;4;31;.886;3600000;0
9851;215246;143;51;2;0;2;1.000;707000;0
9851;216130;143;40;32;6;26;.813;2880000;0
9851;-1;141;0;0;0;0;.00nan;0;0
9852;208575;142;0;0;0;0;.00nan;0;0
9852;210213;139;0;0;0;0;.00nan;0;0
9852;221361;139;53;32;4;28;.875;3600000;0
9852;217769;142;61;29;3;26;.897;3600000;0
9853;213799;140;0;0;0;0;.00nan;0;0
9853;215246;143;35;22;4;18;.818;3600000;0
9853;220672;140;97;32;1;31;.969;3600000;0
9853;216130;143;0;0;0;0;.00nan;0;0
9854;208556;135;0;0;0;0;.00nan;0;0
9854;225725;136;0;0;0;0;.00nan;0;0
9854;-1;136;68;26;2;24;.923;3600000;0
9854;-1;135;54;28;4;24;.857;3600000;0
9855;220566;138;0;0;0;0;.00nan;0;0
9855;210060;137;57;25;3;22;.880;3562000;0
9855;223929;138;63;28;2;26;.929;3600000;0
9855;-1;137;0;0;0;0;.00nan;0;0
9856;213756;132;65;36;4;32;.889;3547000;0
9856;220511;132;0;0;0;0;.00nan;0;0
9856;209998;129;0;0;0;0;.00nan;0;0
9856;215319;129;73;37;3;34;.919;3600000;0
9857;219003;133;0;0;0;0;.00nan;0;0
9857;211984;131;53;55;8;47;.855;3655000;0
9857;212526;131;0;0;0;0;.00nan;0;0
9857;-1;133;29;32;7;25;.781;3655000;0
9858;220575;134;0;0;0;0;.00nan;0;0
9858;215217;1340;0;0;0;0;.00nan;0;0
9858;210876;134;23;36;8;28;.778;3600000;0
9858;-1;1340;71;22;1;21;.955;3600000;0
9859;212166;128;62;34;4;30;.882;3900000;0
9859;212529;128;0;0;0;0;.00nan;0;0
9859;-1;130;77;37;4;33;.892;3900000;0
9859;-1;130;0;0;0;0;.00nan;0;0
9860;215128;141;0;0;0;0;.00nan;0;0
9860;215331;144;0;0;0;0;.00nan;0;0
9860;223946;144;51;55;8;47;.855;3600000;0
9860;-1;141;51;22;3;19;.864;3600000;0
9861;213799;140;0;0;0;0;.00nan;0;0
9861;208575;142;44;22;4;18;.818;3563000;0
9861;220672;140;80;33;2;31;.939;3600000;0
9861;217769;142;0;0;0;0;.00nan;0;0
9862;220575;134;73;46;4;42;.913;3600000;0
9862;215217;1340;97;18;0;18;1.000;3600000;0
9862;210876;134;0;0;0;0;.00nan;0;0
9862;-1;1340;0;0;0;0;.00nan;0;0
9863;213756;132;97;44;2;42;.955;3552000;0
9863;220511;132;0;0;0;0;.00nan;0;0
9863;-1;130;69;20;1;19;.950;3600000;0
9863;-1;130;0;0;0;0;.00nan;0;0
9864;208556;135;0;0;0;0;.00nan;0;0
9864;211984;131;80;38;3;35;.921;3600000;0
9864;212526;131;0;0;0;0;.00nan;0;0
9864;-1;135;54;28;4;24;.857;3592000;0
9865;225725;136;33;27;5;22;.815;3585000;0
9865;223929;138;0;0;0;0;.00nan;0;0
9865;-1;136;0;0;0;0;.00nan;0;0
9865;-1;138;46;21;4;17;.810;3600000;0
9866;215246;143;0;0;0;0;.00nan;0;0
9866;215331;144;43;5;1;4;.800;511000;0
9866;216130;143;30;29;6;23;.793;3600000;0
9866;223946;144;28;34;7;27;.794;3006000;0
9867;210060;137;0;0;0;0;.00nan;0;0
9867;212166;128;0;0;0;0;.00nan;0;0
9867;212529;128;76;39;2;37;.949;3573000;0
9867;-1;137;100;29;0;29;1.000;3600000;0
9868;219003;133;35;21;4;17;.810;3600000;0
9868;210213;139;41;32;6;26;.813;3535000;0
9868;221361;139;0;0;0;0;.00nan;0;0
9868;-1;133;0;0;0;0;.00nan;0;0
9869;215246;143;24;12;4;8;.667;860000;0
9869;215331;144;34;12;3;9;.750;431000;0
9869;216130;143;75;21;1;20;.952;2740000;0
9869;223946;144;56;32;4;28;.875;3083000;0
9870;208556;135;0;0;0;0;.00nan;0;0
9870;210213;139;0;0;0;0;.00nan;0;0
9870;221361;139;82;34;1;33;.971;3600000;0
9870;-1;135;54;32;4;28;.875;3600000;0
9871;209998;129;19;45;9;36;.800;3600000;0
9871;215319;129;0;0;0;0;.00nan;0;0
9871;-1;130;0;0;0;0;.00nan;0;0
9871;-1;130;54;22;3;19;.864;3600000;0
9872;213756;132;69;22;1;21;.955;3600000;0
9872;220511;132;0;0;0;0;.00nan;0;0
9872;215217;1340;28;8;3;5;.625;512000;0
9872;-1;1340;53;28;4;24;.857;3088000;0
9873;219003;133;0;0;0;0;.00nan;0;0
9873;213799;140;0;0;0;0;.00nan;0;0
9873;220672;140;80;47;5;42;.894;3553000;0
9873;-1;133;55;29;4;25;.862;3600000;0
9874;220575;134;89;30;1;29;.967;3600000;0
9874;210876;134;0;0;0;0;.00nan;0;0
9874;211984;131;29;10;3;7;.700;438000;0
9874;212526;131;90;29;1;28;.966;3162000;0
9875;212166;128;81;29;2;27;.931;3600000;0
9875;212529;128;0;0;0;0;.00nan;0;0
9875;223929;138;48;34;5;29;.853;3600000;0
9875;-1;138;0;0;0;0;.00nan;0;0
9876;225725;136;79;40;3;37;.925;3600000;0
9876;210060;137;45;6;1;5;.833;799000;0
9876;-1;136;0;0;0;0;.00nan;0;0
9876;-1;137;56;43;6;37;.860;2801000;0
9877;213756;132;0;0;0;0;.00nan;0;0
9877;220511;132;88;51;4;47;.922;3600000;0
9877;-1;130;30;26;6;20;.769;3542000;0
9877;-1;130;0;0;0;0;.00nan;0;0
9878;220575;134;45;6;1;5;.833;403000;0
9878;210213;139;77;28;1;27;.964;3600000;0
9878;210876;134;47;36;5;31;.861;3197000;0
9878;221361;139;0;0;0;0;.00nan;0;0
9879;213799;140;51;29;4;25;.862;3550000;0
9879;220672;140;0;0;0;0;.00nan;0;0
9879;211984;131;68;32;3;29;.906;3600000;0
9879;212526;131;0;0;0;0;.00nan;0;0
9880;208575;142;0;0;0;0;.00nan;0;0
9880;215128;141;89;33;1;32;.970;3600000;0
9880;209987;141;0;0;0;0;.00nan;0;0
9880;217769;142;87;18;0;18;1.000;3600000;0
9881;209998;129;0;0;0;0;.00nan;0;0
9881;215217;1340;85;34;3;31;.912;3600000;0
9881;215319;129;54;34;4;30;.882;3571000;0
9881;-1;1340;0;0;0;0;.00nan;0;0
9882;208575;142;0;0;0;0;.00nan;0;0
9882;215331;144;0;0;0;0;.00nan;0;0
9882;217769;142;77;26;1;25;.962;3600000;0
9882;223946;144;57;25;3;22;.880;3589000;0
9883;215128;141;0;0;0;0;.00nan;0;0
9883;209987;141;88;44;2;42;.955;3900000;0
9883;215246;143;84;37;2;35;.946;3900000;0
9883;216130;143;0;0;0;0;.00nan;0;0
9884;219003;133;66;27;3;24;.889;3600000;0
9884;208556;135;0;0;0;0;.00nan;0;0
9884;-1;133;0;0;0;0;.00nan;0;0
9884;-1;135;53;33;4;29;.879;3583000;0
9885;225725;136;0;0;0;0;.00nan;0;0
9885;210060;137;74;39;3;36;.923;3636000;0
9885;-1;136;94;34;2;32;.941;3636000;0
9885;-1;137;0;0;0;0;.00nan;0;0
9886;212166;128;0;0;0;0;.00nan;0;0
9886;212529;128;87;42;3;39;.929;3515000;0
9886;223929;138;81;27;1;26;.963;3600000;0
9886;-1;138;0;0;0;0;.00nan;0;0
9887;213756;132;100;33;0;33;1.000;3600000;0
9887;220511;132;0;0;0;0;.00nan;0;0
9887;209998;129;57;35;5;30;.857;3600000;0
9887;215319;129;0;0;0;0;.00nan;0;0
9888;213799;140;0;0;0;0;.00nan;0;0
9888;215128;141;0;0;0;0;.00nan;0;0
9888;210004;141;83;27;1;26;.963;3600000;0
9888;220672;140;91;41;2;39;.951;3600000;0
9889;215217;1340;25;11;4;7;.636;1602000;0
9889;-1;130;45;23;4;19;.826;3600000;0
9889;-1;130;0;0;0;0;.00nan;0;0
9889;-1;1340;63;21;2;19;.905;1963000;0
9890;208556;135;0;0;0;0;.00nan;0;0
9890;210213;139;0;0;0;0;.00nan;0;0
9890;221361;139;66;19;1;18;.947;3900000;0
9890;-1;135;98;47;1;46;.979;3900000;0
9891;220575;134;53;35;4;31;.886;3600000;0
9891;215331;144;0;0;0;0;.00nan;0;0
9891;210876;134;0;0;0;0;.00nan;0;0
9891;223946;144;50;33;5;28;.848;3566000;0
9892;225725;136;68;32;3;29;.906;3600000;0
9892;215246;143;48;40;6;34;.850;3189000;0
9892;216130;143;44;7;1;6;.857;411000;0
9892;-1;136;0;0;0;0;.00nan;0;0
9893;213799;140;0;0;0;0;.00nan;0;0
9893;220575;134;0;0;0;0;.00nan;0;0
9893;220672;140;76;26;1;25;.962;3805000;0
9893;210876;134;79;30;2;28;.933;3805000;0
9894;225725;136;0;0;0;0;.00nan;0;0
9894;215331;144;26;25;6;19;.760;2612000;0
9894;223946;144;42;9;2;7;.778;988000;0
9894;-1;136;61;43;5;38;.884;3600000;0
9895;213756;132;82;29;2;27;.931;3600000;0
9895;220511;132;0;0;0;0;.00nan;0;0
9895;215217;1340;0;0;0;0;.00nan;0;0
9895;-1;1340;39;32;5;27;.844;3600000;0
9896;208609;131;79;49;5;44;.898;3608000;0
9896;211984;131;0;0;0;0;.00nan;0;0
9896;-1;130;0;0;0;0;.00nan;0;0
9896;-1;130;38;20;4;16;.800;3608000;0
9897;219003;133;60;22;3;19;.864;3900000;0
9897;212166;128;0;0;0;0;.00nan;0;0
9897;212529;128;75;40;3;37;.925;3900000;0
9897;-1;133;0;0;0;0;.00nan;0;0
9898;209998;129;0;0;0;0;.00nan;0;0
9898;215319;129;8;47;11;36;.766;3600000;0
9898;223929;138;27;25;6;19;.760;3600000;0
9898;-1;138;0;0;0;0;.00nan;0;0
9899;223929;138;0;0;0;0;.00nan;0;0
9899;-1;130;85;32;1;31;.969;3600000;0
9899;-1;130;0;0;0;0;.00nan;0;0
9899;-1;138;47;31;4;27;.871;3600000;0
9900;209998;129;72;36;3;33;.917;3900000;0
9900;210060;137;0;0;0;0;.00nan;0;0
9900;215319;129;0;0;0;0;.00nan;0;0
9900;-1;137;54;20;3;17;.850;3900000;0
9901;213756;132;0;0;0;0;.00nan;0;0
9901;208609;131;71;27;2;25;.926;3600000;0
9901;220511;132;56;36;5;31;.861;3600000;0
9901;211984;131;0;0;0;0;.00nan;0;0
9902;215128;141;0;0;0;0;.00nan;0;0
9902;210004;141;97;19;0;19;1.000;3600000;0
9902;225725;136;86;34;2;32;.941;3547000;0
9902;-1;136;0;0;0;0;.00nan;0;0
9903;208556;135;0;0;0;0;.00nan;0;0
9903;208575;142;0;0;0;0;.00nan;0;0
9903;217769;142;63;19;1;18;.947;3600000;0
9903;-1;135;69;45;4;41;.911;3600000;0
9904;220575;134;59;38;4;34;.895;3600000;0
9904;215246;143;0;0;0;0;.00nan;0;0
9904;210876;134;0;0;0;0;.00nan;0;0
9904;216130;143;56;26;3;23;.885;3600000;0
9905;213799;140;84;28;1;27;.964;3600000;0
9905;220672;140;0;0;0;0;.00nan;0;0
9905;210213;139;0;0;0;0;.00nan;0;0
9905;221361;139;63;27;3;24;.889;3586000;0
9906;208556;135;98;44;2;42;.955;3600000;0
9906;215331;144;0;0;0;0;.00nan;0;0
9906;223946;144;29;22;5;17;.773;3600000;0
9906;-1;135;0;0;0;0;.00nan;0;0
9907;208609;131;64;28;3;25;.893;3533000;0
9907;211984;131;0;0;0;0;.00nan;0;0
9907;212166;128;0;0;0;0;.00nan;0;0
9907;212529;128;78;28;2;26;.929;3600000;0
9908;208575;142;70;34;3;31;.912;3543000;0
9908;215128;141;0;0;0;0;.00nan;0;0
9908;210004;141;77;25;2;23;.920;3600000;0
9908;217769;142;0;0;0;0;.00nan;0;0
9909;209998;129;57;14;1;13;.929;989000;0
9909;210060;137;67;22;2;20;.909;3600000;0
9909;215319;129;47;42;6;36;.857;2611000;0
9909;-1;137;0;0;0;0;.00nan;0;0
9910;219003;133;0;0;0;0;.00nan;0;0
9910;215217;1340;34;36;8;28;.778;2939000;0
9910;-1;133;66;18;2;16;.889;3600000;0
9910;-1;1340;52;3;0;3;1.000;661000;0
9911;215246;143;31;32;6;26;.813;2972000;0
9911;215331;144;0;0;0;0;.00nan;0;0
9911;216130;143;63;7;0;7;1.000;628000;0
9911;223946;144;72;28;3;25;.893;3600000;0
9912;215128;141;0;0;0;0;.00nan;0;0
9912;210004;141;92;31;1;30;.968;3600000;0
9912;-1;130;64;23;2;21;.913;3590000;0
9912;-1;130;0;0;0;0;.00nan;0;0
9913;210213;139;0;0;0;0;.00nan;0;0
9913;221361;139;80;37;3;34;.919;3600000;0
9913;223929;138;88;30;1;29;.967;3600000;0
9913;-1;138;0;0;0;0;.00nan;0;0
9914;213799;140;0;0;0;0;.00nan;0;0
9914;208575;142;0;0;0;0;.00nan;0;0
9914;220672;140;91;42;3;39;.929;3583000;0
9914;217769;142;80;26;1;25;.962;3600000;0
9915;219003;133;72;24;1;23;.958;3600000;0
9915;215246;143;0;0;0;0;.00nan;0;0
9915;216130;143;45;33;5;28;.848;3600000;0
9915;-1;133;0;0;0;0;.00nan;0;0
9916;209998;129;94;49;3;46;.939;3600000;0
9916;210060;137;0;0;0;0;.00nan;0;0
9916;215319;129;0;0;0;0;.00nan;0;0
9916;-1;137;69;20;1;19;.950;3600000;0
9917;215128;141;61;26;2;24;.923;3600000;0
9917;210004;141;0;0;0;0;.00nan;0;0
9917;220575;134;98;53;3;50;.943;3543000;0
9917;210876;134;0;0;0;0;.00nan;0;0
9918;215217;1340;75;45;4;41;.911;3600000;0
9918;212166;128;0;0;0;0;.00nan;0;0
9918;212529;128;91;31;1;30;.968;3600000;0
9918;-1;1340;0;0;0;0;.00nan;0;0
9919;219003;133;0;0;0;0;.00nan;0;0
9919;215331;144;0;0;0;0;.00nan;0;0
9919;223946;144;67;44;4;40;.909;3600000;0
9919;-1;133;92;50;2;48;.960;3600000;0
9920;208609;131;100;35;0;35;1.000;3600000;0
9920;225725;136;52;31;4;27;.871;3600000;0
9920;211984;131;0;0;0;0;.00nan;0;0
9920;-1;136;0;0;0;0;.00nan;0;0
9921;213756;132;0;0;0;0;.00nan;0;0
9921;220511;132;77;30;1;29;.967;3600000;0
9921;210060;137;60;26;3;23;.885;3527000;0
9921;-1;137;0;0;0;0;.00nan;0;0
9922;208556;135;0;0;0;0;.00nan;0;0
9922;-1;130;0;0;0;0;.00nan;0;0
9922;-1;135;73;39;4;35;.897;3563000;0
9922;-1;130;82;34;2;32;.941;3600000;0
9923;215128;141;0;0;0;0;.00nan;0;0
9923;210004;141;78;29;3;26;.897;3600000;0
9923;225725;136;0;0;0;0;.00nan;0;0
9923;-1;136;57;38;4;34;.895;3567000;0
9924;209998;129;5;34;8;26;.765;2161000;0
9924;215217;1340;74;19;1;18;.947;3600000;0
9924;215319;129;49;8;1;7;.875;1439000;0
9924;-1;1340;0;0;0;0;.00nan;0;0
9925;213756;132;56;29;3;26;.897;3544000;0
9925;220511;132;0;0;0;0;.00nan;0;0
9925;210060;137;0;0;0;0;.00nan;0;0
9925;-1;137;91;48;2;46;.958;3600000;0
9926;220575;134;51;30;4;26;.867;3515000;0
9926;210876;134;0;0;0;0;.00nan;0;0
9926;212166;128;0;0;0;0;.00nan;0;0
9926;212529;128;80;32;2;30;.938;3600000;0
9927;219003;133;37;22;4;18;.818;3517000;0
9927;213799;140;61;19;2;17;.895;3600000;0
9927;220672;140;0;0;0;0;.00nan;0;0
9927;-1;133;0;0;0;0;.00nan;0;0
9928;215246;143;89;45;3;42;.933;3600000;0
9928;210213;139;0;0;0;0;.00nan;0;0
9928;221361;139;100;30;0;30;1.000;3600000;0
9928;216130;143;0;0;0;0;.00nan;0;0
9929;208575;142;0;0;0;0;.00nan;0;0
9929;217769;142;89;54;3;51;.944;3600000;0
9929;223929;138;50;34;5;29;.853;3562000;0
9929;-1;138;0;0;0;0;.00nan;0;0
9930;208575;142;89;37;2;35;.946;3600000;0
9930;210213;139;0;0;0;0;.00nan;0;0
9930;221361;139;60;33;4;29;.879;3523000;0
9930;217769;142;0;0;0;0;.00nan;0;0
9931;215331;144;99;55;2;53;.964;3600000;0
9931;223929;138;0;0;0;0;.00nan;0;0
9931;223946;144;0;0;0;0;.00nan;0;0
9931;-1;138;71;32;3;29;.906;3545000;0
9932;208556;135;0;0;0;0;.00nan;0;0
9932;208609;131;63;34;4;30;.882;3629000;0
9932;211984;131;0;0;0;0;.00nan;0;0
9932;-1;135;59;38;5;33;.868;3629000;0
9933;215217;1340;0;0;0;0;.00nan;0;0
9933;-1;130;0;0;0;0;.00nan;0;0
9933;-1;130;89;26;1;25;.962;3600000;0
9933;-1;1340;64;34;4;30;.882;3600000;0
9934;209998;129;31;41;7;34;.829;3600000;0
9934;215319;129;0;0;0;0;.00nan;0;0
9934;212166;128;91;20;0;20;1.000;3600000;0
9934;212529;128;0;0;0;0;.00nan;0;0
9935;213799;140;0;0;0;0;.00nan;0;0
9935;220672;140;49;30;4;26;.867;3571000;0
9935;212166;128;78;28;2;26;.929;3600000;0
9935;212529;128;0;0;0;0;.00nan;0;0
9936;215128;141;0;0;0;0;.00nan;0;0
9936;210004;141;91;31;1;30;.968;3600000;0
9936;210213;139;0;0;0;0;.00nan;0;0
9936;221361;139;76;33;3;30;.909;3600000;0
9937;208575;142;0;0;0;0;.00nan;0;0
9937;215331;144;0;0;0;0;.00nan;0;0
9937;217769;142;81;23;1;22;.957;3600000;0
9937;223946;144;67;34;3;31;.912;3543000;0
9938;210060;137;0;0;0;0;.00nan;0;0
9938;223929;138;63;25;2;23;.920;3900000;0
9938;-1;137;99;44;2;42;.955;3900000;0
9938;-1;138;0;0;0;0;.00nan;0;0
9939;208609;131;0;0;0;0;.00nan;0;0
9939;215217;1340;85;31;2;29;.935;3900000;0
9939;211984;131;82;36;2;34;.944;3900000;0
9939;-1;1340;0;0;0;0;.00nan;0;0
9940;213756;132;0;0;0;0;.00nan;0;0
9940;220511;132;55;23;3;20;.870;3900000;0
9940;225725;136;85;37;3;34;.919;3900000;0
9940;-1;136;0;0;0;0;.00nan;0;0
9941;219003;133;44;21;4;17;.810;3600000;0
9941;215246;143;99;36;1;35;.972;3600000;0
9941;216130;143;0;0;0;0;.00nan;0;0
9941;-1;133;0;0;0;0;.00nan;0;0
9942;220575;134;51;41;6;35;.854;3600000;0
9942;210876;134;0;0;0;0;.00nan;0;0
9942;-1;130;0;0;0;0;.00nan;0;0
9942;-1;130;50;19;3;16;.842;3600000;0
9943;208556;135;0;0;0;0;.00nan;0;0
9943;210060;137;62;35;4;31;.886;3557000;0
9943;-1;135;57;25;3;22;.880;3600000;0
9943;-1;137;0;0;0;0;.00nan;0;0
9944;219003;133;0;0;0;0;.00nan;0;0
9944;-1;133;73;46;5;41;.891;3600000;0
9944;-1;130;73;25;1;24;.960;3600000;0
9944;-1;130;0;0;0;0;.00nan;0;0
9945;220575;134;0;0;0;0;.00nan;0;0
9945;215246;143;0;0;0;0;.00nan;0;0
9945;210876;134;69;30;3;27;.900;3563000;0
9945;216130;143;77;24;1;23;.958;3600000;0
9946;215331;144;39;24;4;20;.833;3549000;0
9946;212166;128;0;0;0;0;.00nan;0;0
9946;212529;128;71;32;3;29;.906;3600000;0
9946;223946;144;0;0;0;0;.00nan;0;0
9947;209998;129;74;44;5;39;.886;3575000;0
9947;225725;136;0;0;0;0;.00nan;0;0
9947;215319;129;0;0;0;0;.00nan;0;0
9947;-1;136;50;20;3;17;.850;3600000;0
9948;213799;140;0;0;0;0;.00nan;0;0
9948;220672;140;77;12;0;12;1.000;3600000;0
9948;215331;144;0;0;0;0;.00nan;0;0
9948;223946;144;63;41;5;36;.878;3600000;0
9949;208575;142;0;0;0;0;.00nan;0;0
9949;210213;139;0;0;0;0;.00nan;0;0
9949;221361;139;78;29;2;27;.931;3600000;0
9949;217769;142;55;29;4;25;.862;3550000;0
9950;215217;1340;63;31;5;26;.839;3600000;0
9950;215246;143;43;43;6;37;.860;3600000;0
9950;216130;143;0;0;0;0;.00nan;0;0
9950;-1;1340;0;0;0;0;.00nan;0;0
9951;213756;132;68;31;3;28;.903;3600000;0
9951;220511;132;0;0;0;0;.00nan;0;0
9951;225725;136;74;37;4;33;.892;3600000;0
9951;-1;136;0;0;0;0;.00nan;0;0
9952;215128;141;0;0;0;0;.00nan;0;0
9952;210004;141;49;21;3;18;.857;3744000;0
9952;212166;128;38;25;4;21;.840;3744000;0
9952;212529;128;0;0;0;0;.00nan;0;0
9953;208556;135;33;34;6;28;.824;2729000;0
9953;223929;138;57;15;2;13;.867;3600000;0
9953;-1;135;49;11;2;9;.818;871000;0
9953;-1;138;0;0;0;0;.00nan;0;0
9954;219003;133;58;30;3;27;.900;3600000;0
9954;209998;129;85;53;5;48;.906;3557000;0
9954;215319;129;0;0;0;0;.00nan;0;0
9954;-1;133;0;0;0;0;.00nan;0;0
9955;208556;135;0;0;0;0;.00nan;0;0
9955;215217;1340;68;32;3;29;.906;3600000;0
9955;-1;135;70;39;4;35;.897;3581000;0
9955;-1;1340;0;0;0;0;.00nan;0;0
9956;213756;132;0;0;0;0;.00nan;0;0
9956;219003;133;0;0;0;0;.00nan;0;0
9956;220511;132;58;48;6;42;.875;3895000;0
9956;-1;133;50;34;5;29;.853;3895000;0
9957;209998;129;58;47;6;41;.872;2919000;0
9957;215319;129;41;8;2;6;.750;681000;0
9957;-1;130;0;0;0;0;.00nan;0;0
9957;-1;130;66;20;2;18;.900;3600000;0
9958;208609;131;84;33;2;31;.939;3600000;0
9958;210060;137;0;0;0;0;.00nan;0;0
9958;211984;131;0;0;0;0;.00nan;0;0
9958;-1;137;76;44;4;40;.909;3523000;0
9959;208575;142;0;0;0;0;.00nan;0;0
9959;220575;134;98;36;1;35;.972;3600000;0
9959;210876;134;0;0;0;0;.00nan;0;0
9959;217769;142;78;33;2;31;.939;3593000;0
9960;215217;1340;58;6;0;6;1.000;332000;0
9960;223929;138;56;23;3;20;.870;3600000;0
9960;-1;138;0;0;0;0;.00nan;0;0
9960;-1;1340;66;45;6;39;.867;3268000;0
9961;213799;140;0;0;0;0;.00nan;0;0
9961;215246;143;0;0;0;0;.00nan;0;0
9961;220672;140;100;28;0;28;1.000;3600000;0
9961;216130;143;78;39;2;37;.949;3545000;0
9962;215331;144;52;38;5;33;.868;3600000;0
9962;210213;139;92;34;1;33;.971;3600000;0
9962;221361;139;0;0;0;0;.00nan;0;0
9962;223946;144;0;0;0;0;.00nan;0;0
9963;210060;137;88;36;2;34;.944;3600000;0
9963;-1;135;58;34;4;30;.882;3562000;0
9963;-1;137;0;0;0;0;.00nan;0;0
9963;-1;135;0;0;0;0;.00nan;0;0
9964;208575;142;0;0;0;0;.00nan;0;0
9964;208609;131;0;0;0;0;.00nan;0;0
9964;211984;131;68;47;5;42;.894;3600000;0
9964;217769;142;78;26;1;25;.962;3600000;0
9965;209998;129;66;9;0;9;1.000;1236000;0
9965;220575;134;0;0;0;0;.00nan;0;0
9965;215319;129;34;22;4;18;.818;2364000;0
9965;210876;134;71;28;2;26;.929;3600000;0
9966;213756;132;0;0;0;0;.00nan;0;0
9966;220511;132;56;27;3;24;.889;3528000;0
9966;212166;128;0;0;0;0;.00nan;0;0
9966;212529;128;97;33;1;32;.970;3600000;0
9967;210060;137;76;21;2;19;.905;1443000;0
9967;-1;135;81;28;1;27;.964;3600000;0
9967;-1;137;36;21;4;17;.810;2157000;0
9967;-1;135;0;0;0;0;.00nan;0;0
9968;213756;132;56;30;4;26;.867;3900000;0
9968;220511;132;0;0;0;0;.00nan;0;0
9968;215217;1340;45;30;4;26;.867;3900000;0
9968;-1;1340;0;0;0;0;.00nan;0;0
9969;225725;136;81;58;7;51;.879;3600000;0
9969;-1;130;0;0;0;0;.00nan;0;0
9969;-1;136;0;0;0;0;.00nan;0;0
9969;-1;130;59;24;2;22;.917;3600000;0
9970;219003;133;49;37;5;32;.865;3552000;0
9970;208575;142;0;0;0;0;.00nan;0;0
9970;217769;142;55;30;4;26;.867;3600000;0
9970;-1;133;0;0;0;0;.00nan;0;0
9971;213799;140;0;0;0;0;.00nan;0;0
9971;215128;141;0;0;0;0;.00nan;0;0
9971;210004;141;66;38;5;33;.868;3579000;0
9971;220672;140;64;28;3;25;.893;3600000;0
9972;215331;144;0;0;0;0;.00nan;0;0
9972;210213;139;0;0;0;0;.00nan;0;0
9972;221361;139;55;35;5;30;.857;3600000;0
9972;223946;144;76;34;2;32;.941;3600000;0
9973;225725;136;0;0;0;0;.00nan;0;0
9973;-1;130;64;16;1;15;.938;3600000;0
9973;-1;136;59;42;5;37;.881;3600000;0
9973;-1;130;0;0;0;0;.00nan;0;0
9974;209998;129;68;44;5;39;.886;3555000;0
9974;215319;129;0;0;0;0;.00nan;0;0
9974;212166;128;0;0;0;0;.00nan;0;0
9974;212529;128;46;18;3;15;.833;3600000;0
9975;215128;141;0;0;0;0;.00nan;0;0
9975;210004;141;78;30;2;28;.933;3600000;0
9975;215246;143;36;30;6;24;.800;2784000;0
9975;216130;143;46;6;1;5;.833;816000;0
9976;219003;133;48;0;0;0;.00nan;210000;0
9976;223929;138;51;28;4;24;.857;3600000;0
9976;-1;133;46;36;6;30;.833;3341000;0
9976;-1;138;0;0;0;0;.00nan;0;0
9977;208609;131;73;31;5;26;.839;3900000;0
9977;220575;134;64;44;5;39;.886;3866000;0
9977;210876;134;0;0;0;0;.00nan;0;0
9977;211984;131;0;0;0;0;.00nan;0;0
9978;213799;140;0;0;0;0;.00nan;0;0
9978;215217;1340;49;32;5;27;.844;3582000;0
9978;220672;140;78;31;3;28;.903;3600000;0
9978;-1;1340;0;0;0;0;.00nan;0;0
9979;215128;141;0;0;0;0;.00nan;0;0
9979;210004;141;65;29;3;26;.897;3600000;0
9979;210060;137;0;0;0;0;.00nan;0;0
9979;-1;137;72;38;4;34;.895;3551000;0
9980;225725;136;81;35;3;32;.914;3600000;0
9980;210213;139;66;41;4;37;.902;3565000;0
9980;221361;139;0;0;0;0;.00nan;0;0
9980;-1;136;0;0;0;0;.00nan;0;0
9981;208575;142;0;0;0;0;.00nan;0;0
9981;215246;143;0;0;0;0;.00nan;0;0
9981;216130;143;74;53;6;47;.887;3541000;0
9981;217769;142;54;24;4;20;.833;3600000;0
9982;213799;140;0;0;0;0;.00nan;0;0
9982;209998;129;54;49;6;43;.878;3600000;0
9982;215319;129;0;0;0;0;.00nan;0;0
9982;220672;140;43;23;4;19;.826;3600000;0
9983;220575;134;69;47;5;42;.894;3600000;0
9983;210876;134;0;0;0;0;.00nan;0;0
9983;-1;130;0;0;0;0;.00nan;0;0
9983;-1;130;51;16;2;14;.875;3600000;0
9984;215246;143;61;42;5;37;.881;3564000;0
9984;215331;144;70;34;3;31;.912;3600000;0
9984;216130;143;0;0;0;0;.00nan;0;0
9984;223946;144;0;0;0;0;.00nan;0;0
9985;210060;137;0;0;0;0;.00nan;0;0
9985;210213;139;0;0;0;0;.00nan;0;0
9985;221361;139;49;23;3;20;.870;3523000;0
9985;-1;137;90;23;1;22;.957;3600000;0
9986;215217;1340;74;40;4;36;.900;3600000;0
9986;225725;136;90;27;1;26;.963;3600000;0
9986;-1;136;0;0;0;0;.00nan;0;0
9986;-1;1340;0;0;0;0;.00nan;0;0
9987;213756;132;43;24;4;20;.833;3600000;0
9987;213799;140;50;35;5;30;.857;3558000;0
9987;220511;132;0;0;0;0;.00nan;0;0
9987;220672;140;0;0;0;0;.00nan;0;0
9988;219003;133;60;26;3;23;.885;3600000;0
9988;208609;131;26;19;5;14;.737;1501000;0
9988;211984;131;69;30;2;28;.933;2099000;0
9988;-1;133;0;0;0;0;.00nan;0;0
9989;212166;128;0;0;0;0;.00nan;0;0
9989;212529;128;45;20;4;16;.800;3559000;0
9989;-1;135;98;39;2;37;.949;3600000;0
9989;-1;135;0;0;0;0;.00nan;0;0
9990;215128;141;0;0;0;0;.00nan;0;0
9990;210004;141;99;37;1;36;.973;3600000;0
9990;223929;138;52;14;2;12;.857;3600000;0
9990;-1;138;0;0;0;0;.00nan;0;0
9991;210213;139;26;26;6;20;.769;2092000;0
9991;221361;139;61;14;1;13;.929;1508000;0
9991;223929;138;0;0;0;0;.00nan;0;0
9991;-1;138;76;25;1;24;.960;3600000;0
9992;215217;1340;0;0;0;0;.00nan;0;0
9992;225725;136;0;0;0;0;.00nan;0;0
9992;-1;136;47;27;5;22;.815;3791000;0
9992;-1;1340;46;27;4;23;.852;3791000;0
9993;213756;132;0;0;0;0;.00nan;0;0
9993;220511;132;82;35;2;33;.943;3588000;0
9993;220575;134;100;29;0;29;1.000;3600000;0
9993;210876;134;0;0;0;0;.00nan;0;0
9994;212166;128;88;37;3;34;.919;3600000;0
9994;212529;128;0;0;0;0;.00nan;0;0
9994;-1;130;0;0;0;0;.00nan;0;0
9994;-1;130;52;38;5;33;.868;3587000;0
9995;208609;131;71;21;1;20;.952;3545000;0
9995;215128;141;0;0;0;0;.00nan;0;0
9995;210004;141;100;27;0;27;1.000;3600000;0
9995;211984;131;0;0;0;0;.00nan;0;0
9996;208575;142;0;0;0;0;.00nan;0;0
9996;215331;144;0;0;0;0;.00nan;0;0
9996;217769;142;50;21;3;18;.857;3600000;0
9996;223946;144;65;52;5;47;.904;3589000;0
9997;219003;133;0;0;0;0;.00nan;0;0
9997;-1;133;28;27;6;21;.778;3556000;0
9997;-1;135;63;43;5;38;.884;3600000;0
9997;-1;135;0;0;0;0;.00nan;0;0
9998;209998;129;65;39;4;35;.897;3600000;0
9998;220575;134;39;13;3;10;.769;3600000;0
9998;215319;129;0;0;0;0;.00nan;0;0
9998;210876;134;0;0;0;0;.00nan;0;0
9999;223929;138;100;28;0;28;1.000;3600000;0
9999;-1;135;0;0;0;0;.00nan;0;0
9999;-1;135;98;42;1;41;.976;3582000;0
9999;-1;138;0;0;0;0;.00nan;0;0
10000;215128;141;0;0;0;0;.00nan;0;0
10000;210004;141;86;43;3;40;.930;3597000;0
10000;210213;139;0;0;0;0;.00nan;0;0
10000;221361;139;90;34;1;33;.971;3600000;0
10001;215246;143;60;48;5;43;.896;3573000;0
10001;216130;143;0;0;0;0;.00nan;0;0
10001;-1;130;0;0;0;0;.00nan;0;0
10001;-1;130;71;31;3;28;.903;3600000;0
10002;213756;132;77;31;2;29;.935;3728000;0
10002;208609;131;56;22;3;19;.864;3728000;0
10002;220511;132;0;0;0;0;.00nan;0;0
10002;211984;131;0;0;0;0;.00nan;0;0
10003;225725;136;55;38;5;33;.868;3600000;0
10003;212166;128;0;0;0;0;.00nan;0;0
10003;212529;128;86;29;2;27;.931;3600000;0
10003;-1;136;0;0;0;0;.00nan;0;0
10004;219003;133;25;14;4;10;.714;989000;0
10004;223929;138;83;29;1;28;.966;3600000;0
10004;-1;133;40;22;4;18;.818;2611000;0
10004;-1;138;0;0;0;0;.00nan;0;0
10005;215128;141;0;0;0;0;.00nan;0;0
10005;210004;141;64;33;3;30;.909;3550000;0
10005;215217;1340;72;27;2;25;.926;3600000;0
10005;-1;1340;0;0;0;0;.00nan;0;0
10006;213799;140;0;0;0;0;.00nan;0;0
10006;220672;140;80;33;2;31;.939;3600000;0
10006;-1;130;43;35;7;28;.800;2864000;0
10006;-1;130;55;6;0;6;1.000;736000;0
10007;208575;142;0;0;0;0;.00nan;0;0
10007;210213;139;14;28;7;21;.750;1834000;0
10007;221361;139;79;20;0;20;1.000;1766000;0
10007;217769;142;54;25;3;22;.880;3600000;0
10008;219003;133;52;23;4;19;.826;3708000;0
10008;210060;137;0;0;0;0;.00nan;0;0
10008;-1;133;0;0;0;0;.00nan;0;0
10008;-1;137;73;33;3;30;.909;3708000;0
10009;209998;129;0;0;0;0;.00nan;0;0
10009;215319;129;66;33;3;30;.909;3600000;0
10009;-1;135;91;18;0;18;1.000;3600000;0
10009;-1;135;0;0;0;0;.00nan;0;0
10010;213756;132;0;0;0;0;.00nan;0;0
10010;220511;132;91;38;2;36;.947;3600000;0
10010;220575;134;81;27;1;26;.963;3600000;0
10010;210876;134;0;0;0;0;.00nan;0;0
10011;208609;131;0;0;0;0;.00nan;0;0
10011;211984;131;98;25;0;25;1.000;3600000;0
10011;212166;128;68;32;2;30;.938;3526000;0
10011;212529;128;0;0;0;0;.00nan;0;0
10012;225725;136;42;40;6;34;.850;3562000;0
10012;223929;138;55;27;4;23;.852;3600000;0
10012;-1;136;0;0;0;0;.00nan;0;0
10012;-1;138;0;0;0;0;.00nan;0;0
10013;215331;144;31;29;6;23;.793;2001000;0
10013;223946;144;63;17;1;16;.941;1577000;0
10013;-1;130;51;1;0;1;1.000;319000;0
10013;-1;130;31;24;5;19;.792;3281000;0
10014;215217;1340;58;6;0;6;1.000;1001000;0
10014;215246;143;0;0;0;0;.00nan;0;0
10014;216130;143;66;43;5;38;.884;3600000;0
10014;-1;1340;41;29;6;23;.793;2569000;0
10015;209998;129;77;32;2;30;.938;3580000;0
10015;215319;129;0;0;0;0;.00nan;0;0
10015;-1;135;60;12;1;11;.917;3600000;0
10015;-1;135;0;0;0;0;.00nan;0;0
10016;213799;140;0;0;0;0;.00nan;0;0
10016;215217;1340;68;39;4;35;.897;3600000;0
10016;220672;140;42;28;5;23;.821;3596000;0
10016;-1;1340;0;0;0;0;.00nan;0;0
10017;208575;142;66;13;0;13;1.000;1095000;0
10017;215128;141;0;0;0;0;.00nan;0;0
10017;210004;141;80;26;1;25;.962;3600000;0
10017;217769;142;33;32;6;26;.813;2505000;0
10018;225725;136;0;0;0;0;.00nan;0;0
10018;212166;128;0;0;0;0;.00nan;0;0
10018;212529;128;69;35;3;32;.914;3600000;0
10018;-1;136;31;26;5;21;.808;3600000;0
10019;213756;132;0;0;0;0;.00nan;0;0
10019;220511;132;85;30;2;28;.933;3900000;0
10019;-1;135;90;42;2;40;.952;3900000;0
10019;-1;135;0;0;0;0;.00nan;0;0
10020;219003;133;0;0;0;0;.00nan;0;0
10020;208609;131;0;0;0;0;.00nan;0;0
10020;211984;131;96;45;2;43;.956;3530000;0
10020;-1;133;82;16;0;16;1.000;3600000;0
10021;220575;134;54;32;5;27;.844;3570000;0
10021;210060;137;0;0;0;0;.00nan;0;0
10021;210876;134;0;0;0;0;.00nan;0;0
10021;-1;137;71;32;3;29;.906;3600000;0
10022;208575;142;0;0;0;0;.00nan;0;0
10022;215128;141;72;33;3;30;.909;3572000;0
10022;210004;141;0;0;0;0;.00nan;0;0
10022;217769;142;75;26;2;24;.923;3600000;0
10023;213799;140;35;32;6;26;.813;3600000;0
10023;220672;140;0;0;0;0;.00nan;0;0
10023;215331;144;0;0;0;0;.00nan;0;0
10023;223946;144;96;45;3;42;.933;3600000;0
10024;215246;143;41;23;4;19;.826;3600000;0
10024;210213;139;43;28;5;23;.821;3545000;0
10024;221361;139;0;0;0;0;.00nan;0;0
10024;216130;143;0;0;0;0;.00nan;0;0
10025;213799;140;0;0;0;0;.00nan;0;0
10025;215128;141;0;0;0;0;.00nan;0;0
10025;210004;141;69;28;3;25;.893;3635000;0
10025;220672;140;65;34;4;30;.882;3635000;0
10026;220575;134;91;40;3;37;.925;3600000;0
10026;210060;137;0;0;0;0;.00nan;0;0
10026;210876;134;0;0;0;0;.00nan;0;0
10026;-1;137;96;21;0;21;1.000;3600000;0
10027;215217;1340;24;28;6;22;.786;2099000;0
10027;-1;130;0;0;0;0;.00nan;0;0
10027;-1;130;100;24;0;24;1.000;3600000;0
10027;-1;1340;27;12;4;8;.667;1501000;0
10028;213756;132;0;0;0;0;.00nan;0;0
10028;220511;132;43;11;2;9;.818;3600000;0
10028;209998;129;61;42;5;37;.881;3600000;0
10028;215319;129;0;0;0;0;.00nan;0;0
10029;208575;142;0;0;0;0;.00nan;0;0
10029;212166;128;0;0;0;0;.00nan;0;0
10029;212529;128;89;35;2;33;.943;3545000;0
10029;217769;142;64;20;1;19;.950;3600000;0
10030;225725;136;84;46;4;42;.913;3600000;0
10030;223929;138;45;27;5;22;.815;3600000;0
10030;-1;136;0;0;0;0;.00nan;0;0
10030;-1;138;0;0;0;0;.00nan;0;0
10031;215246;143;0;0;0;0;.00nan;0;0
10031;216130;143;89;39;2;37;.949;3600000;0
10031;-1;135;0;0;0;0;.00nan;0;0
10031;-1;135;46;30;4;26;.867;3530000;0
10032;208575;142;68;21;2;19;.905;3600000;0
10032;215217;1340;46;26;4;22;.846;3556000;0
10032;217769;142;0;0;0;0;.00nan;0;0
10032;-1;1340;0;0;0;0;.00nan;0;0
10033;219003;133;0;0;0;0;.00nan;0;0
10033;208609;131;90;50;4;46;.920;3600000;0
10033;211984;131;0;0;0;0;.00nan;0;0
10033;-1;133;85;17;0;17;1.000;3600000;0
10034;220575;134;59;31;4;27;.871;3605000;0
10034;210876;134;0;0;0;0;.00nan;0;0
10034;223929;138;0;0;0;0;.00nan;0;0
10034;-1;138;58;28;3;25;.893;3605000;0
10035;225725;136;59;30;3;27;.900;3900000;0
10035;210060;137;0;0;0;0;.00nan;0;0
10035;-1;136;0;0;0;0;.00nan;0;0
10035;-1;137;72;31;3;28;.903;3900000;0
10036;209998;129;75;35;2;33;.943;3581000;0
10036;215319;129;0;0;0;0;.00nan;0;0
10036;-1;130;0;0;0;0;.00nan;0;0
10036;-1;130;89;21;0;21;1.000;3600000;0
10037;208609;131;0;0;0;0;.00nan;0;0
10037;215246;143;25;30;6;24;.800;3078000;0
10037;216130;143;48;8;1;7;.875;522000;0
10037;211984;131;72;36;3;33;.917;3600000;0
10038;213756;132;0;0;0;0;.00nan;0;0
10038;220511;132;72;25;1;24;.960;3600000;0
10038;212166;128;0;0;0;0;.00nan;0;0
10038;212529;128;51;23;3;20;.870;3514000;0
10039;215128;141;0;0;0;0;.00nan;0;0
10039;210004;141;44;25;4;21;.840;3600000;0
10039;215331;144;0;0;0;0;.00nan;0;0
10039;223946;144;69;49;6;43;.878;3600000;0
10040;213799;140;0;0;0;0;.00nan;0;0
10040;220672;140;69;44;5;39;.886;3600000;0
10040;210213;139;0;0;0;0;.00nan;0;0
10040;221361;139;86;45;2;43;.956;3600000;0
10041;213799;140;62;30;3;27;.900;3850000;0
10041;220672;140;0;0;0;0;.00nan;0;0
10041;210213;139;93;53;4;49;.925;3850000;0
10041;221361;139;0;0;0;0;.00nan;0;0
10042;215128;141;0;0;0;0;.00nan;0;0
10042;210004;141;76;47;5;42;.894;3600000;0
10042;215331;144;99;24;0;24;1.000;3600000;0
10042;223946;144;0;0;0;0;.00nan;0;0
10043;208575;142;0;0;0;0;.00nan;0;0
10043;217769;142;60;21;2;19;.905;3600000;0
10043;-1;135;64;34;3;31;.912;3581000;0
10043;-1;135;0;0;0;0;.00nan;0;0
10044;213756;132;15;46;10;36;.783;3600000;0
10044;220511;132;0;0;0;0;.00nan;0;0
10044;-1;130;0;0;0;0;.00nan;0;0
10044;-1;130;73;27;2;25;.926;3600000;0
10045;215246;143;0;0;0;0;.00nan;0;0
10045;216130;143;68;36;5;31;.861;3554000;0
10045;212166;128;52;22;3;19;.864;3600000;0
10045;212529;128;0;0;0;0;.00nan;0;0
10046;225725;136;0;0;0;0;.00nan;0;0
10046;210060;137;41;33;6;27;.818;2735000;0
10046;-1;136;47;24;4;20;.833;3600000;0
10046;-1;137;47;6;1;5;.833;865000;0
10047;219003;133;0;0;0;0;.00nan;0;0
10047;220575;134;59;37;4;33;.892;3600000;0
10047;210876;134;0;0;0;0;.00nan;0;0
10047;-1;133;93;22;0;22;1.000;3600000;0
10048;208609;131;60;26;3;23;.885;3600000;0
10048;209998;129;0;0;0;0;.00nan;0;0
10048;215319;129;62;40;4;36;.900;3584000;0
10048;211984;131;0;0;0;0;.00nan;0;0
10049;208575;142;0;0;0;0;.00nan;0;0
10049;210213;139;0;0;0;0;.00nan;0;0
10049;221361;139;76;37;3;34;.919;3600000;0
10049;217769;142;51;38;6;32;.842;3600000;0
10050;215217;1340;67;30;3;27;.900;3600000;0
10050;223929;138;30;19;4;15;.789;3600000;0
10050;-1;138;0;0;0;0;.00nan;0;0
10050;-1;1340;0;0;0;0;.00nan;0;0
10051;215331;144;41;35;6;29;.829;2514000;0
10051;223946;144;41;23;4;19;.826;1086000;0
10051;-1;130;0;0;0;0;.00nan;0;0
10051;-1;130;48;14;2;12;.857;3600000;0
10052;220575;134;87;42;2;40;.952;3600000;0
10052;210876;134;0;0;0;0;.00nan;0;0
10052;-1;135;41;37;6;31;.838;3358000;0
10052;-1;135;42;3;1;2;.667;242000;0
10053;215128;141;0;0;0;0;.00nan;0;0
10053;210004;141;47;26;4;22;.846;3868000;0
10053;210060;137;0;0;0;0;.00nan;0;0
10053;-1;137;50;36;5;31;.861;3868000;0
10054;213799;140;0;0;0;0;.00nan;0;0
10054;208575;142;87;32;2;30;.938;3900000;0
10054;220672;140;68;27;2;25;.926;3900000;0
10054;217769;142;0;0;0;0;.00nan;0;0
10055;213756;132;48;21;4;17;.810;3600000;0
10055;219003;133;0;0;0;0;.00nan;0;0
10055;220511;132;0;0;0;0;.00nan;0;0
10055;-1;133;33;31;6;25;.806;3588000;0
10056;210060;137;86;29;1;28;.966;3600000;0
10056;215246;143;77;20;1;19;.950;1906000;0
10056;216130;143;12;19;6;13;.684;1694000;0
10056;-1;137;0;0;0;0;.00nan;0;0
10057;209998;129;72;45;5;40;.889;3543000;0
10057;215319;129;0;0;0;0;.00nan;0;0
10057;223929;138;45;22;4;18;.818;3600000;0
10057;-1;138;0;0;0;0;.00nan;0;0
10058;213756;132;29;22;5;17;.773;3559000;0
10058;220511;132;0;0;0;0;.00nan;0;0
10058;215217;1340;0;0;0;0;.00nan;0;0
10058;-1;1340;61;29;3;26;.897;3600000;0
10059;219003;133;0;0;0;0;.00nan;0;0
10059;212166;128;0;0;0;0;.00nan;0;0
10059;212529;128;45;30;4;26;.867;3561000;0
10059;-1;133;87;37;3;34;.919;3600000;0
10060;208609;131;57;31;4;27;.871;3600000;0
10060;215331;144;0;0;0;0;.00nan;0;0
10060;211984;131;0;0;0;0;.00nan;0;0
10060;223946;144;87;33;1;32;.970;3600000;0
10061;220575;134;66;43;5;38;.884;3871000;0
10061;210876;134;0;0;0;0;.00nan;0;0
10061;-1;130;0;0;0;0;.00nan;0;0
10061;-1;130;45;28;4;24;.857;3871000;0
10062;213799;140;54;16;2;14;.875;3559000;0
10062;210060;137;0;0;0;0;.00nan;0;0
10062;220672;140;0;0;0;0;.00nan;0;0
10062;-1;137;100;45;1;44;.978;3600000;0
10063;225725;136;88;31;1;30;.968;3600000;0
10063;-1;136;0;0;0;0;.00nan;0;0
10063;-1;135;53;18;2;16;.889;3599000;0
10063;-1;135;0;0;0;0;.00nan;0;0
10064;215217;1340;100;38;1;37;.974;3600000;0
10064;-1;130;60;29;3;26;.897;3564000;0
10064;-1;130;0;0;0;0;.00nan;0;0
10064;-1;1340;0;0;0;0;.00nan;0;0
10065;220575;134;75;47;5;42;.894;3746000;0
10065;215331;144;29;31;6;25;.806;3746000;0
10065;210876;134;0;0;0;0;.00nan;0;0
10065;223946;144;0;0;0;0;.00nan;0;0
10066;215128;141;0;0;0;0;.00nan;0;0
10066;210004;141;94;44;3;41;.932;3900000;0
10066;210213;139;71;29;3;26;.897;3900000;0
10066;221361;139;0;0;0;0;.00nan;0;0
10067;208575;142;0;0;0;0;.00nan;0;0
10067;215246;143;0;0;0;0;.00nan;0;0
10067;216130;143;86;39;2;37;.949;3579000;0
10067;217769;142;85;17;0;17;1.000;3600000;0
10068;209998;129;0;0;0;0;.00nan;0;0
10068;215319;129;77;40;4;36;.900;3791000;0
10068;223929;138;0;0;0;0;.00nan;0;0
10068;-1;138;48;17;3;14;.824;3791000;0
10069;213799;140;0;0;0;0;.00nan;0;0
10069;220672;140;70;39;4;35;.897;3568000;0
10069;210213;139;56;29;3;26;.897;3600000;0
10069;221361;139;0;0;0;0;.00nan;0;0
10070;219003;133;0;0;0;0;.00nan;0;0
10070;225725;136;0;0;0;0;.00nan;0;0
10070;-1;133;41;31;5;26;.839;3567000;0
10070;-1;136;56;30;4;26;.867;3600000;0
10071;213756;132;0;0;0;0;.00nan;0;0
10071;220511;132;53;39;5;34;.872;3563000;0
10071;223929;138;52;24;3;21;.875;3600000;0
10071;-1;138;0;0;0;0;.00nan;0;0
10072;208609;131;0;0;0;0;.00nan;0;0
10072;211984;131;81;24;1;23;.958;3600000;0
10072;212166;128;0;0;0;0;.00nan;0;0
10072;212529;128;87;32;2;30;.938;3584000;0
10073;215128;141;0;0;0;0;.00nan;0;0
10073;210004;141;53;21;3;18;.857;3600000;0
10073;215246;143;0;0;0;0;.00nan;0;0
10073;216130;143;76;27;1;26;.963;3600000;0
10074;215331;144;55;13;1;12;.923;1409000;0
10074;210213;139;0;0;0;0;.00nan;0;0
10074;221361;139;85;33;2;31;.939;3600000;0
10074;223946;144;28;27;6;21;.778;2191000;0
10075;220575;134;65;29;3;26;.897;3553000;0
10075;210876;134;0;0;0;0;.00nan;0;0
10075;-1;135;54;14;2;12;.857;3600000;0
10075;-1;135;0;0;0;0;.00nan;0;0
10076;208609;131;35;28;5;23;.821;3546000;0
10076;210060;137;0;0;0;0;.00nan;0;0
10076;211984;131;0;0;0;0;.00nan;0;0
10076;-1;137;74;29;3;26;.897;3600000;0
10077;213756;132;83;29;2;27;.931;3600000;0
10077;220511;132;0;0;0;0;.00nan;0;0
10077;209998;129;58;51;7;44;.863;3600000;0
10077;215319;129;0;0;0;0;.00nan;0;0
10078;212166;128;0;0;0;0;.00nan;0;0
10078;212529;128;51;35;5;30;.857;3600000;0
10078;-1;130;0;0;0;0;.00nan;0;0
10078;-1;130;87;27;1;26;.963;3600000;0
10079;215246;143;0;0;0;0;.00nan;0;0
10079;210213;139;62;28;3;25;.893;3600000;0
10079;221361;139;0;0;0;0;.00nan;0;0
10079;216130;143;80;50;4;46;.920;3543000;0
10080;213799;140;0;0;0;0;.00nan;0;0
10080;208575;142;0;0;0;0;.00nan;0;0
10080;220672;140;68;35;5;30;.857;3600000;0
10080;217769;142;79;21;1;20;.952;3600000;0
10081;215217;1340;47;29;5;24;.828;3600000;0
10081;-1;135;95;34;1;33;.971;3600000;0
10081;-1;135;0;0;0;0;.00nan;0;0
10081;-1;1340;0;0;0;0;.00nan;0;0
10082;225725;136;56;41;5;36;.878;3600000;0
10082;-1;130;0;0;0;0;.00nan;0;0
10082;-1;136;0;0;0;0;.00nan;0;0
10082;-1;130;54;17;3;14;.824;3600000;0
10083;213756;132;75;40;4;36;.900;3600000;0
10083;220511;132;0;0;0;0;.00nan;0;0
10083;212166;128;20;28;7;21;.750;2677000;0
10083;212529;128;52;3;0;3;1.000;923000;0
10084;208609;131;51;38;6;32;.842;3900000;0
10084;220575;134;40;28;6;22;.786;3900000;0
10084;210876;134;0;0;0;0;.00nan;0;0
10084;211984;131;0;0;0;0;.00nan;0;0
10085;215217;1340;81;22;1;21;.955;3600000;0
10085;-1;135;49;13;3;10;.769;2011000;0
10085;-1;135;16;21;6;15;.714;1589000;0
10085;-1;1340;0;0;0;0;.00nan;0;0
10086;210060;137;0;0;0;0;.00nan;0;0
10086;223929;138;47;22;4;18;.818;3600000;0
10086;-1;137;80;57;5;52;.912;3600000;0
10086;-1;138;0;0;0;0;.00nan;0;0
10087;225725;136;0;0;0;0;.00nan;0;0
10087;-1;130;72;27;2;25;.926;3600000;0
10087;-1;136;64;45;5;40;.889;3600000;0
10087;-1;130;0;0;0;0;.00nan;0;0
10088;213756;132;59;6;0;6;1.000;521000;0
10088;219003;133;0;0;0;0;.00nan;0;0
10088;220511;132;36;40;7;33;.825;3079000;0
10088;-1;133;47;20;3;17;.850;3600000;0
10089;215246;143;41;32;6;26;.813;3600000;0
10089;210213;139;0;0;0;0;.00nan;0;0
10089;221361;139;67;30;3;27;.900;3600000;0
10089;216130;143;0;0;0;0;.00nan;0;0
10090;215128;141;0;0;0;0;.00nan;0;0
10090;210004;141;66;35;4;31;.886;3600000;0
10090;215331;144;0;0;0;0;.00nan;0;0
10090;223946;144;37;36;6;30;.833;3515000;0
10091;209998;129;0;0;0;0;.00nan;0;0
10091;215319;129;65;30;3;27;.900;3900000;0
10091;212166;128;0;0;0;0;.00nan;0;0
10091;212529;128;58;31;3;28;.903;3900000;0
10092;213799;140;0;0;0;0;.00nan;0;0
10092;220672;140;47;23;3;20;.870;3900000;0
10092;215331;144;66;29;3;26;.897;3900000;0
10092;223946;144;0;0;0;0;.00nan;0;0
10093;208575;142;0;0;0;0;.00nan;0;0
10093;215128;141;0;0;0;0;.00nan;0;0
10093;210004;141;67;45;5;40;.889;3900000;0
10093;217769;142;27;21;5;16;.762;3900000;0
10094;210060;137;40;36;6;30;.833;3014000;0
10094;223929;138;0;0;0;0;.00nan;0;0
10094;-1;137;64;9;0;9;1.000;586000;0
10094;-1;138;59;24;3;21;.875;3600000;0
10095;219003;133;0;0;0;0;.00nan;0;0
10095;209998;129;93;48;1;47;.979;3575000;0
10095;215319;129;0;0;0;0;.00nan;0;0
10095;-1;133;81;13;0;13;1.000;3600000;0
10096;208609;131;0;0;0;0;.00nan;0;0
10096;220575;134;90;51;2;49;.961;3600000;0
10096;210876;134;0;0;0;0;.00nan;0;0
10096;211984;131;66;31;3;28;.903;3600000;0
10097;210060;137;0;0;0;0;.00nan;0;0
10097;-1;135;71;28;2;26;.929;3552000;0
10097;-1;137;96;26;1;25;.962;3600000;0
10097;-1;135;0;0;0;0;.00nan;0;0
10098;225725;136;80;42;4;38;.905;3600000;0
10098;223929;138;31;21;5;16;.762;3600000;0
10098;-1;136;0;0;0;0;.00nan;0;0
10098;-1;138;0;0;0;0;.00nan;0;0
10099;213756;132;51;29;4;25;.862;3600000;0
10099;208609;131;100;39;0;39;1.000;3600000;0
10099;220511;132;0;0;0;0;.00nan;0;0
10099;211984;131;0;0;0;0;.00nan;0;0
10100;209998;129;84;50;5;45;.900;3600000;0
10100;220575;134;78;31;2;29;.935;3600000;0
10100;215319;129;0;0;0;0;.00nan;0;0
10100;210876;134;0;0;0;0;.00nan;0;0
10101;215128;141;0;0;0;0;.00nan;0;0
10101;210004;141;66;35;3;32;.914;3600000;0
10101;210213;139;35;34;6;28;.824;2478000;0
10101;221361;139;37;9;2;7;.778;1122000;0
10102;208575;142;0;0;0;0;.00nan;0;0
10102;215331;144;100;27;0;27;1.000;3600000;0
10102;217769;142;66;23;2;21;.913;3532000;0
10102;223946;144;0;0;0;0;.00nan;0;0
10103;213799;140;0;0;0;0;.00nan;0;0
10103;215246;143;0;0;0;0;.00nan;0;0
10103;220672;140;87;36;2;34;.944;3600000;0
10103;216130;143;55;43;5;38;.884;3600000;0
10104;219003;133;73;14;0;14;1.000;2609000;0
10104;209998;129;0;0;0;0;.00nan;0;0
10104;215319;129;76;51;5;46;.902;3600000;0
10104;-1;133;38;17;4;13;.765;991000;0
10105;220575;134;51;36;5;31;.861;3600000;0
10105;210876;134;0;0;0;0;.00nan;0;0
10105;212166;128;0;0;0;0;.00nan;0;0
10105;212529;128;69;20;1;19;.950;3600000;0
10106;213756;132;76;24;1;23;.958;3600000;0
10106;219003;133;0;0;0;0;.00nan;0;0
10106;220511;132;0;0;0;0;.00nan;0;0
10106;-1;133;93;37;2;35;.946;3567000;0
10107;225725;136;0;0;0;0;.00nan;0;0
10107;212166;128;73;37;3;34;.919;3589000;0
10107;212529;128;0;0;0;0;.00nan;0;0
10107;-1;136;76;31;2;29;.935;3600000;0
10108;223929;138;19;21;6;15;.714;3548000;0
10108;-1;135;71;46;5;41;.891;3600000;0
10108;-1;135;0;0;0;0;.00nan;0;0
10108;-1;138;0;0;0;0;.00nan;0;0
10109;208609;131;29;14;4;10;.714;980000;0
10109;211984;131;86;38;2;36;.947;2620000;0
10109;-1;130;0;0;0;0;.00nan;0;0
10109;-1;130;73;25;2;23;.920;3600000;0
10110;213799;140;50;29;4;25;.862;3705000;0
10110;220672;140;0;0;0;0;.00nan;0;0
10110;210213;139;0;0;0;0;.00nan;0;0
10110;221361;139;73;31;3;28;.903;3705000;0
10111;210060;137;50;8;1;7;.875;908000;0
10111;-1;135;0;0;0;0;.00nan;0;0
10111;-1;137;23;33;7;26;.788;2606000;0
10111;-1;135;45;38;6;32;.842;3600000;0
10112;209998;129;86;47;3;44;.936;3569000;0
10112;215217;1340;85;35;2;33;.943;3600000;0
10112;215319;129;0;0;0;0;.00nan;0;0
10112;-1;1340;0;0;0;0;.00nan;0;0
10113;213756;132;0;0;0;0;.00nan;0;0
10113;220511;132;60;44;6;38;.864;3600000;0
10113;-1;130;74;21;1;20;.952;3600000;0
10113;-1;130;0;0;0;0;.00nan;0;0
10114;208609;131;73;33;3;30;.909;3600000;0
10114;225725;136;39;28;5;23;.821;3541000;0
10114;211984;131;0;0;0;0;.00nan;0;0
10114;-1;136;0;0;0;0;.00nan;0;0
10115;208575;142;0;0;0;0;.00nan;0;0
10115;215128;141;0;0;0;0;.00nan;0;0
10115;210004;141;78;32;2;30;.938;3600000;0
10115;217769;142;62;26;3;23;.885;3554000;0
10116;215246;143;0;0;0;0;.00nan;0;0
10116;215331;144;16;24;6;18;.750;3271000;0
10116;216130;143;50;27;4;23;.852;3600000;0
10116;223946;144;44;3;1;2;.667;329000;0
10117;215246;143;65;42;5;37;.881;3600000;0
10117;215331;144;0;0;0;0;.00nan;0;0
10117;216130;143;0;0;0;0;.00nan;0;0
10117;223946;144;85;36;2;34;.944;3600000;0
10118;219003;133;0;0;0;0;.00nan;0;0
10118;215217;1340;0;0;0;0;.00nan;0;0
10118;-1;133;73;45;3;42;.933;3900000;0
10118;-1;1340;86;38;3;35;.921;3900000;0
10119;210060;137;27;28;6;22;.786;3156000;0
10119;212166;128;0;0;0;0;.00nan;0;0
10119;212529;128;66;24;2;22;.917;3600000;0
10119;-1;137;40;2;1;1;.500;444000;0
10120;215128;141;92;34;1;33;.971;3600000;0
10120;210004;141;0;0;0;0;.00nan;0;0
10120;210213;139;53;26;4;22;.846;3600000;0
10120;221361;139;0;0;0;0;.00nan;0;0
10121;220575;134;49;46;7;39;.848;3121000;0
10121;210876;134;55;4;0;4;1.000;479000;0
10121;223929;138;54;24;3;21;.875;3600000;0
10121;-1;138;0;0;0;0;.00nan;0;0
10122;208609;131;75;15;0;15;1.000;1945000;0
10122;211984;131;52;29;4;25;.862;1655000;0
10122;212166;128;45;32;5;27;.844;3600000;0
10122;212529;128;0;0;0;0;.00nan;0;0
10123;213799;140;0;0;0;0;.00nan;0;0
10123;220672;140;84;44;3;41;.932;3545000;0
10123;215331;144;72;24;1;23;.958;3600000;0
10123;223946;144;0;0;0;0;.00nan;0;0
10124;215128;141;0;0;0;0;.00nan;0;0
10124;210004;141;71;23;2;21;.913;3600000;0
10124;215246;143;0;0;0;0;.00nan;0;0
10124;216130;143;79;41;3;38;.927;3545000;0
10125;-1;130;0;0;0;0;.00nan;0;0
10125;-1;135;63;38;4;34;.895;3600000;0
10125;-1;135;0;0;0;0;.00nan;0;0
10125;-1;130;86;21;0;21;1.000;3600000;0
10126;213756;132;86;30;1;29;.967;3600000;0
10126;220511;132;0;0;0;0;.00nan;0;0
10126;209998;129;58;47;7;40;.851;3600000;0
10126;215319;129;0;0;0;0;.00nan;0;0
10127;219003;133;49;2;0;2;1.000;254000;0
10127;220575;134;96;35;2;33;.943;3600000;0
10127;210876;134;0;0;0;0;.00nan;0;0
10127;-1;133;13;29;7;22;.759;3346000;0
10128;219003;133;57;40;5;35;.875;3266000;0
10128;-1;133;21;3;3;0;.000;334000;0
10128;-1;130;0;0;0;0;.00nan;0;0
10128;-1;130;85;31;1;30;.968;3600000;0
10129;213799;140;6;23;7;16;.696;3600000;0
10129;215128;141;0;0;0;0;.00nan;0;0
10129;210004;141;84;41;3;38;.927;3600000;0
10129;220672;140;0;0;0;0;.00nan;0;0
10130;208575;142;0;0;0;0;.00nan;0;0
10130;215246;143;23;12;4;8;.667;1197000;0
10130;216130;143;61;21;2;19;.905;2391000;0
10130;217769;142;55;33;5;28;.848;3600000;0
10131;215331;144;0;0;0;0;.00nan;0;0
10131;210213;139;0;0;0;0;.00nan;0;0
10131;221361;139;52;36;5;31;.861;3575000;0
10131;223946;144;76;35;3;32;.914;3600000;0
10132;210060;137;52;2;0;2;1.000;298000;0
10132;212166;128;92;18;0;18;1.000;3600000;0
10132;212529;128;0;0;0;0;.00nan;0;0
10132;-1;137;31;36;6;30;.833;3302000;0
10133;225725;136;0;0;0;0;.00nan;0;0
10133;-1;136;79;28;2;26;.929;3600000;0
10133;-1;135;47;37;5;32;.865;3600000;0
10133;-1;135;0;0;0;0;.00nan;0;0
10134;209998;129;0;0;0;0;.00nan;0;0
10134;220575;134;61;34;4;30;.882;3555000;0
10134;215319;129;91;40;2;38;.950;3600000;0
10134;210876;134;0;0;0;0;.00nan;0;0
10135;213756;132;56;29;4;25;.862;3600000;0
10135;220511;132;0;0;0;0;.00nan;0;0
10135;215217;1340;100;40;1;39;.975;3600000;0
10135;-1;1340;0;0;0;0;.00nan;0;0
10136;208609;131;42;21;4;17;.810;1121000;0
10136;211984;131;95;29;1;28;.966;2479000;0
10136;223929;138;53;16;2;14;.875;3600000;0
10136;-1;138;0;0;0;0;.00nan;0;0
10137;213799;140;0;0;0;0;.00nan;0;0
10137;215128;141;89;27;1;26;.963;3600000;0
10137;210004;141;0;0;0;0;.00nan;0;0
10137;220672;140;96;46;3;43;.935;3582000;0
10138;215331;144;67;35;4;31;.886;3600000;0
10138;210213;139;27;29;6;23;.793;2500000;0
10138;221361;139;56;14;1;13;.929;1100000;0
10138;223946;144;0;0;0;0;.00nan;0;0
10139;208575;142;45;24;4;20;.833;3600000;0
10139;215246;143;78;37;3;34;.919;3600000;0
10139;216130;143;0;0;0;0;.00nan;0;0
10139;217769;142;0;0;0;0;.00nan;0;0
10140;225725;136;95;38;2;36;.947;3600000;0
10140;-1;136;0;0;0;0;.00nan;0;0
10140;-1;135;0;0;0;0;.00nan;0;0
10140;-1;135;68;32;3;29;.906;3600000;0
10141;212166;128;70;40;4;36;.900;3600000;0
10141;212529;128;0;0;0;0;.00nan;0;0
10141;223929;138;0;0;0;0;.00nan;0;0
10141;-1;138;79;26;1;25;.962;3600000;0
10142;208609;131;67;33;4;29;.879;3600000;0
10142;210060;137;66;33;5;28;.848;3595000;0
10142;211984;131;0;0;0;0;.00nan;0;0
10142;-1;137;0;0;0;0;.00nan;0;0
10143;209998;129;91;51;3;48;.941;3600000;0
10143;215217;1340;0;0;0;0;.00nan;0;0
10143;215319;129;0;0;0;0;.00nan;0;0
10143;-1;1340;97;20;0;20;1.000;3600000;0
10144;213756;132;0;0;0;0;.00nan;0;0
10144;220511;132;32;26;5;21;.808;3572000;0
10144;220575;134;57;37;4;33;.892;3600000;0
10144;210876;134;0;0;0;0;.00nan;0;0
10145;219003;133;16;28;7;21;.750;3600000;0
10145;-1;133;0;0;0;0;.00nan;0;0
10145;-1;130;52;1;0;1;1.000;378000;0
10145;-1;130;41;30;6;24;.800;3222000;0
10147;208556;135;28;15;4;11;.733;1199000;0
10147;210060;137;0;0;0;0;.00nan;0;0
10147;-1;135;57;31;4;27;.871;2401000;0
10147;-1;137;83;31;2;29;.935;3600000;0
10149;215217;1340;87;30;1;29;.967;3600000;0
10149;225734;131;0;0;0;0;.00nan;0;0
10149;211984;131;37;27;5;22;.815;3600000;0
10149;-1;1340;0;0;0;0;.00nan;0;0
10151;213799;140;64;44;5;39;.886;3600000;0
10151;220672;140;0;0;0;0;.00nan;0;0
10151;-1;130;72;31;2;29;.935;3600000;0
10151;-1;130;0;0;0;0;.00nan;0;0
10153;220566;138;29;29;6;23;.793;3900000;0
10153;210213;139;0;0;0;0;.00nan;0;0
10153;221361;139;93;64;6;58;.906;3900000;0
10153;223929;138;0;0;0;0;.00nan;0;0
10155;213756;132;0;0;0;0;.00nan;0;0
10155;215128;141;0;0;0;0;.00nan;0;0
10155;220511;132;64;21;2;19;.905;3600000;0
10155;210004;141;66;45;6;39;.867;3600000;0
10157;208575;142;0;0;0;0;.00nan;0;0
10157;220575;134;90;45;3;42;.933;3900000;0
10157;210876;134;0;0;0;0;.00nan;0;0
10157;217769;142;63;23;3;20;.870;3900000;0
10159;209998;129;89;41;4;37;.902;3600000;0
10159;215246;143;89;30;1;29;.967;3600000;0
10159;215319;129;0;0;0;0;.00nan;0;0
10159;216130;143;0;0;0;0;.00nan;0;0
10161;215331;144;0;0;0;0;.00nan;0;0
10161;212166;128;0;0;0;0;.00nan;0;0
10161;212529;128;81;29;1;28;.966;3600000;0
10161;223946;144;64;36;3;33;.917;3600000;0
10163;219003;133;0;0;0;0;.00nan;0;0
10163;225725;136;0;0;0;0;.00nan;0;0
10163;-1;133;34;20;4;16;.800;3740000;0
10163;-1;136;87;48;3;45;.938;3740000;0
10165;219003;133;65;20;2;18;.900;3600000;0
10165;215246;143;0;0;0;0;.00nan;0;0
10165;216130;143;57;47;6;41;.872;3600000;0
10165;-1;133;0;0;0;0;.00nan;0;0
10167;220566;138;0;0;0;0;.00nan;0;0
10167;220575;134;38;33;6;27;.818;3600000;0
10167;210876;134;0;0;0;0;.00nan;0;0
10167;223929;138;65;32;3;29;.906;3600000;0
10169;208575;142;67;29;2;27;.931;3600000;0
10169;215128;141;0;0;0;0;.00nan;0;0
10169;210004;141;31;21;5;16;.762;3600000;0
10169;217769;142;0;0;0;0;.00nan;0;0
10171;213799;140;0;0;0;0;.00nan;0;0
10171;225725;136;56;39;5;34;.872;3600000;0
10171;220672;140;83;23;1;22;.957;3600000;0
10171;-1;136;0;0;0;0;.00nan;0;0
10173;213756;132;22;9;4;5;.556;1177000;0
10173;220511;132;49;22;3;19;.864;2397000;0
10173;225734;131;59;40;5;35;.875;3600000;0
10173;211984;131;0;0;0;0;.00nan;0;0
10175;210213;139;54;44;6;38;.864;2736000;0
10175;221361;139;46;13;2;11;.846;864000;0
10175;212166;128;66;37;4;33;.892;3600000;0
10175;212529;128;0;0;0;0;.00nan;0;0
10177;208556;135;0;0;0;0;.00nan;0;0
10177;215331;144;54;5;0;5;1.000;379000;0
10177;223946;144;14;20;6;14;.700;3221000;0
10177;-1;135;78;37;3;34;.919;3600000;0
10179;209998;129;71;38;4;34;.895;3576000;0
10179;215319;129;0;0;0;0;.00nan;0;0
10179;-1;130;0;0;0;0;.00nan;0;0
10179;-1;130;40;14;3;11;.786;3600000;0
10181;215217;1340;94;28;2;26;.929;3600000;0
10181;210060;137;0;0;0;0;.00nan;0;0
10181;-1;137;63;38;4;34;.895;3531000;0
10181;-1;1340;0;0;0;0;.00nan;0;0
10183;219003;133;0;0;0;0;.00nan;0;0
10183;225734;131;0;0;0;0;.00nan;0;0
10183;211984;131;41;23;4;19;.826;3544000;0
10183;-1;133;53;29;3;26;.897;3600000;0
10185;213756;132;18;24;6;18;.750;3212000;0
10185;208556;135;43;12;3;9;.750;551000;0
10185;220511;132;57;5;0;5;1.000;359000;0
10185;-1;135;72;28;2;26;.929;3049000;0
10187;210060;137;65;29;2;27;.931;3600000;0
10187;215331;144;60;28;3;25;.893;3566000;0
10187;223946;144;0;0;0;0;.00nan;0;0
10187;-1;137;0;0;0;0;.00nan;0;0
10189;220566;138;32;24;5;19;.792;3600000;0
10189;225725;136;0;0;0;0;.00nan;0;0
10189;223929;138;0;0;0;0;.00nan;0;0
10189;-1;136;91;52;4;48;.923;3600000;0
10191;209998;129;0;0;0;0;.00nan;0;0
10191;220575;134;0;0;0;0;.00nan;0;0
10191;215319;129;97;47;2;45;.957;3900000;0
10191;210876;134;90;34;2;32;.941;3900000;0
10193;215217;1340;60;21;3;18;.857;2379000;0
10193;210213;139;54;25;3;22;.880;3003000;0
10193;221361;139;29;8;3;5;.625;597000;0
10193;-1;1340;33;18;4;14;.778;1168000;0
10195;208575;142;51;8;1;7;.875;692000;0
10195;217769;142;41;40;6;34;.850;2868000;0
10195;-1;130;15;19;6;13;.684;3600000;0
10195;-1;130;0;0;0;0;.00nan;0;0
10197;213799;140;11;21;6;15;.714;2646000;0
10197;215128;141;61;21;2;19;.905;3600000;0
10197;210004;141;0;0;0;0;.00nan;0;0
10197;220672;140;65;12;0;12;1.000;954000;0
10199;215246;143;57;36;4;32;.889;3900000;0
10199;216130;143;0;0;0;0;.00nan;0;0
10199;212166;128;0;0;0;0;.00nan;0;0
10199;212529;128;49;24;4;20;.833;3900000;0
10201;208556;135;69;61;6;55;.902;3600000;0
10201;-1;130;0;0;0;0;.00nan;0;0
10201;-1;135;0;0;0;0;.00nan;0;0
10201;-1;130;69;25;2;23;.920;3600000;0
10203;213799;140;70;23;2;21;.913;3600000;0
10203;225725;136;0;0;0;0;.00nan;0;0
10203;220672;140;0;0;0;0;.00nan;0;0
10203;-1;136;69;42;5;37;.881;3600000;0
10205;220575;134;93;40;2;38;.950;3600000;0
10205;225734;131;100;26;0;26;1.000;3600000;0
10205;210876;134;0;0;0;0;.00nan;0;0
10205;211984;131;0;0;0;0;.00nan;0;0
10207;210213;139;0;0;0;0;.00nan;0;0
10207;221361;139;63;33;3;30;.909;3900000;0
10207;212166;128;57;26;3;23;.885;3900000;0
10207;212529;128;0;0;0;0;.00nan;0;0
10209;215217;1340;43;33;5;28;.848;2276000;0
10209;215331;144;0;0;0;0;.00nan;0;0
10209;223946;144;56;27;3;24;.889;3600000;0
10209;-1;1340;68;12;0;12;1.000;1252000;0
10211;219003;133;0;0;0;0;.00nan;0;0
10211;215128;141;0;0;0;0;.00nan;0;0
10211;210004;141;56;21;2;19;.905;3585000;0
10211;-1;133;93;20;0;20;1.000;3600000;0
10213;209998;129;41;35;6;29;.829;2892000;0
10213;210060;137;0;0;0;0;.00nan;0;0
10213;215319;129;32;9;3;6;.667;708000;0
10213;-1;137;60;28;3;25;.893;3600000;0
10215;213756;132;51;22;3;19;.864;3778000;0
10215;208575;142;0;0;0;0;.00nan;0;0
10215;220511;132;0;0;0;0;.00nan;0;0
10215;217769;142;62;30;4;26;.867;3778000;0
10217;220566;138;0;0;0;0;.00nan;0;0
10217;215246;143;0;0;0;0;.00nan;0;0
10217;216130;143;97;57;4;53;.930;3570000;0
10217;223929;138;51;17;3;14;.824;3600000;0
10219;219003;133;48;8;1;7;.875;1263000;0
10219;220566;138;54;25;3;22;.880;3600000;0
10219;223929;138;0;0;0;0;.00nan;0;0
10219;-1;133;51;30;5;25;.833;2337000;0
10221;225725;136;86;40;2;38;.950;3600000;0
10221;-1;130;46;18;3;15;.833;3558000;0
10221;-1;136;0;0;0;0;.00nan;0;0
10221;-1;130;0;0;0;0;.00nan;0;0
10223;215128;141;100;25;0;25;1.000;3600000;0
10223;210004;141;0;0;0;0;.00nan;0;0
10223;225734;131;0;0;0;0;.00nan;0;0
10223;211984;131;86;41;3;38;.927;3600000;0
10225;220575;134;0;0;0;0;.00nan;0;0
10225;215331;144;34;17;4;13;.765;3600000;0
10225;210876;134;75;59;5;54;.915;3600000;0
10225;223946;144;0;0;0;0;.00nan;0;0
10227;208556;135;32;10;3;7;.700;793000;0
10227;210213;139;100;23;0;23;1.000;3600000;0
10227;221361;139;0;0;0;0;.00nan;0;0
10227;-1;135;31;29;6;23;.793;2807000;0
10229;213756;132;0;0;0;0;.00nan;0;0
10229;213799;140;0;0;0;0;.00nan;0;0
10229;220511;132;69;33;3;30;.909;3677000;0
10229;220672;140;63;25;4;21;.840;3677000;0
10231;215217;1340;19;30;7;23;.767;3016000;0
10231;215246;143;66;27;2;25;.926;3600000;0
10231;216130;143;0;0;0;0;.00nan;0;0
10231;-1;1340;61;7;0;7;1.000;584000;0
10233;209998;129;44;16;3;13;.813;1005000;0
10233;215319;129;41;36;6;30;.833;2595000;0
10233;212166;128;0;0;0;0;.00nan;0;0
10233;212529;128;93;19;0;19;1.000;3600000;0
10235;208575;142;76;30;2;28;.933;3600000;0
10235;210060;137;55;41;5;36;.878;3600000;0
10235;217769;142;0;0;0;0;.00nan;0;0
10235;-1;137;0;0;0;0;.00nan;0;0
10237;219003;133;77;43;4;39;.907;3600000;0
10237;215331;144;0;0;0;0;.00nan;0;0
10237;223946;144;23;25;6;19;.760;3600000;0
10237;-1;133;0;0;0;0;.00nan;0;0
10239;215128;141;69;29;2;27;.931;3900000;0
10239;209998;129;77;32;2;30;.938;3900000;0
10239;210004;141;0;0;0;0;.00nan;0;0
10239;215319;129;0;0;0;0;.00nan;0;0
10241;220566;138;0;0;0;0;.00nan;0;0
10241;223929;138;36;29;6;23;.793;3600000;0
10241;-1;130;0;0;0;0;.00nan;0;0
10241;-1;130;69;30;3;27;.900;3600000;0
10243;213756;132;60;41;5;36;.878;3600000;0
10243;208575;142;0;0;0;0;.00nan;0;0
10243;220511;132;0;0;0;0;.00nan;0;0
10243;217769;142;77;32;2;30;.938;3600000;0
10245;225725;136;75;54;6;48;.889;3600000;0
10245;212166;128;0;0;0;0;.00nan;0;0
10245;212529;128;58;12;1;11;.917;3600000;0
10245;-1;136;0;0;0;0;.00nan;0;0
10247;220575;134;87;32;1;31;.969;3600000;0
10247;225734;131;85;17;0;17;1.000;3600000;0
10247;210876;134;0;0;0;0;.00nan;0;0
10247;211984;131;0;0;0;0;.00nan;0;0
10249;213799;140;35;33;6;27;.818;3250000;0
10249;210060;137;0;0;0;0;.00nan;0;0
10249;220672;140;49;1;0;1;1.000;280000;0
10249;-1;137;48;27;4;23;.852;3600000;0
10251;208556;135;49;36;5;31;.861;3600000;0
10251;215217;1340;21;32;7;25;.781;3579000;0
10251;-1;135;0;0;0;0;.00nan;0;0
10251;-1;1340;0;0;0;0;.00nan;0;0
10253;215246;143;0;0;0;0;.00nan;0;0
10253;210213;139;65;38;5;33;.868;3593000;0
10253;221361;139;0;0;0;0;.00nan;0;0
10253;216130;143;39;35;6;29;.829;3627000;0
10255;213756;132;73;23;1;22;.957;3600000;0
10255;220511;132;0;0;0;0;.00nan;0;0
10255;215217;1340;0;0;0;0;.00nan;0;0
10255;-1;1340;54;25;3;22;.880;3592000;0
10257;220566;138;54;9;1;8;.889;3600000;0
10257;220575;134;0;0;0;0;.00nan;0;0
10257;210876;134;85;46;3;43;.935;3525000;0
10257;223929;138;0;0;0;0;.00nan;0;0
10259;208575;142;60;29;3;26;.897;3900000;0
10259;215331;144;59;33;3;30;.909;3900000;0
10259;217769;142;0;0;0;0;.00nan;0;0
10259;223946;144;0;0;0;0;.00nan;0;0
10261;219003;133;0;0;0;0;.00nan;0;0
10261;209998;129;0;0;0;0;.00nan;0;0
10261;215319;129;61;46;5;41;.891;3513000;0
10261;-1;133;52;20;3;17;.850;3600000;0
10263;208556;135;0;0;0;0;.00nan;0;0
10263;215128;141;0;0;0;0;.00nan;0;0
10263;210004;141;96;38;1;37;.974;3600000;0
10263;-1;135;52;31;4;27;.871;3600000;0
10265;225725;136;58;6;0;6;1.000;586000;0
10265;215246;143;33;30;6;24;.800;3349000;0
10265;216130;143;58;8;0;8;1.000;551000;0
10265;-1;136;37;34;6;28;.824;3314000;0
10267;225734;131;0;0;0;0;.00nan;0;0
10267;211984;131;44;25;4;21;.840;3600000;0
10267;212166;128;89;36;2;34;.944;3600000;0
10267;212529;128;0;0;0;0;.00nan;0;0
10269;213799;140;0;0;0;0;.00nan;0;0
10269;220672;140;64;47;5;42;.894;3600000;0
10269;210213;139;0;0;0;0;.00nan;0;0
10269;221361;139;62;13;1;12;.923;3600000;0
10271;210060;137;49;49;7;42;.857;3600000;0
10271;-1;130;100;24;0;24;1.000;3600000;0
10271;-1;137;0;0;0;0;.00nan;0;0
10271;-1;130;0;0;0;0;.00nan;0;0
1637;220575;134;86;48;3;45;.938;3600000;0
1637;210876;134;0;0;0;0;.00nan;0;0
1637;223929;138;93;20;0;20;1.000;3600000;0
1637;-1;138;0;0;0;0;.00nan;0;0
1638;215246;143;0;0;0;0;.00nan;0;0
1638;216130;143;74;45;6;39;.867;3663000;0
1638;-1;130;0;0;0;0;.00nan;0;0
1638;-1;130;31;21;5;16;.762;3663000;0
1639;215128;141;0;0;0;0;.00nan;0;0
1639;210004;141;91;34;2;32;.941;3600000;0
1639;215331;144;0;0;0;0;.00nan;0;0
1639;223946;144;45;38;6;32;.842;3600000;0
1640;219003;133;0;0;0;0;.00nan;0;0
1640;225725;136;0;0;0;0;.00nan;0;0
1640;-1;133;49;29;4;25;.862;3600000;0
1640;-1;136;47;35;6;29;.829;3537000;0
1641;208609;131;75;46;5;41;.891;3548000;0
1641;211984;131;0;0;0;0;.00nan;0;0
1641;212166;128;0;0;0;0;.00nan;0;0
1641;212529;128;56;31;4;27;.871;3600000;0
1642;208575;142;0;0;0;0;.00nan;0;0
1642;210060;137;0;0;0;0;.00nan;0;0
1642;217769;142;91;20;0;20;1.000;3600000;0
1642;-1;137;75;42;5;37;.881;3600000;0
1643;213756;132;54;25;3;22;.880;3853000;0
1643;220511;132;0;0;0;0;.00nan;0;0
1643;215217;1340;0;0;0;0;.00nan;0;0
1643;-1;1340;39;19;4;15;.789;3853000;0
1644;213799;140;0;0;0;0;.00nan;0;0
1644;220672;140;87;39;3;36;.923;3557000;0
1644;210213;139;0;0;0;0;.00nan;0;0
1644;221361;139;66;18;1;17;.944;3600000;0
1645;220575;134;100;57;3;54;.947;3815000;0
1645;210876;134;0;0;0;0;.00nan;0;0
1645;223929;138;49;21;4;17;.810;3815000;0
1645;-1;138;0;0;0;0;.00nan;0;0
1646;215246;143;85;32;1;31;.969;3600000;0
1646;216130;143;0;0;0;0;.00nan;0;0
1646;-1;130;0;0;0;0;.00nan;0;0
1646;-1;130;55;21;3;18;.857;3522000;0
1647;215128;141;0;0;0;0;.00nan;0;0
1647;210004;141;80;35;3;32;.914;3600000;0
1647;215331;144;0;0;0;0;.00nan;0;0
1647;223946;144;40;21;4;17;.810;3578000;0
1648;219003;133;0;0;0;0;.00nan;0;0
1648;225725;136;0;0;0;0;.00nan;0;0
1648;-1;133;81;28;2;26;.929;3600000;0
1648;-1;136;76;37;3;34;.919;3600000;0
1649;208609;131;71;30;3;27;.900;3530000;0
1649;211984;131;0;0;0;0;.00nan;0;0
1649;212166;128;0;0;0;0;.00nan;0;0
1649;212529;128;90;31;1;30;.968;3600000;0
1650;208575;142;0;0;0;0;.00nan;0;0
1650;210060;137;0;0;0;0;.00nan;0;0
1650;217769;142;57;16;2;14;.875;3600000;0
1650;-1;137;34;42;6;36;.857;3600000;0
1651;213756;132;52;27;4;23;.852;3563000;0
1651;220511;132;0;0;0;0;.00nan;0;0
1651;215217;1340;92;48;3;45;.938;3600000;0
1651;-1;1340;0;0;0;0;.00nan;0;0
1652;213799;140;59;9;0;9;1.000;745000;0
1652;220672;140;31;29;6;23;.793;2777000;0
1652;210213;139;0;0;0;0;.00nan;0;0
1652;221361;139;64;36;4;32;.889;3600000;0
1653;220575;134;73;34;3;31;.912;3683000;0
1653;210876;134;0;0;0;0;.00nan;0;0
1653;223929;138;74;21;2;19;.905;3683000;0
1653;-1;138;0;0;0;0;.00nan;0;0
1654;215246;143;37;17;4;13;.765;1134000;0
1654;216130;143;67;33;3;30;.909;2466000;0
1654;-1;130;0;0;0;0;.00nan;0;0
1654;-1;130;66;20;2;18;.900;3600000;0
1655;215128;141;0;0;0;0;.00nan;0;0
1655;210004;141;83;33;2;31;.939;3600000;0
1655;215331;144;0;0;0;0;.00nan;0;0
1655;223946;144;21;34;8;26;.765;3600000;0
1656;219003;133;0;0;0;0;.00nan;0;0
1656;225725;136;0;0;0;0;.00nan;0;0
1656;-1;133;95;34;1;33;.971;3600000;0
1656;-1;136;53;32;5;27;.844;3600000;0
1657;208609;131;86;34;2;32;.941;3600000;0
1657;211984;131;0;0;0;0;.00nan;0;0
1657;212166;128;0;0;0;0;.00nan;0;0
1657;212529;128;79;33;3;30;.909;3545000;0
1658;208575;142;0;0;0;0;.00nan;0;0
1658;210060;137;56;4;0;4;1.000;359000;0
1658;217769;142;58;26;3;23;.885;3600000;0
1658;-1;137;25;28;7;21;.750;3241000;0
1659;213756;132;77;31;2;29;.935;3600000;0
1659;220511;132;0;0;0;0;.00nan;0;0
1659;215217;1340;39;31;5;26;.839;3600000;0
1659;-1;1340;0;0;0;0;.00nan;0;0
1660;213799;140;0;0;0;0;.00nan;0;0
1660;220672;140;67;36;3;33;.917;3944000;0
1660;210213;139;0;0;0;0;.00nan;0;0
1660;221361;139;40;20;4;16;.800;3944000;0
1661;220575;134;89;38;2;36;.947;3600000;0
1661;210876;134;0;0;0;0;.00nan;0;0
1661;223929;138;46;25;4;21;.840;3600000;0
1661;-1;138;0;0;0;0;.00nan;0;0
1662;215246;143;43;63;10;53;.841;3600000;0
1662;216130;143;0;0;0;0;.00nan;0;0
1662;-1;130;0;0;0;0;.00nan;0;0
1662;-1;130;47;13;2;11;.846;3600000;0
1663;215128;141;0;0;0;0;.00nan;0;0
1663;210004;141;58;29;4;25;.862;3575000;0
1663;215331;144;0;0;0;0;.00nan;0;0
1663;223946;144;65;35;3;32;.914;3600000;0
1664;219003;133;0;0;0;0;.00nan;0;0
1664;225725;136;0;0;0;0;.00nan;0;0
1664;-1;133;73;25;2;23;.920;3600000;0
1664;-1;136;64;40;4;36;.900;3539000;0
1665;208609;131;65;23;2;21;.913;3600000;0
1665;211984;131;0;0;0;0;.00nan;0;0
1665;212166;128;0;0;0;0;.00nan;0;0
1665;212529;128;75;33;3;30;.909;3564000;0
1666;208575;142;0;0;0;0;.00nan;0;0
1666;210060;137;0;0;0;0;.00nan;0;0
1666;217769;142;96;25;0;25;1.000;3600000;0
1666;-1;137;75;27;2;25;.926;3590000;0
1667;213756;132;23;12;4;8;.667;1170000;0
1667;220511;132;59;23;2;21;.913;2430000;0
1667;215217;1340;80;36;2;34;.944;3600000;0
1667;-1;1340;0;0;0;0;.00nan;0;0
1668;213799;140;0;0;0;0;.00nan;0;0
1668;220672;140;96;33;1;32;.970;3600000;0
1668;210213;139;0;0;0;0;.00nan;0;0
1668;221361;139;71;43;4;39;.907;3600000;0
1889;220575;134;72;51;5;46;.902;3560000;0
1889;210876;134;0;0;0;0;.00nan;0;0
1889;223929;138;63;22;2;20;.909;3600000;0
1889;-1;138;0;0;0;0;.00nan;0;0
1890;215246;143;78;56;5;51;.911;4623000;0
1890;216130;143;0;0;0;0;.00nan;0;0
1890;-1;130;70;8;0;8;1.000;1382000;0
1890;-1;130;51;25;4;21;.840;3241000;0
1891;215128;141;0;0;0;0;.00nan;0;0
1891;210004;141;69;47;5;42;.894;4126000;0
1891;215331;144;0;0;0;0;.00nan;0;0
1891;223946;144;29;26;6;20;.769;4126000;0
1892;208609;131;37;31;6;25;.806;3600000;0
1892;211984;131;0;0;0;0;.00nan;0;0
1892;212166;128;0;0;0;0;.00nan;0;0
1892;212529;128;68;27;2;25;.926;3600000;0
1893;213756;132;0;0;0;0;.00nan;0;0
1893;220511;132;52;20;3;17;.850;3600000;0
1893;215217;1340;89;49;5;44;.898;3518000;0
1893;-1;1340;0;0;0;0;.00nan;0;0
1894;213799;140;0;0;0;0;.00nan;0;0
1894;220672;140;75;21;2;19;.905;3600000;0
1894;210213;139;0;0;0;0;.00nan;0;0
1894;221361;139;58;42;5;37;.881;3600000;0
1943;220575;134;79;41;3;38;.927;3600000;0
1943;210876;134;0;0;0;0;.00nan;0;0
1943;223929;138;86;22;0;22;1.000;3600000;0
1943;-1;138;0;0;0;0;.00nan;0;0
1944;208609;131;87;35;2;33;.943;3600000;0
1944;211984;131;0;0;0;0;.00nan;0;0
1944;212166;128;0;0;0;0;.00nan;0;0
1944;212529;128;56;32;5;27;.844;3600000;0
1945;213756;132;0;0;0;0;.00nan;0;0
1945;220511;132;45;20;4;16;.800;3600000;0
1945;215217;1340;86;29;1;28;.966;3600000;0
1945;-1;1340;0;0;0;0;.00nan;0;0
1946;213799;140;0;0;0;0;.00nan;0;0
1946;220672;140;91;46;2;44;.957;4150000;0
1946;210213;139;0;0;0;0;.00nan;0;0
1946;221361;139;76;26;1;25;.962;4150000;0
1986;208609;131;95;44;2;42;.955;4148000;0
1986;211984;131;0;0;0;0;.00nan;0;0
1986;212166;128;0;0;0;0;.00nan;0;0
1986;212529;128;78;41;3;38;.927;4144000;0
1987;213756;132;0;0;0;0;.00nan;0;0
1987;220511;132;67;17;1;16;.941;3600000;0
1987;215217;1340;96;55;4;51;.927;3600000;0
1987;-1;1340;0;0;0;0;.00nan;0;0
1988;213799;140;0;0;0;0;.00nan;0;0
1988;220672;140;89;37;2;35;.946;4060000;0
1988;210213;139;0;0;0;0;.00nan;0;0
1988;221361;139;74;25;1;24;.960;4060000;0
2014;208609;131;33;23;5;18;.783;1884000;0
2014;211984;131;64;21;2;19;.905;1716000;0
2014;223929;138;63;22;2;20;.909;3600000;0
2014;-1;138;0;0;0;0;.00nan;0;0
2015;215128;141;0;0;0;0;.00nan;0;0
2015;210004;141;47;38;6;32;.842;3600000;0
2015;210213;139;0;0;0;0;.00nan;0;0
2015;221361;139;71;28;2;26;.929;3600000;0
2016;219003;133;0;0;0;0;.00nan;0;0
2016;208575;142;0;0;0;0;.00nan;0;0
2016;217769;142;73;26;2;24;.923;3600000;0
2016;-1;133;50;27;4;23;.852;3563000;0
2017;213756;132;0;0;0;0;.00nan;0;0
2017;220511;132;32;38;7;31;.816;3600000;0
2017;-1;130;55;19;3;16;.842;3600000;0
2017;-1;130;0;0;0;0;.00nan;0;0
2018;208609;131;98;61;4;57;.934;3600000;0
2018;211984;131;0;0;0;0;.00nan;0;0
2018;223929;138;50;13;2;11;.846;3600000;0
2018;-1;138;0;0;0;0;.00nan;0;0
2019;215128;141;0;0;0;0;.00nan;0;0
2019;210004;141;49;43;6;37;.860;3600000;0
2019;210213;139;0;0;0;0;.00nan;0;0
2019;221361;139;73;24;2;22;.917;3600000;0
2020;219003;133;0;0;0;0;.00nan;0;0
2020;208575;142;0;0;0;0;.00nan;0;0
2020;217769;142;76;23;1;22;.957;3600000;0
2020;-1;133;80;33;2;31;.939;3600000;0
2021;213756;132;0;0;0;0;.00nan;0;0
2021;220511;132;62;37;4;33;.892;3543000;0
2021;-1;130;64;23;3;20;.870;3600000;0
2021;-1;130;0;0;0;0;.00nan;0;0
2022;208609;131;97;65;4;61;.938;3600000;0
2022;211984;131;0;0;0;0;.00nan;0;0
2022;223929;138;59;21;2;19;.905;3600000;0
2022;-1;138;0;0;0;0;.00nan;0;0
2023;215128;141;0;0;0;0;.00nan;0;0
2023;210004;141;52;22;3;19;.864;3546000;0
2023;210213;139;0;0;0;0;.00nan;0;0
2023;221361;139;81;29;1;28;.966;3600000;0
2024;219003;133;0;0;0;0;.00nan;0;0
2024;208575;142;0;0;0;0;.00nan;0;0
2024;217769;142;78;25;1;24;.960;3600000;0
2024;-1;133;50;27;3;24;.889;3565000;0
2025;213756;132;0;0;0;0;.00nan;0;0
2025;220511;132;58;48;7;41;.854;4317000;0
2025;-1;130;57;42;6;36;.857;4317000;0
2025;-1;130;0;0;0;0;.00nan;0;0
2026;208609;131;50;41;6;35;.854;3600000;0
2026;211984;131;0;0;0;0;.00nan;0;0
2026;223929;138;62;18;2;16;.889;3600000;0
2026;-1;138;0;0;0;0;.00nan;0;0
2027;215128;141;0;0;0;0;.00nan;0;0
2027;210004;141;99;28;0;28;1.000;3600000;0
2027;210213;139;0;0;0;0;.00nan;0;0
2027;221361;139;63;33;3;30;.909;3600000;0
2028;219003;133;0;0;0;0;.00nan;0;0
2028;208575;142;0;0;0;0;.00nan;0;0
2028;217769;142;100;31;0;31;1.000;3600000;0
2028;-1;133;76;33;2;31;.939;3565000;0
2029;213756;132;0;0;0;0;.00nan;0;0
2029;220511;132;91;58;4;54;.931;3600000;0
2029;-1;130;39;24;5;19;.792;3600000;0
2029;-1;130;0;0;0;0;.00nan;0;0
2292;215128;141;0;0;0;0;.00nan;0;0
2292;210004;141;99;44;2;42;.955;3848000;0
2292;210213;139;0;0;0;0;.00nan;0;0
2292;221361;139;45;19;3;16;.842;3848000;0
2293;213756;132;73;26;2;24;.923;2684000;0
2293;220511;132;27;13;4;9;.692;1066000;0
2293;-1;130;0;0;0;0;.00nan;0;0
2293;-1;130;57;38;5;33;.868;3750000;0
2357;215128;141;0;0;0;0;.00nan;0;0
2357;210004;141;100;33;0;33;1.000;3600000;0
2357;210213;139;0;0;0;0;.00nan;0;0
2357;221361;139;39;17;3;14;.824;3600000;0
2398;215128;141;0;0;0;0;.00nan;0;0
2398;210004;141;61;18;2;16;.889;3600000;0
2398;210213;139;0;0;0;0;.00nan;0;0
2398;221361;139;67;37;3;34;.919;3559000;0
2455;208575;142;0;0;0;0;.00nan;0;0
2455;217769;142;71;31;3;28;.903;4077000;0
2455;223929;138;71;40;4;36;.900;4077000;0
2455;-1;138;0;0;0;0;.00nan;0;0
2456;215128;141;0;0;0;0;.00nan;0;0
2456;210004;141;99;41;1;40;.976;3600000;0
2456;-1;130;0;0;0;0;.00nan;0;0
2456;-1;130;68;31;3;28;.903;3531000;0
2457;208575;142;0;0;0;0;.00nan;0;0
2457;217769;142;29;46;8;38;.826;3600000;0
2457;223929;138;79;24;1;23;.958;3600000;0
2457;-1;138;0;0;0;0;.00nan;0;0
2458;215128;141;0;0;0;0;.00nan;0;0
2458;210004;141;59;31;4;27;.871;3600000;0
2458;-1;130;0;0;0;0;.00nan;0;0
2458;-1;130;100;26;0;26;1.000;3600000;0
2459;208575;142;0;0;0;0;.00nan;0;0
2459;217769;142;41;25;5;20;.800;3530000;0
2459;223929;138;71;26;3;23;.885;3600000;0
2459;-1;138;0;0;0;0;.00nan;0;0
2460;215128;141;0;0;0;0;.00nan;0;0
2460;210004;141;82;41;3;38;.927;4544000;0
2460;-1;130;0;0;0;0;.00nan;0;0
2460;-1;130;60;36;4;32;.889;4544000;0
2461;208575;142;0;0;0;0;.00nan;0;0
2461;217769;142;80;38;4;34;.895;3567000;0
2461;223929;138;56;25;3;22;.880;3600000;0
2461;-1;138;0;0;0;0;.00nan;0;0
2462;215128;141;0;0;0;0;.00nan;0;0
2462;210004;141;74;42;4;38;.905;3576000;0
2462;-1;130;0;0;0;0;.00nan;0;0
2462;-1;130;67;25;3;22;.880;3600000;0
2570;208575;142;44;20;3;17;.850;2179000;0
2570;217769;142;4;15;6;9;.600;1421000;0
2570;223929;138;71;23;2;21;.913;3600000;0
2570;-1;138;0;0;0;0;.00nan;0;0
2571;215128;141;0;0;0;0;.00nan;0;0
2571;210004;141;99;51;2;49;.961;3600000;0
2571;-1;130;0;0;0;0;.00nan;0;0
2571;-1;130;37;31;5;26;.839;3600000;0
2585;215128;141;77;21;0;21;1.000;954000;0
2585;210004;141;34;28;6;22;.786;2646000;0
2585;-1;130;0;0;0;0;.00nan;0;0
2585;-1;130;100;27;1;26;.963;3600000;0
2672;215128;141;44;12;2;10;.833;553000;0
2672;210004;141;27;27;6;21;.778;3047000;0
2672;-1;130;0;0;0;0;.00nan;0;0
2672;-1;130;64;27;3;24;.889;3600000;0
2694;223929;138;95;39;2;37;.949;3600000;0
2694;-1;130;0;0;0;0;.00nan;0;0
2694;-1;130;84;42;3;39;.929;3579000;0
2694;-1;138;0;0;0;0;.00nan;0;0
2695;223929;138;73;27;1;26;.963;3600000;0
2695;-1;130;0;0;0;0;.00nan;0;0
2695;-1;130;43;24;4;20;.833;3600000;0
2695;-1;138;0;0;0;0;.00nan;0;0
2696;223929;138;61;35;4;31;.886;3561000;0
2696;-1;130;0;0;0;0;.00nan;0;0
2696;-1;130;70;29;3;26;.897;3600000;0
2696;-1;138;0;0;0;0;.00nan;0;0
2697;223929;138;95;39;2;37;.949;3600000;0
2697;-1;130;0;0;0;0;.00nan;0;0
2697;-1;130;62;23;3;20;.870;3570000;0
2697;-1;138;0;0;0;0;.00nan;0;0
2766;223929;138;56;38;5;33;.868;3564000;0
2766;-1;130;0;0;0;0;.00nan;0;0
2766;-1;130;78;46;4;42;.913;3600000;0
2766;-1;138;0;0;0;0;.00nan;0;0
2773;223929;138;100;34;1;33;.971;3600000;0
2773;-1;130;0;0;0;0;.00nan;0;0
2773;-1;130;82;33;2;31;.939;3573000;0
2773;-1;138;0;0;0;0;.00nan;0;0
10302;200452;221;97;37;2;35;.946;3600000;0
10302;206971;4960;33;23;5;18;.783;3600000;0
10302;212304;4960;0;0;0;0;.00nan;0;0
10302;-1;221;0;0;0;0;.00nan;0;0
11559;201495;213;0;0;0;0;.00nan;0;0
11559;217198;213;87;42;3;39;.929;3558000;0
11559;197672;210;74;28;2;26;.929;3600000;0
11559;-1;210;0;0;0;0;.00nan;0;0
10300;196296;219;0;0;0;0;.00nan;0;0
10300;191063;211;0;0;0;0;.00nan;0;0
10300;-1;211;81;43;4;39;.907;3600000;0
10300;218658;219;99;27;0;27;1.000;3600000;0
10289;198149;188;0;0;0;0;.00nan;0;0
10289;215703;195;63;18;1;17;.944;3600000;0
10289;184409;188;86;57;3;54;.947;3600000;0
10289;207061;195;0;0;0;0;.00nan;0;0
11511;211017;220;55;37;5;32;.865;3600000;0
11511;218510;220;0;0;0;0;.00nan;0;0
11511;-1;1371;84;28;1;27;.964;3600000;0
11511;-1;1371;0;0;0;0;.00nan;0;0
11495;206801;176;76;44;4;40;.909;3564000;0
11495;-1;2620;0;0;0;0;.00nan;0;0
11495;213533;176;0;0;0;0;.00nan;0;0
11495;213550;2620;54;28;3;25;.893;3600000;0
10498;205769;200;0;0;0;0;.00nan;0;0
10498;212002;200;71;24;2;22;.917;3600000;0
10498;203087;204;53;37;5;32;.865;3600000;0
10498;203120;204;0;0;0;0;.00nan;0;0
10344;204676;192;0;0;0;0;.00nan;0;0
10344;200333;194;0;0;0;0;.00nan;0;0
10344;196352;194;89;47;3;44;.936;3600000;0
10344;207398;192;81;14;0;14;1.000;3600000;0
10432;196571;177;89;41;2;39;.951;3778000;0
10432;-1;178;0;0;0;0;.00nan;0;0
10432;-1;178;78;24;1;23;.958;3778000;0
10432;-1;177;0;0;0;0;.00nan;0;0
10329;198172;181;0;0;0;0;.00nan;0;0
10329;216001;181;46;19;3;16;.842;3600000;0
10329;182014;214;0;0;0;0;.00nan;0;0
10329;202914;214;52;49;8;41;.837;3600000;0
10313;213803;230;94;19;0;19;1.000;3600000;0
10313;217269;223;79;30;1;29;.967;3600000;0
10313;217312;223;0;0;0;0;.00nan;0;0
10313;191120;230;0;0;0;0;.00nan;0;0
10417;188977;215;0;0;0;0;.00nan;0;0
10417;210794;215;96;44;2;42;.955;3900000;0
10417;201718;217;0;0;0;0;.00nan;0;0
10417;-1;217;55;23;2;21;.913;3900000;0
10318;200437;201;68;28;3;25;.893;3600000;0
10318;205788;207;0;0;0;0;.00nan;0;0
10318;208048;201;0;0;0;0;.00nan;0;0
10318;197853;207;41;28;4;24;.857;3557000;0
10544;195118;197;0;0;0;0;.00nan;0;0
10544;206822;197;97;44;2;42;.955;3600000;0
10544;191118;196;41;34;6;28;.824;3600000;0
10544;202830;196;0;0;0;0;.00nan;0;0
10275;196088;185;47;39;6;33;.846;3600000;0
10275;185810;182;29;21;5;16;.762;3600000;0
10275;-1;185;0;0;0;0;.00nan;0;0
10275;213498;182;0;0;0;0;.00nan;0;0
10281;216313;180;73;26;2;24;.923;3600000;0
10281;191130;186;0;0;0;0;.00nan;0;0
10281;213507;186;40;38;6;32;.842;3600000;0
10281;208383;180;0;0;0;0;.00nan;0;0
10282;199416;191;0;0;0;0;.00nan;0;0
10282;201892;191;57;28;3;25;.893;3600000;0
10282;-1;189;0;0;0;0;.00nan;0;0
10282;-1;189;81;32;2;30;.938;3600000;0
11586;192915;179;98;42;2;40;.952;3591000;0
11586;211942;183;67;19;1;18;.947;3600000;0
11586;196237;183;0;0;0;0;.00nan;0;0
11586;187355;179;0;0;0;0;.00nan;0;0
10333;201525;203;62;30;3;27;.900;3600000;0
10333;201560;202;49;34;5;29;.853;3559000;0
10333;206772;203;0;0;0;0;.00nan;0;0
10333;208067;202;0;0;0;0;.00nan;0;0
11650;194950;1505;71;31;2;29;.935;3856000;0
11650;212814;1505;0;0;0;0;.00nan;0;0
11650;-1;4949;70;39;3;36;.923;3856000;0
11650;-1;4949;0;0;0;0;.00nan;0;0
10283;205681;226;76;25;1;24;.960;3600000;0
10283;201524;205;0;0;0;0;.00nan;0;0
10283;-1;226;0;0;0;0;.00nan;0;0
10283;-1;205;53;25;3;22;.880;3513000;0
10276;213399;216;0;0;0;0;.00nan;0;0
10276;-1;4949;87;21;0;21;1.000;3600000;0
10276;-1;4949;0;0;0;0;.00nan;0;0
10276;-1;216;63;27;4;23;.852;3600000;0
10277;192862;187;60;20;2;18;.900;3600000;0
10277;200333;194;0;0;0;0;.00nan;0;0
10277;196352;194;48;38;5;33;.868;3600000;0
10277;-1;187;0;0;0;0;.00nan;0;0
10401;201495;213;70;46;5;41;.891;3600000;0
10401;211942;183;58;22;2;20;.909;3600000;0
10401;196237;183;0;0;0;0;.00nan;0;0
10401;217198;213;0;0;0;0;.00nan;0;0
10284;200437;201;100;25;0;25;1.000;3758000;0
10284;201525;203;94;39;1;38;.974;3758000;0
10284;206772;203;0;0;0;0;.00nan;0;0
10284;208048;201;0;0;0;0;.00nan;0;0
10361;205788;207;0;0;0;0;.00nan;0;0
10361;-1;199;0;0;0;0;.00nan;0;0
10361;197853;207;70;37;4;33;.892;3570000;0
10361;-1;199;60;30;3;27;.900;3600000;0
10330;192939;208;0;0;0;0;.00nan;0;0
10330;205681;226;0;0;0;0;.00nan;0;0
10330;-1;226;59;42;5;37;.881;3516000;0
10330;-1;208;69;34;3;31;.912;3600000;0
10350;201718;217;0;0;0;0;.00nan;0;0
10350;191063;211;0;0;0;0;.00nan;0;0
10350;-1;211;52;35;5;30;.857;3600000;0
10350;-1;217;81;27;1;26;.963;3600000;0
10366;210504;193;52;26;3;23;.885;3779000;0
10366;212143;198;80;47;4;43;.915;3779000;0
10366;212649;198;0;0;0;0;.00nan;0;0
10366;218059;193;0;0;0;0;.00nan;0;0
10357;215703;195;0;0;0;0;.00nan;0;0
10357;207061;195;62;13;1;12;.923;3600000;0
10357;-1;190;97;62;5;57;.919;3600000;0
10357;-1;190;0;0;0;0;.00nan;0;0
10326;190164;4959;0;0;0;0;.00nan;0;0
10326;-1;209;69;33;3;30;.909;3571000;0
10326;-1;4959;84;27;1;26;.963;3600000;0
10326;213590;209;0;0;0;0;.00nan;0;0
10502;205769;200;0;0;0;0;.00nan;0;0
10502;201524;205;0;0;0;0;.00nan;0;0
10502;212002;200;61;22;2;20;.909;3581000;0
10502;-1;205;85;11;0;11;1.000;3600000;0
10325;215240;231;0;0;0;0;.00nan;0;0
10325;189773;231;80;13;0;13;1.000;3600000;0
10325;195363;222;0;0;0;0;.00nan;0;0
10325;213560;222;66;33;4;29;.879;3600000;0
10324;199416;191;0;0;0;0;.00nan;0;0
10324;201892;191;66;19;1;18;.947;3600000;0
10324;-1;189;81;29;2;27;.931;3550000;0
10324;-1;189;0;0;0;0;.00nan;0;0
10310;201514;227;0;0;0;0;.00nan;0;0
10310;180377;228;0;0;0;0;.00nan;0;0
10310;213280;227;74;30;2;28;.933;3900000;0
10310;208044;228;79;36;2;34;.944;3900000;0
10294;206833;4864;0;0;0;0;.00nan;0;0
10294;202801;4864;47;31;5;26;.839;3900000;0
10294;-1;2620;0;0;0;0;.00nan;0;0
10294;213550;2620;52;34;5;29;.853;3900000;0
10287;211017;220;89;33;2;31;.939;3600000;0
10287;182014;214;66;16;1;15;.938;1410000;0
10287;218510;220;0;0;0;0;.00nan;0;0
10287;202914;214;36;37;6;31;.838;2190000;0
10290;209840;184;0;0;0;0;.00nan;0;0
10290;205837;184;90;51;5;46;.902;3600000;0
10290;185810;182;78;29;2;27;.931;3600000;0
10290;213498;182;0;0;0;0;.00nan;0;0
10291;192915;179;31;11;3;8;.727;550000;0
10291;194950;1505;49;20;3;17;.850;3600000;0
10291;212814;1505;0;0;0;0;.00nan;0;0
10291;187355;179;90;33;1;32;.970;2995000;0
10684;204676;192;0;0;0;0;.00nan;0;0
10684;207398;192;92;27;1;26;.963;3600000;0
10684;191118;196;64;33;3;30;.909;3537000;0
10684;202830;196;0;0;0;0;.00nan;0;0
10298;200444;224;50;35;6;29;.829;3600000;0
10298;206800;225;0;0;0;0;.00nan;0;0
10298;-1;225;81;36;2;34;.944;3600000;0
10298;208372;224;0;0;0;0;.00nan;0;0
10304;206971;4960;100;27;0;27;1.000;3600000;0
10304;212304;4960;0;0;0;0;.00nan;0;0
10304;217269;223;0;0;0;0;.00nan;0;0
10304;217312;223;50;51;6;45;.882;3600000;0
10306;216313;180;38;36;6;30;.833;3560000;0
10306;212050;218;0;0;0;0;.00nan;0;0
10306;208051;218;51;30;4;26;.867;3600000;0
10306;208383;180;0;0;0;0;.00nan;0;0
11679;196571;177;73;31;2;29;.935;3900000;0
11679;197672;210;0;0;0;0;.00nan;0;0
11679;-1;210;63;27;2;25;.926;3892000;0
11679;-1;177;0;0;0;0;.00nan;0;0
10286;196283;206;0;0;0;0;.00nan;0;0
10286;202998;206;91;28;1;27;.964;3574000;0
10286;203087;204;0;0;0;0;.00nan;0;0
10286;203120;204;100;28;0;28;1.000;3600000;0
10579;196088;185;85;28;1;27;.964;3600000;0
10579;-1;185;0;0;0;0;.00nan;0;0
10579;-1;1371;47;32;5;27;.844;3600000;0
10579;-1;1371;0;0;0;0;.00nan;0;0
11491;192862;187;52;26;4;22;.846;3600000;0
11491;195118;197;0;0;0;0;.00nan;0;0
11491;206822;197;68;45;5;40;.889;3600000;0
11491;-1;187;0;0;0;0;.00nan;0;0
10296;200444;224;53;30;5;25;.833;3600000;0
10296;211080;229;39;36;6;30;.833;3600000;0
10296;208372;224;0;0;0;0;.00nan;0;0
10296;-1;229;0;0;0;0;.00nan;0;0
10378;200452;221;72;31;2;29;.935;3600000;0
10378;195363;222;49;8;1;7;.875;447000;0
10378;213560;222;36;36;6;30;.833;3153000;0
10378;-1;221;0;0;0;0;.00nan;0;0
10347;213803;230;64;26;2;24;.923;3600000;0
10347;187689;230;0;0;0;0;.00nan;0;0
10347;180377;228;46;40;5;35;.875;3600000;0
10347;208044;228;0;0;0;0;.00nan;0;0
10280;190164;4959;0;0;0;0;.00nan;0;0
10280;-1;209;0;0;0;0;.00nan;0;0
10280;-1;4959;87;18;0;18;1.000;3600000;0
10280;213590;209;93;46;2;44;.957;3558000;0
10315;212050;218;0;0;0;0;.00nan;0;0
10315;196296;219;0;0;0;0;.00nan;0;0
10315;208051;218;75;26;2;24;.923;3600000;0
10315;218658;219;82;37;3;34;.919;3544000;0
10274;188977;215;0;0;0;0;.00nan;0;0
10274;210794;215;75;38;3;35;.921;3600000;0
10274;191130;186;0;0;0;0;.00nan;0;0
10274;213507;186;88;15;0;15;1.000;3600000;0
11677;188977;215;42;31;5;26;.839;3561000;0
11677;210794;215;0;0;0;0;.00nan;0;0
11677;191063;211;0;0;0;0;.00nan;0;0
11677;-1;211;74;40;4;36;.900;3600000;0
10374;200452;221;0;0;0;0;.00nan;0;0
10374;211080;229;65;47;6;41;.872;3773000;0
10374;-1;221;29;23;5;18;.783;3773000;0
10374;-1;229;0;0;0;0;.00nan;0;0
10445;201718;217;72;21;1;20;.952;3600000;0
10445;196296;219;45;31;5;26;.839;3600000;0
10445;218658;219;0;0;0;0;.00nan;0;0
10445;-1;217;0;0;0;0;.00nan;0;0
10580;183695;232;77;21;0;21;1.000;1488000;0
10580;215240;231;0;0;0;0;.00nan;0;0
10580;189773;231;29;12;4;8;.667;3600000;0
10580;-1;232;37;36;6;30;.833;2112000;0
10906;196088;185;0;0;0;0;.00nan;0;0
10906;-1;185;67;39;4;35;.897;3569000;0
10906;-1;1371;0;0;0;0;.00nan;0;0
10906;-1;1371;68;33;3;30;.909;3600000;0
10411;201514;227;0;0;0;0;.00nan;0;0
10411;206800;225;0;0;0;0;.00nan;0;0
10411;-1;225;64;25;3;22;.880;3600000;0
10411;213280;227;70;41;4;37;.902;3569000;0
10525;206801;176;64;42;6;36;.857;3123000;0
10525;206833;4864;0;0;0;0;.00nan;0;0
10525;202801;4864;84;18;0;18;1.000;3600000;0
10525;213533;176;53;3;0;3;1.000;477000;0
10365;192939;208;33;34;6;28;.824;3600000;0
10365;-1;208;0;0;0;0;.00nan;0;0
10365;203087;204;41;19;3;16;.842;1978000;0
10365;203120;204;23;26;6;20;.769;1622000;0
10388;210504;193;46;29;5;24;.828;3900000;0
10388;195118;197;0;0;0;0;.00nan;0;0
10388;206822;197;44;37;5;32;.865;3900000;0
10388;218059;193;0;0;0;0;.00nan;0;0
10272;211017;220;0;0;0;0;.00nan;0;0
10272;182014;214;0;0;0;0;.00nan;0;0
10272;218510;220;66;20;1;19;.950;3600000;0
10272;202914;214;32;24;4;20;.833;3600000;0
10327;198172;181;57;15;1;14;.933;1637000;0
10327;209840;184;0;0;0;0;.00nan;0;0
10327;205837;184;99;45;2;43;.956;3600000;0
10327;216001;181;32;15;4;11;.733;1963000;0
10292;211942;183;35;36;6;30;.833;3600000;0
10292;196237;183;0;0;0;0;.00nan;0;0
10292;-1;178;0;0;0;0;.00nan;0;0
10292;-1;178;61;21;2;19;.905;3600000;0
10301;212143;198;56;31;4;27;.871;3600000;0
10301;212649;198;0;0;0;0;.00nan;0;0
10301;-1;190;87;60;5;55;.917;3600000;0
10301;-1;190;0;0;0;0;.00nan;0;0
10279;205681;226;0;0;0;0;.00nan;0;0
10279;-1;226;57;25;3;22;.880;3564000;0
10279;-1;199;0;0;0;0;.00nan;0;0
10279;-1;199;75;33;2;31;.939;3600000;0
10285;191130;186;0;0;0;0;.00nan;0;0
10285;213507;186;74;37;2;35;.946;3584000;0
10285;-1;212;0;0;0;0;.00nan;0;0
10285;-1;212;87;31;1;30;.968;3600000;0
10297;201560;202;59;38;4;34;.895;3600000;0
10297;196283;206;0;0;0;0;.00nan;0;0
10297;208067;202;0;0;0;0;.00nan;0;0
10297;202998;206;73;25;1;24;.960;3600000;0
10311;194950;1505;0;0;0;0;.00nan;0;0
10311;201495;213;0;0;0;0;.00nan;0;0
10311;217198;213;69;60;6;54;.900;3600000;0
10311;212814;1505;60;13;1;12;.923;3600000;0
10278;-1;4949;77;47;5;42;.894;3600000;0
10278;197672;210;0;0;0;0;.00nan;0;0
10278;-1;4949;0;0;0;0;.00nan;0;0
10278;-1;210;92;38;1;37;.974;3600000;0
11499;210504;193;75;27;2;25;.926;3900000;0
11499;218059;193;0;0;0;0;.00nan;0;0
11499;191118;196;75;34;2;32;.941;3900000;0
11499;202830;196;0;0;0;0;.00nan;0;0
10299;200437;201;76;35;3;32;.914;3600000;0
10299;201560;202;0;0;0;0;.00nan;0;0
10299;208048;201;0;0;0;0;.00nan;0;0
10299;208067;202;81;27;1;26;.963;3600000;0
10295;206971;4960;92;19;0;19;1.000;3600000;0
10295;212304;4960;0;0;0;0;.00nan;0;0
10295;180377;228;68;54;5;49;.907;3600000;0
10295;208044;228;0;0;0;0;.00nan;0;0
10322;199416;191;0;0;0;0;.00nan;0;0
10322;201892;191;31;17;4;13;.765;3600000;0
10322;-1;190;69;59;6;53;.898;2645000;0
10322;-1;190;44;15;2;13;.867;955000;0
10362;191063;211;98;53;3;50;.943;3540000;0
10362;-1;211;0;0;0;0;.00nan;0;0
10362;-1;212;55;10;1;9;.900;3600000;0
10362;-1;212;0;0;0;0;.00nan;0;0
10293;200333;194;54;41;5;36;.878;3600000;0
10293;196352;194;0;0;0;0;.00nan;0;0
10293;-1;189;100;28;0;28;1.000;3600000;0
10293;-1;189;0;0;0;0;.00nan;0;0
10323;201524;205;0;0;0;0;.00nan;0;0
10323;196283;206;88;34;2;32;.941;3600000;0
10323;-1;205;59;24;3;21;.875;3592000;0
10323;202998;206;0;0;0;0;.00nan;0;0
10380;190164;4959;0;0;0;0;.00nan;0;0
10380;206833;4864;0;0;0;0;.00nan;0;0
10380;202801;4864;52;21;3;18;.857;3529000;0
10380;-1;4959;92;32;1;31;.969;3600000;0
11432;215703;195;0;0;0;0;.00nan;0;0
11432;212143;198;0;0;0;0;.00nan;0;0
11432;207061;195;75;37;3;34;.919;3600000;0
11432;212649;198;43;28;5;23;.821;3572000;0
11556;196088;185;73;46;4;42;.913;3600000;0
11556;185810;182;53;21;3;18;.857;3600000;0
11556;-1;185;0;0;0;0;.00nan;0;0
11556;213498;182;0;0;0;0;.00nan;0;0
10317;201525;203;84;28;1;27;.964;3600000;0
10317;206772;203;0;0;0;0;.00nan;0;0
10317;-1;199;71;39;4;35;.897;3600000;0
10317;-1;199;0;0;0;0;.00nan;0;0
10332;192862;187;0;0;0;0;.00nan;0;0
10332;198149;188;0;0;0;0;.00nan;0;0
10332;184409;188;76;29;2;27;.931;3600000;0
10332;-1;187;41;32;5;27;.844;3600000;0
10308;-1;178;33;30;6;24;.800;2722000;0
10308;213399;216;0;0;0;0;.00nan;0;0
10308;-1;178;52;9;1;8;.889;878000;0
10308;-1;216;99;53;1;52;.981;3600000;0
10406;192915;179;52;36;5;31;.861;3600000;0
10406;201495;213;43;45;7;38;.844;3592000;0
10406;217198;213;0;0;0;0;.00nan;0;0
10406;187355;179;0;0;0;0;.00nan;0;0
10437;183695;232;0;0;0;0;.00nan;0;0
10437;201514;227;91;33;1;32;.970;3600000;0
10437;213280;227;0;0;0;0;.00nan;0;0
10437;-1;232;38;25;5;20;.800;3600000;0
10464;213803;230;46;20;3;17;.850;3586000;0
10464;187689;230;0;0;0;0;.00nan;0;0
10464;206800;225;0;0;0;0;.00nan;0;0
10464;-1;225;100;43;1;42;.977;3600000;0
10305;211942;183;0;0;0;0;.00nan;0;0
10305;196237;183;33;31;6;25;.806;3600000;0
10305;196571;177;43;34;5;29;.853;3600000;0
10305;-1;177;0;0;0;0;.00nan;0;0
10349;198172;181;0;0;0;0;.00nan;0;0
10349;209840;184;73;41;3;38;.927;3600000;0
10349;205837;184;0;0;0;0;.00nan;0;0
10349;216001;181;22;17;5;12;.706;3513000;0
11585;216313;180;0;0;0;0;.00nan;0;0
11585;201718;217;0;0;0;0;.00nan;0;0
11585;-1;217;80;41;3;38;.927;3600000;0
11585;208383;180;89;19;0;19;1.000;3600000;0
10307;215240;231;93;35;1;34;.971;3600000;0
10307;200444;224;0;0;0;0;.00nan;0;0
10307;189773;231;0;0;0;0;.00nan;0;0
10307;208372;224;62;29;3;26;.897;3561000;0
10320;194950;1505;78;26;1;25;.962;3600000;0
10320;212814;1505;0;0;0;0;.00nan;0;0
10320;-1;4949;0;0;0;0;.00nan;0;0
10320;-1;4949;86;38;2;36;.947;3571000;0
10584;192915;179;0;0;0;0;.00nan;0;0
10584;196571;177;0;0;0;0;.00nan;0;0
10584;187355;179;70;32;3;29;.906;3600000;0
10584;-1;177;47;30;5;25;.833;3521000;0
10501;188977;215;0;0;0;0;.00nan;0;0
10501;210794;215;95;46;1;45;.978;3600000;0
10501;212050;218;0;0;0;0;.00nan;0;0
10501;208051;218;33;12;3;9;.750;3575000;0
10383;192939;208;66;30;3;27;.900;3600000;0
10383;205788;207;58;6;0;6;1.000;738000;0
10383;197853;207;39;40;6;34;.850;2862000;0
10383;-1;208;0;0;0;0;.00nan;0;0
10309;211017;220;61;42;6;36;.857;3229000;0
10309;218510;220;59;9;0;9;1.000;371000;0
10309;-1;1371;100;25;0;25;1.000;3600000;0
10309;-1;1371;0;0;0;0;.00nan;0;0
10463;204676;192;0;0;0;0;.00nan;0;0
10463;215703;195;0;0;0;0;.00nan;0;0
10463;207061;195;78;34;2;32;.941;3823000;0
10463;207398;192;81;36;3;33;.917;3823000;0
10273;182014;214;98;40;1;39;.975;3600000;0
10273;185810;182;53;33;4;29;.879;3600000;0
10273;202914;214;0;0;0;0;.00nan;0;0
10273;213498;182;0;0;0;0;.00nan;0;0
10363;195118;197;0;0;0;0;.00nan;0;0
10363;206822;197;82;33;2;31;.939;3581000;0
10363;-1;189;81;22;1;21;.955;3600000;0
10363;-1;189;0;0;0;0;.00nan;0;0
10364;206801;176;73;39;3;36;.923;3600000;0
10364;-1;2620;0;0;0;0;.00nan;0;0
10364;213533;176;0;0;0;0;.00nan;0;0
10364;213550;2620;70;26;2;24;.923;3600000;0
11543;201525;203;100;45;1;44;.978;3600000;0
11543;206772;203;0;0;0;0;.00nan;0;0
11543;203087;204;0;0;0;0;.00nan;0;0
11543;203120;204;77;38;3;35;.921;3592000;0
10346;213399;216;70;34;3;31;.912;3600000;0
10346;197672;210;0;0;0;0;.00nan;0;0
10346;-1;210;34;31;5;26;.839;3540000;0
10346;-1;216;0;0;0;0;.00nan;0;0
11566;216313;180;49;32;4;28;.875;3900000;0
11566;191130;186;0;0;0;0;.00nan;0;0
11566;213507;186;73;43;3;40;.930;3900000;0
11566;208383;180;0;0;0;0;.00nan;0;0
10288;192862;187;69;22;2;20;.909;3600000;0
10288;191118;196;0;0;0;0;.00nan;0;0
10288;-1;187;0;0;0;0;.00nan;0;0
10288;202830;196;68;44;5;39;.886;3600000;0
11662;200452;221;84;29;1;28;.966;3600000;0
11662;211080;229;0;0;0;0;.00nan;0;0
11662;-1;221;0;0;0;0;.00nan;0;0
11662;-1;229;69;32;2;30;.938;3566000;0
11649;195363;222;82;24;2;22;.917;3900000;0
11649;180377;228;96;50;2;48;.960;3900000;0
11649;208044;228;0;0;0;0;.00nan;0;0
11649;213560;222;0;0;0;0;.00nan;0;0
11144;204676;192;73;37;3;34;.919;3900000;0
11144;210504;193;82;51;3;48;.941;3900000;0
11144;207398;192;0;0;0;0;.00nan;0;0
11144;218059;193;0;0;0;0;.00nan;0;0
11651;206801;176;44;38;6;32;.842;2911000;0
11651;206833;4864;60;14;1;13;.929;3600000;0
11651;202801;4864;0;0;0;0;.00nan;0;0
11651;213533;176;52;4;0;4;1.000;689000;0
11610;201524;205;0;0;0;0;.00nan;0;0
11610;201560;202;95;30;1;29;.967;3600000;0
11610;208067;202;0;0;0;0;.00nan;0;0
11610;-1;205;65;30;3;27;.900;3519000;0
10474;192939;208;71;28;2;26;.929;3600000;0
10474;205681;226;0;0;0;0;.00nan;0;0
10474;-1;226;44;32;6;26;.813;3600000;0
10474;-1;208;0;0;0;0;.00nan;0;0
11645;205788;207;42;25;4;21;.840;3600000;0
11645;196283;206;0;0;0;0;.00nan;0;0
11645;197853;207;0;0;0;0;.00nan;0;0
11645;202998;206;77;46;5;41;.891;3600000;0
10339;-1;209;0;0;0;0;.00nan;0;0
10339;-1;2620;92;44;3;41;.932;3900000;0
10339;213550;2620;0;0;0;0;.00nan;0;0
10339;213590;209;63;26;3;23;.885;3900000;0
10919;215240;231;0;0;0;0;.00nan;0;0
10919;189773;231;86;17;0;17;1.000;3600000;0
10919;206800;225;0;0;0;0;.00nan;0;0
10919;-1;225;77;54;4;50;.926;3600000;0
10376;198149;188;0;0;0;0;.00nan;0;0
10376;184409;188;71;31;2;29;.935;3600000;0
10376;212143;198;19;24;6;18;.750;3316000;0
10376;212649;198;48;0;0;0;.00nan;284000;0
10603;213803;230;69;25;2;23;.920;3600000;0
10603;187689;230;0;0;0;0;.00nan;0;0
10603;200444;224;39;29;5;24;.828;1731000;0
10603;208372;224;60;18;2;16;.889;1869000;0
11109;183695;232;0;0;0;0;.00nan;0;0
11109;217269;223;0;0;0;0;.00nan;0;0
11109;217312;223;87;29;1;28;.966;3600000;0
11109;-1;232;65;32;3;29;.906;3600000;0
10427;212050;218;35;29;5;24;.828;3563000;0
10427;208051;218;0;0;0;0;.00nan;0;0
10427;-1;212;84;49;4;45;.918;3600000;0
10427;-1;212;0;0;0;0;.00nan;0;0
11028;201514;227;0;0;0;0;.00nan;0;0
11028;206971;4960;54;10;1;9;.900;3600000;0
11028;212304;4960;0;0;0;0;.00nan;0;0
11028;213280;227;94;51;2;49;.961;3593000;0
10382;195363;222;0;0;0;0;.00nan;0;0
10382;211080;229;98;53;3;50;.943;3565000;0
10382;213560;222;61;10;1;9;.900;3600000;0
10382;-1;229;0;0;0;0;.00nan;0;0
11463;198172;181;57;30;3;27;.900;3900000;0
11463;209840;184;0;0;0;0;.00nan;0;0
11463;205837;184;65;28;3;25;.893;3900000;0
11463;216001;181;0;0;0;0;.00nan;0;0
10452;211942;183;69;20;1;19;.950;3600000;0
10452;196237;183;0;0;0;0;.00nan;0;0
10452;196571;177;66;36;4;32;.889;3600000;0
10452;-1;177;0;0;0;0;.00nan;0;0
10515;213803;230;0;0;0;0;.00nan;0;0
10515;187689;230;43;25;5;20;.800;3520000;0
10515;183695;232;81;38;3;35;.921;3600000;0
10515;-1;232;0;0;0;0;.00nan;0;0
11105;211017;220;27;25;6;19;.760;3900000;0
11105;182014;214;0;0;0;0;.00nan;0;0
11105;218510;220;0;0;0;0;.00nan;0;0
11105;202914;214;67;53;6;47;.887;3900000;0
10459;-1;178;0;0;0;0;.00nan;0;0
10459;-1;4949;99;26;0;26;1.000;3900000;0
10459;-1;4949;0;0;0;0;.00nan;0;0
10459;-1;178;96;35;0;35;1.000;3900000;0
10748;201524;205;60;35;4;31;.886;3512000;0
10748;196283;206;84;32;2;30;.938;3600000;0
10748;-1;205;0;0;0;0;.00nan;0;0
10748;202998;206;0;0;0;0;.00nan;0;0
11629;200333;194;0;0;0;0;.00nan;0;0
11629;195118;197;0;0;0;0;.00nan;0;0
11629;206822;197;84;44;4;40;.909;3600000;0
11629;196352;194;78;25;1;24;.960;3600000;0
11633;215240;231;0;0;0;0;.00nan;0;0
11633;200452;221;72;45;4;41;.911;3600000;0
11633;189773;231;80;15;0;15;1.000;3600000;0
11633;-1;221;0;0;0;0;.00nan;0;0
10939;206800;225;0;0;0;0;.00nan;0;0
10939;217269;223;0;0;0;0;.00nan;0;0
10939;217312;223;54;40;5;35;.875;3900000;0
10939;-1;225;53;34;5;29;.853;3900000;0
10334;194950;1505;49;22;3;19;.864;3600000;0
10334;212814;1505;0;0;0;0;.00nan;0;0
10334;213399;216;0;0;0;0;.00nan;0;0
10334;-1;216;66;37;4;33;.892;3600000;0
10368;205769;200;0;0;0;0;.00nan;0;0
10368;212002;200;64;27;3;24;.889;3600000;0
10368;-1;199;0;0;0;0;.00nan;0;0
10368;-1;199;52;36;5;31;.861;3562000;0
10370;201514;227;54;26;3;23;.885;3556000;0
10370;180377;228;0;0;0;0;.00nan;0;0
10370;213280;227;0;0;0;0;.00nan;0;0
10370;208044;228;99;41;1;40;.976;3600000;0
10353;-1;189;37;36;6;30;.833;3600000;0
10353;-1;190;67;20;1;19;.950;3600000;0
10353;-1;189;0;0;0;0;.00nan;0;0
10353;-1;190;0;0;0;0;.00nan;0;0
10345;190164;4959;0;0;0;0;.00nan;0;0
10345;-1;209;0;0;0;0;.00nan;0;0
10345;-1;4959;92;31;2;29;.935;3600000;0
10345;213590;209;55;29;4;25;.862;3600000;0
10342;196296;219;0;0;0;0;.00nan;0;0
10342;191130;186;0;0;0;0;.00nan;0;0
10342;218658;219;77;32;2;30;.938;3600000;0
10342;213507;186;73;37;3;34;.919;3553000;0
10335;185810;182;0;0;0;0;.00nan;0;0
10335;-1;1371;41;25;4;21;.840;3583000;0
10335;213498;182;78;27;2;25;.926;3600000;0
10335;-1;1371;0;0;0;0;.00nan;0;0
10331;199416;191;0;0;0;0;.00nan;0;0
10331;201892;191;62;17;2;15;.882;3900000;0
10331;191118;196;100;57;2;55;.965;3900000;0
10331;202830;196;0;0;0;0;.00nan;0;0
10611;215703;195;0;0;0;0;.00nan;0;0
10611;195118;197;0;0;0;0;.00nan;0;0
10611;206822;197;60;40;5;35;.875;3600000;0
10611;207061;195;54;11;1;10;.909;3600000;0
10422;211017;220;0;0;0;0;.00nan;0;0
10422;196088;185;83;37;2;35;.946;3600000;0
10422;-1;185;0;0;0;0;.00nan;0;0
10422;218510;220;52;36;5;31;.861;3600000;0
10328;199416;191;84;28;1;27;.964;3600000;0
10328;212143;198;24;6;3;3;.500;603000;0
10328;201892;191;0;0;0;0;.00nan;0;0
10328;212649;198;92;37;1;36;.973;2997000;0
10583;190164;4959;81;31;2;29;.935;3557000;0
10583;206833;4864;75;26;1;25;.962;3600000;0
10583;202801;4864;0;0;0;0;.00nan;0;0
10583;-1;4959;0;0;0;0;.00nan;0;0
10539;188977;215;0;0;0;0;.00nan;0;0
10539;210794;215;69;43;5;38;.884;3600000;0
10539;212050;218;0;0;0;0;.00nan;0;0
10539;208051;218;98;36;1;35;.972;3600000;0
10385;198149;188;0;0;0;0;.00nan;0;0
10385;184409;188;62;24;2;22;.917;3600000;0
10385;-1;189;0;0;0;0;.00nan;0;0
10385;-1;189;86;30;1;29;.967;3600000;0
10321;196296;219;35;22;5;17;.773;3515000;0
10321;191130;186;70;29;3;26;.897;3600000;0
10321;218658;219;0;0;0;0;.00nan;0;0
10321;213507;186;0;0;0;0;.00nan;0;0
10433;-1;178;0;0;0;0;.00nan;0;0
10433;197672;210;61;29;3;26;.897;3778000;0
10433;-1;178;61;32;4;28;.875;3778000;0
10433;-1;210;0;0;0;0;.00nan;0;0
10354;205769;200;24;19;5;14;.737;3600000;0
10354;201560;202;80;33;2;31;.939;3600000;0
10354;212002;200;0;0;0;0;.00nan;0;0
10354;208067;202;0;0;0;0;.00nan;0;0
10348;192862;187;0;0;0;0;.00nan;0;0
10348;191118;196;37;45;6;39;.867;3600000;0
10348;-1;187;64;23;2;21;.913;3600000;0
10348;202830;196;0;0;0;0;.00nan;0;0
10316;182014;214;99;41;1;40;.976;3611000;0
10316;202914;214;0;0;0;0;.00nan;0;0
10316;-1;1371;0;0;0;0;.00nan;0;0
10316;-1;1371;80;29;2;27;.931;3611000;0
10449;210504;193;32;16;4;12;.750;3600000;0
10449;218059;193;0;0;0;0;.00nan;0;0
10449;-1;190;86;57;5;52;.912;3600000;0
10449;-1;190;0;0;0;0;.00nan;0;0
10483;198172;181;0;0;0;0;.00nan;0;0
10483;209840;184;71;33;3;30;.909;3900000;0
10483;205837;184;0;0;0;0;.00nan;0;0
10483;216001;181;65;28;3;25;.893;3900000;0
11233;201718;217;0;0;0;0;.00nan;0;0
11233;191063;211;0;0;0;0;.00nan;0;0
11233;-1;211;100;43;1;42;.977;3600000;0
11233;-1;217;51;16;2;14;.875;3575000;0
10381;204676;192;0;0;0;0;.00nan;0;0
10381;200333;194;99;42;3;39;.929;3600000;0
10381;196352;194;0;0;0;0;.00nan;0;0
10381;207398;192;24;19;5;14;.737;3515000;0
10337;192939;208;50;20;3;17;.850;3600000;0
10337;200437;201;43;44;8;36;.818;2598000;0
10337;208048;201;16;24;6;18;.750;1002000;0
10337;-1;208;0;0;0;0;.00nan;0;0
10336;205681;226;0;0;0;0;.00nan;0;0
10336;-1;226;64;18;2;16;.889;3600000;0
10336;-1;199;45;41;6;35;.854;3186000;0
10336;-1;199;53;4;0;4;1.000;414000;0
10395;216313;180;88;56;3;53;.946;3600000;0
10395;208383;180;0;0;0;0;.00nan;0;0
10395;-1;212;83;31;2;29;.935;3600000;0
10395;-1;212;0;0;0;0;.00nan;0;0
10343;200452;221;63;10;0;10;1.000;344000;0
10343;206971;4960;100;27;0;27;1.000;3600000;0
10343;212304;4960;0;0;0;0;.00nan;0;0
10343;-1;221;32;41;7;34;.829;3256000;0
10312;200444;224;62;15;1;14;.933;3600000;0
10312;211080;229;79;20;0;20;1.000;1431000;0
10312;208372;224;0;0;0;0;.00nan;0;0
10312;-1;229;23;29;6;23;.793;2169000;0
10416;195363;222;50;28;5;23;.821;3571000;0
10416;180377;228;63;34;4;30;.882;3600000;0
10416;208044;228;0;0;0;0;.00nan;0;0
10416;213560;222;0;0;0;0;.00nan;0;0
11598;206801;176;43;47;7;40;.851;3600000;0
11598;-1;2620;66;16;1;15;.938;3600000;0
11598;213533;176;0;0;0;0;.00nan;0;0
11598;213550;2620;0;0;0;0;.00nan;0;0
11592;211942;183;0;0;0;0;.00nan;0;0
11592;196237;183;59;33;4;29;.879;3564000;0
11592;213399;216;76;38;3;35;.921;3600000;0
11592;-1;216;0;0;0;0;.00nan;0;0
10412;201525;203;69;36;3;33;.917;3600000;0
10412;206772;203;0;0;0;0;.00nan;0;0
10412;203087;204;0;0;0;0;.00nan;0;0
10412;203120;204;79;27;1;26;.963;3600000;0
10387;196571;177;0;0;0;0;.00nan;0;0
10387;-1;4949;0;0;0;0;.00nan;0;0
10387;-1;4949;54;32;4;28;.875;3539000;0
10387;-1;177;92;38;2;36;.947;3600000;0
10303;200444;224;0;0;0;0;.00nan;0;0
10303;201514;227;0;0;0;0;.00nan;0;0
10303;213280;227;80;35;2;33;.943;3600000;0
10303;208372;224;92;17;0;17;1.000;3600000;0
10734;213803;230;41;19;4;15;.789;3559000;0
10734;187689;230;0;0;0;0;.00nan;0;0
10734;206800;225;0;0;0;0;.00nan;0;0
10734;-1;225;86;38;3;35;.921;3600000;0
10424;-1;209;86;40;3;37;.925;3592000;0
10424;-1;2620;0;0;0;0;.00nan;0;0
10424;213550;2620;53;15;2;13;.867;3600000;0
10424;213590;209;0;0;0;0;.00nan;0;0
11570;205681;226;0;0;0;0;.00nan;0;0
11570;201524;205;0;0;0;0;.00nan;0;0
11570;-1;226;85;34;2;32;.941;3600000;0
11570;-1;205;52;25;3;22;.880;3580000;0
10408;201718;217;48;41;5;36;.878;3600000;0
10408;-1;217;0;0;0;0;.00nan;0;0
10408;-1;212;0;0;0;0;.00nan;0;0
10408;-1;212;78;24;1;23;.958;3600000;0
10340;192862;187;86;30;1;29;.967;3600000;0
10340;212143;198;46;28;4;24;.857;3600000;0
10340;212649;198;0;0;0;0;.00nan;0;0
10340;-1;187;0;0;0;0;.00nan;0;0
10390;200437;201;0;0;0;0;.00nan;0;0
10390;205788;207;0;0;0;0;.00nan;0;0
10390;208048;201;89;29;1;28;.966;3600000;0
10390;197853;207;35;23;4;19;.826;3600000;0
10359;194950;1505;74;9;0;9;1.000;3600000;0
10359;201495;213;0;0;0;0;.00nan;0;0
10359;217198;213;85;59;5;54;.915;3600000;0
10359;212814;1505;0;0;0;0;.00nan;0;0
11471;198149;188;83;48;2;46;.958;3554000;0
11471;215703;195;68;15;1;14;.933;3600000;0
11471;184409;188;0;0;0;0;.00nan;0;0
11471;207061;195;0;0;0;0;.00nan;0;0
10355;192939;208;0;0;0;0;.00nan;0;0
10355;201560;202;0;0;0;0;.00nan;0;0
10355;208067;202;92;55;5;50;.909;3600000;0
10355;-1;208;36;14;3;11;.786;3600000;0
10547;212050;218;49;1;0;1;1.000;422000;0
10547;191063;211;0;0;0;0;.00nan;0;0
10547;208051;218;52;36;5;31;.861;3178000;0
10547;-1;211;66;26;2;24;.923;3600000;0
10527;205788;207;84;29;1;28;.966;3600000;0
10527;201524;205;52;18;2;16;.889;3546000;0
10527;197853;207;0;0;0;0;.00nan;0;0
10527;-1;205;0;0;0;0;.00nan;0;0
10509;196571;177;86;39;2;37;.949;3600000;0
10509;-1;4949;67;24;3;21;.875;3545000;0
10509;-1;4949;0;0;0;0;.00nan;0;0
10509;-1;177;0;0;0;0;.00nan;0;0
10510;188977;215;0;0;0;0;.00nan;0;0
10510;210794;215;94;30;1;29;.967;3600000;0
10510;216313;180;73;30;2;28;.933;3595000;0
10510;208383;180;0;0;0;0;.00nan;0;0
10358;201525;203;60;29;4;25;.862;3578000;0
10358;206772;203;0;0;0;0;.00nan;0;0
10358;203087;204;54;23;3;20;.870;3600000;0
10358;203120;204;0;0;0;0;.00nan;0;0
10351;182014;214;0;0;0;0;.00nan;0;0
10351;202914;214;81;40;3;37;.925;3552000;0
10351;-1;1371;0;0;0;0;.00nan;0;0
10351;-1;1371;60;21;2;19;.905;3600000;0
10555;210504;193;76;21;1;20;.952;3600000;0
10555;218059;193;0;0;0;0;.00nan;0;0
10555;-1;189;94;40;2;38;.950;3548000;0
10555;-1;189;0;0;0;0;.00nan;0;0
11609;211942;183;71;35;3;32;.914;3900000;0
11609;196237;183;0;0;0;0;.00nan;0;0
11609;197672;210;0;0;0;0;.00nan;0;0
11609;-1;210;91;49;3;46;.939;3900000;0
10341;209840;184;47;6;1;5;.833;446000;0
10341;205837;184;37;30;6;24;.800;3154000;0
10341;185810;182;77;24;1;23;.958;3600000;0
10341;213498;182;0;0;0;0;.00nan;0;0
11639;195363;222;0;0;0;0;.00nan;0;0
11639;201514;227;43;40;6;34;.850;3138000;0
11639;213280;227;54;5;0;5;1.000;462000;0
11639;213560;222;67;25;2;23;.920;3600000;0
10352;196296;219;0;0;0;0;.00nan;0;0
10352;191130;186;31;12;4;8;.667;626000;0
10352;218658;219;51;21;3;18;.857;3600000;0
10352;213507;186;54;32;4;28;.875;2974000;0
10566;195118;197;84;19;0;19;1.000;3600000;0
10566;206822;197;0;0;0;0;.00nan;0;0
10566;191118;196;70;34;3;31;.912;3600000;0
10566;202830;196;0;0;0;0;.00nan;0;0
10356;211080;229;25;25;6;19;.760;2372000;0
10356;206971;4960;70;8;0;8;1.000;3600000;0
10356;212304;4960;0;0;0;0;.00nan;0;0
10356;-1;229;50;15;2;13;.867;1228000;0
10379;200452;221;43;13;2;11;.846;3600000;0
10379;217269;223;97;56;3;53;.946;3595000;0
10379;217312;223;0;0;0;0;.00nan;0;0
10379;-1;221;0;0;0;0;.00nan;0;0
11019;215240;231;0;0;0;0;.00nan;0;0
11019;189773;231;79;9;0;9;1.000;3600000;0
11019;206800;225;0;0;0;0;.00nan;0;0
11019;-1;225;63;56;7;49;.875;3600000;0
10466;192915;179;0;0;0;0;.00nan;0;0
10466;187355;179;62;27;3;24;.889;3900000;0
10466;-1;178;0;0;0;0;.00nan;0;0
10466;-1;178;72;33;3;30;.909;3900000;0
10795;190164;4959;0;0;0;0;.00nan;0;0
10795;206833;4864;0;0;0;0;.00nan;0;0
10795;202801;4864;67;26;2;24;.923;3600000;0
10795;-1;4959;86;37;3;34;.919;3583000;0
10400;204676;192;0;0;0;0;.00nan;0;0
10400;207398;192;64;22;2;20;.909;3600000;0
10400;-1;190;50;36;6;30;.833;2810000;0
10400;-1;190;59;6;0;6;1.000;790000;0
10458;198172;181;0;0;0;0;.00nan;0;0
10458;216001;181;65;28;2;26;.929;3900000;0
10458;196088;185;0;0;0;0;.00nan;0;0
10458;-1;185;70;29;2;27;.931;3900000;0
10426;183695;232;0;0;0;0;.00nan;0;0
10426;180377;228;99;49;3;46;.939;3600000;0
10426;208044;228;0;0;0;0;.00nan;0;0
10426;-1;232;50;25;4;21;.840;3563000;0
10418;196283;206;0;0;0;0;.00nan;0;0
10418;-1;199;0;0;0;0;.00nan;0;0
10418;-1;199;55;33;4;29;.879;3600000;0
10418;202998;206;85;24;0;24;1.000;3600000;0
10429;206801;176;67;13;1;12;.923;3900000;0
10429;-1;209;0;0;0;0;.00nan;0;0
10429;213533;176;0;0;0;0;.00nan;0;0
10429;213590;209;97;49;1;48;.980;3900000;0
10420;201495;213;47;30;5;25;.833;3713000;0
10420;217198;213;0;0;0;0;.00nan;0;0
10420;213399;216;0;0;0;0;.00nan;0;0
10420;-1;216;62;34;4;30;.882;3713000;0
10534;213399;216;71;43;4;39;.907;3812000;0
10534;197672;210;46;19;3;16;.842;3812000;0
10534;-1;210;0;0;0;0;.00nan;0;0
10534;-1;216;0;0;0;0;.00nan;0;0
10377;205769;200;0;0;0;0;.00nan;0;0
10377;201525;203;0;0;0;0;.00nan;0;0
10377;212002;200;83;25;1;24;.960;3600000;0
10377;206772;203;56;37;5;32;.865;3600000;0
11577;194950;1505;48;26;4;22;.846;3600000;0
11577;212814;1505;0;0;0;0;.00nan;0;0
11577;-1;178;20;9;4;5;.556;1173000;0
11577;-1;178;30;30;6;24;.800;2427000;0
10369;192939;208;24;23;6;17;.739;3600000;0
10369;196283;206;0;0;0;0;.00nan;0;0
10369;-1;208;0;0;0;0;.00nan;0;0
10369;202998;206;85;36;2;34;.944;3600000;0
11576;213803;230;93;35;1;34;.971;3600000;0
11576;187689;230;0;0;0;0;.00nan;0;0
11576;215240;231;76;30;2;28;.933;3048000;0
11576;189773;231;30;9;3;6;.667;552000;0
10384;211080;229;98;70;4;66;.943;3600000;0
10384;206971;4960;82;11;0;11;1.000;3600000;0
10384;212304;4960;0;0;0;0;.00nan;0;0
10384;-1;229;0;0;0;0;.00nan;0;0
11575;196571;177;0;0;0;0;.00nan;0;0
11575;-1;4949;0;0;0;0;.00nan;0;0
11575;-1;4949;74;28;2;26;.929;3555000;0
11575;-1;177;72;26;1;25;.962;3600000;0
10367;182014;214;90;37;2;35;.946;3600000;0
10367;185810;182;52;22;4;18;.818;3587000;0
10367;202914;214;0;0;0;0;.00nan;0;0
10367;213498;182;0;0;0;0;.00nan;0;0
10440;216313;180;0;0;0;0;.00nan;0;0
10440;208383;180;94;46;2;44;.957;3600000;0
10440;-1;212;51;25;4;21;.840;3513000;0
10440;-1;212;0;0;0;0;.00nan;0;0
11551;192862;187;68;25;1;24;.960;3600000;0
11551;-1;190;75;30;2;28;.933;3593000;0
11551;-1;187;0;0;0;0;.00nan;0;0
11551;-1;190;0;0;0;0;.00nan;0;0
10397;206801;176;0;0;0;0;.00nan;0;0
10397;-1;2620;50;45;6;39;.867;3600000;0
10397;213533;176;67;23;2;21;.913;3600000;0
10397;213550;2620;0;0;0;0;.00nan;0;0
10571;200333;194;0;0;0;0;.00nan;0;0
10571;215703;195;0;0;0;0;.00nan;0;0
10571;207061;195;88;19;0;19;1.000;3600000;0
10571;196352;194;82;49;4;45;.918;3600000;0
10391;198149;188;47;7;1;6;.857;314000;0
10391;184409;188;56;46;6;40;.870;3286000;0
10391;212143;198;49;27;4;23;.852;3600000;0
10391;212649;198;0;0;0;0;.00nan;0;0
10553;188977;215;100;31;0;31;1.000;3600000;0
10553;210794;215;0;0;0;0;.00nan;0;0
10553;201718;217;0;0;0;0;.00nan;0;0
10553;-1;217;72;29;3;26;.897;3600000;0
10448;209840;184;35;33;5;28;.848;3600000;0
10448;205837;184;0;0;0;0;.00nan;0;0
10448;196088;185;65;20;2;18;.900;3600000;0
10448;-1;185;0;0;0;0;.00nan;0;0
10451;195363;222;90;30;1;29;.967;3600000;0
10451;217269;223;0;0;0;0;.00nan;0;0
10451;217312;223;73;30;2;28;.933;3600000;0
10451;213560;222;0;0;0;0;.00nan;0;0
11607;200437;201;100;27;0;27;1.000;3600000;0
11607;208048;201;0;0;0;0;.00nan;0;0
11607;-1;199;90;58;3;55;.948;3600000;0
11607;-1;199;0;0;0;0;.00nan;0;0
10403;206833;4864;90;37;2;35;.946;3560000;0
10403;202801;4864;0;0;0;0;.00nan;0;0
10403;-1;2620;0;0;0;0;.00nan;0;0
10403;213550;2620;97;36;1;35;.972;3600000;0
10371;201560;202;92;37;1;36;.973;3600000;0
10371;208067;202;0;0;0;0;.00nan;0;0
10371;203087;204;0;0;0;0;.00nan;0;0
10371;203120;204;69;25;2;23;.920;3560000;0
11517;212143;198;0;0;0;0;.00nan;0;0
11517;212649;198;65;31;3;28;.903;3529000;0
11517;-1;189;93;30;1;29;.967;3600000;0
11517;-1;189;0;0;0;0;.00nan;0;0
10372;192862;187;0;0;0;0;.00nan;0;0
10372;199416;191;0;0;0;0;.00nan;0;0
10372;201892;191;66;29;2;27;.931;3600000;0
10372;-1;187;61;26;3;23;.885;3600000;0
10573;200333;194;67;41;4;37;.902;3600000;0
10573;210504;193;74;21;1;20;.952;3600000;0
10573;196352;194;0;0;0;0;.00nan;0;0
10573;218059;193;0;0;0;0;.00nan;0;0
10520;183695;232;0;0;0;0;.00nan;0;0
10520;201514;227;0;0;0;0;.00nan;0;0
10520;213280;227;73;30;2;28;.933;3600000;0
10520;-1;232;55;26;3;23;.885;3547000;0
10423;192915;179;53;17;2;15;.882;3600000;0
10423;201495;213;0;0;0;0;.00nan;0;0
10423;217198;213;49;40;6;34;.850;3600000;0
10423;187355;179;0;0;0;0;.00nan;0;0
10591;198172;181;87;37;3;34;.919;3600000;0
10591;216001;181;0;0;0;0;.00nan;0;0
10591;211017;220;84;49;4;45;.918;3554000;0
10591;218510;220;0;0;0;0;.00nan;0;0
10727;215703;195;0;0;0;0;.00nan;0;0
10727;195118;197;60;22;2;20;.909;3600000;0
10727;206822;197;0;0;0;0;.00nan;0;0
10727;207061;195;36;19;4;15;.789;3600000;0
10314;200444;224;0;0;0;0;.00nan;0;0
10314;200452;221;90;31;1;30;.968;3600000;0
10314;208372;224;64;27;2;25;.926;3600000;0
10314;-1;221;0;0;0;0;.00nan;0;0
10881;205681;226;0;0;0;0;.00nan;0;0
10881;201524;205;0;0;0;0;.00nan;0;0
10881;-1;226;61;22;2;20;.909;3900000;0
10881;-1;205;94;41;2;39;.951;3900000;0
10691;212050;218;70;22;2;20;.909;3600000;0
10691;191063;211;69;44;5;39;.886;3600000;0
10691;208051;218;0;0;0;0;.00nan;0;0
10691;-1;211;0;0;0;0;.00nan;0;0
10360;200437;201;52;24;3;21;.875;3600000;0
10360;205788;207;0;0;0;0;.00nan;0;0
10360;208048;201;0;0;0;0;.00nan;0;0
10360;197853;207;64;39;4;35;.897;3600000;0
11465;192939;208;74;45;4;41;.911;3590000;0
11465;205681;226;61;29;3;26;.897;3600000;0
11465;-1;226;0;0;0;0;.00nan;0;0
11465;-1;208;0;0;0;0;.00nan;0;0
10453;213803;230;73;31;3;28;.903;3765000;0
10453;187689;230;0;0;0;0;.00nan;0;0
10453;195363;222;0;0;0;0;.00nan;0;0
10453;213560;222;88;37;2;35;.946;3765000;0
10447;198149;188;0;0;0;0;.00nan;0;0
10447;204676;192;0;0;0;0;.00nan;0;0
10447;184409;188;57;46;6;40;.870;3600000;0
10447;207398;192;85;20;1;19;.950;3600000;0
10494;192915;179;0;0;0;0;.00nan;0;0
10494;194950;1505;0;0;0;0;.00nan;0;0
10494;212814;1505;80;19;1;18;.947;3600000;0
10494;187355;179;56;29;3;26;.897;3600000;0
11271;211942;183;80;29;1;28;.966;3600000;0
11271;196237;183;0;0;0;0;.00nan;0;0
11271;197672;210;0;0;0;0;.00nan;0;0
11271;-1;210;38;18;3;15;.833;3518000;0
11540;198172;181;0;0;0;0;.00nan;0;0
11540;216001;181;72;47;5;42;.894;3600000;0
11540;196088;185;0;0;0;0;.00nan;0;0
11540;-1;185;75;28;2;26;.929;3600000;0
11595;201525;203;72;25;1;24;.960;3600000;0
11595;206772;203;0;0;0;0;.00nan;0;0
11595;196283;206;0;0;0;0;.00nan;0;0
11595;202998;206;66;24;3;21;.875;3522000;0
10319;213803;230;0;0;0;0;.00nan;0;0
10319;187689;230;63;31;3;28;.903;3600000;0
10319;200444;224;68;30;2;28;.933;3600000;0
10319;208372;224;0;0;0;0;.00nan;0;0
10435;212143;198;83;16;0;16;1.000;3600000;0
10435;212649;198;0;0;0;0;.00nan;0;0
10435;-1;189;79;28;2;26;.929;3575000;0
10435;-1;189;0;0;0;0;.00nan;0;0
10434;211017;220;0;0;0;0;.00nan;0;0
10434;185810;182;54;21;3;18;.857;3600000;0
10434;218510;220;67;43;5;38;.884;3558000;0
10434;213498;182;0;0;0;0;.00nan;0;0
10540;213399;216;0;0;0;0;.00nan;0;0
10540;-1;4949;53;24;3;21;.875;3600000;0
10540;-1;4949;0;0;0;0;.00nan;0;0
10540;-1;216;71;45;4;41;.911;3543000;0
10373;191063;211;0;0;0;0;.00nan;0;0
10373;191130;186;0;0;0;0;.00nan;0;0
10373;-1;211;61;31;3;28;.903;3574000;0
10373;213507;186;99;32;1;31;.969;3600000;0
10450;198149;188;36;11;3;8;.727;575000;0
10450;204676;192;52;13;2;11;.846;3600000;0
10450;184409;188;80;42;4;38;.905;3025000;0
10450;207398;192;0;0;0;0;.00nan;0;0
10444;194950;1505;67;17;1;16;.941;3900000;0
10444;201495;213;97;53;1;52;.981;3900000;0
10444;217198;213;0;0;0;0;.00nan;0;0
10444;212814;1505;0;0;0;0;.00nan;0;0
10575;188977;215;81;41;3;38;.927;3600000;0
10575;210794;215;0;0;0;0;.00nan;0;0
10575;212050;218;0;0;0;0;.00nan;0;0
10575;208051;218;100;38;0;38;1.000;3600000;0
10552;206800;225;0;0;0;0;.00nan;0;0
10552;206971;4960;84;26;1;25;.962;3600000;0
10552;212304;4960;0;0;0;0;.00nan;0;0
10552;-1;225;83;45;4;41;.911;3600000;0
10413;196296;219;0;0;0;0;.00nan;0;0
10413;218658;219;77;33;2;31;.939;3900000;0
10413;-1;212;0;0;0;0;.00nan;0;0
10413;-1;212;72;35;2;33;.943;3900000;0
10419;192862;187;69;27;3;24;.889;3600000;0
10419;-1;190;85;30;2;28;.933;3600000;0
10419;-1;187;0;0;0;0;.00nan;0;0
10419;-1;190;0;0;0;0;.00nan;0;0
10471;201525;203;0;0;0;0;.00nan;0;0
10471;206772;203;89;31;1;30;.968;3600000;0
10471;203087;204;72;28;2;26;.929;3552000;0
10471;203120;204;0;0;0;0;.00nan;0;0
10492;206833;4864;0;0;0;0;.00nan;0;0
10492;202801;4864;75;27;1;26;.963;3600000;0
10492;-1;2620;72;32;2;30;.938;3573000;0
10492;213550;2620;0;0;0;0;.00nan;0;0
10457;206801;176;78;43;4;39;.907;3600000;0
10457;-1;209;86;28;1;27;.964;3600000;0
10457;213533;176;0;0;0;0;.00nan;0;0
10457;213590;209;0;0;0;0;.00nan;0;0
10421;209840;184;50;6;1;5;.833;1393000;0
10421;205837;184;36;23;4;19;.826;2207000;0
10421;182014;214;0;0;0;0;.00nan;0;0
10421;202914;214;75;30;2;28;.933;3600000;0
11555;200333;194;0;0;0;0;.00nan;0;0
11555;215703;195;56;24;3;21;.875;3857000;0
11555;207061;195;0;0;0;0;.00nan;0;0
11555;196352;194;91;48;3;45;.938;3900000;0
10398;205769;200;0;0;0;0;.00nan;0;0
10398;212002;200;55;38;4;34;.895;3600000;0
10398;-1;199;0;0;0;0;.00nan;0;0
10398;-1;199;55;47;6;41;.872;3531000;0
11380;183695;232;0;0;0;0;.00nan;0;0
11380;215240;231;0;0;0;0;.00nan;0;0
11380;189773;231;51;13;2;11;.846;3600000;0
11380;-1;232;74;50;5;45;.900;3600000;0
10392;201524;205;0;0;0;0;.00nan;0;0
10392;201560;202;77;29;2;27;.931;3771000;0
10392;208067;202;0;0;0;0;.00nan;0;0
10392;-1;205;75;26;1;25;.962;3771000;0
10456;201514;227;0;0;0;0;.00nan;0;0
10456;217269;223;61;34;4;30;.882;3589000;0
10456;217312;223;0;0;0;0;.00nan;0;0
10456;213280;227;75;37;3;34;.919;3600000;0
10468;199416;191;0;0;0;0;.00nan;0;0
10468;201892;191;44;22;3;19;.864;3545000;0
10468;191118;196;87;31;2;29;.935;3600000;0
10468;202830;196;0;0;0;0;.00nan;0;0
10405;195363;222;42;29;5;24;.828;3600000;0
10405;211080;229;0;0;0;0;.00nan;0;0
10405;213560;222;0;0;0;0;.00nan;0;0
10405;-1;229;30;31;6;25;.806;3583000;0
10441;211017;220;71;21;1;20;.952;3600000;0
10441;182014;214;86;39;2;37;.949;3600000;0
10441;218510;220;0;0;0;0;.00nan;0;0
10441;202914;214;0;0;0;0;.00nan;0;0
10402;192862;187;0;0;0;0;.00nan;0;0
10402;-1;189;71;36;3;33;.917;3900000;0
10402;-1;187;62;28;3;25;.893;3900000;0
10402;-1;189;0;0;0;0;.00nan;0;0
10404;205769;200;0;0;0;0;.00nan;0;0
10404;212002;200;64;30;3;27;.900;3518000;0
10404;196283;206;68;21;1;20;.952;3600000;0
10404;202998;206;0;0;0;0;.00nan;0;0
10482;191063;211;98;49;3;46;.939;3554000;0
10482;-1;211;0;0;0;0;.00nan;0;0
10482;-1;212;63;23;2;21;.913;3600000;0
10482;-1;212;0;0;0;0;.00nan;0;0
10414;212050;218;0;0;0;0;.00nan;0;0
10414;191130;186;66;25;3;22;.880;3600000;0
10414;208051;218;67;30;4;26;.867;3599000;0
10414;213507;186;0;0;0;0;.00nan;0;0
10467;190164;4959;0;0;0;0;.00nan;0;0
10467;206801;176;0;0;0;0;.00nan;0;0
10467;-1;4959;38;22;4;18;.818;3563000;0
10467;213533;176;84;41;3;38;.927;3600000;0
10479;-1;209;0;0;0;0;.00nan;0;0
10479;-1;2620;0;0;0;0;.00nan;0;0
10479;213550;2620;50;26;3;23;.885;3600000;0
10479;213590;209;48;35;5;30;.857;3572000;0
10681;200333;194;81;33;2;31;.939;3543000;0
10681;195118;197;0;0;0;0;.00nan;0;0
10681;206822;197;72;20;1;19;.950;3600000;0
10681;196352;194;0;0;0;0;.00nan;0;0
10396;198172;181;0;0;0;0;.00nan;0;0
10396;216001;181;75;26;2;24;.923;3600000;0
10396;185810;182;63;32;3;29;.906;3590000;0
10396;213498;182;0;0;0;0;.00nan;0;0
10521;192915;179;58;19;2;17;.895;3600000;0
10521;187355;179;0;0;0;0;.00nan;0;0
10521;-1;4949;0;0;0;0;.00nan;0;0
10521;-1;4949;78;38;3;35;.921;3568000;0
10386;205681;226;0;0;0;0;.00nan;0;0
10386;201560;202;59;11;0;11;1.000;589000;0
10386;-1;226;56;18;2;16;.889;3600000;0
10386;208067;202;33;33;6;27;.818;3011000;0
11125;-1;178;0;0;0;0;.00nan;0;0
11125;197672;210;70;24;2;22;.917;3547000;0
11125;-1;178;96;39;1;38;.974;3600000;0
11125;-1;210;0;0;0;0;.00nan;0;0
10513;201718;217;0;0;0;0;.00nan;0;0
10513;196296;219;19;25;6;19;.760;3600000;0
10513;218658;219;0;0;0;0;.00nan;0;0
10513;-1;217;66;33;3;30;.909;3600000;0
10461;200452;221;80;12;0;12;1.000;3600000;0
10461;180377;228;98;51;2;49;.961;3596000;0
10461;208044;228;0;0;0;0;.00nan;0;0
10461;-1;221;0;0;0;0;.00nan;0;0
10428;192939;208;65;27;1;26;.963;3543000;0
10428;201524;205;100;38;0;38;1.000;3600000;0
10428;-1;208;0;0;0;0;.00nan;0;0
10428;-1;205;0;0;0;0;.00nan;0;0
11374;200437;201;76;29;4;25;.862;3900000;0
11374;205788;207;0;0;0;0;.00nan;0;0
11374;208048;201;0;0;0;0;.00nan;0;0
11374;197853;207;77;48;4;44;.917;3900000;0
10425;201495;213;0;0;0;0;.00nan;0;0
10425;217198;213;55;34;4;30;.882;3600000;0
10425;196571;177;59;15;1;14;.933;3600000;0
10425;-1;177;0;0;0;0;.00nan;0;0
10850;215240;231;0;0;0;0;.00nan;0;0
10850;189773;231;62;24;2;22;.917;3600000;0
10850;201514;227;56;49;6;43;.878;3163000;0
10850;213280;227;48;5;1;4;.800;437000;0
10885;209840;184;81;27;1;26;.963;3900000;0
10885;205837;184;0;0;0;0;.00nan;0;0
10885;196088;185;88;33;1;32;.970;3900000;0
10885;-1;185;0;0;0;0;.00nan;0;0
10389;206971;4960;58;15;2;13;.867;3600000;0
10389;212304;4960;0;0;0;0;.00nan;0;0
10389;217269;223;0;0;0;0;.00nan;0;0
10389;217312;223;67;53;6;47;.887;3600000;0
10442;212143;198;75;36;2;34;.944;3600000;0
10442;212649;198;0;0;0;0;.00nan;0;0
10442;-1;190;36;32;6;26;.813;3600000;0
10442;-1;190;0;0;0;0;.00nan;0;0
11527;183695;232;0;0;0;0;.00nan;0;0
11527;180377;228;0;0;0;0;.00nan;0;0
11527;208044;228;52;16;2;14;.875;3600000;0
11527;-1;232;48;33;5;28;.848;3600000;0
10628;205681;226;47;21;3;18;.857;3552000;0
10628;-1;226;0;0;0;0;.00nan;0;0
10628;203087;204;0;0;0;0;.00nan;0;0
10628;203120;204;89;33;2;31;.939;3600000;0
10595;211942;183;52;39;6;33;.846;3600000;0
10595;196237;183;0;0;0;0;.00nan;0;0
10595;196571;177;0;0;0;0;.00nan;0;0
10595;-1;177;61;32;4;28;.875;3600000;0
10338;200444;224;0;0;0;0;.00nan;0;0
10338;211080;229;97;43;2;41;.953;3600000;0
10338;208372;224;70;20;1;19;.950;3600000;0
10338;-1;229;0;0;0;0;.00nan;0;0
10430;192939;208;0;0;0;0;.00nan;0;0
10430;201525;203;100;51;3;48;.941;3900000;0
10430;206772;203;0;0;0;0;.00nan;0;0
10430;-1;208;57;25;3;22;.880;3900000;0
10460;213803;230;61;20;2;18;.900;3600000;0
10460;187689;230;0;0;0;0;.00nan;0;0
10460;195363;222;0;0;0;0;.00nan;0;0
10460;213560;222;71;39;3;36;.923;3527000;0
10493;198149;188;0;0;0;0;.00nan;0;0
10493;184409;188;63;36;4;32;.889;3533000;0
10493;191118;196;99;41;2;39;.951;3600000;0
10493;202830;196;0;0;0;0;.00nan;0;0
10465;198172;181;93;36;1;35;.972;3600000;0
10465;216001;181;0;0;0;0;.00nan;0;0
10465;196088;185;0;0;0;0;.00nan;0;0
10465;-1;185;50;24;3;21;.875;3550000;0
10415;211080;229;0;0;0;0;.00nan;0;0
10415;206800;225;0;0;0;0;.00nan;0;0
10415;-1;225;59;25;3;22;.880;3900000;0
10415;-1;229;58;30;3;27;.900;3900000;0
10503;212050;218;70;38;3;35;.921;3600000;0
10503;208051;218;0;0;0;0;.00nan;0;0
10503;-1;212;84;14;0;14;1.000;3600000;0
10503;-1;212;0;0;0;0;.00nan;0;0
10480;199416;191;0;0;0;0;.00nan;0;0
10480;201892;191;57;15;2;13;.867;3600000;0
10480;-1;190;0;0;0;0;.00nan;0;0
10480;-1;190;46;45;6;39;.867;3600000;0
10375;201560;202;97;22;0;22;1.000;3600000;0
10375;208067;202;0;0;0;0;.00nan;0;0
10375;-1;199;64;40;4;36;.900;3600000;0
10375;-1;199;0;0;0;0;.00nan;0;0
10454;200437;201;100;40;1;39;.975;3600000;0
10454;201524;205;44;25;4;21;.840;3600000;0
10454;208048;201;0;0;0;0;.00nan;0;0
10454;-1;205;0;0;0;0;.00nan;0;0
10638;198149;188;71;43;5;38;.884;3550000;0
10638;200333;194;0;0;0;0;.00nan;0;0
10638;184409;188;0;0;0;0;.00nan;0;0
10638;196352;194;65;34;3;31;.912;3600000;0
10409;192862;187;97;40;1;39;.975;3600000;0
10409;204676;192;0;0;0;0;.00nan;0;0
10409;207398;192;99;26;0;26;1.000;3600000;0
10409;-1;187;0;0;0;0;.00nan;0;0
10407;200444;224;69;26;2;24;.923;3600000;0
10407;195363;222;37;20;4;16;.800;3517000;0
10407;213560;222;0;0;0;0;.00nan;0;0
10407;208372;224;0;0;0;0;.00nan;0;0
10536;215703;195;0;0;0;0;.00nan;0;0
10536;212143;198;0;0;0;0;.00nan;0;0
10536;207061;195;66;18;1;17;.944;3600000;0
10536;212649;198;97;56;3;53;.946;3583000;0
10605;210504;193;0;0;0;0;.00nan;0;0
10605;218059;193;60;25;2;23;.920;3514000;0
10605;-1;189;100;38;0;38;1.000;3600000;0
10605;-1;189;0;0;0;0;.00nan;0;0
10410;185810;182;75;35;3;32;.914;3776000;0
10410;-1;1371;89;28;2;26;.929;3776000;0
10410;213498;182;0;0;0;0;.00nan;0;0
10410;-1;1371;0;0;0;0;.00nan;0;0
11617;-1;209;46;30;5;25;.833;3600000;0
11617;-1;2620;82;34;2;32;.941;3600000;0
11617;213550;2620;0;0;0;0;.00nan;0;0
11617;213590;209;0;0;0;0;.00nan;0;0
10620;206801;176;86;38;2;36;.947;3600000;0
10620;206833;4864;0;0;0;0;.00nan;0;0
10620;202801;4864;71;22;3;19;.864;3548000;0
10620;213533;176;0;0;0;0;.00nan;0;0
10533;213803;230;0;0;0;0;.00nan;0;0
10533;187689;230;75;27;1;26;.963;3600000;0
10533;206971;4960;64;26;2;24;.923;3562000;0
10533;212304;4960;0;0;0;0;.00nan;0;0
10439;205769;200;0;0;0;0;.00nan;0;0
10439;205788;207;65;36;3;33;.917;3515000;0
10439;212002;200;64;19;1;18;.947;3600000;0
10439;197853;207;0;0;0;0;.00nan;0;0
10806;195118;197;0;0;0;0;.00nan;0;0
10806;206822;197;71;33;3;30;.909;3600000;0
10806;191118;196;58;35;4;31;.886;3547000;0
10806;202830;196;0;0;0;0;.00nan;0;0
10565;192915;179;75;34;3;31;.912;3588000;0
10565;211942;183;0;0;0;0;.00nan;0;0
10565;196237;183;99;43;2;41;.953;3600000;0
10565;187355;179;0;0;0;0;.00nan;0;0
10842;216313;180;35;26;5;21;.808;3574000;0
10842;201718;217;0;0;0;0;.00nan;0;0
10842;-1;217;64;29;3;26;.897;3600000;0
10842;208383;180;0;0;0;0;.00nan;0;0
10560;215240;231;0;0;0;0;.00nan;0;0
10560;189773;231;85;16;0;16;1.000;3600000;0
10560;201514;227;0;0;0;0;.00nan;0;0
10560;213280;227;92;68;5;63;.926;3600000;0
10554;200452;221;55;21;2;19;.905;3900000;0
10554;217269;223;0;0;0;0;.00nan;0;0
10554;217312;223;85;39;2;37;.949;3900000;0
10554;-1;221;0;0;0;0;.00nan;0;0
10524;194950;1505;98;32;1;31;.969;3600000;0
10524;212814;1505;0;0;0;0;.00nan;0;0
10524;-1;178;0;0;0;0;.00nan;0;0
10524;-1;178;82;52;5;47;.904;3600000;0
10394;209840;184;0;0;0;0;.00nan;0;0
10394;205837;184;60;26;2;24;.923;3600000;0
10394;182014;214;0;0;0;0;.00nan;0;0
10394;202914;214;52;29;4;25;.862;3583000;0
10446;188977;215;0;0;0;0;.00nan;0;0
10446;210794;215;70;33;3;30;.909;3600000;0
10446;191130;186;0;0;0;0;.00nan;0;0
10446;213507;186;49;29;4;25;.862;3600000;0
10537;205788;207;0;0;0;0;.00nan;0;0
10537;196283;206;0;0;0;0;.00nan;0;0
10537;197853;207;91;29;1;28;.966;3900000;0
10537;202998;206;92;44;1;43;.977;3900000;0
10486;206833;4864;57;18;2;16;.889;3600000;0
10486;-1;209;0;0;0;0;.00nan;0;0
10486;202801;4864;0;0;0;0;.00nan;0;0
10486;213590;209;71;36;4;32;.889;3513000;0
10801;213399;216;0;0;0;0;.00nan;0;0
10801;197672;210;0;0;0;0;.00nan;0;0
10801;-1;210;54;19;2;17;.895;3707000;0
10801;-1;216;88;47;3;44;.936;3703000;0
11630;201514;227;66;44;5;39;.886;3900000;0
11630;217269;223;69;44;5;39;.886;3888000;0
11630;217312;223;0;0;0;0;.00nan;0;0
11630;213280;227;0;0;0;0;.00nan;0;0
10594;192915;179;0;0;0;0;.00nan;0;0
10594;196571;177;95;35;1;34;.971;3600000;0
10594;187355;179;56;25;3;22;.880;3586000;0
10594;-1;177;0;0;0;0;.00nan;0;0
10549;200437;201;87;39;2;37;.949;3600000;0
10549;205681;226;0;0;0;0;.00nan;0;0
10549;208048;201;0;0;0;0;.00nan;0;0
10549;-1;226;67;17;1;16;.941;3600000;0
10399;199416;191;78;35;3;32;.914;3844000;0
10399;204676;192;0;0;0;0;.00nan;0;0
10399;201892;191;0;0;0;0;.00nan;0;0
10399;207398;192;57;28;4;24;.857;3837000;0
11652;201525;203;72;29;3;26;.897;3600000;0
11652;201560;202;100;31;0;31;1.000;3600000;0
11652;206772;203;0;0;0;0;.00nan;0;0
11652;208067;202;0;0;0;0;.00nan;0;0
10518;183695;232;0;0;0;0;.00nan;0;0
10518;180377;228;59;36;4;32;.889;3561000;0
10518;208044;228;0;0;0;0;.00nan;0;0
10518;-1;232;62;27;3;24;.889;3600000;0
10861;216313;180;0;0;0;0;.00nan;0;0
10861;201718;217;92;45;3;42;.933;3600000;0
10861;-1;217;0;0;0;0;.00nan;0;0
10861;208383;180;57;17;2;15;.882;3600000;0
10581;210504;193;84;42;2;40;.952;3579000;0
10581;215703;195;83;29;1;28;.966;3600000;0
10581;207061;195;0;0;0;0;.00nan;0;0
10581;218059;193;0;0;0;0;.00nan;0;0
11514;215240;231;0;0;0;0;.00nan;0;0
11514;189773;231;73;33;3;30;.909;3600000;0
11514;206971;4960;0;0;0;0;.00nan;0;0
11514;212304;4960;55;37;5;32;.865;3554000;0
10545;190164;4959;0;0;0;0;.00nan;0;0
10545;-1;4959;61;24;3;21;.875;3600000;0
10545;-1;2620;0;0;0;0;.00nan;0;0
10545;213550;2620;48;35;5;30;.857;3561000;0
10443;201495;213;89;44;2;42;.955;3900000;0
10443;217198;213;0;0;0;0;.00nan;0;0
10443;-1;4949;65;22;2;20;.909;3900000;0
10443;-1;4949;0;0;0;0;.00nan;0;0
10436;198172;181;51;42;6;36;.857;3600000;0
10436;216001;181;0;0;0;0;.00nan;0;0
10436;-1;1371;0;0;0;0;.00nan;0;0
10436;-1;1371;57;33;4;29;.879;3600000;0
11663;201524;205;0;0;0;0;.00nan;0;0
11663;-1;205;94;24;0;24;1.000;3600000;0
11663;203087;204;58;26;3;23;.885;3600000;0
11663;203120;204;0;0;0;0;.00nan;0;0
11672;191063;211;0;0;0;0;.00nan;0;0
11672;-1;211;60;24;3;21;.875;3600000;0
11672;-1;212;0;0;0;0;.00nan;0;0
11672;-1;212;48;26;4;22;.846;3564000;0
11544;209840;184;65;26;3;23;.885;3900000;0
11544;205837;184;0;0;0;0;.00nan;0;0
11544;182014;214;70;35;3;32;.914;3879000;0
11544;202914;214;0;0;0;0;.00nan;0;0
10621;183695;232;61;40;5;35;.875;3600000;0
10621;200452;221;63;21;2;19;.905;3600000;0
10621;-1;221;0;0;0;0;.00nan;0;0
10621;-1;232;0;0;0;0;.00nan;0;0
11632;200444;224;95;23;0;23;1.000;3600000;0
11632;195363;222;0;0;0;0;.00nan;0;0
11632;213560;222;62;29;3;26;.897;3600000;0
11632;208372;224;0;0;0;0;.00nan;0;0
10455;192939;208;0;0;0;0;.00nan;0;0
10455;-1;208;57;16;2;14;.875;3600000;0
10455;203087;204;0;0;0;0;.00nan;0;0
10455;203120;204;62;47;5;42;.894;3600000;0
10604;188977;215;0;0;0;0;.00nan;0;0
10604;210794;215;98;46;3;43;.935;3600000;0
10604;196296;219;0;0;0;0;.00nan;0;0
10604;218658;219;46;29;4;25;.862;3557000;0
11377;190164;4959;71;38;3;35;.921;3600000;0
11377;206801;176;56;30;4;26;.867;3567000;0
11377;-1;4959;0;0;0;0;.00nan;0;0
11377;213533;176;0;0;0;0;.00nan;0;0
11654;198149;188;83;17;0;17;1.000;948000;0
11654;184409;188;60;41;6;35;.854;2611000;0
11654;212143;198;48;24;4;20;.833;3600000;0
11654;212649;198;0;0;0;0;.00nan;0;0
10489;196283;206;72;41;4;37;.902;3524000;0
10489;-1;199;0;0;0;0;.00nan;0;0
10489;-1;199;60;22;2;20;.909;3600000;0
10489;202998;206;0;0;0;0;.00nan;0;0
11572;201495;213;52;4;0;4;1.000;346000;0
11572;217198;213;47;40;6;34;.850;3254000;0
11572;196571;177;0;0;0;0;.00nan;0;0
11572;-1;177;76;33;2;31;.939;3600000;0
10735;211942;183;64;16;1;15;.938;3600000;0
10735;196237;183;0;0;0;0;.00nan;0;0
10735;-1;178;0;0;0;0;.00nan;0;0
10735;-1;178;74;31;2;29;.935;3561000;0
10532;194950;1505;0;0;0;0;.00nan;0;0
10532;212814;1505;99;12;0;12;1.000;3600000;0
10532;213399;216;98;47;2;45;.957;3569000;0
10532;-1;216;0;0;0;0;.00nan;0;0
10561;206800;225;0;0;0;0;.00nan;0;0
10561;180377;228;0;0;0;0;.00nan;0;0
10561;-1;225;79;23;1;22;.957;3600000;0
10561;208044;228;76;36;2;34;.944;3600000;0
11563;205681;226;0;0;0;0;.00nan;0;0
11563;201525;203;77;29;2;27;.931;3600000;0
11563;206772;203;0;0;0;0;.00nan;0;0
11563;-1;226;52;29;4;25;.862;3552000;0
10871;196088;185;49;35;5;30;.857;3600000;0
10871;185810;182;84;17;0;17;1.000;3600000;0
10871;-1;185;0;0;0;0;.00nan;0;0
10871;213498;182;0;0;0;0;.00nan;0;0
10864;215703;195;0;0;0;0;.00nan;0;0
10864;195118;197;0;0;0;0;.00nan;0;0
10864;206822;197;82;35;2;33;.943;3560000;0
10864;207061;195;100;28;0;28;1.000;3600000;0
10618;201718;217;0;0;0;0;.00nan;0;0
10618;191063;211;0;0;0;0;.00nan;0;0
10618;-1;211;61;34;4;30;.882;3600000;0
10618;-1;217;100;30;0;30;1.000;3600000;0
10625;200333;194;0;0;0;0;.00nan;0;0
10625;210504;193;58;29;4;25;.862;3761000;0
10625;196352;194;92;55;5;50;.909;3761000;0
10625;218059;193;0;0;0;0;.00nan;0;0
11588;216313;180;30;24;5;19;.792;3580000;0
11588;191130;186;0;0;0;0;.00nan;0;0
11588;213507;186;76;45;4;41;.911;3600000;0
11588;208383;180;0;0;0;0;.00nan;0;0
11656;192915;179;61;30;3;27;.900;3543000;0
11656;187355;179;0;0;0;0;.00nan;0;0
11656;-1;4949;74;35;2;33;.943;3600000;0
11656;-1;4949;0;0;0;0;.00nan;0;0
10588;211017;220;76;31;2;29;.935;3600000;0
10588;218510;220;0;0;0;0;.00nan;0;0
10588;-1;1371;55;26;3;23;.885;3600000;0
10588;-1;1371;0;0;0;0;.00nan;0;0
11605;-1;178;0;0;0;0;.00nan;0;0
11605;213399;216;0;0;0;0;.00nan;0;0
11605;-1;178;95;51;3;48;.941;3545000;0
11605;-1;216;71;25;2;23;.920;3600000;0
10508;196296;219;0;0;0;0;.00nan;0;0
10508;218658;219;95;23;0;23;1.000;3600000;0
10508;-1;212;59;34;3;31;.912;3600000;0
10508;-1;212;0;0;0;0;.00nan;0;0
10629;211942;183;63;27;2;25;.926;3900000;0
10629;196237;183;0;0;0;0;.00nan;0;0
10629;196571;177;91;42;2;40;.952;3900000;0
10629;-1;177;0;0;0;0;.00nan;0;0
10567;200452;221;74;37;4;33;.892;3600000;0
10567;206800;225;0;0;0;0;.00nan;0;0
10567;-1;225;100;36;0;36;1.000;3600000;0
10567;-1;221;0;0;0;0;.00nan;0;0
10516;211080;229;62;23;2;21;.913;3600000;0
10516;217269;223;0;0;0;0;.00nan;0;0
10516;217312;223;47;25;4;21;.840;3567000;0
10516;-1;229;0;0;0;0;.00nan;0;0
10538;212143;198;42;27;4;23;.852;3600000;0
10538;212649;198;0;0;0;0;.00nan;0;0
10538;-1;190;100;41;1;40;.976;3600000;0
10538;-1;190;0;0;0;0;.00nan;0;0
10472;205769;200;0;0;0;0;.00nan;0;0
10472;205788;207;0;0;0;0;.00nan;0;0
10472;212002;200;29;25;5;20;.800;3600000;0
10472;197853;207;98;34;1;33;.971;3600000;0
11669;201525;203;73;35;3;32;.914;3555000;0
11669;206772;203;0;0;0;0;.00nan;0;0
11669;203087;204;0;0;0;0;.00nan;0;0
11669;203120;204;68;20;1;19;.950;3600000;0
10647;212050;218;0;0;0;0;.00nan;0;0
10647;191130;186;54;44;5;39;.886;3600000;0
10647;208051;218;91;21;0;21;1.000;3600000;0
10647;213507;186;0;0;0;0;.00nan;0;0
10529;206833;4864;0;0;0;0;.00nan;0;0
10529;-1;209;78;35;3;32;.914;3600000;0
10529;202801;4864;42;33;5;28;.848;3540000;0
10529;213590;209;0;0;0;0;.00nan;0;0
10655;188977;215;50;15;2;13;.867;1213000;0
10655;210794;215;22;25;6;19;.760;2387000;0
10655;216313;180;0;0;0;0;.00nan;0;0
10655;208383;180;75;31;2;29;.935;3600000;0
10505;205681;226;0;0;0;0;.00nan;0;0
10505;-1;226;51;20;2;18;.900;3600000;0
10505;-1;199;0;0;0;0;.00nan;0;0
10505;-1;199;80;43;3;40;.930;3600000;0
11661;183695;232;0;0;0;0;.00nan;0;0
11661;201514;227;0;0;0;0;.00nan;0;0
11661;213280;227;73;31;2;29;.935;3611000;0
11661;-1;232;79;26;1;25;.962;3611000;0
10674;210504;193;54;25;3;22;.880;3551000;0
10674;218059;193;0;0;0;0;.00nan;0;0
10674;191118;196;98;32;1;31;.969;3600000;0
10674;202830;196;0;0;0;0;.00nan;0;0
10758;195118;197;20;23;6;17;.739;2258000;0
10758;206822;197;39;9;2;7;.778;1342000;0
10758;-1;189;61;28;3;25;.893;3600000;0
10758;-1;189;0;0;0;0;.00nan;0;0
10431;200444;224;99;27;0;27;1.000;3600000;0
10431;195363;222;88;38;2;36;.947;3580000;0
10431;213560;222;0;0;0;0;.00nan;0;0
10431;208372;224;0;0;0;0;.00nan;0;0
11640;199416;191;0;0;0;0;.00nan;0;0
11640;215703;195;0;0;0;0;.00nan;0;0
11640;201892;191;55;29;4;25;.862;3552000;0
11640;207061;195;94;48;3;45;.938;3600000;0
11579;190164;4959;0;0;0;0;.00nan;0;0
11579;206801;176;100;28;0;28;1.000;3600000;0
11579;-1;4959;96;45;2;43;.956;3578000;0
11579;213533;176;0;0;0;0;.00nan;0;0
10732;213803;230;91;22;0;22;1.000;3600000;0
10732;187689;230;0;0;0;0;.00nan;0;0
10732;180377;228;74;38;3;35;.921;3600000;0
10732;208044;228;0;0;0;0;.00nan;0;0
10506;211017;220;0;0;0;0;.00nan;0;0
10506;218510;220;73;20;1;19;.950;3600000;0
10506;-1;1371;0;0;0;0;.00nan;0;0
10506;-1;1371;51;25;4;21;.840;3600000;0
10645;200437;201;83;32;2;30;.938;3600000;0
10645;208048;201;0;0;0;0;.00nan;0;0
10645;203087;204;39;30;5;25;.833;3600000;0
10645;203120;204;0;0;0;0;.00nan;0;0
11122;213399;216;72;45;4;41;.911;3574000;0
11122;-1;4949;0;0;0;0;.00nan;0;0
11122;-1;4949;62;20;2;18;.900;3600000;0
11122;-1;216;0;0;0;0;.00nan;0;0
10574;198149;188;0;0;0;0;.00nan;0;0
10574;184409;188;57;45;6;39;.867;3585000;0
10574;-1;190;69;32;3;29;.906;3600000;0
10574;-1;190;0;0;0;0;.00nan;0;0
10484;201495;213;63;45;5;40;.889;3600000;0
10484;211942;183;0;0;0;0;.00nan;0;0
10484;196237;183;96;29;0;29;1.000;3600000;0
10484;217198;213;0;0;0;0;.00nan;0;0
10512;198172;181;0;0;0;0;.00nan;0;0
10512;216001;181;97;52;2;50;.962;3600000;0
10512;185810;182;64;33;3;30;.909;3593000;0
10512;213498;182;0;0;0;0;.00nan;0;0
10576;-1;209;0;0;0;0;.00nan;0;0
10576;-1;2620;66;30;3;27;.900;3673000;0
10576;213550;2620;0;0;0;0;.00nan;0;0
10576;213590;209;75;32;2;30;.938;3673000;0
10473;200444;224;0;0;0;0;.00nan;0;0
10473;206971;4960;55;22;2;20;.909;3545000;0
10473;212304;4960;0;0;0;0;.00nan;0;0
10473;208372;224;73;22;1;21;.955;3600000;0
10531;196088;185;59;35;4;31;.886;3582000;0
10531;182014;214;0;0;0;0;.00nan;0;0
10531;-1;185;0;0;0;0;.00nan;0;0
10531;202914;214;75;31;2;29;.935;3600000;0
10623;196571;177;0;0;0;0;.00nan;0;0
10623;-1;178;43;38;6;32;.842;3246000;0
10623;-1;178;49;1;0;1;1.000;354000;0
10623;-1;177;91;34;2;32;.941;3600000;0
10640;190164;4959;68;33;3;30;.909;3600000;0
10640;206833;4864;79;30;2;28;.933;3600000;0
10640;202801;4864;0;0;0;0;.00nan;0;0
10640;-1;4959;0;0;0;0;.00nan;0;0
10526;211080;229;0;0;0;0;.00nan;0;0
10526;180377;228;0;0;0;0;.00nan;0;0
10526;208044;228;90;33;1;32;.970;3600000;0
10526;-1;229;69;34;3;31;.912;3577000;0
10619;215240;231;0;0;0;0;.00nan;0;0
10619;189773;231;90;16;0;16;1.000;3600000;0
10619;217269;223;81;54;5;49;.907;3600000;0
10619;217312;223;0;0;0;0;.00nan;0;0
10535;213803;230;98;28;0;28;1.000;3900000;0
10535;187689;230;0;0;0;0;.00nan;0;0
10535;200452;221;0;0;0;0;.00nan;0;0
10535;-1;221;96;29;0;29;1.000;3900000;0
10614;192915;179;86;36;3;33;.917;3600000;0
10614;187355;179;0;0;0;0;.00nan;0;0
10614;197672;210;49;25;4;21;.840;3600000;0
10614;-1;210;0;0;0;0;.00nan;0;0
10607;204676;192;0;0;0;0;.00nan;0;0
10607;200333;194;0;0;0;0;.00nan;0;0
10607;196352;194;94;49;3;46;.939;3600000;0
10607;207398;192;64;23;2;21;.913;3600000;0
10557;212050;218;0;0;0;0;.00nan;0;0
10557;208051;218;78;36;2;34;.944;3900000;0
10557;-1;212;0;0;0;0;.00nan;0;0
10557;-1;212;85;39;2;37;.949;3900000;0
10562;205788;207;48;39;4;35;.897;3900000;0
10562;196283;206;0;0;0;0;.00nan;0;0
10562;197853;207;0;0;0;0;.00nan;0;0
10562;202998;206;57;30;4;26;.867;3900000;0
10663;188977;215;0;0;0;0;.00nan;0;0
10663;210794;215;64;33;3;30;.909;3574000;0
10663;191063;211;0;0;0;0;.00nan;0;0
10663;-1;211;87;38;2;36;.947;3600000;0
10438;192862;187;63;22;2;20;.909;3600000;0
10438;199416;191;50;21;4;17;.810;3541000;0
10438;201892;191;0;0;0;0;.00nan;0;0
10438;-1;187;0;0;0;0;.00nan;0;0
10462;192939;208;0;0;0;0;.00nan;0;0
10462;201524;205;0;0;0;0;.00nan;0;0
10462;-1;208;55;33;4;29;.879;3600000;0
10462;-1;205;63;44;6;38;.864;3548000;0
10475;183695;232;69;30;2;28;.933;3600000;0
10475;195363;222;0;0;0;0;.00nan;0;0
10475;213560;222;53;28;4;24;.857;3516000;0
10475;-1;232;0;0;0;0;.00nan;0;0
10632;201718;217;0;0;0;0;.00nan;0;0
10632;196296;219;0;0;0;0;.00nan;0;0
10632;218658;219;57;25;3;22;.880;3600000;0
10632;-1;217;54;36;4;32;.889;3544000;0
10667;212143;198;0;0;0;0;.00nan;0;0
10667;212649;198;51;28;4;24;.857;3644000;0
10667;191118;196;36;24;5;19;.792;3644000;0
10667;202830;196;0;0;0;0;.00nan;0;0
10786;201525;203;96;37;1;36;.973;3600000;0
10786;206772;203;0;0;0;0;.00nan;0;0
10786;-1;199;0;0;0;0;.00nan;0;0
10786;-1;199;76;28;2;26;.929;3545000;0
10644;198149;188;70;44;5;39;.886;3600000;0
10644;200333;194;37;36;6;30;.833;3600000;0
10644;184409;188;0;0;0;0;.00nan;0;0
10644;196352;194;0;0;0;0;.00nan;0;0
10470;192939;208;42;28;5;23;.821;3600000;0
10470;201524;205;44;39;6;33;.846;3547000;0
10470;-1;208;0;0;0;0;.00nan;0;0
10470;-1;205;0;0;0;0;.00nan;0;0
10488;192862;187;0;0;0;0;.00nan;0;0
10488;210504;193;89;34;1;33;.971;3600000;0
10488;218059;193;0;0;0;0;.00nan;0;0
10488;-1;187;37;21;4;17;.810;3600000;0
10683;188977;215;0;0;0;0;.00nan;0;0
10683;210794;215;86;41;3;38;.927;3600000;0
10683;216313;180;68;28;2;26;.929;3600000;0
10683;208383;180;0;0;0;0;.00nan;0;0
10578;195118;197;0;0;0;0;.00nan;0;0
10578;206822;197;86;39;2;37;.949;3600000;0
10578;-1;190;88;40;3;37;.925;3553000;0
10578;-1;190;0;0;0;0;.00nan;0;0
10569;196296;219;72;21;1;20;.952;3600000;0
10569;218658;219;0;0;0;0;.00nan;0;0
10569;-1;212;74;38;3;35;.921;3576000;0
10569;-1;212;0;0;0;0;.00nan;0;0
10500;190164;4959;0;0;0;0;.00nan;0;0
10500;-1;209;99;31;1;30;.968;3600000;0
10500;-1;4959;25;20;5;15;.750;3600000;0
10500;213590;209;0;0;0;0;.00nan;0;0
10564;206833;4864;0;0;0;0;.00nan;0;0
10564;202801;4864;83;41;2;39;.951;3900000;0
10564;-1;2620;0;0;0;0;.00nan;0;0
10564;213550;2620;78;31;2;29;.935;3900000;0
10528;215240;231;0;0;0;0;.00nan;0;0
10528;189773;231;50;15;2;13;.867;3600000;0
10528;211080;229;39;32;6;26;.813;2562000;0
10528;-1;229;79;24;1;23;.958;1038000;0
10559;213803;230;83;24;1;23;.958;3900000;0
10559;187689;230;0;0;0;0;.00nan;0;0
10559;201514;227;0;0;0;0;.00nan;0;0
10559;213280;227;96;42;1;41;.976;3900000;0
10523;201495;213;0;0;0;0;.00nan;0;0
10523;217198;213;100;27;0;27;1.000;3600000;0
10523;-1;178;0;0;0;0;.00nan;0;0
10523;-1;178;54;33;4;29;.879;3600000;0
10935;205681;226;0;0;0;0;.00nan;0;0
10935;-1;226;57;21;2;19;.905;3600000;0
10935;203087;204;0;0;0;0;.00nan;0;0
10935;203120;204;91;41;3;38;.927;3600000;0
11435;183695;232;0;0;0;0;.00nan;0;0
11435;206971;4960;72;21;2;19;.905;3545000;0
11435;212304;4960;0;0;0;0;.00nan;0;0
11435;-1;232;100;48;1;47;.979;3600000;0
10751;182014;214;0;0;0;0;.00nan;0;0
10751;185810;182;59;23;3;20;.870;3600000;0
10751;202914;214;61;38;4;34;.895;3600000;0
10751;213498;182;0;0;0;0;.00nan;0;0
10707;215703;195;0;0;0;0;.00nan;0;0
10707;207061;195;89;20;0;20;1.000;3600000;0
10707;191118;196;53;44;6;38;.864;3600000;0
10707;202830;196;0;0;0;0;.00nan;0;0
10679;200437;201;69;31;3;28;.903;3600000;0
10679;201525;203;0;0;0;0;.00nan;0;0
10679;206772;203;86;39;2;37;.949;3600000;0
10679;208048;201;0;0;0;0;.00nan;0;0
10481;200444;224;70;15;1;14;.933;3600000;0
10481;180377;228;76;45;4;41;.911;3600000;0
10481;208044;228;0;0;0;0;.00nan;0;0
10481;208372;224;0;0;0;0;.00nan;0;0
10469;200452;221;0;0;0;0;.00nan;0;0
10469;206800;225;0;0;0;0;.00nan;0;0
10469;-1;225;73;30;2;28;.933;3600000;0
10469;-1;221;27;25;5;20;.800;3600000;0
10393;205769;200;0;0;0;0;.00nan;0;0
10393;201560;202;92;38;1;37;.974;3900000;0
10393;212002;200;64;16;1;15;.938;3900000;0
10393;208067;202;0;0;0;0;.00nan;0;0
10477;198172;181;0;0;0;0;.00nan;0;0
10477;216001;181;78;35;3;32;.914;3600000;0
10477;196088;185;76;36;4;32;.889;3571000;0
10477;-1;185;0;0;0;0;.00nan;0;0
10653;194950;1505;0;0;0;0;.00nan;0;0
10653;212814;1505;59;12;1;11;.917;3600000;0
10653;213399;216;0;0;0;0;.00nan;0;0
10653;-1;216;90;52;3;49;.942;3586000;0
10589;209840;184;0;0;0;0;.00nan;0;0
10589;205837;184;37;26;5;21;.808;3600000;0
10589;211017;220;91;34;1;33;.971;3600000;0
10589;218510;220;0;0;0;0;.00nan;0;0
10610;199416;191;0;0;0;0;.00nan;0;0
10610;204676;192;0;0;0;0;.00nan;0;0
10610;201892;191;80;38;3;35;.921;3554000;0
10610;207398;192;63;22;2;20;.909;3600000;0
10615;192915;179;0;0;0;0;.00nan;0;0
10615;187355;179;95;40;3;37;.925;3900000;0
10615;-1;4949;48;24;3;21;.875;3900000;0
10615;-1;4949;0;0;0;0;.00nan;0;0
10491;201718;217;71;39;3;36;.923;3600000;0
10491;191130;186;0;0;0;0;.00nan;0;0
10491;213507;186;50;28;4;24;.857;3576000;0
10491;-1;217;0;0;0;0;.00nan;0;0
10693;196571;177;0;0;0;0;.00nan;0;0
10693;213399;216;68;36;4;32;.889;3900000;0
10693;-1;216;0;0;0;0;.00nan;0;0
10693;-1;177;65;30;4;26;.867;3900000;0
10646;198149;188;0;0;0;0;.00nan;0;0
10646;204676;192;100;30;0;30;1.000;3600000;0
10646;184409;188;58;31;3;28;.903;3600000;0
10646;207398;192;0;0;0;0;.00nan;0;0
10504;205769;200;77;31;2;29;.935;3600000;0
10504;201524;205;0;0;0;0;.00nan;0;0
10504;212002;200;0;0;0;0;.00nan;0;0
10504;-1;205;52;24;3;21;.875;3571000;0
10657;192915;179;19;30;7;23;.767;2728000;0
10657;194950;1505;57;15;1;14;.933;3600000;0
10657;212814;1505;0;0;0;0;.00nan;0;0
10657;187355;179;63;11;0;11;1.000;872000;0
10601;201495;213;36;6;2;4;.667;377000;0
10601;217198;213;49;47;6;41;.872;3223000;0
10601;197672;210;0;0;0;0;.00nan;0;0
10601;-1;210;55;29;4;25;.862;3600000;0
10476;192862;187;37;22;5;17;.773;3600000;0
10476;210504;193;83;30;2;28;.933;3600000;0
10476;218059;193;0;0;0;0;.00nan;0;0
10476;-1;187;0;0;0;0;.00nan;0;0
11437;206801;176;52;25;4;21;.840;2373000;0
11437;-1;209;0;0;0;0;.00nan;0;0
11437;213533;176;54;4;0;4;1.000;1164000;0
11437;213590;209;73;28;2;26;.929;3600000;0
10609;183695;232;98;43;2;41;.953;3600000;0
10609;217269;223;0;0;0;0;.00nan;0;0
10609;217312;223;60;30;3;27;.900;3600000;0
10609;-1;232;0;0;0;0;.00nan;0;0
10478;201560;202;0;0;0;0;.00nan;0;0
10478;196283;206;0;0;0;0;.00nan;0;0
10478;208067;202;87;21;0;21;1.000;3600000;0
10478;202998;206;96;41;1;40;.976;3555000;0
10563;182014;214;68;37;4;33;.892;3633000;0
10563;202914;214;0;0;0;0;.00nan;0;0
10563;-1;1371;59;29;3;26;.897;3633000;0
10563;-1;1371;0;0;0;0;.00nan;0;0
10550;201718;217;0;0;0;0;.00nan;0;0
10550;191130;186;72;24;1;23;.958;3600000;0
10550;213507;186;0;0;0;0;.00nan;0;0
10550;-1;217;64;24;2;22;.917;3596000;0
11641;188977;215;83;38;3;35;.921;3797000;0
11641;210794;215;0;0;0;0;.00nan;0;0
11641;196296;219;0;0;0;0;.00nan;0;0
11641;218658;219;73;30;2;28;.933;3797000;0
10600;195118;197;0;0;0;0;.00nan;0;0
10600;206822;197;88;28;1;27;.964;3600000;0
10600;212143;198;49;23;3;20;.870;3526000;0
10600;212649;198;0;0;0;0;.00nan;0;0
11520;213803;230;92;36;1;35;.972;3900000;0
11520;187689;230;0;0;0;0;.00nan;0;0
11520;206971;4960;64;18;1;17;.944;3900000;0
11520;212304;4960;0;0;0;0;.00nan;0;0
10597;190164;4959;98;43;2;41;.953;3575000;0
10597;-1;4959;0;0;0;0;.00nan;0;0
10597;-1;2620;100;37;0;37;1.000;3600000;0
10597;213550;2620;0;0;0;0;.00nan;0;0
10522;209840;184;45;17;3;14;.824;3600000;0
10522;205837;184;0;0;0;0;.00nan;0;0
10522;185810;182;0;0;0;0;.00nan;0;0
10522;213498;182;67;42;4;38;.905;3547000;0
10723;216313;180;0;0;0;0;.00nan;0;0
10723;191063;211;91;35;2;33;.943;3600000;0
10723;-1;211;0;0;0;0;.00nan;0;0
10723;208383;180;53;31;4;27;.871;3531000;0
10899;205681;226;46;22;4;18;.818;3900000;0
10899;-1;226;0;0;0;0;.00nan;0;0
10899;-1;199;24;5;3;2;.400;279000;0
10899;-1;199;96;43;1;42;.977;3621000;0
11571;200333;194;0;0;0;0;.00nan;0;0
11571;196352;194;77;34;3;31;.912;3560000;0
11571;191118;196;69;27;2;25;.926;3600000;0
11571;202830;196;0;0;0;0;.00nan;0;0
10631;211942;183;0;0;0;0;.00nan;0;0
10631;196237;183;66;17;2;15;.882;3600000;0
10631;-1;178;94;49;3;46;.939;3546000;0
10631;-1;178;0;0;0;0;.00nan;0;0
11554;210504;193;0;0;0;0;.00nan;0;0
11554;212143;198;0;0;0;0;.00nan;0;0
11554;212649;198;87;32;1;31;.969;3600000;0
11554;218059;193;28;23;5;18;.783;3600000;0
11611;211942;183;72;37;3;34;.919;3600000;0
11611;196237;183;0;0;0;0;.00nan;0;0
11611;-1;4949;78;27;2;25;.926;3600000;0
11611;-1;4949;0;0;0;0;.00nan;0;0
10830;212050;218;0;0;0;0;.00nan;0;0
10830;191063;211;98;35;1;34;.971;2400000;0
10830;208051;218;100;29;0;29;1.000;3600000;0
10830;-1;211;17;16;5;11;.688;1200000;0
11614;180377;228;54;27;4;23;.852;3528000;0
11614;217269;223;86;44;2;42;.955;3600000;0
11614;217312;223;0;0;0;0;.00nan;0;0
11614;208044;228;0;0;0;0;.00nan;0;0
10558;200437;201;60;32;4;28;.875;3533000;0
10558;208048;201;0;0;0;0;.00nan;0;0
10558;203087;204;0;0;0;0;.00nan;0;0
10558;203120;204;81;27;2;25;.926;3600000;0
10514;199416;191;0;0;0;0;.00nan;0;0
10514;201892;191;83;27;1;26;.963;3600000;0
10514;-1;189;71;40;5;35;.875;3600000;0
10514;-1;189;0;0;0;0;.00nan;0;0
11657;201524;205;67;16;1;15;.938;3600000;0
11657;-1;199;91;41;2;39;.951;3600000;0
11657;-1;199;0;0;0;0;.00nan;0;0
11657;-1;205;0;0;0;0;.00nan;0;0
10485;195363;222;67;31;3;28;.903;3646000;0
10485;201514;227;0;0;0;0;.00nan;0;0
10485;213280;227;64;35;4;31;.886;3646000;0
10485;213560;222;0;0;0;0;.00nan;0;0
10495;192939;208;0;0;0;0;.00nan;0;0
10495;196283;206;55;38;5;33;.868;2256000;0
10495;-1;208;48;18;3;15;.833;3600000;0
10495;202998;206;68;16;1;15;.938;1344000;0
10686;198172;181;0;0;0;0;.00nan;0;0
10686;216001;181;62;22;2;20;.909;3600000;0
10686;211017;220;92;50;3;47;.940;3549000;0
10686;218510;220;0;0;0;0;.00nan;0;0
11637;216313;180;76;49;5;44;.898;3600000;0
11637;208383;180;0;0;0;0;.00nan;0;0
11637;-1;212;64;21;2;19;.905;3600000;0
11637;-1;212;0;0;0;0;.00nan;0;0
10685;194950;1505;71;24;2;22;.917;3600000;0
10685;212814;1505;0;0;0;0;.00nan;0;0
10685;197672;210;0;0;0;0;.00nan;0;0
10685;-1;210;47;30;4;26;.867;3566000;0
10622;209840;184;0;0;0;0;.00nan;0;0
10622;205837;184;48;20;3;17;.850;3567000;0
10622;-1;1371;0;0;0;0;.00nan;0;0
10622;-1;1371;76;36;2;34;.944;3600000;0
10487;205788;207;0;0;0;0;.00nan;0;0
10487;201560;202;0;0;0;0;.00nan;0;0
10487;208067;202;33;35;6;29;.829;3600000;0
10487;197853;207;83;29;1;28;.966;3600000;0
10729;200333;194;0;0;0;0;.00nan;0;0
10729;196352;194;83;35;2;33;.943;3564000;0
10729;-1;189;0;0;0;0;.00nan;0;0
10729;-1;189;99;28;0;28;1.000;3600000;0
10586;201514;227;66;27;3;24;.889;3573000;0
10586;206800;225;0;0;0;0;.00nan;0;0
10586;-1;225;73;21;1;20;.952;3600000;0
10586;213280;227;0;0;0;0;.00nan;0;0
11625;196088;185;76;37;3;34;.919;3555000;0
11625;185810;182;79;34;2;32;.941;3600000;0
11625;-1;185;0;0;0;0;.00nan;0;0
11625;213498;182;0;0;0;0;.00nan;0;0
10694;215240;231;0;0;0;0;.00nan;0;0
10694;189773;231;66;32;3;29;.906;3600000;0
10694;206971;4960;52;41;5;36;.878;3513000;0
10694;212304;4960;0;0;0;0;.00nan;0;0
10814;188977;215;0;0;0;0;.00nan;0;0
10814;210794;215;94;41;3;38;.927;3600000;0
10814;212050;218;0;0;0;0;.00nan;0;0
10814;208051;218;55;31;4;27;.871;3548000;0
10490;192862;187;66;21;2;19;.905;3600000;0
10490;212143;198;85;40;3;37;.925;3600000;0
10490;212649;198;0;0;0;0;.00nan;0;0
10490;-1;187;0;0;0;0;.00nan;0;0
10541;200444;224;100;18;0;18;1.000;3600000;0
10541;217269;223;0;0;0;0;.00nan;0;0
10541;217312;223;70;38;3;35;.921;3600000;0
10541;208372;224;0;0;0;0;.00nan;0;0
10548;183695;232;50;9;1;8;.889;783000;0
10548;211080;229;90;47;3;44;.936;3600000;0
10548;-1;232;43;35;6;29;.829;2817000;0
10548;-1;229;0;0;0;0;.00nan;0;0
10762;194950;1505;0;0;0;0;.00nan;0;0
10762;212814;1505;80;35;2;33;.943;3600000;0
10762;-1;4949;0;0;0;0;.00nan;0;0
10762;-1;4949;88;49;3;46;.939;3553000;0
10556;191130;186;0;0;0;0;.00nan;0;0
10556;213507;186;99;36;1;35;.972;3600000;0
10556;-1;212;0;0;0;0;.00nan;0;0
10556;-1;212;67;25;2;23;.920;3547000;0
10779;201524;205;0;0;0;0;.00nan;0;0
10779;201525;203;42;32;5;27;.844;3530000;0
10779;206772;203;0;0;0;0;.00nan;0;0
10779;-1;205;71;35;3;32;.914;3600000;0
10608;190164;4959;0;0;0;0;.00nan;0;0
10608;-1;4959;86;52;4;48;.923;3600000;0
10608;-1;2620;0;0;0;0;.00nan;0;0
10608;213550;2620;65;38;5;33;.868;3559000;0
10782;191118;196;73;48;4;44;.917;3558000;0
10782;-1;190;74;28;2;26;.929;3600000;0
10782;202830;196;0;0;0;0;.00nan;0;0
10782;-1;190;0;0;0;0;.00nan;0;0
10677;196571;177;61;37;4;33;.892;3600000;0
10677;197672;210;0;0;0;0;.00nan;0;0
10677;-1;210;97;25;0;25;1.000;3600000;0
10677;-1;177;0;0;0;0;.00nan;0;0
10592;206801;176;49;34;5;29;.853;3570000;0
10592;-1;209;87;37;3;34;.919;3600000;0
10592;213533;176;0;0;0;0;.00nan;0;0
10592;213590;209;0;0;0;0;.00nan;0;0
10692;204676;192;53;33;4;29;.879;3519000;0
10692;215703;195;0;0;0;0;.00nan;0;0
10692;207061;195;91;37;2;35;.946;3600000;0
10692;207398;192;0;0;0;0;.00nan;0;0
10690;205788;207;43;22;4;18;.818;3573000;0
10690;197853;207;0;0;0;0;.00nan;0;0
10690;203087;204;84;37;3;34;.919;3600000;0
10690;203120;204;0;0;0;0;.00nan;0;0
10703;199416;191;0;0;0;0;.00nan;0;0
10703;210504;193;84;31;2;29;.935;3600000;0
10703;201892;191;68;20;1;19;.950;3600000;0
10703;218059;193;0;0;0;0;.00nan;0;0
10651;206800;225;0;0;0;0;.00nan;0;0
10651;180377;228;25;32;6;26;.813;3553000;0
10651;-1;225;70;36;4;32;.889;3600000;0
10651;208044;228;0;0;0;0;.00nan;0;0
10652;209840;184;91;35;2;33;.943;3600000;0
10652;205837;184;0;0;0;0;.00nan;0;0
10652;-1;1371;77;45;4;41;.911;3516000;0
10652;-1;1371;0;0;0;0;.00nan;0;0
10496;195363;222;0;0;0;0;.00nan;0;0
10496;206971;4960;61;23;3;20;.870;3600000;0
10496;212304;4960;0;0;0;0;.00nan;0;0
10496;213560;222;71;45;4;41;.911;3557000;0
10511;205769;200;0;0;0;0;.00nan;0;0
10511;212002;200;47;20;3;17;.850;3600000;0
10511;-1;199;0;0;0;0;.00nan;0;0
10511;-1;199;85;49;4;45;.918;3581000;0
10627;201495;213;0;0;0;0;.00nan;0;0
10627;217198;213;77;40;3;37;.925;3563000;0
10627;213399;216;68;19;1;18;.947;3600000;0
10627;-1;216;0;0;0;0;.00nan;0;0
10662;196296;219;64;22;2;20;.909;3600000;0
10662;191063;211;0;0;0;0;.00nan;0;0
10662;-1;211;91;41;3;38;.927;3583000;0
10662;218658;219;0;0;0;0;.00nan;0;0
10497;195363;222;75;27;2;25;.926;3600000;0
10497;201514;227;0;0;0;0;.00nan;0;0
10497;213280;227;69;37;4;33;.892;3600000;0
10497;213560;222;0;0;0;0;.00nan;0;0
11618;196571;177;0;0;0;0;.00nan;0;0
11618;-1;4949;58;31;3;28;.903;3543000;0
11618;-1;4949;0;0;0;0;.00nan;0;0
11618;-1;177;74;24;1;23;.958;3600000;0
10517;192862;187;0;0;0;0;.00nan;0;0
10517;204676;192;0;0;0;0;.00nan;0;0
10517;207398;192;91;34;3;31;.912;3573000;0
10517;-1;187;95;38;2;36;.947;3600000;0
10974;216313;180;64;18;1;17;.944;3900000;0
10974;191063;211;87;26;1;25;.962;3900000;0
10974;-1;211;0;0;0;0;.00nan;0;0
10974;208383;180;0;0;0;0;.00nan;0;0
10507;205681;226;0;0;0;0;.00nan;0;0
10507;205769;200;67;33;4;29;.879;3555000;0
10507;212002;200;0;0;0;0;.00nan;0;0
10507;-1;226;73;31;2;29;.935;3600000;0
10551;196088;185;100;38;0;38;1.000;3600000;0
10551;182014;214;0;0;0;0;.00nan;0;0
10551;-1;185;0;0;0;0;.00nan;0;0
10551;202914;214;73;31;2;29;.935;3566000;0
10624;198149;188;0;0;0;0;.00nan;0;0
10624;199416;191;46;24;4;20;.833;3795000;0
10624;184409;188;91;46;3;43;.935;3795000;0
10624;201892;191;0;0;0;0;.00nan;0;0
10743;212143;198;0;0;0;0;.00nan;0;0
10743;212649;198;86;20;0;20;1.000;3600000;0
10743;-1;189;0;0;0;0;.00nan;0;0
10743;-1;189;54;23;3;20;.870;3600000;0
10543;192939;208;0;0;0;0;.00nan;0;0
10543;-1;199;36;43;7;36;.837;3035000;0
10543;-1;208;79;22;1;21;.955;3600000;0
10543;-1;199;64;9;0;9;1.000;565000;0
10546;201525;203;0;0;0;0;.00nan;0;0
10546;206772;203;98;36;1;35;.972;3600000;0
10546;196283;206;0;0;0;0;.00nan;0;0
10546;202998;206;65;23;2;21;.913;3596000;0
10706;188977;215;0;0;0;0;.00nan;0;0
10706;210794;215;61;47;5;42;.894;3573000;0
10706;191130;186;64;27;3;24;.889;3600000;0
10706;213507;186;0;0;0;0;.00nan;0;0
10641;211017;220;87;55;5;50;.909;3600000;0
10641;185810;182;89;26;1;25;.962;3600000;0
10641;218510;220;0;0;0;0;.00nan;0;0
10641;213498;182;0;0;0;0;.00nan;0;0
10741;206801;176;0;0;0;0;.00nan;0;0
10741;206833;4864;76;18;1;17;.944;3600000;0
10741;202801;4864;0;0;0;0;.00nan;0;0
10741;213533;176;55;42;5;37;.881;3600000;0
10704;212050;218;57;30;3;27;.900;3542000;0
10704;196296;219;0;0;0;0;.00nan;0;0
10704;208051;218;0;0;0;0;.00nan;0;0
10704;218658;219;74;28;2;26;.929;3600000;0
10602;190164;4959;99;40;1;39;.975;3600000;0
10602;-1;209;0;0;0;0;.00nan;0;0
10602;-1;4959;0;0;0;0;.00nan;0;0
10602;213590;209;67;24;2;22;.917;3563000;0
10676;200333;194;0;0;0;0;.00nan;0;0
10676;196352;194;57;24;3;21;.875;3575000;0
10676;-1;190;78;33;2;31;.939;3600000;0
10676;-1;190;0;0;0;0;.00nan;0;0
10736;215240;231;0;0;0;0;.00nan;0;0
10736;189773;231;52;24;3;21;.875;3600000;0
10736;180377;228;0;0;0;0;.00nan;0;0
10736;208044;228;85;49;4;45;.918;3600000;0
10572;200437;201;81;27;1;26;.963;3550000;0
10572;216114;202;0;0;0;0;.00nan;0;0
10572;201560;202;100;27;0;27;1.000;3600000;0
10572;208048;201;0;0;0;0;.00nan;0;0
10570;200452;221;71;18;1;17;.944;3600000;0
10570;211080;229;91;46;2;44;.957;3552000;0
10570;-1;221;0;0;0;0;.00nan;0;0
10570;-1;229;0;0;0;0;.00nan;0;0
10673;201524;205;0;0;0;0;.00nan;0;0
10673;-1;205;99;43;1;42;.977;3600000;0
10673;203087;204;0;0;0;0;.00nan;0;0
10673;203120;204;24;33;7;26;.788;3600000;0
10658;192915;179;0;0;0;0;.00nan;0;0
10658;187355;179;63;17;2;15;.882;3900000;0
10658;213399;216;0;0;0;0;.00nan;0;0
10658;-1;216;76;25;2;23;.920;3900000;0
10654;201495;213;46;44;7;37;.841;3600000;0
10654;217198;213;0;0;0;0;.00nan;0;0
10654;-1;178;0;0;0;0;.00nan;0;0
10654;-1;178;45;19;3;16;.842;3600000;0
10978;183695;232;0;0;0;0;.00nan;0;0
10978;206800;225;0;0;0;0;.00nan;0;0
10978;-1;225;72;19;1;18;.947;3600000;0
10978;-1;232;68;34;3;31;.912;3535000;0
10616;201718;217;0;0;0;0;.00nan;0;0
10616;-1;217;59;36;4;32;.889;3524000;0
10616;-1;212;77;30;2;28;.933;3600000;0
10616;-1;212;0;0;0;0;.00nan;0;0
10822;215703;195;0;0;0;0;.00nan;0;0
10822;207061;195;66;12;1;11;.917;3600000;0
10822;-1;189;65;55;6;49;.891;3600000;0
10822;-1;189;0;0;0;0;.00nan;0;0
10716;198172;181;0;0;0;0;.00nan;0;0
10716;216001;181;62;23;3;20;.870;3600000;0
10716;-1;1371;0;0;0;0;.00nan;0;0
10716;-1;1371;56;47;6;41;.872;3600000;0
10669;209840;184;0;0;0;0;.00nan;0;0
10669;205837;184;100;21;0;21;1.000;3900000;0
10669;182014;214;97;32;0;32;1.000;3900000;0
10669;202914;214;0;0;0;0;.00nan;0;0
10701;211017;220;0;0;0;0;.00nan;0;0
10701;185810;182;0;0;0;0;.00nan;0;0
10701;218510;220;100;30;0;30;1.000;3600000;0
10701;213498;182;84;31;2;29;.935;3549000;0
10738;205788;207;0;0;0;0;.00nan;0;0
10738;201524;205;0;0;0;0;.00nan;0;0
10738;197853;207;59;25;2;23;.920;3543000;0
10738;-1;205;100;49;1;48;.980;3600000;0
10612;201495;213;0;0;0;0;.00nan;0;0
10612;217198;213;78;36;3;33;.917;3573000;0
10612;196571;177;78;31;2;29;.935;3600000;0
10612;-1;177;0;0;0;0;.00nan;0;0
10636;180377;228;27;25;5;20;.800;3600000;0
10636;217269;223;0;0;0;0;.00nan;0;0
10636;217312;223;98;35;1;34;.971;3600000;0
10636;208044;228;0;0;0;0;.00nan;0;0
10682;211942;183;62;18;2;16;.889;3600000;0
10682;196237;183;0;0;0;0;.00nan;0;0
10682;213399;216;0;0;0;0;.00nan;0;0
10682;-1;216;60;39;5;34;.872;3600000;0
10678;192915;179;69;36;4;32;.889;3736000;0
10678;194950;1505;0;0;0;0;.00nan;0;0
10678;212814;1505;61;26;3;23;.885;3736000;0
10678;187355;179;0;0;0;0;.00nan;0;0
11538;199416;191;0;0;0;0;.00nan;0;0
11538;195118;197;0;0;0;0;.00nan;0;0
11538;206822;197;71;46;5;41;.891;3531000;0
11538;201892;191;69;31;3;28;.903;3600000;0
10689;204676;192;0;0;0;0;.00nan;0;0
10689;212143;198;0;0;0;0;.00nan;0;0
10689;212649;198;63;39;5;34;.872;3600000;0
10689;207398;192;69;28;2;26;.929;3600000;0
10499;200452;221;70;17;1;16;.941;3600000;0
10499;195363;222;0;0;0;0;.00nan;0;0
10499;213560;222;74;41;3;38;.927;3544000;0
10499;-1;221;0;0;0;0;.00nan;0;0
10705;212050;218;0;0;0;0;.00nan;0;0
10705;196296;219;0;0;0;0;.00nan;0;0
10705;208051;218;66;36;4;32;.889;3587000;0
10705;218658;219;79;31;2;29;.935;3600000;0
11128;216313;180;54;24;3;21;.875;3600000;0
11128;201718;217;26;27;6;21;.778;3057000;0
11128;-1;217;41;2;1;1;.500;543000;0
11128;208383;180;0;0;0;0;.00nan;0;0
10733;198149;188;0;0;0;0;.00nan;0;0
10733;184409;188;79;43;4;39;.907;3845000;0
10733;191118;196;73;31;3;28;.903;3845000;0
10733;202830;196;0;0;0;0;.00nan;0;0
10715;191063;211;61;33;4;29;.879;3541000;0
10715;191130;186;0;0;0;0;.00nan;0;0
10715;-1;211;0;0;0;0;.00nan;0;0
10715;213507;186;51;22;3;19;.864;3600000;0
11660;188977;215;0;0;0;0;.00nan;0;0
11660;210794;215;68;38;3;35;.921;3556000;0
11660;-1;212;0;0;0;0;.00nan;0;0
11660;-1;212;82;31;2;29;.935;3600000;0
11670;201525;203;33;30;5;25;.833;3553000;0
11670;206772;203;0;0;0;0;.00nan;0;0
11670;-1;199;0;0;0;0;.00nan;0;0
11670;-1;199;80;32;3;29;.906;3600000;0
10892;206800;225;0;0;0;0;.00nan;0;0
10892;206971;4960;46;16;3;13;.813;3600000;0
10892;212304;4960;0;0;0;0;.00nan;0;0
10892;-1;225;83;44;4;40;.909;3552000;0
10519;200437;201;94;30;2;28;.933;3600000;0
10519;205769;200;0;0;0;0;.00nan;0;0
10519;212002;200;81;40;3;37;.925;3592000;0
10519;208048;201;0;0;0;0;.00nan;0;0
10752;213803;230;99;39;2;37;.949;3900000;0
10752;187689;230;0;0;0;0;.00nan;0;0
10752;183695;232;81;37;2;35;.946;3900000;0
10752;-1;232;0;0;0;0;.00nan;0;0
10542;192939;208;69;25;1;24;.960;3600000;0
10542;205681;226;0;0;0;0;.00nan;0;0
10542;-1;226;62;30;3;27;.900;3551000;0
10542;-1;208;0;0;0;0;.00nan;0;0
11116;198172;181;48;32;5;27;.844;3600000;0
11116;216001;181;0;0;0;0;.00nan;0;0
11116;196088;185;47;36;6;30;.833;3585000;0
11116;-1;185;0;0;0;0;.00nan;0;0
10675;206801;176;70;40;4;36;.900;3600000;0
10675;206833;4864;0;0;0;0;.00nan;0;0
10675;202801;4864;80;21;2;19;.905;3600000;0
10675;213533;176;0;0;0;0;.00nan;0;0
10593;200444;224;69;26;2;24;.923;3592000;0
10593;201514;227;99;43;1;42;.977;3600000;0
10593;213280;227;0;0;0;0;.00nan;0;0
10593;208372;224;0;0;0;0;.00nan;0;0
10774;-1;178;0;0;0;0;.00nan;0;0
10774;-1;4949;66;29;3;26;.897;3600000;0
10774;-1;4949;0;0;0;0;.00nan;0;0
10774;-1;178;83;46;4;42;.913;3600000;0
10635;190164;4959;0;0;0;0;.00nan;0;0
10635;-1;4959;57;50;6;44;.880;3538000;0
10635;-1;2620;57;26;4;22;.846;3600000;0
10635;213550;2620;0;0;0;0;.00nan;0;0
10769;200333;194;96;36;1;35;.972;3600000;0
10769;210504;193;65;28;2;26;.929;3584000;0
10769;196352;194;0;0;0;0;.00nan;0;0
10769;218059;193;0;0;0;0;.00nan;0;0
10666;211080;229;61;16;1;15;.938;3600000;0
10666;217269;223;75;36;3;33;.917;3539000;0
10666;217312;223;0;0;0;0;.00nan;0;0
10666;-1;229;0;0;0;0;.00nan;0;0
10650;201514;227;0;0;0;0;.00nan;0;0
10650;206971;4960;78;15;0;15;1.000;3600000;0
10650;212304;4960;0;0;0;0;.00nan;0;0
10650;213280;227;90;66;5;61;.924;3600000;0
10672;206833;4864;61;22;2;20;.909;3600000;0
10672;202801;4864;0;0;0;0;.00nan;0;0
10672;-1;2620;0;0;0;0;.00nan;0;0
10672;213550;2620;32;29;5;24;.828;3600000;0
10810;185810;182;62;34;4;30;.882;3517000;0
10810;-1;1371;71;26;2;24;.923;3600000;0
10810;213498;182;0;0;0;0;.00nan;0;0
10810;-1;1371;0;0;0;0;.00nan;0;0
10746;196571;177;0;0;0;0;.00nan;0;0
10746;197672;210;0;0;0;0;.00nan;0;0
10746;-1;210;84;36;2;34;.944;3845000;0
10746;-1;177;98;32;1;31;.969;3845000;0
10596;205681;226;0;0;0;0;.00nan;0;0
10596;216114;202;0;0;0;0;.00nan;0;0
10596;201560;202;73;28;2;26;.929;3590000;0
10596;-1;226;70;20;1;19;.950;3600000;0
10590;205788;207;69;23;2;21;.913;3794000;0
10590;196283;206;0;0;0;0;.00nan;0;0
10590;197853;207;0;0;0;0;.00nan;0;0
10590;202998;206;90;33;1;32;.970;3794000;0
11293;213803;230;68;36;3;33;.917;3600000;0
11293;187689;230;0;0;0;0;.00nan;0;0
11293;215240;231;0;0;0;0;.00nan;0;0
11293;189773;231;28;25;5;20;.800;3588000;0
10585;192939;208;0;0;0;0;.00nan;0;0
10585;200437;201;0;0;0;0;.00nan;0;0
10585;208048;201;59;36;5;31;.861;3600000;0
10585;-1;208;48;30;4;26;.867;3600000;0
11668;205769;200;78;33;2;31;.939;3578000;0
11668;201524;205;84;13;0;13;1.000;3600000;0
11668;212002;200;0;0;0;0;.00nan;0;0
11668;-1;205;0;0;0;0;.00nan;0;0
10568;192862;187;54;28;3;25;.893;3600000;0
10568;191118;196;0;0;0;0;.00nan;0;0
10568;-1;187;0;0;0;0;.00nan;0;0
10568;202830;196;100;29;0;29;1.000;3600000;0
10577;200444;224;0;0;0;0;.00nan;0;0
10577;200452;221;0;0;0;0;.00nan;0;0
10577;208372;224;49;15;2;13;.867;3536000;0
10577;-1;221;100;32;0;32;1.000;3600000;0
11509;200333;194;0;0;0;0;.00nan;0;0
11509;195118;197;51;25;3;22;.880;3600000;0
11509;206822;197;0;0;0;0;.00nan;0;0
11509;196352;194;35;35;6;29;.829;3600000;0
11439;206801;176;0;0;0;0;.00nan;0;0
11439;-1;209;67;24;2;22;.917;3600000;0
11439;213533;176;79;40;4;36;.900;3577000;0
11439;213590;209;0;0;0;0;.00nan;0;0
10702;209840;184;0;0;0;0;.00nan;0;0
10702;205837;184;98;33;1;32;.970;3600000;0
10702;182014;214;73;37;3;34;.919;3574000;0
10702;202914;214;0;0;0;0;.00nan;0;0
10630;199416;191;99;41;1;40;.976;3600000;0
10630;215703;195;0;0;0;0;.00nan;0;0
10630;201892;191;0;0;0;0;.00nan;0;0
10630;207061;195;56;19;2;17;.895;3543000;0
10821;194950;1505;57;20;2;18;.900;3900000;0
10821;211942;183;0;0;0;0;.00nan;0;0
10821;196237;183;86;38;2;36;.947;3899000;0
10821;212814;1505;0;0;0;0;.00nan;0;0
10739;211017;220;0;0;0;0;.00nan;0;0
10739;196088;185;0;0;0;0;.00nan;0;0
10739;-1;185;84;29;1;28;.966;3900000;0
10739;218510;220;100;34;1;33;.971;3899000;0
10720;-1;189;86;34;2;32;.941;3900000;0
10720;-1;190;79;27;2;25;.926;3900000;0
10720;-1;189;0;0;0;0;.00nan;0;0
10720;-1;190;0;0;0;0;.00nan;0;0
10719;192915;179;0;0;0;0;.00nan;0;0
10719;187355;179;73;23;1;22;.957;3600000;0
10719;-1;178;0;0;0;0;.00nan;0;0
10719;-1;178;89;16;0;16;1.000;3600000;0
10745;198149;188;84;43;4;39;.907;3705000;0
10745;210504;193;55;20;3;17;.850;3705000;0
10745;184409;188;0;0;0;0;.00nan;0;0
10745;218059;193;0;0;0;0;.00nan;0;0
11659;183695;232;0;0;0;0;.00nan;0;0
11659;206800;225;0;0;0;0;.00nan;0;0
11659;-1;225;77;31;2;29;.935;3600000;0
11659;-1;232;74;34;3;31;.912;3559000;0
11546;209840;184;50;22;3;19;.864;3576000;0
11546;205837;184;0;0;0;0;.00nan;0;0
11546;-1;1371;0;0;0;0;.00nan;0;0
11546;-1;1371;87;33;2;31;.939;3600000;0
11024;216313;180;56;20;2;18;.900;3600000;0
11024;201718;217;0;0;0;0;.00nan;0;0
11024;-1;217;59;34;4;30;.882;3600000;0
11024;208383;180;0;0;0;0;.00nan;0;0
10648;201525;203;60;29;3;26;.897;3600000;0
10648;206772;203;0;0;0;0;.00nan;0;0
10648;196283;206;50;38;5;33;.868;3582000;0
10648;202998;206;0;0;0;0;.00nan;0;0
10639;216114;202;56;17;2;15;.882;3600000;0
10639;201560;202;0;0;0;0;.00nan;0;0
10639;-1;199;0;0;0;0;.00nan;0;0
10639;-1;199;72;33;4;29;.879;3556000;0
11636;211017;220;52;29;4;25;.862;3600000;0
11636;182014;214;0;0;0;0;.00nan;0;0
11636;218510;220;0;0;0;0;.00nan;0;0
11636;202914;214;38;30;5;25;.833;3578000;0
10812;-1;4949;100;32;0;32;1.000;3600000;0
10812;197672;210;57;37;5;32;.865;3600000;0
10812;-1;4949;0;0;0;0;.00nan;0;0
10812;-1;210;0;0;0;0;.00nan;0;0
10848;213803;230;52;32;4;28;.875;3600000;0
10848;187689;230;0;0;0;0;.00nan;0;0
10848;215240;231;88;23;0;23;1.000;3600000;0
10848;189773;231;0;0;0;0;.00nan;0;0
11587;216313;180;0;0;0;0;.00nan;0;0
11587;196296;219;24;12;4;8;.667;975000;0
11587;218658;219;66;21;1;20;.952;2625000;0
11587;208383;180;81;33;2;31;.939;3600000;0
11675;205681;226;0;0;0;0;.00nan;0;0
11675;205788;207;0;0;0;0;.00nan;0;0
11675;-1;226;58;19;3;16;.842;3600000;0
11675;197853;207;46;43;6;37;.860;3600000;0
11612;206833;4864;0;0;0;0;.00nan;0;0
11612;-1;209;0;0;0;0;.00nan;0;0
11612;202801;4864;29;24;5;19;.792;3577000;0
11612;213590;209;52;31;4;27;.871;3600000;0
11593;211942;183;7;13;6;7;.538;2174000;0
11593;196237;183;53;10;1;9;.900;1426000;0
11593;213399;216;85;41;3;38;.927;3600000;0
11593;-1;216;0;0;0;0;.00nan;0;0
10634;188977;215;0;0;0;0;.00nan;0;0
10634;210794;215;97;41;2;39;.951;3900000;0
10634;-1;212;77;35;2;33;.943;3900000;0
10634;-1;212;0;0;0;0;.00nan;0;0
11597;200452;221;0;0;0;0;.00nan;0;0
11597;201514;227;0;0;0;0;.00nan;0;0
11597;213280;227;76;38;3;35;.921;3600000;0
11597;-1;221;48;27;4;23;.852;3600000;0
10687;190164;4959;75;21;1;20;.952;3600000;0
10687;206801;176;71;43;4;39;.907;3600000;0
10687;-1;4959;0;0;0;0;.00nan;0;0
10687;213533;176;0;0;0;0;.00nan;0;0
10759;200333;194;0;0;0;0;.00nan;0;0
10759;212143;198;72;19;1;18;.947;3600000;0
10759;196352;194;51;37;5;32;.865;3600000;0
10759;212649;198;0;0;0;0;.00nan;0;0
10626;192939;208;86;25;1;24;.960;3600000;0
10626;-1;199;53;30;4;26;.867;1944000;0
10626;-1;208;0;0;0;0;.00nan;0;0
10626;-1;199;15;11;5;6;.545;1656000;0
10802;192915;179;70;18;1;17;.944;3600000;0
10802;187355;179;0;0;0;0;.00nan;0;0
10802;-1;178;0;0;0;0;.00nan;0;0
10802;-1;178;68;45;4;41;.911;3600000;0
10696;211080;229;68;24;2;22;.917;3600000;0
10696;180377;228;0;0;0;0;.00nan;0;0
10696;208044;228;63;29;3;26;.897;3600000;0
10696;-1;229;0;0;0;0;.00nan;0;0
10730;216114;202;0;0;0;0;.00nan;0;0
10730;201525;203;49;33;4;29;.879;3547000;0
10730;201560;202;80;36;3;33;.917;3600000;0
10730;206772;203;0;0;0;0;.00nan;0;0
10713;201495;213;0;0;0;0;.00nan;0;0
10713;211942;183;55;21;3;18;.857;3556000;0
10713;196237;183;0;0;0;0;.00nan;0;0
10713;217198;213;98;37;1;36;.973;3600000;0
10617;195363;222;13;36;9;27;.750;3600000;0
10617;206971;4960;100;26;0;26;1.000;3600000;0
10617;212304;4960;0;0;0;0;.00nan;0;0
10617;213560;222;0;0;0;0;.00nan;0;0
10816;209840;184;65;28;3;25;.893;3900000;0
10816;205837;184;0;0;0;0;.00nan;0;0
10816;211017;220;91;47;3;44;.936;3900000;0
10816;218510;220;0;0;0;0;.00nan;0;0
10852;201718;217;0;0;0;0;.00nan;0;0
10852;191130;186;54;16;2;14;.875;3600000;0
10852;213507;186;0;0;0;0;.00nan;0;0
10852;-1;217;76;39;3;36;.923;3600000;0
10749;198149;188;0;0;0;0;.00nan;0;0
10749;195118;197;0;0;0;0;.00nan;0;0
10749;184409;188;92;43;3;40;.930;3594000;0
10749;206822;197;69;22;2;20;.909;3600000;0
10857;213803;230;83;13;0;13;1.000;3600000;0
10857;187689;230;0;0;0;0;.00nan;0;0
10857;217269;223;0;0;0;0;.00nan;0;0
10857;217312;223;69;60;6;54;.900;3600000;0
11678;205769;200;0;0;0;0;.00nan;0;0
11678;212002;200;77;30;2;28;.933;3600000;0
11678;196283;206;58;5;0;5;1.000;489000;0
11678;202998;206;31;30;6;24;.800;3111000;0
10915;196571;177;19;11;4;7;.636;734000;0
10915;-1;4949;97;31;1;30;.968;3600000;0
10915;-1;4949;0;0;0;0;.00nan;0;0
10915;-1;177;78;26;1;25;.962;2866000;0
10908;185810;182;72;27;2;25;.926;3600000;0
10908;-1;1371;52;36;5;31;.861;3600000;0
10908;213498;182;0;0;0;0;.00nan;0;0
10908;-1;1371;0;0;0;0;.00nan;0;0
10712;204676;192;0;0;0;0;.00nan;0;0
10712;207398;192;58;30;3;27;.900;3523000;0
10712;191118;196;0;0;0;0;.00nan;0;0
10712;202830;196;87;36;1;35;.972;3600000;0
10711;192915;179;0;0;0;0;.00nan;0;0
10711;201495;213;34;32;6;26;.813;3142000;0
10711;217198;213;50;1;0;1;1.000;458000;0
10711;187355;179;71;19;1;18;.947;3600000;0
10708;183695;232;0;0;0;0;.00nan;0;0
10708;211080;229;0;0;0;0;.00nan;0;0
10708;-1;232;79;31;2;29;.935;3600000;0
10708;-1;229;59;39;4;35;.897;3582000;0
11111;215240;231;29;18;4;14;.778;3600000;0
11111;189773;231;0;0;0;0;.00nan;0;0
11111;206971;4960;90;36;2;34;.944;3600000;0
11111;212304;4960;0;0;0;0;.00nan;0;0
10582;192862;187;38;19;4;15;.789;2238000;0
10582;195118;197;50;36;5;31;.861;3554000;0
10582;206822;197;0;0;0;0;.00nan;0;0
10582;-1;187;56;4;0;4;1.000;1362000;0
10722;212050;218;0;0;0;0;.00nan;0;0
10722;196296;219;0;0;0;0;.00nan;0;0
10722;208051;218;100;24;0;24;1.000;3600000;0
10722;218658;219;60;36;4;32;.889;3600000;0
10898;200333;194;84;41;4;37;.902;3543000;0
10898;196352;194;0;0;0;0;.00nan;0;0
10898;191118;196;69;29;3;26;.897;3600000;0
10898;202830;196;0;0;0;0;.00nan;0;0
10587;205769;200;69;31;2;29;.935;3600000;0
10587;212002;200;0;0;0;0;.00nan;0;0
10587;196283;206;64;34;4;30;.882;3529000;0
10587;202998;206;0;0;0;0;.00nan;0;0
10911;209840;184;0;0;0;0;.00nan;0;0
10911;205837;184;89;30;1;29;.967;3600000;0
10911;-1;1371;0;0;0;0;.00nan;0;0
10911;-1;1371;61;21;2;19;.905;3548000;0
10756;199416;191;0;0;0;0;.00nan;0;0
10756;204676;192;52;38;5;33;.868;3563000;0
10756;201892;191;39;20;4;16;.800;3600000;0
10756;207398;192;0;0;0;0;.00nan;0;0
10778;215703;195;0;0;0;0;.00nan;0;0
10778;207061;195;81;24;1;23;.958;3600000;0
10778;-1;189;63;48;6;42;.875;3270000;0
10778;-1;189;53;3;0;3;1.000;330000;0
10755;206833;4864;71;22;1;21;.955;3600000;0
10755;-1;209;74;34;3;31;.912;3557000;0
10755;202801;4864;0;0;0;0;.00nan;0;0
10755;213590;209;0;0;0;0;.00nan;0;0
10853;196088;185;87;32;1;31;.969;3600000;0
10853;185810;182;0;0;0;0;.00nan;0;0
10853;-1;185;0;0;0;0;.00nan;0;0
10853;213498;182;57;29;4;25;.862;3600000;0
10633;200452;221;56;21;3;18;.857;3600000;0
10633;195363;222;0;0;0;0;.00nan;0;0
10633;213560;222;54;38;4;34;.895;3561000;0
10633;-1;221;0;0;0;0;.00nan;0;0
10799;205681;226;0;0;0;0;.00nan;0;0
10799;-1;226;69;28;3;25;.893;3600000;0
10799;203087;204;0;0;0;0;.00nan;0;0
10799;203120;204;66;34;4;30;.882;3591000;0
10699;194950;1505;0;0;0;0;.00nan;0;0
10699;212814;1505;58;14;1;13;.929;3600000;0
10699;213399;216;0;0;0;0;.00nan;0;0
10699;-1;216;98;60;4;56;.933;3600000;0
10839;196571;177;53;37;5;32;.865;3600000;0
10839;-1;4949;86;19;0;19;1.000;3600000;0
10839;-1;4949;0;0;0;0;.00nan;0;0
10839;-1;177;0;0;0;0;.00nan;0;0
10886;216313;180;90;37;2;35;.946;3600000;0
10886;191130;186;0;0;0;0;.00nan;0;0
10886;213507;186;59;25;3;22;.880;3558000;0
10886;208383;180;0;0;0;0;.00nan;0;0
10660;191063;211;83;43;4;39;.907;3600000;0
10660;-1;211;0;0;0;0;.00nan;0;0
10660;-1;212;38;29;5;24;.828;3548000;0
10660;-1;212;0;0;0;0;.00nan;0;0
10740;198172;181;0;0;0;0;.00nan;0;0
10740;216001;181;69;23;2;21;.913;3600000;0
10740;182014;214;0;0;0;0;.00nan;0;0
10740;202914;214;66;43;5;38;.884;3600000;0
10613;200444;224;64;16;1;15;.938;3600000;0
10613;201514;227;0;0;0;0;.00nan;0;0
10613;213280;227;75;46;5;41;.891;3600000;0
10613;208372;224;0;0;0;0;.00nan;0;0
10643;200437;201;73;24;2;22;.917;3600000;0
10643;201524;205;0;0;0;0;.00nan;0;0
10643;208048;201;0;0;0;0;.00nan;0;0
10643;-1;205;73;23;1;22;.957;3600000;0
10817;205788;207;0;0;0;0;.00nan;0;0
10817;201525;203;0;0;0;0;.00nan;0;0
10817;206772;203;100;28;0;28;1.000;3600000;0
10817;197853;207;58;37;5;32;.865;3600000;0
10642;190164;4959;0;0;0;0;.00nan;0;0
10642;-1;4959;94;32;1;31;.969;3600000;0
10642;-1;2620;53;28;3;25;.893;3541000;0
10642;213550;2620;0;0;0;0;.00nan;0;0
10670;200444;224;0;0;0;0;.00nan;0;0
10670;206800;225;0;0;0;0;.00nan;0;0
10670;-1;225;96;53;2;51;.962;3900000;0
10670;208372;224;71;26;2;24;.923;3900000;0
10649;192862;187;0;0;0;0;.00nan;0;0
10649;210504;193;57;27;3;24;.889;3557000;0
10649;218059;193;0;0;0;0;.00nan;0;0
10649;-1;187;79;24;1;23;.958;3600000;0
10659;192939;208;0;0;0;0;.00nan;0;0
10659;200437;201;91;40;2;38;.950;3848000;0
10659;208048;201;0;0;0;0;.00nan;0;0
10659;-1;208;74;28;1;27;.964;3848000;0
10777;199416;191;48;26;4;22;.846;3900000;0
10777;212143;198;85;53;4;49;.925;3900000;0
10777;201892;191;0;0;0;0;.00nan;0;0
10777;212649;198;0;0;0;0;.00nan;0;0
10785;206801;176;91;38;2;36;.947;3600000;0
10785;206833;4864;0;0;0;0;.00nan;0;0
10785;202801;4864;70;35;3;32;.914;3542000;0
10785;213533;176;0;0;0;0;.00nan;0;0
10664;188977;215;0;0;0;0;.00nan;0;0
10664;210794;215;44;30;5;25;.833;3600000;0
10664;-1;212;50;7;1;6;.857;1177000;0
10664;-1;212;47;37;6;31;.838;2338000;0
11613;194950;1505;59;19;2;17;.895;3600000;0
11613;211942;183;57;3;0;3;1.000;478000;0
11613;196237;183;56;44;6;38;.864;3122000;0
11613;212814;1505;0;0;0;0;.00nan;0;0
10896;-1;189;37;30;6;24;.800;3121000;0
10896;-1;190;84;31;2;29;.935;3600000;0
10896;-1;189;53;3;0;3;1.000;479000;0
10896;-1;190;0;0;0;0;.00nan;0;0
10668;200452;221;68;19;1;18;.947;3816000;0
10668;211080;229;85;37;2;35;.946;3816000;0
10668;-1;221;0;0;0;0;.00nan;0;0
10668;-1;229;0;0;0;0;.00nan;0;0
10637;183695;232;83;36;3;33;.917;3900000;0
10637;195363;222;0;0;0;0;.00nan;0;0
10637;213560;222;55;24;3;21;.875;3900000;0
10637;-1;232;0;0;0;0;.00nan;0;0
10709;206800;225;0;0;0;0;.00nan;0;0
10709;217269;223;0;0;0;0;.00nan;0;0
10709;217312;223;45;24;4;20;.833;3600000;0
10709;-1;225;93;37;1;36;.973;3600000;0
10598;205769;200;0;0;0;0;.00nan;0;0
10598;212002;200;55;34;4;30;.882;3581000;0
10598;-1;199;66;33;3;30;.909;3600000;0
10598;-1;199;0;0;0;0;.00nan;0;0
10921;196088;185;42;34;5;29;.853;3535000;0
10921;-1;185;0;0;0;0;.00nan;0;0
10921;-1;1371;71;33;3;30;.909;3600000;0
10921;-1;1371;0;0;0;0;.00nan;0;0
11096;216114;202;54;11;1;10;.909;915000;0
11096;201524;205;0;0;0;0;.00nan;0;0
11096;201560;202;47;39;6;33;.846;2685000;0
11096;-1;205;31;22;5;17;.773;3600000;0
11366;215240;231;0;0;0;0;.00nan;0;0
11366;189773;231;74;21;2;19;.905;3900000;0
11366;201514;227;97;57;2;55;.965;3900000;0
11366;213280;227;0;0;0;0;.00nan;0;0
11600;204676;192;0;0;0;0;.00nan;0;0
11600;195118;197;0;0;0;0;.00nan;0;0
11600;206822;197;62;32;3;29;.906;3600000;0
11600;207398;192;80;28;1;27;.964;3600000;0
10714;190164;4959;0;0;0;0;.00nan;0;0
10714;-1;209;0;0;0;0;.00nan;0;0
10714;-1;4959;88;21;0;21;1.000;3600000;0
10714;213590;209;46;29;4;25;.862;3600000;0
10747;198172;181;0;0;0;0;.00nan;0;0
10747;216001;181;44;34;5;29;.853;3600000;0
10747;211017;220;73;33;2;31;.939;3600000;0
10747;218510;220;0;0;0;0;.00nan;0;0
10840;188977;215;76;37;3;34;.919;3600000;0
10840;210794;215;0;0;0;0;.00nan;0;0
10840;191063;211;42;31;5;26;.839;3559000;0
10840;-1;211;0;0;0;0;.00nan;0;0
10768;201525;203;78;39;3;36;.923;3600000;0
10768;206772;203;0;0;0;0;.00nan;0;0
10768;196283;206;0;0;0;0;.00nan;0;0
10768;202998;206;37;21;4;17;.810;3581000;0
10856;-1;178;0;0;0;0;.00nan;0;0
10856;-1;4949;82;22;1;21;.955;3600000;0
10856;-1;4949;0;0;0;0;.00nan;0;0
10856;-1;178;85;39;3;36;.923;3550000;0
10770;211942;183;92;15;0;15;1.000;3600000;0
10770;196237;183;0;0;0;0;.00nan;0;0
10770;213399;216;0;0;0;0;.00nan;0;0
10770;-1;216;41;23;4;19;.826;3600000;0
10781;209840;184;0;0;0;0;.00nan;0;0
10781;205837;184;81;39;3;36;.923;3565000;0
10781;182014;214;0;0;0;0;.00nan;0;0
10781;202914;214;73;35;2;33;.943;3600000;0
10757;198149;188;0;0;0;0;.00nan;0;0
10757;215703;195;0;0;0;0;.00nan;0;0
10757;184409;188;61;28;3;25;.893;3600000;0
10757;207061;195;70;22;1;21;.955;3600000;0
10794;201718;217;62;31;3;28;.903;3600000;0
10794;196296;219;0;0;0;0;.00nan;0;0
10794;218658;219;79;24;1;23;.958;3600000;0
10794;-1;217;0;0;0;0;.00nan;0;0
10788;213803;230;35;26;5;21;.808;3555000;0
10788;187689;230;0;0;0;0;.00nan;0;0
10788;180377;228;88;44;3;41;.932;3600000;0
10788;208044;228;0;0;0;0;.00nan;0;0
10803;192915;179;50;38;5;33;.868;3600000;0
10803;187355;179;0;0;0;0;.00nan;0;0
10803;197672;210;0;0;0;0;.00nan;0;0
10803;-1;210;60;12;1;11;.917;3600000;0
10731;212050;218;0;0;0;0;.00nan;0;0
10731;196296;219;76;30;3;27;.900;3600000;0
10731;208051;218;100;28;0;28;1.000;3600000;0
10731;218658;219;0;0;0;0;.00nan;0;0
10661;201495;213;0;0;0;0;.00nan;0;0
10661;217198;213;36;30;5;25;.833;3600000;0
10661;213399;216;100;39;1;38;.974;3600000;0
10661;-1;216;0;0;0;0;.00nan;0;0
10772;211017;220;0;0;0;0;.00nan;0;0
10772;196088;185;0;0;0;0;.00nan;0;0
10772;-1;185;87;36;2;34;.944;3600000;0
10772;218510;220;58;38;4;34;.895;3520000;0
10665;216313;180;69;26;2;24;.923;3900000;0
10665;208383;180;0;0;0;0;.00nan;0;0
10665;-1;212;98;30;2;28;.933;3900000;0
10665;-1;212;0;0;0;0;.00nan;0;0
10926;212143;198;41;28;5;23;.821;3548000;0
10926;212649;198;0;0;0;0;.00nan;0;0
10926;-1;190;81;31;2;29;.935;3600000;0
10926;-1;190;0;0;0;0;.00nan;0;0
10728;192939;208;72;27;2;25;.926;3868000;0
10728;205788;207;0;0;0;0;.00nan;0;0
10728;197853;207;64;32;3;29;.906;3868000;0
10728;-1;208;0;0;0;0;.00nan;0;0
10826;191118;196;78;18;1;17;.944;3600000;0
10826;-1;189;79;36;2;34;.944;3555000;0
10826;202830;196;0;0;0;0;.00nan;0;0
10826;-1;189;0;0;0;0;.00nan;0;0
10717;200437;201;62;30;3;27;.900;3600000;0
10717;196283;206;52;40;6;34;.850;2768000;0
10717;208048;201;0;0;0;0;.00nan;0;0
10717;202998;206;34;10;3;7;.700;832000;0
10818;206801;176;91;38;2;36;.947;3600000;0
10818;206833;4864;40;24;4;20;.833;3575000;0
10818;202801;4864;0;0;0;0;.00nan;0;0
10818;213533;176;0;0;0;0;.00nan;0;0
11056;194950;1505;0;0;0;0;.00nan;0;0
11056;212814;1505;63;23;2;21;.913;3900000;0
11056;197672;210;91;48;2;46;.958;3900000;0
11056;-1;210;0;0;0;0;.00nan;0;0
10894;216114;202;0;0;0;0;.00nan;0;0
10894;201560;202;92;45;2;43;.956;3570000;0
10894;203087;204;0;0;0;0;.00nan;0;0
10894;203120;204;59;13;1;12;.923;3600000;0
10783;200452;221;0;0;0;0;.00nan;0;0
10783;206971;4960;97;29;1;28;.966;3600000;0
10783;212304;4960;0;0;0;0;.00nan;0;0
10783;-1;221;76;33;3;30;.909;3581000;0
10797;204676;192;53;24;3;21;.875;3600000;0
10797;210504;193;26;7;3;4;.571;209000;0
10797;207398;192;0;0;0;0;.00nan;0;0
10797;218059;193;75;37;3;34;.919;3391000;0
11181;215240;231;0;0;0;0;.00nan;0;0
11181;189773;231;66;23;2;21;.913;3600000;0
11181;217269;223;98;63;3;60;.952;3556000;0
11181;217312;223;0;0;0;0;.00nan;0;0
10750;-1;209;0;0;0;0;.00nan;0;0
10750;-1;2620;0;0;0;0;.00nan;0;0
10750;213550;2620;66;22;2;20;.909;3555000;0
10750;213590;209;99;38;1;37;.974;3600000;0
10808;201514;227;0;0;0;0;.00nan;0;0
10808;180377;228;77;21;1;20;.952;3900000;0
10808;213280;227;92;33;1;32;.970;3900000;0
10808;208044;228;0;0;0;0;.00nan;0;0
10963;191063;211;0;0;0;0;.00nan;0;0
10963;191130;186;0;0;0;0;.00nan;0;0
10963;-1;211;57;29;3;26;.897;3574000;0
10963;213507;186;74;25;1;24;.960;3600000;0
11644;196571;177;83;25;1;24;.960;3600000;0
11644;-1;178;0;0;0;0;.00nan;0;0
11644;-1;178;64;30;3;27;.900;3516000;0
11644;-1;177;0;0;0;0;.00nan;0;0
10530;205769;200;0;0;0;0;.00nan;0;0
10530;212002;200;100;32;0;32;1.000;3600000;0
10530;-1;199;0;0;0;0;.00nan;0;0
10530;-1;199;70;28;2;26;.929;3523000;0
10819;212050;218;0;0;0;0;.00nan;0;0
10819;201718;217;0;0;0;0;.00nan;0;0
10819;208051;218;50;33;5;28;.848;3567000;0
10819;-1;217;58;36;4;32;.889;3600000;0
10680;183695;232;0;0;0;0;.00nan;0;0
10680;200444;224;79;29;2;27;.931;3777000;0
10680;208372;224;0;0;0;0;.00nan;0;0
10680;-1;232;88;41;3;38;.927;3777000;0
10807;198172;181;0;0;0;0;.00nan;0;0
10807;216001;181;19;23;6;17;.739;3528000;0
10807;182014;214;61;33;4;29;.879;3600000;0
10807;202914;214;0;0;0;0;.00nan;0;0
11026;213803;230;69;20;1;19;.950;3600000;0
11026;187689;230;0;0;0;0;.00nan;0;0
11026;206800;225;0;0;0;0;.00nan;0;0
11026;-1;225;65;43;5;38;.884;3600000;0
11642;190164;4959;0;0;0;0;.00nan;0;0
11642;206833;4864;0;0;0;0;.00nan;0;0
11642;202801;4864;63;37;4;33;.892;3580000;0
11642;-1;4959;82;31;2;29;.935;3600000;0
11553;201524;205;66;18;1;17;.944;3600000;0
11553;201525;203;69;35;3;32;.914;3600000;0
11553;206772;203;0;0;0;0;.00nan;0;0
11553;-1;205;0;0;0;0;.00nan;0;0
10721;192862;187;96;40;4;36;.900;3600000;0
10721;195118;197;0;0;0;0;.00nan;0;0
10721;206822;197;39;33;6;27;.818;3521000;0
10721;-1;187;0;0;0;0;.00nan;0;0
10917;188977;215;0;0;0;0;.00nan;0;0
10917;210794;215;43;50;8;42;.840;3600000;0
10917;216313;180;0;0;0;0;.00nan;0;0
10917;208383;180;68;23;2;21;.913;3600000;0
10891;205788;207;65;27;2;25;.926;3600000;0
10891;197853;207;0;0;0;0;.00nan;0;0
10891;203087;204;63;29;3;26;.897;3559000;0
10891;203120;204;0;0;0;0;.00nan;0;0
10912;210504;193;81;49;4;45;.918;3600000;0
10912;215703;195;0;0;0;0;.00nan;0;0
10912;207061;195;54;21;3;18;.857;3600000;0
10912;218059;193;0;0;0;0;.00nan;0;0
11631;209840;184;0;0;0;0;.00nan;0;0
11631;205837;184;71;22;1;21;.955;3900000;0
11631;196088;185;99;35;1;34;.971;3900000;0
11631;-1;185;0;0;0;0;.00nan;0;0
11594;183695;232;96;61;3;58;.951;3600000;0
11594;206971;4960;88;14;0;14;1.000;3600000;0
11594;212304;4960;0;0;0;0;.00nan;0;0
11594;-1;232;0;0;0;0;.00nan;0;0
11153;194950;1505;69;31;2;29;.935;3600000;0
11153;212814;1505;0;0;0;0;.00nan;0;0
11153;197672;210;0;0;0;0;.00nan;0;0
11153;-1;210;66;31;3;28;.903;3600000;0
11249;200333;194;0;0;0;0;.00nan;0;0
11249;196352;194;64;42;4;38;.905;3600000;0
11249;-1;190;100;31;0;31;1.000;3600000;0
11249;-1;190;0;0;0;0;.00nan;0;0
11626;200452;221;92;23;0;23;1.000;3600000;0
11626;201514;227;0;0;0;0;.00nan;0;0
11626;213280;227;84;32;1;31;.969;3546000;0
11626;-1;221;0;0;0;0;.00nan;0;0
10844;196571;177;66;37;3;34;.919;3600000;0
10844;-1;178;93;36;1;35;.972;3600000;0
10844;-1;178;0;0;0;0;.00nan;0;0
10844;-1;177;0;0;0;0;.00nan;0;0
10793;198149;188;72;19;1;18;.947;966000;0
10793;199416;191;0;0;0;0;.00nan;0;0
10793;184409;188;39;34;6;28;.824;2634000;0
10793;201892;191;68;18;1;17;.944;3600000;0
10904;192915;179;0;0;0;0;.00nan;0;0
10904;211942;183;56;24;3;21;.875;3520000;0
10904;196237;183;0;0;0;0;.00nan;0;0
10904;187355;179;84;33;1;32;.970;3600000;0
11638;200333;194;91;39;2;37;.949;3600000;0
11638;196352;194;0;0;0;0;.00nan;0;0
11638;-1;190;73;29;3;26;.897;3600000;0
11638;-1;190;0;0;0;0;.00nan;0;0
10875;201718;217;0;0;0;0;.00nan;0;0
10875;191130;186;98;39;1;38;.974;3600000;0
10875;213507;186;0;0;0;0;.00nan;0;0
10875;-1;217;37;26;5;21;.808;3600000;0
10943;205788;207;0;0;0;0;.00nan;0;0
10943;196283;206;0;0;0;0;.00nan;0;0
10943;197853;207;74;40;4;36;.900;3738000;0
10943;202998;206;49;22;3;19;.864;3738000;0
11049;215240;231;0;0;0;0;.00nan;0;0
11049;189773;231;55;10;1;9;.900;3600000;0
11049;206800;225;0;0;0;0;.00nan;0;0
11049;-1;225;98;53;3;50;.943;3600000;0
10599;192939;208;71;32;3;29;.906;3900000;0
10599;205769;200;0;0;0;0;.00nan;0;0
10599;212002;200;68;31;3;28;.903;3900000;0
10599;-1;208;0;0;0;0;.00nan;0;0
10813;188977;215;0;0;0;0;.00nan;0;0
10813;210794;215;86;38;2;36;.947;3600000;0
10813;196296;219;0;0;0;0;.00nan;0;0
10813;218658;219;46;30;5;25;.833;3600000;0
11025;210504;193;64;29;3;26;.897;3555000;0
11025;218059;193;0;0;0;0;.00nan;0;0
11025;-1;189;0;0;0;0;.00nan;0;0
11025;-1;189;70;26;2;24;.923;3600000;0
11213;216313;180;79;29;2;27;.931;3600000;0
11213;191063;211;65;37;4;33;.892;3600000;0
11213;-1;211;0;0;0;0;.00nan;0;0
11213;208383;180;0;0;0;0;.00nan;0;0
10754;200437;201;100;51;2;49;.961;3900000;0
10754;205681;226;0;0;0;0;.00nan;0;0
10754;208048;201;0;0;0;0;.00nan;0;0
10754;-1;226;56;22;2;20;.909;3900000;0
10804;198172;181;0;0;0;0;.00nan;0;0
10804;216001;181;86;28;1;27;.964;3900000;0
10804;211017;220;85;33;1;32;.970;3900000;0
10804;218510;220;0;0;0;0;.00nan;0;0
10835;196571;177;0;0;0;0;.00nan;0;0
10835;213399;216;0;0;0;0;.00nan;0;0
10835;-1;216;65;25;2;23;.920;3696000;0
10835;-1;177;77;22;1;21;.955;3696000;0
10698;201524;205;0;0;0;0;.00nan;0;0
10698;-1;199;0;0;0;0;.00nan;0;0
10698;-1;199;87;36;2;34;.944;3900000;0
10698;-1;205;60;16;2;14;.875;3900000;0
10761;204676;192;0;0;0;0;.00nan;0;0
10761;195118;197;52;12;1;11;.917;687000;0
10761;206822;197;23;28;6;22;.786;2913000;0
10761;207398;192;100;28;0;28;1.000;3600000;0
11667;190164;4959;0;0;0;0;.00nan;0;0
11667;206833;4864;51;15;2;13;.867;3600000;0
11667;202801;4864;0;0;0;0;.00nan;0;0
11667;-1;4959;69;43;5;38;.884;3600000;0
10784;198149;188;59;47;6;41;.872;3600000;0
10784;184409;188;0;0;0;0;.00nan;0;0
10784;212143;198;51;11;2;9;.818;3600000;0
10784;212649;198;0;0;0;0;.00nan;0;0
10718;211080;229;65;22;2;20;.909;3888000;0
10718;217269;223;0;0;0;0;.00nan;0;0
10718;217312;223;80;33;2;31;.939;3900000;0
10718;-1;229;0;0;0;0;.00nan;0;0
10792;192862;187;0;0;0;0;.00nan;0;0
10792;191118;196;77;38;2;36;.947;3900000;0
10792;-1;187;66;25;2;23;.920;3900000;0
10792;202830;196;0;0;0;0;.00nan;0;0
10959;182014;214;0;0;0;0;.00nan;0;0
10959;185810;182;33;24;5;19;.792;3600000;0
10959;202914;214;95;36;1;35;.972;3600000;0
10959;213498;182;0;0;0;0;.00nan;0;0
10789;213803;230;67;14;1;13;.929;3600000;0
10789;187689;230;0;0;0;0;.00nan;0;0
10789;200452;221;84;40;3;37;.925;3547000;0
10789;-1;221;0;0;0;0;.00nan;0;0
10878;201495;213;0;0;0;0;.00nan;0;0
10878;211942;183;0;0;0;0;.00nan;0;0
10878;196237;183;80;25;1;24;.960;3600000;0
10878;217198;213;81;40;4;36;.900;3600000;0
10710;211080;229;30;33;6;27;.818;3600000;0
10710;206800;225;0;0;0;0;.00nan;0;0
10710;-1;225;68;26;2;24;.923;3600000;0
10710;-1;229;0;0;0;0;.00nan;0;0
11011;216114;202;0;0;0;0;.00nan;0;0
11011;201560;202;88;47;2;45;.957;3564000;0
11011;203087;204;0;0;0;0;.00nan;0;0
11011;203120;204;77;13;0;13;1.000;3600000;0
10726;192862;187;100;39;1;38;.974;3600000;0
10726;212143;198;0;0;0;0;.00nan;0;0
10726;212649;198;52;24;3;21;.875;3534000;0
10726;-1;187;0;0;0;0;.00nan;0;0
10888;199416;191;0;0;0;0;.00nan;0;0
10888;215703;195;50;32;6;26;.813;3059000;0
10888;201892;191;85;44;4;40;.909;3600000;0
10888;207061;195;53;2;0;2;1.000;489000;0
10981;-1;4949;97;32;1;31;.969;3600000;0
10981;197672;210;0;0;0;0;.00nan;0;0
10981;-1;4949;0;0;0;0;.00nan;0;0
10981;-1;210;72;35;4;31;.886;3600000;0
10725;190164;4959;96;51;3;48;.941;3570000;0
10725;206801;176;78;21;1;20;.952;3600000;0
10725;-1;4959;0;0;0;0;.00nan;0;0
10725;213533;176;0;0;0;0;.00nan;0;0
11075;201718;217;63;32;3;29;.906;3566000;0
11075;191063;211;0;0;0;0;.00nan;0;0
11075;-1;211;92;36;1;35;.972;3600000;0
11075;-1;217;0;0;0;0;.00nan;0;0
10846;194950;1505;83;13;0;13;1.000;3600000;0
10846;212814;1505;0;0;0;0;.00nan;0;0
10846;213399;216;72;37;3;34;.919;3600000;0
10846;-1;216;0;0;0;0;.00nan;0;0
11070;198172;181;66;28;2;26;.929;3566000;0
11070;209840;184;100;51;1;50;.980;3600000;0
11070;205837;184;0;0;0;0;.00nan;0;0
11070;216001;181;0;0;0;0;.00nan;0;0
10742;212050;218;0;0;0;0;.00nan;0;0
10742;208051;218;59;13;1;12;.923;3600000;0
10742;-1;212;46;26;4;22;.846;3600000;0
10742;-1;212;0;0;0;0;.00nan;0;0
10671;192939;208;0;0;0;0;.00nan;0;0
10671;-1;199;80;57;5;52;.912;3600000;0
10671;-1;208;92;27;1;26;.963;3600000;0
10671;-1;199;0;0;0;0;.00nan;0;0
10874;210504;193;0;0;0;0;.00nan;0;0
10874;218059;193;39;24;4;20;.833;3600000;0
10874;-1;189;66;44;5;39;.886;3579000;0
10874;-1;189;0;0;0;0;.00nan;0;0
10688;200444;224;41;19;4;15;.789;3570000;0
10688;217269;223;91;47;3;44;.936;3600000;0
10688;217312;223;0;0;0;0;.00nan;0;0
10688;208372;224;0;0;0;0;.00nan;0;0
10938;185810;182;0;0;0;0;.00nan;0;0
10938;-1;1371;53;30;4;26;.867;3600000;0
10938;213498;182;100;31;0;31;1.000;3600000;0
10938;-1;1371;0;0;0;0;.00nan;0;0
10827;204676;192;0;0;0;0;.00nan;0;0
10827;207398;192;46;26;4;22;.846;3600000;0
10827;191118;196;99;50;1;49;.980;3600000;0
10827;202830;196;0;0;0;0;.00nan;0;0
10765;206833;4864;0;0;0;0;.00nan;0;0
10765;-1;209;87;23;2;21;.913;3600000;0
10765;202801;4864;30;23;5;18;.783;3600000;0
10765;213590;209;0;0;0;0;.00nan;0;0
10695;195363;222;100;23;0;23;1.000;3600000;0
10695;180377;228;97;43;2;41;.953;3535000;0
10695;208044;228;0;0;0;0;.00nan;0;0
10695;213560;222;0;0;0;0;.00nan;0;0
10849;201524;205;55;23;3;20;.870;3600000;0
10849;196283;206;40;31;5;26;.839;3568000;0
10849;-1;205;0;0;0;0;.00nan;0;0
10849;202998;206;0;0;0;0;.00nan;0;0
10902;205788;207;74;45;4;41;.911;3576000;0
10902;201525;203;73;28;2;26;.929;3600000;0
10902;206772;203;0;0;0;0;.00nan;0;0
10902;197853;207;0;0;0;0;.00nan;0;0
11422;201514;227;81;49;4;45;.918;3600000;0
11422;206971;4960;72;8;0;8;1.000;3600000;0
11422;212304;4960;0;0;0;0;.00nan;0;0
11422;213280;227;0;0;0;0;.00nan;0;0
10825;211017;220;0;0;0;0;.00nan;0;0
10825;182014;214;38;22;4;18;.818;1182000;0
10825;218510;220;55;10;1;9;.900;3600000;0
10825;202914;214;43;30;5;25;.833;2418000;0
10800;212050;218;52;21;3;18;.857;3900000;0
10800;196296;219;0;0;0;0;.00nan;0;0
10800;208051;218;0;0;0;0;.00nan;0;0
10800;218658;219;84;39;3;36;.923;3900000;0
10796;198149;188;0;0;0;0;.00nan;0;0
10796;195118;197;0;0;0;0;.00nan;0;0
10796;184409;188;81;33;2;31;.939;3544000;0
10796;206822;197;97;34;1;33;.971;3600000;0
10724;200444;224;0;0;0;0;.00nan;0;0
10724;200452;221;0;0;0;0;.00nan;0;0
10724;208372;224;100;30;0;30;1.000;3600000;0
10724;-1;221;87;34;1;33;.971;3596000;0
10753;188977;215;0;0;0;0;.00nan;0;0
10753;210794;215;95;59;3;56;.949;3900000;0
10753;-1;212;0;0;0;0;.00nan;0;0
10753;-1;212;53;21;3;18;.857;3900000;0
10780;183695;232;0;0;0;0;.00nan;0;0
10780;180377;228;70;25;2;23;.920;3600000;0
10780;208044;228;0;0;0;0;.00nan;0;0
10780;-1;232;59;30;3;27;.900;3600000;0
10697;195363;222;0;0;0;0;.00nan;0;0
10697;206971;4960;100;28;0;28;1.000;3600000;0
10697;212304;4960;0;0;0;0;.00nan;0;0
10697;213560;222;94;56;4;52;.929;3600000;0
10841;192915;179;57;18;2;16;.889;3600000;0
10841;187355;179;0;0;0;0;.00nan;0;0
10841;-1;178;0;0;0;0;.00nan;0;0
10841;-1;178;84;44;3;41;.932;3600000;0
10833;195118;197;73;37;3;34;.919;3600000;0
10833;206822;197;0;0;0;0;.00nan;0;0
10833;-1;190;63;30;5;25;.833;3533000;0
10833;-1;190;0;0;0;0;.00nan;0;0
10836;206801;176;69;32;3;29;.906;3600000;0
10836;-1;2620;0;0;0;0;.00nan;0;0
10836;213533;176;0;0;0;0;.00nan;0;0
10836;213550;2620;45;23;4;19;.826;3544000;0
10847;216313;180;72;28;2;26;.929;3900000;0
10847;196296;219;75;35;2;33;.943;3900000;0
10847;218658;219;0;0;0;0;.00nan;0;0
10847;208383;180;0;0;0;0;.00nan;0;0
10656;192939;208;96;34;0;34;1.000;3900000;0
10656;205769;200;0;0;0;0;.00nan;0;0
10656;212002;200;100;38;0;38;1.000;3900000;0
10656;-1;208;0;0;0;0;.00nan;0;0
10820;199416;191;0;0;0;0;.00nan;0;0
10820;212143;198;92;36;2;34;.944;3677000;0
10820;201892;191;79;23;1;22;.957;3677000;0
10820;212649;198;0;0;0;0;.00nan;0;0
11456;191063;211;0;0;0;0;.00nan;0;0
11456;191130;186;0;0;0;0;.00nan;0;0
11456;-1;211;65;35;4;31;.886;3600000;0
11456;213507;186;44;36;5;31;.861;3577000;0
11205;201514;227;59;27;3;24;.889;3595000;0
11205;217269;223;0;0;0;0;.00nan;0;0
11205;217312;223;99;45;1;44;.978;3600000;0
11205;213280;227;0;0;0;0;.00nan;0;0
10798;190164;4959;0;0;0;0;.00nan;0;0
10798;206833;4864;74;22;1;21;.955;3600000;0
10798;202801;4864;0;0;0;0;.00nan;0;0
10798;-1;4959;71;35;3;32;.914;3543000;0
10866;211017;220;82;31;2;29;.935;3893000;0
10866;196088;185;100;35;1;34;.971;3893000;0
10866;-1;185;0;0;0;0;.00nan;0;0
10866;218510;220;0;0;0;0;.00nan;0;0
11541;213803;230;91;51;2;49;.961;3600000;0
11541;187689;230;0;0;0;0;.00nan;0;0
11541;215240;231;0;0;0;0;.00nan;0;0
11541;189773;231;78;43;5;38;.884;3600000;0
11602;200333;194;0;0;0;0;.00nan;0;0
11602;196352;194;53;41;5;36;.878;3600000;0
11602;-1;189;21;10;4;6;.600;964000;0
11602;-1;189;47;21;3;18;.857;2636000;0
10975;205681;226;0;0;0;0;.00nan;0;0
10975;201525;203;70;39;4;35;.897;3600000;0
10975;206772;203;0;0;0;0;.00nan;0;0
10975;-1;226;63;16;1;15;.938;3600000;0
10946;185810;182;0;0;0;0;.00nan;0;0
10946;-1;1371;82;30;1;29;.967;3600000;0
10946;213498;182;64;30;4;26;.867;3600000;0
10946;-1;1371;0;0;0;0;.00nan;0;0
10967;201495;213;0;0;0;0;.00nan;0;0
10967;217198;213;78;38;2;36;.947;3566000;0
10967;197672;210;0;0;0;0;.00nan;0;0
10967;-1;210;61;16;1;15;.938;3600000;0
10763;200437;201;72;31;2;29;.935;3600000;0
10763;208048;201;0;0;0;0;.00nan;0;0
10763;203087;204;71;22;1;21;.955;2445000;0
10763;203120;204;21;13;4;9;.692;1155000;0
10961;216114;202;0;0;0;0;.00nan;0;0
10961;201524;205;0;0;0;0;.00nan;0;0
10961;201560;202;84;45;4;41;.911;3600000;0
10961;-1;205;84;15;0;15;1.000;3600000;0
10824;190164;4959;48;42;6;36;.857;3600000;0
10824;206801;176;0;0;0;0;.00nan;0;0
10824;-1;4959;0;0;0;0;.00nan;0;0
10824;213533;176;68;29;2;27;.931;3600000;0
10832;198149;188;0;0;0;0;.00nan;0;0
10832;204676;192;0;0;0;0;.00nan;0;0
10832;184409;188;69;44;5;39;.886;3600000;0
10832;207398;192;97;17;0;17;1.000;3600000;0
10791;212050;218;0;0;0;0;.00nan;0;0
10791;208051;218;68;38;4;34;.895;3900000;0
10791;-1;212;62;41;4;37;.902;3900000;0
10791;-1;212;0;0;0;0;.00nan;0;0
10831;201495;213;74;36;3;33;.917;3544000;0
10831;217198;213;0;0;0;0;.00nan;0;0
10831;197672;210;76;31;2;29;.935;3600000;0
10831;-1;210;0;0;0;0;.00nan;0;0
10767;200437;201;60;30;4;26;.867;3600000;0
10767;208048;201;0;0;0;0;.00nan;0;0
10767;-1;199;0;0;0;0;.00nan;0;0
10767;-1;199;89;42;3;39;.929;3600000;0
10606;205769;200;0;0;0;0;.00nan;0;0
10606;212002;200;54;38;6;32;.842;3600000;0
10606;196283;206;0;0;0;0;.00nan;0;0
10606;202998;206;100;30;0;30;1.000;3600000;0
10829;191118;196;100;41;0;41;1.000;3900000;0
10829;-1;189;92;23;0;23;1.000;3900000;0
10829;202830;196;0;0;0;0;.00nan;0;0
10829;-1;189;0;0;0;0;.00nan;0;0
10960;196088;185;0;0;0;0;.00nan;0;0
10960;182014;214;0;0;0;0;.00nan;0;0
10960;-1;185;33;20;4;16;.800;3600000;0
10960;202914;214;89;35;1;34;.971;3600000;0
10737;211080;229;71;37;4;33;.892;3600000;0
10737;206971;4960;74;19;1;18;.947;3600000;0
10737;212304;4960;0;0;0;0;.00nan;0;0
10737;-1;229;0;0;0;0;.00nan;0;0
11404;215240;231;0;0;0;0;.00nan;0;0
11404;189773;231;69;16;1;15;.938;3600000;0
11404;206800;225;0;0;0;0;.00nan;0;0
11404;-1;225;69;42;5;37;.881;3600000;0
10700;183695;232;0;0;0;0;.00nan;0;0
10700;195363;222;100;35;0;35;1.000;3600000;0
10700;213560;222;0;0;0;0;.00nan;0;0
10700;-1;232;43;22;4;18;.818;3600000;0
10859;188977;215;0;0;0;0;.00nan;0;0
10859;210794;215;52;31;4;27;.871;3600000;0
10859;201718;217;0;0;0;0;.00nan;0;0
10859;-1;217;90;18;0;18;1.000;3600000;0
10855;192915;179;0;0;0;0;.00nan;0;0
10855;211942;183;58;29;4;25;.862;3560000;0
10855;196237;183;0;0;0;0;.00nan;0;0
10855;187355;179;59;29;3;26;.897;3600000;0
11303;200333;194;90;44;2;42;.955;3600000;0
11303;210504;193;32;35;6;29;.829;2686000;0
11303;196352;194;0;0;0;0;.00nan;0;0
11303;218059;193;52;3;0;3;1.000;914000;0
11091;213803;230;60;14;1;13;.929;3600000;0
11091;187689;230;0;0;0;0;.00nan;0;0
11091;201514;227;0;0;0;0;.00nan;0;0
11091;213280;227;58;45;5;40;.889;3600000;0
10920;196571;177;49;32;4;28;.875;3600000;0
10920;213399;216;0;0;0;0;.00nan;0;0
10920;-1;216;90;43;1;42;.977;3600000;0
10920;-1;177;0;0;0;0;.00nan;0;0
11068;198172;181;0;0;0;0;.00nan;0;0
11068;216001;181;45;36;6;30;.833;3673000;0
11068;-1;1371;0;0;0;0;.00nan;0;0
11068;-1;1371;66;43;5;38;.884;3673000;0
10858;194950;1505;58;21;2;19;.905;3900000;0
10858;212814;1505;0;0;0;0;.00nan;0;0
10858;-1;178;0;0;0;0;.00nan;0;0
10858;-1;178;98;43;2;41;.953;3900000;0
11646;192939;208;75;20;1;19;.950;3600000;0
11646;-1;199;83;59;6;53;.898;3600000;0
11646;-1;208;0;0;0;0;.00nan;0;0
11646;-1;199;0;0;0;0;.00nan;0;0
11175;196571;177;0;0;0;0;.00nan;0;0
11175;-1;4949;61;30;3;27;.900;3900000;0
11175;-1;4949;0;0;0;0;.00nan;0;0
11175;-1;177;68;31;3;28;.903;3900000;0
10775;192862;187;76;25;1;24;.960;3600000;0
10775;215703;195;0;0;0;0;.00nan;0;0
10775;207061;195;40;23;5;18;.783;3600000;0
10775;-1;187;0;0;0;0;.00nan;0;0
10823;200444;224;0;0;0;0;.00nan;0;0
10823;180377;228;58;56;7;49;.875;3600000;0
10823;208044;228;0;0;0;0;.00nan;0;0
10823;208372;224;100;25;0;25;1.000;3600000;0
10910;205788;207;0;0;0;0;.00nan;0;0
10910;197853;207;73;23;1;22;.957;3600000;0
10910;203087;204;0;0;0;0;.00nan;0;0
10910;203120;204;68;40;4;36;.900;3600000;0
10838;206833;4864;0;0;0;0;.00nan;0;0
10838;202801;4864;67;35;4;31;.886;3596000;0
10838;-1;2620;59;24;3;21;.875;3600000;0
10838;213550;2620;0;0;0;0;.00nan;0;0
10928;199416;191;0;0;0;0;.00nan;0;0
10928;201892;191;53;33;4;29;.879;3600000;0
10928;-1;190;56;41;5;36;.878;3558000;0
10928;-1;190;0;0;0;0;.00nan;0;0
11215;205681;226;66;16;1;15;.938;3600000;0
11215;216114;202;0;0;0;0;.00nan;0;0
11215;201560;202;79;45;4;41;.911;3600000;0
11215;-1;226;0;0;0;0;.00nan;0;0
10828;183695;232;81;38;3;35;.921;3600000;0
10828;200452;221;100;19;0;19;1.000;3600000;0
10828;-1;221;0;0;0;0;.00nan;0;0
10828;-1;232;0;0;0;0;.00nan;0;0
11020;216313;180;0;0;0;0;.00nan;0;0
11020;191130;186;67;18;1;17;.944;3600000;0
11020;213507;186;0;0;0;0;.00nan;0;0
11020;208383;180;76;41;3;38;.927;3521000;0
11124;200333;194;0;0;0;0;.00nan;0;0
11124;215703;195;0;0;0;0;.00nan;0;0
11124;207061;195;61;9;1;8;.889;3600000;0
11124;196352;194;47;61;10;51;.836;3600000;0
10945;194950;1505;0;0;0;0;.00nan;0;0
10945;212814;1505;43;18;3;15;.833;3600000;0
10945;-1;178;62;17;2;15;.882;1417000;0
10945;-1;178;42;42;6;36;.857;2183000;0
11044;-1;209;0;0;0;0;.00nan;0;0
11044;-1;2620;0;0;0;0;.00nan;0;0
11044;213550;2620;76;33;2;31;.939;3600000;0
11044;213590;209;91;48;3;45;.938;3555000;0
11156;209840;184;0;0;0;0;.00nan;0;0
11156;205837;184;84;13;0;13;1.000;3600000;0
11156;196088;185;95;38;1;37;.974;3600000;0
11156;-1;185;0;0;0;0;.00nan;0;0
11635;211942;183;75;29;2;27;.931;3600000;0
11635;196237;183;0;0;0;0;.00nan;0;0
11635;197672;210;0;0;0;0;.00nan;0;0
11635;-1;210;66;26;3;23;.885;3549000;0
11569;198172;181;77;23;1;22;.957;3600000;0
11569;216001;181;0;0;0;0;.00nan;0;0
11569;-1;1371;0;0;0;0;.00nan;0;0
11569;-1;1371;73;41;3;38;.927;3569000;0
11331;191118;196;100;31;0;31;1.000;3600000;0
11331;-1;190;96;45;2;43;.956;3531000;0
11331;202830;196;0;0;0;0;.00nan;0;0
11331;-1;190;0;0;0;0;.00nan;0;0
11568;183695;232;100;56;2;54;.964;3900000;0
11568;201514;227;0;0;0;0;.00nan;0;0
11568;213280;227;63;23;2;21;.913;3900000;0
11568;-1;232;0;0;0;0;.00nan;0;0
10870;191063;211;83;34;2;32;.941;3900000;0
10870;-1;211;0;0;0;0;.00nan;0;0
10870;-1;212;78;31;2;29;.935;3900000;0
10870;-1;212;0;0;0;0;.00nan;0;0
10936;200452;221;47;37;5;32;.865;2233000;0
10936;206971;4960;45;16;3;13;.813;3600000;0
10936;212304;4960;0;0;0;0;.00nan;0;0
10936;-1;221;56;13;1;12;.923;1367000;0
10766;205681;226;0;0;0;0;.00nan;0;0
10766;205769;200;0;0;0;0;.00nan;0;0
10766;212002;200;53;41;6;35;.854;3600000;0
10766;-1;226;58;25;3;22;.880;3600000;0
11004;209840;184;0;0;0;0;.00nan;0;0
11004;205837;184;79;26;2;24;.923;3583000;0
11004;185810;182;77;24;1;23;.958;3600000;0
11004;213498;182;0;0;0;0;.00nan;0;0
10744;192939;208;0;0;0;0;.00nan;0;0
10744;-1;208;80;25;1;24;.960;3600000;0
10744;203087;204;0;0;0;0;.00nan;0;0
10744;203120;204;83;41;3;38;.927;3579000;0
10834;204676;192;0;0;0;0;.00nan;0;0
10834;207398;192;50;20;3;17;.850;3900000;0
10834;-1;189;67;43;3;40;.930;3900000;0
10834;-1;189;0;0;0;0;.00nan;0;0
10863;212050;218;0;0;0;0;.00nan;0;0
10863;191130;186;0;0;0;0;.00nan;0;0
10863;208051;218;84;29;1;28;.966;3600000;0
10863;213507;186;62;32;3;29;.906;3540000;0
11051;196088;185;0;0;0;0;.00nan;0;0
11051;-1;185;58;36;4;32;.889;3587000;0
11051;-1;1371;66;21;2;19;.905;3600000;0
11051;-1;1371;0;0;0;0;.00nan;0;0
10971;200444;224;0;0;0;0;.00nan;0;0
10971;180377;228;90;35;1;34;.971;3600000;0
10971;208044;228;0;0;0;0;.00nan;0;0
10971;208372;224;73;7;0;7;1.000;3600000;0
10860;206833;4864;65;21;1;20;.952;3600000;0
10860;-1;209;92;41;2;39;.951;3600000;0
10860;202801;4864;0;0;0;0;.00nan;0;0
10860;213590;209;0;0;0;0;.00nan;0;0
10865;192862;187;82;28;1;27;.964;3593000;0
10865;198149;188;0;0;0;0;.00nan;0;0
10865;184409;188;100;47;0;47;1.000;3600000;0
10865;-1;187;0;0;0;0;.00nan;0;0
10811;213803;230;68;17;1;16;.941;3600000;0
10811;211080;229;83;37;2;35;.946;3542000;0
10811;191120;230;0;0;0;0;.00nan;0;0
10811;-1;229;0;0;0;0;.00nan;0;0
11029;213399;216;0;0;0;0;.00nan;0;0
11029;197672;210;84;35;2;33;.943;3743000;0
11029;-1;210;0;0;0;0;.00nan;0;0
11029;-1;216;46;18;3;15;.833;3743000;0
11351;199416;191;85;21;1;20;.952;3600000;0
11351;200333;194;86;63;5;58;.921;3600000;0
11351;201892;191;0;0;0;0;.00nan;0;0
11351;196352;194;0;0;0;0;.00nan;0;0
10868;210504;193;77;28;1;27;.964;3600000;0
10868;195118;197;0;0;0;0;.00nan;0;0
10868;206822;197;75;33;2;31;.939;3566000;0
10868;218059;193;0;0;0;0;.00nan;0;0
11080;201495;213;0;0;0;0;.00nan;0;0
11080;217198;213;85;39;3;36;.923;3600000;0
11080;-1;4949;42;24;4;20;.833;3565000;0
11080;-1;4949;0;0;0;0;.00nan;0;0
10929;215240;231;0;0;0;0;.00nan;0;0
10929;200444;224;0;0;0;0;.00nan;0;0
10929;189773;231;68;24;2;22;.917;3600000;0
10929;208372;224;74;40;4;36;.900;3531000;0
10900;204676;192;52;23;3;20;.870;3653000;0
10900;195118;197;65;34;4;30;.882;3653000;0
10900;206822;197;0;0;0;0;.00nan;0;0
10900;207398;192;0;0;0;0;.00nan;0;0
11095;188977;215;0;0;0;0;.00nan;0;0
11095;210794;215;100;29;0;29;1.000;3600000;0
11095;201718;217;0;0;0;0;.00nan;0;0
11095;-1;217;80;40;3;37;.925;3600000;0
10854;212050;218;59;43;5;38;.884;3600000;0
10854;196296;219;0;0;0;0;.00nan;0;0
10854;208051;218;0;0;0;0;.00nan;0;0
10854;218658;219;81;26;1;25;.962;3600000;0
10851;190164;4959;0;0;0;0;.00nan;0;0
10851;206833;4864;0;0;0;0;.00nan;0;0
10851;202801;4864;85;28;1;27;.964;3600000;0
10851;-1;4959;71;29;3;26;.897;3568000;0
10998;213803;230;37;14;3;11;.786;3527000;0
10998;183695;232;88;34;1;33;.971;3600000;0
10998;191120;230;0;0;0;0;.00nan;0;0
10998;-1;232;0;0;0;0;.00nan;0;0
10845;216313;180;77;34;2;32;.941;3545000;0
10845;208383;180;0;0;0;0;.00nan;0;0
10845;-1;212;0;0;0;0;.00nan;0;0
10845;-1;212;66;19;1;18;.947;3600000;0
10916;206801;176;85;30;2;28;.933;3549000;0
10916;-1;2620;86;29;1;28;.966;3600000;0
10916;213533;176;0;0;0;0;.00nan;0;0
10916;213550;2620;0;0;0;0;.00nan;0;0
10913;192915;179;0;0;0;0;.00nan;0;0
10913;211942;183;76;37;3;34;.919;3532000;0
10913;196237;183;0;0;0;0;.00nan;0;0
10913;187355;179;96;36;1;35;.972;3600000;0
10760;195363;222;0;0;0;0;.00nan;0;0
10760;217269;223;0;0;0;0;.00nan;0;0
10760;217312;223;56;43;6;37;.860;3600000;0
10760;213560;222;63;23;2;21;.913;3600000;0
10977;205681;226;100;24;0;24;1.000;3600000;0
10977;196283;206;0;0;0;0;.00nan;0;0
10977;-1;226;0;0;0;0;.00nan;0;0
10977;202998;206;67;28;2;26;.929;3600000;0
10903;-1;178;0;0;0;0;.00nan;0;0
10903;213399;216;75;29;2;27;.931;3600000;0
10903;-1;178;54;31;4;27;.871;3584000;0
10903;-1;216;0;0;0;0;.00nan;0;0
10996;194950;1505;0;0;0;0;.00nan;0;0
10996;196571;177;48;40;6;34;.850;3600000;0
10996;212814;1505;73;21;1;20;.952;3600000;0
10996;-1;177;0;0;0;0;.00nan;0;0
10927;198149;188;0;0;0;0;.00nan;0;0
10927;210504;193;62;24;3;21;.875;3600000;0
10927;184409;188;92;53;4;49;.925;3544000;0
10927;218059;193;0;0;0;0;.00nan;0;0
10764;205769;200;60;30;3;27;.900;3600000;0
10764;205788;207;0;0;0;0;.00nan;0;0
10764;212002;200;0;0;0;0;.00nan;0;0
10764;197853;207;67;42;4;38;.905;3561000;0
11255;206971;4960;0;0;0;0;.00nan;0;0
11255;212304;4960;63;13;1;12;.923;3600000;0
11255;180377;228;92;37;2;35;.946;3600000;0
11255;208044;228;0;0;0;0;.00nan;0;0
10805;201524;205;0;0;0;0;.00nan;0;0
10805;-1;199;0;0;0;0;.00nan;0;0
10805;-1;199;97;53;3;50;.943;3570000;0
10805;-1;205;51;13;2;11;.846;3600000;0
10771;200437;201;87;30;1;29;.967;3600000;0
10771;201525;203;86;44;2;42;.955;3599000;0
10771;206772;203;0;0;0;0;.00nan;0;0
10771;208048;201;0;0;0;0;.00nan;0;0
10962;182014;214;0;0;0;0;.00nan;0;0
10962;185810;182;0;0;0;0;.00nan;0;0
10962;202914;214;99;49;1;48;.980;3600000;0
10962;213498;182;55;23;2;21;.913;3563000;0
10809;192862;187;0;0;0;0;.00nan;0;0
10809;-1;189;0;0;0;0;.00nan;0;0
10809;-1;187;59;33;4;29;.879;3600000;0
10809;-1;189;79;30;2;28;.933;3600000;0
10951;215703;195;0;0;0;0;.00nan;0;0
10951;212143;198;59;32;4;28;.875;2323000;0
10951;207061;195;62;24;2;22;.917;3600000;0
10951;212649;198;56;14;1;13;.929;1277000;0
10969;191118;196;75;34;3;31;.912;3600000;0
10969;-1;190;48;38;5;33;.868;3583000;0
10969;202830;196;0;0;0;0;.00nan;0;0
10969;-1;190;0;0;0;0;.00nan;0;0
10869;198172;181;0;0;0;0;.00nan;0;0
10869;216001;181;65;29;3;26;.897;3707000;0
10869;211017;220;72;30;2;28;.933;3707000;0
10869;218510;220;0;0;0;0;.00nan;0;0
10937;192939;208;98;27;0;27;1.000;3600000;0
10937;216114;202;0;0;0;0;.00nan;0;0
10937;201560;202;53;30;4;26;.867;3600000;0
10937;-1;208;0;0;0;0;.00nan;0;0
10815;211080;229;0;0;0;0;.00nan;0;0
10815;206800;225;0;0;0;0;.00nan;0;0
10815;-1;225;100;29;0;29;1.000;3600000;0
10815;-1;229;68;36;3;33;.917;3600000;0
10787;205788;207;96;21;0;21;1.000;3600000;0
10787;-1;199;80;30;2;28;.933;3600000;0
10787;197853;207;0;0;0;0;.00nan;0;0
10787;-1;199;0;0;0;0;.00nan;0;0
10947;192915;179;0;0;0;0;.00nan;0;0
10947;187355;179;83;28;1;27;.964;3600000;0
10947;197672;210;0;0;0;0;.00nan;0;0
10947;-1;210;70;26;2;24;.923;3558000;0
10876;200452;221;70;21;1;20;.952;3600000;0
10876;217269;223;58;37;4;33;.892;3600000;0
10876;217312;223;0;0;0;0;.00nan;0;0
10876;-1;221;0;0;0;0;.00nan;0;0
10897;200437;201;100;40;1;39;.975;3600000;0
10897;201525;203;51;20;3;17;.850;3573000;0
10897;206772;203;0;0;0;0;.00nan;0;0
10897;208048;201;0;0;0;0;.00nan;0;0
10907;216313;180;0;0;0;0;.00nan;0;0
10907;196296;219;65;24;3;21;.875;3900000;0
10907;218658;219;0;0;0;0;.00nan;0;0
10907;208383;180;59;27;3;24;.889;3900000;0
11434;201514;227;0;0;0;0;.00nan;0;0
11434;206971;4960;95;18;0;18;1.000;3600000;0
11434;212304;4960;0;0;0;0;.00nan;0;0
11434;213280;227;79;44;3;41;.932;3600000;0
11017;188977;215;0;0;0;0;.00nan;0;0
11017;210794;215;57;32;4;28;.875;3550000;0
11017;191130;186;0;0;0;0;.00nan;0;0
11017;213507;186;57;17;2;15;.882;3600000;0
11673;183695;232;28;33;6;27;.818;3003000;0
11673;200444;224;68;14;1;13;.929;3600000;0
11673;208372;224;0;0;0;0;.00nan;0;0
11673;-1;232;40;11;2;9;.818;597000;0
11023;196088;185;92;47;2;45;.957;3753000;0
11023;185810;182;67;34;3;31;.912;3753000;0
11023;-1;185;0;0;0;0;.00nan;0;0
11023;213498;182;0;0;0;0;.00nan;0;0
11031;209840;184;19;7;4;3;.429;1063000;0
11031;205837;184;62;14;1;13;.929;2537000;0
11031;182014;214;0;0;0;0;.00nan;0;0
11031;202914;214;88;32;1;31;.969;3600000;0
10776;192939;208;61;24;3;21;.875;3583000;0
10776;205769;200;0;0;0;0;.00nan;0;0
10776;212002;200;99;49;2;47;.959;3600000;0
10776;-1;208;0;0;0;0;.00nan;0;0
10955;204676;192;0;0;0;0;.00nan;0;0
10955;210504;193;92;31;1;30;.968;3600000;0
10955;207398;192;88;52;3;49;.942;3563000;0
10955;218059;193;0;0;0;0;.00nan;0;0
10883;198172;181;58;41;5;36;.878;3900000;0
10883;216001;181;0;0;0;0;.00nan;0;0
10883;211017;220;0;0;0;0;.00nan;0;0
10883;218510;220;61;44;5;39;.886;3900000;0
10966;201524;205;0;0;0;0;.00nan;0;0
10966;-1;205;40;27;5;22;.815;3600000;0
10966;203087;204;0;0;0;0;.00nan;0;0
10966;203120;204;39;36;6;30;.833;3544000;0
11001;215240;231;57;26;4;22;.846;3600000;0
11001;189773;231;0;0;0;0;.00nan;0;0
11001;180377;228;63;40;5;35;.875;3572000;0
11001;208044;228;0;0;0;0;.00nan;0;0
11036;201495;213;0;0;0;0;.00nan;0;0
11036;217198;213;72;30;3;27;.900;3600000;0
11036;197672;210;69;34;4;30;.882;3600000;0
11036;-1;210;0;0;0;0;.00nan;0;0
10940;195118;197;0;0;0;0;.00nan;0;0
10940;206822;197;35;30;6;24;.800;3564000;0
10940;-1;190;72;50;5;45;.900;3600000;0
10940;-1;190;0;0;0;0;.00nan;0;0
11065;194950;1505;0;0;0;0;.00nan;0;0
11065;212814;1505;75;44;5;39;.886;3600000;0
11065;-1;4949;87;31;1;30;.968;3600000;0
11065;-1;4949;0;0;0;0;.00nan;0;0
10837;192862;187;39;19;4;15;.789;3548000;0
10837;-1;189;96;38;2;36;.947;3600000;0
10837;-1;187;0;0;0;0;.00nan;0;0
10837;-1;189;0;0;0;0;.00nan;0;0
10887;198149;188;73;33;3;30;.909;3600000;0
10887;184409;188;0;0;0;0;.00nan;0;0
10887;191118;196;66;35;4;31;.886;3600000;0
10887;202830;196;0;0;0;0;.00nan;0;0
10862;190164;4959;50;22;4;18;.818;2503000;0
10862;-1;209;100;34;0;34;1.000;3328000;0
10862;-1;4959;35;12;4;8;.667;1097000;0
10862;213590;209;25;4;3;1;.250;272000;0
10997;196571;177;94;34;1;33;.971;3600000;0
10997;-1;178;0;0;0;0;.00nan;0;0
10997;-1;178;100;39;0;39;1.000;3600000;0
10997;-1;177;0;0;0;0;.00nan;0;0
10843;212050;218;0;0;0;0;.00nan;0;0
10843;191063;211;0;0;0;0;.00nan;0;0
10843;208051;218;68;18;1;17;.944;3900000;0
10843;-1;211;100;40;1;39;.975;3900000;0
11082;200333;194;72;14;0;14;1.000;836000;0
11082;212143;198;88;30;1;29;.967;3600000;0
11082;196352;194;44;37;6;31;.838;2764000;0
11082;212649;198;0;0;0;0;.00nan;0;0
10914;206801;176;49;39;5;34;.872;3586000;0
10914;206833;4864;50;30;4;26;.867;3600000;0
10914;202801;4864;0;0;0;0;.00nan;0;0
10914;213533;176;0;0;0;0;.00nan;0;0
10880;201718;217;0;0;0;0;.00nan;0;0
10880;-1;217;69;31;2;29;.935;3533000;0
10880;-1;212;100;25;0;25;1.000;3600000;0
10880;-1;212;0;0;0;0;.00nan;0;0
10790;195363;222;75;26;1;25;.962;3600000;0
10790;206800;225;0;0;0;0;.00nan;0;0
10790;-1;225;100;29;0;29;1.000;3600000;0
10790;213560;222;0;0;0;0;.00nan;0;0
11166;209840;184;94;32;1;31;.969;3600000;0
11166;205837;184;0;0;0;0;.00nan;0;0
11166;196088;185;0;0;0;0;.00nan;0;0
11166;-1;185;74;37;3;34;.919;3543000;0
10895;211017;220;100;27;0;27;1.000;3600000;0
10895;182014;214;34;26;6;20;.769;3004000;0
10895;218510;220;0;0;0;0;.00nan;0;0
10895;202914;214;60;5;0;5;1.000;596000;0
10890;190164;4959;0;0;0;0;.00nan;0;0
10890;-1;4959;82;62;5;57;.919;3600000;0
10890;-1;2620;0;0;0;0;.00nan;0;0
10890;213550;2620;54;10;2;8;.800;3600000;0
10889;195363;222;0;0;0;0;.00nan;0;0
10889;206800;225;0;0;0;0;.00nan;0;0
10889;-1;225;53;32;4;28;.875;3517000;0
10889;213560;222;64;21;2;19;.905;3600000;0
10934;188977;215;0;0;0;0;.00nan;0;0
10934;210794;215;54;41;5;36;.878;3565000;0
10934;201718;217;79;33;3;30;.909;3600000;0
10934;-1;217;0;0;0;0;.00nan;0;0
11022;-1;178;0;0;0;0;.00nan;0;0
11022;213399;216;0;0;0;0;.00nan;0;0
11022;-1;178;69;34;3;31;.912;3600000;0
11022;-1;216;57;21;2;19;.905;3600000;0
10924;192915;179;0;0;0;0;.00nan;0;0
10924;196571;177;0;0;0;0;.00nan;0;0
10924;187355;179;65;21;2;19;.905;3600000;0
10924;-1;177;49;32;5;27;.844;3600000;0
10873;196296;219;0;0;0;0;.00nan;0;0
10873;191063;211;70;31;2;29;.935;3582000;0
10873;-1;211;0;0;0;0;.00nan;0;0
10873;218658;219;76;27;1;26;.963;3600000;0
10867;201524;205;62;17;2;15;.882;3600000;0
10867;-1;199;59;41;4;37;.902;3580000;0
10867;-1;199;0;0;0;0;.00nan;0;0
10867;-1;205;0;0;0;0;.00nan;0;0
10877;213803;230;55;27;4;23;.852;3891000;0
10877;200452;221;0;0;0;0;.00nan;0;0
10877;191120;230;0;0;0;0;.00nan;0;0
10877;-1;221;52;35;4;31;.886;3900000;0
10773;200437;201;42;15;3;12;.800;3555000;0
10773;216114;202;0;0;0;0;.00nan;0;0
10773;201560;202;91;35;1;34;.971;3600000;0
10773;208048;201;0;0;0;0;.00nan;0;0
11458;199416;191;0;0;0;0;.00nan;0;0
11458;200333;194;80;46;4;42;.913;3528000;0
11458;201892;191;59;13;2;11;.846;3600000;0
11458;196352;194;0;0;0;0;.00nan;0;0
11076;198172;181;0;0;0;0;.00nan;0;0
11076;216001;181;73;25;1;24;.960;3900000;0
11076;-1;1371;88;36;1;35;.972;3900000;0
11076;-1;1371;0;0;0;0;.00nan;0;0
11159;194950;1505;57;16;2;14;.875;3600000;0
11159;212814;1505;0;0;0;0;.00nan;0;0
11159;-1;4949;88;42;3;39;.929;3584000;0
11159;-1;4949;0;0;0;0;.00nan;0;0
11016;215703;195;0;0;0;0;.00nan;0;0
11016;207061;195;79;13;0;13;1.000;3600000;0
11016;191118;196;68;46;5;41;.891;3600000;0
11016;202830;196;0;0;0;0;.00nan;0;0
11010;215240;231;0;0;0;0;.00nan;0;0
11010;200444;224;50;36;5;31;.861;3600000;0
11010;189773;231;91;19;0;19;1.000;3600000;0
11010;208372;224;0;0;0;0;.00nan;0;0
10982;205681;226;80;25;1;24;.960;3600000;0
10982;205788;207;75;42;4;38;.905;3600000;0
10982;-1;226;0;0;0;0;.00nan;0;0
10982;197853;207;0;0;0;0;.00nan;0;0
11627;192915;179;0;0;0;0;.00nan;0;0
11627;187355;179;73;21;1;20;.952;3600000;0
11627;213399;216;56;26;3;23;.885;3561000;0
11627;-1;216;0;0;0;0;.00nan;0;0
10992;196283;206;0;0;0;0;.00nan;0;0
10992;202998;206;48;27;4;23;.852;3578000;0
10992;203087;204;0;0;0;0;.00nan;0;0
10992;203120;204;57;24;3;21;.875;3600000;0
11292;216313;180;60;30;3;27;.900;3549000;0
11292;191130;186;0;0;0;0;.00nan;0;0
11292;213507;186;66;25;2;23;.920;3600000;0
11292;208383;180;0;0;0;0;.00nan;0;0
11059;206801;176;93;37;2;35;.946;3732000;0
11059;-1;209;70;35;3;32;.914;3732000;0
11059;213533;176;0;0;0;0;.00nan;0;0
11059;213590;209;0;0;0;0;.00nan;0;0
11621;201495;213;0;0;0;0;.00nan;0;0
11621;211942;183;61;12;1;11;.917;3600000;0
11621;196237;183;0;0;0;0;.00nan;0;0
11621;217198;213;96;45;2;43;.956;3600000;0
10879;211080;229;72;46;4;42;.913;3900000;0
10879;201514;227;68;35;4;31;.886;3900000;0
10879;213280;227;0;0;0;0;.00nan;0;0
10879;-1;229;0;0;0;0;.00nan;0;0
11220;216114;202;64;38;4;34;.895;3900000;0
11220;201525;203;65;39;4;35;.897;3900000;0
11220;201560;202;0;0;0;0;.00nan;0;0
11220;206772;203;0;0;0;0;.00nan;0;0
11174;200452;221;68;28;2;26;.929;3600000;0
11174;217269;223;0;0;0;0;.00nan;0;0
11174;217312;223;91;36;1;35;.972;3600000;0
11174;-1;221;0;0;0;0;.00nan;0;0
10942;206833;4864;0;0;0;0;.00nan;0;0
10942;202801;4864;91;30;1;29;.967;3600000;0
10942;-1;2620;77;31;2;29;.935;3551000;0
10942;213550;2620;0;0;0;0;.00nan;0;0
11048;215703;195;0;0;0;0;.00nan;0;0
11048;207061;195;48;21;3;18;.857;3600000;0
11048;-1;190;0;0;0;0;.00nan;0;0
11048;-1;190;45;42;6;36;.857;3600000;0
11134;196296;219;0;0;0;0;.00nan;0;0
11134;191130;186;0;0;0;0;.00nan;0;0
11134;218658;219;60;28;3;25;.893;3558000;0
11134;213507;186;99;35;1;34;.971;3600000;0
11185;209840;184;26;32;6;26;.813;3021000;0
11185;205837;184;55;5;0;5;1.000;579000;0
11185;185810;182;93;24;0;24;1.000;3600000;0
11185;213498;182;0;0;0;0;.00nan;0;0
11608;200333;194;0;0;0;0;.00nan;0;0
11608;196352;194;100;39;2;37;.949;3900000;0
11608;-1;190;74;27;2;25;.926;3900000;0
11608;-1;190;0;0;0;0;.00nan;0;0
11191;213803;230;48;13;2;11;.846;3600000;0
11191;183695;232;39;42;6;36;.857;2695000;0
11191;191120;230;0;0;0;0;.00nan;0;0
11191;-1;232;45;5;1;4;.800;905000;0
10884;191063;211;55;39;5;34;.872;3600000;0
10884;-1;211;0;0;0;0;.00nan;0;0
10884;-1;212;85;33;2;31;.939;3600000;0
10884;-1;212;0;0;0;0;.00nan;0;0
10918;192862;187;92;39;2;37;.949;3564000;0
10918;199416;191;0;0;0;0;.00nan;0;0
10918;201892;191;74;22;1;21;.955;3600000;0
10918;-1;187;0;0;0;0;.00nan;0;0
11052;211017;220;69;39;4;35;.897;3588000;0
11052;218510;220;0;0;0;0;.00nan;0;0
11052;-1;1371;71;35;3;32;.914;3600000;0
11052;-1;1371;0;0;0;0;.00nan;0;0
10893;195363;222;80;25;1;24;.960;3600000;0
10893;180377;228;78;34;2;32;.941;3549000;0
10893;208044;228;0;0;0;0;.00nan;0;0
10893;213560;222;0;0;0;0;.00nan;0;0
11033;205788;207;0;0;0;0;.00nan;0;0
11033;201525;203;74;36;3;33;.917;3636000;0
11033;206772;203;0;0;0;0;.00nan;0;0
11033;197853;207;44;25;4;21;.840;3636000;0
10922;200437;201;49;35;5;30;.857;3573000;0
10922;205769;200;0;0;0;0;.00nan;0;0
10922;212002;200;92;42;3;39;.929;3600000;0
10922;208048;201;0;0;0;0;.00nan;0;0
10952;196283;206;0;0;0;0;.00nan;0;0
10952;-1;199;0;0;0;0;.00nan;0;0
10952;-1;199;57;48;6;42;.875;3600000;0
10952;202998;206;79;29;2;27;.931;3600000;0
11097;-1;178;0;0;0;0;.00nan;0;0
11097;-1;4949;67;28;3;25;.893;3673000;0
11097;-1;4949;0;0;0;0;.00nan;0;0
11097;-1;178;74;27;2;25;.926;3673000;0
11050;198149;188;0;0;0;0;.00nan;0;0
11050;184409;188;88;30;1;29;.967;3600000;0
11050;191118;196;62;29;3;26;.897;3600000;0
11050;202830;196;0;0;0;0;.00nan;0;0
11006;201495;213;0;0;0;0;.00nan;0;0
11006;217198;213;69;39;3;36;.923;3701000;0
11006;196571;177;48;17;2;15;.882;3701000;0
11006;-1;177;0;0;0;0;.00nan;0;0
11057;196088;185;80;39;2;37;.949;3900000;0
11057;182014;214;0;0;0;0;.00nan;0;0
11057;-1;185;0;0;0;0;.00nan;0;0
11057;202914;214;87;35;2;33;.943;3900000;0
10965;192939;208;68;25;2;23;.920;3900000;0
10965;216114;202;0;0;0;0;.00nan;0;0
10965;201560;202;90;38;2;36;.947;3900000;0
10965;-1;208;0;0;0;0;.00nan;0;0
10931;190164;4959;81;32;2;30;.938;3600000;0
10931;206833;4864;51;27;4;23;.852;3534000;0
10931;202801;4864;0;0;0;0;.00nan;0;0
10931;-1;4959;0;0;0;0;.00nan;0;0
10988;195118;197;0;0;0;0;.00nan;0;0
10988;206822;197;77;40;3;37;.925;3551000;0
10988;212143;198;53;10;1;9;.900;3600000;0
10988;212649;198;0;0;0;0;.00nan;0;0
10985;215240;231;0;0;0;0;.00nan;0;0
10985;189773;231;75;12;0;12;1.000;3600000;0
10985;211080;229;86;51;5;46;.902;3600000;0
10985;-1;229;0;0;0;0;.00nan;0;0
11069;-1;209;0;0;0;0;.00nan;0;0
11069;-1;2620;0;0;0;0;.00nan;0;0
11069;213550;2620;57;25;3;22;.880;3600000;0
11069;213590;209;64;33;4;29;.879;3575000;0
10958;192862;187;0;0;0;0;.00nan;0;0
10958;200333;194;82;42;4;38;.905;3600000;0
10958;196352;194;0;0;0;0;.00nan;0;0
10958;-1;187;77;21;1;20;.952;3600000;0
10930;205681;226;0;0;0;0;.00nan;0;0
10930;205769;200;59;34;3;31;.912;3521000;0
10930;212002;200;0;0;0;0;.00nan;0;0
10930;-1;226;77;25;1;24;.960;3600000;0
10872;216313;180;77;24;1;23;.958;3544000;0
10872;212050;218;0;0;0;0;.00nan;0;0
10872;208051;218;92;21;0;21;1.000;3600000;0
10872;208383;180;0;0;0;0;.00nan;0;0
10909;200437;201;29;7;3;4;.571;529000;0
10909;196283;206;27;7;3;4;.571;337000;0
10909;208048;201;96;30;1;29;.967;3071000;0
10909;202998;206;48;20;3;17;.850;3206000;0
11035;200444;224;64;18;1;17;.944;3600000;0
11035;200452;221;50;38;6;32;.842;3600000;0
11035;208372;224;0;0;0;0;.00nan;0;0
11035;-1;221;0;0;0;0;.00nan;0;0
10933;196296;219;96;36;2;34;.944;3900000;0
10933;191130;186;77;28;2;26;.929;3900000;0
10933;218658;219;0;0;0;0;.00nan;0;0
10933;213507;186;0;0;0;0;.00nan;0;0
10973;-1;199;68;50;5;45;.900;3554000;0
10973;-1;199;0;0;0;0;.00nan;0;0
10973;203087;204;0;0;0;0;.00nan;0;0
10973;203120;204;55;30;4;26;.867;3600000;0
11273;213803;230;77;22;1;21;.955;3600000;0
11273;217269;223;49;41;6;35;.854;3281000;0
11273;217312;223;45;4;1;3;.750;319000;0
11273;191120;230;0;0;0;0;.00nan;0;0
10882;201718;217;0;0;0;0;.00nan;0;0
10882;-1;217;75;28;2;26;.929;3600000;0
10882;-1;212;0;0;0;0;.00nan;0;0
10882;-1;212;58;26;3;23;.885;3600000;0
11032;215703;195;0;0;0;0;.00nan;0;0
11032;207061;195;73;21;1;20;.952;3600000;0
11032;191118;196;0;0;0;0;.00nan;0;0
11032;202830;196;98;50;3;47;.940;3600000;0
11087;195363;222;0;0;0;0;.00nan;0;0
11087;206971;4960;68;22;2;20;.909;3600000;0
11087;212304;4960;0;0;0;0;.00nan;0;0
11087;213560;222;66;41;4;37;.902;3600000;0
10950;190164;4959;42;3;1;2;.667;358000;0
10950;206801;176;85;30;2;28;.933;3600000;0
10950;-1;4959;49;36;6;30;.833;3242000;0
10950;213533;176;0;0;0;0;.00nan;0;0
11009;211080;229;96;53;2;51;.962;3570000;0
11009;201514;227;0;0;0;0;.00nan;0;0
11009;213280;227;91;22;0;22;1.000;3600000;0
11009;-1;229;0;0;0;0;.00nan;0;0
11228;199416;191;74;22;1;21;.955;3600000;0
11228;201892;191;0;0;0;0;.00nan;0;0
11228;-1;189;0;0;0;0;.00nan;0;0
11228;-1;189;45;44;6;38;.864;3600000;0
11002;205788;207;57;41;4;37;.902;3600000;0
11002;201524;205;0;0;0;0;.00nan;0;0
11002;197853;207;0;0;0;0;.00nan;0;0
11002;-1;205;62;20;2;18;.900;3600000;0
10925;206800;225;0;0;0;0;.00nan;0;0
10925;180377;228;74;34;3;31;.912;3534000;0
10925;-1;225;92;28;1;27;.964;3600000;0
10925;208044;228;0;0;0;0;.00nan;0;0
10968;188977;215;56;23;3;20;.870;3600000;0
10968;210794;215;0;0;0;0;.00nan;0;0
10968;191063;211;0;0;0;0;.00nan;0;0
10968;-1;211;55;45;6;39;.867;3600000;0
11000;192915;179;0;0;0;0;.00nan;0;0
11000;187355;179;100;30;0;30;1.000;3600000;0
11000;213399;216;0;0;0;0;.00nan;0;0
11000;-1;216;90;36;1;35;.972;3600000;0
11098;198172;181;64;15;1;14;.933;3600000;0
11098;209840;184;0;0;0;0;.00nan;0;0
11098;205837;184;57;33;4;29;.879;3600000;0
11098;216001;181;0;0;0;0;.00nan;0;0
11147;210504;193;90;31;1;30;.968;3600000;0
11147;195118;197;59;37;4;33;.892;3600000;0
11147;206822;197;0;0;0;0;.00nan;0;0
11147;218059;193;0;0;0;0;.00nan;0;0
10964;204676;192;0;0;0;0;.00nan;0;0
10964;212143;198;0;0;0;0;.00nan;0;0
10964;212649;198;70;29;2;27;.931;3900000;0
10964;207398;192;79;31;2;29;.935;3900000;0
10970;211017;220;0;0;0;0;.00nan;0;0
10970;196088;185;47;3;1;2;.667;352000;0
10970;-1;185;38;26;5;21;.808;3222000;0
10970;218510;220;67;45;4;41;.911;3600000;0
11013;198149;188;0;0;0;0;.00nan;0;0
11013;184409;188;84;46;3;43;.935;3600000;0
11013;-1;190;74;39;4;35;.897;3545000;0
11013;-1;190;0;0;0;0;.00nan;0;0
11106;198172;181;0;0;0;0;.00nan;0;0
11106;216001;181;69;38;4;34;.895;3548000;0
11106;185810;182;84;41;2;39;.951;3600000;0
11106;213498;182;0;0;0;0;.00nan;0;0
11141;211942;183;81;31;2;29;.935;3600000;0
11141;196237;183;0;0;0;0;.00nan;0;0
11141;-1;4949;52;35;6;29;.829;3171000;0
11141;-1;4949;32;3;2;1;.333;429000;0
10905;188977;215;0;0;0;0;.00nan;0;0
10905;210794;215;100;36;0;36;1.000;3600000;0
10905;212050;218;0;0;0;0;.00nan;0;0
10905;208051;218;97;32;1;31;.969;3546000;0
11133;194950;1505;56;11;1;10;.909;3600000;0
11133;212814;1505;0;0;0;0;.00nan;0;0
11133;-1;178;0;0;0;0;.00nan;0;0
11133;-1;178;78;59;5;54;.915;3600000;0
11346;183695;232;74;24;2;22;.917;3600000;0
11346;217269;223;0;0;0;0;.00nan;0;0
11346;217312;223;59;34;4;30;.882;3560000;0
11346;-1;232;0;0;0;0;.00nan;0;0
11040;210504;193;0;0;0;0;.00nan;0;0
11040;215703;195;76;25;1;24;.960;3600000;0
11040;207061;195;0;0;0;0;.00nan;0;0
11040;218059;193;65;28;2;26;.929;3600000;0
10949;192915;179;0;0;0;0;.00nan;0;0
10949;201495;213;0;0;0;0;.00nan;0;0
10949;217198;213;64;45;5;40;.889;3600000;0
10949;187355;179;67;7;0;7;1.000;3600000;0
10901;191130;186;0;0;0;0;.00nan;0;0
10901;213507;186;54;42;5;37;.881;3600000;0
10901;-1;212;68;26;2;24;.923;3600000;0
10901;-1;212;0;0;0;0;.00nan;0;0
11449;209840;184;0;0;0;0;.00nan;0;0
11449;205837;184;64;37;4;33;.892;3537000;0
11449;-1;1371;0;0;0;0;.00nan;0;0
11449;-1;1371;77;28;2;26;.929;3600000;0
11466;199416;191;0;0;0;0;.00nan;0;0
11466;200333;194;27;16;5;11;.688;1293000;0
11466;201892;191;97;18;0;18;1.000;3600000;0
11466;196352;194;36;28;6;22;.786;2307000;0
10944;205769;200;0;0;0;0;.00nan;0;0
10944;212002;200;97;39;2;37;.949;3732000;0
10944;203087;204;69;34;3;31;.912;3732000;0
10944;203120;204;0;0;0;0;.00nan;0;0
10957;198149;188;100;41;1;40;.976;3600000;0
10957;184409;188;0;0;0;0;.00nan;0;0
10957;-1;190;33;25;5;20;.800;3600000;0
10957;-1;190;0;0;0;0;.00nan;0;0
11375;213803;230;97;59;4;55;.932;3600000;0
11375;206971;4960;66;13;1;12;.923;3600000;0
11375;212304;4960;0;0;0;0;.00nan;0;0
11375;191120;230;0;0;0;0;.00nan;0;0
10994;201524;205;0;0;0;0;.00nan;0;0
10994;196283;206;45;36;5;31;.861;3129000;0
10994;-1;205;69;19;1;18;.947;3600000;0
10994;202998;206;47;7;1;6;.857;471000;0
11063;-1;209;71;37;4;33;.892;3600000;0
11063;-1;2620;68;23;2;21;.913;3600000;0
11063;213550;2620;0;0;0;0;.00nan;0;0
11063;213590;209;0;0;0;0;.00nan;0;0
10932;192862;187;92;43;3;40;.930;3520000;0
10932;204676;192;0;0;0;0;.00nan;0;0
10932;207398;192;81;21;1;20;.952;3600000;0
10932;-1;187;0;0;0;0;.00nan;0;0
11256;194950;1505;0;0;0;0;.00nan;0;0
11256;211942;183;0;0;0;0;.00nan;0;0
11256;196237;183;63;32;3;29;.906;3576000;0
11256;212814;1505;73;17;1;16;.941;3600000;0
10923;216313;180;56;17;2;15;.882;3641000;0
10923;196296;219;0;0;0;0;.00nan;0;0
10923;218658;219;86;40;3;37;.925;3641000;0
10923;208383;180;0;0;0;0;.00nan;0;0
10986;205681;226;0;0;0;0;.00nan;0;0
10986;205788;207;0;0;0;0;.00nan;0;0
10986;-1;226;77;34;2;32;.941;3900000;0
10986;197853;207;84;37;2;35;.946;3900000;0
10983;215240;231;0;0;0;0;.00nan;0;0
10983;200452;221;57;39;5;34;.872;3600000;0
10983;189773;231;97;19;0;19;1.000;3600000;0
10983;-1;221;0;0;0;0;.00nan;0;0
10993;200444;224;78;13;0;13;1.000;3600000;0
10993;206800;225;42;12;2;10;.833;1207000;0
10993;-1;225;32;27;6;21;.778;2393000;0
10993;208372;224;0;0;0;0;.00nan;0;0
11160;195118;197;0;0;0;0;.00nan;0;0
11160;206822;197;70;28;3;25;.893;3600000;0
11160;-1;189;0;0;0;0;.00nan;0;0
11160;-1;189;55;36;5;31;.861;3526000;0
10989;201560;202;84;27;1;26;.963;3600000;0
10989;208067;202;0;0;0;0;.00nan;0;0
10989;-1;199;0;0;0;0;.00nan;0;0
10989;-1;199;72;34;3;31;.912;3600000;0
10954;212050;218;63;24;2;22;.917;3600000;0
10954;191063;211;0;0;0;0;.00nan;0;0
10954;208051;218;0;0;0;0;.00nan;0;0
10954;-1;211;86;50;4;46;.920;3600000;0
11229;-1;178;74;28;2;26;.929;3600000;0
11229;197672;210;0;0;0;0;.00nan;0;0
11229;-1;178;0;0;0;0;.00nan;0;0
11229;-1;210;34;29;5;24;.828;3600000;0
11620;201514;227;0;0;0;0;.00nan;0;0
11620;217269;223;63;39;5;34;.872;3600000;0
11620;217312;223;0;0;0;0;.00nan;0;0
11620;213280;227;88;33;1;32;.970;3600000;0
11110;200444;224;77;25;1;24;.960;3600000;0
11110;206971;4960;0;0;0;0;.00nan;0;0
11110;212304;4960;52;27;4;23;.852;3600000;0
11110;208372;224;0;0;0;0;.00nan;0;0
10995;204676;192;66;25;3;22;.880;3584000;0
10995;212143;198;67;27;2;25;.926;3600000;0
10995;212649;198;0;0;0;0;.00nan;0;0
10995;207398;192;0;0;0;0;.00nan;0;0
11130;201524;205;62;29;3;26;.897;3600000;0
11130;201525;203;50;29;5;24;.828;3511000;0
11130;206772;203;0;0;0;0;.00nan;0;0
11130;-1;205;0;0;0;0;.00nan;0;0
11058;211017;220;68;41;5;36;.878;3600000;0
11058;185810;182;100;24;0;24;1.000;3600000;0
11058;218510;220;0;0;0;0;.00nan;0;0
11058;213498;182;0;0;0;0;.00nan;0;0
11171;216313;180;0;0;0;0;.00nan;0;0
11171;201718;217;64;20;1;19;.950;1243000;0
11171;-1;217;16;25;7;18;.720;2357000;0
11171;208383;180;54;18;2;16;.889;3600000;0
11121;198172;181;94;37;2;35;.946;3541000;0
11121;216001;181;0;0;0;0;.00nan;0;0
11121;182014;214;0;0;0;0;.00nan;0;0
11121;202914;214;94;34;1;33;.971;3600000;0
11083;215240;231;0;0;0;0;.00nan;0;0
11083;200452;221;0;0;0;0;.00nan;0;0
11083;189773;231;54;15;2;13;.867;3600000;0
11083;-1;221;64;52;5;47;.904;3600000;0
11086;206801;176;91;40;2;38;.950;3563000;0
11086;-1;2620;0;0;0;0;.00nan;0;0
11086;213533;176;0;0;0;0;.00nan;0;0
11086;213550;2620;76;22;1;21;.955;3600000;0
11126;195363;222;70;23;2;21;.913;3600000;0
11126;206800;225;0;0;0;0;.00nan;0;0
11126;-1;225;60;32;4;28;.875;3546000;0
11126;213560;222;0;0;0;0;.00nan;0;0
10948;211080;229;0;0;0;0;.00nan;0;0
10948;180377;228;0;0;0;0;.00nan;0;0
10948;208044;228;68;21;1;20;.952;3600000;0
10948;-1;229;71;38;3;35;.921;3547000;0
11034;192939;208;51;34;5;29;.853;3600000;0
11034;205681;226;0;0;0;0;.00nan;0;0
11034;-1;226;72;21;1;20;.952;3600000;0
11034;-1;208;0;0;0;0;.00nan;0;0
10941;200437;201;0;0;0;0;.00nan;0;0
10941;201560;202;73;28;2;26;.929;3576000;0
10941;208048;201;89;18;0;18;1.000;3600000;0
10941;208067;202;0;0;0;0;.00nan;0;0
11012;196571;177;0;0;0;0;.00nan;0;0
11012;213399;216;0;0;0;0;.00nan;0;0
11012;-1;216;79;31;2;29;.935;3600000;0
11012;-1;177;62;30;3;27;.900;3585000;0
11547;194950;1505;46;26;4;22;.846;3600000;0
11547;212814;1505;0;0;0;0;.00nan;0;0
11547;197672;210;44;39;6;33;.846;3600000;0
11547;-1;210;0;0;0;0;.00nan;0;0
11150;201525;203;0;0;0;0;.00nan;0;0
11150;206772;203;65;31;4;27;.871;3545000;0
11150;203087;204;0;0;0;0;.00nan;0;0
11150;203120;204;77;36;3;33;.917;3600000;0
11164;210504;193;68;35;3;32;.914;3900000;0
11164;218059;193;0;0;0;0;.00nan;0;0
11164;191118;196;74;38;3;35;.921;3900000;0
11164;202830;196;0;0;0;0;.00nan;0;0
11074;196088;185;54;35;4;31;.886;3538000;0
11074;182014;214;100;41;2;39;.951;3600000;0
11074;-1;185;0;0;0;0;.00nan;0;0
11074;202914;214;0;0;0;0;.00nan;0;0
11658;199416;191;0;0;0;0;.00nan;0;0
11658;201892;191;85;32;1;31;.969;3600000;0
11658;-1;190;58;48;5;43;.896;3600000;0
11658;-1;190;0;0;0;0;.00nan;0;0
11039;206801;176;63;46;6;40;.870;2859000;0
11039;206833;4864;0;0;0;0;.00nan;0;0
11039;202801;4864;83;29;1;28;.966;3600000;0
11039;213533;176;63;9;0;9;1.000;741000;0
10953;190164;4959;0;0;0;0;.00nan;0;0
10953;-1;209;0;0;0;0;.00nan;0;0
10953;-1;4959;41;31;5;26;.839;3600000;0
10953;213590;209;100;27;0;27;1.000;3600000;0
11266;211942;183;36;36;6;30;.833;3600000;0
11266;196237;183;0;0;0;0;.00nan;0;0
11266;-1;4949;0;0;0;0;.00nan;0;0
11266;-1;4949;100;34;0;34;1.000;3600000;0
11045;201495;213;0;0;0;0;.00nan;0;0
11045;217198;213;100;44;1;43;.977;3900000;0
11045;196571;177;61;17;1;16;.941;3900000;0
11045;-1;177;0;0;0;0;.00nan;0;0
11402;183695;232;77;31;1;30;.968;3600000;0
11402;200452;221;96;34;2;32;.941;3600000;0
11402;-1;221;0;0;0;0;.00nan;0;0
11402;-1;232;0;0;0;0;.00nan;0;0
11332;188977;215;0;0;0;0;.00nan;0;0
11332;210794;215;72;37;3;34;.919;3600000;0
11332;201718;217;0;0;0;0;.00nan;0;0
11332;-1;217;100;29;0;29;1.000;3600000;0
11014;192915;179;0;0;0;0;.00nan;0;0
11014;187355;179;100;24;0;24;1.000;3600000;0
11014;213399;216;0;0;0;0;.00nan;0;0
11014;-1;216;51;39;5;34;.872;3600000;0
11244;196088;185;0;0;0;0;.00nan;0;0
11244;-1;185;80;32;2;30;.938;3600000;0
11244;-1;1371;56;26;4;22;.846;3517000;0
11244;-1;1371;0;0;0;0;.00nan;0;0
11041;215703;195;0;0;0;0;.00nan;0;0
11041;207061;195;79;14;0;14;1.000;3600000;0
11041;-1;189;0;0;0;0;.00nan;0;0
11041;-1;189;55;47;6;41;.872;3600000;0
11578;213803;230;92;15;0;15;1.000;3600000;0
11578;206800;225;0;0;0;0;.00nan;0;0
11578;-1;225;62;41;5;36;.878;3600000;0
11578;191120;230;0;0;0;0;.00nan;0;0
11043;195363;222;0;0;0;0;.00nan;0;0
11043;211080;229;89;43;2;41;.953;3549000;0
11043;213560;222;69;21;1;20;.952;3600000;0
11043;-1;229;0;0;0;0;.00nan;0;0
11090;206833;4864;0;0;0;0;.00nan;0;0
11090;202801;4864;55;31;4;27;.871;3600000;0
11090;-1;2620;0;0;0;0;.00nan;0;0
11090;213550;2620;36;41;7;34;.829;3600000;0
10987;205769;200;0;0;0;0;.00nan;0;0
10987;212002;200;52;30;4;26;.867;3597000;0
10987;203087;204;0;0;0;0;.00nan;0;0
10987;203120;204;58;21;3;18;.857;3600000;0
11101;201495;213;0;0;0;0;.00nan;0;0
11101;217198;213;93;39;1;38;.974;3600000;0
11101;-1;178;0;0;0;0;.00nan;0;0
11101;-1;178;53;24;3;21;.875;3545000;0
11066;205681;226;0;0;0;0;.00nan;0;0
11066;196283;206;0;0;0;0;.00nan;0;0
11066;-1;226;95;40;2;38;.950;3600000;0
11066;202998;206;42;30;5;25;.833;3600000;0
11107;190164;4959;51;7;1;6;.857;708000;0
11107;-1;209;0;0;0;0;.00nan;0;0
11107;-1;4959;13;25;7;18;.720;2892000;0
11107;213590;209;66;18;1;17;.944;3600000;0
11357;201525;203;68;34;3;31;.912;3566000;0
11357;206772;203;0;0;0;0;.00nan;0;0
11357;-1;199;0;0;0;0;.00nan;0;0
11357;-1;199;100;39;1;38;.974;3600000;0
11062;213399;216;80;47;4;43;.915;3600000;0
11062;197672;210;80;24;1;23;.958;3600000;0
11062;-1;210;0;0;0;0;.00nan;0;0
11062;-1;216;0;0;0;0;.00nan;0;0
11257;199416;191;0;0;0;0;.00nan;0;0
11257;210504;193;58;38;5;33;.868;3600000;0
11257;201892;191;95;20;0;20;1.000;3600000;0
11257;218059;193;0;0;0;0;.00nan;0;0
11169;216313;180;100;44;2;42;.955;3600000;0
11169;196296;219;0;0;0;0;.00nan;0;0
11169;218658;219;79;46;4;42;.913;3554000;0
11169;208383;180;0;0;0;0;.00nan;0;0
11139;198149;188;0;0;0;0;.00nan;0;0
11139;184409;188;80;38;2;36;.947;3543000;0
11139;-1;189;0;0;0;0;.00nan;0;0
11139;-1;189;84;28;1;27;.964;3600000;0
10956;191063;211;0;0;0;0;.00nan;0;0
10956;-1;211;98;54;3;51;.944;3568000;0
10956;-1;212;68;16;1;15;.938;3600000;0
10956;-1;212;0;0;0;0;.00nan;0;0
11120;209840;184;0;0;0;0;.00nan;0;0
11120;205837;184;76;25;2;23;.920;3900000;0
11120;211017;220;68;32;2;30;.938;3900000;0
11120;218510;220;0;0;0;0;.00nan;0;0
11339;200452;221;66;26;2;24;.923;3900000;0
11339;201514;227;0;0;0;0;.00nan;0;0
11339;213280;227;87;37;2;35;.946;3900000;0
11339;-1;221;0;0;0;0;.00nan;0;0
11161;198172;181;47;6;1;5;.833;509000;0
11161;216001;181;74;50;5;45;.900;3091000;0
11161;185810;182;61;25;2;23;.920;3600000;0
11161;213498;182;0;0;0;0;.00nan;0;0
10991;192939;208;0;0;0;0;.00nan;0;0
10991;205769;200;76;32;3;29;.906;3855000;0
10991;212002;200;0;0;0;0;.00nan;0;0
10991;-1;208;67;32;4;28;.875;3855000;0
11060;198149;188;85;37;2;35;.946;3600000;0
11060;200333;194;0;0;0;0;.00nan;0;0
11060;184409;188;0;0;0;0;.00nan;0;0
11060;196352;194;86;24;1;23;.958;3600000;0
11073;212050;218;0;0;0;0;.00nan;0;0
11073;201718;217;0;0;0;0;.00nan;0;0
11073;208051;218;100;30;0;30;1.000;3600000;0
11073;-1;217;83;36;3;33;.917;3600000;0
11067;205788;207;0;0;0;0;.00nan;0;0
11067;196283;206;75;25;1;24;.960;3600000;0
11067;197853;207;58;30;3;27;.900;3589000;0
11067;202998;206;0;0;0;0;.00nan;0;0
11157;-1;199;63;33;3;30;.909;3551000;0
11157;-1;199;0;0;0;0;.00nan;0;0
11157;203087;204;76;30;2;28;.933;3600000;0
11157;203120;204;0;0;0;0;.00nan;0;0
11192;204676;192;0;0;0;0;.00nan;0;0
11192;207398;192;100;25;0;25;1.000;3600000;0
11192;191118;196;87;45;3;42;.933;3600000;0
11192;202830;196;0;0;0;0;.00nan;0;0
11015;192915;179;0;0;0;0;.00nan;0;0
11015;211942;183;100;27;0;27;1.000;3600000;0
11015;196237;183;0;0;0;0;.00nan;0;0
11015;187355;179;76;44;4;40;.909;3600000;0
11291;182014;214;0;0;0;0;.00nan;0;0
11291;202914;214;57;28;4;24;.857;3572000;0
11291;-1;1371;64;26;2;24;.923;3600000;0
11291;-1;1371;0;0;0;0;.00nan;0;0
11077;211017;220;0;0;0;0;.00nan;0;0
11077;196088;185;100;27;0;27;1.000;3600000;0
11077;-1;185;0;0;0;0;.00nan;0;0
11077;218510;220;46;22;4;18;.818;3600000;0
11021;201524;205;0;0;0;0;.00nan;0;0
11021;201525;203;31;33;6;27;.818;2780000;0
11021;206772;203;60;9;0;9;1.000;799000;0
11021;-1;205;55;24;4;20;.833;3600000;0
11202;183695;232;73;28;2;26;.929;3900000;0
11202;206800;225;73;33;2;31;.939;3900000;0
11202;-1;225;0;0;0;0;.00nan;0;0
11202;-1;232;0;0;0;0;.00nan;0;0
11047;195118;197;0;0;0;0;.00nan;0;0
11047;206822;197;79;44;5;39;.886;3549000;0
11047;212143;198;79;39;3;36;.923;3600000;0
11047;212649;198;0;0;0;0;.00nan;0;0
11027;195363;222;67;16;1;15;.938;3600000;0
11027;211080;229;58;41;6;35;.854;3600000;0
11027;213560;222;0;0;0;0;.00nan;0;0
11027;-1;229;0;0;0;0;.00nan;0;0
11042;190164;4959;73;18;1;17;.944;3600000;0
11042;-1;4959;0;0;0;0;.00nan;0;0
11042;-1;2620;84;43;3;40;.930;3540000;0
11042;213550;2620;0;0;0;0;.00nan;0;0
11007;188977;215;36;28;5;23;.821;2138000;0
11007;210794;215;70;20;1;19;.950;1462000;0
11007;-1;212;0;0;0;0;.00nan;0;0
11007;-1;212;53;23;3;20;.870;3600000;0
10984;192862;187;61;33;4;29;.879;3580000;0
10984;215703;195;0;0;0;0;.00nan;0;0
10984;207061;195;69;23;2;21;.913;3600000;0
10984;-1;187;0;0;0;0;.00nan;0;0
10979;196296;219;72;20;1;19;.950;3600000;0
10979;191063;211;90;48;4;44;.917;3600000;0
10979;-1;211;0;0;0;0;.00nan;0;0
10979;218658;219;0;0;0;0;.00nan;0;0
11129;206801;176;24;35;7;28;.800;3600000;0
11129;-1;209;40;20;4;16;.800;3600000;0
11129;213533;176;0;0;0;0;.00nan;0;0
11129;213590;209;0;0;0;0;.00nan;0;0
11399;206971;4960;67;32;4;28;.875;3600000;0
11399;212304;4960;0;0;0;0;.00nan;0;0
11399;217269;223;0;0;0;0;.00nan;0;0
11399;217312;223;100;48;0;48;1.000;3600000;0
11142;213803;230;82;42;3;39;.929;3600000;0
11142;200444;224;35;26;5;21;.808;3540000;0
11142;191120;230;0;0;0;0;.00nan;0;0
11142;208372;224;0;0;0;0;.00nan;0;0
11468;216313;180;0;0;0;0;.00nan;0;0
11468;191130;186;0;0;0;0;.00nan;0;0
11468;213507;186;63;31;4;27;.871;3523000;0
11468;208383;180;73;30;2;28;.933;3600000;0
11078;194950;1505;73;22;2;20;.909;3600000;0
11078;196571;177;79;52;4;48;.923;3600000;0
11078;212814;1505;0;0;0;0;.00nan;0;0
11078;-1;177;0;0;0;0;.00nan;0;0
11188;201495;213;61;27;2;25;.926;3600000;0
11188;217198;213;0;0;0;0;.00nan;0;0
11188;-1;4949;0;0;0;0;.00nan;0;0
11188;-1;4949;59;29;3;26;.897;3535000;0
10976;192862;187;0;0;0;0;.00nan;0;0
10976;-1;189;73;23;2;21;.913;3548000;0
10976;-1;187;93;36;1;35;.972;3600000;0
10976;-1;189;0;0;0;0;.00nan;0;0
11359;209840;184;0;0;0;0;.00nan;0;0
11359;205837;184;89;36;2;34;.944;3600000;0
11359;185810;182;70;39;4;35;.897;3515000;0
11359;213498;182;0;0;0;0;.00nan;0;0
11222;196088;185;47;19;3;16;.842;3600000;0
11222;-1;185;0;0;0;0;.00nan;0;0
11222;-1;1371;0;0;0;0;.00nan;0;0
11222;-1;1371;51;27;4;23;.852;3545000;0
11079;206800;225;0;0;0;0;.00nan;0;0
11079;180377;228;57;27;3;24;.889;3545000;0
11079;-1;225;60;22;2;20;.909;3600000;0
11079;208044;228;0;0;0;0;.00nan;0;0
11230;210504;193;80;28;3;25;.893;3900000;0
11230;218059;193;0;0;0;0;.00nan;0;0
11230;191118;196;97;46;3;43;.935;3900000;0
11230;202830;196;0;0;0;0;.00nan;0;0
11064;204676;192;0;0;0;0;.00nan;0;0
11064;215703;195;56;18;2;16;.889;3595000;0
11064;207061;195;0;0;0;0;.00nan;0;0
11064;207398;192;83;28;1;27;.964;3600000;0
11088;192915;179;83;33;2;31;.939;3600000;0
11088;187355;179;0;0;0;0;.00nan;0;0
11088;-1;178;0;0;0;0;.00nan;0;0
11088;-1;178;49;25;3;22;.880;3546000;0
11135;206801;176;0;0;0;0;.00nan;0;0
11135;206833;4864;0;0;0;0;.00nan;0;0
11135;202801;4864;52;20;3;17;.850;3600000;0
11135;213533;176;68;45;5;40;.889;3522000;0
11008;212050;218;0;0;0;0;.00nan;0;0
11008;208051;218;80;39;2;37;.949;3546000;0
11008;-1;212;71;19;1;18;.947;3600000;0
11008;-1;212;0;0;0;0;.00nan;0;0
11114;209840;184;75;24;1;23;.958;3600000;0
11114;205837;184;0;0;0;0;.00nan;0;0
11114;211017;220;80;33;2;31;.939;3600000;0
11114;218510;220;0;0;0;0;.00nan;0;0
11446;213803;230;100;29;0;29;1.000;3600000;0
11446;201514;227;77;47;5;42;.894;3600000;0
11446;191120;230;0;0;0;0;.00nan;0;0
11446;213280;227;0;0;0;0;.00nan;0;0
11308;210504;193;0;0;0;0;.00nan;0;0
11308;218059;193;45;29;4;25;.862;3600000;0
11308;-1;190;48;38;6;32;.842;3536000;0
11308;-1;190;0;0;0;0;.00nan;0;0
11071;215240;231;90;19;0;19;1.000;3600000;0
11071;189773;231;0;0;0;0;.00nan;0;0
11071;211080;229;40;36;7;29;.806;2001000;0
11071;-1;229;75;21;1;20;.952;1599000;0
11072;194950;1505;59;19;2;17;.895;3600000;0
11072;212814;1505;0;0;0;0;.00nan;0;0
11072;213399;216;0;0;0;0;.00nan;0;0
11072;-1;216;68;41;4;37;.902;3549000;0
11349;211942;183;100;32;1;31;.969;3600000;0
11349;196237;183;0;0;0;0;.00nan;0;0
11349;-1;4949;75;36;2;34;.944;3593000;0
11349;-1;4949;0;0;0;0;.00nan;0;0
11143;196283;206;0;0;0;0;.00nan;0;0
11143;202998;206;56;31;4;27;.871;3600000;0
11143;203087;204;0;0;0;0;.00nan;0;0
11143;203120;204;84;23;1;22;.957;3600000;0
11146;195363;222;0;0;0;0;.00nan;0;0
11146;217269;223;0;0;0;0;.00nan;0;0
11146;217312;223;85;34;2;32;.941;3526000;0
11146;213560;222;100;33;0;33;1.000;3600000;0
11179;201718;217;56;39;5;34;.872;3545000;0
11179;191130;186;83;39;3;36;.923;3600000;0
11179;213507;186;0;0;0;0;.00nan;0;0
11179;-1;217;0;0;0;0;.00nan;0;0
11085;198149;188;0;0;0;0;.00nan;0;0
11085;195118;197;71;32;3;29;.906;3543000;0
11085;184409;188;79;31;2;29;.935;3600000;0
11085;206822;197;0;0;0;0;.00nan;0;0
11136;198172;181;0;0;0;0;.00nan;0;0
11136;216001;181;67;25;2;23;.920;3551000;0
11136;182014;214;0;0;0;0;.00nan;0;0
11136;202914;214;99;39;1;38;.974;3600000;0
11232;201495;213;20;10;4;6;.600;959000;0
11232;217198;213;56;43;6;37;.860;2641000;0
11232;197672;210;0;0;0;0;.00nan;0;0
11232;-1;210;100;23;0;23;1.000;3600000;0
11203;183695;232;78;46;3;43;.935;3900000;0
11203;200452;221;69;33;3;30;.909;3900000;0
11203;-1;221;0;0;0;0;.00nan;0;0
11203;-1;232;0;0;0;0;.00nan;0;0
10972;200437;201;0;0;0;0;.00nan;0;0
10972;201524;205;0;0;0;0;.00nan;0;0
10972;208048;201;62;42;5;37;.881;3544000;0
10972;-1;205;62;34;4;30;.882;3600000;0
10980;188977;215;0;0;0;0;.00nan;0;0
10980;210794;215;83;36;3;33;.917;3557000;0
10980;191063;211;0;0;0;0;.00nan;0;0
10980;-1;211;70;27;2;25;.926;3600000;0
11084;194950;1505;0;0;0;0;.00nan;0;0
11084;196571;177;83;34;2;32;.941;3600000;0
11084;212814;1505;58;22;3;19;.864;3548000;0
11084;-1;177;0;0;0;0;.00nan;0;0
10999;192862;187;97;48;3;45;.938;3552000;0
10999;215703;195;0;0;0;0;.00nan;0;0
10999;207061;195;54;17;2;15;.882;3600000;0
10999;-1;187;0;0;0;0;.00nan;0;0
11262;188977;215;75;22;1;21;.955;3586000;0
11262;210794;215;0;0;0;0;.00nan;0;0
11262;216313;180;100;29;0;29;1.000;3600000;0
11262;208383;180;0;0;0;0;.00nan;0;0
11154;200452;221;0;0;0;0;.00nan;0;0
11154;180377;228;67;53;6;47;.887;3600000;0
11154;208044;228;0;0;0;0;.00nan;0;0
11154;-1;221;72;24;1;23;.958;3600000;0
11186;206833;4864;78;15;0;15;1.000;3600000;0
11186;-1;209;0;0;0;0;.00nan;0;0
11186;202801;4864;0;0;0;0;.00nan;0;0
11186;213590;209;76;46;5;41;.891;3600000;0
11189;-1;189;75;26;3;23;.885;3744000;0
11189;-1;190;81;29;2;27;.931;3744000;0
11189;-1;189;0;0;0;0;.00nan;0;0
11189;-1;190;0;0;0;0;.00nan;0;0
11299;211942;183;0;0;0;0;.00nan;0;0
11299;196237;183;77;31;2;29;.935;3600000;0
11299;197672;210;0;0;0;0;.00nan;0;0
11299;-1;210;48;32;4;28;.875;3542000;0
11081;204676;192;0;0;0;0;.00nan;0;0
11081;212143;198;56;27;3;24;.889;3886000;0
11081;212649;198;0;0;0;0;.00nan;0;0
11081;207398;192;67;29;3;26;.897;3900000;0
11149;215240;231;80;22;1;21;.955;3600000;0
11149;200444;224;0;0;0;0;.00nan;0;0
11149;189773;231;0;0;0;0;.00nan;0;0
11149;208372;224;70;34;3;31;.912;3584000;0
11567;199416;191;0;0;0;0;.00nan;0;0
11567;200333;194;37;41;6;35;.854;3600000;0
11567;201892;191;92;28;1;27;.964;3600000;0
11567;196352;194;0;0;0;0;.00nan;0;0
11393;213803;230;71;36;4;32;.889;3584000;0
11393;206971;4960;66;21;2;19;.905;3600000;0
11393;212304;4960;0;0;0;0;.00nan;0;0
11393;191120;230;0;0;0;0;.00nan;0;0
11003;205681;226;0;0;0;0;.00nan;0;0
11003;205769;200;0;0;0;0;.00nan;0;0
11003;212002;200;90;44;3;41;.932;3811000;0
11003;-1;226;59;17;2;15;.882;3811000;0
11005;190164;4959;0;0;0;0;.00nan;0;0
11005;-1;4959;92;42;3;39;.929;3551000;0
11005;-1;2620;0;0;0;0;.00nan;0;0
11005;213550;2620;72;18;2;16;.889;3600000;0
11187;-1;178;0;0;0;0;.00nan;0;0
11187;213399;216;87;35;2;33;.943;3600000;0
11187;-1;178;59;30;3;27;.900;3559000;0
11187;-1;216;0;0;0;0;.00nan;0;0
11127;196088;185;0;0;0;0;.00nan;0;0
11127;182014;214;49;32;5;27;.844;3600000;0
11127;-1;185;72;30;2;28;.933;3600000;0
11127;202914;214;0;0;0;0;.00nan;0;0
11038;205788;207;64;25;2;23;.920;3900000;0
11038;201560;202;77;28;2;26;.929;3900000;0
11038;208067;202;0;0;0;0;.00nan;0;0
11038;197853;207;0;0;0;0;.00nan;0;0
11103;200437;201;51;37;5;32;.865;3837000;0
11103;205681;226;0;0;0;0;.00nan;0;0
11103;208048;201;0;0;0;0;.00nan;0;0
11103;-1;226;57;33;4;29;.879;3805000;0
11268;205769;200;76;40;3;37;.925;3600000;0
11268;201525;203;30;25;5;20;.800;3528000;0
11268;212002;200;0;0;0;0;.00nan;0;0
11268;206772;203;0;0;0;0;.00nan;0;0
11182;212143;198;0;0;0;0;.00nan;0;0
11182;212649;198;59;35;4;31;.886;3900000;0
11182;191118;196;75;45;4;41;.911;3900000;0
11182;202830;196;0;0;0;0;.00nan;0;0
11214;198172;181;81;45;4;41;.911;3673000;0
11214;216001;181;0;0;0;0;.00nan;0;0
11214;185810;182;67;29;3;26;.897;3673000;0
11214;213498;182;0;0;0;0;.00nan;0;0
11530;196296;219;0;0;0;0;.00nan;0;0
11530;191130;186;0;0;0;0;.00nan;0;0
11530;218658;219;56;25;3;22;.880;3600000;0
11530;213507;186;42;28;4;24;.857;3597000;0
11204;199416;191;52;23;3;20;.870;3600000;0
11204;195118;197;0;0;0;0;.00nan;0;0
11204;206822;197;78;42;4;38;.905;3600000;0
11204;201892;191;0;0;0;0;.00nan;0;0
11089;212050;218;0;0;0;0;.00nan;0;0
11089;201718;217;0;0;0;0;.00nan;0;0
11089;208051;218;59;26;3;23;.885;3600000;0
11089;-1;217;77;32;2;30;.938;3600000;0
11219;206800;225;0;0;0;0;.00nan;0;0
11219;217269;223;34;30;6;24;.800;2704000;0
11219;217312;223;60;8;0;8;1.000;831000;0
11219;-1;225;80;37;4;33;.892;3600000;0
11055;192939;208;84;27;1;26;.963;3551000;0
11055;205788;207;0;0;0;0;.00nan;0;0
11055;197853;207;100;41;0;41;1.000;3600000;0
11055;-1;208;0;0;0;0;.00nan;0;0
11030;192915;179;0;0;0;0;.00nan;0;0
11030;196571;177;0;0;0;0;.00nan;0;0
11030;187355;179;63;41;5;36;.878;3543000;0
11030;-1;177;65;29;3;26;.897;3600000;0
11250;200437;201;100;28;0;28;1.000;3600000;0
11250;201524;205;0;0;0;0;.00nan;0;0
11250;208048;201;0;0;0;0;.00nan;0;0
11250;-1;205;61;21;2;19;.905;3555000;0
11207;200444;224;82;13;0;13;1.000;3600000;0
11207;180377;228;94;47;3;44;.936;3600000;0
11207;208044;228;0;0;0;0;.00nan;0;0
11207;208372;224;0;0;0;0;.00nan;0;0
11224;183695;232;94;60;4;56;.933;3801000;0
11224;215240;231;0;0;0;0;.00nan;0;0
11224;189773;231;49;19;3;16;.842;3801000;0
11224;-1;232;0;0;0;0;.00nan;0;0
11054;192939;208;0;0;0;0;.00nan;0;0
11054;201560;202;78;41;3;38;.927;3543000;0
11054;208067;202;0;0;0;0;.00nan;0;0
11054;-1;208;76;29;2;27;.931;3600000;0
11269;182014;214;0;0;0;0;.00nan;0;0
11269;185810;182;61;29;4;25;.862;3600000;0
11269;202914;214;41;32;5;27;.844;3560000;0
11269;213498;182;0;0;0;0;.00nan;0;0
11384;215240;231;64;18;1;17;.944;3600000;0
11384;189773;231;0;0;0;0;.00nan;0;0
11384;217269;223;78;51;4;47;.922;3154000;0
11384;217312;223;32;17;4;13;.765;446000;0
11253;198149;188;0;0;0;0;.00nan;0;0
11253;210504;193;59;24;3;21;.875;3600000;0
11253;184409;188;87;52;4;48;.923;3555000;0
11253;218059;193;0;0;0;0;.00nan;0;0
11113;-1;209;70;35;3;32;.914;3585000;0
11113;-1;2620;0;0;0;0;.00nan;0;0
11113;213550;2620;90;37;2;35;.946;3600000;0
11113;213590;209;0;0;0;0;.00nan;0;0
11173;194950;1505;95;20;0;20;1.000;3600000;0
11173;212814;1505;0;0;0;0;.00nan;0;0
11173;213399;216;0;0;0;0;.00nan;0;0
11173;-1;216;70;48;4;44;.917;3600000;0
11298;188977;215;0;0;0;0;.00nan;0;0
11298;210794;215;85;44;3;41;.932;3516000;0
11298;196296;219;0;0;0;0;.00nan;0;0
11298;218658;219;75;24;1;23;.958;3600000;0
11231;211080;229;95;35;2;33;.943;3600000;0
11231;201514;227;61;22;2;20;.909;2642000;0
11231;213280;227;24;12;4;8;.667;958000;0
11231;-1;229;0;0;0;0;.00nan;0;0
11102;215703;195;0;0;0;0;.00nan;0;0
11102;207061;195;43;9;2;7;.778;3600000;0
11102;191118;196;74;45;4;41;.911;3600000;0
11102;202830;196;0;0;0;0;.00nan;0;0
11195;205788;207;0;0;0;0;.00nan;0;0
11195;197853;207;72;47;5;42;.894;3600000;0
11195;203087;204;0;0;0;0;.00nan;0;0
11195;203120;204;84;18;0;18;1.000;3600000;0
11132;198172;181;0;0;0;0;.00nan;0;0
11132;216001;181;87;30;1;29;.967;3600000;0
11132;211017;220;65;26;2;24;.923;3580000;0
11132;218510;220;0;0;0;0;.00nan;0;0
11591;200333;194;0;0;0;0;.00nan;0;0
11591;212143;198;59;26;3;23;.885;3600000;0
11591;196352;194;59;47;5;42;.894;3531000;0
11591;212649;198;0;0;0;0;.00nan;0;0
11264;209840;184;0;0;0;0;.00nan;0;0
11264;205837;184;41;26;4;22;.846;3527000;0
11264;196088;185;73;31;2;29;.935;3600000;0
11264;-1;185;0;0;0;0;.00nan;0;0
11217;205681;226;0;0;0;0;.00nan;0;0
11217;201524;205;41;36;6;30;.833;2986000;0
11217;-1;226;49;13;2;11;.846;3600000;0
11217;-1;205;46;4;1;3;.750;614000;0
11117;212050;218;0;0;0;0;.00nan;0;0
11117;191063;211;0;0;0;0;.00nan;0;0
11117;208051;218;77;30;2;28;.933;3600000;0
11117;-1;211;44;27;4;23;.852;3524000;0
11092;206801;176;72;31;3;28;.903;3750000;0
11092;-1;2620;66;25;2;23;.920;3750000;0
11092;213533;176;0;0;0;0;.00nan;0;0
11092;213550;2620;0;0;0;0;.00nan;0;0
11163;212050;218;64;27;2;25;.926;3870000;0
11163;191130;186;0;0;0;0;.00nan;0;0
11163;208051;218;0;0;0;0;.00nan;0;0
11163;213507;186;67;36;3;33;.917;3870000;0
11223;201495;213;0;0;0;0;.00nan;0;0
11223;217198;213;98;62;3;59;.952;3545000;0
11223;213399;216;68;20;1;19;.950;3600000;0
11223;-1;216;0;0;0;0;.00nan;0;0
11226;200444;224;26;29;7;22;.759;3155000;0
11226;206971;4960;68;33;3;30;.909;3600000;0
11226;212304;4960;0;0;0;0;.00nan;0;0
11226;208372;224;59;14;1;13;.929;445000;0
11209;196571;177;41;27;5;22;.815;3583000;0
11209;-1;178;0;0;0;0;.00nan;0;0
11209;-1;178;79;34;3;31;.912;3600000;0
11209;-1;177;0;0;0;0;.00nan;0;0
11137;215703;195;69;35;4;31;.886;3735000;0
11137;207061;195;0;0;0;0;.00nan;0;0
11137;-1;189;0;0;0;0;.00nan;0;0
11137;-1;189;99;47;3;44;.936;3735000;0
11212;192862;187;67;41;4;37;.902;3600000;0
11212;195118;197;0;0;0;0;.00nan;0;0
11212;206822;197;98;25;0;25;1.000;3600000;0
11212;-1;187;0;0;0;0;.00nan;0;0
11104;200437;201;92;31;1;30;.968;3600000;0
11104;201560;202;67;24;2;22;.917;3572000;0
11104;208048;201;0;0;0;0;.00nan;0;0
11104;208067;202;0;0;0;0;.00nan;0;0
11145;211080;229;0;0;0;0;.00nan;0;0
11145;180377;228;61;24;2;22;.917;3600000;0
11145;208044;228;0;0;0;0;.00nan;0;0
11145;-1;229;54;32;3;29;.906;3600000;0
11279;204676;192;0;0;0;0;.00nan;0;0
11279;207398;192;73;19;1;18;.947;3710000;0
11279;-1;190;94;48;2;46;.958;3710000;0
11279;-1;190;0;0;0;0;.00nan;0;0
11328;185810;182;36;30;6;24;.800;2978000;0
11328;-1;1371;83;30;2;28;.933;3600000;0
11328;213498;182;57;5;0;5;1.000;622000;0
11328;-1;1371;0;0;0;0;.00nan;0;0
11288;213803;230;62;21;2;19;.905;3559000;0
11288;195363;222;0;0;0;0;.00nan;0;0
11288;191120;230;0;0;0;0;.00nan;0;0
11288;213560;222;100;41;0;41;1.000;3600000;0
11119;192915;179;0;0;0;0;.00nan;0;0
11119;187355;179;82;18;1;17;.944;3600000;0
11119;-1;4949;85;32;2;30;.938;3600000;0
11119;-1;4949;0;0;0;0;.00nan;0;0
11018;201718;217;0;0;0;0;.00nan;0;0
11018;-1;217;64;42;5;37;.881;3600000;0
11018;-1;212;75;12;0;12;1.000;3600000;0
11018;-1;212;0;0;0;0;.00nan;0;0
11118;192939;208;69;27;2;25;.926;3600000;0
11118;196283;206;68;36;3;33;.917;3583000;0
11118;-1;208;0;0;0;0;.00nan;0;0
11118;202998;206;0;0;0;0;.00nan;0;0
11326;200452;221;77;34;2;32;.941;3600000;0
11326;206800;225;0;0;0;0;.00nan;0;0
11326;-1;225;85;48;4;44;.917;3573000;0
11326;-1;221;0;0;0;0;.00nan;0;0
11314;198149;188;91;41;3;38;.927;3900000;0
11314;199416;191;0;0;0;0;.00nan;0;0
11314;184409;188;0;0;0;0;.00nan;0;0
11314;201892;191;75;29;3;26;.897;3900000;0
11294;194950;1505;77;33;2;31;.939;3650000;0
11294;211942;183;86;40;3;37;.925;3650000;0
11294;196237;183;0;0;0;0;.00nan;0;0
11294;212814;1505;0;0;0;0;.00nan;0;0
11284;212143;198;0;0;0;0;.00nan;0;0
11284;212649;198;65;25;2;23;.920;3900000;0
11284;191118;196;91;45;2;43;.956;3900000;0
11284;202830;196;0;0;0;0;.00nan;0;0
11198;206833;4864;31;22;5;17;.773;3529000;0
11198;-1;209;0;0;0;0;.00nan;0;0
11198;202801;4864;0;0;0;0;.00nan;0;0
11198;213590;209;90;60;4;56;.933;3600000;0
11201;209840;184;74;38;3;35;.921;3600000;0
11201;205837;184;0;0;0;0;.00nan;0;0
11201;211017;220;0;0;0;0;.00nan;0;0
11201;218510;220;37;37;7;30;.811;3600000;0
11037;205769;200;0;0;0;0;.00nan;0;0
11037;212002;200;72;21;1;20;.952;3600000;0
11037;-1;199;89;35;2;33;.943;3582000;0
11037;-1;199;0;0;0;0;.00nan;0;0
11190;198172;181;62;18;1;17;.944;3600000;0
11190;216001;181;0;0;0;0;.00nan;0;0
11190;182014;214;59;40;6;34;.850;3600000;0
11190;202914;214;0;0;0;0;.00nan;0;0
11425;199416;191;40;19;3;16;.842;3600000;0
11425;210504;193;99;48;1;47;.979;3600000;0
11425;201892;191;0;0;0;0;.00nan;0;0
11425;218059;193;0;0;0;0;.00nan;0;0
11300;196571;177;0;0;0;0;.00nan;0;0
11300;197672;210;67;22;1;21;.955;3600000;0
11300;-1;210;0;0;0;0;.00nan;0;0
11300;-1;177;93;41;2;39;.951;3596000;0
11061;196296;219;0;0;0;0;.00nan;0;0
11061;218658;219;81;35;2;33;.943;3600000;0
11061;-1;212;94;37;1;36;.973;3600000;0
11061;-1;212;0;0;0;0;.00nan;0;0
11208;200452;221;73;31;2;29;.935;3600000;0
11208;180377;228;0;0;0;0;.00nan;0;0
11208;208044;228;57;31;4;27;.871;3600000;0
11208;-1;221;0;0;0;0;.00nan;0;0
11093;205788;207;92;45;1;44;.978;3777000;0
11093;-1;199;0;0;0;0;.00nan;0;0
11093;197853;207;0;0;0;0;.00nan;0;0
11093;-1;199;97;29;0;29;1.000;3777000;0
11227;201524;205;0;0;0;0;.00nan;0;0
11227;196283;206;0;0;0;0;.00nan;0;0
11227;-1;205;65;35;5;30;.857;3600000;0
11227;202998;206;75;37;2;35;.946;3600000;0
11508;216313;180;52;28;4;24;.857;3542000;0
11508;191130;186;73;23;2;21;.913;3600000;0
11508;213507;186;0;0;0;0;.00nan;0;0
11508;208383;180;0;0;0;0;.00nan;0;0
11238;200444;224;0;0;0;0;.00nan;0;0
11238;217269;223;0;0;0;0;.00nan;0;0
11238;217312;223;85;51;4;47;.922;3715000;0
11238;208372;224;37;13;3;10;.769;3715000;0
11297;206833;4864;0;0;0;0;.00nan;0;0
11297;-1;209;67;41;5;36;.878;3581000;0
11297;202801;4864;60;25;3;22;.880;3600000;0
11297;213590;209;0;0;0;0;.00nan;0;0
11193;188977;215;0;0;0;0;.00nan;0;0
11193;210794;215;55;38;5;33;.868;3579000;0
11193;201718;217;70;31;3;28;.903;3600000;0
11193;-1;217;0;0;0;0;.00nan;0;0
11200;200437;201;68;28;3;25;.893;3600000;0
11200;205681;226;0;0;0;0;.00nan;0;0
11200;208048;201;0;0;0;0;.00nan;0;0
11200;-1;226;56;32;4;28;.875;3600000;0
11235;211080;229;83;53;5;48;.906;3600000;0
11235;206971;4960;71;20;1;19;.950;3600000;0
11235;212304;4960;0;0;0;0;.00nan;0;0
11235;-1;229;0;0;0;0;.00nan;0;0
11234;213399;216;0;0;0;0;.00nan;0;0
11234;-1;4949;70;19;1;18;.947;3600000;0
11234;-1;4949;0;0;0;0;.00nan;0;0
11234;-1;216;70;37;3;34;.919;3576000;0
11218;211017;220;59;36;4;32;.889;3567000;0
11218;218510;220;0;0;0;0;.00nan;0;0
11218;-1;1371;0;0;0;0;.00nan;0;0
11218;-1;1371;83;34;3;31;.912;3600000;0
11046;192862;187;62;25;3;22;.880;3600000;0
11046;-1;190;45;33;4;29;.879;3557000;0
11046;-1;187;0;0;0;0;.00nan;0;0
11046;-1;190;0;0;0;0;.00nan;0;0
10990;196296;219;38;17;4;13;.765;1188000;0
10990;191063;211;0;0;0;0;.00nan;0;0
10990;-1;211;51;23;3;20;.870;3600000;0
10990;218658;219;69;20;1;19;.950;2338000;0
11100;206801;176;100;42;1;41;.976;3600000;0
11100;-1;2620;0;0;0;0;.00nan;0;0
11100;213533;176;0;0;0;0;.00nan;0;0
11100;213550;2620;44;26;4;22;.846;3600000;0
11329;183695;232;72;23;1;22;.957;3600000;0
11329;206800;225;0;0;0;0;.00nan;0;0
11329;-1;225;98;43;3;40;.930;3526000;0
11329;-1;232;0;0;0;0;.00nan;0;0
11162;192939;208;69;31;3;28;.903;3600000;0
11162;201524;205;24;34;7;27;.794;2756000;0
11162;-1;208;0;0;0;0;.00nan;0;0
11162;-1;205;58;14;1;13;.929;844000;0
11165;192915;179;0;0;0;0;.00nan;0;0
11165;201495;213;0;0;0;0;.00nan;0;0
11165;217198;213;78;39;3;36;.923;3900000;0
11165;187355;179;54;20;3;17;.850;3900000;0
11053;205769;200;0;0;0;0;.00nan;0;0
11053;201560;202;57;33;4;29;.879;3900000;0
11053;212002;200;64;34;4;30;.882;3900000;0
11053;208067;202;0;0;0;0;.00nan;0;0
11177;216313;180;0;0;0;0;.00nan;0;0
11177;212050;218;0;0;0;0;.00nan;0;0
11177;208051;218;74;24;1;23;.958;3600000;0
11177;208383;180;93;42;2;40;.952;3544000;0
11304;195363;222;0;0;0;0;.00nan;0;0
11304;201514;227;0;0;0;0;.00nan;0;0
11304;213280;227;78;41;3;38;.927;3600000;0
11304;213560;222;91;31;2;29;.935;3600000;0
11178;198149;188;0;0;0;0;.00nan;0;0
11178;184409;188;99;43;1;42;.977;3600000;0
11178;-1;189;0;0;0;0;.00nan;0;0
11178;-1;189;40;16;3;13;.813;3529000;0
11184;204676;192;52;23;3;20;.870;3600000;0
11184;195118;197;0;0;0;0;.00nan;0;0
11184;206822;197;76;51;5;46;.902;3600000;0
11184;207398;192;0;0;0;0;.00nan;0;0
11265;-1;178;0;0;0;0;.00nan;0;0
11265;197672;210;0;0;0;0;.00nan;0;0
11265;-1;178;58;27;3;24;.889;3525000;0
11265;-1;210;79;26;1;25;.962;3600000;0
11316;196088;185;100;29;0;29;1.000;3600000;0
11316;182014;214;0;0;0;0;.00nan;0;0
11316;-1;185;0;0;0;0;.00nan;0;0
11316;202914;214;98;52;3;49;.942;3600000;0
11270;210504;193;0;0;0;0;.00nan;0;0
11270;212143;198;27;7;3;4;.571;519000;0
11270;212649;198;51;20;3;17;.850;3081000;0
11270;218059;193;67;33;3;30;.909;3600000;0
11216;198172;181;0;0;0;0;.00nan;0;0
11216;216001;181;74;44;4;40;.909;3600000;0
11216;185810;182;22;20;6;14;.700;2016000;0
11216;213498;182;51;15;2;13;.867;1584000;0
11389;206800;225;59;6;0;6;1.000;424000;0
11389;206971;4960;42;14;3;11;.786;3600000;0
11389;212304;4960;0;0;0;0;.00nan;0;0
11389;-1;225;78;46;5;41;.891;3176000;0
11583;194950;1505;0;0;0;0;.00nan;0;0
11583;211942;183;44;31;5;26;.839;3600000;0
11583;196237;183;0;0;0;0;.00nan;0;0
11583;212814;1505;72;32;2;30;.938;3600000;0
11131;190164;4959;0;0;0;0;.00nan;0;0
11131;206801;176;0;0;0;0;.00nan;0;0
11131;-1;4959;56;28;3;25;.893;3853000;0
11131;213533;176;67;33;4;29;.879;3853000;0
11267;201495;213;53;22;3;19;.864;3600000;0
11267;217198;213;0;0;0;0;.00nan;0;0
11267;-1;178;37;23;4;19;.826;3545000;0
11267;-1;178;0;0;0;0;.00nan;0;0
11155;192915;179;0;0;0;0;.00nan;0;0
11155;187355;179;83;41;2;39;.951;3600000;0
11155;-1;4949;0;0;0;0;.00nan;0;0
11155;-1;4949;82;20;1;19;.950;3600000;0
11301;215240;231;0;0;0;0;.00nan;0;0
11301;189773;231;60;22;2;20;.909;3600000;0
11301;195363;222;83;49;4;45;.918;3555000;0
11301;213560;222;0;0;0;0;.00nan;0;0
11245;192939;208;0;0;0;0;.00nan;0;0
11245;201525;203;13;18;6;12;.667;2530000;0
11245;206772;203;62;9;0;9;1.000;1070000;0
11245;-1;208;60;40;5;35;.875;3600000;0
11094;215703;195;0;0;0;0;.00nan;0;0
11094;207061;195;32;11;3;8;.727;3600000;0
11094;-1;190;77;59;6;53;.898;3600000;0
11094;-1;190;0;0;0;0;.00nan;0;0
11280;195118;197;56;42;5;37;.881;3600000;0
11280;206822;197;0;0;0;0;.00nan;0;0
11280;-1;189;0;0;0;0;.00nan;0;0
11280;-1;189;85;26;1;25;.962;3600000;0
11151;213803;230;50;38;5;33;.868;3600000;0
11151;200444;224;24;13;4;9;.692;855000;0
11151;191120;230;0;0;0;0;.00nan;0;0
11151;208372;224;59;22;2;20;.909;2690000;0
11242;200437;201;0;0;0;0;.00nan;0;0
11242;196283;206;0;0;0;0;.00nan;0;0
11242;208048;201;92;43;2;41;.953;3724000;0
11242;202998;206;85;30;1;29;.967;3724000;0
11367;196088;185;69;41;4;37;.902;3600000;0
11367;-1;185;0;0;0;0;.00nan;0;0
11367;-1;1371;54;32;5;27;.844;3548000;0
11367;-1;1371;0;0;0;0;.00nan;0;0
11099;205788;207;46;27;4;23;.852;3574000;0
11099;-1;199;0;0;0;0;.00nan;0;0
11099;197853;207;0;0;0;0;.00nan;0;0
11099;-1;199;100;45;2;43;.956;3600000;0
11322;192862;187;0;0;0;0;.00nan;0;0
11322;199416;191;0;0;0;0;.00nan;0;0
11322;201892;191;58;21;3;18;.857;3600000;0
11322;-1;187;71;43;4;39;.907;3600000;0
11112;205769;200;36;32;6;26;.813;3600000;0
11112;212002;200;0;0;0;0;.00nan;0;0
11112;203087;204;0;0;0;0;.00nan;0;0
11112;203120;204;41;16;3;13;.813;3600000;0
11170;216313;180;100;31;0;31;1.000;3600000;0
11170;191063;211;0;0;0;0;.00nan;0;0
11170;-1;211;59;35;4;31;.886;3600000;0
11170;208383;180;0;0;0;0;.00nan;0;0
11428;201560;202;48;19;4;15;.789;3568000;0
11428;208067;202;0;0;0;0;.00nan;0;0
11428;203087;204;100;46;2;44;.957;3600000;0
11428;203120;204;0;0;0;0;.00nan;0;0
11123;191130;186;91;47;2;45;.957;3600000;0
11123;213507;186;0;0;0;0;.00nan;0;0
11123;-1;212;0;0;0;0;.00nan;0;0
11123;-1;212;45;21;3;18;.857;3558000;0
11361;215240;231;40;16;3;13;.813;3600000;0
11361;189773;231;0;0;0;0;.00nan;0;0
11361;217269;223;37;24;5;19;.792;1253000;0
11361;217312;223;53;37;5;32;.865;2347000;0
11252;205681;226;0;0;0;0;.00nan;0;0
11252;201525;203;59;40;5;35;.875;3600000;0
11252;206772;203;0;0;0;0;.00nan;0;0
11252;-1;226;58;18;2;16;.889;3600000;0
11287;190164;4959;67;38;4;34;.895;3600000;0
11287;206833;4864;0;0;0;0;.00nan;0;0
11287;202801;4864;70;18;1;17;.944;3600000;0
11287;-1;4959;0;0;0;0;.00nan;0;0
11305;200333;194;0;0;0;0;.00nan;0;0
11305;196352;194;100;36;0;36;1.000;3600000;0
11305;191118;196;78;31;2;29;.935;3600000;0
11305;202830;196;0;0;0;0;.00nan;0;0
11180;188977;215;0;0;0;0;.00nan;0;0
11180;210794;215;40;30;5;25;.833;3570000;0
11180;191063;211;71;37;3;34;.919;3600000;0
11180;-1;211;0;0;0;0;.00nan;0;0
11354;204676;192;0;0;0;0;.00nan;0;0
11354;200333;194;44;16;3;13;.813;1458000;0
11354;196352;194;43;24;4;20;.833;2142000;0
11354;207398;192;81;11;0;11;1.000;3600000;0
11311;196571;177;0;0;0;0;.00nan;0;0
11311;197672;210;0;0;0;0;.00nan;0;0
11311;-1;210;88;34;1;33;.971;3900000;0
11311;-1;177;80;29;1;28;.966;3900000;0
11313;201514;227;0;0;0;0;.00nan;0;0
11313;180377;228;52;35;6;29;.829;2703000;0
11313;213280;227;85;31;1;30;.968;3600000;0
11313;208044;228;56;5;0;5;1.000;897000;0
11542;201524;205;0;0;0;0;.00nan;0;0
11542;-1;205;61;30;3;27;.900;3553000;0
11542;203087;204;0;0;0;0;.00nan;0;0
11542;203120;204;81;25;1;24;.960;3600000;0
11206;200437;201;90;33;2;31;.939;3600000;0
11206;205769;200;0;0;0;0;.00nan;0;0
11206;212002;200;53;36;4;32;.889;3545000;0
11206;208048;201;0;0;0;0;.00nan;0;0
11183;212050;218;0;0;0;0;.00nan;0;0
11183;201718;217;0;0;0;0;.00nan;0;0
11183;208051;218;65;21;2;19;.905;3900000;0
11183;-1;217;84;33;2;31;.939;3900000;0
11210;196571;177;45;20;3;17;.850;3847000;0
11210;213399;216;0;0;0;0;.00nan;0;0
11210;-1;216;92;44;4;40;.909;3847000;0
11210;-1;177;0;0;0;0;.00nan;0;0
11176;206801;176;78;32;2;30;.938;3579000;0
11176;-1;2620;0;0;0;0;.00nan;0;0
11176;213533;176;0;0;0;0;.00nan;0;0
11176;213550;2620;80;26;1;25;.962;3600000;0
11444;215240;231;0;0;0;0;.00nan;0;0
11444;189773;231;81;15;0;15;1.000;3600000;0
11444;180377;228;60;59;8;51;.864;3600000;0
11444;208044;228;0;0;0;0;.00nan;0;0
11278;183695;232;76;24;1;23;.958;3600000;0
11278;211080;229;66;50;6;44;.880;3600000;0
11278;-1;232;0;0;0;0;.00nan;0;0
11278;-1;229;0;0;0;0;.00nan;0;0
11277;198172;181;47;27;4;23;.852;3900000;0
11277;216001;181;0;0;0;0;.00nan;0;0
11277;-1;1371;0;0;0;0;.00nan;0;0
11277;-1;1371;87;54;4;50;.926;3900000;0
11628;209840;184;0;0;0;0;.00nan;0;0
11628;205837;184;71;26;2;24;.923;3600000;0
11628;196088;185;72;40;4;36;.900;3600000;0
11628;-1;185;0;0;0;0;.00nan;0;0
11281;192939;208;35;20;4;16;.800;3600000;0
11281;201525;203;86;58;5;53;.914;3541000;0
11281;206772;203;0;0;0;0;.00nan;0;0
11281;-1;208;0;0;0;0;.00nan;0;0
11599;194950;1505;81;15;0;15;1.000;3600000;0
11599;212814;1505;0;0;0;0;.00nan;0;0
11599;-1;4949;92;36;2;34;.944;3546000;0
11599;-1;4949;0;0;0;0;.00nan;0;0
11481;188977;215;41;31;5;26;.839;3600000;0
11481;210794;215;0;0;0;0;.00nan;0;0
11481;191130;186;0;0;0;0;.00nan;0;0
11481;213507;186;79;43;3;40;.930;3600000;0
11289;212143;198;100;29;0;29;1.000;3600000;0
11289;212649;198;0;0;0;0;.00nan;0;0
11289;-1;189;0;0;0;0;.00nan;0;0
11289;-1;189;68;33;3;30;.909;3600000;0
11302;201560;202;55;33;4;29;.879;3600000;0
11302;196283;206;0;0;0;0;.00nan;0;0
11302;208067;202;0;0;0;0;.00nan;0;0
11302;202998;206;85;29;1;28;.966;3600000;0
11528;190164;4959;0;0;0;0;.00nan;0;0
11528;-1;209;0;0;0;0;.00nan;0;0
11528;-1;4959;56;37;4;33;.892;3600000;0
11528;213590;209;68;30;3;27;.900;3600000;0
11341;195363;222;90;29;1;28;.966;3600000;0
11341;206800;225;0;0;0;0;.00nan;0;0
11341;-1;225;83;39;3;36;.923;3566000;0
11341;213560;222;0;0;0;0;.00nan;0;0
11476;211017;220;88;29;1;28;.966;3600000;0
11476;185810;182;77;41;4;37;.902;3600000;0
11476;218510;220;0;0;0;0;.00nan;0;0
11476;213498;182;0;0;0;0;.00nan;0;0
11400;192915;179;67;17;1;16;.941;1311000;0
11400;187355;179;13;21;6;15;.714;2238000;0
11400;197672;210;34;26;5;21;.808;3600000;0
11400;-1;210;0;0;0;0;.00nan;0;0
11320;200444;224;43;16;3;13;.813;3545000;0
11320;217269;223;99;52;2;50;.962;3600000;0
11320;217312;223;0;0;0;0;.00nan;0;0
11320;208372;224;0;0;0;0;.00nan;0;0
11397;210504;193;65;26;3;23;.885;3600000;0
11397;195118;197;0;0;0;0;.00nan;0;0
11397;206822;197;51;38;5;33;.868;3597000;0
11397;218059;193;0;0;0;0;.00nan;0;0
11394;213803;230;95;25;0;25;1.000;3600000;0
11394;200452;221;65;29;2;27;.931;3520000;0
11394;191120;230;0;0;0;0;.00nan;0;0
11394;-1;221;0;0;0;0;.00nan;0;0
11381;199416;191;0;0;0;0;.00nan;0;0
11381;204676;192;0;0;0;0;.00nan;0;0
11381;201892;191;78;30;2;28;.933;3600000;0
11381;207398;192;48;20;3;17;.850;3594000;0
11275;211017;220;0;0;0;0;.00nan;0;0
11275;218510;220;73;42;4;38;.905;3600000;0
11275;-1;1371;20;12;4;8;.667;855000;0
11275;-1;1371;34;24;5;19;.792;2745000;0
11350;196088;185;0;0;0;0;.00nan;0;0
11350;185810;182;80;14;0;14;1.000;3600000;0
11350;-1;185;91;37;2;35;.946;3593000;0
11350;213498;182;0;0;0;0;.00nan;0;0
11334;199416;191;51;30;4;26;.867;3600000;0
11334;201892;191;0;0;0;0;.00nan;0;0
11334;191118;196;49;39;6;33;.846;2320000;0
11334;202830;196;39;12;3;9;.750;1280000;0
11443;194950;1505;82;16;0;16;1.000;3600000;0
11443;212814;1505;0;0;0;0;.00nan;0;0
11443;-1;4949;0;0;0;0;.00nan;0;0
11443;-1;4949;71;35;3;32;.914;3600000;0
11340;196296;219;0;0;0;0;.00nan;0;0
11340;218658;219;95;43;2;41;.953;3600000;0
11340;-1;212;50;22;3;19;.864;3600000;0
11340;-1;212;0;0;0;0;.00nan;0;0
11296;192939;208;0;0;0;0;.00nan;0;0
11296;205788;207;0;0;0;0;.00nan;0;0
11296;197853;207;49;31;4;27;.871;3515000;0
11296;-1;208;74;29;2;27;.931;3600000;0
11283;211942;183;65;26;2;24;.923;3768000;0
11283;196237;183;0;0;0;0;.00nan;0;0
11283;-1;178;0;0;0;0;.00nan;0;0
11283;-1;178;75;41;3;38;.927;3768000;0
11452;206800;225;0;0;0;0;.00nan;0;0
11452;206971;4960;77;31;2;29;.935;3618000;0
11452;212304;4960;0;0;0;0;.00nan;0;0
11452;-1;225;99;43;1;42;.977;3618000;0
11140;205681;226;0;0;0;0;.00nan;0;0
11140;-1;226;55;17;2;15;.882;3556000;0
11140;-1;199;0;0;0;0;.00nan;0;0
11140;-1;199;78;24;1;23;.958;3600000;0
11548;198149;188;0;0;0;0;.00nan;0;0
11548;200333;194;100;28;0;28;1.000;3600000;0
11548;184409;188;31;38;7;31;.816;3600000;0
11548;196352;194;0;0;0;0;.00nan;0;0
11254;201718;217;70;35;3;32;.914;3576000;0
11254;191130;186;84;32;1;31;.969;3600000;0
11254;213507;186;0;0;0;0;.00nan;0;0
11254;-1;217;0;0;0;0;.00nan;0;0
11418;183695;232;71;25;2;23;.920;3600000;0
11418;217269;223;54;6;0;6;1.000;355000;0
11418;217312;223;34;32;6;26;.813;3245000;0
11418;-1;232;0;0;0;0;.00nan;0;0
11496;200444;224;0;0;0;0;.00nan;0;0
11496;201514;227;92;45;3;42;.933;3641000;0
11496;213280;227;0;0;0;0;.00nan;0;0
11496;208372;224;70;24;2;22;.917;3641000;0
11319;206833;4864;77;28;2;26;.929;3600000;0
11319;-1;209;70;44;4;40;.909;3587000;0
11319;202801;4864;0;0;0;0;.00nan;0;0
11319;213590;209;0;0;0;0;.00nan;0;0
11240;198172;181;0;0;0;0;.00nan;0;0
11240;209840;184;84;40;4;36;.900;3576000;0
11240;205837;184;0;0;0;0;.00nan;0;0
11240;216001;181;61;24;2;22;.917;3600000;0
11138;192862;187;65;29;4;25;.862;3600000;0
11138;215703;195;0;0;0;0;.00nan;0;0
11138;207061;195;82;27;1;26;.963;3600000;0
11138;-1;187;0;0;0;0;.00nan;0;0
11353;215240;231;0;0;0;0;.00nan;0;0
11353;189773;231;86;24;2;22;.917;3574000;0
11353;195363;222;0;0;0;0;.00nan;0;0
11353;213560;222;99;46;1;45;.978;3600000;0
11260;201495;213;0;0;0;0;.00nan;0;0
11260;217198;213;68;42;4;38;.905;3600000;0
11260;213399;216;97;34;1;33;.971;3600000;0
11260;-1;216;0;0;0;0;.00nan;0;0
11115;200437;201;87;32;1;31;.969;3600000;0
11115;205769;200;100;31;0;31;1.000;3600000;0
11115;212002;200;0;0;0;0;.00nan;0;0
11115;208048;201;0;0;0;0;.00nan;0;0
11108;212050;218;0;0;0;0;.00nan;0;0
11108;196296;219;98;50;4;46;.920;3513000;0
11108;208051;218;67;18;2;16;.889;3600000;0
11108;218658;219;0;0;0;0;.00nan;0;0
11261;213803;230;63;28;3;25;.893;3544000;0
11261;211080;229;78;31;2;29;.935;3600000;0
11261;191120;230;0;0;0;0;.00nan;0;0
11261;-1;229;0;0;0;0;.00nan;0;0
11247;196283;206;99;39;1;38;.974;3600000;0
11247;202998;206;0;0;0;0;.00nan;0;0
11247;203087;204;0;0;0;0;.00nan;0;0
11247;203120;204;41;30;5;25;.833;3600000;0
11148;215703;195;0;0;0;0;.00nan;0;0
11148;207061;195;46;22;3;19;.864;3600000;0
11148;-1;190;100;42;0;42;1.000;3600000;0
11148;-1;190;0;0;0;0;.00nan;0;0
11360;195118;197;0;0;0;0;.00nan;0;0
11360;206822;197;74;22;1;21;.955;3600000;0
11360;191118;196;73;32;2;30;.938;3585000;0
11360;202830;196;0;0;0;0;.00nan;0;0
11634;216313;180;59;16;1;15;.938;3600000;0
11634;191063;211;0;0;0;0;.00nan;0;0
11634;-1;211;57;36;4;32;.889;3600000;0
11634;208383;180;0;0;0;0;.00nan;0;0
11158;205681;226;65;13;1;12;.923;3600000;0
11158;-1;226;0;0;0;0;.00nan;0;0
11158;-1;199;72;36;3;33;.917;3600000;0
11158;-1;199;0;0;0;0;.00nan;0;0
11666;192915;179;0;0;0;0;.00nan;0;0
11666;187355;179;73;29;2;27;.931;3600000;0
11666;197672;210;0;0;0;0;.00nan;0;0
11666;-1;210;91;33;1;32;.970;3600000;0
11370;192862;187;0;0;0;0;.00nan;0;0
11370;200333;194;28;8;3;5;.625;500000;0
11370;196352;194;78;26;1;25;.962;3099000;0
11370;-1;187;49;18;3;15;.833;3600000;0
11386;206971;4960;92;19;0;19;1.000;3600000;0
11386;212304;4960;0;0;0;0;.00nan;0;0
11386;180377;228;77;51;5;46;.902;3600000;0
11386;208044;228;0;0;0;0;.00nan;0;0
11336;205788;207;37;35;6;29;.829;3600000;0
11336;201560;202;27;12;4;8;.667;772000;0
11336;208067;202;60;28;3;25;.893;2758000;0
11336;197853;207;0;0;0;0;.00nan;0;0
11172;206801;176;86;43;3;40;.930;3600000;0
11172;-1;2620;60;32;4;28;.875;3566000;0
11172;213533;176;0;0;0;0;.00nan;0;0
11172;213550;2620;0;0;0;0;.00nan;0;0
11413;204676;192;0;0;0;0;.00nan;0;0
11413;210504;193;83;40;3;37;.925;3600000;0
11413;207398;192;54;31;4;27;.871;3600000;0
11413;218059;193;0;0;0;0;.00nan;0;0
11574;194950;1505;75;18;1;17;.944;3600000;0
11574;212814;1505;0;0;0;0;.00nan;0;0
11574;197672;210;93;55;3;52;.945;3515000;0
11574;-1;210;0;0;0;0;.00nan;0;0
11258;200444;224;89;28;1;27;.964;3600000;0
11258;211080;229;0;0;0;0;.00nan;0;0
11258;208372;224;0;0;0;0;.00nan;0;0
11258;-1;229;61;47;5;42;.894;3600000;0
11385;180377;228;0;0;0;0;.00nan;0;0
11385;217269;223;0;0;0;0;.00nan;0;0
11385;217312;223;57;26;3;23;.885;3600000;0
11385;208044;228;68;22;1;21;.955;3600000;0
11478;215240;231;0;0;0;0;.00nan;0;0
11478;200452;221;100;55;2;53;.964;3900000;0
11478;189773;231;46;16;2;14;.875;3900000;0
11478;-1;221;0;0;0;0;.00nan;0;0
11317;201524;205;0;0;0;0;.00nan;0;0
11317;196283;206;0;0;0;0;.00nan;0;0
11317;-1;205;51;21;3;18;.857;3600000;0
11317;202998;206;54;45;6;39;.867;3600000;0
11309;198149;188;62;43;5;38;.884;3089000;0
11309;184409;188;27;7;3;4;.571;511000;0
11309;-1;190;92;31;1;30;.968;3600000;0
11309;-1;190;0;0;0;0;.00nan;0;0
11286;201495;213;59;11;1;10;.909;1465000;0
11286;217198;213;48;29;4;25;.862;2122000;0
11286;-1;4949;45;25;4;21;.840;3600000;0
11286;-1;4949;0;0;0;0;.00nan;0;0
11337;182014;214;0;0;0;0;.00nan;0;0
11337;202914;214;88;34;1;33;.971;3600000;0
11337;-1;1371;57;20;2;18;.900;3576000;0
11337;-1;1371;0;0;0;0;.00nan;0;0
11285;209840;184;0;0;0;0;.00nan;0;0
11285;205837;184;67;20;2;18;.900;3900000;0
11285;211017;220;58;20;2;18;.900;3900000;0
11285;218510;220;0;0;0;0;.00nan;0;0
11531;198172;181;89;64;6;58;.906;3126000;0
11531;216001;181;59;4;0;4;1.000;474000;0
11531;185810;182;76;36;3;33;.917;3600000;0
11531;213498;182;0;0;0;0;.00nan;0;0
11347;196571;177;34;32;6;26;.813;3600000;0
11347;-1;178;0;0;0;0;.00nan;0;0
11347;-1;178;60;25;2;23;.920;3600000;0
11347;-1;177;0;0;0;0;.00nan;0;0
11348;204676;192;68;23;2;21;.913;3597000;0
11348;207398;192;0;0;0;0;.00nan;0;0
11348;-1;189;0;0;0;0;.00nan;0;0
11348;-1;189;81;23;1;22;.957;3600000;0
11401;192939;208;35;21;4;17;.810;3600000;0
11401;-1;208;0;0;0;0;.00nan;0;0
11401;203087;204;97;34;1;33;.971;3600000;0
11401;203120;204;0;0;0;0;.00nan;0;0
11335;188977;215;49;2;0;2;1.000;260000;0
11335;210794;215;45;39;6;33;.846;3309000;0
11335;216313;180;0;0;0;0;.00nan;0;0
11335;208383;180;54;26;4;22;.846;3600000;0
11333;192915;179;77;32;3;29;.906;3555000;0
11333;211942;183;76;24;2;22;.917;3600000;0
11333;196237;183;0;0;0;0;.00nan;0;0
11333;187355;179;0;0;0;0;.00nan;0;0
11373;201718;217;0;0;0;0;.00nan;0;0
11373;191063;211;48;22;3;19;.864;3545000;0
11373;-1;211;0;0;0;0;.00nan;0;0
11373;-1;217;73;31;2;29;.935;3600000;0
11368;201514;227;0;0;0;0;.00nan;0;0
11368;206800;225;0;0;0;0;.00nan;0;0
11368;-1;225;50;26;4;22;.846;3517000;0
11368;213280;227;57;20;2;18;.900;3600000;0
11451;199416;191;0;0;0;0;.00nan;0;0
11451;195118;197;13;17;6;11;.647;1766000;0
11451;206822;197;68;21;1;20;.952;1834000;0
11451;201892;191;55;25;4;21;.840;3600000;0
11196;212050;218;61;33;4;29;.879;3692000;0
11196;191130;186;0;0;0;0;.00nan;0;0
11196;208051;218;0;0;0;0;.00nan;0;0
11196;213507;186;54;24;3;21;.875;3692000;0
11241;206801;176;0;0;0;0;.00nan;0;0
11241;206833;4864;0;0;0;0;.00nan;0;0
11241;202801;4864;77;15;0;15;1.000;3600000;0
11241;213533;176;96;45;2;43;.956;3600000;0
11356;183695;232;0;0;0;0;.00nan;0;0
11356;195363;222;73;35;3;32;.914;3600000;0
11356;213560;222;0;0;0;0;.00nan;0;0
11356;-1;232;50;33;4;29;.879;3570000;0
11441;201525;203;72;36;4;32;.889;3900000;0
11441;201560;202;50;25;4;21;.840;3900000;0
11441;206772;203;0;0;0;0;.00nan;0;0
11441;208067;202;0;0;0;0;.00nan;0;0
11236;200437;201;80;22;1;21;.955;3600000;0
11236;205769;200;58;45;6;39;.867;3600000;0
11236;212002;200;0;0;0;0;.00nan;0;0
11236;208048;201;0;0;0;0;.00nan;0;0
11431;210504;193;61;22;1;21;.955;3900000;0
11431;212143;198;89;35;1;34;.971;3900000;0
11431;212649;198;0;0;0;0;.00nan;0;0
11431;218059;193;0;0;0;0;.00nan;0;0
11197;190164;4959;0;0;0;0;.00nan;0;0
11197;-1;4959;93;35;1;34;.971;3600000;0
11197;-1;2620;0;0;0;0;.00nan;0;0
11197;213550;2620;51;34;5;29;.853;3600000;0
11494;198149;188;54;23;3;20;.870;3600000;0
11494;210504;193;50;14;2;12;.857;3600000;0
11494;184409;188;0;0;0;0;.00nan;0;0
11494;218059;193;0;0;0;0;.00nan;0;0
11225;205769;200;0;0;0;0;.00nan;0;0
11225;205788;207;0;0;0;0;.00nan;0;0
11225;212002;200;46;30;4;26;.867;3600000;0
11225;197853;207;84;34;1;33;.971;3600000;0
11282;205681;226;0;0;0;0;.00nan;0;0
11282;196283;206;0;0;0;0;.00nan;0;0
11282;-1;226;83;33;2;31;.939;3600000;0
11282;202998;206;52;29;4;25;.862;3565000;0
11211;216313;180;63;27;3;24;.889;3600000;0
11211;212050;218;0;0;0;0;.00nan;0;0
11211;208051;218;61;33;4;29;.879;3587000;0
11211;208383;180;0;0;0;0;.00nan;0;0
11342;211942;183;62;29;3;26;.897;3900000;0
11342;196237;183;0;0;0;0;.00nan;0;0
11342;196571;177;78;39;3;36;.923;3900000;0
11342;-1;177;0;0;0;0;.00nan;0;0
11537;200444;224;0;0;0;0;.00nan;0;0
11537;206971;4960;67;34;3;31;.912;3600000;0
11537;212304;4960;0;0;0;0;.00nan;0;0
11537;208372;224;83;33;2;31;.939;3600000;0
11521;209840;184;0;0;0;0;.00nan;0;0
11521;205837;184;91;41;2;39;.951;3600000;0
11521;-1;1371;0;0;0;0;.00nan;0;0
11521;-1;1371;57;25;3;22;.880;3544000;0
11475;192915;179;0;0;0;0;.00nan;0;0
11475;187355;179;58;19;3;16;.842;3600000;0
11475;-1;178;0;0;0;0;.00nan;0;0
11475;-1;178;66;30;2;28;.933;3600000;0
11310;201495;213;0;0;0;0;.00nan;0;0
11310;217198;213;58;42;6;36;.857;3600000;0
11310;197672;210;0;0;0;0;.00nan;0;0
11310;-1;210;93;18;0;18;1.000;3600000;0
11408;192862;187;40;31;5;26;.839;3731000;0
11408;212143;198;52;32;4;28;.875;3731000;0
11408;212649;198;0;0;0;0;.00nan;0;0
11408;-1;187;0;0;0;0;.00nan;0;0
11321;211017;220;43;15;3;12;.800;3600000;0
11321;196088;185;69;37;4;33;.892;3600000;0
11321;-1;185;0;0;0;0;.00nan;0;0
11321;218510;220;0;0;0;0;.00nan;0;0
11564;204676;192;0;0;0;0;.00nan;0;0
11564;207398;192;97;34;1;33;.971;3900000;0
11564;-1;190;0;0;0;0;.00nan;0;0
11564;-1;190;100;43;1;42;.977;3900000;0
11345;190164;4959;0;0;0;0;.00nan;0;0
11345;206833;4864;0;0;0;0;.00nan;0;0
11345;202801;4864;60;17;2;15;.882;3514000;0
11345;-1;4959;100;39;0;39;1.000;3600000;0
11307;191130;186;11;20;7;13;.650;1939000;0
11307;213507;186;49;17;2;15;.882;1661000;0
11307;-1;212;54;20;3;17;.850;3600000;0
11307;-1;212;0;0;0;0;.00nan;0;0
11545;200452;221;35;27;6;21;.778;2545000;0
11545;195363;222;0;0;0;0;.00nan;0;0
11545;213560;222;99;25;0;25;1.000;3600000;0
11545;-1;221;46;5;1;4;.800;1055000;0
11376;191118;196;52;19;2;17;.895;3600000;0
11376;-1;189;0;0;0;0;.00nan;0;0
11376;202830;196;0;0;0;0;.00nan;0;0
11376;-1;189;90;25;0;25;1.000;3600000;0
11199;190164;4959;0;0;0;0;.00nan;0;0
11199;-1;4959;97;45;3;42;.933;3600000;0
11199;-1;2620;0;0;0;0;.00nan;0;0
11199;213550;2620;88;21;0;21;1.000;3600000;0
11362;191118;196;0;0;0;0;.00nan;0;0
11362;-1;189;0;0;0;0;.00nan;0;0
11362;202830;196;99;38;1;37;.974;3600000;0
11362;-1;189;58;19;2;17;.895;3566000;0
11312;195118;197;0;0;0;0;.00nan;0;0
11312;206822;197;67;30;3;27;.900;3600000;0
11312;-1;190;44;33;5;28;.848;3520000;0
11312;-1;190;0;0;0;0;.00nan;0;0
11364;192939;208;0;0;0;0;.00nan;0;0
11364;205788;207;63;37;5;32;.865;3600000;0
11364;197853;207;0;0;0;0;.00nan;0;0
11364;-1;208;78;14;0;14;1.000;3600000;0
11391;-1;178;49;32;4;28;.875;3545000;0
11391;197672;210;0;0;0;0;.00nan;0;0
11391;-1;178;0;0;0;0;.00nan;0;0
11391;-1;210;71;25;2;23;.920;3600000;0
11194;206801;176;53;15;2;13;.867;3600000;0
11194;-1;209;0;0;0;0;.00nan;0;0
11194;213533;176;0;0;0;0;.00nan;0;0
11194;213590;209;53;35;5;30;.857;3600000;0
11327;212050;218;100;38;1;37;.974;3600000;0
11327;201718;217;0;0;0;0;.00nan;0;0
11327;208051;218;0;0;0;0;.00nan;0;0
11327;-1;217;77;41;4;37;.902;3600000;0
11290;213803;230;64;14;1;13;.929;3600000;0
11290;211080;229;88;49;4;45;.918;3600000;0
11290;191120;230;0;0;0;0;.00nan;0;0
11290;-1;229;0;0;0;0;.00nan;0;0
11596;196296;219;0;0;0;0;.00nan;0;0
11596;191063;211;0;0;0;0;.00nan;0;0
11596;-1;211;80;28;2;26;.929;3600000;0
11596;218658;219;59;29;4;25;.862;3519000;0
11473;200444;224;62;16;1;15;.938;3600000;0
11473;206800;225;0;0;0;0;.00nan;0;0
11473;-1;225;84;37;3;34;.919;3588000;0
11473;208372;224;0;0;0;0;.00nan;0;0
11274;201560;202;52;21;3;18;.857;3565000;0
11274;208067;202;0;0;0;0;.00nan;0;0
11274;-1;199;0;0;0;0;.00nan;0;0
11274;-1;199;71;23;1;22;.957;3600000;0
11358;194950;1505;56;12;1;11;.917;3600000;0
11358;201495;213;0;0;0;0;.00nan;0;0
11358;217198;213;81;40;2;38;.950;3600000;0
11358;212814;1505;0;0;0;0;.00nan;0;0
11152;198149;188;0;0;0;0;.00nan;0;0
11152;215703;195;0;0;0;0;.00nan;0;0
11152;184409;188;74;39;3;36;.923;3559000;0
11152;207061;195;71;20;1;19;.950;3600000;0
11248;200437;201;47;27;4;23;.852;3543000;0
11248;208048;201;0;0;0;0;.00nan;0;0
11248;203087;204;0;0;0;0;.00nan;0;0
11248;203120;204;69;35;3;32;.914;3600000;0
11616;199416;191;0;0;0;0;.00nan;0;0
11616;212143;198;0;0;0;0;.00nan;0;0
11616;201892;191;75;38;4;34;.895;3543000;0
11616;212649;198;60;29;3;26;.897;3600000;0
11263;198172;181;0;0;0;0;.00nan;0;0
11263;216001;181;62;13;1;12;.923;3736000;0
11263;196088;185;0;0;0;0;.00nan;0;0
11263;-1;185;73;28;2;26;.929;3736000;0
11487;180377;228;66;34;4;30;.882;3815000;0
11487;217269;223;56;25;3;22;.880;3815000;0
11487;217312;223;0;0;0;0;.00nan;0;0
11487;208044;228;0;0;0;0;.00nan;0;0
11410;188977;215;0;0;0;0;.00nan;0;0
11410;210794;215;74;39;3;36;.923;3585000;0
11410;191130;186;0;0;0;0;.00nan;0;0
11410;213507;186;88;34;2;32;.941;3600000;0
11489;182014;214;0;0;0;0;.00nan;0;0
11489;202914;214;69;28;3;25;.893;3900000;0
11489;-1;1371;66;38;3;35;.921;3900000;0
11489;-1;1371;0;0;0;0;.00nan;0;0
11470;215240;231;0;0;0;0;.00nan;0;0
11470;189773;231;87;17;0;17;1.000;3600000;0
11470;195363;222;0;0;0;0;.00nan;0;0
11470;213560;222;81;50;5;45;.900;3600000;0
11251;211017;220;0;0;0;0;.00nan;0;0
11251;185810;182;62;23;2;21;.913;3553000;0
11251;218510;220;100;33;0;33;1.000;3600000;0
11251;213498;182;0;0;0;0;.00nan;0;0
11352;192915;179;71;21;2;19;.905;3600000;0
11352;187355;179;0;0;0;0;.00nan;0;0
11352;213399;216;0;0;0;0;.00nan;0;0
11352;-1;216;62;32;3;29;.906;3589000;0
11411;211942;183;0;0;0;0;.00nan;0;0
11411;196237;183;53;40;5;35;.875;3555000;0
11411;-1;4949;54;23;3;20;.870;3600000;0
11411;-1;4949;0;0;0;0;.00nan;0;0
11445;200452;221;74;31;2;29;.935;3730000;0
11445;201514;227;0;0;0;0;.00nan;0;0
11445;213280;227;74;31;3;28;.903;3730000;0
11445;-1;221;0;0;0;0;.00nan;0;0
11167;200333;194;0;0;0;0;.00nan;0;0
11167;215703;195;50;18;2;16;.889;3600000;0
11167;207061;195;0;0;0;0;.00nan;0;0
11167;196352;194;86;65;6;59;.908;3600000;0
11330;183695;232;95;16;0;16;1.000;3600000;0
11330;211080;229;0;0;0;0;.00nan;0;0
11330;-1;232;0;0;0;0;.00nan;0;0
11330;-1;229;98;59;4;55;.932;3600000;0
11276;198172;181;34;32;6;26;.813;3268000;0
11276;216001;181;53;2;0;2;1.000;332000;0
11276;185810;182;82;30;1;29;.967;3600000;0
11276;213498;182;0;0;0;0;.00nan;0;0
11221;196283;206;83;30;2;28;.933;3600000;0
11221;-1;199;73;42;4;38;.905;3580000;0
11221;-1;199;0;0;0;0;.00nan;0;0
11221;202998;206;0;0;0;0;.00nan;0;0
11383;201524;205;0;0;0;0;.00nan;0;0
11383;-1;205;22;17;5;12;.706;3600000;0
11383;203087;204;92;46;2;44;.957;3600000;0
11383;203120;204;0;0;0;0;.00nan;0;0
11369;201495;213;0;0;0;0;.00nan;0;0
11369;217198;213;81;52;4;48;.923;3600000;0
11369;213399;216;0;0;0;0;.00nan;0;0
11369;-1;216;36;24;5;19;.792;3554000;0
11243;206801;176;37;28;5;23;.821;3600000;0
11243;-1;209;0;0;0;0;.00nan;0;0
11243;213533;176;0;0;0;0;.00nan;0;0
11243;213590;209;92;34;1;33;.971;3600000;0
11469;211942;183;60;22;2;20;.909;3900000;0
11469;196237;183;0;0;0;0;.00nan;0;0
11469;-1;178;0;0;0;0;.00nan;0;0
11469;-1;178;96;46;2;44;.957;3900000;0
11407;199416;191;0;0;0;0;.00nan;0;0
11407;201892;191;76;30;3;27;.900;3600000;0
11407;191118;196;67;40;4;36;.900;3600000;0
11407;202830;196;0;0;0;0;.00nan;0;0
11371;194950;1505;0;0;0;0;.00nan;0;0
11371;196571;177;40;22;4;18;.818;1168000;0
11371;212814;1505;25;15;4;11;.733;3600000;0
11371;-1;177;79;32;2;30;.938;2412000;0
11246;216313;180;20;11;4;7;.636;1132000;0
11246;212050;218;0;0;0;0;.00nan;0;0
11246;208051;218;89;31;1;30;.968;3600000;0
11246;208383;180;52;20;2;18;.900;2468000;0
11365;211017;220;0;0;0;0;.00nan;0;0
11365;182014;214;0;0;0;0;.00nan;0;0
11365;218510;220;63;41;4;37;.902;3570000;0
11365;202914;214;65;30;3;27;.900;3600000;0
11306;200437;201;92;28;1;27;.964;3600000;0
11306;196283;206;0;0;0;0;.00nan;0;0
11306;208048;201;0;0;0;0;.00nan;0;0
11306;202998;206;70;38;4;34;.895;3600000;0
11239;205769;200;0;0;0;0;.00nan;0;0
11239;201525;203;67;25;3;22;.880;3564000;0
11239;212002;200;78;33;2;31;.939;3600000;0
11239;206772;203;0;0;0;0;.00nan;0;0
11412;191130;186;0;0;0;0;.00nan;0;0
11412;213507;186;48;36;5;31;.861;3600000;0
11412;-1;212;0;0;0;0;.00nan;0;0
11412;-1;212;56;26;3;23;.885;3600000;0
11414;183695;232;47;40;6;34;.850;2779000;0
11414;215240;231;0;0;0;0;.00nan;0;0
11414;189773;231;82;25;1;24;.960;3600000;0
11414;-1;232;25;12;4;8;.667;821000;0
11457;200333;194;70;32;3;29;.906;3900000;0
11457;196352;194;0;0;0;0;.00nan;0;0
11457;-1;189;0;0;0;0;.00nan;0;0
11457;-1;189;70;30;3;27;.900;3900000;0
11378;201718;217;52;30;4;26;.867;3599000;0
11378;191063;211;0;0;0;0;.00nan;0;0
11378;-1;211;86;36;2;34;.944;3600000;0
11378;-1;217;0;0;0;0;.00nan;0;0
11459;198149;188;83;30;1;29;.967;3600000;0
11459;195118;197;0;0;0;0;.00nan;0;0
11459;184409;188;0;0;0;0;.00nan;0;0
11459;206822;197;63;15;2;13;.867;3600000;0
11396;192939;208;0;0;0;0;.00nan;0;0
11396;205681;226;0;0;0;0;.00nan;0;0
11396;-1;226;54;26;4;22;.846;3564000;0
11396;-1;208;66;32;3;29;.906;3600000;0
11395;190164;4959;54;9;1;8;.889;1259000;0
11395;-1;4959;30;25;6;19;.760;2316000;0
11395;-1;2620;50;0;0;0;.00nan;533000;0
11395;213550;2620;25;21;6;15;.714;3067000;0
11390;213803;230;35;18;4;14;.778;3600000;0
11390;195363;222;99;46;2;44;.957;3600000;0
11390;191120;230;0;0;0;0;.00nan;0;0
11390;213560;222;0;0;0;0;.00nan;0;0
11448;-1;4949;0;0;0;0;.00nan;0;0
11448;197672;210;0;0;0;0;.00nan;0;0
11448;-1;4949;40;22;4;18;.818;3600000;0
11448;-1;210;100;36;0;36;1.000;3600000;0
11498;200452;221;0;0;0;0;.00nan;0;0
11498;180377;228;54;34;4;30;.882;3567000;0
11498;208044;228;0;0;0;0;.00nan;0;0
11498;-1;221;77;33;2;31;.939;3600000;0
11424;192862;187;70;37;3;34;.919;3900000;0
11424;210504;193;74;34;3;31;.912;3900000;0
11424;218059;193;0;0;0;0;.00nan;0;0
11424;-1;187;0;0;0;0;.00nan;0;0
11398;205788;207;0;0;0;0;.00nan;0;0
11398;201525;203;0;0;0;0;.00nan;0;0
11398;206772;203;72;30;2;28;.933;3600000;0
11398;197853;207;55;29;4;25;.862;3530000;0
11259;206801;176;0;0;0;0;.00nan;0;0
11259;-1;209;71;24;2;22;.917;3600000;0
11259;213533;176;100;42;1;41;.976;3600000;0
11259;213590;209;0;0;0;0;.00nan;0;0
11168;204676;192;79;40;3;37;.925;3293000;0
11168;215703;195;0;0;0;0;.00nan;0;0
11168;207061;195;69;32;4;28;.875;3600000;0
11168;207398;192;19;8;4;4;.500;307000;0
11372;196296;219;0;0;0;0;.00nan;0;0
11372;218658;219;52;25;3;22;.880;3514000;0
11372;-1;212;83;23;1;22;.957;3600000;0
11372;-1;212;0;0;0;0;.00nan;0;0
11338;211080;229;100;40;1;39;.975;3600000;0
11338;217269;223;0;0;0;0;.00nan;0;0
11338;217312;223;47;19;3;16;.842;3526000;0
11338;-1;229;0;0;0;0;.00nan;0;0
11318;198172;181;0;0;0;0;.00nan;0;0
11318;216001;181;100;45;2;43;.956;3900000;0
11318;196088;185;0;0;0;0;.00nan;0;0
11318;-1;185;77;34;2;32;.941;3900000;0
11421;194950;1505;76;30;3;27;.900;3600000;0
11421;196571;177;30;28;6;22;.786;2669000;0
11421;212814;1505;0;0;0;0;.00nan;0;0
11421;-1;177;52;8;1;7;.875;931000;0
11519;209840;184;0;0;0;0;.00nan;0;0
11519;205837;184;70;30;3;27;.900;3600000;0
11519;-1;1371;0;0;0;0;.00nan;0;0
11519;-1;1371;58;34;4;30;.882;3600000;0
11653;216313;180;62;22;2;20;.909;3600000;0
11653;191063;211;0;0;0;0;.00nan;0;0
11653;-1;211;78;40;3;37;.925;3600000;0
11653;208383;180;0;0;0;0;.00nan;0;0
11295;205769;200;90;16;0;16;1.000;3600000;0
11295;201560;202;95;31;1;30;.968;3565000;0
11295;212002;200;0;0;0;0;.00nan;0;0
11295;208067;202;0;0;0;0;.00nan;0;0
11392;206833;4864;0;0;0;0;.00nan;0;0
11392;202801;4864;82;30;1;29;.967;3600000;0
11392;-1;2620;54;39;5;34;.872;3600000;0
11392;213550;2620;0;0;0;0;.00nan;0;0
11549;213399;216;86;31;1;30;.968;3600000;0
11549;-1;4949;29;27;5;22;.815;3600000;0
11549;-1;4949;0;0;0;0;.00nan;0;0
11549;-1;216;0;0;0;0;.00nan;0;0
11379;205681;226;56;20;2;18;.900;3600000;0
11379;-1;226;0;0;0;0;.00nan;0;0
11379;203087;204;0;0;0;0;.00nan;0;0
11379;203120;204;33;33;6;27;.818;3600000;0
11534;201514;227;0;0;0;0;.00nan;0;0
11534;206800;225;0;0;0;0;.00nan;0;0
11534;-1;225;99;34;1;33;.971;3600000;0
11534;213280;227;79;34;2;32;.941;3600000;0
11324;200437;201;0;0;0;0;.00nan;0;0
11324;208048;201;67;26;3;23;.885;3600000;0
11324;-1;199;0;0;0;0;.00nan;0;0
11324;-1;199;89;55;4;51;.927;3557000;0
11460;195118;197;30;11;3;8;.727;564000;0
11460;206822;197;73;35;3;32;.914;3036000;0
11460;212143;198;85;27;1;26;.963;3600000;0
11460;212649;198;0;0;0;0;.00nan;0;0
11483;215240;231;82;46;3;43;.935;3597000;0
11483;189773;231;0;0;0;0;.00nan;0;0
11483;206971;4960;73;30;2;28;.933;3600000;0
11483;212304;4960;0;0;0;0;.00nan;0;0
11382;209840;184;54;42;6;36;.857;3144000;0
11382;205837;184;55;6;0;6;1.000;448000;0
11382;185810;182;42;28;5;23;.821;3600000;0
11382;213498;182;0;0;0;0;.00nan;0;0
11409;188977;215;87;34;2;32;.941;3900000;0
11409;210794;215;0;0;0;0;.00nan;0;0
11409;201718;217;0;0;0;0;.00nan;0;0
11409;-1;217;64;22;2;20;.909;3900000;0
11500;192862;187;57;22;2;20;.909;3600000;0
11500;200333;194;75;36;3;33;.917;3573000;0
11500;196352;194;0;0;0;0;.00nan;0;0
11500;-1;187;0;0;0;0;.00nan;0;0
11497;183695;232;0;0;0;0;.00nan;0;0
11497;206971;4960;0;0;0;0;.00nan;0;0
11497;212304;4960;83;25;1;24;.960;3600000;0
11497;-1;232;85;44;3;41;.932;3600000;0
11419;213803;230;55;15;1;14;.933;3900000;0
11419;217269;223;95;47;1;46;.979;3900000;0
11419;217312;223;0;0;0;0;.00nan;0;0
11419;191120;230;0;0;0;0;.00nan;0;0
11467;210504;193;100;34;0;34;1.000;3600000;0
11467;218059;193;0;0;0;0;.00nan;0;0
11467;-1;190;92;50;3;47;.940;3600000;0
11467;-1;190;0;0;0;0;.00nan;0;0
11415;188977;215;0;0;0;0;.00nan;0;0
11415;210794;215;57;21;2;19;.905;3600000;0
11415;196296;219;0;0;0;0;.00nan;0;0
11415;218658;219;54;41;6;35;.854;3600000;0
11462;201525;203;82;30;1;29;.967;3600000;0
11462;201560;202;0;0;0;0;.00nan;0;0
11462;206772;203;0;0;0;0;.00nan;0;0
11462;208067;202;61;32;3;29;.906;3550000;0
11582;206833;4864;0;0;0;0;.00nan;0;0
11582;202801;4864;57;41;5;36;.878;3600000;0
11582;-1;2620;0;0;0;0;.00nan;0;0
11582;213550;2620;53;46;7;39;.848;3514000;0
11507;196088;185;80;26;1;25;.962;3600000;0
11507;182014;214;0;0;0;0;.00nan;0;0
11507;-1;185;0;0;0;0;.00nan;0;0
11507;202914;214;55;31;4;27;.871;3600000;0
11484;-1;4949;33;27;6;21;.778;2792000;0
11484;197672;210;0;0;0;0;.00nan;0;0
11484;-1;4949;32;9;3;6;.667;808000;0
11484;-1;210;73;33;2;31;.939;3600000;0
11488;212050;218;0;0;0;0;.00nan;0;0
11488;201718;217;0;0;0;0;.00nan;0;0
11488;208051;218;81;14;0;14;1.000;3600000;0
11488;-1;217;65;36;4;32;.889;3600000;0
11442;183695;232;61;48;6;42;.875;3600000;0
11442;206971;4960;52;20;3;17;.850;3600000;0
11442;212304;4960;0;0;0;0;.00nan;0;0
11442;-1;232;0;0;0;0;.00nan;0;0
11504;209840;184;60;40;5;35;.875;3600000;0
11504;205837;184;0;0;0;0;.00nan;0;0
11504;185810;182;0;0;0;0;.00nan;0;0
11504;213498;182;72;24;1;23;.958;3600000;0
11493;200437;201;100;34;1;33;.971;3600000;0
11493;208048;201;0;0;0;0;.00nan;0;0
11493;-1;199;0;0;0;0;.00nan;0;0
11493;-1;199;37;30;6;24;.800;3600000;0
11560;192915;179;0;0;0;0;.00nan;0;0
11560;187355;179;76;34;2;32;.941;3600000;0
11560;-1;178;0;0;0;0;.00nan;0;0
11560;-1;178;55;44;5;39;.886;3563000;0
11416;212143;198;55;25;3;22;.880;3900000;0
11416;212649;198;0;0;0;0;.00nan;0;0
11416;191118;196;92;40;3;37;.925;3900000;0
11416;202830;196;0;0;0;0;.00nan;0;0
11430;205769;200;81;39;2;37;.949;3558000;0
11430;201524;205;0;0;0;0;.00nan;0;0
11430;212002;200;0;0;0;0;.00nan;0;0
11430;-1;205;87;28;1;27;.964;3600000;0
11573;200444;224;0;0;0;0;.00nan;0;0
11573;195363;222;0;0;0;0;.00nan;0;0
11573;213560;222;68;43;4;39;.907;3737000;0
11573;208372;224;45;18;3;15;.833;3737000;0
11604;204676;192;0;0;0;0;.00nan;0;0
11604;207398;192;73;31;2;29;.935;3543000;0
11604;-1;189;0;0;0;0;.00nan;0;0
11604;-1;189;99;35;1;34;.971;3600000;0
11344;205769;200;0;0;0;0;.00nan;0;0
11344;201525;203;57;35;4;31;.886;3571000;0
11344;212002;200;84;45;3;42;.933;3600000;0
11344;206772;203;0;0;0;0;.00nan;0;0
11486;201718;217;99;34;1;33;.971;3600000;0
11486;196296;219;58;20;2;18;.900;3551000;0
11486;218658;219;0;0;0;0;.00nan;0;0
11486;-1;217;0;0;0;0;.00nan;0;0
11423;213803;230;74;9;0;9;1.000;3600000;0
11423;211080;229;97;57;3;54;.947;3600000;0
11423;191120;230;0;0;0;0;.00nan;0;0
11423;-1;229;0;0;0;0;.00nan;0;0
11417;200333;194;0;0;0;0;.00nan;0;0
11417;196352;194;98;34;1;33;.971;3600000;0
11417;191118;196;80;35;3;32;.914;3556000;0
11417;202830;196;0;0;0;0;.00nan;0;0
11513;-1;178;0;0;0;0;.00nan;0;0
11513;-1;4949;0;0;0;0;.00nan;0;0
11513;-1;4949;53;31;4;27;.871;3600000;0
11513;-1;178;93;39;1;38;.974;3600000;0
11503;183695;232;51;24;3;21;.875;1641000;0
11503;200444;224;26;11;4;7;.636;858000;0
11503;208372;224;59;13;1;12;.923;2742000;0
11503;-1;232;17;30;7;23;.767;1959000;0
11272;190164;4959;0;0;0;0;.00nan;0;0
11272;206801;176;69;42;4;38;.905;3900000;0
11272;-1;4959;48;26;4;22;.846;3900000;0
11272;213533;176;0;0;0;0;.00nan;0;0
11427;206971;4960;54;24;2;22;.917;3559000;0
11427;212304;4960;0;0;0;0;.00nan;0;0
11427;180377;228;100;43;0;43;1.000;3600000;0
11427;208044;228;0;0;0;0;.00nan;0;0
11420;206833;4864;0;0;0;0;.00nan;0;0
11420;-1;209;0;0;0;0;.00nan;0;0
11420;202801;4864;83;23;1;22;.957;3600000;0
11420;213590;209;88;40;3;37;.925;3586000;0
11343;211017;220;82;36;2;34;.944;3600000;0
11343;185810;182;98;22;0;22;1.000;3600000;0
11343;218510;220;0;0;0;0;.00nan;0;0
11343;213498;182;0;0;0;0;.00nan;0;0
11450;205681;226;0;0;0;0;.00nan;0;0
11450;201560;202;81;44;3;41;.932;3600000;0
11450;-1;226;91;21;0;21;1.000;3600000;0
11450;208067;202;0;0;0;0;.00nan;0;0
11581;191063;211;42;3;1;2;.667;543000;0
11581;191130;186;49;20;3;17;.850;3600000;0
11581;-1;211;27;30;6;24;.800;3057000;0
11581;213507;186;0;0;0;0;.00nan;0;0
11535;195363;222;100;30;0;30;1.000;3600000;0
11535;217269;223;0;0;0;0;.00nan;0;0
11535;217312;223;79;41;3;38;.927;3600000;0
11535;213560;222;0;0;0;0;.00nan;0;0
11539;210504;193;72;26;2;24;.923;3900000;0
11539;218059;193;0;0;0;0;.00nan;0;0
11539;-1;190;87;39;2;37;.949;3900000;0
11539;-1;190;0;0;0;0;.00nan;0;0
11387;192939;208;48;21;3;18;.857;3600000;0
11387;196283;206;76;45;4;41;.911;3544000;0
11387;-1;208;0;0;0;0;.00nan;0;0
11387;202998;206;0;0;0;0;.00nan;0;0
11561;200452;221;99;40;1;39;.975;3600000;0
11561;206800;225;0;0;0;0;.00nan;0;0
11561;-1;225;77;37;2;35;.946;3593000;0
11561;-1;221;0;0;0;0;.00nan;0;0
11440;188977;215;0;0;0;0;.00nan;0;0
11440;210794;215;100;50;2;48;.960;3600000;0
11440;-1;212;50;19;3;16;.842;3575000;0
11440;-1;212;0;0;0;0;.00nan;0;0
11436;201495;213;0;0;0;0;.00nan;0;0
11436;217198;213;98;43;1;42;.977;3900000;0
11436;213399;216;0;0;0;0;.00nan;0;0
11436;-1;216;80;22;1;21;.955;3900000;0
11558;215240;231;0;0;0;0;.00nan;0;0
11558;189773;231;88;19;0;19;1.000;3600000;0
11558;201514;227;0;0;0;0;.00nan;0;0
11558;213280;227;79;51;4;47;.922;3600000;0
11323;198172;181;0;0;0;0;.00nan;0;0
11323;216001;181;86;30;1;29;.967;3900000;0
11323;-1;1371;0;0;0;0;.00nan;0;0
11323;-1;1371;81;28;1;27;.964;3900000;0
11676;198149;188;17;21;6;15;.714;1753000;0
11676;199416;191;0;0;0;0;.00nan;0;0
11676;184409;188;43;27;5;22;.815;1847000;0
11676;201892;191;77;24;1;23;.958;3600000;0
11524;-1;199;82;43;3;40;.930;3564000;0
11524;-1;199;0;0;0;0;.00nan;0;0
11524;203087;204;0;0;0;0;.00nan;0;0
11524;203120;204;58;18;2;16;.889;3600000;0
11525;205788;207;0;0;0;0;.00nan;0;0
11525;201524;205;90;29;1;28;.966;3600000;0
11525;197853;207;65;31;3;28;.903;3600000;0
11525;-1;205;0;0;0;0;.00nan;0;0
11429;192915;179;73;42;4;38;.905;3600000;0
11429;194950;1505;79;10;0;10;1.000;3600000;0
11429;212814;1505;0;0;0;0;.00nan;0;0
11429;187355;179;0;0;0;0;.00nan;0;0
11454;211942;183;68;30;3;27;.900;3553000;0
11454;196237;183;0;0;0;0;.00nan;0;0
11454;197672;210;87;39;2;37;.949;3600000;0
11454;-1;210;0;0;0;0;.00nan;0;0
11237;215703;195;0;0;0;0;.00nan;0;0
11237;195118;197;0;0;0;0;.00nan;0;0
11237;206822;197;79;57;6;51;.895;3600000;0
11237;207061;195;74;17;1;16;.941;3600000;0
11502;200437;201;68;19;1;18;.947;3900000;0
11502;201560;202;0;0;0;0;.00nan;0;0
11502;208048;201;0;0;0;0;.00nan;0;0
11502;208067;202;100;55;1;54;.982;3900000;0
11474;213803;230;77;22;1;21;.955;3600000;0
11474;180377;228;0;0;0;0;.00nan;0;0
11474;191120;230;0;0;0;0;.00nan;0;0
11474;208044;228;59;42;5;37;.881;3600000;0
11447;216313;180;96;38;1;37;.974;3600000;0
11447;208383;180;0;0;0;0;.00nan;0;0
11447;-1;212;0;0;0;0;.00nan;0;0
11447;-1;212;68;23;2;21;.913;3600000;0
11363;198172;181;100;44;0;44;1.000;3600000;0
11363;216001;181;0;0;0;0;.00nan;0;0
11363;-1;1371;62;20;2;18;.900;3544000;0
11363;-1;1371;0;0;0;0;.00nan;0;0
11492;211942;183;0;0;0;0;.00nan;0;0
11492;196237;183;58;19;2;17;.895;3600000;0
11492;213399;216;73;45;5;40;.889;3600000;0
11492;-1;216;0;0;0;0;.00nan;0;0
11479;201495;213;0;0;0;0;.00nan;0;0
11479;217198;213;98;58;3;55;.948;3580000;0
11479;-1;178;0;0;0;0;.00nan;0;0
11479;-1;178;94;35;1;34;.971;3600000;0
11472;191118;196;88;40;2;38;.950;3575000;0
11472;-1;190;87;20;0;20;1.000;3600000;0
11472;202830;196;0;0;0;0;.00nan;0;0
11472;-1;190;0;0;0;0;.00nan;0;0
11655;198149;188;0;0;0;0;.00nan;0;0
11655;184409;188;73;44;4;40;.909;3600000;0
11655;-1;189;0;0;0;0;.00nan;0;0
11655;-1;189;58;25;3;22;.880;3600000;0
11464;200333;194;0;0;0;0;.00nan;0;0
11464;195118;197;0;0;0;0;.00nan;0;0
11464;206822;197;92;23;0;23;1.000;3600000;0
11464;196352;194;48;29;4;25;.862;3600000;0
11480;205681;226;0;0;0;0;.00nan;0;0
11480;196283;206;0;0;0;0;.00nan;0;0
11480;-1;226;70;26;2;24;.923;3900000;0
11480;202998;206;97;53;2;51;.962;3900000;0
11477;215240;231;0;0;0;0;.00nan;0;0
11477;189773;231;69;15;1;14;.933;3600000;0
11477;211080;229;61;46;6;40;.870;2969000;0
11477;-1;229;66;9;0;9;1.000;631000;0
11562;192862;187;19;26;6;20;.769;3600000;0
11562;204676;192;0;0;0;0;.00nan;0;0
11562;207398;192;65;21;2;19;.905;3600000;0
11562;-1;187;0;0;0;0;.00nan;0;0
11325;206801;176;96;36;1;35;.972;3900000;0
11325;-1;209;0;0;0;0;.00nan;0;0
11325;213533;176;0;0;0;0;.00nan;0;0
11325;213590;209;72;20;1;19;.950;3900000;0
11518;182014;214;0;0;0;0;.00nan;0;0
11518;185810;182;64;38;4;34;.895;3600000;0
11518;202914;214;26;30;6;24;.800;3600000;0
11518;213498;182;0;0;0;0;.00nan;0;0
11603;188977;215;0;0;0;0;.00nan;0;0
11603;210794;215;61;41;5;36;.878;3600000;0
11603;212050;218;0;0;0;0;.00nan;0;0
11603;208051;218;94;30;1;29;.967;3600000;0
11590;206833;4864;100;31;0;31;1.000;3600000;0
11590;202801;4864;0;0;0;0;.00nan;0;0
11590;-1;2620;0;0;0;0;.00nan;0;0
11590;213550;2620;65;38;4;34;.895;3600000;0
11589;206971;4960;49;12;2;10;.833;3600000;0
11589;212304;4960;0;0;0;0;.00nan;0;0
11589;217269;223;98;62;3;59;.952;3600000;0
11589;217312;223;0;0;0;0;.00nan;0;0
11533;183695;232;22;27;6;21;.778;1429000;0
11533;200444;224;42;20;4;16;.800;3600000;0
11533;208372;224;0;0;0;0;.00nan;0;0
11533;-1;232;63;47;5;42;.894;2171000;0
11550;216313;180;38;19;4;15;.789;3600000;0
11550;196296;219;0;0;0;0;.00nan;0;0
11550;218658;219;31;32;6;26;.813;3575000;0
11550;208383;180;0;0;0;0;.00nan;0;0
11523;200437;201;0;0;0;0;.00nan;0;0
11523;205769;200;0;0;0;0;.00nan;0;0
11523;212002;200;58;38;5;33;.868;3600000;0
11523;208048;201;100;39;1;38;.974;3600000;0
11615;191063;211;0;0;0;0;.00nan;0;0
11615;191130;186;50;10;1;9;.900;1630000;0
11615;-1;211;74;51;6;45;.882;3890000;0
11615;213507;186;41;22;4;18;.818;2260000;0
11315;210504;193;30;40;7;33;.825;2679000;0
11315;215703;195;0;0;0;0;.00nan;0;0
11315;207061;195;85;14;0;14;1.000;3600000;0
11315;218059;193;44;12;2;10;.833;921000;0
11622;201524;205;0;0;0;0;.00nan;0;0
11622;-1;205;61;35;5;30;.857;3600000;0
11622;203087;204;0;0;0;0;.00nan;0;0
11622;203120;204;80;33;2;31;.939;3600000;0
11433;192939;208;61;25;3;22;.880;3600000;0
11433;205788;207;22;9;4;5;.556;1170000;0
11433;197853;207;79;31;2;29;.935;2430000;0
11433;-1;208;0;0;0;0;.00nan;0;0
11455;190164;4959;0;0;0;0;.00nan;0;0
11455;-1;209;90;35;1;34;.971;3600000;0
11455;-1;4959;57;26;3;23;.885;3594000;0
11455;213590;209;0;0;0;0;.00nan;0;0
11403;198172;181;73;20;1;19;.950;3600000;0
11403;216001;181;0;0;0;0;.00nan;0;0
11403;182014;214;71;27;2;25;.926;3600000;0
11403;202914;214;0;0;0;0;.00nan;0;0
11388;215703;195;0;0;0;0;.00nan;0;0
11388;212143;198;41;38;6;32;.842;3600000;0
11388;207061;195;71;26;2;24;.923;3600000;0
11388;212649;198;0;0;0;0;.00nan;0;0
11643;-1;199;0;0;0;0;.00nan;0;0
11643;-1;199;62;27;3;24;.889;3675000;0
11643;203087;204;67;28;2;26;.929;3675000;0
11643;203120;204;0;0;0;0;.00nan;0;0
11510;215240;231;85;13;0;13;1.000;3600000;0
11510;189773;231;0;0;0;0;.00nan;0;0
11510;180377;228;75;48;4;44;.917;2320000;0
11510;208044;228;52;24;3;21;.875;1280000;0
11557;192915;179;0;0;0;0;.00nan;0;0
11557;196571;177;0;0;0;0;.00nan;0;0
11557;187355;179;72;20;1;19;.950;3600000;0
11557;-1;177;68;38;4;34;.895;3600000;0
11512;201495;213;90;43;3;40;.930;3600000;0
11512;217198;213;0;0;0;0;.00nan;0;0
11512;-1;4949;68;16;1;15;.938;3600000;0
11512;-1;4949;0;0;0;0;.00nan;0;0
11453;205681;226;43;20;3;17;.850;3578000;0
11453;201525;203;83;34;2;32;.941;3600000;0
11453;206772;203;0;0;0;0;.00nan;0;0
11453;-1;226;0;0;0;0;.00nan;0;0
11405;211017;220;55;28;3;25;.893;3520000;0
11405;218510;220;0;0;0;0;.00nan;0;0
11405;-1;1371;0;0;0;0;.00nan;0;0
11405;-1;1371;91;32;1;31;.969;3600000;0
11485;199416;191;0;0;0;0;.00nan;0;0
11485;195118;197;0;0;0;0;.00nan;0;0
11485;206822;197;100;45;0;45;1.000;3600000;0
11485;201892;191;76;26;2;24;.923;3580000;0
11529;192862;187;0;0;0;0;.00nan;0;0
11529;-1;190;46;36;6;30;.833;3156000;0
11529;-1;187;100;26;0;26;1.000;3600000;0
11529;-1;190;60;12;1;11;.917;444000;0
11552;188977;215;63;31;3;28;.903;3600000;0
11552;210794;215;0;0;0;0;.00nan;0;0
11552;196296;219;0;0;0;0;.00nan;0;0
11552;218658;219;41;31;5;26;.839;3600000;0
11461;205788;207;14;14;5;9;.643;3600000;0
11461;201560;202;84;29;2;27;.931;3600000;0
11461;208067;202;0;0;0;0;.00nan;0;0
11461;197853;207;0;0;0;0;.00nan;0;0
11505;200333;194;92;34;2;32;.941;3664000;0
11505;212143;198;74;22;1;21;.955;3664000;0
11505;196352;194;0;0;0;0;.00nan;0;0
11505;212649;198;0;0;0;0;.00nan;0;0
11506;216313;180;0;0;0;0;.00nan;0;0
11506;212050;218;0;0;0;0;.00nan;0;0
11506;208051;218;66;32;4;28;.875;3600000;0
11506;208383;180;67;43;5;38;.884;3600000;0
11648;199416;191;42;26;4;22;.846;3532000;0
11648;210504;193;84;33;2;31;.939;3600000;0
11648;201892;191;0;0;0;0;.00nan;0;0
11648;218059;193;0;0;0;0;.00nan;0;0
11516;211080;229;83;52;5;47;.904;3600000;0
11516;201514;227;0;0;0;0;.00nan;0;0
11516;213280;227;73;29;2;27;.931;3600000;0
11516;-1;229;0;0;0;0;.00nan;0;0
11623;206800;225;70;19;1;18;.947;3600000;0
11623;217269;223;0;0;0;0;.00nan;0;0
11623;217312;223;89;50;4;46;.920;3600000;0
11623;-1;225;0;0;0;0;.00nan;0;0
11647;204676;192;0;0;0;0;.00nan;0;0
11647;207398;192;87;34;3;31;.912;3860000;0
11647;-1;189;54;29;4;25;.862;3860000;0
11647;-1;189;0;0;0;0;.00nan;0;0
11406;209840;184;57;20;2;18;.900;3600000;0
11406;205837;184;0;0;0;0;.00nan;0;0
11406;196088;185;84;44;3;41;.932;3550000;0
11406;-1;185;0;0;0;0;.00nan;0;0
11565;209840;184;0;0;0;0;.00nan;0;0
11565;205837;184;77;24;2;22;.917;3574000;0
11565;211017;220;0;0;0;0;.00nan;0;0
11565;218510;220;86;27;1;26;.963;3600000;0
11438;192939;208;31;9;3;6;.667;324000;0
11438;201525;203;100;40;2;38;.950;3600000;0
11438;206772;203;0;0;0;0;.00nan;0;0
11438;-1;208;63;20;1;19;.950;3219000;0
11606;192862;187;0;0;0;0;.00nan;0;0
11606;198149;188;56;46;6;40;.870;3600000;0
11606;184409;188;0;0;0;0;.00nan;0;0
11606;-1;187;82;15;0;15;1.000;3600000;0
11501;213803;230;81;14;0;14;1.000;3600000;0
11501;201514;227;0;0;0;0;.00nan;0;0
11501;191120;230;0;0;0;0;.00nan;0;0
11501;213280;227;98;52;3;49;.942;3600000;0
11515;211942;183;67;21;2;19;.905;3600000;0
11515;196237;183;0;0;0;0;.00nan;0;0
11515;197672;210;0;0;0;0;.00nan;0;0
11515;-1;210;61;41;4;37;.902;3550000;0
11482;201718;217;0;0;0;0;.00nan;0;0
11482;-1;217;51;45;5;40;.889;3600000;0
11482;-1;212;28;25;6;19;.760;3576000;0
11482;-1;212;0;0;0;0;.00nan;0;0
11355;190164;4959;56;33;4;29;.879;3567000;0
11355;206801;176;82;32;2;30;.938;3600000;0
11355;-1;4959;0;0;0;0;.00nan;0;0
11355;213533;176;0;0;0;0;.00nan;0;0
11526;205681;226;0;0;0;0;.00nan;0;0
11526;205788;207;62;15;1;14;.933;1579000;0
11526;-1;226;72;19;1;18;.947;3600000;0
11526;197853;207;20;20;6;14;.700;2021000;0
11522;194950;1505;37;14;3;11;.786;3600000;0
11522;201495;213;0;0;0;0;.00nan;0;0
11522;217198;213;93;55;4;51;.927;3600000;0
11522;212814;1505;0;0;0;0;.00nan;0;0
11674;182014;214;0;0;0;0;.00nan;0;0
11674;202914;214;46;31;5;26;.839;3600000;0
11674;-1;1371;79;37;3;34;.919;3600000;0
11674;-1;1371;0;0;0;0;.00nan;0;0
11532;199416;191;0;0;0;0;.00nan;0;0
11532;215703;195;73;24;2;22;.917;1759000;0
11532;201892;191;53;29;4;25;.862;3600000;0
11532;207061;195;30;31;6;25;.806;1841000;0
11580;211080;229;33;13;4;9;.692;698000;0
11580;206800;225;0;0;0;0;.00nan;0;0
11580;-1;225;69;28;2;26;.929;3600000;0
11580;-1;229;77;24;1;23;.958;2902000;0
11536;192939;208;0;0;0;0;.00nan;0;0
11536;200437;201;61;37;4;33;.892;3600000;0
11536;208048;201;0;0;0;0;.00nan;0;0
11536;-1;208;85;29;1;28;.966;3600000;0
11584;201560;202;77;26;2;24;.923;3571000;0
11584;196283;206;0;0;0;0;.00nan;0;0
11584;208067;202;0;0;0;0;.00nan;0;0
11584;202998;206;87;20;0;20;1.000;3600000;0
11671;204676;192;23;31;7;24;.774;3563000;0
11671;207398;192;0;0;0;0;.00nan;0;0
11671;-1;190;67;42;5;37;.881;3600000;0
11671;-1;190;0;0;0;0;.00nan;0;0
11624;-1;209;0;0;0;0;.00nan;0;0
11624;-1;2620;69;25;2;23;.920;3600000;0
11624;213550;2620;0;0;0;0;.00nan;0;0
11624;213590;209;73;39;3;36;.923;3585000;0
11664;212050;218;0;0;0;0;.00nan;0;0
11664;191130;186;99;25;0;25;1.000;3600000;0
11664;208051;218;58;30;4;26;.867;3600000;0
11664;213507;186;0;0;0;0;.00nan;0;0
11490;191063;211;0;0;0;0;.00nan;0;0
11490;-1;211;64;45;5;40;.889;3600000;0
11490;-1;212;0;0;0;0;.00nan;0;0
11490;-1;212;93;19;0;19;1.000;3600000;0
11665;211942;183;0;0;0;0;.00nan;0;0
11665;196237;183;76;32;3;29;.906;3600000;0
11665;197672;210;59;32;4;28;.875;3600000;0
11665;-1;210;0;0;0;0;.00nan;0;0
11426;190164;4959;0;0;0;0;.00nan;0;0
11426;206801;176;0;0;0;0;.00nan;0;0
11426;-1;4959;60;28;3;25;.893;3576000;0
11426;213533;176;85;22;1;21;.955;3600000;0
11601;201718;217;79;37;3;34;.919;3539000;0
11601;196296;219;89;33;1;32;.970;3600000;0
11601;218658;219;0;0;0;0;.00nan;0;0
11601;-1;217;0;0;0;0;.00nan;0;0
11619;192862;187;0;0;0;0;.00nan;0;0
11619;198149;188;0;0;0;0;.00nan;0;0
11619;184409;188;97;40;2;38;.950;3600000;0
11619;-1;187;37;14;3;11;.786;3560000;0
11681;195118;197;0;0;0;0;.00nan;0;0
11681;201495;213;0;0;0;0;.00nan;0;0
11681;206822;197;43;29;4;25;.862;3600000;0
11681;217198;213;54;36;5;31;.861;3546000;0
11683;198149;188;0;0;0;0;.00nan;0;0
11683;192915;179;0;0;0;0;.00nan;0;0
11683;184409;188;45;33;5;28;.848;3600000;0
11683;187355;179;87;33;1;32;.970;3600000;0
11685;215240;231;73;26;2;24;.923;3600000;0
11685;189773;231;0;0;0;0;.00nan;0;0
11685;201718;217;55;17;2;15;.882;1556000;0
11685;-1;217;35;30;6;24;.800;2044000;0
11687;200333;194;0;0;0;0;.00nan;0;0
11687;216313;180;100;33;0;33;1.000;3600000;0
11687;196352;194;83;36;3;33;.917;3600000;0
11687;208383;180;0;0;0;0;.00nan;0;0
11689;210504;193;73;28;2;26;.929;3900000;0
11689;218059;193;0;0;0;0;.00nan;0;0
11689;-1;1371;0;0;0;0;.00nan;0;0
11689;-1;1371;72;32;2;30;.938;3900000;0
11691;188977;215;0;0;0;0;.00nan;0;0
11691;210794;215;100;44;2;42;.955;3900000;0
11691;206971;4960;69;27;2;25;.926;3900000;0
11691;212304;4960;0;0;0;0;.00nan;0;0
11693;196283;206;0;0;0;0;.00nan;0;0
11693;196296;219;0;0;0;0;.00nan;0;0
11693;218658;219;95;30;1;29;.967;3600000;0
11693;202998;206;75;35;3;32;.914;3600000;0
11695;204676;192;0;0;0;0;.00nan;0;0
11695;207398;192;59;12;1;11;.917;3600000;0
11695;213399;216;0;0;0;0;.00nan;0;0
11695;-1;216;67;38;4;34;.895;3600000;0
11697;199416;191;72;19;1;18;.947;3600000;0
11697;211017;220;53;54;7;47;.870;2840000;0
11697;201892;191;0;0;0;0;.00nan;0;0
11697;218510;220;55;13;1;12;.923;760000;0
11699;209840;184;0;0;0;0;.00nan;0;0
11699;205769;200;0;0;0;0;.00nan;0;0
11699;205837;184;83;28;1;27;.964;3600000;0
11699;212002;200;21;23;6;17;.739;3600000;0
11701;192862;187;51;16;3;13;.813;3731000;0
11701;-1;189;69;21;2;19;.905;3731000;0
11701;-1;187;0;0;0;0;.00nan;0;0
11701;-1;189;0;0;0;0;.00nan;0;0
11703;200437;201;65;39;4;35;.897;3600000;0
11703;191118;196;76;21;1;20;.952;3600000;0
11703;208048;201;0;0;0;0;.00nan;0;0
11703;202830;196;0;0;0;0;.00nan;0;0
11705;201514;227;0;0;0;0;.00nan;0;0
11705;182014;214;0;0;0;0;.00nan;0;0
11705;213280;227;49;36;5;31;.861;3600000;0
11705;202914;214;76;26;2;24;.923;3600000;0
11707;201560;202;75;30;2;28;.933;3560000;0
11707;196571;177;68;18;1;17;.944;3600000;0
11707;208067;202;0;0;0;0;.00nan;0;0
11707;-1;177;0;0;0;0;.00nan;0;0
11709;200452;221;65;33;4;29;.879;3600000;0
11709;201525;203;27;32;7;25;.781;2963000;0
11709;206772;203;57;7;0;7;1.000;637000;0
11709;-1;221;0;0;0;0;.00nan;0;0
11711;206833;4864;0;0;0;0;.00nan;0;0
11711;212143;198;69;29;3;26;.897;3513000;0
11711;212649;198;0;0;0;0;.00nan;0;0
11711;202801;4864;74;26;1;25;.962;3600000;0
11713;192939;208;53;15;2;13;.867;3600000;0
11713;200444;224;80;40;3;37;.925;3549000;0
11713;-1;208;0;0;0;0;.00nan;0;0
11713;208372;224;0;0;0;0;.00nan;0;0
11715;183695;232;0;0;0;0;.00nan;0;0
11715;-1;2620;0;0;0;0;.00nan;0;0
11715;213550;2620;55;35;4;31;.886;3600000;0
11715;-1;232;63;35;3;32;.914;3600000;0
11717;205681;226;0;0;0;0;.00nan;0;0
11717;-1;226;51;35;6;29;.829;3600000;0
11717;-1;199;0;0;0;0;.00nan;0;0
11717;-1;199;91;39;3;36;.923;3600000;0
11719;205788;207;0;0;0;0;.00nan;0;0
11719;190164;4959;0;0;0;0;.00nan;0;0
11719;197853;207;48;23;3;20;.870;3900000;0
11719;-1;4959;97;44;3;41;.932;3900000;0
11721;215703;195;0;0;0;0;.00nan;0;0
11721;207061;195;65;14;1;13;.929;3600000;0
11721;-1;178;0;0;0;0;.00nan;0;0
11721;-1;178;82;55;5;50;.909;3600000;0
11723;206801;176;100;34;0;34;1.000;3600000;0
11723;-1;190;31;23;5;18;.783;3600000;0
11723;213533;176;0;0;0;0;.00nan;0;0
11723;-1;190;0;0;0;0;.00nan;0;0
11725;213803;230;67;21;2;19;.905;3600000;0
11725;198172;181;48;7;1;6;.857;854000;0
11725;216001;181;56;44;6;38;.864;2746000;0
11725;191120;230;0;0;0;0;.00nan;0;0
11727;212035;205;0;0;0;0;.00nan;0;0
11727;212050;218;0;0;0;0;.00nan;0;0
11727;208051;218;81;34;2;32;.941;3898000;0
11727;-1;205;76;25;1;24;.960;3898000;0
11729;212538;211;46;38;6;32;.842;3600000;0
11729;-1;211;0;0;0;0;.00nan;0;0
11729;-1;212;0;0;0;0;.00nan;0;0
11729;-1;212;67;30;3;27;.900;3600000;0
11731;197672;210;91;39;1;38;.974;3600000;0
11731;203087;204;0;0;0;0;.00nan;0;0
11731;203120;204;55;25;3;22;.880;3562000;0
11731;-1;210;0;0;0;0;.00nan;0;0
11733;194950;1505;63;25;3;22;.880;3600000;0
11733;195363;222;0;0;0;0;.00nan;0;0
11733;212814;1505;0;0;0;0;.00nan;0;0
11733;213560;222;39;31;5;26;.839;3600000;0
11735;211080;229;75;38;3;35;.921;3600000;0
11735;211942;183;70;23;1;22;.957;3600000;0
11735;196237;183;0;0;0;0;.00nan;0;0
11735;-1;229;0;0;0;0;.00nan;0;0
11737;206800;225;0;0;0;0;.00nan;0;0
11737;196088;185;55;29;4;25;.862;3560000;0
11737;-1;225;55;22;3;19;.864;3600000;0
11737;-1;185;0;0;0;0;.00nan;0;0
11739;185810;182;60;27;3;24;.889;3600000;0
11739;191130;186;0;0;0;0;.00nan;0;0
11739;213507;186;97;21;0;21;1.000;3600000;0
11739;208290;182;0;0;0;0;.00nan;0;0
11741;217269;223;0;0;0;0;.00nan;0;0
11741;217312;223;70;41;4;37;.902;3547000;0
11741;-1;4949;57;24;3;21;.875;3600000;0
11741;-1;4949;0;0;0;0;.00nan;0;0
11743;180377;228;76;37;3;34;.919;3551000;0
11743;208044;228;0;0;0;0;.00nan;0;0
11743;203063;209;0;0;0;0;.00nan;0;0
11743;213590;209;55;14;2;12;.857;3600000;0
11745;194950;1505;0;0;0;0;.00nan;0;0
11745;212814;1505;75;20;1;19;.950;3600000;0
11745;203087;204;89;50;5;45;.900;3600000;0
11745;203120;204;0;0;0;0;.00nan;0;0
11747;201495;213;53;46;6;40;.870;3580000;0
11747;217198;213;0;0;0;0;.00nan;0;0
11747;182014;214;60;33;4;29;.879;3600000;0
11747;202914;214;0;0;0;0;.00nan;0;0
11749;200437;201;0;0;0;0;.00nan;0;0
11749;206971;4960;0;0;0;0;.00nan;0;0
11749;212304;4960;95;32;1;31;.969;3900000;0
11749;208048;201;90;38;1;37;.974;3900000;0
11751;215240;231;0;0;0;0;.00nan;0;0
11751;189773;231;64;16;1;15;.938;3600000;0
11751;217269;223;54;41;6;35;.854;2555000;0
11751;217312;223;52;6;0;6;1.000;1045000;0
11753;200452;221;0;0;0;0;.00nan;0;0
11753;185810;182;0;0;0;0;.00nan;0;0
11753;208290;182;97;38;1;37;.974;3600000;0
11753;-1;221;54;24;3;21;.875;3541000;0
11755;201718;217;99;40;1;39;.975;3600000;0
11755;191118;196;0;0;0;0;.00nan;0;0
11755;202830;196;55;18;2;16;.889;3565000;0
11755;-1;217;0;0;0;0;.00nan;0;0
11757;188977;215;66;35;4;31;.886;3600000;0
11757;210794;215;0;0;0;0;.00nan;0;0
11757;216313;180;71;24;1;23;.958;3600000;0
11757;208383;180;0;0;0;0;.00nan;0;0
11759;201560;202;0;0;0;0;.00nan;0;0
11759;208067;202;81;45;3;42;.933;3600000;0
11759;-1;4949;0;0;0;0;.00nan;0;0
11759;-1;4949;92;29;1;28;.966;3600000;0
11761;200333;194;60;25;2;23;.920;3546000;0
11761;201525;203;0;0;0;0;.00nan;0;0
11761;206772;203;90;34;1;33;.971;3600000;0
11761;196352;194;0;0;0;0;.00nan;0;0
11763;209840;184;90;32;1;31;.969;3631000;0
11763;210504;193;81;13;0;13;1.000;3631000;0
11763;205837;184;0;0;0;0;.00nan;0;0
11763;218059;193;0;0;0;0;.00nan;0;0
11765;213803;230;0;0;0;0;.00nan;0;0
11765;198172;181;82;52;4;48;.923;3582000;0
11765;216001;181;0;0;0;0;.00nan;0;0
11765;191120;230;63;24;2;22;.917;3600000;0
11767;200444;224;61;5;0;5;1.000;1513000;0
11767;196283;206;85;33;1;32;.970;3600000;0
11767;202998;206;0;0;0;0;.00nan;0;0
11767;208372;224;41;26;5;21;.808;2087000;0
11769;213399;216;70;33;2;31;.939;3594000;0
11769;203063;209;71;24;1;23;.958;3600000;0
11769;-1;216;0;0;0;0;.00nan;0;0
11769;213590;209;0;0;0;0;.00nan;0;0
11771;205788;207;73;24;1;23;.958;3900000;0
11771;-1;189;0;0;0;0;.00nan;0;0
11771;197853;207;0;0;0;0;.00nan;0;0
11771;-1;189;100;34;1;33;.971;3900000;0
11773;192915;179;80;36;2;34;.944;3900000;0
11773;211942;183;0;0;0;0;.00nan;0;0
11773;196237;183;74;31;2;29;.935;3900000;0
11773;187355;179;0;0;0;0;.00nan;0;0
11775;204676;192;74;27;2;25;.926;3576000;0
11775;207398;192;0;0;0;0;.00nan;0;0
11775;-1;212;81;27;1;26;.963;3600000;0
11775;-1;212;0;0;0;0;.00nan;0;0
11777;199416;191;0;0;0;0;.00nan;0;0
11777;206801;176;97;58;2;56;.966;3600000;0
11777;201892;191;66;18;1;17;.944;3600000;0
11777;213533;176;0;0;0;0;.00nan;0;0
11779;-1;178;69;28;2;26;.929;3549000;0
11779;-1;1371;100;36;1;35;.972;3600000;0
11779;-1;178;0;0;0;0;.00nan;0;0
11779;-1;1371;0;0;0;0;.00nan;0;0
11781;201514;227;51;26;3;23;.885;3900000;0
11781;206833;4864;70;33;3;30;.909;3900000;0
11781;213280;227;0;0;0;0;.00nan;0;0
11781;202801;4864;0;0;0;0;.00nan;0;0
11783;212538;211;0;0;0;0;.00nan;0;0
11783;-1;190;0;0;0;0;.00nan;0;0
11783;-1;211;46;25;4;21;.840;3600000;0
11783;-1;190;63;15;1;14;.933;3600000;0
11785;195363;222;73;51;5;46;.902;3600000;0
11785;197672;210;0;0;0;0;.00nan;0;0
11785;213560;222;0;0;0;0;.00nan;0;0
11785;-1;210;47;11;2;9;.818;3600000;0
11787;180377;228;0;0;0;0;.00nan;0;0
11787;191130;186;0;0;0;0;.00nan;0;0
11787;208044;228;67;48;5;43;.896;3600000;0
11787;213507;186;64;29;2;27;.931;3600000;0
11789;211080;229;41;12;2;10;.833;694000;0
11789;212035;205;64;24;2;22;.917;3600000;0
11789;-1;205;0;0;0;0;.00nan;0;0
11789;-1;229;36;40;6;34;.850;2906000;0
11791;205769;200;86;47;4;43;.915;3600000;0
11791;212002;200;0;0;0;0;.00nan;0;0
11791;212143;198;0;0;0;0;.00nan;0;0
11791;212649;198;66;18;1;17;.944;3600000;0
11793;211017;220;55;11;1;10;.909;1408000;0
11793;206800;225;75;31;2;29;.935;3600000;0
11793;-1;225;0;0;0;0;.00nan;0;0
11793;218510;220;37;33;5;28;.848;2192000;0
11795;183695;232;45;37;6;31;.838;2882000;0
11795;196296;219;74;32;2;30;.938;3600000;0
11795;218658;219;0;0;0;0;.00nan;0;0
11795;-1;232;52;2;0;2;1.000;718000;0
11797;198149;188;66;38;4;34;.895;3600000;0
11797;184409;188;0;0;0;0;.00nan;0;0
11797;196571;177;0;0;0;0;.00nan;0;0
11797;-1;177;68;18;1;17;.944;3600000;0
11799;192939;208;0;0;0;0;.00nan;0;0
11799;205681;226;90;28;1;27;.964;3600000;0
11799;-1;226;0;0;0;0;.00nan;0;0
11799;-1;208;56;21;2;19;.905;3568000;0
11801;192862;187;0;0;0;0;.00nan;0;0
11801;212050;218;41;23;4;19;.826;3576000;0
11801;208051;218;0;0;0;0;.00nan;0;0
11801;-1;187;70;34;3;31;.912;3600000;0
11803;190164;4959;77;43;4;39;.907;3565000;0
11803;-1;4959;0;0;0;0;.00nan;0;0
11803;-1;2620;55;25;3;22;.880;3600000;0
11803;213550;2620;0;0;0;0;.00nan;0;0
11805;215703;195;83;26;1;25;.962;3600000;0
11805;195118;197;26;31;6;25;.806;2269000;0
11805;206822;197;64;14;1;13;.929;1331000;0
11805;207061;195;0;0;0;0;.00nan;0;0
11807;196088;185;0;0;0;0;.00nan;0;0
11807;-1;185;85;29;1;28;.966;3600000;0
11807;-1;199;52;18;2;16;.889;3560000;0
11807;-1;199;0;0;0;0;.00nan;0;0
11809;201495;213;78;16;0;16;1.000;1754000;0
11809;212143;198;75;15;1;14;.933;3600000;0
11809;217198;213;37;32;6;26;.813;1846000;0
11809;212649;198;0;0;0;0;.00nan;0;0
11811;215240;231;71;8;0;8;1.000;3831000;0
11811;189773;231;0;0;0;0;.00nan;0;0
11811;203063;209;0;0;0;0;.00nan;0;0
11811;213590;209;94;53;1;52;.981;3831000;0
11813;210504;193;36;19;4;15;.789;3546000;0
11813;196088;185;0;0;0;0;.00nan;0;0
11813;218059;193;0;0;0;0;.00nan;0;0
11813;-1;185;81;42;3;39;.929;3600000;0
11815;-1;2620;0;0;0;0;.00nan;0;0
11815;203087;204;0;0;0;0;.00nan;0;0
11815;203120;204;86;35;2;33;.943;3600000;0
11815;213550;2620;58;24;3;21;.875;3585000;0
11817;205681;226;0;0;0;0;.00nan;0;0
11817;185810;182;64;40;4;36;.900;3545000;0
11817;-1;226;56;21;3;18;.857;3600000;0
11817;208290;182;0;0;0;0;.00nan;0;0
11819;192862;187;0;0;0;0;.00nan;0;0
11819;205769;200;61;17;1;16;.941;2373000;0
11819;212002;200;34;17;4;13;.765;1186000;0
11819;-1;187;46;20;3;17;.850;3600000;0
11821;204676;192;0;0;0;0;.00nan;0;0
11821;211017;220;0;0;0;0;.00nan;0;0
11821;207398;192;82;24;1;23;.958;3600000;0
11821;218510;220;80;34;2;32;.941;3560000;0
11823;209840;184;57;25;3;22;.880;3900000;0
11823;205837;184;0;0;0;0;.00nan;0;0
11823;211942;183;55;30;3;27;.900;3899000;0
11823;196237;183;0;0;0;0;.00nan;0;0
11825;198149;188;0;0;0;0;.00nan;0;0
11825;200333;194;0;0;0;0;.00nan;0;0
11825;184409;188;82;37;3;34;.919;3580000;0
11825;196352;194;100;38;1;37;.974;3600000;0
11827;211080;229;45;30;4;26;.867;3600000;0
11827;201560;202;89;24;0;24;1.000;3600000;0
11827;208067;202;0;0;0;0;.00nan;0;0
11827;-1;229;0;0;0;0;.00nan;0;0
11829;194950;1505;81;33;2;31;.939;3600000;0
11829;212814;1505;0;0;0;0;.00nan;0;0
11829;-1;4949;64;37;4;33;.892;3569000;0
11829;-1;4949;0;0;0;0;.00nan;0;0
11831;201718;217;49;1;0;1;1.000;250000;0
11831;182014;214;0;0;0;0;.00nan;0;0
11831;202914;214;100;32;0;32;1.000;3600000;0
11831;-1;217;15;25;6;19;.760;3350000;0
11833;200452;221;0;0;0;0;.00nan;0;0
11833;205788;207;0;0;0;0;.00nan;0;0
11833;197853;207;85;36;2;34;.944;3586000;0
11833;-1;221;72;20;1;19;.950;3600000;0
11835;188977;215;0;0;0;0;.00nan;0;0
11835;210794;215;49;36;5;31;.861;3600000;0
11835;191118;196;87;16;0;16;1.000;3600000;0
11835;202830;196;0;0;0;0;.00nan;0;0
11837;196283;206;0;0;0;0;.00nan;0;0
11837;197672;210;82;44;3;41;.932;3600000;0
11837;202998;206;100;25;0;25;1.000;3600000;0
11837;-1;210;0;0;0;0;.00nan;0;0
11839;183695;232;0;0;0;0;.00nan;0;0
11839;201525;203;45;27;4;23;.852;3600000;0
11839;206772;203;0;0;0;0;.00nan;0;0
11839;-1;232;53;51;6;45;.882;3514000;0
11841;213803;230;46;19;3;16;.842;3567000;0
11841;191120;230;0;0;0;0;.00nan;0;0
11841;213399;216;0;0;0;0;.00nan;0;0
11841;-1;216;100;46;1;45;.978;3600000;0
11843;198172;181;0;0;0;0;.00nan;0;0
11843;216001;181;100;19;0;19;1.000;3600000;0
11843;216313;180;98;38;1;37;.974;3600000;0
11843;208383;180;0;0;0;0;.00nan;0;0
11845;206833;4864;0;0;0;0;.00nan;0;0
11845;191130;186;56;34;4;30;.882;3600000;0
11845;202801;4864;66;19;1;18;.947;3600000;0
11845;213507;186;0;0;0;0;.00nan;0;0
11847;192939;208;0;0;0;0;.00nan;0;0
11847;-1;199;0;0;0;0;.00nan;0;0
11847;-1;208;58;15;2;13;.867;3600000;0
11847;-1;199;98;57;3;54;.947;3580000;0
11849;192915;179;0;0;0;0;.00nan;0;0
11849;206971;4960;82;35;2;33;.943;3900000;0
11849;212304;4960;0;0;0;0;.00nan;0;0
11849;187355;179;69;24;2;22;.917;3900000;0
11851;212035;205;0;0;0;0;.00nan;0;0
11851;-1;189;45;20;4;16;.800;3600000;0
11851;-1;189;0;0;0;0;.00nan;0;0
11851;-1;205;87;49;3;46;.939;3600000;0
11853;201514;227;0;0;0;0;.00nan;0;0
11853;213280;227;100;37;1;36;.973;3600000;0
11853;-1;190;66;29;3;26;.897;3596000;0
11853;-1;190;0;0;0;0;.00nan;0;0
11855;200437;201;85;23;1;22;.957;3600000;0
11855;217269;223;0;0;0;0;.00nan;0;0
11855;217312;223;93;46;2;44;.957;3569000;0
11855;208048;201;0;0;0;0;.00nan;0;0
11857;190164;4959;0;0;0;0;.00nan;0;0
11857;206800;225;0;0;0;0;.00nan;0;0
11857;-1;225;55;30;4;26;.867;3560000;0
11857;-1;4959;81;29;2;27;.931;3600000;0
11859;200444;224;0;0;0;0;.00nan;0;0
11859;208372;224;84;16;0;16;1.000;3600000;0
11859;-1;212;55;34;4;30;.882;3600000;0
11859;-1;212;0;0;0;0;.00nan;0;0
11861;206801;176;30;29;6;23;.793;2506000;0
11861;-1;178;0;0;0;0;.00nan;0;0
11861;-1;178;72;24;2;22;.917;3600000;0
11861;213533;176;82;18;0;18;1.000;1094000;0
11863;180377;228;91;52;3;49;.942;3734000;0
11863;196296;219;0;0;0;0;.00nan;0;0
11863;208044;228;0;0;0;0;.00nan;0;0
11863;218658;219;53;25;4;21;.840;3716000;0
11865;195118;197;0;0;0;0;.00nan;0;0
11865;206822;197;57;28;4;24;.857;3600000;0
11865;196571;177;38;15;3;12;.800;3600000;0
11865;-1;177;0;0;0;0;.00nan;0;0
11867;199416;191;100;19;0;19;1.000;3600000;0
11867;195363;222;0;0;0;0;.00nan;0;0
11867;201892;191;0;0;0;0;.00nan;0;0
11867;213560;222;69;55;6;49;.891;3600000;0
11869;215703;195;0;0;0;0;.00nan;0;0
11869;207061;195;41;16;3;13;.813;3600000;0
11869;-1;1371;47;36;6;30;.833;2372000;0
11869;-1;1371;68;20;1;19;.950;1228000;0
11871;212050;218;0;0;0;0;.00nan;0;0
11871;212538;211;51;41;6;35;.854;3210000;0
11871;208051;218;33;17;4;13;.765;3600000;0
11871;-1;211;54;4;0;4;1.000;380000;0
11873;211017;220;83;31;1;30;.968;3600000;0
11873;218510;220;0;0;0;0;.00nan;0;0
11873;213399;216;65;26;2;24;.923;3553000;0
11873;-1;216;0;0;0;0;.00nan;0;0
11875;188977;215;88;43;3;40;.930;3588000;0
11875;200444;224;60;19;2;17;.895;3600000;0
11875;210794;215;0;0;0;0;.00nan;0;0
11875;208372;224;0;0;0;0;.00nan;0;0
11877;199416;191;67;19;1;18;.947;3600000;0
11877;205788;207;60;37;5;32;.865;3600000;0
11877;201892;191;0;0;0;0;.00nan;0;0
11877;197853;207;0;0;0;0;.00nan;0;0
11879;205769;200;0;0;0;0;.00nan;0;0
11879;212002;200;64;27;2;25;.926;3599000;0
11879;196088;185;100;28;0;28;1.000;3600000;0
11879;-1;185;0;0;0;0;.00nan;0;0
11881;192939;208;83;30;1;29;.967;3600000;0
11881;206833;4864;98;44;2;42;.955;3596000;0
11881;202801;4864;0;0;0;0;.00nan;0;0
11881;-1;208;0;0;0;0;.00nan;0;0
11883;198172;181;36;25;5;20;.800;3600000;0
11883;216001;181;0;0;0;0;.00nan;0;0
11883;201525;203;0;0;0;0;.00nan;0;0
11883;206772;203;84;31;1;30;.968;3600000;0
11885;206801;176;0;0;0;0;.00nan;0;0
11885;196571;177;0;0;0;0;.00nan;0;0
11885;213533;176;82;40;3;37;.925;3600000;0
11885;-1;177;56;33;4;29;.879;3545000;0
11887;190164;4959;37;29;5;24;.828;3600000;0
11887;196296;219;61;20;2;18;.900;3600000;0
11887;218658;219;0;0;0;0;.00nan;0;0
11887;-1;4959;0;0;0;0;.00nan;0;0
11889;200333;194;63;32;3;29;.906;3548000;0
11889;196352;194;0;0;0;0;.00nan;0;0
11889;203087;204;87;38;2;36;.947;3600000;0
11889;203120;204;0;0;0;0;.00nan;0;0
11891;210504;193;57;21;2;19;.905;3561000;0
11891;218059;193;0;0;0;0;.00nan;0;0
11891;191118;196;100;39;1;38;.974;3600000;0
11891;202830;196;0;0;0;0;.00nan;0;0
11893;198149;188;62;37;4;33;.892;3585000;0
11893;184409;188;0;0;0;0;.00nan;0;0
11893;212538;211;0;0;0;0;.00nan;0;0
11893;-1;211;57;25;3;22;.880;3600000;0
11895;194950;1505;0;0;0;0;.00nan;0;0
11895;212814;1505;36;13;3;10;.769;3600000;0
11895;-1;199;98;70;4;66;.943;3600000;0
11895;-1;199;0;0;0;0;.00nan;0;0
11897;201560;202;78;26;1;25;.962;3600000;0
11897;-1;178;28;24;6;18;.750;2562000;0
11897;208067;202;0;0;0;0;.00nan;0;0
11897;-1;178;59;9;1;8;.889;1038000;0
11899;217269;223;53;27;4;23;.852;3600000;0
11899;217312;223;0;0;0;0;.00nan;0;0
11899;-1;1371;0;0;0;0;.00nan;0;0
11899;-1;1371;86;34;1;33;.971;3600000;0
11901;213803;230;0;0;0;0;.00nan;0;0
11901;206800;225;83;54;5;49;.907;3600000;0
11901;-1;225;0;0;0;0;.00nan;0;0
11901;191120;230;62;15;1;14;.933;3600000;0
11903;192862;187;69;22;2;20;.909;3600000;0
11903;200452;221;31;27;6;21;.778;3027000;0
11903;-1;187;0;0;0;0;.00nan;0;0
11903;-1;221;57;7;1;6;.857;573000;0
11905;216313;180;0;0;0;0;.00nan;0;0
11905;-1;4949;0;0;0;0;.00nan;0;0
11905;-1;4949;27;31;6;25;.806;3600000;0
11905;208383;180;61;30;3;27;.900;3600000;0
11907;201495;213;0;0;0;0;.00nan;0;0
11907;212050;218;71;27;2;25;.926;3600000;0
11907;217198;213;92;52;3;49;.942;3600000;0
11907;208051;218;0;0;0;0;.00nan;0;0
11909;183695;232;91;41;1;40;.976;3600000;0
11909;-1;2620;66;37;4;33;.892;3600000;0
11909;213550;2620;0;0;0;0;.00nan;0;0
11909;-1;232;0;0;0;0;.00nan;0;0
11911;201514;227;82;34;2;32;.941;3600000;0
11911;185810;182;0;0;0;0;.00nan;0;0
11911;213280;227;0;0;0;0;.00nan;0;0
11911;208290;182;59;32;4;28;.875;3600000;0
11913;192915;179;84;53;4;49;.925;3587000;0
11913;206971;4960;0;0;0;0;.00nan;0;0
11913;212304;4960;46;11;2;9;.818;3600000;0
11913;187355;179;0;0;0;0;.00nan;0;0
11915;195118;197;70;21;2;19;.905;3549000;0
11915;211080;229;0;0;0;0;.00nan;0;0
11915;206822;197;0;0;0;0;.00nan;0;0
11915;-1;229;88;32;1;31;.969;3600000;0
11917;205681;226;92;23;0;23;1.000;3600000;0
11917;-1;226;0;0;0;0;.00nan;0;0
11917;203063;209;0;0;0;0;.00nan;0;0
11917;213590;209;63;42;4;38;.905;3600000;0
11919;215703;195;73;10;0;10;1.000;3600000;0
11919;207061;195;0;0;0;0;.00nan;0;0
11919;182014;214;0;0;0;0;.00nan;0;0
11919;202914;214;98;61;3;58;.951;3600000;0
11921;211942;183;0;0;0;0;.00nan;0;0
11921;196237;183;48;14;2;12;.857;3530000;0
11921;180377;228;0;0;0;0;.00nan;0;0
11921;208044;228;100;32;0;32;1.000;3600000;0
11923;201718;217;47;29;5;24;.828;2383000;0
11923;-1;217;53;17;2;15;.882;1217000;0
11923;-1;212;0;0;0;0;.00nan;0;0
11923;-1;212;72;9;0;9;1.000;3600000;0
11925;204676;192;52;26;4;22;.846;3668000;0
11925;195363;222;77;43;3;40;.930;3668000;0
11925;207398;192;0;0;0;0;.00nan;0;0
11925;213560;222;0;0;0;0;.00nan;0;0
11927;196283;206;0;0;0;0;.00nan;0;0
11927;-1;190;0;0;0;0;.00nan;0;0
11927;202998;206;92;36;1;35;.972;3900000;0
11927;-1;190;84;26;1;25;.962;3900000;0
11929;209840;184;0;0;0;0;.00nan;0;0
11929;205837;184;40;19;3;16;.842;3600000;0
11929;191130;186;0;0;0;0;.00nan;0;0
11929;213507;186;100;40;0;40;1.000;3600000;0
11931;215240;231;0;0;0;0;.00nan;0;0
11931;189773;231;55;19;2;17;.895;3900000;0
11931;212143;198;0;0;0;0;.00nan;0;0
11931;212649;198;82;42;2;40;.952;3900000;0
11933;212035;205;62;15;1;14;.933;3600000;0
11933;197672;210;0;0;0;0;.00nan;0;0
11933;-1;205;0;0;0;0;.00nan;0;0
11933;-1;210;78;34;3;31;.912;3577000;0
11935;200437;201;0;0;0;0;.00nan;0;0
11935;-1;189;0;0;0;0;.00nan;0;0
11935;208048;201;68;28;3;25;.893;3589000;0
11935;-1;189;76;30;2;28;.933;3600000;0
1372;194950;1505;91;43;2;41;.953;4575000;0
1372;212143;198;69;20;1;19;.950;4575000;0
1372;212649;198;0;0;0;0;.00nan;0;0
1372;212814;1505;0;0;0;0;.00nan;0;0
1373;213803;230;31;28;6;22;.786;3555000;0
1373;187689;230;0;0;0;0;.00nan;0;0
1373;200444;224;65;26;2;24;.923;3228000;0
1373;208372;224;27;5;3;2;.400;372000;0
1374;192939;208;36;11;3;8;.727;3600000;0
1374;206833;4864;56;30;4;26;.867;3556000;0
1374;202801;4864;0;0;0;0;.00nan;0;0
1374;-1;208;0;0;0;0;.00nan;0;0
1375;204676;192;0;0;0;0;.00nan;0;0
1375;206971;4960;99;33;1;32;.970;3600000;0
1375;212304;4960;0;0;0;0;.00nan;0;0
1375;207398;192;68;24;2;22;.917;3547000;0
1376;215240;231;0;0;0;0;.00nan;0;0
1376;189773;231;86;21;1;20;.952;3600000;0
1376;-1;212;68;47;4;43;.915;3600000;0
1376;-1;212;0;0;0;0;.00nan;0;0
1377;210504;193;91;32;1;31;.969;3600000;0
1377;205681;226;0;0;0;0;.00nan;0;0
1377;218059;193;0;0;0;0;.00nan;0;0
1377;-1;226;35;28;5;23;.821;3600000;0
1378;215703;195;0;0;0;0;.00nan;0;0
1378;207061;195;71;22;1;21;.955;3600000;0
1378;191130;186;0;0;0;0;.00nan;0;0
1378;213507;186;56;25;3;22;.880;3537000;0
1379;199416;191;0;0;0;0;.00nan;0;0
1379;201892;191;67;19;1;18;.947;3600000;0
1379;185810;182;98;56;3;53;.946;3540000;0
1379;213498;182;0;0;0;0;.00nan;0;0
1604;200444;224;78;24;1;23;.958;3600000;0
1604;212143;198;67;34;3;31;.912;3534000;0
1604;212649;198;0;0;0;0;.00nan;0;0
1604;208372;224;0;0;0;0;.00nan;0;0
1605;192939;208;48;31;4;27;.871;3600000;0
1605;206971;4960;54;33;5;28;.848;3546000;0
1605;212304;4960;0;0;0;0;.00nan;0;0
1605;-1;208;0;0;0;0;.00nan;0;0
1606;215240;231;0;0;0;0;.00nan;0;0
1606;210504;193;70;40;4;36;.900;3600000;0
1606;189773;231;40;14;3;11;.786;3600000;0
1606;218059;193;0;0;0;0;.00nan;0;0
1607;199416;191;0;0;0;0;.00nan;0;0
1607;215703;195;0;0;0;0;.00nan;0;0
1607;201892;191;52;44;5;39;.886;5606000;0
1607;207061;195;61;38;4;34;.895;5606000;0
1761;192939;208;64;41;4;37;.902;3600000;0
1761;200444;224;47;14;2;12;.857;3600000;0
1761;-1;208;0;0;0;0;.00nan;0;0
1761;208372;224;0;0;0;0;.00nan;0;0
1762;215240;231;0;0;0;0;.00nan;0;0
1762;215703;195;0;0;0;0;.00nan;0;0
1762;189773;231;95;53;2;51;.962;4483000;0
1762;207061;195;56;19;3;16;.842;4483000;0
1916;215240;231;0;0;0;0;.00nan;0;0
1916;200444;224;56;44;5;39;.886;3600000;0
1916;189773;231;70;24;2;22;.917;3600000;0
1916;208372;224;0;0;0;0;.00nan;0;0
11936;183265;2471;0;0;0;0;.00nan;0;0
11936;166044;2471;54;37;5;32;.865;3600000;0
11936;-1;2473;99;23;0;23;1.000;3600000;0
11936;-1;2473;0;0;0;0;.00nan;0;0
11937;-1;713;67;25;2;23;.920;3600000;0
11937;-1;2465;35;32;6;26;.813;3600000;0
11937;145838;2465;0;0;0;0;.00nan;0;0
11937;145843;713;0;0;0;0;.00nan;0;0
11938;170548;712;62;29;3;26;.897;3600000;0
11938;145636;2474;0;0;0;0;.00nan;0;0
11938;146001;2474;62;43;5;38;.884;3600000;0
11938;160866;712;0;0;0;0;.00nan;0;0
11939;181748;714;100;25;0;25;1.000;3600000;0
11939;-1;706;0;0;0;0;.00nan;0;0
11939;72229;706;82;27;1;26;.963;3600000;0
11939;145787;714;0;0;0;0;.00nan;0;0
11940;26308;710;98;45;3;42;.933;3600000;0
11940;176206;710;0;0;0;0;.00nan;0;0
11940;78251;711;0;0;0;0;.00nan;0;0
11940;145733;711;100;30;0;30;1.000;3600000;0
11941;-1;2465;98;30;1;29;.967;3600000;0
11941;-1;706;0;0;0;0;.00nan;0;0
11941;72229;706;60;27;3;24;.889;3579000;0
11941;145838;2465;0;0;0;0;.00nan;0;0
11942;183265;2471;0;0;0;0;.00nan;0;0
11942;166044;2471;38;43;7;36;.837;3600000;0
11942;26308;710;0;0;0;0;.00nan;0;0
11942;176206;710;67;27;2;25;.926;3600000;0
11943;170548;712;74;34;3;31;.912;3852000;0
11943;-1;2465;61;30;4;26;.867;3852000;0
11943;145838;2465;0;0;0;0;.00nan;0;0
11943;160866;712;0;0;0;0;.00nan;0;0
11944;-1;713;72;20;1;19;.950;3600000;0
11944;181748;714;53;48;5;43;.896;3600000;0
11944;145787;714;0;0;0;0;.00nan;0;0
11944;145843;713;0;0;0;0;.00nan;0;0
11945;78251;711;54;9;1;8;.889;3600000;0
11945;145636;2474;44;23;4;19;.826;1140000;0
11945;145733;711;0;0;0;0;.00nan;0;0
11945;146001;2474;63;39;4;35;.897;2460000;0
11946;-1;2473;80;14;0;14;1.000;3600000;0
11946;-1;2473;0;0;0;0;.00nan;0;0
11946;-1;706;87;20;0;20;1.000;1203000;0
11946;72229;706;17;20;6;14;.700;2397000;0
11947;26308;710;0;0;0;0;.00nan;0;0
11947;176206;710;96;30;1;29;.967;3900000;0
11947;-1;2465;97;52;1;51;.981;3900000;0
11947;145838;2465;0;0;0;0;.00nan;0;0
11948;183265;2471;0;0;0;0;.00nan;0;0
11948;166044;2471;57;28;5;23;.821;3561000;0
11948;-1;706;0;0;0;0;.00nan;0;0
11948;72229;706;59;26;3;23;.885;3600000;0
11949;-1;713;0;0;0;0;.00nan;0;0
11949;78251;711;73;21;1;20;.952;3600000;0
11949;145733;711;0;0;0;0;.00nan;0;0
11949;145843;713;93;40;2;38;.950;3546000;0
11950;-1;2473;39;24;4;20;.833;3572000;0
11950;-1;2473;0;0;0;0;.00nan;0;0
11950;145636;2474;63;28;3;25;.893;3600000;0
11950;146001;2474;0;0;0;0;.00nan;0;0
11951;170548;712;88;46;3;43;.935;3583000;0
11951;181748;714;75;26;2;24;.923;3600000;0
11951;145787;714;0;0;0;0;.00nan;0;0
11951;160866;712;0;0;0;0;.00nan;0;0
11952;181748;714;97;35;1;34;.971;3900000;0
11952;78251;711;76;20;1;19;.950;3900000;0
11952;145733;711;0;0;0;0;.00nan;0;0
11952;145787;714;0;0;0;0;.00nan;0;0
11953;183265;2471;0;0;0;0;.00nan;0;0
11953;166044;2471;49;31;4;27;.871;3586000;0
11953;145636;2474;91;41;2;39;.951;3600000;0
11953;146001;2474;0;0;0;0;.00nan;0;0
11954;26308;710;0;0;0;0;.00nan;0;0
11954;176206;710;62;12;1;11;.917;3600000;0
11954;-1;706;0;0;0;0;.00nan;0;0
11954;72229;706;75;44;3;41;.932;3558000;0
11955;170548;712;47;36;5;31;.861;2366000;0
11955;78251;711;66;17;1;16;.941;3600000;0
11955;145733;711;0;0;0;0;.00nan;0;0
11955;160866;712;75;20;0;20;1.000;1234000;0
11956;-1;713;70;28;3;25;.893;3600000;0
11956;-1;2473;49;38;5;33;.868;3580000;0
11956;-1;2473;0;0;0;0;.00nan;0;0
11956;145843;713;0;0;0;0;.00nan;0;0
11957;-1;2465;71;28;3;25;.893;3566000;0
11957;181748;714;64;15;1;14;.933;3600000;0
11957;145787;714;0;0;0;0;.00nan;0;0
11957;145838;2465;0;0;0;0;.00nan;0;0
11958;170548;712;98;26;0;26;1.000;3600000;0
11958;-1;2473;86;26;1;25;.962;3549000;0
11958;-1;2473;0;0;0;0;.00nan;0;0
11958;160866;712;0;0;0;0;.00nan;0;0
11959;26308;710;0;0;0;0;.00nan;0;0
11959;176206;710;82;15;0;15;1.000;3600000;0
11959;145636;2474;0;0;0;0;.00nan;0;0
11959;146001;2474;98;50;2;48;.960;3578000;0
11960;-1;2465;73;25;2;23;.920;3600000;0
11960;-1;706;52;4;0;4;1.000;485000;0
11960;72229;706;40;32;6;26;.813;3115000;0
11960;145838;2465;0;0;0;0;.00nan;0;0
11961;183265;2471;0;0;0;0;.00nan;0;0
11961;166044;2471;89;49;4;45;.918;3600000;0
11961;-1;713;84;30;1;29;.967;3600000;0
11961;145843;713;0;0;0;0;.00nan;0;0
11962;181748;714;69;35;3;32;.914;3600000;0
11962;78251;711;92;20;0;20;1.000;3600000;0
11962;145733;711;0;0;0;0;.00nan;0;0
11962;145787;714;0;0;0;0;.00nan;0;0
11963;-1;713;43;24;4;20;.833;3600000;0
11963;145636;2474;39;39;7;32;.821;3600000;0
11963;145843;713;0;0;0;0;.00nan;0;0
11963;146001;2474;0;0;0;0;.00nan;0;0
11964;183265;2471;52;19;3;16;.842;2824000;0
11964;166044;2471;22;11;4;7;.636;776000;0
11964;170548;712;78;32;3;29;.906;3600000;0
11964;160866;712;0;0;0;0;.00nan;0;0
11965;-1;706;58;24;3;21;.875;3553000;0
11965;72229;706;0;0;0;0;.00nan;0;0
11965;145636;2474;0;0;0;0;.00nan;0;0
11965;146001;2474;71;28;2;26;.929;3600000;0
11966;-1;713;0;0;0;0;.00nan;0;0
11966;26308;710;0;0;0;0;.00nan;0;0
11966;176206;710;53;30;4;26;.867;3600000;0
11966;145843;713;47;33;5;28;.848;3563000;0
11967;-1;2465;47;42;6;36;.857;3600000;0
11967;78251;711;77;25;1;24;.960;3600000;0
11967;145733;711;0;0;0;0;.00nan;0;0
11967;145838;2465;0;0;0;0;.00nan;0;0
11968;-1;2473;0;0;0;0;.00nan;0;0
11968;-1;2473;92;35;1;34;.971;3600000;0
11968;181748;714;27;27;6;21;.778;2732000;0
11968;145787;714;63;9;0;9;1.000;868000;0
11969;-1;713;54;21;3;18;.857;3600000;0
11969;-1;706;0;0;0;0;.00nan;0;0
11969;72229;706;66;42;4;38;.905;3542000;0
11969;145843;713;0;0;0;0;.00nan;0;0
11970;183265;2471;0;0;0;0;.00nan;0;0
11970;166044;2471;82;45;4;41;.911;3600000;0
11970;181748;714;74;17;1;16;.941;3600000;0
11970;145787;714;0;0;0;0;.00nan;0;0
11971;-1;2473;58;35;4;31;.886;3571000;0
11971;-1;2473;0;0;0;0;.00nan;0;0
11971;78251;711;47;13;2;11;.846;3600000;0
11971;145733;711;0;0;0;0;.00nan;0;0
11972;-1;2465;41;24;4;20;.833;3549000;0
11972;145636;2474;85;39;3;36;.923;3600000;0
11972;145838;2465;0;0;0;0;.00nan;0;0
11972;146001;2474;0;0;0;0;.00nan;0;0
11973;170548;712;62;55;5;50;.909;3562000;0
11973;26308;710;0;0;0;0;.00nan;0;0
11973;176206;710;41;14;3;11;.786;3600000;0
11973;160866;712;0;0;0;0;.00nan;0;0
11974;183265;2471;0;0;0;0;.00nan;0;0
11974;166044;2471;97;45;3;42;.933;3600000;0
11974;78251;711;64;18;1;17;.944;3600000;0
11974;145733;711;0;0;0;0;.00nan;0;0
11975;170548;712;49;31;5;26;.839;3600000;0
11975;-1;706;0;0;0;0;.00nan;0;0
11975;72229;706;36;37;6;31;.838;3600000;0
11975;160866;712;0;0;0;0;.00nan;0;0
11976;26308;710;0;0;0;0;.00nan;0;0
11976;176206;710;80;12;0;12;1.000;3600000;0
11976;181748;714;97;45;2;43;.956;3557000;0
11976;145787;714;0;0;0;0;.00nan;0;0
11977;-1;2473;0;0;0;0;.00nan;0;0
11977;-1;2465;66;34;3;31;.912;3600000;0
11977;-1;2473;85;15;0;15;1.000;3600000;0
11977;145838;2465;0;0;0;0;.00nan;0;0
11978;166044;2471;33;16;4;12;.750;1323000;0
11978;-1;2473;0;0;0;0;.00nan;0;0
11978;-1;2473;70;29;3;26;.897;3600000;0
11978;161047;2471;16;19;6;13;.684;2277000;0
11979;181748;714;37;22;5;17;.773;3600000;0
11979;-1;706;0;0;0;0;.00nan;0;0
11979;72229;706;43;44;7;37;.841;3543000;0
11979;145787;714;0;0;0;0;.00nan;0;0
11980;170548;712;65;37;4;33;.892;3600000;0
11980;145636;2474;0;0;0;0;.00nan;0;0
11980;146001;2474;59;24;3;21;.875;3600000;0
11980;160866;712;0;0;0;0;.00nan;0;0
11981;26308;710;0;0;0;0;.00nan;0;0
11981;176206;710;100;32;0;32;1.000;3600000;0
11981;78251;711;84;42;3;39;.929;3600000;0
11981;145733;711;0;0;0;0;.00nan;0;0
11982;-1;713;70;30;3;27;.900;3544000;0
11982;-1;2465;100;46;2;44;.957;3600000;0
11982;145838;2465;0;0;0;0;.00nan;0;0
11982;145843;713;0;0;0;0;.00nan;0;0
11983;166044;2471;0;0;0;0;.00nan;0;0
11983;-1;2465;74;23;1;22;.957;3600000;0
11983;145838;2465;0;0;0;0;.00nan;0;0
11983;161047;2471;67;41;4;37;.902;3600000;0
11984;-1;713;53;29;3;26;.897;3900000;0
11984;170548;712;95;42;3;39;.929;3900000;0
11984;145843;713;0;0;0;0;.00nan;0;0
11984;160866;712;0;0;0;0;.00nan;0;0
11985;-1;706;0;0;0;0;.00nan;0;0
11985;72229;706;67;38;4;34;.895;3515000;0
11985;78251;711;67;22;2;20;.909;3600000;0
11985;145733;711;0;0;0;0;.00nan;0;0
11986;-1;2473;88;40;2;38;.950;3704000;0
11986;26308;710;0;0;0;0;.00nan;0;0
11986;176206;710;57;25;3;22;.880;3704000;0
11986;-1;2473;0;0;0;0;.00nan;0;0
11987;170548;712;62;24;3;21;.875;3600000;0
11987;-1;2465;65;40;4;36;.900;3567000;0
11987;145838;2465;0;0;0;0;.00nan;0;0
11987;160866;712;0;0;0;0;.00nan;0;0
11988;-1;2473;0;0;0;0;.00nan;0;0
11988;-1;2473;34;20;4;16;.800;3567000;0
11988;-1;706;0;0;0;0;.00nan;0;0
11988;72229;706;62;25;3;22;.880;3600000;0
11989;78251;711;60;14;1;13;.929;3600000;0
11989;145636;2474;98;55;2;53;.964;3570000;0
11989;145733;711;0;0;0;0;.00nan;0;0
11989;146001;2474;0;0;0;0;.00nan;0;0
11990;166044;2471;0;0;0;0;.00nan;0;0
11990;26308;710;0;0;0;0;.00nan;0;0
11990;176206;710;55;16;3;13;.813;3900000;0
11990;161047;2471;93;58;3;55;.948;3900000;0
11991;-1;713;0;0;0;0;.00nan;0;0
11991;181748;714;78;43;4;39;.907;3600000;0
11991;145787;714;0;0;0;0;.00nan;0;0
11991;145843;713;44;23;3;20;.870;3600000;0
11992;-1;2465;97;46;3;43;.935;3900000;0
11992;181748;714;65;25;3;22;.880;3900000;0
11992;145787;714;0;0;0;0;.00nan;0;0
11992;145838;2465;0;0;0;0;.00nan;0;0
11993;26308;710;0;0;0;0;.00nan;0;0
11993;176206;710;65;16;1;15;.938;3600000;0
11993;-1;706;86;50;4;46;.920;3600000;0
11993;72229;706;0;0;0;0;.00nan;0;0
11994;-1;713;59;18;2;16;.889;3547000;0
11994;-1;2473;88;37;1;36;.973;3600000;0
11994;-1;2473;0;0;0;0;.00nan;0;0
11994;145843;713;0;0;0;0;.00nan;0;0
11995;170548;712;74;29;3;26;.897;3900000;0
11995;78251;711;23;4;3;1;.250;465000;0
11995;145733;711;79;20;0;20;1.000;3435000;0
11995;160866;712;0;0;0;0;.00nan;0;0
11996;166044;2471;0;0;0;0;.00nan;0;0
11996;145636;2474;0;0;0;0;.00nan;0;0
11996;146001;2474;65;28;2;26;.929;3600000;0
11996;161047;2471;51;24;4;20;.833;3551000;0
11997;-1;706;49;22;3;19;.864;1673000;0
11997;72229;706;70;43;4;39;.907;1927000;0
11997;78251;711;62;21;2;19;.905;3600000;0
11997;145733;711;0;0;0;0;.00nan;0;0
11998;166044;2471;0;0;0;0;.00nan;0;0
11998;-1;713;77;23;1;22;.957;3600000;0
11998;145843;713;0;0;0;0;.00nan;0;0
11998;161047;2471;77;38;3;35;.921;3556000;0
11999;26308;710;0;0;0;0;.00nan;0;0
11999;176206;710;90;24;0;24;1.000;3600000;0
11999;145636;2474;97;59;3;56;.949;3600000;0
11999;146001;2474;0;0;0;0;.00nan;0;0
12000;170548;712;93;36;2;34;.944;3900000;0
12000;-1;2473;66;22;1;21;.955;3900000;0
12000;-1;2473;0;0;0;0;.00nan;0;0
12000;160866;712;0;0;0;0;.00nan;0;0
12001;181748;714;71;26;2;24;.923;3600000;0
12001;145636;2474;0;0;0;0;.00nan;0;0
12001;145787;714;0;0;0;0;.00nan;0;0
12001;146001;2474;71;41;4;37;.902;3583000;0
12002;-1;2465;0;0;0;0;.00nan;0;0
12002;78251;711;52;16;2;14;.875;3600000;0
12002;145733;711;0;0;0;0;.00nan;0;0
12002;145838;2465;86;45;3;42;.933;3600000;0
12003;-1;713;0;0;0;0;.00nan;0;0
12003;26308;710;0;0;0;0;.00nan;0;0
12003;176206;710;88;35;2;33;.943;3600000;0
12003;145843;713;55;33;4;29;.879;3543000;0
12004;166044;2471;0;0;0;0;.00nan;0;0
12004;170548;712;0;0;0;0;.00nan;0;0
12004;160866;712;46;25;4;21;.840;3600000;0
12004;161047;2471;93;37;3;34;.919;3600000;0
12005;-1;2473;0;0;0;0;.00nan;0;0
12005;-1;2473;48;41;5;36;.878;3600000;0
12005;181748;714;76;24;2;22;.917;3600000;0
12005;145787;714;0;0;0;0;.00nan;0;0
12006;-1;706;0;0;0;0;.00nan;0;0
12006;72229;706;54;40;6;34;.850;3600000;0
12006;145636;2474;38;13;3;10;.769;3600000;0
12006;146001;2474;0;0;0;0;.00nan;0;0
12007;-1;2465;83;24;1;23;.958;3600000;0
12007;145636;2474;0;0;0;0;.00nan;0;0
12007;145838;2465;0;0;0;0;.00nan;0;0
12007;146001;2474;54;26;3;23;.885;3519000;0
12008;166044;2471;0;0;0;0;.00nan;0;0
12008;181748;714;90;31;1;30;.968;3600000;0
12008;145787;714;0;0;0;0;.00nan;0;0
12008;161047;2471;69;41;4;37;.902;3600000;0
12009;170548;712;87;43;3;40;.930;3574000;0
12009;26308;710;0;0;0;0;.00nan;0;0
12009;176206;710;55;17;2;15;.882;3600000;0
12009;160866;712;0;0;0;0;.00nan;0;0
12010;-1;2473;0;0;0;0;.00nan;0;0
12010;-1;2473;86;40;2;38;.950;3543000;0
12010;78251;711;77;20;1;19;.950;3600000;0
12010;145733;711;0;0;0;0;.00nan;0;0
12011;-1;713;30;22;5;17;.773;3600000;0
12011;-1;706;56;11;1;10;.909;821000;0
12011;72229;706;42;34;6;28;.824;2779000;0
12011;145843;713;0;0;0;0;.00nan;0;0
12012;-1;2473;0;0;0;0;.00nan;0;0
12012;-1;2465;71;32;2;30;.938;3545000;0
12012;-1;2473;93;35;1;34;.971;3600000;0
12012;145838;2465;0;0;0;0;.00nan;0;0
12013;170548;712;100;37;0;37;1.000;3600000;0
12013;-1;706;0;0;0;0;.00nan;0;0
12013;72229;706;81;30;1;29;.967;3600000;0
12013;160866;712;0;0;0;0;.00nan;0;0
12014;26308;710;0;0;0;0;.00nan;0;0
12014;176206;710;49;24;4;20;.833;3600000;0
12014;181748;714;50;34;5;29;.853;3600000;0
12014;145787;714;0;0;0;0;.00nan;0;0
12015;-1;713;35;20;4;16;.800;3600000;0
12015;145636;2474;0;0;0;0;.00nan;0;0
12015;145843;713;0;0;0;0;.00nan;0;0
12015;146001;2474;59;45;5;40;.889;3600000;0
12016;166044;2471;0;0;0;0;.00nan;0;0
12016;78251;711;54;16;2;14;.875;3600000;0
12016;145733;711;0;0;0;0;.00nan;0;0
12016;161047;2471;41;39;6;33;.846;3600000;0
12017;170548;712;82;25;1;24;.960;3727000;0
12017;145636;2474;93;38;2;36;.947;3727000;0
12017;146001;2474;0;0;0;0;.00nan;0;0
12017;160866;712;0;0;0;0;.00nan;0;0
12018;181748;714;94;25;0;25;1.000;3600000;0
12018;-1;706;0;0;0;0;.00nan;0;0
12018;72229;706;43;32;5;27;.844;3600000;0
12018;145787;714;0;0;0;0;.00nan;0;0
12019;26308;710;0;0;0;0;.00nan;0;0
12019;176206;710;67;30;3;27;.900;3900000;0
12019;78251;711;52;22;3;19;.864;3900000;0
12019;145733;711;0;0;0;0;.00nan;0;0
12020;166044;2471;0;0;0;0;.00nan;0;0
12020;-1;2473;0;0;0;0;.00nan;0;0
12020;-1;2473;75;29;2;27;.931;3600000;0
12020;161047;2471;75;42;3;39;.929;3600000;0
12021;-1;713;78;24;1;23;.958;3600000;0
12021;-1;2465;79;31;2;29;.935;3576000;0
12021;145838;2465;0;0;0;0;.00nan;0;0
12021;145843;713;0;0;0;0;.00nan;0;0
12022;-1;2473;65;22;3;19;.864;3647000;0
12022;-1;2473;0;0;0;0;.00nan;0;0
12022;145636;2474;0;0;0;0;.00nan;0;0
12022;146001;2474;73;26;2;24;.923;3647000;0
12023;166044;2471;0;0;0;0;.00nan;0;0
12023;-1;2465;78;24;1;23;.958;3600000;0
12023;145838;2465;0;0;0;0;.00nan;0;0
12023;161047;2471;88;37;2;35;.946;3554000;0
12024;-1;706;85;44;2;42;.955;3600000;0
12024;72229;706;0;0;0;0;.00nan;0;0
12024;78251;711;54;9;1;8;.889;3600000;0
12024;145733;711;0;0;0;0;.00nan;0;0
12025;-1;713;0;0;0;0;.00nan;0;0
12025;170548;712;52;46;7;39;.848;3365000;0
12025;145843;713;51;23;3;20;.870;3600000;0
12025;160866;712;48;0;0;0;.00nan;235000;0
12026;181748;714;67;22;2;20;.909;3600000;0
12026;145636;2474;0;0;0;0;.00nan;0;0
12026;145787;714;0;0;0;0;.00nan;0;0
12026;146001;2474;23;34;7;27;.794;3600000;0
12027;-1;2473;56;42;5;37;.881;3524000;0
12027;26308;710;0;0;0;0;.00nan;0;0
12027;176206;710;61;22;3;19;.864;3600000;0
12027;-1;2473;0;0;0;0;.00nan;0;0
12028;166044;2471;0;0;0;0;.00nan;0;0
12028;26308;710;0;0;0;0;.00nan;0;0
12028;176206;710;68;21;1;20;.952;3600000;0
12028;161047;2471;28;36;7;29;.806;3600000;0
12029;-1;713;100;20;0;20;1.000;3600000;0
12029;181748;714;92;32;1;31;.969;3600000;0
12029;145787;714;0;0;0;0;.00nan;0;0
12029;145843;713;0;0;0;0;.00nan;0;0
12030;78251;711;0;0;0;0;.00nan;0;0
12030;145636;2474;28;32;6;26;.813;2234000;0
12030;145733;711;77;27;1;26;.963;3600000;0
12030;146001;2474;60;29;3;26;.897;1366000;0
12031;170548;712;93;36;2;34;.944;3600000;0
12031;-1;2465;52;25;3;22;.880;3547000;0
12031;145838;2465;0;0;0;0;.00nan;0;0
12031;160866;712;0;0;0;0;.00nan;0;0
12032;-1;2473;55;2;0;2;1.000;928000;0
12032;-1;2473;29;30;6;24;.800;2972000;0
12032;-1;706;0;0;0;0;.00nan;0;0
12032;72229;706;47;34;6;28;.824;3900000;0
12033;26308;710;0;0;0;0;.00nan;0;0
12033;176206;710;67;28;3;25;.893;3900000;0
12033;-1;2465;81;45;3;42;.933;3900000;0
12033;145838;2465;0;0;0;0;.00nan;0;0
12034;166044;2471;0;0;0;0;.00nan;0;0
12034;-1;706;0;0;0;0;.00nan;0;0
12034;72229;706;41;37;6;31;.838;3600000;0
12034;161047;2471;90;27;1;26;.963;3600000;0
12035;-1;713;68;34;3;31;.912;3900000;0
12035;78251;711;68;30;3;27;.900;3900000;0
12035;145733;711;0;0;0;0;.00nan;0;0
12035;145843;713;0;0;0;0;.00nan;0;0
12036;170548;712;100;21;0;21;1.000;3600000;0
12036;181748;714;59;30;5;25;.833;3600000;0
12036;145787;714;0;0;0;0;.00nan;0;0
12036;160866;712;0;0;0;0;.00nan;0;0
12037;166044;2471;50;34;4;30;.882;3600000;0
12037;145636;2474;48;41;6;35;.854;3555000;0
12037;146001;2474;0;0;0;0;.00nan;0;0
12037;161047;2471;0;0;0;0;.00nan;0;0
12038;-1;2465;67;33;3;30;.909;3600000;0
12038;181748;714;72;15;0;15;1.000;1893000;0
12038;145787;714;10;15;6;9;.600;1707000;0
12038;145838;2465;0;0;0;0;.00nan;0;0
12039;26308;710;0;0;0;0;.00nan;0;0
12039;176206;710;45;20;3;17;.850;3600000;0
12039;-1;706;0;0;0;0;.00nan;0;0
12039;72229;706;49;41;6;35;.854;3600000;0
12040;170548;712;92;52;2;50;.962;3600000;0
12040;78251;711;43;15;3;12;.800;3584000;0
12040;145733;711;0;0;0;0;.00nan;0;0
12040;160866;712;0;0;0;0;.00nan;0;0
12041;-1;713;65;29;3;26;.897;3600000;0
12041;-1;2473;43;25;4;21;.840;3600000;0
12041;-1;2473;0;0;0;0;.00nan;0;0
12041;145843;713;0;0;0;0;.00nan;0;0
12042;-1;2465;86;34;2;32;.941;3600000;0
12042;-1;706;0;0;0;0;.00nan;0;0
12042;72229;706;54;26;3;23;.885;3554000;0
12042;145838;2465;0;0;0;0;.00nan;0;0
12043;166044;2471;0;0;0;0;.00nan;0;0
12043;-1;713;30;14;4;10;.714;3515000;0
12043;145843;713;0;0;0;0;.00nan;0;0
12043;161047;2471;90;38;2;36;.947;3600000;0
12044;170548;712;76;34;3;31;.912;3600000;0
12044;-1;2473;0;0;0;0;.00nan;0;0
12044;-1;2473;65;33;4;29;.879;3543000;0
12044;160866;712;0;0;0;0;.00nan;0;0
12045;181748;714;98;55;3;52;.945;3544000;0
12045;78251;711;73;20;2;18;.900;3600000;0
12045;145733;711;0;0;0;0;.00nan;0;0
12045;145787;714;0;0;0;0;.00nan;0;0
12046;26308;710;0;0;0;0;.00nan;0;0
12046;176206;710;43;19;4;15;.789;3900000;0
12046;145636;2474;92;57;4;53;.930;3900000;0
12046;146001;2474;0;0;0;0;.00nan;0;0
12047;166044;2471;0;0;0;0;.00nan;0;0
12047;170548;712;76;31;3;28;.903;3515000;0
12047;160866;712;0;0;0;0;.00nan;0;0
12047;161047;2471;97;30;1;29;.967;3600000;0
12048;-1;706;0;0;0;0;.00nan;0;0
12048;72229;706;85;21;1;20;.952;3600000;0
12048;145636;2474;75;41;3;38;.927;3526000;0
12048;146001;2474;0;0;0;0;.00nan;0;0
12049;-1;713;97;22;0;22;1.000;3600000;0
12049;26308;710;0;0;0;0;.00nan;0;0
12049;176206;710;46;31;5;26;.839;3600000;0
12049;145843;713;0;0;0;0;.00nan;0;0
12050;-1;2465;70;39;3;36;.923;3580000;0
12050;78251;711;64;21;2;19;.905;3600000;0
12050;145733;711;0;0;0;0;.00nan;0;0
12050;145838;2465;0;0;0;0;.00nan;0;0
12051;-1;2473;64;40;4;36;.900;3600000;0
12051;-1;2473;0;0;0;0;.00nan;0;0
12051;181748;714;73;25;2;23;.920;3600000;0
12051;145787;714;0;0;0;0;.00nan;0;0
12052;-1;713;21;20;5;15;.750;3560000;0
12052;-1;706;0;0;0;0;.00nan;0;0
12052;72229;706;78;35;3;32;.914;3600000;0
12052;145843;713;0;0;0;0;.00nan;0;0
12053;170548;712;92;48;3;45;.938;3550000;0
12053;26308;710;0;0;0;0;.00nan;0;0
12053;176206;710;60;19;2;17;.895;3600000;0
12053;160866;712;0;0;0;0;.00nan;0;0
12054;166044;2471;0;0;0;0;.00nan;0;0
12054;181748;714;100;36;0;36;1.000;3600000;0
12054;145787;714;0;0;0;0;.00nan;0;0
12054;161047;2471;64;31;3;28;.903;3600000;0
12055;-1;2465;81;26;1;25;.962;3900000;0
12055;145636;2474;77;28;1;27;.964;3900000;0
12055;145838;2465;0;0;0;0;.00nan;0;0
12055;146001;2474;0;0;0;0;.00nan;0;0
12056;-1;2473;0;0;0;0;.00nan;0;0
12056;-1;2473;36;40;6;34;.850;3600000;0
12056;78251;711;74;12;0;12;1.000;3600000;0
12056;145733;711;0;0;0;0;.00nan;0;0
12057;166044;2471;0;0;0;0;.00nan;0;0
12057;78251;711;70;20;1;19;.950;3600000;0
12057;145733;711;0;0;0;0;.00nan;0;0
12057;161047;2471;55;32;4;28;.875;3600000;0
12058;170548;712;57;18;2;16;.889;3600000;0
12058;-1;706;0;0;0;0;.00nan;0;0
12058;72229;706;61;35;4;31;.886;3600000;0
12058;160866;712;0;0;0;0;.00nan;0;0
12059;-1;713;65;22;2;20;.909;3600000;0
12059;145636;2474;58;30;4;26;.867;3559000;0
12059;145843;713;0;0;0;0;.00nan;0;0
12059;146001;2474;0;0;0;0;.00nan;0;0
12060;-1;2473;61;23;2;21;.913;3786000;0
12060;-1;2465;73;35;3;32;.914;3786000;0
12060;-1;2473;0;0;0;0;.00nan;0;0
12060;145838;2465;0;0;0;0;.00nan;0;0
12061;26308;710;69;20;1;19;.950;3600000;0
12061;176206;710;0;0;0;0;.00nan;0;0
12061;181748;714;55;31;4;27;.871;3600000;0
12061;145787;714;0;0;0;0;.00nan;0;0
12062;166044;2471;0;0;0;0;.00nan;0;0
12062;-1;2473;0;0;0;0;.00nan;0;0
12062;-1;2473;50;25;4;21;.840;3600000;0
12062;161047;2471;37;41;7;34;.829;3600000;0
12063;181748;714;81;23;1;22;.957;3600000;0
12063;-1;706;34;33;6;27;.818;3345000;0
12063;72229;706;49;1;0;1;1.000;255000;0
12063;145787;714;0;0;0;0;.00nan;0;0
12064;-1;713;57;19;3;16;.842;3600000;0
12064;-1;2465;69;45;5;40;.889;3600000;0
12064;145838;2465;0;0;0;0;.00nan;0;0
12064;145843;713;0;0;0;0;.00nan;0;0
12065;170548;712;100;32;0;32;1.000;3600000;0
12065;145636;2474;0;0;0;0;.00nan;0;0
12065;146001;2474;74;35;2;33;.943;3600000;0
12065;160866;712;0;0;0;0;.00nan;0;0
12066;26308;710;0;0;0;0;.00nan;0;0
12066;176206;710;93;41;2;39;.951;3900000;0
12066;78251;711;73;23;2;21;.913;3900000;0
12066;145733;711;0;0;0;0;.00nan;0;0
12067;166044;2471;0;0;0;0;.00nan;0;0
12067;-1;2465;84;33;1;32;.970;3892000;0
12067;145838;2465;0;0;0;0;.00nan;0;0
12067;161047;2471;65;13;1;12;.923;3900000;0
12068;-1;713;39;18;4;14;.778;3597000;0
12068;170548;712;83;36;3;33;.917;3600000;0
12068;145843;713;0;0;0;0;.00nan;0;0
12068;160866;712;0;0;0;0;.00nan;0;0
12069;181748;714;0;0;0;0;.00nan;0;0
12069;145636;2474;83;33;2;31;.939;3600000;0
12069;145787;714;82;27;1;26;.963;3600000;0
12069;146001;2474;0;0;0;0;.00nan;0;0
12070;-1;706;0;0;0;0;.00nan;0;0
12070;72229;706;83;54;5;49;.907;3600000;0
12070;78251;711;92;19;0;19;1.000;3600000;0
12070;145733;711;0;0;0;0;.00nan;0;0
12071;-1;2473;55;25;3;22;.880;3900000;0
12071;26308;710;0;0;0;0;.00nan;0;0
12071;176206;710;72;29;3;26;.897;3872000;0
12071;-1;2473;0;0;0;0;.00nan;0;0
12072;170548;712;81;35;3;32;.914;3587000;0
12072;-1;2465;87;42;2;40;.952;3600000;0
12072;145838;2465;0;0;0;0;.00nan;0;0
12072;160866;712;0;0;0;0;.00nan;0;0
12073;-1;2473;0;0;0;0;.00nan;0;0
12073;-1;2473;76;21;1;20;.952;3900000;0
12073;-1;706;0;0;0;0;.00nan;0;0
12073;72229;706;89;30;1;29;.967;3900000;0
12074;-1;713;70;43;4;39;.907;3571000;0
12074;181748;714;85;25;2;23;.920;3600000;0
12074;145787;714;0;0;0;0;.00nan;0;0
12074;145843;713;0;0;0;0;.00nan;0;0
12075;78251;711;49;22;3;19;.864;3598000;0
12075;145636;2474;0;0;0;0;.00nan;0;0
12075;145733;711;0;0;0;0;.00nan;0;0
12075;146001;2474;99;59;2;57;.966;3600000;0
12076;166044;2471;0;0;0;0;.00nan;0;0
12076;26308;710;0;0;0;0;.00nan;0;0
12076;176206;710;63;19;2;17;.895;3600000;0
12076;161047;2471;52;32;4;28;.875;3600000;0
12077;166044;2471;29;26;6;20;.769;3547000;0
12077;-1;706;0;0;0;0;.00nan;0;0
12077;72229;706;60;33;5;28;.848;3600000;0
12077;161047;2471;0;0;0;0;.00nan;0;0
12078;170548;712;87;29;1;28;.966;3600000;0
12078;181748;714;67;39;5;34;.872;3600000;0
12078;145787;714;0;0;0;0;.00nan;0;0
12078;160866;712;0;0;0;0;.00nan;0;0
12079;26308;710;0;0;0;0;.00nan;0;0
12079;176206;710;49;23;4;19;.826;3600000;0
12079;-1;2465;100;51;0;51;1.000;3600000;0
12079;145838;2465;0;0;0;0;.00nan;0;0
12080;-1;713;45;43;6;37;.860;3550000;0
12080;78251;711;35;22;5;17;.773;3600000;0
12080;145733;711;0;0;0;0;.00nan;0;0
12080;145843;713;0;0;0;0;.00nan;0;0
12081;-1;2473;75;23;1;22;.957;3600000;0
12081;-1;2473;0;0;0;0;.00nan;0;0
12081;145636;2474;68;43;5;38;.884;3600000;0
12081;146001;2474;0;0;0;0;.00nan;0;0
12082;-1;2465;82;26;1;25;.962;3600000;0
12082;181748;714;54;29;3;26;.897;3535000;0
12082;145787;714;0;0;0;0;.00nan;0;0
12082;145838;2465;0;0;0;0;.00nan;0;0
12083;26308;710;0;0;0;0;.00nan;0;0
12083;176206;710;32;16;4;12;.750;3600000;0
12083;-1;706;72;22;1;21;.955;1327000;0
12083;72229;706;44;34;5;29;.853;2273000;0
12084;-1;713;71;22;1;21;.955;3900000;0
12084;-1;2473;89;28;1;27;.964;3900000;0
12084;-1;2473;0;0;0;0;.00nan;0;0
12084;145843;713;0;0;0;0;.00nan;0;0
12085;170548;712;0;0;0;0;.00nan;0;0
12085;78251;711;52;12;2;10;.833;3600000;0
12085;145733;711;0;0;0;0;.00nan;0;0
12085;160866;712;49;39;5;34;.872;3600000;0
12086;166044;2471;0;0;0;0;.00nan;0;0
12086;145636;2474;58;5;0;5;1.000;436000;0
12086;146001;2474;41;35;6;29;.829;3164000;0
12086;161047;2471;77;25;1;24;.960;3600000;0
12087;-1;2465;58;23;3;20;.870;3637000;0
12087;-1;706;0;0;0;0;.00nan;0;0
12087;72229;706;45;22;4;18;.818;3637000;0
12087;145838;2465;0;0;0;0;.00nan;0;0
12088;26308;710;0;0;0;0;.00nan;0;0
12088;176206;710;70;15;1;14;.933;3600000;0
12088;145636;2474;75;56;7;49;.875;3600000;0
12088;146001;2474;0;0;0;0;.00nan;0;0
12089;181748;714;75;41;4;37;.902;3900000;0
12089;78251;711;45;24;4;20;.833;3900000;0
12089;145733;711;0;0;0;0;.00nan;0;0
12089;145787;714;0;0;0;0;.00nan;0;0
12090;170548;712;58;38;5;33;.868;3600000;0
12090;-1;2473;0;0;0;0;.00nan;0;0
12090;-1;2473;67;27;2;25;.926;3600000;0
12090;160866;712;0;0;0;0;.00nan;0;0
12091;166044;2471;0;0;0;0;.00nan;0;0
12091;-1;713;62;19;2;17;.895;3900000;0
12091;145843;713;0;0;0;0;.00nan;0;0
12091;161047;2471;70;30;2;28;.933;3900000;0
12092;-1;2465;83;44;2;42;.955;3565000;0
12092;78251;711;96;22;0;22;1.000;3600000;0
12092;145733;711;0;0;0;0;.00nan;0;0
12092;145838;2465;0;0;0;0;.00nan;0;0
12093;-1;713;79;39;3;36;.923;3600000;0
12093;26308;710;0;0;0;0;.00nan;0;0
12093;176206;710;47;27;4;23;.852;3566000;0
12093;145843;713;0;0;0;0;.00nan;0;0
12094;166044;2471;0;0;0;0;.00nan;0;0
12094;170548;712;61;30;4;26;.867;3571000;0
12094;160866;712;0;0;0;0;.00nan;0;0
12094;161047;2471;96;43;2;41;.953;3600000;0
12095;-1;2473;0;0;0;0;.00nan;0;0
12095;-1;2473;72;30;2;28;.933;3600000;0
12095;181748;714;69;26;3;23;.885;3600000;0
12095;145787;714;0;0;0;0;.00nan;0;0
12096;-1;706;0;0;0;0;.00nan;0;0
12096;72229;706;26;28;6;22;.786;3600000;0
12096;145636;2474;0;0;0;0;.00nan;0;0
12096;146001;2474;78;26;2;24;.923;3600000;0
12097;166044;2471;0;0;0;0;.00nan;0;0
12097;181748;714;70;19;1;18;.947;3600000;0
12097;145787;714;0;0;0;0;.00nan;0;0
12097;161047;2471;62;35;3;32;.914;3573000;0
12098;-1;2465;38;16;4;12;.750;3600000;0
12098;145636;2474;53;40;6;34;.850;3578000;0
12098;145838;2465;0;0;0;0;.00nan;0;0
12098;146001;2474;0;0;0;0;.00nan;0;0
12099;170548;712;78;41;3;38;.927;3600000;0
12099;26308;710;0;0;0;0;.00nan;0;0
12099;176206;710;68;16;1;15;.938;3600000;0
12099;160866;712;0;0;0;0;.00nan;0;0
12100;-1;2473;36;41;7;34;.829;3600000;0
12100;-1;2473;0;0;0;0;.00nan;0;0
12100;78251;711;74;25;2;23;.920;3600000;0
12100;145733;711;0;0;0;0;.00nan;0;0
12101;-1;713;33;15;4;11;.733;3600000;0
12101;-1;706;0;0;0;0;.00nan;0;0
12101;72229;706;100;35;1;34;.971;3600000;0
12101;145843;713;0;0;0;0;.00nan;0;0
12102;-1;713;67;32;3;29;.906;3600000;0
12102;-1;2465;94;20;0;20;1.000;3600000;0
12102;145838;2465;0;0;0;0;.00nan;0;0
12102;145843;713;0;0;0;0;.00nan;0;0
12103;170548;712;81;46;5;41;.891;3600000;0
12103;145636;2474;0;0;0;0;.00nan;0;0
12103;146001;2474;25;34;7;27;.794;3513000;0
12103;160866;712;0;0;0;0;.00nan;0;0
12104;181748;714;81;27;1;26;.963;3600000;0
12104;-1;706;0;0;0;0;.00nan;0;0
12104;72229;706;70;36;4;32;.889;3600000;0
12104;145787;714;0;0;0;0;.00nan;0;0
12105;26308;710;0;0;0;0;.00nan;0;0
12105;176206;710;51;44;6;38;.864;3600000;0
12105;78251;711;58;23;2;21;.913;3600000;0
12105;145733;711;0;0;0;0;.00nan;0;0
12106;166044;2471;0;0;0;0;.00nan;0;0
12106;-1;2473;0;0;0;0;.00nan;0;0
12106;-1;2473;48;18;3;15;.833;3553000;0
12106;161047;2471;80;34;2;32;.941;3600000;0
12107;-1;706;0;0;0;0;.00nan;0;0
12107;72229;706;85;46;3;43;.935;3600000;0
12107;78251;711;58;16;1;15;.938;3600000;0
12107;145733;711;0;0;0;0;.00nan;0;0
12108;181748;714;74;32;2;30;.938;3544000;0
12108;145636;2474;100;25;0;25;1.000;3600000;0
12108;145787;714;0;0;0;0;.00nan;0;0
12108;146001;2474;0;0;0;0;.00nan;0;0
12109;-1;2473;39;37;6;31;.838;2049000;0
12109;26308;710;0;0;0;0;.00nan;0;0
12109;176206;710;44;18;3;15;.833;3600000;0
12109;-1;2473;35;13;3;10;.769;1551000;0
12110;166044;2471;82;35;3;32;.914;3580000;0
12110;-1;2465;72;28;2;26;.929;3600000;0
12110;145838;2465;0;0;0;0;.00nan;0;0
12110;161047;2471;0;0;0;0;.00nan;0;0
12111;-1;713;77;37;3;34;.919;3600000;0
12111;170548;712;68;36;4;32;.889;3559000;0
12111;145843;713;0;0;0;0;.00nan;0;0
12111;160866;712;0;0;0;0;.00nan;0;0
12112;166044;2471;0;0;0;0;.00nan;0;0
12112;26308;710;0;0;0;0;.00nan;0;0
12112;176206;710;83;17;0;17;1.000;3600000;0
12112;161047;2471;98;40;1;39;.975;3563000;0
12113;170548;712;81;27;1;26;.963;3753000;0
12113;-1;2465;76;26;2;24;.923;3753000;0
12113;145838;2465;0;0;0;0;.00nan;0;0
12113;160866;712;0;0;0;0;.00nan;0;0
12114;-1;713;80;29;1;28;.966;3600000;0
12114;181748;714;63;41;5;36;.878;3600000;0
12114;145787;714;0;0;0;0;.00nan;0;0
12114;145843;713;0;0;0;0;.00nan;0;0
12115;78251;711;68;16;1;15;.938;3600000;0
12115;145636;2474;0;0;0;0;.00nan;0;0
12115;145733;711;0;0;0;0;.00nan;0;0
12115;146001;2474;78;45;4;41;.911;3600000;0
12116;-1;2473;89;20;0;20;1.000;3600000;0
12116;-1;2473;0;0;0;0;.00nan;0;0
12116;-1;706;0;0;0;0;.00nan;0;0
12116;72229;706;55;38;6;32;.842;3600000;0
12117;26308;710;0;0;0;0;.00nan;0;0
12117;176206;710;61;18;2;16;.889;3900000;0
12117;-1;2465;92;42;2;40;.952;3900000;0
12117;145838;2465;0;0;0;0;.00nan;0;0
12118;170548;712;98;41;2;39;.951;3600000;0
12118;181748;714;75;23;1;22;.957;3600000;0
12118;145787;714;0;0;0;0;.00nan;0;0
12118;160866;712;0;0;0;0;.00nan;0;0
12119;-1;2473;85;28;2;26;.929;3600000;0
12119;-1;2473;0;0;0;0;.00nan;0;0
12119;145636;2474;31;31;6;25;.806;2848000;0
12119;146001;2474;55;5;0;5;1.000;752000;0
12120;166044;2471;0;0;0;0;.00nan;0;0
12120;-1;706;0;0;0;0;.00nan;0;0
12120;72229;706;73;41;4;37;.902;3600000;0
12120;161047;2471;32;23;5;18;.783;3544000;0
12121;-1;713;0;0;0;0;.00nan;0;0
12121;78251;711;64;19;2;17;.895;3600000;0
12121;145733;711;0;0;0;0;.00nan;0;0
12121;145843;713;24;28;6;22;.786;3600000;0
12122;166044;2471;0;0;0;0;.00nan;0;0
12122;145636;2474;0;0;0;0;.00nan;0;0
12122;146001;2474;46;33;5;28;.848;3549000;0
12122;161047;2471;47;22;3;19;.864;3600000;0
12123;26308;710;0;0;0;0;.00nan;0;0
12123;176206;710;57;11;1;10;.909;3600000;0
12123;-1;706;0;0;0;0;.00nan;0;0
12123;72229;706;81;38;2;36;.947;3595000;0
12124;170548;712;67;42;5;37;.881;3600000;0
12124;78251;711;96;24;0;24;1.000;3600000;0
12124;145733;711;0;0;0;0;.00nan;0;0
12124;160866;712;0;0;0;0;.00nan;0;0
12125;-1;713;66;30;3;27;.900;3600000;0
12125;-1;2473;0;0;0;0;.00nan;0;0
12125;-1;2473;58;30;4;26;.867;3600000;0
12125;145843;713;0;0;0;0;.00nan;0;0
12126;-1;2465;42;35;5;30;.857;3563000;0
12126;181748;714;0;0;0;0;.00nan;0;0
12126;145787;714;67;29;3;26;.897;3600000;0
12126;145838;2465;0;0;0;0;.00nan;0;0
12127;26308;710;0;0;0;0;.00nan;0;0
12127;176206;710;82;18;1;17;.944;3600000;0
12127;145636;2474;59;48;6;42;.875;3600000;0
12127;146001;2474;0;0;0;0;.00nan;0;0
12128;-1;2465;79;22;1;21;.955;3600000;0
12128;-1;706;0;0;0;0;.00nan;0;0
12128;72229;706;40;35;5;30;.857;3600000;0
12128;145838;2465;0;0;0;0;.00nan;0;0
12129;166044;2471;0;0;0;0;.00nan;0;0
12129;-1;713;54;23;4;19;.826;3600000;0
12129;145843;713;0;0;0;0;.00nan;0;0
12129;161047;2471;74;47;5;42;.894;3531000;0
12130;170548;712;75;39;4;35;.897;3565000;0
12130;-1;2473;0;0;0;0;.00nan;0;0
12130;-1;2473;64;24;2;22;.917;3600000;0
12130;160866;712;0;0;0;0;.00nan;0;0
12131;181748;714;68;34;3;31;.912;3565000;0
12131;78251;711;90;37;2;35;.946;3600000;0
12131;145733;711;0;0;0;0;.00nan;0;0
12131;145787;714;0;0;0;0;.00nan;0;0
12132;166044;2471;0;0;0;0;.00nan;0;0
12132;170548;712;93;30;1;29;.967;3600000;0
12132;160866;712;0;0;0;0;.00nan;0;0
12132;161047;2471;31;49;8;41;.837;3600000;0
12133;-1;706;0;0;0;0;.00nan;0;0
12133;72229;706;48;24;3;21;.875;3900000;0
12133;145636;2474;77;36;3;33;.917;3900000;0
12133;146001;2474;0;0;0;0;.00nan;0;0
12134;-1;713;68;39;4;35;.897;3600000;0
12134;26308;710;48;17;3;14;.824;3600000;0
12134;176206;710;0;0;0;0;.00nan;0;0
12134;145843;713;0;0;0;0;.00nan;0;0
12135;-1;2465;72;43;4;39;.907;3600000;0
12135;78251;711;64;11;1;10;.909;3600000;0
12135;145733;711;0;0;0;0;.00nan;0;0
12135;145838;2465;0;0;0;0;.00nan;0;0
12136;-1;2473;79;21;1;20;.952;3600000;0
12136;-1;2473;0;0;0;0;.00nan;0;0
12136;181748;714;58;19;2;17;.895;3600000;0
12136;145787;714;0;0;0;0;.00nan;0;0
12137;170548;712;97;28;1;27;.964;3600000;0
12137;26308;710;0;0;0;0;.00nan;0;0
12137;176206;710;58;22;3;19;.864;3582000;0
12137;160866;712;0;0;0;0;.00nan;0;0
12138;166044;2471;0;0;0;0;.00nan;0;0
12138;181748;714;63;19;2;17;.895;3900000;0
12138;145787;714;0;0;0;0;.00nan;0;0
12138;161047;2471;91;38;2;36;.947;3900000;0
12139;-1;2473;45;27;4;23;.852;3109000;0
12139;-1;2473;32;10;3;7;.700;491000;0
12139;78251;711;75;20;1;19;.950;3600000;0
12139;145733;711;0;0;0;0;.00nan;0;0
12140;-1;2465;54;23;3;20;.870;3600000;0
12140;145636;2474;76;32;2;30;.938;3037000;0
12140;145838;2465;0;0;0;0;.00nan;0;0
12140;146001;2474;27;7;3;4;.571;533000;0
12141;-1;713;55;14;2;12;.857;3600000;0
12141;-1;706;0;0;0;0;.00nan;0;0
12141;72229;706;72;45;4;41;.911;3600000;0
12141;145843;713;0;0;0;0;.00nan;0;0
12142;166044;2471;0;0;0;0;.00nan;0;0
12142;78251;711;80;28;1;27;.964;3600000;0
12142;145733;711;0;0;0;0;.00nan;0;0
12142;161047;2471;75;49;5;44;.898;3600000;0
12143;170548;712;77;32;3;29;.906;3600000;0
12143;-1;706;35;26;5;21;.808;3516000;0
12143;72229;706;0;0;0;0;.00nan;0;0
12143;160866;712;0;0;0;0;.00nan;0;0
12144;-1;713;87;16;0;16;1.000;3600000;0
12144;145636;2474;59;41;5;36;.878;3600000;0
12144;145843;713;0;0;0;0;.00nan;0;0
12144;146001;2474;0;0;0;0;.00nan;0;0
12145;26308;710;0;0;0;0;.00nan;0;0
12145;176206;710;100;38;1;37;.974;3900000;0
12145;181748;714;86;30;1;29;.967;3900000;0
12145;145787;714;0;0;0;0;.00nan;0;0
12146;-1;2473;44;16;2;14;.875;3553000;0
12146;-1;2465;84;30;1;29;.967;3600000;0
12146;-1;2473;0;0;0;0;.00nan;0;0
12146;145838;2465;0;0;0;0;.00nan;0;0
12147;166044;2471;0;0;0;0;.00nan;0;0
12147;-1;2465;28;30;7;23;.767;2942000;0
12147;145838;2465;48;7;1;6;.857;658000;0
12147;161047;2471;58;26;3;23;.885;3600000;0
12148;181748;714;65;24;2;22;.917;3560000;0
12148;145636;2474;95;31;1;30;.968;3600000;0
12148;145787;714;0;0;0;0;.00nan;0;0
12148;146001;2474;0;0;0;0;.00nan;0;0
12149;-1;2473;69;31;3;28;.903;3600000;0
12149;26308;710;0;0;0;0;.00nan;0;0
12149;176206;710;46;24;4;20;.833;3549000;0
12149;-1;2473;0;0;0;0;.00nan;0;0
12150;-1;713;70;27;2;25;.926;3600000;0
12150;170548;712;64;29;3;26;.897;3595000;0
12150;145843;713;0;0;0;0;.00nan;0;0
12150;160866;712;0;0;0;0;.00nan;0;0
12151;166044;2471;0;0;0;0;.00nan;0;0
12151;-1;706;0;0;0;0;.00nan;0;0
12151;72229;706;88;45;2;43;.956;3600000;0
12151;161047;2471;91;32;1;31;.969;3600000;0
12152;170548;712;79;37;5;32;.865;3600000;0
12152;181748;714;76;25;1;24;.960;3600000;0
12152;145787;714;0;0;0;0;.00nan;0;0
12152;160866;712;0;0;0;0;.00nan;0;0
12153;26308;710;0;0;0;0;.00nan;0;0
12153;176206;710;67;26;4;22;.846;3900000;0
12153;-1;2465;52;30;4;26;.867;3900000;0
12153;145838;2465;0;0;0;0;.00nan;0;0
12154;-1;713;76;48;4;44;.917;3573000;0
12154;78251;711;0;0;0;0;.00nan;0;0
12154;145733;711;58;27;3;24;.889;3600000;0
12154;145843;713;0;0;0;0;.00nan;0;0
12155;-1;2473;0;0;0;0;.00nan;0;0
12155;-1;2473;55;13;2;11;.846;3600000;0
12155;145636;2474;60;39;4;35;.897;3600000;0
12155;146001;2474;0;0;0;0;.00nan;0;0
12156;-1;2473;46;26;4;22;.846;3600000;0
12156;-1;2465;0;0;0;0;.00nan;0;0
12156;-1;2473;0;0;0;0;.00nan;0;0
12156;145838;2465;77;30;2;28;.933;3600000;0
12157;-1;713;0;0;0;0;.00nan;0;0
12157;145636;2474;69;49;7;42;.857;3600000;0
12157;145843;713;49;12;2;10;.833;3600000;0
12157;146001;2474;0;0;0;0;.00nan;0;0
12158;170548;712;100;27;0;27;1.000;3600000;0
12158;-1;706;0;0;0;0;.00nan;0;0
12158;72229;706;88;34;1;33;.971;3578000;0
12158;160866;712;0;0;0;0;.00nan;0;0
12159;26308;710;0;0;0;0;.00nan;0;0
12159;176206;710;58;12;2;10;.833;3600000;0
12159;181748;714;61;30;4;26;.867;3593000;0
12159;145787;714;0;0;0;0;.00nan;0;0
12160;166044;2471;0;0;0;0;.00nan;0;0
12160;78251;711;78;30;2;28;.933;3600000;0
12160;145733;711;0;0;0;0;.00nan;0;0
12160;161047;2471;39;37;6;31;.838;3600000;0
12162;183265;2471;0;0;0;0;.00nan;0;0
12162;166044;2471;91;51;4;47;.922;3540000;0
12162;-1;713;59;17;2;15;.882;3600000;0
12162;145843;713;0;0;0;0;.00nan;0;0
12164;181748;714;42;12;3;9;.750;569000;0
12164;78251;711;100;24;0;24;1.000;3600000;0
12164;145733;711;0;0;0;0;.00nan;0;0
12164;145787;714;79;37;2;35;.946;3031000;0
12166;170548;712;65;31;2;29;.935;3561000;0
12166;145636;2474;79;28;1;27;.964;3600000;0
12166;146001;2474;0;0;0;0;.00nan;0;0
12166;160866;712;0;0;0;0;.00nan;0;0
12168;-1;2473;100;42;0;42;1.000;3600000;0
12168;26308;710;0;0;0;0;.00nan;0;0
12168;176206;710;82;21;1;20;.952;3572000;0
12168;-1;2473;0;0;0;0;.00nan;0;0
12170;-1;2465;29;23;5;18;.783;3600000;0
12170;-1;706;0;0;0;0;.00nan;0;0
12170;72229;706;78;26;1;25;.962;3600000;0
12170;145838;2465;0;0;0;0;.00nan;0;0
12172;183265;2471;0;0;0;0;.00nan;0;0
12172;166044;2471;71;42;4;38;.905;3578000;0
12172;-1;713;0;0;0;0;.00nan;0;0
12172;145843;713;51;15;2;13;.867;3600000;0
12174;170548;712;65;40;5;35;.875;3702000;0
12174;26308;710;0;0;0;0;.00nan;0;0
12174;176206;710;65;39;4;35;.897;3702000;0
12174;160866;712;0;0;0;0;.00nan;0;0
12176;181748;714;77;26;2;24;.923;3600000;0
12176;145636;2474;0;0;0;0;.00nan;0;0
12176;145787;714;0;0;0;0;.00nan;0;0
12176;146001;2474;58;48;6;42;.875;3600000;0
12178;-1;2473;94;46;1;45;.978;3626000;0
12178;-1;2473;0;0;0;0;.00nan;0;0
12178;78251;711;57;17;2;15;.882;3626000;0
12178;145733;711;0;0;0;0;.00nan;0;0
12180;-1;2465;72;27;3;24;.889;3726000;0
12180;-1;706;0;0;0;0;.00nan;0;0
12180;72229;706;87;43;4;39;.907;3726000;0
12180;145838;2465;0;0;0;0;.00nan;0;0
12182;170548;712;57;6;0;6;1.000;1004000;0
12182;26308;710;27;31;6;25;.806;3600000;0
12182;176206;710;0;0;0;0;.00nan;0;0
12182;160866;712;22;45;9;36;.800;2596000;0
12184;-1;2473;0;0;0;0;.00nan;0;0
12184;-1;2473;74;43;4;39;.907;3573000;0
12184;78251;711;0;0;0;0;.00nan;0;0
12184;145733;711;47;12;2;10;.833;3600000;0
12186;-1;2465;0;0;0;0;.00nan;0;0
12186;-1;706;67;43;4;39;.907;3556000;0
12186;72229;706;0;0;0;0;.00nan;0;0
12186;145838;2465;67;24;2;22;.917;3600000;0
12188;183265;2471;33;35;6;29;.829;3290000;0
12188;166044;2471;52;10;1;9;.900;458000;0
12188;181748;714;0;0;0;0;.00nan;0;0
12188;145787;714;28;27;6;21;.778;3775000;0
12190;-1;713;74;8;0;8;1.000;3600000;0
12190;145636;2474;67;39;4;35;.897;3600000;0
12190;145843;713;0;0;0;0;.00nan;0;0
12190;146001;2474;0;0;0;0;.00nan;0;0
12192;-1;2473;100;41;1;40;.976;3600000;0
12192;26308;710;0;0;0;0;.00nan;0;0
12192;176206;710;67;29;3;26;.897;3516000;0
12192;-1;2473;0;0;0;0;.00nan;0;0
12194;170548;712;71;41;4;37;.902;3600000;0
12194;78251;711;76;18;1;17;.944;3600000;0
12194;145733;711;0;0;0;0;.00nan;0;0
12194;160866;712;0;0;0;0;.00nan;0;0
12196;181748;714;66;25;2;23;.920;3600000;0
12196;145636;2474;0;0;0;0;.00nan;0;0
12196;145787;714;0;0;0;0;.00nan;0;0
12196;146001;2474;77;56;5;51;.911;3600000;0
12198;183265;2471;0;0;0;0;.00nan;0;0
12198;166044;2471;80;29;2;27;.931;3600000;0
12198;-1;706;0;0;0;0;.00nan;0;0
12198;72229;706;51;26;3;23;.885;3558000;0
12200;-1;713;52;16;2;14;.875;3600000;0
12200;-1;2465;83;41;3;38;.927;3570000;0
12200;145838;2465;0;0;0;0;.00nan;0;0
12200;145843;713;0;0;0;0;.00nan;0;0
12202;-1;2473;0;0;0;0;.00nan;0;0
12202;-1;2473;50;18;3;15;.833;3600000;0
12202;145636;2474;62;39;4;35;.897;3597000;0
12202;146001;2474;0;0;0;0;.00nan;0;0
12204;170548;712;0;0;0;0;.00nan;0;0
12204;78251;711;0;0;0;0;.00nan;0;0
12204;145733;711;97;16;0;16;1.000;3600000;0
12204;160866;712;66;49;5;44;.898;3600000;0
12206;-1;713;0;0;0;0;.00nan;0;0
12206;181748;714;51;2;0;2;1.000;353000;0
12206;145787;714;18;20;6;14;.700;3247000;0
12206;145843;713;85;35;2;33;.943;3600000;0
12208;183265;2471;85;36;3;33;.917;3552000;0
12208;166044;2471;0;0;0;0;.00nan;0;0
12208;-1;706;88;40;2;38;.950;3600000;0
12208;72229;706;0;0;0;0;.00nan;0;0
12210;26308;710;78;9;0;9;1.000;3600000;0
12210;176206;710;0;0;0;0;.00nan;0;0
12210;-1;2465;55;4;0;4;1.000;418000;0
12210;145838;2465;65;55;6;49;.891;3182000;0
12212;26308;710;76;38;3;35;.921;3900000;0
12212;176206;710;0;0;0;0;.00nan;0;0
12212;181748;714;74;40;3;37;.925;3900000;0
12212;145787;714;0;0;0;0;.00nan;0;0
12214;-1;713;57;19;2;17;.895;3600000;0
12214;-1;2473;86;47;3;44;.936;3594000;0
12214;-1;2473;0;0;0;0;.00nan;0;0
12214;145843;713;0;0;0;0;.00nan;0;0
12216;170548;712;59;34;4;30;.882;3583000;0
12216;-1;2465;63;27;3;24;.889;3600000;0
12216;145838;2465;0;0;0;0;.00nan;0;0
12216;160866;712;0;0;0;0;.00nan;0;0
12218;183265;2471;0;0;0;0;.00nan;0;0
12218;166044;2471;43;12;2;10;.833;3600000;0
12218;145636;2474;0;0;0;0;.00nan;0;0
12218;146001;2474;56;36;4;32;.889;3591000;0
12220;-1;706;0;0;0;0;.00nan;0;0
12220;72229;706;90;53;3;50;.943;3600000;0
12220;78251;711;43;9;2;7;.778;3600000;0
12220;145733;711;0;0;0;0;.00nan;0;0
12222;-1;2473;0;0;0;0;.00nan;0;0
12222;-1;2473;62;13;1;12;.923;3600000;0
12222;-1;706;92;51;4;47;.922;3600000;0
12222;72229;706;0;0;0;0;.00nan;0;0
12224;183265;2471;75;26;1;25;.962;3899000;0
12224;166044;2471;0;0;0;0;.00nan;0;0
12224;26308;710;0;0;0;0;.00nan;0;0
12224;176206;710;85;25;1;24;.960;3900000;0
12226;-1;2465;0;0;0;0;.00nan;0;0
12226;78251;711;0;0;0;0;.00nan;0;0
12226;145733;711;77;11;0;11;1.000;3600000;0
12226;145838;2465;97;34;1;33;.971;3600000;0
12228;170548;712;0;0;0;0;.00nan;0;0
12228;181748;714;0;0;0;0;.00nan;0;0
12228;145787;714;56;22;2;20;.909;3732000;0
12228;160866;712;53;21;3;18;.857;3732000;0
12230;-1;713;0;0;0;0;.00nan;0;0
12230;145636;2474;80;44;4;40;.909;3600000;0
12230;145843;713;65;15;1;14;.933;3600000;0
12230;146001;2474;0;0;0;0;.00nan;0;0
1241;78251;711;88;18;0;18;1.000;3600000;0
1241;145636;2474;81;45;3;42;.933;3600000;0
1241;145733;711;0;0;0;0;.00nan;0;0
1241;146001;2474;0;0;0;0;.00nan;0;0
1242;-1;2473;56;36;4;32;.889;3600000;0
1242;26308;710;0;0;0;0;.00nan;0;0
1242;176206;710;96;35;1;34;.971;3600000;0
1242;-1;2473;0;0;0;0;.00nan;0;0
1243;-1;713;47;11;2;9;.818;3600000;0
1243;-1;2465;35;36;7;29;.806;3600000;0
1243;145838;2465;0;0;0;0;.00nan;0;0
1243;145843;713;0;0;0;0;.00nan;0;0
1244;170548;712;93;49;3;46;.939;3800000;0
1244;181748;714;33;14;4;10;.714;3800000;0
1244;145787;714;0;0;0;0;.00nan;0;0
1244;160866;712;0;0;0;0;.00nan;0;0
1245;78251;711;88;15;0;15;1.000;3600000;0
1245;145636;2474;83;46;4;42;.913;3600000;0
1245;145733;711;0;0;0;0;.00nan;0;0
1245;146001;2474;0;0;0;0;.00nan;0;0
1246;-1;2473;69;30;3;27;.900;3547000;0
1246;26308;710;0;0;0;0;.00nan;0;0
1246;176206;710;82;23;1;22;.957;3600000;0
1246;-1;2473;0;0;0;0;.00nan;0;0
1247;-1;713;100;24;0;24;1.000;3600000;0
1247;-1;2465;43;37;6;31;.838;3600000;0
1247;145838;2465;0;0;0;0;.00nan;0;0
1247;145843;713;0;0;0;0;.00nan;0;0
1248;170548;712;89;31;1;30;.968;4002000;0
1248;181748;714;98;26;0;26;1.000;4002000;0
1248;145787;714;0;0;0;0;.00nan;0;0
1248;160866;712;0;0;0;0;.00nan;0;0
1249;78251;711;67;23;1;22;.957;3600000;0
1249;145636;2474;84;55;5;50;.909;3600000;0
1249;145733;711;0;0;0;0;.00nan;0;0
1249;146001;2474;0;0;0;0;.00nan;0;0
1250;-1;2473;93;54;3;51;.944;3600000;0
1250;26308;710;0;0;0;0;.00nan;0;0
1250;176206;710;42;24;4;20;.833;3543000;0
1250;-1;2473;0;0;0;0;.00nan;0;0
1251;-1;713;45;33;5;28;.848;3600000;0
1251;-1;2465;100;42;1;41;.976;3600000;0
1251;145838;2465;0;0;0;0;.00nan;0;0
1251;145843;713;0;0;0;0;.00nan;0;0
1252;170548;712;94;34;1;33;.971;3600000;0
1252;181748;714;96;24;0;24;1.000;3600000;0
1252;145787;714;0;0;0;0;.00nan;0;0
1252;160866;712;0;0;0;0;.00nan;0;0
1253;78251;711;59;13;1;12;.923;3600000;0
1253;145636;2474;74;46;4;42;.913;3600000;0
1253;145733;711;0;0;0;0;.00nan;0;0
1253;146001;2474;0;0;0;0;.00nan;0;0
1254;-1;2473;100;44;0;44;1.000;3600000;0
1254;26308;710;0;0;0;0;.00nan;0;0
1254;176206;710;44;14;2;12;.857;3539000;0
1254;-1;2473;0;0;0;0;.00nan;0;0
1255;-1;713;83;26;1;25;.962;3600000;0
1255;-1;2465;47;39;6;33;.846;3600000;0
1255;145838;2465;0;0;0;0;.00nan;0;0
1255;145843;713;0;0;0;0;.00nan;0;0
1256;170548;712;97;40;1;39;.975;3595000;0
1256;181748;714;96;25;0;25;1.000;3600000;0
1256;145787;714;0;0;0;0;.00nan;0;0
1256;160866;712;0;0;0;0;.00nan;0;0
1537;-1;2473;81;50;4;46;.920;3600000;0
1537;26308;710;0;0;0;0;.00nan;0;0
1537;176206;710;91;17;0;17;1.000;3600000;0
1537;-1;2473;0;0;0;0;.00nan;0;0
1538;-1;713;62;22;2;20;.909;3543000;0
1538;-1;2465;68;20;1;19;.950;3600000;0
1538;145838;2465;0;0;0;0;.00nan;0;0
1538;145843;713;0;0;0;0;.00nan;0;0
1539;170548;712;29;26;5;21;.808;3600000;0
1539;181748;714;62;17;2;15;.882;3600000;0
1539;145787;714;0;0;0;0;.00nan;0;0
1539;160866;712;0;0;0;0;.00nan;0;0
1576;-1;2473;87;35;1;34;.971;3600000;0
1576;26308;710;0;0;0;0;.00nan;0;0
1576;176206;710;55;21;2;19;.905;3600000;0
1576;-1;2473;0;0;0;0;.00nan;0;0
1577;-1;713;91;19;0;19;1.000;3600000;0
1577;-1;2465;87;35;1;34;.971;3600000;0
1577;145838;2465;0;0;0;0;.00nan;0;0
1577;145843;713;0;0;0;0;.00nan;0;0
1628;-1;2473;58;36;4;32;.889;3600000;0
1628;26308;710;0;0;0;0;.00nan;0;0
1628;176206;710;100;30;0;30;1.000;3600000;0
1628;-1;2473;0;0;0;0;.00nan;0;0
1763;181748;714;89;42;3;39;.929;3600000;0
1763;78251;711;100;30;0;30;1.000;3600000;0
1763;145733;711;0;0;0;0;.00nan;0;0
1763;145787;714;0;0;0;0;.00nan;0;0
1764;-1;713;89;48;3;45;.938;4747000;0
1764;26308;710;0;0;0;0;.00nan;0;0
1764;176206;710;84;43;4;39;.907;4747000;0
1764;145843;713;0;0;0;0;.00nan;0;0
1765;181748;714;84;50;4;46;.920;5064000;0
1765;78251;711;65;33;3;30;.909;5064000;0
1765;145733;711;0;0;0;0;.00nan;0;0
1765;145787;714;0;0;0;0;.00nan;0;0
1766;-1;713;56;30;4;26;.867;3600000;0
1766;26308;710;62;15;1;14;.933;1713000;0
1766;176206;710;36;18;4;14;.778;1832000;0
1766;145843;713;0;0;0;0;.00nan;0;0
1767;181748;714;72;28;2;26;.929;4013000;0
1767;78251;711;72;38;3;35;.921;4013000;0
1767;145733;711;0;0;0;0;.00nan;0;0
1767;145787;714;0;0;0;0;.00nan;0;0
1768;-1;713;63;25;3;22;.880;3600000;0
1768;26308;710;0;0;0;0;.00nan;0;0
1768;176206;710;35;28;6;22;.786;3600000;0
1768;145843;713;0;0;0;0;.00nan;0;0
1769;181748;714;60;28;4;24;.857;3600000;0
1769;78251;711;25;13;4;9;.692;741000;0
1769;145733;711;50;15;2;13;.867;2800000;0
1769;145787;714;0;0;0;0;.00nan;0;0
1770;-1;713;73;26;1;25;.962;3542000;0
1770;26308;710;0;0;0;0;.00nan;0;0
1770;176206;710;94;19;0;19;1.000;3600000;0
1770;145843;713;0;0;0;0;.00nan;0;0
1917;181748;714;25;7;3;4;.571;540000;0
1917;78251;711;61;22;3;19;.864;3600000;0
1917;145733;711;0;0;0;0;.00nan;0;0
1917;145787;714;30;29;6;23;.793;3060000;0
1918;-1;713;91;42;2;40;.952;3600000;0
1918;26308;710;0;0;0;0;.00nan;0;0
1918;176206;710;74;20;1;19;.950;3600000;0
1918;145843;713;0;0;0;0;.00nan;0;0
1976;181748;714;98;40;1;39;.975;3600000;0
1976;78251;711;41;18;4;14;.778;3600000;0
1976;145733;711;0;0;0;0;.00nan;0;0
1976;145787;714;0;0;0;0;.00nan;0;0
1977;-1;713;90;29;1;28;.966;3600000;0
1977;26308;710;0;0;0;0;.00nan;0;0
1977;176206;710;39;29;5;24;.828;3600000;0
1977;145843;713;0;0;0;0;.00nan;0;0
2001;181748;714;82;28;1;27;.964;3600000;0
2001;78251;711;28;20;5;15;.750;3600000;0
2001;145733;711;0;0;0;0;.00nan;0;0
2001;145787;714;0;0;0;0;.00nan;0;0
2030;-1;713;68;27;2;25;.926;4816000;0
2030;181748;714;87;45;3;42;.933;4816000;0
2030;145787;714;0;0;0;0;.00nan;0;0
2030;145843;713;0;0;0;0;.00nan;0;0
2031;-1;713;64;22;2;20;.909;3600000;0
2031;181748;714;37;45;7;38;.844;3340000;0
2031;145787;714;34;5;2;3;.600;260000;0
2031;145843;713;0;0;0;0;.00nan;0;0
2032;-1;713;46;21;3;18;.857;3590000;0
2032;181748;714;74;21;1;20;.952;3600000;0
2032;145787;714;0;0;0;0;.00nan;0;0
2032;145843;713;0;0;0;0;.00nan;0;0
2033;-1;713;63;33;3;30;.909;4508000;0
2033;181748;714;88;41;2;39;.951;4508000;0
2033;145787;714;0;0;0;0;.00nan;0;0
2033;145843;713;0;0;0;0;.00nan;0;0
2273;-1;713;70;29;3;26;.897;3584000;0
2273;181748;714;69;25;2;23;.920;3600000;0
2273;145787;714;0;0;0;0;.00nan;0;0
2273;145843;713;0;0;0;0;.00nan;0;0
2322;-1;713;68;23;2;21;.913;3600000;0
2322;181748;714;40;26;5;21;.808;3600000;0
2322;145787;714;0;0;0;0;.00nan;0;0
2322;145843;713;0;0;0;0;.00nan;0;0
2393;-1;713;88;29;1;28;.966;3600000;0
2393;181748;714;53;25;3;22;.880;3570000;0
2393;145787;714;0;0;0;0;.00nan;0;0
2393;145843;713;0;0;0;0;.00nan;0;0
12231;66457;4644;0;0;0;0;.00nan;0;0
12231;156221;620;0;0;0;0;.00nan;0;0
12231;156254;4644;94;61;4;57;.934;3978000;0
12231;156298;620;43;16;3;13;.813;3978000;0
12232;168021;619;0;0;0;0;.00nan;0;0
12232;175651;2319;71;26;2;24;.923;3557000;0
12232;73699;2319;0;0;0;0;.00nan;0;0
12232;90734;619;82;21;1;20;.952;3600000;0
12233;192776;611;58;25;3;22;.880;3600000;0
12233;-1;2167;87;52;4;48;.923;3551000;0
12233;-1;2167;0;0;0;0;.00nan;0;0
12233;95925;611;0;0;0;0;.00nan;0;0
12234;188070;614;0;0;0;0;.00nan;0;0
12234;171190;614;76;32;2;30;.938;3600000;0
12234;84525;2308;54;28;4;24;.857;3543000;0
12234;144421;2308;0;0;0;0;.00nan;0;0
12235;178911;2310;83;34;2;32;.941;3600000;0
12235;179350;2310;0;0;0;0;.00nan;0;0
12235;186520;617;66;34;3;31;.912;3545000;0
12235;202587;617;0;0;0;0;.00nan;0;0
12236;178911;2310;0;0;0;0;.00nan;0;0
12236;179350;2310;67;33;3;30;.909;4200000;0
12236;156221;620;0;0;0;0;.00nan;0;0
12236;156298;620;67;36;3;33;.917;4199000;0
12237;2140;622;0;0;0;0;.00nan;0;0
12237;-1;2167;76;51;4;47;.922;4044000;0
12237;-1;2167;0;0;0;0;.00nan;0;0
12237;143036;622;53;24;3;21;.875;4044000;0
12238;188070;614;0;0;0;0;.00nan;0;0
12238;171190;614;94;37;1;36;.973;3600000;0
12238;144410;612;0;0;0;0;.00nan;0;0
12238;156322;612;51;22;3;19;.864;3576000;0
12239;192776;611;81;35;2;33;.943;4200000;0
12239;66457;4644;0;0;0;0;.00nan;0;0
12239;95925;611;0;0;0;0;.00nan;0;0
12239;156254;4644;100;46;2;44;.957;4200000;0
12240;168021;619;58;35;5;30;.857;3563000;0
12240;84525;2308;50;26;4;22;.846;3600000;0
12240;90734;619;0;0;0;0;.00nan;0;0
12240;144421;2308;0;0;0;0;.00nan;0;0
12241;175651;2319;55;36;5;31;.861;3600000;0
12241;186520;617;63;29;4;25;.862;3600000;0
12241;202587;617;0;0;0;0;.00nan;0;0
12241;73699;2319;0;0;0;0;.00nan;0;0
12242;-1;2167;42;22;4;18;.818;3600000;0
12242;-1;2167;0;0;0;0;.00nan;0;0
12242;66457;4644;0;0;0;0;.00nan;0;0
12242;156254;4644;38;23;5;18;.783;3600000;0
12243;175651;2319;58;31;4;27;.871;3569000;0
12243;73699;2319;0;0;0;0;.00nan;0;0
12243;156221;620;0;0;0;0;.00nan;0;0
12243;156298;620;71;24;2;22;.917;3600000;0
12244;168021;619;79;25;1;24;.960;3600000;0
12244;90734;619;0;0;0;0;.00nan;0;0
12244;144410;612;0;0;0;0;.00nan;0;0
12244;156322;612;72;28;2;26;.929;3544000;0
12245;192776;611;86;32;2;30;.938;3577000;0
12245;178911;2310;0;0;0;0;.00nan;0;0
12245;179350;2310;88;30;1;29;.967;3600000;0
12245;95925;611;0;0;0;0;.00nan;0;0
12246;186520;617;92;37;2;35;.946;3600000;0
12246;202587;617;0;0;0;0;.00nan;0;0
12246;84525;2308;63;32;3;29;.906;3590000;0
12246;144421;2308;0;0;0;0;.00nan;0;0
12247;2140;622;0;0;0;0;.00nan;0;0
12247;188070;614;0;0;0;0;.00nan;0;0
12247;171190;614;54;30;4;26;.867;3571000;0
12247;143036;622;75;35;3;32;.914;3600000;0
12248;2140;622;0;0;0;0;.00nan;0;0
12248;143036;622;66;30;3;27;.900;3991000;0
12248;144410;612;0;0;0;0;.00nan;0;0
12248;156322;612;87;42;4;38;.905;3991000;0
12249;178911;2310;0;0;0;0;.00nan;0;0
12249;179350;2310;53;15;2;13;.867;3600000;0
12249;-1;2167;38;39;7;32;.821;3600000;0
12249;-1;2167;0;0;0;0;.00nan;0;0
12250;186520;617;77;25;1;24;.960;3600000;0
12250;202587;617;0;0;0;0;.00nan;0;0
12250;144410;612;0;0;0;0;.00nan;0;0
12250;156322;612;64;33;3;30;.909;3537000;0
12251;2140;622;0;0;0;0;.00nan;0;0
12251;66457;4644;48;0;0;0;.00nan;424000;0
12251;143036;622;76;22;1;21;.955;3600000;0
12251;156254;4644;19;25;6;19;.760;3176000;0
12252;84525;2308;0;0;0;0;.00nan;0;0
12252;144421;2308;43;39;5;34;.872;3600000;0
12252;156221;620;0;0;0;0;.00nan;0;0
12252;156298;620;54;28;4;24;.857;3600000;0
12253;192776;611;86;39;2;37;.949;3557000;0
12253;175651;2319;0;0;0;0;.00nan;0;0
12253;73699;2319;96;35;1;34;.971;3600000;0
12253;95925;611;0;0;0;0;.00nan;0;0
12254;188070;614;72;32;3;29;.906;3600000;0
12254;168021;619;75;13;0;13;1.000;3600000;0
12254;171190;614;0;0;0;0;.00nan;0;0
12254;90734;619;0;0;0;0;.00nan;0;0
12255;175651;2319;71;30;2;28;.933;3600000;0
12255;-1;2167;0;0;0;0;.00nan;0;0
12255;-1;2167;71;39;4;35;.897;3536000;0
12255;73699;2319;0;0;0;0;.00nan;0;0
12256;144410;612;0;0;0;0;.00nan;0;0
12256;156221;620;0;0;0;0;.00nan;0;0
12256;156298;620;62;26;2;24;.923;3762000;0
12256;156322;612;92;34;1;33;.971;3762000;0
12257;178911;2310;0;0;0;0;.00nan;0;0
12257;179350;2310;75;21;1;20;.952;3600000;0
12257;66457;4644;0;0;0;0;.00nan;0;0
12257;156254;4644;64;31;3;28;.903;3600000;0
12258;192776;611;61;31;5;26;.839;3968000;0
12258;84525;2308;63;54;6;48;.889;3968000;0
12258;95925;611;0;0;0;0;.00nan;0;0
12258;144421;2308;0;0;0;0;.00nan;0;0
12259;188070;614;0;0;0;0;.00nan;0;0
12259;171190;614;76;40;3;37;.925;3722000;0
12259;186520;617;74;23;2;21;.913;3723000;0
12259;202587;617;0;0;0;0;.00nan;0;0
12260;2140;622;0;0;0;0;.00nan;0;0
12260;168021;619;89;22;1;21;.955;3600000;0
12260;90734;619;0;0;0;0;.00nan;0;0
12260;143036;622;67;34;3;31;.912;3550000;0
12261;2140;622;0;0;0;0;.00nan;0;0
12261;178911;2310;64;40;5;35;.875;3600000;0
12261;179350;2310;0;0;0;0;.00nan;0;0
12261;143036;622;69;16;1;15;.938;3600000;0
12262;192776;611;68;22;1;21;.955;3600000;0
12262;95925;611;0;0;0;0;.00nan;0;0
12262;144410;612;0;0;0;0;.00nan;0;0
12262;156322;612;64;26;2;24;.923;3600000;0
12263;168021;619;63;21;2;19;.905;3600000;0
12263;186520;617;48;25;4;21;.840;3583000;0
12263;202587;617;0;0;0;0;.00nan;0;0
12263;90734;619;0;0;0;0;.00nan;0;0
12264;-1;2167;59;32;3;29;.906;3571000;0
12264;-1;2167;0;0;0;0;.00nan;0;0
12264;84525;2308;0;0;0;0;.00nan;0;0
12264;144421;2308;75;27;2;25;.926;3600000;0
12265;175651;2319;56;20;3;17;.850;3600000;0
12265;66457;4644;0;0;0;0;.00nan;0;0
12265;73699;2319;0;0;0;0;.00nan;0;0
12265;156254;4644;69;39;4;35;.897;3583000;0
12266;188070;614;0;0;0;0;.00nan;0;0
12266;171190;614;99;38;1;37;.974;3600000;0
12266;156221;620;0;0;0;0;.00nan;0;0
12266;156298;620;59;21;2;19;.905;3563000;0
12267;-1;2167;81;38;3;35;.921;3575000;0
12267;-1;2167;0;0;0;0;.00nan;0;0
12267;144410;612;0;0;0;0;.00nan;0;0
12267;156322;612;59;16;2;14;.875;3600000;0
12268;168021;619;57;37;4;33;.892;3600000;0
12268;90734;619;0;0;0;0;.00nan;0;0
12268;156221;620;0;0;0;0;.00nan;0;0
12268;156298;620;51;34;5;29;.853;3543000;0
12269;66457;4644;55;30;3;27;.900;3600000;0
12269;84525;2308;86;33;1;32;.970;3600000;0
12269;144421;2308;0;0;0;0;.00nan;0;0
12269;156254;4644;0;0;0;0;.00nan;0;0
12270;192776;611;65;23;2;21;.913;3600000;0
12270;188070;614;41;35;7;28;.800;3069000;0
12270;171190;614;27;8;3;5;.625;531000;0
12270;95925;611;0;0;0;0;.00nan;0;0
12271;2140;622;0;0;0;0;.00nan;0;0
12271;186520;617;44;37;6;31;.838;3600000;0
12271;202587;617;0;0;0;0;.00nan;0;0
12271;143036;622;62;24;3;21;.875;3600000;0
12272;66457;4644;52;10;1;9;.900;366000;0
12272;144410;612;75;22;1;21;.955;3600000;0
12272;156254;4644;50;40;6;34;.850;3234000;0
12272;156322;612;0;0;0;0;.00nan;0;0
12273;192776;611;59;35;4;31;.886;3600000;0
12273;168021;619;79;27;1;26;.963;3600000;0
12273;90734;619;0;0;0;0;.00nan;0;0
12273;95925;611;0;0;0;0;.00nan;0;0
12274;178911;2310;53;19;3;16;.842;3623000;0
12274;179350;2310;0;0;0;0;.00nan;0;0
12274;84525;2308;0;0;0;0;.00nan;0;0
12274;144421;2308;75;48;4;44;.917;3623000;0
12275;2140;622;0;0;0;0;.00nan;0;0
12275;175651;2319;54;34;5;29;.853;3513000;0
12275;73699;2319;0;0;0;0;.00nan;0;0
12275;143036;622;70;31;3;28;.903;3600000;0
12276;188070;614;91;31;1;30;.968;3600000;0
12276;171190;614;0;0;0;0;.00nan;0;0
12276;-1;2167;60;35;5;30;.857;3600000;0
12276;-1;2167;0;0;0;0;.00nan;0;0
12277;186520;617;62;40;5;35;.875;4200000;0
12277;202587;617;0;0;0;0;.00nan;0;0
12277;156221;620;0;0;0;0;.00nan;0;0
12277;156298;620;69;47;5;42;.894;4200000;0
12278;178911;2310;0;0;0;0;.00nan;0;0
12278;179350;2310;100;29;0;29;1.000;3600000;0
12278;144410;612;0;0;0;0;.00nan;0;0
12278;156322;612;35;26;5;21;.808;3600000;0
12279;168021;619;33;18;4;14;.778;3600000;0
12279;-1;2167;28;27;6;21;.778;1843000;0
12279;-1;2167;39;9;2;7;.778;1757000;0
12279;90734;619;0;0;0;0;.00nan;0;0
12280;188070;614;97;41;1;40;.976;3600000;0
12280;171190;614;0;0;0;0;.00nan;0;0
12280;66457;4644;0;0;0;0;.00nan;0;0
12280;156254;4644;62;36;4;32;.889;3600000;0
12281;192776;611;71;35;3;32;.914;3570000;0
12281;186520;617;89;29;1;28;.966;3600000;0
12281;202587;617;0;0;0;0;.00nan;0;0
12281;95925;611;0;0;0;0;.00nan;0;0
12282;175651;2319;80;33;2;31;.939;3578000;0
12282;73699;2319;0;0;0;0;.00nan;0;0
12282;84525;2308;62;16;1;15;.938;3600000;0
12282;144421;2308;0;0;0;0;.00nan;0;0
12283;2140;622;0;0;0;0;.00nan;0;0
12283;143036;622;75;30;2;28;.933;3600000;0
12283;156221;620;0;0;0;0;.00nan;0;0
12283;156298;620;55;26;4;22;.846;3535000;0
12284;192776;611;88;31;2;29;.935;4200000;0
12284;95925;611;0;0;0;0;.00nan;0;0
12284;156221;620;0;0;0;0;.00nan;0;0
12284;156298;620;76;40;2;38;.950;4200000;0
12285;175651;2319;77;34;2;32;.941;3600000;0
12285;73699;2319;0;0;0;0;.00nan;0;0
12285;144410;612;0;0;0;0;.00nan;0;0
12285;156322;612;57;28;3;25;.893;3549000;0
12286;168021;619;61;12;1;11;.917;3600000;0
12286;66457;4644;0;0;0;0;.00nan;0;0
12286;90734;619;0;0;0;0;.00nan;0;0
12286;156254;4644;87;37;2;35;.946;3600000;0
12287;188070;614;93;48;2;46;.958;4200000;0
12287;178911;2310;0;0;0;0;.00nan;0;0
12287;171190;614;0;0;0;0;.00nan;0;0
12287;179350;2310;79;33;2;31;.939;4200000;0
12288;186520;617;55;25;4;21;.840;3600000;0
12288;202587;617;0;0;0;0;.00nan;0;0
12288;-1;2167;65;49;6;43;.878;3559000;0
12288;-1;2167;0;0;0;0;.00nan;0;0
12289;168021;619;32;23;5;18;.783;3600000;0
12289;178911;2310;0;0;0;0;.00nan;0;0
12289;179350;2310;90;33;1;32;.970;3600000;0
12289;90734;619;0;0;0;0;.00nan;0;0
12290;-1;2167;0;0;0;0;.00nan;0;0
12290;-1;2167;68;46;5;41;.891;3600000;0
12290;156221;620;0;0;0;0;.00nan;0;0
12290;156298;620;67;18;2;16;.889;3600000;0
12291;186520;617;58;26;3;23;.885;3600000;0
12291;202587;617;0;0;0;0;.00nan;0;0
12291;66457;4644;0;0;0;0;.00nan;0;0
12291;156254;4644;56;33;4;29;.879;3561000;0
12292;84525;2308;44;4;1;3;.750;477000;0
12292;144410;612;0;0;0;0;.00nan;0;0
12292;144421;2308;33;34;6;28;.824;3123000;0
12292;156322;612;52;30;4;26;.867;3600000;0
12293;188070;614;0;0;0;0;.00nan;0;0
12293;171190;614;71;33;3;30;.909;3600000;0
12293;175651;2319;77;35;2;33;.943;3600000;0
12293;73699;2319;0;0;0;0;.00nan;0;0
12294;192776;611;96;44;1;43;.977;3600000;0
12294;2140;622;52;27;4;23;.852;3600000;0
12294;95925;611;0;0;0;0;.00nan;0;0
12294;143036;622;0;0;0;0;.00nan;0;0
12295;-1;2167;53;48;6;42;.875;3037000;0
12295;-1;2167;47;5;1;4;.800;563000;0
12295;156221;620;0;0;0;0;.00nan;0;0
12295;156298;620;22;21;6;15;.714;3600000;0
12296;84525;2308;71;33;2;31;.939;3600000;0
12296;144410;612;0;0;0;0;.00nan;0;0
12296;144421;2308;0;0;0;0;.00nan;0;0
12296;156322;612;27;19;5;14;.737;3600000;0
12297;168021;619;0;0;0;0;.00nan;0;0
12297;178911;2310;0;0;0;0;.00nan;0;0
12297;179350;2310;92;34;1;33;.971;3600000;0
12297;90734;619;100;26;0;26;1.000;3600000;0
12298;188070;614;71;35;4;31;.886;3632000;0
12298;171190;614;0;0;0;0;.00nan;0;0
12298;175651;2319;58;24;3;21;.875;3632000;0
12298;73699;2319;0;0;0;0;.00nan;0;0
12299;186520;617;100;27;0;27;1.000;3600000;0
12299;202587;617;0;0;0;0;.00nan;0;0
12299;66457;4644;0;0;0;0;.00nan;0;0
12299;156254;4644;65;47;5;42;.894;3600000;0
12300;188070;614;33;41;7;34;.829;3267000;0
12300;178911;2310;0;0;0;0;.00nan;0;0
12300;171190;614;46;6;1;5;.833;333000;0
12300;179350;2310;82;26;1;25;.962;3600000;0
12301;186520;617;87;34;2;32;.941;3630000;0
12301;202587;617;0;0;0;0;.00nan;0;0
12301;-1;2167;0;0;0;0;.00nan;0;0
12301;-1;2167;77;29;1;28;.966;3630000;0
12302;168021;619;0;0;0;0;.00nan;0;0
12302;66457;4644;0;0;0;0;.00nan;0;0
12302;90734;619;58;20;2;18;.900;3600000;0
12302;156254;4644;60;33;4;29;.879;3545000;0
12303;192776;611;48;27;4;23;.852;3934000;0
12303;95925;611;0;0;0;0;.00nan;0;0
12303;156221;620;0;0;0;0;.00nan;0;0
12303;156298;620;45;28;5;23;.821;3934000;0
12304;175651;2319;0;0;0;0;.00nan;0;0
12304;73699;2319;76;23;1;22;.957;3600000;0
12304;144410;612;0;0;0;0;.00nan;0;0
12304;156322;612;63;26;2;24;.923;3544000;0
12305;2140;622;0;0;0;0;.00nan;0;0
12305;84525;2308;77;49;4;45;.918;3585000;0
12305;143036;622;67;21;2;19;.905;3600000;0
12305;144421;2308;0;0;0;0;.00nan;0;0
12306;2140;622;0;0;0;0;.00nan;0;0
12306;84525;2308;0;0;0;0;.00nan;0;0
12306;143036;622;62;21;2;19;.905;3600000;0
12306;144421;2308;73;47;5;42;.894;3600000;0
12307;2140;622;0;0;0;0;.00nan;0;0
12307;143036;622;100;40;2;38;.950;3600000;0
12307;156221;620;0;0;0;0;.00nan;0;0
12307;156298;620;72;43;4;39;.907;3572000;0
12308;178911;2310;67;34;3;31;.912;3838000;0
12308;179350;2310;0;0;0;0;.00nan;0;0
12308;144410;612;0;0;0;0;.00nan;0;0
12308;156322;612;50;29;4;25;.862;3838000;0
12309;168021;619;0;0;0;0;.00nan;0;0
12309;-1;2167;54;35;4;31;.886;3577000;0
12309;-1;2167;0;0;0;0;.00nan;0;0
12309;90734;619;82;35;3;32;.914;3600000;0
12310;175651;2319;88;32;2;30;.938;3600000;0
12310;73699;2319;0;0;0;0;.00nan;0;0
12310;84525;2308;46;23;3;20;.870;3559000;0
12310;144421;2308;0;0;0;0;.00nan;0;0
12311;188070;614;0;0;0;0;.00nan;0;0
12311;171190;614;59;32;4;28;.875;3631000;0
12311;66457;4644;0;0;0;0;.00nan;0;0
12311;156254;4644;62;26;3;23;.885;3631000;0
12312;192776;611;77;20;1;19;.950;3600000;0
12312;186520;617;0;0;0;0;.00nan;0;0
12312;202587;617;54;33;4;29;.879;3600000;0
12312;95925;611;0;0;0;0;.00nan;0;0
12313;178911;2310;0;0;0;0;.00nan;0;0
12313;179350;2310;57;32;4;28;.875;3600000;0
12313;84525;2308;0;0;0;0;.00nan;0;0
12313;144421;2308;83;31;1;30;.968;3600000;0
12314;186520;617;76;44;4;40;.909;4200000;0
12314;202587;617;0;0;0;0;.00nan;0;0
12314;156221;620;50;30;4;26;.867;4200000;0
12314;156298;620;0;0;0;0;.00nan;0;0
12315;66457;4644;0;0;0;0;.00nan;0;0
12315;144410;612;0;0;0;0;.00nan;0;0
12315;156254;4644;82;29;2;27;.931;3514000;0
12315;156322;612;100;29;0;29;1.000;3600000;0
12316;192776;611;79;28;2;26;.929;3538000;0
12316;168021;619;0;0;0;0;.00nan;0;0
12316;90734;619;89;20;0;20;1.000;3600000;0
12316;95925;611;0;0;0;0;.00nan;0;0
12317;2140;622;0;0;0;0;.00nan;0;0
12317;175651;2319;60;51;6;45;.882;3600000;0
12317;73699;2319;0;0;0;0;.00nan;0;0
12317;143036;622;67;23;2;21;.913;3600000;0
12318;-1;2167;21;12;4;8;.667;1159000;0
12318;-1;2167;86;35;1;34;.971;2441000;0
12318;144410;612;0;0;0;0;.00nan;0;0
12318;156322;612;81;29;1;28;.966;3600000;0
12319;168021;619;0;0;0;0;.00nan;0;0
12319;90734;619;38;25;5;20;.800;3600000;0
12319;156221;620;0;0;0;0;.00nan;0;0
12319;156298;620;62;27;3;24;.889;3600000;0
12320;66457;4644;25;27;6;21;.778;1655000;0
12320;84525;2308;0;0;0;0;.00nan;0;0
12320;144421;2308;75;21;1;20;.952;3600000;0
12320;156254;4644;34;31;5;26;.839;1945000;0
12321;178911;2310;0;0;0;0;.00nan;0;0
12321;179350;2310;59;27;4;23;.852;3952000;0
12321;175651;2319;64;37;3;34;.919;3952000;0
12321;73699;2319;0;0;0;0;.00nan;0;0
12322;192776;611;84;32;2;30;.938;3600000;0
12322;188070;614;47;19;3;16;.842;1578000;0
12322;171190;614;41;24;5;19;.792;2022000;0
12322;95925;611;0;0;0;0;.00nan;0;0
12323;2140;622;0;0;0;0;.00nan;0;0
12323;186520;617;100;44;1;43;.977;3600000;0
12323;202587;617;0;0;0;0;.00nan;0;0
12323;143036;622;45;29;5;24;.828;3600000;0
12324;-1;2167;0;0;0;0;.00nan;0;0
12324;-1;2167;92;35;1;34;.971;3600000;0
12324;84525;2308;0;0;0;0;.00nan;0;0
12324;144421;2308;50;23;3;20;.870;3579000;0
12325;188070;614;40;50;7;43;.860;2854000;0
12325;171190;614;28;13;4;9;.692;746000;0
12325;156221;620;0;0;0;0;.00nan;0;0
12325;156298;620;38;19;4;15;.789;3600000;0
12326;192776;611;92;34;1;33;.971;3600000;0
12326;95925;611;0;0;0;0;.00nan;0;0
12326;144410;612;0;0;0;0;.00nan;0;0
12326;156322;612;50;23;3;20;.870;3538000;0
12327;168021;619;0;0;0;0;.00nan;0;0
12327;186520;617;99;48;2;46;.958;3600000;0
12327;202587;617;0;0;0;0;.00nan;0;0
12327;90734;619;58;26;3;23;.885;3567000;0
12328;2140;622;0;0;0;0;.00nan;0;0
12328;178911;2310;55;35;4;31;.886;2526000;0
12328;179350;2310;40;25;5;20;.800;1074000;0
12328;143036;622;68;23;2;21;.913;3600000;0
12329;188070;614;0;0;0;0;.00nan;0;0
12329;171190;614;67;45;5;40;.889;3600000;0
12329;-1;2167;0;0;0;0;.00nan;0;0
12329;-1;2167;61;22;2;20;.909;3600000;0
12330;178911;2310;59;37;5;32;.865;3565000;0
12330;179350;2310;0;0;0;0;.00nan;0;0
12330;66457;4644;0;0;0;0;.00nan;0;0
12330;156254;4644;90;54;4;50;.926;3600000;0
12331;144410;612;0;0;0;0;.00nan;0;0
12331;156221;620;0;0;0;0;.00nan;0;0
12331;156298;620;90;37;2;35;.946;3600000;0
12331;156322;612;76;34;3;31;.912;3556000;0
12332;2140;622;0;0;0;0;.00nan;0;0
12332;168021;619;0;0;0;0;.00nan;0;0
12332;90734;619;53;36;5;31;.861;3600000;0
12332;143036;622;100;28;1;27;.964;3600000;0
12333;192776;611;62;29;3;26;.897;3600000;0
12333;84525;2308;44;35;5;30;.857;3562000;0
12333;95925;611;0;0;0;0;.00nan;0;0
12333;144421;2308;0;0;0;0;.00nan;0;0
12334;175651;2319;80;23;1;22;.957;3600000;0
12334;-1;2167;0;0;0;0;.00nan;0;0
12334;-1;2167;82;49;4;45;.918;3600000;0
12334;73699;2319;0;0;0;0;.00nan;0;0
12335;188070;614;78;31;2;29;.935;3513000;0
12335;171190;614;0;0;0;0;.00nan;0;0
12335;186520;617;100;25;0;25;1.000;3600000;0
12335;202587;617;0;0;0;0;.00nan;0;0
12336;178911;2310;55;27;3;24;.889;3600000;0
12336;179350;2310;0;0;0;0;.00nan;0;0
12336;-1;2167;39;35;6;29;.829;3600000;0
12336;-1;2167;0;0;0;0;.00nan;0;0
12337;84525;2308;0;0;0;0;.00nan;0;0
12337;144421;2308;45;43;6;37;.860;3600000;0
12337;156221;620;0;0;0;0;.00nan;0;0
12337;156298;620;68;37;3;34;.919;3600000;0
12338;188070;614;0;0;0;0;.00nan;0;0
12338;168021;619;0;0;0;0;.00nan;0;0
12338;171190;614;39;39;6;33;.846;3600000;0
12338;90734;619;100;34;0;34;1.000;3600000;0
12339;192776;611;77;20;1;19;.950;3600000;0
12339;175651;2319;82;34;2;32;.941;3600000;0
12339;73699;2319;0;0;0;0;.00nan;0;0
12339;95925;611;0;0;0;0;.00nan;0;0
12340;186520;617;69;40;5;35;.875;3640000;0
12340;202587;617;0;0;0;0;.00nan;0;0
12340;144410;612;0;0;0;0;.00nan;0;0
12340;156322;612;64;33;4;29;.879;3640000;0
12341;2140;622;0;0;0;0;.00nan;0;0
12341;66457;4644;50;27;4;23;.852;1364000;0
12341;143036;622;85;25;1;24;.960;3600000;0
12341;156254;4644;23;30;6;24;.800;2236000;0
12342;192776;611;70;43;4;39;.907;3986000;0
12342;178911;2310;52;36;5;31;.861;3986000;0
12342;179350;2310;0;0;0;0;.00nan;0;0
12342;95925;611;0;0;0;0;.00nan;0;0
12343;168021;619;29;26;6;20;.769;2795000;0
12343;90734;619;50;1;0;1;1.000;775000;0
12343;144410;612;0;0;0;0;.00nan;0;0
12343;156322;612;29;16;4;12;.750;3600000;0
12344;-1;2167;0;0;0;0;.00nan;0;0
12344;-1;2167;86;32;1;31;.969;3600000;0
12344;66457;4644;54;19;2;17;.895;3585000;0
12344;156254;4644;0;0;0;0;.00nan;0;0
12345;186520;617;21;25;6;19;.760;3600000;0
12345;202587;617;0;0;0;0;.00nan;0;0
12345;84525;2308;89;35;2;33;.943;3600000;0
12345;144421;2308;0;0;0;0;.00nan;0;0
12346;175651;2319;0;0;0;0;.00nan;0;0
12346;73699;2319;88;32;1;31;.969;3600000;0
12346;156221;620;0;0;0;0;.00nan;0;0
12346;156298;620;91;17;0;17;1.000;3600000;0
12347;2140;622;0;0;0;0;.00nan;0;0
12347;188070;614;68;52;5;47;.904;3586000;0
12347;171190;614;0;0;0;0;.00nan;0;0
12347;143036;622;66;26;3;23;.885;3600000;0
12348;178911;2310;0;0;0;0;.00nan;0;0
12348;179350;2310;12;26;7;19;.731;3600000;0
12348;156221;620;0;0;0;0;.00nan;0;0
12348;156298;620;82;23;1;22;.957;3600000;0
12349;168021;619;90;32;2;30;.938;3600000;0
12349;84525;2308;40;35;6;29;.829;3600000;0
12349;90734;619;0;0;0;0;.00nan;0;0
12349;144421;2308;0;0;0;0;.00nan;0;0
12350;192776;611;63;17;1;16;.941;3600000;0
12350;66457;4644;0;0;0;0;.00nan;0;0
12350;95925;611;0;0;0;0;.00nan;0;0
12350;156254;4644;57;38;5;33;.868;3600000;0
12351;188070;614;0;0;0;0;.00nan;0;0
12351;171190;614;33;35;7;28;.800;3600000;0
12351;144410;612;0;0;0;0;.00nan;0;0
12351;156322;612;90;32;1;31;.969;3600000;0
12352;175651;2319;24;33;7;26;.788;3600000;0
12352;186520;617;100;29;0;29;1.000;3600000;0
12352;202587;617;0;0;0;0;.00nan;0;0
12352;73699;2319;0;0;0;0;.00nan;0;0
12353;2140;622;0;0;0;0;.00nan;0;0
12353;-1;2167;0;0;0;0;.00nan;0;0
12353;-1;2167;48;44;6;38;.864;3600000;0
12353;143036;622;67;21;2;19;.905;3600000;0
12354;178911;2310;58;41;5;36;.878;3600000;0
12354;179350;2310;0;0;0;0;.00nan;0;0
12354;186520;617;71;19;1;18;.947;3600000;0
12354;202587;617;0;0;0;0;.00nan;0;0
12355;192776;611;83;17;0;17;1.000;3600000;0
12355;-1;2167;0;0;0;0;.00nan;0;0
12355;-1;2167;73;36;3;33;.917;3600000;0
12355;95925;611;0;0;0;0;.00nan;0;0
12356;2140;622;0;0;0;0;.00nan;0;0
12356;143036;622;67;26;2;24;.923;4200000;0
12356;144410;612;0;0;0;0;.00nan;0;0
12356;156322;612;99;41;2;39;.951;4200000;0
12357;66457;4644;0;0;0;0;.00nan;0;0
12357;156221;620;0;0;0;0;.00nan;0;0
12357;156254;4644;74;36;3;33;.917;3600000;0
12357;156298;620;20;15;5;10;.667;3516000;0
12358;188070;614;48;41;6;35;.854;3207000;0
12358;171190;614;56;6;0;6;1.000;393000;0
12358;84525;2308;81;33;2;31;.939;3600000;0
12358;144421;2308;0;0;0;0;.00nan;0;0
12359;168021;619;0;0;0;0;.00nan;0;0
12359;175651;2319;79;36;2;34;.944;3600000;0
12359;73699;2319;0;0;0;0;.00nan;0;0
12359;90734;619;74;19;1;18;.947;3600000;0
12360;188070;614;0;0;0;0;.00nan;0;0
12360;178911;2310;55;19;2;17;.895;3600000;0
12360;171190;614;98;47;3;44;.936;3600000;0
12360;179350;2310;0;0;0;0;.00nan;0;0
12361;192776;611;64;22;2;20;.909;3600000;0
12361;-1;2167;42;37;6;31;.838;3600000;0
12361;-1;2167;0;0;0;0;.00nan;0;0
12361;95925;611;0;0;0;0;.00nan;0;0
12362;144410;612;0;0;0;0;.00nan;0;0
12362;156221;620;0;0;0;0;.00nan;0;0
12362;156298;620;83;25;1;24;.960;3600000;0
12362;156322;612;68;42;4;38;.905;3600000;0
12363;168021;619;64;26;2;24;.923;3600000;0
12363;66457;4644;21;29;6;23;.793;3357000;0
12363;90734;619;0;0;0;0;.00nan;0;0
12363;156254;4644;27;7;3;4;.571;243000;0
12364;186520;617;37;28;6;22;.786;3574000;0
12364;202587;617;0;0;0;0;.00nan;0;0
12364;84525;2308;0;0;0;0;.00nan;0;0
12364;144421;2308;60;39;4;35;.897;3600000;0
12365;2140;622;0;0;0;0;.00nan;0;0
12365;175651;2319;52;42;6;36;.857;3600000;0
12365;73699;2319;0;0;0;0;.00nan;0;0
12365;143036;622;70;21;2;19;.905;3600000;0
12366;178911;2310;52;24;3;21;.875;3546000;0
12366;179350;2310;0;0;0;0;.00nan;0;0
12366;144410;612;0;0;0;0;.00nan;0;0
12366;156322;612;70;24;2;22;.917;3600000;0
12367;-1;2167;0;0;0;0;.00nan;0;0
12367;-1;2167;43;32;5;27;.844;3600000;0
12367;66457;4644;33;17;4;13;.765;1653000;0
12367;156254;4644;32;26;5;21;.808;1947000;0
12368;192776;611;57;36;4;32;.889;3554000;0
12368;2140;622;0;0;0;0;.00nan;0;0
12368;95925;611;0;0;0;0;.00nan;0;0
12368;143036;622;56;24;3;21;.875;3600000;0
12369;84525;2308;61;32;5;27;.844;3600000;0
12369;144421;2308;0;0;0;0;.00nan;0;0
12369;156221;620;0;0;0;0;.00nan;0;0
12369;156298;620;66;28;3;25;.893;3600000;0
12370;175651;2319;0;0;0;0;.00nan;0;0
12370;186520;617;39;25;5;20;.800;3600000;0
12370;202587;617;0;0;0;0;.00nan;0;0
12370;73699;2319;100;25;0;25;1.000;3600000;0
12371;188070;614;0;0;0;0;.00nan;0;0
12371;168021;619;0;0;0;0;.00nan;0;0
12371;171190;614;76;38;3;35;.921;3577000;0
12371;90734;619;68;17;1;16;.941;3600000;0
12372;178911;2310;0;0;0;0;.00nan;0;0
12372;179350;2310;88;31;2;29;.935;3985000;0
12372;84525;2308;66;31;3;28;.903;3985000;0
12372;144421;2308;0;0;0;0;.00nan;0;0
12373;175651;2319;0;0;0;0;.00nan;0;0
12373;73699;2319;55;45;6;39;.867;3600000;0
12373;156221;620;46;17;3;14;.824;3600000;0
12373;156298;620;0;0;0;0;.00nan;0;0
12374;168021;619;0;0;0;0;.00nan;0;0
12374;-1;2167;0;0;0;0;.00nan;0;0
12374;-1;2167;71;37;4;33;.892;3600000;0
12374;90734;619;52;24;3;21;.875;3600000;0
12375;188070;614;52;33;5;28;.848;3600000;0
12375;171190;614;0;0;0;0;.00nan;0;0
12375;144410;612;0;0;0;0;.00nan;0;0
12375;156322;612;88;30;1;29;.967;3600000;0
12376;192776;611;73;30;2;28;.933;3600000;0
12376;186520;617;65;29;4;25;.862;3565000;0
12376;202587;617;0;0;0;0;.00nan;0;0
12376;95925;611;0;0;0;0;.00nan;0;0
12377;2140;622;0;0;0;0;.00nan;0;0
12377;66457;4644;0;0;0;0;.00nan;0;0
12377;143036;622;100;25;0;25;1.000;3600000;0
12377;156254;4644;85;57;5;52;.912;3600000;0
12378;2140;622;0;0;0;0;.00nan;0;0
12378;-1;2167;0;0;0;0;.00nan;0;0
12378;-1;2167;97;55;3;52;.945;3586000;0
12378;143036;622;74;19;1;18;.947;3600000;0
12379;168021;619;0;0;0;0;.00nan;0;0
12379;90734;619;73;33;2;31;.939;3551000;0
12379;144410;612;0;0;0;0;.00nan;0;0
12379;156322;612;78;21;1;20;.952;3600000;0
12380;186520;617;88;23;1;22;.957;3600000;0
12380;202587;617;0;0;0;0;.00nan;0;0
12380;66457;4644;0;0;0;0;.00nan;0;0
12380;156254;4644;92;43;2;41;.953;3600000;0
12381;192776;611;57;42;5;37;.881;3600000;0
12381;95925;611;0;0;0;0;.00nan;0;0
12381;156221;620;0;0;0;0;.00nan;0;0
12381;156298;620;74;25;1;24;.960;3600000;0
12382;188070;614;61;6;0;6;1.000;249000;0
12382;171190;614;48;37;6;31;.838;3351000;0
12382;84525;2308;43;4;1;3;.750;817000;0
12382;144421;2308;15;21;6;15;.714;2783000;0
12383;178911;2310;0;0;0;0;.00nan;0;0
12383;179350;2310;59;33;4;29;.879;3600000;0
12383;175651;2319;67;15;1;14;.933;3600000;0
12383;73699;2319;0;0;0;0;.00nan;0;0
12384;192776;611;82;38;3;35;.921;4119000;0
12384;178911;2310;0;0;0;0;.00nan;0;0
12384;179350;2310;84;39;2;37;.949;4119000;0
12384;95925;611;0;0;0;0;.00nan;0;0
12385;66457;4644;30;17;4;13;.765;594000;0
12385;156221;620;0;0;0;0;.00nan;0;0
12385;156254;4644;35;31;6;25;.806;3006000;0
12385;156298;620;100;27;0;27;1.000;3600000;0
12386;84525;2308;80;47;3;44;.936;3893000;0
12386;144410;612;0;0;0;0;.00nan;0;0
12386;144421;2308;0;0;0;0;.00nan;0;0
12386;156322;612;63;31;4;27;.871;3922000;0
12387;2140;622;0;0;0;0;.00nan;0;0
12387;168021;619;88;35;1;34;.971;3567000;0
12387;90734;619;0;0;0;0;.00nan;0;0
12387;143036;622;96;24;0;24;1.000;3600000;0
12388;188070;614;30;35;6;29;.829;3572000;0
12388;171190;614;0;0;0;0;.00nan;0;0
12388;175651;2319;0;0;0;0;.00nan;0;0
12388;73699;2319;50;23;4;19;.826;3600000;0
12389;186520;617;76;21;1;20;.952;3600000;0
12389;202587;617;0;0;0;0;.00nan;0;0
12389;-1;2167;34;35;6;29;.829;2760000;0
12389;-1;2167;65;14;0;14;1.000;840000;0
12390;-1;2167;0;0;0;0;.00nan;0;0
12390;-1;2167;87;53;3;50;.943;3550000;0
12390;156221;620;0;0;0;0;.00nan;0;0
12390;156298;620;52;13;2;11;.846;3600000;0
12391;178911;2310;0;0;0;0;.00nan;0;0
12391;179350;2310;61;30;3;27;.900;3600000;0
12391;66457;4644;50;1;0;1;1.000;563000;0
12391;156254;4644;46;37;6;31;.838;3037000;0
12392;192776;611;53;14;2;12;.857;3600000;0
12392;188070;614;57;25;3;22;.880;3600000;0
12392;171190;614;0;0;0;0;.00nan;0;0
12392;95925;611;0;0;0;0;.00nan;0;0
12393;168021;619;79;30;2;28;.933;3600000;0
12393;84525;2308;0;0;0;0;.00nan;0;0
12393;90734;619;0;0;0;0;.00nan;0;0
12393;144421;2308;44;34;5;29;.853;3600000;0
12394;175651;2319;79;35;2;33;.943;3600000;0
12394;73699;2319;0;0;0;0;.00nan;0;0
12394;144410;612;0;0;0;0;.00nan;0;0
12394;156322;612;25;28;6;22;.786;3600000;0
12395;2140;622;0;0;0;0;.00nan;0;0
12395;186520;617;46;37;6;31;.838;3600000;0
12395;202587;617;0;0;0;0;.00nan;0;0
12395;143036;622;76;26;2;24;.923;3600000;0
12396;178911;2310;89;24;1;23;.958;3600000;0
12396;179350;2310;0;0;0;0;.00nan;0;0
12396;-1;2167;55;41;5;36;.878;3600000;0
12396;-1;2167;0;0;0;0;.00nan;0;0
12397;2140;622;0;0;0;0;.00nan;0;0
12397;143036;622;76;23;2;21;.913;3600000;0
12397;156221;620;0;0;0;0;.00nan;0;0
12397;156298;620;49;37;5;32;.865;3600000;0
12398;192776;611;99;39;1;38;.974;3600000;0
12398;95925;611;0;0;0;0;.00nan;0;0
12398;144410;612;0;0;0;0;.00nan;0;0
12398;156322;612;81;37;2;35;.946;3566000;0
12399;168021;619;64;23;3;20;.870;3600000;0
12399;186520;617;33;30;6;24;.800;3033000;0
12399;202587;617;55;4;0;4;1.000;567000;0
12399;90734;619;0;0;0;0;.00nan;0;0
12400;175651;2319;73;27;2;25;.926;3522000;0
12400;73699;2319;0;0;0;0;.00nan;0;0
12400;84525;2308;100;23;0;23;1.000;3600000;0
12400;144421;2308;0;0;0;0;.00nan;0;0
12401;188070;614;82;37;3;34;.919;3600000;0
12401;171190;614;0;0;0;0;.00nan;0;0
12401;66457;4644;0;0;0;0;.00nan;0;0
12401;156254;4644;36;27;5;22;.815;3569000;0
12402;188070;614;23;11;4;7;.636;1062000;0
12402;171190;614;73;26;1;25;.962;2538000;0
12402;-1;2167;0;0;0;0;.00nan;0;0
12402;-1;2167;52;20;3;17;.850;3600000;0
12403;66457;4644;0;0;0;0;.00nan;0;0
12403;144410;612;0;0;0;0;.00nan;0;0
12403;156254;4644;85;56;6;50;.893;3600000;0
12403;156322;612;58;13;1;12;.923;3600000;0
12404;192776;611;46;28;5;23;.821;3600000;0
12404;84525;2308;36;32;6;26;.813;2283000;0
12404;95925;611;0;0;0;0;.00nan;0;0
12404;144421;2308;81;15;0;15;1.000;1317000;0
12405;168021;619;0;0;0;0;.00nan;0;0
12405;175651;2319;59;21;2;19;.905;1686000;0
12405;73699;2319;48;27;4;23;.852;1862000;0
12405;90734;619;47;29;5;24;.828;3600000;0
12406;186520;617;0;0;0;0;.00nan;0;0
12406;202587;617;82;40;3;37;.925;3600000;0
12406;156221;620;0;0;0;0;.00nan;0;0
12406;156298;620;33;26;5;21;.808;3532000;0
12407;2140;622;0;0;0;0;.00nan;0;0
12407;178911;2310;0;0;0;0;.00nan;0;0
12407;179350;2310;97;48;3;45;.938;4200000;0
12407;143036;622;83;38;3;35;.921;4200000;0
12408;178911;2310;0;0;0;0;.00nan;0;0
12408;179350;2310;93;48;3;45;.938;3600000;0
12408;186520;617;65;27;2;25;.926;3600000;0
12408;202587;617;0;0;0;0;.00nan;0;0
12409;-1;2167;78;51;4;47;.922;3600000;0
12409;-1;2167;0;0;0;0;.00nan;0;0
12409;144410;612;64;24;3;21;.875;3600000;0
12409;156322;612;0;0;0;0;.00nan;0;0
12410;168021;619;69;25;2;23;.920;3600000;0
12410;90734;619;0;0;0;0;.00nan;0;0
12410;156221;620;0;0;0;0;.00nan;0;0
12410;156298;620;72;34;3;31;.912;3600000;0
12411;66457;4644;0;0;0;0;.00nan;0;0
12411;84525;2308;0;0;0;0;.00nan;0;0
12411;144421;2308;73;20;1;19;.950;3600000;0
12411;156254;4644;68;44;4;40;.909;3600000;0
12412;192776;611;75;36;3;33;.917;3600000;0
12412;175651;2319;86;32;2;30;.938;3600000;0
12412;73699;2319;0;0;0;0;.00nan;0;0
12412;95925;611;0;0;0;0;.00nan;0;0
12413;2140;622;0;0;0;0;.00nan;0;0
12413;188070;614;0;0;0;0;.00nan;0;0
12413;171190;614;82;36;3;33;.917;3570000;0
12413;143036;622;66;13;1;12;.923;3600000;0
12414;-1;2167;0;0;0;0;.00nan;0;0
12414;-1;2167;52;32;4;28;.875;3600000;0
12414;84525;2308;89;26;1;25;.962;3600000;0
12414;144421;2308;0;0;0;0;.00nan;0;0
12415;178911;2310;0;0;0;0;.00nan;0;0
12415;179350;2310;93;35;2;33;.943;3600000;0
12415;156221;620;0;0;0;0;.00nan;0;0
12415;156298;620;69;33;3;30;.909;3600000;0
12416;175651;2319;57;26;4;22;.846;3698000;0
12416;66457;4644;0;0;0;0;.00nan;0;0
12416;73699;2319;0;0;0;0;.00nan;0;0
12416;156254;4644;52;26;3;23;.885;3698000;0
12417;192776;611;52;31;4;27;.871;3558000;0
12417;168021;619;0;0;0;0;.00nan;0;0
12417;90734;619;60;16;2;14;.875;3600000;0
12417;95925;611;0;0;0;0;.00nan;0;0
12418;188070;614;73;39;4;35;.897;3600000;0
12418;171190;614;0;0;0;0;.00nan;0;0
12418;186520;617;74;23;1;22;.957;3600000;0
12418;202587;617;0;0;0;0;.00nan;0;0
12419;2140;622;0;0;0;0;.00nan;0;0
12419;143036;622;93;28;1;27;.964;3600000;0
12419;144410;612;40;12;2;10;.833;1103000;0
12419;156322;612;27;38;7;31;.816;2497000;0
12420;186520;617;99;43;2;41;.953;3600000;0
12420;202587;617;0;0;0;0;.00nan;0;0
12420;144410;612;0;0;0;0;.00nan;0;0
12420;156322;612;50;31;4;27;.871;3570000;0
12421;168021;619;68;19;1;18;.947;3600000;0
12421;178911;2310;0;0;0;0;.00nan;0;0
12421;179350;2310;64;32;3;29;.906;3575000;0
12421;90734;619;0;0;0;0;.00nan;0;0
12422;192776;611;0;0;0;0;.00nan;0;0
12422;66457;4644;51;25;3;22;.880;1689000;0
12422;95925;611;83;22;1;21;.955;3600000;0
12422;156254;4644;47;36;6;30;.833;1911000;0
12423;2140;622;0;0;0;0;.00nan;0;0
12423;84525;2308;96;48;3;45;.938;3593000;0
12423;143036;622;82;18;1;17;.944;3600000;0
12423;144421;2308;0;0;0;0;.00nan;0;0
12424;175651;2319;43;19;4;15;.789;3849000;0
12424;-1;2167;56;38;5;33;.868;3849000;0
12424;-1;2167;0;0;0;0;.00nan;0;0
12424;73699;2319;0;0;0;0;.00nan;0;0
12425;188070;614;0;0;0;0;.00nan;0;0
12425;171190;614;95;54;3;51;.944;3597000;0
12425;156221;620;0;0;0;0;.00nan;0;0
12425;156298;620;88;25;1;24;.960;3600000;0
12426;178911;2310;72;12;0;12;1.000;1325000;0
12426;179350;2310;50;30;5;25;.833;2275000;0
12426;175651;2319;61;24;2;22;.917;3600000;0
12426;73699;2319;0;0;0;0;.00nan;0;0
12427;178911;2310;85;34;2;32;.941;3600000;0
12427;179350;2310;0;0;0;0;.00nan;0;0
12427;144410;612;0;0;0;0;.00nan;0;0
12427;156322;612;48;30;5;25;.833;3600000;0
12428;-1;2167;0;0;0;0;.00nan;0;0
12428;-1;2167;68;41;4;37;.902;3544000;0
12428;66457;4644;0;0;0;0;.00nan;0;0
12428;156254;4644;59;31;3;28;.903;3600000;0
12429;84525;2308;78;40;3;37;.925;3677000;0
12429;144421;2308;0;0;0;0;.00nan;0;0
12429;156221;620;0;0;0;0;.00nan;0;0
12429;156298;620;69;38;4;34;.895;3677000;0
12430;188070;614;55;46;6;40;.870;3600000;0
12430;168021;619;0;0;0;0;.00nan;0;0
12430;171190;614;0;0;0;0;.00nan;0;0
12430;90734;619;58;27;4;23;.852;3600000;0
12431;175651;2319;54;26;4;22;.846;3660000;0
12431;186520;617;67;28;3;25;.893;3660000;0
12431;202587;617;0;0;0;0;.00nan;0;0
12431;73699;2319;0;0;0;0;.00nan;0;0
12432;192776;611;66;42;4;38;.905;3600000;0
12432;2140;622;0;0;0;0;.00nan;0;0
12432;95925;611;0;0;0;0;.00nan;0;0
12432;143036;622;96;33;1;32;.970;3600000;0
12433;168021;619;80;32;2;30;.938;3600000;0
12433;-1;2167;0;0;0;0;.00nan;0;0
12433;-1;2167;70;33;3;30;.909;3575000;0
12433;90734;619;0;0;0;0;.00nan;0;0
12434;188070;614;0;0;0;0;.00nan;0;0
12434;171190;614;51;34;5;29;.853;3584000;0
12434;144410;612;0;0;0;0;.00nan;0;0
12434;156322;612;69;38;4;34;.895;3600000;0
12435;2140;622;0;0;0;0;.00nan;0;0
12435;66457;4644;0;0;0;0;.00nan;0;0
12435;143036;622;57;20;3;17;.850;3600000;0
12435;156254;4644;91;69;6;63;.913;3600000;0
12436;192776;611;59;27;3;24;.889;3600000;0
12436;186520;617;100;27;0;27;1.000;3600000;0
12436;202587;617;0;0;0;0;.00nan;0;0
12436;95925;611;0;0;0;0;.00nan;0;0
12437;178911;2310;0;0;0;0;.00nan;0;0
12437;179350;2310;69;49;5;44;.898;3583000;0
12437;84525;2308;0;0;0;0;.00nan;0;0
12437;144421;2308;68;30;3;27;.900;3600000;0
12438;175651;2319;0;0;0;0;.00nan;0;0
12438;73699;2319;100;36;1;35;.972;4200000;0
12438;156221;620;0;0;0;0;.00nan;0;0
12438;156298;620;91;34;1;33;.971;4200000;0
12439;178911;2310;0;0;0;0;.00nan;0;0
12439;179350;2310;55;21;3;18;.857;3600000;0
12439;175651;2319;45;25;4;21;.840;3600000;0
12439;73699;2319;0;0;0;0;.00nan;0;0
12440;192776;611;69;42;4;38;.905;3548000;0
12440;95925;611;0;0;0;0;.00nan;0;0
12440;156221;620;68;22;2;20;.909;3600000;0
12440;156298;620;0;0;0;0;.00nan;0;0
12441;168021;619;0;0;0;0;.00nan;0;0
12441;90734;619;64;22;2;20;.909;3600000;0
12441;144410;612;31;3;2;1;.333;434000;0
12441;156322;612;55;43;6;37;.860;3166000;0
12442;188070;614;47;22;4;18;.818;3600000;0
12442;171190;614;0;0;0;0;.00nan;0;0
12442;84525;2308;45;33;5;28;.848;3544000;0
12442;144421;2308;0;0;0;0;.00nan;0;0
12443;186520;617;86;25;1;24;.960;3600000;0
12443;202587;617;0;0;0;0;.00nan;0;0
12443;66457;4644;0;0;0;0;.00nan;0;0
12443;156254;4644;52;38;5;33;.868;3600000;0
12444;2140;622;0;0;0;0;.00nan;0;0
12444;-1;2167;56;5;0;5;1.000;337000;0
12444;-1;2167;68;51;6;45;.882;3263000;0
12444;143036;622;55;22;3;19;.864;3600000;0
12445;186520;617;84;35;2;33;.943;4175000;0
12445;202587;617;0;0;0;0;.00nan;0;0
12445;-1;2167;0;0;0;0;.00nan;0;0
12445;-1;2167;76;29;2;27;.931;4200000;0
12446;66457;4644;47;38;5;33;.868;3600000;0
12446;156221;620;0;0;0;0;.00nan;0;0
12446;156254;4644;0;0;0;0;.00nan;0;0
12446;156298;620;53;23;4;19;.826;3600000;0
12447;192776;611;83;39;3;36;.923;3971000;0
12447;178911;2310;0;0;0;0;.00nan;0;0
12447;179350;2310;62;33;4;29;.879;3971000;0
12447;95925;611;0;0;0;0;.00nan;0;0
12448;84525;2308;75;24;1;23;.958;3600000;0
12448;144410;612;50;26;3;23;.885;1565000;0
12448;144421;2308;0;0;0;0;.00nan;0;0
12448;156322;612;31;22;5;17;.773;2035000;0
12449;188070;614;0;0;0;0;.00nan;0;0
12449;171190;614;40;40;6;34;.850;3600000;0
12449;175651;2319;85;38;2;36;.947;3600000;0
12449;73699;2319;0;0;0;0;.00nan;0;0
12450;2140;622;0;0;0;0;.00nan;0;0
12450;168021;619;82;43;5;38;.884;4200000;0
12450;90734;619;0;0;0;0;.00nan;0;0
12450;143036;622;49;31;5;26;.839;4200000;0
12451;178911;2310;0;0;0;0;.00nan;0;0
12451;179350;2310;67;28;3;25;.893;3545000;0
12451;66457;4644;0;0;0;0;.00nan;0;0
12451;156254;4644;80;26;2;24;.923;3600000;0
12452;-1;2167;31;12;3;9;.750;1364000;0
12452;-1;2167;34;35;7;28;.800;2236000;0
12452;156221;620;0;0;0;0;.00nan;0;0
12452;156298;620;97;22;0;22;1.000;3600000;0
12453;175651;2319;84;17;0;17;1.000;3600000;0
12453;73699;2319;0;0;0;0;.00nan;0;0
12453;144410;612;0;0;0;0;.00nan;0;0
12453;156322;612;90;33;1;32;.970;3549000;0
12454;168021;619;0;0;0;0;.00nan;0;0
12454;84525;2308;97;62;2;60;.968;3570000;0
12454;90734;619;62;15;1;14;.933;3600000;0
12454;144421;2308;0;0;0;0;.00nan;0;0
12455;192776;611;71;33;3;30;.909;3587000;0
12455;188070;614;85;36;1;35;.972;3600000;0
12455;171190;614;0;0;0;0;.00nan;0;0
12455;95925;611;0;0;0;0;.00nan;0;0
12456;2140;622;0;0;0;0;.00nan;0;0
12456;186520;617;49;39;6;33;.846;3600000;0
12456;202587;617;0;0;0;0;.00nan;0;0
12456;143036;622;46;17;3;14;.824;3600000;0
12457;178911;2310;0;0;0;0;.00nan;0;0
12457;179350;2310;79;34;3;31;.912;4200000;0
12457;-1;2167;0;0;0;0;.00nan;0;0
12457;-1;2167;74;42;3;39;.929;4200000;0
12458;188070;614;0;0;0;0;.00nan;0;0
12458;171190;614;76;44;3;41;.932;4198000;0
12458;66457;4644;0;0;0;0;.00nan;0;0
12458;156254;4644;76;31;2;29;.935;4198000;0
12459;192776;611;73;27;2;25;.926;3600000;0
12459;95925;611;0;0;0;0;.00nan;0;0
12459;144410;612;0;0;0;0;.00nan;0;0
12459;156322;612;49;23;3;20;.870;3559000;0
12460;175651;2319;35;29;5;24;.828;3518000;0
12460;73699;2319;0;0;0;0;.00nan;0;0
12460;84525;2308;62;31;3;28;.903;3600000;0
12460;144421;2308;0;0;0;0;.00nan;0;0
12461;168021;619;97;24;0;24;1.000;3600000;0
12461;186520;617;79;29;1;28;.966;3600000;0
12461;202587;617;0;0;0;0;.00nan;0;0
12461;90734;619;0;0;0;0;.00nan;0;0
12462;2140;622;100;28;0;28;1.000;3600000;0
12462;143036;622;0;0;0;0;.00nan;0;0
12462;156221;620;0;0;0;0;.00nan;0;0
12462;156298;620;57;39;5;34;.872;3600000;0
12463;2140;622;81;21;1;20;.952;3600000;0
12463;178911;2310;37;29;6;23;.793;3017000;0
12463;179350;2310;40;13;3;10;.769;583000;0
12463;143036;622;0;0;0;0;.00nan;0;0
12464;186520;617;58;38;4;34;.895;3546000;0
12464;202587;617;0;0;0;0;.00nan;0;0
12464;156221;620;0;0;0;0;.00nan;0;0
12464;156298;620;57;26;3;23;.885;3600000;0
12465;66457;4644;18;11;4;7;.636;1483000;0
12465;144410;612;0;0;0;0;.00nan;0;0
12465;156254;4644;30;24;5;19;.792;2117000;0
12465;156322;612;48;26;4;22;.846;3600000;0
12466;168021;619;71;25;2;23;.920;4200000;0
12466;175651;2319;100;49;2;47;.959;4200000;0
12466;73699;2319;0;0;0;0;.00nan;0;0
12466;90734;619;0;0;0;0;.00nan;0;0
12467;192776;611;34;26;5;21;.808;3588000;0
12467;84525;2308;0;0;0;0;.00nan;0;0
12467;95925;611;0;0;0;0;.00nan;0;0
12467;144421;2308;42;24;4;20;.833;3600000;0
12468;188070;614;0;0;0;0;.00nan;0;0
12468;171190;614;56;27;3;24;.889;3784000;0
12468;-1;2167;0;0;0;0;.00nan;0;0
12468;-1;2167;65;34;4;30;.882;3784000;0
12469;-1;2167;60;42;5;37;.881;3600000;0
12469;-1;2167;0;0;0;0;.00nan;0;0
12469;144410;612;0;0;0;0;.00nan;0;0
12469;156322;612;61;16;2;14;.875;3600000;0
12470;168021;619;67;30;3;27;.900;3600000;0
12470;90734;619;0;0;0;0;.00nan;0;0
12470;156221;620;0;0;0;0;.00nan;0;0
12470;156298;620;92;24;0;24;1.000;3600000;0
12471;66457;4644;0;0;0;0;.00nan;0;0
12471;84525;2308;74;45;4;41;.911;4107000;0
12471;144421;2308;0;0;0;0;.00nan;0;0
12471;156254;4644;68;30;3;27;.900;4107000;0
12472;192776;611;72;33;3;30;.909;3544000;0
12472;175651;2319;83;40;2;38;.950;3600000;0
12472;73699;2319;0;0;0;0;.00nan;0;0
12472;95925;611;0;0;0;0;.00nan;0;0
12473;178911;2310;0;0;0;0;.00nan;0;0
12473;179350;2310;71;33;4;29;.879;3600000;0
12473;186520;617;44;27;5;22;.815;3544000;0
12473;202587;617;0;0;0;0;.00nan;0;0
12474;2140;622;0;0;0;0;.00nan;0;0
12474;188070;614;30;26;6;20;.769;1455000;0
12474;171190;614;67;33;3;30;.909;2145000;0
12474;143036;622;88;18;0;18;1.000;3600000;0
12475;178911;2310;0;0;0;0;.00nan;0;0
12475;179350;2310;100;52;3;49;.942;3600000;0
12475;156221;620;0;0;0;0;.00nan;0;0
12475;156298;620;36;19;4;15;.789;3585000;0
12476;2140;622;0;0;0;0;.00nan;0;0
12476;143036;622;100;25;0;25;1.000;3600000;0
12476;144410;612;0;0;0;0;.00nan;0;0
12476;156322;612;60;27;3;24;.889;3600000;0
12477;192776;611;84;34;2;32;.941;3600000;0
12477;168021;619;70;16;1;15;.938;2612000;0
12477;90734;619;28;11;4;7;.636;988000;0
12477;95925;611;0;0;0;0;.00nan;0;0
12478;-1;2167;100;54;2;52;.963;3600000;0
12478;-1;2167;0;0;0;0;.00nan;0;0
12478;84525;2308;81;41;4;37;.902;3563000;0
12478;144421;2308;0;0;0;0;.00nan;0;0
12479;175651;2319;0;0;0;0;.00nan;0;0
12479;66457;4644;70;17;0;17;1.000;1584000;0
12479;73699;2319;45;21;4;17;.810;3600000;0
12479;156254;4644;19;23;6;17;.739;1944000;0
12480;188070;614;0;0;0;0;.00nan;0;0
12480;171190;614;29;22;5;17;.773;3600000;0
12480;186520;617;100;32;0;32;1.000;3600000;0
12480;202587;617;0;0;0;0;.00nan;0;0
12481;175651;2319;26;27;6;21;.778;2852000;0
12481;66457;4644;0;0;0;0;.00nan;0;0
12481;73699;2319;48;8;1;7;.875;748000;0
12481;156254;4644;86;41;3;38;.927;3600000;0
12482;192776;611;51;35;6;29;.829;3600000;0
12482;2140;622;0;0;0;0;.00nan;0;0
12482;95925;611;0;0;0;0;.00nan;0;0
12482;143036;622;73;18;1;17;.944;3600000;0
12483;168021;619;0;0;0;0;.00nan;0;0
12483;178911;2310;63;41;5;36;.878;3600000;0
12483;179350;2310;0;0;0;0;.00nan;0;0
12483;90734;619;62;16;2;14;.875;3600000;0
12484;175651;2319;54;31;4;27;.871;4200000;0
12484;-1;2167;56;30;4;26;.867;4200000;0
12484;-1;2167;0;0;0;0;.00nan;0;0
12484;73699;2319;0;0;0;0;.00nan;0;0
12485;188070;614;59;10;1;9;.900;836000;0
12485;171190;614;49;39;6;33;.846;2764000;0
12485;156221;620;0;0;0;0;.00nan;0;0
12485;156298;620;51;15;2;13;.867;3600000;0
12486;192776;611;77;33;3;30;.909;4200000;0
12486;66457;4644;0;0;0;0;.00nan;0;0
12486;95925;611;0;0;0;0;.00nan;0;0
12486;156254;4644;87;42;3;39;.929;4200000;0
12487;186520;617;86;48;4;44;.917;3600000;0
12487;202587;617;0;0;0;0;.00nan;0;0
12487;144410;612;0;0;0;0;.00nan;0;0
12487;156322;612;82;14;0;14;1.000;3600000;0
12488;2140;622;0;0;0;0;.00nan;0;0
12488;84525;2308;74;35;3;32;.914;3600000;0
12488;143036;622;18;22;6;16;.727;3600000;0
12488;144421;2308;0;0;0;0;.00nan;0;0
12489;144410;612;0;0;0;0;.00nan;0;0
12489;156221;620;0;0;0;0;.00nan;0;0
12489;156298;620;71;18;1;17;.944;3600000;0
12489;156322;612;52;42;6;36;.857;3600000;0
12490;168021;619;52;21;4;17;.810;3959000;0
12490;66457;4644;68;55;5;50;.909;3959000;0
12490;90734;619;0;0;0;0;.00nan;0;0
12490;156254;4644;0;0;0;0;.00nan;0;0
12491;192776;611;92;24;0;24;1.000;4200000;0
12491;-1;2167;100;29;0;29;1.000;4200000;0
12491;-1;2167;0;0;0;0;.00nan;0;0
12491;95925;611;0;0;0;0;.00nan;0;0
12492;186520;617;27;19;5;14;.737;3600000;0
12492;202587;617;0;0;0;0;.00nan;0;0
12492;84525;2308;54;10;1;9;.900;616000;0
12492;144421;2308;48;53;7;46;.868;2984000;0
12493;2140;622;0;0;0;0;.00nan;0;0
12493;175651;2319;74;23;1;22;.957;2455000;0
12493;73699;2319;40;23;4;19;.826;1145000;0
12493;143036;622;76;10;0;10;1.000;3600000;0
12494;188070;614;99;40;1;39;.975;3600000;0
12494;178911;2310;0;0;0;0;.00nan;0;0
12494;171190;614;0;0;0;0;.00nan;0;0
12494;179350;2310;64;25;3;22;.880;3567000;0
12496;175651;2319;68;20;1;19;.950;3600000;0
12496;73699;2319;0;0;0;0;.00nan;0;0
12496;144410;612;0;0;0;0;.00nan;0;0
12496;156322;612;48;29;4;25;.862;3600000;0
12498;192776;611;55;30;4;26;.867;3547000;0
12498;186520;617;89;36;2;34;.944;3600000;0
12498;202587;617;0;0;0;0;.00nan;0;0
12498;156254;611;0;0;0;0;.00nan;0;0
12500;168021;619;68;25;3;22;.880;4200000;0
12500;171190;614;98;56;3;53;.946;4200000;0
12500;90734;619;0;0;0;0;.00nan;0;0
12500;156221;614;0;0;0;0;.00nan;0;0
12502;2140;622;0;0;0;0;.00nan;0;0
12502;84525;620;0;0;0;0;.00nan;0;0
12502;143036;622;81;31;2;29;.935;3600000;0
12502;156298;620;32;42;8;34;.810;3600000;0
12504;188070;2308;50;6;1;5;.833;3600000;0
12504;-1;2167;40;38;7;31;.816;2087000;0
12504;-1;2167;18;30;7;23;.767;1513000;0
12504;144421;2308;0;0;0;0;.00nan;0;0
12506;178911;2310;0;0;0;0;.00nan;0;0
12506;179350;2310;39;24;4;20;.833;3600000;0
12506;66457;4644;73;24;1;23;.958;3600000;0
12506;95925;4644;0;0;0;0;.00nan;0;0
12508;2140;622;63;13;1;12;.923;3600000;0
12508;66457;4644;81;37;3;34;.919;2630000;0
12508;95925;4644;22;12;4;8;.667;970000;0
12508;143036;622;0;0;0;0;.00nan;0;0
12510;188070;2308;0;0;0;0;.00nan;0;0
12510;-1;2167;0;0;0;0;.00nan;0;0
12510;-1;2167;63;36;3;33;.917;3600000;0
12510;144421;2308;74;17;1;16;.941;3600000;0
12512;192776;611;0;0;0;0;.00nan;0;0
12512;171190;614;0;0;0;0;.00nan;0;0
12512;156221;614;84;35;2;33;.943;3600000;0
12512;156254;611;50;22;3;19;.864;3534000;0
12514;168021;619;0;0;0;0;.00nan;0;0
12514;175651;2319;0;0;0;0;.00nan;0;0
12514;73699;2319;100;38;0;38;1.000;3600000;0
12514;90734;619;64;32;4;28;.875;3600000;0
12516;186520;617;100;43;2;41;.953;3600000;0
12516;202587;617;0;0;0;0;.00nan;0;0
12516;84525;620;46;24;4;20;.833;3522000;0
12516;156298;620;0;0;0;0;.00nan;0;0
12518;178911;2310;67;25;2;23;.920;3600000;0
12518;179350;2310;0;0;0;0;.00nan;0;0
12518;144410;612;68;38;3;35;.921;3583000;0
12518;156322;612;0;0;0;0;.00nan;0;0
12522;178911;2310;0;0;0;0;.00nan;0;0
12522;179350;2310;84;29;2;27;.931;3863000;0
12522;175651;2319;0;0;0;0;.00nan;0;0
12522;73699;2319;57;28;3;25;.893;3863000;0
12524;192776;611;64;34;3;31;.912;4200000;0
12524;186520;617;82;30;3;27;.900;4200000;0
12524;202587;617;0;0;0;0;.00nan;0;0
12524;156254;611;0;0;0;0;.00nan;0;0
12526;-1;2167;90;44;4;40;.909;3600000;0
12526;-1;2167;0;0;0;0;.00nan;0;0
12526;66457;4644;0;0;0;0;.00nan;0;0
12526;95925;4644;20;18;5;13;.722;3600000;0
12528;84525;620;0;0;0;0;.00nan;0;0
12528;144410;612;0;0;0;0;.00nan;0;0
12528;156298;620;32;23;5;18;.783;3600000;0
12528;156322;612;47;43;6;37;.860;3572000;0
12530;2140;622;0;0;0;0;.00nan;0;0
12530;171190;614;0;0;0;0;.00nan;0;0
12530;143036;622;68;42;5;37;.881;3600000;0
12530;156221;614;99;44;1;43;.977;3600000;0
12532;2140;622;0;0;0;0;.00nan;0;0
12532;66457;4644;0;0;0;0;.00nan;0;0
12532;143036;622;65;32;3;29;.906;4200000;0
12532;156254;4644;77;43;3;40;.930;4200000;0
12534;84525;2308;0;0;0;0;.00nan;0;0
12534;144421;2308;56;44;6;38;.864;3600000;0
12534;156221;620;0;0;0;0;.00nan;0;0
12534;156298;620;81;31;2;29;.935;3600000;0
12536;188070;614;0;0;0;0;.00nan;0;0
12536;171190;614;79;34;2;32;.941;3514000;0
12536;186520;617;91;19;0;19;1.000;3600000;0
12536;202587;617;0;0;0;0;.00nan;0;0
12540;192776;611;50;15;2;13;.867;3600000;0
12540;-1;2167;76;47;4;43;.915;3541000;0
12540;-1;2167;0;0;0;0;.00nan;0;0
12540;95925;611;0;0;0;0;.00nan;0;0
12542;178911;2310;68;30;3;27;.900;3600000;0
12542;179350;2310;0;0;0;0;.00nan;0;0
12542;175651;2319;100;30;0;30;1.000;3600000;0
12542;73699;2319;0;0;0;0;.00nan;0;0
12544;192776;611;51;40;6;34;.850;3600000;0
12544;95925;611;0;0;0;0;.00nan;0;0
12544;144410;612;0;0;0;0;.00nan;0;0
12544;156322;612;47;19;3;16;.842;3600000;0
12546;186520;617;57;24;3;21;.875;3595000;0
12546;202587;617;0;0;0;0;.00nan;0;0
12546;156221;620;85;34;2;32;.941;3600000;0
12546;156298;620;0;0;0;0;.00nan;0;0
12548;175651;2319;63;25;2;23;.920;3600000;0
12548;66457;4644;46;41;6;35;.854;2648000;0
12548;73699;2319;0;0;0;0;.00nan;0;0
12548;156254;4644;59;14;1;13;.929;952000;0
12552;178911;2310;0;0;0;0;.00nan;0;0
12552;179350;2310;91;35;2;33;.943;4055000;0
12552;84525;2308;100;35;1;34;.971;4055000;0
12552;144421;2308;0;0;0;0;.00nan;0;0
12554;188070;614;54;24;4;20;.833;3767000;0
12554;171190;614;0;0;0;0;.00nan;0;0
12554;-1;2167;0;0;0;0;.00nan;0;0
12554;-1;2167;75;45;5;40;.889;3767000;0
12556;2140;622;0;0;0;0;.00nan;0;0
12556;66457;4644;56;5;0;5;1.000;395000;0
12556;143036;622;90;24;1;23;.958;3600000;0
12556;156254;4644;56;47;6;41;.872;3205000;0
12558;192776;611;100;24;0;24;1.000;3600000;0
12558;178911;2310;69;30;2;28;.933;3577000;0
12558;179350;2310;0;0;0;0;.00nan;0;0
12558;95925;611;0;0;0;0;.00nan;0;0
12560;186520;617;85;26;1;25;.962;3600000;0
12560;202587;617;0;0;0;0;.00nan;0;0
12560;156221;620;56;5;0;5;1.000;362000;0
12560;156298;620;34;21;4;17;.810;3238000;0
12562;168021;619;0;0;0;0;.00nan;0;0
12562;90734;619;70;26;2;24;.923;3600000;0
12562;144410;612;0;0;0;0;.00nan;0;0
12562;156322;612;42;28;4;24;.857;3547000;0
12564;188070;614;0;0;0;0;.00nan;0;0
12564;171190;614;98;61;4;57;.934;3572000;0
12564;84525;2308;59;21;2;19;.905;3600000;0
12564;144421;2308;0;0;0;0;.00nan;0;0
12566;175651;2319;0;0;0;0;.00nan;0;0
12566;-1;2167;0;0;0;0;.00nan;0;0
12566;-1;2167;87;52;5;47;.904;3600000;0
12566;73699;2319;56;10;1;9;.900;3600000;0
12568;-1;2167;95;38;1;37;.974;3600000;0
12568;-1;2167;0;0;0;0;.00nan;0;0
12568;66457;4644;45;23;3;20;.870;3580000;0
12568;156254;4644;0;0;0;0;.00nan;0;0
12570;2140;622;71;28;3;25;.893;3925000;0
12570;178911;2310;0;0;0;0;.00nan;0;0
12570;179350;2310;82;45;4;41;.911;3925000;0
12570;143036;622;0;0;0;0;.00nan;0;0
12572;192776;611;99;67;4;63;.940;3600000;0
12572;84525;2308;0;0;0;0;.00nan;0;0
12572;95925;611;0;0;0;0;.00nan;0;0
12572;144421;2308;29;26;5;21;.808;3575000;0
12574;188070;614;41;33;5;28;.848;3600000;0
12574;171190;614;0;0;0;0;.00nan;0;0
12574;175651;2319;71;24;2;22;.917;3600000;0
12574;73699;2319;0;0;0;0;.00nan;0;0
12578;144410;612;64;19;1;18;.947;3600000;0
12578;156221;620;65;40;4;36;.900;3600000;0
12578;156298;620;0;0;0;0;.00nan;0;0
12578;156322;612;0;0;0;0;.00nan;0;0
948;2140;622;0;0;0;0;.00nan;0;0
948;84525;2308;100;32;1;31;.969;3600000;0
948;143036;622;65;23;2;21;.913;3542000;0
948;144421;2308;0;0;0;0;.00nan;0;0
949;168021;619;0;0;0;0;.00nan;0;0
949;178911;2310;0;0;0;0;.00nan;0;0
949;179350;2310;100;35;1;34;.971;4012000;0
949;90734;619;72;27;2;25;.926;4012000;0
950;175651;2319;82;40;3;37;.925;3600000;0
950;73699;2319;0;0;0;0;.00nan;0;0
950;156221;620;0;0;0;0;.00nan;0;0
950;156298;620;95;19;0;19;1.000;3600000;0
951;192776;611;47;38;6;32;.842;3600000;0
951;186520;617;74;28;3;25;.893;3600000;0
951;202587;617;0;0;0;0;.00nan;0;0
951;95925;611;0;0;0;0;.00nan;0;0
952;2140;622;0;0;0;0;.00nan;0;0
952;84525;2308;85;42;3;39;.929;3778000;0
952;143036;622;65;21;2;19;.905;3778000;0
952;144421;2308;0;0;0;0;.00nan;0;0
953;168021;619;77;25;1;24;.960;3600000;0
953;178911;2310;0;0;0;0;.00nan;0;0
953;179350;2310;79;49;5;44;.898;3600000;0
953;90734;619;0;0;0;0;.00nan;0;0
954;175651;2319;83;47;4;43;.915;3800000;0
954;73699;2319;0;0;0;0;.00nan;0;0
954;156221;620;0;0;0;0;.00nan;0;0
954;156298;620;63;21;3;18;.857;3800000;0
955;192776;611;58;26;4;22;.846;4200000;0
955;186520;617;50;32;4;28;.875;4200000;0
955;202587;617;0;0;0;0;.00nan;0;0
955;95925;611;0;0;0;0;.00nan;0;0
956;2140;622;0;0;0;0;.00nan;0;0
956;84525;2308;12;27;7;20;.741;2056000;0
956;143036;622;66;27;3;24;.889;3600000;0
956;144421;2308;79;23;1;22;.957;1544000;0
957;168021;619;75;29;2;27;.931;3580000;0
957;178911;2310;0;0;0;0;.00nan;0;0
957;179350;2310;84;28;1;27;.964;3600000;0
957;90734;619;0;0;0;0;.00nan;0;0
958;175651;2319;23;6;3;3;.500;441000;0
958;73699;2319;84;30;2;28;.933;3159000;0
958;156221;620;0;0;0;0;.00nan;0;0
958;156298;620;67;20;2;18;.900;3600000;0
959;192776;611;76;35;3;32;.914;3600000;0
959;186520;617;80;39;4;35;.897;3552000;0
959;202587;617;0;0;0;0;.00nan;0;0
959;95925;611;0;0;0;0;.00nan;0;0
960;2140;622;0;0;0;0;.00nan;0;0
960;84525;2308;56;35;4;31;.886;4200000;0
960;143036;622;75;34;4;30;.882;4200000;0
960;144421;2308;0;0;0;0;.00nan;0;0
961;168021;619;65;24;2;22;.917;3600000;0
961;178911;2310;0;0;0;0;.00nan;0;0
961;179350;2310;46;33;5;28;.848;3600000;0
961;90734;619;0;0;0;0;.00nan;0;0
962;175651;2319;57;34;4;30;.882;3600000;0
962;73699;2319;0;0;0;0;.00nan;0;0
962;156221;620;0;0;0;0;.00nan;0;0
962;156298;620;63;16;1;15;.938;3600000;0
963;192776;611;97;39;2;37;.949;3600000;0
963;186520;617;60;27;3;24;.889;3600000;0
963;202587;617;0;0;0;0;.00nan;0;0
963;95925;611;0;0;0;0;.00nan;0;0
1319;2140;622;0;0;0;0;.00nan;0;0
1319;84525;2308;88;36;2;34;.944;3600000;0
1319;143036;622;100;19;0;19;1.000;3600000;0
1319;144421;2308;0;0;0;0;.00nan;0;0
1320;168021;619;90;42;2;40;.952;3562000;0
1320;178911;2310;0;0;0;0;.00nan;0;0
1320;179350;2310;94;22;0;22;1.000;3600000;0
1320;90734;619;0;0;0;0;.00nan;0;0
1321;192776;611;79;39;3;36;.923;4200000;0
1321;186520;617;72;32;3;29;.906;4200000;0
1321;202587;617;0;0;0;0;.00nan;0;0
1321;95925;611;0;0;0;0;.00nan;0;0
1424;168021;619;74;31;2;29;.935;3600000;0
1424;178911;2310;77;19;0;19;1.000;1264000;0
1424;179350;2310;25;24;6;18;.750;2336000;0
1424;90734;619;0;0;0;0;.00nan;0;0
1425;192776;611;84;42;1;41;.976;4200000;0
1425;186520;617;82;24;1;23;.958;4200000;0
1425;202587;617;0;0;0;0;.00nan;0;0
1425;95925;611;0;0;0;0;.00nan;0;0
1486;168021;619;100;33;0;33;1.000;3600000;0
1486;178911;2310;0;0;0;0;.00nan;0;0
1486;179350;2310;47;31;5;26;.839;3600000;0
1486;90734;619;0;0;0;0;.00nan;0;0
1487;192776;611;31;29;6;23;.793;3600000;0
1487;186520;617;79;21;1;20;.952;3600000;0
1487;202587;617;0;0;0;0;.00nan;0;0
1487;95925;611;0;0;0;0;.00nan;0;0
1510;2140;622;0;0;0;0;.00nan;0;0
1510;186520;617;69;46;5;41;.891;3600000;0
1510;202587;617;0;0;0;0;.00nan;0;0
1510;143036;622;68;21;1;20;.952;3600000;0
1511;168021;619;74;32;2;30;.938;3552000;0
1511;90734;619;0;0;0;0;.00nan;0;0
1511;156221;620;0;0;0;0;.00nan;0;0
1511;156298;620;100;40;1;39;.975;3600000;0
1512;2140;622;0;0;0;0;.00nan;0;0
1512;186520;617;55;39;5;34;.872;3600000;0
1512;202587;617;0;0;0;0;.00nan;0;0
1512;143036;622;43;19;3;16;.842;3600000;0
1513;168021;619;69;30;2;28;.933;4200000;0
1513;90734;619;0;0;0;0;.00nan;0;0
1513;156221;620;0;0;0;0;.00nan;0;0
1513;156298;620;88;31;2;29;.935;4200000;0
1514;2140;622;0;0;0;0;.00nan;0;0
1514;186520;617;79;33;2;31;.939;3595000;0
1514;202587;617;0;0;0;0;.00nan;0;0
1514;143036;622;90;22;0;22;1.000;3600000;0
1515;168021;619;53;24;4;20;.833;3105000;0
1515;90734;619;46;5;1;4;.800;495000;0
1515;156221;620;0;0;0;0;.00nan;0;0
1515;156298;620;100;29;1;28;.966;3600000;0
1516;2140;622;0;0;0;0;.00nan;0;0
1516;186520;617;20;25;6;19;.760;2347000;0
1516;202587;617;43;16;3;13;.813;1253000;0
1516;143036;622;49;23;4;19;.826;3600000;0
1517;168021;619;46;25;5;20;.800;3600000;0
1517;90734;619;0;0;0;0;.00nan;0;0
1517;156221;620;0;0;0;0;.00nan;0;0
1517;156298;620;69;23;2;21;.913;3600000;0
1820;2140;622;0;0;0;0;.00nan;0;0
1820;143036;622;69;29;3;26;.897;3600000;0
1820;156221;620;0;0;0;0;.00nan;0;0
1820;156298;620;50;33;5;28;.848;3566000;0
1821;2140;622;0;0;0;0;.00nan;0;0
1821;143036;622;56;25;3;22;.880;3600000;0
1821;156221;620;0;0;0;0;.00nan;0;0
1821;156298;620;57;35;4;31;.886;3588000;0
1822;2140;622;0;0;0;0;.00nan;0;0
1822;143036;622;74;31;2;29;.935;3600000;0
1822;156221;620;0;0;0;0;.00nan;0;0
1822;156298;620;49;32;5;27;.844;3600000;0
1823;2140;622;0;0;0;0;.00nan;0;0
1823;143036;622;50;35;6;29;.829;3600000;0
1823;156221;620;0;0;0;0;.00nan;0;0
1823;156298;620;80;36;3;33;.917;3600000;0
1989;2140;622;0;0;0;0;.00nan;0;0
1989;143036;622;81;31;3;28;.903;3659000;0
1989;156221;620;0;0;0;0;.00nan;0;0
1989;156298;620;85;34;2;32;.941;3659000;0
2034;2140;622;0;0;0;0;.00nan;0;0
2034;143036;622;53;25;4;21;.840;3600000;0
2034;156221;620;32;24;5;19;.792;2525000;0
2034;156298;620;21;12;4;8;.667;1075000;0
12579;180738;720;50;14;2;12;.857;3600000;0
12579;185775;720;0;0;0;0;.00nan;0;0
12579;-1;721;0;0;0;0;.00nan;0;0
12579;62469;721;61;31;3;28;.903;3550000;0
12580;175712;717;0;0;0;0;.00nan;0;0
12580;181446;2188;44;34;6;28;.824;3600000;0
12580;-1;2188;0;0;0;0;.00nan;0;0
12580;86283;717;84;27;1;26;.963;3600000;0
12581;168842;2529;71;31;3;28;.903;3594000;0
12581;-1;2529;0;0;0;0;.00nan;0;0
12581;-1;716;0;0;0;0;.00nan;0;0
12581;-1;716;69;22;1;21;.955;3600000;0
12582;182339;715;55;39;4;35;.897;3557000;0
12582;28394;719;0;0;0;0;.00nan;0;0
12582;66721;719;55;25;3;22;.880;3600000;0
12582;160650;715;0;0;0;0;.00nan;0;0
12583;168842;2529;88;22;1;21;.955;3600000;0
12583;-1;2529;0;0;0;0;.00nan;0;0
12583;-1;718;0;0;0;0;.00nan;0;0
12583;-1;718;66;37;4;33;.892;3600000;0
12584;28394;719;0;0;0;0;.00nan;0;0
12584;-1;716;0;0;0;0;.00nan;0;0
12584;-1;716;68;36;3;33;.917;3600000;0
12584;66721;719;61;31;4;27;.871;3559000;0
12585;175712;717;0;0;0;0;.00nan;0;0
12585;-1;721;0;0;0;0;.00nan;0;0
12585;62469;721;98;47;2;45;.957;3600000;0
12585;86283;717;73;23;1;22;.957;3600000;0
12586;182339;715;81;35;2;33;.943;3559000;0
12586;181446;2188;79;14;0;14;1.000;3600000;0
12586;-1;2188;0;0;0;0;.00nan;0;0
12586;160650;715;0;0;0;0;.00nan;0;0
12587;182339;715;44;39;6;33;.846;3645000;0
12587;-1;721;0;0;0;0;.00nan;0;0
12587;62469;721;33;25;7;18;.720;3645000;0
12587;160650;715;0;0;0;0;.00nan;0;0
12588;181446;2188;50;28;4;24;.857;3600000;0
12588;-1;2188;0;0;0;0;.00nan;0;0
12588;-1;716;0;0;0;0;.00nan;0;0
12588;-1;716;49;32;5;27;.844;3559000;0
12589;175712;717;0;0;0;0;.00nan;0;0
12589;180738;720;54;31;4;27;.871;3600000;0
12589;185775;720;0;0;0;0;.00nan;0;0
12589;86283;717;93;32;1;31;.969;3600000;0
12590;28394;719;0;0;0;0;.00nan;0;0
12590;-1;718;0;0;0;0;.00nan;0;0
12590;-1;718;78;23;1;22;.957;3600000;0
12590;66721;719;51;16;2;14;.875;3551000;0
12591;181446;2188;85;18;0;18;1.000;3600000;0
12591;-1;2188;0;0;0;0;.00nan;0;0
12591;-1;718;29;26;6;20;.769;2099000;0
12591;-1;718;46;20;3;17;.850;1501000;0
12592;-1;721;0;0;0;0;.00nan;0;0
12592;-1;716;95;38;1;37;.974;3600000;0
12592;-1;716;0;0;0;0;.00nan;0;0
12592;62469;721;58;23;2;21;.913;3575000;0
12593;168842;2529;54;26;3;23;.885;3600000;0
12593;28394;719;0;0;0;0;.00nan;0;0
12593;-1;2529;0;0;0;0;.00nan;0;0
12593;66721;719;64;18;2;16;.889;3600000;0
12594;182339;715;51;37;5;32;.865;3600000;0
12594;180738;720;70;27;2;25;.926;3600000;0
12594;185775;720;0;0;0;0;.00nan;0;0
12594;160650;715;0;0;0;0;.00nan;0;0
12595;-1;721;53;33;4;29;.879;3600000;0
12595;-1;718;0;0;0;0;.00nan;0;0
12595;-1;718;36;41;6;35;.854;3582000;0
12595;62469;721;0;0;0;0;.00nan;0;0
12596;168842;2529;98;39;2;37;.949;3900000;0
12596;181446;2188;52;19;2;17;.895;3900000;0
12596;-1;2529;0;0;0;0;.00nan;0;0
12596;-1;2188;0;0;0;0;.00nan;0;0
12597;180738;720;50;17;3;14;.824;3600000;0
12597;185775;720;0;0;0;0;.00nan;0;0
12597;-1;716;64;15;1;14;.933;1279000;0
12597;-1;716;21;25;6;19;.760;2321000;0
12598;182339;715;69;50;5;45;.900;3600000;0
12598;175712;717;0;0;0;0;.00nan;0;0
12598;86283;717;53;17;2;15;.882;3600000;0
12598;160650;715;0;0;0;0;.00nan;0;0
12599;180738;720;57;10;1;9;.900;3600000;0
12599;185775;720;0;0;0;0;.00nan;0;0
12599;-1;718;0;0;0;0;.00nan;0;0
12599;-1;718;73;46;4;42;.913;3600000;0
12600;175712;717;0;0;0;0;.00nan;0;0
12600;-1;716;62;38;4;34;.895;3530000;0
12600;-1;716;0;0;0;0;.00nan;0;0
12600;86283;717;61;22;2;20;.909;3600000;0
12601;168842;2529;65;25;2;23;.920;3600000;0
12601;-1;721;0;0;0;0;.00nan;0;0
12601;-1;2529;0;0;0;0;.00nan;0;0
12601;62469;721;62;30;3;27;.900;3567000;0
12602;28394;719;52;27;4;23;.852;3600000;0
12602;181446;2188;97;37;1;36;.973;3600000;0
12602;-1;2188;0;0;0;0;.00nan;0;0
12602;66721;719;0;0;0;0;.00nan;0;0
12603;28394;719;0;0;0;0;.00nan;0;0
12603;-1;721;0;0;0;0;.00nan;0;0
12603;62469;721;69;27;2;25;.926;3572000;0
12603;66721;719;75;28;1;27;.964;3600000;0
12604;168842;2529;88;29;1;28;.966;3600000;0
12604;180738;720;46;30;5;25;.833;3600000;0
12604;185775;720;0;0;0;0;.00nan;0;0
12604;-1;2529;0;0;0;0;.00nan;0;0
12605;175712;717;0;0;0;0;.00nan;0;0
12605;-1;718;0;0;0;0;.00nan;0;0
12605;-1;718;72;37;4;33;.892;3624000;0
12605;86283;717;57;26;3;23;.885;3624000;0
12606;182339;715;80;26;2;24;.923;3600000;0
12606;-1;716;0;0;0;0;.00nan;0;0
12606;-1;716;49;32;5;27;.844;3600000;0
12606;160650;715;0;0;0;0;.00nan;0;0
12607;182339;715;23;25;6;19;.760;2338000;0
12607;-1;718;0;0;0;0;.00nan;0;0
12607;-1;718;65;36;4;32;.889;3600000;0
12607;160650;715;54;7;1;6;.857;1262000;0
12608;181446;2188;97;27;0;27;1.000;3600000;0
12608;-1;721;0;0;0;0;.00nan;0;0
12608;-1;2188;0;0;0;0;.00nan;0;0
12608;62469;721;66;34;3;31;.912;3600000;0
12609;168842;2529;62;27;3;24;.889;3572000;0
12609;175712;717;0;0;0;0;.00nan;0;0
12609;-1;2529;0;0;0;0;.00nan;0;0
12609;86283;717;82;23;2;21;.913;3600000;0
12610;28394;719;0;0;0;0;.00nan;0;0
12610;180738;720;79;31;2;29;.935;3600000;0
12610;185775;720;0;0;0;0;.00nan;0;0
12610;66721;719;76;42;3;39;.929;3545000;0
12611;-1;718;0;0;0;0;.00nan;0;0
12611;-1;718;66;34;3;31;.912;3600000;0
12611;-1;716;0;0;0;0;.00nan;0;0
12611;-1;716;42;30;5;25;.833;3579000;0
12612;180738;720;73;22;1;21;.955;3600000;0
12612;181446;2188;30;8;3;5;.625;440000;0
12612;185775;720;0;0;0;0;.00nan;0;0
12612;-1;2188;75;32;3;29;.906;3160000;0
12613;28394;719;0;0;0;0;.00nan;0;0
12613;175712;717;0;0;0;0;.00nan;0;0
12613;66721;719;61;37;5;32;.865;3600000;0
12613;86283;717;68;29;2;27;.931;3600000;0
12614;182339;715;99;36;1;35;.972;3600000;0
12614;168842;2529;58;25;3;22;.880;3514000;0
12614;-1;2529;0;0;0;0;.00nan;0;0
12614;160650;715;0;0;0;0;.00nan;0;0
12615;168842;2529;93;30;1;29;.967;3600000;0
12615;-1;2529;0;0;0;0;.00nan;0;0
12615;-1;716;15;20;6;14;.700;1873000;0
12615;-1;716;66;10;0;10;1.000;1727000;0
12616;180738;720;93;15;0;15;1.000;3600000;0
12616;185775;720;0;0;0;0;.00nan;0;0
12616;-1;721;0;0;0;0;.00nan;0;0
12616;62469;721;98;52;3;49;.942;3600000;0
12617;175712;717;87;21;0;21;1.000;3600000;0
12617;181446;2188;70;32;2;30;.938;3582000;0
12617;-1;2188;0;0;0;0;.00nan;0;0
12617;86283;717;0;0;0;0;.00nan;0;0
12618;182339;715;49;47;7;40;.851;3600000;0
12618;28394;719;0;0;0;0;.00nan;0;0
12618;66721;719;81;23;1;22;.957;3600000;0
12618;160650;715;0;0;0;0;.00nan;0;0
12619;175712;717;67;29;3;26;.897;3746000;0
12619;-1;721;0;0;0;0;.00nan;0;0
12619;62469;721;79;34;2;32;.941;3746000;0
12619;86283;717;0;0;0;0;.00nan;0;0
12620;182339;715;46;36;6;30;.833;2807000;0
12620;181446;2188;68;28;3;25;.893;3600000;0
12620;-1;2188;0;0;0;0;.00nan;0;0
12620;160650;715;40;12;2;10;.833;793000;0
12621;168842;2529;35;19;4;15;.789;3577000;0
12621;-1;2529;0;0;0;0;.00nan;0;0
12621;-1;718;0;0;0;0;.00nan;0;0
12621;-1;718;76;34;2;32;.941;3600000;0
12622;28394;719;0;0;0;0;.00nan;0;0
12622;-1;716;0;0;0;0;.00nan;0;0
12622;-1;716;54;29;3;26;.897;3573000;0
12622;66721;719;76;27;2;25;.926;3600000;0
12623;28394;719;0;0;0;0;.00nan;0;0
12623;-1;718;0;0;0;0;.00nan;0;0
12623;-1;718;62;28;3;25;.893;3554000;0
12623;66721;719;73;19;1;18;.947;3600000;0
12624;181446;2188;62;27;3;24;.889;3600000;0
12624;-1;2188;0;0;0;0;.00nan;0;0
12624;-1;716;21;25;6;19;.760;2534000;0
12624;-1;716;45;6;1;5;.833;1066000;0
12625;175712;717;0;0;0;0;.00nan;0;0
12625;180738;720;84;40;4;36;.900;3515000;0
12625;185775;720;0;0;0;0;.00nan;0;0
12625;86283;717;82;31;2;29;.935;3600000;0
12626;182339;715;89;50;4;46;.920;3600000;0
12626;-1;721;0;0;0;0;.00nan;0;0
12626;62469;721;100;29;0;29;1.000;3600000;0
12626;160650;715;0;0;0;0;.00nan;0;0
12627;-1;721;0;0;0;0;.00nan;0;0
12627;-1;716;0;0;0;0;.00nan;0;0
12627;-1;716;75;37;3;34;.919;3900000;0
12627;62469;721;70;25;3;22;.880;3900000;0
12628;181446;2188;45;19;3;16;.842;3600000;0
12628;-1;2188;0;0;0;0;.00nan;0;0
12628;-1;718;0;0;0;0;.00nan;0;0
12628;-1;718;59;36;4;32;.889;3600000;0
12629;182339;715;91;44;2;42;.955;3547000;0
12629;180738;720;86;21;1;20;.952;3600000;0
12629;185775;720;0;0;0;0;.00nan;0;0
12629;160650;715;0;0;0;0;.00nan;0;0
12630;168842;2529;47;25;4;21;.840;3600000;0
12630;28394;719;81;26;1;25;.962;3600000;0
12630;-1;2529;0;0;0;0;.00nan;0;0
12630;66721;719;0;0;0;0;.00nan;0;0
12631;-1;721;0;0;0;0;.00nan;0;0
12631;-1;718;0;0;0;0;.00nan;0;0
12631;-1;718;71;38;2;36;.947;3600000;0
12631;62469;721;45;34;5;29;.853;3600000;0
12632;180738;720;63;20;2;18;.900;3600000;0
12632;185775;720;0;0;0;0;.00nan;0;0
12632;-1;716;70;36;3;33;.917;3600000;0
12632;-1;716;0;0;0;0;.00nan;0;0
12633;168842;2529;78;29;2;27;.931;3600000;0
12633;181446;2188;55;22;3;19;.864;3539000;0
12633;-1;2529;0;0;0;0;.00nan;0;0
12633;-1;2188;0;0;0;0;.00nan;0;0
12634;182339;715;68;31;3;28;.903;3900000;0
12634;175712;717;0;0;0;0;.00nan;0;0
12634;86283;717;56;19;3;16;.842;3900000;0
12634;160650;715;0;0;0;0;.00nan;0;0
12635;168842;2529;86;37;3;34;.919;3600000;0
12635;-1;721;48;23;4;19;.826;3545000;0
12635;-1;2529;0;0;0;0;.00nan;0;0
12635;62469;721;0;0;0;0;.00nan;0;0
12636;28394;719;0;0;0;0;.00nan;0;0
12636;181446;2188;26;16;4;12;.750;3549000;0
12636;-1;2188;0;0;0;0;.00nan;0;0
12636;66721;719;72;42;3;39;.929;3600000;0
12637;180738;720;62;15;1;14;.933;3600000;0
12637;185775;720;0;0;0;0;.00nan;0;0
12637;-1;718;0;0;0;0;.00nan;0;0
12637;-1;718;85;42;2;40;.952;3600000;0
12638;175712;717;57;13;1;12;.923;808000;0
12638;-1;716;0;0;0;0;.00nan;0;0
12638;-1;716;56;38;5;33;.868;3600000;0
12638;86283;717;1;12;6;6;.500;2775000;0
12639;175712;717;0;0;0;0;.00nan;0;0
12639;-1;718;0;0;0;0;.00nan;0;0
12639;-1;718;63;43;4;39;.907;3520000;0
12639;86283;717;68;20;2;18;.900;3600000;0
12640;182339;715;93;32;1;31;.969;3600000;0
12640;-1;716;47;28;4;24;.857;3600000;0
12640;-1;716;0;0;0;0;.00nan;0;0
12640;160650;715;0;0;0;0;.00nan;0;0
12641;168842;2529;62;30;4;26;.867;3557000;0
12641;180738;720;79;28;2;26;.929;3600000;0
12641;185775;720;0;0;0;0;.00nan;0;0
12641;-1;2529;0;0;0;0;.00nan;0;0
12642;28394;719;0;0;0;0;.00nan;0;0
12642;-1;721;0;0;0;0;.00nan;0;0
12642;62469;721;66;28;2;26;.929;3600000;0
12642;66721;719;76;31;3;28;.903;3556000;0
12643;181446;2188;95;20;0;20;1.000;3600000;0
12643;-1;721;0;0;0;0;.00nan;0;0
12643;-1;2188;0;0;0;0;.00nan;0;0
12643;62469;721;30;29;6;23;.793;3600000;0
12644;28394;719;0;0;0;0;.00nan;0;0
12644;180738;720;53;16;2;14;.875;3600000;0
12644;185775;720;0;0;0;0;.00nan;0;0
12644;66721;719;63;38;4;34;.895;3582000;0
12645;168842;2529;29;40;8;32;.800;3120000;0
12645;175712;717;0;0;0;0;.00nan;0;0
12645;-1;2529;56;5;0;5;1.000;480000;0
12645;86283;717;74;19;1;18;.947;3600000;0
12646;182339;715;90;32;1;31;.969;3600000;0
12646;-1;718;0;0;0;0;.00nan;0;0
12646;-1;718;39;31;5;26;.839;3600000;0
12646;160650;715;0;0;0;0;.00nan;0;0
12647;-1;718;50;31;4;27;.871;3585000;0
12647;-1;718;0;0;0;0;.00nan;0;0
12647;-1;716;0;0;0;0;.00nan;0;0
12647;-1;716;83;33;2;31;.939;3600000;0
12648;180738;720;55;19;2;17;.895;3600000;0
12648;181446;2188;44;29;5;24;.828;3600000;0
12648;185775;720;0;0;0;0;.00nan;0;0
12648;-1;2188;0;0;0;0;.00nan;0;0
12649;28394;719;49;9;1;8;.889;857000;0
12649;175712;717;0;0;0;0;.00nan;0;0
12649;66721;719;35;38;6;32;.842;2743000;0
12649;86283;717;53;17;2;15;.882;3600000;0
12650;182339;715;70;35;4;31;.886;3580000;0
12650;168842;2529;63;25;2;23;.920;3600000;0
12650;-1;2529;0;0;0;0;.00nan;0;0
12650;160650;715;0;0;0;0;.00nan;0;0
12651;180738;720;74;25;2;23;.920;3600000;0
12651;185775;720;0;0;0;0;.00nan;0;0
12651;-1;721;0;0;0;0;.00nan;0;0
12651;62469;721;51;23;3;20;.870;3575000;0
12652;175712;717;0;0;0;0;.00nan;0;0
12652;181446;2188;100;28;0;28;1.000;3600000;0
12652;-1;2188;0;0;0;0;.00nan;0;0
12652;86283;717;87;31;1;30;.968;3575000;0
12653;168842;2529;88;35;1;34;.971;3555000;0
12653;-1;2529;0;0;0;0;.00nan;0;0
12653;-1;716;0;0;0;0;.00nan;0;0
12653;-1;716;90;20;0;20;1.000;3600000;0
12654;182339;715;55;44;6;38;.864;3649000;0
12654;28394;719;0;0;0;0;.00nan;0;0
12654;66721;719;27;19;5;14;.737;3649000;0
12654;160650;715;0;0;0;0;.00nan;0;0
12655;168842;2529;71;38;3;35;.921;3600000;0
12655;-1;2529;0;0;0;0;.00nan;0;0
12655;-1;718;0;0;0;0;.00nan;0;0
12655;-1;718;78;35;2;33;.943;3600000;0
12656;28394;719;0;0;0;0;.00nan;0;0
12656;-1;716;0;0;0;0;.00nan;0;0
12656;-1;716;62;32;3;29;.906;3600000;0
12656;66721;719;52;28;4;24;.857;3584000;0
12657;175712;717;0;0;0;0;.00nan;0;0
12657;-1;721;0;0;0;0;.00nan;0;0
12657;62469;721;68;38;4;34;.895;3600000;0
12657;86283;717;28;25;6;19;.760;3539000;0
12658;182339;715;65;37;4;33;.892;3567000;0
12658;181446;2188;46;12;2;10;.833;3600000;0
12658;-1;2188;0;0;0;0;.00nan;0;0
12658;160650;715;0;0;0;0;.00nan;0;0
12659;182339;715;73;32;2;30;.938;3600000;0
12659;-1;721;0;0;0;0;.00nan;0;0
12659;62469;721;92;28;1;27;.964;3600000;0
12659;160650;715;0;0;0;0;.00nan;0;0
12660;181446;2188;0;0;0;0;.00nan;0;0
12660;-1;2188;80;34;2;32;.941;3600000;0
12660;-1;716;0;0;0;0;.00nan;0;0
12660;-1;716;69;36;4;32;.889;3566000;0
12661;175712;717;0;0;0;0;.00nan;0;0
12661;180738;720;59;37;4;33;.892;3600000;0
12661;185775;720;0;0;0;0;.00nan;0;0
12661;86283;717;90;31;1;30;.968;3600000;0
12662;28394;719;0;0;0;0;.00nan;0;0
12662;-1;718;90;34;2;32;.941;2815000;0
12662;-1;718;21;10;4;6;.600;785000;0
12662;66721;719;64;26;2;24;.923;3600000;0
12663;181446;2188;75;18;1;17;.944;3600000;0
12663;-1;2188;0;0;0;0;.00nan;0;0
12663;-1;718;0;0;0;0;.00nan;0;0
12663;-1;718;51;23;2;21;.913;3550000;0
12664;-1;721;0;0;0;0;.00nan;0;0
12664;-1;716;86;19;0;19;1.000;3600000;0
12664;-1;716;0;0;0;0;.00nan;0;0
12664;62469;721;70;38;4;34;.895;3600000;0
12665;168842;2529;63;26;3;23;.885;3600000;0
12665;28394;719;0;0;0;0;.00nan;0;0
12665;-1;2529;0;0;0;0;.00nan;0;0
12665;66721;719;75;29;2;27;.931;3600000;0
12666;182339;715;0;0;0;0;.00nan;0;0
12666;180738;720;74;19;1;18;.947;3600000;0
12666;185775;720;0;0;0;0;.00nan;0;0
12666;160650;715;68;45;5;40;.889;3600000;0
12667;-1;721;95;35;1;34;.971;3600000;0
12667;-1;718;0;0;0;0;.00nan;0;0
12667;-1;718;41;30;5;25;.833;3600000;0
12667;62469;721;0;0;0;0;.00nan;0;0
12668;168842;2529;75;40;3;37;.925;3600000;0
12668;181446;2188;35;26;5;21;.808;3557000;0
12668;-1;2529;0;0;0;0;.00nan;0;0
12668;-1;2188;0;0;0;0;.00nan;0;0
12669;180738;720;0;0;0;0;.00nan;0;0
12669;185775;720;84;13;0;13;1.000;3600000;0
12669;-1;716;85;28;1;27;.964;3600000;0
12669;-1;716;0;0;0;0;.00nan;0;0
12670;182339;715;60;51;6;45;.882;3600000;0
12670;175712;717;46;16;3;13;.813;3600000;0
12670;86283;717;0;0;0;0;.00nan;0;0
12670;160650;715;0;0;0;0;.00nan;0;0
12671;180738;720;0;0;0;0;.00nan;0;0
12671;185775;720;100;26;0;26;1.000;3600000;0
12671;-1;718;0;0;0;0;.00nan;0;0
12671;-1;718;37;34;6;28;.824;3600000;0
12672;175712;717;0;0;0;0;.00nan;0;0
12672;-1;716;0;0;0;0;.00nan;0;0
12672;-1;716;94;40;2;38;.950;3600000;0
12672;86283;717;53;19;3;16;.842;3600000;0
12673;168842;2529;62;28;3;25;.893;3600000;0
12673;-1;721;0;0;0;0;.00nan;0;0
12673;-1;2529;0;0;0;0;.00nan;0;0
12673;62469;721;52;36;5;31;.861;3549000;0
12674;28394;719;0;0;0;0;.00nan;0;0
12674;181446;2188;41;22;4;18;.818;3569000;0
12674;-1;2188;0;0;0;0;.00nan;0;0
12674;66721;719;66;33;3;30;.909;3600000;0
12675;28394;719;0;0;0;0;.00nan;0;0
12675;-1;721;0;0;0;0;.00nan;0;0
12675;62469;721;60;32;4;28;.875;3600000;0
12675;66721;719;100;24;0;24;1.000;3600000;0
12676;168842;2529;61;30;3;27;.900;3656000;0
12676;180738;720;0;0;0;0;.00nan;0;0
12676;185775;720;49;16;2;14;.875;3656000;0
12676;-1;2529;0;0;0;0;.00nan;0;0
12677;175712;717;0;0;0;0;.00nan;0;0
12677;-1;718;69;15;0;15;1.000;1087000;0
12677;-1;718;34;37;6;31;.838;2513000;0
12677;86283;717;79;15;1;14;.933;3600000;0
12678;182339;715;45;39;6;33;.846;2745000;0
12678;-1;716;30;25;6;19;.760;3600000;0
12678;-1;716;0;0;0;0;.00nan;0;0
12678;160650;715;49;15;2;13;.867;832000;0
12679;182339;715;52;31;5;26;.839;3595000;0
12679;-1;718;58;30;3;27;.900;3600000;0
12679;-1;718;0;0;0;0;.00nan;0;0
12679;160650;715;0;0;0;0;.00nan;0;0
12680;181446;2188;44;21;4;17;.810;3600000;0
12680;-1;721;0;0;0;0;.00nan;0;0
12680;-1;2188;0;0;0;0;.00nan;0;0
12680;62469;721;55;32;5;27;.844;3600000;0
12681;168842;2529;48;35;5;30;.857;3600000;0
12681;175712;717;0;0;0;0;.00nan;0;0
12681;-1;2529;0;0;0;0;.00nan;0;0
12681;86283;717;80;29;1;28;.966;3600000;0
12682;28394;719;0;0;0;0;.00nan;0;0
12682;180738;720;100;42;1;41;.976;3682000;0
12682;185775;720;0;0;0;0;.00nan;0;0
12682;66721;719;65;21;2;19;.905;3682000;0
12683;-1;718;0;0;0;0;.00nan;0;0
12683;-1;718;53;44;5;39;.886;3600000;0
12683;-1;716;0;0;0;0;.00nan;0;0
12683;-1;716;88;36;1;35;.972;3600000;0
12684;180738;720;91;34;2;32;.941;3600000;0
12684;181446;2188;26;23;6;17;.739;3600000;0
12684;185775;720;0;0;0;0;.00nan;0;0
12684;-1;2188;0;0;0;0;.00nan;0;0
12685;28394;719;0;0;0;0;.00nan;0;0
12685;175712;717;0;0;0;0;.00nan;0;0
12685;66721;719;58;46;7;39;.848;3600000;0
12685;86283;717;79;26;2;24;.923;3600000;0
12686;182339;715;42;26;4;22;.846;3545000;0
12686;168842;2529;83;33;2;31;.939;3600000;0
12686;-1;2529;0;0;0;0;.00nan;0;0
12686;160650;715;0;0;0;0;.00nan;0;0
12687;168842;2529;75;36;3;33;.917;3600000;0
12687;-1;2529;0;0;0;0;.00nan;0;0
12687;-1;716;0;0;0;0;.00nan;0;0
12687;-1;716;77;45;4;41;.911;3543000;0
12688;180738;720;77;31;2;29;.935;3600000;0
12688;185775;720;0;0;0;0;.00nan;0;0
12688;-1;721;0;0;0;0;.00nan;0;0
12688;62469;721;38;36;7;29;.806;3600000;0
12689;175712;717;0;0;0;0;.00nan;0;0
12689;181446;2188;84;39;3;36;.923;3570000;0
12689;-1;2188;0;0;0;0;.00nan;0;0
12689;86283;717;72;20;1;19;.950;3600000;0
12690;182339;715;97;42;2;40;.952;3759000;0
12690;28394;719;0;0;0;0;.00nan;0;0
12690;66721;719;56;26;3;23;.885;3759000;0
12690;160650;715;0;0;0;0;.00nan;0;0
12691;175712;717;0;0;0;0;.00nan;0;0
12691;-1;721;0;0;0;0;.00nan;0;0
12691;62469;721;72;38;3;35;.921;3561000;0
12691;86283;717;70;20;2;18;.900;3600000;0
12692;182339;715;60;34;4;30;.882;3600000;0
12692;181446;2188;80;27;1;26;.963;3600000;0
12692;-1;2188;0;0;0;0;.00nan;0;0
12692;160650;715;0;0;0;0;.00nan;0;0
12693;168842;2529;0;0;0;0;.00nan;0;0
12693;-1;2529;28;17;4;13;.765;3595000;0
12693;-1;718;0;0;0;0;.00nan;0;0
12693;-1;718;94;48;3;45;.938;3600000;0
12694;28394;719;62;32;3;29;.906;3600000;0
12694;-1;716;53;2;0;2;1.000;531000;0
12694;-1;716;27;27;6;21;.778;3069000;0
12694;66721;719;0;0;0;0;.00nan;0;0
12695;28394;719;0;0;0;0;.00nan;0;0
12695;-1;718;0;0;0;0;.00nan;0;0
12695;-1;718;75;34;2;32;.941;3570000;0
12695;66721;719;79;25;1;24;.960;3600000;0
12696;181446;2188;54;22;2;20;.909;3900000;0
12696;-1;2188;0;0;0;0;.00nan;0;0
12696;-1;716;72;28;2;26;.929;3900000;0
12696;-1;716;0;0;0;0;.00nan;0;0
12697;175712;717;0;0;0;0;.00nan;0;0
12697;180738;720;45;27;4;23;.852;3600000;0
12697;185775;720;0;0;0;0;.00nan;0;0
12697;86283;717;82;27;1;26;.963;3600000;0
12698;182339;715;77;49;5;44;.898;3597000;0
12698;-1;721;0;0;0;0;.00nan;0;0
12698;62469;721;59;25;3;22;.880;3600000;0
12698;160650;715;0;0;0;0;.00nan;0;0
12699;-1;721;60;30;3;27;.900;3592000;0
12699;-1;716;0;0;0;0;.00nan;0;0
12699;-1;716;71;16;1;15;.938;3600000;0
12699;62469;721;0;0;0;0;.00nan;0;0
12700;181446;2188;0;0;0;0;.00nan;0;0
12700;-1;2188;74;13;0;13;1.000;3600000;0
12700;-1;718;0;0;0;0;.00nan;0;0
12700;-1;718;42;41;6;35;.854;3600000;0
12701;182339;715;43;27;5;22;.815;3515000;0
12701;180738;720;75;33;3;30;.909;3600000;0
12701;185775;720;0;0;0;0;.00nan;0;0
12701;160650;715;0;0;0;0;.00nan;0;0
12702;168842;2529;50;28;4;24;.857;3600000;0
12702;28394;719;0;0;0;0;.00nan;0;0
12702;-1;2529;0;0;0;0;.00nan;0;0
12702;66721;719;72;21;1;20;.952;3600000;0
12703;-1;721;0;0;0;0;.00nan;0;0
12703;-1;718;0;0;0;0;.00nan;0;0
12703;-1;718;71;36;3;33;.917;3600000;0
12703;62469;721;74;29;2;27;.931;3600000;0
12704;180738;720;65;32;3;29;.906;3579000;0
12704;185775;720;0;0;0;0;.00nan;0;0
12704;-1;716;0;0;0;0;.00nan;0;0
12704;-1;716;79;26;1;25;.962;3600000;0
12705;168842;2529;85;33;2;31;.939;3600000;0
12705;181446;2188;0;0;0;0;.00nan;0;0
12705;-1;2529;0;0;0;0;.00nan;0;0
12705;-1;2188;42;18;3;15;.833;3565000;0
12706;182339;715;60;40;5;35;.875;3600000;0
12706;175712;717;0;0;0;0;.00nan;0;0
12706;86283;717;90;19;0;19;1.000;3600000;0
12706;160650;715;0;0;0;0;.00nan;0;0
12707;168842;2529;67;27;2;25;.926;3900000;0
12707;-1;721;0;0;0;0;.00nan;0;0
12707;-1;2529;0;0;0;0;.00nan;0;0
12707;62469;721;97;39;2;37;.949;3900000;0
12708;28394;719;0;0;0;0;.00nan;0;0
12708;181446;2188;82;17;0;17;1.000;3600000;0
12708;-1;2188;0;0;0;0;.00nan;0;0
12708;66721;719;38;33;5;28;.848;3600000;0
12709;180738;720;0;0;0;0;.00nan;0;0
12709;185775;720;36;11;3;8;.727;3600000;0
12709;-1;718;0;0;0;0;.00nan;0;0
12709;-1;718;44;37;6;31;.838;3600000;0
12710;175712;717;0;0;0;0;.00nan;0;0
12710;-1;716;92;34;1;33;.971;3600000;0
12710;-1;716;0;0;0;0;.00nan;0;0
12710;86283;717;65;40;4;36;.900;3600000;0
12711;175712;717;0;0;0;0;.00nan;0;0
12711;-1;718;0;0;0;0;.00nan;0;0
12711;-1;718;65;33;3;30;.909;3824000;0
12711;86283;717;45;22;4;18;.818;3824000;0
12712;182339;715;71;41;3;38;.927;3600000;0
12712;-1;716;0;0;0;0;.00nan;0;0
12712;-1;716;68;25;2;23;.920;3600000;0
12712;160650;715;0;0;0;0;.00nan;0;0
12713;168842;2529;82;32;1;31;.969;3600000;0
12713;180738;720;44;22;4;18;.818;3600000;0
12713;185775;720;0;0;0;0;.00nan;0;0
12713;-1;2529;0;0;0;0;.00nan;0;0
12714;28394;719;71;42;5;37;.881;3539000;0
12714;-1;721;0;0;0;0;.00nan;0;0
12714;62469;721;56;29;3;26;.897;3600000;0
12714;66721;719;0;0;0;0;.00nan;0;0
12715;181446;2188;77;27;2;25;.926;3600000;0
12715;-1;721;0;0;0;0;.00nan;0;0
12715;-1;2188;0;0;0;0;.00nan;0;0
12715;62469;721;82;26;1;25;.962;3600000;0
12716;28394;719;0;0;0;0;.00nan;0;0
12716;180738;720;90;32;1;31;.969;3600000;0
12716;185775;720;0;0;0;0;.00nan;0;0
12716;66721;719;41;25;4;21;.840;3600000;0
12717;168842;2529;54;34;5;29;.853;3600000;0
12717;175712;717;0;0;0;0;.00nan;0;0
12717;-1;2529;0;0;0;0;.00nan;0;0
12717;86283;717;77;25;2;23;.920;3600000;0
12718;182339;715;15;28;7;21;.750;3600000;0
12718;-1;718;0;0;0;0;.00nan;0;0
12718;-1;718;65;17;1;16;.941;3600000;0
12718;160650;715;0;0;0;0;.00nan;0;0
12719;-1;718;0;0;0;0;.00nan;0;0
12719;-1;718;67;53;6;47;.887;3600000;0
12719;-1;716;0;0;0;0;.00nan;0;0
12719;-1;716;50;22;3;19;.864;3600000;0
12720;180738;720;0;0;0;0;.00nan;0;0
12720;181446;2188;50;23;4;19;.826;3576000;0
12720;185775;720;54;23;3;20;.870;3600000;0
12720;-1;2188;0;0;0;0;.00nan;0;0
12721;182339;715;73;34;3;31;.912;3555000;0
12721;168842;2529;85;40;2;38;.950;3600000;0
12721;-1;2529;0;0;0;0;.00nan;0;0
12721;160650;715;0;0;0;0;.00nan;0;0
12722;28394;719;61;31;3;28;.903;3588000;0
12722;175712;717;0;0;0;0;.00nan;0;0
12722;66721;719;0;0;0;0;.00nan;0;0
12722;86283;717;65;22;2;20;.909;3600000;0
12724;181446;2188;23;26;6;20;.769;2860000;0
12724;-1;721;0;0;0;0;.00nan;0;0
12724;-1;2188;59;7;0;7;1.000;736000;0
12724;62469;721;33;23;5;18;.783;3600000;0
12726;182339;715;64;35;3;32;.914;3900000;0
12726;168842;2529;69;28;3;25;.893;3900000;0
12726;-1;2529;0;0;0;0;.00nan;0;0
12726;160650;715;0;0;0;0;.00nan;0;0
12728;180738;720;100;27;0;27;1.000;3600000;0
12728;185775;720;0;0;0;0;.00nan;0;0
12728;-1;718;0;0;0;0;.00nan;0;0
12728;-1;718;64;25;2;23;.920;3574000;0
12732;168842;2529;68;26;2;24;.923;3588000;0
12732;28394;719;0;0;0;0;.00nan;0;0
12732;-1;2529;0;0;0;0;.00nan;0;0
12732;66721;719;57;14;1;13;.929;3600000;0
12734;-1;721;79;33;2;31;.939;3595000;0
12734;-1;716;68;23;1;22;.957;3600000;0
12734;-1;716;0;0;0;0;.00nan;0;0
12734;62469;721;0;0;0;0;.00nan;0;0
12738;182339;715;86;39;2;37;.949;3537000;0
12738;180738;720;93;19;0;19;1.000;3600000;0
12738;185775;720;0;0;0;0;.00nan;0;0
12738;160650;715;0;0;0;0;.00nan;0;0
12740;-1;721;0;0;0;0;.00nan;0;0
12740;-1;716;0;0;0;0;.00nan;0;0
12740;-1;716;74;27;1;26;.963;3600000;0
12740;62469;721;57;26;3;23;.885;3593000;0
12742;168842;2529;0;0;0;0;.00nan;0;0
12742;181446;2188;85;32;2;30;.938;3900000;0
12742;-1;2529;72;29;2;27;.931;3900000;0
12742;-1;2188;0;0;0;0;.00nan;0;0
12746;180738;720;67;18;2;16;.889;3900000;0
12746;185775;720;0;0;0;0;.00nan;0;0
12746;-1;718;62;28;2;26;.929;3900000;0
12746;-1;718;0;0;0;0;.00nan;0;0
12748;28394;719;0;0;0;0;.00nan;0;0
12748;181446;2188;93;35;1;34;.971;3600000;0
12748;-1;2188;0;0;0;0;.00nan;0;0
12748;66721;719;66;30;3;27;.900;3548000;0
12750;180738;720;0;0;0;0;.00nan;0;0
12750;185775;720;76;26;1;25;.962;3600000;0
12750;-1;716;61;28;3;25;.893;3514000;0
12750;-1;716;0;0;0;0;.00nan;0;0
12752;175712;717;0;0;0;0;.00nan;0;0
12752;-1;718;0;0;0;0;.00nan;0;0
12752;-1;718;87;38;2;36;.947;3546000;0
12752;86283;717;90;29;1;28;.966;3600000;0
12754;168842;2529;47;40;6;34;.850;2887000;0
12754;-1;721;0;0;0;0;.00nan;0;0
12754;-1;2529;41;4;1;3;.750;713000;0
12754;62469;721;57;29;3;26;.897;3600000;0
12756;182339;715;81;32;1;31;.969;3900000;0
12756;-1;716;0;0;0;0;.00nan;0;0
12756;-1;716;61;20;1;19;.950;3900000;0
12756;160650;715;0;0;0;0;.00nan;0;0
12758;28394;719;77;40;4;36;.900;3900000;0
12758;181446;2188;0;0;0;0;.00nan;0;0
12758;-1;2188;68;33;4;29;.879;3900000;0
12758;66721;719;0;0;0;0;.00nan;0;0
12760;180738;720;61;14;1;13;.929;3600000;0
12760;185775;720;0;0;0;0;.00nan;0;0
12760;-1;718;80;35;2;33;.943;3600000;0
12760;-1;718;0;0;0;0;.00nan;0;0
536;28394;719;0;0;0;0;.00nan;0;0
536;180738;720;100;22;0;22;1.000;3600000;0
536;185775;720;0;0;0;0;.00nan;0;0
536;66721;719;57;32;3;29;.906;3600000;0
537;181446;2188;29;21;5;16;.762;3580000;0
537;-1;2188;0;0;0;0;.00nan;0;0
537;-1;716;0;0;0;0;.00nan;0;0
537;-1;716;55;30;4;26;.867;3600000;0
538;28394;719;0;0;0;0;.00nan;0;0
538;175712;717;0;0;0;0;.00nan;0;0
538;66721;719;74;35;3;32;.914;3600000;0
538;86283;717;100;28;0;28;1.000;3600000;0
539;180738;720;94;38;2;36;.947;3618000;0
539;181446;2188;74;23;1;22;.957;3618000;0
539;185775;720;0;0;0;0;.00nan;0;0
539;-1;2188;0;0;0;0;.00nan;0;0
540;175712;717;0;0;0;0;.00nan;0;0
540;-1;716;0;0;0;0;.00nan;0;0
540;-1;716;47;29;4;25;.862;3558000;0
540;86283;717;69;32;3;29;.906;3600000;0
541;28394;719;0;0;0;0;.00nan;0;0
541;181446;2188;34;28;5;23;.821;3600000;0
541;-1;2188;0;0;0;0;.00nan;0;0
541;66721;719;75;31;2;29;.935;3600000;0
542;175712;717;58;23;3;20;.870;3600000;0
542;181446;2188;48;31;5;26;.839;3581000;0
542;-1;2188;0;0;0;0;.00nan;0;0
542;86283;717;0;0;0;0;.00nan;0;0
543;180738;720;79;29;2;27;.931;3600000;0
543;185775;720;0;0;0;0;.00nan;0;0
543;-1;716;56;28;3;25;.893;3600000;0
543;-1;716;0;0;0;0;.00nan;0;0
544;175712;717;0;0;0;0;.00nan;0;0
544;180738;720;78;25;1;24;.960;3600000;0
544;185775;720;0;0;0;0;.00nan;0;0
544;86283;717;73;37;3;34;.919;3560000;0
545;28394;719;52;2;0;2;1.000;404000;0
545;-1;716;0;0;0;0;.00nan;0;0
545;-1;716;95;31;1;30;.968;3600000;0
545;66721;719;49;38;6;32;.842;3196000;0
546;28394;719;0;0;0;0;.00nan;0;0
546;180738;720;71;25;2;23;.920;3600000;0
546;185775;720;0;0;0;0;.00nan;0;0
546;66721;719;50;35;5;30;.857;3600000;0
547;181446;2188;0;0;0;0;.00nan;0;0
547;-1;2188;96;20;0;20;1.000;3600000;0
547;-1;716;0;0;0;0;.00nan;0;0
547;-1;716;70;17;1;16;.941;3599000;0
548;28394;719;0;0;0;0;.00nan;0;0
548;175712;717;0;0;0;0;.00nan;0;0
548;66721;719;81;39;3;36;.923;3600000;0
548;86283;717;31;26;5;21;.808;3561000;0
549;180738;720;60;28;3;25;.893;3600000;0
549;181446;2188;0;0;0;0;.00nan;0;0
549;185775;720;0;0;0;0;.00nan;0;0
549;-1;2188;52;29;4;25;.862;3563000;0
550;175712;717;0;0;0;0;.00nan;0;0
550;-1;716;0;0;0;0;.00nan;0;0
550;-1;716;65;38;4;34;.895;3559000;0
550;86283;717;76;32;2;30;.938;3600000;0
551;28394;719;0;0;0;0;.00nan;0;0
551;181446;2188;71;42;3;39;.929;3570000;0
551;-1;2188;0;0;0;0;.00nan;0;0
551;66721;719;91;28;1;27;.964;3600000;0
552;175712;717;0;0;0;0;.00nan;0;0
552;181446;2188;75;26;2;24;.923;3600000;0
552;-1;2188;0;0;0;0;.00nan;0;0
552;86283;717;71;30;3;27;.900;3600000;0
553;180738;720;67;22;2;20;.909;3600000;0
553;185775;720;0;0;0;0;.00nan;0;0
553;-1;716;0;0;0;0;.00nan;0;0
553;-1;716;81;48;4;44;.917;3600000;0
554;175712;717;0;0;0;0;.00nan;0;0
554;180738;720;45;11;2;9;.818;3600000;0
554;185775;720;0;0;0;0;.00nan;0;0
554;86283;717;43;34;5;29;.853;3600000;0
555;28394;719;0;0;0;0;.00nan;0;0
555;-1;716;75;39;3;36;.923;3600000;0
555;-1;716;0;0;0;0;.00nan;0;0
555;66721;719;27;29;6;23;.793;3600000;0
556;182339;715;34;14;4;10;.714;1143000;0
556;168842;2529;58;17;3;14;.824;3600000;0
556;-1;2529;0;0;0;0;.00nan;0;0
556;160650;715;64;24;2;22;.917;2457000;0
557;-1;721;0;0;0;0;.00nan;0;0
557;-1;718;39;22;4;18;.818;3600000;0
557;-1;718;0;0;0;0;.00nan;0;0
557;62469;721;66;21;1;20;.952;3600000;0
558;168842;2529;50;28;4;24;.857;3552000;0
558;-1;2529;0;0;0;0;.00nan;0;0
558;-1;718;0;0;0;0;.00nan;0;0
558;-1;718;92;39;2;37;.949;3600000;0
559;182339;715;92;38;1;37;.974;3667000;0
559;-1;721;0;0;0;0;.00nan;0;0
559;62469;721;80;28;2;26;.929;3667000;0
559;160650;715;0;0;0;0;.00nan;0;0
560;168842;2529;66;25;2;23;.920;3600000;0
560;-1;721;0;0;0;0;.00nan;0;0
560;-1;2529;0;0;0;0;.00nan;0;0
560;62469;721;52;34;5;29;.853;3600000;0
561;182339;715;0;0;0;0;.00nan;0;0
561;-1;718;0;0;0;0;.00nan;0;0
561;-1;718;74;28;2;26;.929;3600000;0
561;160650;715;79;44;3;41;.932;3549000;0
562;182339;715;73;48;5;43;.896;3648000;0
562;168842;2529;52;30;4;26;.867;3648000;0
562;-1;2529;0;0;0;0;.00nan;0;0
562;160650;715;0;0;0;0;.00nan;0;0
563;-1;721;0;0;0;0;.00nan;0;0
563;-1;718;0;0;0;0;.00nan;0;0
563;-1;718;84;36;2;34;.944;3891000;0
563;62469;721;93;35;1;34;.971;3891000;0
564;168842;2529;65;33;4;29;.879;3600000;0
564;-1;2529;0;0;0;0;.00nan;0;0
564;-1;718;0;0;0;0;.00nan;0;0
564;-1;718;45;40;6;34;.850;3596000;0
565;182339;715;69;30;2;28;.933;3600000;0
565;-1;721;0;0;0;0;.00nan;0;0
565;62469;721;64;18;1;17;.944;3600000;0
565;160650;715;0;0;0;0;.00nan;0;0
566;168842;2529;63;34;5;29;.853;3552000;0
566;-1;721;0;0;0;0;.00nan;0;0
566;-1;2529;0;0;0;0;.00nan;0;0
566;62469;721;48;21;3;18;.857;3600000;0
567;182339;715;62;32;4;28;.875;3600000;0
567;-1;718;30;24;5;19;.792;3557000;0
567;-1;718;0;0;0;0;.00nan;0;0
567;160650;715;0;0;0;0;.00nan;0;0
832;180738;720;61;19;2;17;.895;3600000;0
832;185775;720;0;0;0;0;.00nan;0;0
832;-1;718;0;0;0;0;.00nan;0;0
832;-1;718;66;38;4;34;.895;3587000;0
833;175712;717;0;0;0;0;.00nan;0;0
833;-1;721;0;0;0;0;.00nan;0;0
833;62469;721;73;52;5;47;.904;3600000;0
833;86283;717;71;22;1;21;.955;3600000;0
834;168842;2529;18;21;6;15;.714;2731000;0
834;181446;2188;86;41;2;39;.951;3600000;0
834;-1;2529;46;7;1;6;.857;869000;0
834;-1;2188;0;0;0;0;.00nan;0;0
835;28394;719;0;0;0;0;.00nan;0;0
835;-1;716;0;0;0;0;.00nan;0;0
835;-1;716;65;41;4;37;.902;3600000;0
835;66721;719;77;24;1;23;.958;3600000;0
836;180738;720;62;15;1;14;.933;3600000;0
836;185775;720;0;0;0;0;.00nan;0;0
836;-1;718;0;0;0;0;.00nan;0;0
836;-1;718;91;49;5;44;.898;3600000;0
837;175712;717;0;0;0;0;.00nan;0;0
837;-1;721;0;0;0;0;.00nan;0;0
837;62469;721;83;23;1;22;.957;3600000;0
837;86283;717;50;24;4;20;.833;3600000;0
838;168842;2529;96;34;3;31;.912;3542000;0
838;181446;2188;80;25;1;24;.960;3600000;0
838;-1;2529;0;0;0;0;.00nan;0;0
838;-1;2188;0;0;0;0;.00nan;0;0
839;28394;719;0;0;0;0;.00nan;0;0
839;-1;716;0;0;0;0;.00nan;0;0
839;-1;716;100;27;0;27;1.000;3600000;0
839;66721;719;66;32;3;29;.906;3600000;0
840;180738;720;53;16;2;14;.875;4282000;0
840;185775;720;0;0;0;0;.00nan;0;0
840;-1;718;0;0;0;0;.00nan;0;0
840;-1;718;85;33;1;32;.970;4282000;0
841;175712;717;0;0;0;0;.00nan;0;0
841;-1;721;0;0;0;0;.00nan;0;0
841;62469;721;70;24;2;22;.917;3686000;0
841;86283;717;61;29;3;26;.897;3686000;0
842;168842;2529;72;31;3;28;.903;3600000;0
842;181446;2188;89;19;0;19;1.000;3600000;0
842;-1;2529;0;0;0;0;.00nan;0;0
842;-1;2188;0;0;0;0;.00nan;0;0
843;28394;719;0;0;0;0;.00nan;0;0
843;-1;716;0;0;0;0;.00nan;0;0
843;-1;716;93;31;2;29;.935;3560000;0
843;66721;719;71;22;1;21;.955;3600000;0
844;180738;720;59;23;3;20;.870;3547000;0
844;185775;720;0;0;0;0;.00nan;0;0
844;-1;718;0;0;0;0;.00nan;0;0
844;-1;718;85;31;2;29;.935;3600000;0
845;175712;717;0;0;0;0;.00nan;0;0
845;-1;721;0;0;0;0;.00nan;0;0
845;62469;721;94;37;2;35;.946;4136000;0
845;86283;717;71;33;3;30;.909;4136000;0
846;168842;2529;70;30;2;28;.933;3600000;0
846;181446;2188;51;29;4;25;.862;3518000;0
846;-1;2529;0;0;0;0;.00nan;0;0
846;-1;2188;0;0;0;0;.00nan;0;0
847;28394;719;0;0;0;0;.00nan;0;0
847;-1;716;0;0;0;0;.00nan;0;0
847;-1;716;75;24;2;22;.917;3600000;0
847;66721;719;70;29;3;26;.897;3568000;0
1043;180738;720;79;27;2;25;.926;3512000;0
1043;185775;720;0;0;0;0;.00nan;0;0
1043;-1;718;0;0;0;0;.00nan;0;0
1043;-1;718;98;25;0;25;1.000;3600000;0
1044;175712;717;0;0;0;0;.00nan;0;0
1044;-1;721;0;0;0;0;.00nan;0;0
1044;62469;721;66;43;5;38;.884;3592000;0
1044;86283;717;68;28;3;25;.893;3600000;0
1045;168842;2529;98;39;2;37;.949;3600000;0
1045;181446;2188;73;23;1;22;.957;3600000;0
1045;-1;2529;0;0;0;0;.00nan;0;0
1045;-1;2188;0;0;0;0;.00nan;0;0
1046;28394;719;0;0;0;0;.00nan;0;0
1046;-1;716;0;0;0;0;.00nan;0;0
1046;-1;716;92;33;1;32;.970;3600000;0
1046;66721;719;55;42;5;37;.881;3600000;0
1134;180738;720;94;32;1;31;.969;3600000;0
1134;185775;720;0;0;0;0;.00nan;0;0
1134;-1;718;0;0;0;0;.00nan;0;0
1134;-1;718;65;31;4;27;.871;3600000;0
1135;175712;717;0;0;0;0;.00nan;0;0
1135;-1;721;0;0;0;0;.00nan;0;0
1135;62469;721;100;44;1;43;.977;3600000;0
1135;86283;717;76;29;2;27;.931;3571000;0
1136;28394;719;0;0;0;0;.00nan;0;0
1136;-1;716;0;0;0;0;.00nan;0;0
1136;-1;716;82;34;2;32;.941;3600000;0
1136;66721;719;46;27;5;22;.815;3600000;0
1203;180738;720;71;16;1;15;.938;3600000;0
1203;185775;720;0;0;0;0;.00nan;0;0
1203;-1;718;0;0;0;0;.00nan;0;0
1203;-1;718;76;41;3;38;.927;3596000;0
1269;180738;720;90;31;1;30;.968;3600000;0
1269;185775;720;0;0;0;0;.00nan;0;0
1269;-1;721;0;0;0;0;.00nan;0;0
1269;62469;721;73;36;4;32;.889;3600000;0
1270;181446;2188;82;31;2;29;.935;3600000;0
1270;-1;2188;0;0;0;0;.00nan;0;0
1270;-1;716;0;0;0;0;.00nan;0;0
1270;-1;716;45;21;3;18;.857;3551000;0
1271;180738;720;81;30;2;28;.933;3600000;0
1271;185775;720;0;0;0;0;.00nan;0;0
1271;-1;721;0;0;0;0;.00nan;0;0
1271;62469;721;54;26;3;23;.885;3600000;0
1272;181446;2188;63;38;4;34;.895;3600000;0
1272;-1;2188;0;0;0;0;.00nan;0;0
1272;-1;716;0;0;0;0;.00nan;0;0
1272;-1;716;76;26;2;24;.923;3600000;0
1273;180738;720;49;26;4;22;.846;4015000;0
1273;185775;720;0;0;0;0;.00nan;0;0
1273;-1;721;0;0;0;0;.00nan;0;0
1273;62469;721;69;41;5;36;.878;4015000;0
1274;181446;2188;80;48;3;45;.938;4741000;0
1274;-1;2188;0;0;0;0;.00nan;0;0
1274;-1;716;0;0;0;0;.00nan;0;0
1274;-1;716;69;24;2;22;.917;4741000;0
1275;180738;720;35;18;4;14;.778;3682000;0
1275;185775;720;0;0;0;0;.00nan;0;0
1275;-1;721;0;0;0;0;.00nan;0;0
1275;62469;721;60;41;5;36;.878;3671000;0
1276;181446;2188;74;29;3;26;.897;4069000;0
1276;-1;2188;0;0;0;0;.00nan;0;0
1276;-1;716;0;0;0;0;.00nan;0;0
1276;-1;716;76;26;2;24;.923;4069000;0
1540;181446;2188;35;26;5;21;.808;3600000;0
1540;-1;2188;0;0;0;0;.00nan;0;0
1540;-1;716;0;0;0;0;.00nan;0;0
1540;-1;716;75;24;2;22;.917;3600000;0
1578;180738;720;81;24;2;22;.917;3600000;0
1578;185775;720;0;0;0;0;.00nan;0;0
1578;-1;716;0;0;0;0;.00nan;0;0
1578;-1;716;15;23;7;16;.696;3600000;0
1579;180738;720;100;28;0;28;1.000;3600000;0
1579;185775;720;0;0;0;0;.00nan;0;0
1579;-1;716;0;0;0;0;.00nan;0;0
1579;-1;716;81;32;2;30;.938;3600000;0
1580;180738;720;43;38;6;32;.842;3802000;0
1580;185775;720;0;0;0;0;.00nan;0;0
1580;-1;716;0;0;0;0;.00nan;0;0
1580;-1;716;40;42;7;35;.833;3802000;0
1581;180738;720;55;29;4;25;.862;3574000;0
1581;185775;720;0;0;0;0;.00nan;0;0
1581;-1;716;0;0;0;0;.00nan;0;0
1581;-1;716;90;41;2;39;.951;3600000;0
1845;180738;720;55;17;2;15;.882;3600000;0
1845;185775;720;0;0;0;0;.00nan;0;0
1845;-1;716;0;0;0;0;.00nan;0;0
1845;-1;716;74;45;4;41;.911;3554000;0
12763;46139;473;77;31;2;29;.935;3600000;0
12763;66551;474;0;0;0;0;.00nan;0;0
12763;85127;474;86;36;3;33;.917;3586000;0
12763;153779;473;0;0;0;0;.00nan;0;0
12764;163528;490;69;37;3;34;.919;3600000;0
12764;67222;675;67;38;4;34;.895;3579000;0
12764;78422;490;0;0;0;0;.00nan;0;0
12764;142583;675;0;0;0;0;.00nan;0;0
12765;176765;476;96;24;0;24;1.000;3600000;0
12765;-1;480;77;38;2;36;.947;3600000;0
12765;-1;480;0;0;0;0;.00nan;0;0
12765;87894;476;0;0;0;0;.00nan;0;0
12766;199114;4535;0;0;0;0;.00nan;0;0
12766;193870;4535;42;27;5;22;.815;3571000;0
12766;173840;5004;0;0;0;0;.00nan;0;0
12766;171673;5004;68;35;3;32;.914;3600000;0
12767;170042;481;56;32;4;28;.875;3600000;0
12767;24593;676;67;42;5;37;.881;3555000;0
12767;190235;481;0;0;0;0;.00nan;0;0
12767;-1;676;0;0;0;0;.00nan;0;0
12768;193041;482;0;0;0;0;.00nan;0;0
12768;163695;482;77;34;3;31;.912;3600000;0
12768;11500;472;0;0;0;0;.00nan;0;0
12768;71297;472;41;21;4;17;.810;3563000;0
12769;24593;676;63;22;2;20;.909;3543000;0
12769;46139;473;95;39;1;38;.974;3600000;0
12769;-1;676;0;0;0;0;.00nan;0;0
12769;153779;473;0;0;0;0;.00nan;0;0
12770;173823;682;0;0;0;0;.00nan;0;0
12770;-1;480;75;22;1;21;.955;3610000;0
12770;-1;480;0;0;0;0;.00nan;0;0
12770;146184;682;68;23;2;21;.913;3610000;0
12771;173840;5004;0;0;0;0;.00nan;0;0
12771;171673;5004;53;34;5;29;.853;3600000;0
12771;67222;675;0;0;0;0;.00nan;0;0
12771;142583;675;50;22;3;19;.864;3600000;0
12772;193041;482;0;0;0;0;.00nan;0;0
12772;163695;482;93;31;1;30;.968;3600000;0
12772;170042;481;47;23;4;19;.826;3600000;0
12772;190235;481;0;0;0;0;.00nan;0;0
12773;163528;490;43;25;4;21;.840;3557000;0
12773;176765;476;97;36;2;34;.944;3600000;0
12773;78422;490;0;0;0;0;.00nan;0;0
12773;87894;476;0;0;0;0;.00nan;0;0
12774;11500;472;0;0;0;0;.00nan;0;0
12774;66551;474;0;0;0;0;.00nan;0;0
12774;71297;472;39;13;3;10;.769;3600000;0
12774;85127;474;65;48;5;43;.896;3543000;0
12775;173823;682;0;0;0;0;.00nan;0;0
12775;24593;676;63;26;2;24;.923;3545000;0
12775;-1;676;0;0;0;0;.00nan;0;0
12775;146184;682;86;29;1;28;.966;3600000;0
12776;199114;4535;0;0;0;0;.00nan;0;0
12776;193870;4535;73;34;3;31;.912;3600000;0
12776;24593;676;100;31;0;31;1.000;3600000;0
12776;-1;676;0;0;0;0;.00nan;0;0
12777;173840;5004;0;0;0;0;.00nan;0;0
12777;171673;5004;78;30;2;28;.933;3582000;0
12777;46139;473;89;30;1;29;.967;3600000;0
12777;153779;473;0;0;0;0;.00nan;0;0
12778;176765;476;62;16;2;14;.875;3803000;0
12778;67222;675;0;0;0;0;.00nan;0;0
12778;87894;476;0;0;0;0;.00nan;0;0
12778;142583;675;100;38;1;37;.974;3803000;0
12779;193041;482;0;0;0;0;.00nan;0;0
12779;163695;482;49;29;4;25;.862;3522000;0
12779;66551;474;0;0;0;0;.00nan;0;0
12779;85127;474;64;25;2;23;.920;3600000;0
12780;173823;682;58;19;2;17;.895;4020000;0
12780;170042;481;89;37;2;35;.946;4020000;0
12780;190235;481;0;0;0;0;.00nan;0;0
12780;146184;682;0;0;0;0;.00nan;0;0
12781;11500;472;23;27;6;21;.778;3600000;0
12781;-1;480;95;35;1;34;.971;3600000;0
12781;-1;480;0;0;0;0;.00nan;0;0
12781;71297;472;0;0;0;0;.00nan;0;0
12782;170042;481;85;40;2;38;.950;3600000;0
12782;176765;476;42;15;3;12;.800;3590000;0
12782;190235;481;0;0;0;0;.00nan;0;0
12782;87894;476;0;0;0;0;.00nan;0;0
12783;24593;676;76;22;1;21;.955;3600000;0
12783;-1;676;0;0;0;0;.00nan;0;0
12783;66551;474;65;26;2;24;.923;3594000;0
12783;85127;474;0;0;0;0;.00nan;0;0
12784;193041;482;0;0;0;0;.00nan;0;0
12784;163695;482;59;37;5;32;.865;3600000;0
12784;-1;480;93;29;1;28;.966;3600000;0
12784;-1;480;0;0;0;0;.00nan;0;0
12785;199114;4535;43;26;4;22;.846;3543000;0
12785;193870;4535;0;0;0;0;.00nan;0;0
12785;46139;473;77;32;2;30;.938;3600000;0
12785;153779;473;0;0;0;0;.00nan;0;0
12786;11500;472;0;0;0;0;.00nan;0;0
12786;173840;5004;0;0;0;0;.00nan;0;0
12786;171673;5004;60;29;3;26;.897;3600000;0
12786;71297;472;60;36;4;32;.889;3600000;0
12787;163528;490;40;27;5;22;.815;3600000;0
12787;173823;682;0;0;0;0;.00nan;0;0
12787;78422;490;0;0;0;0;.00nan;0;0
12787;146184;682;71;24;2;22;.917;3600000;0
12788;24593;676;79;27;1;26;.963;3553000;0
12788;176765;476;85;22;0;22;1.000;3600000;0
12788;-1;676;0;0;0;0;.00nan;0;0
12788;87894;476;0;0;0;0;.00nan;0;0
12789;46139;473;85;29;1;28;.966;3600000;0
12789;67222;675;0;0;0;0;.00nan;0;0
12789;142583;675;58;25;3;22;.880;3540000;0
12789;153779;473;0;0;0;0;.00nan;0;0
12790;173840;5004;0;0;0;0;.00nan;0;0
12790;170042;481;26;14;4;10;.714;1107000;0
12790;171673;5004;73;27;2;25;.926;3600000;0
12790;190235;481;63;26;2;24;.923;2493000;0
12791;193041;482;0;0;0;0;.00nan;0;0
12791;163695;482;52;29;4;25;.862;3572000;0
12791;199114;4535;0;0;0;0;.00nan;0;0
12791;193870;4535;78;35;2;33;.943;3600000;0
12792;173823;682;0;0;0;0;.00nan;0;0
12792;66551;474;0;0;0;0;.00nan;0;0
12792;85127;474;72;52;5;47;.904;3600000;0
12792;146184;682;55;20;2;18;.900;3600000;0
12793;163528;490;77;35;3;32;.914;3999000;0
12793;11500;472;0;0;0;0;.00nan;0;0
12793;71297;472;78;34;2;32;.941;3999000;0
12793;78422;490;0;0;0;0;.00nan;0;0
12794;193041;482;0;0;0;0;.00nan;0;0
12794;163695;482;74;38;3;35;.921;3600000;0
12794;24593;676;85;17;0;17;1.000;3600000;0
12794;-1;676;0;0;0;0;.00nan;0;0
12795;170042;481;52;43;6;37;.860;4018000;0
12795;190235;481;0;0;0;0;.00nan;0;0
12795;67222;675;0;0;0;0;.00nan;0;0
12795;142583;675;45;31;5;26;.839;4018000;0
12796;11500;472;0;0;0;0;.00nan;0;0
12796;176765;476;50;28;4;24;.857;3549000;0
12796;71297;472;88;36;2;34;.944;3600000;0
12796;87894;476;0;0;0;0;.00nan;0;0
12797;199114;4535;0;0;0;0;.00nan;0;0
12797;193870;4535;99;53;1;52;.981;4020000;0
12797;-1;480;69;22;1;21;.955;4020000;0
12797;-1;480;0;0;0;0;.00nan;0;0
12798;173823;682;0;0;0;0;.00nan;0;0
12798;173840;5004;0;0;0;0;.00nan;0;0
12798;171673;5004;70;26;2;24;.923;3600000;0
12798;146184;682;63;27;3;24;.889;3579000;0
12799;163528;490;86;21;1;20;.952;3600000;0
12799;46139;473;98;52;2;50;.962;3567000;0
12799;78422;490;0;0;0;0;.00nan;0;0
12799;153779;473;0;0;0;0;.00nan;0;0
12800;170042;481;84;37;2;35;.946;3600000;0
12800;190235;481;0;0;0;0;.00nan;0;0
12800;46139;473;78;24;1;23;.958;3600000;0
12800;153779;473;0;0;0;0;.00nan;0;0
12801;-1;480;60;24;3;21;.875;3600000;0
12801;-1;480;0;0;0;0;.00nan;0;0
12801;66551;474;0;0;0;0;.00nan;0;0
12801;85127;474;61;42;5;37;.881;3576000;0
12802;11500;472;0;0;0;0;.00nan;0;0
12802;67222;675;0;0;0;0;.00nan;0;0
12802;71297;472;41;39;7;32;.821;3780000;0
12802;142583;675;35;32;6;26;.813;3780000;0
12803;193041;482;85;33;1;32;.970;1449000;0
12803;163695;482;21;25;6;19;.760;2151000;0
12803;176765;476;69;16;2;14;.875;3600000;0
12803;87894;476;0;0;0;0;.00nan;0;0
12804;163528;490;73;26;2;24;.923;4020000;0
12804;173840;5004;0;0;0;0;.00nan;0;0
12804;171673;5004;75;30;2;28;.933;4013000;0
12804;78422;490;0;0;0;0;.00nan;0;0
12805;199114;4535;0;0;0;0;.00nan;0;0
12805;193870;4535;60;28;3;25;.893;3600000;0
12805;173823;682;0;0;0;0;.00nan;0;0
12805;146184;682;92;19;0;19;1.000;3600000;0
12806;66551;474;0;0;0;0;.00nan;0;0
12806;67222;675;0;0;0;0;.00nan;0;0
12806;85127;474;65;31;2;29;.935;4020000;0
12806;142583;675;66;23;2;21;.913;4020000;0
12807;163528;490;57;22;3;19;.864;3600000;0
12807;199114;4535;0;0;0;0;.00nan;0;0
12807;193870;4535;31;36;6;30;.833;3600000;0
12807;78422;490;0;0;0;0;.00nan;0;0
12808;193041;482;0;0;0;0;.00nan;0;0
12808;163695;482;95;22;0;22;1.000;3600000;0
12808;173840;5004;71;40;4;36;.900;3600000;0
12808;171673;5004;0;0;0;0;.00nan;0;0
12809;170042;481;59;21;2;19;.905;3600000;0
12809;190235;481;0;0;0;0;.00nan;0;0
12809;-1;480;78;29;1;28;.966;3600000;0
12809;-1;480;0;0;0;0;.00nan;0;0
12810;173823;682;0;0;0;0;.00nan;0;0
12810;46139;473;80;39;3;36;.923;3600000;0
12810;146184;682;89;19;0;19;1.000;3600000;0
12810;153779;473;0;0;0;0;.00nan;0;0
12811;11500;472;94;30;1;29;.967;3600000;0
12811;24593;676;56;20;2;18;.900;3600000;0
12811;-1;676;0;0;0;0;.00nan;0;0
12811;71297;472;0;0;0;0;.00nan;0;0
12812;163528;490;68;14;1;13;.929;3600000;0
12812;66551;474;0;0;0;0;.00nan;0;0
12812;78422;490;0;0;0;0;.00nan;0;0
12812;85127;474;71;53;6;47;.887;3600000;0
12813;-1;480;100;28;0;28;1.000;3600000;0
12813;46139;473;30;30;6;24;.800;3600000;0
12813;-1;480;0;0;0;0;.00nan;0;0
12813;153779;473;0;0;0;0;.00nan;0;0
12814;173840;5004;0;0;0;0;.00nan;0;0
12814;171673;5004;83;34;2;32;.941;4020000;0
12814;176765;476;51;15;2;13;.867;4020000;0
12814;87894;476;0;0;0;0;.00nan;0;0
12815;199114;4535;0;0;0;0;.00nan;0;0
12815;193870;4535;88;31;1;30;.968;3546000;0
12815;170042;481;100;26;0;26;1.000;3600000;0
12815;190235;481;0;0;0;0;.00nan;0;0
12816;193041;482;0;0;0;0;.00nan;0;0
12816;163695;482;91;36;1;35;.972;3600000;0
12816;67222;675;0;0;0;0;.00nan;0;0
12816;142583;675;76;25;2;23;.920;3544000;0
12817;163528;490;86;19;0;19;1.000;3600000;0
12817;24593;676;91;49;3;46;.939;3600000;0
12817;-1;676;0;0;0;0;.00nan;0;0
12817;78422;490;0;0;0;0;.00nan;0;0
12818;176765;476;62;23;2;21;.913;3600000;0
12818;46139;473;98;55;3;52;.945;3565000;0
12818;87894;476;0;0;0;0;.00nan;0;0
12818;153779;473;0;0;0;0;.00nan;0;0
12819;-1;480;57;31;4;27;.871;3571000;0
12819;-1;480;0;0;0;0;.00nan;0;0
12819;67222;675;0;0;0;0;.00nan;0;0
12819;142583;675;48;22;3;19;.864;3600000;0
12820;199114;4535;73;22;2;20;.909;3600000;0
12820;193870;4535;0;0;0;0;.00nan;0;0
12820;66551;474;0;0;0;0;.00nan;0;0
12820;85127;474;44;37;6;31;.838;3600000;0
12821;193041;482;0;0;0;0;.00nan;0;0
12821;163695;482;65;43;4;39;.907;3600000;0
12821;173823;682;0;0;0;0;.00nan;0;0
12821;146184;682;76;9;0;9;1.000;3600000;0
12822;11500;472;0;0;0;0;.00nan;0;0
12822;170042;481;50;36;5;31;.861;4005000;0
12822;190235;481;0;0;0;0;.00nan;0;0
12822;71297;472;31;31;6;25;.806;4005000;0
12823;176765;476;51;27;4;23;.852;3600000;0
12823;-1;480;56;37;5;32;.865;3559000;0
12823;-1;480;0;0;0;0;.00nan;0;0
12823;87894;476;0;0;0;0;.00nan;0;0
12824;173840;5004;0;0;0;0;.00nan;0;0
12824;171673;5004;86;37;2;35;.946;3600000;0
12824;-1;480;66;14;1;13;.929;3600000;0
12824;-1;480;0;0;0;0;.00nan;0;0
12825;24593;676;40;31;5;26;.839;3600000;0
12825;-1;676;0;0;0;0;.00nan;0;0
12825;67222;675;0;0;0;0;.00nan;0;0
12825;142583;675;65;25;2;23;.920;3600000;0
12826;173823;682;0;0;0;0;.00nan;0;0
12826;176765;476;71;20;1;19;.950;3600000;0
12826;87894;476;0;0;0;0;.00nan;0;0
12826;146184;682;75;30;2;28;.933;3600000;0
12827;199114;4535;0;0;0;0;.00nan;0;0
12827;193870;4535;63;41;5;36;.878;3538000;0
12827;11500;472;0;0;0;0;.00nan;0;0
12827;71297;472;46;21;3;18;.857;3600000;0
12828;193041;482;0;0;0;0;.00nan;0;0
12828;163528;490;79;29;1;28;.966;4020000;0
12828;163695;482;100;54;1;53;.981;4020000;0
12828;78422;490;0;0;0;0;.00nan;0;0
12829;193041;482;0;0;0;0;.00nan;0;0
12829;163695;482;94;44;3;41;.932;3545000;0
12829;46139;473;52;17;2;15;.882;3600000;0
12829;153779;473;0;0;0;0;.00nan;0;0
12830;11500;472;0;0;0;0;.00nan;0;0
12830;173823;682;0;0;0;0;.00nan;0;0
12830;71297;472;65;29;3;26;.897;3600000;0
12830;146184;682;23;20;5;15;.750;3546000;0
12831;176765;476;51;9;1;8;.889;3766000;0
12831;66551;474;92;52;2;50;.962;3766000;0
12831;85127;474;0;0;0;0;.00nan;0;0
12831;87894;476;0;0;0;0;.00nan;0;0
12832;199114;4535;24;32;7;25;.781;2818000;0
12832;193870;4535;16;8;4;4;.500;782000;0
12832;67222;675;79;30;2;28;.933;3600000;0
12832;142583;675;0;0;0;0;.00nan;0;0
12833;173840;5004;0;0;0;0;.00nan;0;0
12833;24593;676;79;35;3;32;.914;3600000;0
12833;171673;5004;50;26;4;22;.846;3600000;0
12833;-1;676;0;0;0;0;.00nan;0;0
12834;163528;490;92;17;0;17;1.000;3600000;0
12834;-1;480;79;32;2;30;.938;3561000;0
12834;-1;480;0;0;0;0;.00nan;0;0
12834;78422;490;0;0;0;0;.00nan;0;0
12835;24593;676;91;28;1;27;.964;3600000;0
12835;-1;480;71;26;2;24;.923;3600000;0
12835;-1;480;0;0;0;0;.00nan;0;0
12835;-1;676;0;0;0;0;.00nan;0;0
12836;173823;682;0;0;0;0;.00nan;0;0
12836;67222;675;0;0;0;0;.00nan;0;0
12836;142583;675;61;20;2;18;.900;3596000;0
12836;146184;682;67;17;1;16;.941;3600000;0
12837;199114;4535;0;0;0;0;.00nan;0;0
12837;193870;4535;66;35;4;31;.886;3820000;0
12837;176765;476;76;32;3;29;.906;3820000;0
12837;87894;476;0;0;0;0;.00nan;0;0
12838;173840;5004;0;0;0;0;.00nan;0;0
12838;171673;5004;62;22;2;20;.909;3600000;0
12838;66551;474;65;31;3;28;.903;3561000;0
12838;85127;474;0;0;0;0;.00nan;0;0
12839;163528;490;64;33;4;29;.879;3586000;0
12839;170042;481;84;32;2;30;.938;3600000;0
12839;190235;481;0;0;0;0;.00nan;0;0
12839;78422;490;0;0;0;0;.00nan;0;0
12840;11500;472;75;30;2;28;.933;4020000;0
12840;46139;473;91;39;2;37;.949;4020000;0
12840;71297;472;0;0;0;0;.00nan;0;0
12840;153779;473;0;0;0;0;.00nan;0;0
12841;170042;481;0;0;0;0;.00nan;0;0
12841;190235;481;61;26;3;23;.885;3600000;0
12841;46139;473;55;28;4;24;.857;3567000;0
12841;153779;473;0;0;0;0;.00nan;0;0
12842;193041;482;68;14;0;14;1.000;1165000;0
12842;163528;490;67;25;2;23;.920;3600000;0
12842;163695;482;15;25;7;18;.720;2435000;0
12842;78422;490;0;0;0;0;.00nan;0;0
12843;11500;472;0;0;0;0;.00nan;0;0
12843;66551;474;0;0;0;0;.00nan;0;0
12843;71297;472;43;19;3;16;.842;3527000;0
12843;85127;474;100;44;1;43;.977;3600000;0
12844;199114;4535;0;0;0;0;.00nan;0;0
12844;193870;4535;83;41;3;38;.927;3600000;0
12844;-1;480;0;0;0;0;.00nan;0;0
12844;-1;480;26;36;7;29;.806;3600000;0
12845;24593;676;81;47;6;41;.872;3600000;0
12845;176765;476;51;9;1;8;.889;3600000;0
12845;-1;676;0;0;0;0;.00nan;0;0
12845;87894;476;0;0;0;0;.00nan;0;0
12846;173823;682;0;0;0;0;.00nan;0;0
12846;173840;5004;0;0;0;0;.00nan;0;0
12846;171673;5004;69;41;4;37;.902;3600000;0
12846;146184;682;86;18;0;18;1.000;3600000;0
12847;-1;480;57;37;4;33;.892;3572000;0
12847;-1;480;0;0;0;0;.00nan;0;0
12847;67222;675;0;0;0;0;.00nan;0;0
12847;142583;675;54;14;2;12;.857;3600000;0
12848;24593;676;100;26;0;26;1.000;3600000;0
12848;-1;676;0;0;0;0;.00nan;0;0
12848;66551;474;0;0;0;0;.00nan;0;0
12848;85127;474;71;20;1;19;.950;3588000;0
12849;176765;476;81;31;2;29;.935;3600000;0
12849;46139;473;71;36;3;33;.917;3568000;0
12849;87894;476;0;0;0;0;.00nan;0;0
12849;153779;473;0;0;0;0;.00nan;0;0
12850;193041;482;0;0;0;0;.00nan;0;0
12850;163695;482;94;21;0;21;1.000;3600000;0
12850;173840;5004;0;0;0;0;.00nan;0;0
12850;171673;5004;85;40;2;38;.950;3574000;0
12851;163528;490;63;21;2;19;.905;3600000;0
12851;199114;4535;0;0;0;0;.00nan;0;0
12851;193870;4535;52;30;4;26;.867;3549000;0
12851;78422;490;0;0;0;0;.00nan;0;0
12852;11500;472;0;0;0;0;.00nan;0;0
12852;173823;682;0;0;0;0;.00nan;0;0
12852;71297;472;92;45;2;43;.956;3815000;0
12852;146184;682;59;14;1;13;.929;3815000;0
12853;193041;482;0;0;0;0;.00nan;0;0
12853;163695;482;75;41;5;36;.878;3514000;0
12853;66551;474;66;34;3;31;.912;3600000;0
12853;85127;474;0;0;0;0;.00nan;0;0
12854;24593;676;61;23;3;20;.870;3600000;0
12854;46139;473;69;36;4;32;.889;3551000;0
12854;-1;676;0;0;0;0;.00nan;0;0
12854;153779;473;0;0;0;0;.00nan;0;0
12855;199114;4535;0;0;0;0;.00nan;0;0
12855;193870;4535;84;36;3;33;.917;3600000;0
12855;67222;675;0;0;0;0;.00nan;0;0
12855;142583;675;34;20;4;16;.800;3551000;0
12856;163528;490;64;19;1;18;.947;3600000;0
12856;173840;5004;0;0;0;0;.00nan;0;0
12856;171673;5004;58;27;3;24;.889;3600000;0
12856;78422;490;0;0;0;0;.00nan;0;0
12857;11500;472;0;0;0;0;.00nan;0;0
12857;170042;481;96;36;1;35;.972;3600000;0
12857;190235;481;0;0;0;0;.00nan;0;0
12857;71297;472;58;25;2;23;.920;3586000;0
12858;173823;682;0;0;0;0;.00nan;0;0
12858;-1;480;91;32;1;31;.969;3600000;0
12858;-1;480;0;0;0;0;.00nan;0;0
12858;146184;682;76;24;2;22;.917;3574000;0
12859;170042;481;40;32;5;27;.844;3600000;0
12859;190235;481;0;0;0;0;.00nan;0;0
12859;-1;480;96;33;1;32;.970;3600000;0
12859;-1;480;0;0;0;0;.00nan;0;0
12860;173840;5004;0;0;0;0;.00nan;0;0
12860;171673;5004;89;28;1;27;.964;3600000;0
12860;67222;675;33;28;6;22;.786;3600000;0
12860;142583;675;0;0;0;0;.00nan;0;0
12861;176765;476;37;10;3;7;.700;3600000;0
12861;66551;474;80;50;4;46;.920;3600000;0
12861;85127;474;0;0;0;0;.00nan;0;0
12861;87894;476;0;0;0;0;.00nan;0;0
12862;193041;482;0;0;0;0;.00nan;0;0
12862;163695;482;96;43;2;41;.953;4020000;0
12862;46139;473;89;31;2;29;.935;4020000;0
12862;153779;473;0;0;0;0;.00nan;0;0
12863;163528;490;73;23;3;20;.870;3600000;0
12863;24593;676;46;32;5;27;.844;3600000;0
12863;-1;676;0;0;0;0;.00nan;0;0
12863;78422;490;0;0;0;0;.00nan;0;0
12864;199114;4535;0;0;0;0;.00nan;0;0
12864;193870;4535;68;34;4;30;.882;3651000;0
12864;11500;472;0;0;0;0;.00nan;0;0
12864;71297;472;45;16;3;13;.813;3651000;0
12865;173823;682;0;0;0;0;.00nan;0;0
12865;66551;474;66;54;6;48;.889;3600000;0
12865;85127;474;0;0;0;0;.00nan;0;0
12865;146184;682;76;21;1;20;.952;3600000;0
12866;193041;482;0;0;0;0;.00nan;0;0
12866;163695;482;86;45;3;42;.933;3545000;0
12866;67222;675;0;0;0;0;.00nan;0;0
12866;142583;675;62;22;2;20;.909;3600000;0
12867;163528;490;61;30;3;27;.900;3600000;0
12867;176765;476;0;0;0;0;.00nan;0;0
12867;78422;490;0;0;0;0;.00nan;0;0
12867;87894;476;71;20;1;19;.950;3600000;0
12868;199114;4535;62;32;3;29;.906;3600000;0
12868;193870;4535;0;0;0;0;.00nan;0;0
12868;24593;676;78;27;2;25;.926;3600000;0
12868;-1;676;0;0;0;0;.00nan;0;0
12869;173840;5004;75;31;2;29;.935;3600000;0
12869;170042;481;74;34;3;31;.912;3569000;0
12869;171673;5004;0;0;0;0;.00nan;0;0
12869;190235;481;0;0;0;0;.00nan;0;0
12870;199114;4535;0;0;0;0;.00nan;0;0
12870;193870;4535;49;27;4;23;.852;3538000;0
12870;66551;474;96;36;2;34;.944;3600000;0
12870;85127;474;0;0;0;0;.00nan;0;0
12871;176765;476;30;14;4;10;.714;3600000;0
12871;-1;480;71;48;6;42;.875;3180000;0
12871;-1;480;46;4;1;3;.750;420000;0
12871;87894;476;0;0;0;0;.00nan;0;0
12872;173840;5004;0;0;0;0;.00nan;0;0
12872;24593;676;61;24;2;22;.917;3563000;0
12872;171673;5004;100;33;1;32;.970;3600000;0
12872;-1;676;0;0;0;0;.00nan;0;0
12873;193041;482;0;0;0;0;.00nan;0;0
12873;163695;482;100;30;0;30;1.000;3600000;0
12873;170042;481;65;21;1;20;.952;3595000;0
12873;190235;481;0;0;0;0;.00nan;0;0
12874;163528;490;53;21;3;18;.857;3686000;0
12874;11500;472;0;0;0;0;.00nan;0;0
12874;71297;472;76;44;4;40;.909;3686000;0
12874;78422;490;0;0;0;0;.00nan;0;0
12875;173823;682;0;0;0;0;.00nan;0;0
12875;67222;675;50;7;1;6;.857;1057000;0
12875;142583;675;29;28;6;22;.786;2543000;0
12875;146184;682;65;20;2;18;.900;3600000;0
12876;11500;472;0;0;0;0;.00nan;0;0
12876;46139;473;27;32;7;25;.781;2290000;0
12876;71297;472;60;13;2;11;.846;3600000;0
12876;153779;473;70;12;0;12;1.000;1310000;0
12877;163528;490;71;33;4;29;.879;3984000;0
12877;46139;473;80;44;4;40;.909;4020000;0
12877;78422;490;0;0;0;0;.00nan;0;0
12877;153779;473;0;0;0;0;.00nan;0;0
12878;24593;676;89;40;3;37;.925;3600000;0
12878;-1;676;0;0;0;0;.00nan;0;0
12878;67222;675;0;0;0;0;.00nan;0;0
12878;142583;675;29;22;5;17;.773;3600000;0
12879;193041;482;0;0;0;0;.00nan;0;0
12879;163695;482;64;51;5;46;.902;3600000;0
12879;176765;476;49;19;3;16;.842;3600000;0
12879;87894;476;0;0;0;0;.00nan;0;0
12880;199114;4535;0;0;0;0;.00nan;0;0
12880;193870;4535;53;36;4;32;.889;4020000;0
12880;173823;682;0;0;0;0;.00nan;0;0
12880;146184;682;45;24;4;20;.833;4020000;0
12881;173840;5004;0;0;0;0;.00nan;0;0
12881;171673;5004;75;26;1;25;.962;3600000;0
12881;-1;480;74;25;2;23;.920;3590000;0
12881;-1;480;0;0;0;0;.00nan;0;0
12882;170042;481;87;17;0;17;1.000;3600000;0
12882;190235;481;0;0;0;0;.00nan;0;0
12882;66551;474;0;0;0;0;.00nan;0;0
12882;85127;474;85;35;2;33;.943;3600000;0
12883;193041;482;0;0;0;0;.00nan;0;0
12883;163695;482;83;14;0;14;1.000;3600000;0
12883;-1;480;54;29;4;25;.862;3600000;0
12883;-1;480;0;0;0;0;.00nan;0;0
12884;173823;682;0;0;0;0;.00nan;0;0
12884;24593;676;91;38;1;37;.974;3553000;0
12884;-1;676;0;0;0;0;.00nan;0;0
12884;146184;682;87;20;0;20;1.000;3600000;0
12885;199114;4535;0;0;0;0;.00nan;0;0
12885;193870;4535;50;25;4;21;.840;3600000;0
12885;46139;473;33;24;5;19;.792;3549000;0
12885;153779;473;0;0;0;0;.00nan;0;0
12886;170042;481;98;42;2;40;.952;3600000;0
12886;176765;476;16;17;6;11;.647;2743000;0
12886;190235;481;0;0;0;0;.00nan;0;0
12886;87894;476;43;4;1;3;.750;857000;0
12887;163528;490;0;0;0;0;.00nan;0;0
12887;66551;474;0;0;0;0;.00nan;0;0
12887;78422;490;36;20;4;16;.800;3600000;0
12887;85127;474;61;49;6;43;.878;3599000;0
12888;11500;472;76;37;3;34;.919;3600000;0
12888;67222;675;0;0;0;0;.00nan;0;0
12888;71297;472;0;0;0;0;.00nan;0;0
12888;142583;675;96;35;1;34;.971;3600000;0
12889;46139;473;0;0;0;0;.00nan;0;0
12889;66551;474;21;25;6;19;.760;2324000;0
12889;85127;474;61;10;0;10;1.000;1276000;0
12889;153779;473;65;18;1;17;.944;3600000;0
12890;170042;481;0;0;0;0;.00nan;0;0
12890;190235;481;72;24;2;22;.917;3600000;0
12890;67222;675;0;0;0;0;.00nan;0;0
12890;142583;675;40;30;5;25;.833;3600000;0
12891;11500;472;0;0;0;0;.00nan;0;0
12891;176765;476;84;25;1;24;.960;3600000;0
12891;71297;472;48;20;4;16;.800;3600000;0
12891;87894;476;0;0;0;0;.00nan;0;0
12892;163528;490;94;23;0;23;1.000;3600000;0
12892;-1;480;78;38;3;35;.921;3600000;0
12892;-1;480;0;0;0;0;.00nan;0;0
12892;78422;490;0;0;0;0;.00nan;0;0
12893;199114;4535;51;4;0;4;1.000;298000;0
12893;193870;4535;38;27;5;22;.815;3222000;0
12893;173840;5004;0;0;0;0;.00nan;0;0
12893;171673;5004;64;33;3;30;.909;3600000;0
12894;193041;482;0;0;0;0;.00nan;0;0
12894;163695;482;74;31;2;29;.935;3574000;0
12894;173823;682;0;0;0;0;.00nan;0;0
12894;146184;682;65;17;1;16;.941;3600000;0
12895;11500;472;0;0;0;0;.00nan;0;0
12895;-1;480;99;34;1;33;.971;3600000;0
12895;-1;480;0;0;0;0;.00nan;0;0
12895;71297;472;49;24;3;21;.875;3585000;0
12896;170042;481;67;36;3;33;.917;4020000;0
12896;24593;676;68;30;3;27;.900;4020000;0
12896;190235;481;0;0;0;0;.00nan;0;0
12896;-1;676;0;0;0;0;.00nan;0;0
12897;46139;473;84;47;3;44;.936;3600000;0
12897;67222;675;0;0;0;0;.00nan;0;0
12897;142583;675;49;25;4;21;.840;3585000;0
12897;153779;473;0;0;0;0;.00nan;0;0
12898;193041;482;0;0;0;0;.00nan;0;0
12898;163695;482;77;30;3;27;.900;3556000;0
12898;199114;4535;93;30;1;29;.967;3600000;0
12898;193870;4535;0;0;0;0;.00nan;0;0
12899;173840;5004;0;0;0;0;.00nan;0;0
12899;171673;5004;89;34;1;33;.971;3600000;0
12899;176765;476;49;28;4;24;.857;3600000;0
12899;87894;476;0;0;0;0;.00nan;0;0
12900;163528;490;54;22;3;19;.864;3549000;0
12900;173823;682;0;0;0;0;.00nan;0;0
12900;78422;490;0;0;0;0;.00nan;0;0
12900;146184;682;68;26;2;24;.923;3600000;0
12901;173840;5004;0;0;0;0;.00nan;0;0
12901;171673;5004;71;29;2;27;.931;3600000;0
12901;66551;474;0;0;0;0;.00nan;0;0
12901;85127;474;52;24;3;21;.875;3600000;0
12902;11500;472;0;0;0;0;.00nan;0;0
12902;24593;676;93;47;2;45;.957;4020000;0
12902;-1;676;0;0;0;0;.00nan;0;0
12902;71297;472;80;32;2;30;.938;4020000;0
12903;-1;480;41;18;4;14;.778;3600000;0
12903;46139;473;52;28;5;23;.821;3563000;0
12903;-1;480;0;0;0;0;.00nan;0;0
12903;153779;473;0;0;0;0;.00nan;0;0
12904;199114;4535;0;0;0;0;.00nan;0;0
12904;193870;4535;67;48;5;43;.896;3600000;0
12904;176765;476;76;18;1;17;.944;3600000;0
12904;87894;476;0;0;0;0;.00nan;0;0
12905;173823;682;0;0;0;0;.00nan;0;0
12905;170042;481;83;42;3;39;.929;3593000;0
12905;190235;481;0;0;0;0;.00nan;0;0
12905;146184;682;59;21;2;19;.905;3600000;0
12906;163528;490;86;40;3;37;.925;3584000;0
12906;67222;675;0;0;0;0;.00nan;0;0
12906;78422;490;0;0;0;0;.00nan;0;0
12906;142583;675;71;22;1;21;.955;3600000;0
12907;24593;676;56;19;3;16;.842;3600000;0
12907;-1;480;11;22;6;16;.727;3600000;0
12907;-1;480;0;0;0;0;.00nan;0;0
12907;-1;676;0;0;0;0;.00nan;0;0
12908;66551;474;0;0;0;0;.00nan;0;0
12908;67222;675;96;18;0;18;1.000;4020000;0
12908;85127;474;85;32;0;32;1.000;4020000;0
12908;142583;675;0;0;0;0;.00nan;0;0
12909;199114;4535;0;0;0;0;.00nan;0;0
12909;193870;4535;82;27;1;26;.963;3600000;0
12909;170042;481;63;25;2;23;.920;3547000;0
12909;190235;481;0;0;0;0;.00nan;0;0
12910;173840;5004;0;0;0;0;.00nan;0;0
12910;171673;5004;66;27;3;24;.889;3600000;0
12910;46139;473;59;29;4;25;.862;3600000;0
12910;153779;473;0;0;0;0;.00nan;0;0
12911;173823;682;0;0;0;0;.00nan;0;0
12911;176765;476;65;15;1;14;.933;3577000;0
12911;87894;476;0;0;0;0;.00nan;0;0
12911;146184;682;100;36;0;36;1.000;3600000;0
12912;193041;482;0;0;0;0;.00nan;0;0
12912;163695;482;71;44;4;40;.909;3600000;0
12912;11500;472;0;0;0;0;.00nan;0;0
12912;71297;472;66;29;3;26;.897;3600000;0
12913;-1;480;100;27;0;27;1.000;3600000;0
12913;-1;480;0;0;0;0;.00nan;0;0
12913;66551;474;0;0;0;0;.00nan;0;0
12913;85127;474;65;33;3;30;.909;3600000;0
12914;173823;682;0;0;0;0;.00nan;0;0
12914;46139;473;85;41;3;38;.927;3576000;0
12914;146184;682;76;30;2;28;.933;3600000;0
12914;153779;473;0;0;0;0;.00nan;0;0
12915;176765;476;86;19;0;19;1.000;3600000;0
12915;67222;675;66;30;4;26;.867;3600000;0
12915;87894;476;0;0;0;0;.00nan;0;0
12915;142583;675;0;0;0;0;.00nan;0;0
12916;193041;482;0;0;0;0;.00nan;0;0
12916;163695;482;56;32;4;28;.875;3600000;0
12916;24593;676;70;25;2;23;.920;3600000;0
12916;-1;676;0;0;0;0;.00nan;0;0
12917;163528;490;71;30;3;27;.900;3600000;0
12917;170042;481;59;40;5;35;.875;3596000;0
12917;190235;481;0;0;0;0;.00nan;0;0
12917;78422;490;0;0;0;0;.00nan;0;0
12918;11500;472;0;0;0;0;.00nan;0;0
12918;173840;5004;0;0;0;0;.00nan;0;0
12918;171673;5004;98;42;2;40;.952;3600000;0
12918;71297;472;43;15;3;12;.800;3547000;0
12919;170042;481;73;26;3;23;.885;3566000;0
12919;190235;481;0;0;0;0;.00nan;0;0
12919;46139;473;0;0;0;0;.00nan;0;0
12919;153779;473;85;39;2;37;.949;3600000;0
12920;193041;482;69;34;3;31;.912;3600000;0
12920;163695;482;0;0;0;0;.00nan;0;0
12920;-1;480;47;25;4;21;.840;3552000;0
12920;-1;480;0;0;0;0;.00nan;0;0
12921;199114;4535;0;0;0;0;.00nan;0;0
12921;193870;4535;81;31;3;28;.903;4020000;0
12921;66551;474;97;51;3;48;.941;4020000;0
12921;85127;474;0;0;0;0;.00nan;0;0
12922;24593;676;0;0;0;0;.00nan;0;0
12922;-1;676;74;28;2;26;.929;4020000;0
12922;67222;675;0;0;0;0;.00nan;0;0
12922;142583;675;55;19;2;17;.895;4020000;0
12923;163528;490;100;36;0;36;1.000;3600000;0
12923;11500;472;48;0;0;0;.00nan;365000;0
12923;71297;472;21;37;8;29;.784;3235000;0
12923;78422;490;0;0;0;0;.00nan;0;0
12924;173823;682;61;20;2;18;.900;3600000;0
12924;173840;5004;0;0;0;0;.00nan;0;0
12924;171673;5004;73;33;3;30;.909;3600000;0
12924;146184;682;0;0;0;0;.00nan;0;0
12925;11500;472;0;0;0;0;.00nan;0;0
12925;46139;473;69;34;4;30;.882;3536000;0
12925;71297;472;51;16;2;14;.875;3600000;0
12925;153779;473;0;0;0;0;.00nan;0;0
12926;163528;490;89;32;1;31;.969;3600000;0
12926;-1;480;56;32;4;28;.875;3600000;0
12926;-1;480;0;0;0;0;.00nan;0;0
12926;78422;490;0;0;0;0;.00nan;0;0
12927;46139;473;65;27;3;24;.889;3543000;0
12927;66551;474;75;29;2;27;.931;3600000;0
12927;85127;474;0;0;0;0;.00nan;0;0
12927;153779;473;0;0;0;0;.00nan;0;0
12928;193041;482;0;0;0;0;.00nan;0;0
12928;163695;482;64;29;3;26;.897;3600000;0
12928;67222;675;77;16;0;16;1.000;3600000;0
12928;142583;675;0;0;0;0;.00nan;0;0
12929;199114;4535;0;0;0;0;.00nan;0;0
12929;193870;4535;56;31;4;27;.871;3600000;0
12929;24593;676;46;30;5;25;.833;3600000;0
12929;-1;676;0;0;0;0;.00nan;0;0
12930;170042;481;75;46;4;42;.913;4020000;0
12930;176765;476;39;18;4;14;.778;4020000;0
12930;190235;481;0;0;0;0;.00nan;0;0
12930;87894;476;0;0;0;0;.00nan;0;0
12931;11500;472;26;30;6;24;.800;3141000;0
12931;173823;682;0;0;0;0;.00nan;0;0
12931;71297;472;45;5;1;4;.800;459000;0
12931;146184;682;57;19;2;17;.895;3600000;0
12932;163528;490;70;19;1;18;.947;3600000;0
12932;66551;474;0;0;0;0;.00nan;0;0
12932;78422;490;0;0;0;0;.00nan;0;0
12932;85127;474;76;32;2;30;.938;3600000;0
12933;11500;472;61;12;0;12;1.000;1253000;0
12933;176765;476;66;24;2;22;.917;3600000;0
12933;71297;472;51;27;4;23;.852;2278000;0
12933;87894;476;0;0;0;0;.00nan;0;0
12934;24593;676;52;29;4;25;.862;3600000;0
12934;-1;480;100;26;0;26;1.000;3600000;0
12934;-1;480;0;0;0;0;.00nan;0;0
12934;-1;676;0;0;0;0;.00nan;0;0
12935;173840;5004;0;0;0;0;.00nan;0;0
12935;170042;481;47;29;5;24;.828;3600000;0
12935;171673;5004;61;32;3;29;.906;3600000;0
12935;190235;481;0;0;0;0;.00nan;0;0
12936;193041;482;0;0;0;0;.00nan;0;0
12936;163695;482;64;18;2;16;.889;3830000;0
12936;46139;473;99;34;1;33;.971;3830000;0
12936;153779;473;0;0;0;0;.00nan;0;0
12937;199114;4535;0;0;0;0;.00nan;0;0
12937;193870;4535;65;26;2;24;.923;3600000;0
12937;173823;682;0;0;0;0;.00nan;0;0
12937;146184;682;50;21;3;18;.857;3563000;0
12938;170042;481;76;23;1;22;.957;3600000;0
12938;190235;481;0;0;0;0;.00nan;0;0
12938;66551;474;84;35;2;33;.943;3570000;0
12938;85127;474;0;0;0;0;.00nan;0;0
12939;66551;474;0;0;0;0;.00nan;0;0
12939;67222;675;62;16;1;15;.938;3600000;0
12939;85127;474;87;72;6;66;.917;3600000;0
12939;142583;675;0;0;0;0;.00nan;0;0
12940;199114;4535;0;0;0;0;.00nan;0;0
12940;193870;4535;80;35;3;32;.914;3589000;0
12940;173840;5004;0;0;0;0;.00nan;0;0
12940;171673;5004;88;32;2;30;.938;3600000;0
12941;193041;482;0;0;0;0;.00nan;0;0
12941;163695;482;91;43;2;41;.953;3581000;0
12941;170042;481;92;32;1;31;.969;3600000;0
12941;190235;481;0;0;0;0;.00nan;0;0
12942;163528;490;97;28;1;27;.964;4020000;0
12942;24593;676;97;41;1;40;.976;4020000;0
12942;-1;676;0;0;0;0;.00nan;0;0
12942;78422;490;0;0;0;0;.00nan;0;0
12943;11500;472;0;0;0;0;.00nan;0;0
12943;46139;473;40;26;4;22;.846;3548000;0
12943;71297;472;62;25;3;22;.880;3600000;0
12943;153779;473;0;0;0;0;.00nan;0;0
12944;-1;480;52;24;3;21;.875;3600000;0
12944;46139;473;85;37;2;35;.946;3600000;0
12944;-1;480;0;0;0;0;.00nan;0;0
12944;153779;473;0;0;0;0;.00nan;0;0
12945;24593;676;79;41;3;38;.927;4020000;0
12945;176765;476;67;25;3;22;.880;4020000;0
12945;-1;676;0;0;0;0;.00nan;0;0
12945;87894;476;0;0;0;0;.00nan;0;0
12946;199114;4535;0;0;0;0;.00nan;0;0
12946;193870;4535;39;33;6;27;.818;3600000;0
12946;67222;675;63;21;2;19;.905;3600000;0
12946;142583;675;0;0;0;0;.00nan;0;0
12947;193041;482;0;0;0;0;.00nan;0;0
12947;163695;482;73;38;4;34;.895;3573000;0
12947;173840;5004;0;0;0;0;.00nan;0;0
12947;171673;5004;71;31;3;28;.903;3600000;0
12948;163528;490;88;31;2;29;.935;3600000;0
12948;170042;481;64;36;4;32;.889;3568000;0
12948;190235;481;0;0;0;0;.00nan;0;0
12948;78422;490;0;0;0;0;.00nan;0;0
12949;173823;682;0;0;0;0;.00nan;0;0
12949;66551;474;0;0;0;0;.00nan;0;0
12949;85127;474;59;43;5;38;.884;3600000;0
12949;146184;682;60;13;1;12;.923;3600000;0
12950;170042;481;100;37;1;36;.973;3600000;0
12950;190235;481;0;0;0;0;.00nan;0;0
12950;-1;480;58;29;3;26;.897;3570000;0
12950;-1;480;0;0;0;0;.00nan;0;0
12951;173823;682;0;0;0;0;.00nan;0;0
12951;24593;676;80;42;4;38;.905;3576000;0
12951;-1;676;0;0;0;0;.00nan;0;0
12951;146184;682;53;13;2;11;.846;3600000;0
12952;46139;473;20;9;4;5;.556;838000;0
12952;67222;675;53;23;4;19;.826;3600000;0
12952;142583;675;0;0;0;0;.00nan;0;0
12952;153779;473;34;22;5;17;.773;2762000;0
12953;199114;4535;0;0;0;0;.00nan;0;0
12953;193870;4535;60;34;5;29;.853;3574000;0
12953;176765;476;66;28;3;25;.893;3600000;0
12953;87894;476;0;0;0;0;.00nan;0;0
12954;193041;482;0;0;0;0;.00nan;0;0
12954;163695;482;78;47;5;42;.894;3600000;0
12954;11500;472;0;0;0;0;.00nan;0;0
12954;71297;472;74;29;2;27;.931;3600000;0
12955;163528;490;88;18;0;18;1.000;3600000;0
12955;173840;5004;0;0;0;0;.00nan;0;0
12955;171673;5004;88;42;1;41;.976;3600000;0
12955;78422;490;0;0;0;0;.00nan;0;0
12956;24593;676;72;32;3;29;.906;3600000;0
12956;-1;676;0;0;0;0;.00nan;0;0
12956;66551;474;31;26;6;20;.769;2815000;0
12956;85127;474;44;4;1;3;.750;785000;0
12957;163528;490;100;29;0;29;1.000;3600000;0
12957;67222;675;69;17;1;16;.941;3600000;0
12957;78422;490;0;0;0;0;.00nan;0;0
12957;142583;675;0;0;0;0;.00nan;0;0
12958;193041;482;0;0;0;0;.00nan;0;0
12958;163695;482;90;37;3;34;.919;3550000;0
12958;199114;4535;0;0;0;0;.00nan;0;0
12958;193870;4535;87;34;2;32;.941;3600000;0
12959;173840;5004;0;0;0;0;.00nan;0;0
12959;171673;5004;54;46;7;39;.848;3600000;0
12959;176765;476;95;21;0;21;1.000;3600000;0
12959;87894;476;0;0;0;0;.00nan;0;0
12960;173823;682;0;0;0;0;.00nan;0;0
12960;46139;473;66;37;4;33;.892;3595000;0
12960;146184;682;83;30;2;28;.933;3600000;0
12960;153779;473;0;0;0;0;.00nan;0;0
12961;11500;472;97;18;0;18;1.000;3600000;0
12961;-1;480;97;36;1;35;.972;3542000;0
12961;-1;480;0;0;0;0;.00nan;0;0
12961;71297;472;0;0;0;0;.00nan;0;0
12962;-1;480;65;35;4;31;.886;3600000;0
12962;-1;480;0;0;0;0;.00nan;0;0
12962;67222;675;89;25;1;24;.960;3600000;0
12962;142583;675;0;0;0;0;.00nan;0;0
12963;199114;4535;0;0;0;0;.00nan;0;0
12963;193870;4535;58;28;3;25;.893;3794000;0
12963;46139;473;48;27;4;23;.852;3794000;0
12963;153779;473;0;0;0;0;.00nan;0;0
12964;176765;476;53;15;2;13;.867;3600000;0
12964;66551;474;0;0;0;0;.00nan;0;0
12964;85127;474;71;35;3;32;.914;3561000;0
12964;87894;476;0;0;0;0;.00nan;0;0
12965;173840;5004;0;0;0;0;.00nan;0;0
12965;24593;676;79;34;3;31;.912;4020000;0
12965;171673;5004;67;27;3;24;.889;4020000;0
12965;-1;676;0;0;0;0;.00nan;0;0
12966;11500;472;0;0;0;0;.00nan;0;0
12966;170042;481;26;5;3;2;.400;307000;0
12966;190235;481;76;14;0;14;1.000;3293000;0
12966;71297;472;64;40;4;36;.900;3544000;0
12967;193041;482;0;0;0;0;.00nan;0;0
12967;163695;482;79;48;4;44;.917;4020000;0
12967;173823;682;0;0;0;0;.00nan;0;0
12967;146184;682;40;22;4;18;.818;4020000;0
12968;11500;472;0;0;0;0;.00nan;0;0
12968;66551;474;0;0;0;0;.00nan;0;0
12968;71297;472;60;16;1;15;.938;3821000;0
12968;85127;474;92;51;2;49;.961;3819000;0
12969;170042;481;93;29;1;28;.966;4020000;0
12969;24593;676;90;34;1;33;.971;4020000;0
12969;190235;481;0;0;0;0;.00nan;0;0
12969;-1;676;0;0;0;0;.00nan;0;0
12970;176765;476;80;27;2;25;.926;3600000;0
12970;46139;473;0;0;0;0;.00nan;0;0
12970;87894;476;0;0;0;0;.00nan;0;0
12970;153779;473;31;42;7;35;.833;3600000;0
12971;173840;5004;0;0;0;0;.00nan;0;0
12971;171673;5004;79;29;1;28;.966;4020000;0
12971;67222;675;0;0;0;0;.00nan;0;0
12971;142583;675;93;24;1;23;.958;4020000;0
12972;163528;490;68;19;2;17;.895;3600000;0
12972;199114;4535;48;39;5;34;.872;3600000;0
12972;193870;4535;0;0;0;0;.00nan;0;0
12972;78422;490;0;0;0;0;.00nan;0;0
12973;173823;682;0;0;0;0;.00nan;0;0
12973;-1;480;95;36;1;35;.972;3560000;0
12973;-1;480;0;0;0;0;.00nan;0;0
12973;146184;682;100;24;0;24;1.000;3600000;0
12974;176765;476;0;0;0;0;.00nan;0;0
12974;67222;675;0;0;0;0;.00nan;0;0
12974;87894;476;70;40;3;37;.925;3600000;0
12974;142583;675;46;31;5;26;.839;3600000;0
12975;173840;5004;0;0;0;0;.00nan;0;0
12975;171673;5004;64;30;3;27;.900;3600000;0
12975;-1;480;50;27;4;23;.852;3576000;0
12975;-1;480;0;0;0;0;.00nan;0;0
12976;173823;682;0;0;0;0;.00nan;0;0
12976;170042;481;93;39;2;37;.949;3600000;0
12976;190235;481;0;0;0;0;.00nan;0;0
12976;146184;682;75;38;3;35;.921;3600000;0
12977;193041;482;0;0;0;0;.00nan;0;0
12977;163695;482;81;26;1;25;.962;4020000;0
12977;66551;474;0;0;0;0;.00nan;0;0
12977;85127;474;93;40;1;39;.975;4020000;0
12978;163528;490;100;32;0;32;1.000;3600000;0
12978;46139;473;76;33;4;29;.879;3600000;0
12978;78422;490;0;0;0;0;.00nan;0;0
12978;153779;473;0;0;0;0;.00nan;0;0
12979;11500;472;0;0;0;0;.00nan;0;0
12979;24593;676;100;28;0;28;1.000;3600000;0
12979;-1;676;0;0;0;0;.00nan;0;0
12979;71297;472;86;34;1;33;.971;3591000;0
12980;170042;481;74;23;1;22;.957;3600000;0
12980;190235;481;0;0;0;0;.00nan;0;0
12980;66551;474;0;0;0;0;.00nan;0;0
12980;85127;474;57;29;4;25;.862;3600000;0
12981;193041;482;0;0;0;0;.00nan;0;0
12981;163695;482;96;44;1;43;.977;4020000;0
12981;24593;676;82;28;1;27;.964;4020000;0
12981;-1;676;0;0;0;0;.00nan;0;0
12982;173823;682;0;0;0;0;.00nan;0;0
12982;67222;675;92;36;2;34;.944;3600000;0
12982;142583;675;0;0;0;0;.00nan;0;0
12982;146184;682;44;32;5;27;.844;3600000;0
12983;199114;4535;0;0;0;0;.00nan;0;0
12983;193870;4535;32;26;5;21;.808;4020000;0
12983;-1;480;47;33;5;28;.848;4020000;0
12983;-1;480;0;0;0;0;.00nan;0;0
12984;163528;490;74;31;3;28;.903;3600000;0
12984;176765;476;57;28;4;24;.857;3577000;0
12984;78422;490;0;0;0;0;.00nan;0;0
12984;87894;476;0;0;0;0;.00nan;0;0
12985;11500;472;0;0;0;0;.00nan;0;0
12985;173840;5004;0;0;0;0;.00nan;0;0
12985;171673;5004;83;50;3;47;.940;3572000;0
12985;71297;472;68;17;1;16;.941;3600000;0
12986;24593;676;57;20;2;18;.900;3600000;0
12986;46139;473;79;42;3;39;.929;3600000;0
12986;-1;676;0;0;0;0;.00nan;0;0
12986;153779;473;0;0;0;0;.00nan;0;0
12987;173840;5004;0;0;0;0;.00nan;0;0
12987;171673;5004;75;23;1;22;.957;3600000;0
12987;66551;474;52;23;3;20;.870;2428000;0
12987;85127;474;37;15;4;11;.733;1172000;0
12988;199114;4535;0;0;0;0;.00nan;0;0
12988;193870;4535;75;26;2;24;.923;3867000;0
12988;170042;481;93;28;1;27;.964;3867000;0
12988;190235;481;0;0;0;0;.00nan;0;0
12989;193041;482;0;0;0;0;.00nan;0;0
12989;163695;482;73;35;3;32;.914;3580000;0
12989;176765;476;56;18;2;16;.889;3600000;0
12989;87894;476;0;0;0;0;.00nan;0;0
12990;163528;490;62;35;3;32;.914;3822000;0
12990;173823;682;0;0;0;0;.00nan;0;0
12990;78422;490;0;0;0;0;.00nan;0;0
12990;146184;682;36;19;4;15;.789;3822000;0
12991;11500;472;0;0;0;0;.00nan;0;0
12991;67222;675;0;0;0;0;.00nan;0;0
12991;71297;472;39;17;3;14;.824;4020000;0
12991;142583;675;91;44;3;41;.932;4020000;0
12992;-1;480;0;0;0;0;.00nan;0;0
12992;-1;480;63;18;1;17;.944;3600000;0
12992;66551;474;0;0;0;0;.00nan;0;0
12992;85127;474;70;37;4;33;.892;3600000;0
12993;173840;5004;0;0;0;0;.00nan;0;0
12993;171673;5004;71;37;3;34;.919;3628000;0
12993;46139;473;42;21;4;17;.810;3628000;0
12993;153779;473;0;0;0;0;.00nan;0;0
12994;170042;481;48;30;5;25;.833;3600000;0
12994;190235;481;0;0;0;0;.00nan;0;0
12994;67222;675;0;0;0;0;.00nan;0;0
12994;142583;675;81;24;1;23;.958;3600000;0
12995;173823;682;0;0;0;0;.00nan;0;0
12995;176765;476;95;52;2;50;.962;3600000;0
12995;87894;476;0;0;0;0;.00nan;0;0
12995;146184;682;50;23;3;20;.870;3600000;0
12996;199114;4535;0;0;0;0;.00nan;0;0
12996;193870;4535;60;45;6;39;.867;3600000;0
12996;11500;472;0;0;0;0;.00nan;0;0
12996;71297;472;60;28;3;25;.893;3600000;0
12997;193041;482;0;0;0;0;.00nan;0;0
12997;163528;490;75;20;1;19;.950;3600000;0
12997;163695;482;54;39;5;34;.872;3600000;0
12997;78422;490;0;0;0;0;.00nan;0;0
12998;193041;482;0;0;0;0;.00nan;0;0
12998;163695;482;86;31;1;30;.968;3699000;0
12998;46139;473;0;0;0;0;.00nan;0;0
12998;153779;473;73;29;2;27;.931;3699000;0
12999;163528;490;0;0;0;0;.00nan;0;0
12999;170042;481;88;32;2;30;.938;3577000;0
12999;190235;481;0;0;0;0;.00nan;0;0
12999;78422;490;80;26;1;25;.962;3600000;0
13000;11500;472;62;36;4;32;.889;3574000;0
13000;173823;682;67;29;3;26;.897;3600000;0
13000;71297;472;0;0;0;0;.00nan;0;0
13000;146184;682;0;0;0;0;.00nan;0;0
13001;-1;480;82;26;1;25;.962;3600000;0
13001;-1;480;0;0;0;0;.00nan;0;0
13001;67222;675;0;0;0;0;.00nan;0;0
13001;142583;675;48;28;4;24;.857;3600000;0
13002;24593;676;27;34;7;27;.794;3600000;0
13002;176765;476;90;19;0;19;1.000;3600000;0
13002;-1;676;0;0;0;0;.00nan;0;0
13002;87894;476;0;0;0;0;.00nan;0;0
13003;199114;4535;0;0;0;0;.00nan;0;0
13003;193870;4535;63;26;2;24;.923;3574000;0
13003;173840;5004;100;25;0;25;1.000;3600000;0
13003;171673;5004;0;0;0;0;.00nan;0;0
13004;176765;476;59;16;1;15;.938;3600000;0
13004;66551;474;13;23;6;17;.739;1539000;0
13004;85127;474;67;19;1;18;.947;2061000;0
13004;87894;476;0;0;0;0;.00nan;0;0
13005;24593;676;77;23;1;22;.957;3600000;0
13005;46139;473;100;34;0;34;1.000;3600000;0
13005;-1;676;0;0;0;0;.00nan;0;0
13005;153779;473;0;0;0;0;.00nan;0;0
13006;199114;4535;0;0;0;0;.00nan;0;0
13006;193870;4535;62;37;4;33;.892;3600000;0
13006;67222;675;0;0;0;0;.00nan;0;0
13006;142583;675;30;30;6;24;.800;3584000;0
13007;173840;5004;50;14;2;12;.857;3600000;0
13007;170042;481;0;0;0;0;.00nan;0;0
13007;171673;5004;0;0;0;0;.00nan;0;0
13007;190235;481;46;26;5;21;.808;3600000;0
13008;193041;482;0;0;0;0;.00nan;0;0
13008;163695;482;97;47;3;44;.936;3600000;0
13008;173823;682;0;0;0;0;.00nan;0;0
13008;146184;682;28;24;5;19;.792;3596000;0
13009;163528;490;76;28;2;26;.929;3600000;0
13009;11500;472;0;0;0;0;.00nan;0;0
13009;71297;472;51;32;4;28;.875;3600000;0
13009;78422;490;0;0;0;0;.00nan;0;0
13010;46139;473;70;17;1;16;.941;3600000;0
13010;66551;474;0;0;0;0;.00nan;0;0
13010;85127;474;76;34;2;32;.941;3585000;0
13010;153779;473;0;0;0;0;.00nan;0;0
13011;173840;5004;0;0;0;0;.00nan;0;0
13011;24593;676;82;30;2;28;.933;3910000;0
13011;171673;5004;87;40;3;37;.925;3910000;0
13011;-1;676;0;0;0;0;.00nan;0;0
13012;193041;482;0;0;0;0;.00nan;0;0
13012;163528;490;70;31;3;28;.903;3544000;0
13012;163695;482;91;36;1;35;.972;3600000;0
13012;78422;490;0;0;0;0;.00nan;0;0
13013;176765;476;71;20;1;19;.950;3600000;0
13013;67222;675;85;41;2;39;.951;3600000;0
13013;87894;476;0;0;0;0;.00nan;0;0
13013;142583;675;0;0;0;0;.00nan;0;0
13014;170042;481;39;24;5;19;.792;3600000;0
13014;190235;481;0;0;0;0;.00nan;0;0
13014;-1;480;79;28;2;26;.929;3600000;0
13014;-1;480;0;0;0;0;.00nan;0;0
13015;199114;4535;0;0;0;0;.00nan;0;0
13015;193870;4535;70;29;3;26;.897;3637000;0
13015;11500;472;0;0;0;0;.00nan;0;0
13015;71297;472;56;24;2;22;.917;3637000;0
13016;173840;5004;0;0;0;0;.00nan;0;0
13016;171673;5004;99;37;1;36;.973;3600000;0
13016;-1;480;54;17;2;15;.882;3554000;0
13016;-1;480;0;0;0;0;.00nan;0;0
13017;173823;682;0;0;0;0;.00nan;0;0
13017;46139;473;58;54;7;47;.870;3600000;0
13017;146184;682;51;21;3;18;.857;3600000;0
13017;153779;473;0;0;0;0;.00nan;0;0
13018;193041;482;0;0;0;0;.00nan;0;0
13018;163695;482;32;23;5;18;.783;3600000;0
13018;176765;476;83;18;0;18;1.000;3600000;0
13018;87894;476;0;0;0;0;.00nan;0;0
13019;199114;4535;52;20;3;17;.850;3600000;0
13019;193870;4535;0;0;0;0;.00nan;0;0
13019;66551;474;0;0;0;0;.00nan;0;0
13019;85127;474;58;36;4;32;.889;3600000;0
13020;170042;481;28;24;5;19;.792;3600000;0
13020;24593;676;59;31;4;27;.871;3600000;0
13020;190235;481;0;0;0;0;.00nan;0;0
13020;-1;676;0;0;0;0;.00nan;0;0
13021;163528;490;100;27;0;27;1.000;3600000;0
13021;67222;675;50;24;3;21;.875;3600000;0
13021;78422;490;0;0;0;0;.00nan;0;0
13021;142583;675;0;0;0;0;.00nan;0;0
13022;163528;490;87;16;0;16;1.000;3600000;0
13022;66551;474;0;0;0;0;.00nan;0;0
13022;78422;490;0;0;0;0;.00nan;0;0
13022;85127;474;98;43;1;42;.977;3566000;0
13023;11500;472;0;0;0;0;.00nan;0;0
13023;176765;476;100;23;0;23;1.000;3600000;0
13023;71297;472;72;40;4;36;.900;3600000;0
13023;87894;476;0;0;0;0;.00nan;0;0
13024;199114;4535;0;0;0;0;.00nan;0;0
13024;193870;4535;80;48;3;45;.938;3600000;0
13024;170042;481;65;23;2;21;.913;3600000;0
13024;190235;481;0;0;0;0;.00nan;0;0
13025;193041;482;0;0;0;0;.00nan;0;0
13025;163695;482;72;25;2;23;.920;3699000;0
13025;-1;480;85;37;3;34;.919;3699000;0
13025;-1;480;0;0;0;0;.00nan;0;0
13026;173823;682;0;0;0;0;.00nan;0;0
13026;67222;675;0;0;0;0;.00nan;0;0
13026;142583;675;70;26;2;24;.923;3600000;0
13026;146184;682;74;20;1;19;.950;3600000;0
13027;163528;490;6;13;6;7;.538;2464000;0
13027;24593;676;75;32;2;30;.938;3600000;0
13027;-1;676;0;0;0;0;.00nan;0;0
13027;78422;490;52;8;1;7;.875;1136000;0
13028;11500;472;74;32;2;30;.938;3555000;0
13028;67222;675;78;24;1;23;.958;3600000;0
13028;71297;472;0;0;0;0;.00nan;0;0
13028;142583;675;0;0;0;0;.00nan;0;0
13029;170042;481;85;35;3;32;.914;3600000;0
13029;176765;476;33;19;4;15;.789;3543000;0
13029;190235;481;0;0;0;0;.00nan;0;0
13029;87894;476;0;0;0;0;.00nan;0;0
13030;193041;482;0;0;0;0;.00nan;0;0
13030;163695;482;68;21;2;19;.905;3600000;0
13030;66551;474;0;0;0;0;.00nan;0;0
13030;85127;474;52;33;5;28;.848;3600000;0
13031;199114;4535;0;0;0;0;.00nan;0;0
13031;193870;4535;69;25;2;23;.920;3600000;0
13031;-1;480;78;26;3;23;.885;3600000;0
13031;-1;480;0;0;0;0;.00nan;0;0
13032;173823;682;0;0;0;0;.00nan;0;0
13032;173840;5004;0;0;0;0;.00nan;0;0
13032;171673;5004;56;26;3;23;.885;3695000;0
13032;146184;682;76;25;2;23;.920;3695000;0
13033;173840;5004;0;0;0;0;.00nan;0;0
13033;171673;5004;89;30;1;29;.967;3600000;0
13033;46139;473;76;41;3;38;.927;3516000;0
13033;153779;473;0;0;0;0;.00nan;0;0
13034;24593;676;60;21;2;19;.905;3591000;0
13034;-1;480;74;21;1;20;.952;3600000;0
13034;-1;480;0;0;0;0;.00nan;0;0
13034;-1;676;0;0;0;0;.00nan;0;0
13035;163528;490;70;35;3;32;.914;3565000;0
13035;46139;473;91;40;2;38;.950;3600000;0
13035;78422;490;0;0;0;0;.00nan;0;0
13035;153779;473;0;0;0;0;.00nan;0;0
13036;173840;5004;0;0;0;0;.00nan;0;0
13036;171673;5004;98;49;4;45;.918;3600000;0
13036;67222;675;58;18;3;15;.833;3600000;0
13036;142583;675;0;0;0;0;.00nan;0;0
13037;193041;482;73;40;2;38;.950;4020000;0
13037;163695;482;0;0;0;0;.00nan;0;0
13037;199114;4535;0;0;0;0;.00nan;0;0
13037;193870;4535;67;22;2;20;.909;4020000;0
13038;173823;682;0;0;0;0;.00nan;0;0
13038;176765;476;87;30;2;28;.933;3600000;0
13038;87894;476;0;0;0;0;.00nan;0;0
13038;146184;682;47;40;6;34;.850;3600000;0
13039;11500;472;27;18;5;13;.722;3577000;0
13039;66551;474;0;0;0;0;.00nan;0;0
13039;71297;472;0;0;0;0;.00nan;0;0
13039;85127;474;91;48;3;45;.938;3600000;0
13040;173840;5004;50;1;0;1;1.000;551000;0
13040;171673;5004;26;24;6;18;.750;3049000;0
13040;66551;474;97;39;2;37;.949;3600000;0
13040;85127;474;0;0;0;0;.00nan;0;0
13041;11500;472;0;0;0;0;.00nan;0;0
13041;24593;676;0;0;0;0;.00nan;0;0
13041;-1;676;61;29;3;26;.897;3554000;0
13041;71297;472;55;15;2;13;.867;3600000;0
13042;199114;4535;0;0;0;0;.00nan;0;0
13042;193870;4535;83;40;3;37;.925;3567000;0
13042;173823;682;0;0;0;0;.00nan;0;0
13042;146184;682;72;17;1;16;.941;3600000;0
13043;193041;482;0;0;0;0;.00nan;0;0
13043;163695;482;29;30;6;24;.800;3600000;0
13043;170042;481;100;36;0;36;1.000;3600000;0
13043;190235;481;0;0;0;0;.00nan;0;0
13044;163528;490;99;30;1;29;.967;3600000;0
13044;-1;480;28;37;8;29;.784;3600000;0
13044;-1;480;0;0;0;0;.00nan;0;0
13044;78422;490;0;0;0;0;.00nan;0;0
13045;173823;682;0;0;0;0;.00nan;0;0
13045;66551;474;0;0;0;0;.00nan;0;0
13045;85127;474;66;40;4;36;.900;3600000;0
13045;146184;682;78;20;1;19;.950;3600000;0
13046;11500;472;0;0;0;0;.00nan;0;0
13046;-1;480;57;27;3;24;.889;3600000;0
13046;-1;480;0;0;0;0;.00nan;0;0
13046;71297;472;41;37;5;32;.865;3530000;0
13047;163528;490;51;36;5;31;.861;3600000;0
13047;176765;476;96;39;2;37;.949;3600000;0
13047;78422;490;0;0;0;0;.00nan;0;0
13047;87894;476;0;0;0;0;.00nan;0;0
13048;199114;4535;0;0;0;0;.00nan;0;0
13048;193870;4535;45;25;4;21;.840;3600000;0
13048;46139;473;45;33;5;28;.848;3600000;0
13048;153779;473;0;0;0;0;.00nan;0;0
13049;170042;481;29;25;6;19;.760;2235000;0
13049;190235;481;43;10;2;8;.800;1365000;0
13049;67222;675;57;18;2;16;.889;3600000;0
13049;142583;675;0;0;0;0;.00nan;0;0
13050;193041;482;0;0;0;0;.00nan;0;0
13050;163695;482;84;25;1;24;.960;4020000;0
13050;24593;676;96;42;1;41;.976;4020000;0
13050;-1;676;0;0;0;0;.00nan;0;0
13051;-1;480;57;26;3;23;.885;3683000;0
13051;46139;473;72;37;4;33;.892;3683000;0
13051;-1;480;0;0;0;0;.00nan;0;0
13051;153779;473;0;0;0;0;.00nan;0;0
13052;66551;474;0;0;0;0;.00nan;0;0
13052;67222;675;52;21;3;18;.857;4020000;0
13052;85127;474;97;48;3;45;.938;4020000;0
13052;142583;675;0;0;0;0;.00nan;0;0
13053;173840;5004;0;0;0;0;.00nan;0;0
13053;171673;5004;64;37;4;33;.892;3576000;0
13053;176765;476;62;24;2;22;.917;3600000;0
13053;87894;476;0;0;0;0;.00nan;0;0
13054;163528;490;48;13;2;11;.846;4020000;0
13054;199114;4535;0;0;0;0;.00nan;0;0
13054;193870;4535;100;60;2;58;.967;4020000;0
13054;78422;490;0;0;0;0;.00nan;0;0
13055;173823;682;0;0;0;0;.00nan;0;0
13055;24593;676;91;37;2;35;.946;3578000;0
13055;-1;676;0;0;0;0;.00nan;0;0
13055;146184;682;70;16;1;15;.938;3600000;0
13056;11500;472;57;14;1;13;.929;977000;0
13056;170042;481;92;54;6;48;.889;3600000;0
13056;190235;481;0;0;0;0;.00nan;0;0
13056;71297;472;20;23;6;17;.739;2591000;0
13057;173823;682;0;0;0;0;.00nan;0;0
13057;-1;480;100;31;0;31;1.000;3600000;0
13057;-1;480;0;0;0;0;.00nan;0;0
13057;146184;682;71;26;2;24;.923;3548000;0
13058;24593;676;52;15;2;13;.867;3574000;0
13058;-1;676;0;0;0;0;.00nan;0;0
13058;66551;474;0;0;0;0;.00nan;0;0
13058;85127;474;97;36;1;35;.972;3600000;0
13059;199114;4535;78;36;2;34;.944;3530000;0
13059;193870;4535;0;0;0;0;.00nan;0;0
13059;176765;476;100;27;0;27;1.000;3600000;0
13059;87894;476;0;0;0;0;.00nan;0;0
13060;11500;472;0;0;0;0;.00nan;0;0
13060;173840;5004;0;0;0;0;.00nan;0;0
13060;171673;5004;70;34;4;30;.882;4020000;0
13060;71297;472;47;29;4;25;.862;4020000;0
13061;170042;481;63;26;3;23;.885;3600000;0
13061;190235;481;0;0;0;0;.00nan;0;0
13061;46139;473;56;32;4;28;.875;3600000;0
13061;153779;473;0;0;0;0;.00nan;0;0
13062;193041;482;0;0;0;0;.00nan;0;0
13062;163695;482;55;19;2;17;.895;3600000;0
13062;67222;675;0;0;0;0;.00nan;0;0
13062;142583;675;52;31;4;27;.871;3584000;0
13063;-1;480;55;30;4;26;.867;3596000;0
13063;-1;480;0;0;0;0;.00nan;0;0
13063;66551;474;0;0;0;0;.00nan;0;0
13063;85127;474;64;22;2;20;.909;3600000;0
13064;24593;676;88;31;2;29;.935;3600000;0
13064;-1;676;0;0;0;0;.00nan;0;0
13064;67222;675;51;24;3;21;.875;3544000;0
13064;142583;675;0;0;0;0;.00nan;0;0
13065;176765;476;90;31;1;30;.968;3600000;0
13065;46139;473;43;26;4;22;.846;3600000;0
13065;87894;476;0;0;0;0;.00nan;0;0
13065;153779;473;0;0;0;0;.00nan;0;0
13066;163528;490;97;26;1;25;.962;3600000;0
13066;173840;5004;0;0;0;0;.00nan;0;0
13066;171673;5004;65;32;3;29;.906;3513000;0
13066;78422;490;0;0;0;0;.00nan;0;0
13067;173823;682;0;0;0;0;.00nan;0;0
13067;170042;481;72;35;3;32;.914;3600000;0
13067;190235;481;0;0;0;0;.00nan;0;0
13067;146184;682;64;21;2;19;.905;3600000;0
13068;193041;482;0;0;0;0;.00nan;0;0
13068;163695;482;69;39;3;36;.923;3514000;0
13068;11500;472;89;26;1;25;.962;3600000;0
13068;71297;472;0;0;0;0;.00nan;0;0
13069;176765;476;64;16;1;15;.938;3600000;0
13069;-1;480;65;46;6;40;.870;3600000;0
13069;-1;480;0;0;0;0;.00nan;0;0
13069;87894;476;0;0;0;0;.00nan;0;0
13070;199114;4535;0;0;0;0;.00nan;0;0
13070;193870;4535;49;23;4;19;.826;3600000;0
13070;24593;676;68;19;1;18;.947;3600000;0
13070;-1;676;0;0;0;0;.00nan;0;0
13071;46139;473;54;34;5;29;.853;3564000;0
13071;67222;675;72;28;3;25;.893;3600000;0
13071;142583;675;0;0;0;0;.00nan;0;0
13071;153779;473;0;0;0;0;.00nan;0;0
13072;170042;481;45;17;3;14;.824;3538000;0
13072;190235;481;0;0;0;0;.00nan;0;0
13072;66551;474;0;0;0;0;.00nan;0;0
13072;85127;474;93;47;2;45;.957;3600000;0
13073;193041;482;0;0;0;0;.00nan;0;0
13073;163695;482;67;28;3;25;.893;3600000;0
13073;173840;5004;0;0;0;0;.00nan;0;0
13073;171673;5004;90;19;0;19;1.000;3600000;0
13074;163528;490;72;32;4;28;.875;3600000;0
13074;173823;682;0;0;0;0;.00nan;0;0
13074;78422;490;0;0;0;0;.00nan;0;0
13074;146184;682;71;17;1;16;.941;3600000;0
13076;-1;480;65;32;3;29;.906;3600000;0
13076;-1;480;0;0;0;0;.00nan;0;0
13076;66551;474;63;8;0;8;1.000;768000;0
13076;85127;474;61;40;6;34;.850;2832000;0
13084;193041;482;0;0;0;0;.00nan;0;0
13084;163695;482;57;25;3;22;.880;3574000;0
13084;173840;5004;0;0;0;0;.00nan;0;0
13084;171673;5004;86;34;2;32;.941;3600000;0
13086;199114;4535;0;0;0;0;.00nan;0;0
13086;193870;4535;60;38;5;33;.868;3600000;0
13086;170042;481;93;34;1;33;.971;3600000;0
13086;190235;481;0;0;0;0;.00nan;0;0
13088;163528;490;43;32;5;27;.844;3851000;0
13088;46139;473;41;36;6;30;.833;3799000;0
13088;78422;490;0;0;0;0;.00nan;0;0
13088;153779;473;0;0;0;0;.00nan;0;0
13090;11500;472;0;0;0;0;.00nan;0;0
13090;176765;476;47;29;4;25;.862;3600000;0
13090;71297;472;57;39;5;34;.872;3590000;0
13090;87894;476;0;0;0;0;.00nan;0;0
13092;173823;682;0;0;0;0;.00nan;0;0
13092;173840;5004;50;1;0;1;1.000;290000;0
13092;171673;5004;41;20;4;16;.800;3308000;0
13092;146184;682;75;25;2;23;.920;3600000;0
13094;199114;4535;0;0;0;0;.00nan;0;0
13094;193870;4535;94;40;2;38;.950;3600000;0
13094;170042;481;48;26;4;22;.846;3553000;0
13094;190235;481;0;0;0;0;.00nan;0;0
13096;24593;676;80;47;4;43;.915;3516000;0
13096;-1;480;61;25;2;23;.920;3600000;0
13096;-1;480;0;0;0;0;.00nan;0;0
13096;-1;676;0;0;0;0;.00nan;0;0
13098;193041;482;0;0;0;0;.00nan;0;0
13098;163695;482;78;41;3;38;.927;3553000;0
13098;67222;675;0;0;0;0;.00nan;0;0
13098;142583;675;61;18;2;16;.889;3600000;0
13100;170042;481;0;0;0;0;.00nan;0;0
13100;190235;481;83;31;3;28;.903;3600000;0
13100;-1;480;17;18;6;12;.667;1404000;0
13100;-1;480;39;15;3;12;.800;2196000;0
13104;199114;4535;43;44;6;38;.864;3600000;0
13104;193870;4535;0;0;0;0;.00nan;0;0
13104;46139;473;0;0;0;0;.00nan;0;0
13104;153779;473;74;22;1;21;.955;3600000;0
13106;24593;676;0;0;0;0;.00nan;0;0
13106;-1;676;46;31;5;26;.839;3600000;0
13106;66551;474;60;32;4;28;.875;3600000;0
13106;85127;474;0;0;0;0;.00nan;0;0
13108;193041;482;56;27;4;23;.852;3800000;0
13108;163695;482;0;0;0;0;.00nan;0;0
13108;173840;5004;49;27;5;22;.815;3800000;0
13108;171673;5004;0;0;0;0;.00nan;0;0
13112;199114;4535;0;0;0;0;.00nan;0;0
13112;193870;4535;100;53;2;51;.962;4020000;0
13112;176765;476;63;18;2;16;.889;4020000;0
13112;87894;476;0;0;0;0;.00nan;0;0
13116;24593;676;45;35;6;29;.829;3139000;0
13116;-1;480;74;26;2;24;.923;3600000;0
13116;-1;480;0;0;0;0;.00nan;0;0
13116;-1;676;55;5;0;5;1.000;461000;0
13118;173840;5004;0;0;0;0;.00nan;0;0
13118;171673;5004;62;22;2;20;.909;3598000;0
13118;46139;473;83;28;1;27;.964;3600000;0
13118;153779;473;0;0;0;0;.00nan;0;0
13122;193041;482;0;0;0;0;.00nan;0;0
13122;163695;482;71;29;2;27;.931;3600000;0
13122;170042;481;88;28;1;27;.964;3600000;0
13122;190235;481;0;0;0;0;.00nan;0;0
13124;163528;490;93;33;1;32;.970;3600000;0
13124;66551;474;0;0;0;0;.00nan;0;0
13124;78422;490;0;0;0;0;.00nan;0;0
13124;85127;474;60;37;4;33;.892;3600000;0
13126;173840;5004;92;49;2;47;.959;3908000;0
13126;171673;5004;0;0;0;0;.00nan;0;0
13126;-1;480;65;18;1;17;.944;3908000;0
13126;-1;480;0;0;0;0;.00nan;0;0
13132;193041;482;0;0;0;0;.00nan;0;0
13132;163695;482;79;42;4;38;.905;3693000;0
13132;46139;473;0;0;0;0;.00nan;0;0
13132;153779;473;68;45;5;40;.889;3693000;0
13134;170042;481;46;7;1;6;.857;1324000;0
13134;24593;676;0;0;0;0;.00nan;0;0
13134;190235;481;24;28;6;22;.786;2276000;0
13134;-1;676;63;29;3;26;.897;3600000;0
13138;173840;5004;0;0;0;0;.00nan;0;0
13138;24593;676;81;24;1;23;.958;3600000;0
13138;171673;5004;81;42;3;39;.929;3558000;0
13138;-1;676;0;0;0;0;.00nan;0;0
13140;193041;482;0;0;0;0;.00nan;0;0
13140;163695;482;32;27;5;22;.815;3600000;0
13140;46139;473;84;28;1;27;.964;3600000;0
13140;153779;473;0;0;0;0;.00nan;0;0
13142;199114;4535;0;0;0;0;.00nan;0;0
13142;193870;4535;52;34;4;30;.882;3588000;0
13142;66551;474;0;0;0;0;.00nan;0;0
13142;85127;474;68;33;3;30;.909;3600000;0
13144;170042;481;63;40;5;35;.875;3559000;0
13144;176765;476;68;26;3;23;.885;3600000;0
13144;190235;481;0;0;0;0;.00nan;0;0
13144;87894;476;0;0;0;0;.00nan;0;0
13146;163528;490;76;18;1;17;.944;3600000;0
13146;-1;480;33;44;8;36;.818;3600000;0
13146;-1;480;0;0;0;0;.00nan;0;0
13146;78422;490;0;0;0;0;.00nan;0;0
13148;170042;481;69;36;3;33;.917;3943000;0
13148;190235;481;0;0;0;0;.00nan;0;0
13148;66551;474;92;52;4;48;.923;3943000;0
13148;85127;474;0;0;0;0;.00nan;0;0
13150;199114;4535;82;41;3;38;.927;3600000;0
13150;193870;4535;0;0;0;0;.00nan;0;0
13150;24593;676;0;0;0;0;.00nan;0;0
13150;-1;676;50;34;5;29;.853;3548000;0
13152;11500;472;0;0;0;0;.00nan;0;0
13152;173840;5004;92;40;2;38;.950;3791000;0
13152;171673;5004;0;0;0;0;.00nan;0;0
13152;71297;472;86;29;1;28;.966;3791000;0
13154;193041;482;31;29;6;23;.793;2026000;0
13154;163695;482;71;22;1;21;.955;1553000;0
13154;176765;476;0;0;0;0;.00nan;0;0
13154;87894;476;46;20;4;16;.800;3600000;0
13156;173823;682;0;0;0;0;.00nan;0;0
13156;-1;480;0;0;0;0;.00nan;0;0
13156;-1;480;80;35;2;33;.943;3600000;0
13156;146184;682;87;19;0;19;1.000;3600000;0
13158;163528;490;60;23;2;21;.913;3600000;0
13158;46139;473;65;9;0;9;1.000;690000;0
13158;78422;490;0;0;0;0;.00nan;0;0
13158;153779;473;55;37;6;31;.838;2910000;0
826;199114;4535;0;0;0;0;.00nan;0;0
826;193870;4535;76;23;1;22;.957;3600000;0
826;24593;676;68;35;4;31;.886;3600000;0
826;-1;676;0;0;0;0;.00nan;0;0
827;11500;472;54;19;2;17;.895;3039000;0
827;-1;480;77;29;2;27;.931;3600000;0
827;-1;480;0;0;0;0;.00nan;0;0
827;71297;472;31;10;3;7;.700;561000;0
828;199114;4535;0;0;0;0;.00nan;0;0
828;193870;4535;69;23;2;21;.913;3600000;0
828;24593;676;64;36;4;32;.889;3593000;0
828;-1;676;0;0;0;0;.00nan;0;0
829;11500;472;0;0;0;0;.00nan;0;0
829;-1;480;64;29;3;26;.897;4287000;0
829;-1;480;0;0;0;0;.00nan;0;0
829;71297;472;68;36;4;32;.889;4287000;0
886;199114;4535;0;0;0;0;.00nan;0;0
886;193870;4535;42;50;8;42;.840;3600000;0
886;176765;476;52;12;2;10;.833;3600000;0
886;87894;476;0;0;0;0;.00nan;0;0
887;173823;682;0;0;0;0;.00nan;0;0
887;-1;480;74;34;2;32;.941;3568000;0
887;-1;480;0;0;0;0;.00nan;0;0
887;146184;682;67;19;1;18;.947;3600000;0
888;163528;490;66;22;2;20;.909;3600000;0
888;170042;481;63;38;4;34;.895;3521000;0
888;190235;481;0;0;0;0;.00nan;0;0
888;78422;490;0;0;0;0;.00nan;0;0
889;173840;5004;0;0;0;0;.00nan;0;0
889;171673;5004;81;27;2;25;.926;3600000;0
889;67222;675;0;0;0;0;.00nan;0;0
889;142583;675;46;21;4;17;.810;3545000;0
890;199114;4535;0;0;0;0;.00nan;0;0
890;193870;4535;76;43;4;39;.907;3572000;0
890;176765;476;47;14;2;12;.857;3600000;0
890;87894;476;0;0;0;0;.00nan;0;0
891;173823;682;73;11;0;11;1.000;1380000;0
891;-1;480;45;33;5;28;.848;3564000;0
891;-1;480;0;0;0;0;.00nan;0;0
891;146184;682;48;25;4;21;.840;2220000;0
892;163528;490;73;27;2;25;.926;3600000;0
892;170042;481;47;32;5;27;.844;3600000;0
892;190235;481;0;0;0;0;.00nan;0;0
892;78422;490;0;0;0;0;.00nan;0;0
893;173840;5004;0;0;0;0;.00nan;0;0
893;171673;5004;100;30;0;30;1.000;3600000;0
893;67222;675;0;0;0;0;.00nan;0;0
893;142583;675;54;19;2;17;.895;3579000;0
894;199114;4535;0;0;0;0;.00nan;0;0
894;193870;4535;89;35;2;33;.943;3600000;0
894;176765;476;77;11;0;11;1.000;3600000;0
894;87894;476;0;0;0;0;.00nan;0;0
895;173823;682;0;0;0;0;.00nan;0;0
895;-1;480;60;27;3;24;.889;3600000;0
895;-1;480;0;0;0;0;.00nan;0;0
895;146184;682;43;26;5;21;.808;3600000;0
896;163528;490;44;18;3;15;.833;3597000;0
896;170042;481;92;44;2;42;.955;3600000;0
896;190235;481;0;0;0;0;.00nan;0;0
896;78422;490;0;0;0;0;.00nan;0;0
897;173840;5004;0;0;0;0;.00nan;0;0
897;171673;5004;78;44;2;42;.955;4476000;0
897;67222;675;0;0;0;0;.00nan;0;0
897;142583;675;69;31;3;28;.903;4476000;0
898;199114;4535;0;0;0;0;.00nan;0;0
898;193870;4535;92;36;1;35;.972;3676000;0
898;176765;476;67;22;2;20;.909;3676000;0
898;87894;476;0;0;0;0;.00nan;0;0
899;173823;682;0;0;0;0;.00nan;0;0
899;-1;480;85;42;3;39;.929;3600000;0
899;-1;480;0;0;0;0;.00nan;0;0
899;146184;682;32;25;5;20;.800;3552000;0
900;163528;490;46;20;3;17;.850;3594000;0
900;170042;481;85;34;2;32;.941;3600000;0
900;190235;481;0;0;0;0;.00nan;0;0
900;78422;490;0;0;0;0;.00nan;0;0
901;173840;5004;0;0;0;0;.00nan;0;0
901;171673;5004;62;28;3;25;.893;3560000;0
901;67222;675;0;0;0;0;.00nan;0;0
901;142583;675;70;27;2;25;.926;3600000;0
1049;199114;4535;0;0;0;0;.00nan;0;0
1049;193870;4535;99;55;1;54;.982;3600000;0
1049;176765;476;48;19;3;16;.842;3529000;0
1049;87894;476;0;0;0;0;.00nan;0;0
1050;173823;682;0;0;0;0;.00nan;0;0
1050;-1;480;73;38;3;35;.921;3600000;0
1050;-1;480;0;0;0;0;.00nan;0;0
1050;146184;682;20;19;5;14;.737;3588000;0
1051;163528;490;15;20;6;14;.700;2606000;0
1051;170042;481;71;38;4;34;.895;3600000;0
1051;190235;481;0;0;0;0;.00nan;0;0
1051;78422;490;46;5;1;4;.800;994000;0
1052;173840;5004;0;0;0;0;.00nan;0;0
1052;171673;5004;86;31;1;30;.968;3562000;0
1052;67222;675;0;0;0;0;.00nan;0;0
1052;142583;675;85;13;0;13;1.000;3600000;0
1182;199114;4535;0;0;0;0;.00nan;0;0
1182;193870;4535;89;56;3;53;.946;3600000;0
1182;176765;476;63;15;1;14;.933;3600000;0
1182;87894;476;0;0;0;0;.00nan;0;0
1183;173823;682;0;0;0;0;.00nan;0;0
1183;-1;480;12;24;7;17;.708;2354000;0
1183;-1;480;64;16;1;15;.938;1246000;0
1183;146184;682;69;20;1;19;.950;3600000;0
1184;163528;490;58;38;3;35;.921;5112000;0
1184;170042;481;53;31;4;27;.871;5112000;0
1184;190235;481;0;0;0;0;.00nan;0;0
1184;78422;490;0;0;0;0;.00nan;0;0
1185;173840;5004;0;0;0;0;.00nan;0;0
1185;171673;5004;83;46;3;43;.935;3600000;0
1185;67222;675;0;0;0;0;.00nan;0;0
1185;142583;675;47;27;4;23;.852;3600000;0
1277;173823;682;0;0;0;0;.00nan;0;0
1277;-1;480;68;32;3;29;.906;3568000;0
1277;-1;480;0;0;0;0;.00nan;0;0
1277;146184;682;65;16;2;14;.875;3600000;0
1278;163528;490;92;38;2;36;.947;3600000;0
1278;170042;481;84;43;3;40;.930;3551000;0
1278;190235;481;0;0;0;0;.00nan;0;0
1278;78422;490;0;0;0;0;.00nan;0;0
1322;173840;5004;0;0;0;0;.00nan;0;0
1322;171673;5004;78;32;2;30;.938;3590000;0
1322;176765;476;68;14;1;13;.929;3600000;0
1322;87894;476;0;0;0;0;.00nan;0;0
1323;163528;490;61;28;3;25;.893;3548000;0
1323;173823;682;0;0;0;0;.00nan;0;0
1323;78422;490;0;0;0;0;.00nan;0;0
1323;146184;682;81;24;1;23;.958;3600000;0
1324;173840;5004;0;0;0;0;.00nan;0;0
1324;171673;5004;86;45;2;43;.956;3531000;0
1324;176765;476;99;19;0;19;1.000;3600000;0
1324;87894;476;0;0;0;0;.00nan;0;0
1325;163528;490;28;29;6;23;.793;3600000;0
1325;173823;682;0;0;0;0;.00nan;0;0
1325;78422;490;0;0;0;0;.00nan;0;0
1325;146184;682;61;27;3;24;.889;3600000;0
1326;173840;5004;0;0;0;0;.00nan;0;0
1326;171673;5004;98;47;1;46;.979;3600000;0
1326;176765;476;80;12;0;12;1.000;3600000;0
1326;87894;476;0;0;0;0;.00nan;0;0
1327;163528;490;80;26;1;25;.962;3600000;0
1327;173823;682;0;0;0;0;.00nan;0;0
1327;78422;490;0;0;0;0;.00nan;0;0
1327;146184;682;59;31;4;27;.871;3600000;0
1328;173840;5004;0;0;0;0;.00nan;0;0
1328;171673;5004;82;46;4;42;.913;3600000;0
1328;176765;476;78;11;0;11;1.000;3600000;0
1328;87894;476;0;0;0;0;.00nan;0;0
1329;163528;490;76;31;2;29;.935;3923000;0
1329;173823;682;0;0;0;0;.00nan;0;0
1329;78422;490;0;0;0;0;.00nan;0;0
1329;146184;682;76;24;1;23;.958;3923000;0
1558;163528;490;64;34;4;30;.882;3596000;0
1558;173823;682;0;0;0;0;.00nan;0;0
1558;78422;490;0;0;0;0;.00nan;0;0
1558;146184;682;83;30;2;28;.933;3600000;0
1608;173823;682;0;0;0;0;.00nan;0;0
1608;176765;476;63;14;1;13;.929;3600000;0
1608;87894;476;0;0;0;0;.00nan;0;0
1608;146184;682;71;31;2;29;.935;3584000;0
1609;173823;682;0;0;0;0;.00nan;0;0
1609;176765;476;61;17;1;16;.941;3600000;0
1609;87894;476;0;0;0;0;.00nan;0;0
1609;146184;682;83;45;4;41;.911;3600000;0
1610;173823;682;0;0;0;0;.00nan;0;0
1610;176765;476;59;26;3;23;.885;3546000;0
1610;87894;476;0;0;0;0;.00nan;0;0
1610;146184;682;84;37;2;35;.946;3600000;0
1611;173823;682;0;0;0;0;.00nan;0;0
1611;176765;476;51;28;4;24;.857;3545000;0
1611;87894;476;0;0;0;0;.00nan;0;0
1611;146184;682;46;18;3;15;.833;3600000;0
1846;173823;682;0;0;0;0;.00nan;0;0
1846;176765;476;76;23;1;22;.957;3600000;0
1846;87894;476;0;0;0;0;.00nan;0;0
1846;146184;682;79;36;2;34;.944;3599000;0
1871;173823;682;0;0;0;0;.00nan;0;0
1871;176765;476;35;22;4;18;.818;3600000;0
1871;87894;476;0;0;0;0;.00nan;0;0
1871;146184;682;75;33;3;30;.909;3600000;0
1895;173823;682;0;0;0;0;.00nan;0;0
1895;176765;476;66;26;3;23;.885;3570000;0
1895;87894;476;0;0;0;0;.00nan;0;0
1895;146184;682;89;41;2;39;.951;3600000;0
13159;177124;496;73;37;4;33;.892;3587000;0
13159;203533;497;100;49;3;46;.939;3600000;0
13159;202104;497;0;0;0;0;.00nan;0;0
13159;158630;496;0;0;0;0;.00nan;0;0
13160;3075;505;0;0;0;0;.00nan;0;0
13160;-1;504;85;30;1;29;.967;3600000;0
13160;-1;504;0;0;0;0;.00nan;0;0
13160;94508;505;84;25;2;23;.920;3600000;0
13161;208778;4636;0;0;0;0;.00nan;0;0
13161;165611;4636;70;26;2;24;.923;3676000;0
13161;189433;498;100;31;1;30;.968;3676000;0
13161;196374;498;0;0;0;0;.00nan;0;0
13162;504;495;76;26;1;25;.962;3600000;0
13162;-1;495;0;0;0;0;.00nan;0;0
13162;197409;502;74;34;2;32;.941;3548000;0
13162;148829;502;0;0;0;0;.00nan;0;0
13163;170543;503;36;25;5;20;.800;3600000;0
13163;175593;500;60;15;1;14;.933;3600000;0
13163;195887;500;0;0;0;0;.00nan;0;0
13163;-1;503;0;0;0;0;.00nan;0;0
13164;169680;499;78;13;0;13;1.000;3600000;0
13164;185442;2591;85;43;3;40;.930;3600000;0
13164;-1;2591;0;0;0;0;.00nan;0;0
13164;71485;499;0;0;0;0;.00nan;0;0
13165;189433;498;71;30;3;27;.900;3627000;0
13165;196374;498;0;0;0;0;.00nan;0;0
13165;197409;502;0;0;0;0;.00nan;0;0
13165;148829;502;81;34;2;32;.941;3627000;0
13166;504;495;60;18;1;17;.944;3600000;0
13166;-1;495;0;0;0;0;.00nan;0;0
13166;170543;503;69;35;4;31;.886;3600000;0
13166;-1;503;0;0;0;0;.00nan;0;0
13167;169680;499;72;25;1;24;.960;3600000;0
13167;175593;500;95;46;2;44;.957;3546000;0
13167;195887;500;0;0;0;0;.00nan;0;0
13167;71485;499;0;0;0;0;.00nan;0;0
13168;3075;505;84;30;1;29;.967;3600000;0
13168;185442;2591;11;23;7;16;.696;2444000;0
13168;-1;2591;53;12;1;11;.917;1156000;0
13168;94508;505;0;0;0;0;.00nan;0;0
13169;177124;496;74;22;1;21;.955;3600000;0
13169;208778;4636;0;0;0;0;.00nan;0;0
13169;165611;4636;84;37;2;35;.946;3545000;0
13169;158630;496;0;0;0;0;.00nan;0;0
13170;203533;497;67;21;1;20;.952;3900000;0
13170;-1;504;100;44;1;43;.977;3900000;0
13170;-1;504;0;0;0;0;.00nan;0;0
13170;202104;497;0;0;0;0;.00nan;0;0
13171;189433;498;0;0;0;0;.00nan;0;0
13171;196374;498;60;18;2;16;.889;3543000;0
13171;197409;502;0;0;0;0;.00nan;0;0
13171;148829;502;100;33;0;33;1.000;3600000;0
13172;504;495;56;17;1;16;.941;3600000;0
13172;-1;495;0;0;0;0;.00nan;0;0
13172;170543;503;62;41;5;36;.878;3600000;0
13172;-1;503;0;0;0;0;.00nan;0;0
13173;169680;499;97;43;1;42;.977;3900000;0
13173;175593;500;91;25;1;24;.960;3900000;0
13173;195887;500;0;0;0;0;.00nan;0;0
13173;71485;499;0;0;0;0;.00nan;0;0
13174;3075;505;31;25;5;20;.800;3600000;0
13174;185442;2591;100;35;0;35;1.000;3600000;0
13174;-1;2591;0;0;0;0;.00nan;0;0
13174;94508;505;0;0;0;0;.00nan;0;0
13175;177124;496;66;34;3;31;.912;3600000;0
13175;208778;4636;0;0;0;0;.00nan;0;0
13175;165611;4636;95;25;0;25;1.000;3600000;0
13175;158630;496;0;0;0;0;.00nan;0;0
13176;203533;497;0;0;0;0;.00nan;0;0
13176;-1;504;100;33;0;33;1.000;3600000;0
13176;-1;504;0;0;0;0;.00nan;0;0
13176;202104;497;85;31;1;30;.968;3543000;0
13177;208778;4636;0;0;0;0;.00nan;0;0
13177;165611;4636;54;22;3;19;.864;3553000;0
13177;-1;504;65;28;2;26;.929;3600000;0
13177;-1;504;0;0;0;0;.00nan;0;0
13178;203533;497;100;32;0;32;1.000;3900000;0
13178;202104;497;0;0;0;0;.00nan;0;0
13178;185442;2591;96;32;0;32;1.000;3900000;0
13178;-1;2591;0;0;0;0;.00nan;0;0
13179;177124;496;65;23;2;21;.913;3600000;0
13179;189433;498;71;37;3;34;.919;3543000;0
13179;196374;498;0;0;0;0;.00nan;0;0
13179;158630;496;0;0;0;0;.00nan;0;0
13180;504;495;65;27;3;24;.889;3796000;0
13180;-1;495;0;0;0;0;.00nan;0;0
13180;169680;499;63;35;4;31;.886;3796000;0
13180;71485;499;0;0;0;0;.00nan;0;0
13181;170543;503;82;35;3;32;.914;3567000;0
13181;-1;503;0;0;0;0;.00nan;0;0
13181;197409;502;0;0;0;0;.00nan;0;0
13181;148829;502;74;25;2;23;.920;3600000;0
13182;3075;505;74;36;2;34;.944;3545000;0
13182;175593;500;0;0;0;0;.00nan;0;0
13182;195887;500;69;16;1;15;.938;3600000;0
13182;94508;505;0;0;0;0;.00nan;0;0
13183;208778;4636;0;0;0;0;.00nan;0;0
13183;165611;4636;64;16;1;15;.938;3600000;0
13183;-1;504;90;41;2;39;.951;3559000;0
13183;-1;504;0;0;0;0;.00nan;0;0
13184;203533;497;58;35;4;31;.886;3600000;0
13184;202104;497;0;0;0;0;.00nan;0;0
13184;185442;2591;100;30;0;30;1.000;3600000;0
13184;-1;2591;0;0;0;0;.00nan;0;0
13185;177124;496;69;34;3;31;.912;3565000;0
13185;189433;498;65;20;2;18;.900;3600000;0
13185;196374;498;0;0;0;0;.00nan;0;0
13185;158630;496;0;0;0;0;.00nan;0;0
13186;504;495;0;0;0;0;.00nan;0;0
13186;-1;495;95;43;2;41;.953;3600000;0
13186;169680;499;44;26;4;22;.846;3539000;0
13186;71485;499;0;0;0;0;.00nan;0;0
13187;170543;503;98;42;2;40;.952;3900000;0
13187;-1;503;0;0;0;0;.00nan;0;0
13187;197409;502;76;32;2;30;.938;3900000;0
13187;148829;502;0;0;0;0;.00nan;0;0
13188;3075;505;0;0;0;0;.00nan;0;0
13188;175593;500;96;22;0;22;1.000;3600000;0
13188;195887;500;0;0;0;0;.00nan;0;0
13188;94508;505;71;46;4;42;.913;3600000;0
13189;504;495;67;17;1;16;.941;3600000;0
13189;3075;505;61;35;4;31;.886;3600000;0
13189;-1;495;0;0;0;0;.00nan;0;0
13189;94508;505;0;0;0;0;.00nan;0;0
13190;203533;497;0;0;0;0;.00nan;0;0
13190;175593;500;67;24;2;22;.917;3541000;0
13190;195887;500;0;0;0;0;.00nan;0;0
13190;202104;497;100;32;0;32;1.000;3600000;0
13191;169680;499;94;20;0;20;1.000;3600000;0
13191;197409;502;0;0;0;0;.00nan;0;0
13191;71485;499;0;0;0;0;.00nan;0;0
13191;148829;502;92;42;1;41;.976;3600000;0
13192;177124;496;100;33;0;33;1.000;3600000;0
13192;-1;504;70;29;3;26;.897;3600000;0
13192;-1;504;0;0;0;0;.00nan;0;0
13192;158630;496;0;0;0;0;.00nan;0;0
13193;168872;498;32;21;5;16;.762;3529000;0
13193;189433;498;0;0;0;0;.00nan;0;0
13193;170543;503;78;40;3;37;.925;3600000;0
13193;-1;503;0;0;0;0;.00nan;0;0
13194;208778;4636;27;20;5;15;.750;3600000;0
13194;165611;4636;0;0;0;0;.00nan;0;0
13194;185442;2591;44;36;6;30;.833;3198000;0
13194;-1;2591;55;3;0;3;1.000;351000;0
13195;504;495;0;0;0;0;.00nan;0;0
13195;3075;505;0;0;0;0;.00nan;0;0
13195;-1;495;51;19;3;16;.842;3600000;0
13195;94508;505;58;32;4;28;.875;3565000;0
13196;203533;497;0;0;0;0;.00nan;0;0
13196;175593;500;44;14;3;11;.786;3553000;0
13196;195887;500;0;0;0;0;.00nan;0;0
13196;202104;497;77;30;2;28;.933;3600000;0
13197;169680;499;81;27;2;25;.926;3600000;0
13197;197409;502;0;0;0;0;.00nan;0;0
13197;71485;499;0;0;0;0;.00nan;0;0
13197;148829;502;42;29;5;24;.828;3600000;0
13198;177124;496;70;34;3;31;.912;3600000;0
13198;-1;504;100;25;0;25;1.000;3600000;0
13198;-1;504;0;0;0;0;.00nan;0;0
13198;158630;496;0;0;0;0;.00nan;0;0
13199;168872;498;87;27;2;25;.926;3554000;0
13199;189433;498;0;0;0;0;.00nan;0;0
13199;170543;503;71;21;1;20;.952;3600000;0
13199;-1;503;0;0;0;0;.00nan;0;0
13200;208778;4636;0;0;0;0;.00nan;0;0
13200;165611;4636;76;28;2;26;.929;3600000;0
13200;185442;2591;64;26;3;23;.885;3575000;0
13200;-1;2591;0;0;0;0;.00nan;0;0
13201;3075;505;62;46;5;41;.891;3600000;0
13201;197409;502;60;23;2;21;.913;3600000;0
13201;94508;505;0;0;0;0;.00nan;0;0
13201;148829;502;0;0;0;0;.00nan;0;0
13202;208778;4636;0;0;0;0;.00nan;0;0
13202;165611;4636;100;42;2;40;.952;3773000;0
13202;175593;500;0;0;0;0;.00nan;0;0
13202;195887;500;53;20;3;17;.850;3773000;0
13203;177124;496;58;25;4;21;.840;3685000;0
13203;185442;2591;66;35;3;32;.914;3685000;0
13203;-1;2591;0;0;0;0;.00nan;0;0
13203;158630;496;0;0;0;0;.00nan;0;0
13204;504;495;0;0;0;0;.00nan;0;0
13204;203533;497;55;27;3;24;.889;3600000;0
13204;-1;495;84;23;1;22;.957;3600000;0
13204;202104;497;0;0;0;0;.00nan;0;0
13205;169680;499;60;16;2;14;.875;3600000;0
13205;170543;503;92;53;4;49;.925;3571000;0
13205;-1;503;0;0;0;0;.00nan;0;0
13205;71485;499;0;0;0;0;.00nan;0;0
13206;168872;498;57;21;2;19;.905;3537000;0
13206;189433;498;0;0;0;0;.00nan;0;0
13206;-1;504;100;29;0;29;1.000;3600000;0
13206;-1;504;0;0;0;0;.00nan;0;0
13207;3075;505;0;0;0;0;.00nan;0;0
13207;197409;502;0;0;0;0;.00nan;0;0
13207;94508;505;85;28;1;27;.964;3560000;0
13207;148829;502;100;22;0;22;1.000;3600000;0
13208;208778;4636;0;0;0;0;.00nan;0;0
13208;165611;4636;71;38;4;34;.895;3542000;0
13208;175593;500;79;35;3;32;.914;3600000;0
13208;195887;500;0;0;0;0;.00nan;0;0
13209;177124;496;91;35;1;34;.971;3900000;0
13209;185442;2591;89;30;1;29;.967;3900000;0
13209;-1;2591;0;0;0;0;.00nan;0;0
13209;158630;496;0;0;0;0;.00nan;0;0
13210;504;495;85;30;1;29;.967;3600000;0
13210;203533;497;0;0;0;0;.00nan;0;0
13210;-1;495;0;0;0;0;.00nan;0;0
13210;202104;497;63;17;2;15;.882;3544000;0
13211;169680;499;71;16;1;15;.938;3600000;0
13211;170543;503;96;40;3;37;.925;3549000;0
13211;-1;503;0;0;0;0;.00nan;0;0
13211;71485;499;0;0;0;0;.00nan;0;0
13212;168872;498;77;30;2;28;.933;3600000;0
13212;189433;498;0;0;0;0;.00nan;0;0
13212;-1;504;62;35;4;31;.886;3581000;0
13212;-1;504;0;0;0;0;.00nan;0;0
13213;-1;504;0;0;0;0;.00nan;0;0
13213;-1;504;59;33;4;29;.879;3582000;0
13213;185442;2591;89;28;2;26;.929;3600000;0
13213;-1;2591;0;0;0;0;.00nan;0;0
13214;3075;505;47;24;3;21;.875;3600000;0
13214;170543;503;84;30;2;28;.933;3600000;0
13214;-1;503;0;0;0;0;.00nan;0;0
13214;94508;505;0;0;0;0;.00nan;0;0
13215;203533;497;84;26;1;25;.962;3600000;0
13215;202104;497;0;0;0;0;.00nan;0;0
13215;197409;502;0;0;0;0;.00nan;0;0
13215;148829;502;66;22;2;20;.909;3550000;0
13216;177124;496;100;25;0;25;1.000;3600000;0
13216;175593;500;59;20;2;18;.900;3540000;0
13216;195887;500;0;0;0;0;.00nan;0;0
13216;158630;496;0;0;0;0;.00nan;0;0
13217;504;495;0;0;0;0;.00nan;0;0
13217;208778;4636;0;0;0;0;.00nan;0;0
13217;165611;4636;97;38;1;37;.974;3600000;0
13217;-1;495;80;14;0;14;1.000;3600000;0
13218;168872;498;63;41;5;36;.878;3561000;0
13218;189433;498;0;0;0;0;.00nan;0;0
13218;169680;499;66;32;4;28;.875;3600000;0
13218;71485;499;0;0;0;0;.00nan;0;0
13219;-1;504;69;30;3;27;.900;3600000;0
13219;-1;504;0;0;0;0;.00nan;0;0
13219;185442;2591;62;24;2;22;.917;3600000;0
13219;-1;2591;0;0;0;0;.00nan;0;0
13220;3075;505;0;0;0;0;.00nan;0;0
13220;170543;503;97;32;1;31;.969;3900000;0
13220;-1;503;0;0;0;0;.00nan;0;0
13220;94508;505;100;27;1;26;.963;3900000;0
13221;203533;497;70;27;2;25;.926;3600000;0
13221;202104;497;0;0;0;0;.00nan;0;0
13221;197409;502;0;0;0;0;.00nan;0;0
13221;148829;502;69;25;3;22;.880;3560000;0
13222;177124;496;93;34;1;33;.971;3600000;0
13222;175593;500;96;27;0;27;1.000;3600000;0
13222;195887;500;0;0;0;0;.00nan;0;0
13222;158630;496;0;0;0;0;.00nan;0;0
13223;504;495;24;30;7;23;.767;3600000;0
13223;208778;4636;0;0;0;0;.00nan;0;0
13223;165611;4636;63;22;2;20;.909;3600000;0
13223;-1;495;0;0;0;0;.00nan;0;0
13224;168872;498;90;35;1;34;.971;3576000;0
13224;189433;498;0;0;0;0;.00nan;0;0
13224;169680;499;100;26;0;26;1.000;3600000;0
13224;71485;499;0;0;0;0;.00nan;0;0
13225;504;495;0;0;0;0;.00nan;0;0
13225;177124;496;85;26;1;25;.962;3600000;0
13225;-1;495;59;22;2;20;.909;3546000;0
13225;158630;496;0;0;0;0;.00nan;0;0
13226;175593;500;100;24;0;24;1.000;3600000;0
13226;195887;500;0;0;0;0;.00nan;0;0
13226;-1;504;98;46;1;45;.978;3600000;0
13226;-1;504;0;0;0;0;.00nan;0;0
13227;3075;505;71;52;5;47;.904;3600000;0
13227;169680;499;95;22;0;22;1.000;3600000;0
13227;71485;499;0;0;0;0;.00nan;0;0
13227;94508;505;0;0;0;0;.00nan;0;0
13228;208778;4636;0;0;0;0;.00nan;0;0
13228;165611;4636;86;29;1;28;.966;3600000;0
13228;197409;502;100;27;0;27;1.000;3600000;0
13228;148829;502;0;0;0;0;.00nan;0;0
13229;203533;497;46;11;2;9;.818;3600000;0
13229;170543;503;0;0;0;0;.00nan;0;0
13229;202104;497;0;0;0;0;.00nan;0;0
13229;-1;503;68;45;5;40;.889;3600000;0
13230;168872;498;92;51;3;48;.941;3528000;0
13230;189433;498;0;0;0;0;.00nan;0;0
13230;185442;2591;88;26;1;25;.962;3600000;0
13230;-1;2591;0;0;0;0;.00nan;0;0
13231;504;495;68;26;2;24;.923;3593000;0
13231;177124;496;100;51;1;50;.980;3600000;0
13231;-1;495;0;0;0;0;.00nan;0;0
13231;158630;496;0;0;0;0;.00nan;0;0
13232;175593;500;68;11;1;10;.909;3600000;0
13232;195887;500;0;0;0;0;.00nan;0;0
13232;-1;504;82;44;3;41;.932;3554000;0
13232;-1;504;0;0;0;0;.00nan;0;0
13233;3075;505;0;0;0;0;.00nan;0;0
13233;169680;499;67;22;2;20;.909;3600000;0
13233;71485;499;0;0;0;0;.00nan;0;0
13233;94508;505;71;42;4;38;.905;3600000;0
13234;208778;4636;0;0;0;0;.00nan;0;0
13234;165611;4636;61;34;4;30;.882;3518000;0
13234;197409;502;78;34;2;32;.941;3600000;0
13234;148829;502;0;0;0;0;.00nan;0;0
13235;203533;497;0;0;0;0;.00nan;0;0
13235;170543;503;67;45;4;41;.911;3811000;0
13235;202104;497;29;21;5;16;.762;3811000;0
13235;-1;503;0;0;0;0;.00nan;0;0
13236;168872;498;55;45;5;40;.889;3586000;0
13236;189433;498;0;0;0;0;.00nan;0;0
13236;185442;2591;54;24;3;21;.875;3600000;0
13236;-1;2591;0;0;0;0;.00nan;0;0
13237;504;495;67;17;1;16;.941;3600000;0
13237;-1;495;0;0;0;0;.00nan;0;0
13237;-1;504;57;42;5;37;.881;3600000;0
13237;-1;504;0;0;0;0;.00nan;0;0
13238;208778;4636;0;0;0;0;.00nan;0;0
13238;165611;4636;95;29;1;28;.966;3600000;0
13238;170543;503;59;26;3;23;.885;3539000;0
13238;-1;503;0;0;0;0;.00nan;0;0
13239;203533;497;68;34;4;30;.882;3900000;0
13239;169680;499;51;32;4;28;.875;3900000;0
13239;202104;497;0;0;0;0;.00nan;0;0
13239;71485;499;0;0;0;0;.00nan;0;0
13240;177124;496;0;0;0;0;.00nan;0;0
13240;197409;502;0;0;0;0;.00nan;0;0
13240;148829;502;52;25;5;20;.800;3597000;0
13240;158630;496;91;36;3;33;.917;3600000;0
13241;3075;505;46;24;4;20;.833;3600000;0
13241;168872;498;71;45;5;40;.889;3527000;0
13241;189433;498;0;0;0;0;.00nan;0;0
13241;94508;505;0;0;0;0;.00nan;0;0
13242;175593;500;86;15;0;15;1.000;3600000;0
13242;195887;500;0;0;0;0;.00nan;0;0
13242;185442;2591;64;33;4;29;.879;3600000;0
13242;-1;2591;0;0;0;0;.00nan;0;0
13243;504;495;0;0;0;0;.00nan;0;0
13243;-1;495;79;10;0;10;1.000;3600000;0
13243;-1;504;97;43;1;42;.977;3566000;0
13243;-1;504;0;0;0;0;.00nan;0;0
13244;208778;4636;0;0;0;0;.00nan;0;0
13244;165611;4636;89;26;1;25;.962;3600000;0
13244;170543;503;69;32;3;29;.906;3530000;0
13244;-1;503;0;0;0;0;.00nan;0;0
13245;203533;497;0;0;0;0;.00nan;0;0
13245;169680;499;52;26;3;23;.885;3600000;0
13245;202104;497;80;30;1;29;.967;3600000;0
13245;71485;499;0;0;0;0;.00nan;0;0
13246;177124;496;54;25;3;22;.880;3895000;0
13246;197409;502;74;28;3;25;.893;3900000;0
13246;148829;502;0;0;0;0;.00nan;0;0
13246;158630;496;0;0;0;0;.00nan;0;0
13247;3075;505;0;0;0;0;.00nan;0;0
13247;168872;498;66;30;3;27;.900;3595000;0
13247;189433;498;0;0;0;0;.00nan;0;0
13247;94508;505;76;22;2;20;.909;3600000;0
13248;175593;500;52;11;1;10;.909;3900000;0
13248;195887;500;0;0;0;0;.00nan;0;0
13248;185442;2591;100;47;1;46;.979;3900000;0
13248;-1;2591;0;0;0;0;.00nan;0;0
13249;504;495;67;24;2;22;.917;3583000;0
13249;-1;495;0;0;0;0;.00nan;0;0
13249;185442;2591;92;28;1;27;.964;3600000;0
13249;-1;2591;0;0;0;0;.00nan;0;0
13250;-1;504;61;39;4;35;.897;3600000;0
13250;-1;504;0;0;0;0;.00nan;0;0
13250;197409;502;83;25;1;24;.960;3600000;0
13250;148829;502;0;0;0;0;.00nan;0;0
13251;177124;496;62;24;3;21;.875;3576000;0
13251;170543;503;82;30;1;29;.967;3600000;0
13251;-1;503;0;0;0;0;.00nan;0;0
13251;158630;496;0;0;0;0;.00nan;0;0
13252;3075;505;49;36;5;31;.861;3600000;0
13252;203533;497;71;25;2;23;.920;3600000;0
13252;202104;497;0;0;0;0;.00nan;0;0
13252;94508;505;0;0;0;0;.00nan;0;0
13253;208778;4636;0;0;0;0;.00nan;0;0
13253;165611;4636;76;27;1;26;.963;3622000;0
13253;169680;499;100;22;0;22;1.000;3622000;0
13253;71485;499;0;0;0;0;.00nan;0;0
13254;168872;498;94;35;1;34;.971;3600000;0
13254;189433;498;0;0;0;0;.00nan;0;0
13254;175593;500;72;24;3;21;.875;3572000;0
13254;195887;500;0;0;0;0;.00nan;0;0
13255;504;495;0;0;0;0;.00nan;0;0
13255;-1;495;50;24;3;21;.875;3900000;0
13255;185442;2591;79;36;3;33;.917;3900000;0
13255;-1;2591;0;0;0;0;.00nan;0;0
13256;-1;504;93;34;1;33;.971;3600000;0
13256;-1;504;0;0;0;0;.00nan;0;0
13256;197409;502;0;0;0;0;.00nan;0;0
13256;148829;502;80;34;2;32;.941;3548000;0
13257;177124;496;89;20;0;20;1.000;3600000;0
13257;170543;503;84;39;1;38;.974;3576000;0
13257;-1;503;0;0;0;0;.00nan;0;0
13257;158630;496;0;0;0;0;.00nan;0;0
13258;3075;505;0;0;0;0;.00nan;0;0
13258;203533;497;0;0;0;0;.00nan;0;0
13258;202104;497;62;30;3;27;.900;3615000;0
13258;94508;505;67;33;4;29;.879;3615000;0
13259;208778;4636;0;0;0;0;.00nan;0;0
13259;165611;4636;58;38;4;34;.895;3600000;0
13259;169680;499;93;19;0;19;1.000;3600000;0
13259;71485;499;0;0;0;0;.00nan;0;0
13260;168872;498;75;33;3;30;.909;3600000;0
13260;189433;498;0;0;0;0;.00nan;0;0
13260;175593;500;86;13;0;13;1.000;3600000;0
13260;195887;500;0;0;0;0;.00nan;0;0
13261;177124;496;96;48;1;47;.979;3570000;0
13261;169680;499;80;15;0;15;1.000;3600000;0
13261;71485;499;0;0;0;0;.00nan;0;0
13261;158630;496;0;0;0;0;.00nan;0;0
13262;3075;505;63;33;3;30;.909;3550000;0
13262;208778;4636;0;0;0;0;.00nan;0;0
13262;165611;4636;78;23;2;21;.913;3600000;0
13262;94508;505;0;0;0;0;.00nan;0;0
13263;203533;497;31;25;5;20;.800;3600000;0
13263;168872;498;73;36;2;34;.944;3600000;0
13263;189433;498;0;0;0;0;.00nan;0;0
13263;202104;497;0;0;0;0;.00nan;0;0
13264;170543;503;65;28;2;26;.929;3600000;0
13264;-1;504;49;19;3;16;.842;3553000;0
13264;-1;504;0;0;0;0;.00nan;0;0
13264;-1;503;0;0;0;0;.00nan;0;0
13265;504;495;0;0;0;0;.00nan;0;0
13265;-1;495;80;31;1;30;.968;3698000;0
13265;175593;500;79;28;2;26;.929;3698000;0
13265;195887;500;0;0;0;0;.00nan;0;0
13266;185442;2591;85;23;1;22;.957;3600000;0
13266;197409;502;100;30;0;30;1.000;3600000;0
13266;-1;2591;0;0;0;0;.00nan;0;0
13266;148829;502;0;0;0;0;.00nan;0;0
13267;177124;496;67;46;6;40;.870;3272000;0
13267;169680;499;63;15;1;14;.933;3600000;0
13267;71485;499;0;0;0;0;.00nan;0;0
13267;158630;496;50;1;0;1;1.000;328000;0
13268;3075;505;0;0;0;0;.00nan;0;0
13268;208778;4636;0;0;0;0;.00nan;0;0
13268;165611;4636;74;28;2;26;.929;3600000;0
13268;94508;505;52;22;3;19;.864;3543000;0
13269;203533;497;0;0;0;0;.00nan;0;0
13269;168872;498;80;35;2;33;.943;3900000;0
13269;189433;498;0;0;0;0;.00nan;0;0
13269;202104;497;85;30;2;28;.933;3900000;0
13270;170543;503;91;32;1;31;.969;3600000;0
13270;-1;504;71;26;2;24;.923;3544000;0
13270;-1;504;0;0;0;0;.00nan;0;0
13270;-1;503;0;0;0;0;.00nan;0;0
13271;504;495;54;27;4;23;.852;3609000;0
13271;-1;495;0;0;0;0;.00nan;0;0
13271;175593;500;0;0;0;0;.00nan;0;0
13271;195887;500;63;29;3;26;.897;3609000;0
13272;185442;2591;73;35;3;32;.914;3600000;0
13272;197409;502;53;30;4;26;.867;3582000;0
13272;-1;2591;0;0;0;0;.00nan;0;0
13272;148829;502;0;0;0;0;.00nan;0;0
13273;175593;500;100;36;1;35;.972;3900000;0
13273;195887;500;0;0;0;0;.00nan;0;0
13273;197409;502;0;0;0;0;.00nan;0;0
13273;148829;502;86;28;1;27;.964;3900000;0
13274;170543;503;0;0;0;0;.00nan;0;0
13274;185442;2591;76;28;2;26;.929;3900000;0
13274;-1;503;82;35;2;33;.943;3900000;0
13274;-1;2591;0;0;0;0;.00nan;0;0
13275;504;495;0;0;0;0;.00nan;0;0
13275;-1;495;81;24;1;23;.958;3600000;0
13275;168872;498;76;44;3;41;.932;3581000;0
13275;189433;498;0;0;0;0;.00nan;0;0
13276;177124;496;77;31;2;29;.935;3900000;0
13276;3075;505;75;35;2;33;.943;3900000;0
13276;94508;505;0;0;0;0;.00nan;0;0
13276;158630;496;0;0;0;0;.00nan;0;0
13277;208778;4636;0;0;0;0;.00nan;0;0
13277;203533;497;75;28;1;27;.964;3571000;0
13277;165611;4636;100;34;0;34;1.000;3600000;0
13277;202104;497;0;0;0;0;.00nan;0;0
13278;169680;499;67;19;1;18;.947;3600000;0
13278;-1;504;40;40;6;34;.850;3083000;0
13278;-1;504;31;10;3;7;.700;517000;0
13278;71485;499;0;0;0;0;.00nan;0;0
13279;175593;500;100;30;0;30;1.000;3600000;0
13279;195887;500;0;0;0;0;.00nan;0;0
13279;197409;502;0;0;0;0;.00nan;0;0
13279;148829;502;83;31;2;29;.935;3560000;0
13280;170543;503;79;34;2;32;.941;3576000;0
13280;185442;2591;66;17;1;16;.941;3600000;0
13280;-1;503;0;0;0;0;.00nan;0;0
13280;-1;2591;0;0;0;0;.00nan;0;0
13281;504;495;69;22;1;21;.955;3600000;0
13281;-1;495;0;0;0;0;.00nan;0;0
13281;168872;498;31;35;6;29;.829;3600000;0
13281;189433;498;0;0;0;0;.00nan;0;0
13282;177124;496;76;30;2;28;.933;3600000;0
13282;3075;505;73;36;3;33;.917;3600000;0
13282;94508;505;0;0;0;0;.00nan;0;0
13282;158630;496;0;0;0;0;.00nan;0;0
13283;208778;4636;52;2;0;2;1.000;340000;0
13283;203533;497;0;0;0;0;.00nan;0;0
13283;165611;4636;45;33;6;27;.818;3260000;0
13283;202104;497;41;18;3;15;.833;3600000;0
13284;169680;499;87;17;0;17;1.000;3600000;0
13284;-1;504;54;34;4;30;.882;3600000;0
13284;-1;504;0;0;0;0;.00nan;0;0
13284;71485;499;0;0;0;0;.00nan;0;0
13285;504;495;0;0;0;0;.00nan;0;0
13285;-1;495;81;32;3;29;.906;3546000;0
13285;197409;502;74;32;2;30;.938;3600000;0
13285;148829;502;0;0;0;0;.00nan;0;0
13286;170543;503;100;46;0;46;1.000;3600000;0
13286;175593;500;69;16;1;15;.938;3559000;0
13286;195887;500;0;0;0;0;.00nan;0;0
13286;-1;503;0;0;0;0;.00nan;0;0
13287;169680;499;91;31;1;30;.968;3600000;0
13287;185442;2591;65;26;2;24;.923;3577000;0
13287;-1;2591;0;0;0;0;.00nan;0;0
13287;71485;499;0;0;0;0;.00nan;0;0
13288;3075;505;0;0;0;0;.00nan;0;0
13288;-1;504;67;30;2;28;.933;3596000;0
13288;-1;504;0;0;0;0;.00nan;0;0
13288;94508;505;77;28;1;27;.964;3600000;0
13289;208778;4636;0;0;0;0;.00nan;0;0
13289;165611;4636;75;27;1;26;.963;3600000;0
13289;168872;498;33;24;5;19;.792;3600000;0
13289;189433;498;0;0;0;0;.00nan;0;0
13290;177124;496;63;43;5;38;.884;3600000;0
13290;203533;497;88;30;1;29;.967;3600000;0
13290;202104;497;0;0;0;0;.00nan;0;0
13290;158630;496;0;0;0;0;.00nan;0;0
13291;504;495;64;17;1;16;.941;3900000;0
13291;-1;495;0;0;0;0;.00nan;0;0
13291;197409;502;0;0;0;0;.00nan;0;0
13291;148829;502;100;48;1;47;.979;3900000;0
13292;170543;503;100;43;0;43;1.000;3600000;0
13292;175593;500;56;11;1;10;.909;3596000;0
13292;195887;500;0;0;0;0;.00nan;0;0
13292;-1;503;0;0;0;0;.00nan;0;0
13293;169680;499;0;0;0;0;.00nan;0;0
13293;185442;2591;58;31;4;27;.871;3600000;0
13293;-1;2591;0;0;0;0;.00nan;0;0
13293;71485;499;56;20;3;17;.850;3600000;0
13294;3075;505;67;22;2;20;.909;3600000;0
13294;-1;504;65;34;4;30;.882;3513000;0
13294;-1;504;0;0;0;0;.00nan;0;0
13294;94508;505;0;0;0;0;.00nan;0;0
13295;208778;4636;0;0;0;0;.00nan;0;0
13295;165611;4636;84;29;2;27;.931;3600000;0
13295;168872;498;51;21;3;18;.857;3554000;0
13295;189433;498;0;0;0;0;.00nan;0;0
13296;177124;496;79;46;4;42;.913;3600000;0
13296;203533;497;0;0;0;0;.00nan;0;0
13296;202104;497;56;20;2;18;.900;3600000;0
13296;158630;496;0;0;0;0;.00nan;0;0
13297;177124;496;89;33;1;32;.970;3900000;0
13297;208778;4636;0;0;0;0;.00nan;0;0
13297;165611;4636;96;34;1;33;.971;3900000;0
13297;158630;496;0;0;0;0;.00nan;0;0
13298;203533;497;100;28;0;28;1.000;3600000;0
13298;-1;504;0;0;0;0;.00nan;0;0
13298;-1;504;77;30;1;29;.967;3591000;0
13298;202104;497;0;0;0;0;.00nan;0;0
13299;3075;505;27;7;3;4;.571;1139000;0
13299;185442;2591;0;0;0;0;.00nan;0;0
13299;-1;2591;92;23;0;23;1.000;3600000;0
13299;94508;505;34;27;6;21;.778;2461000;0
13300;504;495;0;0;0;0;.00nan;0;0
13300;-1;495;66;17;1;16;.941;3600000;0
13300;170543;503;93;44;2;42;.955;3558000;0
13300;-1;503;0;0;0;0;.00nan;0;0
13301;169680;499;86;15;0;15;1.000;3600000;0
13301;175593;500;0;0;0;0;.00nan;0;0
13301;195887;500;83;39;3;36;.923;3600000;0
13301;71485;499;0;0;0;0;.00nan;0;0
13302;168872;498;0;0;0;0;.00nan;0;0
13302;189433;498;79;31;2;29;.935;3544000;0
13302;197409;502;67;21;1;20;.952;3600000;0
13302;148829;502;0;0;0;0;.00nan;0;0
13303;177124;496;87;23;1;22;.957;3900000;0
13303;208778;4636;0;0;0;0;.00nan;0;0
13303;165611;4636;89;30;1;29;.967;3900000;0
13303;158630;496;0;0;0;0;.00nan;0;0
13304;203533;497;52;16;2;14;.875;3600000;0
13304;-1;504;85;48;3;45;.938;3591000;0
13304;-1;504;0;0;0;0;.00nan;0;0
13304;202104;497;0;0;0;0;.00nan;0;0
13305;3075;505;94;38;2;36;.947;3600000;0
13305;185442;2591;0;0;0;0;.00nan;0;0
13305;-1;2591;43;39;6;33;.846;3600000;0
13305;94508;505;0;0;0;0;.00nan;0;0
13306;504;495;73;22;1;21;.955;3600000;0
13306;-1;495;0;0;0;0;.00nan;0;0
13306;170543;503;83;52;4;48;.923;3600000;0
13306;-1;503;0;0;0;0;.00nan;0;0
13307;169680;499;76;19;1;18;.947;3600000;0
13307;175593;500;80;39;2;37;.949;3595000;0
13307;195887;500;0;0;0;0;.00nan;0;0
13307;71485;499;0;0;0;0;.00nan;0;0
13308;168872;498;54;33;4;29;.879;3514000;0
13308;189433;498;0;0;0;0;.00nan;0;0
13308;197409;502;0;0;0;0;.00nan;0;0
13308;148829;502;75;22;2;20;.909;3600000;0
13309;3075;505;0;0;0;0;.00nan;0;0
13309;175593;500;89;35;2;33;.943;3545000;0
13309;195887;500;0;0;0;0;.00nan;0;0
13309;94508;505;92;33;1;32;.970;3600000;0
13310;170543;503;96;46;1;45;.978;3900000;0
13310;-1;503;0;0;0;0;.00nan;0;0
13310;197409;502;89;26;1;25;.962;3900000;0
13310;148829;502;0;0;0;0;.00nan;0;0
13311;504;495;61;19;2;17;.895;3600000;0
13311;-1;495;0;0;0;0;.00nan;0;0
13311;169680;499;70;29;3;26;.897;3600000;0
13311;71485;499;0;0;0;0;.00nan;0;0
13312;177124;496;70;38;3;35;.921;3600000;0
13312;168872;498;79;46;4;42;.913;3570000;0
13312;189433;498;0;0;0;0;.00nan;0;0
13312;158630;496;0;0;0;0;.00nan;0;0
13313;208778;4636;0;0;0;0;.00nan;0;0
13313;165611;4636;91;18;0;18;1.000;3600000;0
13313;-1;504;88;39;2;37;.949;3517000;0
13313;-1;504;0;0;0;0;.00nan;0;0
13314;203533;497;100;24;0;24;1.000;3600000;0
13314;202104;497;0;0;0;0;.00nan;0;0
13314;185442;2591;59;35;5;30;.857;3600000;0
13314;-1;2591;0;0;0;0;.00nan;0;0
13315;3075;505;55;24;3;21;.875;3900000;0
13315;175593;500;66;31;3;28;.903;3900000;0
13315;195887;500;0;0;0;0;.00nan;0;0
13315;94508;505;0;0;0;0;.00nan;0;0
13316;170543;503;0;0;0;0;.00nan;0;0
13316;-1;503;66;29;2;27;.931;3515000;0
13316;197409;502;0;0;0;0;.00nan;0;0
13316;148829;502;99;24;0;24;1.000;3600000;0
13317;504;495;0;0;0;0;.00nan;0;0
13317;-1;495;49;22;3;19;.864;3900000;0
13317;169680;499;74;29;3;26;.897;3900000;0
13317;71485;499;0;0;0;0;.00nan;0;0
13318;177124;496;78;33;3;30;.909;3855000;0
13318;168872;498;70;28;2;26;.929;3855000;0
13318;189433;498;0;0;0;0;.00nan;0;0
13318;158630;496;0;0;0;0;.00nan;0;0
13319;208778;4636;0;0;0;0;.00nan;0;0
13319;165611;4636;73;18;1;17;.944;3600000;0
13319;-1;504;70;31;4;27;.871;3600000;0
13319;-1;504;0;0;0;0;.00nan;0;0
13320;203533;497;64;29;3;26;.897;3544000;0
13320;202104;497;0;0;0;0;.00nan;0;0
13320;185442;2591;63;27;2;25;.926;3600000;0
13320;-1;2591;0;0;0;0;.00nan;0;0
13321;177124;496;53;23;3;20;.870;3600000;0
13321;-1;504;69;35;4;31;.886;3589000;0
13321;-1;504;0;0;0;0;.00nan;0;0
13321;158630;496;0;0;0;0;.00nan;0;0
13322;208778;4636;0;0;0;0;.00nan;0;0
13322;165611;4636;99;37;1;36;.973;3600000;0
13322;185442;2591;65;25;2;23;.920;3554000;0
13322;-1;2591;0;0;0;0;.00nan;0;0
13323;168872;498;86;20;0;20;1.000;3600000;0
13323;189433;498;0;0;0;0;.00nan;0;0
13323;170543;503;88;37;3;34;.919;3600000;0
13323;-1;503;0;0;0;0;.00nan;0;0
13324;504;495;0;0;0;0;.00nan;0;0
13324;3075;505;0;0;0;0;.00nan;0;0
13324;-1;495;73;26;2;24;.923;3551000;0
13324;94508;505;82;27;1;26;.963;3600000;0
13325;169680;499;53;30;4;26;.867;3600000;0
13325;197409;502;0;0;0;0;.00nan;0;0
13325;71485;499;0;0;0;0;.00nan;0;0
13325;148829;502;84;26;1;25;.962;3600000;0
13326;203533;497;77;37;3;34;.919;3561000;0
13326;175593;500;63;12;1;11;.917;3600000;0
13326;195887;500;0;0;0;0;.00nan;0;0
13326;202104;497;0;0;0;0;.00nan;0;0
13327;177124;496;65;26;2;24;.923;3555000;0
13327;-1;504;93;33;1;32;.970;3600000;0
13327;-1;504;0;0;0;0;.00nan;0;0
13327;158630;496;0;0;0;0;.00nan;0;0
13328;208778;4636;0;0;0;0;.00nan;0;0
13328;165611;4636;46;36;5;31;.861;3600000;0
13328;185442;2591;76;21;1;20;.952;3600000;0
13328;-1;2591;0;0;0;0;.00nan;0;0
13329;168872;498;63;23;2;21;.913;3517000;0
13329;189433;498;0;0;0;0;.00nan;0;0
13329;170543;503;91;21;0;21;1.000;3600000;0
13329;-1;503;0;0;0;0;.00nan;0;0
13330;504;495;77;24;1;23;.958;3600000;0
13330;3075;505;76;43;3;40;.930;3600000;0
13330;-1;495;0;0;0;0;.00nan;0;0
13330;94508;505;0;0;0;0;.00nan;0;0
13331;169680;499;76;23;1;22;.957;3628000;0
13331;197409;502;77;33;2;31;.939;3628000;0
13331;71485;499;0;0;0;0;.00nan;0;0
13331;148829;502;0;0;0;0;.00nan;0;0
13332;203533;497;0;0;0;0;.00nan;0;0
13332;175593;500;100;27;0;27;1.000;3600000;0
13332;195887;500;0;0;0;0;.00nan;0;0
13332;202104;497;88;40;2;38;.950;3525000;0
13333;168872;498;80;25;1;24;.960;3600000;0
13333;189433;498;0;0;0;0;.00nan;0;0
13333;-1;504;84;32;2;30;.938;3592000;0
13333;-1;504;0;0;0;0;.00nan;0;0
13334;504;495;0;0;0;0;.00nan;0;0
13334;203533;497;100;39;0;39;1.000;3600000;0
13334;-1;495;69;24;2;22;.917;3535000;0
13334;202104;497;0;0;0;0;.00nan;0;0
13335;169680;499;58;16;2;14;.875;3600000;0
13335;170543;503;85;46;3;43;.935;3600000;0
13335;-1;503;0;0;0;0;.00nan;0;0
13335;71485;499;0;0;0;0;.00nan;0;0
13336;177124;496;55;33;4;29;.879;3535000;0
13336;185442;2591;73;24;2;22;.917;3600000;0
13336;-1;2591;0;0;0;0;.00nan;0;0
13336;158630;496;0;0;0;0;.00nan;0;0
13337;3075;505;0;0;0;0;.00nan;0;0
13337;197409;502;21;17;5;12;.706;3545000;0
13337;94508;505;73;41;4;37;.902;3600000;0
13337;148829;502;0;0;0;0;.00nan;0;0
13338;208778;4636;75;41;3;38;.927;3600000;0
13338;165611;4636;0;0;0;0;.00nan;0;0
13338;175593;500;88;16;0;16;1.000;3600000;0
13338;195887;500;0;0;0;0;.00nan;0;0
13339;168872;498;58;30;3;27;.900;3531000;0
13339;189433;498;0;0;0;0;.00nan;0;0
13339;-1;504;100;37;1;36;.973;3600000;0
13339;-1;504;0;0;0;0;.00nan;0;0
13340;504;495;100;38;0;38;1.000;3600000;0
13340;203533;497;72;28;2;26;.929;3562000;0
13340;-1;495;0;0;0;0;.00nan;0;0
13340;202104;497;0;0;0;0;.00nan;0;0
13341;169680;499;91;14;0;14;1.000;3600000;0
13341;170543;503;98;52;1;51;.981;3593000;0
13341;-1;503;0;0;0;0;.00nan;0;0
13341;71485;499;0;0;0;0;.00nan;0;0
13342;177124;496;93;27;0;27;1.000;3600000;0
13342;185442;2591;82;34;2;32;.941;3580000;0
13342;-1;2591;0;0;0;0;.00nan;0;0
13342;158630;496;0;0;0;0;.00nan;0;0
13343;3075;505;100;38;1;37;.974;3900000;0
13343;197409;502;0;0;0;0;.00nan;0;0
13343;94508;505;0;0;0;0;.00nan;0;0
13343;148829;502;95;29;1;28;.966;3900000;0
13344;208778;4636;0;0;0;0;.00nan;0;0
13344;165611;4636;53;27;3;24;.889;3600000;0
13344;175593;500;81;13;0;13;1.000;3600000;0
13344;195887;500;0;0;0;0;.00nan;0;0
13345;504;495;71;18;1;17;.944;3600000;0
13345;208778;4636;0;0;0;0;.00nan;0;0
13345;165611;4636;69;23;2;21;.913;3571000;0
13345;-1;495;0;0;0;0;.00nan;0;0
13346;177124;496;89;38;3;35;.921;3599000;0
13346;175593;500;74;19;1;18;.947;3600000;0
13346;195887;500;0;0;0;0;.00nan;0;0
13346;158630;496;0;0;0;0;.00nan;0;0
13347;168872;498;79;41;2;39;.951;3600000;0
13347;189433;498;0;0;0;0;.00nan;0;0
13347;169680;499;57;27;3;24;.889;3549000;0
13347;71485;499;0;0;0;0;.00nan;0;0
13348;203533;497;71;46;4;42;.913;3800000;0
13348;202104;497;0;0;0;0;.00nan;0;0
13348;197409;502;95;26;0;26;1.000;3371000;0
13348;148829;502;25;5;3;2;.400;429000;0
13349;3075;505;0;0;0;0;.00nan;0;0
13349;170543;503;57;33;4;29;.879;3549000;0
13349;-1;503;0;0;0;0;.00nan;0;0
13349;94508;505;62;27;3;24;.889;3600000;0
13350;-1;504;98;48;1;47;.979;3600000;0
13350;-1;504;0;0;0;0;.00nan;0;0
13350;185442;2591;96;23;0;23;1.000;3600000;0
13350;-1;2591;0;0;0;0;.00nan;0;0
13351;504;495;0;0;0;0;.00nan;0;0
13351;165611;4636;74;41;4;37;.902;3600000;0
13351;-1;495;87;16;0;16;1.000;3600000;0
13351;82273;4636;0;0;0;0;.00nan;0;0
13352;177124;496;40;36;6;30;.833;3305000;0
13352;175593;500;50;28;4;24;.857;3600000;0
13352;195887;500;0;0;0;0;.00nan;0;0
13352;158630;496;41;6;2;4;.667;295000;0
13353;168872;498;84;28;1;27;.964;3600000;0
13353;169680;499;47;32;4;28;.875;3600000;0
13353;202516;498;0;0;0;0;.00nan;0;0
13353;71485;499;0;0;0;0;.00nan;0;0
13354;203533;497;65;21;2;19;.905;3600000;0
13354;202104;497;0;0;0;0;.00nan;0;0
13354;197409;502;86;40;3;37;.925;3577000;0
13354;148829;502;0;0;0;0;.00nan;0;0
13355;3075;505;85;35;2;33;.943;3900000;0
13355;170543;503;100;51;2;49;.961;3900000;0
13355;-1;503;0;0;0;0;.00nan;0;0
13355;94508;505;0;0;0;0;.00nan;0;0
13356;-1;504;81;28;1;27;.964;3600000;0
13356;185442;2591;70;27;2;25;.926;3587000;0
13356;-1;2591;0;0;0;0;.00nan;0;0
13356;152624;504;0;0;0;0;.00nan;0;0
13357;165611;4636;100;34;0;34;1.000;3600000;0
13357;197409;502;0;0;0;0;.00nan;0;0
13357;82273;4636;0;0;0;0;.00nan;0;0
13357;148829;502;98;50;2;48;.960;3555000;0
13358;168872;498;82;32;1;31;.969;3900000;0
13358;189433;498;0;0;0;0;.00nan;0;0
13358;185442;2591;81;26;1;25;.962;3900000;0
13358;-1;2591;0;0;0;0;.00nan;0;0
13359;203533;497;0;0;0;0;.00nan;0;0
13359;170543;503;68;47;6;41;.872;3600000;0
13359;202104;497;64;24;2;22;.917;3600000;0
13359;-1;503;0;0;0;0;.00nan;0;0
13360;504;495;0;0;0;0;.00nan;0;0
13360;177124;496;70;30;3;27;.900;3600000;0
13360;-1;495;58;16;2;14;.875;3600000;0
13360;158630;496;0;0;0;0;.00nan;0;0
13361;175593;500;98;23;0;23;1.000;3600000;0
13361;195887;500;0;0;0;0;.00nan;0;0
13361;-1;504;89;36;1;35;.972;3600000;0
13361;152624;504;0;0;0;0;.00nan;0;0
13362;3075;505;0;0;0;0;.00nan;0;0
13362;169680;499;80;24;2;22;.917;3679000;0
13362;71485;499;0;0;0;0;.00nan;0;0
13362;94508;505;70;33;3;30;.909;3679000;0
13363;165611;4636;73;48;4;44;.917;3546000;0
13363;197409;502;0;0;0;0;.00nan;0;0
13363;82273;4636;0;0;0;0;.00nan;0;0
13363;148829;502;55;23;3;20;.870;3600000;0
13364;168872;498;65;30;3;27;.900;3541000;0
13364;189433;498;0;0;0;0;.00nan;0;0
13364;185442;2591;91;33;1;32;.970;3600000;0
13364;-1;2591;0;0;0;0;.00nan;0;0
13365;203533;497;67;18;1;17;.944;3600000;0
13365;170543;503;90;42;2;40;.952;3593000;0
13365;202104;497;0;0;0;0;.00nan;0;0
13365;-1;503;0;0;0;0;.00nan;0;0
13366;504;495;30;26;6;20;.769;3344000;0
13366;177124;496;0;0;0;0;.00nan;0;0
13366;-1;495;53;2;0;2;1.000;188000;0
13366;158630;496;48;24;4;20;.833;3600000;0
13367;175593;500;68;17;1;16;.941;3600000;0
13367;195887;500;0;0;0;0;.00nan;0;0
13367;-1;504;86;30;2;28;.933;3572000;0
13367;152624;504;0;0;0;0;.00nan;0;0
13368;3075;505;50;30;5;25;.833;3321000;0
13368;169680;499;61;26;3;23;.885;3600000;0
13368;71485;499;0;0;0;0;.00nan;0;0
13368;94508;505;52;2;0;2;1.000;258000;0
13369;177124;496;62;20;2;18;.900;3600000;0
13369;197409;502;0;0;0;0;.00nan;0;0
13369;148829;502;83;34;3;31;.912;3559000;0
13369;158630;496;0;0;0;0;.00nan;0;0
13370;175593;500;0;0;0;0;.00nan;0;0
13370;195887;500;55;27;3;24;.889;3900000;0
13370;185442;2591;83;28;3;25;.893;3895000;0
13370;-1;2591;0;0;0;0;.00nan;0;0
13371;203533;497;82;25;1;24;.960;3561000;0
13371;169680;499;100;29;0;29;1.000;3600000;0
13371;202104;497;0;0;0;0;.00nan;0;0
13371;71485;499;0;0;0;0;.00nan;0;0
13372;504;495;0;0;0;0;.00nan;0;0
13372;-1;495;68;19;2;17;.895;3900000;0
13372;-1;504;90;40;2;38;.950;3900000;0
13372;152624;504;0;0;0;0;.00nan;0;0
13373;165611;4636;70;20;1;19;.950;3600000;0
13373;170543;503;95;38;2;36;.947;3553000;0
13373;-1;503;0;0;0;0;.00nan;0;0
13373;82273;4636;0;0;0;0;.00nan;0;0
13374;3075;505;0;0;0;0;.00nan;0;0
13374;168872;498;66;36;4;32;.889;3600000;0
13374;189433;498;0;0;0;0;.00nan;0;0
13374;94508;505;70;21;1;20;.952;3600000;0
13375;177124;496;45;27;4;23;.852;3600000;0
13375;197409;502;99;23;0;23;1.000;3600000;0
13375;148829;502;0;0;0;0;.00nan;0;0
13375;158630;496;0;0;0;0;.00nan;0;0
13376;175593;500;79;24;1;23;.958;3600000;0
13376;195887;500;0;0;0;0;.00nan;0;0
13376;185442;2591;87;39;3;36;.923;3566000;0
13376;-1;2591;0;0;0;0;.00nan;0;0
13377;203533;497;92;28;2;26;.929;3600000;0
13377;169680;499;38;29;5;24;.828;3600000;0
13377;202104;497;0;0;0;0;.00nan;0;0
13377;71485;499;0;0;0;0;.00nan;0;0
13378;504;495;52;17;2;15;.882;3600000;0
13378;-1;495;0;0;0;0;.00nan;0;0
13378;-1;504;60;39;3;36;.923;3600000;0
13378;152624;504;0;0;0;0;.00nan;0;0
13379;165611;4636;71;18;1;17;.944;3900000;0
13379;170543;503;94;35;1;34;.971;3900000;0
13379;-1;503;0;0;0;0;.00nan;0;0
13379;82273;4636;0;0;0;0;.00nan;0;0
13380;3075;505;85;40;3;37;.925;3577000;0
13380;168872;498;94;32;1;31;.969;3600000;0
13380;189433;498;0;0;0;0;.00nan;0;0
13380;94508;505;0;0;0;0;.00nan;0;0
13381;165611;4636;0;0;0;0;.00nan;0;0
13381;169680;499;36;13;3;10;.769;3566000;0
13381;71485;499;0;0;0;0;.00nan;0;0
13381;82273;4636;83;32;2;30;.938;3600000;0
13382;168872;498;98;30;1;29;.967;3600000;0
13382;189433;498;0;0;0;0;.00nan;0;0
13382;175593;500;63;25;2;23;.920;3545000;0
13382;195887;500;0;0;0;0;.00nan;0;0
13383;3075;505;0;0;0;0;.00nan;0;0
13383;203533;497;100;31;0;31;1.000;3600000;0
13383;202104;497;0;0;0;0;.00nan;0;0
13383;94508;505;93;40;3;37;.925;3600000;0
13384;177124;496;72;20;1;19;.950;3600000;0
13384;170543;503;70;35;3;32;.914;3516000;0
13384;-1;503;0;0;0;0;.00nan;0;0
13384;158630;496;0;0;0;0;.00nan;0;0
13385;-1;504;97;42;3;39;.929;3588000;0
13385;197409;502;75;30;2;28;.933;3600000;0
13385;148829;502;0;0;0;0;.00nan;0;0
13385;152624;504;0;0;0;0;.00nan;0;0
13386;504;495;68;12;0;12;1.000;1367000;0
13386;-1;495;11;16;6;10;.625;2233000;0
13386;185442;2591;54;23;3;20;.870;3600000;0
13386;-1;2591;0;0;0;0;.00nan;0;0
13387;165611;4636;85;36;2;34;.944;3900000;0
13387;169680;499;64;24;2;22;.917;3900000;0
13387;71485;499;0;0;0;0;.00nan;0;0
13387;82273;4636;0;0;0;0;.00nan;0;0
13388;168872;498;53;41;6;35;.854;3353000;0
13388;189433;498;50;1;0;1;1.000;247000;0
13388;175593;500;73;27;3;24;.889;3600000;0
13388;195887;500;0;0;0;0;.00nan;0;0
13389;3075;505;94;55;3;52;.945;3622000;0
13389;203533;497;83;35;2;33;.943;3622000;0
13389;202104;497;0;0;0;0;.00nan;0;0
13389;94508;505;0;0;0;0;.00nan;0;0
13390;177124;496;80;30;2;28;.933;3600000;0
13390;170543;503;50;23;3;20;.870;3552000;0
13390;-1;503;0;0;0;0;.00nan;0;0
13390;158630;496;0;0;0;0;.00nan;0;0
13391;-1;504;0;0;0;0;.00nan;0;0
13391;197409;502;35;15;3;12;.800;3561000;0
13391;148829;502;0;0;0;0;.00nan;0;0
13391;152624;504;85;38;2;36;.947;3600000;0
13392;504;495;66;22;2;20;.909;3536000;0
13392;-1;495;0;0;0;0;.00nan;0;0
13392;185442;2591;100;33;0;33;1.000;3600000;0
13392;-1;2591;0;0;0;0;.00nan;0;0
13393;3075;505;72;25;2;23;.920;3824000;0
13393;165611;4636;53;21;3;18;.857;3824000;0
13393;82273;4636;0;0;0;0;.00nan;0;0
13393;94508;505;0;0;0;0;.00nan;0;0
13394;177124;496;55;37;5;32;.865;3600000;0
13394;169680;499;30;16;4;12;.750;3600000;0
13394;71485;499;0;0;0;0;.00nan;0;0
13394;158630;496;0;0;0;0;.00nan;0;0
13395;203533;497;78;31;2;29;.935;3900000;0
13395;168872;498;92;41;2;39;.951;3900000;0
13395;189433;498;0;0;0;0;.00nan;0;0
13395;202104;497;0;0;0;0;.00nan;0;0
13396;504;495;68;28;2;26;.929;3600000;0
13396;-1;495;0;0;0;0;.00nan;0;0
13396;175593;500;55;30;4;26;.867;3600000;0
13396;195887;500;0;0;0;0;.00nan;0;0
13397;185442;2591;97;47;2;45;.957;3552000;0
13397;197409;502;64;14;1;13;.929;3600000;0
13397;-1;2591;0;0;0;0;.00nan;0;0
13397;148829;502;0;0;0;0;.00nan;0;0
13398;170543;503;95;34;1;33;.971;3600000;0
13398;-1;504;61;20;2;18;.900;3546000;0
13398;-1;503;0;0;0;0;.00nan;0;0
13398;152624;504;0;0;0;0;.00nan;0;0
13399;3075;505;0;0;0;0;.00nan;0;0
13399;165611;4636;84;29;1;28;.966;3600000;0
13399;82273;4636;0;0;0;0;.00nan;0;0
13399;94508;505;53;30;4;26;.867;3600000;0
13400;177124;496;55;24;3;21;.875;3564000;0
13400;169680;499;81;24;1;23;.958;3600000;0
13400;71485;499;0;0;0;0;.00nan;0;0
13400;158630;496;0;0;0;0;.00nan;0;0
13401;203533;497;0;0;0;0;.00nan;0;0
13401;168872;498;85;32;2;30;.938;3600000;0
13401;189433;498;0;0;0;0;.00nan;0;0
13401;202104;497;50;27;4;23;.852;3535000;0
13402;504;495;0;0;0;0;.00nan;0;0
13402;-1;495;80;23;1;22;.957;3600000;0
13402;175593;500;58;19;2;17;.895;3567000;0
13402;195887;500;0;0;0;0;.00nan;0;0
13403;185442;2591;100;54;2;52;.963;3900000;0
13403;197409;502;58;18;2;16;.889;3900000;0
13403;-1;2591;0;0;0;0;.00nan;0;0
13403;148829;502;0;0;0;0;.00nan;0;0
13404;170543;503;92;29;1;28;.966;3600000;0
13404;-1;504;64;32;3;29;.906;3535000;0
13404;-1;503;0;0;0;0;.00nan;0;0
13404;152624;504;0;0;0;0;.00nan;0;0
13405;504;495;56;19;2;17;.895;3600000;0
13405;-1;495;0;0;0;0;.00nan;0;0
13405;168872;498;77;36;3;33;.917;3600000;0
13405;189433;498;0;0;0;0;.00nan;0;0
13406;177124;496;59;26;3;23;.885;3105000;0
13406;3075;505;76;25;1;24;.960;3600000;0
13406;94508;505;0;0;0;0;.00nan;0;0
13406;158630;496;26;6;3;3;.500;495000;0
13407;203533;497;66;21;2;19;.905;3600000;0
13407;165611;4636;51;36;5;31;.861;3600000;0
13407;202104;497;0;0;0;0;.00nan;0;0
13407;82273;4636;0;0;0;0;.00nan;0;0
13408;169680;499;63;27;3;24;.889;3563000;0
13408;-1;504;83;32;1;31;.969;3600000;0
13408;71485;499;0;0;0;0;.00nan;0;0
13408;152624;504;0;0;0;0;.00nan;0;0
13409;175593;500;92;27;1;26;.963;3600000;0
13409;195887;500;0;0;0;0;.00nan;0;0
13409;197409;502;74;23;2;21;.913;3600000;0
13409;148829;502;0;0;0;0;.00nan;0;0
13410;170543;503;67;37;4;33;.892;3600000;0
13410;185442;2591;99;28;0;28;1.000;3600000;0
13410;-1;503;0;0;0;0;.00nan;0;0
13410;-1;2591;0;0;0;0;.00nan;0;0
13411;504;495;0;0;0;0;.00nan;0;0
13411;-1;495;64;20;2;18;.900;3600000;0
13411;168872;498;72;37;3;34;.919;3558000;0
13411;189433;498;0;0;0;0;.00nan;0;0
13412;177124;496;67;26;2;24;.923;3900000;0
13412;3075;505;0;0;0;0;.00nan;0;0
13412;94508;505;95;43;2;41;.953;3900000;0
13412;158630;496;0;0;0;0;.00nan;0;0
13413;203533;497;33;18;5;13;.722;3850000;0
13413;165611;4636;0;0;0;0;.00nan;0;0
13413;202104;497;0;0;0;0;.00nan;0;0
13413;82273;4636;78;43;4;39;.907;3850000;0
13414;169680;499;89;30;2;28;.933;3900000;0
13414;-1;504;77;36;2;34;.944;3900000;0
13414;71485;499;0;0;0;0;.00nan;0;0
13414;152624;504;0;0;0;0;.00nan;0;0
13415;175593;500;0;0;0;0;.00nan;0;0
13415;195887;500;100;37;1;36;.973;3900000;0
13415;197409;502;0;0;0;0;.00nan;0;0
13415;148829;502;80;27;1;26;.963;3900000;0
13416;170543;503;67;22;1;21;.955;3578000;0
13416;185442;2591;100;34;0;34;1.000;3600000;0
13416;-1;503;0;0;0;0;.00nan;0;0
13416;-1;2591;0;0;0;0;.00nan;0;0
13417;185442;2591;73;37;3;34;.919;3900000;0
13417;197409;502;70;31;3;28;.903;3900000;0
13417;-1;2591;0;0;0;0;.00nan;0;0
13417;148829;502;0;0;0;0;.00nan;0;0
13418;170543;503;70;29;2;27;.931;3643000;0
13418;175593;500;76;21;1;20;.952;3643000;0
13418;195887;500;0;0;0;0;.00nan;0;0
13418;-1;503;0;0;0;0;.00nan;0;0
13419;203533;497;57;27;3;24;.889;3600000;0
13419;169680;499;88;34;1;33;.971;3600000;0
13419;202104;497;0;0;0;0;.00nan;0;0
13419;71485;499;0;0;0;0;.00nan;0;0
13420;504;495;61;27;3;24;.889;3600000;0
13420;177124;496;35;28;5;23;.821;3600000;0
13420;-1;495;0;0;0;0;.00nan;0;0
13420;158630;496;0;0;0;0;.00nan;0;0
13421;3075;505;76;30;1;29;.967;3600000;0
13421;-1;504;71;21;2;19;.905;3563000;0
13421;94508;505;0;0;0;0;.00nan;0;0
13421;152624;504;0;0;0;0;.00nan;0;0
13422;165611;4636;58;13;1;12;.923;3600000;0
13422;168872;498;100;25;0;25;1.000;3600000;0
13422;189433;498;0;0;0;0;.00nan;0;0
13422;82273;4636;0;0;0;0;.00nan;0;0
13423;170543;503;56;34;4;30;.882;3600000;0
13423;-1;503;0;0;0;0;.00nan;0;0
13423;197409;502;79;28;1;27;.964;3600000;0
13423;148829;502;0;0;0;0;.00nan;0;0
13424;169680;499;76;21;1;20;.952;3600000;0
13424;175593;500;75;27;2;25;.926;3589000;0
13424;195887;500;0;0;0;0;.00nan;0;0
13424;71485;499;0;0;0;0;.00nan;0;0
13425;203533;497;0;0;0;0;.00nan;0;0
13425;202104;497;85;20;0;20;1.000;3655000;0
13425;185442;2591;93;46;1;45;.978;3655000;0
13425;-1;2591;0;0;0;0;.00nan;0;0
13426;177124;496;19;26;7;19;.731;2020000;0
13426;165611;4636;81;38;3;35;.921;3600000;0
13426;82273;4636;0;0;0;0;.00nan;0;0
13426;158630;496;26;13;4;9;.692;1580000;0
13427;504;495;0;0;0;0;.00nan;0;0
13427;3075;505;0;0;0;0;.00nan;0;0
13427;-1;495;72;30;4;26;.867;3600000;0
13427;94508;505;84;26;1;25;.962;3600000;0
13428;168872;498;85;33;2;31;.939;3803000;0
13428;189433;498;0;0;0;0;.00nan;0;0
13428;-1;504;68;29;3;26;.897;3803000;0
13428;152624;504;0;0;0;0;.00nan;0;0
13429;169680;499;77;19;1;18;.947;3600000;0
13429;197409;502;61;37;4;33;.892;3600000;0
13429;71485;499;0;0;0;0;.00nan;0;0
13429;148829;502;0;0;0;0;.00nan;0;0
13430;175593;500;93;46;3;43;.935;3699000;0
13430;195887;500;0;0;0;0;.00nan;0;0
13430;185442;2591;65;21;2;19;.905;3699000;0
13430;-1;2591;0;0;0;0;.00nan;0;0
13431;203533;497;0;0;0;0;.00nan;0;0
13431;170543;503;94;56;4;52;.929;3715000;0
13431;202104;497;50;21;3;18;.857;3715000;0
13431;-1;503;0;0;0;0;.00nan;0;0
13432;177124;496;86;37;3;34;.919;3900000;0
13432;-1;504;60;30;3;27;.900;3900000;0
13432;152624;504;0;0;0;0;.00nan;0;0
13432;158630;496;0;0;0;0;.00nan;0;0
13433;3075;505;96;31;1;30;.968;3600000;0
13433;165611;4636;75;33;3;30;.909;3563000;0
13433;82273;4636;0;0;0;0;.00nan;0;0
13433;94508;505;0;0;0;0;.00nan;0;0
13434;504;495;47;20;3;17;.850;3600000;0
13434;-1;495;0;0;0;0;.00nan;0;0
13434;168872;498;67;34;4;30;.882;3574000;0
13434;189433;498;0;0;0;0;.00nan;0;0
13435;3075;505;0;0;0;0;.00nan;0;0
13435;170543;503;14;21;6;15;.714;2702000;0
13435;-1;503;48;7;1;6;.857;898000;0
13435;94508;505;71;27;3;24;.889;3600000;0
13436;168872;498;75;35;3;32;.914;3700000;0
13436;189433;498;0;0;0;0;.00nan;0;0
13436;185442;2591;0;0;0;0;.00nan;0;0
13436;-1;2591;60;25;2;23;.920;3700000;0
13437;177124;496;84;42;3;39;.929;3600000;0
13437;169680;499;100;20;0;20;1.000;3600000;0
13437;71485;499;0;0;0;0;.00nan;0;0
13437;158630;496;0;0;0;0;.00nan;0;0
13438;504;495;0;0;0;0;.00nan;0;0
13438;-1;495;69;30;2;28;.933;3600000;0
13438;197409;502;0;0;0;0;.00nan;0;0
13438;148829;502;99;24;0;24;1.000;3600000;0
13439;175593;500;71;17;1;16;.941;3600000;0
13439;195887;500;0;0;0;0;.00nan;0;0
13439;-1;504;0;0;0;0;.00nan;0;0
13439;152624;504;98;54;4;50;.926;3600000;0
13440;203533;497;63;30;3;27;.900;3600000;0
13440;165611;4636;63;32;4;28;.875;3564000;0
13440;202104;497;0;0;0;0;.00nan;0;0
13440;82273;4636;0;0;0;0;.00nan;0;0
13441;177124;496;29;31;6;25;.806;3548000;0
13441;170543;503;0;0;0;0;.00nan;0;0
13441;-1;503;100;57;3;54;.947;3600000;0
13441;158630;496;0;0;0;0;.00nan;0;0
13442;3075;505;44;33;5;28;.848;3556000;0
13442;185442;2591;73;30;3;27;.900;3600000;0
13442;-1;2591;0;0;0;0;.00nan;0;0
13442;94508;505;0;0;0;0;.00nan;0;0
13443;168872;498;72;42;4;38;.905;3524000;0
13443;189433;498;0;0;0;0;.00nan;0;0
13443;169680;499;0;0;0;0;.00nan;0;0
13443;71485;499;56;15;2;13;.867;3600000;0
13444;504;495;67;27;3;24;.889;3612000;0
13444;203533;497;57;23;2;21;.913;3612000;0
13444;-1;495;0;0;0;0;.00nan;0;0
13444;202104;497;0;0;0;0;.00nan;0;0
13445;-1;504;83;33;2;31;.939;3519000;0
13445;197409;502;0;0;0;0;.00nan;0;0
13445;148829;502;99;17;0;17;1.000;3600000;0
13445;152624;504;0;0;0;0;.00nan;0;0
13446;165611;4636;82;38;4;34;.895;3600000;0
13446;175593;500;87;15;0;15;1.000;3600000;0
13446;195887;500;0;0;0;0;.00nan;0;0
13446;82273;4636;0;0;0;0;.00nan;0;0
13447;168872;498;53;24;3;21;.875;3520000;0
13447;189433;498;0;0;0;0;.00nan;0;0
13447;170543;503;85;32;1;31;.969;3600000;0
13447;-1;503;0;0;0;0;.00nan;0;0
13448;177124;496;91;52;4;48;.923;3600000;0
13448;185442;2591;100;29;0;29;1.000;3600000;0
13448;-1;2591;0;0;0;0;.00nan;0;0
13448;158630;496;0;0;0;0;.00nan;0;0
13449;3075;505;0;0;0;0;.00nan;0;0
13449;169680;499;81;24;2;22;.917;3900000;0
13449;71485;499;0;0;0;0;.00nan;0;0
13449;94508;505;97;43;2;41;.953;3900000;0
13450;504;495;0;0;0;0;.00nan;0;0
13450;-1;495;66;20;1;19;.950;3900000;0
13450;175593;500;95;32;1;31;.969;3900000;0
13450;195887;500;0;0;0;0;.00nan;0;0
13451;203533;497;70;19;1;18;.947;3600000;0
13451;-1;504;89;46;2;44;.957;3600000;0
13451;202104;497;0;0;0;0;.00nan;0;0
13451;152624;504;0;0;0;0;.00nan;0;0
13452;165611;4636;90;43;2;41;.953;3591000;0
13452;197409;502;0;0;0;0;.00nan;0;0
13452;82273;4636;0;0;0;0;.00nan;0;0
13452;148829;502;76;22;1;21;.955;3600000;0
13453;504;495;48;16;2;14;.875;3600000;0
13453;-1;495;0;0;0;0;.00nan;0;0
13453;-1;504;0;0;0;0;.00nan;0;0
13453;152624;504;96;45;3;42;.933;3572000;0
13454;165611;4636;59;25;3;22;.880;3600000;0
13454;170543;503;100;27;0;27;1.000;3600000;0
13454;-1;503;0;0;0;0;.00nan;0;0
13454;82273;4636;0;0;0;0;.00nan;0;0
13455;169680;499;77;27;2;25;.926;3600000;0
13455;185442;2591;67;27;3;24;.889;3600000;0
13455;-1;2591;0;0;0;0;.00nan;0;0
13455;71485;499;0;0;0;0;.00nan;0;0
13456;177124;496;44;42;7;35;.833;2522000;0
13456;203533;497;47;21;3;18;.857;3600000;0
13456;202104;497;0;0;0;0;.00nan;0;0
13456;158630;496;41;9;2;7;.778;1078000;0
13457;3075;505;93;20;0;20;1.000;3600000;0
13457;197409;502;0;0;0;0;.00nan;0;0
13457;94508;505;0;0;0;0;.00nan;0;0
13457;148829;502;68;35;3;32;.914;3600000;0
13458;168872;498;63;38;4;34;.895;3574000;0
13458;189433;498;0;0;0;0;.00nan;0;0
13458;175593;500;52;14;2;12;.857;3600000;0
13458;195887;500;0;0;0;0;.00nan;0;0
13459;504;495;0;0;0;0;.00nan;0;0
13459;-1;495;59;20;2;18;.900;3525000;0
13459;170543;503;100;30;0;30;1.000;3600000;0
13459;-1;503;0;0;0;0;.00nan;0;0
13460;-1;504;89;42;2;40;.952;3600000;0
13460;185442;2591;70;32;3;29;.906;3565000;0
13460;-1;2591;0;0;0;0;.00nan;0;0
13460;152624;504;0;0;0;0;.00nan;0;0
13461;165611;4636;77;37;3;34;.919;3600000;0
13461;169680;499;81;23;1;22;.957;3600000;0
13461;71485;499;0;0;0;0;.00nan;0;0
13461;82273;4636;0;0;0;0;.00nan;0;0
13462;175593;500;75;23;2;21;.913;3879000;0
13462;195887;500;0;0;0;0;.00nan;0;0
13462;197409;502;0;0;0;0;.00nan;0;0
13462;148829;502;70;30;3;27;.900;3879000;0
13463;177124;496;98;47;1;46;.979;3557000;0
13463;3075;505;89;23;0;23;1.000;3600000;0
13463;94508;505;0;0;0;0;.00nan;0;0
13463;158630;496;0;0;0;0;.00nan;0;0
13464;203533;497;0;0;0;0;.00nan;0;0
13464;168872;498;100;37;0;37;1.000;3600000;0
13464;189433;498;0;0;0;0;.00nan;0;0
13464;202104;497;62;14;1;13;.929;3566000;0
13465;504;495;65;17;1;16;.941;3600000;0
13465;-1;495;0;0;0;0;.00nan;0;0
13465;169680;499;73;25;2;23;.920;3600000;0
13465;71485;499;0;0;0;0;.00nan;0;0
13466;170543;503;74;34;3;31;.912;3561000;0
13466;-1;504;69;23;2;21;.913;3600000;0
13466;-1;503;0;0;0;0;.00nan;0;0
13466;152624;504;0;0;0;0;.00nan;0;0
13467;165611;4636;88;32;1;31;.969;3600000;0
13467;185442;2591;67;32;3;29;.906;3560000;0
13467;-1;2591;0;0;0;0;.00nan;0;0
13467;82273;4636;0;0;0;0;.00nan;0;0
13468;203533;497;71;31;2;29;.935;3600000;0
13468;202104;497;0;0;0;0;.00nan;0;0
13468;197409;502;58;29;4;25;.862;3520000;0
13468;148829;502;0;0;0;0;.00nan;0;0
13469;3075;505;77;33;2;31;.939;3600000;0
13469;175593;500;46;14;3;11;.786;3600000;0
13469;195887;500;0;0;0;0;.00nan;0;0
13469;94508;505;0;0;0;0;.00nan;0;0
13470;177124;496;40;33;5;28;.848;3600000;0
13470;168872;498;100;29;0;29;1.000;3600000;0
13470;189433;498;0;0;0;0;.00nan;0;0
13470;158630;496;0;0;0;0;.00nan;0;0
13471;504;495;0;0;0;0;.00nan;0;0
13471;165611;4636;82;33;2;31;.939;3567000;0
13471;-1;495;74;16;1;15;.938;3600000;0
13471;82273;4636;0;0;0;0;.00nan;0;0
13472;170543;503;42;32;5;27;.844;3600000;0
13472;185442;2591;63;23;2;21;.913;3600000;0
13472;-1;503;0;0;0;0;.00nan;0;0
13472;-1;2591;0;0;0;0;.00nan;0;0
13473;169680;499;86;33;1;32;.970;3600000;0
13473;-1;504;60;35;5;30;.857;3600000;0
13473;71485;499;0;0;0;0;.00nan;0;0
13473;152624;504;0;0;0;0;.00nan;0;0
13474;177124;496;58;40;5;35;.875;3600000;0
13474;175593;500;76;24;2;22;.917;3600000;0
13474;195887;500;0;0;0;0;.00nan;0;0
13474;158630;496;0;0;0;0;.00nan;0;0
13475;3075;505;0;0;0;0;.00nan;0;0
13475;203533;497;59;33;4;29;.879;3900000;0
13475;202104;497;0;0;0;0;.00nan;0;0
13475;94508;505;53;26;4;22;.846;3900000;0
13476;168872;498;97;40;1;39;.975;3600000;0
13476;189433;498;0;0;0;0;.00nan;0;0
13476;197409;502;0;0;0;0;.00nan;0;0
13476;148829;502;96;21;0;21;1.000;3600000;0
13477;165611;4636;72;32;3;29;.906;3531000;0
13477;-1;504;77;23;1;22;.957;3600000;0
13477;82273;4636;0;0;0;0;.00nan;0;0
13477;152624;504;0;0;0;0;.00nan;0;0
13478;504;495;85;19;0;19;1.000;3600000;0
13478;-1;495;0;0;0;0;.00nan;0;0
13478;185442;2591;87;63;4;59;.937;3600000;0
13478;-1;2591;0;0;0;0;.00nan;0;0
13479;169680;499;100;23;0;23;1.000;3600000;0
13479;170543;503;97;42;1;41;.976;3541000;0
13479;-1;503;0;0;0;0;.00nan;0;0
13479;71485;499;0;0;0;0;.00nan;0;0
13480;177124;496;99;34;1;33;.971;3600000;0
13480;197409;502;0;0;0;0;.00nan;0;0
13480;148829;502;70;29;2;27;.931;3545000;0
13480;158630;496;0;0;0;0;.00nan;0;0
13481;203533;497;29;25;5;20;.800;3523000;0
13481;175593;500;68;29;3;26;.897;3600000;0
13481;195887;500;0;0;0;0;.00nan;0;0
13481;202104;497;0;0;0;0;.00nan;0;0
13482;3075;505;0;0;0;0;.00nan;0;0
13482;168872;498;0;0;0;0;.00nan;0;0
13482;189433;498;62;16;1;15;.938;3600000;0
13482;94508;505;67;32;3;29;.906;3587000;0
13483;177124;496;68;51;6;45;.882;3351000;0
13483;203533;497;61;24;3;21;.875;3600000;0
13483;202104;497;0;0;0;0;.00nan;0;0
13483;158630;496;39;1;1;0;.000;249000;0
13484;3075;505;0;0;0;0;.00nan;0;0
13484;-1;504;0;0;0;0;.00nan;0;0
13484;94508;505;92;49;1;48;.980;3600000;0
13484;152624;504;54;26;4;22;.846;3600000;0
13485;165611;4636;51;24;4;20;.833;3554000;0
13485;168872;498;69;23;2;21;.913;3600000;0
13485;189433;498;0;0;0;0;.00nan;0;0
13485;82273;4636;0;0;0;0;.00nan;0;0
13486;504;495;71;17;1;16;.941;3600000;0
13486;-1;495;0;0;0;0;.00nan;0;0
13486;197409;502;0;0;0;0;.00nan;0;0
13486;148829;502;79;43;4;39;.907;3600000;0
13487;170543;503;64;37;4;33;.892;3600000;0
13487;175593;500;63;14;1;13;.929;3600000;0
13487;195887;500;0;0;0;0;.00nan;0;0
13487;-1;503;0;0;0;0;.00nan;0;0
13488;169680;499;71;26;2;24;.923;3543000;0
13488;185442;2591;99;38;1;37;.974;3600000;0
13488;-1;2591;0;0;0;0;.00nan;0;0
13488;71485;499;0;0;0;0;.00nan;0;0
13490;208778;4636;0;0;0;0;.00nan;0;0
13490;165611;4636;58;27;3;24;.889;3600000;0
13490;175593;500;53;29;4;25;.862;3555000;0
13490;195887;500;0;0;0;0;.00nan;0;0
13492;3075;505;77;20;1;19;.950;3600000;0
13492;170543;503;55;34;4;30;.882;3600000;0
13492;-1;503;0;0;0;0;.00nan;0;0
13492;94508;505;0;0;0;0;.00nan;0;0
13494;177124;496;70;31;3;28;.903;3574000;0
13494;203533;497;86;33;2;31;.939;3600000;0
13494;202104;497;0;0;0;0;.00nan;0;0
13494;158630;496;0;0;0;0;.00nan;0;0
13496;169680;499;93;32;1;31;.969;3600000;0
13496;197409;502;65;23;2;21;.913;3569000;0
13496;71485;499;0;0;0;0;.00nan;0;0
13496;148829;502;0;0;0;0;.00nan;0;0
13498;189433;498;66;31;3;28;.903;3595000;0
13498;196374;498;0;0;0;0;.00nan;0;0
13498;185442;2591;53;19;2;17;.895;3600000;0
13498;-1;2591;0;0;0;0;.00nan;0;0
13500;-1;495;61;22;3;19;.864;3600000;0
13500;-1;504;62;36;4;32;.889;3600000;0
13500;-1;504;0;0;0;0;.00nan;0;0
13500;148508;495;0;0;0;0;.00nan;0;0
13502;504;495;72;37;3;34;.919;3547000;0
13502;3075;505;0;0;0;0;.00nan;0;0
13502;-1;495;0;0;0;0;.00nan;0;0
13502;94508;505;74;30;2;28;.933;3600000;0
13504;177124;496;0;0;0;0;.00nan;0;0
13504;169680;499;0;0;0;0;.00nan;0;0
13504;71485;499;72;23;2;21;.913;3600000;0
13504;158630;496;95;56;4;52;.929;3600000;0
13506;203533;497;0;0;0;0;.00nan;0;0
13506;189433;498;0;0;0;0;.00nan;0;0
13506;196374;498;80;33;2;31;.939;3565000;0
13506;202104;497;96;37;1;36;.973;3600000;0
13508;185442;2591;0;0;0;0;.00nan;0;0
13508;197409;502;0;0;0;0;.00nan;0;0
13508;-1;2591;45;28;4;24;.857;3555000;0
13508;148829;502;81;35;3;32;.914;3600000;0
13510;175593;500;0;0;0;0;.00nan;0;0
13510;195887;500;57;24;3;21;.875;3600000;0
13510;-1;504;0;0;0;0;.00nan;0;0
13510;-1;504;63;38;4;34;.895;3600000;0
13512;208778;4636;68;32;3;29;.906;3550000;0
13512;165611;4636;0;0;0;0;.00nan;0;0
13512;170543;503;0;0;0;0;.00nan;0;0
13512;-1;503;100;36;1;35;.972;3600000;0
13514;203533;497;72;28;2;26;.929;3900000;0
13514;175593;500;64;25;2;23;.920;3900000;0
13514;195887;500;0;0;0;0;.00nan;0;0
13514;202104;497;0;0;0;0;.00nan;0;0
13516;177124;496;76;35;3;32;.914;3600000;0
13516;-1;504;32;37;6;31;.838;3600000;0
13516;-1;504;0;0;0;0;.00nan;0;0
13516;158630;496;0;0;0;0;.00nan;0;0
13518;208778;4636;0;0;0;0;.00nan;0;0
13518;165611;4636;46;22;3;19;.864;3600000;0
13518;185442;2591;49;27;4;23;.852;3598000;0
13518;-1;2591;0;0;0;0;.00nan;0;0
13520;504;495;0;0;0;0;.00nan;0;0
13520;-1;495;91;30;1;29;.967;3600000;0
13520;169680;499;57;29;4;25;.862;3600000;0
13520;71485;499;0;0;0;0;.00nan;0;0
13522;189433;498;83;32;2;30;.938;3600000;0
13522;170543;503;67;33;3;30;.909;3600000;0
13522;196374;498;0;0;0;0;.00nan;0;0
13522;-1;503;0;0;0;0;.00nan;0;0
13524;3075;505;0;0;0;0;.00nan;0;0
13524;197409;502;0;0;0;0;.00nan;0;0
13524;94508;505;74;21;1;20;.952;3600000;0
13524;148829;502;36;42;7;35;.833;3600000;0
13526;504;495;69;28;2;26;.929;3555000;0
13526;-1;495;0;0;0;0;.00nan;0;0
13526;197409;502;100;36;0;36;1.000;3600000;0
13526;148829;502;0;0;0;0;.00nan;0;0
13528;203533;497;0;0;0;0;.00nan;0;0
13528;-1;504;0;0;0;0;.00nan;0;0
13528;-1;504;85;41;2;39;.951;3900000;0
13528;202104;497;89;36;2;34;.944;3900000;0
13530;3075;505;76;21;1;20;.952;3600000;0
13530;185442;2591;0;0;0;0;.00nan;0;0
13530;-1;2591;97;47;2;45;.957;3572000;0
13530;94508;505;0;0;0;0;.00nan;0;0
13532;189433;498;0;0;0;0;.00nan;0;0
13532;169680;499;0;0;0;0;.00nan;0;0
13532;196374;498;96;49;0;49;1.000;3900000;0
13532;71485;499;100;31;0;31;1.000;3900000;0
13534;177124;496;0;0;0;0;.00nan;0;0
13534;175593;500;0;0;0;0;.00nan;0;0
13534;195887;500;65;18;1;17;.944;3600000;0
13534;158630;496;74;38;3;35;.921;3600000;0
13536;208778;4636;0;0;0;0;.00nan;0;0
13536;165611;4636;75;22;1;21;.955;3600000;0
13536;170543;503;0;0;0;0;.00nan;0;0
13536;-1;503;72;29;2;27;.931;3553000;0
13538;175593;500;45;16;3;13;.813;3596000;0
13538;195887;500;0;0;0;0;.00nan;0;0
13538;185442;2591;74;29;2;27;.931;3600000;0
13538;-1;2591;0;0;0;0;.00nan;0;0
13540;203533;497;57;20;3;17;.850;3547000;0
13540;170543;503;96;30;1;29;.967;3600000;0
13540;202104;497;0;0;0;0;.00nan;0;0
13540;-1;503;0;0;0;0;.00nan;0;0
13542;169680;499;0;0;0;0;.00nan;0;0
13542;-1;504;84;38;2;36;.947;3581000;0
13542;-1;504;0;0;0;0;.00nan;0;0
13542;71485;499;62;11;1;10;.909;3600000;0
13544;3075;505;0;0;0;0;.00nan;0;0
13544;208778;4636;0;0;0;0;.00nan;0;0
13544;165611;4636;61;24;3;21;.875;3524000;0
13544;94508;505;97;32;1;31;.969;3600000;0
13546;177124;496;65;46;5;41;.891;3600000;0
13546;197409;502;65;19;2;17;.895;3600000;0
13546;148829;502;0;0;0;0;.00nan;0;0
13546;158630;496;0;0;0;0;.00nan;0;0
13548;504;495;0;0;0;0;.00nan;0;0
13548;-1;495;75;11;0;11;1.000;3600000;0
13548;189433;498;0;0;0;0;.00nan;0;0
13548;196374;498;98;53;1;52;.981;3600000;0
13550;208778;4636;0;0;0;0;.00nan;0;0
13550;165611;4636;80;38;4;34;.895;3589000;0
13550;197409;502;0;0;0;0;.00nan;0;0
13550;148829;502;60;22;3;19;.864;3600000;0
13552;177124;496;51;32;4;28;.875;3600000;0
13552;175593;500;51;21;3;18;.857;3600000;0
13552;195887;500;0;0;0;0;.00nan;0;0
13552;158630;496;0;0;0;0;.00nan;0;0
13554;170543;503;65;31;3;28;.903;3577000;0
13554;185442;2591;100;36;1;35;.972;3600000;0
13554;-1;503;0;0;0;0;.00nan;0;0
13554;-1;2591;0;0;0;0;.00nan;0;0
13556;504;495;0;0;0;0;.00nan;0;0
13556;-1;495;74;27;2;25;.926;3600000;0
13556;169680;499;62;28;3;25;.893;3561000;0
13556;71485;499;0;0;0;0;.00nan;0;0
13558;203533;497;0;0;0;0;.00nan;0;0
13558;189433;498;67;33;3;30;.909;3600000;0
13558;196374;498;0;0;0;0;.00nan;0;0
13558;202104;497;67;35;4;31;.886;3571000;0
13560;3075;505;0;0;0;0;.00nan;0;0
13560;-1;504;86;29;1;28;.966;3600000;0
13560;-1;504;0;0;0;0;.00nan;0;0
13560;94508;505;36;18;4;14;.778;3600000;0
13562;177124;496;0;0;0;0;.00nan;0;0
13562;170543;503;0;0;0;0;.00nan;0;0
13562;-1;503;76;28;1;27;.964;3600000;0
13562;158630;496;89;37;2;35;.946;3600000;0
13564;504;495;50;15;2;13;.867;3599000;0
13564;-1;495;0;0;0;0;.00nan;0;0
13564;-1;504;0;0;0;0;.00nan;0;0
13564;-1;504;97;42;1;41;.976;3600000;0
13566;3075;505;71;20;1;19;.950;3600000;0
13566;208778;4636;0;0;0;0;.00nan;0;0
13566;165611;4636;67;28;3;25;.893;3600000;0
13566;94508;505;0;0;0;0;.00nan;0;0
13568;189433;498;0;0;0;0;.00nan;0;0
13568;196374;498;77;39;3;36;.923;3600000;0
13568;197409;502;73;48;4;44;.917;3594000;0
13568;148829;502;0;0;0;0;.00nan;0;0
13570;203533;497;54;25;3;22;.880;3515000;0
13570;202104;497;0;0;0;0;.00nan;0;0
13570;185442;2591;0;0;0;0;.00nan;0;0
13570;-1;2591;74;23;1;22;.957;3600000;0
13572;169680;499;0;0;0;0;.00nan;0;0
13572;175593;500;0;0;0;0;.00nan;0;0
13572;195887;500;98;56;3;53;.946;3554000;0
13572;71485;499;63;17;1;16;.941;3600000;0
911;203533;497;87;39;2;37;.949;3600000;0
911;169680;499;100;24;0;24;1.000;3600000;0
911;202104;497;0;0;0;0;.00nan;0;0
911;71485;499;0;0;0;0;.00nan;0;0
912;504;495;80;30;2;28;.933;3600000;0
912;-1;495;0;0;0;0;.00nan;0;0
912;175593;500;69;37;4;33;.892;3600000;0
912;195887;500;0;0;0;0;.00nan;0;0
913;203533;497;55;30;3;27;.900;3600000;0
913;169680;499;100;28;0;28;1.000;3600000;0
913;202104;497;0;0;0;0;.00nan;0;0
913;71485;499;0;0;0;0;.00nan;0;0
914;504;495;87;43;2;41;.953;4352000;0
914;-1;495;0;0;0;0;.00nan;0;0
914;175593;500;72;25;1;24;.960;4352000;0
914;195887;500;0;0;0;0;.00nan;0;0
915;203533;497;84;43;3;40;.930;4470000;0
915;169680;499;57;21;2;19;.905;4470000;0
915;202104;497;0;0;0;0;.00nan;0;0
915;71485;499;0;0;0;0;.00nan;0;0
916;504;495;60;28;3;25;.893;3600000;0
916;-1;495;0;0;0;0;.00nan;0;0
916;175593;500;90;32;1;31;.969;3600000;0
916;195887;500;0;0;0;0;.00nan;0;0
917;203533;497;94;45;2;43;.956;3928000;0
917;169680;499;90;28;1;27;.964;3928000;0
917;202104;497;0;0;0;0;.00nan;0;0
917;71485;499;0;0;0;0;.00nan;0;0
918;504;495;65;32;4;28;.875;4115000;0
918;-1;495;0;0;0;0;.00nan;0;0
918;175593;500;60;30;3;27;.900;4127000;0
918;195887;500;0;0;0;0;.00nan;0;0
1186;504;495;54;18;2;16;.889;3518000;0
1186;-1;495;0;0;0;0;.00nan;0;0
1186;175593;500;95;27;0;27;1.000;3600000;0
1186;195887;500;0;0;0;0;.00nan;0;0
1279;169680;499;68;42;2;40;.952;5609000;0
1279;175593;500;77;46;3;43;.935;5609000;0
1279;195887;500;0;0;0;0;.00nan;0;0
1279;71485;499;0;0;0;0;.00nan;0;0
1280;169680;499;77;24;1;23;.958;3600000;0
1280;175593;500;82;31;2;29;.935;3556000;0
1280;195887;500;0;0;0;0;.00nan;0;0
1280;71485;499;0;0;0;0;.00nan;0;0
1281;169680;499;100;45;0;45;1.000;3600000;0
1281;175593;500;74;24;1;23;.958;3579000;0
1281;195887;500;0;0;0;0;.00nan;0;0
1281;71485;499;0;0;0;0;.00nan;0;0
1282;169680;499;82;23;1;22;.957;3600000;0
1282;175593;500;63;27;3;24;.889;3590000;0
1282;195887;500;0;0;0;0;.00nan;0;0
1282;71485;499;0;0;0;0;.00nan;0;0
13573;44487;543;62;31;4;27;.871;3599000;0
13573;71660;546;74;23;2;21;.913;3600000;0
13573;72108;543;0;0;0;0;.00nan;0;0
13573;150187;546;0;0;0;0;.00nan;0;0
13574;6389;545;0;0;0;0;.00nan;0;0
13574;14047;2190;62;16;1;15;.938;3600000;0
13574;73939;2190;0;0;0;0;.00nan;0;0
13574;143829;545;39;26;5;21;.808;3600000;0
13575;182780;548;84;26;1;25;.962;3600000;0
13575;169478;550;78;23;2;21;.913;3551000;0
13575;170037;548;0;0;0;0;.00nan;0;0
13575;150203;550;0;0;0;0;.00nan;0;0
13576;182780;548;31;18;4;14;.778;987000;0
13576;13041;551;0;0;0;0;.00nan;0;0
13576;170037;548;55;26;3;23;.885;2613000;0
13576;150345;551;100;26;0;26;1.000;3600000;0
13577;14047;2190;0;0;0;0;.00nan;0;0
13577;169478;550;55;21;2;19;.905;3600000;0
13577;73939;2190;52;35;4;31;.886;3513000;0
13577;150203;550;0;0;0;0;.00nan;0;0
13578;-1;547;69;27;2;25;.926;3522000;0
13578;44487;543;100;26;0;26;1.000;3600000;0
13578;72108;543;0;0;0;0;.00nan;0;0
13578;73792;547;0;0;0;0;.00nan;0;0
13579;-1;549;89;28;1;27;.964;3600000;0
13579;-1;549;0;0;0;0;.00nan;0;0
13579;71660;546;61;31;4;27;.871;3600000;0
13579;150187;546;0;0;0;0;.00nan;0;0
13580;6389;545;67;24;2;22;.917;3600000;0
13580;13041;551;59;33;5;28;.848;3600000;0
13580;143829;545;0;0;0;0;.00nan;0;0
13580;150345;551;0;0;0;0;.00nan;0;0
13581;13041;551;53;27;4;23;.852;3669000;0
13581;44487;543;51;26;5;21;.808;3669000;0
13581;72108;543;0;0;0;0;.00nan;0;0
13581;150345;551;0;0;0;0;.00nan;0;0
13582;169478;550;87;35;2;33;.943;3600000;0
13582;-1;549;68;31;3;28;.903;3564000;0
13582;-1;549;0;0;0;0;.00nan;0;0
13582;150203;550;0;0;0;0;.00nan;0;0
13583;14047;2190;59;27;3;24;.889;3596000;0
13583;71660;546;69;26;2;24;.923;3600000;0
13583;73939;2190;0;0;0;0;.00nan;0;0
13583;150187;546;0;0;0;0;.00nan;0;0
13584;182780;548;0;0;0;0;.00nan;0;0
13584;6389;545;0;0;0;0;.00nan;0;0
13584;170037;548;82;29;1;28;.966;3600000;0
13584;143829;545;30;23;5;18;.783;3600000;0
13585;14047;2190;51;30;5;25;.833;3600000;0
13585;44487;543;0;0;0;0;.00nan;0;0
13585;72108;543;57;33;4;29;.879;3600000;0
13585;73939;2190;0;0;0;0;.00nan;0;0
13586;182780;548;71;31;2;29;.935;3549000;0
13586;170037;548;0;0;0;0;.00nan;0;0
13586;71660;546;75;23;1;22;.957;3600000;0
13586;150187;546;0;0;0;0;.00nan;0;0
13587;169478;550;0;0;0;0;.00nan;0;0
13587;-1;547;28;42;9;33;.786;3600000;0
13587;73792;547;0;0;0;0;.00nan;0;0
13587;150203;550;53;28;4;24;.857;3600000;0
13588;14047;2190;69;31;3;28;.903;3600000;0
13588;-1;547;69;40;5;35;.875;3568000;0
13588;73792;547;0;0;0;0;.00nan;0;0
13588;73939;2190;0;0;0;0;.00nan;0;0
13589;13041;551;55;25;3;22;.880;3600000;0
13589;169478;550;96;23;0;23;1.000;3600000;0
13589;150203;550;0;0;0;0;.00nan;0;0
13589;150345;551;0;0;0;0;.00nan;0;0
13590;182780;548;69;21;1;20;.952;3600000;0
13590;170037;548;0;0;0;0;.00nan;0;0
13590;44487;543;37;33;6;27;.818;3600000;0
13590;72108;543;0;0;0;0;.00nan;0;0
13591;6389;545;55;8;1;7;.875;1244000;0
13591;-1;549;70;33;3;30;.909;3600000;0
13591;-1;549;0;0;0;0;.00nan;0;0
13591;143829;545;33;19;5;14;.737;2356000;0
13592;13041;551;0;0;0;0;.00nan;0;0
13592;71660;546;80;25;1;24;.960;3900000;0
13592;150187;546;0;0;0;0;.00nan;0;0
13592;150345;551;85;31;1;30;.968;3900000;0
13593;182780;548;48;35;5;30;.857;3600000;0
13593;170037;548;0;0;0;0;.00nan;0;0
13593;-1;547;83;28;1;27;.964;3600000;0
13593;73792;547;0;0;0;0;.00nan;0;0
13594;14047;2190;0;0;0;0;.00nan;0;0
13594;-1;549;0;0;0;0;.00nan;0;0
13594;-1;549;50;25;4;21;.840;3564000;0
13594;73939;2190;97;44;3;41;.932;3600000;0
13595;6389;545;0;0;0;0;.00nan;0;0
13595;44487;543;77;22;1;21;.955;3600000;0
13595;72108;543;0;0;0;0;.00nan;0;0
13595;143829;545;45;22;4;18;.818;3600000;0
13596;-1;549;75;32;2;30;.938;3600000;0
13596;44487;543;58;28;3;25;.893;3581000;0
13596;-1;549;0;0;0;0;.00nan;0;0
13596;72108;543;0;0;0;0;.00nan;0;0
13597;13041;551;90;26;0;26;1.000;3900000;0
13597;14047;2190;87;18;0;18;1.000;3900000;0
13597;73939;2190;0;0;0;0;.00nan;0;0
13597;150345;551;0;0;0;0;.00nan;0;0
13598;169478;550;100;27;0;27;1.000;3600000;0
13598;71660;546;74;39;4;35;.897;3600000;0
13598;150187;546;0;0;0;0;.00nan;0;0
13598;150203;550;0;0;0;0;.00nan;0;0
13599;6389;545;95;36;1;35;.972;3600000;0
13599;-1;547;91;42;3;39;.929;3580000;0
13599;73792;547;0;0;0;0;.00nan;0;0
13599;143829;545;0;0;0;0;.00nan;0;0
13600;13041;551;59;29;4;25;.862;3557000;0
13600;-1;549;77;27;2;25;.926;3600000;0
13600;-1;549;0;0;0;0;.00nan;0;0
13600;150345;551;0;0;0;0;.00nan;0;0
13601;-1;547;73;34;3;31;.912;3600000;0
13601;71660;546;58;36;4;32;.889;3559000;0
13601;73792;547;0;0;0;0;.00nan;0;0
13601;150187;546;0;0;0;0;.00nan;0;0
13602;182780;548;0;0;0;0;.00nan;0;0
13602;14047;2190;100;30;0;30;1.000;3600000;0
13602;170037;548;84;36;2;34;.944;3558000;0
13602;73939;2190;0;0;0;0;.00nan;0;0
13603;13041;551;0;0;0;0;.00nan;0;0
13603;-1;547;0;0;0;0;.00nan;0;0
13603;73792;547;54;39;5;34;.872;3515000;0
13603;150345;551;66;37;3;34;.919;3600000;0
13604;182780;548;98;31;1;30;.968;3900000;0
13604;170037;548;0;0;0;0;.00nan;0;0
13604;-1;549;82;24;1;23;.958;3900000;0
13604;-1;549;0;0;0;0;.00nan;0;0
13605;169478;550;40;36;6;30;.833;3600000;0
13605;44487;543;0;0;0;0;.00nan;0;0
13605;72108;543;58;26;3;23;.885;3600000;0
13605;150203;550;0;0;0;0;.00nan;0;0
13606;6389;545;0;0;0;0;.00nan;0;0
13606;71660;546;49;23;3;20;.870;3251000;0
13606;143829;545;89;30;1;29;.967;3600000;0
13606;150187;546;48;0;0;0;.00nan;299000;0
13607;-1;549;0;0;0;0;.00nan;0;0
13607;-1;547;65;38;4;34;.895;3600000;0
13607;-1;549;82;22;1;21;.955;3600000;0
13607;73792;547;0;0;0;0;.00nan;0;0
13608;13041;551;0;0;0;0;.00nan;0;0
13608;169478;550;68;26;2;24;.923;3600000;0
13608;150203;550;0;0;0;0;.00nan;0;0
13608;150345;551;57;32;4;28;.875;3557000;0
13609;6389;545;0;0;0;0;.00nan;0;0
13609;44487;543;94;37;1;36;.973;3600000;0
13609;72108;543;0;0;0;0;.00nan;0;0
13609;143829;545;56;20;3;17;.850;3583000;0
13610;169478;550;83;36;3;33;.917;3900000;0
13610;-1;547;71;24;3;21;.875;3900000;0
13610;73792;547;0;0;0;0;.00nan;0;0
13610;150203;550;0;0;0;0;.00nan;0;0
13611;14047;2190;63;15;1;14;.933;3600000;0
13611;-1;549;59;39;5;34;.872;3600000;0
13611;-1;549;0;0;0;0;.00nan;0;0
13611;73939;2190;0;0;0;0;.00nan;0;0
13612;182780;548;68;21;1;20;.952;3600000;0
13612;170037;548;0;0;0;0;.00nan;0;0
13612;71660;546;93;36;2;34;.944;3587000;0
13612;150187;546;0;0;0;0;.00nan;0;0
13613;13041;551;81;36;2;34;.944;3900000;0
13613;14047;2190;58;18;2;16;.889;3900000;0
13613;73939;2190;0;0;0;0;.00nan;0;0
13613;150345;551;0;0;0;0;.00nan;0;0
13614;6389;545;0;0;0;0;.00nan;0;0
13614;-1;549;56;21;2;19;.905;3591000;0
13614;-1;549;0;0;0;0;.00nan;0;0
13614;143829;545;86;26;1;25;.962;3600000;0
13615;-1;547;67;44;5;39;.886;3600000;0
13615;44487;543;68;20;2;18;.900;3600000;0
13615;72108;543;0;0;0;0;.00nan;0;0
13615;73792;547;0;0;0;0;.00nan;0;0
13616;182780;548;72;19;1;18;.947;3600000;0
13616;169478;550;88;34;2;32;.941;3600000;0
13616;170037;548;0;0;0;0;.00nan;0;0
13616;150203;550;0;0;0;0;.00nan;0;0
13617;182780;548;0;0;0;0;.00nan;0;0
13617;170037;548;51;23;3;20;.870;3600000;0
13617;-1;547;54;33;4;29;.879;3554000;0
13617;73792;547;0;0;0;0;.00nan;0;0
13618;6389;545;58;19;2;17;.895;3664000;0
13618;169478;550;91;39;3;36;.923;3664000;0
13618;143829;545;0;0;0;0;.00nan;0;0
13618;150203;550;0;0;0;0;.00nan;0;0
13619;-1;549;59;32;3;29;.906;3541000;0
13619;-1;549;0;0;0;0;.00nan;0;0
13619;71660;546;66;22;2;20;.909;3600000;0
13619;150187;546;0;0;0;0;.00nan;0;0
13620;182780;548;87;36;2;34;.944;3600000;0
13620;14047;2190;57;27;3;24;.889;3551000;0
13620;170037;548;0;0;0;0;.00nan;0;0
13620;73939;2190;0;0;0;0;.00nan;0;0
13621;13041;551;51;31;4;27;.871;3900000;0
13621;44487;543;56;31;4;27;.871;3900000;0
13621;72108;543;0;0;0;0;.00nan;0;0
13621;150345;551;0;0;0;0;.00nan;0;0
13622;6389;545;0;0;0;0;.00nan;0;0
13622;13041;551;0;0;0;0;.00nan;0;0
13622;143829;545;29;20;5;15;.750;3587000;0
13622;150345;551;79;39;4;35;.897;3600000;0
13623;14047;2190;0;0;0;0;.00nan;0;0
13623;-1;547;57;32;4;28;.875;3580000;0
13623;73792;547;0;0;0;0;.00nan;0;0
13623;73939;2190;41;17;3;14;.824;3600000;0
13624;44487;543;65;23;2;21;.913;3600000;0
13624;71660;546;62;6;0;6;1.000;655000;0
13624;72108;543;0;0;0;0;.00nan;0;0
13624;150187;546;42;36;6;30;.833;2945000;0
13625;182780;548;76;20;1;19;.950;3600000;0
13625;170037;548;0;0;0;0;.00nan;0;0
13625;-1;549;24;17;5;12;.706;1853000;0
13625;-1;549;52;13;2;11;.846;1747000;0
13626;6389;545;0;0;0;0;.00nan;0;0
13626;169478;550;0;0;0;0;.00nan;0;0
13626;143829;545;72;17;1;16;.941;3900000;0
13626;150203;550;90;34;1;33;.971;3900000;0
13627;13041;551;0;0;0;0;.00nan;0;0
13627;-1;549;0;0;0;0;.00nan;0;0
13627;-1;549;41;31;5;26;.839;3544000;0
13627;150345;551;63;28;3;25;.893;3600000;0
13628;14047;2190;71;25;3;22;.880;3543000;0
13628;71660;546;82;31;2;29;.935;3600000;0
13628;73939;2190;0;0;0;0;.00nan;0;0
13628;150187;546;0;0;0;0;.00nan;0;0
13629;182780;548;60;30;3;27;.900;3577000;0
13629;170037;548;0;0;0;0;.00nan;0;0
13629;44487;543;82;28;2;26;.929;3600000;0
13629;72108;543;0;0;0;0;.00nan;0;0
13630;169478;550;72;25;3;22;.880;3600000;0
13630;-1;549;46;23;4;19;.826;3576000;0
13630;-1;549;0;0;0;0;.00nan;0;0
13630;150203;550;0;0;0;0;.00nan;0;0
13631;6389;545;0;0;0;0;.00nan;0;0
13631;71660;546;72;26;3;23;.885;3600000;0
13631;143829;545;48;28;4;24;.857;3581000;0
13631;150187;546;0;0;0;0;.00nan;0;0
13632;13041;551;0;0;0;0;.00nan;0;0
13632;-1;547;80;41;4;37;.902;3693000;0
13632;73792;547;0;0;0;0;.00nan;0;0
13632;150345;551;71;41;3;38;.927;3693000;0
13633;182780;548;0;0;0;0;.00nan;0;0
13633;13041;551;0;0;0;0;.00nan;0;0
13633;170037;548;71;30;2;28;.933;3600000;0
13633;150345;551;58;25;3;22;.880;3568000;0
13634;6389;545;0;0;0;0;.00nan;0;0
13634;-1;547;94;33;1;32;.970;3600000;0
13634;73792;547;0;0;0;0;.00nan;0;0
13634;143829;545;84;15;0;15;1.000;3600000;0
13635;14047;2190;64;31;3;28;.903;3656000;0
13635;44487;543;88;30;2;28;.933;3656000;0
13635;72108;543;0;0;0;0;.00nan;0;0
13635;73939;2190;0;0;0;0;.00nan;0;0
13636;169478;550;80;25;1;24;.960;3600000;0
13636;71660;546;64;26;2;24;.923;3600000;0
13636;150187;546;0;0;0;0;.00nan;0;0
13636;150203;550;0;0;0;0;.00nan;0;0
13637;-1;549;66;13;1;12;.923;3600000;0
13637;-1;547;77;41;4;37;.902;3600000;0
13637;-1;549;0;0;0;0;.00nan;0;0
13637;73792;547;0;0;0;0;.00nan;0;0
13638;169478;550;69;25;2;23;.920;3600000;0
13638;44487;543;64;27;3;24;.889;3581000;0
13638;72108;543;0;0;0;0;.00nan;0;0
13638;150203;550;0;0;0;0;.00nan;0;0
13639;6389;545;0;0;0;0;.00nan;0;0
13639;14047;2190;69;29;3;26;.897;3900000;0
13639;73939;2190;0;0;0;0;.00nan;0;0
13639;143829;545;83;43;3;40;.930;3900000;0
13640;13041;551;0;0;0;0;.00nan;0;0
13640;71660;546;67;39;5;34;.872;3900000;0
13640;150187;546;0;0;0;0;.00nan;0;0
13640;150345;551;53;36;5;31;.861;3849000;0
13641;-1;549;64;23;2;21;.913;3565000;0
13641;44487;543;99;41;1;40;.976;3600000;0
13641;-1;549;0;0;0;0;.00nan;0;0
13641;72108;543;0;0;0;0;.00nan;0;0
13642;14047;2190;65;17;1;16;.941;3600000;0
13642;169478;550;79;39;3;36;.923;3600000;0
13642;73939;2190;0;0;0;0;.00nan;0;0
13642;150203;550;0;0;0;0;.00nan;0;0
13643;-1;547;58;21;3;18;.857;3600000;0
13643;71660;546;0;0;0;0;.00nan;0;0
13643;73792;547;0;0;0;0;.00nan;0;0
13643;150187;546;65;33;4;29;.879;3580000;0
13644;182780;548;64;39;5;34;.872;3600000;0
13644;6389;545;0;0;0;0;.00nan;0;0
13644;170037;548;0;0;0;0;.00nan;0;0
13644;143829;545;96;23;0;23;1.000;3600000;0
13645;-1;549;0;0;0;0;.00nan;0;0
13645;44487;543;85;24;1;23;.958;3600000;0
13645;-1;549;69;44;4;40;.909;3600000;0
13645;72108;543;0;0;0;0;.00nan;0;0
13646;182780;548;67;27;2;25;.926;3600000;0
13646;6389;545;0;0;0;0;.00nan;0;0
13646;170037;548;0;0;0;0;.00nan;0;0
13646;143829;545;76;32;3;29;.906;3584000;0
13647;-1;547;0;0;0;0;.00nan;0;0
13647;71660;546;55;18;3;15;.833;3529000;0
13647;73792;547;76;25;1;24;.960;3600000;0
13647;150187;546;0;0;0;0;.00nan;0;0
13648;14047;2190;79;23;1;22;.957;3900000;0
13648;169478;550;79;25;1;24;.960;3900000;0
13648;73939;2190;0;0;0;0;.00nan;0;0
13648;150203;550;0;0;0;0;.00nan;0;0
13649;-1;549;90;18;0;18;1.000;3600000;0
13649;-1;547;78;35;4;31;.886;3600000;0
13649;-1;549;0;0;0;0;.00nan;0;0
13649;73792;547;0;0;0;0;.00nan;0;0
13650;13041;551;0;0;0;0;.00nan;0;0
13650;71660;546;87;34;2;32;.941;3600000;0
13650;150187;546;0;0;0;0;.00nan;0;0
13650;150345;551;90;28;1;27;.964;3600000;0
13651;182780;548;93;19;0;19;1.000;3600000;0
13651;14047;2190;70;26;2;24;.923;3558000;0
13651;170037;548;0;0;0;0;.00nan;0;0
13651;73939;2190;0;0;0;0;.00nan;0;0
13652;6389;545;0;0;0;0;.00nan;0;0
13652;169478;550;50;39;5;34;.872;3546000;0
13652;143829;545;70;33;3;30;.909;3600000;0
13652;150203;550;0;0;0;0;.00nan;0;0
13653;182780;548;56;23;2;21;.913;3590000;0
13653;170037;548;0;0;0;0;.00nan;0;0
13653;-1;547;100;35;1;34;.971;3600000;0
13653;73792;547;0;0;0;0;.00nan;0;0
13654;13041;551;0;0;0;0;.00nan;0;0
13654;44487;543;50;24;4;20;.833;3225000;0
13654;72108;543;49;1;0;1;1.000;375000;0
13654;150345;551;100;33;0;33;1.000;3600000;0
13655;169478;550;100;34;1;33;.971;3600000;0
13655;71660;546;63;23;2;21;.913;3545000;0
13655;150187;546;0;0;0;0;.00nan;0;0
13655;150203;550;0;0;0;0;.00nan;0;0
13656;14047;2190;77;34;2;32;.941;3559000;0
13656;-1;547;100;33;0;33;1.000;3600000;0
13656;73792;547;0;0;0;0;.00nan;0;0
13656;73939;2190;0;0;0;0;.00nan;0;0
13657;13041;551;0;0;0;0;.00nan;0;0
13657;169478;550;72;39;3;36;.923;3900000;0
13657;150203;550;0;0;0;0;.00nan;0;0
13657;150345;551;56;21;3;18;.857;3900000;0
13658;182780;548;72;21;2;19;.905;3565000;0
13658;170037;548;0;0;0;0;.00nan;0;0
13658;-1;549;67;17;1;16;.941;3600000;0
13658;-1;549;0;0;0;0;.00nan;0;0
13659;6389;545;56;3;0;3;1.000;592000;0
13659;44487;543;100;30;0;30;1.000;3600000;0
13659;72108;543;0;0;0;0;.00nan;0;0
13659;143829;545;38;35;6;29;.829;3008000;0
13660;-1;549;71;20;2;18;.900;3590000;0
13660;-1;549;0;0;0;0;.00nan;0;0
13660;71660;546;76;23;1;22;.957;3600000;0
13660;150187;546;0;0;0;0;.00nan;0;0
13661;182780;548;78;43;4;39;.907;3600000;0
13661;170037;548;0;0;0;0;.00nan;0;0
13661;44487;543;94;20;0;20;1.000;3600000;0
13661;72108;543;0;0;0;0;.00nan;0;0
13662;6389;545;0;0;0;0;.00nan;0;0
13662;13041;551;56;11;1;10;.909;1041000;0
13662;143829;545;69;25;2;23;.920;3600000;0
13662;150345;551;12;21;7;14;.667;2559000;0
13663;169478;550;65;19;2;17;.895;3600000;0
13663;-1;547;36;29;5;24;.828;3600000;0
13663;73792;547;0;0;0;0;.00nan;0;0
13663;150203;550;0;0;0;0;.00nan;0;0
13664;169478;550;87;38;3;35;.921;3600000;0
13664;-1;549;75;37;4;33;.892;3566000;0
13664;-1;549;0;0;0;0;.00nan;0;0
13664;150203;550;0;0;0;0;.00nan;0;0
13665;182780;548;75;28;2;26;.929;3600000;0
13665;13041;551;70;33;3;30;.909;3558000;0
13665;170037;548;0;0;0;0;.00nan;0;0
13665;150345;551;0;0;0;0;.00nan;0;0
13666;14047;2190;75;24;2;22;.917;3600000;0
13666;44487;543;44;29;5;24;.828;3600000;0
13666;72108;543;0;0;0;0;.00nan;0;0
13666;73939;2190;0;0;0;0;.00nan;0;0
13667;6389;545;0;0;0;0;.00nan;0;0
13667;-1;547;96;47;2;45;.957;3600000;0
13667;73792;547;0;0;0;0;.00nan;0;0
13667;143829;545;67;16;1;15;.938;3600000;0
13668;-1;547;65;37;4;33;.892;3543000;0
13668;44487;543;68;23;2;21;.913;3600000;0
13668;72108;543;0;0;0;0;.00nan;0;0
13668;73792;547;0;0;0;0;.00nan;0;0
13669;13041;551;0;0;0;0;.00nan;0;0
13669;14047;2190;86;26;1;25;.962;3900000;0
13669;73939;2190;0;0;0;0;.00nan;0;0
13669;150345;551;82;32;1;31;.969;3900000;0
13670;6389;545;0;0;0;0;.00nan;0;0
13670;71660;546;60;37;5;32;.865;3600000;0
13670;143829;545;80;35;2;33;.943;3600000;0
13670;150187;546;0;0;0;0;.00nan;0;0
13671;182780;548;92;36;2;34;.944;3900000;0
13671;169478;550;81;34;2;32;.941;3900000;0
13671;170037;548;0;0;0;0;.00nan;0;0
13671;150203;550;0;0;0;0;.00nan;0;0
13672;6389;545;0;0;0;0;.00nan;0;0
13672;-1;549;87;33;2;31;.939;3900000;0
13672;-1;549;0;0;0;0;.00nan;0;0
13672;143829;545;83;29;2;27;.931;3878000;0
13673;14047;2190;29;15;4;11;.733;1888000;0
13673;169478;550;100;34;2;32;.941;3600000;0
13673;73939;2190;52;3;0;3;1.000;1673000;0
13673;150203;550;0;0;0;0;.00nan;0;0
13674;182780;548;100;32;0;32;1.000;3600000;0
13674;6389;545;44;22;3;19;.864;3600000;0
13674;170037;548;0;0;0;0;.00nan;0;0
13674;143829;545;0;0;0;0;.00nan;0;0
13675;13041;551;0;0;0;0;.00nan;0;0
13675;-1;549;67;28;3;25;.893;3900000;0
13675;-1;549;0;0;0;0;.00nan;0;0
13675;150345;551;81;42;3;39;.929;3900000;0
13676;44487;543;93;36;1;35;.972;3600000;0
13676;71660;546;73;28;2;26;.929;3600000;0
13676;72108;543;0;0;0;0;.00nan;0;0
13676;150187;546;0;0;0;0;.00nan;0;0
13677;6389;545;0;0;0;0;.00nan;0;0
13677;14047;2190;55;28;4;24;.857;3600000;0
13677;73939;2190;0;0;0;0;.00nan;0;0
13677;143829;545;100;27;0;27;1.000;3600000;0
13678;13041;551;0;0;0;0;.00nan;0;0
13678;-1;547;73;43;5;38;.884;3600000;0
13678;73792;547;0;0;0;0;.00nan;0;0
13678;150345;551;32;31;6;25;.806;3562000;0
13679;14047;2190;70;17;1;16;.941;3600000;0
13679;-1;549;0;0;0;0;.00nan;0;0
13679;-1;549;68;34;3;31;.912;3544000;0
13679;73939;2190;0;0;0;0;.00nan;0;0
13680;169478;550;84;34;1;33;.971;3600000;0
13680;44487;543;0;0;0;0;.00nan;0;0
13680;72108;543;43;22;4;18;.818;3600000;0
13680;150203;550;0;0;0;0;.00nan;0;0
13681;182780;548;82;31;2;29;.935;3900000;0
13681;170037;548;0;0;0;0;.00nan;0;0
13681;71660;546;74;30;2;28;.933;3900000;0
13681;150187;546;0;0;0;0;.00nan;0;0
13682;14047;2190;0;0;0;0;.00nan;0;0
13682;169478;550;62;27;3;24;.889;3600000;0
13682;73939;2190;43;23;4;19;.826;3600000;0
13682;150203;550;0;0;0;0;.00nan;0;0
13683;6389;545;0;0;0;0;.00nan;0;0
13683;44487;543;44;21;4;17;.810;3535000;0
13683;72108;543;0;0;0;0;.00nan;0;0
13683;143829;545;100;48;2;46;.958;3600000;0
13684;182780;548;0;0;0;0;.00nan;0;0
13684;170037;548;73;30;2;28;.933;3600000;0
13684;-1;549;76;34;3;31;.912;3568000;0
13684;-1;549;0;0;0;0;.00nan;0;0
13685;6389;545;0;0;0;0;.00nan;0;0
13685;169478;550;0;0;0;0;.00nan;0;0
13685;143829;545;69;25;2;23;.920;3600000;0
13685;150203;550;86;30;1;29;.967;3600000;0
13686;-1;547;100;42;2;40;.952;3600000;0
13686;44487;543;63;26;3;23;.885;3588000;0
13686;72108;543;0;0;0;0;.00nan;0;0
13686;73792;547;0;0;0;0;.00nan;0;0
13687;14047;2190;100;19;0;19;1.000;3600000;0
13687;-1;547;67;47;5;42;.894;3600000;0
13687;73792;547;0;0;0;0;.00nan;0;0
13687;73939;2190;0;0;0;0;.00nan;0;0
13688;182780;548;98;39;1;38;.974;3600000;0
13688;170037;548;0;0;0;0;.00nan;0;0
13688;44487;543;100;29;0;29;1.000;3600000;0
13688;72108;543;0;0;0;0;.00nan;0;0
13689;13041;551;56;16;2;14;.875;2616000;0
13689;169478;550;62;27;3;24;.889;3600000;0
13689;150203;550;0;0;0;0;.00nan;0;0
13689;150345;551;19;11;4;7;.636;984000;0
13690;6389;545;0;0;0;0;.00nan;0;0
13690;71660;546;80;28;1;27;.964;3600000;0
13690;143829;545;71;29;2;27;.931;3543000;0
13690;150187;546;0;0;0;0;.00nan;0;0
13691;6389;545;0;0;0;0;.00nan;0;0
13691;-1;549;82;38;2;36;.947;3600000;0
13691;-1;549;0;0;0;0;.00nan;0;0
13691;143829;545;45;26;4;22;.846;3551000;0
13692;-1;547;56;17;1;16;.941;3900000;0
13692;71660;546;82;23;1;22;.957;3900000;0
13692;73792;547;0;0;0;0;.00nan;0;0
13692;150187;546;0;0;0;0;.00nan;0;0
13693;13041;551;74;40;4;36;.900;3600000;0
13693;-1;547;92;17;0;17;1.000;3600000;0
13693;73792;547;0;0;0;0;.00nan;0;0
13693;150345;551;0;0;0;0;.00nan;0;0
13694;169478;550;85;33;2;31;.939;3600000;0
13694;-1;547;88;42;4;38;.905;3577000;0
13694;73792;547;0;0;0;0;.00nan;0;0
13694;150203;550;0;0;0;0;.00nan;0;0
13695;-1;549;89;31;2;29;.935;3900000;0
13695;-1;549;0;0;0;0;.00nan;0;0
13695;71660;546;76;31;2;29;.935;3900000;0
13695;150187;546;0;0;0;0;.00nan;0;0
13696;14047;2190;64;26;3;23;.885;3725000;0
13696;44487;543;49;27;4;23;.852;3725000;0
13696;72108;543;0;0;0;0;.00nan;0;0
13696;73939;2190;0;0;0;0;.00nan;0;0
13697;182780;548;80;29;2;27;.931;3600000;0
13697;13041;551;82;28;1;27;.964;3600000;0
13697;170037;548;0;0;0;0;.00nan;0;0
13697;150345;551;0;0;0;0;.00nan;0;0
13698;-1;549;69;23;1;22;.957;3600000;0
13698;-1;549;0;0;0;0;.00nan;0;0
13698;71660;546;72;35;3;32;.914;3600000;0
13698;150187;546;0;0;0;0;.00nan;0;0
13699;13041;551;0;0;0;0;.00nan;0;0
13699;14047;2190;95;22;0;22;1.000;3600000;0
13699;73939;2190;0;0;0;0;.00nan;0;0
13699;150345;551;77;30;1;29;.967;3555000;0
13700;182780;548;100;31;1;30;.968;3600000;0
13700;170037;548;0;0;0;0;.00nan;0;0
13700;71660;546;55;20;2;18;.900;3550000;0
13700;150187;546;0;0;0;0;.00nan;0;0
13701;-1;549;71;39;3;36;.923;3900000;0
13701;44487;543;86;37;3;34;.919;3900000;0
13701;-1;549;0;0;0;0;.00nan;0;0
13701;72108;543;0;0;0;0;.00nan;0;0
13702;13041;551;98;38;1;37;.974;3588000;0
13702;71660;546;99;27;0;27;1.000;3600000;0
13702;150187;546;0;0;0;0;.00nan;0;0
13702;150345;551;0;0;0;0;.00nan;0;0
13703;14047;2190;58;36;4;32;.889;3520000;0
13703;-1;549;66;27;2;25;.926;3600000;0
13703;-1;549;0;0;0;0;.00nan;0;0
13703;73939;2190;0;0;0;0;.00nan;0;0
13704;169478;550;61;30;3;27;.900;3600000;0
13704;44487;543;82;26;2;24;.923;3600000;0
13704;72108;543;0;0;0;0;.00nan;0;0
13704;150203;550;0;0;0;0;.00nan;0;0
13705;182780;548;49;25;3;22;.880;3900000;0
13705;6389;545;0;0;0;0;.00nan;0;0
13705;170037;548;0;0;0;0;.00nan;0;0
13705;143829;545;59;26;3;23;.885;3900000;0
13706;6389;545;0;0;0;0;.00nan;0;0
13706;-1;547;73;36;3;33;.917;3544000;0
13706;73792;547;0;0;0;0;.00nan;0;0
13706;143829;545;54;16;2;14;.875;3600000;0
13707;13041;551;0;0;0;0;.00nan;0;0
13707;-1;549;56;13;1;12;.923;1274000;0
13707;-1;549;19;18;6;12;.667;2326000;0
13707;150345;551;83;33;3;30;.909;3600000;0
13708;44487;543;61;17;2;15;.882;3600000;0
13708;71660;546;68;33;4;29;.879;3572000;0
13708;72108;543;0;0;0;0;.00nan;0;0
13708;150187;546;0;0;0;0;.00nan;0;0
13709;182780;548;69;26;2;24;.923;3591000;0
13709;169478;550;74;24;1;23;.958;3600000;0
13709;170037;548;0;0;0;0;.00nan;0;0
13709;150203;550;0;0;0;0;.00nan;0;0
13710;-1;549;79;29;2;27;.931;3600000;0
13710;-1;547;0;0;0;0;.00nan;0;0
13710;-1;549;0;0;0;0;.00nan;0;0
13710;73792;547;54;39;5;34;.872;3600000;0
13711;6389;545;0;0;0;0;.00nan;0;0
13711;13041;551;0;0;0;0;.00nan;0;0
13711;143829;545;65;27;3;24;.889;3774000;0
13711;150345;551;67;30;2;28;.933;3774000;0
13712;14047;2190;98;28;1;27;.964;3600000;0
13712;71660;546;56;30;3;27;.900;3555000;0
13712;73939;2190;0;0;0;0;.00nan;0;0
13712;150187;546;0;0;0;0;.00nan;0;0
13713;182780;548;75;29;2;27;.931;3600000;0
13713;169478;550;46;37;5;32;.865;3600000;0
13713;170037;548;0;0;0;0;.00nan;0;0
13713;150203;550;0;0;0;0;.00nan;0;0
13714;-1;549;0;0;0;0;.00nan;0;0
13714;-1;547;54;35;5;30;.857;3900000;0
13714;-1;549;61;40;5;35;.875;3900000;0
13714;73792;547;0;0;0;0;.00nan;0;0
13715;169478;550;0;0;0;0;.00nan;0;0
13715;44487;543;65;28;3;25;.893;3900000;0
13715;72108;543;0;0;0;0;.00nan;0;0
13715;150203;550;48;26;3;23;.885;3900000;0
13716;14047;2190;100;33;1;32;.970;3600000;0
13716;71660;546;53;23;3;20;.870;3600000;0
13716;73939;2190;0;0;0;0;.00nan;0;0
13716;150187;546;0;0;0;0;.00nan;0;0
13717;6389;545;86;31;1;30;.968;3600000;0
13717;13041;551;29;27;5;22;.815;2338000;0
13717;143829;545;0;0;0;0;.00nan;0;0
13717;150345;551;64;17;1;16;.941;1262000;0
13718;169478;550;83;31;2;29;.935;3900000;0
13718;71660;546;0;0;0;0;.00nan;0;0
13718;150187;546;57;22;2;20;.909;3900000;0
13718;150203;550;0;0;0;0;.00nan;0;0
13719;169478;550;51;22;3;19;.864;3596000;0
13719;-1;549;82;35;2;33;.943;3600000;0
13719;-1;549;0;0;0;0;.00nan;0;0
13719;150203;550;0;0;0;0;.00nan;0;0
13720;13041;551;0;0;0;0;.00nan;0;0
13720;44487;543;94;16;0;16;1.000;3600000;0
13720;72108;543;0;0;0;0;.00nan;0;0
13720;150345;551;65;24;2;22;.917;3549000;0
13721;182780;548;77;25;1;24;.960;3600000;0
13721;170037;548;0;0;0;0;.00nan;0;0
13721;-1;547;83;32;2;30;.938;3600000;0
13721;73792;547;0;0;0;0;.00nan;0;0
13722;6389;545;0;0;0;0;.00nan;0;0
13722;14047;2190;23;24;6;18;.750;3554000;0
13722;73939;2190;0;0;0;0;.00nan;0;0
13722;143829;545;58;29;4;25;.862;3600000;0
13723;182780;548;70;35;3;32;.914;3580000;0
13723;170037;548;0;0;0;0;.00nan;0;0
13723;-1;547;0;0;0;0;.00nan;0;0
13723;73792;547;67;19;2;17;.895;3600000;0
13724;14047;2190;55;25;3;22;.880;3600000;0
13724;71660;546;100;32;0;32;1.000;3600000;0
13724;73939;2190;0;0;0;0;.00nan;0;0
13724;150187;546;0;0;0;0;.00nan;0;0
13725;13041;551;0;0;0;0;.00nan;0;0
13725;-1;549;72;42;3;39;.929;3600000;0
13725;-1;549;0;0;0;0;.00nan;0;0
13725;150345;551;81;26;2;24;.923;3600000;0
13726;-1;547;95;40;2;38;.950;3900000;0
13726;44487;543;96;34;2;32;.941;3900000;0
13726;72108;543;0;0;0;0;.00nan;0;0
13726;73792;547;0;0;0;0;.00nan;0;0
13727;13041;551;0;0;0;0;.00nan;0;0
13727;14047;2190;83;25;1;24;.960;3600000;0
13727;73939;2190;0;0;0;0;.00nan;0;0
13727;150345;551;79;31;2;29;.935;3594000;0
13728;182780;548;73;28;2;26;.929;3600000;0
13728;170037;548;0;0;0;0;.00nan;0;0
13728;-1;549;77;17;1;16;.941;3600000;0
13728;-1;549;0;0;0;0;.00nan;0;0
13729;6389;545;0;0;0;0;.00nan;0;0
13729;71660;546;67;43;4;39;.907;3595000;0
13729;143829;545;75;21;2;19;.905;3600000;0
13729;150187;546;0;0;0;0;.00nan;0;0
13730;169478;550;54;26;3;23;.885;3660000;0
13730;-1;547;75;50;4;46;.920;3660000;0
13730;73792;547;0;0;0;0;.00nan;0;0
13730;150203;550;0;0;0;0;.00nan;0;0
13731;13041;551;62;26;3;23;.885;3564000;0
13731;44487;543;77;29;2;27;.931;3600000;0
13731;72108;543;0;0;0;0;.00nan;0;0
13731;150345;551;0;0;0;0;.00nan;0;0
13732;182780;548;100;25;0;25;1.000;3630000;0
13732;14047;2190;89;24;1;23;.958;3630000;0
13732;170037;548;0;0;0;0;.00nan;0;0
13732;73939;2190;0;0;0;0;.00nan;0;0
13733;6389;545;0;0;0;0;.00nan;0;0
13733;169478;550;45;24;4;20;.833;3669000;0
13733;143829;545;74;32;3;29;.906;3669000;0
13733;150203;550;0;0;0;0;.00nan;0;0
13734;6389;545;63;32;3;29;.906;3600000;0
13734;44487;543;96;23;0;23;1.000;3600000;0
13734;72108;543;0;0;0;0;.00nan;0;0
13734;143829;545;0;0;0;0;.00nan;0;0
13735;182780;548;100;28;0;28;1.000;3600000;0
13735;14047;2190;85;35;1;34;.971;3600000;0
13735;170037;548;0;0;0;0;.00nan;0;0
13735;73939;2190;0;0;0;0;.00nan;0;0
13736;169478;550;68;32;3;29;.906;3600000;0
13736;71660;546;42;25;4;21;.840;3600000;0
13736;150187;546;0;0;0;0;.00nan;0;0
13736;150203;550;0;0;0;0;.00nan;0;0
13737;-1;547;100;44;1;43;.977;3600000;0
13737;71660;546;53;20;3;17;.850;3592000;0
13737;73792;547;0;0;0;0;.00nan;0;0
13737;150187;546;0;0;0;0;.00nan;0;0
13738;182780;548;56;33;5;28;.848;3600000;0
13738;13041;551;0;0;0;0;.00nan;0;0
13738;170037;548;0;0;0;0;.00nan;0;0
13738;150345;551;95;43;2;41;.953;3600000;0
13739;14047;2190;72;17;1;16;.941;3600000;0
13739;44487;543;68;27;2;25;.926;3566000;0
13739;72108;543;0;0;0;0;.00nan;0;0
13739;73939;2190;0;0;0;0;.00nan;0;0
13740;6389;545;0;0;0;0;.00nan;0;0
13740;-1;549;64;30;3;27;.900;3529000;0
13740;-1;549;0;0;0;0;.00nan;0;0
13740;143829;545;91;35;1;34;.971;3600000;0
13741;13041;551;0;0;0;0;.00nan;0;0
13741;-1;547;37;37;7;30;.811;3600000;0
13741;73792;547;0;0;0;0;.00nan;0;0
13741;150345;551;49;30;4;26;.867;3600000;0
13742;6389;545;0;0;0;0;.00nan;0;0
13742;14047;2190;71;30;2;28;.933;3900000;0
13742;73939;2190;0;0;0;0;.00nan;0;0
13742;143829;545;60;18;2;16;.889;3900000;0
13743;44487;543;99;38;1;37;.974;3600000;0
13743;71660;546;59;29;4;25;.862;3600000;0
13743;72108;543;0;0;0;0;.00nan;0;0
13743;150187;546;0;0;0;0;.00nan;0;0
13744;169478;550;53;30;4;26;.867;3555000;0
13744;-1;549;65;31;3;28;.903;3600000;0
13744;-1;549;0;0;0;0;.00nan;0;0
13744;150203;550;0;0;0;0;.00nan;0;0
13745;-1;549;56;27;3;24;.889;3576000;0
13745;44487;543;100;32;1;31;.969;3600000;0
13745;-1;549;0;0;0;0;.00nan;0;0
13745;72108;543;0;0;0;0;.00nan;0;0
13746;13041;551;0;0;0;0;.00nan;0;0
13746;169478;550;91;25;1;24;.960;3900000;0
13746;150203;550;0;0;0;0;.00nan;0;0
13746;150345;551;91;30;1;29;.967;3900000;0
13747;182780;548;46;26;4;22;.846;3600000;0
13747;170037;548;0;0;0;0;.00nan;0;0
13747;71660;546;73;23;1;22;.957;3600000;0
13747;150187;546;0;0;0;0;.00nan;0;0
13748;6389;545;0;0;0;0;.00nan;0;0
13748;-1;547;73;31;3;28;.903;3600000;0
13748;73792;547;0;0;0;0;.00nan;0;0
13748;143829;545;100;26;0;26;1.000;3600000;0
13749;14047;2190;69;22;2;20;.909;3900000;0
13749;-1;547;100;46;2;44;.957;3900000;0
13749;73792;547;0;0;0;0;.00nan;0;0
13749;73939;2190;0;0;0;0;.00nan;0;0
13750;13041;551;0;0;0;0;.00nan;0;0
13750;71660;546;0;0;0;0;.00nan;0;0
13750;150187;546;91;19;0;19;1.000;3600000;0
13750;150345;551;85;32;2;30;.938;3519000;0
13751;182780;548;0;0;0;0;.00nan;0;0
13751;170037;548;82;26;1;25;.962;3600000;0
13751;44487;543;78;27;2;25;.926;3565000;0
13751;72108;543;0;0;0;0;.00nan;0;0
13752;6389;545;0;0;0;0;.00nan;0;0
13752;-1;547;100;52;0;52;1.000;3600000;0
13752;73792;547;0;0;0;0;.00nan;0;0
13752;143829;545;75;23;1;22;.957;3547000;0
13753;14047;2190;60;27;3;24;.889;3600000;0
13753;71660;546;0;0;0;0;.00nan;0;0
13753;73939;2190;0;0;0;0;.00nan;0;0
13753;150187;546;74;21;1;20;.952;3600000;0
13754;13041;551;0;0;0;0;.00nan;0;0
13754;169478;550;70;42;3;39;.929;3900000;0
13754;150203;550;0;0;0;0;.00nan;0;0
13754;150345;551;75;31;3;28;.903;3900000;0
13755;182780;548;76;32;3;29;.906;3900000;0
13755;170037;548;0;0;0;0;.00nan;0;0
13755;-1;549;90;39;3;36;.923;3900000;0
13755;-1;549;0;0;0;0;.00nan;0;0
13756;14047;2190;38;22;4;18;.818;1729000;0
13756;-1;547;85;45;4;41;.911;3600000;0
13756;73792;547;0;0;0;0;.00nan;0;0
13756;73939;2190;56;13;2;11;.846;1784000;0
13757;13041;551;91;24;1;23;.958;3600000;0
13757;71660;546;60;34;4;30;.882;3600000;0
13757;150187;546;0;0;0;0;.00nan;0;0
13757;150345;551;0;0;0;0;.00nan;0;0
13758;6389;545;0;0;0;0;.00nan;0;0
13758;-1;549;0;0;0;0;.00nan;0;0
13758;-1;549;70;37;3;34;.919;3600000;0
13758;143829;545;66;31;4;27;.871;3579000;0
13759;169478;550;100;34;1;33;.971;3900000;0
13759;44487;543;86;25;1;24;.960;3900000;0
13759;72108;543;0;0;0;0;.00nan;0;0
13759;150203;550;0;0;0;0;.00nan;0;0
13760;13041;551;0;0;0;0;.00nan;0;0
13760;-1;549;77;22;1;21;.955;3600000;0
13760;-1;549;0;0;0;0;.00nan;0;0
13760;150345;551;74;29;2;27;.931;3590000;0
13761;-1;547;32;31;6;25;.806;2814000;0
13761;44487;543;70;26;2;24;.923;3600000;0
13761;72108;543;0;0;0;0;.00nan;0;0
13761;73792;547;41;8;2;6;.750;786000;0
13762;14047;2190;0;0;0;0;.00nan;0;0
13762;169478;550;65;24;2;22;.917;3584000;0
13762;73939;2190;89;20;0;20;1.000;3600000;0
13762;150203;550;0;0;0;0;.00nan;0;0
13763;182780;548;100;41;1;40;.976;3600000;0
13763;6389;545;0;0;0;0;.00nan;0;0
13763;170037;548;0;0;0;0;.00nan;0;0
13763;143829;545;80;30;2;28;.933;3551000;0
13764;13041;551;0;0;0;0;.00nan;0;0
13764;-1;547;91;51;3;48;.941;3527000;0
13764;73792;547;0;0;0;0;.00nan;0;0
13764;150345;551;83;30;1;29;.967;3600000;0
13765;14047;2190;0;0;0;0;.00nan;0;0
13765;-1;549;78;39;4;35;.897;3600000;0
13765;-1;549;0;0;0;0;.00nan;0;0
13765;73939;2190;38;27;5;22;.815;3600000;0
13766;182780;548;55;20;2;18;.900;3600000;0
13766;170037;548;0;0;0;0;.00nan;0;0
13766;71660;546;41;24;4;20;.833;3591000;0
13766;150187;546;0;0;0;0;.00nan;0;0
13767;6389;545;0;0;0;0;.00nan;0;0
13767;44487;543;17;7;4;3;.429;1144000;0
13767;72108;543;70;19;1;18;.947;2456000;0
13767;143829;545;78;22;1;21;.955;3600000;0
13768;-1;549;98;35;1;34;.971;3600000;0
13768;-1;547;68;39;4;35;.897;3600000;0
13768;-1;549;0;0;0;0;.00nan;0;0
13768;73792;547;0;0;0;0;.00nan;0;0
13769;6389;545;0;0;0;0;.00nan;0;0
13769;13041;551;0;0;0;0;.00nan;0;0
13769;143829;545;66;26;3;23;.885;3600000;0
13769;150345;551;54;31;4;27;.871;3555000;0
13770;182780;548;57;34;5;29;.853;3600000;0
13770;170037;548;0;0;0;0;.00nan;0;0
13770;44487;543;0;0;0;0;.00nan;0;0
13770;72108;543;83;33;2;31;.939;3600000;0
13771;169478;550;55;37;4;33;.892;3573000;0
13771;71660;546;80;32;2;30;.938;3600000;0
13771;150187;546;0;0;0;0;.00nan;0;0
13771;150203;550;0;0;0;0;.00nan;0;0
13772;14047;2190;72;41;4;37;.902;3600000;0
13772;-1;549;0;0;0;0;.00nan;0;0
13772;-1;549;100;26;0;26;1.000;3600000;0
13772;73939;2190;0;0;0;0;.00nan;0;0
13773;182780;548;72;38;3;35;.921;3600000;0
13773;13041;551;0;0;0;0;.00nan;0;0
13773;170037;548;0;0;0;0;.00nan;0;0
13773;150345;551;88;30;1;29;.967;3600000;0
13774;14047;2190;91;34;1;33;.971;3600000;0
13774;44487;543;76;35;3;32;.914;3584000;0
13774;72108;543;0;0;0;0;.00nan;0;0
13774;73939;2190;0;0;0;0;.00nan;0;0
13775;-1;547;51;43;6;37;.860;3600000;0
13775;71660;546;0;0;0;0;.00nan;0;0
13775;73792;547;0;0;0;0;.00nan;0;0
13775;150187;546;88;28;1;27;.964;3600000;0
13776;6389;545;0;0;0;0;.00nan;0;0
13776;169478;550;0;0;0;0;.00nan;0;0
13776;143829;545;73;25;2;23;.920;3600000;0
13776;150203;550;50;39;5;34;.872;3600000;0
13777;13041;551;59;28;4;24;.857;3600000;0
13777;14047;2190;24;15;5;10;.667;3577000;0
13777;73939;2190;0;0;0;0;.00nan;0;0
13777;150345;551;0;0;0;0;.00nan;0;0
13778;-1;549;54;22;3;19;.864;3600000;0
13778;44487;543;100;41;0;41;1.000;3600000;0
13778;-1;549;0;0;0;0;.00nan;0;0
13778;72108;543;0;0;0;0;.00nan;0;0
13779;182780;548;58;31;4;27;.871;3591000;0
13779;169478;550;78;35;2;33;.943;3600000;0
13779;170037;548;0;0;0;0;.00nan;0;0
13779;150203;550;0;0;0;0;.00nan;0;0
13780;6389;545;0;0;0;0;.00nan;0;0
13780;71660;546;72;27;3;24;.889;3527000;0
13780;143829;545;75;21;1;20;.952;3600000;0
13780;150187;546;0;0;0;0;.00nan;0;0
13781;169478;550;56;18;2;16;.889;3600000;0
13781;-1;547;0;0;0;0;.00nan;0;0
13781;73792;547;60;38;5;33;.868;3600000;0
13781;150203;550;0;0;0;0;.00nan;0;0
13782;-1;549;97;20;0;20;1.000;3600000;0
13782;-1;549;0;0;0;0;.00nan;0;0
13782;71660;546;77;25;1;24;.960;3543000;0
13782;150187;546;0;0;0;0;.00nan;0;0
13783;13041;551;0;0;0;0;.00nan;0;0
13783;44487;543;97;38;3;35;.921;3600000;0
13783;72108;543;0;0;0;0;.00nan;0;0
13783;150345;551;57;37;5;32;.865;3543000;0
13784;182780;548;48;23;4;19;.826;3567000;0
13784;14047;2190;0;0;0;0;.00nan;0;0
13784;170037;548;0;0;0;0;.00nan;0;0
13784;73939;2190;62;19;2;17;.895;3600000;0
13785;44487;543;98;40;3;37;.925;3600000;0
13785;71660;546;100;26;0;26;1.000;3600000;0
13785;72108;543;0;0;0;0;.00nan;0;0
13785;150187;546;0;0;0;0;.00nan;0;0
13786;169478;550;92;23;0;23;1.000;3600000;0
13786;-1;549;58;29;4;25;.862;3600000;0
13786;-1;549;0;0;0;0;.00nan;0;0
13786;150203;550;0;0;0;0;.00nan;0;0
13787;182780;548;0;0;0;0;.00nan;0;0
13787;170037;548;54;35;4;31;.886;3900000;0
13787;-1;547;91;52;4;48;.923;3900000;0
13787;73792;547;0;0;0;0;.00nan;0;0
13788;6389;545;0;0;0;0;.00nan;0;0
13788;14047;2190;73;23;1;22;.957;3600000;0
13788;73939;2190;0;0;0;0;.00nan;0;0
13788;143829;545;78;33;3;30;.909;3600000;0
13790;-1;547;95;39;2;37;.949;3523000;0
13790;71660;546;97;19;0;19;1.000;3600000;0
13790;73792;546;0;0;0;0;.00nan;0;0
13790;150187;547;0;0;0;0;.00nan;0;0
13792;6389;545;0;0;0;0;.00nan;0;0
13792;-1;549;67;20;2;18;.900;3619000;0
13792;-1;549;0;0;0;0;.00nan;0;0
13792;143829;545;82;25;1;24;.960;3619000;0
13794;13041;551;0;0;0;0;.00nan;0;0
13794;14047;2190;71;38;4;34;.895;3600000;0
13794;73939;2190;0;0;0;0;.00nan;0;0
13794;150345;551;58;24;3;21;.875;3600000;0
13796;169478;550;59;35;4;31;.886;3566000;0
13796;44487;543;82;37;3;34;.919;3600000;0
13796;72108;543;0;0;0;0;.00nan;0;0
13796;150203;550;0;0;0;0;.00nan;0;0
13798;13041;551;0;0;0;0;.00nan;0;0
13798;-1;547;34;30;5;25;.833;3600000;0
13798;150187;547;0;0;0;0;.00nan;0;0
13798;150345;551;50;24;4;20;.833;3600000;0
13800;6389;545;0;0;0;0;.00nan;0;0
13800;14047;2190;84;29;2;27;.931;3900000;0
13800;73939;2190;0;0;0;0;.00nan;0;0
13800;143829;545;72;25;2;23;.920;3900000;0
13802;182780;548;88;42;3;39;.929;3581000;0
13802;170037;548;0;0;0;0;.00nan;0;0
13802;71660;546;76;22;1;21;.955;3600000;0
13802;73792;546;0;0;0;0;.00nan;0;0
13804;-1;549;0;0;0;0;.00nan;0;0
13804;44487;543;50;30;4;26;.867;3600000;0
13804;-1;549;81;25;1;24;.960;3600000;0
13804;72108;543;0;0;0;0;.00nan;0;0
13806;-1;549;63;18;1;17;.944;3600000;0
13806;-1;547;0;0;0;0;.00nan;0;0
13806;-1;549;0;0;0;0;.00nan;0;0
13806;150187;547;76;34;2;32;.941;3577000;0
13808;14047;2190;54;10;1;9;.900;1324000;0
13808;169478;550;44;20;4;16;.800;2088000;0
13808;73939;2190;13;20;6;14;.700;2276000;0
13808;150203;550;65;7;0;7;1.000;1512000;0
13810;6389;545;70;30;2;28;.933;3900000;0
13810;71660;546;0;0;0;0;.00nan;0;0
13810;73792;546;90;35;2;33;.943;3900000;0
13810;143829;545;0;0;0;0;.00nan;0;0
13812;182780;548;0;0;0;0;.00nan;0;0
13812;13041;551;72;34;2;32;.941;3900000;0
13812;170037;548;89;36;2;34;.944;3900000;0
13812;150345;551;0;0;0;0;.00nan;0;0
13814;182780;548;72;27;2;25;.926;3546000;0
13814;170037;548;0;0;0;0;.00nan;0;0
13814;71660;546;99;20;0;20;1.000;3600000;0
13814;73792;546;0;0;0;0;.00nan;0;0
13816;-1;549;0;0;0;0;.00nan;0;0
13816;-1;547;90;27;1;26;.963;3600000;0
13816;-1;549;58;27;3;24;.889;3530000;0
13816;150187;547;0;0;0;0;.00nan;0;0
13818;6389;545;0;0;0;0;.00nan;0;0
13818;14047;2190;55;24;3;21;.875;3600000;0
13818;73939;2190;0;0;0;0;.00nan;0;0
13818;143829;545;100;34;0;34;1.000;3600000;0
13820;169478;550;73;35;3;32;.914;3548000;0
13820;44487;543;80;31;2;29;.935;3600000;0
13820;72108;543;0;0;0;0;.00nan;0;0
13820;150203;550;0;0;0;0;.00nan;0;0
13822;14047;2190;0;0;0;0;.00nan;0;0
13822;44487;543;0;0;0;0;.00nan;0;0
13822;72108;543;62;33;3;30;.909;3900000;0
13822;73939;2190;57;28;3;25;.893;3900000;0
13824;-1;549;35;36;6;30;.833;3600000;0
13824;-1;549;0;0;0;0;.00nan;0;0
13824;71660;546;70;26;2;24;.923;3600000;0
13824;73792;546;0;0;0;0;.00nan;0;0
13826;182780;548;0;0;0;0;.00nan;0;0
13826;6389;545;0;0;0;0;.00nan;0;0
13826;170037;548;71;28;2;26;.929;3600000;0
13826;143829;545;58;24;3;21;.875;3543000;0
13828;13041;551;0;0;0;0;.00nan;0;0
13828;-1;547;0;0;0;0;.00nan;0;0
13828;150187;547;94;45;2;43;.956;3789000;0
13828;150345;551;71;29;3;26;.897;3789000;0
13830;44487;543;86;27;1;26;.963;3600000;0
13830;71660;546;31;17;4;13;.765;2372000;0
13830;72108;543;0;0;0;0;.00nan;0;0
13830;73792;546;54;5;0;5;1.000;1228000;0
13832;14047;2190;41;21;4;17;.810;3548000;0
13832;-1;549;0;0;0;0;.00nan;0;0
13832;-1;549;67;33;3;30;.909;3600000;0
13832;73939;2190;0;0;0;0;.00nan;0;0
13834;6389;545;71;23;2;21;.913;3600000;0
13834;-1;547;44;27;5;22;.815;3600000;0
13834;143829;545;0;0;0;0;.00nan;0;0
13834;150187;547;0;0;0;0;.00nan;0;0
13836;182780;548;77;31;2;29;.935;3550000;0
13836;169478;550;100;38;1;37;.974;3600000;0
13836;170037;548;0;0;0;0;.00nan;0;0
13836;150203;550;0;0;0;0;.00nan;0;0
13838;169478;550;0;0;0;0;.00nan;0;0
13838;71660;546;0;0;0;0;.00nan;0;0
13838;73792;546;66;26;2;24;.923;3600000;0
13838;150203;550;65;29;3;26;.897;3553000;0
13840;182780;548;0;0;0;0;.00nan;0;0
13840;13041;551;50;1;0;1;1.000;423000;0
13840;170037;548;27;25;6;19;.760;3600000;0
13840;150345;551;47;38;6;32;.842;3150000;0
13842;14047;2190;0;0;0;0;.00nan;0;0
13842;-1;549;59;34;4;30;.882;3654000;0
13842;-1;549;0;0;0;0;.00nan;0;0
13842;73939;2190;56;29;3;26;.897;3654000;0
13844;6389;545;0;0;0;0;.00nan;0;0
13844;-1;547;0;0;0;0;.00nan;0;0
13844;143829;545;69;26;2;24;.923;3574000;0
13844;150187;547;71;24;1;23;.958;3600000;0
1053;44487;543;36;33;6;27;.818;3362000;0
1053;71660;546;80;28;2;26;.929;3600000;0
1053;72108;543;56;4;0;4;1.000;238000;0
1053;150187;546;0;0;0;0;.00nan;0;0
1054;13041;551;0;0;0;0;.00nan;0;0
1054;169478;550;65;34;4;30;.882;3639000;0
1054;150203;550;0;0;0;0;.00nan;0;0
1054;150345;551;59;30;3;27;.900;3639000;0
1055;182780;548;71;31;4;27;.871;3600000;0
1055;6389;545;0;0;0;0;.00nan;0;0
1055;170037;548;0;0;0;0;.00nan;0;0
1055;143829;545;100;25;0;25;1.000;3600000;0
1056;14047;2190;77;24;2;22;.917;3600000;0
1056;-1;549;84;41;3;38;.927;3563000;0
1056;-1;549;0;0;0;0;.00nan;0;0
1056;73939;2190;0;0;0;0;.00nan;0;0
1057;44487;543;71;32;3;29;.906;3749000;0
1057;71660;546;69;38;4;34;.895;3749000;0
1057;72108;543;0;0;0;0;.00nan;0;0
1057;150187;546;0;0;0;0;.00nan;0;0
1058;13041;551;0;0;0;0;.00nan;0;0
1058;169478;550;84;41;2;39;.951;5192000;0
1058;150203;550;0;0;0;0;.00nan;0;0
1058;150345;551;84;26;1;25;.962;5192000;0
1059;182780;548;74;37;3;34;.919;4011000;0
1059;6389;545;0;0;0;0;.00nan;0;0
1059;170037;548;0;0;0;0;.00nan;0;0
1059;143829;545;60;30;4;26;.867;4011000;0
1060;14047;2190;100;23;0;23;1.000;3600000;0
1060;-1;549;47;33;5;28;.848;3600000;0
1060;-1;549;0;0;0;0;.00nan;0;0
1060;73939;2190;0;0;0;0;.00nan;0;0
1061;44487;543;87;34;2;32;.941;3570000;0
1061;71660;546;75;21;1;20;.952;3600000;0
1061;72108;543;0;0;0;0;.00nan;0;0
1061;150187;546;0;0;0;0;.00nan;0;0
1062;13041;551;0;0;0;0;.00nan;0;0
1062;169478;550;77;37;2;35;.946;3681000;0
1062;150203;550;0;0;0;0;.00nan;0;0
1062;150345;551;73;18;1;17;.944;3681000;0
1063;182780;548;78;44;3;41;.932;5775000;0
1063;6389;545;0;0;0;0;.00nan;0;0
1063;170037;548;0;0;0;0;.00nan;0;0
1063;143829;545;87;43;2;41;.953;5775000;0
1064;14047;2190;23;32;7;25;.781;3600000;0
1064;-1;549;60;29;3;26;.897;3600000;0
1064;-1;549;0;0;0;0;.00nan;0;0
1064;73939;2190;0;0;0;0;.00nan;0;0
1065;44487;543;61;28;3;25;.893;3931000;0
1065;71660;546;68;40;4;36;.900;3931000;0
1065;72108;543;0;0;0;0;.00nan;0;0
1065;150187;546;0;0;0;0;.00nan;0;0
1066;13041;551;0;0;0;0;.00nan;0;0
1066;169478;550;57;35;4;31;.886;3967000;0
1066;150203;550;0;0;0;0;.00nan;0;0
1066;150345;551;54;25;3;22;.880;3967000;0
1067;182780;548;30;25;6;19;.760;3600000;0
1067;6389;545;0;0;0;0;.00nan;0;0
1067;170037;548;0;0;0;0;.00nan;0;0
1067;143829;545;72;28;2;26;.929;3600000;0
1068;14047;2190;81;41;2;39;.951;5644000;0
1068;-1;549;65;46;3;43;.935;5644000;0
1068;-1;549;0;0;0;0;.00nan;0;0
1068;73939;2190;0;0;0;0;.00nan;0;0
1458;44487;543;53;37;6;31;.838;3570000;0
1458;71660;546;40;22;4;18;.818;3600000;0
1458;72108;543;0;0;0;0;.00nan;0;0
1458;150187;546;0;0;0;0;.00nan;0;0
1459;182780;548;72;25;1;24;.960;3600000;0
1459;6389;545;0;0;0;0;.00nan;0;0
1459;170037;548;0;0;0;0;.00nan;0;0
1459;143829;545;73;34;2;32;.941;3590000;0
1460;14047;2190;48;21;3;18;.857;3600000;0
1460;-1;549;57;33;4;29;.879;3543000;0
1460;-1;549;0;0;0;0;.00nan;0;0
1460;73939;2190;0;0;0;0;.00nan;0;0
1494;44487;543;86;37;2;35;.946;3600000;0
1494;71660;546;69;29;3;26;.897;3579000;0
1494;72108;543;0;0;0;0;.00nan;0;0
1494;150187;546;0;0;0;0;.00nan;0;0
1495;182780;548;63;33;3;30;.909;3577000;0
1495;6389;545;0;0;0;0;.00nan;0;0
1495;170037;548;0;0;0;0;.00nan;0;0
1495;143829;545;69;29;2;27;.931;3600000;0
1541;44487;543;89;33;1;32;.970;3600000;0
1541;71660;546;36;30;6;24;.800;3070000;0
1541;72108;543;0;0;0;0;.00nan;0;0
1541;150187;546;57;5;0;5;1.000;530000;0
1559;13041;551;0;0;0;0;.00nan;0;0
1559;44487;543;100;22;0;22;1.000;3600000;0
1559;72108;543;0;0;0;0;.00nan;0;0
1559;150345;551;73;40;4;36;.900;3600000;0
1560;6389;545;0;0;0;0;.00nan;0;0
1560;14047;2190;89;25;1;24;.960;3600000;0
1560;73939;2190;0;0;0;0;.00nan;0;0
1560;143829;545;54;25;3;22;.880;3549000;0
1561;13041;551;0;0;0;0;.00nan;0;0
1561;44487;543;48;22;3;19;.864;3600000;0
1561;72108;543;0;0;0;0;.00nan;0;0
1561;150345;551;55;40;5;35;.875;3600000;0
1562;6389;545;0;0;0;0;.00nan;0;0
1562;14047;2190;52;24;3;21;.875;3559000;0
1562;73939;2190;0;0;0;0;.00nan;0;0
1562;143829;545;67;25;2;23;.920;3600000;0
1563;13041;551;0;0;0;0;.00nan;0;0
1563;44487;543;64;29;3;26;.897;3600000;0
1563;72108;543;0;0;0;0;.00nan;0;0
1563;150345;551;58;20;2;18;.900;3600000;0
1564;6389;545;0;0;0;0;.00nan;0;0
1564;14047;2190;55;26;4;22;.846;3576000;0
1564;73939;2190;0;0;0;0;.00nan;0;0
1564;143829;545;80;31;2;29;.935;3600000;0
1565;13041;551;0;0;0;0;.00nan;0;0
1565;44487;543;52;21;3;18;.857;3600000;0
1565;72108;543;0;0;0;0;.00nan;0;0
1565;150345;551;91;20;0;20;1.000;3600000;0
1566;6389;545;0;0;0;0;.00nan;0;0
1566;14047;2190;75;28;2;26;.929;3732000;0
1566;73939;2190;0;0;0;0;.00nan;0;0
1566;143829;545;84;42;3;39;.929;3733000;0
1847;13041;551;0;0;0;0;.00nan;0;0
1847;44487;543;91;31;1;30;.968;3600000;0
1847;72108;543;0;0;0;0;.00nan;0;0
1847;150345;551;39;38;6;32;.842;3600000;0
1848;6389;545;0;0;0;0;.00nan;0;0
1848;14047;2190;67;18;1;17;.944;3544000;0
1848;73939;2190;0;0;0;0;.00nan;0;0
1848;143829;545;93;21;0;21;1.000;3600000;0
1872;13041;551;0;0;0;0;.00nan;0;0
1872;44487;543;64;34;4;30;.882;3600000;0
1872;72108;543;0;0;0;0;.00nan;0;0
1872;150345;551;82;25;1;24;.960;3600000;0
1873;6389;545;0;0;0;0;.00nan;0;0
1873;14047;2190;71;26;2;24;.923;4158000;0
1873;73939;2190;0;0;0;0;.00nan;0;0
1873;143829;545;88;31;1;30;.968;4158000;0
1896;13041;551;0;0;0;0;.00nan;0;0
1896;44487;543;55;15;3;12;.800;3600000;0
1896;72108;543;0;0;0;0;.00nan;0;0
1896;150345;551;59;33;5;28;.848;3539000;0
1919;6389;545;0;0;0;0;.00nan;0;0
1919;44487;543;86;29;1;28;.966;3600000;0
1919;72108;543;0;0;0;0;.00nan;0;0
1919;143829;545;52;33;5;28;.848;3600000;0
1920;13041;551;0;0;0;0;.00nan;0;0
1920;14047;2190;89;34;1;33;.971;3600000;0
1920;73939;2190;0;0;0;0;.00nan;0;0
1920;150345;551;72;30;2;28;.933;3587000;0
1921;6389;545;0;0;0;0;.00nan;0;0
1921;44487;543;92;29;1;28;.966;3600000;0
1921;72108;543;0;0;0;0;.00nan;0;0
1921;143829;545;61;20;2;18;.900;3583000;0
1922;13041;551;0;0;0;0;.00nan;0;0
1922;14047;2190;58;16;2;14;.875;3600000;0
1922;73939;2190;0;0;0;0;.00nan;0;0
1922;150345;551;75;39;3;36;.923;3546000;0
1923;6389;545;0;0;0;0;.00nan;0;0
1923;44487;543;41;30;5;25;.833;3600000;0
1923;72108;543;0;0;0;0;.00nan;0;0
1923;143829;545;64;18;2;16;.889;3600000;0
1924;13041;551;0;0;0;0;.00nan;0;0
1924;14047;2190;66;21;1;20;.952;3600000;0
1924;73939;2190;0;0;0;0;.00nan;0;0
1924;150345;551;65;30;4;26;.867;3600000;0
1925;6389;545;0;0;0;0;.00nan;0;0
1925;44487;543;50;26;4;22;.846;3600000;0
1925;72108;543;0;0;0;0;.00nan;0;0
1925;143829;545;100;43;0;43;1.000;3600000;0
1926;13041;551;0;0;0;0;.00nan;0;0
1926;14047;2190;65;31;4;27;.871;3598000;0
1926;73939;2190;0;0;0;0;.00nan;0;0
1926;150345;551;94;48;3;45;.938;3600000;0
2145;6389;545;0;0;0;0;.00nan;0;0
2145;44487;543;69;20;1;19;.950;3600000;0
2145;72108;543;0;0;0;0;.00nan;0;0
2145;143829;545;58;28;4;24;.857;3600000;0
2146;13041;551;0;0;0;0;.00nan;0;0
2146;14047;2190;54;23;3;20;.870;3600000;0
2146;73939;2190;0;0;0;0;.00nan;0;0
2146;150345;551;31;37;7;30;.811;3600000;0
2189;6389;545;0;0;0;0;.00nan;0;0
2189;44487;543;56;33;4;29;.879;3600000;0
2189;72108;543;0;0;0;0;.00nan;0;0
2189;143829;545;69;19;1;18;.947;3600000;0
2274;6389;545;0;0;0;0;.00nan;0;0
2274;44487;543;91;34;2;32;.941;3580000;0
2274;72108;543;0;0;0;0;.00nan;0;0
2274;143829;545;83;28;1;27;.964;3600000;0
13845;203470;460;0;0;0;0;.00nan;0;0
13845;179373;460;1;27;8;19;.704;3600000;0
13845;179652;452;0;0;0;0;.00nan;0;0
13845;202193;452;93;44;2;42;.955;3600000;0
13846;203478;457;0;0;0;0;.00nan;0;0
13846;173279;457;99;39;2;37;.949;3600000;0
13846;179652;452;0;0;0;0;.00nan;0;0
13846;202193;452;28;28;6;22;.786;3600000;0
13847;2153;459;97;27;0;27;1.000;3600000;0
13847;208723;1086;0;0;0;0;.00nan;0;0
13847;188429;459;0;0;0;0;.00nan;0;0
13847;15564;1086;29;28;5;23;.821;3600000;0
13848;208716;2579;44;30;4;26;.867;3900000;0
13848;172079;4337;52;28;4;24;.857;3900000;0
13848;198885;4337;0;0;0;0;.00nan;0;0
13848;198903;2579;0;0;0;0;.00nan;0;0
13849;168066;455;0;0;0;0;.00nan;0;0
13849;15558;456;0;0;0;0;.00nan;0;0
13849;92283;456;59;30;4;26;.867;3549000;0
13849;155769;455;92;44;3;41;.932;3600000;0
13850;208715;458;0;0;0;0;.00nan;0;0
13850;208723;1086;0;0;0;0;.00nan;0;0
13850;167492;458;73;32;3;29;.906;3600000;0
13850;15564;1086;59;32;4;28;.875;3571000;0
13851;203470;460;0;0;0;0;.00nan;0;0
13851;168066;455;0;0;0;0;.00nan;0;0
13851;179373;460;43;28;5;23;.821;3594000;0
13851;155769;455;62;32;3;29;.906;3600000;0
13852;203470;460;0;0;0;0;.00nan;0;0
13852;179373;460;62;25;2;23;.920;3600000;0
13852;179652;452;18;30;8;22;.733;2745000;0
13852;202193;452;59;11;1;10;.909;855000;0
13853;172079;4337;26;34;8;26;.765;3573000;0
13853;198885;4337;0;0;0;0;.00nan;0;0
13853;15558;456;70;22;1;21;.955;2752000;0
13853;92283;456;29;9;4;5;.556;848000;0
13854;203470;460;0;0;0;0;.00nan;0;0
13854;179373;460;60;16;2;14;.875;3559000;0
13854;179652;452;0;0;0;0;.00nan;0;0
13854;202193;452;100;48;1;47;.979;3600000;0
13855;203478;457;0;0;0;0;.00nan;0;0
13855;168066;455;0;0;0;0;.00nan;0;0
13855;173279;457;61;28;3;25;.893;3600000;0
13855;155769;455;29;24;5;19;.792;3515000;0
13856;2153;459;82;42;4;38;.905;3900000;0
13856;208716;2579;59;34;4;30;.882;3900000;0
13856;198903;2579;0;0;0;0;.00nan;0;0
13856;188429;459;0;0;0;0;.00nan;0;0
13857;208715;458;57;7;0;7;1.000;1064000;0
13857;208716;2579;0;0;0;0;.00nan;0;0
13857;198903;2579;52;23;4;19;.826;3600000;0
13857;167492;458;22;30;7;23;.767;2536000;0
13858;203478;457;0;0;0;0;.00nan;0;0
13858;15558;456;63;12;1;11;.917;2315000;0
13858;173279;457;55;35;5;30;.857;3900000;0
13858;92283;456;29;14;4;10;.714;1556000;0
13859;172079;4337;0;0;0;0;.00nan;0;0
13859;198885;4337;55;35;4;31;.886;3572000;0
13859;179652;452;0;0;0;0;.00nan;0;0
13859;202193;452;56;25;3;22;.880;3600000;0
13860;2153;459;0;0;0;0;.00nan;0;0
13860;208715;458;0;0;0;0;.00nan;0;0
13860;167492;458;47;34;5;29;.853;3670000;0
13860;188429;459;35;33;6;27;.818;3670000;0
13861;172079;4337;44;18;3;15;.833;3600000;0
13861;198885;4337;0;0;0;0;.00nan;0;0
13861;179652;452;20;41;8;33;.805;2955000;0
13861;202193;452;44;4;1;3;.750;645000;0
13862;2153;459;0;0;0;0;.00nan;0;0
13862;203478;457;0;0;0;0;.00nan;0;0
13862;188429;459;71;22;1;21;.955;3600000;0
13862;173279;457;45;28;4;24;.857;3600000;0
13863;203470;460;0;0;0;0;.00nan;0;0
13863;208716;2579;83;28;1;27;.964;3600000;0
13863;198903;2579;0;0;0;0;.00nan;0;0
13863;179373;460;28;26;5;21;.808;3600000;0
13864;208723;1086;0;0;0;0;.00nan;0;0
13864;15558;456;71;23;1;22;.957;3600000;0
13864;15564;1086;60;31;3;28;.903;3566000;0
13864;92283;456;0;0;0;0;.00nan;0;0
13865;203478;457;0;0;0;0;.00nan;0;0
13865;208715;458;0;0;0;0;.00nan;0;0
13865;167492;458;86;35;2;33;.943;3600000;0
13865;173279;457;34;19;4;15;.789;3514000;0
13866;203470;460;0;0;0;0;.00nan;0;0
13866;172079;4337;52;31;5;26;.839;3630000;0
13866;198885;4337;0;0;0;0;.00nan;0;0
13866;179373;460;44;28;4;24;.857;3630000;0
13867;168066;455;0;0;0;0;.00nan;0;0
13867;15558;456;0;0;0;0;.00nan;0;0
13867;92283;456;51;22;3;19;.864;3600000;0
13867;155769;455;44;31;5;26;.839;3515000;0
13868;203470;460;54;30;4;26;.867;3600000;0
13868;172079;4337;0;0;0;0;.00nan;0;0
13868;198885;4337;30;24;6;18;.750;3519000;0
13868;179373;460;0;0;0;0;.00nan;0;0
13869;203478;457;0;0;0;0;.00nan;0;0
13869;208723;1086;0;0;0;0;.00nan;0;0
13869;15564;1086;74;31;3;28;.903;3577000;0
13869;173279;457;83;29;2;27;.931;3600000;0
13870;208723;1086;0;0;0;0;.00nan;0;0
13870;15564;1086;48;39;6;33;.846;3563000;0
13870;179652;452;0;0;0;0;.00nan;0;0
13870;202193;452;66;29;4;25;.862;3600000;0
13871;208715;458;0;0;0;0;.00nan;0;0
13871;208716;2579;36;31;6;25;.806;3734000;0
13871;198903;2579;0;0;0;0;.00nan;0;0
13871;167492;458;50;30;5;25;.833;3734000;0
13872;2153;459;0;0;0;0;.00nan;0;0
13872;188429;459;64;30;3;27;.900;3600000;0
13872;15558;456;49;33;5;28;.848;3567000;0
13872;92283;456;0;0;0;0;.00nan;0;0
13873;208715;458;0;0;0;0;.00nan;0;0
13873;208716;2579;0;0;0;0;.00nan;0;0
13873;198903;2579;57;32;3;29;.906;3576000;0
13873;167492;458;73;27;2;25;.926;3600000;0
13874;2153;459;0;0;0;0;.00nan;0;0
13874;188429;459;67;34;3;31;.912;3600000;0
13874;168066;455;0;0;0;0;.00nan;0;0
13874;155769;455;69;42;5;37;.881;3555000;0
13875;203478;457;0;0;0;0;.00nan;0;0
13875;173279;457;63;35;4;31;.886;3600000;0
13875;179652;452;0;0;0;0;.00nan;0;0
13875;202193;452;39;27;5;22;.815;3587000;0
13876;172079;4337;55;32;5;27;.844;3549000;0
13876;198885;4337;0;0;0;0;.00nan;0;0
13876;168066;455;0;0;0;0;.00nan;0;0
13876;155769;455;55;27;4;23;.852;3600000;0
13877;2153;459;81;50;4;46;.920;3727000;0
13877;203470;460;0;0;0;0;.00nan;0;0
13877;188429;459;0;0;0;0;.00nan;0;0
13877;179373;460;52;22;3;19;.864;3718000;0
13878;208716;2579;34;26;5;21;.808;3600000;0
13878;208723;1086;0;0;0;0;.00nan;0;0
13878;198903;2579;0;0;0;0;.00nan;0;0
13878;15564;1086;85;29;1;28;.966;3600000;0
13879;203470;460;0;0;0;0;.00nan;0;0
13879;208715;458;0;0;0;0;.00nan;0;0
13879;167492;458;59;31;4;27;.871;3600000;0
13879;179373;460;29;34;7;27;.794;3600000;0
13880;15558;456;0;0;0;0;.00nan;0;0
13880;179652;452;0;0;0;0;.00nan;0;0
13880;202193;452;58;33;4;29;.879;3571000;0
13880;92283;456;75;29;2;27;.931;3600000;0
13881;203470;460;0;0;0;0;.00nan;0;0
13881;208716;2579;32;40;7;33;.825;3614000;0
13881;198903;2579;0;0;0;0;.00nan;0;0
13881;179373;460;33;30;6;24;.800;3614000;0
13882;2153;459;0;0;0;0;.00nan;0;0
13882;188429;459;82;29;2;27;.931;3600000;0
13882;15558;456;57;27;3;24;.889;3600000;0
13882;92283;456;0;0;0;0;.00nan;0;0
13883;208723;1086;0;0;0;0;.00nan;0;0
13883;15564;1086;29;20;5;15;.750;3600000;0
13883;179652;452;41;38;6;32;.842;3575000;0
13883;202193;452;0;0;0;0;.00nan;0;0
13884;203478;457;0;0;0;0;.00nan;0;0
13884;168066;455;21;23;6;17;.739;3334000;0
13884;173279;457;54;32;5;27;.844;3600000;0
13884;155769;455;53;3;0;3;1.000;219000;0
13885;208715;458;58;33;3;30;.909;3600000;0
13885;167492;458;0;0;0;0;.00nan;0;0
13885;15558;456;0;0;0;0;.00nan;0;0
13885;92283;456;83;27;2;25;.926;3600000;0
13886;2153;459;63;29;3;26;.897;3900000;0
13886;208715;458;0;0;0;0;.00nan;0;0
13886;167492;458;62;31;3;28;.903;3900000;0
13886;188429;459;0;0;0;0;.00nan;0;0
13887;2153;459;0;0;0;0;.00nan;0;0
13887;172079;4337;60;21;3;18;.857;3600000;0
13887;198885;4337;0;0;0;0;.00nan;0;0
13887;188429;459;50;35;5;30;.857;3570000;0
13888;203478;457;0;0;0;0;.00nan;0;0
13888;15558;456;45;32;5;27;.844;3600000;0
13888;173279;457;93;41;2;39;.951;3600000;0
13888;92283;456;0;0;0;0;.00nan;0;0
13889;208715;458;56;30;4;26;.867;3561000;0
13889;208716;2579;70;38;3;35;.921;3600000;0
13889;198903;2579;0;0;0;0;.00nan;0;0
13889;167492;458;0;0;0;0;.00nan;0;0
13890;203470;460;0;0;0;0;.00nan;0;0
13890;208723;1086;59;51;5;46;.902;2231000;0
13890;15564;1086;22;26;6;20;.769;1369000;0
13890;179373;460;25;30;6;24;.800;3600000;0
13891;168066;455;0;0;0;0;.00nan;0;0
13891;179652;452;0;0;0;0;.00nan;0;0
13891;202193;452;73;39;3;36;.923;3600000;0
13891;155769;455;59;21;2;19;.905;3600000;0
13892;2153;459;61;26;3;23;.885;3712000;0
13892;208716;2579;0;0;0;0;.00nan;0;0
13892;198903;2579;54;20;2;18;.900;3712000;0
13892;188429;459;0;0;0;0;.00nan;0;0
13893;203470;460;0;0;0;0;.00nan;0;0
13893;203478;457;15;19;6;13;.684;2273000;0
13893;173279;457;26;7;3;4;.571;1327000;0
13893;179373;460;60;30;4;26;.867;3600000;0
13894;2153;459;0;0;0;0;.00nan;0;0
13894;188429;459;54;26;4;22;.846;3804000;0
13894;168066;455;0;0;0;0;.00nan;0;0
13894;155769;455;56;40;5;35;.875;3804000;0
13895;172079;4337;86;42;3;39;.929;3600000;0
13895;208723;1086;58;13;1;12;.923;972000;0
13895;198885;4337;0;0;0;0;.00nan;0;0
13895;15564;1086;27;32;6;26;.813;2628000;0
13896;208716;2579;34;28;5;23;.821;3787000;0
13896;198903;2579;0;0;0;0;.00nan;0;0
13896;179652;452;0;0;0;0;.00nan;0;0
13896;202193;452;58;25;4;21;.840;3787000;0
13897;208715;458;0;0;0;0;.00nan;0;0
13897;167492;458;52;29;5;24;.828;3854000;0
13897;168066;455;55;40;6;34;.850;3854000;0
13897;155769;455;0;0;0;0;.00nan;0;0
13898;172079;4337;58;6;0;6;1.000;783000;0
13898;198885;4337;11;18;6;12;.667;2817000;0
13898;15558;456;81;33;2;31;.939;3600000;0
13898;92283;456;0;0;0;0;.00nan;0;0
13899;203470;460;0;0;0;0;.00nan;0;0
13899;203478;457;47;6;1;5;.833;1928000;0
13899;173279;457;28;21;5;16;.762;1672000;0
13899;179373;460;81;28;1;27;.964;3600000;0
13900;172079;4337;28;25;6;19;.760;2882000;0
13900;198885;4337;56;9;1;8;.889;718000;0
13900;179652;452;0;0;0;0;.00nan;0;0
13900;202193;452;83;40;3;37;.925;3600000;0
13901;2153;459;0;0;0;0;.00nan;0;0
13901;203470;460;0;0;0;0;.00nan;0;0
13901;188429;459;28;31;6;25;.806;3559000;0
13901;179373;460;65;40;5;35;.875;3600000;0
13902;203478;457;0;0;0;0;.00nan;0;0
13902;208715;458;0;0;0;0;.00nan;0;0
13902;167492;458;50;34;5;29;.853;3900000;0
13902;173279;457;49;37;5;32;.865;3900000;0
13903;208716;2579;40;30;5;25;.833;3553000;0
13903;208723;1086;0;0;0;0;.00nan;0;0
13903;198903;2579;0;0;0;0;.00nan;0;0
13903;15564;1086;66;35;4;31;.886;3600000;0
13904;208715;458;61;20;1;19;.950;3600000;0
13904;208723;1086;0;0;0;0;.00nan;0;0
13904;167492;458;0;0;0;0;.00nan;0;0
13904;15564;1086;47;36;5;31;.861;3600000;0
13905;208716;2579;0;0;0;0;.00nan;0;0
13905;198903;2579;33;24;6;18;.750;3600000;0
13905;15558;456;0;0;0;0;.00nan;0;0
13905;92283;456;77;33;2;31;.939;3600000;0
13906;172079;4337;67;16;1;15;.938;1876000;0
13906;198885;4337;9;17;6;11;.647;1724000;0
13906;179652;452;64;29;3;26;.897;3600000;0
13906;202193;452;0;0;0;0;.00nan;0;0
13907;2153;459;8;16;6;10;.625;1334000;0
13907;188429;459;89;25;0;25;1.000;2266000;0
13907;168066;455;0;0;0;0;.00nan;0;0
13907;155769;455;79;39;3;36;.923;3600000;0
13908;2153;459;55;6;0;6;1.000;331000;0
13908;188429;459;43;34;6;28;.824;3222000;0
13908;179652;452;0;0;0;0;.00nan;0;0
13908;202193;452;50;34;5;29;.853;3600000;0
13909;203470;460;0;0;0;0;.00nan;0;0
13909;172079;4337;46;26;5;21;.808;3763000;0
13909;198885;4337;0;0;0;0;.00nan;0;0
13909;179373;460;73;36;4;32;.889;3745000;0
13910;203478;457;0;0;0;0;.00nan;0;0
13910;208723;1086;0;0;0;0;.00nan;0;0
13910;15564;1086;55;26;3;23;.885;3548000;0
13910;173279;457;70;19;1;18;.947;3600000;0
13911;208716;2579;26;20;5;15;.750;3900000;0
13911;198903;2579;0;0;0;0;.00nan;0;0
13911;168066;455;0;0;0;0;.00nan;0;0
13911;155769;455;68;38;5;33;.868;3900000;0
13912;2153;459;0;0;0;0;.00nan;0;0
13912;203478;457;49;40;6;34;.850;3600000;0
13912;188429;459;81;33;2;31;.939;3600000;0
13912;173279;457;0;0;0;0;.00nan;0;0
13913;208723;1086;0;0;0;0;.00nan;0;0
13913;15564;1086;40;36;6;30;.833;3546000;0
13913;179652;452;57;39;5;34;.872;3600000;0
13913;202193;452;0;0;0;0;.00nan;0;0
13914;203470;460;0;0;0;0;.00nan;0;0
13914;172079;4337;0;0;0;0;.00nan;0;0
13914;198885;4337;55;35;5;30;.857;3600000;0
13914;179373;460;34;35;6;29;.829;3600000;0
13915;208716;2579;0;0;0;0;.00nan;0;0
13915;198903;2579;33;23;5;18;.783;3600000;0
13915;15558;456;0;0;0;0;.00nan;0;0
13915;92283;456;85;31;1;30;.968;3600000;0
13916;2153;459;57;21;2;19;.905;3900000;0
13916;208715;458;0;0;0;0;.00nan;0;0
13916;167492;458;64;26;2;24;.923;3900000;0
13916;188429;459;0;0;0;0;.00nan;0;0
13917;203470;460;62;8;0;8;1.000;1528000;0
13917;15558;456;0;0;0;0;.00nan;0;0
13917;179373;460;17;20;6;14;.700;2372000;0
13917;92283;456;48;32;6;26;.813;3900000;0
13918;2153;459;0;0;0;0;.00nan;0;0
13918;188429;459;44;24;4;20;.833;3600000;0
13918;179652;452;0;0;0;0;.00nan;0;0
13918;202193;452;45;36;5;31;.861;3559000;0
13919;172079;4337;63;40;5;35;.875;3900000;0
13919;208723;1086;0;0;0;0;.00nan;0;0
13919;198885;4337;0;0;0;0;.00nan;0;0
13919;15564;1086;59;37;5;32;.865;3900000;0
13920;203478;457;0;0;0;0;.00nan;0;0
13920;208716;2579;48;24;3;21;.875;3570000;0
13920;198903;2579;0;0;0;0;.00nan;0;0
13920;173279;457;82;34;2;32;.941;3600000;0
13921;208715;458;0;0;0;0;.00nan;0;0
13921;167492;458;79;32;2;30;.938;3600000;0
13921;179652;452;28;30;6;24;.800;2809000;0
13921;202193;452;37;13;3;10;.769;791000;0
13922;172079;4337;0;0;0;0;.00nan;0;0
13922;198885;4337;92;47;3;44;.936;3600000;0
13922;168066;455;46;5;1;4;.800;256000;0
13922;155769;455;34;29;6;23;.793;3344000;0
13923;208715;458;0;0;0;0;.00nan;0;0
13923;167492;458;69;35;3;32;.914;3600000;0
13923;179652;452;61;35;4;31;.886;3560000;0
13923;202193;452;0;0;0;0;.00nan;0;0
13924;208716;2579;20;27;7;20;.741;3544000;0
13924;172079;4337;21;21;6;15;.714;2755000;0
13924;198885;4337;62;7;0;7;1.000;845000;0
13924;198903;2579;0;0;0;0;.00nan;0;0
13925;203470;460;80;27;1;26;.963;3600000;0
13925;203478;457;0;0;0;0;.00nan;0;0
13925;173279;457;31;29;6;23;.793;3600000;0
13925;179373;460;0;0;0;0;.00nan;0;0
13926;208723;1086;0;0;0;0;.00nan;0;0
13926;168066;455;0;0;0;0;.00nan;0;0
13926;15564;1086;65;31;3;28;.903;3556000;0
13926;155769;455;61;21;2;19;.905;3600000;0
13927;2153;459;0;0;0;0;.00nan;0;0
13927;188429;459;64;35;4;31;.886;3593000;0
13927;15558;456;0;0;0;0;.00nan;0;0
13927;92283;456;55;23;3;20;.870;3600000;0
13928;168066;455;0;0;0;0;.00nan;0;0
13928;179652;452;74;31;2;29;.935;3600000;0
13928;202193;452;0;0;0;0;.00nan;0;0
13928;155769;455;62;29;3;26;.897;3600000;0
13929;2153;459;68;31;3;28;.903;3600000;0
13929;208723;1086;0;0;0;0;.00nan;0;0
13929;188429;459;0;0;0;0;.00nan;0;0
13929;15564;1086;100;27;0;27;1.000;3600000;0
13930;203470;460;31;13;3;10;.769;2088000;0
13930;203478;457;0;0;0;0;.00nan;0;0
13930;173279;457;48;39;6;33;.846;3600000;0
13930;179373;460;34;19;4;15;.789;1512000;0
13931;208715;458;0;0;0;0;.00nan;0;0
13931;167492;458;67;37;4;33;.892;3582000;0
13931;15558;456;62;25;3;22;.880;3600000;0
13931;92283;456;0;0;0;0;.00nan;0;0
13932;203470;460;0;0;0;0;.00nan;0;0
13932;208715;458;0;0;0;0;.00nan;0;0
13932;167492;458;61;45;6;39;.867;3600000;0
13932;179373;460;55;24;3;21;.875;3600000;0
13933;213957;457;0;0;0;0;.00nan;0;0
13933;203478;457;28;26;6;20;.769;3544000;0
13933;172079;4337;0;0;0;0;.00nan;0;0
13933;198885;4337;59;45;5;40;.889;3600000;0
13934;2153;459;0;0;0;0;.00nan;0;0
13934;208716;2579;0;0;0;0;.00nan;0;0
13934;198903;2579;69;24;3;21;.875;3654000;0
13934;188429;459;59;19;2;17;.895;3654000;0
13935;208723;1086;0;0;0;0;.00nan;0;0
13935;168066;455;0;0;0;0;.00nan;0;0
13935;15564;1086;64;35;4;31;.886;3900000;0
13935;155769;455;72;39;4;35;.897;3900000;0
13936;213957;457;13;5;4;1;.200;322000;0
13936;203478;457;35;30;6;24;.800;3278000;0
13936;172079;4337;40;33;6;27;.818;3600000;0
13936;198885;4337;0;0;0;0;.00nan;0;0
13937;2153;459;32;33;7;26;.788;3600000;0
13937;208716;2579;66;23;2;21;.913;3600000;0
13937;198903;2579;0;0;0;0;.00nan;0;0
13937;188429;459;0;0;0;0;.00nan;0;0
13938;208715;458;0;0;0;0;.00nan;0;0
13938;167492;458;41;31;5;26;.839;3547000;0
13938;168066;455;53;31;4;27;.871;3600000;0
13938;155769;455;0;0;0;0;.00nan;0;0
13939;168066;455;0;0;0;0;.00nan;0;0
13939;15558;456;0;0;0;0;.00nan;0;0
13939;92283;456;11;43;9;34;.791;3600000;0
13939;155769;455;74;29;3;26;.897;3600000;0
13940;172079;4337;47;21;4;17;.810;3600000;0
13940;208723;1086;58;10;0;10;1.000;1201000;0
13940;198885;4337;0;0;0;0;.00nan;0;0
13940;15564;1086;22;25;6;19;.760;2317000;0
13941;203478;457;0;0;0;0;.00nan;0;0
13941;208716;2579;53;10;1;9;.900;3600000;0
13941;198903;2579;0;0;0;0;.00nan;0;0
13941;-1;457;70;27;3;24;.889;3512000;0
13942;208715;458;41;8;2;6;.750;1342000;0
13942;167492;458;39;30;5;25;.833;2199000;0
13942;15558;456;36;24;5;19;.792;3600000;0
13942;92283;456;0;0;0;0;.00nan;0;0
13943;172079;4337;0;0;0;0;.00nan;0;0
13943;208723;1086;0;0;0;0;.00nan;0;0
13943;198885;4337;47;31;5;26;.839;3900000;0
13943;15564;1086;29;26;5;21;.808;3900000;0
13944;208715;458;26;21;6;15;.714;2737000;0
13944;167492;458;35;23;5;18;.783;888000;0
13944;168066;455;21;25;6;19;.760;2164000;0
13944;155769;455;16;19;6;13;.684;1461000;0
13945;2153;459;0;0;0;0;.00nan;0;0
13945;208715;458;0;0;0;0;.00nan;0;0
13945;167492;458;46;37;5;32;.865;3600000;0
13945;188429;459;66;24;2;22;.917;3600000;0
13946;203470;460;0;0;0;0;.00nan;0;0
13946;208723;1086;0;0;0;0;.00nan;0;0
13946;15564;1086;45;47;7;40;.851;3600000;0
13946;179373;460;8;36;10;26;.722;3600000;0
13947;203478;457;0;0;0;0;.00nan;0;0
13947;179652;452;58;38;4;34;.895;3600000;0
13947;202193;452;0;0;0;0;.00nan;0;0
13947;-1;457;55;35;5;30;.857;3549000;0
13948;2153;459;66;46;5;41;.891;3600000;0
13948;188429;459;0;0;0;0;.00nan;0;0
13948;15558;456;54;4;0;4;1.000;351000;0
13948;92283;456;22;24;6;18;.750;3217000;0
13949;208716;2579;0;0;0;0;.00nan;0;0
13949;198903;2579;34;34;6;28;.824;3600000;0
13949;168066;455;0;0;0;0;.00nan;0;0
13949;155769;455;39;20;4;16;.800;3600000;0
13950;208715;458;0;0;0;0;.00nan;0;0
13950;167492;458;80;32;1;31;.969;3600000;0
13950;15558;456;60;27;3;24;.889;3600000;0
13950;92283;456;0;0;0;0;.00nan;0;0
13951;203470;460;43;26;4;22;.846;3600000;0
13951;208723;1086;0;0;0;0;.00nan;0;0
13951;15564;1086;11;27;8;19;.704;3600000;0
13951;179373;460;0;0;0;0;.00nan;0;0
13952;208716;2579;57;36;4;32;.889;3600000;0
13952;198903;2579;0;0;0;0;.00nan;0;0
13952;168066;455;0;0;0;0;.00nan;0;0
13952;155769;455;57;25;3;22;.880;3600000;0
13953;208716;2579;85;44;3;41;.932;3600000;0
13953;198903;2579;0;0;0;0;.00nan;0;0
13953;179652;452;47;28;4;24;.857;3554000;0
13953;202193;452;0;0;0;0;.00nan;0;0
13954;168066;455;0;0;0;0;.00nan;0;0
13954;15558;456;57;7;0;7;1.000;549000;0
13954;92283;456;49;31;5;26;.839;3051000;0
13954;155769;455;69;37;3;34;.919;3600000;0
13955;15558;456;96;47;2;45;.957;3600000;0
13955;179652;452;0;0;0;0;.00nan;0;0
13955;202193;452;43;40;6;34;.850;3600000;0
13955;92283;456;0;0;0;0;.00nan;0;0
13956;2153;459;33;28;6;22;.786;3553000;0
13956;172079;4337;44;31;5;26;.839;3600000;0
13956;198885;4337;0;0;0;0;.00nan;0;0
13956;188429;459;0;0;0;0;.00nan;0;0
13957;203478;457;0;0;0;0;.00nan;0;0
13957;208723;1086;0;0;0;0;.00nan;0;0
13957;15564;1086;84;49;3;46;.939;3758000;0
13957;-1;457;58;20;2;18;.900;3758000;0
13958;208715;458;0;0;0;0;.00nan;0;0
13958;172079;4337;0;0;0;0;.00nan;0;0
13958;198885;4337;17;21;6;15;.714;3600000;0
13958;167492;458;71;35;4;31;.886;3600000;0
13959;203470;460;0;0;0;0;.00nan;0;0
13959;208723;1086;62;33;3;30;.909;3063000;0
13959;15564;1086;25;7;3;4;.571;537000;0
13959;179373;460;55;17;2;15;.882;3600000;0
13960;208716;2579;0;0;0;0;.00nan;0;0
13960;198903;2579;55;22;3;19;.864;3600000;0
13960;168066;455;43;28;5;23;.821;3584000;0
13960;155769;455;0;0;0;0;.00nan;0;0
13961;203470;460;0;0;0;0;.00nan;0;0
13961;179373;460;30;23;5;18;.783;3600000;0
13961;179652;452;12;21;7;14;.667;3171000;0
13961;202193;452;48;0;0;0;.00nan;413000;0
13962;208723;1086;0;0;0;0;.00nan;0;0
13962;15558;456;35;33;6;27;.818;3585000;0
13962;15564;1086;62;28;4;24;.857;3600000;0
13962;92283;456;0;0;0;0;.00nan;0;0
13963;203478;457;0;0;0;0;.00nan;0;0
13963;172079;4337;0;0;0;0;.00nan;0;0
13963;198885;4337;85;38;3;35;.921;3600000;0
13963;-1;457;62;30;4;26;.867;3552000;0
13964;208723;1086;69;10;0;10;1.000;1320000;0
13964;15564;1086;16;19;6;13;.684;2280000;0
13964;179652;452;32;4;2;2;.500;572000;0
13964;202193;452;12;17;6;11;.647;2957000;0
13965;2153;459;63;41;4;37;.902;3600000;0
13965;188429;459;0;0;0;0;.00nan;0;0
13965;168066;455;0;0;0;0;.00nan;0;0
13965;155769;455;33;23;5;18;.783;3545000;0
13966;208715;458;0;0;0;0;.00nan;0;0
13966;167492;458;71;23;2;21;.913;3600000;0
13966;168066;455;66;9;0;9;1.000;866000;0
13966;155769;455;12;20;6;14;.700;2734000;0
13967;203478;457;0;0;0;0;.00nan;0;0
13967;172079;4337;31;25;6;19;.760;3600000;0
13967;198885;4337;0;0;0;0;.00nan;0;0
13967;-1;457;24;36;8;28;.778;3600000;0
13968;203470;460;0;0;0;0;.00nan;0;0
13968;15558;456;0;0;0;0;.00nan;0;0
13968;179373;460;59;26;2;24;.923;3549000;0
13968;92283;456;97;20;0;20;1.000;3600000;0
13969;208715;458;0;0;0;0;.00nan;0;0
13969;172079;4337;0;0;0;0;.00nan;0;0
13969;198885;4337;36;20;4;16;.800;3578000;0
13969;167492;458;73;31;3;28;.903;3600000;0
13970;203470;460;0;0;0;0;.00nan;0;0
13970;168066;455;0;0;0;0;.00nan;0;0
13970;179373;460;63;33;3;30;.909;3598000;0
13970;155769;455;71;30;2;28;.933;3600000;0
13971;203478;457;0;0;0;0;.00nan;0;0
13971;179652;452;0;0;0;0;.00nan;0;0
13971;202193;452;31;33;7;26;.788;3809000;0
13971;-1;457;48;39;6;33;.846;3809000;0
13972;203478;457;0;0;0;0;.00nan;0;0
13972;208723;1086;0;0;0;0;.00nan;0;0
13972;15564;1086;71;25;2;23;.920;3553000;0
13972;-1;457;100;43;1;42;.977;3600000;0
13973;208716;2579;58;23;2;21;.913;3600000;0
13973;198903;2579;0;0;0;0;.00nan;0;0
13973;15558;456;0;0;0;0;.00nan;0;0
13973;92283;456;37;30;6;24;.800;3600000;0
13974;208716;2579;49;6;1;5;.833;889000;0
13974;198903;2579;14;30;7;23;.767;2711000;0
13974;15558;456;77;29;2;27;.931;3600000;0
13974;92283;456;0;0;0;0;.00nan;0;0
13976;213957;457;63;30;3;27;.900;3517000;0
13976;203470;460;0;0;0;0;.00nan;0;0
13976;203478;457;0;0;0;0;.00nan;0;0
13976;179373;460;74;25;1;24;.960;3600000;0
13978;208716;2579;0;0;0;0;.00nan;0;0
13978;172079;4337;34;16;4;12;.750;1053000;0
13978;198885;4337;37;25;5;20;.800;2547000;0
13978;198903;2579;70;37;3;34;.919;3600000;0
13980;208715;458;0;0;0;0;.00nan;0;0
13980;167492;458;63;24;2;22;.917;3600000;0
13980;168066;455;0;0;0;0;.00nan;0;0
13980;155769;455;64;38;4;34;.895;3600000;0
13982;208723;1086;0;0;0;0;.00nan;0;0
13982;15558;456;0;0;0;0;.00nan;0;0
13982;15564;1086;84;33;2;31;.939;3547000;0
13982;92283;456;75;22;1;21;.955;3600000;0
13984;2153;459;27;36;7;29;.806;2847000;0
13984;208725;452;0;0;0;0;.00nan;0;0
13984;188429;459;42;10;2;8;.800;753000;0
13984;179652;452;33;20;5;15;.750;3600000;0
13986;208715;458;60;6;0;6;1.000;504000;0
13986;167492;458;32;37;7;30;.811;3096000;0
13986;15558;456;0;0;0;0;.00nan;0;0
13986;92283;456;40;20;4;16;.800;3600000;0
13988;203470;460;0;0;0;0;.00nan;0;0
13988;208716;2579;53;23;3;20;.870;3600000;0
13988;198903;2579;0;0;0;0;.00nan;0;0
13988;179373;460;81;24;2;22;.917;3600000;0
13990;213957;457;0;0;0;0;.00nan;0;0
13990;203478;457;56;37;4;33;.892;3600000;0
13990;208723;1086;0;0;0;0;.00nan;0;0
13990;15564;1086;26;25;6;19;.760;3513000;0
13992;172079;4337;0;0;0;0;.00nan;0;0
13992;208725;452;67;18;1;17;.944;1393000;0
13992;198885;4337;46;27;4;23;.852;3600000;0
13992;179652;452;11;24;7;17;.708;2207000;0
13994;2153;459;0;0;0;0;.00nan;0;0
13994;188429;459;37;26;4;22;.846;3687000;0
13994;168066;455;0;0;0;0;.00nan;0;0
13994;155769;455;69;29;3;26;.897;3687000;0
13996;208723;1086;20;30;6;24;.800;2959000;0
13996;15558;456;21;24;6;18;.750;2041000;0
13996;15564;1086;53;2;0;2;1.000;641000;0
13996;92283;456;49;12;2;10;.833;1526000;0
13998;2153;459;50;28;5;23;.821;3900000;0
13998;213957;457;47;39;5;34;.872;3900000;0
13998;203478;457;0;0;0;0;.00nan;0;0
13998;188429;459;0;0;0;0;.00nan;0;0
14000;208715;458;55;17;2;15;.882;3600000;0
14000;208716;2579;0;0;0;0;.00nan;0;0
14000;198903;2579;43;19;3;16;.842;3584000;0
14000;167492;458;0;0;0;0;.00nan;0;0
14002;172079;4337;56;29;4;25;.862;3691000;0
14002;198885;4337;0;0;0;0;.00nan;0;0
14002;168066;455;76;35;3;32;.914;3691000;0
14002;155769;455;0;0;0;0;.00nan;0;0
14004;203470;460;64;44;5;39;.886;3600000;0
14004;208725;452;0;0;0;0;.00nan;0;0
14004;179373;460;0;0;0;0;.00nan;0;0
14004;179652;452;34;37;7;30;.811;3558000;0
14006;208716;2579;53;41;5;36;.878;3600000;0
14006;198903;2579;0;0;0;0;.00nan;0;0
14006;15558;456;76;25;2;23;.920;3600000;0
14006;92283;456;0;0;0;0;.00nan;0;0
14008;208715;458;0;0;0;0;.00nan;0;0
14008;208723;1086;0;0;0;0;.00nan;0;0
14008;167492;458;47;16;3;13;.813;3600000;0
14008;15564;1086;57;36;4;32;.889;3600000;0
14010;2153;459;0;0;0;0;.00nan;0;0
14010;203470;460;0;0;0;0;.00nan;0;0
14010;188429;459;66;20;1;19;.950;3600000;0
14010;179373;460;43;29;4;25;.862;3600000;0
14012;172079;4337;13;18;6;12;.667;2767000;0
14012;208725;452;0;0;0;0;.00nan;0;0
14012;198885;4337;10;12;5;7;.583;833000;0
14012;179652;452;53;32;4;28;.875;3600000;0
14014;213957;457;21;35;8;27;.771;3545000;0
14014;203478;457;0;0;0;0;.00nan;0;0
14014;168066;455;0;0;0;0;.00nan;0;0
14014;155769;455;26;41;7;34;.829;3600000;0
733;208715;458;0;0;0;0;.00nan;0;0
733;167492;458;87;40;3;37;.925;3600000;0
733;168066;455;0;0;0;0;.00nan;0;0
733;155769;455;39;37;6;31;.838;3600000;0
734;213957;457;0;0;0;0;.00nan;0;0
734;203478;457;40;26;5;21;.808;3600000;0
734;179652;452;56;4;0;4;1.000;779000;0
734;202193;452;23;24;6;18;.750;2821000;0
742;208715;458;0;0;0;0;.00nan;0;0
742;167492;458;28;25;5;20;.800;3600000;0
742;15558;456;0;0;0;0;.00nan;0;0
742;92283;456;77;33;2;31;.939;3600000;0
743;213957;457;0;0;0;0;.00nan;0;0
743;203478;457;70;36;3;33;.917;3600000;0
743;172079;4337;52;23;4;19;.826;3600000;0
743;198885;4337;0;0;0;0;.00nan;0;0
825;213957;457;55;10;1;9;.900;814000;0
825;203478;457;15;19;6;13;.684;2786000;0
825;15558;456;0;0;0;0;.00nan;0;0
825;92283;456;62;29;4;25;.862;3600000;0
14015;199481;4998;63;25;3;22;.880;3691000;0
14015;176938;4919;96;34;2;32;.941;3691000;0
14015;186573;4998;0;0;0;0;.00nan;0;0
14015;202788;4919;0;0;0;0;.00nan;0;0
14016;4487;4715;85;38;3;35;.921;3600000;0
14016;194625;165;0;0;0;0;.00nan;0;0
14016;200549;165;28;32;7;25;.781;3600000;0
14016;195283;4715;0;0;0;0;.00nan;0;0
14017;199481;4998;0;0;0;0;.00nan;0;0
14017;176938;4919;99;39;1;38;.974;3600000;0
14017;186573;4998;68;31;2;29;.935;3600000;0
14017;202788;4919;0;0;0;0;.00nan;0;0
14018;4487;4715;43;33;6;27;.818;3600000;0
14018;194625;165;53;24;3;21;.875;3600000;0
14018;200549;165;0;0;0;0;.00nan;0;0
14018;195283;4715;0;0;0;0;.00nan;0;0
14019;194899;1368;67;23;2;21;.913;3600000;0
14019;-1;4839;85;45;3;42;.933;3587000;0
14019;192457;1368;0;0;0;0;.00nan;0;0
14019;-1;4839;0;0;0;0;.00nan;0;0
14020;199481;4998;0;0;0;0;.00nan;0;0
14020;194625;165;63;27;3;24;.889;3600000;0
14020;200549;165;0;0;0;0;.00nan;0;0
14020;186573;4998;59;31;5;26;.839;3513000;0
14021;165532;4992;26;31;6;25;.806;3567000;0
14021;171615;4246;41;32;5;27;.844;3600000;0
14021;-1;4992;0;0;0;0;.00nan;0;0
14021;65125;4246;0;0;0;0;.00nan;0;0
14022;4487;4715;78;32;2;30;.938;3600000;0
14022;195283;4715;0;0;0;0;.00nan;0;0
14022;176938;4919;99;37;1;36;.973;3600000;0
14022;202788;4919;0;0;0;0;.00nan;0;0
14023;194899;1368;85;38;3;35;.921;3600000;0
14023;-1;4839;58;37;4;33;.892;3600000;0
14023;192457;1368;0;0;0;0;.00nan;0;0
14023;-1;4839;0;0;0;0;.00nan;0;0
14024;4487;4715;0;0;0;0;.00nan;0;0
14024;195283;4715;100;32;0;32;1.000;3600000;0
14024;176938;4919;0;0;0;0;.00nan;0;0
14024;202788;4919;51;27;4;23;.852;3600000;0
14025;199481;4998;0;0;0;0;.00nan;0;0
14025;194625;165;87;29;1;28;.966;3600000;0
14025;200549;165;0;0;0;0;.00nan;0;0
14025;186573;4998;78;39;3;36;.923;3511000;0
14026;165532;4992;99;38;1;37;.974;3600000;0
14026;171615;4246;89;36;2;34;.944;3600000;0
14026;-1;4992;0;0;0;0;.00nan;0;0
14026;65125;4246;0;0;0;0;.00nan;0;0
14027;199481;4998;0;0;0;0;.00nan;0;0
14027;176938;4919;73;35;4;31;.886;3835000;0
14027;186573;4998;57;30;3;27;.900;3835000;0
14027;202788;4919;0;0;0;0;.00nan;0;0
14028;189628;4991;54;24;3;21;.875;3600000;0
14028;179411;4991;0;0;0;0;.00nan;0;0
14028;187391;4714;0;0;0;0;.00nan;0;0
14028;-1;4714;65;40;4;36;.900;3590000;0
14029;199481;4998;95;30;1;29;.967;3600000;0
14029;176938;4919;47;11;2;9;.818;1379000;0
14029;186573;4998;0;0;0;0;.00nan;0;0
14029;202788;4919;48;25;4;21;.840;2221000;0
14030;171615;4246;92;36;2;34;.944;3600000;0
14030;-1;4839;54;25;4;21;.840;3572000;0
14030;-1;4839;0;0;0;0;.00nan;0;0
14030;65125;4246;0;0;0;0;.00nan;0;0
14031;188911;4997;68;34;3;31;.912;3600000;0
14031;194625;165;0;0;0;0;.00nan;0;0
14031;200549;165;29;31;6;25;.806;3600000;0
14031;197047;4997;0;0;0;0;.00nan;0;0
14032;165532;4992;69;24;2;22;.917;4200000;0
14032;194899;1368;0;0;0;0;.00nan;0;0
14032;-1;4992;0;0;0;0;.00nan;0;0
14032;192457;1368;60;28;2;26;.929;4200000;0
14033;189628;4991;38;31;6;25;.806;3600000;0
14033;179411;4991;0;0;0;0;.00nan;0;0
14033;187391;4714;0;0;0;0;.00nan;0;0
14033;-1;4714;95;44;2;42;.955;3600000;0
14034;165532;4992;0;0;0;0;.00nan;0;0
14034;194899;1368;37;42;7;35;.833;3758000;0
14034;-1;4992;51;38;6;32;.842;3758000;0
14034;192457;1368;0;0;0;0;.00nan;0;0
14035;188911;4997;0;0;0;0;.00nan;0;0
14035;194625;165;87;25;2;23;.920;3600000;0
14035;200549;165;0;0;0;0;.00nan;0;0
14035;197047;4997;51;39;5;34;.872;3600000;0
14036;171615;4246;0;0;0;0;.00nan;0;0
14036;-1;4839;0;0;0;0;.00nan;0;0
14036;-1;4839;40;24;4;20;.833;3600000;0
14036;65125;4246;86;35;2;33;.943;3600000;0
14037;4487;4715;0;0;0;0;.00nan;0;0
14037;199481;4998;43;5;1;4;.800;512000;0
14037;195283;4715;90;14;0;14;1.000;3600000;0
14037;186573;4998;39;31;6;25;.806;3088000;0
14038;189628;4991;0;0;0;0;.00nan;0;0
14038;179411;4991;89;28;1;27;.964;3600000;0
14038;187391;4714;28;30;6;24;.800;3600000;0
14038;-1;4714;0;0;0;0;.00nan;0;0
14039;194899;1368;0;0;0;0;.00nan;0;0
14039;176938;4919;42;36;6;30;.833;3600000;0
14039;192457;1368;91;29;1;28;.966;3600000;0
14039;202788;4919;0;0;0;0;.00nan;0;0
14040;165532;4992;69;29;2;27;.931;3714000;0
14040;188911;4997;0;0;0;0;.00nan;0;0
14040;-1;4992;0;0;0;0;.00nan;0;0
14040;197047;4997;71;23;1;22;.957;3713000;0
14041;4487;4715;56;37;5;32;.865;3600000;0
14041;194625;165;90;20;0;20;1.000;3600000;0
14041;200549;165;0;0;0;0;.00nan;0;0
14041;195283;4715;0;0;0;0;.00nan;0;0
14042;171615;4246;57;27;3;24;.889;4200000;0
14042;187391;4714;0;0;0;0;.00nan;0;0
14042;-1;4714;64;33;3;30;.909;4200000;0
14042;65125;4246;0;0;0;0;.00nan;0;0
14043;165532;4992;61;22;2;20;.909;3153000;0
14043;188911;4997;92;24;0;24;1.000;3600000;0
14043;-1;4992;34;10;3;7;.700;447000;0
14043;197047;4997;0;0;0;0;.00nan;0;0
14044;194899;1368;0;0;0;0;.00nan;0;0
14044;176938;4919;0;0;0;0;.00nan;0;0
14044;192457;1368;57;22;4;18;.818;3600000;0
14044;202788;4919;30;30;6;24;.800;3556000;0
14045;199481;4998;46;6;1;5;.833;1390000;0
14045;194625;165;59;22;2;20;.909;3600000;0
14045;200549;165;0;0;0;0;.00nan;0;0
14045;186573;4998;24;18;5;13;.722;2210000;0
14046;189628;4991;67;24;3;21;.875;3600000;0
14046;179411;4991;0;0;0;0;.00nan;0;0
14046;187391;4714;8;20;7;13;.650;3027000;0
14046;-1;4714;64;7;0;7;1.000;573000;0
14047;199481;4998;48;7;1;6;.857;1294000;0
14047;188911;4997;48;27;4;23;.852;3600000;0
14047;186573;4998;28;24;6;18;.750;2306000;0
14047;197047;4997;0;0;0;0;.00nan;0;0
14048;4487;4715;0;0;0;0;.00nan;0;0
14048;195283;4715;59;40;5;35;.875;3600000;0
14048;176938;4919;39;39;7;32;.821;3572000;0
14048;202788;4919;0;0;0;0;.00nan;0;0
14049;165532;4992;72;20;1;19;.950;3600000;0
14049;171615;4246;26;20;5;15;.750;1981000;0
14049;-1;4992;0;0;0;0;.00nan;0;0
14049;65125;4246;57;6;0;6;1.000;1619000;0
14050;194899;1368;0;0;0;0;.00nan;0;0
14050;-1;4839;14;16;5;11;.688;1089000;0
14050;192457;1368;49;13;2;11;.846;3600000;0
14050;-1;4839;75;30;2;28;.933;2511000;0
14051;189628;4991;0;0;0;0;.00nan;0;0
14051;179411;4991;74;25;2;23;.920;3600000;0
14051;187391;4714;46;5;1;4;.800;579000;0
14051;-1;4714;35;35;7;28;.800;3021000;0
14052;194899;1368;0;0;0;0;.00nan;0;0
14052;-1;4839;35;35;6;29;.829;2796000;0
14052;192457;1368;63;28;3;25;.893;3600000;0
14052;-1;4839;45;6;1;5;.833;804000;0
14053;194625;165;60;22;2;20;.909;3642000;0
14053;200549;165;0;0;0;0;.00nan;0;0
14053;176938;4919;0;0;0;0;.00nan;0;0
14053;202788;4919;70;29;3;26;.897;3642000;0
14054;199481;4998;0;0;0;0;.00nan;0;0
14054;188911;4997;0;0;0;0;.00nan;0;0
14054;186573;4998;59;35;5;30;.857;3600000;0
14054;197047;4997;9;21;7;14;.667;3572000;0
14055;165532;4992;0;0;0;0;.00nan;0;0
14055;171615;4246;58;31;4;27;.871;3548000;0
14055;-1;4992;79;25;2;23;.920;3600000;0
14055;65125;4246;0;0;0;0;.00nan;0;0
14056;199481;4998;0;0;0;0;.00nan;0;0
14056;176938;4919;60;29;4;25;.862;3600000;0
14056;186573;4998;50;41;5;36;.878;3587000;0
14056;202788;4919;0;0;0;0;.00nan;0;0
14057;4487;4715;81;29;2;27;.931;3600000;0
14057;194625;165;61;26;3;23;.885;3561000;0
14057;200549;165;0;0;0;0;.00nan;0;0
14057;195283;4715;0;0;0;0;.00nan;0;0
14058;189628;4991;85;18;0;18;1.000;3600000;0
14058;171615;4246;82;40;3;37;.925;3600000;0
14058;179411;4991;0;0;0;0;.00nan;0;0
14058;65125;4246;0;0;0;0;.00nan;0;0
14059;165532;4992;92;30;1;29;.967;3600000;0
14059;188911;4997;67;30;2;28;.933;3577000;0
14059;-1;4992;0;0;0;0;.00nan;0;0
14059;197047;4997;0;0;0;0;.00nan;0;0
14060;187391;4714;70;25;2;23;.920;3600000;0
14060;-1;4839;45;32;5;27;.844;3600000;0
14060;-1;4714;0;0;0;0;.00nan;0;0
14060;-1;4839;0;0;0;0;.00nan;0;0
14061;194625;165;0;0;0;0;.00nan;0;0
14061;200549;165;52;27;4;23;.852;3600000;0
14061;176938;4919;0;0;0;0;.00nan;0;0
14061;202788;4919;20;28;7;21;.750;3600000;0
14062;165532;4992;0;0;0;0;.00nan;0;0
14062;188911;4997;0;0;0;0;.00nan;0;0
14062;-1;4992;35;31;6;25;.806;3600000;0
14062;197047;4997;75;24;1;23;.958;3600000;0
14063;4487;4715;0;0;0;0;.00nan;0;0
14063;199481;4998;59;36;4;32;.889;3600000;0
14063;195283;4715;67;22;1;21;.955;3600000;0
14063;186573;4998;0;0;0;0;.00nan;0;0
14064;187391;4714;0;0;0;0;.00nan;0;0
14064;-1;4839;49;40;6;34;.850;3062000;0
14064;-1;4714;46;27;5;22;.815;3600000;0
14064;-1;4839;20;9;4;5;.556;538000;0
14065;189628;4991;69;40;5;35;.875;3552000;0
14065;171615;4246;0;0;0;0;.00nan;0;0
14065;179411;4991;0;0;0;0;.00nan;0;0
14065;65125;4246;71;35;3;32;.914;3600000;0
14066;199481;4998;0;0;0;0;.00nan;0;0
14066;194625;165;38;30;5;25;.833;3545000;0
14066;200549;165;0;0;0;0;.00nan;0;0
14066;186573;4998;67;38;4;34;.895;3600000;0
14067;4487;4715;92;31;1;30;.968;3600000;0
14067;194899;1368;0;0;0;0;.00nan;0;0
14067;195283;4715;0;0;0;0;.00nan;0;0
14067;192457;1368;53;37;5;32;.865;3600000;0
14068;171615;4246;81;26;1;25;.962;3600000;0
14068;187391;4714;59;33;4;29;.879;3600000;0
14068;-1;4714;0;0;0;0;.00nan;0;0
14068;65125;4246;0;0;0;0;.00nan;0;0
14069;194899;1368;0;0;0;0;.00nan;0;0
14069;176938;4919;46;30;5;25;.833;3600000;0
14069;192457;1368;20;28;7;21;.750;3600000;0
14069;202788;4919;0;0;0;0;.00nan;0;0
14070;199481;4998;0;0;0;0;.00nan;0;0
14070;194625;165;51;29;4;25;.862;3588000;0
14070;200549;165;0;0;0;0;.00nan;0;0
14070;186573;4998;74;40;3;37;.925;3600000;0
14071;188911;4997;58;40;5;35;.875;4200000;0
14071;189628;4991;0;0;0;0;.00nan;0;0
14071;179411;4991;38;23;5;18;.783;4200000;0
14071;197047;4997;0;0;0;0;.00nan;0;0
14072;171615;4246;83;37;3;34;.919;4200000;0
14072;-1;4839;71;33;3;30;.909;4200000;0
14072;-1;4839;0;0;0;0;.00nan;0;0
14072;65125;4246;0;0;0;0;.00nan;0;0
14073;165532;4992;55;27;3;24;.889;3600000;0
14073;187391;4714;67;21;2;19;.905;2512000;0
14073;-1;4992;0;0;0;0;.00nan;0;0
14073;-1;4714;26;12;4;8;.667;1088000;0
14074;188911;4997;55;30;4;26;.867;3600000;0
14074;189628;4991;10;25;7;18;.720;3227000;0
14074;179411;4991;33;4;2;2;.500;373000;0
14074;197047;4997;0;0;0;0;.00nan;0;0
14075;194899;1368;50;25;4;21;.840;3556000;0
14075;176938;4919;0;0;0;0;.00nan;0;0
14075;192457;1368;0;0;0;0;.00nan;0;0
14075;202788;4919;61;36;3;33;.917;3600000;0
14076;199481;4998;12;25;7;18;.720;3085000;0
14076;194625;165;0;0;0;0;.00nan;0;0
14076;200549;165;39;19;4;15;.789;3600000;0
14076;186573;4998;47;6;1;5;.833;515000;0
14077;165532;4992;0;0;0;0;.00nan;0;0
14077;187391;4714;0;0;0;0;.00nan;0;0
14077;-1;4992;33;17;4;13;.765;3600000;0
14077;-1;4714;47;28;5;23;.821;3548000;0
14078;171615;4246;0;0;0;0;.00nan;0;0
14078;-1;4839;0;0;0;0;.00nan;0;0
14078;-1;4839;91;21;0;21;1.000;3600000;0
14078;65125;4246;61;27;2;25;.926;3534000;0
14079;199481;4998;59;8;0;8;1.000;336000;0
14079;176938;4919;52;18;3;15;.833;3600000;0
14079;186573;4998;33;36;7;29;.806;3264000;0
14079;202788;4919;0;0;0;0;.00nan;0;0
14080;165532;4992;44;28;4;24;.857;3563000;0
14080;189628;4991;85;40;3;37;.925;3600000;0
14080;179411;4991;0;0;0;0;.00nan;0;0
14080;-1;4992;0;0;0;0;.00nan;0;0
14081;194625;165;27;5;3;2;.400;555000;0
14081;200549;165;56;24;3;21;.875;3037000;0
14081;194899;1368;44;31;5;26;.839;3600000;0
14081;192457;1368;0;0;0;0;.00nan;0;0
14082;188911;4997;29;23;5;18;.783;3644000;0
14082;-1;4839;66;34;4;30;.882;3644000;0
14082;197047;4997;0;0;0;0;.00nan;0;0
14082;-1;4839;0;0;0;0;.00nan;0;0
14083;171615;4246;44;30;5;25;.833;3658000;0
14083;187391;4714;69;41;4;37;.902;3658000;0
14083;-1;4714;0;0;0;0;.00nan;0;0
14083;65125;4246;0;0;0;0;.00nan;0;0
14084;188911;4997;0;0;0;0;.00nan;0;0
14084;-1;4839;0;0;0;0;.00nan;0;0
14084;197047;4997;48;21;3;18;.857;3773000;0
14084;-1;4839;91;36;2;34;.944;3773000;0
14085;4487;4715;67;28;3;25;.893;3600000;0
14085;195283;4715;0;0;0;0;.00nan;0;0
14085;176938;4919;0;0;0;0;.00nan;0;0
14085;202788;4919;69;37;4;33;.892;3571000;0
14086;165532;4992;0;0;0;0;.00nan;0;0
14086;189628;4991;0;0;0;0;.00nan;0;0
14086;179411;4991;55;34;4;30;.882;3582000;0
14086;-1;4992;64;23;2;21;.913;3600000;0
14087;194625;165;64;31;3;28;.903;3600000;0
14087;200549;165;0;0;0;0;.00nan;0;0
14087;194899;1368;0;0;0;0;.00nan;0;0
14087;192457;1368;52;28;4;24;.857;3551000;0
14088;171615;4246;0;0;0;0;.00nan;0;0
14088;187391;4714;0;0;0;0;.00nan;0;0
14088;-1;4714;63;29;3;26;.897;3600000;0
14088;65125;4246;69;28;4;24;.857;3563000;0
14089;188911;4997;68;13;1;12;.923;3600000;0
14089;-1;4839;36;39;6;33;.846;3600000;0
14089;197047;4997;0;0;0;0;.00nan;0;0
14089;-1;4839;0;0;0;0;.00nan;0;0
14090;4487;4715;0;0;0;0;.00nan;0;0
14090;194899;1368;39;34;5;29;.853;3600000;0
14090;195283;4715;69;16;1;15;.938;3600000;0
14090;192457;1368;0;0;0;0;.00nan;0;0
14091;194899;1368;0;0;0;0;.00nan;0;0
14091;-1;4839;0;0;0;0;.00nan;0;0
14091;192457;1368;37;18;4;14;.778;3600000;0
14091;-1;4839;41;37;6;31;.838;3600000;0
14092;4487;4715;66;34;4;30;.882;3545000;0
14092;195283;4715;0;0;0;0;.00nan;0;0
14092;176938;4919;84;35;2;33;.943;3600000;0
14092;202788;4919;0;0;0;0;.00nan;0;0
14093;189628;4991;67;30;3;27;.900;3670000;0
14093;171615;4246;74;40;4;36;.900;3670000;0
14093;179411;4991;0;0;0;0;.00nan;0;0
14093;65125;4246;0;0;0;0;.00nan;0;0
14094;199481;4998;0;0;0;0;.00nan;0;0
14094;188911;4997;40;35;5;30;.857;3600000;0
14094;186573;4998;61;24;2;22;.917;3600000;0
14094;197047;4997;0;0;0;0;.00nan;0;0
14095;165532;4992;64;38;5;33;.868;3600000;0
14095;187391;4714;66;26;2;24;.923;3600000;0
14095;-1;4992;0;0;0;0;.00nan;0;0
14095;-1;4714;0;0;0;0;.00nan;0;0
14096;199481;4998;27;25;5;20;.800;2258000;0
14096;188911;4997;0;0;0;0;.00nan;0;0
14096;186573;4998;39;11;2;9;.818;1342000;0
14096;197047;4997;55;23;3;20;.870;3600000;0
14097;194899;1368;42;20;4;16;.800;3600000;0
14097;-1;4839;26;29;6;23;.793;2596000;0
14097;192457;1368;0;0;0;0;.00nan;0;0
14097;-1;4839;65;9;0;9;1.000;942000;0
14098;189628;4991;0;0;0;0;.00nan;0;0
14098;171615;4246;0;0;0;0;.00nan;0;0
14098;179411;4991;48;23;4;19;.826;3600000;0
14098;65125;4246;54;48;6;42;.875;3600000;0
14099;4487;4715;0;0;0;0;.00nan;0;0
14099;194625;165;27;19;5;14;.737;3600000;0
14099;200549;165;0;0;0;0;.00nan;0;0
14099;195283;4715;87;28;1;27;.964;3600000;0
14100;165532;4992;0;0;0;0;.00nan;0;0
14100;187391;4714;0;0;0;0;.00nan;0;0
14100;-1;4992;38;31;6;25;.806;3600000;0
14100;-1;4714;100;29;0;29;1.000;3600000;0
14101;171615;4246;47;44;6;38;.864;3583000;0
14101;187391;4714;0;0;0;0;.00nan;0;0
14101;-1;4714;33;25;5;20;.800;3600000;0
14101;65125;4246;0;0;0;0;.00nan;0;0
14102;199481;4998;0;0;0;0;.00nan;0;0
14102;194625;165;37;18;4;14;.778;3600000;0
14102;200549;165;0;0;0;0;.00nan;0;0
14102;186573;4998;64;44;5;39;.886;3546000;0
14103;4487;4715;47;30;5;25;.833;3600000;0
14103;195283;4715;0;0;0;0;.00nan;0;0
14103;176938;4919;0;0;0;0;.00nan;0;0
14103;202788;4919;77;34;2;32;.941;3600000;0
14104;188911;4997;57;31;4;27;.871;3591000;0
14104;194899;1368;0;0;0;0;.00nan;0;0
14104;197047;4997;0;0;0;0;.00nan;0;0
14104;192457;1368;64;30;3;27;.900;3600000;0
14105;189628;4991;85;23;1;22;.957;3600000;0
14105;171615;4246;0;0;0;0;.00nan;0;0
14105;179411;4991;0;0;0;0;.00nan;0;0
14105;65125;4246;53;28;5;23;.821;3600000;0
14106;165532;4992;63;35;4;31;.886;3600000;0
14106;187391;4714;100;35;0;35;1.000;3600000;0
14106;-1;4992;0;0;0;0;.00nan;0;0
14106;-1;4714;0;0;0;0;.00nan;0;0
14107;188911;4997;0;0;0;0;.00nan;0;0
14107;-1;4839;0;0;0;0;.00nan;0;0
14107;197047;4997;45;24;4;20;.833;3550000;0
14107;-1;4839;76;32;3;29;.906;3600000;0
14108;194625;165;0;0;0;0;.00nan;0;0
14108;200549;165;45;37;6;31;.838;3577000;0
14108;176938;4919;61;34;4;30;.882;3600000;0
14108;202788;4919;0;0;0;0;.00nan;0;0
14109;4487;4715;0;0;0;0;.00nan;0;0
14109;199481;4998;35;13;3;10;.769;439000;0
14109;195283;4715;87;25;1;24;.960;3600000;0
14109;186573;4998;36;27;5;22;.815;3161000;0
14110;165532;4992;73;27;1;26;.963;3600000;0
14110;189628;4991;0;0;0;0;.00nan;0;0
14110;179411;4991;72;38;3;35;.921;3600000;0
14110;-1;4992;0;0;0;0;.00nan;0;0
14111;171615;4246;73;41;4;37;.902;3600000;0
14111;187391;4714;34;27;5;22;.815;3546000;0
14111;-1;4714;0;0;0;0;.00nan;0;0
14111;65125;4246;0;0;0;0;.00nan;0;0
14112;4487;4715;69;39;5;34;.872;3600000;0
14112;199481;4998;45;28;4;24;.857;3340000;0
14112;195283;4715;0;0;0;0;.00nan;0;0
14112;186573;4998;23;4;3;1;.250;260000;0
14113;165532;4992;72;34;3;31;.912;3571000;0
14113;188911;4997;65;17;1;16;.941;3600000;0
14113;-1;4992;0;0;0;0;.00nan;0;0
14113;197047;4997;0;0;0;0;.00nan;0;0
14114;194625;165;74;28;2;26;.929;3600000;0
14114;200549;165;0;0;0;0;.00nan;0;0
14114;-1;4839;72;40;4;36;.900;3521000;0
14114;-1;4839;0;0;0;0;.00nan;0;0
14115;194899;1368;0;0;0;0;.00nan;0;0
14115;176938;4919;24;33;7;26;.788;3600000;0
14115;192457;1368;76;32;3;29;.906;3600000;0
14115;202788;4919;0;0;0;0;.00nan;0;0
14116;188911;4997;0;0;0;0;.00nan;0;0
14116;189628;4991;55;26;4;22;.846;3600000;0
14116;179411;4991;0;0;0;0;.00nan;0;0
14116;197047;4997;36;44;7;37;.841;3600000;0
14117;194899;1368;96;44;2;42;.955;3600000;0
14117;176938;4919;59;9;1;8;.889;1762000;0
14117;192457;1368;0;0;0;0;.00nan;0;0
14117;202788;4919;22;11;4;7;.636;1838000;0
14118;194625;165;0;0;0;0;.00nan;0;0
14118;200549;165;49;33;5;28;.848;3549000;0
14118;-1;4839;0;0;0;0;.00nan;0;0
14118;-1;4839;46;24;4;20;.833;3600000;0
14119;4487;4715;0;0;0;0;.00nan;0;0
14119;199481;4998;0;0;0;0;.00nan;0;0
14119;195283;4715;42;25;5;20;.800;3600000;0
14119;186573;4998;36;36;6;30;.833;3600000;0
14120;171615;4246;81;28;1;27;.964;3600000;0
14120;187391;4714;56;33;4;29;.879;3600000;0
14120;-1;4714;0;0;0;0;.00nan;0;0
14120;65125;4246;0;0;0;0;.00nan;0;0
14121;194899;1368;37;31;6;25;.806;3600000;0
14121;-1;4839;59;27;3;24;.889;3600000;0
14121;192457;1368;0;0;0;0;.00nan;0;0
14121;-1;4839;0;0;0;0;.00nan;0;0
14122;199481;4998;0;0;0;0;.00nan;0;0
14122;176938;4919;81;33;2;31;.939;3600000;0
14122;186573;4998;46;41;5;36;.878;3600000;0
14122;202788;4919;0;0;0;0;.00nan;0;0
14123;4487;4715;58;29;4;25;.862;3600000;0
14123;194625;165;48;27;5;22;.815;3547000;0
14123;200549;165;0;0;0;0;.00nan;0;0
14123;195283;4715;0;0;0;0;.00nan;0;0
14124;188911;4997;54;35;5;30;.857;3600000;0
14124;189628;4991;54;18;2;16;.889;3600000;0
14124;179411;4991;0;0;0;0;.00nan;0;0
14124;197047;4997;0;0;0;0;.00nan;0;0
14125;171615;4246;54;24;3;21;.875;3566000;0
14125;187391;4714;71;28;2;26;.929;3600000;0
14125;-1;4714;0;0;0;0;.00nan;0;0
14125;65125;4246;0;0;0;0;.00nan;0;0
14126;188911;4997;0;0;0;0;.00nan;0;0
14126;189628;4991;0;0;0;0;.00nan;0;0
14126;179411;4991;75;25;1;24;.960;3600000;0
14126;197047;4997;54;25;3;22;.880;3600000;0
14127;199481;4998;24;26;6;20;.769;2590000;0
14127;194625;165;0;0;0;0;.00nan;0;0
14127;200549;165;93;42;3;39;.929;3600000;0
14127;186573;4998;40;9;2;7;.778;1010000;0
14128;194899;1368;0;0;0;0;.00nan;0;0
14128;-1;4839;0;0;0;0;.00nan;0;0
14128;192457;1368;61;24;3;21;.875;3600000;0
14128;-1;4839;59;32;4;28;.875;3566000;0
14129;4487;4715;0;0;0;0;.00nan;0;0
14129;195283;4715;65;36;4;32;.889;3600000;0
14129;176938;4919;0;0;0;0;.00nan;0;0
14129;202788;4919;77;25;1;24;.960;3600000;0
14130;171615;4246;0;0;0;0;.00nan;0;0
14130;187391;4714;52;19;3;16;.842;3962000;0
14130;-1;4714;0;0;0;0;.00nan;0;0
14130;65125;4246;63;32;4;28;.875;3962000;0
14131;194899;1368;56;26;3;23;.885;3600000;0
14131;-1;4839;26;5;3;2;.400;501000;0
14131;192457;1368;0;0;0;0;.00nan;0;0
14131;-1;4839;54;26;3;23;.885;3099000;0
14132;188911;4997;42;23;4;19;.826;3600000;0
14132;189628;4991;70;25;2;23;.920;3600000;0
14132;179411;4991;0;0;0;0;.00nan;0;0
14132;197047;4997;0;0;0;0;.00nan;0;0
14133;199481;4998;0;0;0;0;.00nan;0;0
14133;194625;165;60;33;4;29;.879;3600000;0
14133;200549;165;0;0;0;0;.00nan;0;0
14133;186573;4998;60;28;3;25;.893;3600000;0
14134;4487;4715;74;30;3;27;.900;3592000;0
14134;195283;4715;0;0;0;0;.00nan;0;0
14134;176938;4919;96;29;1;28;.966;3600000;0
14134;202788;4919;0;0;0;0;.00nan;0;0
14135;171615;4246;31;28;6;22;.786;3141000;0
14135;-1;4839;47;31;4;27;.871;3600000;0
14135;-1;4839;0;0;0;0;.00nan;0;0
14135;65125;4246;57;6;0;6;1.000;394000;0
14136;171615;4246;0;0;0;0;.00nan;0;0
14136;-1;4839;0;0;0;0;.00nan;0;0
14136;-1;4839;61;32;4;28;.875;3600000;0
14136;65125;4246;65;17;1;16;.941;3600000;0
14137;194625;165;46;30;5;25;.833;3600000;0
14137;200549;165;0;0;0;0;.00nan;0;0
14137;176938;4919;78;29;2;27;.931;3600000;0
14137;202788;4919;0;0;0;0;.00nan;0;0
14138;4487;4715;100;23;0;23;1.000;3600000;0
14138;194899;1368;0;0;0;0;.00nan;0;0
14138;195283;4715;0;0;0;0;.00nan;0;0
14138;192457;1368;69;39;4;35;.897;3600000;0
14139;165532;4992;58;31;4;27;.871;3584000;0
14139;189628;4991;78;29;2;27;.931;3600000;0
14139;179411;4991;0;0;0;0;.00nan;0;0
14139;-1;4992;0;0;0;0;.00nan;0;0
14140;188911;4997;36;26;5;21;.808;3564000;0
14140;-1;4839;85;46;3;43;.935;3600000;0
14140;197047;4997;0;0;0;0;.00nan;0;0
14140;-1;4839;0;0;0;0;.00nan;0;0
14141;171615;4246;92;31;1;30;.968;4200000;0
14141;187391;4714;100;48;1;47;.979;4200000;0
14141;-1;4714;0;0;0;0;.00nan;0;0
14141;65125;4246;0;0;0;0;.00nan;0;0
14142;188911;4997;0;0;0;0;.00nan;0;0
14142;-1;4839;0;0;0;0;.00nan;0;0
14142;197047;4997;84;25;1;24;.960;3600000;0
14142;-1;4839;95;43;2;41;.953;3600000;0
14143;199481;4998;68;22;1;21;.955;3600000;0
14143;194899;1368;76;29;3;26;.897;3600000;0
14143;186573;4998;0;0;0;0;.00nan;0;0
14143;192457;1368;0;0;0;0;.00nan;0;0
14144;165532;4992;0;0;0;0;.00nan;0;0
14144;189628;4991;0;0;0;0;.00nan;0;0
14144;179411;4991;64;21;2;19;.905;3600000;0
14144;-1;4992;72;36;3;33;.917;3583000;0
14145;4487;4715;76;31;2;29;.935;3600000;0
14145;194625;165;62;29;3;26;.897;3600000;0
14145;200549;165;0;0;0;0;.00nan;0;0
14145;195283;4715;0;0;0;0;.00nan;0;0
14146;171615;4246;0;0;0;0;.00nan;0;0
14146;187391;4714;47;33;5;28;.848;3600000;0
14146;-1;4714;0;0;0;0;.00nan;0;0
14146;65125;4246;100;43;1;42;.977;3600000;0
14147;165532;4992;78;43;3;40;.930;3588000;0
14147;171615;4246;74;23;1;22;.957;3600000;0
14147;-1;4992;0;0;0;0;.00nan;0;0
14147;65125;4246;0;0;0;0;.00nan;0;0
14148;165532;4992;39;29;5;24;.828;3572000;0
14148;188911;4997;0;0;0;0;.00nan;0;0
14148;-1;4992;0;0;0;0;.00nan;0;0
14148;197047;4997;66;29;3;26;.897;3600000;0
14149;4487;4715;56;30;4;26;.867;4037000;0
14149;195283;4715;0;0;0;0;.00nan;0;0
14149;-1;4839;0;0;0;0;.00nan;0;0
14149;-1;4839;63;36;3;33;.917;4037000;0
14150;199481;4998;0;0;0;0;.00nan;0;0
14150;194625;165;0;0;0;0;.00nan;0;0
14150;200549;165;74;22;2;20;.909;3600000;0
14150;186573;4998;41;42;6;36;.857;3600000;0
14151;165532;4992;0;0;0;0;.00nan;0;0
14151;194899;1368;60;26;3;23;.885;3049000;0
14151;-1;4992;78;33;2;31;.939;3600000;0
14151;192457;1368;26;6;3;3;.500;551000;0
14152;189628;4991;53;18;2;16;.889;3600000;0
14152;179411;4991;0;0;0;0;.00nan;0;0
14152;176938;4919;75;37;3;34;.919;3600000;0
14152;202788;4919;0;0;0;0;.00nan;0;0
14153;171615;4246;0;0;0;0;.00nan;0;0
14153;187391;4714;0;0;0;0;.00nan;0;0
14153;-1;4714;78;23;1;22;.957;3600000;0
14153;65125;4246;83;33;2;31;.939;3574000;0
14154;4487;4715;0;0;0;0;.00nan;0;0
14154;195283;4715;50;28;4;24;.857;3600000;0
14154;-1;4839;56;39;6;33;.846;3563000;0
14154;-1;4839;0;0;0;0;.00nan;0;0
14155;199481;4998;78;33;3;30;.909;3600000;0
14155;194625;165;62;32;4;28;.875;3600000;0
14155;200549;165;0;0;0;0;.00nan;0;0
14155;186573;4998;0;0;0;0;.00nan;0;0
14156;165532;4992;92;38;1;37;.974;3600000;0
14156;194899;1368;0;0;0;0;.00nan;0;0
14156;-1;4992;0;0;0;0;.00nan;0;0
14156;192457;1368;59;25;3;22;.880;3527000;0
14157;189628;4991;0;0;0;0;.00nan;0;0
14157;179411;4991;70;31;3;28;.903;3600000;0
14157;176938;4919;26;25;6;19;.760;2316000;0
14157;202788;4919;18;14;6;8;.571;1284000;0
14158;171615;4246;10;23;7;16;.696;3354000;0
14158;187391;4714;68;44;5;39;.886;3600000;0
14158;-1;4714;0;0;0;0;.00nan;0;0
14158;65125;4246;41;2;1;1;.500;246000;0
14159;4487;4715;62;25;3;22;.880;3600000;0
14159;195283;4715;0;0;0;0;.00nan;0;0
14159;-1;4839;0;0;0;0;.00nan;0;0
14159;-1;4839;68;43;4;39;.907;3575000;0
14160;199481;4998;0;0;0;0;.00nan;0;0
14160;194625;165;61;32;4;28;.875;3748000;0
14160;200549;165;0;0;0;0;.00nan;0;0
14160;186573;4998;42;36;5;31;.861;3748000;0
14161;4487;4715;37;27;5;22;.815;3600000;0
14161;195283;4715;0;0;0;0;.00nan;0;0
14161;176938;4919;77;28;2;26;.929;3600000;0
14161;202788;4919;0;0;0;0;.00nan;0;0
14162;165532;4992;56;34;4;30;.882;3600000;0
14162;189628;4991;81;24;1;23;.958;3600000;0
14162;179411;4991;0;0;0;0;.00nan;0;0
14162;-1;4992;0;0;0;0;.00nan;0;0
14163;194899;1368;40;25;4;21;.840;3990000;0
14163;-1;4839;0;0;0;0;.00nan;0;0
14163;192457;1368;0;0;0;0;.00nan;0;0
14163;-1;4839;71;37;3;34;.919;3997000;0
14164;188911;4997;83;33;2;31;.939;3600000;0
14164;171615;4246;49;38;5;33;.868;3435000;0
14164;197047;4997;0;0;0;0;.00nan;0;0
14164;65125;4246;22;4;3;1;.250;165000;0
14165;188911;4997;0;0;0;0;.00nan;0;0
14165;171615;4246;0;0;0;0;.00nan;0;0
14165;197047;4997;93;38;2;36;.947;4200000;0
14165;65125;4246;80;32;2;30;.938;4200000;0
14166;165532;4992;0;0;0;0;.00nan;0;0
14166;189628;4991;0;0;0;0;.00nan;0;0
14166;179411;4991;33;20;4;16;.800;3574000;0
14166;-1;4992;80;29;2;27;.931;3600000;0
14167;199481;4998;83;43;4;39;.907;3600000;0
14167;194625;165;41;27;5;22;.815;3545000;0
14167;200549;165;0;0;0;0;.00nan;0;0
14167;186573;4998;0;0;0;0;.00nan;0;0
14168;4487;4715;0;0;0;0;.00nan;0;0
14168;195283;4715;92;43;3;40;.930;3600000;0
14168;176938;4919;0;0;0;0;.00nan;0;0
14168;202788;4919;47;30;4;26;.867;3577000;0
14169;194899;1368;47;31;4;27;.871;3571000;0
14169;-1;4839;70;29;2;27;.931;3600000;0
14169;192457;1368;0;0;0;0;.00nan;0;0
14169;-1;4839;0;0;0;0;.00nan;0;0
14170;176938;4919;62;30;3;27;.900;3600000;0
14170;-1;4839;0;0;0;0;.00nan;0;0
14170;202788;4919;0;0;0;0;.00nan;0;0
14170;-1;4839;59;37;4;33;.892;3593000;0
14171;176938;4919;0;0;0;0;.00nan;0;0
14171;-1;4839;58;37;4;33;.892;3600000;0
14171;202788;4919;32;25;5;20;.800;3598000;0
14171;-1;4839;0;0;0;0;.00nan;0;0
14172;4487;4715;42;28;5;23;.821;3563000;0
14172;199481;4998;0;0;0;0;.00nan;0;0
14172;195283;4715;0;0;0;0;.00nan;0;0
14172;186573;4998;73;36;4;32;.889;3600000;0
14173;165532;4992;78;34;3;31;.912;3600000;0
14173;194899;1368;24;24;6;18;.750;3600000;0
14173;-1;4992;0;0;0;0;.00nan;0;0
14173;192457;1368;0;0;0;0;.00nan;0;0
14174;189628;4991;95;38;1;37;.974;3600000;0
14174;179411;4991;0;0;0;0;.00nan;0;0
14174;187391;4714;40;24;4;20;.833;3600000;0
14174;-1;4714;0;0;0;0;.00nan;0;0
14175;188911;4997;35;22;5;17;.773;3567000;0
14175;171615;4246;66;29;3;26;.897;3600000;0
14175;197047;4997;0;0;0;0;.00nan;0;0
14175;65125;4246;0;0;0;0;.00nan;0;0
14176;165532;4992;0;0;0;0;.00nan;0;0
14176;194899;1368;68;29;3;26;.897;3600000;0
14176;-1;4992;53;15;2;13;.867;3600000;0
14176;192457;1368;0;0;0;0;.00nan;0;0
14177;4487;4715;0;0;0;0;.00nan;0;0
14177;194625;165;0;0;0;0;.00nan;0;0
14177;200549;165;51;25;4;21;.840;3550000;0
14177;195283;4715;74;32;2;30;.938;3600000;0
14178;199481;4998;69;24;3;21;.875;3600000;0
14178;176938;4919;52;39;5;34;.872;3517000;0
14178;186573;4998;0;0;0;0;.00nan;0;0
14178;202788;4919;0;0;0;0;.00nan;0;0
14179;189628;4991;0;0;0;0;.00nan;0;0
14179;179411;4991;63;28;3;25;.893;3571000;0
14179;187391;4714;0;0;0;0;.00nan;0;0
14179;-1;4714;71;29;2;27;.931;3600000;0
14180;188911;4997;64;10;0;10;1.000;1210000;0
14180;171615;4246;0;0;0;0;.00nan;0;0
14180;197047;4997;25;22;5;17;.773;2390000;0
14180;65125;4246;75;31;2;29;.935;3600000;0
14181;165532;4992;39;21;4;17;.810;3572000;0
14181;194899;1368;58;27;3;24;.889;3600000;0
14181;-1;4992;0;0;0;0;.00nan;0;0
14181;192457;1368;0;0;0;0;.00nan;0;0
14182;199481;4998;0;0;0;0;.00nan;0;0
14182;194899;1368;0;0;0;0;.00nan;0;0
14182;186573;4998;52;32;4;28;.875;3562000;0
14182;192457;1368;81;33;3;30;.909;3600000;0
14183;176938;4919;5;21;7;14;.667;2770000;0
14183;-1;4839;0;0;0;0;.00nan;0;0
14183;202788;4919;40;2;1;1;.500;830000;0
14183;-1;4839;68;24;2;22;.917;3600000;0
14184;165532;4992;32;28;5;23;.821;3600000;0
14184;187391;4714;28;25;6;19;.760;3282000;0
14184;-1;4992;0;0;0;0;.00nan;0;0
14184;-1;4714;53;3;0;3;1.000;313000;0
14185;188911;4997;36;20;4;16;.800;3542000;0
14185;194625;165;67;33;3;30;.909;3600000;0
14185;200549;165;0;0;0;0;.00nan;0;0
14185;197047;4997;0;0;0;0;.00nan;0;0
14186;189628;4991;58;35;5;30;.857;3971000;0
14186;171615;4246;77;37;4;33;.892;3971000;0
14186;179411;4991;0;0;0;0;.00nan;0;0
14186;65125;4246;0;0;0;0;.00nan;0;0
14187;188911;4997;66;8;0;8;1.000;576000;0
14187;194625;165;0;0;0;0;.00nan;0;0
14187;200549;165;62;31;3;28;.903;3600000;0
14187;197047;4997;29;34;7;27;.794;3024000;0
14188;165532;4992;0;0;0;0;.00nan;0;0
14188;187391;4714;0;0;0;0;.00nan;0;0
14188;-1;4992;53;22;3;19;.864;3600000;0
14188;-1;4714;54;28;4;24;.857;3583000;0
14189;176938;4919;62;27;4;23;.852;3560000;0
14189;-1;4839;65;30;2;28;.933;3600000;0
14189;202788;4919;0;0;0;0;.00nan;0;0
14189;-1;4839;0;0;0;0;.00nan;0;0
14190;189628;4991;74;16;1;15;.938;3600000;0
14190;171615;4246;49;7;1;6;.857;1289000;0
14190;179411;4991;0;0;0;0;.00nan;0;0
14190;65125;4246;27;34;7;27;.794;2311000;0
14191;4487;4715;78;42;4;38;.905;3600000;0
14191;194899;1368;0;0;0;0;.00nan;0;0
14191;195283;4715;0;0;0;0;.00nan;0;0
14191;192457;1368;64;39;5;34;.872;3600000;0
14192;165532;4992;43;31;5;26;.839;3569000;0
14192;187391;4714;80;37;3;34;.919;3600000;0
14192;-1;4992;0;0;0;0;.00nan;0;0
14192;-1;4714;0;0;0;0;.00nan;0;0
14193;4487;4715;0;0;0;0;.00nan;0;0
14193;194899;1368;0;0;0;0;.00nan;0;0
14193;195283;4715;49;26;4;22;.846;3608000;0
14193;192457;1368;45;29;5;24;.828;3608000;0
14194;188911;4997;70;30;2;28;.933;3600000;0
14194;189628;4991;0;0;0;0;.00nan;0;0
14194;179411;4991;75;40;3;37;.925;3552000;0
14194;197047;4997;0;0;0;0;.00nan;0;0
14195;194625;165;100;25;0;25;1.000;3600000;0
14195;200549;165;0;0;0;0;.00nan;0;0
14195;176938;4919;36;25;5;20;.800;3600000;0
14195;202788;4919;0;0;0;0;.00nan;0;0
14196;4487;4715;55;32;5;27;.844;3600000;0
14196;195283;4715;0;0;0;0;.00nan;0;0
14196;-1;4839;0;0;0;0;.00nan;0;0
14196;-1;4839;93;38;2;36;.947;3600000;0
14197;189628;4991;71;31;2;29;.935;3817000;0
14197;179411;4991;0;0;0;0;.00nan;0;0
14197;187391;4714;90;37;1;36;.973;3817000;0
14197;-1;4714;0;0;0;0;.00nan;0;0
14198;199481;4998;0;0;0;0;.00nan;0;0
14198;194899;1368;0;0;0;0;.00nan;0;0
14198;186573;4998;78;34;3;31;.912;4200000;0
14198;192457;1368;66;29;3;26;.897;4200000;0
14199;199481;4998;0;0;0;0;.00nan;0;0
14199;194899;1368;99;28;1;27;.964;3600000;0
14199;186573;4998;66;31;3;28;.903;3565000;0
14199;192457;1368;0;0;0;0;.00nan;0;0
14200;4487;4715;0;0;0;0;.00nan;0;0
14200;195283;4715;63;28;3;25;.893;4200000;0
14200;-1;4839;68;42;3;39;.929;4200000;0
14200;-1;4839;0;0;0;0;.00nan;0;0
14201;194625;165;19;10;4;6;.600;1030000;0
14201;200549;165;54;17;1;16;.941;3160000;0
14201;176938;4919;72;41;5;36;.878;4200000;0
14201;202788;4919;0;0;0;0;.00nan;0;0
14202;165532;4992;50;39;6;33;.846;3600000;0
14202;188911;4997;76;29;1;28;.966;3600000;0
14202;-1;4992;0;0;0;0;.00nan;0;0
14202;197047;4997;0;0;0;0;.00nan;0;0
14203;189628;4991;0;0;0;0;.00nan;0;0
14203;171615;4246;0;0;0;0;.00nan;0;0
14203;179411;4991;52;15;2;13;.867;3600000;0
14203;65125;4246;80;40;3;37;.925;3600000;0
14204;199481;4998;86;39;3;36;.923;3600000;0
14204;176938;4919;43;3;1;2;.667;320000;0
14204;186573;4998;0;0;0;0;.00nan;0;0
14204;202788;4919;19;22;6;16;.727;3280000;0
14205;199481;4998;72;37;4;33;.892;3555000;0
14205;176938;4919;55;24;3;21;.875;3600000;0
14205;186573;4998;0;0;0;0;.00nan;0;0
14205;202788;4919;0;0;0;0;.00nan;0;0
14206;165532;4992;61;34;4;30;.882;3600000;0
14206;188911;4997;0;0;0;0;.00nan;0;0
14206;-1;4992;0;0;0;0;.00nan;0;0
14206;197047;4997;1;27;9;18;.667;3600000;0
14207;194899;1368;0;0;0;0;.00nan;0;0
14207;-1;4839;0;0;0;0;.00nan;0;0
14207;192457;1368;44;28;5;23;.821;3600000;0
14207;-1;4839;81;28;1;27;.964;3600000;0
14208;165532;4992;58;24;3;21;.875;3600000;0
14208;176938;4919;42;34;6;28;.824;3600000;0
14208;-1;4992;0;0;0;0;.00nan;0;0
14208;202788;4919;0;0;0;0;.00nan;0;0
14209;4487;4715;100;44;2;42;.955;3600000;0
14209;194625;165;47;18;3;15;.833;3570000;0
14209;200549;165;0;0;0;0;.00nan;0;0
14209;195283;4715;0;0;0;0;.00nan;0;0
14210;189628;4991;26;25;6;19;.760;3562000;0
14210;179411;4991;0;0;0;0;.00nan;0;0
14210;187391;4714;60;34;4;30;.882;3600000;0
14210;-1;4714;0;0;0;0;.00nan;0;0
14211;188911;4997;37;17;4;13;.765;2110000;0
14211;171615;4246;76;32;2;30;.938;3600000;0
14211;197047;4997;61;7;0;7;1.000;1413000;0
14211;65125;4246;0;0;0;0;.00nan;0;0
14212;194899;1368;93;19;0;19;1.000;3600000;0
14212;-1;4839;90;42;3;39;.929;3600000;0
14212;192457;1368;0;0;0;0;.00nan;0;0
14212;-1;4839;0;0;0;0;.00nan;0;0
14213;165532;4992;0;0;0;0;.00nan;0;0
14213;176938;4919;85;49;4;45;.918;3600000;0
14213;-1;4992;26;27;7;20;.741;3600000;0
14213;202788;4919;0;0;0;0;.00nan;0;0
14214;189628;4991;0;0;0;0;.00nan;0;0
14214;179411;4991;36;25;5;20;.800;3600000;0
14214;187391;4714;0;0;0;0;.00nan;0;0
14214;-1;4714;33;36;7;29;.806;3596000;0
14215;4487;4715;0;0;0;0;.00nan;0;0
14215;194625;165;0;0;0;0;.00nan;0;0
14215;200549;165;62;26;4;22;.846;3544000;0
14215;195283;4715;96;44;3;41;.932;3600000;0
14216;188911;4997;91;34;1;33;.971;3600000;0
14216;171615;4246;0;0;0;0;.00nan;0;0
14216;197047;4997;0;0;0;0;.00nan;0;0
14216;65125;4246;40;23;5;18;.783;3600000;0
14217;4487;4715;78;39;3;36;.923;3600000;0
14217;194625;165;36;21;4;17;.810;3556000;0
14217;200549;165;0;0;0;0;.00nan;0;0
14217;195283;4715;0;0;0;0;.00nan;0;0
14218;4487;4715;46;23;4;19;.826;3566000;0
14218;199481;4998;0;0;0;0;.00nan;0;0
14218;195283;4715;0;0;0;0;.00nan;0;0
14218;186573;4998;86;32;2;30;.938;3600000;0
14219;194625;165;65;33;3;30;.909;3544000;0
14219;200549;165;0;0;0;0;.00nan;0;0
14219;176938;4919;77;21;1;20;.952;3600000;0
14219;202788;4919;0;0;0;0;.00nan;0;0
14220;165532;4992;52;28;4;24;.857;3600000;0
14220;171615;4246;26;14;4;10;.714;1503000;0
14220;-1;4992;0;0;0;0;.00nan;0;0
14220;65125;4246;72;29;2;27;.931;2090000;0
14221;188911;4997;0;0;0;0;.00nan;0;0
14221;187391;4714;94;22;0;22;1.000;3600000;0
14221;197047;4997;56;26;4;22;.846;3600000;0
14221;-1;4714;0;0;0;0;.00nan;0;0
14222;194899;1368;47;10;2;8;.800;1256000;0
14222;189628;4991;68;24;2;22;.917;3600000;0
14222;179411;4991;0;0;0;0;.00nan;0;0
14222;192457;1368;31;31;5;26;.839;2344000;0
14223;188911;4997;58;19;2;17;.895;3600000;0
14223;171615;4246;12;21;6;15;.714;2265000;0
14223;197047;4997;0;0;0;0;.00nan;0;0
14223;65125;4246;45;5;1;4;.800;1335000;0
14224;194899;1368;0;0;0;0;.00nan;0;0
14224;189628;4991;0;0;0;0;.00nan;0;0
14224;179411;4991;73;39;3;36;.923;3600000;0
14224;192457;1368;42;32;6;26;.813;3600000;0
14225;4487;4715;54;3;0;3;1.000;750000;0
14225;199481;4998;28;13;4;9;.692;954000;0
14225;195283;4715;31;28;6;22;.786;3094000;0
14225;186573;4998;42;17;3;14;.824;2890000;0
14226;194625;165;0;0;0;0;.00nan;0;0
14226;200549;165;91;41;2;39;.951;3600000;0
14226;176938;4919;35;30;6;24;.800;3600000;0
14226;202788;4919;0;0;0;0;.00nan;0;0
14227;165532;4992;0;0;0;0;.00nan;0;0
14227;187391;4714;0;0;0;0;.00nan;0;0
14227;-1;4992;73;27;2;25;.926;3646000;0
14227;-1;4714;78;35;3;32;.914;3646000;0
14228;194899;1368;41;38;6;32;.842;2912000;0
14228;189628;4991;66;24;2;22;.917;3600000;0
14228;179411;4991;0;0;0;0;.00nan;0;0
14228;192457;1368;54;11;1;10;.909;688000;0
14229;199481;4998;70;37;4;33;.892;3600000;0
14229;194625;165;21;26;6;20;.769;3324000;0
14229;200549;165;41;2;1;1;.500;276000;0
14229;186573;4998;0;0;0;0;.00nan;0;0
14230;165532;4992;71;27;2;25;.926;4098000;0
14230;187391;4714;74;32;3;29;.906;4098000;0
14230;-1;4992;0;0;0;0;.00nan;0;0
14230;-1;4714;0;0;0;0;.00nan;0;0
14231;188911;4997;43;32;6;26;.813;2735000;0
14231;187391;4714;66;27;4;23;.852;3600000;0
14231;197047;4997;62;6;0;6;1.000;847000;0
14231;-1;4714;0;0;0;0;.00nan;0;0
14232;4487;4715;79;29;2;27;.931;3600000;0
14232;195283;4715;0;0;0;0;.00nan;0;0
14232;176938;4919;25;14;4;10;.714;1076000;0
14232;202788;4919;73;20;1;19;.950;2524000;0
14233;194625;165;55;16;2;14;.875;4200000;0
14233;200549;165;0;0;0;0;.00nan;0;0
14233;-1;4839;0;0;0;0;.00nan;0;0
14233;-1;4839;90;38;2;36;.947;4200000;0
14234;165532;4992;64;18;1;17;.944;3600000;0
14234;194899;1368;0;0;0;0;.00nan;0;0
14234;-1;4992;0;0;0;0;.00nan;0;0
14234;192457;1368;63;35;4;31;.886;3600000;0
14235;189628;4991;53;26;4;22;.846;3600000;0
14235;171615;4246;0;0;0;0;.00nan;0;0
14235;179411;4991;0;0;0;0;.00nan;0;0
14235;65125;4246;50;37;5;32;.865;3586000;0
14236;188911;4997;0;0;0;0;.00nan;0;0
14236;187391;4714;72;33;3;30;.909;3600000;0
14236;197047;4997;49;38;5;33;.868;3591000;0
14236;-1;4714;0;0;0;0;.00nan;0;0
14237;165532;4992;49;1;0;1;1.000;379000;0
14237;194899;1368;72;27;1;26;.963;3600000;0
14237;-1;4992;30;26;6;20;.769;3221000;0
14237;192457;1368;0;0;0;0;.00nan;0;0
14238;4487;4715;0;0;0;0;.00nan;0;0
14238;195283;4715;77;31;2;29;.935;3600000;0
14238;176938;4919;38;28;5;23;.821;3600000;0
14238;202788;4919;0;0;0;0;.00nan;0;0
14239;194625;165;0;0;0;0;.00nan;0;0
14239;200549;165;52;31;4;27;.871;3600000;0
14239;-1;4839;55;36;5;31;.861;3550000;0
14239;-1;4839;0;0;0;0;.00nan;0;0
14240;188911;4997;61;26;2;24;.923;3561000;0
14240;187391;4714;90;29;1;28;.966;3600000;0
14240;197047;4997;0;0;0;0;.00nan;0;0
14240;-1;4714;0;0;0;0;.00nan;0;0
14241;194625;165;52;19;3;16;.842;3971000;0
14241;200549;165;0;0;0;0;.00nan;0;0
14241;-1;4839;0;0;0;0;.00nan;0;0
14241;-1;4839;77;41;4;37;.902;3971000;0
14242;4487;4715;91;37;2;35;.946;3600000;0
14242;199481;4998;0;0;0;0;.00nan;0;0
14242;195283;4715;0;0;0;0;.00nan;0;0
14242;186573;4998;46;23;4;19;.826;3515000;0
14243;188911;4997;0;0;0;0;.00nan;0;0
14243;189628;4991;78;34;2;32;.941;3600000;0
14243;179411;4991;0;0;0;0;.00nan;0;0
14243;197047;4997;24;38;8;30;.789;3600000;0
14244;199481;4998;53;5;1;4;.800;1232000;0
14244;176938;4919;79;14;0;14;1.000;3600000;0
14244;186573;4998;46;26;5;21;.808;2368000;0
14244;202788;4919;0;0;0;0;.00nan;0;0
14245;165532;4992;82;26;2;24;.923;3600000;0
14245;-1;4992;0;0;0;0;.00nan;0;0
14245;-1;4839;88;47;3;44;.936;3600000;0
14245;-1;4839;0;0;0;0;.00nan;0;0
14246;4487;4715;58;26;3;23;.885;3600000;0
14246;194899;1368;0;0;0;0;.00nan;0;0
14246;195283;4715;0;0;0;0;.00nan;0;0
14246;192457;1368;56;39;5;34;.872;3515000;0
14247;171615;4246;42;29;5;24;.828;3600000;0
14247;187391;4714;51;16;2;14;.875;3600000;0
14247;-1;4714;0;0;0;0;.00nan;0;0
14247;65125;4246;0;0;0;0;.00nan;0;0
14248;188911;4997;48;28;4;24;.857;3600000;0
14248;187391;4714;80;26;1;25;.962;3600000;0
14248;197047;4997;0;0;0;0;.00nan;0;0
14248;-1;4714;0;0;0;0;.00nan;0;0
14249;4487;4715;0;0;0;0;.00nan;0;0
14249;194899;1368;23;18;5;13;.722;3600000;0
14249;195283;4715;75;23;2;21;.913;3600000;0
14249;192457;1368;0;0;0;0;.00nan;0;0
14250;199481;4998;0;0;0;0;.00nan;0;0
14250;194625;165;91;32;1;31;.969;3600000;0
14250;200549;165;0;0;0;0;.00nan;0;0
14250;186573;4998;62;38;4;34;.895;3600000;0
14251;165532;4992;0;0;0;0;.00nan;0;0
14251;-1;4992;56;32;4;28;.875;3600000;0
14251;-1;4839;0;0;0;0;.00nan;0;0
14251;-1;4839;47;43;7;36;.837;3600000;0
14252;189628;4991;67;24;3;21;.875;3838000;0
14252;171615;4246;0;0;0;0;.00nan;0;0
14252;179411;4991;0;0;0;0;.00nan;0;0
14252;65125;4246;80;48;4;44;.917;3838000;0
14253;165532;4992;58;29;3;26;.897;3600000;0
14253;194899;1368;0;0;0;0;.00nan;0;0
14253;-1;4992;0;0;0;0;.00nan;0;0
14253;192457;1368;63;34;4;30;.882;3565000;0
14254;188911;4997;0;0;0;0;.00nan;0;0
14254;187391;4714;68;18;1;17;.944;3600000;0
14254;197047;4997;79;28;2;26;.929;3586000;0
14254;-1;4714;0;0;0;0;.00nan;0;0
14255;4487;4715;75;32;3;29;.906;3600000;0
14255;195283;4715;0;0;0;0;.00nan;0;0
14255;-1;4839;54;35;4;31;.886;3566000;0
14255;-1;4839;0;0;0;0;.00nan;0;0
14256;189628;4991;0;0;0;0;.00nan;0;0
14256;171615;4246;4;21;7;14;.667;2943000;0
14256;179411;4991;84;29;1;28;.966;3600000;0
14256;65125;4246;58;5;0;5;1.000;657000;0
14257;199481;4998;47;31;5;26;.839;3600000;0
14257;171615;4246;0;0;0;0;.00nan;0;0
14257;186573;4998;0;0;0;0;.00nan;0;0
14257;65125;4246;36;38;7;31;.816;3600000;0
14258;194899;1368;0;0;0;0;.00nan;0;0
14258;-1;4839;0;0;0;0;.00nan;0;0
14258;192457;1368;55;21;3;18;.857;3600000;0
14258;-1;4839;58;30;4;26;.867;3600000;0
14259;194625;165;43;31;5;26;.839;3677000;0
14259;200549;165;0;0;0;0;.00nan;0;0
14259;176938;4919;57;32;4;28;.875;3677000;0
14259;202788;4919;0;0;0;0;.00nan;0;0
14260;165532;4992;0;0;0;0;.00nan;0;0
14260;188911;4997;47;25;5;20;.800;3149000;0
14260;-1;4992;68;27;3;24;.889;3600000;0
14260;197047;4997;42;4;1;3;.750;451000;0
14261;189628;4991;39;19;4;15;.789;3600000;0
14261;179411;4991;0;0;0;0;.00nan;0;0
14261;187391;4714;81;36;3;33;.917;3600000;0
14261;-1;4714;0;0;0;0;.00nan;0;0
14262;194899;1368;53;18;3;15;.833;3600000;0
14262;-1;4839;58;50;6;44;.880;3600000;0
14262;192457;1368;0;0;0;0;.00nan;0;0
14262;-1;4839;0;0;0;0;.00nan;0;0
14263;165532;4992;43;15;3;12;.800;3600000;0
14263;188911;4997;0;0;0;0;.00nan;0;0
14263;-1;4992;0;0;0;0;.00nan;0;0
14263;197047;4997;30;40;8;32;.800;3600000;0
14264;189628;4991;63;26;3;23;.885;3600000;0
14264;179411;4991;0;0;0;0;.00nan;0;0
14264;187391;4714;26;28;6;22;.786;2399000;0
14264;-1;4714;63;10;0;10;1.000;1201000;0
14265;199481;4998;56;5;0;5;1.000;376000;0
14265;171615;4246;43;36;6;30;.833;3656000;0
14265;186573;4998;35;23;5;18;.783;3280000;0
14265;65125;4246;0;0;0;0;.00nan;0;0
14266;4487;4715;89;42;3;39;.929;4200000;0
14266;194625;165;0;0;0;0;.00nan;0;0
14266;200549;165;67;40;3;37;.925;4200000;0
14266;195283;4715;0;0;0;0;.00nan;0;0
14267;194899;1368;0;0;0;0;.00nan;0;0
14267;-1;4839;0;0;0;0;.00nan;0;0
14267;192457;1368;66;16;1;15;.938;3600000;0
14267;-1;4839;29;42;8;34;.810;3600000;0
14268;4487;4715;0;0;0;0;.00nan;0;0
14268;199481;4998;61;30;4;26;.867;4200000;0
14268;195283;4715;47;30;4;26;.867;4200000;0
14268;186573;4998;0;0;0;0;.00nan;0;0
14269;189628;4991;0;0;0;0;.00nan;0;0
14269;179411;4991;63;29;3;26;.897;3600000;0
14269;187391;4714;46;22;4;18;.818;3540000;0
14269;-1;4714;0;0;0;0;.00nan;0;0
14270;194625;165;32;27;5;22;.815;3600000;0
14270;200549;165;0;0;0;0;.00nan;0;0
14270;176938;4919;85;31;1;30;.968;3600000;0
14270;202788;4919;0;0;0;0;.00nan;0;0
14271;165532;4992;47;28;4;24;.857;3600000;0
14271;188911;4997;69;23;2;21;.913;3600000;0
14271;-1;4992;0;0;0;0;.00nan;0;0
14271;197047;4997;0;0;0;0;.00nan;0;0
14272;4487;4715;79;20;1;19;.950;3600000;0
14272;199481;4998;0;0;0;0;.00nan;0;0
14272;195283;4715;0;0;0;0;.00nan;0;0
14272;186573;4998;42;26;4;22;.846;3600000;0
14273;176938;4919;90;36;1;35;.972;3600000;0
14273;-1;4839;63;26;2;24;.923;3583000;0
14273;202788;4919;0;0;0;0;.00nan;0;0
14273;-1;4839;0;0;0;0;.00nan;0;0
14274;165532;4992;56;36;4;32;.889;3564000;0
14274;194625;165;73;29;3;26;.897;3600000;0
14274;200549;165;0;0;0;0;.00nan;0;0
14274;-1;4992;0;0;0;0;.00nan;0;0
14275;188911;4997;62;16;1;15;.938;3600000;0
14275;187391;4714;85;28;2;26;.929;3600000;0
14275;197047;4997;0;0;0;0;.00nan;0;0
14275;-1;4714;0;0;0;0;.00nan;0;0
14276;194899;1368;81;27;1;26;.963;3600000;0
14276;189628;4991;49;29;4;25;.862;3600000;0
14276;179411;4991;0;0;0;0;.00nan;0;0
14276;192457;1368;0;0;0;0;.00nan;0;0
14277;188911;4997;0;0;0;0;.00nan;0;0
14277;187391;4714;41;22;4;18;.818;3545000;0
14277;197047;4997;75;33;2;31;.939;3600000;0
14277;-1;4714;0;0;0;0;.00nan;0;0
14278;176938;4919;59;39;5;34;.872;3581000;0
14278;-1;4839;0;0;0;0;.00nan;0;0
14278;202788;4919;0;0;0;0;.00nan;0;0
14278;-1;4839;51;26;4;22;.846;3600000;0
14279;165532;4992;0;0;0;0;.00nan;0;0
14279;194625;165;53;40;6;34;.850;3600000;0
14279;200549;165;0;0;0;0;.00nan;0;0
14279;-1;4992;70;28;3;25;.893;3600000;0
14280;194899;1368;69;28;2;26;.929;2081000;0
14280;189628;4991;0;0;0;0;.00nan;0;0
14280;179411;4991;100;27;0;27;1.000;3600000;0
14280;192457;1368;17;17;6;11;.647;1519000;0
14281;4487;4715;0;0;0;0;.00nan;0;0
14281;199481;4998;76;26;1;25;.962;3571000;0
14281;195283;4715;86;16;0;16;1.000;3600000;0
14281;186573;4998;0;0;0;0;.00nan;0;0
14282;4487;4715;0;0;0;0;.00nan;0;0
14282;199481;4998;0;0;0;0;.00nan;0;0
14282;195283;4715;77;42;5;37;.881;3600000;0
14282;186573;4998;90;23;0;23;1.000;3600000;0
14283;194899;1368;0;0;0;0;.00nan;0;0
14283;189628;4991;0;0;0;0;.00nan;0;0
14283;179411;4991;70;21;1;20;.952;3600000;0
14283;192457;1368;8;30;8;22;.733;3600000;0
14284;189628;4991;59;32;4;28;.875;3600000;0
14284;179411;4991;0;0;0;0;.00nan;0;0
14284;-1;4839;43;38;6;32;.842;3063000;0
14284;-1;4839;56;6;0;6;1.000;501000;0
14285;171615;4246;52;26;3;23;.885;2441000;0
14285;187391;4714;63;21;2;19;.905;3600000;0
14285;-1;4714;0;0;0;0;.00nan;0;0
14285;65125;4246;38;22;4;18;.818;1159000;0
14286;199481;4998;55;5;0;5;1.000;1301000;0
14286;186573;4998;45;29;5;24;.828;2299000;0
14286;-1;4839;0;0;0;0;.00nan;0;0
14286;-1;4839;51;39;6;33;.846;3544000;0
14287;4487;4715;87;29;1;28;.966;3600000;0
14287;194625;165;33;26;5;21;.808;3600000;0
14287;200549;165;0;0;0;0;.00nan;0;0
14287;195283;4715;0;0;0;0;.00nan;0;0
14288;194899;1368;31;32;6;26;.813;3600000;0
14288;189628;4991;0;0;0;0;.00nan;0;0
14288;179411;4991;69;37;3;34;.919;3600000;0
14288;192457;1368;0;0;0;0;.00nan;0;0
14289;165532;4992;56;20;2;18;.900;3636000;0
14289;188911;4997;62;22;3;19;.864;3636000;0
14289;-1;4992;0;0;0;0;.00nan;0;0
14289;197047;4997;0;0;0;0;.00nan;0;0
14290;171615;4246;0;0;0;0;.00nan;0;0
14290;187391;4714;0;0;0;0;.00nan;0;0
14290;-1;4714;68;25;3;22;.880;3600000;0
14290;65125;4246;36;32;6;26;.813;3600000;0
14291;199481;4998;0;0;0;0;.00nan;0;0
14291;194899;1368;0;0;0;0;.00nan;0;0
14291;186573;4998;44;28;5;23;.821;3836000;0
14291;192457;1368;62;36;4;32;.889;3846000;0
14292;4487;4715;91;30;2;28;.933;3180000;0
14292;195283;4715;31;14;4;10;.714;1020000;0
14292;176938;4919;36;37;6;31;.838;4200000;0
14292;202788;4919;0;0;0;0;.00nan;0;0
14293;165532;4992;71;19;1;18;.947;1292000;0
14293;188911;4997;0;0;0;0;.00nan;0;0
14293;-1;4992;6;17;6;11;.647;2308000;0
14293;197047;4997;72;25;2;23;.920;3600000;0
14294;189628;4991;65;23;2;21;.913;3538000;0
14294;179411;4991;0;0;0;0;.00nan;0;0
14294;-1;4839;100;31;0;31;1.000;3600000;0
14294;-1;4839;0;0;0;0;.00nan;0;0
14295;171615;4246;30;29;6;23;.793;3600000;0
14295;187391;4714;58;26;3;23;.885;3600000;0
14295;-1;4714;0;0;0;0;.00nan;0;0
14295;65125;4246;0;0;0;0;.00nan;0;0
14296;194625;165;61;29;3;26;.897;3600000;0
14296;200549;165;0;0;0;0;.00nan;0;0
14296;176938;4919;0;0;0;0;.00nan;0;0
14296;202788;4919;34;31;6;25;.806;3600000;0
14297;171615;4246;0;0;0;0;.00nan;0;0
14297;187391;4714;0;0;0;0;.00nan;0;0
14297;-1;4714;81;33;2;31;.939;3600000;0
14297;65125;4246;51;26;4;22;.846;3514000;0
14298;199481;4998;0;0;0;0;.00nan;0;0
14298;176938;4919;92;47;3;44;.936;3569000;0
14298;186573;4998;76;23;1;22;.957;3600000;0
14298;202788;4919;0;0;0;0;.00nan;0;0
14299;199481;4998;65;26;3;23;.885;3600000;0
14299;194625;165;30;25;5;20;.800;3514000;0
14299;200549;165;0;0;0;0;.00nan;0;0
14299;186573;4998;0;0;0;0;.00nan;0;0
14300;4487;4715;66;32;3;29;.906;3600000;0
14300;195283;4715;0;0;0;0;.00nan;0;0
14300;176938;4919;38;37;6;31;.838;3600000;0
14300;202788;4919;0;0;0;0;.00nan;0;0
14301;165532;4992;27;18;5;13;.722;3600000;0
14301;189628;4991;40;39;6;33;.846;3599000;0
14301;179411;4991;0;0;0;0;.00nan;0;0
14301;-1;4992;0;0;0;0;.00nan;0;0
14302;188911;4997;71;26;2;24;.923;4169000;0
14302;171615;4246;94;43;2;41;.953;4200000;0
14302;197047;4997;0;0;0;0;.00nan;0;0
14302;65125;4246;0;0;0;0;.00nan;0;0
14303;187391;4714;80;27;1;26;.963;3600000;0
14303;-1;4839;73;35;3;32;.914;3545000;0
14303;-1;4714;0;0;0;0;.00nan;0;0
14303;-1;4839;0;0;0;0;.00nan;0;0
14304;199481;4998;0;0;0;0;.00nan;0;0
14304;194625;165;0;0;0;0;.00nan;0;0
14304;200549;165;75;22;1;21;.955;3600000;0
14304;186573;4998;70;22;2;20;.909;3600000;0
14305;165532;4992;0;0;0;0;.00nan;0;0
14305;189628;4991;0;0;0;0;.00nan;0;0
14305;179411;4991;74;28;1;27;.964;3600000;0
14305;-1;4992;58;35;5;30;.857;3600000;0
14306;4487;4715;63;28;3;25;.893;3735000;0
14306;195283;4715;0;0;0;0;.00nan;0;0
14306;176938;4919;45;27;4;23;.852;3715000;0
14306;202788;4919;0;0;0;0;.00nan;0;0
14307;187391;4714;0;0;0;0;.00nan;0;0
14307;-1;4839;57;10;1;9;.900;1305000;0
14307;-1;4714;87;28;1;27;.964;3600000;0
14307;-1;4839;24;22;6;16;.727;2295000;0
14308;188911;4997;0;0;0;0;.00nan;0;0
14308;171615;4246;0;0;0;0;.00nan;0;0
14308;197047;4997;19;25;6;19;.760;3600000;0
14308;65125;4246;67;25;2;23;.920;3600000;0
14309;194625;165;40;30;5;25;.833;3600000;0
14309;200549;165;0;0;0;0;.00nan;0;0
14309;176938;4919;0;0;0;0;.00nan;0;0
14309;202788;4919;87;36;2;34;.944;3600000;0
14310;189628;4991;53;29;4;25;.862;3571000;0
14310;171615;4246;68;26;2;24;.923;3600000;0
14310;179411;4991;0;0;0;0;.00nan;0;0
14310;65125;4246;0;0;0;0;.00nan;0;0
14311;188911;4997;67;29;3;26;.897;3722000;0
14311;189628;4991;80;38;4;34;.895;3722000;0
14311;179411;4991;0;0;0;0;.00nan;0;0
14311;197047;4997;0;0;0;0;.00nan;0;0
14312;171615;4246;0;0;0;0;.00nan;0;0
14312;187391;4714;87;33;1;32;.970;3600000;0
14312;-1;4714;0;0;0;0;.00nan;0;0
14312;65125;4246;49;25;4;21;.840;3600000;0
14313;194899;1368;0;0;0;0;.00nan;0;0
14313;-1;4839;76;35;2;33;.943;3600000;0
14313;192457;1368;59;28;3;25;.893;3544000;0
14313;-1;4839;0;0;0;0;.00nan;0;0
14314;4487;4715;92;44;2;42;.955;3600000;0
14314;165532;4992;28;7;3;4;.571;572000;0
14314;195283;4715;0;0;0;0;.00nan;0;0
14314;-1;4992;98;33;0;33;1.000;2984000;0
14315;199481;4998;0;0;0;0;.00nan;0;0
14315;194625;165;50;31;5;26;.839;3600000;0
14315;200549;165;0;0;0;0;.00nan;0;0
14315;186573;4998;25;29;7;22;.759;3560000;0
14316;188911;4997;0;0;0;0;.00nan;0;0
14316;189628;4991;74;21;1;20;.952;3819000;0
14316;179411;4991;0;0;0;0;.00nan;0;0
14316;197047;4997;79;28;2;26;.929;3819000;0
14317;171615;4246;47;20;3;17;.850;3600000;0
14317;187391;4714;0;0;0;0;.00nan;0;0
14317;-1;4714;47;29;5;24;.828;3519000;0
14317;65125;4246;0;0;0;0;.00nan;0;0
14318;194899;1368;74;21;1;20;.952;3600000;0
14318;-1;4839;0;0;0;0;.00nan;0;0
14318;192457;1368;0;0;0;0;.00nan;0;0
14318;-1;4839;72;44;4;40;.909;3600000;0
14319;4487;4715;42;37;7;30;.811;3345000;0
14319;165532;4992;74;41;4;37;.902;3600000;0
14319;195283;4715;39;1;1;0;.000;255000;0
14319;-1;4992;0;0;0;0;.00nan;0;0
14320;199481;4998;32;40;7;33;.825;3030000;0
14320;176938;4919;27;23;6;17;.739;2802000;0
14320;186573;4998;57;5;0;5;1.000;533000;0
14320;202788;4919;52;2;0;2;1.000;798000;0
14321;188911;4997;87;41;2;39;.951;3549000;0
14321;189628;4991;0;0;0;0;.00nan;0;0
14321;179411;4991;78;23;1;22;.957;3600000;0
14321;197047;4997;0;0;0;0;.00nan;0;0
14322;171615;4246;0;0;0;0;.00nan;0;0
14322;187391;4714;62;21;3;18;.857;3600000;0
14322;-1;4714;0;0;0;0;.00nan;0;0
14322;65125;4246;73;47;5;42;.894;3514000;0
14324;199481;4998;60;34;4;30;.882;3600000;0
14324;165532;4992;76;22;1;21;.955;3600000;0
14324;186573;4998;0;0;0;0;.00nan;0;0
14324;-1;4992;0;0;0;0;.00nan;0;0
14326;194899;1368;0;0;0;0;.00nan;0;0
14326;176860;1368;61;23;3;20;.870;3600000;0
14326;176938;4919;66;40;4;36;.900;3549000;0
14326;202788;4919;0;0;0;0;.00nan;0;0
14328;171615;4246;65;37;4;33;.892;3632000;0
14328;187391;4714;50;17;3;14;.824;3632000;0
14328;-1;4714;0;0;0;0;.00nan;0;0
14328;65125;4246;0;0;0;0;.00nan;0;0
14330;4487;4715;64;30;3;27;.900;4200000;0
14330;194625;165;58;35;3;32;.914;4200000;0
14330;200549;165;0;0;0;0;.00nan;0;0
14330;195283;4715;0;0;0;0;.00nan;0;0
14332;188911;4997;100;32;0;32;1.000;3600000;0
14332;189628;4991;83;36;2;34;.944;3513000;0
14332;179411;4991;0;0;0;0;.00nan;0;0
14332;197047;4997;0;0;0;0;.00nan;0;0
2190;194899;1368;0;0;0;0;.00nan;0;0
2190;189628;4991;21;18;5;13;.722;3600000;0
2190;179411;4991;0;0;0;0;.00nan;0;0
2190;192457;1368;73;25;2;23;.920;3600000;0
2191;188911;4997;73;42;4;38;.905;3831000;0
2191;187391;4714;74;35;3;32;.914;3814000;0
2191;197047;4997;0;0;0;0;.00nan;0;0
2191;-1;4714;0;0;0;0;.00nan;0;0
2192;4487;4715;83;25;1;24;.960;3600000;0
2192;194625;165;31;9;3;6;.667;410000;0
2192;200549;165;48;33;5;28;.848;3190000;0
2192;195283;4715;0;0;0;0;.00nan;0;0
2193;165532;4992;73;37;4;33;.892;3591000;0
2193;176938;4919;70;23;3;20;.870;3600000;0
2193;-1;4992;0;0;0;0;.00nan;0;0
2193;202788;4919;0;0;0;0;.00nan;0;0
2194;194899;1368;0;0;0;0;.00nan;0;0
2194;189628;4991;75;42;4;38;.905;3583000;0
2194;179411;4991;0;0;0;0;.00nan;0;0
2194;192457;1368;62;25;3;22;.880;3600000;0
2195;188911;4997;36;20;4;16;.800;3548000;0
2195;187391;4714;47;20;3;17;.850;3600000;0
2195;197047;4997;0;0;0;0;.00nan;0;0
2195;-1;4714;0;0;0;0;.00nan;0;0
2196;4487;4715;98;39;2;37;.949;3600000;0
2196;194625;165;24;19;5;14;.737;2313000;0
2196;200549;165;77;18;0;18;1.000;1287000;0
2196;195283;4715;0;0;0;0;.00nan;0;0
2197;165532;4992;84;27;1;26;.963;3600000;0
2197;176938;4919;61;23;3;20;.870;3551000;0
2197;-1;4992;0;0;0;0;.00nan;0;0
2197;202788;4919;0;0;0;0;.00nan;0;0
2323;165532;4992;79;41;3;38;.927;3544000;0
2323;176938;4919;57;18;2;16;.889;3600000;0
2323;-1;4992;0;0;0;0;.00nan;0;0
2323;202788;4919;0;0;0;0;.00nan;0;0
2394;194899;1368;0;0;0;0;.00nan;0;0
2394;187391;4714;57;29;4;25;.862;3600000;0
2394;192457;1368;7;23;7;16;.696;3600000;0
2394;-1;4714;0;0;0;0;.00nan;0;0
2395;4487;4715;90;25;1;24;.960;3600000;0
2395;195283;4715;0;0;0;0;.00nan;0;0
2395;176938;4919;32;43;8;35;.814;3600000;0
2395;202788;4919;0;0;0;0;.00nan;0;0
2396;194899;1368;0;0;0;0;.00nan;0;0
2396;187391;4714;63;35;4;31;.886;3600000;0
2396;192457;1368;100;32;0;32;1.000;3600000;0
2396;-1;4714;0;0;0;0;.00nan;0;0
2397;4487;4715;62;29;4;25;.862;3596000;0
2397;195283;4715;0;0;0;0;.00nan;0;0
2397;176938;4919;84;35;3;32;.914;3600000;0
2397;202788;4919;0;0;0;0;.00nan;0;0
2480;194899;1368;0;0;0;0;.00nan;0;0
2480;187391;4714;67;37;4;33;.892;3600000;0
2480;192457;1368;62;25;3;22;.880;3600000;0
2480;-1;4714;0;0;0;0;.00nan;0;0
2481;4487;4715;83;52;4;48;.923;4942000;0
2481;195283;4715;0;0;0;0;.00nan;0;0
2481;176938;4919;90;44;3;41;.932;4942000;0
2481;202788;4919;0;0;0;0;.00nan;0;0
2491;194899;1368;0;0;0;0;.00nan;0;0
2491;176938;4919;51;31;4;27;.871;3584000;0
2491;192457;1368;45;18;3;15;.833;3600000;0
2491;202788;4919;0;0;0;0;.00nan;0;0
2492;194899;1368;0;0;0;0;.00nan;0;0
2492;176938;4919;46;31;5;26;.839;3586000;0
2492;192457;1368;49;33;4;29;.879;3600000;0
2492;202788;4919;0;0;0;0;.00nan;0;0
14333;20122;172;0;0;0;0;.00nan;0;0
14333;171608;167;0;0;0;0;.00nan;0;0
14333;181874;167;99;52;3;49;.942;3900000;0
14333;92313;172;57;29;3;26;.897;3900000;0
14334;2495;171;0;0;0;0;.00nan;0;0
14334;202059;171;67;24;2;22;.917;3600000;0
14334;191692;3916;0;0;0;0;.00nan;0;0
14334;149450;3916;43;44;7;37;.841;3600000;0
14335;164987;169;36;15;4;11;.733;1731000;0
14335;194576;169;77;15;0;15;1.000;1817000;0
14335;78864;170;78;35;3;32;.914;3600000;0
14335;79280;170;0;0;0;0;.00nan;0;0
14336;163462;1527;0;0;0;0;.00nan;0;0
14336;191692;3916;0;0;0;0;.00nan;0;0
14336;85228;1527;73;28;2;26;.929;3600000;0
14336;149450;3916;38;21;4;17;.810;3571000;0
14337;2495;171;0;0;0;0;.00nan;0;0
14337;187657;4247;0;0;0;0;.00nan;0;0
14337;202059;171;65;30;3;27;.900;3900000;0
14337;85336;4247;82;37;3;34;.919;3900000;0
14338;164987;169;74;38;3;35;.921;3584000;0
14338;194576;169;0;0;0;0;.00nan;0;0
14338;78864;170;97;32;1;31;.969;3600000;0
14338;79280;170;0;0;0;0;.00nan;0;0
14339;173874;174;0;0;0;0;.00nan;0;0
14339;202246;175;64;24;2;22;.917;3600000;0
14339;86347;175;0;0;0;0;.00nan;0;0
14339;91703;174;36;34;7;27;.794;3600000;0
14340;20122;172;70;22;2;20;.909;3569000;0
14340;171608;167;0;0;0;0;.00nan;0;0
14340;181874;167;98;37;1;36;.973;3600000;0
14340;92313;172;0;0;0;0;.00nan;0;0
14341;191692;3916;0;0;0;0;.00nan;0;0
14341;78864;170;0;0;0;0;.00nan;0;0
14341;79280;170;51;25;4;21;.840;3600000;0
14341;149450;3916;57;43;5;38;.884;3600000;0
14342;187657;4247;0;0;0;0;.00nan;0;0
14342;202246;175;75;41;4;37;.902;3600000;0
14342;85336;4247;87;30;1;29;.967;3600000;0
14342;86347;175;0;0;0;0;.00nan;0;0
14343;164987;169;0;0;0;0;.00nan;0;0
14343;194576;169;74;44;4;40;.909;3600000;0
14343;171608;167;0;0;0;0;.00nan;0;0
14343;181874;167;54;21;3;18;.857;3600000;0
14344;2495;171;0;0;0;0;.00nan;0;0
14344;163462;1527;0;0;0;0;.00nan;0;0
14344;202059;171;62;24;2;22;.917;3599000;0
14344;85228;1527;92;35;1;34;.971;3600000;0
14345;20122;172;47;17;3;14;.824;3600000;0
14345;173874;174;46;41;6;35;.854;3600000;0
14345;91703;174;0;0;0;0;.00nan;0;0
14345;92313;172;0;0;0;0;.00nan;0;0
14346;164987;169;95;35;1;34;.971;3600000;0
14346;194576;169;0;0;0;0;.00nan;0;0
14346;171608;167;59;27;2;25;.926;3581000;0
14346;181874;167;0;0;0;0;.00nan;0;0
14347;2495;171;90;40;2;38;.950;3826000;0
14347;163462;1527;97;30;1;29;.967;3826000;0
14347;202059;171;0;0;0;0;.00nan;0;0
14347;85228;1527;0;0;0;0;.00nan;0;0
14348;191692;3916;56;19;2;17;.895;3600000;0
14348;78864;170;42;36;5;31;.861;3600000;0
14348;79280;170;0;0;0;0;.00nan;0;0
14348;149450;3916;0;0;0;0;.00nan;0;0
14349;20122;172;62;21;2;19;.905;3555000;0
14349;173874;174;94;39;1;38;.974;3600000;0
14349;91703;174;0;0;0;0;.00nan;0;0
14349;92313;172;0;0;0;0;.00nan;0;0
14350;173874;174;98;40;1;39;.975;3552000;0
14350;202246;175;100;24;0;24;1.000;3600000;0
14350;86347;175;0;0;0;0;.00nan;0;0
14350;91703;174;0;0;0;0;.00nan;0;0
14351;2495;171;0;0;0;0;.00nan;0;0
14351;202059;171;75;24;1;23;.958;3600000;0
14351;191692;3916;69;31;3;28;.903;3535000;0
14351;149450;3916;0;0;0;0;.00nan;0;0
14352;171608;167;0;0;0;0;.00nan;0;0
14352;181874;167;71;35;3;32;.914;3848000;0
14352;78864;170;0;0;0;0;.00nan;0;0
14352;79280;170;85;38;2;36;.947;3848000;0
14353;187657;4247;0;0;0;0;.00nan;0;0
14353;164987;169;51;27;4;23;.852;3515000;0
14353;194576;169;0;0;0;0;.00nan;0;0
14353;85336;4247;79;33;2;31;.939;3600000;0
14354;163462;1527;0;0;0;0;.00nan;0;0
14354;20122;172;68;26;2;24;.923;3600000;0
14354;85228;1527;67;39;4;35;.897;3518000;0
14354;92313;172;0;0;0;0;.00nan;0;0
14355;173874;174;0;0;0;0;.00nan;0;0
14355;202246;175;67;16;1;15;.938;3600000;0
14355;86347;175;0;0;0;0;.00nan;0;0
14355;91703;174;90;45;4;41;.911;3600000;0
14356;2495;171;75;26;2;24;.923;3600000;0
14356;202059;171;0;0;0;0;.00nan;0;0
14356;191692;3916;0;0;0;0;.00nan;0;0
14356;149450;3916;59;23;3;20;.870;3555000;0
14357;171608;167;56;38;5;33;.868;3600000;0
14357;181874;167;0;0;0;0;.00nan;0;0
14357;78864;170;57;36;4;32;.889;3600000;0
14357;79280;170;0;0;0;0;.00nan;0;0
14358;187657;4247;81;36;3;33;.917;3600000;0
14358;164987;169;0;0;0;0;.00nan;0;0
14358;194576;169;69;41;4;37;.902;3566000;0
14358;85336;4247;0;0;0;0;.00nan;0;0
14359;163462;1527;88;24;1;23;.958;3600000;0
14359;20122;172;0;0;0;0;.00nan;0;0
14359;85228;1527;0;0;0;0;.00nan;0;0
14359;92313;172;87;35;3;32;.914;3578000;0
14360;163462;1527;0;0;0;0;.00nan;0;0
14360;171608;167;0;0;0;0;.00nan;0;0
14360;181874;167;64;30;3;27;.900;3599000;0
14360;85228;1527;76;35;2;33;.943;3600000;0
14361;2495;171;0;0;0;0;.00nan;0;0
14361;202059;171;69;22;2;20;.909;3545000;0
14361;78864;170;99;58;1;57;.983;3600000;0
14361;79280;170;0;0;0;0;.00nan;0;0
14362;163462;1527;0;0;0;0;.00nan;0;0
14362;191692;3916;80;32;2;30;.938;3600000;0
14362;85228;1527;43;16;3;13;.813;3582000;0
14362;149450;3916;0;0;0;0;.00nan;0;0
14363;187657;4247;72;32;3;29;.906;3600000;0
14363;202246;175;26;27;6;21;.778;3153000;0
14363;85336;4247;0;0;0;0;.00nan;0;0
14363;86347;175;58;3;0;3;1.000;447000;0
14364;173874;174;100;37;0;37;1.000;3742000;0
14364;171608;167;0;0;0;0;.00nan;0;0
14364;181874;167;87;28;1;27;.964;3742000;0
14364;91703;174;0;0;0;0;.00nan;0;0
14365;163462;1527;62;15;1;14;.933;3600000;0
14365;78864;170;0;0;0;0;.00nan;0;0
14365;79280;170;37;28;5;23;.821;3600000;0
14365;85228;1527;0;0;0;0;.00nan;0;0
14366;164987;169;50;22;4;18;.818;3600000;0
14366;194576;169;0;0;0;0;.00nan;0;0
14366;191692;3916;0;0;0;0;.00nan;0;0
14366;149450;3916;88;32;1;31;.969;3600000;0
14367;2495;171;84;38;2;36;.947;3561000;0
14367;20122;172;71;21;1;20;.952;3600000;0
14367;202059;171;0;0;0;0;.00nan;0;0
14367;92313;172;0;0;0;0;.00nan;0;0
14368;173874;174;74;26;2;24;.923;3600000;0
14368;171608;167;0;0;0;0;.00nan;0;0
14368;181874;167;65;35;3;32;.914;3600000;0
14368;91703;174;0;0;0;0;.00nan;0;0
14369;2495;171;29;16;4;12;.750;895000;0
14369;187657;4247;0;0;0;0;.00nan;0;0
14369;202059;171;11;20;6;14;.700;2705000;0
14369;85336;4247;99;29;1;28;.966;3600000;0
14370;163462;1527;0;0;0;0;.00nan;0;0
14370;78864;170;66;40;4;36;.900;3600000;0
14370;79280;170;0;0;0;0;.00nan;0;0
14370;85228;1527;71;20;1;19;.950;3600000;0
14371;164987;169;0;0;0;0;.00nan;0;0
14371;194576;169;75;19;1;18;.947;3600000;0
14371;20122;172;0;0;0;0;.00nan;0;0
14371;92313;172;83;37;3;34;.919;3579000;0
14372;187657;4247;0;0;0;0;.00nan;0;0
14372;202246;175;100;41;1;40;.976;3600000;0
14372;85336;4247;60;24;3;21;.875;3555000;0
14372;86347;175;0;0;0;0;.00nan;0;0
14373;181874;167;49;40;6;34;.850;3806000;0
14373;78864;170;71;50;5;45;.900;3788000;0
14373;79280;170;0;0;0;0;.00nan;0;0
14373;91225;167;0;0;0;0;.00nan;0;0
14374;187657;4247;55;24;3;21;.875;3600000;0
14374;78864;170;42;28;6;22;.786;2358000;0
14374;79280;170;44;13;2;11;.846;1242000;0
14374;85336;4247;0;0;0;0;.00nan;0;0
14375;2495;171;0;0;0;0;.00nan;0;0
14375;202059;171;96;33;1;32;.970;3600000;0
14375;181874;167;0;0;0;0;.00nan;0;0
14375;91225;167;72;29;2;27;.931;3555000;0
14376;163462;1527;69;21;2;19;.905;3600000;0
14376;191692;3916;0;0;0;0;.00nan;0;0
14376;85228;1527;0;0;0;0;.00nan;0;0
14376;149450;3916;73;34;3;31;.912;3566000;0
14377;20122;172;61;27;3;24;.889;3600000;0
14377;202246;175;66;42;4;38;.905;3555000;0
14377;86347;175;0;0;0;0;.00nan;0;0
14377;92313;172;0;0;0;0;.00nan;0;0
14378;2495;171;78;40;3;37;.925;3542000;0
14378;202059;171;0;0;0;0;.00nan;0;0
14378;181874;167;99;47;1;46;.979;3600000;0
14378;91225;167;0;0;0;0;.00nan;0;0
14379;191692;3916;94;35;1;34;.971;3600000;0
14379;78864;170;55;43;6;37;.860;3361000;0
14379;79280;170;50;1;0;1;1.000;239000;0
14379;149450;3916;0;0;0;0;.00nan;0;0
14380;163462;1527;0;0;0;0;.00nan;0;0
14380;164987;169;96;29;0;29;1.000;3600000;0
14380;194576;169;0;0;0;0;.00nan;0;0
14380;85228;1527;97;31;1;30;.968;3590000;0
14381;187657;4247;0;0;0;0;.00nan;0;0
14381;173874;174;55;24;3;21;.875;3554000;0
14381;85336;4247;63;21;2;19;.905;3600000;0
14381;91703;174;0;0;0;0;.00nan;0;0
14382;20122;172;0;0;0;0;.00nan;0;0
14382;202246;175;0;0;0;0;.00nan;0;0
14382;86347;175;76;29;2;27;.931;3600000;0
14382;92313;172;56;28;4;24;.857;3557000;0
14383;163462;1527;93;24;0;24;1.000;3600000;0
14383;191692;3916;0;0;0;0;.00nan;0;0
14383;85228;1527;0;0;0;0;.00nan;0;0
14383;149450;3916;69;32;2;30;.938;3600000;0
14384;187657;4247;0;0;0;0;.00nan;0;0
14384;173874;174;90;42;2;40;.952;3600000;0
14384;85336;4247;57;26;3;23;.885;3596000;0
14384;91703;174;0;0;0;0;.00nan;0;0
14385;2495;171;0;0;0;0;.00nan;0;0
14385;20122;172;83;27;1;26;.963;3600000;0
14385;202059;171;70;44;5;39;.886;3600000;0
14385;92313;172;0;0;0;0;.00nan;0;0
14386;164987;169;41;28;5;23;.821;3600000;0
14386;194576;169;0;0;0;0;.00nan;0;0
14386;181874;167;97;35;1;34;.971;3600000;0
14386;91225;167;0;0;0;0;.00nan;0;0
14387;202246;175;80;27;3;24;.889;3900000;0
14387;78864;170;88;37;3;34;.919;3900000;0
14387;79280;170;0;0;0;0;.00nan;0;0
14387;86347;175;0;0;0;0;.00nan;0;0
14388;2495;171;76;30;1;29;.967;3600000;0
14388;202059;171;0;0;0;0;.00nan;0;0
14388;202246;175;0;0;0;0;.00nan;0;0
14388;86347;175;62;44;5;39;.886;3600000;0
14389;187657;4247;67;28;2;26;.929;3900000;0
14389;173874;174;86;39;2;37;.949;3900000;0
14389;85336;4247;0;0;0;0;.00nan;0;0
14389;91703;174;0;0;0;0;.00nan;0;0
14390;20122;172;0;0;0;0;.00nan;0;0
14390;181874;167;83;30;1;29;.967;3600000;0
14390;91225;167;0;0;0;0;.00nan;0;0
14390;92313;172;71;29;3;26;.897;3514000;0
14391;164987;169;49;27;3;24;.889;3594000;0
14391;194576;169;0;0;0;0;.00nan;0;0
14391;78864;170;0;0;0;0;.00nan;0;0
14391;79280;170;99;33;1;32;.970;3600000;0
14392;163462;1527;74;27;2;25;.926;3551000;0
14392;191692;3916;99;37;1;36;.973;3600000;0
14392;85228;1527;0;0;0;0;.00nan;0;0
14392;149450;3916;0;0;0;0;.00nan;0;0
14393;2495;171;0;0;0;0;.00nan;0;0
14393;202059;171;81;38;2;36;.947;3600000;0
14393;202246;175;40;26;4;22;.846;3555000;0
14393;86347;175;0;0;0;0;.00nan;0;0
14394;187657;4247;0;0;0;0;.00nan;0;0
14394;173874;174;0;0;0;0;.00nan;0;0
14394;85336;4247;94;28;1;27;.964;3600000;0
14394;91703;174;97;57;3;54;.947;3548000;0
14395;164987;169;0;0;0;0;.00nan;0;0
14395;194576;169;59;18;2;16;.889;3900000;0
14395;78864;170;98;49;2;47;.959;3900000;0
14395;79280;170;0;0;0;0;.00nan;0;0
14396;163462;1527;0;0;0;0;.00nan;0;0
14396;164987;169;51;25;3;22;.880;3556000;0
14396;194576;169;0;0;0;0;.00nan;0;0
14396;85228;1527;97;36;1;35;.972;3600000;0
14397;164987;169;68;20;1;19;.950;3600000;0
14397;194576;169;0;0;0;0;.00nan;0;0
14397;191692;3916;78;41;4;37;.902;3600000;0
14397;149450;3916;0;0;0;0;.00nan;0;0
14398;163462;1527;57;33;4;29;.879;3556000;0
14398;202246;175;62;24;3;21;.875;3600000;0
14398;85228;1527;0;0;0;0;.00nan;0;0
14398;86347;175;0;0;0;0;.00nan;0;0
14399;187657;4247;0;0;0;0;.00nan;0;0
14399;20122;172;0;0;0;0;.00nan;0;0
14399;85336;4247;62;30;3;27;.900;3548000;0
14399;92313;172;78;31;2;29;.935;3600000;0
14400;164987;169;0;0;0;0;.00nan;0;0
14400;194576;169;73;37;3;34;.919;3600000;0
14400;191692;3916;0;0;0;0;.00nan;0;0
14400;149450;3916;39;25;5;20;.800;3559000;0
14401;2495;171;0;0;0;0;.00nan;0;0
14401;202059;171;37;34;5;29;.853;3600000;0
14401;181874;167;73;25;2;23;.920;3600000;0
14401;91225;167;0;0;0;0;.00nan;0;0
14402;163462;1527;0;0;0;0;.00nan;0;0
14402;202246;175;65;39;4;35;.897;3530000;0
14402;85228;1527;68;25;2;23;.920;3600000;0
14402;86347;175;0;0;0;0;.00nan;0;0
14403;187657;4247;64;36;3;33;.917;3541000;0
14403;20122;172;70;18;1;17;.944;3600000;0
14403;85336;4247;0;0;0;0;.00nan;0;0
14403;92313;172;0;0;0;0;.00nan;0;0
14404;2495;171;43;30;5;25;.833;3600000;0
14404;202059;171;0;0;0;0;.00nan;0;0
14404;181874;167;0;0;0;0;.00nan;0;0
14404;91225;167;42;40;6;34;.850;3587000;0
14405;187657;4247;0;0;0;0;.00nan;0;0
14405;202246;175;0;0;0;0;.00nan;0;0
14405;85336;4247;76;28;2;26;.929;3600000;0
14405;86347;175;77;40;4;36;.900;3572000;0
14406;2495;171;0;0;0;0;.00nan;0;0
14406;202059;171;61;23;2;21;.913;3600000;0
14406;191692;3916;57;34;4;30;.882;3546000;0
14406;149450;3916;0;0;0;0;.00nan;0;0
14407;164987;169;0;0;0;0;.00nan;0;0
14407;194576;169;86;13;0;13;1.000;3600000;0
14407;78864;170;80;33;2;31;.939;3571000;0
14407;79280;170;0;0;0;0;.00nan;0;0
14408;163462;1527;0;0;0;0;.00nan;0;0
14408;173874;174;94;37;1;36;.973;3900000;0
14408;85228;1527;64;16;1;15;.938;3900000;0
14408;91703;174;0;0;0;0;.00nan;0;0
14409;20122;172;84;39;3;36;.923;3900000;0
14409;181874;167;69;31;3;28;.903;3900000;0
14409;91225;167;0;0;0;0;.00nan;0;0
14409;92313;172;0;0;0;0;.00nan;0;0
14410;2495;171;87;33;1;32;.970;3600000;0
14410;202059;171;0;0;0;0;.00nan;0;0
14410;191692;3916;0;0;0;0;.00nan;0;0
14410;149450;3916;61;31;3;28;.903;3600000;0
14411;164987;169;0;0;0;0;.00nan;0;0
14411;194576;169;86;28;1;27;.964;3600000;0
14411;78864;170;49;23;3;20;.870;2464000;0
14411;79280;170;32;25;5;20;.800;1136000;0
14412;163462;1527;100;20;0;20;1.000;3600000;0
14412;173874;174;0;0;0;0;.00nan;0;0
14412;85228;1527;0;0;0;0;.00nan;0;0
14412;91703;174;61;26;3;23;.885;3600000;0
14413;187657;4247;81;27;2;25;.926;3600000;0
14413;202246;175;61;33;4;29;.879;3528000;0
14413;85336;4247;0;0;0;0;.00nan;0;0
14413;86347;175;0;0;0;0;.00nan;0;0
14414;20122;172;0;0;0;0;.00nan;0;0
14414;181874;167;0;0;0;0;.00nan;0;0
14414;91225;167;100;23;0;23;1.000;3600000;0
14414;92313;172;46;35;5;30;.857;3600000;0
14415;173874;174;87;30;1;29;.967;3600000;0
14415;202246;175;0;0;0;0;.00nan;0;0
14415;86347;175;71;34;3;31;.912;3551000;0
14415;91703;174;0;0;0;0;.00nan;0;0
14416;181874;167;0;0;0;0;.00nan;0;0
14416;191692;3916;68;39;3;36;.923;3596000;0
14416;91225;167;79;24;1;23;.958;3600000;0
14416;149450;3916;0;0;0;0;.00nan;0;0
14417;2495;171;0;0;0;0;.00nan;0;0
14417;187657;4247;0;0;0;0;.00nan;0;0
14417;202059;171;90;50;3;47;.940;3600000;0
14417;85336;4247;37;20;4;16;.800;3595000;0
14418;173874;174;0;0;0;0;.00nan;0;0
14418;202246;175;78;25;1;24;.960;3600000;0
14418;86347;175;0;0;0;0;.00nan;0;0
14418;91703;174;69;39;3;36;.923;3571000;0
14419;20122;172;78;12;0;12;1.000;3900000;0
14419;78864;170;96;43;0;43;1.000;3900000;0
14419;79280;170;0;0;0;0;.00nan;0;0
14419;92313;172;0;0;0;0;.00nan;0;0
14420;20122;172;60;12;1;11;.917;3600000;0
14420;191692;3916;0;0;0;0;.00nan;0;0
14420;92313;172;0;0;0;0;.00nan;0;0
14420;149450;3916;57;49;7;42;.857;3600000;0
14421;164987;169;0;0;0;0;.00nan;0;0
14421;194576;169;82;32;1;31;.969;3600000;0
14421;181874;167;67;27;2;25;.926;3573000;0
14421;91225;167;0;0;0;0;.00nan;0;0
14422;2495;171;78;42;3;39;.929;3594000;0
14422;163462;1527;100;43;2;41;.953;3600000;0
14422;202059;171;0;0;0;0;.00nan;0;0
14422;85228;1527;0;0;0;0;.00nan;0;0
14423;187657;4247;65;23;2;21;.913;3900000;0
14423;202246;175;0;0;0;0;.00nan;0;0
14423;85336;4247;0;0;0;0;.00nan;0;0
14423;86347;175;86;35;2;33;.943;3900000;0
14424;173874;174;73;45;6;39;.867;3600000;0
14424;78864;170;63;18;1;17;.944;3600000;0
14424;79280;170;0;0;0;0;.00nan;0;0
14424;91703;174;0;0;0;0;.00nan;0;0
14425;173874;174;54;23;3;20;.870;3600000;0
14425;191692;3916;65;35;4;31;.886;3091000;0
14425;91703;174;0;0;0;0;.00nan;0;0
14425;149450;3916;24;6;3;3;.500;509000;0
14426;191692;3916;0;0;0;0;.00nan;0;0
14426;78864;170;56;35;5;30;.857;3574000;0
14426;79280;170;0;0;0;0;.00nan;0;0
14426;149450;3916;67;34;4;30;.882;3600000;0
14427;187657;4247;60;25;3;22;.880;3600000;0
14427;202246;175;43;36;6;30;.833;3047000;0
14427;85336;4247;0;0;0;0;.00nan;0;0
14427;86347;175;44;3;1;2;.667;553000;0
14428;163462;1527;0;0;0;0;.00nan;0;0
14428;164987;169;0;0;0;0;.00nan;0;0
14428;194576;169;81;36;3;33;.917;3647000;0
14428;85228;1527;60;21;2;19;.905;3647000;0
14429;2495;171;0;0;0;0;.00nan;0;0
14429;173874;174;0;0;0;0;.00nan;0;0
14429;202059;171;75;22;1;21;.955;3600000;0
14429;91703;174;86;34;2;32;.941;3575000;0
14430;20122;172;89;36;3;33;.917;3627000;0
14430;181874;167;0;0;0;0;.00nan;0;0
14430;91225;167;87;36;2;34;.944;3627000;0
14430;92313;172;0;0;0;0;.00nan;0;0
14431;2495;171;65;27;3;24;.889;3573000;0
14431;202059;171;0;0;0;0;.00nan;0;0
14431;191692;3916;85;35;2;33;.943;3600000;0
14431;149450;3916;0;0;0;0;.00nan;0;0
14432;187657;4247;0;0;0;0;.00nan;0;0
14432;202246;175;0;0;0;0;.00nan;0;0
14432;85336;4247;76;11;0;11;1.000;3600000;0
14432;86347;175;75;46;5;41;.891;3600000;0
14433;20122;172;0;0;0;0;.00nan;0;0
14433;181874;167;93;32;1;31;.969;3600000;0
14433;91225;167;0;0;0;0;.00nan;0;0
14433;92313;172;66;25;2;23;.920;3588000;0
14434;163462;1527;0;0;0;0;.00nan;0;0
14434;164987;169;49;36;5;31;.861;3600000;0
14434;194576;169;0;0;0;0;.00nan;0;0
14434;85228;1527;96;21;0;21;1.000;3600000;0
14435;173874;174;100;40;1;39;.975;3600000;0
14435;78864;170;0;0;0;0;.00nan;0;0
14435;79280;170;63;22;2;20;.909;3572000;0
14435;91703;174;0;0;0;0;.00nan;0;0
14436;163462;1527;0;0;0;0;.00nan;0;0
14436;191692;3916;0;0;0;0;.00nan;0;0
14436;85228;1527;76;18;1;17;.944;3600000;0
14436;149450;3916;73;31;2;29;.935;3588000;0
14437;2495;171;0;0;0;0;.00nan;0;0
14437;187657;4247;0;0;0;0;.00nan;0;0
14437;202059;171;100;32;1;31;.969;3600000;0
14437;85336;4247;96;44;2;42;.955;3563000;0
14438;173874;174;0;0;0;0;.00nan;0;0
14438;202246;175;0;0;0;0;.00nan;0;0
14438;86347;175;43;21;4;17;.810;3600000;0
14438;91703;174;85;36;2;34;.944;3600000;0
14439;20122;172;46;9;2;7;.778;3600000;0
14439;78864;170;71;37;4;33;.892;3555000;0
14439;79280;170;0;0;0;0;.00nan;0;0
14439;92313;172;0;0;0;0;.00nan;0;0
14440;187657;4247;0;0;0;0;.00nan;0;0
14440;173874;174;82;40;3;37;.925;3544000;0
14440;85336;4247;50;16;2;14;.875;3600000;0
14440;91703;174;0;0;0;0;.00nan;0;0
14441;181874;167;0;0;0;0;.00nan;0;0
14441;78864;170;93;51;4;47;.922;3600000;0
14441;79280;170;0;0;0;0;.00nan;0;0
14441;91225;167;73;22;1;21;.955;3600000;0
14442;2495;171;0;0;0;0;.00nan;0;0
14442;20122;172;0;0;0;0;.00nan;0;0
14442;202059;171;100;50;1;49;.980;3900000;0
14442;92313;172;71;20;1;19;.950;3900000;0
14443;164987;169;62;33;3;30;.909;3600000;0
14443;194576;169;0;0;0;0;.00nan;0;0
14443;202246;175;100;30;1;29;.967;3600000;0
14443;86347;175;0;0;0;0;.00nan;0;0
14444;163462;1527;0;0;0;0;.00nan;0;0
14444;191692;3916;86;36;2;34;.944;3600000;0
14444;85228;1527;42;27;5;22;.815;3600000;0
14444;149450;3916;0;0;0;0;.00nan;0;0
14445;163462;1527;69;20;2;18;.900;3600000;0
14445;191692;3916;49;17;2;15;.882;2418000;0
14445;85228;1527;0;0;0;0;.00nan;0;0
14445;149450;3916;27;15;4;11;.733;1182000;0
14446;187657;4247;64;11;1;10;.909;3600000;0
14446;173874;174;0;0;0;0;.00nan;0;0
14446;85336;4247;0;0;0;0;.00nan;0;0
14446;91703;174;66;49;5;44;.898;3600000;0
14447;2495;171;0;0;0;0;.00nan;0;0
14447;20122;172;65;23;2;21;.913;3600000;0
14447;202059;171;81;48;4;44;.917;3563000;0
14447;92313;172;0;0;0;0;.00nan;0;0
14448;181874;167;85;26;2;24;.923;3600000;0
14448;78864;170;0;0;0;0;.00nan;0;0
14448;79280;170;60;38;4;34;.895;3530000;0
14448;91225;167;0;0;0;0;.00nan;0;0
14449;164987;169;0;0;0;0;.00nan;0;0
14449;194576;169;78;25;1;24;.960;3600000;0
14449;202246;175;0;0;0;0;.00nan;0;0
14449;86347;175;63;28;3;25;.893;3521000;0
14450;20122;172;0;0;0;0;.00nan;0;0
14450;78864;170;66;41;5;36;.878;3549000;0
14450;79280;170;0;0;0;0;.00nan;0;0
14450;92313;172;51;20;3;17;.850;3600000;0
14451;187657;4247;0;0;0;0;.00nan;0;0
14451;164987;169;19;12;4;8;.667;961000;0
14451;194576;169;76;32;3;29;.906;2639000;0
14451;85336;4247;53;18;3;15;.833;3600000;0
14452;173874;174;58;29;4;25;.862;3600000;0
14452;202246;175;55;38;6;32;.842;3567000;0
14452;86347;175;0;0;0;0;.00nan;0;0
14452;91703;174;0;0;0;0;.00nan;0;0
14453;163462;1527;0;0;0;0;.00nan;0;0
14453;202246;175;0;0;0;0;.00nan;0;0
14453;85228;1527;63;32;3;29;.906;3600000;0
14453;86347;175;57;35;5;30;.857;3533000;0
14454;20122;172;51;21;3;18;.857;3767000;0
14454;191692;3916;0;0;0;0;.00nan;0;0
14454;92313;172;0;0;0;0;.00nan;0;0
14454;149450;3916;86;54;4;50;.926;3767000;0
14455;181874;167;0;0;0;0;.00nan;0;0
14455;78864;170;97;51;3;48;.941;3557000;0
14455;79280;170;0;0;0;0;.00nan;0;0
14455;91225;167;65;25;2;23;.920;3600000;0
14456;163462;1527;88;30;1;29;.967;3600000;0
14456;164987;169;0;0;0;0;.00nan;0;0
14456;194576;169;58;30;3;27;.900;3552000;0
14456;85228;1527;0;0;0;0;.00nan;0;0
14457;2495;171;0;0;0;0;.00nan;0;0
14457;202059;171;87;30;1;29;.967;3600000;0
14457;202246;175;54;38;5;33;.868;3600000;0
14457;86347;175;0;0;0;0;.00nan;0;0
14458;187657;4247;0;0;0;0;.00nan;0;0
14458;173874;174;51;39;6;33;.846;3600000;0
14458;85336;4247;86;37;2;35;.946;3600000;0
14458;91703;174;0;0;0;0;.00nan;0;0
14459;20122;172;0;0;0;0;.00nan;0;0
14459;78864;170;0;0;0;0;.00nan;0;0
14459;79280;170;92;38;2;36;.947;3600000;0
14459;92313;172;50;27;3;24;.889;3561000;0
14460;164987;169;57;28;3;25;.893;3600000;0
14460;194576;169;0;0;0;0;.00nan;0;0
14460;181874;167;77;24;1;23;.958;3600000;0
14460;91225;167;0;0;0;0;.00nan;0;0
14461;163462;1527;0;0;0;0;.00nan;0;0
14461;191692;3916;56;21;2;19;.905;3547000;0
14461;85228;1527;77;24;1;23;.958;3600000;0
14461;149450;3916;0;0;0;0;.00nan;0;0
14462;2495;171;66;32;3;29;.906;3600000;0
14462;202059;171;0;0;0;0;.00nan;0;0
14462;202246;175;0;0;0;0;.00nan;0;0
14462;86347;175;62;24;2;22;.917;3600000;0
14463;187657;4247;85;26;1;25;.962;3600000;0
14463;173874;174;0;0;0;0;.00nan;0;0
14463;85336;4247;0;0;0;0;.00nan;0;0
14463;91703;174;71;47;5;42;.894;3600000;0
14464;187657;4247;0;0;0;0;.00nan;0;0
14464;78864;170;62;37;5;32;.865;3600000;0
14464;79280;170;0;0;0;0;.00nan;0;0
14464;85336;4247;61;17;2;15;.882;3600000;0
14465;164987;169;0;0;0;0;.00nan;0;0
14465;194576;169;93;40;2;38;.950;3634000;0
14465;181874;167;0;0;0;0;.00nan;0;0
14465;91225;167;62;23;3;20;.870;3634000;0
14466;2495;171;0;0;0;0;.00nan;0;0
14466;202059;171;87;47;3;44;.936;3600000;0
14466;202246;175;0;0;0;0;.00nan;0;0
14466;86347;175;77;27;2;25;.926;3600000;0
14467;173874;174;79;33;2;31;.939;3874000;0
14467;191692;3916;0;0;0;0;.00nan;0;0
14467;91703;174;0;0;0;0;.00nan;0;0
14467;149450;3916;96;30;2;28;.933;3900000;0
14468;163462;1527;27;30;6;24;.800;2165000;0
14468;20122;172;0;0;0;0;.00nan;0;0
14468;85228;1527;68;20;1;19;.950;1435000;0
14468;92313;172;100;25;0;25;1.000;3600000;0
14469;187657;4247;42;25;4;21;.840;3900000;0
14469;78864;170;0;0;0;0;.00nan;0;0
14469;79280;170;69;33;4;29;.879;3900000;0
14469;85336;4247;0;0;0;0;.00nan;0;0
14470;164987;169;55;23;3;20;.870;3600000;0
14470;194576;169;0;0;0;0;.00nan;0;0
14470;181874;167;52;30;4;26;.867;3548000;0
14470;91225;167;0;0;0;0;.00nan;0;0
14471;2495;171;85;42;3;39;.929;3588000;0
14471;202059;171;0;0;0;0;.00nan;0;0
14471;202246;175;87;34;2;32;.941;3600000;0
14471;86347;175;0;0;0;0;.00nan;0;0
14472;173874;174;0;0;0;0;.00nan;0;0
14472;191692;3916;58;26;3;23;.885;3600000;0
14472;91703;174;30;16;4;12;.750;3559000;0
14472;149450;3916;0;0;0;0;.00nan;0;0
14473;163462;1527;0;0;0;0;.00nan;0;0
14473;20122;172;0;0;0;0;.00nan;0;0
14473;85228;1527;65;21;2;19;.905;3600000;0
14473;92313;172;68;31;3;28;.903;3574000;0
14474;2495;171;0;0;0;0;.00nan;0;0
14474;202059;171;70;33;3;30;.909;3545000;0
14474;202246;175;0;0;0;0;.00nan;0;0
14474;86347;175;85;25;1;24;.960;3600000;0
14475;191692;3916;0;0;0;0;.00nan;0;0
14475;78864;170;95;41;1;40;.976;3600000;0
14475;79280;170;0;0;0;0;.00nan;0;0
14475;149450;3916;41;25;5;20;.800;3600000;0
14476;164987;169;0;0;0;0;.00nan;0;0
14476;194576;169;16;15;5;10;.667;3525000;0
14476;173874;174;91;46;3;43;.935;3600000;0
14476;91703;174;0;0;0;0;.00nan;0;0
14477;164987;169;70;35;3;32;.914;3600000;0
14477;194576;169;0;0;0;0;.00nan;0;0
14477;20122;172;77;25;2;23;.920;3600000;0
14477;92313;172;0;0;0;0;.00nan;0;0
14478;181874;167;0;0;0;0;.00nan;0;0
14478;191692;3916;0;0;0;0;.00nan;0;0
14478;91225;167;69;22;1;21;.955;3600000;0
14478;149450;3916;80;38;3;35;.921;3554000;0
14479;169166;4247;0;0;0;0;.00nan;0;0
14479;202246;175;0;0;0;0;.00nan;0;0
14479;85336;4247;71;24;2;22;.917;3600000;0
14479;86347;175;73;31;3;28;.903;3569000;0
14480;2495;171;0;0;0;0;.00nan;0;0
14480;163462;1527;0;0;0;0;.00nan;0;0
14480;202059;171;53;43;6;37;.860;3600000;0
14480;85228;1527;94;21;0;21;1.000;3600000;0
14481;173874;174;61;25;2;23;.920;3600000;0
14481;78864;170;86;21;1;20;.952;3600000;0
14481;79280;170;0;0;0;0;.00nan;0;0
14481;91703;174;0;0;0;0;.00nan;0;0
14482;164987;169;0;0;0;0;.00nan;0;0
14482;194576;169;61;42;5;37;.881;3600000;0
14482;20122;172;0;0;0;0;.00nan;0;0
14482;92313;172;63;18;2;16;.889;3600000;0
14483;181874;167;83;24;1;23;.958;3600000;0
14483;191692;3916;51;41;5;36;.878;3600000;0
14483;91225;167;0;0;0;0;.00nan;0;0
14483;149450;3916;0;0;0;0;.00nan;0;0
14484;173874;174;0;0;0;0;.00nan;0;0
14484;78864;170;0;0;0;0;.00nan;0;0
14484;79280;170;43;24;4;20;.833;3570000;0
14484;91703;174;60;33;3;30;.909;3600000;0
14485;163462;1527;0;0;0;0;.00nan;0;0
14485;164987;169;68;35;3;32;.914;3600000;0
14485;194576;169;0;0;0;0;.00nan;0;0
14485;85228;1527;87;16;0;16;1.000;3600000;0
14486;169166;4247;63;35;4;31;.886;3599000;0
14486;202246;175;80;31;2;29;.935;3600000;0
14486;85336;4247;0;0;0;0;.00nan;0;0
14486;86347;175;0;0;0;0;.00nan;0;0
14487;2495;171;80;41;3;38;.927;3600000;0
14487;20122;172;54;27;4;23;.852;3582000;0
14487;202059;171;0;0;0;0;.00nan;0;0
14487;92313;172;0;0;0;0;.00nan;0;0
14488;181874;167;0;0;0;0;.00nan;0;0
14488;191692;3916;0;0;0;0;.00nan;0;0
14488;91225;167;70;21;1;20;.952;3600000;0
14488;149450;3916;59;35;4;31;.886;3600000;0
14489;169166;4247;69;28;3;25;.893;3600000;0
14489;191692;3916;0;0;0;0;.00nan;0;0
14489;85336;4247;0;0;0;0;.00nan;0;0
14489;149450;3916;66;40;5;35;.875;3577000;0
14490;2495;171;68;24;1;23;.958;2797000;0
14490;202059;171;18;8;4;4;.500;757000;0
14490;181874;167;0;0;0;0;.00nan;0;0
14490;91225;167;50;22;3;19;.864;3600000;0
14491;164987;169;37;16;4;12;.750;3585000;0
14491;194576;169;0;0;0;0;.00nan;0;0
14491;173874;174;88;36;2;34;.944;3600000;0
14491;91703;174;0;0;0;0;.00nan;0;0
14492;163462;1527;0;0;0;0;.00nan;0;0
14492;20122;172;0;0;0;0;.00nan;0;0
14492;85228;1527;61;29;3;26;.897;3600000;0
14492;92313;172;58;35;5;30;.857;3562000;0
14493;202246;175;0;0;0;0;.00nan;0;0
14493;78864;170;74;27;2;25;.926;3600000;0
14493;79280;170;0;0;0;0;.00nan;0;0
14493;86347;175;46;26;4;22;.846;3568000;0
14494;169166;4247;66;21;1;20;.952;3600000;0
14494;191692;3916;74;38;4;34;.895;3600000;0
14494;85336;4247;0;0;0;0;.00nan;0;0
14494;149450;3916;0;0;0;0;.00nan;0;0
14495;2495;171;0;0;0;0;.00nan;0;0
14495;202059;171;59;32;4;28;.875;3900000;0
14495;181874;167;47;30;4;26;.867;3900000;0
14495;91225;167;0;0;0;0;.00nan;0;0
14496;164987;169;0;0;0;0;.00nan;0;0
14496;194576;169;57;20;2;18;.900;3600000;0
14496;173874;174;0;0;0;0;.00nan;0;0
14496;91703;174;57;41;5;36;.878;3600000;0
14497;163462;1527;0;0;0;0;.00nan;0;0
14497;20122;172;61;37;5;32;.865;3600000;0
14497;85228;1527;90;37;2;35;.946;3600000;0
14497;92313;172;0;0;0;0;.00nan;0;0
14498;202246;175;78;31;2;29;.935;3600000;0
14498;78864;170;0;0;0;0;.00nan;0;0
14498;79280;170;65;41;4;37;.902;3516000;0
14498;86347;175;0;0;0;0;.00nan;0;0
14499;164987;169;0;0;0;0;.00nan;0;0
14499;194576;169;71;22;1;21;.955;3600000;0
14499;191692;3916;76;33;3;30;.909;3572000;0
14499;149450;3916;0;0;0;0;.00nan;0;0
14500;169166;4247;49;20;4;16;.800;3600000;0
14500;173874;174;47;41;6;35;.854;2770000;0
14500;85336;4247;0;0;0;0;.00nan;0;0
14500;91703;174;59;13;1;12;.923;830000;0
14501;20122;172;0;0;0;0;.00nan;0;0
14501;202246;175;0;0;0;0;.00nan;0;0
14501;86347;175;73;34;3;31;.912;3900000;0
14501;92313;172;79;32;3;29;.906;3891000;0
14502;163462;1527;0;0;0;0;.00nan;0;0
14502;191692;3916;0;0;0;0;.00nan;0;0
14502;85228;1527;78;22;1;21;.955;3600000;0
14502;149450;3916;80;42;2;40;.952;3553000;0
14503;2495;171;0;0;0;0;.00nan;0;0
14503;173874;174;60;35;4;31;.886;3697000;0
14503;202059;171;47;33;5;28;.848;3696000;0
14503;91703;174;0;0;0;0;.00nan;0;0
14504;169166;4247;61;15;1;14;.933;3600000;0
14504;78864;170;88;53;3;50;.943;3600000;0
14504;79280;170;0;0;0;0;.00nan;0;0
14504;85336;4247;0;0;0;0;.00nan;0;0
14505;202246;175;65;36;4;32;.889;3600000;0
14505;181874;167;0;0;0;0;.00nan;0;0
14505;86347;175;0;0;0;0;.00nan;0;0
14505;91225;167;31;30;6;24;.800;3518000;0
14506;164987;169;98;56;3;53;.946;3600000;0
14506;194576;169;0;0;0;0;.00nan;0;0
14506;20122;172;92;15;0;15;1.000;3600000;0
14506;92313;172;0;0;0;0;.00nan;0;0
14507;2495;171;0;0;0;0;.00nan;0;0
14507;173874;174;88;38;2;36;.947;3600000;0
14507;202059;171;39;21;4;17;.810;3514000;0
14507;91703;174;0;0;0;0;.00nan;0;0
14508;169166;4247;63;30;4;26;.867;3900000;0
14508;78864;170;0;0;0;0;.00nan;0;0
14508;79280;170;63;29;4;25;.862;3900000;0
14508;85336;4247;0;0;0;0;.00nan;0;0
14509;163462;1527;0;0;0;0;.00nan;0;0
14509;164987;169;0;0;0;0;.00nan;0;0
14509;194576;169;54;19;2;17;.895;3600000;0
14509;85228;1527;25;20;5;15;.750;3600000;0
14510;202246;175;0;0;0;0;.00nan;0;0
14510;181874;167;68;25;2;23;.920;3600000;0
14510;86347;175;52;39;5;34;.872;3600000;0
14510;91225;167;0;0;0;0;.00nan;0;0
14511;20122;172;61;14;1;13;.929;3600000;0
14511;191692;3916;92;47;4;43;.915;3600000;0
14511;92313;172;0;0;0;0;.00nan;0;0
14511;149450;3916;0;0;0;0;.00nan;0;0
14512;169166;4247;52;14;2;12;.857;3600000;0
14512;191692;3916;0;0;0;0;.00nan;0;0
14512;85336;4247;0;0;0;0;.00nan;0;0
14512;149450;3916;61;48;6;42;.875;3600000;0
14513;181874;167;58;20;2;18;.900;3600000;0
14513;78864;170;52;40;6;34;.850;3600000;0
14513;79280;170;0;0;0;0;.00nan;0;0
14513;91225;167;0;0;0;0;.00nan;0;0
14514;164987;169;92;43;3;40;.930;3597000;0
14514;194576;169;0;0;0;0;.00nan;0;0
14514;20122;172;0;0;0;0;.00nan;0;0
14514;92313;172;74;16;1;15;.938;3600000;0
14515;2495;171;0;0;0;0;.00nan;0;0
14515;163462;1527;0;0;0;0;.00nan;0;0
14515;202059;171;71;28;3;25;.893;3533000;0
14515;85228;1527;72;23;1;22;.957;3600000;0
14516;173874;174;65;36;3;33;.917;3600000;0
14516;202246;175;0;0;0;0;.00nan;0;0
14516;86347;175;87;17;0;17;1.000;3600000;0
14516;91703;174;0;0;0;0;.00nan;0;0
14517;169166;4247;60;24;2;22;.917;3600000;0
14517;191692;3916;96;41;3;38;.927;3568000;0
14517;85336;4247;0;0;0;0;.00nan;0;0
14517;149450;3916;0;0;0;0;.00nan;0;0
14518;20122;172;55;11;1;10;.909;3600000;0
14518;78864;170;0;0;0;0;.00nan;0;0
14518;79280;170;80;48;4;44;.917;3600000;0
14518;92313;172;0;0;0;0;.00nan;0;0
14519;164987;169;0;0;0;0;.00nan;0;0
14519;194576;169;94;42;2;40;.952;3600000;0
14519;181874;167;0;0;0;0;.00nan;0;0
14519;91225;167;65;29;3;26;.897;3600000;0
14520;2495;171;25;5;3;2;.400;366000;0
14520;163462;1527;0;0;0;0;.00nan;0;0
14520;202059;171;41;33;5;28;.848;3234000;0
14520;85228;1527;91;33;1;32;.970;3600000;0
14521;173874;174;73;37;3;34;.919;3600000;0
14521;202246;175;0;0;0;0;.00nan;0;0
14521;86347;175;92;15;0;15;1.000;3600000;0
14521;91703;174;0;0;0;0;.00nan;0;0
14522;169166;4247;49;25;4;21;.840;3600000;0
14522;173874;174;49;39;6;33;.846;3514000;0
14522;85336;4247;0;0;0;0;.00nan;0;0
14522;91703;174;0;0;0;0;.00nan;0;0
14523;20122;172;0;0;0;0;.00nan;0;0
14523;169166;4247;30;30;7;23;.767;3600000;0
14523;85336;4247;0;0;0;0;.00nan;0;0
14523;92313;172;90;26;1;25;.962;3600000;0
14524;202246;175;0;0;0;0;.00nan;0;0
14524;181874;167;43;22;4;18;.818;3600000;0
14524;86347;175;91;42;2;40;.952;3600000;0
14524;91225;167;0;0;0;0;.00nan;0;0
14525;2495;171;0;0;0;0;.00nan;0;0
14525;202059;171;36;22;4;18;.818;3600000;0
14525;191692;3916;0;0;0;0;.00nan;0;0
14525;149450;3916;75;29;2;27;.931;3600000;0
14526;164987;169;78;26;1;25;.962;3600000;0
14526;194576;169;0;0;0;0;.00nan;0;0
14526;78864;170;60;34;4;30;.882;3600000;0
14526;79280;170;0;0;0;0;.00nan;0;0
14527;163462;1527;0;0;0;0;.00nan;0;0
14527;173874;174;100;48;1;47;.979;3600000;0
14527;85228;1527;71;24;2;22;.917;3600000;0
14527;91703;174;0;0;0;0;.00nan;0;0
14528;20122;172;61;32;4;28;.875;3549000;0
14528;169166;4247;75;33;3;30;.909;3600000;0
14528;85336;4247;0;0;0;0;.00nan;0;0
14528;92313;172;0;0;0;0;.00nan;0;0
14529;202246;175;91;35;2;33;.943;3600000;0
14529;181874;167;0;0;0;0;.00nan;0;0
14529;86347;175;0;0;0;0;.00nan;0;0
14529;91225;167;74;36;3;33;.917;3566000;0
14530;2495;171;0;0;0;0;.00nan;0;0
14530;202059;171;55;35;4;31;.886;3900000;0
14530;191692;3916;99;56;4;52;.929;3900000;0
14530;149450;3916;0;0;0;0;.00nan;0;0
14531;164987;169;76;42;4;38;.905;3600000;0
14531;194576;169;0;0;0;0;.00nan;0;0
14531;78864;170;0;0;0;0;.00nan;0;0
14531;79280;170;83;27;1;26;.963;3600000;0
14532;163462;1527;63;17;2;15;.882;3709000;0
14532;173874;174;77;34;3;31;.912;3709000;0
14532;85228;1527;0;0;0;0;.00nan;0;0
14532;91703;174;0;0;0;0;.00nan;0;0
14533;202246;175;57;12;1;11;.917;863000;0
14533;181874;167;22;31;6;25;.806;3900000;0
14533;86347;175;45;33;5;28;.848;3027000;0
14533;91225;167;0;0;0;0;.00nan;0;0
14534;2495;171;88;27;1;26;.963;3600000;0
14534;202059;171;0;0;0;0;.00nan;0;0
14534;78864;170;64;33;3;30;.909;3531000;0
14534;79280;170;0;0;0;0;.00nan;0;0
14535;163462;1527;0;0;0;0;.00nan;0;0
14535;173874;174;76;44;5;39;.886;3600000;0
14535;85228;1527;66;20;1;19;.950;3600000;0
14535;91703;174;0;0;0;0;.00nan;0;0
14536;169166;4247;97;22;0;22;1.000;3600000;0
14536;191692;3916;0;0;0;0;.00nan;0;0
14536;85336;4247;0;0;0;0;.00nan;0;0
14536;149450;3916;79;36;3;33;.917;3600000;0
14537;164987;169;74;30;2;28;.933;3012000;0
14537;194576;169;32;10;3;7;.700;588000;0
14537;20122;172;74;26;2;24;.923;3600000;0
14537;92313;172;0;0;0;0;.00nan;0;0
14538;164987;169;66;20;2;18;.900;3600000;0
14538;194576;169;0;0;0;0;.00nan;0;0
14538;191692;3916;0;0;0;0;.00nan;0;0
14538;149450;3916;71;36;3;33;.917;3546000;0
14539;169166;4247;74;28;2;26;.929;3676000;0
14539;202246;175;0;0;0;0;.00nan;0;0
14539;85336;4247;0;0;0;0;.00nan;0;0
14539;86347;175;79;36;3;33;.917;3676000;0
14540;163462;1527;0;0;0;0;.00nan;0;0
14540;78864;170;0;0;0;0;.00nan;0;0
14540;79280;170;93;43;3;40;.930;3584000;0
14540;85228;1527;75;33;2;31;.939;3600000;0
14541;173874;174;61;43;5;38;.884;3513000;0
14541;181874;167;48;23;3;20;.870;3600000;0
14541;91225;167;0;0;0;0;.00nan;0;0
14541;91703;174;0;0;0;0;.00nan;0;0
14542;2495;171;0;0;0;0;.00nan;0;0
14542;20122;172;0;0;0;0;.00nan;0;0
14542;202059;171;51;37;6;31;.838;3600000;0
14542;92313;172;69;18;1;17;.944;3600000;0
14543;164987;169;0;0;0;0;.00nan;0;0
14543;194576;169;53;26;4;22;.846;3900000;0
14543;191692;3916;77;45;4;41;.911;3900000;0
14543;149450;3916;0;0;0;0;.00nan;0;0
14544;163462;1527;0;0;0;0;.00nan;0;0
14544;78864;170;93;39;2;37;.949;3513000;0
14544;79280;170;0;0;0;0;.00nan;0;0
14544;85228;1527;96;23;0;23;1.000;3600000;0
14545;169166;4247;84;34;2;32;.941;3600000;0
14545;202246;175;60;27;3;24;.889;3597000;0
14545;85336;4247;0;0;0;0;.00nan;0;0
14545;86347;175;0;0;0;0;.00nan;0;0
14546;173874;174;52;38;5;33;.868;3600000;0
14546;181874;167;0;0;0;0;.00nan;0;0
14546;91225;167;86;38;2;36;.947;3600000;0
14546;91703;174;0;0;0;0;.00nan;0;0
14547;2495;171;0;0;0;0;.00nan;0;0
14547;20122;172;81;35;2;33;.943;3600000;0
14547;202059;171;65;30;3;27;.900;3600000;0
14547;92313;172;0;0;0;0;.00nan;0;0
14548;173874;174;81;45;3;42;.933;3900000;0
14548;181874;167;57;21;3;18;.857;3900000;0
14548;91225;167;0;0;0;0;.00nan;0;0
14548;91703;174;0;0;0;0;.00nan;0;0
14549;2495;171;0;0;0;0;.00nan;0;0
14549;202059;171;76;23;1;22;.957;3900000;0
14549;78864;170;0;0;0;0;.00nan;0;0
14549;79280;170;100;38;1;37;.974;3900000;0
14550;202246;175;0;0;0;0;.00nan;0;0
14550;191692;3916;66;28;3;25;.893;3600000;0
14550;86347;175;96;34;1;33;.971;3600000;0
14550;149450;3916;0;0;0;0;.00nan;0;0
14551;163462;1527;0;0;0;0;.00nan;0;0
14551;181874;167;57;35;4;31;.886;3514000;0
14551;85228;1527;65;27;2;25;.926;3600000;0
14551;91225;167;0;0;0;0;.00nan;0;0
14552;2495;171;78;41;3;38;.927;3600000;0
14552;164987;169;55;32;5;27;.844;3575000;0
14552;194576;169;0;0;0;0;.00nan;0;0
14552;202059;171;0;0;0;0;.00nan;0;0
14553;20122;172;85;38;3;35;.921;3600000;0
14553;78864;170;53;41;6;35;.854;3346000;0
14553;79280;170;48;0;0;0;.00nan;254000;0
14553;92313;172;0;0;0;0;.00nan;0;0
14554;169166;4247;57;26;3;23;.885;3600000;0
14554;173874;174;45;24;4;20;.833;3599000;0
14554;85336;4247;0;0;0;0;.00nan;0;0
14554;91703;174;0;0;0;0;.00nan;0;0
14555;202246;175;0;0;0;0;.00nan;0;0
14555;191692;3916;54;4;0;4;1.000;750000;0
14555;86347;175;80;31;2;29;.935;3600000;0
14555;149450;3916;45;30;6;24;.800;2850000;0
14556;163462;1527;46;28;4;24;.857;3600000;0
14556;181874;167;24;30;7;23;.767;3119000;0
14556;85228;1527;0;0;0;0;.00nan;0;0
14556;91225;167;60;6;0;6;1.000;481000;0
14557;20122;172;0;0;0;0;.00nan;0;0
14557;78864;170;53;6;1;5;.833;490000;0
14557;79280;170;59;45;6;39;.867;3110000;0
14557;92313;172;71;9;0;9;1.000;3600000;0
14558;2495;171;0;0;0;0;.00nan;0;0
14558;164987;169;0;0;0;0;.00nan;0;0
14558;194576;169;53;17;2;15;.882;3600000;0
14558;202059;171;46;35;5;30;.857;3600000;0
14559;169166;4247;53;22;3;19;.864;3600000;0
14559;173874;174;39;40;6;34;.850;3073000;0
14559;85336;4247;0;0;0;0;.00nan;0;0
14559;91703;174;56;5;0;5;1.000;527000;0
14560;2495;171;0;0;0;0;.00nan;0;0
14560;169166;4247;87;29;2;27;.931;3600000;0
14560;202059;171;66;49;5;44;.898;3600000;0
14560;85336;4247;0;0;0;0;.00nan;0;0
14561;181874;167;42;14;3;11;.786;3600000;0
14561;191692;3916;84;52;4;48;.923;3600000;0
14561;91225;167;0;0;0;0;.00nan;0;0
14561;149450;3916;0;0;0;0;.00nan;0;0
14562;164987;169;99;24;0;24;1.000;3600000;0
14562;194576;169;0;0;0;0;.00nan;0;0
14562;173874;174;63;24;2;22;.917;3529000;0
14562;91703;174;0;0;0;0;.00nan;0;0
14563;163462;1527;0;0;0;0;.00nan;0;0
14563;202246;175;0;0;0;0;.00nan;0;0
14563;85228;1527;89;26;1;25;.962;3600000;0
14563;86347;175;79;33;2;31;.939;3541000;0
14564;20122;172;0;0;0;0;.00nan;0;0
14564;78864;170;0;0;0;0;.00nan;0;0
14564;79280;170;89;42;2;40;.952;3518000;0
14564;92313;172;82;17;0;17;1.000;3600000;0
14565;2495;171;96;48;3;45;.938;3900000;0
14565;169166;4247;60;22;3;19;.864;3900000;0
14565;202059;171;0;0;0;0;.00nan;0;0
14565;85336;4247;0;0;0;0;.00nan;0;0
14566;181874;167;0;0;0;0;.00nan;0;0
14566;191692;3916;0;0;0;0;.00nan;0;0
14566;91225;167;68;22;1;21;.955;3600000;0
14566;149450;3916;83;33;2;31;.939;3559000;0
14567;164987;169;51;30;5;25;.833;3600000;0
14567;194576;169;0;0;0;0;.00nan;0;0
14567;173874;174;0;0;0;0;.00nan;0;0
14567;91703;174;93;48;2;46;.958;3600000;0
14568;163462;1527;0;0;0;0;.00nan;0;0
14568;202246;175;53;31;4;27;.871;3900000;0
14568;85228;1527;75;43;4;39;.907;3900000;0
14568;86347;175;0;0;0;0;.00nan;0;0
14569;20122;172;0;0;0;0;.00nan;0;0
14569;78864;170;88;32;1;31;.969;3600000;0
14569;79280;170;0;0;0;0;.00nan;0;0
14569;92313;172;50;34;5;29;.853;3600000;0
14570;163462;1527;0;0;0;0;.00nan;0;0
14570;169166;4247;54;11;1;10;.909;3554000;0
14570;85228;1527;100;33;0;33;1.000;3600000;0
14570;85336;4247;0;0;0;0;.00nan;0;0
14571;20122;172;83;26;1;25;.962;3600000;0
14571;181874;167;55;26;3;23;.885;3559000;0
14571;91225;167;0;0;0;0;.00nan;0;0
14571;92313;172;0;0;0;0;.00nan;0;0
14572;164987;169;72;32;2;30;.938;3600000;0
14572;194576;169;0;0;0;0;.00nan;0;0
14572;169166;4247;54;33;4;29;.879;3582000;0
14572;85336;4247;0;0;0;0;.00nan;0;0
14573;181874;167;0;0;0;0;.00nan;0;0
14573;78864;170;0;0;0;0;.00nan;0;0
14573;79280;170;71;38;3;35;.921;3600000;0
14573;91225;167;52;37;5;32;.865;3531000;0
14574;2495;171;0;0;0;0;.00nan;0;0
14574;163462;1527;0;0;0;0;.00nan;0;0
14574;202059;171;91;40;2;38;.950;3802000;0
14574;85228;1527;90;26;1;25;.962;3802000;0
14575;173874;174;46;32;6;26;.813;2439000;0
14575;202246;175;0;0;0;0;.00nan;0;0
14575;86347;175;77;30;2;28;.933;3600000;0
14575;91703;174;59;13;1;12;.923;1161000;0
14576;20122;172;67;12;0;12;1.000;1213000;0
14576;191692;3916;0;0;0;0;.00nan;0;0
14576;92313;172;33;19;4;15;.789;2387000;0
14576;149450;3916;100;41;0;41;1.000;3600000;0
14577;164987;169;0;0;0;0;.00nan;0;0
14577;194576;169;51;30;4;26;.867;3600000;0
14577;169166;4247;61;25;3;22;.880;3600000;0
14577;85336;4247;0;0;0;0;.00nan;0;0
14578;2495;171;29;28;6;22;.786;3334000;0
14578;163462;1527;70;20;1;19;.950;3600000;0
14578;202059;171;48;0;0;0;.00nan;266000;0
14578;85228;1527;0;0;0;0;.00nan;0;0
14579;181874;167;53;35;5;30;.857;3600000;0
14579;78864;170;90;39;2;37;.949;3600000;0
14579;79280;170;0;0;0;0;.00nan;0;0
14579;91225;167;0;0;0;0;.00nan;0;0
14580;173874;174;80;32;2;30;.938;3900000;0
14580;202246;175;0;0;0;0;.00nan;0;0
14580;86347;175;84;33;2;31;.939;3900000;0
14580;91703;174;0;0;0;0;.00nan;0;0
14581;20122;172;37;22;5;17;.773;3544000;0
14581;191692;3916;89;44;3;41;.932;3600000;0
14581;92313;172;0;0;0;0;.00nan;0;0
14581;149450;3916;0;0;0;0;.00nan;0;0
14582;181874;167;68;26;2;24;.923;3600000;0
14582;191692;3916;82;41;3;38;.927;3584000;0
14582;91225;167;0;0;0;0;.00nan;0;0
14582;149450;3916;0;0;0;0;.00nan;0;0
14583;2495;171;0;0;0;0;.00nan;0;0
14583;202059;171;65;27;2;25;.926;3600000;0
14583;78864;170;0;0;0;0;.00nan;0;0
14583;79280;170;96;41;1;40;.976;3600000;0
14584;163462;1527;0;0;0;0;.00nan;0;0
14584;164987;169;19;7;4;3;.429;841000;0
14584;194576;169;49;31;4;27;.871;2759000;0
14584;85228;1527;95;20;0;20;1.000;3600000;0
14585;169166;4247;59;21;3;18;.857;3600000;0
14585;202246;175;63;9;0;9;1.000;489000;0
14585;85336;4247;0;0;0;0;.00nan;0;0
14585;86347;175;46;43;6;37;.860;3111000;0
14586;20122;172;0;0;0;0;.00nan;0;0
14586;173874;174;77;36;3;33;.917;3731000;0
14586;91703;174;0;0;0;0;.00nan;0;0
14586;92313;172;50;15;2;13;.867;3731000;0
14587;191692;3916;0;0;0;0;.00nan;0;0
14587;78864;170;56;28;4;24;.857;3900000;0
14587;79280;170;0;0;0;0;.00nan;0;0
14587;149450;3916;59;33;4;29;.879;3900000;0
14588;2495;171;33;17;4;13;.765;1142000;0
14588;202059;171;66;21;2;19;.905;2458000;0
14588;181874;167;0;0;0;0;.00nan;0;0
14588;91225;167;65;30;3;27;.900;3600000;0
14589;163462;1527;0;0;0;0;.00nan;0;0
14589;164987;169;94;23;0;23;1.000;3600000;0
14589;194576;169;0;0;0;0;.00nan;0;0
14589;85228;1527;72;29;2;27;.931;3520000;0
14590;169166;4247;0;0;0;0;.00nan;0;0
14590;202246;175;48;6;1;5;.833;416000;0
14590;85336;4247;100;31;0;31;1.000;3600000;0
14590;86347;175;49;40;6;34;.850;3184000;0
14591;20122;172;74;13;1;12;.923;3900000;0
14591;173874;174;0;0;0;0;.00nan;0;0
14591;91703;174;96;40;1;39;.975;3900000;0
14591;92313;172;0;0;0;0;.00nan;0;0
14592;163462;1527;0;0;0;0;.00nan;0;0
14592;169166;4247;100;35;1;34;.971;3900000;0
14592;85228;1527;92;31;1;30;.968;3900000;0
14592;85336;4247;0;0;0;0;.00nan;0;0
14593;20122;172;0;0;0;0;.00nan;0;0
14593;181874;167;57;41;5;36;.878;3600000;0
14593;91225;167;0;0;0;0;.00nan;0;0
14593;92313;172;68;24;2;22;.917;3600000;0
14594;2495;171;0;0;0;0;.00nan;0;0
14594;202059;171;97;25;0;25;1.000;3600000;0
14594;78864;170;0;0;0;0;.00nan;0;0
14594;79280;170;89;31;1;30;.968;3600000;0
14595;164987;169;72;27;2;25;.926;3563000;0
14595;194576;169;0;0;0;0;.00nan;0;0
14595;191692;3916;72;20;1;19;.950;3600000;0
14595;149450;3916;0;0;0;0;.00nan;0;0
14596;173874;174;64;35;4;31;.886;3600000;0
14596;202246;175;0;0;0;0;.00nan;0;0
14596;86347;175;40;11;3;8;.727;3600000;0
14596;91703;174;0;0;0;0;.00nan;0;0
14597;163462;1527;66;25;2;23;.920;3600000;0
14597;169166;4247;43;27;5;22;.815;3600000;0
14597;85228;1527;0;0;0;0;.00nan;0;0
14597;85336;4247;0;0;0;0;.00nan;0;0
14598;20122;172;73;39;4;35;.897;3584000;0
14598;181874;167;0;0;0;0;.00nan;0;0
14598;91225;167;72;27;2;25;.926;3600000;0
14598;92313;172;0;0;0;0;.00nan;0;0
14599;2495;171;0;0;0;0;.00nan;0;0
14599;202059;171;72;28;3;25;.893;3573000;0
14599;78864;170;75;30;2;28;.933;3600000;0
14599;79280;170;0;0;0;0;.00nan;0;0
14600;164987;169;0;0;0;0;.00nan;0;0
14600;194576;169;85;43;3;40;.930;3698000;0
14600;191692;3916;0;0;0;0;.00nan;0;0
14600;149450;3916;58;23;2;21;.913;3698000;0
14601;173874;174;0;0;0;0;.00nan;0;0
14601;202246;175;69;28;2;26;.929;3600000;0
14601;86347;175;0;0;0;0;.00nan;0;0
14601;91703;174;62;28;3;25;.893;3600000;0
14602;163462;1527;0;0;0;0;.00nan;0;0
14602;164987;169;71;29;3;26;.897;3567000;0
14602;194576;169;0;0;0;0;.00nan;0;0
14602;85228;1527;75;27;2;25;.926;3600000;0
14603;169166;4247;96;40;2;38;.950;3900000;0
14603;191692;3916;92;31;2;29;.935;3900000;0
14603;85336;4247;0;0;0;0;.00nan;0;0
14603;149450;3916;0;0;0;0;.00nan;0;0
14604;20122;172;0;0;0;0;.00nan;0;0
14604;78864;170;97;62;5;57;.919;3600000;0
14604;79280;170;0;0;0;0;.00nan;0;0
14604;92313;172;57;16;2;14;.875;3600000;0
14605;2495;171;0;0;0;0;.00nan;0;0
14605;164987;169;0;0;0;0;.00nan;0;0
14605;194576;169;91;35;1;34;.971;3600000;0
14605;202059;171;67;34;4;30;.882;3600000;0
14606;163462;1527;0;0;0;0;.00nan;0;0
14606;181874;167;69;31;1;30;.968;3900000;0
14606;85228;1527;68;23;1;22;.957;3900000;0
14606;91225;167;0;0;0;0;.00nan;0;0
14607;173874;174;65;23;3;20;.870;3900000;0
14607;202246;175;0;0;0;0;.00nan;0;0
14607;86347;175;73;40;3;37;.925;3900000;0
14607;91703;174;0;0;0;0;.00nan;0;0
14608;169166;4247;0;0;0;0;.00nan;0;0
14608;191692;3916;0;0;0;0;.00nan;0;0
14608;85336;4247;59;29;3;26;.897;3600000;0
14608;149450;3916;21;32;7;25;.781;3600000;0
14609;2495;171;63;41;5;36;.878;3594000;0
14609;164987;169;68;36;4;32;.889;3600000;0
14609;194576;169;0;0;0;0;.00nan;0;0
14609;202059;171;0;0;0;0;.00nan;0;0
14610;163462;1527;79;22;1;21;.955;3600000;0
14610;181874;167;0;0;0;0;.00nan;0;0
14610;85228;1527;0;0;0;0;.00nan;0;0
14610;91225;167;60;33;3;30;.909;3529000;0
14611;173874;174;49;16;2;14;.875;1907000;0
14611;202246;175;83;28;2;26;.929;3600000;0
14611;86347;175;0;0;0;0;.00nan;0;0
14611;91703;174;32;22;5;17;.773;1693000;0
14612;20122;172;58;19;2;17;.895;3899000;0
14612;78864;170;0;0;0;0;.00nan;0;0
14612;79280;170;78;27;2;25;.926;3900000;0
14612;92313;172;0;0;0;0;.00nan;0;0
14614;173874;174;0;0;0;0;.00nan;0;0
14614;78864;170;62;27;3;24;.889;3600000;0
14614;79280;170;0;0;0;0;.00nan;0;0
14614;91703;174;60;39;5;34;.872;3542000;0
14616;20122;172;89;20;0;20;1.000;3600000;0
14616;171608;167;0;0;0;0;.00nan;0;0
14616;181874;167;79;38;3;35;.921;3600000;0
14616;92313;172;0;0;0;0;.00nan;0;0
14618;2495;171;0;0;0;0;.00nan;0;0
14618;202059;171;86;26;1;25;.962;3600000;0
14618;202246;175;0;0;0;0;.00nan;0;0
14618;86347;175;61;37;4;33;.892;3600000;0
14620;164987;169;37;30;5;25;.833;3600000;0
14620;194576;169;0;0;0;0;.00nan;0;0
14620;191692;3916;0;0;0;0;.00nan;0;0
14620;149450;3916;84;33;2;31;.939;3600000;0
14622;187657;4247;88;29;1;28;.966;3600000;0
14622;163462;1527;0;0;0;0;.00nan;0;0
14622;85228;1527;69;26;2;24;.923;3549000;0
14622;85336;4247;0;0;0;0;.00nan;0;0
2002;2495;171;0;0;0;0;.00nan;0;0
2002;163462;1527;0;0;0;0;.00nan;0;0
2002;202059;171;58;38;5;33;.868;3586000;0
2002;85228;1527;66;32;4;28;.875;3600000;0
2003;169166;4247;87;35;2;33;.943;3757000;0
2003;78864;170;65;26;3;23;.885;3757000;0
2003;79280;170;0;0;0;0;.00nan;0;0
2003;85336;4247;0;0;0;0;.00nan;0;0
2004;164987;169;88;38;2;36;.947;3600000;0
2004;194576;169;0;0;0;0;.00nan;0;0
2004;20122;172;0;0;0;0;.00nan;0;0
2004;92313;172;62;27;3;24;.889;3544000;0
2005;202246;175;0;0;0;0;.00nan;0;0
2005;181874;167;63;21;2;19;.905;3600000;0
2005;86347;175;86;48;3;45;.938;3583000;0
2005;91225;167;0;0;0;0;.00nan;0;0
2006;2495;171;0;0;0;0;.00nan;0;0
2006;163462;1527;0;0;0;0;.00nan;0;0
2006;202059;171;69;53;4;49;.925;5006000;0
2006;85228;1527;75;40;3;37;.925;5006000;0
2007;169166;4247;56;32;4;28;.875;3600000;0
2007;78864;170;72;26;2;24;.923;3600000;0
2007;79280;170;0;0;0;0;.00nan;0;0
2007;85336;4247;0;0;0;0;.00nan;0;0
2008;164987;169;85;48;4;44;.917;3588000;0
2008;194576;169;0;0;0;0;.00nan;0;0
2008;20122;172;70;22;2;20;.909;3600000;0
2008;92313;172;0;0;0;0;.00nan;0;0
2009;202246;175;0;0;0;0;.00nan;0;0
2009;181874;167;58;35;4;31;.886;3585000;0
2009;86347;175;72;23;2;21;.913;3600000;0
2009;91225;167;0;0;0;0;.00nan;0;0
2164;169166;4247;67;31;3;28;.903;3521000;0
2164;78864;170;99;43;1;42;.977;3600000;0
2164;79280;170;0;0;0;0;.00nan;0;0
2164;85336;4247;0;0;0;0;.00nan;0;0
2165;164987;169;73;37;3;34;.919;4407000;0
2165;194576;169;0;0;0;0;.00nan;0;0
2165;20122;172;59;19;2;17;.895;4407000;0
2165;92313;172;0;0;0;0;.00nan;0;0
2166;202246;175;0;0;0;0;.00nan;0;0
2166;181874;167;54;18;2;16;.889;3600000;0
2166;86347;175;59;47;5;42;.894;3600000;0
2166;91225;167;0;0;0;0;.00nan;0;0
2198;163462;1527;0;0;0;0;.00nan;0;0
2198;78864;170;78;37;4;33;.892;3600000;0
2198;79280;170;0;0;0;0;.00nan;0;0
2198;85228;1527;58;18;2;16;.889;3600000;0
2199;20122;172;69;24;2;22;.917;3544000;0
2199;181874;167;99;45;1;44;.978;3600000;0
2199;91225;167;0;0;0;0;.00nan;0;0
2199;92313;172;0;0;0;0;.00nan;0;0
2200;163462;1527;0;0;0;0;.00nan;0;0
2200;78864;170;72;40;4;36;.900;3587000;0
2200;79280;170;0;0;0;0;.00nan;0;0
2200;85228;1527;57;26;3;23;.885;3600000;0
2201;20122;172;37;33;6;27;.818;3937000;0
2201;181874;167;46;30;5;25;.833;3937000;0
2201;91225;167;0;0;0;0;.00nan;0;0
2201;92313;172;0;0;0;0;.00nan;0;0
2358;163462;1527;0;0;0;0;.00nan;0;0
2358;181874;167;68;18;1;17;.944;3555000;0
2358;85228;1527;94;19;0;19;1.000;3600000;0
2358;91225;167;0;0;0;0;.00nan;0;0
2359;163462;1527;0;0;0;0;.00nan;0;0
2359;181874;167;77;36;3;33;.917;4343000;0
2359;85228;1527;86;47;4;43;.915;4343000;0
2359;91225;167;0;0;0;0;.00nan;0;0
2463;163462;1527;0;0;0;0;.00nan;0;0
2463;181874;167;99;38;2;36;.947;3620000;0
2463;85228;1527;62;27;3;24;.889;3620000;0
2463;91225;167;0;0;0;0;.00nan;0;0
14623;194390;441;56;30;4;26;.867;3600000;0
14623;190157;442;1;20;9;11;.550;1689000;0
14623;191713;441;0;0;0;0;.00nan;0;0
14623;191849;442;45;13;2;11;.846;1911000;0
14624;188965;423;41;38;6;32;.842;3242000;0
14624;179071;423;54;5;0;5;1.000;358000;0
14624;179127;422;65;24;2;22;.917;3600000;0
14624;180578;422;0;0;0;0;.00nan;0;0
14625;168414;444;41;32;5;27;.844;3600000;0
14625;194630;444;0;0;0;0;.00nan;0;0
14625;189288;419;0;0;0;0;.00nan;0;0
14625;196975;419;80;27;2;25;.926;3600000;0
14626;188965;423;0;0;0;0;.00nan;0;0
14626;179071;423;63;31;3;28;.903;3600000;0
14626;179127;422;100;27;0;27;1.000;3600000;0
14626;180578;422;0;0;0;0;.00nan;0;0
14627;168414;444;100;38;1;37;.974;4200000;0
14627;194630;444;0;0;0;0;.00nan;0;0
14627;189288;419;0;0;0;0;.00nan;0;0
14627;196975;419;92;29;1;28;.966;4200000;0
14628;199892;421;0;0;0;0;.00nan;0;0
14628;179169;421;79;27;2;25;.926;3600000;0
14628;207137;418;79;43;3;40;.930;3584000;0
14628;191687;418;0;0;0;0;.00nan;0;0
14629;183885;449;96;39;2;37;.949;3600000;0
14629;-1;449;0;0;0;0;.00nan;0;0
14629;186076;420;0;0;0;0;.00nan;0;0
14629;-1;420;81;32;3;29;.906;3600000;0
14630;199892;421;0;0;0;0;.00nan;0;0
14630;179169;421;98;38;1;37;.974;3600000;0
14630;207137;418;47;24;4;20;.833;3600000;0
14630;191687;418;0;0;0;0;.00nan;0;0
14631;183885;449;54;38;5;33;.868;3542000;0
14631;-1;449;0;0;0;0;.00nan;0;0
14631;186076;420;80;30;2;28;.933;3600000;0
14631;-1;420;0;0;0;0;.00nan;0;0
14632;184033;411;0;0;0;0;.00nan;0;0
14632;190073;413;0;0;0;0;.00nan;0;0
14632;192627;413;82;37;2;35;.946;3600000;0
14632;197699;411;30;28;5;23;.821;3600000;0
14633;184060;425;0;0;0;0;.00nan;0;0
14633;-1;426;74;43;4;39;.907;4166000;0
14633;-1;426;0;0;0;0;.00nan;0;0
14633;-1;425;74;36;3;33;.917;4166000;0
14634;194221;433;0;0;0;0;.00nan;0;0
14634;-1;434;70;28;2;26;.929;3600000;0
14634;186671;434;0;0;0;0;.00nan;0;0
14634;191212;433;88;49;3;46;.939;3560000;0
14635;173339;430;0;0;0;0;.00nan;0;0
14635;178743;435;0;0;0;0;.00nan;0;0
14635;-1;430;85;26;1;25;.962;3600000;0
14635;-1;435;54;19;2;17;.895;3600000;0
14636;183832;436;72;28;2;26;.929;3600000;0
14636;-1;428;0;0;0;0;.00nan;0;0
14636;196979;428;53;29;4;25;.862;3552000;0
14636;191861;436;0;0;0;0;.00nan;0;0
14637;194650;410;0;0;0;0;.00nan;0;0
14637;184183;410;39;35;5;30;.857;3600000;0
14637;-1;412;0;0;0;0;.00nan;0;0
14637;-1;412;74;19;1;18;.947;3600000;0
14638;207137;418;60;21;2;19;.905;3600000;0
14638;186076;420;0;0;0;0;.00nan;0;0
14638;191687;418;0;0;0;0;.00nan;0;0
14638;-1;420;81;40;3;37;.925;3557000;0
14639;182475;437;76;32;3;29;.906;3600000;0
14639;202171;439;0;0;0;0;.00nan;0;0
14639;181338;439;74;22;1;21;.955;3600000;0
14639;186571;437;0;0;0;0;.00nan;0;0
14640;203194;4849;62;25;2;23;.920;3554000;0
14640;188965;423;91;32;1;31;.969;3600000;0
14640;179071;423;0;0;0;0;.00nan;0;0
14640;196412;4849;0;0;0;0;.00nan;0;0
14641;194221;433;0;0;0;0;.00nan;0;0
14641;186468;427;0;0;0;0;.00nan;0;0
14641;191212;433;89;48;3;45;.938;3600000;0
14641;-1;427;48;14;2;12;.857;3600000;0
14642;165023;438;0;0;0;0;.00nan;0;0
14642;184336;429;0;0;0;0;.00nan;0;0
14642;176196;438;35;30;6;24;.800;3600000;0
14642;202180;429;71;29;3;26;.897;3600000;0
14643;199892;421;0;0;0;0;.00nan;0;0
14643;183885;449;64;41;5;36;.878;3600000;0
14643;179169;421;73;25;2;23;.920;3600000;0
14643;-1;449;0;0;0;0;.00nan;0;0
14644;187660;417;0;0;0;0;.00nan;0;0
14644;194456;414;34;26;5;21;.808;3600000;0
14644;194854;417;29;18;4;14;.778;3600000;0
14644;187309;414;0;0;0;0;.00nan;0;0
14645;168414;444;0;0;0;0;.00nan;0;0
14645;194630;444;87;46;3;43;.935;4200000;0
14645;179127;422;47;23;3;20;.870;4200000;0
14645;180578;422;0;0;0;0;.00nan;0;0
14646;194146;432;0;0;0;0;.00nan;0;0
14646;194751;443;97;25;0;25;1.000;3600000;0
14646;194803;443;0;0;0;0;.00nan;0;0
14646;197030;432;44;19;3;16;.842;3600000;0
14647;189783;440;0;0;0;0;.00nan;0;0
14647;175723;440;84;38;3;35;.921;3600000;0
14647;191171;431;0;0;0;0;.00nan;0;0
14647;-1;431;52;40;5;35;.875;3521000;0
14648;198091;415;85;37;2;35;.946;3600000;0
14648;190073;413;47;28;5;23;.821;3600000;0
14648;191877;415;0;0;0;0;.00nan;0;0
14648;192627;413;0;0;0;0;.00nan;0;0
14649;173339;430;0;0;0;0;.00nan;0;0
14649;-1;426;0;0;0;0;.00nan;0;0
14649;-1;426;85;32;1;31;.969;3756000;0
14649;-1;430;67;27;2;25;.926;3756000;0
14650;182475;437;0;0;0;0;.00nan;0;0
14650;202171;439;44;21;4;17;.810;3544000;0
14650;181338;439;0;0;0;0;.00nan;0;0
14650;186571;437;65;31;3;28;.903;3600000;0
14651;203194;4849;71;46;4;42;.913;4200000;0
14651;188965;423;0;0;0;0;.00nan;0;0
14651;179071;423;74;38;4;34;.895;4200000;0
14651;196412;4849;0;0;0;0;.00nan;0;0
14652;165023;438;66;35;4;31;.886;3600000;0
14652;176196;438;0;0;0;0;.00nan;0;0
14652;186468;427;0;0;0;0;.00nan;0;0
14652;-1;427;84;32;1;31;.969;3600000;0
14653;187660;417;0;0;0;0;.00nan;0;0
14653;194854;417;87;38;2;36;.947;3600000;0
14653;-1;412;74;34;3;31;.912;3580000;0
14653;-1;412;0;0;0;0;.00nan;0;0
14654;-1;428;0;0;0;0;.00nan;0;0
14654;194751;443;89;40;2;38;.950;3915000;0
14654;194803;443;0;0;0;0;.00nan;0;0
14654;196979;428;81;27;1;26;.963;3915000;0
14655;207137;418;85;20;0;20;1.000;3064000;0
14655;186076;420;42;32;5;27;.844;3529000;0
14655;191687;418;28;6;3;3;.500;536000;0
14655;-1;420;0;0;0;0;.00nan;0;0
14656;199892;421;70;32;3;29;.906;3600000;0
14656;183885;449;0;0;0;0;.00nan;0;0
14656;179169;421;0;0;0;0;.00nan;0;0
14656;-1;449;100;34;0;34;1.000;3600000;0
14657;168414;444;98;39;1;38;.974;3583000;0
14657;194630;444;0;0;0;0;.00nan;0;0
14657;179127;422;0;0;0;0;.00nan;0;0
14657;180578;422;84;17;0;17;1.000;3600000;0
14658;194456;414;63;29;3;26;.897;3600000;0
14658;194650;410;70;24;1;23;.958;3600000;0
14658;184183;410;0;0;0;0;.00nan;0;0
14658;187309;414;0;0;0;0;.00nan;0;0
14659;194146;432;0;0;0;0;.00nan;0;0
14659;189783;440;87;51;2;49;.961;4025000;0
14659;175723;440;0;0;0;0;.00nan;0;0
14659;197030;432;100;40;1;39;.975;4025000;0
14660;198091;415;60;27;3;24;.889;4200000;0
14660;184033;411;0;0;0;0;.00nan;0;0
14660;191877;415;0;0;0;0;.00nan;0;0
14660;197699;411;70;32;3;29;.906;4200000;0
14661;183832;436;76;35;3;32;.914;3600000;0
14661;191171;431;0;0;0;0;.00nan;0;0
14661;191861;436;0;0;0;0;.00nan;0;0
14661;-1;431;53;35;5;30;.857;3600000;0
14662;194221;433;0;0;0;0;.00nan;0;0
14662;178743;435;0;0;0;0;.00nan;0;0
14662;191212;433;60;27;3;24;.889;3539000;0
14662;-1;435;93;33;1;32;.970;3600000;0
14663;194146;432;0;0;0;0;.00nan;0;0
14663;-1;428;0;0;0;0;.00nan;0;0
14663;196979;428;72;24;2;22;.917;3600000;0
14663;197030;432;54;29;3;26;.897;3551000;0
14664;194456;414;80;33;2;31;.939;3600000;0
14664;184033;411;0;0;0;0;.00nan;0;0
14664;187309;414;0;0;0;0;.00nan;0;0
14664;197699;411;63;32;3;29;.906;3572000;0
14665;194390;441;35;27;6;21;.778;2979000;0
14665;202171;439;36;19;4;15;.789;3600000;0
14665;181338;439;0;0;0;0;.00nan;0;0
14665;191713;441;61;10;0;10;1.000;562000;0
14666;194146;432;24;24;6;18;.750;2154000;0
14666;191171;431;0;0;0;0;.00nan;0;0
14666;197030;432;68;11;0;11;1.000;1446000;0
14666;-1;431;65;23;2;21;.913;3600000;0
14667;165023;438;0;0;0;0;.00nan;0;0
14667;178743;435;80;27;1;26;.963;4200000;0
14667;176196;438;96;42;1;41;.976;4200000;0
14667;-1;435;0;0;0;0;.00nan;0;0
14668;184033;411;0;0;0;0;.00nan;0;0
14668;-1;412;99;40;2;38;.950;4002000;0
14668;-1;412;0;0;0;0;.00nan;0;0
14668;197699;411;48;19;3;16;.842;4002000;0
14669;188965;423;0;0;0;0;.00nan;0;0
14669;179071;423;46;38;5;33;.868;3600000;0
14669;207137;418;100;32;1;31;.969;3600000;0
14669;191687;418;0;0;0;0;.00nan;0;0
14670;194221;433;60;12;0;12;1.000;1259000;0
14670;191212;433;28;18;5;13;.722;2341000;0
14670;-1;426;0;0;0;0;.00nan;0;0
14670;-1;426;88;31;2;29;.935;3600000;0
14671;182475;437;0;0;0;0;.00nan;0;0
14671;183832;436;87;27;2;25;.926;3600000;0
14671;186571;437;51;21;3;18;.857;3557000;0
14671;191861;436;0;0;0;0;.00nan;0;0
14672;179127;422;0;0;0;0;.00nan;0;0
14672;180578;422;99;21;0;21;1.000;3600000;0
14672;186076;420;0;0;0;0;.00nan;0;0
14672;-1;420;78;41;4;37;.902;3600000;0
14673;194650;410;29;24;5;19;.792;3600000;0
14673;184183;410;0;0;0;0;.00nan;0;0
14673;190073;413;79;35;2;33;.943;3600000;0
14673;192627;413;0;0;0;0;.00nan;0;0
14674;173339;430;83;48;4;44;.917;3600000;0
14674;184336;429;37;27;5;22;.815;3600000;0
14674;202180;429;0;0;0;0;.00nan;0;0
14674;-1;430;0;0;0;0;.00nan;0;0
14675;184060;425;0;0;0;0;.00nan;0;0
14675;186468;427;0;0;0;0;.00nan;0;0
14675;-1;427;77;41;3;38;.927;3544000;0
14675;-1;425;61;21;2;19;.905;3600000;0
14676;203194;4849;97;43;2;41;.953;3990000;0
14676;199892;421;0;0;0;0;.00nan;0;0
14676;179169;421;55;22;3;19;.864;3990000;0
14676;196412;4849;0;0;0;0;.00nan;0;0
14677;183885;449;0;0;0;0;.00nan;0;0
14677;189288;419;0;0;0;0;.00nan;0;0
14677;-1;449;57;33;4;29;.879;4200000;0
14677;196975;419;62;37;4;33;.892;4200000;0
14678;198091;415;0;0;0;0;.00nan;0;0
14678;187660;417;0;0;0;0;.00nan;0;0
14678;194854;417;83;36;2;34;.944;3600000;0
14678;191877;415;63;26;4;22;.846;3546000;0
14679;194751;443;62;43;4;39;.907;3600000;0
14679;194803;443;0;0;0;0;.00nan;0;0
14679;202171;439;0;0;0;0;.00nan;0;0
14679;181338;439;55;23;3;20;.870;3600000;0
14680;189783;440;80;35;2;33;.943;4200000;0
14680;175723;440;0;0;0;0;.00nan;0;0
14680;190157;442;60;16;2;14;.875;4200000;0
14680;191849;442;0;0;0;0;.00nan;0;0
14681;179127;422;86;30;2;28;.933;3600000;0
14681;180578;422;0;0;0;0;.00nan;0;0
14681;186076;420;59;26;3;23;.885;3566000;0
14681;-1;420;0;0;0;0;.00nan;0;0
14682;194390;441;68;25;2;23;.920;3600000;0
14682;-1;428;0;0;0;0;.00nan;0;0
14682;196979;428;65;36;3;33;.917;3600000;0
14682;191713;441;0;0;0;0;.00nan;0;0
14683;182475;437;0;0;0;0;.00nan;0;0
14683;183832;436;0;0;0;0;.00nan;0;0
14683;186571;437;65;22;2;20;.909;3600000;0
14683;191861;436;57;25;3;22;.880;3550000;0
14684;178743;435;0;0;0;0;.00nan;0;0
14684;-1;434;0;0;0;0;.00nan;0;0
14684;186671;434;67;16;1;15;.938;3600000;0
14684;-1;435;32;49;7;42;.857;3600000;0
14685;187660;417;29;27;6;21;.778;2837000;0
14685;194854;417;43;5;1;4;.800;763000;0
14685;190073;413;76;21;1;20;.952;3600000;0
14685;192627;413;0;0;0;0;.00nan;0;0
14686;188965;423;100;30;0;30;1.000;3600000;0
14686;179071;423;0;0;0;0;.00nan;0;0
14686;207137;418;0;0;0;0;.00nan;0;0
14686;191687;418;72;25;2;23;.920;3600000;0
14687;173339;430;0;0;0;0;.00nan;0;0
14687;186468;427;52;17;2;15;.882;3600000;0
14687;-1;430;83;40;3;37;.925;3600000;0
14687;-1;427;0;0;0;0;.00nan;0;0
14688;184060;425;17;23;6;17;.739;3600000;0
14688;184336;429;71;37;4;33;.892;3600000;0
14688;202180;429;0;0;0;0;.00nan;0;0
14688;-1;425;0;0;0;0;.00nan;0;0
14689;194456;414;0;0;0;0;.00nan;0;0
14689;-1;412;64;23;2;21;.913;3600000;0
14689;187309;414;57;30;4;26;.867;3600000;0
14689;-1;412;0;0;0;0;.00nan;0;0
14690;203194;4849;0;0;0;0;.00nan;0;0
14690;199892;421;61;29;3;26;.897;3558000;0
14690;179169;421;0;0;0;0;.00nan;0;0
14690;196412;4849;100;47;2;45;.957;3600000;0
14691;183885;449;99;36;1;35;.972;3600000;0
14691;189288;419;42;23;4;19;.826;3600000;0
14691;-1;449;0;0;0;0;.00nan;0;0
14691;196975;419;0;0;0;0;.00nan;0;0
14692;198091;415;71;22;1;21;.955;3600000;0
14692;194650;410;28;27;6;21;.778;2595000;0
14692;184183;410;58;11;1;10;.909;1005000;0
14692;191877;415;0;0;0;0;.00nan;0;0
14693;165023;438;0;0;0;0;.00nan;0;0
14693;176196;438;85;26;1;25;.962;3930000;0
14693;-1;426;0;0;0;0;.00nan;0;0
14693;-1;426;87;44;2;42;.955;3930000;0
14694;189783;440;49;22;3;19;.864;3600000;0
14694;175723;440;0;0;0;0;.00nan;0;0
14694;190157;442;0;0;0;0;.00nan;0;0
14694;191849;442;60;44;5;39;.886;3519000;0
14695;187660;417;0;0;0;0;.00nan;0;0
14695;194650;410;63;13;1;12;.923;1360000;0
14695;194854;417;50;20;3;17;.850;3600000;0
14695;184183;410;25;13;4;9;.692;2196000;0
14696;165023;438;0;0;0;0;.00nan;0;0
14696;176196;438;65;35;3;32;.914;3600000;0
14696;-1;434;0;0;0;0;.00nan;0;0
14696;186671;434;76;18;1;17;.944;3600000;0
14697;194751;443;39;21;4;17;.810;3600000;0
14697;194803;443;0;0;0;0;.00nan;0;0
14697;191171;431;0;0;0;0;.00nan;0;0
14697;-1;431;62;27;3;24;.889;3600000;0
14698;203194;4849;81;27;1;26;.963;3639000;0
14698;183885;449;82;29;2;27;.931;3639000;0
14698;-1;449;0;0;0;0;.00nan;0;0
14698;196412;4849;0;0;0;0;.00nan;0;0
14699;194146;432;0;0;0;0;.00nan;0;0
14699;194751;443;0;0;0;0;.00nan;0;0
14699;194803;443;94;45;1;44;.978;4200000;0
14699;197030;432;96;35;1;34;.971;4200000;0
14700;198091;415;62;45;6;39;.867;3071000;0
14700;-1;412;0;0;0;0;.00nan;0;0
14700;191877;415;53;8;1;7;.875;529000;0
14700;-1;412;45;19;3;16;.842;3600000;0
14701;188965;423;0;0;0;0;.00nan;0;0
14701;179071;423;57;30;3;27;.900;4007000;0
14701;186076;420;0;0;0;0;.00nan;0;0
14701;-1;420;40;20;4;16;.800;4007000;0
14702;173339;430;0;0;0;0;.00nan;0;0
14702;202171;439;62;23;2;21;.913;3600000;0
14702;181338;439;0;0;0;0;.00nan;0;0
14702;-1;430;68;41;4;37;.902;3538000;0
14703;183832;436;53;28;4;24;.857;3600000;0
14703;186468;427;0;0;0;0;.00nan;0;0
14703;191861;436;0;0;0;0;.00nan;0;0
14703;-1;427;100;41;2;39;.951;3600000;0
14704;194390;441;79;32;2;30;.938;4200000;0
14704;184060;425;0;0;0;0;.00nan;0;0
14704;191713;441;0;0;0;0;.00nan;0;0
14704;-1;425;76;22;2;20;.909;4200000;0
14705;189288;419;0;0;0;0;.00nan;0;0
14705;179127;422;0;0;0;0;.00nan;0;0
14705;180578;422;65;33;4;29;.879;3600000;0
14705;196975;419;69;34;3;31;.912;3600000;0
14706;165023;438;25;28;6;22;.786;2975000;0
14706;176196;438;45;5;1;4;.800;625000;0
14706;-1;434;0;0;0;0;.00nan;0;0
14706;186671;434;100;24;0;24;1.000;3600000;0
14707;190157;442;62;35;4;31;.886;3548000;0
14707;-1;426;0;0;0;0;.00nan;0;0
14707;-1;426;52;23;3;20;.870;3600000;0
14707;191849;442;0;0;0;0;.00nan;0;0
14708;-1;428;0;0;0;0;.00nan;0;0
14708;184336;429;65;21;2;19;.905;3600000;0
14708;202180;429;0;0;0;0;.00nan;0;0
14708;196979;428;47;28;4;24;.857;3534000;0
14709;194456;414;71;33;3;30;.909;3600000;0
14709;190073;413;50;30;4;26;.867;3578000;0
14709;187309;414;0;0;0;0;.00nan;0;0
14709;192627;413;0;0;0;0;.00nan;0;0
14710;199892;421;0;0;0;0;.00nan;0;0
14710;168414;444;100;47;1;46;.979;4200000;0
14710;194630;444;0;0;0;0;.00nan;0;0
14710;179169;421;69;29;1;28;.966;4200000;0
14711;194146;432;92;47;2;45;.957;3553000;0
14711;194221;433;0;0;0;0;.00nan;0;0
14711;191212;433;82;25;1;24;.960;3600000;0
14711;197030;432;0;0;0;0;.00nan;0;0
14712;187660;417;0;0;0;0;.00nan;0;0
14712;184033;411;76;34;2;32;.941;4200000;0
14712;194854;417;79;37;2;35;.946;4200000;0
14712;197699;411;0;0;0;0;.00nan;0;0
14713;190073;413;0;0;0;0;.00nan;0;0
14713;-1;412;65;27;2;25;.926;3600000;0
14713;192627;413;21;31;7;24;.774;3600000;0
14713;-1;412;0;0;0;0;.00nan;0;0
14714;184060;425;73;44;4;40;.909;3600000;0
14714;202171;439;0;0;0;0;.00nan;0;0
14714;181338;439;71;35;3;32;.914;3600000;0
14714;-1;425;0;0;0;0;.00nan;0;0
14715;188965;423;83;33;2;31;.939;3547000;0
14715;179071;423;0;0;0;0;.00nan;0;0
14715;186076;420;94;34;1;33;.971;3600000;0
14715;-1;420;0;0;0;0;.00nan;0;0
14716;-1;428;66;25;2;23;.920;3600000;0
14716;186468;427;65;37;4;33;.892;3566000;0
14716;196979;428;0;0;0;0;.00nan;0;0
14716;-1;427;0;0;0;0;.00nan;0;0
14717;194390;441;0;0;0;0;.00nan;0;0
14717;173339;430;43;9;2;7;.778;1072000;0
14717;191713;441;87;38;2;36;.947;3600000;0
14717;-1;430;21;24;6;18;.750;2528000;0
14718;182475;437;61;32;3;29;.906;3600000;0
14718;178743;435;0;0;0;0;.00nan;0;0
14718;186571;437;0;0;0;0;.00nan;0;0
14718;-1;435;51;31;4;27;.871;3600000;0
14719;189288;419;52;34;4;30;.882;3600000;0
14719;179127;422;86;28;1;27;.964;3600000;0
14719;180578;422;0;0;0;0;.00nan;0;0
14719;196975;419;0;0;0;0;.00nan;0;0
14720;194221;433;58;29;4;25;.862;3600000;0
14720;190157;442;0;0;0;0;.00nan;0;0
14720;191212;433;0;0;0;0;.00nan;0;0
14720;191849;442;91;34;1;33;.971;3600000;0
14721;183832;436;0;0;0;0;.00nan;0;0
14721;184336;429;0;0;0;0;.00nan;0;0
14721;202180;429;74;31;3;28;.903;3600000;0
14721;191861;436;49;24;4;20;.833;3547000;0
14722;199892;421;64;23;2;21;.913;3600000;0
14722;168414;444;0;0;0;0;.00nan;0;0
14722;194630;444;58;27;3;24;.889;3551000;0
14722;179169;421;0;0;0;0;.00nan;0;0
14723;198091;415;74;24;2;22;.917;3600000;0
14723;194456;414;0;0;0;0;.00nan;0;0
14723;187309;414;59;37;5;32;.865;3600000;0
14723;191877;415;0;0;0;0;.00nan;0;0
14724;203194;4849;64;45;6;39;.867;3600000;0
14724;183885;449;0;0;0;0;.00nan;0;0
14724;-1;449;65;22;1;21;.955;3600000;0
14724;196412;4849;0;0;0;0;.00nan;0;0
14725;194650;410;61;28;3;25;.893;3600000;0
14725;184033;411;0;0;0;0;.00nan;0;0
14725;184183;410;0;0;0;0;.00nan;0;0
14725;197699;411;69;23;2;21;.913;3600000;0
14726;187660;417;82;26;1;25;.962;3600000;0
14726;194650;410;0;0;0;0;.00nan;0;0
14726;194854;417;0;0;0;0;.00nan;0;0
14726;184183;410;64;34;4;30;.882;3600000;0
14727;-1;428;0;0;0;0;.00nan;0;0
14727;196979;428;64;30;3;27;.900;3600000;0
14727;-1;426;0;0;0;0;.00nan;0;0
14727;-1;426;71;29;2;27;.931;3600000;0
14728;194221;433;0;0;0;0;.00nan;0;0
14728;194390;441;78;41;3;38;.927;3600000;0
14728;191212;433;55;10;1;9;.900;3600000;0
14728;191713;441;0;0;0;0;.00nan;0;0
14729;183885;449;0;0;0;0;.00nan;0;0
14729;179127;422;0;0;0;0;.00nan;0;0
14729;-1;449;77;63;7;56;.889;3600000;0
14729;180578;422;61;22;2;20;.909;3600000;0
14730;189288;419;0;0;0;0;.00nan;0;0
14730;207137;418;53;37;5;32;.865;3557000;0
14730;196975;419;63;28;3;25;.893;3600000;0
14730;191687;418;0;0;0;0;.00nan;0;0
14731;-1;434;0;0;0;0;.00nan;0;0
14731;202171;439;63;35;3;32;.914;3582000;0
14731;181338;439;0;0;0;0;.00nan;0;0
14731;186671;434;71;25;2;23;.920;3600000;0
14732;194456;414;64;38;4;34;.895;4200000;0
14732;190073;413;72;41;4;37;.902;4200000;0
14732;187309;414;0;0;0;0;.00nan;0;0
14732;192627;413;0;0;0;0;.00nan;0;0
14733;178743;435;0;0;0;0;.00nan;0;0
14733;-1;426;88;31;1;30;.968;3600000;0
14733;-1;426;0;0;0;0;.00nan;0;0
14733;-1;435;42;30;5;25;.833;3600000;0
14734;165023;438;0;0;0;0;.00nan;0;0
14734;173339;430;71;21;2;19;.905;3543000;0
14734;176196;438;88;23;1;22;.957;3600000;0
14734;-1;430;0;0;0;0;.00nan;0;0
14735;184060;425;0;0;0;0;.00nan;0;0
14735;191171;431;0;0;0;0;.00nan;0;0
14735;-1;425;79;27;1;26;.963;3600000;0
14735;-1;431;57;45;6;39;.867;3600000;0
14736;203194;4849;90;36;2;34;.944;3600000;0
14736;168414;444;68;29;3;26;.897;3546000;0
14736;194630;444;0;0;0;0;.00nan;0;0
14736;196412;4849;0;0;0;0;.00nan;0;0
14737;182475;437;0;0;0;0;.00nan;0;0
14737;194146;432;0;0;0;0;.00nan;0;0
14737;186571;437;100;27;0;27;1.000;3600000;0
14737;197030;432;67;26;2;24;.923;3514000;0
14738;198091;415;76;28;2;26;.929;3600000;0
14738;-1;412;69;37;3;34;.919;3597000;0
14738;191877;415;0;0;0;0;.00nan;0;0
14738;-1;412;0;0;0;0;.00nan;0;0
14739;187660;417;0;0;0;0;.00nan;0;0
14739;184033;411;0;0;0;0;.00nan;0;0
14739;194854;417;69;35;3;32;.914;3600000;0
14739;197699;411;62;25;2;23;.920;3600000;0
14740;183832;436;71;25;2;23;.920;3600000;0
14740;190157;442;70;48;4;44;.917;3600000;0
14740;191849;442;0;0;0;0;.00nan;0;0
14740;191861;436;0;0;0;0;.00nan;0;0
14741;194751;443;48;25;4;21;.840;3600000;0
14741;194803;443;0;0;0;0;.00nan;0;0
14741;186468;427;0;0;0;0;.00nan;0;0
14741;-1;427;91;31;1;30;.968;3600000;0
14742;184336;429;58;35;5;30;.857;3600000;0
14742;189783;440;0;0;0;0;.00nan;0;0
14742;175723;440;100;32;0;32;1.000;3600000;0
14742;202180;429;0;0;0;0;.00nan;0;0
14743;194221;433;49;38;5;33;.868;3568000;0
14743;202171;439;0;0;0;0;.00nan;0;0
14743;181338;439;79;26;2;24;.923;3600000;0
14743;191212;433;0;0;0;0;.00nan;0;0
14744;-1;428;0;0;0;0;.00nan;0;0
14744;190157;442;0;0;0;0;.00nan;0;0
14744;196979;428;54;29;4;25;.862;3696000;0
14744;191849;442;72;36;3;33;.917;3696000;0
14745;183885;449;83;44;4;40;.909;3596000;0
14745;179127;422;67;24;3;21;.875;3600000;0
14745;-1;449;0;0;0;0;.00nan;0;0
14745;180578;422;0;0;0;0;.00nan;0;0
14746;189288;419;83;30;1;29;.967;3600000;0
14746;207137;418;0;0;0;0;.00nan;0;0
14746;196975;419;0;0;0;0;.00nan;0;0
14746;191687;418;72;36;4;32;.889;3600000;0
14747;194390;441;0;0;0;0;.00nan;0;0
14747;-1;434;41;15;3;12;.800;3600000;0
14747;186671;434;0;0;0;0;.00nan;0;0
14747;191713;441;66;44;4;40;.909;3550000;0
14748;190073;413;0;0;0;0;.00nan;0;0
14748;-1;412;0;0;0;0;.00nan;0;0
14748;192627;413;77;37;3;34;.919;3600000;0
14748;-1;412;36;28;5;23;.821;3585000;0
14749;183832;436;0;0;0;0;.00nan;0;0
14749;178743;435;58;46;6;40;.870;3600000;0
14749;191861;436;89;14;0;14;1.000;3600000;0
14749;-1;435;0;0;0;0;.00nan;0;0
14750;173339;430;56;7;0;7;1.000;931000;0
14750;191171;431;46;25;4;21;.840;3600000;0
14750;-1;430;43;38;6;32;.842;2669000;0
14750;-1;431;0;0;0;0;.00nan;0;0
14751;165023;438;69;32;2;30;.938;3575000;0
14751;184060;425;74;22;1;21;.955;3600000;0
14751;176196;438;0;0;0;0;.00nan;0;0
14751;-1;425;0;0;0;0;.00nan;0;0
14752;203194;4849;0;0;0;0;.00nan;0;0
14752;168414;444;0;0;0;0;.00nan;0;0
14752;194630;444;76;33;2;31;.939;3551000;0
14752;196412;4849;100;25;0;25;1.000;3600000;0
14753;182475;437;0;0;0;0;.00nan;0;0
14753;194146;432;74;40;4;36;.900;4008000;0
14753;186571;437;66;30;3;27;.900;4008000;0
14753;197030;432;0;0;0;0;.00nan;0;0
14754;198091;415;70;31;3;28;.903;3600000;0
14754;194456;414;0;0;0;0;.00nan;0;0
14754;187309;414;45;39;6;33;.846;3600000;0
14754;191877;415;0;0;0;0;.00nan;0;0
14755;194650;410;49;39;5;34;.872;3548000;0
14755;184033;411;45;25;4;21;.840;3600000;0
14755;184183;410;0;0;0;0;.00nan;0;0
14755;197699;411;0;0;0;0;.00nan;0;0
14756;194751;443;0;0;0;0;.00nan;0;0
14756;194803;443;38;24;4;20;.833;3564000;0
14756;184336;429;0;0;0;0;.00nan;0;0
14756;202180;429;86;31;2;29;.935;3600000;0
14757;189783;440;92;43;3;40;.930;4200000;0
14757;175723;440;0;0;0;0;.00nan;0;0
14757;186468;427;76;28;3;25;.893;4200000;0
14757;-1;427;0;0;0;0;.00nan;0;0
14758;184033;411;0;0;0;0;.00nan;0;0
14758;190073;413;0;0;0;0;.00nan;0;0
14758;192627;413;92;37;2;35;.946;3600000;0
14758;197699;411;45;17;3;14;.824;3600000;0
14759;184060;425;0;0;0;0;.00nan;0;0
14759;178743;435;0;0;0;0;.00nan;0;0
14759;-1;425;55;10;1;9;.900;3600000;0
14759;-1;435;90;45;3;42;.933;3600000;0
14760;165023;438;0;0;0;0;.00nan;0;0
14760;194221;433;0;0;0;0;.00nan;0;0
14760;176196;438;68;21;2;19;.905;3600000;0
14760;191212;433;62;40;4;36;.900;3600000;0
14761;183832;436;0;0;0;0;.00nan;0;0
14761;-1;426;0;0;0;0;.00nan;0;0
14761;-1;426;89;30;2;28;.933;3600000;0
14761;191861;436;56;29;4;25;.862;3513000;0
14762;-1;428;0;0;0;0;.00nan;0;0
14762;191171;431;0;0;0;0;.00nan;0;0
14762;196979;428;73;30;2;28;.933;3550000;0
14762;-1;431;80;28;1;27;.964;3600000;0
14763;203194;4849;0;0;0;0;.00nan;0;0
14763;189288;419;0;0;0;0;.00nan;0;0
14763;196412;4849;89;44;2;42;.955;3900000;0
14763;196975;419;52;19;3;16;.842;3900000;0
14764;194650;410;0;0;0;0;.00nan;0;0
14764;184183;410;58;34;5;29;.853;3600000;0
14764;-1;412;70;20;1;19;.950;3600000;0
14764;-1;412;0;0;0;0;.00nan;0;0
14765;168414;444;49;26;3;23;.885;3553000;0
14765;194630;444;0;0;0;0;.00nan;0;0
14765;186076;420;0;0;0;0;.00nan;0;0
14765;-1;420;91;38;1;37;.974;3600000;0
14766;189783;440;71;28;2;26;.929;3215000;0
14766;175723;440;21;3;3;0;.000;330000;0
14766;202171;439;0;0;0;0;.00nan;0;0
14766;181338;439;37;19;4;15;.789;3600000;0
14767;194390;441;76;31;2;29;.935;3600000;0
14767;178743;435;0;0;0;0;.00nan;0;0
14767;191713;441;0;0;0;0;.00nan;0;0
14767;-1;435;59;30;3;27;.900;3576000;0
14768;182475;437;0;0;0;0;.00nan;0;0
14768;194751;443;61;19;2;17;.895;3600000;0
14768;194803;443;0;0;0;0;.00nan;0;0
14768;186571;437;57;40;4;36;.900;3591000;0
14769;203194;4849;84;41;3;38;.927;3600000;0
14769;189288;419;51;24;4;20;.833;3551000;0
14769;196412;4849;0;0;0;0;.00nan;0;0
14769;196975;419;0;0;0;0;.00nan;0;0
14770;183885;449;58;5;0;5;1.000;1370000;0
14770;-1;449;28;15;4;11;.733;2195000;0
14770;207137;418;100;43;2;41;.953;3600000;0
14770;191687;418;0;0;0;0;.00nan;0;0
14771;184336;429;100;36;0;36;1.000;3600000;0
14771;202180;429;0;0;0;0;.00nan;0;0
14771;186468;427;0;0;0;0;.00nan;0;0
14771;-1;427;43;24;4;20;.833;3600000;0
14772;173339;430;0;0;0;0;.00nan;0;0
14772;190157;442;80;38;2;36;.947;3563000;0
14772;191849;442;0;0;0;0;.00nan;0;0
14772;-1;430;87;25;1;24;.960;3600000;0
14773;199892;421;0;0;0;0;.00nan;0;0
14773;188965;423;70;31;3;28;.903;3600000;0
14773;179071;423;0;0;0;0;.00nan;0;0
14773;179169;421;39;24;4;20;.833;3539000;0
14774;184060;425;0;0;0;0;.00nan;0;0
14774;-1;434;61;7;0;7;1.000;721000;0
14774;186671;434;12;20;6;14;.700;2879000;0
14774;-1;425;56;22;2;20;.909;3600000;0
14775;187660;417;0;0;0;0;.00nan;0;0
14775;194456;414;82;29;1;28;.966;3600000;0
14775;194854;417;40;35;6;29;.829;3600000;0
14775;187309;414;0;0;0;0;.00nan;0;0
14776;194146;432;0;0;0;0;.00nan;0;0
14776;-1;428;88;38;2;36;.947;4200000;0
14776;196979;428;0;0;0;0;.00nan;0;0
14776;197030;432;89;37;2;35;.946;4200000;0
14777;198091;415;73;22;1;21;.955;3600000;0
14777;190073;413;71;30;2;28;.933;3549000;0
14777;191877;415;0;0;0;0;.00nan;0;0
14777;192627;413;0;0;0;0;.00nan;0;0
14778;187660;417;53;19;3;16;.842;3600000;0
14778;194854;417;0;0;0;0;.00nan;0;0
14778;-1;412;0;0;0;0;.00nan;0;0
14778;-1;412;56;35;4;31;.886;3594000;0
14779;168414;444;0;0;0;0;.00nan;0;0
14779;194630;444;69;37;4;33;.892;3592000;0
14779;186076;420;71;33;3;30;.909;3600000;0
14779;-1;420;0;0;0;0;.00nan;0;0
14780;178743;435;0;0;0;0;.00nan;0;0
14780;202171;439;85;18;1;17;.944;3600000;0
14780;181338;439;0;0;0;0;.00nan;0;0
14780;-1;435;98;57;2;55;.965;3589000;0
14781;184336;429;87;47;3;44;.936;3600000;0
14781;202180;429;0;0;0;0;.00nan;0;0
14781;186468;427;52;31;4;27;.871;3550000;0
14781;-1;427;0;0;0;0;.00nan;0;0
14782;194390;441;0;0;0;0;.00nan;0;0
14782;189783;440;89;20;0;20;1.000;3600000;0
14782;175723;440;0;0;0;0;.00nan;0;0
14782;191713;441;84;34;2;32;.941;3562000;0
14783;182475;437;82;27;2;25;.926;3600000;0
14783;194751;443;64;42;5;37;.881;3600000;0
14783;194803;443;0;0;0;0;.00nan;0;0
14783;186571;437;0;0;0;0;.00nan;0;0
14784;183885;449;66;37;4;33;.892;3545000;0
14784;-1;449;0;0;0;0;.00nan;0;0
14784;207137;418;0;0;0;0;.00nan;0;0
14784;191687;418;50;24;3;21;.875;3600000;0
14785;173339;430;78;45;4;41;.911;3595000;0
14785;-1;434;45;18;3;15;.833;3600000;0
14785;186671;434;0;0;0;0;.00nan;0;0
14785;-1;430;0;0;0;0;.00nan;0;0
14786;199892;421;82;14;0;14;1.000;3600000;0
14786;188965;423;0;0;0;0;.00nan;0;0
14786;179071;423;68;29;3;26;.897;3600000;0
14786;179169;421;0;0;0;0;.00nan;0;0
14787;184060;425;78;14;0;14;1.000;3600000;0
14787;190157;442;79;44;3;41;.932;3600000;0
14787;191849;442;0;0;0;0;.00nan;0;0
14787;-1;425;0;0;0;0;.00nan;0;0
14788;194456;414;0;0;0;0;.00nan;0;0
14788;194650;410;77;33;2;31;.939;3568000;0
14788;184183;410;0;0;0;0;.00nan;0;0
14788;187309;414;95;34;1;33;.971;3600000;0
14789;191171;431;0;0;0;0;.00nan;0;0
14789;-1;426;0;0;0;0;.00nan;0;0
14789;-1;426;67;19;1;18;.947;3600000;0
14789;-1;431;86;46;3;43;.935;3513000;0
14790;198091;415;69;34;4;30;.882;3190000;0
14790;184033;411;0;0;0;0;.00nan;0;0
14790;191877;415;31;8;3;5;.625;410000;0
14790;197699;411;75;21;1;20;.952;3600000;0
14791;194146;432;80;38;3;35;.921;3593000;0
14791;183832;436;62;22;2;20;.909;3600000;0
14791;197030;432;0;0;0;0;.00nan;0;0
14791;191861;436;0;0;0;0;.00nan;0;0
14792;165023;438;0;0;0;0;.00nan;0;0
14792;194221;433;0;0;0;0;.00nan;0;0
14792;176196;438;87;30;1;29;.967;3600000;0
14792;191212;433;90;43;2;41;.953;3557000;0
14793;194456;414;68;43;4;39;.907;3514000;0
14793;184033;411;0;0;0;0;.00nan;0;0
14793;187309;414;0;0;0;0;.00nan;0;0
14793;197699;411;53;17;2;15;.882;3600000;0
14794;165023;438;0;0;0;0;.00nan;0;0
14794;176196;438;82;41;4;37;.902;3600000;0
14794;-1;434;0;0;0;0;.00nan;0;0
14794;186671;434;90;29;1;28;.966;3600000;0
14795;194390;441;85;38;2;36;.947;3547000;0
14795;-1;428;0;0;0;0;.00nan;0;0
14795;196979;428;65;15;1;14;.933;3600000;0
14795;191713;441;0;0;0;0;.00nan;0;0
14796;182475;437;0;0;0;0;.00nan;0;0
14796;190157;442;13;22;6;16;.727;2069000;0
14796;186571;437;56;13;1;12;.923;3600000;0
14796;191849;442;40;23;4;19;.826;1531000;0
14797;194146;432;0;0;0;0;.00nan;0;0
14797;-1;426;78;20;1;19;.950;3600000;0
14797;-1;426;0;0;0;0;.00nan;0;0
14797;197030;432;76;40;4;36;.900;3600000;0
14798;184033;411;0;0;0;0;.00nan;0;0
14798;-1;412;79;30;2;28;.933;3600000;0
14798;-1;412;0;0;0;0;.00nan;0;0
14798;197699;411;79;33;1;32;.970;3600000;0
14799;184060;425;70;25;2;23;.920;3600000;0
14799;186468;427;0;0;0;0;.00nan;0;0
14799;-1;427;58;30;4;26;.867;3546000;0
14799;-1;425;0;0;0;0;.00nan;0;0
14800;198091;415;71;41;5;36;.878;3546000;0
14800;187660;417;73;33;3;30;.909;3600000;0
14800;194854;417;0;0;0;0;.00nan;0;0
14800;191877;415;0;0;0;0;.00nan;0;0
14801;194390;441;0;0;0;0;.00nan;0;0
14801;191171;431;0;0;0;0;.00nan;0;0
14801;191713;441;59;23;2;21;.913;3555000;0
14801;-1;431;99;38;1;37;.974;3600000;0
14802;207137;418;55;31;4;27;.871;3600000;0
14802;186076;420;0;0;0;0;.00nan;0;0
14802;191687;418;0;0;0;0;.00nan;0;0
14802;-1;420;30;23;5;18;.783;3552000;0
14803;182475;437;76;41;4;37;.902;4200000;0
14803;190157;442;74;37;4;33;.892;4200000;0
14803;186571;437;0;0;0;0;.00nan;0;0
14803;191849;442;0;0;0;0;.00nan;0;0
14804;173339;430;0;0;0;0;.00nan;0;0
14804;184336;429;49;29;5;24;.828;3582000;0
14804;202180;429;0;0;0;0;.00nan;0;0
14804;-1;430;54;28;4;24;.857;3600000;0
14805;199892;421;66;30;3;27;.900;3600000;0
14805;189288;419;0;0;0;0;.00nan;0;0
14805;179169;421;0;0;0;0;.00nan;0;0
14805;196975;419;40;34;5;29;.853;3565000;0
14806;188965;423;0;0;0;0;.00nan;0;0
14806;168414;444;61;36;4;32;.889;4096000;0
14806;194630;444;0;0;0;0;.00nan;0;0
14806;179071;423;75;39;3;36;.923;4096000;0
14807;194650;410;0;0;0;0;.00nan;0;0
14807;184183;410;75;33;2;31;.939;3600000;0
14807;190073;413;80;26;1;25;.962;3600000;0
14807;192627;413;0;0;0;0;.00nan;0;0
14808;203194;4849;38;33;6;27;.818;3237000;0
14808;179127;422;54;23;3;20;.870;3600000;0
14808;180578;422;0;0;0;0;.00nan;0;0
14808;196412;4849;52;2;0;2;1.000;363000;0
14809;183832;436;100;58;1;57;.983;4200000;0
14809;202171;439;0;0;0;0;.00nan;0;0
14809;181338;439;77;24;1;23;.958;4200000;0
14809;191861;436;0;0;0;0;.00nan;0;0
14810;194221;433;47;17;4;13;.765;2206000;0
14810;194751;443;80;22;1;21;.955;3600000;0
14810;194803;443;0;0;0;0;.00nan;0;0
14810;191212;433;49;10;1;9;.900;1394000;0
14811;178743;435;37;6;2;4;.667;1379000;0
14811;189783;440;73;23;2;21;.913;3600000;0
14811;175723;440;0;0;0;0;.00nan;0;0
14811;-1;435;32;31;6;25;.806;2221000;0
14812;207137;418;0;0;0;0;.00nan;0;0
14812;186076;420;0;0;0;0;.00nan;0;0
14812;191687;418;72;21;1;20;.952;3600000;0
14812;-1;420;69;35;4;31;.886;3600000;0
14813;173339;430;93;35;1;34;.971;3600000;0
14813;186468;427;61;27;2;25;.926;3550000;0
14813;-1;430;0;0;0;0;.00nan;0;0
14813;-1;427;0;0;0;0;.00nan;0;0
14814;187660;417;0;0;0;0;.00nan;0;0
14814;194854;417;80;28;2;26;.929;3600000;0
14814;190073;413;0;0;0;0;.00nan;0;0
14814;192627;413;100;32;0;32;1.000;3600000;0
14815;-1;434;0;0;0;0;.00nan;0;0
14815;186671;434;66;29;3;26;.897;3660000;0
14815;-1;426;0;0;0;0;.00nan;0;0
14815;-1;426;49;26;4;22;.846;3660000;0
14816;184060;425;0;0;0;0;.00nan;0;0
14816;184336;429;0;0;0;0;.00nan;0;0
14816;202180;429;98;39;1;38;.974;3815000;0
14816;-1;425;90;34;2;32;.941;3815000;0
14817;199892;421;0;0;0;0;.00nan;0;0
14817;189288;419;73;34;3;31;.912;3550000;0
14817;179169;421;78;28;2;26;.929;3600000;0
14817;196975;419;0;0;0;0;.00nan;0;0
14818;194456;414;70;40;4;36;.900;3600000;0
14818;-1;412;0;0;0;0;.00nan;0;0
14818;187309;414;0;0;0;0;.00nan;0;0
14818;-1;412;87;28;1;27;.964;3600000;0
14819;188965;423;76;33;2;31;.939;3545000;0
14819;168414;444;0;0;0;0;.00nan;0;0
14819;194630;444;99;30;1;29;.967;3600000;0
14819;179071;423;0;0;0;0;.00nan;0;0
14820;198091;415;0;0;0;0;.00nan;0;0
14820;194650;410;89;41;2;39;.951;3590000;0
14820;184183;410;0;0;0;0;.00nan;0;0
14820;191877;415;100;25;0;25;1.000;3600000;0
14821;183832;436;0;0;0;0;.00nan;0;0
14821;191171;431;82;38;2;36;.947;3600000;0
14821;191861;436;33;28;5;23;.821;3600000;0
14821;-1;431;0;0;0;0;.00nan;0;0
14822;203194;4849;0;0;0;0;.00nan;0;0
14822;179127;422;0;0;0;0;.00nan;0;0
14822;180578;422;69;37;3;34;.919;4200000;0
14822;196412;4849;77;38;3;35;.921;4200000;0
14823;165023;438;0;0;0;0;.00nan;0;0
14823;194146;432;0;0;0;0;.00nan;0;0
14823;176196;438;76;25;1;24;.960;3600000;0
14823;197030;432;43;27;5;22;.815;3600000;0
14824;194751;443;0;0;0;0;.00nan;0;0
14824;194803;443;57;25;3;22;.880;3581000;0
14824;178743;435;0;0;0;0;.00nan;0;0
14824;-1;435;99;43;2;41;.953;3600000;0
14825;194221;433;0;0;0;0;.00nan;0;0
14825;189783;440;0;0;0;0;.00nan;0;0
14825;175723;440;80;22;1;21;.955;3600000;0
14825;191212;433;75;39;3;36;.923;3567000;0
14826;-1;428;0;0;0;0;.00nan;0;0
14826;202171;439;51;28;3;25;.893;3552000;0
14826;181338;439;0;0;0;0;.00nan;0;0
14826;196979;428;88;44;2;42;.955;3600000;0
14827;187660;417;100;24;0;24;1.000;3600000;0
14827;194650;410;0;0;0;0;.00nan;0;0
14827;194854;417;0;0;0;0;.00nan;0;0
14827;184183;410;40;33;6;27;.818;3600000;0
14828;173339;430;0;0;0;0;.00nan;0;0
14828;184060;425;0;0;0;0;.00nan;0;0
14828;-1;430;68;37;3;34;.919;3545000;0
14828;-1;425;60;19;2;17;.895;3600000;0
14829;178743;435;0;0;0;0;.00nan;0;0
14829;-1;426;0;0;0;0;.00nan;0;0
14829;-1;426;68;24;2;22;.917;3600000;0
14829;-1;435;38;20;4;16;.800;3519000;0
14830;194146;432;0;0;0;0;.00nan;0;0
14830;194390;441;48;45;6;39;.867;3600000;0
14830;197030;432;88;24;1;23;.958;3600000;0
14830;191713;441;0;0;0;0;.00nan;0;0
14831;184336;429;65;35;3;32;.914;4196000;0
14831;202180;429;0;0;0;0;.00nan;0;0
14831;191171;431;0;0;0;0;.00nan;0;0
14831;-1;431;85;40;3;37;.925;4200000;0
14832;199892;421;0;0;0;0;.00nan;0;0
14832;179169;421;58;23;4;19;.826;3578000;0
14832;186076;420;0;0;0;0;.00nan;0;0
14832;-1;420;81;37;3;34;.919;3600000;0
14833;194390;441;53;46;6;40;.870;3154000;0
14833;202171;439;0;0;0;0;.00nan;0;0
14833;181338;439;59;24;2;22;.917;3600000;0
14833;191713;441;42;4;1;3;.750;446000;0
14834;188965;423;0;0;0;0;.00nan;0;0
14834;189288;419;0;0;0;0;.00nan;0;0
14834;179071;423;100;24;0;24;1.000;3600000;0
14834;196975;419;67;34;3;31;.912;3600000;0
14835;-1;428;0;0;0;0;.00nan;0;0
14835;-1;434;56;20;3;17;.850;3600000;0
14835;186671;434;0;0;0;0;.00nan;0;0
14835;196979;428;58;42;5;37;.881;3588000;0
14836;179127;422;0;0;0;0;.00nan;0;0
14836;207137;418;74;37;3;34;.919;3542000;0
14836;180578;422;65;17;1;16;.941;3600000;0
14836;191687;418;0;0;0;0;.00nan;0;0
14837;194456;414;51;39;6;33;.846;3600000;0
14837;190073;413;0;0;0;0;.00nan;0;0
14837;187309;414;0;0;0;0;.00nan;0;0
14837;192627;413;81;23;1;22;.957;3600000;0
14838;184336;429;0;0;0;0;.00nan;0;0
14838;190157;442;87;33;2;31;.939;3600000;0
14838;202180;429;78;43;3;40;.930;3600000;0
14838;191849;442;0;0;0;0;.00nan;0;0
14839;173339;430;67;40;4;36;.900;3600000;0
14839;184060;425;0;0;0;0;.00nan;0;0
14839;-1;430;0;0;0;0;.00nan;0;0
14839;-1;425;51;33;5;28;.848;3551000;0
14840;194650;410;76;34;2;32;.941;4200000;0
14840;184033;411;0;0;0;0;.00nan;0;0
14840;184183;410;0;0;0;0;.00nan;0;0
14840;197699;411;84;36;2;34;.944;4200000;0
14841;186468;427;0;0;0;0;.00nan;0;0
14841;191171;431;67;17;1;16;.941;3600000;0
14841;-1;427;58;25;4;21;.840;3600000;0
14841;-1;431;0;0;0;0;.00nan;0;0
14842;168414;444;100;53;1;52;.981;4200000;0
14842;183885;449;77;25;1;24;.960;4200000;0
14842;194630;444;0;0;0;0;.00nan;0;0
14842;-1;449;0;0;0;0;.00nan;0;0
14843;198091;415;0;0;0;0;.00nan;0;0
14843;-1;412;34;30;5;25;.833;3566000;0
14843;191877;415;86;39;3;36;.923;3600000;0
14843;-1;412;0;0;0;0;.00nan;0;0
14844;165023;438;55;4;0;4;1.000;1259000;0
14844;183832;436;73;34;3;31;.912;3600000;0
14844;176196;438;51;26;4;22;.846;2310000;0
14844;191861;436;0;0;0;0;.00nan;0;0
14845;194751;443;79;44;3;41;.932;3871000;0
14845;194803;443;0;0;0;0;.00nan;0;0
14845;189783;440;73;34;4;30;.882;3871000;0
14845;175723;440;0;0;0;0;.00nan;0;0
14846;182475;437;0;0;0;0;.00nan;0;0
14846;186571;437;63;34;4;30;.882;3586000;0
14846;-1;426;0;0;0;0;.00nan;0;0
14846;-1;426;82;34;2;32;.941;3600000;0
14847;199892;421;77;21;1;20;.952;3600000;0
14847;179169;421;0;0;0;0;.00nan;0;0
14847;186076;420;0;0;0;0;.00nan;0;0
14847;-1;420;87;34;2;32;.941;3556000;0
14848;188965;423;0;0;0;0;.00nan;0;0
14848;189288;419;81;25;1;24;.960;3600000;0
14848;179071;423;76;27;2;25;.926;3586000;0
14848;196975;419;0;0;0;0;.00nan;0;0
14849;182475;437;60;28;4;24;.857;3579000;0
14849;194221;433;0;0;0;0;.00nan;0;0
14849;186571;437;0;0;0;0;.00nan;0;0
14849;191212;433;88;38;2;36;.947;3600000;0
14850;187660;417;89;36;2;34;.944;3600000;0
14850;184033;411;62;43;5;38;.884;3600000;0
14850;194854;417;0;0;0;0;.00nan;0;0
14850;197699;411;0;0;0;0;.00nan;0;0
14851;165023;438;0;0;0;0;.00nan;0;0
14851;-1;428;0;0;0;0;.00nan;0;0
14851;176196;438;51;16;2;14;.875;3555000;0
14851;196979;428;93;31;1;30;.968;3600000;0
14852;190073;413;65;22;2;20;.909;3600000;0
14852;-1;412;48;7;1;6;.857;808000;0
14852;192627;413;0;0;0;0;.00nan;0;0
14852;-1;412;18;22;6;16;.727;2792000;0
14853;179127;422;90;27;1;26;.963;3600000;0
14853;207137;418;0;0;0;0;.00nan;0;0
14853;180578;422;0;0;0;0;.00nan;0;0
14853;191687;418;76;30;2;28;.933;3561000;0
14854;190157;442;56;4;0;4;1.000;456000;0
14854;186468;427;72;22;2;20;.909;3600000;0
14854;191849;442;65;47;6;41;.872;3144000;0
14854;-1;427;0;0;0;0;.00nan;0;0
14855;194146;432;94;47;3;44;.936;3556000;0
14855;202171;439;75;31;2;29;.935;3600000;0
14855;181338;439;0;0;0;0;.00nan;0;0
14855;197030;432;0;0;0;0;.00nan;0;0
14856;168414;444;0;0;0;0;.00nan;0;0
14856;183885;449;0;0;0;0;.00nan;0;0
14856;194630;444;80;20;1;19;.950;3600000;0
14856;-1;449;36;26;5;21;.808;3600000;0
14857;198091;415;72;34;4;30;.882;3994000;0
14857;194456;414;0;0;0;0;.00nan;0;0
14857;187309;414;71;58;5;53;.914;3994000;0
14857;191877;415;0;0;0;0;.00nan;0;0
14858;183832;436;0;0;0;0;.00nan;0;0
14858;-1;434;0;0;0;0;.00nan;0;0
14858;186671;434;65;22;2;20;.909;3615000;0
14858;191861;436;77;37;3;34;.919;3615000;0
14859;194751;443;0;0;0;0;.00nan;0;0
14859;194803;443;64;35;4;31;.886;3630000;0
14859;189783;440;0;0;0;0;.00nan;0;0
14859;175723;440;69;28;3;25;.893;3630000;0
14860;184060;425;67;23;2;21;.913;3600000;0
14860;178743;435;0;0;0;0;.00nan;0;0
14860;-1;425;0;0;0;0;.00nan;0;0
14860;-1;435;52;38;5;33;.868;3600000;0
14861;184033;411;0;0;0;0;.00nan;0;0
14861;190073;413;22;21;6;15;.714;2093000;0
14861;192627;413;27;16;4;12;.750;1507000;0
14861;197699;411;73;30;2;28;.933;3600000;0
14862;187660;417;0;0;0;0;.00nan;0;0
14862;194854;417;64;40;5;35;.875;3600000;0
14862;-1;412;64;21;2;19;.905;3600000;0
14862;-1;412;0;0;0;0;.00nan;0;0
14863;194146;432;0;0;0;0;.00nan;0;0
14863;191171;431;0;0;0;0;.00nan;0;0
14863;197030;432;84;34;2;32;.941;3556000;0
14863;-1;431;66;14;1;13;.929;3600000;0
14864;194221;433;54;15;1;14;.933;1913000;0
14864;-1;434;0;0;0;0;.00nan;0;0
14864;186671;434;65;37;5;32;.865;4200000;0
14864;191212;433;34;20;4;16;.800;2287000;0
14865;202171;439;0;0;0;0;.00nan;0;0
14865;181338;439;74;19;1;18;.947;3600000;0
14865;191171;431;0;0;0;0;.00nan;0;0
14865;-1;431;96;41;2;39;.951;3600000;0
14866;188965;423;0;0;0;0;.00nan;0;0
14866;183885;449;89;15;0;15;1.000;3600000;0
14866;179071;423;88;41;3;38;.927;3600000;0
14866;-1;449;0;0;0;0;.00nan;0;0
14867;187660;417;66;22;2;20;.909;3600000;0
14867;194456;414;46;42;7;35;.833;3600000;0
14867;194854;417;0;0;0;0;.00nan;0;0
14867;187309;414;0;0;0;0;.00nan;0;0
14868;182475;437;0;0;0;0;.00nan;0;0
14868;165023;438;0;0;0;0;.00nan;0;0
14868;176196;438;79;25;1;24;.960;3600000;0
14868;186571;437;33;26;5;21;.808;3600000;0
14869;-1;428;0;0;0;0;.00nan;0;0
14869;190157;442;77;31;2;29;.935;3527000;0
14869;196979;428;86;22;0;22;1.000;3600000;0
14869;191849;442;0;0;0;0;.00nan;0;0
14870;189288;419;0;0;0;0;.00nan;0;0
14870;186076;420;0;0;0;0;.00nan;0;0
14870;196975;419;100;27;0;27;1.000;3600000;0
14870;-1;420;54;30;4;26;.867;3600000;0
14871;203194;4849;99;39;1;38;.974;3600000;0
14871;207137;418;52;24;3;21;.875;3544000;0
14871;196412;4849;0;0;0;0;.00nan;0;0
14871;191687;418;0;0;0;0;.00nan;0;0
14872;178743;435;46;15;2;13;.867;1479000;0
14872;186468;427;0;0;0;0;.00nan;0;0
14872;-1;427;35;20;4;16;.800;3600000;0
14872;-1;435;22;28;6;22;.786;2121000;0
14873;173339;430;62;23;2;21;.913;3600000;0
14873;189783;440;49;25;3;22;.880;3565000;0
14873;175723;440;0;0;0;0;.00nan;0;0
14873;-1;430;0;0;0;0;.00nan;0;0
14874;199892;421;66;23;2;21;.913;3600000;0
14874;179127;422;0;0;0;0;.00nan;0;0
14874;179169;421;0;0;0;0;.00nan;0;0
14874;180578;422;75;39;4;35;.897;3591000;0
14875;184060;425;0;0;0;0;.00nan;0;0
14875;194751;443;56;25;4;21;.840;3543000;0
14875;194803;443;0;0;0;0;.00nan;0;0
14875;-1;425;60;23;2;21;.913;3600000;0
14876;194650;410;0;0;0;0;.00nan;0;0
14876;184183;410;53;45;5;40;.889;3600000;0
14876;-1;412;61;17;2;15;.882;3600000;0
14876;-1;412;0;0;0;0;.00nan;0;0
14877;198091;415;86;39;2;37;.949;3600000;0
14877;184033;411;0;0;0;0;.00nan;0;0
14877;191877;415;0;0;0;0;.00nan;0;0
14877;197699;411;54;24;3;21;.875;3573000;0
14878;194390;441;65;37;4;33;.892;3600000;0
14878;183832;436;0;0;0;0;.00nan;0;0
14878;191713;441;0;0;0;0;.00nan;0;0
14878;191861;436;86;31;1;30;.968;3600000;0
14879;184336;429;82;42;3;39;.929;3600000;0
14879;202180;429;0;0;0;0;.00nan;0;0
14879;-1;426;0;0;0;0;.00nan;0;0
14879;-1;426;95;19;0;19;1.000;3600000;0
14880;188965;423;50;30;4;26;.867;3600000;0
14880;183885;449;79;35;3;32;.914;3600000;0
14880;179071;423;0;0;0;0;.00nan;0;0
14880;-1;449;0;0;0;0;.00nan;0;0
14881;182475;437;49;37;6;31;.838;2293000;0
14881;-1;434;65;31;3;28;.903;3600000;0
14881;186571;437;80;13;0;13;1.000;1307000;0
14881;186671;434;0;0;0;0;.00nan;0;0
14882;-1;428;0;0;0;0;.00nan;0;0
14882;202171;439;79;25;1;24;.960;3600000;0
14882;181338;439;0;0;0;0;.00nan;0;0
14882;196979;428;64;40;4;36;.900;3600000;0
14883;189288;419;0;0;0;0;.00nan;0;0
14883;186076;420;42;3;1;2;.667;963000;0
14883;196975;419;79;30;1;29;.967;3600000;0
14883;-1;420;10;27;7;20;.741;2637000;0
14884;198091;415;0;0;0;0;.00nan;0;0
14884;190073;413;0;0;0;0;.00nan;0;0
14884;191877;415;81;34;2;32;.941;3557000;0
14884;192627;413;90;23;0;23;1.000;3600000;0
14885;203194;4849;0;0;0;0;.00nan;0;0
14885;207137;418;0;0;0;0;.00nan;0;0
14885;196412;4849;64;39;5;34;.872;3590000;0
14885;191687;418;48;26;4;22;.846;3600000;0
14886;194221;433;0;0;0;0;.00nan;0;0
14886;178743;435;62;41;5;36;.878;3600000;0
14886;191212;433;97;22;0;22;1.000;3600000;0
14886;-1;435;0;0;0;0;.00nan;0;0
14887;173339;430;0;0;0;0;.00nan;0;0
14887;194751;443;0;0;0;0;.00nan;0;0
14887;194803;443;39;23;4;19;.826;3600000;0
14887;-1;430;57;36;5;31;.861;3569000;0
14888;199892;421;0;0;0;0;.00nan;0;0
14888;179127;422;100;31;0;31;1.000;3600000;0
14888;179169;421;85;35;2;33;.943;3548000;0
14888;180578;422;0;0;0;0;.00nan;0;0
14889;184060;425;65;24;2;22;.917;3600000;0
14889;189783;440;0;0;0;0;.00nan;0;0
14889;175723;440;62;33;3;30;.909;3550000;0
14889;-1;425;0;0;0;0;.00nan;0;0
14890;194456;414;0;0;0;0;.00nan;0;0
14890;194650;410;85;47;3;44;.936;3527000;0
14890;184183;410;0;0;0;0;.00nan;0;0
14890;187309;414;74;22;1;21;.955;3600000;0
14891;194146;432;0;0;0;0;.00nan;0;0
14891;194390;441;98;24;0;24;1.000;3600000;0
14891;197030;432;68;23;2;21;.913;3529000;0
14891;191713;441;0;0;0;0;.00nan;0;0
14892;183832;436;58;33;5;28;.848;3581000;0
14892;190157;442;0;0;0;0;.00nan;0;0
14892;191849;442;73;43;4;39;.907;3600000;0
14892;191861;436;0;0;0;0;.00nan;0;0
14893;186468;427;86;14;0;14;1.000;3600000;0
14893;-1;426;0;0;0;0;.00nan;0;0
14893;-1;426;62;30;3;27;.900;3600000;0
14893;-1;427;0;0;0;0;.00nan;0;0
14894;194390;441;85;29;2;27;.931;3600000;0
14894;190157;442;51;31;4;27;.871;3600000;0
14894;191713;441;0;0;0;0;.00nan;0;0
14894;191849;442;0;0;0;0;.00nan;0;0
14895;194456;414;75;50;5;45;.900;3600000;0
14895;184033;411;0;0;0;0;.00nan;0;0
14895;187309;414;0;0;0;0;.00nan;0;0
14895;197699;411;65;19;1;18;.947;3600000;0
14896;194650;410;0;0;0;0;.00nan;0;0
14896;184183;410;100;32;0;32;1.000;3600000;0
14896;190073;413;0;0;0;0;.00nan;0;0
14896;192627;413;42;20;4;16;.800;3600000;0
14897;-1;428;0;0;0;0;.00nan;0;0
14897;178743;435;0;0;0;0;.00nan;0;0
14897;196979;428;75;30;2;28;.933;3805000;0
14897;-1;435;87;30;1;29;.967;3805000;0
14898;194456;414;98;50;4;46;.920;4200000;0
14898;-1;412;53;35;4;31;.886;4200000;0
14898;187309;414;0;0;0;0;.00nan;0;0
14898;-1;412;0;0;0;0;.00nan;0;0
14899;179127;422;62;29;3;26;.897;3600000;0
14899;180578;422;0;0;0;0;.00nan;0;0
14899;186076;420;0;0;0;0;.00nan;0;0
14899;-1;420;100;23;0;23;1.000;3600000;0
14900;194390;441;84;39;3;36;.923;3564000;0
14900;186468;427;72;19;1;18;.947;3600000;0
14900;191713;441;0;0;0;0;.00nan;0;0
14900;-1;427;0;0;0;0;.00nan;0;0
14901;194221;433;0;0;0;0;.00nan;0;0
14901;-1;428;41;31;5;26;.839;3600000;0
14901;191212;433;80;28;1;27;.964;3600000;0
14901;196979;428;0;0;0;0;.00nan;0;0
14902;187660;417;0;0;0;0;.00nan;0;0
14902;194854;417;74;20;1;19;.950;3600000;0
14902;190073;413;59;27;3;24;.889;3600000;0
14902;192627;413;0;0;0;0;.00nan;0;0
14903;173339;430;0;0;0;0;.00nan;0;0
14903;-1;434;0;0;0;0;.00nan;0;0
14903;186671;434;49;30;4;26;.867;3600000;0
14903;-1;430;100;35;0;35;1.000;3600000;0
14904;184336;429;94;44;2;42;.955;3949000;0
14904;202171;439;78;26;1;25;.962;3949000;0
14904;181338;439;0;0;0;0;.00nan;0;0
14904;202180;429;0;0;0;0;.00nan;0;0
14905;168414;444;36;28;6;22;.786;3600000;0
14905;194630;444;0;0;0;0;.00nan;0;0
14905;207137;418;62;23;2;21;.913;3600000;0
14905;191687;418;0;0;0;0;.00nan;0;0
14906;198091;415;8;24;7;17;.708;3582000;0
14906;194650;410;49;34;5;29;.853;3600000;0
14906;184183;410;0;0;0;0;.00nan;0;0
14906;191877;415;0;0;0;0;.00nan;0;0
14907;194146;432;80;30;1;29;.967;3540000;0
14907;183832;436;37;25;5;20;.800;3800000;0
14907;197030;432;23;3;3;0;.000;260000;0
14907;191861;436;0;0;0;0;.00nan;0;0
14908;182475;437;0;0;0;0;.00nan;0;0
14908;186571;437;86;33;1;32;.970;3600000;0
14908;191171;431;0;0;0;0;.00nan;0;0
14908;-1;431;58;27;3;24;.889;3544000;0
14909;203194;4849;26;10;3;7;.700;570000;0
14909;188965;423;0;0;0;0;.00nan;0;0
14909;179071;423;100;27;0;27;1.000;3600000;0
14909;196412;4849;67;21;1;20;.952;3030000;0
14910;199892;421;0;0;0;0;.00nan;0;0
14910;183885;449;88;29;2;27;.931;3600000;0
14910;179169;421;64;33;4;29;.879;3553000;0
14910;-1;449;0;0;0;0;.00nan;0;0
14911;165023;438;0;0;0;0;.00nan;0;0
14911;184060;425;0;0;0;0;.00nan;0;0
14911;176196;438;100;39;1;38;.974;4200000;0
14911;-1;425;72;23;1;22;.957;4200000;0
14912;194751;443;0;0;0;0;.00nan;0;0
14912;194803;443;81;25;0;25;1.000;4200000;0
14912;189783;440;100;37;0;37;1.000;4200000;0
14912;175723;440;0;0;0;0;.00nan;0;0
14913;202171;439;0;0;0;0;.00nan;0;0
14913;181338;439;78;35;2;33;.943;3600000;0
14913;186468;427;0;0;0;0;.00nan;0;0
14913;-1;427;63;23;3;20;.870;3551000;0
14914;194221;433;50;27;3;24;.889;3935000;0
14914;183832;436;48;26;4;22;.846;3878000;0
14914;191212;433;0;0;0;0;.00nan;0;0
14914;191861;436;0;0;0;0;.00nan;0;0
14915;198091;415;0;0;0;0;.00nan;0;0
14915;187660;417;65;29;3;26;.897;3600000;0
14915;194854;417;0;0;0;0;.00nan;0;0
14915;191877;415;65;40;4;36;.900;3600000;0
14916;179127;422;0;0;0;0;.00nan;0;0
14916;180578;422;77;30;2;28;.933;3831000;0
14916;186076;420;0;0;0;0;.00nan;0;0
14916;-1;420;79;32;3;29;.906;3831000;0
14917;184060;425;63;25;2;23;.920;3531000;0
14917;-1;434;100;29;0;29;1.000;3600000;0
14917;186671;434;0;0;0;0;.00nan;0;0
14917;-1;425;0;0;0;0;.00nan;0;0
14918;178743;435;0;0;0;0;.00nan;0;0
14918;190157;442;84;36;2;34;.944;3600000;0
14918;191849;442;0;0;0;0;.00nan;0;0
14918;-1;435;72;40;4;36;.900;3546000;0
14919;194390;441;0;0;0;0;.00nan;0;0
14919;184336;429;0;0;0;0;.00nan;0;0
14919;202180;429;88;19;0;19;1.000;4200000;0
14919;191713;441;97;49;0;49;1.000;4200000;0
14920;168414;444;0;0;0;0;.00nan;0;0
14920;194630;444;100;53;0;53;1.000;4200000;0
14920;207137;418;0;0;0;0;.00nan;0;0
14920;191687;418;66;18;0;18;1.000;4200000;0
14921;182475;437;0;0;0;0;.00nan;0;0
14921;186571;437;99;22;0;22;1.000;3600000;0
14921;191171;431;45;34;5;29;.853;3600000;0
14921;-1;431;0;0;0;0;.00nan;0;0
14922;203194;4849;51;39;5;34;.872;2959000;0
14922;188965;423;0;0;0;0;.00nan;0;0
14922;179071;423;60;27;3;24;.889;3600000;0
14922;196412;4849;59;10;0;10;1.000;587000;0
14923;199892;421;51;24;3;21;.875;3578000;0
14923;183885;449;0;0;0;0;.00nan;0;0
14923;179169;421;0;0;0;0;.00nan;0;0
14923;-1;449;99;45;1;44;.978;3600000;0
14924;184033;411;0;0;0;0;.00nan;0;0
14924;-1;412;0;0;0;0;.00nan;0;0
14924;-1;412;61;35;4;31;.886;3600000;0
14924;197699;411;99;31;1;30;.968;3600000;0
14925;165023;438;94;37;2;35;.946;4200000;0
14925;173339;430;0;0;0;0;.00nan;0;0
14925;176196;438;0;0;0;0;.00nan;0;0
14925;-1;430;64;30;2;28;.933;4200000;0
14926;194751;443;0;0;0;0;.00nan;0;0
14926;194803;443;100;37;1;36;.973;3600000;0
14926;-1;426;63;25;2;23;.920;3587000;0
14926;-1;426;0;0;0;0;.00nan;0;0
14927;189783;440;58;29;4;25;.862;3600000;0
14927;175723;440;0;0;0;0;.00nan;0;0
14927;-1;426;0;0;0;0;.00nan;0;0
14927;-1;426;41;31;5;26;.839;3580000;0
14928;184336;429;0;0;0;0;.00nan;0;0
14928;-1;434;60;27;3;24;.889;3544000;0
14928;202180;429;94;45;2;43;.956;3600000;0
14928;186671;434;0;0;0;0;.00nan;0;0
14929;194456;414;72;31;3;28;.903;3568000;0
14929;-1;412;0;0;0;0;.00nan;0;0
14929;187309;414;0;0;0;0;.00nan;0;0
14929;-1;412;75;30;2;28;.933;3600000;0
14930;184336;429;0;0;0;0;.00nan;0;0
14930;202180;429;94;42;1;41;.976;4200000;0
14930;186468;427;0;0;0;0;.00nan;0;0
14930;-1;427;87;36;1;35;.972;4200000;0
14931;202171;439;0;0;0;0;.00nan;0;0
14931;181338;439;68;20;1;19;.950;3600000;0
14931;191171;431;0;0;0;0;.00nan;0;0
14931;-1;431;82;44;3;41;.932;3600000;0
14932;203194;4849;77;30;2;28;.933;3600000;0
14932;196412;4849;0;0;0;0;.00nan;0;0
14932;186076;420;69;31;3;28;.903;3600000;0
14932;-1;420;0;0;0;0;.00nan;0;0
14933;188965;423;0;0;0;0;.00nan;0;0
14933;179071;423;61;24;2;22;.917;3600000;0
14933;179127;422;69;37;3;34;.919;3600000;0
14933;180578;422;0;0;0;0;.00nan;0;0
14934;194390;441;0;0;0;0;.00nan;0;0
14934;-1;426;0;0;0;0;.00nan;0;0
14934;-1;426;74;21;1;20;.952;4200000;0
14934;191713;441;84;39;1;38;.974;4200000;0
14935;182475;437;0;0;0;0;.00nan;0;0
14935;173339;430;0;0;0;0;.00nan;0;0
14935;186571;437;65;28;3;25;.893;4200000;0
14935;-1;430;52;28;3;25;.893;4200000;0
14936;183885;449;0;0;0;0;.00nan;0;0
14936;189288;419;0;0;0;0;.00nan;0;0
14936;-1;449;49;28;4;24;.857;3580000;0
14936;196975;419;95;43;2;41;.953;3600000;0
14937;194751;443;78;33;3;30;.909;3594000;0
14937;194803;443;0;0;0;0;.00nan;0;0
14937;-1;434;0;0;0;0;.00nan;0;0
14937;186671;434;100;40;2;38;.950;3600000;0
14938;187660;417;0;0;0;0;.00nan;0;0
14938;194854;417;100;35;0;35;1.000;3600000;0
14938;190073;413;0;0;0;0;.00nan;0;0
14938;192627;413;90;32;1;31;.969;3545000;0
14939;194146;432;0;0;0;0;.00nan;0;0
14939;190157;442;100;39;2;37;.949;3600000;0
14939;197030;432;49;29;5;24;.828;3600000;0
14939;191849;442;0;0;0;0;.00nan;0;0
14940;194221;433;0;0;0;0;.00nan;0;0
14940;191171;431;64;30;3;27;.900;3639000;0
14940;191212;433;66;20;2;18;.900;3639000;0
14940;-1;431;0;0;0;0;.00nan;0;0
14941;198091;415;26;22;6;16;.727;3589000;0
14941;194650;410;61;31;4;27;.871;3600000;0
14941;184183;410;0;0;0;0;.00nan;0;0
14941;191877;415;0;0;0;0;.00nan;0;0
14942;194456;414;67;42;4;38;.905;3600000;0
14942;184033;411;85;11;0;11;1.000;3600000;0
14942;187309;414;0;0;0;0;.00nan;0;0
14942;197699;411;0;0;0;0;.00nan;0;0
14943;165023;438;0;0;0;0;.00nan;0;0
14943;189783;440;95;45;3;42;.933;3575000;0
14943;175723;440;0;0;0;0;.00nan;0;0
14943;176196;438;64;21;2;19;.905;3600000;0
14944;183832;436;0;0;0;0;.00nan;0;0
14944;-1;428;0;0;0;0;.00nan;0;0
14944;196979;428;68;24;2;22;.917;3548000;0
14944;191861;436;92;29;1;28;.966;3600000;0
14945;203194;4849;0;0;0;0;.00nan;0;0
14945;196412;4849;79;40;3;37;.925;3600000;0
14945;186076;420;0;0;0;0;.00nan;0;0
14945;-1;420;48;35;5;30;.857;3545000;0
14946;194390;441;90;39;2;37;.949;3600000;0
14946;202171;439;61;34;4;30;.882;3515000;0
14946;181338;439;0;0;0;0;.00nan;0;0
14946;191713;441;0;0;0;0;.00nan;0;0
14947;178743;435;0;0;0;0;.00nan;0;0
14947;186468;427;0;0;0;0;.00nan;0;0
14947;-1;427;77;13;0;13;1.000;3600000;0
14947;-1;435;79;34;2;32;.941;3567000;0
14948;182475;437;68;29;2;27;.931;4200000;0
14948;184060;425;0;0;0;0;.00nan;0;0
14948;186571;437;0;0;0;0;.00nan;0;0
14948;-1;425;67;34;2;32;.941;4200000;0
14949;188965;423;76;32;2;30;.938;3600000;0
14949;179071;423;0;0;0;0;.00nan;0;0
14949;179127;422;0;0;0;0;.00nan;0;0
14949;180578;422;31;32;6;26;.813;3600000;0
14950;183885;449;55;31;4;27;.871;3600000;0
14950;189288;419;66;26;2;24;.923;3600000;0
14950;-1;449;0;0;0;0;.00nan;0;0
14950;196975;419;0;0;0;0;.00nan;0;0
14951;189783;440;0;0;0;0;.00nan;0;0
14951;175723;440;89;40;3;37;.925;3600000;0
14951;-1;434;24;5;3;2;.400;369000;0
14951;186671;434;71;28;2;26;.929;3231000;0
14952;194650;410;0;0;0;0;.00nan;0;0
14952;184183;410;58;41;5;36;.878;3600000;0
14952;190073;413;65;16;1;15;.938;3600000;0
14952;192627;413;0;0;0;0;.00nan;0;0
14953;194146;432;69;28;3;25;.893;3600000;0
14953;190157;442;69;34;4;30;.882;3600000;0
14953;197030;432;0;0;0;0;.00nan;0;0
14953;191849;442;0;0;0;0;.00nan;0;0
14954;199892;421;0;0;0;0;.00nan;0;0
14954;168414;444;67;19;1;18;.947;1803000;0
14954;194630;444;15;21;6;15;.714;1797000;0
14954;179169;421;100;43;1;42;.977;3600000;0
14955;198091;415;0;0;0;0;.00nan;0;0
14955;187660;417;0;0;0;0;.00nan;0;0
14955;194854;417;65;28;2;26;.929;3600000;0
14955;191877;415;81;40;4;36;.900;3600000;0
14956;184033;411;95;18;0;18;1.000;3600000;0
14956;-1;412;67;43;5;38;.884;3600000;0
14956;-1;412;0;0;0;0;.00nan;0;0
14956;197699;411;0;0;0;0;.00nan;0;0
14957;165023;438;74;29;3;26;.897;3600000;0
14957;194751;443;0;0;0;0;.00nan;0;0
14957;194803;443;73;28;2;26;.929;3600000;0
14957;176196;438;0;0;0;0;.00nan;0;0
14958;194221;433;77;47;5;42;.894;3600000;0
14958;191212;433;0;0;0;0;.00nan;0;0
14958;-1;426;46;12;2;10;.833;3600000;0
14958;-1;426;0;0;0;0;.00nan;0;0
14959;178743;435;100;33;0;33;1.000;3600000;0
14959;184336;429;0;0;0;0;.00nan;0;0
14959;202180;429;55;22;2;20;.909;3525000;0
14959;-1;435;0;0;0;0;.00nan;0;0
14960;199892;421;79;26;2;24;.923;3600000;0
14960;168414;444;71;35;3;32;.914;3558000;0
14960;194630;444;0;0;0;0;.00nan;0;0
14960;179169;421;0;0;0;0;.00nan;0;0
14961;187660;417;79;26;1;25;.962;3600000;0
14961;194650;410;8;25;7;18;.720;2697000;0
14961;194854;417;0;0;0;0;.00nan;0;0
14961;184183;410;60;8;0;8;1.000;903000;0
14962;202171;439;86;29;1;28;.966;3600000;0
14962;181338;439;0;0;0;0;.00nan;0;0
14962;-1;426;0;0;0;0;.00nan;0;0
14962;-1;426;49;43;7;36;.837;3600000;0
14963;178743;435;84;42;3;39;.929;4200000;0
14963;-1;426;68;29;3;26;.897;4200000;0
14963;-1;426;0;0;0;0;.00nan;0;0
14963;-1;435;0;0;0;0;.00nan;0;0
14964;194221;433;0;0;0;0;.00nan;0;0
14964;184336;429;0;0;0;0;.00nan;0;0
14964;202180;429;60;23;2;21;.913;3719000;0
14964;191212;433;71;37;3;34;.919;3719000;0
14965;190073;413;68;20;2;18;.900;3600000;0
14965;-1;412;0;0;0;0;.00nan;0;0
14965;192627;413;0;0;0;0;.00nan;0;0
14965;-1;412;62;30;3;27;.900;3589000;0
14966;188965;423;0;0;0;0;.00nan;0;0
14966;179071;423;73;31;2;29;.935;3600000;0
14966;186076;420;46;5;1;4;.800;423000;0
14966;-1;420;21;22;6;16;.727;3177000;0
14967;187660;417;0;0;0;0;.00nan;0;0
14967;184033;411;34;24;5;19;.792;3586000;0
14967;194854;417;66;23;3;20;.870;3600000;0
14967;197699;411;0;0;0;0;.00nan;0;0
14968;165023;438;0;0;0;0;.00nan;0;0
14968;194390;441;72;34;3;31;.912;4200000;0
14968;176196;438;45;19;3;16;.842;4200000;0
14968;191713;441;0;0;0;0;.00nan;0;0
14969;182475;437;0;0;0;0;.00nan;0;0
14969;-1;428;0;0;0;0;.00nan;0;0
14969;186571;437;48;23;3;20;.870;3512000;0
14969;196979;428;74;22;1;21;.955;3600000;0
14970;189288;419;0;0;0;0;.00nan;0;0
14970;207137;418;0;0;0;0;.00nan;0;0
14970;196975;419;68;28;3;25;.893;3600000;0
14970;191687;418;72;31;2;29;.935;3600000;0
14971;198091;415;79;32;2;30;.938;3600000;0
14971;194456;414;65;18;1;17;.944;3600000;0
14971;187309;414;0;0;0;0;.00nan;0;0
14971;191877;415;0;0;0;0;.00nan;0;0
14972;194146;432;71;27;1;26;.963;2915000;0
14972;-1;434;0;0;0;0;.00nan;0;0
14972;186671;434;63;26;3;23;.885;3600000;0
14972;197030;432;17;9;4;5;.556;685000;0
14973;203194;4849;72;32;2;30;.938;3551000;0
14973;168414;444;93;20;0;20;1.000;3600000;0
14973;194630;444;0;0;0;0;.00nan;0;0
14973;196412;4849;0;0;0;0;.00nan;0;0
14974;183885;449;0;0;0;0;.00nan;0;0
14974;179127;422;68;23;2;21;.913;3556000;0
14974;-1;449;100;30;0;30;1.000;3600000;0
14974;180578;422;0;0;0;0;.00nan;0;0
14975;194751;443;0;0;0;0;.00nan;0;0
14975;194803;443;100;29;0;29;1.000;3600000;0
14975;190157;442;54;33;4;29;.879;3600000;0
14975;191849;442;0;0;0;0;.00nan;0;0
14976;189783;440;87;31;3;28;.903;3600000;0
14976;175723;440;0;0;0;0;.00nan;0;0
14976;191171;431;0;0;0;0;.00nan;0;0
14976;-1;431;49;35;5;30;.857;3583000;0
14977;198091;415;65;41;5;36;.878;3600000;0
14977;-1;412;100;26;0;26;1.000;3600000;0
14977;191877;415;0;0;0;0;.00nan;0;0
14977;-1;412;0;0;0;0;.00nan;0;0
14978;188965;423;78;25;1;24;.960;3600000;0
14978;179071;423;0;0;0;0;.00nan;0;0
14978;186076;420;48;17;3;14;.824;3515000;0
14978;-1;420;0;0;0;0;.00nan;0;0
14979;165023;438;58;38;4;34;.895;3965000;0
14979;176196;438;0;0;0;0;.00nan;0;0
14979;202171;439;0;0;0;0;.00nan;0;0
14979;181338;439;64;26;3;23;.885;3965000;0
14980;194221;433;0;0;0;0;.00nan;0;0
14980;186468;427;0;0;0;0;.00nan;0;0
14980;191212;433;81;34;3;31;.912;3682000;0
14980;-1;427;72;23;2;21;.913;3682000;0
14981;194390;441;0;0;0;0;.00nan;0;0
14981;183832;436;73;21;1;20;.952;3600000;0
14981;191713;441;66;25;2;23;.920;3572000;0
14981;191861;436;0;0;0;0;.00nan;0;0
14982;182475;437;58;29;3;26;.897;3537000;0
14982;-1;428;89;32;1;31;.969;3600000;0
14982;186571;437;0;0;0;0;.00nan;0;0
14982;196979;428;0;0;0;0;.00nan;0;0
14983;189288;419;63;18;2;16;.889;3600000;0
14983;207137;418;76;40;3;37;.925;3576000;0
14983;196975;419;0;0;0;0;.00nan;0;0
14983;191687;418;0;0;0;0;.00nan;0;0
14984;178743;435;0;0;0;0;.00nan;0;0
14984;184336;429;51;37;5;32;.865;3600000;0
14984;202180;429;0;0;0;0;.00nan;0;0
14984;-1;435;100;28;0;28;1.000;3600000;0
14985;173339;430;62;35;4;31;.886;4096000;0
14985;184060;425;0;0;0;0;.00nan;0;0
14985;-1;430;0;0;0;0;.00nan;0;0
14985;-1;425;65;31;3;28;.903;4096000;0
14986;194456;414;0;0;0;0;.00nan;0;0
14986;190073;413;0;0;0;0;.00nan;0;0
14986;187309;414;92;33;1;32;.970;3600000;0
14986;192627;413;60;27;3;24;.889;3530000;0
14987;194650;410;0;0;0;0;.00nan;0;0
14987;184033;411;0;0;0;0;.00nan;0;0
14987;184183;410;83;46;3;43;.935;4057000;0
14987;197699;411;71;33;2;31;.939;4057000;0
14988;-1;434;49;37;5;32;.865;3600000;0
14988;186671;434;0;0;0;0;.00nan;0;0
14988;191171;431;61;18;2;16;.889;3600000;0
14988;-1;431;0;0;0;0;.00nan;0;0
14989;203194;4849;0;0;0;0;.00nan;0;0
14989;168414;444;74;23;1;22;.957;3600000;0
14989;194630;444;0;0;0;0;.00nan;0;0
14989;196412;4849;65;31;3;28;.903;3592000;0
14990;183885;449;0;0;0;0;.00nan;0;0
14990;179127;422;0;0;0;0;.00nan;0;0
14990;-1;449;90;38;1;37;.974;4200000;0
14990;180578;422;81;21;1;20;.952;4200000;0
14991;194751;443;82;24;1;23;.958;3600000;0
14991;194803;443;0;0;0;0;.00nan;0;0
14991;190157;442;89;47;3;44;.936;3583000;0
14991;191849;442;0;0;0;0;.00nan;0;0
14992;194146;432;0;0;0;0;.00nan;0;0
14992;189783;440;0;0;0;0;.00nan;0;0
14992;175723;440;75;39;4;35;.897;3600000;0
14992;197030;432;84;22;0;22;1.000;3600000;0
14993;184033;411;0;0;0;0;.00nan;0;0
14993;190073;413;86;46;3;43;.935;3600000;0
14993;192627;413;0;0;0;0;.00nan;0;0
14993;197699;411;26;16;4;12;.750;3583000;0
14994;194751;443;0;0;0;0;.00nan;0;0
14994;194803;443;80;35;2;33;.943;3600000;0
14994;202171;439;63;25;3;22;.880;3585000;0
14994;181338;439;0;0;0;0;.00nan;0;0
14995;194221;433;0;0;0;0;.00nan;0;0
14995;184060;425;0;0;0;0;.00nan;0;0
14995;191212;433;53;33;4;29;.879;3544000;0
14995;-1;425;58;25;3;22;.880;3600000;0
14996;182475;437;0;0;0;0;.00nan;0;0
14996;194390;441;69;34;4;30;.882;3600000;0
14996;186571;437;100;22;0;22;1.000;3600000;0
14996;191713;441;0;0;0;0;.00nan;0;0
14997;-1;428;0;0;0;0;.00nan;0;0
14997;191171;431;0;0;0;0;.00nan;0;0
14997;196979;428;99;41;1;40;.976;3672000;0
14997;-1;431;84;37;2;35;.946;3672000;0
14998;203194;4849;75;42;3;39;.929;3600000;0
14998;183885;449;35;23;4;19;.826;3580000;0
14998;-1;449;0;0;0;0;.00nan;0;0
14998;196412;4849;0;0;0;0;.00nan;0;0
14999;186468;427;67;23;2;21;.913;3684000;0
14999;-1;426;69;32;3;29;.906;3684000;0
14999;-1;426;0;0;0;0;.00nan;0;0
14999;-1;427;0;0;0;0;.00nan;0;0
15000;187660;417;58;22;3;19;.864;3600000;0
15000;194854;417;0;0;0;0;.00nan;0;0
15000;-1;412;58;30;4;26;.867;3547000;0
15000;-1;412;0;0;0;0;.00nan;0;0
15001;182475;437;0;0;0;0;.00nan;0;0
15001;194390;441;0;0;0;0;.00nan;0;0
15001;186571;437;93;26;1;25;.962;3600000;0
15001;191713;441;62;39;5;34;.872;3600000;0
15002;168414;444;75;34;3;31;.912;3600000;0
15002;194630;444;0;0;0;0;.00nan;0;0
15002;179127;422;74;20;1;19;.950;3600000;0
15002;180578;422;0;0;0;0;.00nan;0;0
15003;188965;423;0;0;0;0;.00nan;0;0
15003;189288;419;0;0;0;0;.00nan;0;0
15003;179071;423;85;27;2;25;.926;3600000;0
15003;196975;419;78;42;4;38;.905;3513000;0
15004;184336;429;76;19;0;19;1.000;1533000;0
15004;-1;434;0;0;0;0;.00nan;0;0
15004;202180;429;31;26;6;20;.769;2042000;0
15004;186671;434;34;17;4;13;.765;3600000;0
15005;194146;432;0;0;0;0;.00nan;0;0
15005;173339;430;0;0;0;0;.00nan;0;0
15005;197030;432;57;27;4;23;.852;3858000;0
15005;-1;430;82;43;3;40;.930;3858000;0
15006;199892;421;0;0;0;0;.00nan;0;0
15006;179169;421;56;27;4;23;.852;3600000;0
15006;207137;418;45;41;6;35;.854;3586000;0
15006;191687;418;0;0;0;0;.00nan;0;0
15007;194456;414;43;29;5;24;.828;3600000;0
15007;194650;410;74;39;3;36;.923;3600000;0
15007;184183;410;0;0;0;0;.00nan;0;0
15007;187309;414;0;0;0;0;.00nan;0;0
15008;203194;4849;0;0;0;0;.00nan;0;0
15008;183885;449;0;0;0;0;.00nan;0;0
15008;-1;449;58;22;3;19;.864;3600000;0
15008;196412;4849;71;37;5;32;.865;3553000;0
15009;198091;415;80;24;1;23;.958;3600000;0
15009;190073;413;0;0;0;0;.00nan;0;0
15009;191877;415;0;0;0;0;.00nan;0;0
15009;192627;413;75;49;4;45;.918;3600000;0
15010;165023;438;0;0;0;0;.00nan;0;0
15010;176196;438;100;26;0;26;1.000;3600000;0
15010;190157;442;50;24;3;21;.875;3600000;0
15010;191849;442;0;0;0;0;.00nan;0;0
15011;183832;436;87;40;2;38;.950;3585000;0
15011;189783;440;98;26;0;26;1.000;3600000;0
15011;175723;440;0;0;0;0;.00nan;0;0
15011;191861;436;0;0;0;0;.00nan;0;0
15012;194650;410;0;0;0;0;.00nan;0;0
15012;184183;410;84;49;3;46;.939;3600000;0
15012;-1;412;0;0;0;0;.00nan;0;0
15012;-1;412;54;18;2;16;.889;3600000;0
15013;183832;436;0;0;0;0;.00nan;0;0
15013;202171;439;0;0;0;0;.00nan;0;0
15013;181338;439;73;26;1;25;.962;3600000;0
15013;191861;436;48;37;6;31;.838;3600000;0
15014;194221;433;0;0;0;0;.00nan;0;0
15014;173339;430;68;22;2;20;.909;3563000;0
15014;191212;433;82;29;1;28;.966;3600000;0
15014;-1;430;0;0;0;0;.00nan;0;0
15015;-1;428;0;0;0;0;.00nan;0;0
15015;189783;440;51;38;4;34;.895;3563000;0
15015;175723;440;0;0;0;0;.00nan;0;0
15015;196979;428;83;37;2;35;.946;3600000;0
15016;168414;444;0;0;0;0;.00nan;0;0
15016;194630;444;89;17;0;17;1.000;3600000;0
15016;179127;422;0;0;0;0;.00nan;0;0
15016;180578;422;61;27;3;24;.889;3600000;0
15017;188965;423;21;29;7;22;.759;2970000;0
15017;189288;419;65;31;3;28;.903;3600000;0
15017;179071;423;53;3;0;3;1.000;630000;0
15017;196975;419;0;0;0;0;.00nan;0;0
15018;190157;442;49;37;5;32;.865;4200000;0
15018;-1;434;55;45;5;40;.889;4163000;0
15018;186671;434;0;0;0;0;.00nan;0;0
15018;191849;442;0;0;0;0;.00nan;0;0
15019;178743;435;0;0;0;0;.00nan;0;0
15019;191171;431;0;0;0;0;.00nan;0;0
15019;-1;435;100;32;0;32;1.000;3600000;0
15019;-1;431;73;41;4;37;.902;3600000;0
15020;184336;429;0;0;0;0;.00nan;0;0
15020;202180;429;74;38;3;35;.921;3600000;0
15020;-1;426;0;0;0;0;.00nan;0;0
15020;-1;426;74;30;2;28;.933;3600000;0
15021;199892;421;61;30;4;26;.867;3542000;0
15021;179169;421;0;0;0;0;.00nan;0;0
15021;207137;418;0;0;0;0;.00nan;0;0
15021;191687;418;65;34;3;31;.912;3600000;0
15022;194146;432;55;49;6;43;.878;3600000;0
15022;184060;425;63;17;1;16;.941;3600000;0
15022;197030;432;0;0;0;0;.00nan;0;0
15022;-1;425;0;0;0;0;.00nan;0;0
15023;187660;417;0;0;0;0;.00nan;0;0
15023;194456;414;82;30;1;29;.967;3600000;0
15023;194854;417;45;34;6;28;.824;3600000;0
15023;187309;414;0;0;0;0;.00nan;0;0
15024;198091;415;66;7;0;7;1.000;1370000;0
15024;184033;411;77;28;1;27;.964;3600000;0
15024;191877;415;27;29;6;23;.793;2230000;0
15024;197699;411;0;0;0;0;.00nan;0;0
15025;183832;436;0;0;0;0;.00nan;0;0
15025;-1;428;0;0;0;0;.00nan;0;0
15025;196979;428;78;23;1;22;.957;3600000;0
15025;191861;436;71;32;3;29;.906;3556000;0
15026;187660;417;85;31;2;29;.935;3600000;0
15026;194650;410;54;31;4;27;.871;3589000;0
15026;194854;417;0;0;0;0;.00nan;0;0
15026;184183;410;0;0;0;0;.00nan;0;0
15027;194146;432;0;0;0;0;.00nan;0;0
15027;186468;427;0;0;0;0;.00nan;0;0
15027;197030;432;100;37;0;37;1.000;3600000;0
15027;-1;427;30;17;4;13;.765;3600000;0
15028;194221;433;0;0;0;0;.00nan;0;0
15028;184060;425;0;0;0;0;.00nan;0;0
15028;191212;433;67;34;3;31;.912;3600000;0
15028;-1;425;74;22;1;21;.955;3600000;0
15029;199892;421;0;0;0;0;.00nan;0;0
15029;179127;422;71;23;2;21;.913;3600000;0
15029;179169;421;76;41;4;37;.902;3557000;0
15029;180578;422;0;0;0;0;.00nan;0;0
15030;190073;413;89;37;2;35;.946;3600000;0
15030;-1;412;99;22;0;22;1.000;3600000;0
15030;192627;413;0;0;0;0;.00nan;0;0
15030;-1;412;0;0;0;0;.00nan;0;0
15031;188965;423;0;0;0;0;.00nan;0;0
15031;179071;423;37;21;5;16;.762;3807000;0
15031;207137;418;56;34;4;30;.882;3807000;0
15031;191687;418;0;0;0;0;.00nan;0;0
15032;190157;442;64;10;0;10;1.000;1454000;0
15032;191171;431;0;0;0;0;.00nan;0;0
15032;191849;442;21;24;6;18;.750;2146000;0
15032;-1;431;47;28;4;24;.857;3600000;0
15033;165023;438;0;0;0;0;.00nan;0;0
15033;178743;435;0;0;0;0;.00nan;0;0
15033;176196;438;58;18;2;16;.889;3600000;0
15033;-1;435;95;49;3;46;.939;3596000;0
15034;182475;437;0;0;0;0;.00nan;0;0
15034;184336;429;0;0;0;0;.00nan;0;0
15034;202180;429;65;28;3;25;.893;3600000;0
15034;186571;437;44;36;6;30;.833;3600000;0
15035;194221;433;40;31;5;26;.839;3600000;0
15035;173339;430;0;0;0;0;.00nan;0;0
15035;191212;433;0;0;0;0;.00nan;0;0
15035;-1;430;66;20;1;19;.950;3600000;0
15036;168414;444;0;0;0;0;.00nan;0;0
15036;194630;444;68;27;2;25;.926;3600000;0
15036;186076;420;46;32;5;27;.844;3600000;0
15036;-1;420;0;0;0;0;.00nan;0;0
15037;203194;4849;100;31;0;31;1.000;3600000;0
15037;189288;419;0;0;0;0;.00nan;0;0
15037;196412;4849;0;0;0;0;.00nan;0;0
15037;196975;419;52;42;5;37;.881;3600000;0
15038;198091;415;84;34;2;32;.941;3576000;0
15038;194456;414;85;27;1;26;.963;3600000;0
15038;187309;414;0;0;0;0;.00nan;0;0
15038;191877;415;0;0;0;0;.00nan;0;0
15039;194650;410;0;0;0;0;.00nan;0;0
15039;184033;411;83;13;0;13;1.000;3600000;0
15039;184183;410;49;34;5;29;.853;3600000;0
15039;197699;411;0;0;0;0;.00nan;0;0
15040;-1;428;0;0;0;0;.00nan;0;0
15040;194751;443;54;24;3;21;.875;3552000;0
15040;194803;443;0;0;0;0;.00nan;0;0
15040;196979;428;57;21;2;19;.905;3600000;0
15041;194390;441;63;42;5;37;.881;3600000;0
15041;189783;440;0;0;0;0;.00nan;0;0
15041;175723;440;87;22;1;21;.955;3600000;0
15041;191713;441;0;0;0;0;.00nan;0;0
15042;-1;434;0;0;0;0;.00nan;0;0
15042;186671;434;88;20;0;20;1.000;3600000;0
15042;-1;426;78;34;2;32;.941;3564000;0
15042;-1;426;0;0;0;0;.00nan;0;0
15043;188965;423;31;23;5;18;.783;1709000;0
15043;179071;423;70;12;0;12;1.000;1836000;0
15043;207137;418;0;0;0;0;.00nan;0;0
15043;191687;418;57;39;4;35;.897;3600000;0
15044;182475;437;28;10;3;7;.700;511000;0
15044;186468;427;0;0;0;0;.00nan;0;0
15044;186571;437;67;32;2;30;.938;3089000;0
15044;-1;427;74;25;2;23;.920;3600000;0
15045;199892;421;65;23;2;21;.913;3600000;0
15045;179127;422;0;0;0;0;.00nan;0;0
15045;179169;421;0;0;0;0;.00nan;0;0
15045;180578;422;56;34;5;29;.853;3600000;0
15046;194456;414;43;31;6;25;.806;3600000;0
15046;190073;413;0;0;0;0;.00nan;0;0
15046;187309;414;0;0;0;0;.00nan;0;0
15046;192627;413;54;29;4;25;.862;3600000;0
15047;190157;442;96;29;1;28;.966;3600000;0
15047;191171;431;77;42;3;39;.929;3518000;0
15047;191849;442;0;0;0;0;.00nan;0;0
15047;-1;431;0;0;0;0;.00nan;0;0
15048;178743;435;75;46;5;41;.891;3600000;0
15048;-1;434;0;0;0;0;.00nan;0;0
15048;186671;434;63;19;2;17;.895;3600000;0
15048;-1;435;0;0;0;0;.00nan;0;0
15049;168414;444;51;37;5;32;.865;3551000;0
15049;194630;444;0;0;0;0;.00nan;0;0
15049;186076;420;0;0;0;0;.00nan;0;0
15049;-1;420;68;29;3;26;.897;3600000;0
15050;194146;432;0;0;0;0;.00nan;0;0
15050;184336;429;0;0;0;0;.00nan;0;0
15050;202180;429;73;26;1;25;.962;3600000;0
15050;197030;432;92;38;2;36;.947;3600000;0
15051;203194;4849;43;44;8;36;.818;3600000;0
15051;189288;419;53;22;3;19;.864;3600000;0
15051;196412;4849;0;0;0;0;.00nan;0;0
15051;196975;419;0;0;0;0;.00nan;0;0
15052;198091;415;99;45;1;44;.978;3600000;0
15052;-1;412;97;47;2;45;.957;3560000;0
15052;191877;415;0;0;0;0;.00nan;0;0
15052;-1;412;0;0;0;0;.00nan;0;0
15053;187660;417;0;0;0;0;.00nan;0;0
15053;184033;411;80;21;1;20;.952;3600000;0
15053;194854;417;74;35;3;32;.914;3600000;0
15053;197699;411;0;0;0;0;.00nan;0;0
15054;183832;436;0;0;0;0;.00nan;0;0
15054;194751;443;0;0;0;0;.00nan;0;0
15054;194803;443;50;35;5;30;.857;3600000;0
15054;191861;436;89;21;0;21;1.000;3600000;0
15055;189783;440;89;29;2;27;.931;3600000;0
15055;175723;440;0;0;0;0;.00nan;0;0
15055;202171;439;19;16;5;11;.688;3600000;0
15055;181338;439;0;0;0;0;.00nan;0;0
15056;165023;438;75;26;1;25;.962;4189000;0
15056;176196;438;0;0;0;0;.00nan;0;0
15056;-1;426;0;0;0;0;.00nan;0;0
15056;-1;426;94;55;2;53;.964;4189000;0
15057;194456;414;85;37;3;34;.919;3664000;0
15057;-1;412;0;0;0;0;.00nan;0;0
15057;187309;414;0;0;0;0;.00nan;0;0
15057;-1;412;65;22;2;20;.909;3664000;0
15058;194221;433;0;0;0;0;.00nan;0;0
15058;-1;434;0;0;0;0;.00nan;0;0
15058;186671;434;89;29;1;28;.966;3600000;0
15058;191212;433;66;41;4;37;.902;3600000;0
15059;173339;430;0;0;0;0;.00nan;0;0
15059;-1;426;0;0;0;0;.00nan;0;0
15059;-1;426;75;46;4;42;.913;3581000;0
15059;-1;430;81;35;2;33;.943;3600000;0
15060;194751;443;93;33;1;32;.970;4200000;0
15060;194803;443;0;0;0;0;.00nan;0;0
15060;191171;431;0;0;0;0;.00nan;0;0
15060;-1;431;95;37;1;36;.973;4200000;0
15061;194146;432;0;0;0;0;.00nan;0;0
15061;178743;435;0;0;0;0;.00nan;0;0
15061;197030;432;38;23;4;19;.826;3600000;0
15061;-1;435;96;30;1;29;.967;3600000;0
15062;183885;449;97;40;1;39;.975;3600000;0
15062;-1;449;0;0;0;0;.00nan;0;0
15062;186076;420;0;0;0;0;.00nan;0;0
15062;-1;420;86;16;0;16;1.000;3600000;0
15063;187660;417;0;0;0;0;.00nan;0;0
15063;194854;417;87;30;1;29;.967;3600000;0
15063;190073;413;45;27;4;23;.852;3600000;0
15063;192627;413;0;0;0;0;.00nan;0;0
15064;182475;437;0;0;0;0;.00nan;0;0
15064;189783;440;60;18;2;16;.889;3799000;0
15064;175723;440;0;0;0;0;.00nan;0;0
15064;186571;437;92;32;1;31;.969;3754000;0
15065;-1;428;0;0;0;0;.00nan;0;0
15065;184060;425;0;0;0;0;.00nan;0;0
15065;196979;428;64;48;5;43;.896;3600000;0
15065;-1;425;56;17;2;15;.882;3600000;0
15066;189288;419;0;0;0;0;.00nan;0;0
15066;179127;422;56;29;3;26;.897;3600000;0
15066;180578;422;0;0;0;0;.00nan;0;0
15066;196975;419;85;32;2;30;.938;3600000;0
15067;168414;444;91;31;1;30;.968;3600000;0
15067;194630;444;0;0;0;0;.00nan;0;0
15067;207137;418;90;39;2;37;.949;3600000;0
15067;191687;418;0;0;0;0;.00nan;0;0
15068;190157;442;51;33;5;28;.848;3600000;0
15068;202171;439;73;27;2;25;.926;3600000;0
15068;181338;439;0;0;0;0;.00nan;0;0
15068;191849;442;0;0;0;0;.00nan;0;0
15069;203194;4849;81;32;2;30;.938;3558000;0
15069;199892;421;0;0;0;0;.00nan;0;0
15069;179169;421;70;19;1;18;.947;3600000;0
15069;196412;4849;0;0;0;0;.00nan;0;0
15070;194456;414;52;35;4;31;.886;3517000;0
15070;184033;411;88;34;2;32;.941;3600000;0
15070;187309;414;0;0;0;0;.00nan;0;0
15070;197699;411;0;0;0;0;.00nan;0;0
15071;198091;415;70;39;4;35;.897;4200000;0
15071;194650;410;87;50;4;46;.920;4200000;0
15071;184183;410;0;0;0;0;.00nan;0;0
15071;191877;415;0;0;0;0;.00nan;0;0
15072;194146;432;90;20;0;20;1.000;3600000;0
15072;191171;431;0;0;0;0;.00nan;0;0
15072;197030;432;0;0;0;0;.00nan;0;0
15072;-1;431;86;47;3;44;.936;3600000;0
15073;165023;438;0;0;0;0;.00nan;0;0
15073;176196;438;78;23;1;22;.957;3553000;0
15073;186468;427;0;0;0;0;.00nan;0;0
15073;-1;427;100;25;0;25;1.000;3600000;0
15074;183832;436;0;0;0;0;.00nan;0;0
15074;173339;430;0;0;0;0;.00nan;0;0
15074;191861;436;69;33;3;30;.909;3553000;0
15074;-1;430;72;32;2;30;.938;3600000;0
15075;194390;441;69;32;4;28;.875;3600000;0
15075;194751;443;0;0;0;0;.00nan;0;0
15075;194803;443;72;15;1;14;.933;3600000;0
15075;191713;441;0;0;0;0;.00nan;0;0
15076;184033;411;0;0;0;0;.00nan;0;0
15076;-1;412;72;34;3;31;.912;3142000;0
15076;-1;412;56;4;0;4;1.000;458000;0
15076;197699;411;60;16;2;14;.875;3600000;0
15077;183885;449;0;0;0;0;.00nan;0;0
15077;-1;449;67;30;3;27;.900;3600000;0
15077;186076;420;0;0;0;0;.00nan;0;0
15077;-1;420;100;34;0;34;1.000;3600000;0
15078;194221;433;0;0;0;0;.00nan;0;0
15078;184336;429;100;30;0;30;1.000;4200000;0
15078;202180;429;0;0;0;0;.00nan;0;0
15078;191212;433;97;34;0;34;1.000;4200000;0
15079;198091;415;100;29;0;29;1.000;3600000;0
15079;187660;417;62;22;3;19;.864;3600000;0
15079;194854;417;0;0;0;0;.00nan;0;0
15079;191877;415;0;0;0;0;.00nan;0;0
15080;182475;437;100;28;0;28;1.000;3600000;0
15080;189783;440;0;0;0;0;.00nan;0;0
15080;175723;440;60;32;4;28;.875;3600000;0
15080;186571;437;0;0;0;0;.00nan;0;0
15081;173339;430;71;33;3;30;.909;3541000;0
15081;-1;428;76;21;1;20;.952;3600000;0
15081;196979;428;0;0;0;0;.00nan;0;0
15081;-1;430;0;0;0;0;.00nan;0;0
15082;189288;419;100;40;1;39;.975;3600000;0
15082;179127;422;0;0;0;0;.00nan;0;0
15082;180578;422;76;31;2;29;.935;3597000;0
15082;196975;419;0;0;0;0;.00nan;0;0
15083;-1;434;48;22;3;19;.864;3600000;0
15083;186468;427;0;0;0;0;.00nan;0;0
15083;186671;434;0;0;0;0;.00nan;0;0
15083;-1;427;48;35;5;30;.857;3600000;0
15084;168414;444;0;0;0;0;.00nan;0;0
15084;194630;444;78;38;3;35;.921;3588000;0
15084;207137;418;0;0;0;0;.00nan;0;0
15084;191687;418;74;21;1;20;.952;3600000;0
15085;190157;442;0;0;0;0;.00nan;0;0
15085;202171;439;0;0;0;0;.00nan;0;0
15085;181338;439;51;19;3;16;.842;3600000;0
15085;191849;442;48;28;4;24;.857;3600000;0
15086;203194;4849;0;0;0;0;.00nan;0;0
15086;199892;421;92;30;1;29;.967;3600000;0
15086;179169;421;0;0;0;0;.00nan;0;0
15086;196412;4849;59;37;4;33;.892;3600000;0
15087;194650;410;51;7;1;6;.857;498000;0
15087;184183;410;19;25;6;19;.760;3102000;0
15087;190073;413;0;0;0;0;.00nan;0;0
15087;192627;413;67;26;3;23;.885;3600000;0
15088;194390;441;0;0;0;0;.00nan;0;0
15088;191171;431;72;28;2;26;.929;3600000;0
15088;191713;441;62;42;4;38;.905;3529000;0
15088;-1;431;0;0;0;0;.00nan;0;0
15089;183832;436;68;38;4;34;.895;3600000;0
15089;184060;425;37;30;5;25;.833;3600000;0
15089;191861;436;0;0;0;0;.00nan;0;0
15089;-1;425;0;0;0;0;.00nan;0;0
15090;178743;435;0;0;0;0;.00nan;0;0
15090;-1;426;0;0;0;0;.00nan;0;0
15090;-1;426;62;29;3;26;.897;3600000;0
15090;-1;435;94;33;1;32;.970;3600000;0
15091;165023;438;0;0;0;0;.00nan;0;0
15091;184336;429;67;49;4;45;.918;4097000;0
15091;176196;438;67;36;5;31;.861;4097000;0
15091;202180;429;0;0;0;0;.00nan;0;0
15092;198091;415;69;23;2;21;.913;3600000;0
15092;190073;413;64;37;4;33;.892;3532000;0
15092;191877;415;0;0;0;0;.00nan;0;0
15092;192627;413;0;0;0;0;.00nan;0;0
15093;165023;438;0;0;0;0;.00nan;0;0
15093;194221;433;0;0;0;0;.00nan;0;0
15093;176196;438;94;49;3;46;.939;4039000;0
15093;191212;433;59;26;2;24;.923;4039000;0
15094;194390;441;80;22;1;21;.955;4035000;0
15094;194751;443;67;22;2;20;.909;4035000;0
15094;194803;443;0;0;0;0;.00nan;0;0
15094;191713;441;0;0;0;0;.00nan;0;0
15095;184336;429;78;35;2;33;.943;3600000;0
15095;202180;429;0;0;0;0;.00nan;0;0
15095;186468;427;0;0;0;0;.00nan;0;0
15095;-1;427;18;30;7;23;.767;3600000;0
15096;173339;430;0;0;0;0;.00nan;0;0
15096;184060;425;0;0;0;0;.00nan;0;0
15096;-1;430;57;24;3;21;.875;3600000;0
15096;-1;425;39;24;4;20;.833;3600000;0
15097;187660;417;0;0;0;0;.00nan;0;0
15097;194854;417;60;25;3;22;.880;3576000;0
15097;-1;412;91;31;1;30;.968;3600000;0
15097;-1;412;0;0;0;0;.00nan;0;0
15098;194146;432;66;46;5;41;.891;3600000;0
15098;202171;439;70;29;3;26;.897;3600000;0
15098;181338;439;0;0;0;0;.00nan;0;0
15098;197030;432;0;0;0;0;.00nan;0;0
15099;199892;421;0;0;0;0;.00nan;0;0
15099;188965;423;0;0;0;0;.00nan;0;0
15099;179071;423;69;40;4;36;.900;3561000;0
15099;179169;421;67;22;2;20;.909;3600000;0
15100;182475;437;87;14;0;14;1.000;3600000;0
15100;190157;442;84;35;2;33;.943;3600000;0
15100;186571;437;0;0;0;0;.00nan;0;0
15100;191849;442;0;0;0;0;.00nan;0;0
15101;194456;414;78;26;1;25;.962;3600000;0
15101;194650;410;85;34;2;32;.941;3543000;0
15101;184183;410;0;0;0;0;.00nan;0;0
15101;187309;414;0;0;0;0;.00nan;0;0
15102;168414;444;65;23;2;21;.913;3581000;0
15102;194630;444;0;0;0;0;.00nan;0;0
15102;189288;419;88;32;1;31;.969;3600000;0
15102;196975;419;0;0;0;0;.00nan;0;0
15103;203194;4849;32;39;7;32;.821;3600000;0
15103;196412;4849;0;0;0;0;.00nan;0;0
15103;186076;420;0;0;0;0;.00nan;0;0
15103;-1;420;49;14;2;12;.857;3600000;0
15104;183885;449;65;22;2;20;.909;3600000;0
15104;-1;449;0;0;0;0;.00nan;0;0
15104;207137;418;65;36;3;33;.917;3600000;0
15104;191687;418;0;0;0;0;.00nan;0;0
15105;184033;411;67;15;1;14;.933;3600000;0
15105;190073;413;0;0;0;0;.00nan;0;0
15105;192627;413;97;44;2;42;.955;3573000;0
15105;197699;411;0;0;0;0;.00nan;0;0
15106;165023;438;67;23;3;20;.870;3600000;0
15106;176196;438;0;0;0;0;.00nan;0;0
15106;191171;431;0;0;0;0;.00nan;0;0
15106;-1;431;45;31;5;26;.839;3538000;0
15107;183832;436;84;29;2;27;.931;4122000;0
15107;194751;443;0;0;0;0;.00nan;0;0
15107;194803;443;95;39;1;38;.974;4122000;0
15107;191861;436;0;0;0;0;.00nan;0;0
15108;-1;428;0;0;0;0;.00nan;0;0
15108;189783;440;64;38;4;34;.895;3600000;0
15108;175723;440;0;0;0;0;.00nan;0;0
15108;196979;428;33;26;5;21;.808;3545000;0
15109;199892;421;70;39;4;35;.897;3560000;0
15109;188965;423;0;0;0;0;.00nan;0;0
15109;179071;423;56;26;3;23;.885;3600000;0
15109;179169;421;0;0;0;0;.00nan;0;0
15110;-1;434;0;0;0;0;.00nan;0;0
15110;186468;427;0;0;0;0;.00nan;0;0
15110;186671;434;63;24;2;22;.917;3583000;0
15110;-1;427;77;23;1;22;.957;3600000;0
15111;187660;417;83;27;2;25;.926;3600000;0
15111;194456;414;65;39;4;35;.897;3542000;0
15111;194854;417;0;0;0;0;.00nan;0;0
15111;187309;414;0;0;0;0;.00nan;0;0
15112;173339;430;37;33;6;27;.818;3600000;0
15112;178743;435;0;0;0;0;.00nan;0;0
15112;-1;430;0;0;0;0;.00nan;0;0
15112;-1;435;96;36;1;35;.972;3600000;0
15113;184060;425;0;0;0;0;.00nan;0;0
15113;-1;426;0;0;0;0;.00nan;0;0
15113;-1;426;73;37;3;34;.919;3552000;0
15113;-1;425;63;23;2;21;.913;3600000;0
15114;168414;444;0;0;0;0;.00nan;0;0
15114;194630;444;55;32;4;28;.875;3589000;0
15114;189288;419;0;0;0;0;.00nan;0;0
15114;196975;419;51;21;3;18;.857;3600000;0
15115;194650;410;80;29;2;27;.931;3076000;0
15115;184183;410;26;7;3;4;.571;524000;0
15115;-1;412;0;0;0;0;.00nan;0;0
15115;-1;412;71;24;2;22;.917;3600000;0
15116;203194;4849;56;7;0;7;1.000;561000;0
15116;196412;4849;44;35;6;29;.829;3039000;0
15116;186076;420;50;19;3;16;.842;3600000;0
15116;-1;420;0;0;0;0;.00nan;0;0
15117;183885;449;0;0;0;0;.00nan;0;0
15117;-1;449;41;22;4;18;.818;3600000;0
15117;207137;418;0;0;0;0;.00nan;0;0
15117;191687;418;61;41;5;36;.878;3592000;0
15118;198091;415;100;37;1;36;.973;3600000;0
15118;184033;411;0;0;0;0;.00nan;0;0
15118;191877;415;0;0;0;0;.00nan;0;0
15118;197699;411;28;18;4;14;.778;3600000;0
15119;183832;436;0;0;0;0;.00nan;0;0
15119;189783;440;0;0;0;0;.00nan;0;0
15119;175723;440;70;24;2;22;.917;3600000;0
15119;191861;436;43;25;3;22;.880;3564000;0
15121;194390;441;82;35;2;33;.943;3549000;0
15121;-1;428;0;0;0;0;.00nan;0;0
15121;196979;428;69;15;1;14;.933;3600000;0
15121;191713;441;0;0;0;0;.00nan;0;0
15123;194650;410;61;55;6;49;.891;3281000;0
15123;184183;410;58;3;0;3;1.000;319000;0
15123;202171;439;0;0;0;0;.00nan;0;0
15123;181338;439;57;16;2;14;.875;3600000;0
15125;194221;433;0;0;0;0;.00nan;0;0
15125;184336;429;0;0;0;0;.00nan;0;0
15125;202180;429;99;40;2;38;.950;3600000;0
15125;191212;433;48;18;3;15;.833;3543000;0
15127;194146;432;0;0;0;0;.00nan;0;0
15127;189288;419;0;0;0;0;.00nan;0;0
15127;196975;419;52;31;5;26;.839;3600000;0
15127;197030;432;82;31;2;29;.935;3600000;0
15129;184060;425;0;0;0;0;.00nan;0;0
15129;-1;426;0;0;0;0;.00nan;0;0
15129;-1;426;86;30;2;28;.933;3600000;0
15129;-1;425;49;31;4;27;.871;3577000;0
15131;194456;414;26;24;5;19;.792;3600000;0
15131;191171;431;0;0;0;0;.00nan;0;0
15131;187309;414;0;0;0;0;.00nan;0;0
15131;-1;431;84;38;2;36;.947;3600000;0
15133;186076;420;0;0;0;0;.00nan;0;0
15133;186468;427;0;0;0;0;.00nan;0;0
15133;-1;427;37;29;5;24;.828;3600000;0
15133;-1;420;100;33;0;33;1.000;3600000;0
15135;182475;437;65;32;3;29;.906;3600000;0
15135;-1;412;59;30;4;26;.867;3600000;0
15135;186571;437;0;0;0;0;.00nan;0;0
15135;-1;412;0;0;0;0;.00nan;0;0
15137;173339;430;0;0;0;0;.00nan;0;0
15137;178743;435;0;0;0;0;.00nan;0;0
15137;-1;430;56;18;2;16;.889;3715000;0
15137;-1;435;93;40;3;37;.925;3715000;0
15139;165023;438;66;34;4;30;.882;3844000;0
15139;190073;413;71;32;3;29;.906;3844000;0
15139;176196;438;0;0;0;0;.00nan;0;0
15139;192627;413;0;0;0;0;.00nan;0;0
15141;198091;415;83;36;3;33;.917;3600000;0
15141;184033;411;0;0;0;0;.00nan;0;0
15141;191877;415;0;0;0;0;.00nan;0;0
15141;197699;411;53;26;4;22;.846;3543000;0
15143;188965;423;0;0;0;0;.00nan;0;0
15143;194751;443;69;27;2;25;.926;3600000;0
15143;194803;443;0;0;0;0;.00nan;0;0
15143;179071;423;49;27;4;23;.852;3546000;0
15145;203194;4849;62;40;4;36;.900;3556000;0
15145;-1;434;0;0;0;0;.00nan;0;0
15145;196412;4849;0;0;0;0;.00nan;0;0
15145;186671;434;51;17;2;15;.882;3600000;0
15147;199892;421;0;0;0;0;.00nan;0;0
15147;168414;444;55;29;4;25;.862;3571000;0
15147;194630;444;0;0;0;0;.00nan;0;0
15147;179169;421;63;28;3;25;.893;3600000;0
15149;183832;436;53;33;4;29;.879;3599000;0
15149;190157;442;79;29;2;27;.931;3600000;0
15149;191849;442;0;0;0;0;.00nan;0;0
15149;191861;436;0;0;0;0;.00nan;0;0
15151;183885;449;60;24;3;21;.875;3516000;0
15151;179127;422;0;0;0;0;.00nan;0;0
15151;-1;449;0;0;0;0;.00nan;0;0
15151;180578;422;72;17;1;16;.941;3600000;0
15153;189783;440;99;30;1;29;.967;3600000;0
15153;175723;440;0;0;0;0;.00nan;0;0
15153;207137;418;78;42;5;37;.881;3600000;0
15153;191687;418;0;0;0;0;.00nan;0;0
15155;188965;423;55;21;3;18;.857;3600000;0
15155;168414;444;61;43;5;38;.884;3600000;0
15155;194630;444;0;0;0;0;.00nan;0;0
15155;179071;423;0;0;0;0;.00nan;0;0
15157;179127;422;100;23;0;23;1.000;3600000;0
15157;190073;413;48;24;3;21;.875;3600000;0
15157;180578;422;0;0;0;0;.00nan;0;0
15157;192627;413;0;0;0;0;.00nan;0;0
15159;184336;429;0;0;0;0;.00nan;0;0
15159;202180;429;76;32;3;29;.906;3600000;0
15159;191171;431;46;40;6;34;.850;3600000;0
15159;-1;431;0;0;0;0;.00nan;0;0
15161;194390;441;78;42;4;38;.905;3648000;0
15161;-1;412;0;0;0;0;.00nan;0;0
15161;191713;441;0;0;0;0;.00nan;0;0
15161;-1;412;59;27;3;24;.889;3648000;0
15163;187660;417;0;0;0;0;.00nan;0;0
15163;194751;443;70;21;1;20;.952;3600000;0
15163;194803;443;0;0;0;0;.00nan;0;0
15163;194854;417;68;28;2;26;.929;3581000;0
15165;203194;4849;63;42;6;36;.857;3600000;0
15165;-1;434;65;20;2;18;.900;3600000;0
15165;196412;4849;0;0;0;0;.00nan;0;0
15165;186671;434;0;0;0;0;.00nan;0;0
15167;183832;436;0;0;0;0;.00nan;0;0
15167;186468;427;0;0;0;0;.00nan;0;0
15167;191861;436;90;45;2;43;.956;4200000;0
15167;-1;427;90;33;2;31;.939;4200000;0
15169;198091;415;86;30;1;29;.967;3600000;0
15169;199892;421;71;27;2;25;.926;3591000;0
15169;179169;421;0;0;0;0;.00nan;0;0
15169;191877;415;0;0;0;0;.00nan;0;0
15171;182475;437;0;0;0;0;.00nan;0;0
15171;178743;435;0;0;0;0;.00nan;0;0
15171;186571;437;77;20;1;19;.950;3600000;0
15171;-1;435;41;29;4;25;.862;3600000;0
15173;-1;428;0;0;0;0;.00nan;0;0
15173;189783;440;0;0;0;0;.00nan;0;0
15173;175723;440;73;29;3;26;.897;3668000;0
15173;196979;428;75;34;2;32;.941;3668000;0
15175;189288;419;92;36;1;35;.972;3582000;0
15175;202171;439;0;0;0;0;.00nan;0;0
15175;181338;439;87;22;0;22;1.000;3600000;0
15175;196975;419;0;0;0;0;.00nan;0;0
15177;190157;442;60;30;3;27;.900;3572000;0
15177;-1;426;90;36;2;34;.944;3600000;0
15177;-1;426;0;0;0;0;.00nan;0;0
15177;191849;442;0;0;0;0;.00nan;0;0
15179;184033;411;0;0;0;0;.00nan;0;0
15179;186076;420;55;17;2;15;.882;1534000;0
15179;197699;411;45;15;3;12;.800;3600000;0
15179;-1;420;36;27;6;21;.778;2066000;0
15181;194456;414;56;43;6;37;.860;3600000;0
15181;184060;425;0;0;0;0;.00nan;0;0
15181;187309;414;0;0;0;0;.00nan;0;0
15181;-1;425;76;21;1;20;.952;3600000;0
15183;194146;432;0;0;0;0;.00nan;0;0
15183;207137;418;47;36;5;31;.861;3559000;0
15183;197030;432;63;32;3;29;.906;3600000;0
15183;191687;418;0;0;0;0;.00nan;0;0
15185;165023;438;0;0;0;0;.00nan;0;0
15185;194650;410;0;0;0;0;.00nan;0;0
15185;184183;410;67;25;2;23;.920;3600000;0
15185;176196;438;43;33;5;28;.848;3600000;0
15187;173339;430;0;0;0;0;.00nan;0;0
15187;183885;449;100;36;0;36;1.000;3600000;0
15187;-1;449;0;0;0;0;.00nan;0;0
15187;-1;430;63;19;1;18;.947;3552000;0
15189;194221;433;79;28;1;27;.964;4200000;0
15189;-1;428;70;27;1;26;.963;4200000;0
15189;191212;433;0;0;0;0;.00nan;0;0
15189;196979;428;0;0;0;0;.00nan;0;0
15191;199892;421;0;0;0;0;.00nan;0;0
15191;184336;429;89;32;1;31;.969;3600000;0
15191;179169;421;60;34;4;30;.882;3600000;0
15191;202180;429;0;0;0;0;.00nan;0;0
15193;189783;440;64;28;3;25;.893;3549000;0
15193;175723;440;0;0;0;0;.00nan;0;0
15193;186076;420;0;0;0;0;.00nan;0;0
15193;-1;420;71;19;1;18;.947;3600000;0
15195;198091;415;0;0;0;0;.00nan;0;0
15195;-1;434;0;0;0;0;.00nan;0;0
15195;186671;434;82;39;4;35;.897;3619000;0
15195;191877;415;53;23;3;20;.870;3619000;0
15197;203194;4849;0;0;0;0;.00nan;0;0
15197;194146;432;20;24;6;18;.750;2021000;0
15197;196412;4849;57;19;2;17;.895;3600000;0
15197;197030;432;44;18;3;15;.833;1579000;0
15199;194390;441;0;0;0;0;.00nan;0;0
15199;179127;422;86;27;2;25;.926;3600000;0
15199;180578;422;0;0;0;0;.00nan;0;0
15199;191713;441;48;34;5;29;.853;3600000;0
15201;183832;436;46;20;4;16;.800;3600000;0
15201;190073;413;0;0;0;0;.00nan;0;0
15201;191861;436;0;0;0;0;.00nan;0;0
15201;192627;413;61;47;6;41;.872;3531000;0
15203;168414;444;0;0;0;0;.00nan;0;0
15203;194630;444;76;31;2;29;.935;3600000;0
15203;-1;412;53;26;3;23;.885;3560000;0
15203;-1;412;0;0;0;0;.00nan;0;0
15205;173339;430;68;22;2;20;.909;3600000;0
15205;190157;442;0;0;0;0;.00nan;0;0
15205;191849;442;50;35;5;30;.857;3600000;0
15205;-1;430;0;0;0;0;.00nan;0;0
15207;165023;438;76;33;2;31;.939;3599000;0
15207;184060;425;93;28;1;27;.964;3600000;0
15207;176196;438;0;0;0;0;.00nan;0;0
15207;-1;425;0;0;0;0;.00nan;0;0
15209;194456;414;0;0;0;0;.00nan;0;0
15209;191171;431;0;0;0;0;.00nan;0;0
15209;187309;414;69;37;4;33;.892;3600000;0
15209;-1;431;62;27;3;24;.889;3600000;0
15211;182475;437;39;19;4;15;.789;3600000;0
15211;178743;435;99;31;1;30;.968;3600000;0
15211;186571;437;0;0;0;0;.00nan;0;0
15211;-1;435;0;0;0;0;.00nan;0;0
15213;188965;423;0;0;0;0;.00nan;0;0
15213;183885;449;76;23;1;22;.957;3593000;0
15213;179071;423;100;25;0;25;1.000;3600000;0
15213;-1;449;0;0;0;0;.00nan;0;0
15215;187660;417;73;30;3;27;.900;3545000;0
15215;194854;417;0;0;0;0;.00nan;0;0
15215;-1;426;0;0;0;0;.00nan;0;0
15215;-1;426;77;28;2;26;.929;3600000;0
15217;189288;419;0;0;0;0;.00nan;0;0
15217;186468;427;66;18;1;17;.944;3600000;0
15217;196975;419;66;30;2;28;.933;3580000;0
15217;-1;427;0;0;0;0;.00nan;0;0
15219;184033;411;75;35;2;33;.943;3600000;0
15219;207137;418;0;0;0;0;.00nan;0;0
15219;191687;418;45;41;7;34;.829;3600000;0
15219;197699;411;0;0;0;0;.00nan;0;0
15221;194650;410;35;31;6;25;.806;3600000;0
15221;184183;410;0;0;0;0;.00nan;0;0
15221;202171;439;0;0;0;0;.00nan;0;0
15221;181338;439;55;17;2;15;.882;3600000;0
15223;182475;437;35;29;6;23;.793;3600000;0
15223;187660;417;0;0;0;0;.00nan;0;0
15223;194854;417;68;20;1;19;.950;3600000;0
15223;186571;437;0;0;0;0;.00nan;0;0
15225;194146;432;0;0;0;0;.00nan;0;0
15225;190073;413;0;0;0;0;.00nan;0;0
15225;197030;432;57;26;3;23;.885;3548000;0
15225;192627;413;82;33;2;31;.939;3600000;0
15227;194390;441;64;37;4;33;.892;3600000;0
15227;184033;411;0;0;0;0;.00nan;0;0
15227;191713;441;0;0;0;0;.00nan;0;0
15227;197699;411;71;20;1;19;.950;3600000;0
15229;178743;435;0;0;0;0;.00nan;0;0
15229;190157;442;77;31;3;28;.903;3600000;0
15229;191849;442;0;0;0;0;.00nan;0;0
15229;-1;435;87;33;2;31;.939;3600000;0
15231;203194;4849;87;29;0;29;1.000;4200000;0
15231;165023;438;0;0;0;0;.00nan;0;0
15231;176196;438;100;38;0;38;1.000;4200000;0
15231;196412;4849;0;0;0;0;.00nan;0;0
15233;173339;430;0;0;0;0;.00nan;0;0
15233;189783;440;99;25;0;25;1.000;3600000;0
15233;175723;440;0;0;0;0;.00nan;0;0
15233;-1;430;81;43;3;40;.930;3600000;0
15235;168414;444;0;0;0;0;.00nan;0;0
15235;194630;444;42;29;5;24;.828;3600000;0
15235;189288;419;0;0;0;0;.00nan;0;0
15235;196975;419;82;30;2;28;.933;3600000;0
15237;199892;421;63;31;3;28;.903;3600000;0
15237;194456;414;36;38;7;31;.816;3600000;0
15237;179169;421;0;0;0;0;.00nan;0;0
15237;187309;414;0;0;0;0;.00nan;0;0
15239;198091;415;57;31;3;28;.903;3600000;0
15239;184336;429;0;0;0;0;.00nan;0;0
15239;202180;429;42;24;4;20;.833;3598000;0
15239;191877;415;0;0;0;0;.00nan;0;0
15241;202171;439;0;0;0;0;.00nan;0;0
15241;181338;439;87;34;2;32;.941;3600000;0
15241;186468;427;0;0;0;0;.00nan;0;0
15241;-1;427;63;29;3;26;.897;3600000;0
15243;194221;433;0;0;0;0;.00nan;0;0
15243;-1;412;0;0;0;0;.00nan;0;0
15243;191212;433;69;38;5;33;.868;3600000;0
15243;-1;412;90;30;1;29;.967;3600000;0
15245;179127;422;0;0;0;0;.00nan;0;0
15245;180578;422;89;29;1;28;.966;3600000;0
15245;-1;426;0;0;0;0;.00nan;0;0
15245;-1;426;56;36;4;32;.889;3600000;0
15247;183885;449;85;33;3;30;.909;3600000;0
15247;194751;443;0;0;0;0;.00nan;0;0
15247;194803;443;46;26;4;22;.846;3543000;0
15247;-1;449;0;0;0;0;.00nan;0;0
15249;194650;410;0;0;0;0;.00nan;0;0
15249;184183;410;86;24;1;23;.958;3600000;0
15249;207137;418;43;36;5;31;.861;3600000;0
15249;191687;418;0;0;0;0;.00nan;0;0
15251;186076;420;67;34;3;31;.912;3600000;0
15251;191171;431;0;0;0;0;.00nan;0;0
15251;-1;420;0;0;0;0;.00nan;0;0
15251;-1;431;39;26;6;20;.769;3600000;0
15253;188965;423;0;0;0;0;.00nan;0;0
15253;183832;436;85;41;3;38;.927;3561000;0
15253;179071;423;57;16;2;14;.875;3600000;0
15253;191861;436;0;0;0;0;.00nan;0;0
15255;-1;428;0;0;0;0;.00nan;0;0
15255;-1;434;99;27;0;27;1.000;3600000;0
15255;186671;434;0;0;0;0;.00nan;0;0
15255;196979;428;45;24;4;20;.833;3600000;0
15256;71075;874;37;17;4;13;.765;3573000;0
15256;146300;874;0;0;0;0;.00nan;0;0
15256;157295;880;0;0;0;0;.00nan;0;0
15256;161255;880;96;42;2;40;.952;3600000;0
15257;7037;885;53;36;6;30;.833;2772000;0
15257;169868;957;0;0;0;0;.00nan;0;0
15257;201288;957;100;21;0;21;1.000;3600000;0
15257;28701;885;61;7;0;7;1.000;828000;0
15258;4215;956;24;5;3;2;.400;358000;0
15258;72439;3965;0;0;0;0;.00nan;0;0
15258;149353;3965;64;28;3;25;.893;3600000;0
15258;160312;956;48;30;4;26;.867;3242000;0
15259;146684;978;0;0;0;0;.00nan;0;0
15259;147164;879;0;0;0;0;.00nan;0;0
15259;147492;978;60;42;6;36;.857;3600000;0
15259;151940;879;78;10;0;10;1.000;3600000;0
15260;196055;945;0;0;0;0;.00nan;0;0
15260;180376;890;70;24;2;22;.917;3600000;0
15260;146479;945;53;32;4;28;.875;3585000;0
15260;146608;890;0;0;0;0;.00nan;0;0
15261;164715;897;65;28;3;25;.893;3900000;0
15261;146386;897;0;0;0;0;.00nan;0;0
15261;147255;891;81;41;3;38;.927;3850000;0
15261;160932;891;0;0;0;0;.00nan;0;0
15262;162979;966;0;0;0;0;.00nan;0;0
15262;8187;894;0;0;0;0;.00nan;0;0
15262;141496;966;60;29;3;26;.897;3600000;0
15262;146445;894;99;45;1;44;.978;3600000;0
15263;8187;894;0;0;0;0;.00nan;0;0
15263;146445;894;51;34;5;29;.853;3600000;0
15263;157295;880;0;0;0;0;.00nan;0;0
15263;161255;880;76;27;2;25;.926;3600000;0
15264;169868;957;65;15;1;14;.933;3600000;0
15264;201288;957;0;0;0;0;.00nan;0;0
15264;146684;978;0;0;0;0;.00nan;0;0
15264;147492;978;95;53;4;49;.925;3600000;0
15265;164715;897;0;0;0;0;.00nan;0;0
15265;196055;945;64;8;0;8;1.000;681000;0
15265;146386;897;90;22;0;22;1.000;3600000;0
15265;146479;945;53;42;6;36;.857;2919000;0
15266;4215;956;97;59;0;59;1.000;3900000;0
15266;147164;879;86;12;0;12;1.000;3900000;0
15266;151940;879;0;0;0;0;.00nan;0;0
15266;160312;956;0;0;0;0;.00nan;0;0
15267;7037;885;86;31;1;30;.968;3600000;0
15267;28701;885;0;0;0;0;.00nan;0;0
15267;72439;3965;0;0;0;0;.00nan;0;0
15267;149353;3965;87;46;3;43;.935;3564000;0
15268;180376;890;41;44;7;37;.841;3299000;0
15268;71075;874;0;0;0;0;.00nan;0;0
15268;146300;874;64;20;2;18;.900;3600000;0
15268;146608;890;61;10;0;10;1.000;301000;0
15269;162979;966;97;58;3;55;.948;3531000;0
15269;141496;966;0;0;0;0;.00nan;0;0
15269;147255;891;0;0;0;0;.00nan;0;0
15269;160932;891;87;25;1;24;.960;3600000;0
15270;169868;957;46;22;3;19;.864;3900000;0
15270;201288;957;0;0;0;0;.00nan;0;0
15270;196055;945;0;0;0;0;.00nan;0;0
15270;146479;945;95;50;3;47;.940;3900000;0
15271;4215;956;77;39;4;35;.897;3573000;0
15271;71075;874;0;0;0;0;.00nan;0;0
15271;146300;874;50;13;2;11;.846;3600000;0
15271;160312;956;0;0;0;0;.00nan;0;0
15272;8187;894;97;41;1;40;.976;3900000;0
15272;146445;894;0;0;0;0;.00nan;0;0
15272;147255;891;0;0;0;0;.00nan;0;0
15272;160932;891;99;35;1;34;.971;3900000;0
15273;7037;885;78;47;4;43;.915;3546000;0
15273;28701;885;0;0;0;0;.00nan;0;0
15273;147164;879;57;22;2;20;.909;3600000;0
15273;151940;879;0;0;0;0;.00nan;0;0
15274;180376;890;0;0;0;0;.00nan;0;0
15274;72439;3965;0;0;0;0;.00nan;0;0
15274;146608;890;100;35;0;35;1.000;3600000;0
15274;149353;3965;73;29;2;27;.931;3576000;0
15275;162979;966;91;18;0;18;1.000;3600000;0
15275;141496;966;0;0;0;0;.00nan;0;0
15275;146684;978;49;33;4;29;.879;3600000;0
15275;147492;978;0;0;0;0;.00nan;0;0
15276;164715;897;0;0;0;0;.00nan;0;0
15276;146386;897;100;31;1;30;.968;3600000;0
15276;157295;880;46;28;4;24;.857;3600000;0
15276;161255;880;0;0;0;0;.00nan;0;0
15277;8187;894;0;0;0;0;.00nan;0;0
15277;146445;894;40;33;6;27;.818;3600000;0
15277;147255;891;0;0;0;0;.00nan;0;0
15277;160932;891;63;24;2;22;.917;3600000;0
15278;7037;885;64;35;4;31;.886;3864000;0
15278;28701;885;0;0;0;0;.00nan;0;0
15278;147164;879;81;35;3;32;.914;3864000;0
15278;151940;879;0;0;0;0;.00nan;0;0
15279;7037;885;69;22;2;20;.909;3600000;0
15279;28701;885;0;0;0;0;.00nan;0;0
15279;147255;891;65;29;3;26;.897;3592000;0
15279;160932;891;0;0;0;0;.00nan;0;0
15280;196055;945;0;0;0;0;.00nan;0;0
15280;72439;3965;0;0;0;0;.00nan;0;0
15280;146479;945;61;26;3;23;.885;3900000;0
15280;149353;3965;53;26;3;23;.885;3900000;0
15281;4215;956;98;47;2;45;.957;3544000;0
15281;162979;966;87;17;0;17;1.000;3600000;0
15281;141496;966;0;0;0;0;.00nan;0;0
15281;160312;956;0;0;0;0;.00nan;0;0
15282;164715;897;0;0;0;0;.00nan;0;0
15282;169868;957;79;22;1;21;.955;3900000;0
15282;201288;957;0;0;0;0;.00nan;0;0
15282;146386;897;85;31;1;30;.968;3900000;0
15283;147164;879;0;0;0;0;.00nan;0;0
15283;151940;879;60;18;2;16;.889;3600000;0
15283;157295;880;78;14;0;14;1.000;1757000;0
15283;161255;880;26;32;6;26;.813;1843000;0
15284;8187;894;0;0;0;0;.00nan;0;0
15284;180376;890;0;0;0;0;.00nan;0;0
15284;146445;894;83;28;1;27;.964;3600000;0
15284;146608;890;42;17;3;14;.824;3516000;0
15285;146684;978;0;0;0;0;.00nan;0;0
15285;147492;978;61;35;4;31;.886;3600000;0
15285;157295;880;54;44;6;38;.864;3561000;0
15285;161255;880;0;0;0;0;.00nan;0;0
15286;169868;957;0;0;0;0;.00nan;0;0
15286;201288;957;65;16;1;15;.938;3900000;0
15286;147164;879;100;55;1;54;.982;3900000;0
15286;151940;879;0;0;0;0;.00nan;0;0
15287;8187;894;0;0;0;0;.00nan;0;0
15287;196055;945;0;0;0;0;.00nan;0;0
15287;146445;894;73;27;2;25;.926;3569000;0
15287;146479;945;89;34;1;33;.971;3600000;0
15288;4215;956;48;49;6;43;.878;3600000;0
15288;180376;890;33;11;3;8;.727;3600000;0
15288;146608;890;0;0;0;0;.00nan;0;0
15288;160312;956;0;0;0;0;.00nan;0;0
15289;162979;966;80;36;2;34;.944;3900000;0
15289;7037;885;0;0;0;0;.00nan;0;0
15289;28701;885;85;29;2;27;.931;3900000;0
15289;141496;966;0;0;0;0;.00nan;0;0
15290;164715;897;0;0;0;0;.00nan;0;0
15290;72439;3965;0;0;0;0;.00nan;0;0
15290;146386;897;70;31;2;29;.935;3600000;0
15290;149353;3965;62;41;4;37;.902;3550000;0
15291;71075;874;0;0;0;0;.00nan;0;0
15291;146300;874;50;19;2;17;.895;3900000;0
15291;147255;891;0;0;0;0;.00nan;0;0
15291;160932;891;84;41;2;39;.951;3900000;0
15292;72439;3965;0;0;0;0;.00nan;0;0
15292;147164;879;0;0;0;0;.00nan;0;0
15292;149353;3965;96;51;4;47;.922;3600000;0
15292;151940;879;73;7;0;7;1.000;3600000;0
15293;196055;945;0;0;0;0;.00nan;0;0
15293;146479;945;51;27;4;23;.852;3560000;0
15293;157295;880;0;0;0;0;.00nan;0;0
15293;161255;880;91;45;2;43;.956;3600000;0
15294;169868;957;50;29;4;25;.862;3600000;0
15294;201288;957;0;0;0;0;.00nan;0;0
15294;71075;874;100;24;0;24;1.000;3600000;0
15294;146300;874;0;0;0;0;.00nan;0;0
15295;162979;966;71;25;2;23;.920;3680000;0
15295;180376;890;0;0;0;0;.00nan;0;0
15295;141496;966;0;0;0;0;.00nan;0;0
15295;146608;890;81;24;1;23;.958;3680000;0
15296;7037;885;68;29;2;27;.931;3600000;0
15296;164715;897;0;0;0;0;.00nan;0;0
15296;28701;885;0;0;0;0;.00nan;0;0
15296;146386;897;55;25;3;22;.880;3575000;0
15297;8187;894;0;0;0;0;.00nan;0;0
15297;146445;894;74;40;3;37;.925;3523000;0
15297;146684;978;0;0;0;0;.00nan;0;0
15297;147492;978;89;31;1;30;.968;3600000;0
15298;4215;956;99;43;2;41;.953;3600000;0
15298;147255;891;0;0;0;0;.00nan;0;0
15298;160312;956;0;0;0;0;.00nan;0;0
15298;160932;891;39;14;3;11;.786;3571000;0
15299;169868;957;0;0;0;0;.00nan;0;0
15299;201288;957;39;13;3;10;.769;3600000;0
15299;147255;891;62;34;4;30;.882;3580000;0
15299;160932;891;0;0;0;0;.00nan;0;0
15300;8187;894;0;0;0;0;.00nan;0;0
15300;164715;897;78;23;1;22;.957;3600000;0
15300;146386;897;0;0;0;0;.00nan;0;0
15300;146445;894;70;49;5;44;.898;3600000;0
15301;4215;956;87;45;3;42;.933;3900000;0
15301;196055;945;0;0;0;0;.00nan;0;0
15301;146479;945;64;26;3;23;.885;3900000;0
15301;160312;956;0;0;0;0;.00nan;0;0
15302;71075;874;0;0;0;0;.00nan;0;0
15302;146300;874;42;39;7;32;.821;3600000;0
15302;147164;879;80;35;2;33;.943;3600000;0
15302;151940;879;0;0;0;0;.00nan;0;0
15303;7037;885;100;30;0;30;1.000;3600000;0
15303;28701;885;0;0;0;0;.00nan;0;0
15303;146684;978;0;0;0;0;.00nan;0;0
15303;147492;978;86;44;3;41;.932;3600000;0
15304;180376;890;34;16;4;12;.750;3554000;0
15304;146608;890;0;0;0;0;.00nan;0;0
15304;157295;880;0;0;0;0;.00nan;0;0
15304;161255;880;73;25;2;23;.920;3600000;0
15305;162979;966;0;0;0;0;.00nan;0;0
15305;72439;3965;0;0;0;0;.00nan;0;0
15305;141496;966;98;24;0;24;1.000;3600000;0
15305;149353;3965;33;42;7;35;.833;3600000;0
15306;71075;874;62;16;1;15;.938;3600000;0
15306;146300;874;0;0;0;0;.00nan;0;0
15306;146684;978;54;31;4;27;.871;3600000;0
15306;147492;978;0;0;0;0;.00nan;0;0
15307;169868;957;0;0;0;0;.00nan;0;0
15307;78596;957;78;18;1;17;.944;3600000;0
15307;157295;880;59;44;5;39;.886;3600000;0
15307;161255;880;0;0;0;0;.00nan;0;0
15308;162979;966;0;0;0;0;.00nan;0;0
15308;71075;874;0;0;0;0;.00nan;0;0
15308;141496;966;61;49;6;43;.878;3600000;0
15308;146300;874;88;24;1;23;.958;3600000;0
15309;8187;894;0;0;0;0;.00nan;0;0
15309;14266;879;50;7;1;6;.857;3600000;0
15309;146445;894;98;43;3;40;.930;3593000;0
15309;147164;879;0;0;0;0;.00nan;0;0
15310;4215;956;0;0;0;0;.00nan;0;0
15310;164715;897;0;0;0;0;.00nan;0;0
15310;141978;956;67;40;4;36;.900;3520000;0
15310;146386;897;67;23;2;21;.913;3600000;0
15311;7037;885;79;28;1;27;.964;3717000;0
15311;28701;885;0;0;0;0;.00nan;0;0
15311;196055;945;0;0;0;0;.00nan;0;0
15311;146479;945;75;26;2;24;.923;3717000;0
15312;72439;3965;0;0;0;0;.00nan;0;0
15312;146684;978;58;23;3;20;.870;3600000;0
15312;147492;978;0;0;0;0;.00nan;0;0
15312;149353;3965;64;34;4;30;.882;3577000;0
15313;180376;890;55;6;0;6;1.000;634000;0
15313;146608;890;53;37;6;31;.838;2966000;0
15313;147255;891;75;25;2;23;.920;3600000;0
15313;160932;891;0;0;0;0;.00nan;0;0
15314;4215;956;0;0;0;0;.00nan;0;0
15314;141978;956;97;42;1;41;.976;3900000;0
15314;157295;880;0;0;0;0;.00nan;0;0
15314;161255;880;75;21;1;20;.952;3900000;0
15315;14266;879;74;23;2;21;.913;3600000;0
15315;196055;945;79;40;4;36;.900;3586000;0
15315;146479;945;0;0;0;0;.00nan;0;0
15315;147164;879;0;0;0;0;.00nan;0;0
15316;8187;894;0;0;0;0;.00nan;0;0
15316;169868;957;0;0;0;0;.00nan;0;0
15316;78596;957;87;17;0;17;1.000;3600000;0
15316;146445;894;98;42;2;40;.952;3585000;0
15317;7037;885;100;43;0;43;1.000;3600000;0
15317;28701;885;0;0;0;0;.00nan;0;0
15317;71075;874;37;23;4;19;.826;3600000;0
15317;146300;874;0;0;0;0;.00nan;0;0
15318;180376;890;63;24;2;22;.917;3600000;0
15318;146608;890;0;0;0;0;.00nan;0;0
15318;146684;978;0;0;0;0;.00nan;0;0
15318;147492;978;81;29;1;28;.966;3600000;0
15319;72439;3965;0;0;0;0;.00nan;0;0
15319;147255;891;0;0;0;0;.00nan;0;0
15319;149353;3965;55;39;5;34;.872;3600000;0
15319;160932;891;66;23;2;21;.913;3600000;0
15320;162979;966;53;40;5;35;.875;3600000;0
15320;164715;897;0;0;0;0;.00nan;0;0
15320;141496;966;0;0;0;0;.00nan;0;0
15320;146386;897;53;17;2;15;.882;3600000;0
15321;4215;956;0;0;0;0;.00nan;0;0
15321;141978;956;78;46;4;42;.913;3564000;0
15321;146684;978;0;0;0;0;.00nan;0;0
15321;147492;978;59;27;3;24;.889;3600000;0
15322;4215;956;0;0;0;0;.00nan;0;0
15322;141978;956;82;48;4;44;.917;3600000;0
15322;146684;978;43;19;3;16;.842;3600000;0
15322;147492;978;0;0;0;0;.00nan;0;0
15323;196055;945;0;0;0;0;.00nan;0;0
15323;146479;945;64;35;3;32;.914;3600000;0
15323;147255;891;40;25;5;20;.800;3525000;0
15323;160932;891;0;0;0;0;.00nan;0;0
15324;169868;957;0;0;0;0;.00nan;0;0
15324;72439;3965;0;0;0;0;.00nan;0;0
15324;78596;957;49;19;3;16;.842;3600000;0
15324;149353;3965;83;45;4;41;.911;3562000;0
15325;162979;966;0;0;0;0;.00nan;0;0
15325;141496;966;31;21;5;16;.762;3560000;0
15325;157295;880;0;0;0;0;.00nan;0;0
15325;161255;880;68;40;4;36;.900;3600000;0
15326;7037;885;89;21;0;21;1.000;3600000;0
15326;8187;894;0;0;0;0;.00nan;0;0
15326;28701;885;0;0;0;0;.00nan;0;0
15326;146445;894;65;34;4;30;.882;3600000;0
15327;164715;897;0;0;0;0;.00nan;0;0
15327;71075;874;0;0;0;0;.00nan;0;0
15327;146300;874;47;21;3;18;.857;3600000;0
15327;146386;897;88;19;0;19;1.000;3600000;0
15328;14266;879;68;18;1;17;.944;3600000;0
15328;180376;890;71;38;4;34;.895;3600000;0
15328;146608;890;0;0;0;0;.00nan;0;0
15328;147164;879;0;0;0;0;.00nan;0;0
15329;72439;3965;100;48;1;47;.979;3600000;0
15329;149353;3965;0;0;0;0;.00nan;0;0
15329;157295;880;0;0;0;0;.00nan;0;0
15329;161255;880;55;36;5;31;.861;3600000;0
15330;162979;966;39;27;5;22;.815;3600000;0
15330;196055;945;0;0;0;0;.00nan;0;0
15330;141496;966;0;0;0;0;.00nan;0;0
15330;146479;945;100;33;0;33;1.000;3600000;0
15331;164715;897;0;0;0;0;.00nan;0;0
15331;146386;897;64;17;1;16;.941;3600000;0
15331;146684;978;0;0;0;0;.00nan;0;0
15331;147492;978;86;44;3;41;.932;3561000;0
15332;169868;957;0;0;0;0;.00nan;0;0
15332;180376;890;91;32;1;31;.969;2298000;0
15332;78596;957;92;20;0;20;1.000;3600000;0
15332;146608;890;17;24;6;18;.750;1302000;0
15333;14266;879;58;20;3;17;.850;3600000;0
15333;147164;879;0;0;0;0;.00nan;0;0
15333;147255;891;0;0;0;0;.00nan;0;0
15333;160932;891;93;54;2;52;.963;3600000;0
15334;8187;894;0;0;0;0;.00nan;0;0
15334;71075;874;63;17;2;15;.882;3600000;0
15334;146300;874;0;0;0;0;.00nan;0;0
15334;146445;894;79;46;4;42;.913;3572000;0
15335;4215;956;0;0;0;0;.00nan;0;0
15335;7037;885;81;17;1;16;.941;3600000;0
15335;28701;885;0;0;0;0;.00nan;0;0
15335;141978;956;55;31;4;27;.871;3600000;0
15336;147255;891;0;0;0;0;.00nan;0;0
15336;157295;880;73;40;3;37;.925;3900000;0
15336;160932;891;62;30;3;27;.900;3900000;0
15336;161255;880;0;0;0;0;.00nan;0;0
15337;196055;945;0;0;0;0;.00nan;0;0
15337;146479;945;84;20;0;20;1.000;3600000;0
15337;146684;978;0;0;0;0;.00nan;0;0
15337;147492;978;35;28;5;23;.821;3600000;0
15338;162979;966;0;0;0;0;.00nan;0;0
15338;169868;957;0;0;0;0;.00nan;0;0
15338;78596;957;79;32;2;30;.938;3600000;0
15338;141496;966;83;44;4;40;.909;3567000;0
15339;4215;956;0;0;0;0;.00nan;0;0
15339;8187;894;36;19;4;15;.789;3558000;0
15339;141978;956;89;36;2;34;.944;3600000;0
15339;146445;894;0;0;0;0;.00nan;0;0
15340;164715;897;0;0;0;0;.00nan;0;0
15340;14266;879;17;9;4;5;.556;1087000;0
15340;146386;897;90;44;3;41;.932;3600000;0
15340;147164;879;46;14;2;12;.857;2513000;0
15341;71075;874;0;0;0;0;.00nan;0;0
15341;72439;3965;0;0;0;0;.00nan;0;0
15341;146300;874;70;27;2;25;.926;3900000;0
15341;149353;3965;99;42;2;40;.952;3900000;0
15342;7037;885;100;18;0;18;1.000;3600000;0
15342;28701;885;0;0;0;0;.00nan;0;0
15342;180376;890;84;40;2;38;.950;3560000;0
15342;146608;890;0;0;0;0;.00nan;0;0
15343;196055;945;0;0;0;0;.00nan;0;0
15343;71075;874;99;35;1;34;.971;3600000;0
15343;146300;874;0;0;0;0;.00nan;0;0
15343;146479;945;69;26;2;24;.923;3600000;0
15344;162979;966;0;0;0;0;.00nan;0;0
15344;14266;879;59;14;2;12;.857;3600000;0
15344;141496;966;88;54;3;51;.944;3546000;0
15344;147164;879;0;0;0;0;.00nan;0;0
15345;8187;894;0;0;0;0;.00nan;0;0
15345;72439;3965;0;0;0;0;.00nan;0;0
15345;146445;894;99;49;2;47;.959;3600000;0
15345;149353;3965;73;27;3;24;.889;3545000;0
15346;164715;897;79;20;1;19;.950;3600000;0
15346;180376;890;72;36;3;33;.917;3573000;0
15346;146386;897;0;0;0;0;.00nan;0;0
15346;146608;890;0;0;0;0;.00nan;0;0
15347;4215;956;0;0;0;0;.00nan;0;0
15347;169868;957;0;0;0;0;.00nan;0;0
15347;78596;957;27;24;5;19;.792;3600000;0
15347;141978;956;97;45;1;44;.978;3600000;0
15348;7037;885;0;0;0;0;.00nan;0;0
15348;28701;885;56;18;3;15;.833;3600000;0
15348;157295;880;0;0;0;0;.00nan;0;0
15348;161255;880;53;32;4;28;.875;3567000;0
15349;146684;978;0;0;0;0;.00nan;0;0
15349;147255;891;48;29;4;25;.862;3900000;0
15349;147492;978;83;45;4;41;.911;3900000;0
15349;160932;891;0;0;0;0;.00nan;0;0
15350;4215;956;83;33;2;31;.939;2743000;0
15350;71075;874;0;0;0;0;.00nan;0;0
15350;141978;956;29;13;4;9;.692;857000;0
15350;146300;874;64;15;1;14;.933;3600000;0
15351;180376;890;58;22;3;19;.864;3543000;0
15351;146608;890;0;0;0;0;.00nan;0;0
15351;157295;880;0;0;0;0;.00nan;0;0
15351;161255;880;73;25;2;23;.920;3600000;0
15352;169868;957;0;0;0;0;.00nan;0;0
15352;78596;957;70;23;2;21;.913;3600000;0
15352;146684;978;81;46;3;43;.935;3544000;0
15352;147492;978;0;0;0;0;.00nan;0;0
15353;164715;897;0;0;0;0;.00nan;0;0
15353;146386;897;96;21;0;21;1.000;3600000;0
15353;147255;891;0;0;0;0;.00nan;0;0
15353;160932;891;66;33;4;29;.879;3600000;0
15354;8187;894;0;0;0;0;.00nan;0;0
15354;14266;879;87;19;0;19;1.000;3600000;0
15354;146445;894;78;56;5;51;.911;3600000;0
15354;147164;879;0;0;0;0;.00nan;0;0
15355;7037;885;80;33;3;30;.909;3866000;0
15355;28701;885;0;0;0;0;.00nan;0;0
15355;72439;3965;0;0;0;0;.00nan;0;0
15355;149353;3965;80;38;4;34;.895;3866000;0
15356;162979;966;72;26;3;23;.885;3857000;0
15356;141496;966;0;0;0;0;.00nan;0;0
15356;146684;978;0;0;0;0;.00nan;0;0
15356;147492;978;58;27;3;24;.889;3900000;0
15357;8187;894;0;0;0;0;.00nan;0;0
15357;146445;894;89;53;3;50;.943;3600000;0
15357;147255;891;0;0;0;0;.00nan;0;0
15357;160932;891;100;26;0;26;1.000;3600000;0
15358;196055;945;84;35;2;33;.943;2588000;0
15358;146479;945;27;9;4;5;.556;1012000;0
15358;157295;880;0;0;0;0;.00nan;0;0
15358;161255;880;85;29;2;27;.931;3600000;0
15359;169868;957;0;0;0;0;.00nan;0;0
15359;180376;890;83;50;4;46;.920;3600000;0
15359;78596;957;96;17;0;17;1.000;3600000;0
15359;146608;890;0;0;0;0;.00nan;0;0
15360;4215;956;0;0;0;0;.00nan;0;0
15360;169868;957;0;0;0;0;.00nan;0;0
15360;78596;957;43;7;2;5;.714;3600000;0
15360;141978;956;92;50;4;46;.920;3600000;0
15361;71075;874;83;25;1;24;.960;3600000;0
15361;146300;874;0;0;0;0;.00nan;0;0
15361;146684;978;0;0;0;0;.00nan;0;0
15361;147492;978;96;48;3;45;.938;3540000;0
15362;162979;966;0;0;0;0;.00nan;0;0
15362;8187;894;0;0;0;0;.00nan;0;0
15362;141496;966;79;49;4;45;.918;3600000;0
15362;146445;894;100;25;0;25;1.000;3600000;0
15363;7037;885;52;36;5;31;.861;3571000;0
15363;14266;879;58;23;3;20;.870;3600000;0
15363;28701;885;0;0;0;0;.00nan;0;0
15363;147164;879;0;0;0;0;.00nan;0;0
15364;72439;3965;0;0;0;0;.00nan;0;0
15364;147255;891;0;0;0;0;.00nan;0;0
15364;149353;3965;89;48;3;45;.938;3577000;0
15364;160932;891;60;24;2;22;.917;3600000;0
15365;164715;897;0;0;0;0;.00nan;0;0
15365;180376;890;94;48;2;46;.958;3600000;0
15365;146386;897;73;9;0;9;1.000;3600000;0
15365;146608;890;0;0;0;0;.00nan;0;0
15366;196055;945;82;31;2;29;.935;3600000;0
15366;180376;890;37;32;6;26;.813;3229000;0
15366;146479;945;0;0;0;0;.00nan;0;0
15366;146608;890;65;10;0;10;1.000;371000;0
15367;164715;897;0;0;0;0;.00nan;0;0
15367;146386;897;81;12;0;12;1.000;3600000;0
15367;157295;880;59;4;0;4;1.000;245000;0
15367;161255;880;43;36;6;30;.833;3355000;0
15368;4215;956;55;35;5;30;.857;3600000;0
15368;8187;894;0;0;0;0;.00nan;0;0
15368;141978;956;0;0;0;0;.00nan;0;0
15368;146445;894;57;14;2;12;.857;3600000;0
15369;14266;879;52;19;2;17;.895;3541000;0
15369;169868;957;0;0;0;0;.00nan;0;0
15369;78596;957;68;25;1;24;.960;3600000;0
15369;147164;879;0;0;0;0;.00nan;0;0
15370;72439;3965;0;0;0;0;.00nan;0;0
15370;146684;978;76;28;2;26;.929;3600000;0
15370;147492;978;0;0;0;0;.00nan;0;0
15370;149353;3965;74;42;5;37;.881;3600000;0
15371;71075;874;0;0;0;0;.00nan;0;0
15371;146300;874;73;28;2;26;.929;3600000;0
15371;147255;891;0;0;0;0;.00nan;0;0
15371;160932;891;56;40;5;35;.875;3600000;0
15372;72439;3965;0;0;0;0;.00nan;0;0
15372;146684;978;0;0;0;0;.00nan;0;0
15372;147492;978;61;33;4;29;.879;3600000;0
15372;149353;3965;100;32;0;32;1.000;3600000;0
15373;8187;894;71;33;3;30;.909;3539000;0
15373;169868;957;87;27;1;26;.963;3600000;0
15373;78596;957;0;0;0;0;.00nan;0;0
15373;146445;894;0;0;0;0;.00nan;0;0
15374;7037;885;64;26;3;23;.885;3549000;0
15374;28701;885;0;0;0;0;.00nan;0;0
15374;147255;891;0;0;0;0;.00nan;0;0
15374;160932;891;67;16;1;15;.938;3600000;0
15375;164715;897;0;0;0;0;.00nan;0;0
15375;196055;945;0;0;0;0;.00nan;0;0
15375;146386;897;73;26;2;24;.923;3600000;0
15375;146479;945;44;26;4;22;.846;3537000;0
15376;71075;874;100;26;0;26;1.000;3600000;0
15376;72439;3965;0;0;0;0;.00nan;0;0
15376;146300;874;0;0;0;0;.00nan;0;0
15376;149353;3965;88;37;1;36;.973;3585000;0
15377;162979;966;72;43;4;39;.907;3600000;0
15377;169868;957;0;0;0;0;.00nan;0;0
15377;78596;957;43;16;3;13;.813;3600000;0
15377;141496;966;0;0;0;0;.00nan;0;0
15378;8187;894;0;0;0;0;.00nan;0;0
15378;146445;894;72;30;2;28;.933;3600000;0
15378;157295;880;0;0;0;0;.00nan;0;0
15378;161255;880;52;33;5;28;.848;3600000;0
15379;14266;879;69;15;1;14;.933;3600000;0
15379;146684;978;80;65;5;60;.923;3600000;0
15379;147164;879;0;0;0;0;.00nan;0;0
15379;147492;978;0;0;0;0;.00nan;0;0
15380;4215;956;68;20;1;19;.950;1719000;0
15380;180376;890;0;0;0;0;.00nan;0;0
15380;141978;956;19;15;5;10;.667;1881000;0
15380;146608;890;56;12;1;11;.917;3600000;0
15381;162979;966;0;0;0;0;.00nan;0;0
15381;72439;3965;0;0;0;0;.00nan;0;0
15381;141496;966;84;30;2;28;.933;3900000;0
15381;149353;3965;82;37;2;35;.946;3900000;0
15382;169868;957;0;0;0;0;.00nan;0;0
15382;196055;945;0;0;0;0;.00nan;0;0
15382;78596;957;76;23;1;22;.957;3600000;0
15382;146479;945;68;46;4;42;.913;3600000;0
15383;8187;894;0;0;0;0;.00nan;0;0
15383;180376;890;74;39;4;35;.897;3900000;0
15383;146445;894;75;43;4;39;.907;3895000;0
15383;146608;890;0;0;0;0;.00nan;0;0
15384;164715;897;57;24;3;21;.875;3549000;0
15384;146386;897;0;0;0;0;.00nan;0;0
15384;146684;978;0;0;0;0;.00nan;0;0
15384;147492;978;99;46;1;45;.978;3600000;0
15385;4215;956;0;0;0;0;.00nan;0;0
15385;7037;885;65;25;2;23;.920;3900000;0
15385;28701;885;0;0;0;0;.00nan;0;0
15385;141978;956;100;49;2;47;.959;3900000;0
15386;14266;879;68;20;1;19;.950;3600000;0
15386;147164;879;0;0;0;0;.00nan;0;0
15386;147255;891;0;0;0;0;.00nan;0;0
15386;160932;891;13;35;9;26;.743;3600000;0
15387;71075;874;0;0;0;0;.00nan;0;0
15387;146300;874;55;19;2;17;.895;3600000;0
15387;157295;880;70;38;4;34;.895;3568000;0
15387;161255;880;0;0;0;0;.00nan;0;0
15388;7037;885;81;37;3;34;.919;3547000;0
15388;169868;957;0;0;0;0;.00nan;0;0
15388;28701;885;0;0;0;0;.00nan;0;0
15388;78596;957;68;19;2;17;.895;3600000;0
15389;180376;890;36;30;5;25;.833;3836000;0
15389;72439;3965;0;0;0;0;.00nan;0;0
15389;146608;890;0;0;0;0;.00nan;0;0
15389;149353;3965;59;40;6;34;.850;3836000;0
15390;4215;956;0;0;0;0;.00nan;0;0
15390;196055;945;0;0;0;0;.00nan;0;0
15390;141978;956;43;33;5;28;.848;3565000;0
15390;146479;945;46;25;4;21;.840;3600000;0
15391;14266;879;74;38;3;35;.921;3561000;0
15391;71075;874;83;23;1;22;.957;3600000;0
15391;146300;874;0;0;0;0;.00nan;0;0
15391;147164;879;0;0;0;0;.00nan;0;0
15392;162979;966;75;39;3;36;.923;3565000;0
15392;164715;897;0;0;0;0;.00nan;0;0
15392;141496;966;0;0;0;0;.00nan;0;0
15392;146386;897;71;23;2;21;.913;3600000;0
15393;146684;978;85;18;0;18;1.000;3600000;0
15393;147492;978;0;0;0;0;.00nan;0;0
15393;157295;880;58;24;2;22;.917;3551000;0
15393;161255;880;0;0;0;0;.00nan;0;0
15394;164715;897;0;0;0;0;.00nan;0;0
15394;169868;957;0;0;0;0;.00nan;0;0
15394;78596;957;73;29;2;27;.931;3557000;0
15394;146386;897;100;32;0;32;1.000;3600000;0
15395;8187;894;0;0;0;0;.00nan;0;0
15395;71075;874;0;0;0;0;.00nan;0;0
15395;146300;874;79;21;1;20;.952;3600000;0
15395;146445;894;61;47;5;42;.894;3600000;0
15396;4215;956;81;29;2;27;.931;3600000;0
15396;141978;956;0;0;0;0;.00nan;0;0
15396;157295;880;61;29;3;26;.897;3579000;0
15396;161255;880;0;0;0;0;.00nan;0;0
15397;14266;879;77;9;0;9;1.000;3600000;0
15397;72439;3965;0;0;0;0;.00nan;0;0
15397;147164;879;0;0;0;0;.00nan;0;0
15397;149353;3965;57;53;7;46;.868;3600000;0
15398;7037;885;0;0;0;0;.00nan;0;0
15398;28701;885;94;30;1;29;.967;3600000;0
15398;180376;890;75;23;2;21;.913;3547000;0
15398;146608;890;0;0;0;0;.00nan;0;0
15399;196055;945;0;0;0;0;.00nan;0;0
15399;146479;945;73;27;2;25;.926;3600000;0
15399;147255;891;58;28;3;25;.893;3543000;0
15399;160932;891;0;0;0;0;.00nan;0;0
15400;14266;879;100;27;0;27;1.000;3600000;0
15400;147164;879;0;0;0;0;.00nan;0;0
15400;157295;880;98;52;3;49;.942;3600000;0
15400;161255;880;0;0;0;0;.00nan;0;0
15401;8187;894;0;0;0;0;.00nan;0;0
15401;196055;945;0;0;0;0;.00nan;0;0
15401;146445;894;46;34;5;29;.853;3600000;0
15401;146479;945;94;24;0;24;1.000;3600000;0
15402;7037;885;0;0;0;0;.00nan;0;0
15402;28701;885;78;42;4;38;.905;3567000;0
15402;71075;874;0;0;0;0;.00nan;0;0
15402;146300;874;80;35;2;33;.943;3600000;0
15403;4215;956;54;30;4;26;.867;1634000;0
15403;164715;897;0;0;0;0;.00nan;0;0
15403;141978;956;51;40;5;35;.875;1966000;0
15403;146386;897;63;15;1;14;.933;3600000;0
15404;146684;978;64;36;3;33;.917;3524000;0
15404;147255;891;0;0;0;0;.00nan;0;0
15404;147492;978;0;0;0;0;.00nan;0;0
15404;160932;891;70;23;1;22;.957;3600000;0
15405;162979;966;0;0;0;0;.00nan;0;0
15405;180376;890;0;0;0;0;.00nan;0;0
15405;141496;966;84;45;3;42;.933;3600000;0
15405;146608;890;42;25;4;21;.840;3543000;0
15406;169868;957;0;0;0;0;.00nan;0;0
15406;72439;3965;90;43;2;41;.953;3544000;0
15406;78596;957;75;24;1;23;.958;3600000;0
15406;149353;3965;0;0;0;0;.00nan;0;0
15407;162979;966;64;36;4;32;.889;3600000;0
15407;196055;945;0;0;0;0;.00nan;0;0
15407;141496;966;0;0;0;0;.00nan;0;0
15407;146479;945;68;18;1;17;.944;3600000;0
15408;72439;3965;0;0;0;0;.00nan;0;0
15408;149353;3965;43;16;3;13;.813;3600000;0
15408;157295;880;52;36;5;31;.861;3562000;0
15408;161255;880;0;0;0;0;.00nan;0;0
15409;180376;890;77;31;2;29;.935;3600000;0
15409;71075;874;51;26;3;23;.885;3583000;0
15409;146300;874;0;0;0;0;.00nan;0;0
15409;146608;890;0;0;0;0;.00nan;0;0
15410;8187;894;0;0;0;0;.00nan;0;0
15410;164715;897;0;0;0;0;.00nan;0;0
15410;146386;897;54;25;3;22;.880;3600000;0
15410;146445;894;81;51;4;47;.922;3584000;0
15411;4215;956;0;0;0;0;.00nan;0;0
15411;162979;966;59;17;2;15;.882;3600000;0
15411;141496;966;0;0;0;0;.00nan;0;0
15411;141978;956;63;41;4;37;.902;3600000;0
15412;14266;879;62;18;2;16;.889;3600000;0
15412;196055;945;0;0;0;0;.00nan;0;0
15412;146479;945;58;40;6;34;.850;3600000;0
15412;147164;879;0;0;0;0;.00nan;0;0
15413;7037;885;0;0;0;0;.00nan;0;0
15413;28701;885;80;27;1;26;.963;3600000;0
15413;146684;978;85;44;3;41;.932;3600000;0
15413;147492;978;0;0;0;0;.00nan;0;0
15414;169868;957;0;0;0;0;.00nan;0;0
15414;78596;957;61;32;3;29;.906;3521000;0
15414;147255;891;0;0;0;0;.00nan;0;0
15414;160932;891;96;32;1;31;.969;3600000;0
15415;196055;945;70;31;4;27;.871;3742000;0
15415;146479;945;0;0;0;0;.00nan;0;0
15415;157295;880;57;19;3;16;.842;3742000;0
15415;161255;880;0;0;0;0;.00nan;0;0
15416;169868;957;49;27;4;23;.852;3530000;0
15416;71075;874;0;0;0;0;.00nan;0;0
15416;78596;957;0;0;0;0;.00nan;0;0
15416;146300;874;83;35;2;33;.943;3600000;0
15417;162979;966;0;0;0;0;.00nan;0;0
15417;141496;966;48;33;5;28;.848;3557000;0
15417;147255;891;0;0;0;0;.00nan;0;0
15417;160932;891;63;34;4;30;.882;3600000;0
15418;8187;894;0;0;0;0;.00nan;0;0
15418;146445;894;100;47;2;45;.957;3600000;0
15418;146684;978;59;24;3;21;.875;3580000;0
15418;147492;978;0;0;0;0;.00nan;0;0
15419;7037;885;0;0;0;0;.00nan;0;0
15419;164715;897;0;0;0;0;.00nan;0;0
15419;28701;885;88;39;2;37;.949;3587000;0
15419;146386;897;95;22;0;22;1.000;3600000;0
15420;4215;956;0;0;0;0;.00nan;0;0
15420;72439;3965;35;28;6;22;.786;3600000;0
15420;141978;956;65;31;3;28;.903;3600000;0
15420;149353;3965;0;0;0;0;.00nan;0;0
15421;14266;879;55;19;3;16;.842;3600000;0
15421;180376;890;62;39;5;34;.872;3520000;0
15421;146608;890;0;0;0;0;.00nan;0;0
15421;147164;879;0;0;0;0;.00nan;0;0
15422;7037;885;0;0;0;0;.00nan;0;0
15422;28701;885;100;24;0;24;1.000;3600000;0
15422;196055;945;0;0;0;0;.00nan;0;0
15422;146479;945;49;33;5;28;.848;3600000;0
15423;169868;957;0;0;0;0;.00nan;0;0
15423;78596;957;78;34;3;31;.912;3900000;0
15423;157295;880;68;42;3;39;.929;3900000;0
15423;161255;880;0;0;0;0;.00nan;0;0
15424;162979;966;59;24;2;22;.917;3565000;0
15424;71075;874;0;0;0;0;.00nan;0;0
15424;141496;966;0;0;0;0;.00nan;0;0
15424;146300;874;100;32;1;31;.969;3600000;0
15425;164715;897;0;0;0;0;.00nan;0;0
15425;14266;879;78;25;1;24;.960;3600000;0
15425;146386;897;77;26;2;24;.923;3546000;0
15425;147164;879;0;0;0;0;.00nan;0;0
15426;8187;894;0;0;0;0;.00nan;0;0
15426;72439;3965;0;0;0;0;.00nan;0;0
15426;146445;894;72;25;2;23;.920;3600000;0
15426;149353;3965;87;38;3;35;.921;3600000;0
15427;180376;890;78;39;3;36;.923;3600000;0
15427;146608;890;0;0;0;0;.00nan;0;0
15427;147255;891;27;24;6;18;.750;3600000;0
15427;160932;891;0;0;0;0;.00nan;0;0
15428;7037;885;0;0;0;0;.00nan;0;0
15428;28701;885;48;27;4;23;.852;3550000;0
15428;157295;880;0;0;0;0;.00nan;0;0
15428;161255;880;70;31;3;28;.903;3600000;0
15429;196055;945;0;0;0;0;.00nan;0;0
15429;71075;874;70;17;1;16;.941;3600000;0
15429;146300;874;0;0;0;0;.00nan;0;0
15429;146479;945;35;50;8;42;.840;3600000;0
15430;8187;894;0;0;0;0;.00nan;0;0
15430;169868;957;0;0;0;0;.00nan;0;0
15430;78596;957;64;16;1;15;.938;3600000;0
15430;146445;894;75;44;4;40;.909;3600000;0
15431;164715;897;0;0;0;0;.00nan;0;0
15431;72439;3965;0;0;0;0;.00nan;0;0
15431;146386;897;53;25;4;21;.840;3678000;0
15431;149353;3965;90;44;3;41;.932;3678000;0
15432;4215;956;0;0;0;0;.00nan;0;0
15432;141978;956;75;42;4;38;.905;3584000;0
15432;147255;891;0;0;0;0;.00nan;0;0
15432;160932;891;56;16;2;14;.875;3600000;0
15433;162979;966;0;0;0;0;.00nan;0;0
15433;14266;879;0;0;0;0;.00nan;0;0
15433;141496;966;52;37;5;32;.865;3600000;0
15433;147164;879;61;19;2;17;.895;3600000;0
15434;180376;890;90;35;2;33;.943;3900000;0
15434;146608;890;0;0;0;0;.00nan;0;0
15434;146684;978;91;40;2;38;.950;3900000;0
15434;147492;978;0;0;0;0;.00nan;0;0
15435;4215;956;0;0;0;0;.00nan;0;0
15435;141978;956;85;29;1;28;.966;3600000;0
15435;157295;880;71;28;2;26;.929;3575000;0
15435;161255;880;0;0;0;0;.00nan;0;0
15436;196055;945;0;0;0;0;.00nan;0;0
15436;72439;3965;50;28;4;24;.857;3599000;0
15436;146479;945;73;33;3;30;.909;3600000;0
15436;149353;3965;0;0;0;0;.00nan;0;0
15437;162979;966;100;40;2;38;.950;3600000;0
15437;141496;966;0;0;0;0;.00nan;0;0
15437;147255;891;51;23;4;19;.826;3591000;0
15437;160932;891;0;0;0;0;.00nan;0;0
15438;14266;879;62;24;2;22;.917;3600000;0
15438;146684;978;69;22;1;21;.955;1062000;0
15438;147164;879;0;0;0;0;.00nan;0;0
15438;147492;978;45;37;6;31;.838;2538000;0
15439;164715;897;0;0;0;0;.00nan;0;0
15439;71075;874;0;0;0;0;.00nan;0;0
15439;146300;874;74;36;3;33;.917;3900000;0
15439;146386;897;59;29;3;26;.897;3900000;0
15440;7037;885;0;0;0;0;.00nan;0;0
15440;8187;894;0;0;0;0;.00nan;0;0
15440;28701;885;55;20;2;18;.900;3900000;0
15440;146445;894;95;45;2;43;.956;3900000;0
15441;196055;945;0;0;0;0;.00nan;0;0
15441;71075;874;87;30;1;29;.967;3600000;0
15441;146300;874;0;0;0;0;.00nan;0;0
15441;146479;945;35;27;5;22;.815;3600000;0
15442;14266;879;76;34;3;31;.912;3900000;0
15442;169868;957;0;0;0;0;.00nan;0;0
15442;78596;957;81;39;3;36;.923;3900000;0
15442;147164;879;0;0;0;0;.00nan;0;0
15443;162979;966;0;0;0;0;.00nan;0;0
15443;164715;897;0;0;0;0;.00nan;0;0
15443;141496;966;77;40;3;37;.925;3600000;0
15443;146386;897;71;27;2;25;.926;3600000;0
15444;7037;885;0;0;0;0;.00nan;0;0
15444;28701;885;59;35;4;31;.886;3600000;0
15444;157295;880;0;0;0;0;.00nan;0;0
15444;161255;880;80;22;1;21;.955;3600000;0
15445;4215;956;0;0;0;0;.00nan;0;0
15445;180376;890;53;28;4;24;.857;3600000;0
15445;141978;956;100;36;0;36;1.000;3600000;0
15445;146608;890;0;0;0;0;.00nan;0;0
15446;162979;966;38;16;3;13;.813;3600000;0
15446;141496;966;0;0;0;0;.00nan;0;0
15446;157295;880;100;24;0;24;1.000;3600000;0
15446;161255;880;0;0;0;0;.00nan;0;0
15447;7037;885;0;0;0;0;.00nan;0;0
15447;28701;885;87;48;3;45;.938;3600000;0
15447;71075;874;0;0;0;0;.00nan;0;0
15447;146300;874;52;15;2;13;.867;3600000;0
15448;164715;897;100;27;0;27;1.000;3600000;0
15448;180376;890;50;23;3;20;.870;3600000;0
15448;146386;897;0;0;0;0;.00nan;0;0
15448;146608;890;0;0;0;0;.00nan;0;0
15449;4215;956;0;0;0;0;.00nan;0;0
15449;8187;894;0;0;0;0;.00nan;0;0
15449;141978;956;65;35;3;32;.914;3561000;0
15449;146445;894;82;28;2;26;.929;3600000;0
15450;14266;879;69;19;2;17;.895;3600000;0
15450;147164;879;0;0;0;0;.00nan;0;0
15450;147255;891;62;11;0;11;1.000;506000;0
15450;160932;891;41;36;6;30;.833;3094000;0
15451;169868;957;0;0;0;0;.00nan;0;0
15451;72439;3965;0;0;0;0;.00nan;0;0
15451;78596;957;47;18;3;15;.833;3900000;0
15451;149353;3965;91;49;3;46;.939;3900000;0
15452;164715;897;88;33;1;32;.970;3600000;0
15452;169868;957;0;0;0;0;.00nan;0;0
15452;78596;957;32;24;5;19;.792;3600000;0
15452;146386;897;0;0;0;0;.00nan;0;0
15453;162979;966;0;0;0;0;.00nan;0;0
15453;72439;3965;0;0;0;0;.00nan;0;0
15453;141496;966;42;25;5;20;.800;3596000;0
15453;149353;3965;51;40;6;34;.850;3595000;0
15454;8187;894;0;0;0;0;.00nan;0;0
15454;14266;879;59;26;3;23;.885;3777000;0
15454;146445;894;97;44;2;42;.955;3777000;0
15454;147164;879;0;0;0;0;.00nan;0;0
15455;4215;956;0;0;0;0;.00nan;0;0
15455;7037;885;0;0;0;0;.00nan;0;0
15455;28701;885;77;25;1;24;.960;3600000;0
15455;141978;956;62;34;4;30;.882;3600000;0
15456;196055;945;0;0;0;0;.00nan;0;0
15456;146479;945;75;21;1;20;.952;3600000;0
15456;146684;978;56;24;2;22;.917;3596000;0
15456;147492;978;0;0;0;0;.00nan;0;0
15457;180376;890;56;24;2;22;.917;3900000;0
15457;146608;890;0;0;0;0;.00nan;0;0
15457;157295;880;0;0;0;0;.00nan;0;0
15457;161255;880;100;47;2;45;.957;3900000;0
15458;71075;874;0;0;0;0;.00nan;0;0
15458;146300;874;92;33;2;31;.939;3782000;0
15458;147255;891;89;31;1;30;.968;3782000;0
15458;160932;891;0;0;0;0;.00nan;0;0
15459;196055;945;0;0;0;0;.00nan;0;0
15459;146479;945;53;34;4;30;.882;3543000;0
15459;146684;978;0;0;0;0;.00nan;0;0
15459;147492;978;81;27;2;25;.926;3600000;0
15460;162979;966;68;31;3;28;.903;3600000;0
15460;7037;885;0;0;0;0;.00nan;0;0
15460;28701;885;99;36;2;34;.944;3600000;0
15460;141496;966;0;0;0;0;.00nan;0;0
15461;8187;894;0;0;0;0;.00nan;0;0
15461;146445;894;68;40;4;36;.900;3582000;0
15461;157295;880;61;18;2;16;.889;3600000;0
15461;161255;880;0;0;0;0;.00nan;0;0
15462;196055;945;63;33;4;29;.879;3600000;0
15462;180376;890;100;30;0;30;1.000;3600000;0
15462;146479;945;0;0;0;0;.00nan;0;0
15462;146608;890;0;0;0;0;.00nan;0;0
15463;4215;956;0;0;0;0;.00nan;0;0
15463;71075;874;73;23;1;22;.957;3600000;0
15463;141978;956;76;36;3;33;.917;3560000;0
15463;146300;874;0;0;0;0;.00nan;0;0
15464;162979;966;0;0;0;0;.00nan;0;0
15464;14266;879;99;24;0;24;1.000;3600000;0
15464;141496;966;94;51;4;47;.922;3600000;0
15464;147164;879;0;0;0;0;.00nan;0;0
15465;7037;885;0;0;0;0;.00nan;0;0
15465;28701;885;68;27;3;24;.889;3668000;0
15465;72439;3965;0;0;0;0;.00nan;0;0
15465;149353;3965;56;35;4;31;.886;3668000;0
15466;169868;957;0;0;0;0;.00nan;0;0
15466;78596;957;95;24;0;24;1.000;3600000;0
15466;146684;978;87;37;2;35;.946;3566000;0
15466;147492;978;0;0;0;0;.00nan;0;0
15467;164715;897;0;0;0;0;.00nan;0;0
15467;146386;897;92;26;1;25;.962;3900000;0
15467;147255;891;0;0;0;0;.00nan;0;0
15467;160932;891;96;45;1;44;.978;3900000;0
15468;8187;894;0;0;0;0;.00nan;0;0
15468;180376;890;28;8;3;5;.625;479000;0
15468;146445;894;68;45;5;40;.889;3900000;0
15468;146608;890;84;38;2;36;.947;3421000;0
15469;162979;966;59;23;2;21;.913;3600000;0
15469;141496;966;0;0;0;0;.00nan;0;0
15469;147255;891;0;0;0;0;.00nan;0;0
15469;160932;891;48;20;3;17;.850;3600000;0
15470;146684;978;0;0;0;0;.00nan;0;0
15470;147492;978;35;28;5;23;.821;3600000;0
15470;157295;880;0;0;0;0;.00nan;0;0
15470;161255;880;81;26;1;25;.962;3600000;0
15471;7037;885;0;0;0;0;.00nan;0;0
15471;28701;885;83;24;1;23;.958;3600000;0
15471;196055;945;0;0;0;0;.00nan;0;0
15471;146479;945;72;35;3;32;.914;3563000;0
15472;169868;957;0;0;0;0;.00nan;0;0
15472;78596;957;69;24;3;21;.875;3600000;0
15472;147255;891;94;27;0;27;1.000;2399000;0
15472;160932;891;27;13;4;9;.692;1146000;0
15473;164715;897;0;0;0;0;.00nan;0;0
15473;71075;874;53;22;3;19;.864;3600000;0
15473;146300;874;0;0;0;0;.00nan;0;0
15473;146386;897;43;31;5;26;.839;3549000;0
15474;4215;956;61;44;6;38;.864;3187000;0
15474;162979;966;30;29;6;23;.793;3600000;0
15474;141496;966;0;0;0;0;.00nan;0;0
15474;141978;956;31;12;3;9;.750;413000;0
15475;14266;879;92;19;0;19;1.000;3600000;0
15475;72439;3965;0;0;0;0;.00nan;0;0
15475;147164;879;0;0;0;0;.00nan;0;0
15475;149353;3965;67;42;5;37;.881;3600000;0
15476;71075;874;65;18;1;17;.944;3600000;0
15476;146300;874;0;0;0;0;.00nan;0;0
15476;157295;880;65;44;5;39;.886;3600000;0
15476;161255;880;0;0;0;0;.00nan;0;0
15477;8187;894;0;0;0;0;.00nan;0;0
15477;169868;957;0;0;0;0;.00nan;0;0
15477;78596;957;93;38;2;36;.947;3825000;0
15477;146445;894;94;50;3;47;.940;3825000;0
15478;4215;956;0;0;0;0;.00nan;0;0
15478;14266;879;73;21;1;20;.952;3600000;0
15478;141978;956;89;44;4;40;.909;3600000;0
15478;147164;879;0;0;0;0;.00nan;0;0
15479;7037;885;0;0;0;0;.00nan;0;0
15479;28701;885;78;20;1;19;.950;3600000;0
15479;180376;890;68;37;4;33;.892;3600000;0
15479;146608;890;0;0;0;0;.00nan;0;0
15480;164715;897;0;0;0;0;.00nan;0;0
15480;146386;897;61;28;3;25;.893;3600000;0
15480;146684;978;100;31;0;31;1.000;3600000;0
15480;147492;978;0;0;0;0;.00nan;0;0
15481;72439;3965;0;0;0;0;.00nan;0;0
15481;147255;891;0;0;0;0;.00nan;0;0
15481;149353;3965;82;34;2;32;.941;3600000;0
15481;160932;891;46;24;4;20;.833;3513000;0
15482;162979;966;0;0;0;0;.00nan;0;0
15482;196055;945;0;0;0;0;.00nan;0;0
15482;141496;966;80;26;2;24;.923;3900000;0
15482;146479;945;77;32;2;30;.938;3900000;0
15483;8187;894;0;0;0;0;.00nan;0;0
15483;14266;879;95;22;0;22;1.000;3600000;0
15483;146445;894;98;40;1;39;.975;3552000;0
15483;147164;879;0;0;0;0;.00nan;0;0
15484;72439;3965;0;0;0;0;.00nan;0;0
15484;149353;3965;50;37;6;31;.838;3600000;0
15484;157295;880;0;0;0;0;.00nan;0;0
15484;161255;880;66;30;3;27;.900;3600000;0
15485;162979;966;44;35;5;30;.857;3337000;0
15485;169868;957;71;19;1;18;.947;3600000;0
15485;78596;957;0;0;0;0;.00nan;0;0
15485;141496;966;51;4;0;4;1.000;263000;0
15486;180376;890;96;44;2;42;.955;3600000;0
15486;71075;874;0;0;0;0;.00nan;0;0
15486;146300;874;45;20;3;17;.850;3560000;0
15486;146608;890;0;0;0;0;.00nan;0;0
15487;8187;894;45;4;1;3;.750;409000;0
15487;164715;897;0;0;0;0;.00nan;0;0
15487;146386;897;73;19;1;18;.947;3600000;0
15487;146445;894;38;33;6;27;.818;3191000;0
15488;4215;956;83;25;1;24;.960;3600000;0
15488;196055;945;0;0;0;0;.00nan;0;0
15488;141978;956;0;0;0;0;.00nan;0;0
15488;146479;945;44;31;5;26;.839;3600000;0
15489;146684;978;0;0;0;0;.00nan;0;0
15489;147255;891;73;20;1;19;.950;3600000;0
15489;147492;978;85;32;2;30;.938;3583000;0
15489;160932;891;0;0;0;0;.00nan;0;0
15490;169868;957;0;0;0;0;.00nan;0;0
15490;196055;945;69;38;4;34;.895;3600000;0
15490;78596;957;58;14;1;13;.929;3600000;0
15490;146479;945;0;0;0;0;.00nan;0;0
15491;7037;885;0;0;0;0;.00nan;0;0
15491;164715;897;52;18;2;16;.889;3600000;0
15491;28701;885;41;31;6;25;.806;3600000;0
15491;146386;897;0;0;0;0;.00nan;0;0
15492;4215;956;0;0;0;0;.00nan;0;0
15492;14266;879;46;12;2;10;.833;3600000;0
15492;141978;956;77;49;5;44;.898;3600000;0
15492;147164;879;0;0;0;0;.00nan;0;0
15493;71075;874;88;14;0;14;1.000;3600000;0
15493;72439;3965;0;0;0;0;.00nan;0;0
15493;146300;874;0;0;0;0;.00nan;0;0
15493;149353;3965;84;49;5;44;.898;3600000;0
15494;8187;894;0;0;0;0;.00nan;0;0
15494;146445;894;70;44;5;39;.886;3600000;0
15494;146684;978;58;22;2;20;.909;3600000;0
15494;147492;978;0;0;0;0;.00nan;0;0
15495;180376;890;100;30;0;30;1.000;3600000;0
15495;146608;890;0;0;0;0;.00nan;0;0
15495;147255;891;74;24;2;22;.917;3599000;0
15495;160932;891;0;0;0;0;.00nan;0;0
15496;7037;885;0;0;0;0;.00nan;0;0
15496;28701;885;87;39;3;36;.923;3784000;0
15496;147255;891;0;0;0;0;.00nan;0;0
15496;160932;891;90;39;2;37;.949;3784000;0
15497;162979;966;64;25;3;22;.880;3600000;0
15497;141496;966;0;0;0;0;.00nan;0;0
15497;157295;880;0;0;0;0;.00nan;0;0
15497;161255;880;54;40;5;35;.875;3561000;0
15498;14266;879;58;17;2;15;.882;3600000;0
15498;71075;874;0;0;0;0;.00nan;0;0
15498;146300;874;74;37;4;33;.892;3547000;0
15498;147164;879;0;0;0;0;.00nan;0;0
15499;164715;897;0;0;0;0;.00nan;0;0
15499;146386;897;73;20;1;19;.950;3600000;0
15499;157295;880;53;33;4;29;.879;3600000;0
15499;161255;880;0;0;0;0;.00nan;0;0
15500;162979;966;92;33;1;32;.970;3900000;0
15500;8187;894;100;38;1;37;.974;3900000;0
15500;141496;966;0;0;0;0;.00nan;0;0
15500;146445;894;0;0;0;0;.00nan;0;0
15501;7037;885;0;0;0;0;.00nan;0;0
15501;169868;957;0;0;0;0;.00nan;0;0
15501;28701;885;98;41;2;39;.951;3900000;0
15501;78596;957;80;28;2;26;.929;3900000;0
15502;196055;945;0;0;0;0;.00nan;0;0
15502;72439;3965;48;33;5;28;.848;3600000;0
15502;146479;945;99;37;1;36;.973;3600000;0
15502;149353;3965;0;0;0;0;.00nan;0;0
15503;180376;890;90;22;0;22;1.000;3600000;0
15503;146608;890;0;0;0;0;.00nan;0;0
15503;146684;978;0;0;0;0;.00nan;0;0
15503;147492;978;91;39;2;37;.949;3542000;0
15504;4215;956;0;0;0;0;.00nan;0;0
15504;141978;956;66;26;2;24;.923;3600000;0
15504;147255;891;39;31;5;26;.839;3600000;0
15504;160932;891;0;0;0;0;.00nan;0;0
15505;162979;966;77;38;3;35;.921;3900000;0
15505;71075;874;48;19;3;16;.842;3900000;0
15505;141496;966;0;0;0;0;.00nan;0;0
15505;146300;874;0;0;0;0;.00nan;0;0
15506;196055;945;0;0;0;0;.00nan;0;0
15506;146479;945;77;32;2;30;.938;3900000;0
15506;147255;891;0;0;0;0;.00nan;0;0
15506;160932;891;55;21;2;19;.905;3900000;0
15507;169868;957;0;0;0;0;.00nan;0;0
15507;180376;890;60;38;5;33;.868;3600000;0
15507;78596;957;93;18;0;18;1.000;3600000;0
15507;146608;890;0;0;0;0;.00nan;0;0
15508;4215;956;98;34;0;34;1.000;2422000;0
15508;164715;897;0;0;0;0;.00nan;0;0
15508;141978;956;34;16;4;12;.750;1178000;0
15508;146386;897;54;10;1;9;.900;3600000;0
15509;14266;879;40;8;2;6;.750;3600000;0
15509;147164;879;0;0;0;0;.00nan;0;0
15509;157295;880;100;47;1;46;.979;3600000;0
15509;161255;880;0;0;0;0;.00nan;0;0
15510;7037;885;0;0;0;0;.00nan;0;0
15510;28701;885;100;37;2;35;.946;3600000;0
15510;146684;978;39;30;6;24;.800;3600000;0
15510;147492;978;0;0;0;0;.00nan;0;0
15511;8187;894;0;0;0;0;.00nan;0;0
15511;72439;3965;0;0;0;0;.00nan;0;0
15511;146445;894;81;44;4;40;.909;3591000;0
15511;149353;3965;72;28;3;25;.893;3600000;0
15512;169868;957;0;0;0;0;.00nan;0;0
15512;78596;957;84;14;0;14;1.000;3600000;0
15512;157295;880;0;0;0;0;.00nan;0;0
15512;161255;880;97;50;2;48;.960;3571000;0
15513;162979;966;64;44;5;39;.886;3561000;0
15513;141496;966;0;0;0;0;.00nan;0;0
15513;146684;978;0;0;0;0;.00nan;0;0
15513;147492;978;46;26;4;22;.846;3600000;0
15514;14266;879;61;20;2;18;.900;3600000;0
15514;180376;890;95;46;3;43;.935;3600000;0
15514;146608;890;0;0;0;0;.00nan;0;0
15514;147164;879;0;0;0;0;.00nan;0;0
15515;164715;897;0;0;0;0;.00nan;0;0
15515;196055;945;0;0;0;0;.00nan;0;0
15515;146386;897;100;25;0;25;1.000;3600000;0
15515;146479;945;78;40;3;37;.925;3600000;0
15516;8187;894;0;0;0;0;.00nan;0;0
15516;71075;874;0;0;0;0;.00nan;0;0
15516;146300;874;51;15;2;13;.867;3600000;0
15516;146445;894;52;38;5;33;.868;3600000;0
15517;4215;956;0;0;0;0;.00nan;0;0
15517;72439;3965;0;0;0;0;.00nan;0;0
15517;141978;956;86;29;2;27;.931;3600000;0
15517;149353;3965;74;32;3;29;.906;3565000;0
15518;169868;957;0;0;0;0;.00nan;0;0
15518;71075;874;100;46;2;44;.957;3600000;0
15518;78596;957;57;23;3;20;.870;3552000;0
15518;146300;874;0;0;0;0;.00nan;0;0
15519;162979;966;0;0;0;0;.00nan;0;0
15519;180376;890;81;40;3;37;.925;3582000;0
15519;141496;966;74;29;2;27;.931;3600000;0
15519;146608;890;0;0;0;0;.00nan;0;0
15520;7037;885;66;14;0;14;1.000;1287000;0
15520;8187;894;0;0;0;0;.00nan;0;0
15520;28701;885;34;23;5;18;.783;2236000;0
15520;146445;894;70;40;4;36;.900;3600000;0
15521;14266;879;73;17;1;16;.941;3600000;0
15521;196055;945;87;29;1;28;.966;2114000;0
15521;146479;945;19;22;6;16;.727;1486000;0
15521;147164;879;0;0;0;0;.00nan;0;0
15522;164715;897;0;0;0;0;.00nan;0;0
15522;72439;3965;0;0;0;0;.00nan;0;0
15522;146386;897;57;19;2;17;.895;3600000;0
15522;149353;3965;67;37;4;33;.892;3600000;0
15523;147255;891;0;0;0;0;.00nan;0;0
15523;157295;880;0;0;0;0;.00nan;0;0
15523;160932;891;55;22;3;19;.864;3600000;0
15523;161255;880;58;32;4;28;.875;3600000;0
15524;147255;891;50;34;5;29;.853;3542000;0
15524;157295;880;64;27;3;24;.889;3600000;0
15524;160932;891;0;0;0;0;.00nan;0;0
15524;161255;880;0;0;0;0;.00nan;0;0
15525;8187;894;0;0;0;0;.00nan;0;0
15525;196055;945;0;0;0;0;.00nan;0;0
15525;146445;894;78;31;2;29;.935;3600000;0
15525;146479;945;67;17;1;16;.941;3600000;0
15526;71075;874;0;0;0;0;.00nan;0;0
15526;146300;874;57;20;2;18;.900;3600000;0
15526;146684;978;64;48;6;42;.875;3600000;0
15526;147492;978;0;0;0;0;.00nan;0;0
15527;164715;897;65;22;2;20;.909;3600000;0
15527;14266;879;77;34;3;31;.912;3576000;0
15527;146386;897;0;0;0;0;.00nan;0;0
15527;147164;879;0;0;0;0;.00nan;0;0
15528;4215;956;0;0;0;0;.00nan;0;0
15528;169868;957;0;0;0;0;.00nan;0;0
15528;78596;957;68;18;1;17;.944;3600000;0
15528;141978;956;97;44;2;42;.955;3550000;0
15529;162979;966;0;0;0;0;.00nan;0;0
15529;7037;885;70;27;2;25;.926;3528000;0
15529;28701;885;0;0;0;0;.00nan;0;0
15529;141496;966;100;30;0;30;1.000;3600000;0
15530;180376;890;71;25;1;24;.960;1841000;0
15530;72439;3965;54;14;2;12;.857;3316000;0
15530;146608;890;23;12;4;8;.667;2059000;0
15530;149353;3965;34;9;3;6;.667;584000;0
15531;180376;890;59;28;3;25;.893;3600000;0
15531;72439;3965;0;0;0;0;.00nan;0;0
15531;146608;890;0;0;0;0;.00nan;0;0
15531;149353;3965;28;22;5;17;.773;3523000;0
15532;162979;966;0;0;0;0;.00nan;0;0
15532;141496;966;95;28;1;27;.964;3600000;0
15532;146684;978;0;0;0;0;.00nan;0;0
15532;147492;978;84;41;3;38;.927;3600000;0
15533;4215;956;45;32;5;27;.844;3600000;0
15533;141978;956;0;0;0;0;.00nan;0;0
15533;157295;880;0;0;0;0;.00nan;0;0
15533;161255;880;70;19;1;18;.947;3600000;0
15534;7037;885;0;0;0;0;.00nan;0;0
15534;28701;885;84;23;1;22;.957;3600000;0
15534;196055;945;49;1;0;1;1.000;480000;0
15534;146479;945;27;28;6;22;.786;3120000;0
15535;164715;897;0;0;0;0;.00nan;0;0
15535;169868;957;0;0;0;0;.00nan;0;0
15535;78596;957;66;17;1;16;.941;3600000;0
15535;146386;897;73;31;2;29;.935;3578000;0
15536;8187;894;74;47;4;43;.915;3600000;0
15536;71075;874;0;0;0;0;.00nan;0;0
15536;146300;874;83;18;1;17;.944;3600000;0
15536;146445;894;0;0;0;0;.00nan;0;0
15537;14266;879;54;17;3;14;.824;3900000;0
15537;147164;879;0;0;0;0;.00nan;0;0
15537;147255;891;85;45;3;42;.933;3900000;0
15537;160932;891;0;0;0;0;.00nan;0;0
15538;7037;885;0;0;0;0;.00nan;0;0
15538;28701;885;59;36;4;32;.889;3549000;0
15538;157295;880;89;35;2;33;.943;3600000;0
15538;161255;880;0;0;0;0;.00nan;0;0
15539;169868;957;0;0;0;0;.00nan;0;0
15539;72439;3965;0;0;0;0;.00nan;0;0
15539;78596;957;80;10;0;10;1.000;3600000;0
15539;149353;3965;98;49;3;46;.939;3600000;0
15540;162979;966;56;35;5;30;.857;3600000;0
15540;71075;874;93;20;0;20;1.000;3600000;0
15540;146300;874;0;0;0;0;.00nan;0;0
15540;149584;966;0;0;0;0;.00nan;0;0
15541;8187;894;0;0;0;0;.00nan;0;0
15541;196055;945;0;0;0;0;.00nan;0;0
15541;146445;894;72;28;2;26;.929;3600000;0
15541;146479;945;35;33;6;27;.818;3600000;0
15542;4215;956;0;0;0;0;.00nan;0;0
15542;8519;879;0;0;0;0;.00nan;0;0
15542;141978;956;93;48;2;46;.958;3900000;0
15542;147164;879;48;15;2;13;.867;3900000;0
15543;146684;978;0;0;0;0;.00nan;0;0
15543;147255;891;0;0;0;0;.00nan;0;0
15543;147492;978;55;38;5;33;.868;3600000;0
15543;160932;891;61;26;2;24;.923;3600000;0
15544;164715;897;0;0;0;0;.00nan;0;0
15544;180376;890;91;37;2;35;.946;3600000;0
15544;146386;897;42;39;6;33;.846;3600000;0
15544;146608;890;0;0;0;0;.00nan;0;0
15545;8519;879;50;13;2;11;.846;3600000;0
15545;196055;945;0;0;0;0;.00nan;0;0
15545;146479;945;74;51;5;46;.902;3600000;0
15545;147164;879;0;0;0;0;.00nan;0;0
15546;162979;966;0;0;0;0;.00nan;0;0
15546;169868;957;0;0;0;0;.00nan;0;0
15546;78596;957;70;26;2;24;.923;3600000;0
15546;149584;966;83;44;3;41;.932;3569000;0
15547;164715;897;0;0;0;0;.00nan;0;0
15547;146386;897;53;22;3;19;.864;3600000;0
15547;146684;978;44;22;4;18;.818;998000;0
15547;147492;978;64;24;2;22;.917;2602000;0
15548;4215;956;0;0;0;0;.00nan;0;0
15548;71075;874;0;0;0;0;.00nan;0;0
15548;141978;956;97;49;2;47;.959;3900000;0
15548;146300;874;55;12;2;10;.833;3900000;0
15549;7037;885;0;0;0;0;.00nan;0;0
15549;8187;894;0;0;0;0;.00nan;0;0
15549;28701;885;91;29;1;28;.966;3600000;0
15549;146445;894;56;27;3;24;.889;3600000;0
15550;72439;3965;37;16;4;12;.750;1048000;0
15550;149353;3965;55;18;2;16;.889;2487000;0
15550;157295;880;0;0;0;0;.00nan;0;0
15550;161255;880;52;29;4;25;.862;3600000;0
15551;180376;890;79;40;4;36;.900;3600000;0
15551;146608;890;0;0;0;0;.00nan;0;0
15551;147255;891;61;15;1;14;.933;3600000;0
15551;160932;891;0;0;0;0;.00nan;0;0
15552;196055;945;0;0;0;0;.00nan;0;0
15552;71075;874;76;23;1;22;.957;3900000;0
15552;146300;874;0;0;0;0;.00nan;0;0
15552;146479;945;96;40;1;39;.975;3900000;0
15553;4215;956;79;31;2;29;.935;3600000;0
15553;7037;885;65;19;1;18;.947;3600000;0
15553;28701;885;0;0;0;0;.00nan;0;0
15553;141978;956;0;0;0;0;.00nan;0;0
15554;8519;879;66;15;1;14;.933;3600000;0
15554;180376;890;49;10;1;9;.900;536000;0
15554;146608;890;44;44;6;38;.864;3064000;0
15554;147164;879;0;0;0;0;.00nan;0;0
15555;146684;978;0;0;0;0;.00nan;0;0
15555;147492;978;76;39;3;36;.923;3572000;0
15555;157295;880;88;33;2;31;.939;3600000;0
15555;161255;880;0;0;0;0;.00nan;0;0
15556;164715;897;57;22;3;19;.864;3693000;0
15556;72439;3965;0;0;0;0;.00nan;0;0
15556;146386;897;0;0;0;0;.00nan;0;0
15556;149353;3965;94;55;4;51;.927;3693000;0
15557;164661;956;0;0;0;0;.00nan;0;0
15557;196055;945;0;0;0;0;.00nan;0;0
15557;141978;956;94;17;0;17;1.000;3900000;0
15557;146479;945;88;21;0;21;1.000;3900000;0
15558;71075;874;0;0;0;0;.00nan;0;0
15558;72439;3965;0;0;0;0;.00nan;0;0
15558;146300;874;88;17;0;17;1.000;3600000;0
15558;149353;3965;98;52;3;49;.942;3600000;0
15559;162979;966;0;0;0;0;.00nan;0;0
15559;8519;879;0;0;0;0;.00nan;0;0
15559;14266;879;81;27;2;25;.926;3900000;0
15559;149584;966;79;30;2;28;.933;3900000;0
15560;8187;894;0;0;0;0;.00nan;0;0
15560;146445;894;99;36;1;35;.972;3600000;0
15560;146684;978;54;25;3;22;.880;3576000;0
15560;147492;978;0;0;0;0;.00nan;0;0
15561;7037;885;0;0;0;0;.00nan;0;0
15561;164715;897;0;0;0;0;.00nan;0;0
15561;28701;885;73;36;4;32;.889;3577000;0
15561;146386;897;83;30;2;28;.933;3600000;0
15562;169868;957;0;0;0;0;.00nan;0;0
15562;180376;890;71;41;4;37;.902;3600000;0
15562;78596;957;78;20;1;19;.950;3600000;0
15562;146608;890;0;0;0;0;.00nan;0;0
15563;147255;891;0;0;0;0;.00nan;0;0
15563;157295;880;0;0;0;0;.00nan;0;0
15563;160932;891;27;24;6;18;.750;3600000;0
15563;161255;880;77;40;3;37;.925;3600000;0
15564;162979;966;60;35;4;31;.886;3562000;0
15564;149584;966;0;0;0;0;.00nan;0;0
15564;157295;880;85;37;2;35;.946;3600000;0
15564;161255;880;0;0;0;0;.00nan;0;0
15565;169868;957;0;0;0;0;.00nan;0;0
15565;196055;945;0;0;0;0;.00nan;0;0
15565;78596;957;95;23;0;23;1.000;3600000;0
15565;146479;945;52;31;5;26;.839;3600000;0
15566;8187;894;64;44;5;39;.886;3600000;0
15566;164715;897;0;0;0;0;.00nan;0;0
15566;146386;897;60;17;2;15;.882;3600000;0
15566;146445;894;0;0;0;0;.00nan;0;0
15567;164661;956;0;0;0;0;.00nan;0;0
15567;141978;956;100;43;0;43;1.000;3600000;0
15567;146684;978;0;0;0;0;.00nan;0;0
15567;147492;978;35;24;5;19;.792;3600000;0
15568;8519;879;0;0;0;0;.00nan;0;0
15568;14266;879;99;35;1;34;.971;3600000;0
15568;71075;874;0;0;0;0;.00nan;0;0
15568;146300;874;97;46;2;44;.957;3547000;0
15569;72439;3965;0;0;0;0;.00nan;0;0
15569;147255;891;79;29;1;28;.966;3600000;0
15569;149353;3965;56;35;5;30;.857;3600000;0
15569;160932;891;0;0;0;0;.00nan;0;0
15570;7037;885;0;0;0;0;.00nan;0;0
15570;28701;885;79;27;2;25;.926;3600000;0
15570;180376;890;47;35;5;30;.857;3600000;0
15570;146608;890;0;0;0;0;.00nan;0;0
15571;164661;956;93;56;3;53;.946;3814000;0
15571;141978;956;0;0;0;0;.00nan;0;0
15571;146684;978;76;24;2;22;.917;3814000;0
15571;147492;978;0;0;0;0;.00nan;0;0
15572;180376;890;86;30;2;28;.933;3900000;0
15572;146608;890;0;0;0;0;.00nan;0;0
15572;146684;978;0;0;0;0;.00nan;0;0
15572;147492;978;68;27;2;25;.926;3900000;0
15573;196055;945;0;0;0;0;.00nan;0;0
15573;72439;3965;0;0;0;0;.00nan;0;0
15573;146479;945;64;31;3;28;.903;3537000;0
15573;149353;3965;80;29;2;27;.931;3600000;0
15574;169868;957;0;0;0;0;.00nan;0;0
15574;78596;957;67;29;3;26;.897;3900000;0
15574;157295;880;0;0;0;0;.00nan;0;0
15574;161255;880;68;37;3;34;.919;3900000;0
15575;162979;966;0;0;0;0;.00nan;0;0
15575;164661;956;0;0;0;0;.00nan;0;0
15575;141978;956;55;18;2;16;.889;3546000;0
15575;149584;966;80;26;1;25;.962;3600000;0
15576;164715;897;0;0;0;0;.00nan;0;0
15576;146386;897;83;26;1;25;.962;3546000;0
15576;147255;891;0;0;0;0;.00nan;0;0
15576;160932;891;89;21;0;21;1.000;3600000;0
15577;7037;885;0;0;0;0;.00nan;0;0
15577;28701;885;98;45;3;42;.933;3567000;0
15577;71075;874;0;0;0;0;.00nan;0;0
15577;146300;874;70;17;1;16;.941;3600000;0
15578;8187;894;0;0;0;0;.00nan;0;0
15578;180376;890;34;31;6;25;.806;3592000;0
15578;146445;894;73;45;4;41;.911;3600000;0
15578;146608;890;0;0;0;0;.00nan;0;0
15579;8519;879;0;0;0;0;.00nan;0;0
15579;14266;879;69;20;1;19;.950;3600000;0
15579;157295;880;41;36;6;30;.833;3600000;0
15579;161255;880;0;0;0;0;.00nan;0;0
15580;169868;957;0;0;0;0;.00nan;0;0
15580;71075;874;100;51;2;49;.961;3600000;0
15580;78596;957;69;40;4;36;.900;3600000;0
15580;146300;874;0;0;0;0;.00nan;0;0
15581;164661;956;0;0;0;0;.00nan;0;0
15581;164715;897;72;16;1;15;.938;3900000;0
15581;141978;956;79;27;1;26;.963;3900000;0
15581;146386;897;0;0;0;0;.00nan;0;0
15582;7037;885;0;0;0;0;.00nan;0;0
15582;28701;885;70;18;1;17;.944;3600000;0
15582;146684;978;71;35;3;32;.914;3567000;0
15582;147492;978;0;0;0;0;.00nan;0;0
15583;196055;945;0;0;0;0;.00nan;0;0
15583;146479;945;62;26;3;23;.885;3600000;0
15583;147255;891;0;0;0;0;.00nan;0;0
15583;160932;891;88;20;0;20;1.000;3600000;0
15584;162979;966;90;29;1;28;.966;3600000;0
15584;72439;3965;0;0;0;0;.00nan;0;0
15584;149353;3965;81;43;4;39;.907;3600000;0
15584;149584;966;0;0;0;0;.00nan;0;0
15585;7037;885;88;44;3;41;.932;3583000;0
15585;169868;957;71;24;2;22;.917;3600000;0
15585;28701;885;0;0;0;0;.00nan;0;0
15585;78596;957;0;0;0;0;.00nan;0;0
15586;71075;874;0;0;0;0;.00nan;0;0
15586;146300;874;52;18;2;16;.889;3600000;0
15586;157295;880;0;0;0;0;.00nan;0;0
15586;161255;880;62;28;3;25;.893;3600000;0
15587;196055;945;0;0;0;0;.00nan;0;0
15587;146479;945;80;38;3;35;.921;3600000;0
15587;146684;978;0;0;0;0;.00nan;0;0
15587;147492;978;54;16;2;14;.875;3600000;0
15588;164661;956;0;0;0;0;.00nan;0;0
15588;141978;956;71;40;4;36;.900;3537000;0
15588;147255;891;0;0;0;0;.00nan;0;0
15588;160932;891;72;28;2;26;.929;3600000;0
15589;8519;879;0;0;0;0;.00nan;0;0
15589;164715;897;0;0;0;0;.00nan;0;0
15589;14266;879;65;21;2;19;.905;3600000;0
15589;146386;897;73;33;3;30;.909;3600000;0
15590;8187;894;0;0;0;0;.00nan;0;0
15590;72439;3965;96;21;0;21;1.000;3600000;0
15590;146445;894;98;44;1;43;.977;3545000;0
15590;149353;3965;0;0;0;0;.00nan;0;0
15591;162979;966;0;0;0;0;.00nan;0;0
15591;8187;894;0;0;0;0;.00nan;0;0
15591;146445;894;48;22;3;19;.864;3600000;0
15591;149584;966;100;31;0;31;1.000;3600000;0
15592;164715;897;0;0;0;0;.00nan;0;0
15592;146386;897;77;32;3;29;.906;3600000;0
15592;157295;880;0;0;0;0;.00nan;0;0
15592;161255;880;100;29;0;29;1.000;3600000;0
15593;164661;956;0;0;0;0;.00nan;0;0
15593;72439;3965;75;46;3;43;.935;3900000;0
15593;141978;956;68;29;3;26;.897;3900000;0
15593;149353;3965;0;0;0;0;.00nan;0;0
15594;7037;885;0;0;0;0;.00nan;0;0
15594;8519;879;0;0;0;0;.00nan;0;0
15594;14266;879;90;28;1;27;.964;3600000;0
15594;28701;885;92;20;0;20;1.000;3600000;0
15595;71075;874;0;0;0;0;.00nan;0;0
15595;146300;874;100;26;0;26;1.000;3600000;0
15595;146684;978;58;44;5;39;.886;2876000;0
15595;147492;978;38;8;2;6;.750;724000;0
15596;196055;945;0;0;0;0;.00nan;0;0
15596;180376;890;0;0;0;0;.00nan;0;0
15596;146479;945;99;39;1;38;.974;3600000;0
15596;146608;890;73;26;2;24;.923;3546000;0
15597;169868;957;0;0;0;0;.00nan;0;0
15597;78596;957;81;27;1;26;.963;3600000;0
15597;147255;891;63;36;3;33;.917;3566000;0
15597;160932;891;0;0;0;0;.00nan;0;0
15598;180376;890;42;24;4;20;.833;3600000;0
15598;146608;890;0;0;0;0;.00nan;0;0
15598;157295;880;0;0;0;0;.00nan;0;0
15598;161255;880;77;21;1;20;.952;3600000;0
15599;162979;966;0;0;0;0;.00nan;0;0
15599;196055;945;81;25;1;24;.960;3757000;0
15599;146479;945;0;0;0;0;.00nan;0;0
15599;149584;966;74;27;2;25;.926;3757000;0
15600;169868;957;0;0;0;0;.00nan;0;0
15600;78596;957;72;15;1;14;.933;3600000;0
15600;146684;978;0;0;0;0;.00nan;0;0
15600;147492;978;68;52;5;47;.904;3600000;0
15601;164715;897;59;25;4;21;.840;3838000;0
15601;71075;874;0;0;0;0;.00nan;0;0
15601;146300;874;82;37;3;34;.919;3838000;0
15601;146386;897;0;0;0;0;.00nan;0;0
15602;8187;894;48;34;5;29;.853;3600000;0
15602;164661;956;0;0;0;0;.00nan;0;0
15602;141978;956;71;25;2;23;.920;3600000;0
15602;146445;894;0;0;0;0;.00nan;0;0
15603;7037;885;0;0;0;0;.00nan;0;0
15603;28701;885;81;33;2;31;.939;3600000;0
15603;147255;891;0;0;0;0;.00nan;0;0
15603;160932;891;45;34;5;29;.853;3600000;0
15604;8519;879;0;0;0;0;.00nan;0;0
15604;14266;879;70;26;3;23;.885;3571000;0
15604;72439;3965;0;0;0;0;.00nan;0;0
15604;149353;3965;97;37;1;36;.973;3600000;0
15605;162979;966;42;26;4;22;.846;3535000;0
15605;180376;890;0;0;0;0;.00nan;0;0
15605;146608;890;66;31;2;29;.935;3600000;0
15605;149584;966;0;0;0;0;.00nan;0;0
15606;71075;874;5;27;8;19;.704;3041000;0
15606;146300;874;53;3;0;3;1.000;559000;0
15606;147255;891;0;0;0;0;.00nan;0;0
15606;160932;891;61;26;3;23;.885;3600000;0
15607;162979;966;91;35;2;33;.943;3900000;0
15607;7037;885;0;0;0;0;.00nan;0;0
15607;28701;885;71;27;2;25;.926;3900000;0
15607;149584;966;0;0;0;0;.00nan;0;0
15608;8187;894;0;0;0;0;.00nan;0;0
15608;146445;894;75;31;2;29;.935;3600000;0
15608;157295;880;19;8;4;4;.500;904000;0
15608;161255;880;59;24;3;21;.875;2696000;0
15609;164715;897;0;0;0;0;.00nan;0;0
15609;196055;945;0;0;0;0;.00nan;0;0
15609;146386;897;90;34;2;32;.941;3600000;0
15609;146479;945;44;25;4;21;.840;3600000;0
15610;164661;956;0;0;0;0;.00nan;0;0
15610;180376;890;64;23;2;21;.913;3600000;0
15610;141978;956;67;35;3;32;.914;3561000;0
15610;146608;890;0;0;0;0;.00nan;0;0
15611;8519;879;0;0;0;0;.00nan;0;0
15611;14266;879;82;29;2;27;.931;3600000;0
15611;169868;957;0;0;0;0;.00nan;0;0
15611;78596;957;65;26;3;23;.885;3577000;0
15612;72439;3965;0;0;0;0;.00nan;0;0
15612;146684;978;92;27;1;26;.963;3600000;0
15612;147492;978;0;0;0;0;.00nan;0;0
15612;149353;3965;70;40;4;36;.900;3600000;0
15613;196055;945;0;0;0;0;.00nan;0;0
15613;146479;945;89;41;2;39;.951;3900000;0
15613;157295;880;64;25;2;23;.920;3900000;0
15613;161255;880;0;0;0;0;.00nan;0;0
15614;164661;956;0;0;0;0;.00nan;0;0
15614;169868;957;64;12;1;11;.917;3900000;0
15614;78596;957;0;0;0;0;.00nan;0;0
15614;141978;956;100;40;1;39;.975;3900000;0
15615;162979;966;36;34;6;28;.824;3600000;0
15615;164715;897;96;23;0;23;1.000;3600000;0
15615;146386;897;0;0;0;0;.00nan;0;0
15615;149584;966;0;0;0;0;.00nan;0;0
15616;7037;885;69;28;3;25;.893;3600000;0
15616;28701;885;0;0;0;0;.00nan;0;0
15616;72439;3965;0;0;0;0;.00nan;0;0
15616;149353;3965;70;36;4;32;.889;3578000;0
15617;8519;879;0;0;0;0;.00nan;0;0
15617;14266;879;78;10;0;10;1.000;3600000;0
15617;146684;978;0;0;0;0;.00nan;0;0
15617;147492;978;83;57;5;52;.912;3600000;0
15618;180376;890;51;34;5;29;.853;3600000;0
15618;71075;874;0;0;0;0;.00nan;0;0
15618;146300;874;75;29;2;27;.931;3600000;0
15618;146608;890;0;0;0;0;.00nan;0;0
15619;8187;894;0;0;0;0;.00nan;0;0
15619;146445;894;100;37;0;37;1.000;3600000;0
15619;147255;891;0;0;0;0;.00nan;0;0
15619;160932;891;41;28;5;23;.821;3600000;0
15621;196055;945;0;0;0;0;.00nan;0;0
15621;71075;874;0;0;0;0;.00nan;0;0
15621;146300;874;72;9;0;9;1.000;3600000;0
15621;146479;945;95;44;2;42;.955;3593000;0
15623;4215;956;63;49;7;42;.857;3600000;0
15623;7037;885;46;10;2;8;.800;3600000;0
15623;28701;885;0;0;0;0;.00nan;0;0
15623;160312;956;0;0;0;0;.00nan;0;0
15625;8187;894;0;0;0;0;.00nan;0;0
15625;146445;894;82;26;1;25;.962;3600000;0
15625;146684;978;80;32;2;30;.938;3541000;0
15625;147492;978;0;0;0;0;.00nan;0;0
15627;147164;879;58;25;3;22;.880;3873000;0
15627;151940;879;0;0;0;0;.00nan;0;0
15627;157295;880;94;43;2;41;.953;3873000;0
15627;161255;880;0;0;0;0;.00nan;0;0
15629;164715;897;87;27;1;26;.963;3600000;0
15629;180376;890;88;47;4;43;.915;3600000;0
15629;146386;897;0;0;0;0;.00nan;0;0
15629;146608;890;0;0;0;0;.00nan;0;0
15631;169868;957;0;0;0;0;.00nan;0;0
15631;201288;957;70;20;1;19;.950;3600000;0
15631;72439;3965;72;16;0;16;1.000;1909000;0
15631;149353;3965;54;29;4;25;.862;1691000;0
15633;162979;966;21;9;4;5;.556;843000;0
15633;141496;966;78;18;0;18;1.000;2757000;0
15633;147255;891;99;42;1;41;.976;3600000;0
15633;160932;891;0;0;0;0;.00nan;0;0
15635;7037;885;40;24;4;20;.833;3600000;0
15635;28701;885;0;0;0;0;.00nan;0;0
15635;146684;978;0;0;0;0;.00nan;0;0
15635;147492;978;100;33;0;33;1.000;3600000;0
15637;4215;956;96;51;3;48;.941;3900000;0
15637;157295;880;0;0;0;0;.00nan;0;0
15637;160312;956;0;0;0;0;.00nan;0;0
15637;161255;880;44;16;3;13;.813;3900000;0
15639;162979;966;80;31;2;29;.935;3600000;0
15639;141496;966;0;0;0;0;.00nan;0;0
15639;147164;879;0;0;0;0;.00nan;0;0
15639;151940;879;51;22;3;19;.864;3564000;0
15641;164715;897;0;0;0;0;.00nan;0;0
15641;72439;3965;0;0;0;0;.00nan;0;0
15641;146386;897;44;14;3;11;.786;3600000;0
15641;149353;3965;23;26;6;20;.769;3600000;0
15643;180376;890;48;36;5;31;.861;3600000;0
15643;146608;890;0;0;0;0;.00nan;0;0
15643;147255;891;100;28;0;28;1.000;3600000;0
15643;160932;891;0;0;0;0;.00nan;0;0
15645;8187;894;0;0;0;0;.00nan;0;0
15645;196055;945;0;0;0;0;.00nan;0;0
15645;146445;894;88;20;0;20;1.000;3600000;0
15645;146479;945;98;42;1;41;.976;3588000;0
15647;169868;957;100;25;0;25;1.000;3600000;0
15647;201288;957;0;0;0;0;.00nan;0;0
15647;71075;874;0;0;0;0;.00nan;0;0
15647;146300;874;50;26;4;22;.846;3600000;0
15649;8187;894;0;0;0;0;.00nan;0;0
15649;146445;894;96;47;3;44;.936;3600000;0
15649;157295;880;53;14;2;12;.857;3600000;0
15649;161255;880;0;0;0;0;.00nan;0;0
15651;180376;890;0;0;0;0;.00nan;0;0
15651;71075;874;74;21;1;20;.952;3600000;0
15651;146300;874;0;0;0;0;.00nan;0;0
15651;146608;890;98;45;2;43;.956;3587000;0
15653;7037;885;0;0;0;0;.00nan;0;0
15653;28701;885;100;35;0;35;1.000;3600000;0
15653;146684;978;0;0;0;0;.00nan;0;0
15653;147492;978;53;31;4;27;.871;3600000;0
15655;4215;956;0;0;0;0;.00nan;0;0
15655;169868;957;63;9;1;8;.889;3600000;0
15655;201288;957;0;0;0;0;.00nan;0;0
15655;160312;956;82;64;5;59;.922;3600000;0
15657;162979;966;0;0;0;0;.00nan;0;0
15657;141496;966;100;46;1;45;.978;3600000;0
15657;147255;891;64;25;2;23;.920;3577000;0
15657;160932;891;0;0;0;0;.00nan;0;0
15659;196055;945;100;44;2;42;.955;3900000;0
15659;146479;945;0;0;0;0;.00nan;0;0
15659;147164;879;71;24;2;22;.917;3900000;0
15659;151940;879;0;0;0;0;.00nan;0;0
15661;164715;897;79;12;0;12;1.000;3600000;0
15661;72439;3965;25;32;6;26;.813;3255000;0
15661;146386;897;0;0;0;0;.00nan;0;0
15661;149353;3965;41;2;1;1;.500;345000;0
15663;196055;945;0;0;0;0;.00nan;0;0
15663;72439;3965;20;15;5;10;.667;1859000;0
15663;146479;945;56;28;4;24;.857;3600000;0
15663;149353;3965;63;8;0;8;1.000;1706000;0
15665;146684;978;62;31;4;27;.871;2272000;0
15665;147255;891;0;0;0;0;.00nan;0;0
15665;147492;978;30;9;3;6;.667;1328000;0
15665;160932;891;60;15;1;14;.933;3600000;0
15667;162979;966;56;24;3;21;.875;3600000;0
15667;8187;894;0;0;0;0;.00nan;0;0
15667;141496;966;0;0;0;0;.00nan;0;0
15667;146445;894;66;37;4;33;.892;3561000;0
15669;169868;957;0;0;0;0;.00nan;0;0
15669;201288;957;56;14;1;13;.929;3600000;0
15669;180376;890;95;62;5;57;.919;3600000;0
15669;146608;890;0;0;0;0;.00nan;0;0
15671;71075;874;0;0;0;0;.00nan;0;0
15671;146300;874;57;27;3;24;.889;3600000;0
15671;147164;879;0;0;0;0;.00nan;0;0
15671;151940;879;100;31;0;31;1.000;3600000;0
15673;4215;956;85;42;3;39;.929;3600000;0
15673;157295;880;73;20;1;19;.950;3600000;0
15673;160312;956;0;0;0;0;.00nan;0;0
15673;161255;880;0;0;0;0;.00nan;0;0
15675;7037;885;0;0;0;0;.00nan;0;0
15675;164715;897;34;27;5;22;.815;3900000;0
15675;28701;885;50;32;5;27;.844;3900000;0
15675;146386;897;0;0;0;0;.00nan;0;0
15677;180376;890;0;0;0;0;.00nan;0;0
15677;146608;890;95;46;3;43;.935;3900000;0
15677;157295;880;0;0;0;0;.00nan;0;0
15677;161255;880;51;23;3;20;.870;3900000;0
15679;8187;894;76;39;3;36;.923;3725000;0
15679;146445;894;0;0;0;0;.00nan;0;0
15679;147164;879;0;0;0;0;.00nan;0;0
15679;151940;879;49;17;2;15;.882;3725000;0
15681;162979;966;0;0;0;0;.00nan;0;0
15681;71075;874;22;17;5;12;.706;3600000;0
15681;141496;966;100;43;1;42;.977;3600000;0
15681;146300;874;0;0;0;0;.00nan;0;0
15683;4215;956;57;14;1;13;.929;524000;0
15683;147255;891;57;13;1;12;.923;3600000;0
15683;160312;956;50;47;6;41;.872;3076000;0
15683;160932;891;0;0;0;0;.00nan;0;0
15685;164715;897;0;0;0;0;.00nan;0;0
15685;72439;3965;0;0;0;0;.00nan;0;0
15685;146386;897;56;17;2;15;.882;3600000;0
15685;149353;3965;60;32;3;29;.906;3569000;0
15687;196055;945;62;14;1;13;.929;3900000;0
15687;146479;945;0;0;0;0;.00nan;0;0
15687;146684;978;0;0;0;0;.00nan;0;0
15687;147492;978;96;37;1;36;.973;3900000;0
15689;7037;885;99;43;1;42;.977;3600000;0
15689;169868;957;83;36;2;34;.944;3584000;0
15689;201288;957;0;0;0;0;.00nan;0;0
15689;28701;885;0;0;0;0;.00nan;0;0
15691;169868;957;0;0;0;0;.00nan;0;0
15691;201288;957;90;22;1;21;.955;3600000;0
15691;71075;874;0;0;0;0;.00nan;0;0
15691;146300;874;62;35;4;31;.886;3600000;0
15693;196055;945;0;0;0;0;.00nan;0;0
15693;146479;945;57;35;4;31;.886;3600000;0
15693;147255;891;0;0;0;0;.00nan;0;0
15693;160932;891;79;22;1;21;.955;3600000;0
15695;7037;885;0;0;0;0;.00nan;0;0
15695;8187;894;0;0;0;0;.00nan;0;0
15695;28701;885;40;26;5;21;.808;3552000;0
15695;146445;894;68;40;4;36;.900;3600000;0
15697;147164;879;60;23;2;21;.913;3900000;0
15697;151940;879;0;0;0;0;.00nan;0;0
15697;157295;880;96;48;2;46;.958;3900000;0
15697;161255;880;0;0;0;0;.00nan;0;0
15699;4215;956;44;41;7;34;.829;3600000;0
15699;146684;978;0;0;0;0;.00nan;0;0
15699;147492;978;43;22;4;18;.818;3600000;0
15699;160312;956;0;0;0;0;.00nan;0;0
15701;162979;966;0;0;0;0;.00nan;0;0
15701;164715;897;50;24;3;21;.875;3550000;0
15701;141496;966;93;42;2;40;.952;3600000;0
15701;146386;897;0;0;0;0;.00nan;0;0
15703;180376;890;54;24;4;20;.833;3600000;0
15703;72439;3965;0;0;0;0;.00nan;0;0
15703;146608;890;0;0;0;0;.00nan;0;0
15703;149353;3965;56;41;5;36;.878;3600000;0
15705;180376;890;28;7;3;4;.571;462000;0
15705;71075;874;67;24;2;22;.917;3600000;0
15705;146300;874;0;0;0;0;.00nan;0;0
15705;146608;890;19;37;8;29;.784;3138000;0
15707;7037;885;60;19;2;17;.895;3600000;0
15707;28701;885;0;0;0;0;.00nan;0;0
15707;196055;945;56;23;3;20;.870;3584000;0
15707;146479;945;0;0;0;0;.00nan;0;0
15709;146684;978;36;41;7;34;.829;2851000;0
15709;147164;879;0;0;0;0;.00nan;0;0
15709;147492;978;57;12;1;11;.917;749000;0
15709;151940;879;61;12;2;10;.833;3600000;0
15711;169868;957;100;27;0;27;1.000;3600000;0
15711;201288;957;0;0;0;0;.00nan;0;0
15711;147255;891;66;24;2;22;.917;3566000;0
15711;160932;891;0;0;0;0;.00nan;0;0
15713;162979;966;100;40;0;40;1.000;3600000;0
15713;72439;3965;21;24;6;18;.750;3183000;0
15713;141496;966;0;0;0;0;.00nan;0;0
15713;149353;3965;56;4;0;4;1.000;417000;0
15715;4215;956;0;0;0;0;.00nan;0;0
15715;157295;880;0;0;0;0;.00nan;0;0
15715;160312;956;81;50;5;45;.900;3600000;0
15715;161255;880;61;23;2;21;.913;3600000;0
15717;8187;894;0;0;0;0;.00nan;0;0
15717;164715;897;0;0;0;0;.00nan;0;0
15717;146386;897;72;33;2;31;.939;3600000;0
15717;146445;894;78;38;3;35;.921;3554000;0
1209;8187;894;0;0;0;0;.00nan;0;0
1209;146445;894;94;45;3;42;.933;3961000;0
1209;147255;891;0;0;0;0;.00nan;0;0
1209;160932;891;90;43;4;39;.907;3955000;0
1210;162979;966;0;0;0;0;.00nan;0;0
1210;196055;945;0;0;0;0;.00nan;0;0
1210;146479;945;44;25;4;21;.840;3600000;0
1210;149584;966;67;21;2;19;.905;3600000;0
1211;8187;894;0;0;0;0;.00nan;0;0
1211;146445;894;96;50;4;46;.920;3600000;0
1211;147255;891;0;0;0;0;.00nan;0;0
1211;160932;891;61;19;2;17;.895;3600000;0
1212;162979;966;68;22;2;20;.909;3579000;0
1212;196055;945;0;0;0;0;.00nan;0;0
1212;146479;945;94;31;1;30;.968;3600000;0
1212;149584;966;0;0;0;0;.00nan;0;0
1330;8187;894;0;0;0;0;.00nan;0;0
1330;146445;894;64;26;3;23;.885;3551000;0
1330;147255;891;0;0;0;0;.00nan;0;0
1330;160932;891;82;37;2;35;.946;3600000;0
1331;162979;966;64;26;2;24;.923;3600000;0
1331;196055;945;0;0;0;0;.00nan;0;0
1331;146479;945;63;29;3;26;.897;3552000;0
1331;149584;966;0;0;0;0;.00nan;0;0
1426;162979;966;91;48;2;46;.958;3600000;0
1426;8519;879;0;0;0;0;.00nan;0;0
1426;14266;879;52;22;3;19;.864;3546000;0
1426;149584;966;0;0;0;0;.00nan;0;0
1427;164715;897;0;0;0;0;.00nan;0;0
1427;146386;897;90;19;0;19;1.000;3600000;0
1427;157295;880;0;0;0;0;.00nan;0;0
1427;161255;880;67;41;4;37;.902;3600000;0
1428;7037;885;0;0;0;0;.00nan;0;0
1428;169868;957;0;0;0;0;.00nan;0;0
1428;28701;885;54;42;5;37;.881;4952000;0
1428;78596;957;46;39;6;33;.846;4952000;0
1429;71075;874;0;0;0;0;.00nan;0;0
1429;146300;874;63;19;2;17;.895;3600000;0
1429;147255;891;0;0;0;0;.00nan;0;0
1429;160932;891;61;29;3;26;.897;3577000;0
1430;162979;966;78;47;4;43;.915;3600000;0
1430;8519;879;0;0;0;0;.00nan;0;0
1430;14266;879;53;16;2;14;.875;3600000;0
1430;149584;966;0;0;0;0;.00nan;0;0
1431;164715;897;0;0;0;0;.00nan;0;0
1431;146386;897;58;32;4;28;.875;3542000;0
1431;157295;880;0;0;0;0;.00nan;0;0
1431;161255;880;67;37;3;34;.919;3600000;0
1432;7037;885;0;0;0;0;.00nan;0;0
1432;169868;957;0;0;0;0;.00nan;0;0
1432;28701;885;76;43;3;40;.930;3556000;0
1432;78596;957;72;24;2;22;.917;3600000;0
1433;71075;874;0;0;0;0;.00nan;0;0
1433;146300;874;72;22;1;21;.955;3600000;0
1433;147255;891;57;13;1;12;.923;1575000;0
1433;160932;891;22;25;6;19;.760;2025000;0
1434;162979;966;68;37;3;34;.919;3600000;0
1434;8519;879;0;0;0;0;.00nan;0;0
1434;14266;879;63;22;2;20;.909;3600000;0
1434;149584;966;0;0;0;0;.00nan;0;0
1435;164715;897;0;0;0;0;.00nan;0;0
1435;146386;897;65;28;3;25;.893;3600000;0
1435;157295;880;0;0;0;0;.00nan;0;0
1435;161255;880;100;34;0;34;1.000;3600000;0
1436;7037;885;77;17;0;17;1.000;960000;0
1436;169868;957;0;0;0;0;.00nan;0;0
1436;28701;885;27;24;6;18;.750;2640000;0
1436;78596;957;52;24;3;21;.875;3600000;0
1437;71075;874;0;0;0;0;.00nan;0;0
1437;146300;874;68;17;1;16;.941;3600000;0
1437;147255;891;83;43;3;40;.930;3586000;0
1437;160932;891;0;0;0;0;.00nan;0;0
1438;162979;966;89;42;2;40;.952;4263000;0
1438;8519;879;0;0;0;0;.00nan;0;0
1438;14266;879;67;18;1;17;.944;4263000;0
1438;149584;966;0;0;0;0;.00nan;0;0
1439;164715;897;0;0;0;0;.00nan;0;0
1439;146386;897;60;22;2;20;.909;3600000;0
1439;157295;880;0;0;0;0;.00nan;0;0
1439;161255;880;94;47;3;44;.936;3600000;0
1440;7037;885;100;42;0;42;1.000;3600000;0
1440;169868;957;0;0;0;0;.00nan;0;0
1440;28701;885;0;0;0;0;.00nan;0;0
1440;78596;957;92;34;1;33;.971;3600000;0
1441;71075;874;0;0;0;0;.00nan;0;0
1441;146300;874;82;32;2;30;.938;3563000;0
1441;147255;891;86;32;1;31;.969;3600000;0
1441;160932;891;0;0;0;0;.00nan;0;0
1582;162979;966;83;55;5;50;.909;3600000;0
1582;8519;879;0;0;0;0;.00nan;0;0
1582;14266;879;75;20;1;19;.950;3600000;0
1582;149584;966;0;0;0;0;.00nan;0;0
1583;164715;897;0;0;0;0;.00nan;0;0
1583;146386;897;61;22;3;19;.864;3600000;0
1583;157295;880;0;0;0;0;.00nan;0;0
1583;161255;880;75;40;4;36;.900;3600000;0
1584;7037;885;92;55;2;53;.964;4460000;0
1584;169868;957;0;0;0;0;.00nan;0;0
1584;28701;885;0;0;0;0;.00nan;0;0
1584;78596;957;72;22;1;21;.955;4460000;0
1585;71075;874;0;0;0;0;.00nan;0;0
1585;146300;874;60;23;3;20;.870;3600000;0
1585;147255;891;63;45;5;40;.889;3565000;0
1585;160932;891;0;0;0;0;.00nan;0;0
1629;164715;897;0;0;0;0;.00nan;0;0
1629;146386;897;53;22;3;19;.864;4250000;0
1629;157295;880;0;0;0;0;.00nan;0;0
1629;161255;880;100;51;2;49;.961;4250000;0
1630;7037;885;0;0;0;0;.00nan;0;0
1630;169868;957;0;0;0;0;.00nan;0;0
1630;28701;885;63;35;4;31;.886;3559000;0
1630;78596;957;59;26;3;23;.885;3600000;0
1771;164715;897;0;0;0;0;.00nan;0;0
1771;146386;897;53;33;4;29;.879;4758000;0
1771;157295;880;0;0;0;0;.00nan;0;0
1771;161255;880;56;35;5;30;.857;4758000;0
1801;8519;879;0;0;0;0;.00nan;0;0
1801;14266;879;57;24;3;21;.875;3600000;0
1801;169868;957;0;0;0;0;.00nan;0;0
1801;78596;957;65;35;4;31;.886;3572000;0
1802;164715;897;0;0;0;0;.00nan;0;0
1802;71075;874;0;0;0;0;.00nan;0;0
1802;146300;874;71;31;3;28;.903;3902000;0
1802;146386;897;89;36;2;34;.944;3902000;0
1803;8519;879;0;0;0;0;.00nan;0;0
1803;14266;879;59;35;4;31;.886;3550000;0
1803;169868;957;0;0;0;0;.00nan;0;0
1803;78596;957;72;26;2;24;.923;3600000;0
1804;164715;897;0;0;0;0;.00nan;0;0
1804;71075;874;0;0;0;0;.00nan;0;0
1804;146300;874;61;24;3;21;.875;3600000;0
1804;146386;897;90;34;2;32;.941;3600000;0
1805;8519;879;0;0;0;0;.00nan;0;0
1805;14266;879;61;27;3;24;.889;3904000;0
1805;169868;957;0;0;0;0;.00nan;0;0
1805;78596;957;68;36;4;32;.889;3904000;0
1806;164715;897;0;0;0;0;.00nan;0;0
1806;71075;874;0;0;0;0;.00nan;0;0
1806;146300;874;45;16;3;13;.813;3519000;0
1806;146386;897;95;33;1;32;.970;3600000;0
1807;8519;879;0;0;0;0;.00nan;0;0
1807;14266;879;68;49;4;45;.918;6070000;0
1807;169868;957;0;0;0;0;.00nan;0;0
1807;78596;957;73;43;3;40;.930;6070000;0
1808;164715;897;0;0;0;0;.00nan;0;0
1808;71075;874;0;0;0;0;.00nan;0;0
1808;146300;874;100;20;0;20;1.000;3600000;0
1808;146386;897;77;36;2;34;.944;3557000;0
1947;8519;879;0;0;0;0;.00nan;0;0
1947;14266;879;67;18;1;17;.944;3600000;0
1947;169868;957;0;0;0;0;.00nan;0;0
1947;78596;957;40;33;6;27;.818;3600000;0
1948;164715;897;0;0;0;0;.00nan;0;0
1948;71075;874;0;0;0;0;.00nan;0;0
1948;146300;874;77;35;3;32;.914;3600000;0
1948;146386;897;64;30;4;26;.867;3597000;0
1990;8519;879;0;0;0;0;.00nan;0;0
1990;14266;879;62;33;4;29;.879;3785000;0
1990;169868;957;0;0;0;0;.00nan;0;0
1990;78596;957;67;28;3;25;.893;3785000;0
1991;164715;897;0;0;0;0;.00nan;0;0
1991;71075;874;0;0;0;0;.00nan;0;0
1991;146300;874;85;33;1;32;.970;3600000;0
1991;146386;897;37;18;3;15;.833;3549000;0
2035;8519;879;0;0;0;0;.00nan;0;0
2035;14266;879;90;36;2;34;.944;3661000;0
2035;169868;957;0;0;0;0;.00nan;0;0
2035;78596;957;52;22;3;19;.864;3661000;0
2036;164715;897;0;0;0;0;.00nan;0;0
2036;71075;874;0;0;0;0;.00nan;0;0
2036;146300;874;59;27;3;24;.889;3756000;0
2036;146386;897;86;35;2;33;.943;3756000;0
2134;8519;879;0;0;0;0;.00nan;0;0
2134;164715;897;0;0;0;0;.00nan;0;0
2134;14266;879;80;25;1;24;.960;3600000;0
2134;146386;897;64;33;3;30;.909;3584000;0
2135;8519;879;0;0;0;0;.00nan;0;0
2135;164715;897;0;0;0;0;.00nan;0;0
2135;14266;879;89;24;1;23;.958;3600000;0
2135;146386;897;69;28;2;26;.929;3545000;0
2136;8519;879;0;0;0;0;.00nan;0;0
2136;164715;897;0;0;0;0;.00nan;0;0
2136;14266;879;79;31;3;28;.903;3600000;0
2136;146386;897;86;17;0;17;1.000;3600000;0
2137;8519;879;0;0;0;0;.00nan;0;0
2137;164715;897;0;0;0;0;.00nan;0;0
2137;14266;879;72;21;1;20;.952;3600000;0
2137;146386;897;78;33;2;31;.939;3564000;0
2294;8519;879;0;0;0;0;.00nan;0;0
2294;164715;897;0;0;0;0;.00nan;0;0
2294;14266;879;72;32;3;29;.906;3545000;0
2294;146386;897;70;24;2;22;.917;3600000;0
2360;8519;879;0;0;0;0;.00nan;0;0
2360;164715;897;0;0;0;0;.00nan;0;0
2360;14266;879;62;31;4;27;.871;3600000;0
2360;146386;897;90;20;0;20;1.000;3600000;0
2399;8519;879;0;0;0;0;.00nan;0;0
2399;164715;897;0;0;0;0;.00nan;0;0
2399;14266;879;55;29;4;25;.862;3538000;0
2399;146386;897;76;32;2;30;.938;3600000;0
15718;178116;759;0;0;0;0;.00nan;0;0
15718;189581;758;0;0;0;0;.00nan;0;0
15718;176686;758;82;41;3;38;.927;3600000;0
15718;94134;759;54;17;2;15;.882;3600000;0
15719;189264;4923;0;0;0;0;.00nan;0;0
15719;179406;4923;72;29;2;27;.931;3733000;0
15719;-1;2199;0;0;0;0;.00nan;0;0
15719;148691;2199;80;29;1;28;.966;3733000;0
15720;359;760;0;0;0;0;.00nan;0;0
15720;1756;4989;0;0;0;0;.00nan;0;0
15720;-1;760;77;28;1;27;.964;3600000;0
15720;190570;4989;73;29;2;27;.931;3600000;0
15721;193576;774;0;0;0;0;.00nan;0;0
15721;180188;4924;100;43;1;42;.977;3600000;0
15721;91194;4924;0;0;0;0;.00nan;0;0
15721;149191;774;38;23;4;19;.826;3600000;0
15722;166226;1093;0;0;0;0;.00nan;0;0
15722;174894;2545;92;18;0;18;1.000;3600000;0
15722;63932;1093;93;37;1;36;.973;3566000;0
15722;94107;2545;0;0;0;0;.00nan;0;0
15723;193545;911;0;0;0;0;.00nan;0;0
15723;186234;911;90;20;0;20;1.000;3600000;0
15723;87758;3913;0;0;0;0;.00nan;0;0
15723;142810;3913;83;27;1;26;.963;3600000;0
15724;177356;762;0;0;0;0;.00nan;0;0
15724;188815;762;68;25;3;22;.880;3900000;0
15724;181910;1492;0;0;0;0;.00nan;0;0
15724;86343;1492;97;56;3;53;.946;3900000;0
15725;169618;766;0;0;0;0;.00nan;0;0
15725;185559;766;66;43;5;38;.884;3600000;0
15725;81691;775;56;23;3;20;.870;3600000;0
15725;146249;775;0;0;0;0;.00nan;0;0
15726;199033;750;0;0;0;0;.00nan;0;0
15726;164521;3721;0;0;0;0;.00nan;0;0
15726;212428;750;62;14;1;13;.929;3600000;0
15726;201933;3721;59;28;3;25;.893;3530000;0
15727;178116;759;0;0;0;0;.00nan;0;0
15727;174898;1503;98;46;3;43;.935;3549000;0
15727;196698;1503;0;0;0;0;.00nan;0;0
15727;94134;759;65;17;1;16;.941;3600000;0
15728;174858;3730;0;0;0;0;.00nan;0;0
15728;207194;754;86;18;0;18;1.000;3600000;0
15728;149112;3730;66;39;4;35;.897;3600000;0
15728;149119;754;0;0;0;0;.00nan;0;0
15729;189581;758;0;0;0;0;.00nan;0;0
15729;170530;755;0;0;0;0;.00nan;0;0
15729;176686;758;54;31;4;27;.871;3600000;0
15729;180154;755;54;37;5;32;.865;3575000;0
15730;167629;746;70;17;1;16;.941;3600000;0
15730;164454;746;0;0;0;0;.00nan;0;0
15730;175757;1497;73;32;3;29;.906;3585000;0
15730;216807;1497;0;0;0;0;.00nan;0;0
15731;166226;1093;54;3;0;3;1.000;540000;0
15731;-1;2199;0;0;0;0;.00nan;0;0
15731;63932;1093;43;29;5;24;.828;3060000;0
15731;148691;2199;60;19;2;17;.895;3600000;0
15732;166023;767;0;0;0;0;.00nan;0;0
15732;169618;766;84;46;3;43;.935;3600000;0
15732;185559;766;0;0;0;0;.00nan;0;0
15732;202839;767;48;20;4;16;.800;3545000;0
15733;189264;4923;0;0;0;0;.00nan;0;0
15733;174894;2545;96;37;1;36;.973;3600000;0
15733;179406;4923;59;29;3;26;.897;3594000;0
15733;94107;2545;0;0;0;0;.00nan;0;0
15734;193545;911;0;0;0;0;.00nan;0;0
15734;181910;1492;0;0;0;0;.00nan;0;0
15734;186234;911;69;37;3;34;.919;3546000;0
15734;86343;1492;73;24;2;22;.917;3600000;0
15735;177356;762;0;0;0;0;.00nan;0;0
15735;188815;762;83;31;2;29;.935;3900000;0
15735;87758;3913;0;0;0;0;.00nan;0;0
15735;142810;3913;76;28;2;26;.929;3900000;0
15736;175761;769;99;37;1;36;.973;3600000;0
15736;-1;769;0;0;0;0;.00nan;0;0
15736;81691;775;0;0;0;0;.00nan;0;0
15736;146249;775;55;22;3;19;.864;3520000;0
15737;175757;1497;70;22;1;21;.955;3600000;0
15737;216807;1497;0;0;0;0;.00nan;0;0
15737;222019;768;100;30;0;30;1.000;3600000;0
15737;-1;768;0;0;0;0;.00nan;0;0
15738;178116;759;0;0;0;0;.00nan;0;0
15738;190589;2197;85;43;3;40;.930;3544000;0
15738;82817;2197;0;0;0;0;.00nan;0;0
15738;94134;759;64;12;1;11;.917;3600000;0
15739;207194;754;83;30;1;29;.967;3600000;0
15739;-1;772;0;0;0;0;.00nan;0;0
15739;145463;772;82;37;2;35;.946;3600000;0
15739;149119;754;0;0;0;0;.00nan;0;0
15740;170530;755;96;49;2;47;.959;3572000;0
15740;174898;1503;74;19;1;18;.947;3600000;0
15740;180154;755;0;0;0;0;.00nan;0;0
15740;196698;1503;0;0;0;0;.00nan;0;0
15741;167629;746;59;30;4;26;.867;3560000;0
15741;164454;746;0;0;0;0;.00nan;0;0
15741;189581;758;91;36;2;34;.944;3600000;0
15741;176686;758;0;0;0;0;.00nan;0;0
15742;166023;767;0;0;0;0;.00nan;0;0
15742;175761;769;0;0;0;0;.00nan;0;0
15742;202839;767;93;27;1;26;.963;3600000;0
15742;-1;769;47;39;5;34;.872;3600000;0
15743;169618;766;72;21;1;20;.952;3600000;0
15743;180188;4924;41;36;6;30;.833;3600000;0
15743;185559;766;0;0;0;0;.00nan;0;0
15743;91194;4924;0;0;0;0;.00nan;0;0
15744;359;760;0;0;0;0;.00nan;0;0
15744;193545;911;0;0;0;0;.00nan;0;0
15744;-1;760;96;21;0;21;1.000;3600000;0
15744;186234;911;61;21;2;19;.905;3580000;0
15745;1756;4989;86;26;0;26;1.000;3600000;0
15745;177356;762;0;0;0;0;.00nan;0;0
15745;188815;762;61;17;1;16;.941;3545000;0
15745;190570;4989;0;0;0;0;.00nan;0;0
15746;164521;3721;0;0;0;0;.00nan;0;0
15746;201933;3721;83;46;3;43;.935;3707000;0
15746;81691;775;0;0;0;0;.00nan;0;0
15746;146249;775;70;21;2;19;.905;3707000;0
15747;189581;758;0;0;0;0;.00nan;0;0
15747;176686;758;52;45;6;39;.867;3600000;0
15747;222019;768;59;12;1;11;.917;3600000;0
15747;-1;768;0;0;0;0;.00nan;0;0
15748;174858;3730;0;0;0;0;.00nan;0;0
15748;-1;772;0;0;0;0;.00nan;0;0
15748;145463;772;77;20;1;19;.950;3600000;0
15748;149112;3730;65;37;4;33;.892;3600000;0
15749;178116;759;0;0;0;0;.00nan;0;0
15749;175757;1497;97;41;2;39;.951;3539000;0
15749;216807;1497;0;0;0;0;.00nan;0;0
15749;94134;759;90;18;0;18;1.000;3600000;0
15750;170530;755;30;21;5;16;.762;3600000;0
15750;180154;755;0;0;0;0;.00nan;0;0
15750;190589;2197;78;32;2;30;.938;3600000;0
15750;82817;2197;0;0;0;0;.00nan;0;0
15751;167629;746;0;0;0;0;.00nan;0;0
15751;164454;746;72;23;1;22;.957;3600000;0
15751;174898;1503;66;32;3;29;.906;3575000;0
15751;196698;1503;0;0;0;0;.00nan;0;0
15752;166226;1093;0;0;0;0;.00nan;0;0
15752;63932;1093;63;29;3;26;.897;3543000;0
15752;87758;3913;0;0;0;0;.00nan;0;0
15752;142810;3913;58;20;2;18;.900;3600000;0
15753;164521;3721;0;0;0;0;.00nan;0;0
15753;166023;767;60;24;2;22;.917;3565000;0
15753;201933;3721;83;28;1;27;.964;3600000;0
15753;202839;767;0;0;0;0;.00nan;0;0
15754;175761;769;0;0;0;0;.00nan;0;0
15754;180188;4924;0;0;0;0;.00nan;0;0
15754;-1;769;82;36;2;34;.944;3514000;0
15754;91194;4924;93;22;0;22;1.000;3600000;0
15755;174894;2545;61;27;3;24;.889;3577000;0
15755;-1;2199;0;0;0;0;.00nan;0;0
15755;94107;2545;0;0;0;0;.00nan;0;0
15755;148691;2199;66;23;2;21;.913;3600000;0
15756;1756;4989;60;19;2;17;.895;3571000;0
15756;193545;911;76;24;1;23;.958;3600000;0
15756;190570;4989;0;0;0;0;.00nan;0;0
15756;186234;911;0;0;0;0;.00nan;0;0
15757;359;760;0;0;0;0;.00nan;0;0
15757;177356;762;0;0;0;0;.00nan;0;0
15757;188815;762;60;23;2;21;.913;3533000;0
15757;-1;760;78;17;0;17;1.000;3600000;0
15758;193576;774;0;0;0;0;.00nan;0;0
15758;169618;766;91;32;1;31;.969;3900000;0
15758;185559;766;0;0;0;0;.00nan;0;0
15758;149191;774;90;29;1;28;.966;3900000;0
15759;199033;750;0;0;0;0;.00nan;0;0
15759;212428;750;72;40;4;36;.900;3600000;0
15759;81691;775;0;0;0;0;.00nan;0;0
15759;146249;775;52;16;3;13;.813;3600000;0
15760;174898;1503;90;37;2;35;.946;3900000;0
15760;222019;768;0;0;0;0;.00nan;0;0
15760;196698;1503;0;0;0;0;.00nan;0;0
15760;-1;768;50;17;2;15;.882;3900000;0
15761;170530;755;84;26;1;25;.962;3600000;0
15761;175757;1497;0;0;0;0;.00nan;0;0
15761;216807;1497;31;44;8;36;.818;3600000;0
15761;180154;755;0;0;0;0;.00nan;0;0
15762;167629;746;84;16;0;16;1.000;3600000;0
15762;164454;746;0;0;0;0;.00nan;0;0
15762;190589;2197;67;48;5;43;.896;3600000;0
15762;82817;2197;0;0;0;0;.00nan;0;0
15763;189264;4923;0;0;0;0;.00nan;0;0
15763;179406;4923;100;28;0;28;1.000;3600000;0
15763;87758;3913;0;0;0;0;.00nan;0;0
15763;142810;3913;59;20;2;18;.900;3582000;0
15764;199033;750;0;0;0;0;.00nan;0;0
15764;166023;767;0;0;0;0;.00nan;0;0
15764;212428;750;40;36;6;30;.833;3600000;0
15764;202839;767;75;20;1;19;.950;3600000;0
15765;166226;1093;0;0;0;0;.00nan;0;0
15765;181910;1492;49;7;1;6;.857;848000;0
15765;63932;1093;87;25;1;24;.960;3600000;0
15765;86343;1492;17;24;6;18;.750;2752000;0
15766;164521;3721;0;0;0;0;.00nan;0;0
15766;180188;4924;53;15;2;13;.867;3600000;0
15766;201933;3721;44;38;5;33;.868;3600000;0
15766;91194;4924;0;0;0;0;.00nan;0;0
15767;193576;774;0;0;0;0;.00nan;0;0
15767;175761;769;0;0;0;0;.00nan;0;0
15767;-1;769;94;37;2;35;.946;3600000;0
15767;149191;774;53;28;4;24;.857;3538000;0
15768;222019;768;84;15;0;15;1.000;3600000;0
15768;190589;2197;68;41;5;36;.878;3600000;0
15768;-1;768;0;0;0;0;.00nan;0;0
15768;82817;2197;0;0;0;0;.00nan;0;0
15769;178116;759;0;0;0;0;.00nan;0;0
15769;207194;754;76;47;5;42;.894;3731000;0
15769;94134;759;46;26;4;22;.846;3731000;0
15769;149119;754;0;0;0;0;.00nan;0;0
15770;174894;2545;95;40;2;38;.950;3900000;0
15770;87758;3913;0;0;0;0;.00nan;0;0
15770;94107;2545;0;0;0;0;.00nan;0;0
15770;142810;3913;66;23;2;21;.913;3900000;0
15771;1756;4989;98;19;0;19;1.000;3600000;0
15771;166226;1093;0;0;0;0;.00nan;0;0
15771;190570;4989;0;0;0;0;.00nan;0;0
15771;63932;1093;87;42;4;38;.905;3600000;0
15772;189264;4923;0;0;0;0;.00nan;0;0
15772;179406;4923;44;11;2;9;.818;3555000;0
15772;181910;1492;100;43;1;42;.977;3600000;0
15772;86343;1492;0;0;0;0;.00nan;0;0
15773;359;760;0;0;0;0;.00nan;0;0
15773;-1;760;30;22;5;17;.773;3566000;0
15773;-1;2199;0;0;0;0;.00nan;0;0
15773;148691;2199;51;25;4;21;.840;3600000;0
15774;199033;750;0;0;0;0;.00nan;0;0
15774;180188;4924;0;0;0;0;.00nan;0;0
15774;212428;750;99;40;1;39;.975;3600000;0
15774;91194;4924;74;32;2;30;.938;3600000;0
15775;189581;758;93;32;1;31;.969;3600000;0
15775;176686;758;0;0;0;0;.00nan;0;0
15775;81691;775;0;0;0;0;.00nan;0;0
15775;146249;775;56;25;3;22;.880;3548000;0
15776;193576;774;0;0;0;0;.00nan;0;0
15776;164521;3721;47;33;5;28;.848;3600000;0
15776;201933;3721;0;0;0;0;.00nan;0;0
15776;149191;774;85;19;0;19;1.000;3600000;0
15777;177356;762;0;0;0;0;.00nan;0;0
15777;188815;762;100;29;0;29;1.000;3900000;0
15777;169618;766;85;27;0;27;1.000;3900000;0
15777;185559;766;0;0;0;0;.00nan;0;0
15778;178116;759;0;0;0;0;.00nan;0;0
15778;174858;3730;83;48;4;44;.917;3564000;0
15778;94134;759;51;14;2;12;.857;3600000;0
15778;149112;3730;0;0;0;0;.00nan;0;0
15779;170530;755;69;22;2;20;.909;3600000;0
15779;180154;755;0;0;0;0;.00nan;0;0
15779;207194;754;60;31;3;28;.903;3574000;0
15779;149119;754;0;0;0;0;.00nan;0;0
15780;-1;2199;0;0;0;0;.00nan;0;0
15780;87758;3913;0;0;0;0;.00nan;0;0
15780;142810;3913;97;41;0;41;1.000;3900000;0
15780;148691;2199;99;19;0;19;1.000;3900000;0
15781;1756;4989;62;42;5;37;.881;3600000;0
15781;189264;4923;0;0;0;0;.00nan;0;0
15781;179406;4923;97;35;2;33;.943;3600000;0
15781;190570;4989;0;0;0;0;.00nan;0;0
15782;174894;2545;84;36;2;34;.944;3600000;0
15782;181910;1492;0;0;0;0;.00nan;0;0
15782;86343;1492;43;27;4;23;.852;3549000;0
15782;94107;2545;0;0;0;0;.00nan;0;0
15783;359;760;0;0;0;0;.00nan;0;0
15783;166226;1093;0;0;0;0;.00nan;0;0
15783;-1;760;41;25;4;21;.840;3563000;0
15783;63932;1093;63;26;2;24;.923;3600000;0
15784;166023;767;0;0;0;0;.00nan;0;0
15784;189581;758;0;0;0;0;.00nan;0;0
15784;176686;758;45;24;4;20;.833;3600000;0
15784;202839;767;61;24;2;22;.917;3600000;0
15785;177356;762;0;0;0;0;.00nan;0;0
15785;188815;762;83;40;3;37;.925;3900000;0
15785;175761;769;0;0;0;0;.00nan;0;0
15785;-1;769;82;38;3;35;.921;3900000;0
15786;199033;750;0;0;0;0;.00nan;0;0
15786;193576;774;0;0;0;0;.00nan;0;0
15786;212428;750;81;34;2;32;.941;3584000;0
15786;149191;774;96;23;0;23;1.000;3600000;0
15787;193545;911;0;0;0;0;.00nan;0;0
15787;169618;766;67;40;4;36;.900;3600000;0
15787;185559;766;0;0;0;0;.00nan;0;0
15787;186234;911;61;22;2;20;.909;3600000;0
15788;174898;1503;100;24;0;24;1.000;3600000;0
15788;196698;1503;0;0;0;0;.00nan;0;0
15788;146249;775;0;0;0;0;.00nan;0;0
15788;149280;775;37;17;3;14;.824;3600000;0
15789;170530;755;62;29;3;26;.897;3543000;0
15789;174858;3730;0;0;0;0;.00nan;0;0
15789;180154;755;0;0;0;0;.00nan;0;0
15789;149112;3730;82;30;2;28;.933;3600000;0
15790;178116;759;0;0;0;0;.00nan;0;0
15790;-1;772;66;10;0;10;1.000;729000;0
15790;94134;759;62;19;2;17;.895;3600000;0
15790;145463;772;35;36;6;30;.833;2871000;0
15791;167629;746;78;29;2;27;.931;3600000;0
15791;164454;746;0;0;0;0;.00nan;0;0
15791;207194;754;50;39;5;34;.872;3600000;0
15791;149119;754;0;0;0;0;.00nan;0;0
15792;1756;4989;0;0;0;0;.00nan;0;0
15792;174894;2545;80;23;1;22;.957;3600000;0
15792;190570;4989;58;36;4;32;.889;3600000;0
15792;94107;2545;0;0;0;0;.00nan;0;0
15793;177356;762;0;0;0;0;.00nan;0;0
15793;164521;3721;0;0;0;0;.00nan;0;0
15793;188815;762;60;16;2;14;.875;3600000;0
15793;201933;3721;86;44;3;41;.932;3574000;0
15794;181910;1492;0;0;0;0;.00nan;0;0
15794;-1;2199;0;0;0;0;.00nan;0;0
15794;86343;1492;92;50;1;49;.980;3666000;0
15794;148691;2199;81;16;0;16;1.000;3666000;0
15795;359;760;0;0;0;0;.00nan;0;0
15795;189264;4923;0;0;0;0;.00nan;0;0
15795;-1;760;80;32;3;29;.906;3545000;0
15795;179406;4923;83;26;1;25;.962;3600000;0
15796;189581;758;80;40;3;37;.925;3600000;0
15796;176686;758;0;0;0;0;.00nan;0;0
15796;180188;4924;97;34;1;33;.971;3600000;0
15796;91194;4924;0;0;0;0;.00nan;0;0
15797;193545;911;0;0;0;0;.00nan;0;0
15797;175761;769;83;17;0;17;1.000;3600000;0
15797;186234;911;53;41;5;36;.878;3600000;0
15797;-1;769;0;0;0;0;.00nan;0;0
15798;166023;767;0;0;0;0;.00nan;0;0
15798;174898;1503;62;28;4;24;.857;3543000;0
15798;196698;1503;0;0;0;0;.00nan;0;0
15798;202839;767;72;32;3;29;.906;3600000;0
15799;175757;1497;57;32;4;28;.875;3563000;0
15799;216807;1497;0;0;0;0;.00nan;0;0
15799;146249;775;0;0;0;0;.00nan;0;0
15799;149280;775;59;22;3;19;.864;3600000;0
15800;167629;746;0;0;0;0;.00nan;0;0
15800;164454;746;77;22;1;21;.955;3600000;0
15800;174858;3730;57;23;3;20;.870;3600000;0
15800;149112;3730;0;0;0;0;.00nan;0;0
15801;170530;755;0;0;0;0;.00nan;0;0
15801;180154;755;72;32;2;30;.938;3900000;0
15801;-1;772;71;32;2;30;.938;3900000;0
15801;145463;772;0;0;0;0;.00nan;0;0
15802;222019;768;77;10;0;10;1.000;3600000;0
15802;207194;754;0;0;0;0;.00nan;0;0
15802;-1;768;0;0;0;0;.00nan;0;0
15802;149119;754;65;56;6;50;.893;3600000;0
15803;190589;2197;0;0;0;0;.00nan;0;0
15803;82817;2197;38;28;5;23;.821;3600000;0
15803;146249;775;0;0;0;0;.00nan;0;0
15803;149280;775;83;33;2;31;.939;3600000;0
15804;1756;4989;0;0;0;0;.00nan;0;0
15804;190570;4989;100;36;1;35;.972;3900000;0
15804;-1;2199;0;0;0;0;.00nan;0;0
15804;148691;2199;62;16;1;15;.938;3900000;0
15805;193545;911;0;0;0;0;.00nan;0;0
15805;164521;3721;0;0;0;0;.00nan;0;0
15805;201933;3721;82;33;3;30;.909;3600000;0
15805;186234;911;44;27;4;23;.852;3600000;0
15806;359;760;100;39;1;38;.974;3600000;0
15806;-1;760;0;0;0;0;.00nan;0;0
15806;174894;2545;0;0;0;0;.00nan;0;0
15806;94107;2545;52;28;4;24;.857;3600000;0
15807;193576;774;44;20;3;17;.850;2448000;0
15807;189581;758;0;0;0;0;.00nan;0;0
15807;176686;758;63;20;2;18;.900;3600000;0
15807;149191;774;28;14;4;10;.714;1152000;0
15808;174898;1503;99;20;0;20;1.000;3600000;0
15808;180188;4924;65;17;1;16;.941;1889000;0
15808;196698;1503;0;0;0;0;.00nan;0;0
15808;91194;4924;37;24;5;19;.792;1711000;0
15809;166226;1093;0;0;0;0;.00nan;0;0
15809;169618;766;79;29;1;28;.966;3900000;0
15809;185559;766;0;0;0;0;.00nan;0;0
15809;63932;1093;79;15;1;14;.933;3900000;0
15810;177356;762;60;6;0;6;1.000;241000;0
15810;199033;750;0;0;0;0;.00nan;0;0
15810;188815;762;35;26;6;20;.769;3359000;0
15810;212428;750;90;41;2;39;.951;3600000;0
15811;166023;767;0;0;0;0;.00nan;0;0
15811;175757;1497;0;0;0;0;.00nan;0;0
15811;216807;1497;59;31;3;28;.903;3515000;0
15811;202839;767;86;26;1;25;.962;3600000;0
15812;174858;3730;0;0;0;0;.00nan;0;0
15812;222019;768;78;19;1;18;.947;3600000;0
15812;-1;768;0;0;0;0;.00nan;0;0
15812;149112;3730;81;34;2;32;.941;3600000;0
15813;167629;746;76;18;1;17;.944;3600000;0
15813;164454;746;0;0;0;0;.00nan;0;0
15813;-1;772;0;0;0;0;.00nan;0;0
15813;145463;772;71;43;4;39;.907;3600000;0
15814;166023;767;0;0;0;0;.00nan;0;0
15814;190589;2197;93;28;1;27;.964;3600000;0
15814;202839;767;38;23;4;19;.826;3600000;0
15814;82817;2197;0;0;0;0;.00nan;0;0
15815;181910;1492;0;0;0;0;.00nan;0;0
15815;86343;1492;92;37;2;35;.946;3827000;0
15815;87758;3913;0;0;0;0;.00nan;0;0
15815;142810;3913;89;33;1;32;.970;3827000;0
15816;189264;4923;0;0;0;0;.00nan;0;0
15816;169618;766;0;0;0;0;.00nan;0;0
15816;179406;4923;99;23;0;23;1.000;3600000;0
15816;185559;766;76;51;5;46;.902;3600000;0
15817;193576;774;0;0;0;0;.00nan;0;0
15817;174898;1503;45;22;4;18;.818;3600000;0
15817;196698;1503;0;0;0;0;.00nan;0;0
15817;149191;774;67;27;3;24;.889;3600000;0
15818;166226;1093;69;28;2;26;.929;3600000;0
15818;175761;769;61;35;3;32;.914;3558000;0
15818;-1;769;0;0;0;0;.00nan;0;0
15818;63932;1093;0;0;0;0;.00nan;0;0
15819;199033;750;0;0;0;0;.00nan;0;0
15819;193545;911;0;0;0;0;.00nan;0;0
15819;212428;750;84;25;1;24;.960;3600000;0
15819;186234;911;73;41;4;37;.902;3600000;0
15820;175757;1497;100;36;1;35;.972;3900000;0
15820;216807;1497;0;0;0;0;.00nan;0;0
15820;180188;4924;77;25;1;24;.960;3900000;0
15820;91194;4924;0;0;0;0;.00nan;0;0
15821;222019;768;0;0;0;0;.00nan;0;0
15821;-1;768;39;11;3;8;.727;3600000;0
15821;-1;772;29;31;6;25;.806;2742000;0
15821;145463;772;49;6;1;5;.833;858000;0
15822;180188;4924;0;0;0;0;.00nan;0;0
15822;190589;2197;88;29;1;28;.966;3600000;0
15822;82817;2197;0;0;0;0;.00nan;0;0
15822;91194;4924;58;18;2;16;.889;3600000;0
15823;1756;4989;50;31;5;26;.839;3600000;0
15823;190570;4989;0;0;0;0;.00nan;0;0
15823;181910;1492;0;0;0;0;.00nan;0;0
15823;86343;1492;73;31;2;29;.935;3600000;0
15824;169618;766;0;0;0;0;.00nan;0;0
15824;185559;766;85;36;3;33;.917;3600000;0
15824;-1;2199;0;0;0;0;.00nan;0;0
15824;148691;2199;30;22;5;17;.773;3513000;0
15825;359;760;0;0;0;0;.00nan;0;0
15825;-1;760;59;20;2;18;.900;3561000;0
15825;87758;3913;0;0;0;0;.00nan;0;0
15825;142810;3913;80;26;1;25;.962;3600000;0
15826;177356;762;71;30;2;28;.933;3600000;0
15826;188815;762;0;0;0;0;.00nan;0;0
15826;189581;758;0;0;0;0;.00nan;0;0
15826;176686;758;71;50;5;45;.900;3600000;0
15827;189264;4923;0;0;0;0;.00nan;0;0
15827;179406;4923;100;50;3;47;.940;3900000;0
15827;175761;769;0;0;0;0;.00nan;0;0
15827;-1;769;56;27;3;24;.889;3900000;0
15828;207194;754;94;27;1;26;.963;3545000;0
15828;146249;775;0;0;0;0;.00nan;0;0
15828;149119;754;0;0;0;0;.00nan;0;0
15828;149280;775;97;24;0;24;1.000;3600000;0
15829;164521;3721;0;0;0;0;.00nan;0;0
15829;166226;1093;0;0;0;0;.00nan;0;0
15829;201933;3721;60;26;3;23;.885;3563000;0
15829;63932;1093;73;30;2;28;.933;3600000;0
15830;193576;774;0;0;0;0;.00nan;0;0
15830;175757;1497;0;0;0;0;.00nan;0;0
15830;216807;1497;53;26;3;23;.885;3540000;0
15830;149191;774;69;23;1;22;.957;3600000;0
15831;178116;759;86;13;0;13;1.000;3600000;0
15831;170530;755;83;55;5;50;.909;3600000;0
15831;180154;755;0;0;0;0;.00nan;0;0
15831;94134;759;0;0;0;0;.00nan;0;0
15832;193576;774;0;0;0;0;.00nan;0;0
15832;190589;2197;53;35;5;30;.857;3600000;0
15832;82817;2197;0;0;0;0;.00nan;0;0
15832;149191;774;62;19;2;17;.895;3600000;0
15833;1756;4989;0;0;0;0;.00nan;0;0
15833;190570;4989;64;30;3;27;.900;3549000;0
15833;87758;3913;0;0;0;0;.00nan;0;0
15833;142810;3913;79;38;2;36;.947;3600000;0
15834;175761;769;64;47;6;41;.872;3600000;0
15834;-1;2199;0;0;0;0;.00nan;0;0
15834;-1;769;0;0;0;0;.00nan;0;0
15834;148691;2199;64;22;2;20;.909;3600000;0
15835;166023;767;76;30;2;28;.933;3600000;0
15835;207194;754;75;34;3;31;.912;3550000;0
15835;202839;767;0;0;0;0;.00nan;0;0
15835;149119;754;0;0;0;0;.00nan;0;0
15836;359;760;62;24;3;21;.875;3900000;0
15836;-1;760;0;0;0;0;.00nan;0;0
15836;181910;1492;0;0;0;0;.00nan;0;0
15836;86343;1492;98;46;3;43;.935;3900000;0
15837;169618;766;57;41;6;35;.854;3600000;0
15837;174894;2545;54;16;2;14;.875;3600000;0
15837;185559;766;0;0;0;0;.00nan;0;0
15837;94107;2545;0;0;0;0;.00nan;0;0
15838;193545;911;0;0;0;0;.00nan;0;0
15838;189581;758;61;38;4;34;.895;3600000;0
15838;176686;758;0;0;0;0;.00nan;0;0
15838;186234;911;49;22;3;19;.864;3600000;0
15839;177356;762;0;0;0;0;.00nan;0;0
15839;188815;762;41;20;4;16;.800;3600000;0
15839;174898;1503;99;30;0;30;1.000;3600000;0
15839;196698;1503;0;0;0;0;.00nan;0;0
15840;164521;3721;0;0;0;0;.00nan;0;0
15840;189264;4923;0;0;0;0;.00nan;0;0
15840;179406;4923;66;29;3;26;.897;3600000;0
15840;201933;3721;58;37;4;33;.892;3592000;0
15841;174858;3730;50;36;5;31;.861;3600000;0
15841;146249;775;0;0;0;0;.00nan;0;0
15841;149112;3730;0;0;0;0;.00nan;0;0
15841;149280;775;95;20;0;20;1.000;3600000;0
15842;199033;750;0;0;0;0;.00nan;0;0
15842;166226;1093;0;0;0;0;.00nan;0;0
15842;212428;750;71;32;2;30;.938;3600000;0
15842;63932;1093;67;35;3;32;.914;3545000;0
15843;167629;746;56;45;6;39;.867;3600000;0
15843;164454;746;0;0;0;0;.00nan;0;0
15843;178116;759;84;32;3;29;.906;3600000;0
15843;94134;759;0;0;0;0;.00nan;0;0
15844;164521;3721;55;37;5;32;.865;3600000;0
15844;201933;3721;0;0;0;0;.00nan;0;0
15844;-1;2199;94;18;0;18;1.000;3600000;0
15844;148691;2199;0;0;0;0;.00nan;0;0
15845;166023;767;0;0;0;0;.00nan;0;0
15845;174858;3730;0;0;0;0;.00nan;0;0
15845;202839;767;38;14;3;11;.786;3552000;0
15845;149112;3730;89;35;2;33;.943;3600000;0
15846;180188;4924;96;36;2;34;.944;3900000;0
15846;207194;754;90;37;2;35;.946;3900000;0
15846;91194;4924;0;0;0;0;.00nan;0;0
15846;149119;754;0;0;0;0;.00nan;0;0
15847;174894;2545;99;37;1;36;.973;3600000;0
15847;175761;769;0;0;0;0;.00nan;0;0
15847;-1;769;59;28;3;25;.893;3556000;0
15847;94107;2545;0;0;0;0;.00nan;0;0
15848;193545;911;0;0;0;0;.00nan;0;0
15848;174898;1503;93;19;0;19;1.000;3600000;0
15848;196698;1503;0;0;0;0;.00nan;0;0
15848;186234;911;66;24;2;22;.917;3600000;0
15849;177356;762;0;0;0;0;.00nan;0;0
15849;188815;762;74;19;1;18;.947;3600000;0
15849;175757;1497;92;36;2;34;.944;3600000;0
15849;216807;1497;0;0;0;0;.00nan;0;0
15850;199033;750;0;0;0;0;.00nan;0;0
15850;189264;4923;0;0;0;0;.00nan;0;0
15850;179406;4923;89;43;3;40;.930;3900000;0
15850;212428;750;79;26;3;23;.885;3900000;0
15851;-1;772;0;0;0;0;.00nan;0;0
15851;145463;772;72;31;2;29;.935;3576000;0
15851;146249;775;0;0;0;0;.00nan;0;0
15851;149280;775;58;18;1;17;.944;3600000;0
15852;178116;759;0;0;0;0;.00nan;0;0
15852;222019;768;78;31;2;29;.935;3600000;0
15852;-1;768;0;0;0;0;.00nan;0;0
15852;94134;759;79;26;1;25;.962;3600000;0
15853;167629;746;0;0;0;0;.00nan;0;0
15853;164454;746;74;22;1;21;.955;3600000;0
15853;170530;755;73;35;3;32;.914;3600000;0
15853;180154;755;0;0;0;0;.00nan;0;0
15854;199033;750;0;0;0;0;.00nan;0;0
15854;212428;750;98;35;2;33;.943;3600000;0
15854;-1;2199;64;14;1;13;.929;3600000;0
15854;148691;2199;0;0;0;0;.00nan;0;0
15855;166023;767;0;0;0;0;.00nan;0;0
15855;202839;767;98;26;0;26;1.000;3600000;0
15855;-1;772;0;0;0;0;.00nan;0;0
15855;145463;772;86;42;2;40;.952;3548000;0
15856;174858;3730;80;24;1;23;.958;3218000;0
15856;180188;4924;69;21;2;19;.905;3600000;0
15856;91194;4924;0;0;0;0;.00nan;0;0
15856;149112;3730;22;4;3;1;.250;323000;0
15857;164521;3721;0;0;0;0;.00nan;0;0
15857;174894;2545;94;28;1;27;.964;3600000;0
15857;201933;3721;46;33;5;28;.848;3600000;0
15857;94107;2545;0;0;0;0;.00nan;0;0
15858;166226;1093;0;0;0;0;.00nan;0;0
15858;189581;758;0;0;0;0;.00nan;0;0
15858;176686;758;57;17;2;15;.882;3576000;0
15858;63932;1093;82;25;1;24;.960;3600000;0
15859;193545;911;63;23;2;21;.913;3889000;0
15859;175757;1497;57;21;3;18;.857;3889000;0
15859;216807;1497;0;0;0;0;.00nan;0;0
15859;186234;911;0;0;0;0;.00nan;0;0
15860;177356;762;0;0;0;0;.00nan;0;0
15860;188815;762;82;22;1;21;.955;3900000;0
15860;190589;2197;92;38;1;37;.974;3900000;0
15860;82817;2197;0;0;0;0;.00nan;0;0
15861;193576;774;0;0;0;0;.00nan;0;0
15861;207194;754;68;38;4;34;.895;3600000;0
15861;149119;754;0;0;0;0;.00nan;0;0
15861;149191;774;100;34;0;34;1.000;3600000;0
15862;170530;755;90;53;2;51;.962;3555000;0
15862;222019;768;0;0;0;0;.00nan;0;0
15862;180154;755;0;0;0;0;.00nan;0;0
15862;-1;768;70;8;0;8;1.000;3600000;0
15863;180188;4924;76;31;3;28;.903;3600000;0
15863;-1;772;0;0;0;0;.00nan;0;0
15863;91194;4924;0;0;0;0;.00nan;0;0
15863;145463;772;37;21;4;17;.810;3548000;0
15864;199033;750;0;0;0;0;.00nan;0;0
15864;174894;2545;83;40;2;38;.950;3900000;0
15864;212428;750;62;23;2;21;.913;3900000;0
15864;94107;2545;0;0;0;0;.00nan;0;0
15865;189264;4923;0;0;0;0;.00nan;0;0
15865;189581;758;0;0;0;0;.00nan;0;0
15865;179406;4923;94;19;0;19;1.000;3600000;0
15865;176686;758;58;34;4;30;.882;3600000;0
15866;193545;911;0;0;0;0;.00nan;0;0
15866;190589;2197;93;31;1;30;.968;3567000;0
15866;186234;911;94;25;0;25;1.000;3600000;0
15866;82817;2197;0;0;0;0;.00nan;0;0
15867;175761;769;0;0;0;0;.00nan;0;0
15867;181910;1492;0;0;0;0;.00nan;0;0
15867;-1;769;56;22;2;20;.909;3600000;0
15867;86343;1492;67;37;5;32;.865;3600000;0
15868;193576;774;0;0;0;0;.00nan;0;0
15868;174858;3730;0;0;0;0;.00nan;0;0
15868;149112;3730;52;31;4;27;.871;3590000;0
15868;149191;774;54;20;3;17;.850;3600000;0
15869;169618;766;0;0;0;0;.00nan;0;0
15869;185559;766;38;22;4;18;.818;3516000;0
15869;87758;3913;0;0;0;0;.00nan;0;0
15869;142810;3913;67;27;2;25;.926;3600000;0
15870;166226;1093;0;0;0;0;.00nan;0;0
15870;174898;1503;78;44;4;40;.909;3600000;0
15870;196698;1503;0;0;0;0;.00nan;0;0
15870;63932;1093;82;23;1;22;.957;3600000;0
15871;178116;759;0;0;0;0;.00nan;0;0
15871;94134;759;56;16;2;14;.875;3600000;0
15871;146249;775;0;0;0;0;.00nan;0;0
15871;149280;775;61;34;4;30;.882;3550000;0
15872;167629;746;0;0;0;0;.00nan;0;0
15872;164454;746;75;43;5;38;.884;3600000;0
15872;222019;768;0;0;0;0;.00nan;0;0
15872;-1;768;64;23;2;21;.913;3600000;0
15873;164521;3721;0;0;0;0;.00nan;0;0
15873;201933;3721;70;29;2;27;.931;3600000;0
15873;181910;1492;0;0;0;0;.00nan;0;0
15873;86343;1492;82;45;4;41;.911;3555000;0
15874;189581;758;63;30;3;27;.900;3728000;0
15874;176686;758;0;0;0;0;.00nan;0;0
15874;-1;2199;0;0;0;0;.00nan;0;0
15874;148691;2199;80;29;2;27;.931;3728000;0
15875;175761;769;0;0;0;0;.00nan;0;0
15875;-1;769;77;35;2;33;.943;3600000;0
15875;87758;3913;0;0;0;0;.00nan;0;0
15875;142810;3913;73;34;3;31;.912;3600000;0
15876;193576;774;0;0;0;0;.00nan;0;0
15876;-1;772;0;0;0;0;.00nan;0;0
15876;145463;772;68;39;4;35;.897;3600000;0
15876;149191;774;80;26;2;24;.923;3600000;0
15877;359;760;0;0;0;0;.00nan;0;0
15877;-1;760;80;41;3;38;.927;3900000;0
15877;169618;766;0;0;0;0;.00nan;0;0
15877;185559;766;61;29;3;26;.897;3900000;0
15878;189264;4923;0;0;0;0;.00nan;0;0
15878;174898;1503;0;0;0;0;.00nan;0;0
15878;179406;4923;59;26;3;23;.885;3600000;0
15878;196698;1503;46;24;4;20;.833;3567000;0
15879;166226;1093;0;0;0;0;.00nan;0;0
15879;175757;1497;83;34;2;32;.941;3600000;0
15879;216807;1497;0;0;0;0;.00nan;0;0
15879;63932;1093;49;28;4;24;.857;3553000;0
15880;178116;759;0;0;0;0;.00nan;0;0
15880;166023;767;0;0;0;0;.00nan;0;0
15880;202839;767;98;40;2;38;.950;3600000;0
15880;94134;759;44;30;6;24;.800;3600000;0
15881;177356;762;0;0;0;0;.00nan;0;0
15881;188815;762;90;38;3;35;.921;3524000;0
15881;207194;754;0;0;0;0;.00nan;0;0
15881;149119;754;95;34;1;33;.971;3600000;0
15882;170530;755;86;34;2;32;.941;3600000;0
15882;180154;755;0;0;0;0;.00nan;0;0
15882;146249;775;0;0;0;0;.00nan;0;0
15882;149280;775;49;29;4;25;.862;3513000;0
15883;166226;1093;0;0;0;0;.00nan;0;0
15883;190589;2197;0;0;0;0;.00nan;0;0
15883;63932;1093;70;21;2;19;.905;3600000;0
15883;82817;2197;67;32;3;29;.906;3548000;0
15884;164521;3721;0;0;0;0;.00nan;0;0
15884;201933;3721;53;35;4;31;.886;3544000;0
15884;87758;3913;0;0;0;0;.00nan;0;0
15884;142810;3913;58;26;3;23;.885;3600000;0
15885;189581;758;0;0;0;0;.00nan;0;0
15885;174894;2545;47;29;4;25;.862;3582000;0
15885;176686;758;57;21;3;18;.857;3600000;0
15885;94107;2545;0;0;0;0;.00nan;0;0
15886;359;760;0;0;0;0;.00nan;0;0
15886;-1;760;50;21;3;18;.857;3600000;0
15886;175761;769;0;0;0;0;.00nan;0;0
15886;-1;769;44;30;5;25;.833;3583000;0
15887;1756;4989;40;23;4;19;.826;857000;0
15887;169618;766;69;22;1;21;.955;3600000;0
15887;190570;4989;57;17;2;15;.882;2743000;0
15887;185559;766;0;0;0;0;.00nan;0;0
15888;174898;1503;92;46;3;43;.935;3600000;0
15888;196698;1503;0;0;0;0;.00nan;0;0
15888;-1;2199;0;0;0;0;.00nan;0;0
15888;148691;2199;83;14;0;14;1.000;3600000;0
15889;199033;750;100;20;0;20;1.000;3600000;0
15889;212428;750;0;0;0;0;.00nan;0;0
15889;181910;1492;0;0;0;0;.00nan;0;0
15889;86343;1492;93;54;4;50;.926;3600000;0
15890;189264;4923;0;0;0;0;.00nan;0;0
15890;179406;4923;65;16;1;15;.938;3560000;0
15890;175757;1497;0;0;0;0;.00nan;0;0
15890;216807;1497;100;37;0;37;1.000;3600000;0
15891;222019;768;77;20;1;19;.950;3900000;0
15891;-1;768;0;0;0;0;.00nan;0;0
15891;146249;775;0;0;0;0;.00nan;0;0
15891;149280;775;92;41;1;40;.976;3900000;0
15892;177356;762;0;0;0;0;.00nan;0;0
15892;188815;762;72;21;1;20;.952;3600000;0
15892;174858;3730;53;33;4;29;.879;3600000;0
15892;149112;3730;0;0;0;0;.00nan;0;0
15893;178116;759;0;0;0;0;.00nan;0;0
15893;180188;4924;79;31;2;29;.935;3600000;0
15893;91194;4924;0;0;0;0;.00nan;0;0
15893;94134;759;31;18;4;14;.778;3521000;0
15894;193545;911;0;0;0;0;.00nan;0;0
15894;207194;754;40;26;5;21;.808;3600000;0
15894;186234;911;91;26;1;25;.962;3600000;0
15894;149119;754;0;0;0;0;.00nan;0;0
15895;166023;767;0;0;0;0;.00nan;0;0
15895;170530;755;73;51;5;46;.902;3600000;0
15895;180154;755;0;0;0;0;.00nan;0;0
15895;202839;767;76;17;1;16;.941;3600000;0
15896;189264;4923;0;0;0;0;.00nan;0;0
15896;179406;4923;62;21;2;19;.905;3600000;0
15896;190589;2197;53;31;4;27;.871;3528000;0
15896;82817;2197;0;0;0;0;.00nan;0;0
15897;359;760;65;17;1;16;.941;3600000;0
15897;164521;3721;0;0;0;0;.00nan;0;0
15897;-1;760;0;0;0;0;.00nan;0;0
15897;201933;3721;55;32;4;28;.875;3600000;0
15898;1756;4989;0;0;0;0;.00nan;0;0
15898;175761;769;0;0;0;0;.00nan;0;0
15898;190570;4989;73;41;4;37;.902;3600000;0
15898;-1;769;67;29;3;26;.897;3600000;0
15899;169618;766;0;0;0;0;.00nan;0;0
15899;181910;1492;0;0;0;0;.00nan;0;0
15899;185559;766;65;29;4;25;.862;3542000;0
15899;86343;1492;73;35;3;32;.914;3600000;0
15900;174894;2545;100;38;1;37;.974;3900000;0
15900;174898;1503;58;16;1;15;.938;3900000;0
15900;196698;1503;0;0;0;0;.00nan;0;0
15900;94107;2545;0;0;0;0;.00nan;0;0
15901;199033;750;96;20;0;20;1.000;3600000;0
15901;212428;750;0;0;0;0;.00nan;0;0
15901;87758;3913;0;0;0;0;.00nan;0;0
15901;142810;3913;77;39;4;35;.897;3600000;0
15902;175757;1497;52;3;0;3;1.000;318000;0
15902;216807;1497;69;44;4;40;.909;3245000;0
15902;-1;2199;0;0;0;0;.00nan;0;0
15902;148691;2199;58;16;2;14;.875;3600000;0
15903;166023;767;0;0;0;0;.00nan;0;0
15903;222019;768;0;0;0;0;.00nan;0;0
15903;202839;767;45;32;5;27;.844;3900000;0
15903;-1;768;40;26;5;21;.808;3900000;0
15904;193545;911;0;0;0;0;.00nan;0;0
15904;174858;3730;0;0;0;0;.00nan;0;0
15904;186234;911;83;31;2;29;.935;3532000;0
15904;149112;3730;100;34;0;34;1.000;3600000;0
15905;193576;774;0;0;0;0;.00nan;0;0
15905;178116;759;0;0;0;0;.00nan;0;0
15905;94134;759;73;18;1;17;.944;3600000;0
15905;149191;774;98;46;3;43;.935;3592000;0
15906;177356;762;0;0;0;0;.00nan;0;0
15906;188815;762;67;17;1;16;.941;3600000;0
15906;-1;772;75;30;3;27;.900;3523000;0
15906;145463;772;0;0;0;0;.00nan;0;0
15907;170530;755;0;0;0;0;.00nan;0;0
15907;180154;755;86;16;0;16;1.000;3878000;0
15907;180188;4924;88;30;1;29;.967;3878000;0
15907;91194;4924;0;0;0;0;.00nan;0;0
15908;167629;746;39;19;4;15;.789;3600000;0
15908;164454;746;0;0;0;0;.00nan;0;0
15908;146249;775;0;0;0;0;.00nan;0;0
15908;149280;775;46;34;6;28;.824;3534000;0
15909;190589;2197;34;18;4;14;.778;1139000;0
15909;-1;2199;0;0;0;0;.00nan;0;0
15909;82817;2197;80;42;4;38;.905;2461000;0
15909;148691;2199;56;17;2;15;.882;3600000;0
15910;1756;4989;49;29;5;24;.828;3600000;0
15910;164521;3721;73;22;1;21;.955;3600000;0
15910;201933;3721;0;0;0;0;.00nan;0;0
15910;190570;4989;0;0;0;0;.00nan;0;0
15911;359;760;58;2;0;2;1.000;1217000;0
15911;199033;750;99;31;1;30;.968;3600000;0
15911;-1;760;32;21;5;16;.762;2383000;0
15911;212428;750;0;0;0;0;.00nan;0;0
15912;174894;2545;64;26;3;23;.885;3593000;0
15912;175757;1497;78;31;2;29;.935;3600000;0
15912;216807;1497;0;0;0;0;.00nan;0;0
15912;94107;2545;0;0;0;0;.00nan;0;0
15913;222019;768;47;11;2;9;.818;3600000;0
15913;180188;4924;18;19;6;13;.684;1612000;0
15913;-1;768;0;0;0;0;.00nan;0;0
15913;91194;4924;49;20;3;17;.850;1988000;0
15914;193545;911;0;0;0;0;.00nan;0;0
15914;186234;911;72;29;2;27;.931;3600000;0
15914;-1;772;0;0;0;0;.00nan;0;0
15914;145463;772;52;22;3;19;.864;3600000;0
15915;193576;774;0;0;0;0;.00nan;0;0
15915;170530;755;0;0;0;0;.00nan;0;0
15915;180154;755;64;24;3;21;.875;3600000;0
15915;149191;774;90;23;0;23;1.000;3600000;0
15916;167629;746;0;0;0;0;.00nan;0;0
15916;164454;746;72;34;3;31;.912;3534000;0
15916;166023;767;0;0;0;0;.00nan;0;0
15916;202839;767;94;35;1;34;.971;3600000;0
15917;166226;1093;0;0;0;0;.00nan;0;0
15917;207194;754;76;26;2;24;.923;3900000;0
15917;63932;1093;100;39;2;37;.949;3900000;0
15917;149119;754;0;0;0;0;.00nan;0;0
15918;174894;2545;78;24;1;23;.958;3900000;0
15918;190589;2197;80;22;1;21;.955;3900000;0
15918;82817;2197;0;0;0;0;.00nan;0;0
15918;94107;2545;0;0;0;0;.00nan;0;0
15919;174898;1503;44;27;4;23;.852;3600000;0
15919;196698;1503;0;0;0;0;.00nan;0;0
15919;87758;3913;58;44;5;39;.886;3557000;0
15919;142810;3913;0;0;0;0;.00nan;0;0
15920;1756;4989;38;17;4;13;.765;828000;0
15920;199033;750;0;0;0;0;.00nan;0;0
15920;212428;750;55;18;2;16;.889;3600000;0
15920;190570;4989;51;36;5;31;.861;2772000;0
15921;193576;774;0;0;0;0;.00nan;0;0
15921;222019;768;0;0;0;0;.00nan;0;0
15921;-1;768;54;21;3;18;.857;3600000;0
15921;149191;774;67;38;4;34;.895;3600000;0
15922;177356;762;100;48;2;46;.958;3900000;0
15922;178116;759;0;0;0;0;.00nan;0;0
15922;188815;762;0;0;0;0;.00nan;0;0
15922;94134;759;49;12;2;10;.833;3900000;0
15923;189264;4923;89;31;1;30;.968;3600000;0
15923;179406;4923;0;0;0;0;.00nan;0;0
15923;207194;754;65;38;4;34;.895;3600000;0
15923;149119;754;0;0;0;0;.00nan;0;0
15924;167629;746;91;29;2;27;.931;3600000;0
15924;164454;746;0;0;0;0;.00nan;0;0
15924;180188;4924;63;29;3;26;.897;3600000;0
15924;91194;4924;0;0;0;0;.00nan;0;0
15925;166226;1093;0;0;0;0;.00nan;0;0
15925;174858;3730;0;0;0;0;.00nan;0;0
15925;63932;1093;74;32;2;30;.938;3577000;0
15925;149112;3730;72;18;1;17;.944;3600000;0
15926;189581;758;0;0;0;0;.00nan;0;0
15926;176686;758;68;36;3;33;.917;3600000;0
15926;87758;3913;0;0;0;0;.00nan;0;0
15926;142810;3913;72;27;2;25;.926;3600000;0
15927;174898;1503;22;18;5;13;.722;3545000;0
15927;181910;1492;73;34;3;31;.912;3600000;0
15927;196698;1503;0;0;0;0;.00nan;0;0
15927;86343;1492;0;0;0;0;.00nan;0;0
15928;359;760;0;0;0;0;.00nan;0;0
15928;-1;760;71;44;5;39;.886;3600000;0
15928;175757;1497;0;0;0;0;.00nan;0;0
15928;216807;1497;58;17;2;15;.882;3600000;0
15929;207194;754;89;40;4;36;.900;3900000;0
15929;-1;2199;56;26;4;22;.846;3900000;0
15929;148691;2199;0;0;0;0;.00nan;0;0
15929;149119;754;0;0;0;0;.00nan;0;0
15930;193545;911;0;0;0;0;.00nan;0;0
15930;178116;759;0;0;0;0;.00nan;0;0
15930;186234;911;90;32;1;31;.969;3600000;0
15930;94134;759;35;20;4;16;.800;3600000;0
15931;177356;762;0;0;0;0;.00nan;0;0
15931;188815;762;83;25;1;24;.960;3600000;0
15931;170530;755;71;32;3;29;.906;3523000;0
15931;180154;755;0;0;0;0;.00nan;0;0
15932;189264;4923;0;0;0;0;.00nan;0;0
15932;174858;3730;53;15;2;13;.867;3600000;0
15932;179406;4923;63;34;4;30;.882;3580000;0
15932;149112;3730;0;0;0;0;.00nan;0;0
15933;193576;774;0;0;0;0;.00nan;0;0
15933;167629;746;0;0;0;0;.00nan;0;0
15933;164454;746;43;19;3;16;.842;3900000;0
15933;149191;774;100;49;3;46;.939;3900000;0
15934;166226;1093;0;0;0;0;.00nan;0;0
15934;-1;772;0;0;0;0;.00nan;0;0
15934;63932;1093;61;40;6;34;.850;3600000;0
15934;145463;772;81;40;3;37;.925;3600000;0
15935;190589;2197;39;28;4;24;.857;3600000;0
15935;82817;2197;0;0;0;0;.00nan;0;0
15935;87758;3913;0;0;0;0;.00nan;0;0
15935;142810;3913;71;22;1;21;.955;3600000;0
15936;1756;4989;80;37;3;34;.919;3600000;0
15936;175757;1497;46;23;4;19;.826;3555000;0
15936;216807;1497;0;0;0;0;.00nan;0;0
15936;190570;4989;0;0;0;0;.00nan;0;0
15937;166023;767;0;0;0;0;.00nan;0;0
15937;202839;767;73;34;3;31;.912;3600000;0
15937;146249;775;0;0;0;0;.00nan;0;0
15937;149280;775;35;26;5;21;.808;3559000;0
15938;189581;758;0;0;0;0;.00nan;0;0
15938;176686;758;69;23;2;21;.913;3600000;0
15938;181910;1492;0;0;0;0;.00nan;0;0
15938;86343;1492;76;33;3;30;.909;3579000;0
15939;359;760;0;0;0;0;.00nan;0;0
15939;-1;760;67;33;4;29;.879;3600000;0
15939;174898;1503;68;18;1;17;.944;3600000;0
15939;196698;1503;0;0;0;0;.00nan;0;0
15940;164521;3721;0;0;0;0;.00nan;0;0
15940;175761;769;0;0;0;0;.00nan;0;0
15940;201933;3721;89;43;3;40;.930;3550000;0
15940;-1;769;69;19;2;17;.895;3600000;0
15941;199033;750;0;0;0;0;.00nan;0;0
15941;169618;766;0;0;0;0;.00nan;0;0
15941;212428;750;52;16;2;14;.875;3551000;0
15941;185559;766;88;34;1;33;.971;3600000;0
15942;174858;3730;0;0;0;0;.00nan;0;0
15942;-1;2199;0;0;0;0;.00nan;0;0
15942;148691;2199;63;18;2;16;.889;3556000;0
15942;149112;3730;92;25;0;25;1.000;3600000;0
15943;174894;2545;75;23;2;21;.913;3900000;0
15943;207194;754;85;35;2;33;.943;3900000;0
15943;94107;2545;0;0;0;0;.00nan;0;0
15943;149119;754;0;0;0;0;.00nan;0;0
15944;193545;911;0;0;0;0;.00nan;0;0
15944;170530;755;0;0;0;0;.00nan;0;0
15944;180154;755;91;30;1;29;.967;3566000;0
15944;186234;911;100;26;0;26;1.000;3600000;0
15945;177356;762;0;0;0;0;.00nan;0;0
15945;188815;762;92;42;1;41;.976;3600000;0
15945;222019;768;43;22;4;18;.818;3600000;0
15945;-1;768;0;0;0;0;.00nan;0;0
15946;189264;4923;0;0;0;0;.00nan;0;0
15946;179406;4923;58;11;1;10;.909;3600000;0
15946;-1;772;0;0;0;0;.00nan;0;0
15946;145463;772;56;21;2;19;.905;3584000;0
15947;175757;1497;0;0;0;0;.00nan;0;0
15947;216807;1497;77;24;2;22;.917;3600000;0
15947;87758;3913;0;0;0;0;.00nan;0;0
15947;142810;3913;58;32;3;29;.906;3558000;0
15948;1756;4989;0;0;0;0;.00nan;0;0
15948;174898;1503;73;21;1;20;.952;3580000;0
15948;190570;4989;100;28;0;28;1.000;3600000;0
15948;196698;1503;0;0;0;0;.00nan;0;0
15949;190589;2197;63;24;3;21;.875;3534000;0
15949;181910;1492;0;0;0;0;.00nan;0;0
15949;82817;2197;0;0;0;0;.00nan;0;0
15949;86343;1492;90;28;1;27;.964;3600000;0
15950;359;760;86;25;1;24;.960;3661000;0
15950;-1;760;0;0;0;0;.00nan;0;0
15950;189581;758;0;0;0;0;.00nan;0;0
15950;176686;758;67;23;2;21;.913;3661000;0
15951;180188;4924;0;0;0;0;.00nan;0;0
15951;91194;4924;29;35;7;28;.800;3600000;0
15951;146249;775;0;0;0;0;.00nan;0;0
15951;149280;775;60;20;2;18;.900;3600000;0
15952;199033;750;0;0;0;0;.00nan;0;0
15952;175761;769;0;0;0;0;.00nan;0;0
15952;212428;750;54;22;3;19;.864;3583000;0
15952;-1;769;71;28;2;26;.929;3600000;0
15953;164521;3721;49;33;5;28;.848;3600000;0
15953;169618;766;30;28;6;22;.786;3545000;0
15953;201933;3721;0;0;0;0;.00nan;0;0
15953;185559;766;0;0;0;0;.00nan;0;0
15954;-1;2199;0;0;0;0;.00nan;0;0
15954;-1;772;0;0;0;0;.00nan;0;0
15954;145463;772;58;34;4;30;.882;3589000;0
15954;148691;2199;59;19;2;17;.895;3600000;0
15955;174858;3730;0;0;0;0;.00nan;0;0
15955;174894;2545;87;35;2;33;.943;3900000;0
15955;94107;2545;0;0;0;0;.00nan;0;0
15955;149112;3730;62;18;2;16;.889;3900000;0
15956;193545;911;0;0;0;0;.00nan;0;0
15956;222019;768;0;0;0;0;.00nan;0;0
15956;186234;911;99;44;2;42;.955;3600000;0
15956;-1;768;51;17;3;14;.824;3591000;0
15957;177356;762;0;0;0;0;.00nan;0;0
15957;167629;746;87;16;0;16;1.000;3600000;0
15957;164454;746;0;0;0;0;.00nan;0;0
15957;188815;762;73;36;3;33;.917;3600000;0
15958;1756;4989;66;38;4;34;.895;3600000;0
15958;189581;758;0;0;0;0;.00nan;0;0
15958;176686;758;62;43;5;38;.884;3587000;0
15958;190570;4989;0;0;0;0;.00nan;0;0
15959;175757;1497;70;26;2;24;.923;3580000;0
15959;216807;1497;0;0;0;0;.00nan;0;0
15959;181910;1492;0;0;0;0;.00nan;0;0
15959;86343;1492;78;25;1;24;.960;3600000;0
15960;359;760;0;0;0;0;.00nan;0;0
15960;-1;760;48;26;4;22;.846;3558000;0
15960;190589;2197;77;39;3;36;.923;3600000;0
15960;82817;2197;0;0;0;0;.00nan;0;0
15961;166023;767;0;0;0;0;.00nan;0;0
15961;180188;4924;77;38;3;35;.921;3557000;0
15961;202839;767;88;28;1;27;.964;3600000;0
15961;91194;4924;0;0;0;0;.00nan;0;0
15962;178116;759;85;10;0;10;1.000;3600000;0
15962;166226;1093;0;0;0;0;.00nan;0;0
15962;63932;1093;73;43;4;39;.907;3600000;0
15962;94134;759;0;0;0;0;.00nan;0;0
15963;193576;774;0;0;0;0;.00nan;0;0
15963;146249;775;0;0;0;0;.00nan;0;0
15963;149191;774;80;38;3;35;.921;3900000;0
15963;149280;775;64;25;3;22;.880;3900000;0
15964;174894;2545;65;31;4;27;.871;3600000;0
15964;-1;772;0;0;0;0;.00nan;0;0
15964;94107;2545;0;0;0;0;.00nan;0;0
15964;145463;772;75;20;1;19;.950;3600000;0
15965;193545;911;0;0;0;0;.00nan;0;0
15965;167629;746;73;27;2;25;.926;3600000;0
15965;164454;746;0;0;0;0;.00nan;0;0
15965;186234;911;75;29;3;26;.897;3600000;0
15966;1756;4989;0;0;0;0;.00nan;0;0
15966;190570;4989;63;26;3;23;.885;3600000;0
15966;190589;2197;51;30;4;26;.867;3576000;0
15966;82817;2197;0;0;0;0;.00nan;0;0
15967;178116;759;91;20;0;20;1.000;3600000;0
15967;189264;4923;0;0;0;0;.00nan;0;0
15967;179406;4923;75;52;5;47;.904;3600000;0
15967;94134;759;0;0;0;0;.00nan;0;0
15968;193576;774;0;0;0;0;.00nan;0;0
15968;166023;767;0;0;0;0;.00nan;0;0
15968;202839;767;100;27;0;27;1.000;3600000;0
15968;149191;774;75;33;3;30;.909;3600000;0
15969;207194;754;0;0;0;0;.00nan;0;0
15969;87758;3913;0;0;0;0;.00nan;0;0
15969;142810;3913;86;36;2;34;.944;3900000;0
15969;149119;754;74;27;2;25;.926;3900000;0
15970;166226;1093;0;0;0;0;.00nan;0;0
15970;170530;755;43;24;4;20;.833;2074000;0
15970;180154;755;51;14;2;12;.857;1500000;0
15970;63932;1093;40;26;5;21;.808;3600000;0
15971;174898;1503;97;26;0;26;1.000;3600000;0
15971;175761;769;0;0;0;0;.00nan;0;0
15971;196698;1503;0;0;0;0;.00nan;0;0
15971;-1;769;71;34;3;31;.912;3600000;0
15972;166226;1093;36;19;4;15;.789;1312000;0
15972;222019;768;63;20;2;18;.900;3600000;0
15972;-1;768;0;0;0;0;.00nan;0;0
15972;63932;1093;47;38;6;32;.842;2288000;0
15973;174858;3730;100;28;0;28;1.000;3600000;0
15973;87758;3913;0;0;0;0;.00nan;0;0
15973;142810;3913;55;19;2;17;.895;3559000;0
15973;149112;3730;0;0;0;0;.00nan;0;0
15974;178116;759;75;35;3;32;.914;3557000;0
15974;-1;2199;0;0;0;0;.00nan;0;0
15974;94134;759;0;0;0;0;.00nan;0;0
15974;148691;2199;95;38;2;36;.947;3600000;0
15975;207194;754;91;43;3;40;.930;3600000;0
15975;181910;1492;0;0;0;0;.00nan;0;0
15975;86343;1492;100;25;0;25;1.000;3600000;0
15975;149119;754;0;0;0;0;.00nan;0;0
15976;177356;762;47;21;3;18;.857;3209000;0
15976;188815;762;16;7;4;3;.429;391000;0
15976;146249;775;75;21;1;20;.952;3600000;0
15976;149280;775;0;0;0;0;.00nan;0;0
15977;189264;4923;0;0;0;0;.00nan;0;0
15977;170530;755;85;38;2;36;.947;3560000;0
15977;179406;4923;73;20;1;19;.950;3600000;0
15977;180154;755;0;0;0;0;.00nan;0;0
15978;189581;758;66;41;4;37;.902;3600000;0
15978;175761;769;0;0;0;0;.00nan;0;0
15978;176686;758;0;0;0;0;.00nan;0;0
15978;-1;769;82;29;1;28;.966;3600000;0
15979;169618;766;0;0;0;0;.00nan;0;0
15979;174898;1503;57;30;4;26;.867;3600000;0
15979;185559;766;81;53;5;48;.906;3549000;0
15979;196698;1503;0;0;0;0;.00nan;0;0
15980;177356;762;0;0;0;0;.00nan;0;0
15980;188815;762;71;31;3;28;.903;3552000;0
15980;166023;767;0;0;0;0;.00nan;0;0
15980;202839;767;65;20;2;18;.900;3600000;0
15981;189264;4923;0;0;0;0;.00nan;0;0
15981;179406;4923;98;46;2;44;.957;3576000;0
15981;222019;768;0;0;0;0;.00nan;0;0
15981;-1;768;90;23;1;22;.957;3600000;0
15982;174858;3730;98;24;0;24;1.000;3600000;0
15982;181910;1492;0;0;0;0;.00nan;0;0
15982;86343;1492;46;22;4;18;.818;3600000;0
15982;149112;3730;0;0;0;0;.00nan;0;0
15983;178116;759;0;0;0;0;.00nan;0;0
15983;174894;2545;78;42;4;38;.905;3600000;0
15983;94107;2545;0;0;0;0;.00nan;0;0
15983;94134;759;73;10;0;10;1.000;3600000;0
15984;-1;772;73;27;2;25;.926;3900000;0
15984;87758;3913;0;0;0;0;.00nan;0;0
15984;142810;3913;63;35;2;33;.943;3900000;0
15984;145463;772;0;0;0;0;.00nan;0;0
15985;1756;4989;0;0;0;0;.00nan;0;0
15985;190570;4989;84;25;1;24;.960;3600000;0
15985;207194;754;81;33;2;31;.939;3551000;0
15985;149119;754;0;0;0;0;.00nan;0;0
15986;193545;911;0;0;0;0;.00nan;0;0
15986;186234;911;84;26;1;25;.962;3600000;0
15986;146249;775;0;0;0;0;.00nan;0;0
15986;149280;775;63;25;2;23;.920;3594000;0
15987;170530;755;0;0;0;0;.00nan;0;0
15987;180154;755;69;36;4;32;.889;3600000;0
15987;-1;2199;0;0;0;0;.00nan;0;0
15987;148691;2199;59;16;2;14;.875;3600000;0
15988;167629;746;0;0;0;0;.00nan;0;0
15988;164454;746;56;13;1;12;.923;3600000;0
15988;166226;1093;0;0;0;0;.00nan;0;0
15988;63932;1093;75;30;3;27;.900;3573000;0
15989;175761;769;0;0;0;0;.00nan;0;0
15989;190589;2197;0;0;0;0;.00nan;0;0
15989;-1;769;58;40;5;35;.875;3600000;0
15989;82817;2197;89;22;0;22;1.000;3600000;0
15990;169618;766;0;0;0;0;.00nan;0;0
15990;189581;758;0;0;0;0;.00nan;0;0
15990;176686;758;41;22;4;18;.818;3646000;0
15990;185559;766;78;42;5;37;.881;3646000;0
15991;199033;750;0;0;0;0;.00nan;0;0
15991;174898;1503;0;0;0;0;.00nan;0;0
15991;212428;750;100;37;0;37;1.000;3600000;0
15991;196698;1503;73;25;2;23;.920;3517000;0
15992;164521;3721;48;0;0;0;.00nan;519000;0
15992;175757;1497;70;28;2;26;.929;3600000;0
15992;216807;1497;0;0;0;0;.00nan;0;0
15992;201933;3721;17;21;6;15;.714;3081000;0
15993;193545;911;0;0;0;0;.00nan;0;0
15993;166023;767;0;0;0;0;.00nan;0;0
15993;186234;911;71;34;3;31;.912;3762000;0
15993;202839;767;82;36;2;34;.944;3762000;0
15994;222019;768;71;35;3;32;.914;3584000;0
15994;-1;2199;0;0;0;0;.00nan;0;0
15994;-1;768;0;0;0;0;.00nan;0;0
15994;148691;2199;62;23;2;21;.913;3600000;0
15995;1756;4989;0;0;0;0;.00nan;0;0
15995;174858;3730;65;22;2;20;.909;3574000;0
15995;190570;4989;100;39;0;39;1.000;3600000;0
15995;149112;3730;0;0;0;0;.00nan;0;0
15996;177356;762;0;0;0;0;.00nan;0;0
15996;193576;774;0;0;0;0;.00nan;0;0
15996;188815;762;98;30;1;29;.967;3573000;0
15996;149191;774;92;22;0;22;1.000;3600000;0
15997;181910;1492;0;0;0;0;.00nan;0;0
15997;-1;772;0;0;0;0;.00nan;0;0
15997;86343;1492;100;51;1;50;.980;3600000;0
15997;145463;772;57;22;2;20;.909;3600000;0
15998;359;760;0;0;0;0;.00nan;0;0
15998;-1;760;74;33;3;30;.909;3600000;0
15998;207194;754;75;21;1;20;.952;3600000;0
15998;149119;754;0;0;0;0;.00nan;0;0
15999;170530;755;55;29;4;25;.862;3600000;0
15999;174894;2545;38;27;5;22;.815;3562000;0
15999;180154;755;0;0;0;0;.00nan;0;0
15999;94107;2545;0;0;0;0;.00nan;0;0
16000;167629;746;50;26;3;23;.885;3900000;0
16000;164454;746;0;0;0;0;.00nan;0;0
16000;189264;4923;0;0;0;0;.00nan;0;0
16000;179406;4923;83;35;3;32;.914;3890000;0
16001;169618;766;0;0;0;0;.00nan;0;0
16001;190589;2197;0;0;0;0;.00nan;0;0
16001;185559;766;76;33;3;30;.909;3600000;0
16001;82817;2197;37;22;4;18;.818;3553000;0
16002;199033;750;0;0;0;0;.00nan;0;0
16002;189581;758;0;0;0;0;.00nan;0;0
16002;176686;758;56;31;4;27;.871;3539000;0
16002;212428;750;66;28;3;25;.893;3600000;0
16003;164521;3721;0;0;0;0;.00nan;0;0
16003;174898;1503;99;35;1;34;.971;3600000;0
16003;201933;3721;74;37;3;34;.919;3592000;0
16003;196698;1503;0;0;0;0;.00nan;0;0
16004;175757;1497;0;0;0;0;.00nan;0;0
16004;175761;769;0;0;0;0;.00nan;0;0
16004;216807;1497;67;22;1;21;.955;3600000;0
16004;-1;769;89;38;2;36;.947;3600000;0
16005;174894;2545;81;39;2;37;.949;3900000;0
16005;222019;768;0;0;0;0;.00nan;0;0
16005;-1;768;75;27;2;25;.926;3900000;0
16005;94107;2545;0;0;0;0;.00nan;0;0
16006;359;760;0;0;0;0;.00nan;0;0
16006;-1;760;64;25;2;23;.920;3588000;0
16006;174858;3730;0;0;0;0;.00nan;0;0
16006;149112;3730;77;23;1;22;.957;3600000;0
16007;177356;762;0;0;0;0;.00nan;0;0
16007;188815;762;67;32;2;30;.938;3900000;0
16007;180188;4924;72;23;2;21;.913;3900000;0
16007;91194;4924;0;0;0;0;.00nan;0;0
16008;193545;911;0;0;0;0;.00nan;0;0
16008;193576;774;0;0;0;0;.00nan;0;0
16008;186234;911;57;24;3;21;.875;3900000;0
16008;149191;774;72;24;3;21;.875;3900000;0
16009;1756;4989;0;0;0;0;.00nan;0;0
16009;190570;4989;62;39;5;34;.872;3600000;0
16009;-1;772;0;0;0;0;.00nan;0;0
16009;145463;772;63;17;2;15;.882;3600000;0
16010;167629;746;63;24;2;22;.917;3600000;0
16010;164454;746;0;0;0;0;.00nan;0;0
16010;-1;2199;0;0;0;0;.00nan;0;0
16010;148691;2199;66;38;4;34;.895;3581000;0
16011;199033;750;0;0;0;0;.00nan;0;0
16011;212428;750;60;23;2;21;.913;3544000;0
16011;190589;2197;99;43;1;42;.977;3600000;0
16011;82817;2197;0;0;0;0;.00nan;0;0
16012;164521;3721;0;0;0;0;.00nan;0;0
16012;189581;758;96;35;1;34;.971;3600000;0
16012;176686;758;0;0;0;0;.00nan;0;0
16012;201933;3721;73;30;2;28;.933;3565000;0
16013;169618;766;0;0;0;0;.00nan;0;0
16013;175757;1497;73;26;2;24;.923;3600000;0
16013;216807;1497;0;0;0;0;.00nan;0;0
16013;185559;766;55;40;5;35;.875;3600000;0
16014;170530;755;52;22;3;19;.864;3553000;0
16014;180154;755;0;0;0;0;.00nan;0;0
16014;87758;3913;0;0;0;0;.00nan;0;0
16014;142810;3913;92;41;2;39;.951;3600000;0
16015;178116;759;0;0;0;0;.00nan;0;0
16015;181910;1492;77;36;2;34;.944;3037000;0
16015;86343;1492;19;10;4;6;.600;563000;0
16015;94134;759;68;23;2;21;.913;3600000;0
16016;193545;911;0;0;0;0;.00nan;0;0
16016;180188;4924;58;20;2;18;.900;3565000;0
16016;186234;911;72;20;1;19;.950;3600000;0
16016;91194;4924;0;0;0;0;.00nan;0;0
16017;359;760;100;25;0;25;1.000;3600000;0
16017;-1;760;0;0;0;0;.00nan;0;0
16017;-1;772;48;15;2;13;.867;3560000;0
16017;145463;772;0;0;0;0;.00nan;0;0
16018;167629;746;0;0;0;0;.00nan;0;0
16018;164454;746;61;19;2;17;.895;3600000;0
16018;174894;2545;71;35;3;32;.914;3546000;0
16018;94107;2545;0;0;0;0;.00nan;0;0
16019;164521;3721;89;22;0;22;1.000;3600000;0
16019;201933;3721;0;0;0;0;.00nan;0;0
16019;190589;2197;66;39;4;35;.897;3600000;0
16019;82817;2197;0;0;0;0;.00nan;0;0
16020;189581;758;71;34;2;32;.941;3586000;0
16020;174898;1503;86;12;0;12;1.000;3600000;0
16020;176686;758;0;0;0;0;.00nan;0;0
16020;196698;1503;0;0;0;0;.00nan;0;0
16021;166023;767;0;0;0;0;.00nan;0;0
16021;189264;4923;0;0;0;0;.00nan;0;0
16021;179406;4923;94;46;2;44;.957;3801000;0
16021;202839;767;77;21;1;20;.952;3801000;0
16022;166226;1093;59;38;4;34;.895;3900000;0
16022;63932;1093;0;0;0;0;.00nan;0;0
16022;146249;775;0;0;0;0;.00nan;0;0
16022;149280;775;55;23;4;19;.826;3900000;0
16023;199033;750;0;0;0;0;.00nan;0;0
16023;175757;1497;0;0;0;0;.00nan;0;0
16023;216807;1497;72;28;2;26;.929;3580000;0
16023;212428;750;91;19;0;19;1.000;3600000;0
16024;178116;759;0;0;0;0;.00nan;0;0
16024;87758;3913;0;0;0;0;.00nan;0;0
16024;94134;759;66;18;1;17;.944;3600000;0
16024;142810;3913;86;34;2;32;.941;3558000;0
16025;1756;4989;0;0;0;0;.00nan;0;0
16025;170530;755;63;28;3;25;.893;3595000;0
16025;180154;755;0;0;0;0;.00nan;0;0
16025;190570;4989;78;30;2;28;.933;3600000;0
16026;222019;768;0;0;0;0;.00nan;0;0
16026;181910;1492;0;0;0;0;.00nan;0;0
16026;-1;768;53;15;2;13;.867;3600000;0
16026;86343;1492;91;49;3;46;.939;3600000;0
16027;175761;769;39;27;4;23;.852;3600000;0
16027;207194;754;73;22;1;21;.955;3600000;0
16027;-1;769;0;0;0;0;.00nan;0;0
16027;149119;754;0;0;0;0;.00nan;0;0
16028;193576;774;0;0;0;0;.00nan;0;0
16028;-1;2199;0;0;0;0;.00nan;0;0
16028;148691;2199;67;30;3;27;.900;3600000;0
16028;149191;774;48;32;5;27;.844;3589000;0
16029;189264;4923;0;0;0;0;.00nan;0;0
16029;179406;4923;84;43;3;40;.930;3543000;0
16029;146249;775;0;0;0;0;.00nan;0;0
16029;149280;775;74;29;2;27;.931;3600000;0
16030;166023;767;0;0;0;0;.00nan;0;0
16030;166226;1093;0;0;0;0;.00nan;0;0
16030;202839;767;82;25;1;24;.960;3600000;0
16030;63932;1093;83;38;2;36;.947;3594000;0
16031;222019;768;93;35;2;33;.943;3900000;0
16031;-1;768;0;0;0;0;.00nan;0;0
16031;87758;3913;0;0;0;0;.00nan;0;0
16031;142810;3913;74;24;2;22;.917;3900000;0
16032;1756;4989;0;0;0;0;.00nan;0;0
16032;178116;759;0;0;0;0;.00nan;0;0
16032;190570;4989;72;49;5;44;.898;3600000;0
16032;94134;759;63;13;1;12;.923;3600000;0
16033;167629;746;100;25;0;25;1.000;3600000;0
16033;164454;746;0;0;0;0;.00nan;0;0
16033;181910;1492;0;0;0;0;.00nan;0;0
16033;86343;1492;92;34;2;32;.941;3542000;0
16034;359;760;63;24;3;21;.875;3600000;0
16034;-1;760;0;0;0;0;.00nan;0;0
16034;170530;755;51;27;4;23;.852;3591000;0
16034;180154;755;0;0;0;0;.00nan;0;0
16035;174858;3730;0;0;0;0;.00nan;0;0
16035;175761;769;0;0;0;0;.00nan;0;0
16035;-1;769;72;34;3;31;.912;3555000;0
16035;149112;3730;57;19;2;17;.895;3600000;0
16036;169618;766;0;0;0;0;.00nan;0;0
16036;207194;754;41;26;5;21;.808;3600000;0
16036;185559;766;66;25;2;23;.920;3600000;0
16036;149119;754;0;0;0;0;.00nan;0;0
16037;-1;2199;63;17;2;15;.882;3600000;0
16037;146249;775;0;0;0;0;.00nan;0;0
16037;148691;2199;0;0;0;0;.00nan;0;0
16037;149280;775;79;32;3;29;.906;3568000;0
16038;166023;767;0;0;0;0;.00nan;0;0
16038;174894;2545;0;0;0;0;.00nan;0;0
16038;202839;767;100;27;0;27;1.000;3600000;0
16038;94107;2545;79;45;4;41;.911;3600000;0
16039;189581;758;0;0;0;0;.00nan;0;0
16039;176686;758;84;31;2;29;.935;3900000;0
16039;190589;2197;91;35;2;33;.943;3900000;0
16039;82817;2197;0;0;0;0;.00nan;0;0
16040;193576;774;0;0;0;0;.00nan;0;0
16040;189264;4923;0;0;0;0;.00nan;0;0
16040;179406;4923;78;35;3;32;.914;3600000;0
16040;149191;774;61;32;4;28;.875;3582000;0
16041;166226;1093;0;0;0;0;.00nan;0;0
16041;180188;4924;41;27;4;23;.852;3543000;0
16041;63932;1093;80;30;2;28;.933;3600000;0
16041;91194;4924;0;0;0;0;.00nan;0;0
16042;167629;746;45;31;5;26;.839;3900000;0
16042;164454;746;0;0;0;0;.00nan;0;0
16042;87758;3913;0;0;0;0;.00nan;0;0
16042;142810;3913;36;31;5;26;.839;3900000;0
16043;1756;4989;0;0;0;0;.00nan;0;0
16043;222019;768;0;0;0;0;.00nan;0;0
16043;190570;4989;72;55;6;49;.891;3600000;0
16043;-1;768;42;13;2;11;.846;3600000;0
16044;170530;755;67;26;3;23;.885;3627000;0
16044;180154;755;0;0;0;0;.00nan;0;0
16044;181910;1492;0;0;0;0;.00nan;0;0
16044;86343;1492;52;28;4;24;.857;3627000;0
16045;359;760;93;35;1;34;.971;3900000;0
16045;178116;759;0;0;0;0;.00nan;0;0
16045;-1;760;0;0;0;0;.00nan;0;0
16045;94134;759;66;11;1;10;.909;3900000;0
16046;177356;762;56;7;0;7;1.000;525000;0
16046;193545;911;70;27;3;24;.889;3600000;0
16046;188815;762;49;28;4;24;.857;3048000;0
16046;186234;911;0;0;0;0;.00nan;0;0
16047;175761;769;0;0;0;0;.00nan;0;0
16047;-1;769;93;50;3;47;.940;3514000;0
16047;-1;772;80;24;1;23;.958;3600000;0
16047;145463;772;0;0;0;0;.00nan;0;0
16048;169618;766;53;24;3;21;.875;3600000;0
16048;174858;3730;100;35;0;35;1.000;3600000;0
16048;185559;766;0;0;0;0;.00nan;0;0
16048;149112;3730;0;0;0;0;.00nan;0;0
16049;199033;750;0;0;0;0;.00nan;0;0
16049;212428;750;43;23;4;19;.826;3550000;0
16049;207194;754;64;25;3;22;.880;3600000;0
16049;149119;754;0;0;0;0;.00nan;0;0
16050;166023;767;0;0;0;0;.00nan;0;0
16050;-1;2199;0;0;0;0;.00nan;0;0
16050;202839;767;60;42;5;37;.881;3538000;0
16050;148691;2199;69;29;3;26;.897;3600000;0
16051;174894;2545;75;31;3;28;.903;3600000;0
16051;94107;2545;0;0;0;0;.00nan;0;0
16051;146249;775;0;0;0;0;.00nan;0;0
16051;149280;775;41;26;4;22;.846;3572000;0
16052;189581;758;88;29;2;27;.931;3612000;0
16052;175757;1497;70;31;3;28;.903;3612000;0
16052;216807;1497;0;0;0;0;.00nan;0;0
16052;176686;758;0;0;0;0;.00nan;0;0
16053;189264;4923;0;0;0;0;.00nan;0;0
16053;179406;4923;57;24;3;21;.875;3556000;0
16053;180188;4924;89;37;2;35;.946;3600000;0
16053;91194;4924;0;0;0;0;.00nan;0;0
16054;174898;1503;87;25;1;24;.960;3900000;0
16054;190589;2197;97;46;1;45;.978;3900000;0
16054;196698;1503;0;0;0;0;.00nan;0;0
16054;82817;2197;0;0;0;0;.00nan;0;0
16055;193576;774;0;0;0;0;.00nan;0;0
16055;166226;1093;0;0;0;0;.00nan;0;0
16055;63932;1093;73;25;1;24;.960;3551000;0
16055;149191;774;98;23;0;23;1.000;3600000;0
16056;1756;4989;0;0;0;0;.00nan;0;0
16056;167629;746;0;0;0;0;.00nan;0;0
16056;164454;746;63;14;1;13;.929;3600000;0
16056;190570;4989;70;31;3;28;.903;3581000;0
16057;164521;3721;0;0;0;0;.00nan;0;0
16057;201933;3721;100;37;2;35;.946;3600000;0
16057;207194;754;32;15;4;11;.733;3515000;0
16057;149119;754;0;0;0;0;.00nan;0;0
16058;359;760;0;0;0;0;.00nan;0;0
16058;-1;760;70;44;4;40;.909;3600000;0
16058;222019;768;55;10;1;9;.900;3600000;0
16058;-1;768;0;0;0;0;.00nan;0;0
16059;169618;766;0;0;0;0;.00nan;0;0
16059;185559;766;45;34;5;29;.853;3900000;0
16059;-1;772;0;0;0;0;.00nan;0;0
16059;67818;772;67;37;5;32;.865;3900000;0
16060;199033;750;47;22;4;18;.818;3552000;0
16060;174858;3730;79;32;2;30;.938;3600000;0
16060;212428;750;0;0;0;0;.00nan;0;0
16060;149112;3730;0;0;0;0;.00nan;0;0
16061;180188;4924;0;0;0;0;.00nan;0;0
16061;-1;2199;0;0;0;0;.00nan;0;0
16061;91194;4924;98;32;1;31;.969;3900000;0
16061;148691;2199;85;27;1;26;.963;3900000;0
16062;193576;774;0;0;0;0;.00nan;0;0
16062;174894;2545;89;39;2;37;.949;3554000;0
16062;94107;2545;0;0;0;0;.00nan;0;0
16062;149191;774;70;21;1;20;.952;3600000;0
16063;174898;1503;56;24;3;21;.875;3900000;0
16063;175757;1497;88;42;3;39;.929;3900000;0
16063;216807;1497;0;0;0;0;.00nan;0;0
16063;196698;1503;0;0;0;0;.00nan;0;0
16064;164521;3721;87;40;3;37;.925;3900000;0
16064;174858;3730;0;0;0;0;.00nan;0;0
16064;201933;3721;0;0;0;0;.00nan;0;0
16064;149112;3730;81;38;3;35;.921;3900000;0
16065;359;760;0;0;0;0;.00nan;0;0
16065;167629;746;0;0;0;0;.00nan;0;0
16065;164454;746;51;21;3;18;.857;3600000;0
16065;-1;760;51;33;4;29;.879;3600000;0
16066;199033;750;0;0;0;0;.00nan;0;0
16066;212428;750;100;26;0;26;1.000;3600000;0
16066;-1;772;69;37;4;33;.892;3600000;0
16066;67818;772;0;0;0;0;.00nan;0;0
16067;175757;1497;70;23;2;21;.913;3574000;0
16067;216807;1497;0;0;0;0;.00nan;0;0
16067;190589;2197;91;20;0;20;1.000;3600000;0
16067;82817;2197;0;0;0;0;.00nan;0;0
16068;174894;2545;71;42;5;37;.881;3600000;0
16068;180188;4924;61;22;2;20;.909;3600000;0
16068;91194;4924;0;0;0;0;.00nan;0;0
16068;94107;2545;0;0;0;0;.00nan;0;0
16069;164521;3721;0;0;0;0;.00nan;0;0
16069;201933;3721;79;28;1;27;.964;3900000;0
16069;-1;772;76;26;1;25;.962;3900000;0
16069;145463;772;0;0;0;0;.00nan;0;0
16070;189264;4923;0;0;0;0;.00nan;0;0
16070;179406;4923;100;18;0;18;1.000;3600000;0
16070;186234;911;83;40;2;38;.950;3532000;0
16070;149048;911;0;0;0;0;.00nan;0;0
16071;189581;758;0;0;0;0;.00nan;0;0
16071;176686;758;91;18;0;18;1.000;3600000;0
16071;207194;754;0;0;0;0;.00nan;0;0
16071;149119;754;88;27;2;25;.926;3564000;0
16072;170530;755;0;0;0;0;.00nan;0;0
16072;175761;769;0;0;0;0;.00nan;0;0
16072;180154;755;82;33;1;32;.970;3600000;0
16072;-1;769;39;23;4;19;.826;3600000;0
16073;166023;767;0;0;0;0;.00nan;0;0
16073;202839;767;68;23;2;21;.913;3600000;0
16073;87758;3913;20;9;4;5;.556;921000;0
16073;142810;3913;32;31;6;25;.806;2679000;0
16074;1756;4989;0;0;0;0;.00nan;0;0
16074;193576;774;77;20;1;19;.950;3600000;0
16074;190570;4989;64;36;4;32;.889;3600000;0
16074;149191;774;0;0;0;0;.00nan;0;0
16075;181910;1492;0;0;0;0;.00nan;0;0
16075;86343;1492;49;37;5;32;.865;3599000;0
16075;146249;775;39;21;4;17;.810;3600000;0
16075;149280;775;0;0;0;0;.00nan;0;0
16076;169618;766;0;0;0;0;.00nan;0;0
16076;222019;768;89;18;0;18;1.000;3600000;0
16076;185559;766;58;50;7;43;.860;3600000;0
16076;-1;768;0;0;0;0;.00nan;0;0
16077;189581;758;0;0;0;0;.00nan;0;0
16077;174858;3730;0;0;0;0;.00nan;0;0
16077;176686;758;65;22;2;20;.909;3600000;0
16077;149112;3730;85;26;1;25;.962;3600000;0
16078;166226;1093;0;0;0;0;.00nan;0;0
16078;186234;911;0;0;0;0;.00nan;0;0
16078;63932;1093;92;39;3;36;.923;3600000;0
16078;149048;911;46;21;4;17;.810;3551000;0
16079;178116;759;31;10;3;7;.700;3600000;0
16079;175761;769;0;0;0;0;.00nan;0;0
16079;-1;769;54;44;5;39;.886;3563000;0
16079;94134;759;0;0;0;0;.00nan;0;0
16080;177356;762;60;34;4;30;.882;3547000;0
16080;188815;762;0;0;0;0;.00nan;0;0
16080;189264;4923;0;0;0;0;.00nan;0;0
16080;179406;4923;62;26;3;23;.885;3600000;0
16081;174898;1503;68;21;1;20;.952;3600000;0
16081;207194;754;100;30;0;30;1.000;3600000;0
16081;196698;1503;0;0;0;0;.00nan;0;0
16081;149119;754;0;0;0;0;.00nan;0;0
16082;199033;750;0;0;0;0;.00nan;0;0
16082;170530;755;65;36;4;32;.889;3600000;0
16082;180154;755;0;0;0;0;.00nan;0;0
16082;212428;750;100;41;0;41;1.000;3600000;0
16083;166023;767;0;0;0;0;.00nan;0;0
16083;181910;1492;0;0;0;0;.00nan;0;0
16083;202839;767;79;12;0;12;1.000;3600000;0
16083;86343;1492;76;35;2;33;.943;3519000;0
16084;1756;4989;0;0;0;0;.00nan;0;0
16084;180188;4924;87;30;1;29;.967;3544000;0
16084;190570;4989;100;24;0;24;1.000;3600000;0
16084;91194;4924;0;0;0;0;.00nan;0;0
16085;193576;774;0;0;0;0;.00nan;0;0
16085;87758;3913;0;0;0;0;.00nan;0;0
16085;142810;3913;73;29;2;27;.931;3600000;0
16085;149191;774;56;34;5;29;.853;3600000;0
16086;359;760;0;0;0;0;.00nan;0;0
16086;-1;760;88;47;3;44;.936;3600000;0
16086;146249;775;0;0;0;0;.00nan;0;0
16086;149280;775;72;16;1;15;.938;3600000;0
16087;175761;769;0;0;0;0;.00nan;0;0
16087;222019;768;41;21;4;17;.810;3600000;0
16087;-1;769;69;56;7;49;.875;3600000;0
16087;-1;768;0;0;0;0;.00nan;0;0
16088;174858;3730;100;45;0;45;1.000;3600000;0
16088;174898;1503;70;28;2;26;.929;3588000;0
16088;196698;1503;0;0;0;0;.00nan;0;0
16088;149112;3730;0;0;0;0;.00nan;0;0
16089;174894;2545;62;36;5;31;.861;3600000;0
16089;186234;911;0;0;0;0;.00nan;0;0
16089;94107;2545;0;0;0;0;.00nan;0;0
16089;149048;911;58;17;2;15;.882;3600000;0
16090;199033;750;0;0;0;0;.00nan;0;0
16090;178116;759;0;0;0;0;.00nan;0;0
16090;212428;750;42;23;4;19;.826;3600000;0
16090;94134;759;91;34;1;33;.971;3600000;0
16091;177356;762;0;0;0;0;.00nan;0;0
16091;188815;762;74;18;1;17;.944;3600000;0
16091;166226;1093;0;0;0;0;.00nan;0;0
16091;63932;1093;62;32;4;28;.875;3600000;0
16092;189581;758;50;35;6;29;.829;3600000;0
16092;176686;758;0;0;0;0;.00nan;0;0
16092;-1;772;77;26;1;25;.962;3600000;0
16092;145463;772;0;0;0;0;.00nan;0;0
16093;207194;754;51;19;3;16;.842;3600000;0
16093;190589;2197;44;37;6;31;.838;3600000;0
16093;67818;2197;0;0;0;0;.00nan;0;0
16093;149119;754;0;0;0;0;.00nan;0;0
16094;164521;3721;75;33;2;31;.939;3521000;0
16094;170530;755;100;26;0;26;1.000;3600000;0
16094;180154;755;0;0;0;0;.00nan;0;0
16094;201933;3721;0;0;0;0;.00nan;0;0
16095;167629;746;55;19;2;17;.895;3600000;0
16095;164454;746;0;0;0;0;.00nan;0;0
16095;169618;766;71;45;5;40;.889;3600000;0
16095;185559;766;0;0;0;0;.00nan;0;0
16096;359;760;0;0;0;0;.00nan;0;0
16096;166023;767;0;0;0;0;.00nan;0;0
16096;-1;760;84;31;2;29;.935;3600000;0
16096;202839;767;76;30;3;27;.900;3552000;0
16097;180188;4924;83;31;1;30;.968;3600000;0
16097;87758;3913;0;0;0;0;.00nan;0;0
16097;91194;4924;0;0;0;0;.00nan;0;0
16097;142810;3913;50;19;2;17;.895;3600000;0
16098;193576;774;0;0;0;0;.00nan;0;0
16098;181910;1492;0;0;0;0;.00nan;0;0
16098;86343;1492;98;34;2;32;.941;3900000;0
16098;149191;774;66;25;2;23;.920;3900000;0
16099;1756;4989;93;30;1;29;.967;3312000;0
16099;190570;4989;31;9;3;6;.667;288000;0
16099;146249;775;0;0;0;0;.00nan;0;0
16099;149280;775;99;29;0;29;1.000;3600000;0
16100;199033;750;0;0;0;0;.00nan;0;0
16100;222019;768;0;0;0;0;.00nan;0;0
16100;212428;750;62;33;4;29;.879;3600000;0
16100;-1;768;91;34;1;33;.971;3600000;0
16101;174858;3730;56;23;3;20;.870;3600000;0
16101;190589;2197;100;26;0;26;1.000;3600000;0
16101;67818;2197;0;0;0;0;.00nan;0;0
16101;149112;3730;0;0;0;0;.00nan;0;0
16102;186234;911;0;0;0;0;.00nan;0;0
16102;-1;2199;0;0;0;0;.00nan;0;0
16102;148691;2199;93;31;1;30;.968;3900000;0
16102;149048;911;71;23;1;22;.957;3900000;0
16103;164521;3721;0;0;0;0;.00nan;0;0
16103;178116;759;0;0;0;0;.00nan;0;0
16103;201933;3721;69;41;4;37;.902;3551000;0
16103;94134;759;53;24;3;21;.875;3600000;0
16104;177356;762;0;0;0;0;.00nan;0;0
16104;188815;762;34;21;5;16;.762;3600000;0
16104;174894;2545;39;31;6;25;.806;3600000;0
16104;94107;2545;0;0;0;0;.00nan;0;0
16105;174898;1503;80;41;3;38;.927;3550000;0
16105;196698;1503;0;0;0;0;.00nan;0;0
16105;-1;772;58;19;2;17;.895;3600000;0
16105;145463;772;0;0;0;0;.00nan;0;0
16106;175757;1497;66;30;3;27;.900;3787000;0
16106;216807;1497;0;0;0;0;.00nan;0;0
16106;207194;754;79;37;4;33;.892;3787000;0
16106;149119;754;0;0;0;0;.00nan;0;0
16107;169618;766;100;38;1;37;.974;3600000;0
16107;170530;755;64;36;4;32;.889;3600000;0
16107;180154;755;0;0;0;0;.00nan;0;0
16107;185559;766;0;0;0;0;.00nan;0;0
16108;167629;746;0;0;0;0;.00nan;0;0
16108;164454;746;46;20;3;17;.850;3600000;0
16108;175761;769;0;0;0;0;.00nan;0;0
16108;-1;769;61;44;5;39;.886;3544000;0
16109;1756;4989;0;0;0;0;.00nan;0;0
16109;166023;767;0;0;0;0;.00nan;0;0
16109;190570;4989;100;46;2;44;.957;3600000;0
16109;202839;767;24;19;5;14;.737;3600000;0
16110;180188;4924;70;38;3;35;.921;3532000;0
16110;181910;1492;0;0;0;0;.00nan;0;0
16110;86343;1492;99;36;1;35;.972;3600000;0
16110;91194;4924;0;0;0;0;.00nan;0;0
16111;359;760;0;0;0;0;.00nan;0;0
16111;193576;774;0;0;0;0;.00nan;0;0
16111;-1;760;77;26;2;24;.923;3900000;0
16111;149191;774;69;30;2;28;.933;3900000;0
16112;87758;3913;0;0;0;0;.00nan;0;0
16112;142810;3913;100;46;2;44;.957;3900000;0
16112;146249;775;0;0;0;0;.00nan;0;0
16112;149280;775;77;27;2;25;.926;3900000;0
16113;164521;3721;87;47;4;43;.915;3600000;0
16113;222019;768;75;23;1;22;.957;3600000;0
16113;201933;3721;0;0;0;0;.00nan;0;0
16113;-1;768;0;0;0;0;.00nan;0;0
16114;174858;3730;87;29;1;28;.966;3600000;0
16114;175757;1497;80;37;3;34;.919;3543000;0
16114;216807;1497;0;0;0;0;.00nan;0;0
16114;149112;3730;0;0;0;0;.00nan;0;0
16115;178116;759;0;0;0;0;.00nan;0;0
16115;169618;766;74;48;5;43;.896;3600000;0
16115;185559;766;0;0;0;0;.00nan;0;0
16115;94134;759;69;25;2;23;.920;3600000;0
16116;177356;762;0;0;0;0;.00nan;0;0
16116;188815;762;38;28;5;23;.821;3600000;0
16116;-1;2199;0;0;0;0;.00nan;0;0
16116;148691;2199;69;17;1;16;.941;3600000;0
16117;190589;2197;79;27;1;26;.963;3581000;0
16117;-1;772;100;25;0;25;1.000;3600000;0
16117;67818;2197;0;0;0;0;.00nan;0;0
16117;145463;772;0;0;0;0;.00nan;0;0
16118;199033;750;0;0;0;0;.00nan;0;0
16118;167629;746;86;27;1;26;.963;3594000;0
16118;164454;746;0;0;0;0;.00nan;0;0
16118;212428;750;100;32;0;32;1.000;3600000;0
16119;359;760;0;0;0;0;.00nan;0;0
16119;-1;760;57;10;1;9;.900;3600000;0
16119;180188;4924;0;0;0;0;.00nan;0;0
16119;91194;4924;60;25;2;23;.920;3566000;0
16120;166226;1093;0;0;0;0;.00nan;0;0
16120;189264;4923;68;26;2;24;.923;3745000;0
16120;179406;4923;0;0;0;0;.00nan;0;0
16120;63932;1093;68;23;1;22;.957;3745000;0
16121;175757;1497;34;19;4;15;.789;1052000;0
16121;216807;1497;39;17;3;14;.824;2548000;0
16121;-1;772;92;20;0;20;1.000;3600000;0
16121;145463;772;0;0;0;0;.00nan;0;0
16122;189581;758;0;0;0;0;.00nan;0;0
16122;174898;1503;0;0;0;0;.00nan;0;0
16122;176686;758;97;47;3;44;.936;3900000;0
16122;196698;1503;70;28;3;25;.893;3900000;0
16123;167629;746;0;0;0;0;.00nan;0;0
16123;164454;746;82;14;0;14;1.000;3600000;0
16123;164521;3721;86;42;3;39;.929;3600000;0
16123;201933;3721;0;0;0;0;.00nan;0;0
16124;166023;767;0;0;0;0;.00nan;0;0
16124;202839;767;71;17;1;16;.941;3659000;0
16124;87758;3913;85;32;2;30;.938;3659000;0
16124;142810;3913;0;0;0;0;.00nan;0;0
16125;1756;4989;0;0;0;0;.00nan;0;0
16125;193576;774;0;0;0;0;.00nan;0;0
16125;190570;4989;91;31;1;30;.968;3600000;0
16125;149191;774;59;30;3;27;.900;3514000;0
16126;174894;2545;72;26;2;24;.923;3600000;0
16126;186234;911;0;0;0;0;.00nan;0;0
16126;94107;2545;0;0;0;0;.00nan;0;0
16126;149048;911;49;28;4;24;.857;3559000;0
16127;174858;3730;0;0;0;0;.00nan;0;0
16127;190589;2197;0;0;0;0;.00nan;0;0
16127;67818;2197;77;23;1;22;.957;3600000;0
16127;149112;3730;55;27;3;24;.889;3523000;0
16128;175761;769;95;52;3;49;.942;3600000;0
16128;222019;768;0;0;0;0;.00nan;0;0
16128;-1;769;0;0;0;0;.00nan;0;0
16128;-1;768;27;15;4;11;.733;3545000;0
16129;169618;766;0;0;0;0;.00nan;0;0
16129;170530;755;87;30;1;29;.967;3600000;0
16129;180154;755;0;0;0;0;.00nan;0;0
16129;185559;766;87;35;2;33;.943;3600000;0
16130;174898;1503;63;23;2;21;.913;3560000;0
16130;207194;754;69;23;1;22;.957;3600000;0
16130;196698;1503;0;0;0;0;.00nan;0;0
16130;149119;754;0;0;0;0;.00nan;0;0
16131;199033;750;0;0;0;0;.00nan;0;0
16131;178116;759;0;0;0;0;.00nan;0;0
16131;212428;750;80;42;4;38;.905;3900000;0
16131;94134;759;57;31;4;27;.871;3900000;0
16132;87758;3913;0;0;0;0;.00nan;0;0
16132;142810;3913;90;43;2;41;.953;3600000;0
16132;146249;775;0;0;0;0;.00nan;0;0
16132;149280;775;96;23;1;22;.957;3600000;0
16133;1756;4989;94;32;1;31;.969;3600000;0
16133;166023;767;0;0;0;0;.00nan;0;0
16133;190570;4989;0;0;0;0;.00nan;0;0
16133;202839;767;67;20;2;18;.900;3554000;0
16134;186234;911;0;0;0;0;.00nan;0;0
16134;-1;2199;0;0;0;0;.00nan;0;0
16134;148691;2199;71;22;1;21;.955;3600000;0
16134;149048;911;70;33;4;29;.879;3600000;0
16135;180188;4924;96;31;1;30;.968;3600000;0
16135;181910;1492;45;33;5;28;.848;3600000;0
16135;86343;1492;0;0;0;0;.00nan;0;0
16135;91194;4924;0;0;0;0;.00nan;0;0
16136;359;760;0;0;0;0;.00nan;0;0
16136;193576;774;0;0;0;0;.00nan;0;0
16136;-1;760;81;30;1;29;.967;3900000;0
16136;149191;774;77;17;1;16;.941;3900000;0
16137;177356;762;0;0;0;0;.00nan;0;0
16137;188815;762;74;23;2;21;.913;3900000;0
16137;174894;2545;74;29;2;27;.931;3900000;0
16137;94107;2545;0;0;0;0;.00nan;0;0
16138;190589;2197;70;24;2;22;.917;3600000;0
16138;-1;772;42;23;4;19;.826;3567000;0
16138;67818;2197;0;0;0;0;.00nan;0;0
16138;145463;772;0;0;0;0;.00nan;0;0
16139;164521;3721;0;0;0;0;.00nan;0;0
16139;178116;759;0;0;0;0;.00nan;0;0
16139;201933;3721;95;56;2;54;.964;3600000;0
16139;94134;759;75;12;0;12;1.000;3600000;0
16140;189581;758;0;0;0;0;.00nan;0;0
16140;176686;758;80;36;3;33;.917;3600000;0
16140;207194;754;51;29;4;25;.862;3590000;0
16140;149119;754;0;0;0;0;.00nan;0;0
16141;167629;746;0;0;0;0;.00nan;0;0
16141;164454;746;80;11;0;11;1.000;3600000;0
16141;175761;769;0;0;0;0;.00nan;0;0
16141;-1;769;93;40;2;38;.950;3600000;0
16142;169618;766;85;34;2;32;.941;3900000;0
16142;222019;768;59;23;2;21;.913;3900000;0
16142;185559;766;0;0;0;0;.00nan;0;0
16142;-1;768;0;0;0;0;.00nan;0;0
16143;199033;750;57;21;2;19;.905;3600000;0
16143;170530;755;40;24;5;19;.792;3600000;0
16143;180154;755;0;0;0;0;.00nan;0;0
16143;212428;750;0;0;0;0;.00nan;0;0
16144;174858;3730;69;37;4;33;.892;3600000;0
16144;175757;1497;0;0;0;0;.00nan;0;0
16144;216807;1497;15;26;7;19;.731;3600000;0
16144;149112;3730;0;0;0;0;.00nan;0;0
16145;180188;4924;38;18;4;14;.778;1141000;0
16145;87758;3913;0;0;0;0;.00nan;0;0
16145;91194;4924;59;22;2;20;.909;2459000;0
16145;142810;3913;59;22;2;20;.909;3600000;0
16146;1756;4989;0;0;0;0;.00nan;0;0
16146;190570;4989;84;34;1;33;.971;3589000;0
16146;146249;775;0;0;0;0;.00nan;0;0
16146;149280;775;84;16;0;16;1.000;3600000;0
16147;177356;762;0;0;0;0;.00nan;0;0
16147;188815;762;77;45;3;42;.933;3900000;0
16147;-1;2199;0;0;0;0;.00nan;0;0
16147;148691;2199;56;21;3;18;.857;3900000;0
16148;193576;774;0;0;0;0;.00nan;0;0
16148;181910;1492;0;0;0;0;.00nan;0;0
16148;86343;1492;64;28;2;26;.929;3600000;0
16148;149191;774;72;21;1;20;.952;3600000;0
16149;359;760;68;31;3;28;.903;3580000;0
16149;166023;767;0;0;0;0;.00nan;0;0
16149;-1;760;0;0;0;0;.00nan;0;0
16149;202839;767;78;30;2;28;.933;3600000;0
16150;166226;1093;0;0;0;0;.00nan;0;0
16150;186234;911;0;0;0;0;.00nan;0;0
16150;63932;1093;52;24;3;21;.875;3596000;0
16150;149048;911;64;20;2;18;.900;3600000;0
16151;207194;754;100;42;1;41;.976;3600000;0
16151;190589;2197;70;27;2;25;.926;3592000;0
16151;67818;2197;0;0;0;0;.00nan;0;0
16151;149119;754;0;0;0;0;.00nan;0;0
16152;164521;3721;64;37;4;33;.892;3551000;0
16152;170530;755;64;28;3;25;.893;3600000;0
16152;180154;755;0;0;0;0;.00nan;0;0
16152;201933;3721;0;0;0;0;.00nan;0;0
16153;178116;759;0;0;0;0;.00nan;0;0
16153;175761;769;0;0;0;0;.00nan;0;0
16153;-1;769;75;49;4;45;.918;3590000;0
16153;94134;759;42;15;3;12;.800;3600000;0
16154;167629;746;0;0;0;0;.00nan;0;0
16154;164454;746;48;23;3;20;.870;3600000;0
16154;169618;766;76;48;4;44;.917;3555000;0
16154;185559;766;0;0;0;0;.00nan;0;0
16155;174858;3730;50;7;1;6;.857;812000;0
16155;174898;1503;83;30;2;28;.933;3600000;0
16155;196698;1503;0;0;0;0;.00nan;0;0
16155;149112;3730;51;31;6;25;.806;2788000;0
16156;199033;750;0;0;0;0;.00nan;0;0
16156;222019;768;0;0;0;0;.00nan;0;0
16156;212428;750;70;41;5;36;.878;3600000;0
16156;-1;768;73;19;1;18;.947;3600000;0
16157;175757;1497;74;33;3;30;.909;3591000;0
16157;216807;1497;0;0;0;0;.00nan;0;0
16157;-1;772;0;0;0;0;.00nan;0;0
16157;145463;772;74;22;1;21;.955;3600000;0
16158;193576;774;0;0;0;0;.00nan;0;0
16158;87758;3913;54;4;0;4;1.000;469000;0
16158;142810;3913;30;39;7;32;.821;3131000;0
16158;149191;774;56;25;3;22;.880;3600000;0
16159;1756;4989;0;0;0;0;.00nan;0;0
16159;180188;4924;100;23;0;23;1.000;3900000;0
16159;190570;4989;81;26;0;26;1.000;3900000;0
16159;91194;4924;0;0;0;0;.00nan;0;0
16160;166023;767;0;0;0;0;.00nan;0;0
16160;181910;1492;0;0;0;0;.00nan;0;0
16160;202839;767;69;18;1;17;.944;3600000;0
16160;86343;1492;75;38;3;35;.921;3559000;0
16161;359;760;0;0;0;0;.00nan;0;0
16161;-1;760;95;19;0;19;1.000;3600000;0
16161;146249;775;0;0;0;0;.00nan;0;0
16161;149280;775;77;28;1;27;.964;3548000;0
16162;189264;4923;0;0;0;0;.00nan;0;0
16162;179406;4923;79;29;1;28;.966;3769000;0
16162;186234;911;0;0;0;0;.00nan;0;0
16162;149048;911;94;37;2;35;.946;3769000;0
16163;177356;762;0;0;0;0;.00nan;0;0
16163;188815;762;89;37;2;35;.946;3900000;0
16163;166226;1093;58;20;2;18;.900;3900000;0
16163;63932;1093;0;0;0;0;.00nan;0;0
16164;164521;3721;0;0;0;0;.00nan;0;0
16164;222019;768;82;11;0;11;1.000;3600000;0
16164;201933;3721;80;44;3;41;.932;3600000;0
16164;-1;768;0;0;0;0;.00nan;0;0
16165;189581;758;99;41;1;40;.976;3600000;0
16165;174858;3730;49;25;3;22;.880;3565000;0
16165;176686;758;0;0;0;0;.00nan;0;0
16165;149112;3730;0;0;0;0;.00nan;0;0
16166;170530;755;70;22;3;19;.864;3536000;0
16166;175761;769;0;0;0;0;.00nan;0;0
16166;180154;755;0;0;0;0;.00nan;0;0
16166;-1;769;96;37;1;36;.973;3600000;0
16167;178116;759;0;0;0;0;.00nan;0;0
16167;169618;766;96;51;2;49;.961;3583000;0
16167;185559;766;0;0;0;0;.00nan;0;0
16167;94134;759;51;11;1;10;.909;3600000;0
16168;174898;1503;76;19;1;18;.947;3600000;0
16168;196698;1503;0;0;0;0;.00nan;0;0
16168;-1;772;97;45;2;43;.956;3596000;0
16168;145463;772;0;0;0;0;.00nan;0;0
16169;199033;750;0;0;0;0;.00nan;0;0
16169;167629;746;66;38;4;34;.895;3900000;0
16169;164454;746;0;0;0;0;.00nan;0;0
16169;212428;750;53;37;4;33;.892;3900000;0
16170;175757;1497;68;34;3;31;.912;3600000;0
16170;216807;1497;0;0;0;0;.00nan;0;0
16170;207194;754;89;19;0;19;1.000;3600000;0
16170;149119;754;0;0;0;0;.00nan;0;0
16171;181910;1492;0;0;0;0;.00nan;0;0
16171;86343;1492;48;38;5;33;.868;3558000;0
16171;146249;775;0;0;0;0;.00nan;0;0
16171;149280;775;47;17;3;14;.824;3600000;0
16172;359;760;0;0;0;0;.00nan;0;0
16172;-1;760;81;21;1;20;.952;3600000;0
16172;180188;4924;51;27;5;22;.815;3600000;0
16172;91194;4924;0;0;0;0;.00nan;0;0
16173;177356;762;0;0;0;0;.00nan;0;0
16173;188815;762;72;30;3;27;.900;3900000;0
16173;189264;4923;0;0;0;0;.00nan;0;0
16173;179406;4923;68;26;3;23;.885;3900000;0
16174;167629;746;0;0;0;0;.00nan;0;0
16174;164454;746;72;20;1;19;.950;3600000;0
16174;164521;3721;97;40;2;38;.950;3563000;0
16174;201933;3721;0;0;0;0;.00nan;0;0
16175;189581;758;0;0;0;0;.00nan;0;0
16175;176686;758;64;36;3;33;.917;3900000;0
16175;-1;772;0;0;0;0;.00nan;0;0
16175;145463;772;68;30;3;27;.900;3900000;0
16176;175757;1497;95;17;0;17;1.000;3600000;0
16176;216807;1497;0;0;0;0;.00nan;0;0
16176;190589;2197;71;37;4;33;.892;3600000;0
16176;67818;2197;0;0;0;0;.00nan;0;0
16177;166023;767;0;0;0;0;.00nan;0;0
16177;174894;2545;90;38;2;36;.947;3576000;0
16177;202839;767;66;19;1;18;.947;3600000;0
16177;94107;2545;0;0;0;0;.00nan;0;0
16178;193576;774;0;0;0;0;.00nan;0;0
16178;-1;2199;0;0;0;0;.00nan;0;0
16178;148691;2199;59;21;2;19;.905;3600000;0
16178;149191;774;98;48;3;45;.938;3570000;0
16179;1756;4989;48;17;3;14;.824;1057000;0
16179;222019;768;56;12;1;11;.917;3600000;0
16179;190570;4989;31;43;8;35;.814;2543000;0
16179;-1;768;0;0;0;0;.00nan;0;0
16180;199033;750;0;0;0;0;.00nan;0;0
16180;174858;3730;0;0;0;0;.00nan;0;0
16180;212428;750;76;20;1;19;.950;3600000;0
16180;149112;3730;52;30;5;25;.833;3600000;0
16181;169618;766;0;0;0;0;.00nan;0;0
16181;175761;769;43;32;5;27;.844;3600000;0
16181;185559;766;99;48;1;47;.979;3600000;0
16181;-1;769;0;0;0;0;.00nan;0;0
16182;178116;759;0;0;0;0;.00nan;0;0
16182;87758;3913;0;0;0;0;.00nan;0;0
16182;94134;759;61;15;2;13;.867;3600000;0
16182;142810;3913;94;33;1;32;.970;3600000;0
16183;166023;767;0;0;0;0;.00nan;0;0
16183;189264;4923;0;0;0;0;.00nan;0;0
16183;179406;4923;100;34;0;34;1.000;3600000;0
16183;202839;767;79;30;2;28;.933;3576000;0
16184;180188;4924;69;28;3;25;.893;3569000;0
16184;-1;2199;0;0;0;0;.00nan;0;0
16184;91194;4924;0;0;0;0;.00nan;0;0
16184;148691;2199;85;25;1;24;.960;3600000;0
16185;193576;774;77;30;2;28;.933;3569000;0
16185;174894;2545;80;26;1;25;.962;3600000;0
16185;94107;2545;0;0;0;0;.00nan;0;0
16185;149191;774;0;0;0;0;.00nan;0;0
16186;166226;1093;0;0;0;0;.00nan;0;0
16186;63932;1093;94;53;3;50;.943;3900000;0
16186;146249;775;0;0;0;0;.00nan;0;0
16186;149280;775;67;25;3;22;.880;3900000;0
16187;174898;1503;88;23;1;22;.957;3900000;0
16187;190589;2197;96;47;1;46;.979;3900000;0
16187;196698;1503;0;0;0;0;.00nan;0;0
16187;67818;2197;0;0;0;0;.00nan;0;0
16188;222019;768;0;0;0;0;.00nan;0;0
16188;181910;1492;57;6;0;6;1.000;913000;0
16188;-1;768;69;21;2;19;.905;3600000;0
16188;86343;1492;43;40;6;34;.850;2687000;0
16189;164521;3721;67;31;3;28;.903;3557000;0
16189;174858;3730;73;20;1;19;.950;3600000;0
16189;201933;3721;0;0;0;0;.00nan;0;0
16189;149112;3730;0;0;0;0;.00nan;0;0
16190;359;760;0;0;0;0;.00nan;0;0
16190;178116;759;0;0;0;0;.00nan;0;0
16190;-1;760;75;36;3;33;.917;3600000;0
16190;94134;759;95;24;0;24;1.000;3600000;0
16191;199033;750;0;0;0;0;.00nan;0;0
16191;212428;750;100;33;0;33;1.000;3600000;0
16191;-1;772;73;27;1;26;.963;3552000;0
16191;145463;772;0;0;0;0;.00nan;0;0
16192;170530;755;0;0;0;0;.00nan;0;0
16192;180154;755;50;18;2;16;.889;3570000;0
16192;87758;3913;0;0;0;0;.00nan;0;0
16192;142810;3913;92;38;1;37;.974;3600000;0
16193;1756;4989;0;0;0;0;.00nan;0;0
16193;167629;746;67;28;2;26;.929;3865000;0
16193;164454;746;0;0;0;0;.00nan;0;0
16193;190570;4989;100;46;2;44;.957;3900000;0
16194;166023;767;0;0;0;0;.00nan;0;0
16194;166226;1093;60;7;0;7;1.000;747000;0
16194;202839;767;90;33;1;32;.970;3600000;0
16194;63932;1093;46;44;7;37;.841;2853000;0
16195;174894;2545;98;29;0;29;1.000;3900000;0
16195;180188;4924;0;0;0;0;.00nan;0;0
16195;91194;4924;100;36;0;36;1.000;3900000;0
16195;94107;2545;0;0;0;0;.00nan;0;0
16196;177356;762;59;28;3;25;.893;3600000;0
16196;188815;762;0;0;0;0;.00nan;0;0
16196;186234;911;0;0;0;0;.00nan;0;0
16196;149048;911;69;34;4;30;.882;3600000;0
16197;193576;774;0;0;0;0;.00nan;0;0
16197;189264;4923;57;5;0;5;1.000;757000;0
16197;179406;4923;26;28;6;22;.786;2821000;0
16197;149191;774;74;38;5;33;.868;3600000;0
16198;-1;2199;0;0;0;0;.00nan;0;0
16198;146249;775;0;0;0;0;.00nan;0;0
16198;148691;2199;63;20;2;18;.900;3542000;0
16198;149280;775;83;24;1;23;.958;3600000;0
16199;189581;758;0;0;0;0;.00nan;0;0
16199;176686;758;94;27;1;26;.963;3900000;0
16199;190589;2197;88;33;1;32;.970;3900000;0
16199;67818;2197;0;0;0;0;.00nan;0;0
16200;222019;768;41;17;3;14;.824;3600000;0
16200;-1;768;0;0;0;0;.00nan;0;0
16200;87758;3913;0;0;0;0;.00nan;0;0
16200;142810;3913;64;38;5;33;.868;3583000;0
16201;174858;3730;0;0;0;0;.00nan;0;0
16201;175761;769;0;0;0;0;.00nan;0;0
16201;-1;769;74;44;4;40;.909;3544000;0
16201;149112;3730;63;26;3;23;.885;3600000;0
16202;1756;4989;0;0;0;0;.00nan;0;0
16202;178116;759;0;0;0;0;.00nan;0;0
16202;190570;4989;91;46;3;43;.935;3600000;0
16202;94134;759;93;15;0;15;1.000;3600000;0
16203;164521;3721;92;49;4;45;.918;3600000;0
16203;201933;3721;0;0;0;0;.00nan;0;0
16203;-1;772;0;0;0;0;.00nan;0;0
16203;145463;772;68;19;1;18;.947;3600000;0
16204;199033;750;0;0;0;0;.00nan;0;0
16204;212428;750;66;29;2;27;.931;3600000;0
16204;207194;754;92;30;1;29;.967;3600000;0
16204;149119;754;0;0;0;0;.00nan;0;0
16205;359;760;0;0;0;0;.00nan;0;0
16205;-1;760;77;40;4;36;.900;3600000;0
16205;170530;755;80;30;2;28;.933;3600000;0
16205;180154;755;0;0;0;0;.00nan;0;0
16206;167629;746;0;0;0;0;.00nan;0;0
16206;164454;746;87;19;0;19;1.000;3600000;0
16206;181910;1492;49;7;1;6;.857;666000;0
16206;86343;1492;28;24;6;18;.750;2934000;0
16207;174898;1503;89;21;0;21;1.000;3600000;0
16207;175757;1497;98;42;2;40;.952;3517000;0
16207;216807;1497;0;0;0;0;.00nan;0;0
16207;196698;1503;0;0;0;0;.00nan;0;0
16208;166023;767;0;0;0;0;.00nan;0;0
16208;-1;2199;0;0;0;0;.00nan;0;0
16208;202839;767;91;40;2;38;.950;3600000;0
16208;148691;2199;47;24;4;20;.833;3561000;0
16209;189264;4923;0;0;0;0;.00nan;0;0
16209;179406;4923;93;33;2;31;.939;3900000;0
16209;180188;4924;0;0;0;0;.00nan;0;0
16209;91194;4924;70;23;2;21;.913;3900000;0
16210;193576;774;0;0;0;0;.00nan;0;0
16210;166226;1093;0;0;0;0;.00nan;0;0
16210;63932;1093;66;31;3;28;.903;3855000;0
16210;149191;774;53;15;2;13;.867;3855000;0
16211;174894;2545;47;22;4;18;.818;3600000;0
16211;94107;2545;0;0;0;0;.00nan;0;0
16211;146249;775;0;0;0;0;.00nan;0;0
16211;149280;775;84;16;0;16;1.000;3600000;0
16212;359;760;0;0;0;0;.00nan;0;0
16212;-1;760;87;43;3;40;.930;3563000;0
16212;222019;768;0;0;0;0;.00nan;0;0
16212;-1;768;56;12;1;11;.917;3600000;0
16213;169618;766;0;0;0;0;.00nan;0;0
16213;174858;3730;90;31;1;30;.968;3600000;0
16213;185559;766;54;34;5;29;.853;3600000;0
16213;149112;3730;0;0;0;0;.00nan;0;0
16214;178116;759;0;0;0;0;.00nan;0;0
16214;181910;1492;65;41;5;36;.878;2692000;0
16214;86343;1492;40;18;4;14;.778;908000;0
16214;94134;759;82;16;0;16;1.000;3600000;0
16215;175761;769;0;0;0;0;.00nan;0;0
16215;-1;769;62;30;3;27;.900;3900000;0
16215;-1;772;59;29;3;26;.897;3900000;0
16215;145463;772;0;0;0;0;.00nan;0;0
16216;164521;3721;93;45;2;43;.956;3900000;0
16216;201933;3721;0;0;0;0;.00nan;0;0
16216;207194;754;59;19;2;17;.895;3900000;0
16216;149119;754;0;0;0;0;.00nan;0;0
16217;1756;4989;0;0;0;0;.00nan;0;0
16217;170530;755;100;26;0;26;1.000;3600000;0
16217;180154;755;0;0;0;0;.00nan;0;0
16217;190570;4989;82;34;2;32;.941;3516000;0
16218;167629;746;40;12;2;10;.833;3584000;0
16218;164454;746;0;0;0;0;.00nan;0;0
16218;87758;3913;0;0;0;0;.00nan;0;0
16218;142810;3913;89;32;1;31;.969;3600000;0
16219;189581;758;0;0;0;0;.00nan;0;0
16219;175757;1497;85;28;1;27;.964;3600000;0
16219;216807;1497;0;0;0;0;.00nan;0;0
16219;176686;758;60;26;3;23;.885;3560000;0
16220;166226;1093;0;0;0;0;.00nan;0;0
16220;180188;4924;48;24;4;20;.833;3600000;0
16220;63932;1093;90;31;1;30;.968;3600000;0
16220;91194;4924;0;0;0;0;.00nan;0;0
16221;189264;4923;0;0;0;0;.00nan;0;0
16221;179406;4923;64;37;4;33;.892;3600000;0
16221;146249;775;0;0;0;0;.00nan;0;0
16221;149280;775;72;22;1;21;.955;3600000;0
16222;169618;766;0;0;0;0;.00nan;0;0
16222;185559;766;79;25;1;24;.960;3589000;0
16222;-1;772;0;0;0;0;.00nan;0;0
16222;145463;772;99;29;0;29;1.000;3600000;0
16223;175761;769;0;0;0;0;.00nan;0;0
16223;207194;754;69;23;2;21;.913;3900000;0
16223;-1;769;76;32;2;30;.938;3900000;0
16223;149119;754;0;0;0;0;.00nan;0;0
16224;170530;755;86;29;1;28;.966;3600000;0
16224;180154;755;0;0;0;0;.00nan;0;0
16224;181910;1492;0;0;0;0;.00nan;0;0
16224;86343;1492;57;30;3;27;.900;3584000;0
16225;359;760;0;0;0;0;.00nan;0;0
16225;167629;746;0;0;0;0;.00nan;0;0
16225;164454;746;38;14;3;11;.786;3566000;0
16225;-1;760;100;43;2;41;.953;3600000;0
16226;193576;774;0;0;0;0;.00nan;0;0
16226;186234;911;0;0;0;0;.00nan;0;0
16226;149048;911;65;21;1;20;.952;3577000;0
16226;149191;774;94;20;0;20;1.000;3600000;0
16227;177356;762;0;0;0;0;.00nan;0;0
16227;188815;762;68;28;3;25;.893;3600000;0
16227;166023;767;0;0;0;0;.00nan;0;0
16227;202839;767;100;33;0;33;1.000;3600000;0
16228;1756;4989;52;35;5;30;.857;3600000;0
16228;174858;3730;0;0;0;0;.00nan;0;0
16228;190570;4989;0;0;0;0;.00nan;0;0
16228;149112;3730;58;20;2;18;.900;3600000;0
16229;222019;768;0;0;0;0;.00nan;0;0
16229;-1;2199;79;36;3;33;.917;3569000;0
16229;-1;768;83;30;1;29;.967;3600000;0
16229;148691;2199;0;0;0;0;.00nan;0;0
16230;164521;3721;0;0;0;0;.00nan;0;0
16230;201933;3721;94;28;1;27;.964;3600000;0
16230;190589;2197;47;21;3;18;.857;3599000;0
16230;67818;2197;0;0;0;0;.00nan;0;0
16231;178116;759;0;0;0;0;.00nan;0;0
16231;174894;2545;0;0;0;0;.00nan;0;0
16231;94107;2545;78;62;6;56;.903;3600000;0
16231;94134;759;71;21;1;20;.952;3600000;0
16232;169618;766;0;0;0;0;.00nan;0;0
16232;207194;754;81;32;2;30;.938;3600000;0
16232;185559;766;48;31;5;26;.839;3600000;0
16232;149119;754;0;0;0;0;.00nan;0;0
16233;199033;750;0;0;0;0;.00nan;0;0
16233;175757;1497;70;34;3;31;.912;3600000;0
16233;216807;1497;0;0;0;0;.00nan;0;0
16233;212428;750;63;33;4;29;.879;3593000;0
16234;166023;767;0;0;0;0;.00nan;0;0
16234;186234;911;0;0;0;0;.00nan;0;0
16234;202839;767;42;33;6;27;.818;3789000;0
16234;149048;911;38;28;5;23;.821;3778000;0
16235;177356;762;0;0;0;0;.00nan;0;0
16235;193576;774;0;0;0;0;.00nan;0;0
16235;188815;762;99;21;0;21;1.000;3600000;0
16235;149191;774;81;45;5;40;.889;3600000;0
16236;1756;4989;0;0;0;0;.00nan;0;0
16236;190570;4989;47;35;5;30;.857;3600000;0
16236;-1;772;0;0;0;0;.00nan;0;0
16236;145463;772;31;11;4;7;.636;3600000;0
16237;178116;759;0;0;0;0;.00nan;0;0
16237;-1;2199;0;0;0;0;.00nan;0;0
16237;94134;759;63;19;2;17;.895;3600000;0
16237;148691;2199;60;32;4;28;.875;3527000;0
16238;164521;3721;0;0;0;0;.00nan;0;0
16238;175757;1497;91;34;1;33;.971;3600000;0
16238;216807;1497;0;0;0;0;.00nan;0;0
16238;201933;3721;62;24;2;22;.917;3556000;0
16239;359;760;48;11;2;9;.818;3600000;0
16239;-1;760;0;0;0;0;.00nan;0;0
16239;174858;3730;67;29;3;26;.897;3600000;0
16239;149112;3730;0;0;0;0;.00nan;0;0
16240;167629;746;83;15;0;15;1.000;3600000;0
16240;164454;746;0;0;0;0;.00nan;0;0
16240;174894;2545;57;32;4;28;.875;3600000;0
16240;94107;2545;0;0;0;0;.00nan;0;0
16241;175761;769;65;25;2;23;.920;3600000;0
16241;190589;2197;56;21;3;18;.857;3600000;0
16241;-1;769;0;0;0;0;.00nan;0;0
16241;67818;2197;0;0;0;0;.00nan;0;0
16242;189264;4923;0;0;0;0;.00nan;0;0
16242;179406;4923;75;44;4;40;.909;3596000;0
16242;222019;768;53;16;2;14;.875;3600000;0
16242;-1;768;0;0;0;0;.00nan;0;0
16243;166226;1093;0;0;0;0;.00nan;0;0
16243;170530;755;80;32;2;30;.938;3544000;0
16243;180154;755;0;0;0;0;.00nan;0;0
16243;63932;1093;92;33;1;32;.970;3600000;0
16244;199033;750;0;0;0;0;.00nan;0;0
16244;174898;1503;68;26;4;22;.846;3900000;0
16244;212428;750;71;37;4;33;.892;3900000;0
16244;196698;1503;0;0;0;0;.00nan;0;0
16245;180188;4924;91;29;1;28;.966;3600000;0
16245;186234;911;0;0;0;0;.00nan;0;0
16245;91194;4924;0;0;0;0;.00nan;0;0
16245;149048;911;64;26;2;24;.923;3592000;0
16246;177356;762;0;0;0;0;.00nan;0;0
16246;188815;762;63;27;3;24;.889;3600000;0
16246;146249;775;0;0;0;0;.00nan;0;0
16246;149280;775;89;19;0;19;1.000;3600000;0
16247;1756;4989;0;0;0;0;.00nan;0;0
16247;190570;4989;100;31;1;30;.968;3600000;0
16247;207194;754;62;26;3;23;.885;3519000;0
16247;149119;754;0;0;0;0;.00nan;0;0
16248;167629;746;77;25;2;23;.920;3600000;0
16248;164454;746;0;0;0;0;.00nan;0;0
16248;-1;2199;0;0;0;0;.00nan;0;0
16248;148691;2199;76;26;3;23;.885;3571000;0
16249;164521;3721;0;0;0;0;.00nan;0;0
16249;174898;1503;64;26;3;23;.885;3900000;0
16249;201933;3721;64;32;3;29;.906;3900000;0
16249;196698;1503;0;0;0;0;.00nan;0;0
16250;174858;3730;0;0;0;0;.00nan;0;0
16250;181910;1492;76;23;2;21;.913;3600000;0
16250;86343;1492;0;0;0;0;.00nan;0;0
16250;149112;3730;62;31;3;28;.903;3590000;0
16251;359;760;0;0;0;0;.00nan;0;0
16251;-1;760;87;38;2;36;.947;3570000;0
16251;-1;772;0;0;0;0;.00nan;0;0
16251;145463;772;100;31;0;31;1.000;3600000;0
16252;170530;755;47;10;2;8;.800;3600000;0
16252;174894;2545;27;23;5;18;.783;3600000;0
16252;180154;755;0;0;0;0;.00nan;0;0
16252;94107;2545;0;0;0;0;.00nan;0;0
16253;175757;1497;51;23;3;20;.870;3584000;0
16253;175761;769;0;0;0;0;.00nan;0;0
16253;216807;1497;0;0;0;0;.00nan;0;0
16253;-1;769;75;33;2;31;.939;3600000;0
16254;178116;759;0;0;0;0;.00nan;0;0
16254;189264;4923;0;0;0;0;.00nan;0;0
16254;179406;4923;99;37;1;36;.973;3600000;0
16254;94134;759;68;28;2;26;.929;3591000;0
16255;169618;766;91;18;0;18;1.000;3600000;0
16255;190589;2197;59;22;2;20;.909;3540000;0
16255;185559;766;0;0;0;0;.00nan;0;0
16255;67818;2197;0;0;0;0;.00nan;0;0
16256;166226;1093;0;0;0;0;.00nan;0;0
16256;222019;768;86;25;1;24;.960;3600000;0
16256;-1;768;0;0;0;0;.00nan;0;0
16256;63932;1093;88;40;2;38;.950;3600000;0
16257;199033;750;0;0;0;0;.00nan;0;0
16257;189581;758;0;0;0;0;.00nan;0;0
16257;176686;758;60;37;4;33;.892;3593000;0
16257;212428;750;63;20;2;18;.900;3600000;0
16258;186234;911;0;0;0;0;.00nan;0;0
16258;146249;775;0;0;0;0;.00nan;0;0
16258;149048;911;62;20;2;18;.900;3571000;0
16258;149280;775;100;36;1;35;.972;3600000;0
16259;177356;762;34;23;5;18;.783;3546000;0
16259;188815;762;0;0;0;0;.00nan;0;0
16259;180188;4924;0;0;0;0;.00nan;0;0
16259;91194;4924;72;40;4;36;.900;3600000;0
16260;174858;3730;51;2;0;2;1.000;490000;0
16260;87758;3913;70;20;1;19;.950;3600000;0
16260;142810;3913;0;0;0;0;.00nan;0;0
16260;149112;3730;51;42;6;36;.857;3110000;0
16261;170530;755;0;0;0;0;.00nan;0;0
16261;180154;755;86;35;2;33;.943;3886000;0
16261;-1;2199;73;36;3;33;.917;3886000;0
16261;148691;2199;0;0;0;0;.00nan;0;0
16262;164521;3721;34;30;6;24;.800;3600000;0
16262;189581;758;0;0;0;0;.00nan;0;0
16262;176686;758;71;30;2;28;.933;3600000;0
16262;201933;3721;0;0;0;0;.00nan;0;0
16263;181910;1492;0;0;0;0;.00nan;0;0
16263;-1;772;0;0;0;0;.00nan;0;0
16263;86343;1492;40;39;6;33;.846;3600000;0
16263;145463;772;75;12;0;12;1.000;3600000;0
16264;359;760;0;0;0;0;.00nan;0;0
16264;-1;760;58;30;4;26;.867;3600000;0
16264;207194;754;64;16;1;15;.938;3600000;0
16264;149119;754;0;0;0;0;.00nan;0;0
16265;174894;2545;54;48;7;41;.854;3600000;0
16265;222019;768;0;0;0;0;.00nan;0;0
16265;-1;768;81;18;0;18;1.000;3600000;0
16265;94107;2545;0;0;0;0;.00nan;0;0
16266;174898;1503;32;35;7;28;.800;3213000;0
16266;175761;769;0;0;0;0;.00nan;0;0
16266;196698;1503;49;1;0;1;1.000;340000;0
16266;-1;769;56;38;5;33;.868;3600000;0
16267;167629;746;0;0;0;0;.00nan;0;0
16267;164454;746;62;27;3;24;.889;3600000;0
16267;189264;4923;0;0;0;0;.00nan;0;0
16267;179406;4923;46;26;5;21;.808;3515000;0
16268;169618;766;0;0;0;0;.00nan;0;0
16268;175757;1497;57;23;3;20;.870;3600000;0
16268;216807;1497;0;0;0;0;.00nan;0;0
16268;185559;766;100;27;0;27;1.000;3600000;0
16269;178116;759;0;0;0;0;.00nan;0;0
16269;166226;1093;0;0;0;0;.00nan;0;0
16269;63932;1093;50;28;4;24;.857;3600000;0
16269;94134;759;76;12;0;12;1.000;3600000;0
16270;199033;750;0;0;0;0;.00nan;0;0
16270;212428;750;73;25;2;23;.920;3600000;0
16270;190589;2197;26;34;7;27;.794;2799000;0
16270;67818;2197;64;12;0;12;1.000;801000;0
16271;-1;772;0;0;0;0;.00nan;0;0
16271;87758;3913;0;0;0;0;.00nan;0;0
16271;142810;3913;73;26;1;25;.962;3900000;0
16271;145463;772;92;37;1;36;.973;3900000;0
16272;207194;754;66;26;2;24;.923;3600000;0
16272;181910;1492;0;0;0;0;.00nan;0;0
16272;86343;1492;55;25;3;22;.880;3600000;0
16272;149119;754;0;0;0;0;.00nan;0;0
16273;189581;758;0;0;0;0;.00nan;0;0
16273;175761;769;0;0;0;0;.00nan;0;0
16273;176686;758;86;38;3;35;.921;3575000;0
16273;-1;769;90;33;1;32;.970;3600000;0
16274;170530;755;44;29;5;24;.828;3600000;0
16274;179406;4923;62;21;2;19;.905;3600000;0
16274;180154;755;0;0;0;0;.00nan;0;0
16274;-1;4923;0;0;0;0;.00nan;0;0
16275;169618;766;0;0;0;0;.00nan;0;0
16275;174898;1503;91;13;0;13;1.000;3600000;0
16275;185559;766;77;37;4;33;.892;3600000;0
16275;196698;1503;0;0;0;0;.00nan;0;0
16276;167629;746;64;20;2;18;.900;3600000;0
16276;164454;746;0;0;0;0;.00nan;0;0
16276;166226;1093;40;18;3;15;.833;1210000;0
16276;63932;1093;43;38;6;32;.842;2390000;0
16277;193576;774;0;0;0;0;.00nan;0;0
16277;166023;767;0;0;0;0;.00nan;0;0
16277;202839;767;78;26;2;24;.923;3600000;0
16277;149191;774;42;43;7;36;.837;3600000;0
16278;207194;754;80;30;2;28;.933;3600000;0
16278;87758;3913;0;0;0;0;.00nan;0;0
16278;142810;3913;67;31;3;28;.903;3574000;0
16278;149119;754;0;0;0;0;.00nan;0;0
16279;222019;768;0;0;0;0;.00nan;0;0
16279;186234;911;0;0;0;0;.00nan;0;0
16279;-1;768;73;21;1;20;.952;3600000;0
16279;149048;911;53;29;4;25;.862;3600000;0
16280;174858;3730;64;24;2;22;.917;3600000;0
16280;174894;2545;49;26;4;22;.846;3572000;0
16280;94107;2545;0;0;0;0;.00nan;0;0
16280;149112;3730;0;0;0;0;.00nan;0;0
16281;169618;766;80;26;1;25;.962;3600000;0
16281;189581;758;62;28;3;25;.893;3531000;0
16281;176686;758;0;0;0;0;.00nan;0;0
16281;185559;766;0;0;0;0;.00nan;0;0
16282;166023;767;0;0;0;0;.00nan;0;0
16282;180188;4924;55;30;3;27;.900;3600000;0
16282;202839;767;65;24;2;22;.917;3600000;0
16282;91194;4924;0;0;0;0;.00nan;0;0
16283;193576;774;0;0;0;0;.00nan;0;0
16283;146249;775;0;0;0;0;.00nan;0;0
16283;149191;774;73;31;2;29;.935;3526000;0
16283;149280;775;80;18;1;17;.944;3600000;0
16284;359;760;0;0;0;0;.00nan;0;0
16284;-1;760;72;19;1;18;.947;3600000;0
16284;175757;1497;0;0;0;0;.00nan;0;0
16284;216807;1497;69;29;2;27;.931;3600000;0
16285;199033;750;0;0;0;0;.00nan;0;0
16285;164521;3721;0;0;0;0;.00nan;0;0
16285;204272;750;46;27;4;23;.852;3600000;0
16285;201933;3721;69;46;5;41;.891;3556000;0
16286;174858;3730;0;0;0;0;.00nan;0;0
16286;-1;2199;0;0;0;0;.00nan;0;0
16286;148691;2199;45;29;5;24;.828;3900000;0
16286;149112;3730;53;35;5;30;.857;3900000;0
16287;174894;2545;67;35;3;32;.914;3600000;0
16287;-1;772;58;18;2;16;.889;3600000;0
16287;94107;2545;0;0;0;0;.00nan;0;0
16287;145463;772;0;0;0;0;.00nan;0;0
16288;167629;746;0;0;0;0;.00nan;0;0
16288;201947;746;76;17;1;16;.941;3600000;0
16288;186234;911;0;0;0;0;.00nan;0;0
16288;149048;911;79;26;2;24;.923;3600000;0
16289;359;760;0;0;0;0;.00nan;0;0
16289;-1;760;64;20;2;18;.900;3600000;0
16289;190589;2197;100;31;0;31;1.000;3600000;0
16289;67818;2197;0;0;0;0;.00nan;0;0
16290;180188;4924;52;48;7;41;.854;3600000;0
16290;91194;4924;0;0;0;0;.00nan;0;0
16290;146249;775;70;20;1;19;.950;3600000;0
16290;149280;775;0;0;0;0;.00nan;0;0
16291;166226;1093;0;0;0;0;.00nan;0;0
16291;189264;4923;0;0;0;0;.00nan;0;0
16291;179406;4923;68;37;4;33;.892;3600000;0
16291;63932;1093;35;24;5;19;.792;3583000;0
16292;1756;4989;0;0;0;0;.00nan;0;0
16292;175757;1497;78;29;3;26;.897;3900000;0
16292;216807;1497;0;0;0;0;.00nan;0;0
16292;190570;4989;53;21;3;18;.857;3900000;0
16293;189581;758;0;0;0;0;.00nan;0;0
16293;176686;758;96;23;1;22;.957;3600000;0
16293;87758;3913;0;0;0;0;.00nan;0;0
16293;142810;3913;57;28;3;25;.893;3545000;0
16294;-1;2199;0;0;0;0;.00nan;0;0
16294;-1;772;0;0;0;0;.00nan;0;0
16294;145463;772;34;25;5;20;.800;3600000;0
16294;148691;2199;58;18;2;16;.889;3600000;0
16295;174894;2545;51;35;5;30;.857;3600000;0
16295;207194;754;0;0;0;0;.00nan;0;0
16295;94107;2545;0;0;0;0;.00nan;0;0
16295;149119;754;100;27;0;27;1.000;3600000;0
16296;169618;766;0;0;0;0;.00nan;0;0
16296;175761;769;0;0;0;0;.00nan;0;0
16296;185559;766;49;25;4;21;.840;3600000;0
16296;-1;769;79;27;1;26;.963;3600000;0
16297;174898;1503;52;20;3;17;.850;3600000;0
16297;181910;1492;0;0;0;0;.00nan;0;0
16297;196698;1503;0;0;0;0;.00nan;0;0
16297;86343;1492;82;52;4;48;.923;3550000;0
16298;170530;755;87;40;2;38;.950;3543000;0
16298;180154;755;0;0;0;0;.00nan;0;0
16298;186234;911;0;0;0;0;.00nan;0;0
16298;149048;911;95;30;1;29;.967;3600000;0
16299;177356;762;0;0;0;0;.00nan;0;0
16299;167629;746;0;0;0;0;.00nan;0;0
16299;188815;762;98;49;3;46;.939;3600000;0
16299;201947;746;95;19;0;19;1.000;3600000;0
16300;1756;4989;0;0;0;0;.00nan;0;0
16300;190570;4989;64;18;1;17;.944;3600000;0
16300;190589;2197;46;25;4;21;.840;3600000;0
16300;67818;2197;0;0;0;0;.00nan;0;0
16301;193576;774;0;0;0;0;.00nan;0;0
16301;180188;4924;0;0;0;0;.00nan;0;0
16301;91194;4924;75;26;1;25;.962;3600000;0
16301;149191;774;95;23;0;23;1.000;3600000;0
16302;166023;767;0;0;0;0;.00nan;0;0
16302;202839;767;54;30;4;26;.867;3600000;0
16302;146249;775;0;0;0;0;.00nan;0;0
16302;149280;775;93;30;1;29;.967;3600000;0
16303;177356;762;0;0;0;0;.00nan;0;0
16303;188815;762;56;41;6;35;.854;3600000;0
16303;222019;768;0;0;0;0;.00nan;0;0
16303;180177;768;30;21;5;16;.762;3600000;0
16304;189581;758;100;23;0;23;1.000;3600000;0
16304;176686;758;0;0;0;0;.00nan;0;0
16304;181910;1492;0;0;0;0;.00nan;0;0
16304;86343;1492;98;42;2;40;.952;3541000;0
16305;178116;759;0;0;0;0;.00nan;0;0
16305;186234;911;0;0;0;0;.00nan;0;0
16305;94134;759;83;27;1;26;.963;3600000;0
16305;149048;911;55;38;5;33;.868;3600000;0
16306;207194;754;0;0;0;0;.00nan;0;0
16306;-1;2199;89;18;0;18;1.000;3600000;0
16306;148691;2199;0;0;0;0;.00nan;0;0
16306;149119;754;71;33;3;30;.909;3600000;0
16307;174898;1503;88;23;1;22;.957;3600000;0
16307;196698;1503;0;0;0;0;.00nan;0;0
16307;87758;3913;0;0;0;0;.00nan;0;0
16307;142810;3913;58;37;5;32;.865;3600000;0
16308;189264;4923;0;0;0;0;.00nan;0;0
16308;174858;3730;43;18;3;15;.833;3600000;0
16308;179406;4923;100;25;0;25;1.000;3600000;0
16308;149112;3730;0;0;0;0;.00nan;0;0
16309;164521;3721;0;0;0;0;.00nan;0;0
16309;175761;769;0;0;0;0;.00nan;0;0
16309;201933;3721;100;49;3;46;.939;3900000;0
16309;-1;769;62;29;3;26;.897;3900000;0
16310;199033;750;0;0;0;0;.00nan;0;0
16310;204272;750;53;24;3;21;.875;3600000;0
16310;169618;766;82;44;4;40;.909;3569000;0
16310;185559;766;0;0;0;0;.00nan;0;0
16311;166226;1093;0;0;0;0;.00nan;0;0
16311;174858;3730;0;0;0;0;.00nan;0;0
16311;63932;1093;100;25;0;25;1.000;3600000;0
16311;149112;3730;67;28;2;26;.929;3546000;0
16312;359;760;0;0;0;0;.00nan;0;0
16312;-1;760;97;38;1;37;.974;3900000;0
16312;189581;758;64;17;1;16;.941;3900000;0
16312;176686;758;0;0;0;0;.00nan;0;0
16313;189264;4923;0;0;0;0;.00nan;0;0
16313;179406;4923;68;37;4;33;.892;3610000;0
16313;-1;772;0;0;0;0;.00nan;0;0
16313;145463;772;38;25;5;20;.800;3610000;0
16314;170530;4989;0;0;0;0;.00nan;0;0
16314;174898;1503;0;0;0;0;.00nan;0;0
16314;190570;4989;76;39;3;36;.923;3600000;0
16314;196698;1503;65;24;2;22;.917;3600000;0
16315;190589;2197;63;33;3;30;.909;3553000;0
16315;67818;2197;0;0;0;0;.00nan;0;0
16315;87758;3913;0;0;0;0;.00nan;0;0
16315;142810;3913;63;18;2;16;.889;3600000;0
16316;174894;2545;55;35;5;30;.857;3600000;0
16316;-1;2199;67;15;1;14;.933;3600000;0
16316;94107;2545;0;0;0;0;.00nan;0;0
16316;148691;2199;0;0;0;0;.00nan;0;0
16317;164521;3721;0;0;0;0;.00nan;0;0
16317;169618;766;0;0;0;0;.00nan;0;0
16317;201933;3721;41;25;4;21;.840;3600000;0
16317;185559;766;67;28;2;26;.929;3600000;0
16318;167629;746;0;0;0;0;.00nan;0;0
16318;180188;4924;63;33;3;30;.909;3559000;0
16318;201947;746;67;22;2;20;.909;3600000;0
16318;148904;4924;0;0;0;0;.00nan;0;0
16319;177356;762;0;0;0;0;.00nan;0;0
16319;188815;762;65;18;1;17;.944;3600000;0
16319;-1;755;72;32;2;30;.938;3544000;0
16319;91194;755;0;0;0;0;.00nan;0;0
16320;199033;750;0;0;0;0;.00nan;0;0
16320;204272;750;39;28;5;23;.821;3559000;0
16320;175761;769;0;0;0;0;.00nan;0;0
16320;-1;769;61;26;3;23;.885;3600000;0
16321;175757;1497;70;24;2;22;.917;3600000;0
16321;216807;1497;0;0;0;0;.00nan;0;0
16321;181910;1492;0;0;0;0;.00nan;0;0
16321;86343;1492;70;32;3;29;.906;3553000;0
16322;189581;758;0;0;0;0;.00nan;0;0
16322;170530;4989;91;35;3;32;.914;3600000;0
16322;176686;758;52;15;2;13;.867;3600000;0
16322;190570;4989;0;0;0;0;.00nan;0;0
16323;166226;1093;0;0;0;0;.00nan;0;0
16323;-1;772;0;0;0;0;.00nan;0;0
16323;63932;1093;68;29;3;26;.897;3560000;0
16323;145463;772;96;40;2;38;.950;3600000;0
16324;189264;4923;0;0;0;0;.00nan;0;0
16324;179406;4923;78;24;1;23;.958;3600000;0
16324;207194;754;84;33;2;31;.939;3552000;0
16324;149119;754;0;0;0;0;.00nan;0;0
16325;359;760;0;0;0;0;.00nan;0;0
16325;-1;760;90;34;2;32;.941;3532000;0
16325;174898;1503;100;22;0;22;1.000;3600000;0
16325;196698;1503;0;0;0;0;.00nan;0;0
16326;190589;2197;0;0;0;0;.00nan;0;0
16326;181910;1492;0;0;0;0;.00nan;0;0
16326;67818;2197;50;41;6;35;.854;3600000;0
16326;86343;1492;65;23;3;20;.870;3600000;0
16327;180177;768;66;21;2;19;.905;3545000;0
16327;180188;4924;100;45;1;44;.978;3600000;0
16327;-1;768;0;0;0;0;.00nan;0;0
16327;148904;4924;0;0;0;0;.00nan;0;0
16328;177356;762;0;0;0;0;.00nan;0;0
16328;178116;759;63;14;1;13;.929;3561000;0
16328;188815;762;100;51;0;51;1.000;3600000;0
16328;94134;759;0;0;0;0;.00nan;0;0
16329;193576;774;0;0;0;0;.00nan;0;0
16329;167629;746;0;0;0;0;.00nan;0;0
16329;201947;746;88;27;0;27;1.000;3900000;0
16329;149191;774;100;25;0;25;1.000;3900000;0
16330;175757;1497;0;0;0;0;.00nan;0;0
16330;216807;1497;97;39;1;38;.974;3600000;0
16330;87758;3913;0;0;0;0;.00nan;0;0
16330;142810;3913;63;24;2;22;.917;3575000;0
16331;166226;1093;0;0;0;0;.00nan;0;0
16331;207194;754;57;25;4;21;.840;3600000;0
16331;63932;1093;87;29;1;28;.966;3600000;0
16331;149119;754;0;0;0;0;.00nan;0;0
16332;167629;746;0;0;0;0;.00nan;0;0
16332;166023;767;0;0;0;0;.00nan;0;0
16332;201947;746;74;30;3;27;.900;3528000;0
16332;202839;767;85;27;1;26;.963;3600000;0
16333;-1;755;0;0;0;0;.00nan;0;0
16333;180188;4924;94;25;0;25;1.000;3600000;0
16333;91194;755;94;36;1;35;.972;3600000;0
16333;148904;4924;0;0;0;0;.00nan;0;0
16334;174858;3730;64;23;2;21;.913;3600000;0
16334;186234;911;0;0;0;0;.00nan;0;0
16334;149048;911;49;23;3;20;.870;3537000;0
16334;149112;3730;0;0;0;0;.00nan;0;0
16335;193576;774;55;4;0;4;1.000;834000;0
16335;180177;768;63;16;1;15;.938;3600000;0
16335;-1;768;0;0;0;0;.00nan;0;0
16335;149191;774;42;41;6;35;.854;2766000;0
16336;204272;750;73;35;2;33;.943;3518000;0
16336;170530;4989;0;0;0;0;.00nan;0;0
16336;212428;750;0;0;0;0;.00nan;0;0
16336;190570;4989;100;31;0;31;1.000;3600000;0
16337;175757;1497;56;32;5;27;.844;3600000;0
16337;216807;1497;0;0;0;0;.00nan;0;0
16337;-1;2199;0;0;0;0;.00nan;0;0
16337;148691;2199;76;26;2;24;.923;3600000;0
16338;359;760;52;28;4;24;.857;3600000;0
16338;164521;3721;48;8;1;7;.875;967000;0
16338;-1;760;0;0;0;0;.00nan;0;0
16338;201933;3721;22;23;6;17;.739;2633000;0
16339;174894;2545;0;0;0;0;.00nan;0;0
16339;190589;2197;77;27;3;24;.889;3576000;0
16339;67818;2197;0;0;0;0;.00nan;0;0
16339;146249;2545;74;26;2;24;.923;3600000;0
16340;189264;4923;78;23;1;22;.957;3600000;0
16340;174898;1503;49;31;5;26;.839;3600000;0
16340;179406;4923;0;0;0;0;.00nan;0;0
16340;196698;1503;0;0;0;0;.00nan;0;0
16341;166023;767;0;0;0;0;.00nan;0;0
16341;180177;768;67;26;2;24;.923;3590000;0
16341;202839;767;96;21;0;21;1.000;3600000;0
16341;-1;768;0;0;0;0;.00nan;0;0
16342;178116;759;0;0;0;0;.00nan;0;0
16342;93756;759;49;25;4;21;.840;3545000;0
16342;94107;4924;80;39;3;36;.923;3600000;0
16342;148904;4924;0;0;0;0;.00nan;0;0
16343;186234;911;0;0;0;0;.00nan;0;0
16343;-1;772;0;0;0;0;.00nan;0;0
16343;145463;772;80;30;2;28;.933;3600000;0
16343;149048;911;74;24;1;23;.958;3600000;0
16344;177356;762;0;0;0;0;.00nan;0;0
16344;188815;762;56;22;3;19;.864;3600000;0
16344;174858;3730;0;0;0;0;.00nan;0;0
16344;149112;3730;55;27;4;23;.852;3583000;0
16345;193576;774;0;0;0;0;.00nan;0;0
16345;91194;755;0;0;0;0;.00nan;0;0
16345;94134;755;73;28;2;26;.929;3519000;0
16345;149191;774;100;27;0;27;1.000;3600000;0
16346;176686;746;59;35;5;30;.857;3600000;0
16346;180154;775;40;2;1;1;.500;354000;0
16346;201947;746;0;0;0;0;.00nan;0;0
16346;149280;775;44;39;7;32;.821;3246000;0
16347;204272;750;63;28;3;25;.893;3570000;0
16347;212428;750;0;0;0;0;.00nan;0;0
16347;87758;3913;0;0;0;0;.00nan;0;0
16347;142810;3913;84;30;1;29;.967;3600000;0
16348;170530;4989;0;0;0;0;.00nan;0;0
16348;175761;769;0;0;0;0;.00nan;0;0
16348;190570;4989;67;19;1;18;.947;3600000;0
16348;-1;769;58;22;2;20;.909;3600000;0
16349;174898;1503;67;37;4;33;.892;3600000;0
16349;180188;2199;0;0;0;0;.00nan;0;0
16349;196698;1503;0;0;0;0;.00nan;0;0
16349;86343;2199;73;28;2;26;.929;3600000;0
16350;164521;3721;0;0;0;0;.00nan;0;0
16350;201933;3721;81;35;2;33;.943;3553000;0
16350;181910;1492;86;25;1;24;.960;3600000;0
16350;148691;1492;0;0;0;0;.00nan;0;0
16351;359;760;0;0;0;0;.00nan;0;0
16351;-1;760;80;22;1;21;.955;3631000;0
16351;169618;766;0;0;0;0;.00nan;0;0
16351;189581;766;78;28;2;26;.929;3631000;0
16352;174894;2545;0;0;0;0;.00nan;0;0
16352;175757;1497;0;0;0;0;.00nan;0;0
16352;216807;1497;56;38;5;33;.868;3600000;0
16352;146249;2545;76;27;2;25;.926;3600000;0
16353;167629;758;85;29;2;27;.931;3600000;0
16353;189264;4923;0;0;0;0;.00nan;0;0
16353;179406;4923;63;32;4;28;.875;3516000;0
16353;82711;758;0;0;0;0;.00nan;0;0
16354;166226;1093;48;30;5;25;.833;3836000;0
16354;190589;2197;0;0;0;0;.00nan;0;0
16354;63932;1093;0;0;0;0;.00nan;0;0
16354;67818;2197;79;45;4;41;.911;3836000;0
16355;166023;767;0;0;0;0;.00nan;0;0
16355;202839;767;96;35;1;34;.971;3600000;0
16355;91194;755;0;0;0;0;.00nan;0;0
16355;94134;755;64;42;4;38;.905;3600000;0
16356;207194;754;87;21;0;21;1.000;3600000;0
16356;186234;911;0;0;0;0;.00nan;0;0
16356;148652;754;0;0;0;0;.00nan;0;0
16356;149048;911;54;16;2;14;.875;3600000;0
16357;177356;762;0;0;0;0;.00nan;0;0
16357;188815;762;97;40;3;37;.925;3900000;0
16357;-1;772;0;0;0;0;.00nan;0;0
16357;145463;772;83;24;3;21;.875;3900000;0
16358;193576;774;0;0;0;0;.00nan;0;0
16358;178116;759;0;0;0;0;.00nan;0;0
16358;93756;759;56;21;2;19;.905;3600000;0
16358;149191;774;60;28;3;25;.893;3579000;0
16359;180154;775;44;6;1;5;.833;981000;0
16359;180177;768;63;27;3;24;.889;3600000;0
16359;-1;768;0;0;0;0;.00nan;0;0
16359;149280;775;41;35;6;29;.829;2619000;0
16360;164521;3721;0;0;0;0;.00nan;0;0
16360;201933;3721;81;25;2;23;.920;3900000;0
16360;87758;3913;0;0;0;0;.00nan;0;0
16360;142810;3913;77;27;2;25;.926;3900000;0
16361;169618;766;0;0;0;0;.00nan;0;0
16361;189581;766;78;35;2;33;.943;3600000;0
16361;170530;4989;0;0;0;0;.00nan;0;0
16361;190570;4989;45;30;5;25;.833;3600000;0
16362;167629;758;0;0;0;0;.00nan;0;0
16362;180188;2199;0;0;0;0;.00nan;0;0
16362;82711;758;88;34;1;33;.971;3900000;0
16362;86343;2199;85;23;1;22;.957;3900000;0
16363;204272;750;97;37;2;35;.946;3900000;0
16363;212428;750;0;0;0;0;.00nan;0;0
16363;181910;1492;0;0;0;0;.00nan;0;0
16363;148691;1492;68;21;2;19;.905;3900000;0
16364;359;760;0;0;0;0;.00nan;0;0
16364;-1;760;67;35;4;31;.886;3600000;0
16364;175761;769;0;0;0;0;.00nan;0;0
16364;-1;769;100;31;0;31;1.000;3600000;0
16365;174894;2545;0;0;0;0;.00nan;0;0
16365;174898;1503;100;22;0;22;1.000;3900000;0
16365;196698;1503;0;0;0;0;.00nan;0;0
16365;146249;2545;85;24;0;24;1.000;3900000;0
16366;189264;4923;0;0;0;0;.00nan;0;0
16366;179406;4923;60;13;1;12;.923;3600000;0
16366;190589;2197;91;41;2;39;.951;3600000;0
16366;67818;2197;0;0;0;0;.00nan;0;0
16367;166226;1093;0;0;0;0;.00nan;0;0
16367;175757;1497;59;19;2;17;.895;3555000;0
16367;216807;1497;0;0;0;0;.00nan;0;0
16367;63932;1093;82;24;1;23;.958;3600000;0
16368;178116;759;0;0;0;0;.00nan;0;0
16368;166023;767;0;0;0;0;.00nan;0;0
16368;202839;767;88;33;2;31;.939;3900000;0
16368;93756;759;60;20;2;18;.900;3900000;0
16369;174858;3730;40;26;4;22;.846;3534000;0
16369;94107;4924;0;0;0;0;.00nan;0;0
16369;148904;4924;67;24;2;22;.917;3600000;0
16369;149112;3730;0;0;0;0;.00nan;0;0
16370;177356;762;0;0;0;0;.00nan;0;0
16370;188815;762;96;27;0;27;1.000;3600000;0
16370;207194;754;81;22;1;21;.955;3600000;0
16370;148652;754;0;0;0;0;.00nan;0;0
16371;180154;775;62;21;2;19;.905;3900000;0
16371;91194;755;0;0;0;0;.00nan;0;0
16371;94134;755;73;29;2;27;.931;3900000;0
16371;149280;775;0;0;0;0;.00nan;0;0
16372;169618;766;0;0;0;0;.00nan;0;0
16372;189581;766;66;33;3;30;.909;3579000;0
16372;87758;3913;56;15;2;13;.867;3600000;0
16372;142810;3913;0;0;0;0;.00nan;0;0
16373;164521;3721;0;0;0;0;.00nan;0;0
16373;170530;4989;100;27;0;27;1.000;3900000;0
16373;201933;3721;81;25;0;25;1.000;3900000;0
16373;190570;4989;0;0;0;0;.00nan;0;0
16374;180188;2199;63;18;2;16;.889;3600000;0
16374;190589;2197;0;0;0;0;.00nan;0;0
16374;67818;2197;98;52;3;49;.942;3585000;0
16374;86343;2199;0;0;0;0;.00nan;0;0
16375;175761;769;0;0;0;0;.00nan;0;0
16375;181910;1492;0;0;0;0;.00nan;0;0
16375;-1;769;86;30;1;29;.967;3600000;0
16375;148691;1492;85;27;2;25;.926;3552000;0
16376;359;760;0;0;0;0;.00nan;0;0
16376;204272;750;84;28;1;27;.964;3900000;0
16376;-1;760;85;22;1;21;.955;3900000;0
16376;212428;750;0;0;0;0;.00nan;0;0
16377;167629;758;0;0;0;0;.00nan;0;0
16377;174894;2545;0;0;0;0;.00nan;0;0
16377;82711;758;34;24;5;19;.792;3600000;0
16377;146249;2545;87;39;2;37;.949;3600000;0
16378;189264;4923;0;0;0;0;.00nan;0;0
16378;179406;4923;73;30;3;27;.900;3900000;0
16378;175757;1497;0;0;0;0;.00nan;0;0
16378;216807;1497;67;29;3;26;.897;3900000;0
16379;166226;1093;0;0;0;0;.00nan;0;0
16379;174898;1503;64;29;3;26;.897;3900000;0
16379;196698;1503;0;0;0;0;.00nan;0;0
16379;63932;1093;85;37;3;34;.919;3900000;0
16380;193576;774;0;0;0;0;.00nan;0;0
16380;174858;3730;0;0;0;0;.00nan;0;0
16380;149112;3730;89;30;1;29;.967;3600000;0
16380;149191;774;48;22;3;19;.864;3568000;0
16381;-1;772;61;26;2;24;.923;3844000;0
16381;94107;4924;0;0;0;0;.00nan;0;0
16381;145463;772;0;0;0;0;.00nan;0;0
16381;148904;4924;43;18;3;15;.833;3844000;0
16382;178116;759;0;0;0;0;.00nan;0;0
16382;180154;775;79;31;2;29;.935;3600000;0
16382;93756;759;65;29;3;26;.897;3600000;0
16382;149280;775;0;0;0;0;.00nan;0;0
16383;211572;3913;0;0;0;0;.00nan;0;0
16383;175761;769;0;0;0;0;.00nan;0;0
16383;-1;769;75;29;3;26;.897;3600000;0
16383;142810;3913;33;21;5;16;.762;3514000;0
16384;169618;766;0;0;0;0;.00nan;0;0
16384;189581;766;56;38;5;33;.868;3600000;0
16384;181910;1492;0;0;0;0;.00nan;0;0
16384;148691;1492;92;30;1;29;.967;3600000;0
16385;176686;746;0;0;0;0;.00nan;0;0
16385;180177;768;75;22;1;21;.955;3600000;0
16385;201947;746;69;38;4;34;.895;3600000;0
16385;-1;768;0;0;0;0;.00nan;0;0
16386;167629;758;0;0;0;0;.00nan;0;0
16386;166226;1093;35;27;5;22;.815;3600000;0
16386;63932;1093;0;0;0;0;.00nan;0;0
16386;82711;758;93;22;0;22;1.000;3600000;0
16387;166023;767;0;0;0;0;.00nan;0;0
16387;174858;3730;73;24;2;22;.917;3600000;0
16387;202839;767;77;19;1;18;.947;3600000;0
16387;149112;3730;0;0;0;0;.00nan;0;0
16388;193576;774;0;0;0;0;.00nan;0;0
16388;-1;772;0;0;0;0;.00nan;0;0
16388;145463;772;77;29;1;28;.966;3900000;0
16388;149191;774;93;32;1;31;.969;3900000;0
16389;207194;754;51;29;5;24;.828;3600000;0
16389;94107;4924;0;0;0;0;.00nan;0;0
16389;148652;754;0;0;0;0;.00nan;0;0
16389;148904;4924;74;27;2;25;.926;3600000;0
16390;177356;762;0;0;0;0;.00nan;0;0
16390;188815;762;93;21;0;21;1.000;3789000;0
16390;190589;2197;0;0;0;0;.00nan;0;0
16390;67818;2197;92;37;1;36;.973;3789000;0
16391;164521;3721;0;0;0;0;.00nan;0;0
16391;174894;2545;0;0;0;0;.00nan;0;0
16391;201933;3721;82;42;4;38;.905;3600000;0
16391;146249;2545;82;24;1;23;.958;3600000;0
16392;176686;746;96;24;0;24;1.000;3600000;0
16392;201947;746;0;0;0;0;.00nan;0;0
16392;91194;755;0;0;0;0;.00nan;0;0
16392;94134;755;52;40;6;34;.850;3600000;0
16393;204272;750;73;26;2;24;.923;3600000;0
16393;180188;2199;0;0;0;0;.00nan;0;0
16393;212428;750;0;0;0;0;.00nan;0;0
16393;86343;2199;52;24;3;21;.875;3584000;0
16394;175757;1497;52;28;4;24;.857;3825000;0
16394;216807;1497;0;0;0;0;.00nan;0;0
16394;186234;911;0;0;0;0;.00nan;0;0
16394;149048;911;44;30;5;25;.833;3825000;0
16395;174858;3730;0;0;0;0;.00nan;0;0
16395;180154;775;82;19;1;18;.947;3600000;0
16395;149112;3730;95;34;2;32;.941;3573000;0
16395;149280;775;0;0;0;0;.00nan;0;0
16396;166023;767;0;0;0;0;.00nan;0;0
16396;202839;767;60;22;2;20;.909;3900000;0
16396;-1;772;0;0;0;0;.00nan;0;0
16396;145463;772;83;32;2;30;.938;3900000;0
16397;193576;774;0;0;0;0;.00nan;0;0
16397;207194;754;86;39;3;36;.923;3524000;0
16397;148652;754;0;0;0;0;.00nan;0;0
16397;149191;774;96;33;1;32;.970;3600000;0
16398;190589;2197;0;0;0;0;.00nan;0;0
16398;186234;911;0;0;0;0;.00nan;0;0
16398;67818;2197;65;30;3;27;.900;3567000;0
16398;149048;911;89;30;1;29;.967;3600000;0
16399;164521;3721;0;0;0;0;.00nan;0;0
16399;166226;1093;0;0;0;0;.00nan;0;0
16399;201933;3721;82;37;3;34;.919;3600000;0
16399;63932;1093;18;23;6;17;.739;3600000;0
16400;180177;768;76;28;2;26;.929;3545000;0
16400;-1;768;0;0;0;0;.00nan;0;0
16400;91194;755;0;0;0;0;.00nan;0;0
16400;94134;755;100;40;1;39;.975;3600000;0
16401;174894;2545;0;0;0;0;.00nan;0;0
16401;175761;769;0;0;0;0;.00nan;0;0
16401;-1;769;57;33;4;29;.879;3570000;0
16401;146249;2545;64;25;2;23;.920;3600000;0
16402;169618;766;0;0;0;0;.00nan;0;0
16402;189581;766;100;41;1;40;.976;3600000;0
16402;180188;2199;50;23;3;20;.870;3556000;0
16402;86343;2199;0;0;0;0;.00nan;0;0
16403;178116;759;0;0;0;0;.00nan;0;0
16403;176686;746;70;33;3;30;.909;3563000;0
16403;201947;746;0;0;0;0;.00nan;0;0
16403;93756;759;61;22;2;20;.909;3600000;0
16404;204272;750;55;26;3;23;.885;3543000;0
16404;189264;4923;0;0;0;0;.00nan;0;0
16404;179406;4923;66;24;2;22;.917;3600000;0
16404;212428;750;0;0;0;0;.00nan;0;0
16405;177356;762;0;0;0;0;.00nan;0;0
16405;188815;762;94;33;1;32;.970;3600000;0
16405;175757;1497;0;0;0;0;.00nan;0;0
16405;216807;1497;74;28;2;26;.929;3582000;0
16406;359;760;0;0;0;0;.00nan;0;0
16406;-1;760;36;33;6;27;.818;3513000;0
16406;211572;3913;0;0;0;0;.00nan;0;0
16406;142810;3913;48;24;4;20;.833;3600000;0
16407;170530;4989;86;27;1;26;.963;3900000;0
16407;190570;4989;0;0;0;0;.00nan;0;0
16407;181910;1492;0;0;0;0;.00nan;0;0
16407;148691;1492;97;52;1;51;.981;3900000;0
16408;180154;775;44;20;3;17;.850;3552000;0
16408;-1;772;77;30;2;28;.933;3600000;0
16408;145463;772;0;0;0;0;.00nan;0;0
16408;149280;775;0;0;0;0;.00nan;0;0
16409;166023;767;0;0;0;0;.00nan;0;0
16409;207194;754;86;25;1;24;.960;3900000;0
16409;202839;767;81;21;1;20;.952;3900000;0
16409;148652;754;0;0;0;0;.00nan;0;0
16410;164521;3721;0;0;0;0;.00nan;0;0
16410;189264;4923;0;0;0;0;.00nan;0;0
16410;179406;4923;70;23;1;22;.957;3546000;0
16410;201933;3721;100;40;0;40;1.000;3600000;0
16411;178116;759;0;0;0;0;.00nan;0;0
16411;180177;768;61;26;3;23;.885;3600000;0
16411;-1;768;0;0;0;0;.00nan;0;0
16411;93756;759;74;29;2;27;.931;3600000;0
16412;167629;758;0;0;0;0;.00nan;0;0
16412;186234;911;32;16;4;12;.750;3074000;0
16412;82711;758;66;29;3;26;.897;3600000;0
16412;149048;911;23;4;3;1;.250;526000;0
16413;175761;769;60;24;2;22;.917;3600000;0
16413;180188;2199;0;0;0;0;.00nan;0;0
16413;-1;769;0;0;0;0;.00nan;0;0
16413;86343;2199;39;18;4;14;.778;3527000;0
16414;169618;766;0;0;0;0;.00nan;0;0
16414;189581;766;55;19;2;17;.895;3597000;0
16414;174894;2545;0;0;0;0;.00nan;0;0
16414;146249;2545;99;24;0;24;1.000;3600000;0
16415;177356;762;0;0;0;0;.00nan;0;0
16415;188815;762;59;30;3;27;.900;3550000;0
16415;174898;1503;67;24;2;22;.917;3600000;0
16415;196698;1503;0;0;0;0;.00nan;0;0
16416;204272;750;64;32;3;29;.906;3600000;0
16416;166226;1093;0;0;0;0;.00nan;0;0
16416;212428;750;0;0;0;0;.00nan;0;0
16416;63932;1093;99;26;0;26;1.000;3600000;0
16417;170530;4989;0;0;0;0;.00nan;0;0
16417;211572;3913;0;0;0;0;.00nan;0;0
16417;190570;4989;78;42;3;39;.929;3576000;0
16417;142810;3913;73;20;1;19;.950;3600000;0
16418;359;760;0;0;0;0;.00nan;0;0
16418;-1;760;92;27;1;26;.963;3600000;0
16418;181910;1492;0;0;0;0;.00nan;0;0
16418;148691;1492;41;22;4;18;.818;3600000;0
16419;180154;775;66;31;3;28;.903;3900000;0
16419;207194;754;91;40;3;37;.925;3900000;0
16419;148652;754;0;0;0;0;.00nan;0;0
16419;149280;775;0;0;0;0;.00nan;0;0
16420;164521;3721;51;9;1;8;.889;642000;0
16420;180188;2199;26;5;3;2;.400;510000;0
16420;201933;3721;52;42;7;35;.833;2958000;0
16420;86343;2199;62;15;1;14;.933;3090000;0
16421;177356;762;0;0;0;0;.00nan;0;0
16421;167629;758;73;26;2;24;.923;3547000;0
16421;188815;762;90;29;1;28;.966;3600000;0
16421;82711;758;0;0;0;0;.00nan;0;0
16422;189264;4923;0;0;0;0;.00nan;0;0
16422;179406;4923;75;25;2;23;.920;3600000;0
16422;175761;769;0;0;0;0;.00nan;0;0
16422;-1;769;79;32;3;29;.906;3569000;0
16423;166226;1093;0;0;0;0;.00nan;0;0
16423;169618;766;0;0;0;0;.00nan;0;0
16423;189581;766;69;33;3;30;.909;3600000;0
16423;63932;1093;42;19;4;15;.789;3552000;0
16424;174898;1503;79;29;2;27;.931;3900000;0
16424;196698;1503;0;0;0;0;.00nan;0;0
16424;186234;911;0;0;0;0;.00nan;0;0
16424;149048;911;61;24;2;22;.917;3900000;0
16425;178116;759;0;0;0;0;.00nan;0;0
16425;91194;755;83;45;4;41;.911;3600000;0
16425;93756;759;66;13;1;12;.923;3600000;0
16425;94134;755;0;0;0;0;.00nan;0;0
16426;204272;750;68;18;1;17;.944;3600000;0
16426;174894;2545;0;0;0;0;.00nan;0;0
16426;212428;750;0;0;0;0;.00nan;0;0
16426;146249;2545;53;31;4;27;.871;3600000;0
16427;174858;3730;0;0;0;0;.00nan;0;0
16427;176686;746;0;0;0;0;.00nan;0;0
16427;201947;746;93;37;1;36;.973;3600000;0
16427;149112;3730;73;47;5;42;.894;3600000;0
16428;190589;2197;29;24;5;19;.792;3305000;0
16428;67818;2197;21;3;3;0;.000;295000;0
16428;94107;4924;42;14;3;11;.786;3600000;0
16428;148904;4924;0;0;0;0;.00nan;0;0
16429;166226;1093;0;0;0;0;.00nan;0;0
16429;175761;769;0;0;0;0;.00nan;0;0
16429;-1;769;93;35;2;33;.943;3900000;0
16429;63932;1093;59;20;2;18;.900;3900000;0
16430;193576;774;100;31;0;31;1.000;3600000;0
16430;175757;1497;55;31;4;27;.871;3600000;0
16430;216807;1497;0;0;0;0;.00nan;0;0
16430;149191;774;0;0;0;0;.00nan;0;0
16431;189264;4923;0;0;0;0;.00nan;0;0
16431;169618;766;0;0;0;0;.00nan;0;0
16431;189581;766;85;43;3;40;.930;3600000;0
16431;179406;4923;32;17;4;13;.765;3600000;0
16432;211572;3913;0;0;0;0;.00nan;0;0
16432;181910;1492;0;0;0;0;.00nan;0;0
16432;142810;3913;80;29;1;28;.966;3600000;0
16432;148691;1492;81;33;2;31;.939;3541000;0
16433;174858;3730;97;47;0;47;1.000;3900000;0
16433;180177;768;90;15;0;15;1.000;3900000;0
16433;-1;768;0;0;0;0;.00nan;0;0
16433;149112;3730;0;0;0;0;.00nan;0;0
16434;-1;772;0;0;0;0;.00nan;0;0
16434;91194;755;0;0;0;0;.00nan;0;0
16434;94134;755;88;33;2;31;.939;3600000;0
16434;145463;772;67;33;3;30;.909;3556000;0
16435;176686;746;66;20;2;18;.900;3600000;0
16435;201947;746;0;0;0;0;.00nan;0;0
16435;207194;754;81;57;6;51;.895;3600000;0
16435;148652;754;0;0;0;0;.00nan;0;0
16436;359;760;0;0;0;0;.00nan;0;0
16436;-1;760;58;31;4;27;.871;3600000;0
16436;180188;2199;0;0;0;0;.00nan;0;0
16436;86343;2199;67;19;1;18;.947;3600000;0
16437;166023;767;0;0;0;0;.00nan;0;0
16437;175757;1497;47;41;6;35;.854;3600000;0
16437;216807;1497;0;0;0;0;.00nan;0;0
16437;202839;767;94;18;0;18;1.000;3600000;0
16438;174898;1503;42;27;5;22;.815;3600000;0
16438;196698;1503;0;0;0;0;.00nan;0;0
16438;94107;4924;0;0;0;0;.00nan;0;0
16438;148904;4924;82;39;3;36;.923;3600000;0
16439;170530;4989;76;33;3;30;.909;3575000;0
16439;174894;2545;0;0;0;0;.00nan;0;0
16439;190570;4989;0;0;0;0;.00nan;0;0
16439;146249;2545;53;16;2;14;.875;3600000;0
16440;204272;750;84;34;2;32;.941;3900000;0
16440;212428;750;0;0;0;0;.00nan;0;0
16440;186234;911;0;0;0;0;.00nan;0;0
16440;149048;911;74;24;2;22;.917;3900000;0
16441;177356;762;78;26;1;25;.962;3600000;0
16441;164521;3721;0;0;0;0;.00nan;0;0
16441;188815;762;0;0;0;0;.00nan;0;0
16441;201933;3721;53;40;5;35;.875;3600000;0
16442;193576;774;63;10;1;9;.900;3600000;0
16442;167629;758;0;0;0;0;.00nan;0;0
16442;82711;758;87;33;2;31;.939;3592000;0
16442;149191;774;0;0;0;0;.00nan;0;0
16443;180154;775;70;14;1;13;.929;3600000;0
16443;190589;2197;0;0;0;0;.00nan;0;0
16443;67818;2197;57;48;6;42;.875;3600000;0
16443;149280;775;0;0;0;0;.00nan;0;0
16444;180177;768;66;21;2;19;.905;3600000;0
16444;207194;754;93;45;4;41;.911;3540000;0
16444;-1;768;0;0;0;0;.00nan;0;0
16444;148652;754;0;0;0;0;.00nan;0;0
16445;178116;759;0;0;0;0;.00nan;0;0
16445;-1;772;0;0;0;0;.00nan;0;0
16445;93756;759;87;17;0;17;1.000;3600000;0
16445;145463;772;81;30;2;28;.933;3600000;0
16446;174858;3730;92;26;1;25;.962;3600000;0
16446;91194;755;0;0;0;0;.00nan;0;0
16446;94134;755;61;32;3;29;.906;3579000;0
16446;149112;3730;0;0;0;0;.00nan;0;0
16447;170530;4989;0;0;0;0;.00nan;0;0
16447;180188;2199;0;0;0;0;.00nan;0;0
16447;190570;4989;84;42;3;39;.929;3600000;0
16447;86343;2199;100;22;0;22;1.000;3600000;0
16448;166023;767;0;0;0;0;.00nan;0;0
16448;190589;2197;95;33;1;32;.970;3600000;0
16448;202839;767;71;24;2;22;.917;3569000;0
16448;67818;2197;0;0;0;0;.00nan;0;0
16449;167629;758;0;0;0;0;.00nan;0;0
16449;82711;758;69;36;3;33;.917;3541000;0
16449;94107;4924;88;34;2;32;.941;3600000;0
16449;148904;4924;0;0;0;0;.00nan;0;0
16450;359;760;0;0;0;0;.00nan;0;0
16450;-1;760;61;23;2;21;.913;3568000;0
16450;174894;2545;0;0;0;0;.00nan;0;0
16450;146249;2545;99;26;1;25;.962;3600000;0
16451;164521;3721;0;0;0;0;.00nan;0;0
16451;201933;3721;74;41;4;37;.902;3600000;0
16451;186234;911;0;0;0;0;.00nan;0;0
16451;149048;911;68;16;1;15;.938;3600000;0
16452;177356;762;0;0;0;0;.00nan;0;0
16452;204272;750;56;22;2;20;.909;3600000;0
16452;188815;762;67;36;3;33;.917;3554000;0
16452;212428;750;0;0;0;0;.00nan;0;0
16453;193576;774;0;0;0;0;.00nan;0;0
16453;174898;1503;73;23;1;22;.957;3759000;0
16453;196698;1503;0;0;0;0;.00nan;0;0
16453;149191;774;93;31;2;29;.935;3759000;0
16454;175757;1497;100;37;0;37;1.000;3600000;0
16454;216807;1497;0;0;0;0;.00nan;0;0
16454;180154;775;70;22;1;21;.955;3573000;0
16454;149280;775;0;0;0;0;.00nan;0;0
16455;178116;759;0;0;0;0;.00nan;0;0
16455;174858;3730;0;0;0;0;.00nan;0;0
16455;93756;759;79;21;1;20;.952;3600000;0
16455;149112;3730;34;40;8;32;.800;3600000;0
16456;207194;754;0;0;0;0;.00nan;0;0
16456;91194;755;0;0;0;0;.00nan;0;0
16456;94134;755;57;19;2;17;.895;3600000;0
16456;148652;754;51;30;4;26;.867;3570000;0
16457;176686;746;0;0;0;0;.00nan;0;0
16457;201947;746;66;17;2;15;.882;3600000;0
16457;-1;772;0;0;0;0;.00nan;0;0
16457;145463;772;84;40;3;37;.925;3588000;0
16458;211572;3913;0;0;0;0;.00nan;0;0
16458;180188;2199;0;0;0;0;.00nan;0;0
16458;86343;2199;60;20;2;18;.900;3600000;0
16458;142810;3913;75;47;5;42;.894;3600000;0
16459;166023;767;0;0;0;0;.00nan;0;0
16459;174898;1503;54;27;4;23;.852;3544000;0
16459;196698;1503;0;0;0;0;.00nan;0;0
16459;202839;767;62;22;3;19;.864;3600000;0
16460;175757;1497;69;45;5;40;.889;3600000;0
16460;216807;1497;0;0;0;0;.00nan;0;0
16460;94107;4924;0;0;0;0;.00nan;0;0
16460;148904;4924;65;26;2;24;.923;3600000;0
16461;174894;2545;0;0;0;0;.00nan;0;0
16461;181910;1492;0;0;0;0;.00nan;0;0
16461;146249;2545;81;24;1;23;.958;3600000;0
16461;148691;1492;43;25;4;21;.840;3600000;0
16462;169618;766;0;0;0;0;.00nan;0;0
16462;189581;766;100;41;0;41;1.000;3600000;0
16462;186234;911;0;0;0;0;.00nan;0;0
16462;149048;911;61;25;3;22;.880;3600000;0
16463;177356;762;0;0;0;0;.00nan;0;0
16463;188815;762;50;28;4;24;.857;3573000;0
16463;175761;769;0;0;0;0;.00nan;0;0
16463;-1;769;76;29;2;27;.931;3600000;0
16464;189264;4923;0;0;0;0;.00nan;0;0
16464;170530;4989;79;35;3;32;.914;3600000;0
16464;179406;4923;99;23;0;23;1.000;3600000;0
16464;190570;4989;0;0;0;0;.00nan;0;0
16465;193576;774;0;0;0;0;.00nan;0;0
16465;190589;2197;0;0;0;0;.00nan;0;0
16465;67818;2197;58;38;5;33;.868;3600000;0
16465;149191;774;74;26;2;24;.923;3600000;0
16466;167629;758;0;0;0;0;.00nan;0;0
16466;180154;775;84;31;2;29;.935;3600000;0
16466;82711;758;50;19;3;16;.842;3590000;0
16466;149280;775;0;0;0;0;.00nan;0;0
16467;359;760;0;0;0;0;.00nan;0;0
16467;166226;1093;54;23;3;20;.870;3551000;0
16467;-1;760;82;23;1;22;.957;3600000;0
16467;63932;1093;0;0;0;0;.00nan;0;0
16468;180177;768;64;15;1;14;.933;3600000;0
16468;-1;768;0;0;0;0;.00nan;0;0
16468;-1;772;0;0;0;0;.00nan;0;0
16468;145463;772;70;47;5;42;.894;3600000;0
16469;178116;759;69;25;2;23;.920;3900000;0
16469;207194;754;100;48;2;46;.958;3900000;0
16469;93756;759;0;0;0;0;.00nan;0;0
16469;148652;754;0;0;0;0;.00nan;0;0
16470;180188;2199;0;0;0;0;.00nan;0;0
16470;181910;1492;70;15;0;15;1.000;1364000;0
16470;86343;2199;56;16;2;14;.875;3600000;0
16470;148691;1492;42;32;5;27;.844;2236000;0
16471;167629;758;0;0;0;0;.00nan;0;0
16471;166023;767;0;0;0;0;.00nan;0;0
16471;202839;767;97;38;2;36;.947;3900000;0
16471;82711;758;80;22;2;20;.909;3900000;0
16472;174894;2545;0;0;0;0;.00nan;0;0
16472;211572;3913;0;0;0;0;.00nan;0;0
16472;142810;3913;70;27;3;24;.889;3576000;0
16472;146249;2545;73;22;1;21;.955;3600000;0
16473;175761;769;0;0;0;0;.00nan;0;0
16473;186234;911;67;18;1;17;.944;3600000;0
16473;-1;769;81;40;4;36;.900;3600000;0
16473;149048;911;0;0;0;0;.00nan;0;0
16474;177356;762;0;0;0;0;.00nan;0;0
16474;188815;762;84;12;0;12;1.000;3600000;0
16474;169618;766;0;0;0;0;.00nan;0;0
16474;189581;766;70;36;4;32;.889;3600000;0
16475;359;760;0;0;0;0;.00nan;0;0
16475;189264;4923;0;0;0;0;.00nan;0;0
16475;-1;760;74;24;2;22;.917;3641000;0
16475;179406;4923;63;22;3;19;.864;3641000;0
16476;174898;1503;76;38;4;34;.895;3600000;0
16476;180154;775;26;25;6;19;.760;3549000;0
16476;196698;1503;0;0;0;0;.00nan;0;0
16476;149280;775;0;0;0;0;.00nan;0;0
16477;166226;1093;0;0;0;0;.00nan;0;0
16477;170530;4989;0;0;0;0;.00nan;0;0
16477;190570;4989;90;44;2;42;.955;3564000;0
16477;63932;1093;68;19;1;18;.947;3600000;0
16478;189264;4923;0;0;0;0;.00nan;0;0
16478;179406;4923;65;24;2;22;.917;3600000;0
16478;181910;1492;33;11;3;8;.727;687000;0
16478;148691;1492;35;31;6;25;.806;2913000;0
16479;166226;1093;0;0;0;0;.00nan;0;0
16479;211572;3913;0;0;0;0;.00nan;0;0
16479;63932;1093;69;29;2;27;.931;3900000;0
16479;142810;3913;100;36;2;34;.944;3900000;0
16480;178116;759;0;0;0;0;.00nan;0;0
16480;190589;2197;0;0;0;0;.00nan;0;0
16480;67818;2197;76;43;4;39;.907;3600000;0
16480;93756;759;69;25;2;23;.920;3600000;0
16481;170530;4989;99;44;1;43;.977;3600000;0
16481;190570;4989;0;0;0;0;.00nan;0;0
16481;186234;911;0;0;0;0;.00nan;0;0
16481;149048;911;71;39;4;35;.897;3600000;0
16482;164521;3721;0;0;0;0;.00nan;0;0
16482;166023;767;0;0;0;0;.00nan;0;0
16482;201933;3721;92;27;1;26;.963;3600000;0
16482;202839;767;52;17;2;15;.882;3564000;0
16483;359;760;49;29;4;25;.862;3600000;0
16483;177356;762;0;0;0;0;.00nan;0;0
16483;188815;762;85;18;0;18;1.000;3600000;0
16483;-1;760;0;0;0;0;.00nan;0;0
16484;167629;758;98;49;2;47;.959;3600000;0
16484;180177;768;77;19;1;18;.947;3600000;0
16484;-1;768;0;0;0;0;.00nan;0;0
16484;82711;758;0;0;0;0;.00nan;0;0
16485;175761;769;57;25;3;22;.880;3541000;0
16485;-1;769;0;0;0;0;.00nan;0;0
16485;94107;4924;0;0;0;0;.00nan;0;0
16485;148904;4924;81;32;2;30;.938;3600000;0
16486;189264;4923;0;0;0;0;.00nan;0;0
16486;179406;4923;32;25;5;20;.800;3543000;0
16486;211572;3913;0;0;0;0;.00nan;0;0
16486;142810;3913;72;41;4;37;.902;3600000;0
16487;193576;774;25;6;3;3;.500;2514000;0
16487;169618;766;0;0;0;0;.00nan;0;0
16487;189581;766;89;42;3;39;.929;3600000;0
16487;149191;774;27;13;4;9;.692;1086000;0
16488;174898;1503;58;38;4;34;.895;3563000;0
16488;176686;746;0;0;0;0;.00nan;0;0
16488;201947;746;78;25;2;23;.920;3600000;0
16488;196698;1503;0;0;0;0;.00nan;0;0
16489;166226;1093;57;30;4;26;.867;3600000;0
16489;181910;1492;0;0;0;0;.00nan;0;0
16489;63932;1093;0;0;0;0;.00nan;0;0
16489;148691;1492;93;27;1;26;.963;3600000;0
16490;204272;750;66;33;3;30;.909;3569000;0
16490;180154;775;84;28;1;27;.964;3600000;0
16490;212428;750;0;0;0;0;.00nan;0;0
16490;149280;775;0;0;0;0;.00nan;0;0
16491;175757;1497;0;0;0;0;.00nan;0;0
16491;216807;1497;60;30;2;28;.933;3600000;0
16491;91194;755;0;0;0;0;.00nan;0;0
16491;94134;755;93;35;1;34;.971;3600000;0
16492;174858;3730;36;17;4;13;.765;3600000;0
16492;-1;772;100;29;0;29;1.000;3600000;0
16492;145463;772;0;0;0;0;.00nan;0;0
16492;149112;3730;0;0;0;0;.00nan;0;0
16493;190589;2197;0;0;0;0;.00nan;0;0
16493;67818;2197;91;34;2;32;.941;3600000;0
16493;91194;755;0;0;0;0;.00nan;0;0
16493;94134;755;59;32;3;29;.906;3573000;0
16494;177356;762;0;0;0;0;.00nan;0;0
16494;188815;762;54;23;4;19;.826;3900000;0
16494;170530;4989;0;0;0;0;.00nan;0;0
16494;190570;4989;49;32;4;28;.875;3900000;0
16495;164521;3721;67;35;4;31;.886;3600000;0
16495;180154;775;59;24;3;21;.875;3600000;0
16495;201933;3721;0;0;0;0;.00nan;0;0
16495;149280;775;0;0;0;0;.00nan;0;0
16496;359;760;0;0;0;0;.00nan;0;0
16496;-1;760;59;26;3;23;.885;3552000;0
16496;186234;911;0;0;0;0;.00nan;0;0
16496;149048;911;83;19;1;18;.947;3600000;0
16497;167629;758;0;0;0;0;.00nan;0;0
16497;176686;746;48;22;3;19;.864;3600000;0
16497;201947;746;0;0;0;0;.00nan;0;0
16497;82711;758;59;34;4;30;.882;3600000;0
16498;193576;774;0;0;0;0;.00nan;0;0
16498;175761;769;0;0;0;0;.00nan;0;0
16498;-1;769;74;34;3;31;.912;3900000;0
16498;149191;774;67;30;3;27;.900;3900000;0
16499;169618;766;0;0;0;0;.00nan;0;0
16499;189581;766;92;37;2;35;.946;3570000;0
16499;94107;4924;0;0;0;0;.00nan;0;0
16499;148904;4924;86;22;1;21;.955;3600000;0
16500;174898;1503;100;31;0;31;1.000;3600000;0
16500;180177;768;56;19;2;17;.895;3528000;0
16500;196698;1503;0;0;0;0;.00nan;0;0
16500;-1;768;0;0;0;0;.00nan;0;0
16501;204272;750;74;34;3;31;.912;3678000;0
16501;166023;767;0;0;0;0;.00nan;0;0
16501;212428;750;0;0;0;0;.00nan;0;0
16501;202839;767;78;30;2;28;.933;3678000;0
16502;178116;759;0;0;0;0;.00nan;0;0
16502;175757;1497;98;41;2;39;.951;3554000;0
16502;216807;1497;0;0;0;0;.00nan;0;0
16502;93756;759;65;17;1;16;.941;3600000;0
16503;207194;754;100;29;0;29;1.000;3600000;0
16503;-1;772;70;31;2;29;.935;3577000;0
16503;145463;772;0;0;0;0;.00nan;0;0
16503;148652;754;0;0;0;0;.00nan;0;0
16504;176686;746;0;0;0;0;.00nan;0;0
16504;201947;746;76;20;1;19;.950;3600000;0
16504;190589;2197;55;33;4;29;.879;3600000;0
16504;67818;2197;0;0;0;0;.00nan;0;0
16505;177356;762;0;0;0;0;.00nan;0;0
16505;188815;762;62;36;4;32;.889;3600000;0
16505;211572;3913;58;40;5;35;.875;3571000;0
16505;142810;3913;0;0;0;0;.00nan;0;0
16506;193576;774;0;0;0;0;.00nan;0;0
16506;164521;3721;0;0;0;0;.00nan;0;0
16506;201933;3721;51;24;3;21;.875;3513000;0
16506;149191;774;81;26;1;25;.962;3600000;0
16507;181910;1492;52;40;5;35;.875;3516000;0
16507;186234;911;50;20;3;17;.850;3600000;0
16507;148691;1492;0;0;0;0;.00nan;0;0
16507;149048;911;0;0;0;0;.00nan;0;0
16508;167629;758;0;0;0;0;.00nan;0;0
16508;82711;758;41;23;4;19;.826;3569000;0
16508;91194;755;0;0;0;0;.00nan;0;0
16508;94134;755;74;33;2;31;.939;3600000;0
16509;175761;769;0;0;0;0;.00nan;0;0
16509;180154;775;74;21;2;19;.905;3600000;0
16509;-1;769;88;44;3;41;.932;3596000;0
16509;149280;775;0;0;0;0;.00nan;0;0
16510;189264;4923;0;0;0;0;.00nan;0;0
16510;174894;2545;0;0;0;0;.00nan;0;0
16510;179406;4923;68;32;3;29;.906;3600000;0
16510;146249;2545;35;18;4;14;.778;3550000;0
16511;166023;767;0;0;0;0;.00nan;0;0
16511;169618;766;0;0;0;0;.00nan;0;0
16511;189581;766;79;46;4;42;.913;3600000;0
16511;202839;767;66;20;1;19;.950;3600000;0
16512;178116;759;0;0;0;0;.00nan;0;0
16512;174898;1503;100;46;2;44;.957;3900000;0
16512;196698;1503;0;0;0;0;.00nan;0;0
16512;93756;759;56;18;2;16;.889;3900000;0
16513;166226;1093;0;0;0;0;.00nan;0;0
16513;180188;2199;0;0;0;0;.00nan;0;0
16513;63932;1093;68;37;4;33;.892;3600000;0
16513;86343;2199;90;25;1;24;.960;3600000;0
16514;204272;750;50;30;4;26;.867;3573000;0
16514;212428;750;0;0;0;0;.00nan;0;0
16514;94107;4924;71;22;1;21;.955;3600000;0
16514;148904;4924;0;0;0;0;.00nan;0;0
16515;175757;1497;0;0;0;0;.00nan;0;0
16515;216807;1497;94;32;1;31;.969;3600000;0
16515;180177;768;56;18;2;16;.889;3572000;0
16515;-1;768;0;0;0;0;.00nan;0;0
16516;174858;3730;0;0;0;0;.00nan;0;0
16516;207194;754;97;48;3;45;.938;3600000;0
16516;148652;754;0;0;0;0;.00nan;0;0
16516;149112;3730;81;13;0;13;1.000;3600000;0
16517;180177;768;43;15;3;12;.800;3600000;0
16517;190589;2197;0;0;0;0;.00nan;0;0
16517;-1;768;0;0;0;0;.00nan;0;0
16517;67818;2197;96;60;5;55;.917;3600000;0
16518;211572;3913;0;0;0;0;.00nan;0;0
16518;186234;911;0;0;0;0;.00nan;0;0
16518;142810;3913;100;43;2;41;.953;3900000;0
16518;149048;911;69;25;2;23;.920;3900000;0
16519;359;760;0;0;0;0;.00nan;0;0
16519;-1;760;71;29;2;27;.931;3563000;0
16519;170530;4989;82;25;1;24;.960;3600000;0
16519;190570;4989;0;0;0;0;.00nan;0;0
16520;164521;3721;0;0;0;0;.00nan;0;0
16520;201933;3721;61;28;3;25;.893;3547000;0
16520;94107;4924;60;21;2;19;.905;3600000;0
16520;148904;4924;0;0;0;0;.00nan;0;0
16521;177356;762;0;0;0;0;.00nan;0;0
16521;188815;762;88;31;2;29;.935;3600000;0
16521;181910;1492;0;0;0;0;.00nan;0;0
16521;148691;1492;66;32;3;29;.906;3599000;0
16522;167629;758;0;0;0;0;.00nan;0;0
16522;178116;759;0;0;0;0;.00nan;0;0
16522;82711;758;69;34;3;31;.912;3593000;0
16522;93756;759;68;21;2;19;.905;3600000;0
16523;166023;767;0;0;0;0;.00nan;0;0
16523;175761;769;0;0;0;0;.00nan;0;0
16523;202839;767;61;25;3;22;.880;3594000;0
16523;-1;769;91;32;2;30;.938;3600000;0
16524;189264;4923;0;0;0;0;.00nan;0;0
16524;179406;4923;81;31;2;29;.935;3600000;0
16524;180188;2199;0;0;0;0;.00nan;0;0
16524;86343;2199;57;22;3;19;.864;3600000;0
16525;169618;766;0;0;0;0;.00nan;0;0
16525;189581;766;57;33;4;29;.879;3600000;0
16525;180154;775;84;30;1;29;.967;3600000;0
16525;149280;775;0;0;0;0;.00nan;0;0
16526;174898;1503;100;24;0;24;1.000;3600000;0
16526;196698;1503;0;0;0;0;.00nan;0;0
16526;91194;755;0;0;0;0;.00nan;0;0
16526;94134;755;79;33;1;32;.970;3580000;0
16527;166226;1093;0;0;0;0;.00nan;0;0
16527;174894;2545;0;0;0;0;.00nan;0;0
16527;63932;1093;67;28;2;26;.929;3600000;0
16527;146249;2545;51;23;3;20;.870;3600000;0
16528;193576;774;0;0;0;0;.00nan;0;0
16528;204272;750;75;26;2;24;.923;3600000;0
16528;212428;750;0;0;0;0;.00nan;0;0
16528;149191;774;53;24;3;21;.875;3585000;0
16529;175757;1497;63;39;4;35;.897;3545000;0
16529;216807;1497;0;0;0;0;.00nan;0;0
16529;176686;746;0;0;0;0;.00nan;0;0
16529;201947;746;57;20;2;18;.900;3600000;0
16531;166023;767;0;0;0;0;.00nan;0;0
16531;174894;2545;40;36;5;31;.861;3600000;0
16531;202839;767;73;21;1;20;.952;3600000;0
16531;94107;2545;0;0;0;0;.00nan;0;0
16533;193545;911;0;0;0;0;.00nan;0;0
16533;166226;1093;0;0;0;0;.00nan;0;0
16533;186234;911;72;30;2;28;.933;3600000;0
16533;63932;1093;58;35;4;31;.886;3557000;0
16535;222019;768;84;17;0;17;1.000;3600000;0
16535;-1;768;0;0;0;0;.00nan;0;0
16535;81691;775;0;0;0;0;.00nan;0;0
16535;146249;775;71;41;4;37;.902;3600000;0
16537;174858;3730;0;0;0;0;.00nan;0;0
16537;207194;754;69;23;2;21;.913;3900000;0
16537;149112;3730;59;30;2;28;.933;3900000;0
16537;149119;754;0;0;0;0;.00nan;0;0
16539;189264;4923;0;0;0;0;.00nan;0;0
16539;179406;4923;77;30;3;27;.900;3900000;0
16539;175761;769;0;0;0;0;.00nan;0;0
16539;-1;769;75;28;3;25;.893;3886000;0
16541;193576;774;0;0;0;0;.00nan;0;0
16541;174898;1503;73;28;2;26;.929;3545000;0
16541;196698;1503;0;0;0;0;.00nan;0;0
16541;149191;774;71;22;1;21;.955;3600000;0
16543;359;760;0;0;0;0;.00nan;0;0
16543;-1;760;52;19;2;17;.895;3600000;0
16543;-1;772;0;0;0;0;.00nan;0;0
16543;145463;772;64;32;4;28;.875;3538000;0
16545;164521;3721;0;0;0;0;.00nan;0;0
16545;201933;3721;62;21;2;19;.905;3900000;0
16545;-1;2199;0;0;0;0;.00nan;0;0
16545;148691;2199;74;32;2;30;.938;3900000;0
16547;169618;766;58;25;3;22;.880;3574000;0
16547;181910;1492;0;0;0;0;.00nan;0;0
16547;185559;766;0;0;0;0;.00nan;0;0
16547;86343;1492;91;34;2;32;.941;3600000;0
16549;177356;762;0;0;0;0;.00nan;0;0
16549;188815;762;93;33;1;32;.970;3900000;0
16549;170530;755;0;0;0;0;.00nan;0;0
16549;180154;755;89;36;1;35;.972;3900000;0
16551;190589;2197;87;41;3;38;.927;3600000;0
16551;82817;2197;0;0;0;0;.00nan;0;0
16551;87758;3913;0;0;0;0;.00nan;0;0
16551;142810;3913;49;26;5;21;.808;3518000;0
16553;1756;4989;89;30;1;29;.967;3600000;0
16553;167629;746;0;0;0;0;.00nan;0;0
16553;164454;746;44;20;3;17;.850;3538000;0
16553;190570;4989;0;0;0;0;.00nan;0;0
16555;199033;750;0;0;0;0;.00nan;0;0
16555;178116;759;0;0;0;0;.00nan;0;0
16555;212428;750;99;35;1;34;.971;3900000;0
16555;94134;759;67;16;1;15;.938;3853000;0
16557;189581;758;0;0;0;0;.00nan;0;0
16557;175757;1497;81;30;2;28;.933;3583000;0
16557;216807;1497;0;0;0;0;.00nan;0;0
16557;176686;758;90;34;1;33;.971;3600000;0
16559;177356;762;0;0;0;0;.00nan;0;0
16559;188815;762;97;22;0;22;1.000;3600000;0
16559;190589;2197;57;32;4;28;.875;3600000;0
16559;82817;2197;0;0;0;0;.00nan;0;0
16561;169618;766;58;33;4;29;.879;3521000;0
16561;185559;766;0;0;0;0;.00nan;0;0
16561;-1;2199;0;0;0;0;.00nan;0;0
16561;148691;2199;58;24;2;22;.917;3600000;0
16563;1756;4989;0;0;0;0;.00nan;0;0
16563;190570;4989;100;30;0;30;1.000;3600000;0
16563;181910;1492;0;0;0;0;.00nan;0;0
16563;86343;1492;58;20;3;17;.850;3600000;0
16565;193545;911;57;20;2;18;.900;3869000;0
16565;174858;3730;0;0;0;0;.00nan;0;0
16565;186234;911;0;0;0;0;.00nan;0;0
16565;149112;3730;76;25;1;24;.960;3869000;0
16567;199033;750;0;0;0;0;.00nan;0;0
16567;166023;767;0;0;0;0;.00nan;0;0
16567;212428;750;61;46;6;40;.870;3600000;0
16567;202839;767;58;22;3;19;.864;3600000;0
16569;174894;2545;96;36;2;34;.944;3600000;0
16569;222019;768;36;26;5;21;.808;3600000;0
16569;-1;768;0;0;0;0;.00nan;0;0
16569;94107;2545;0;0;0;0;.00nan;0;0
16571;359;760;0;0;0;0;.00nan;0;0
16571;164521;3721;0;0;0;0;.00nan;0;0
16571;-1;760;97;28;0;28;1.000;3600000;0
16571;201933;3721;55;36;4;32;.889;3600000;0
16573;167629;746;69;39;4;35;.897;3528000;0
16573;164454;746;0;0;0;0;.00nan;0;0
16573;178116;759;0;0;0;0;.00nan;0;0
16573;94134;759;72;21;2;19;.905;3600000;0
16575;166226;1093;0;0;0;0;.00nan;0;0
16575;189581;758;74;31;2;29;.935;3600000;0
16575;176686;758;0;0;0;0;.00nan;0;0
16575;63932;1093;76;34;3;31;.912;3600000;0
16577;170530;755;0;0;0;0;.00nan;0;0
16577;175761;769;0;0;0;0;.00nan;0;0
16577;180154;755;78;31;2;29;.935;3566000;0
16577;-1;769;89;27;1;26;.963;3600000;0
16579;189264;4923;0;0;0;0;.00nan;0;0
16579;179406;4923;32;32;6;26;.813;3600000;0
16579;87758;3913;0;0;0;0;.00nan;0;0
16579;142810;3913;75;29;2;27;.931;3600000;0
16581;193576;774;0;0;0;0;.00nan;0;0
16581;175757;1497;0;0;0;0;.00nan;0;0
16581;216807;1497;71;28;2;26;.929;3582000;0
16581;149191;774;89;18;0;18;1.000;3600000;0
16583;-1;772;0;0;0;0;.00nan;0;0
16583;81691;775;0;0;0;0;.00nan;0;0
16583;145463;772;67;26;2;24;.923;3600000;0
16583;146249;775;43;28;5;23;.821;3600000;0
16585;174898;1503;64;41;6;35;.854;3587000;0
16585;180188;4924;65;38;4;34;.895;3600000;0
16585;196698;1503;0;0;0;0;.00nan;0;0
16585;91194;4924;0;0;0;0;.00nan;0;0
16587;178116;759;100;26;0;26;1.000;3600000;0
16587;166023;767;87;32;1;31;.969;3586000;0
16587;202839;767;0;0;0;0;.00nan;0;0
16587;94134;759;0;0;0;0;.00nan;0;0
16589;193576;774;0;0;0;0;.00nan;0;0
16589;166226;1093;78;31;2;29;.935;3600000;0
16589;63932;1093;0;0;0;0;.00nan;0;0
16589;149191;774;55;24;3;21;.875;3548000;0
16591;169618;766;0;0;0;0;.00nan;0;0
16591;170530;755;79;29;2;27;.931;3600000;0
16591;180154;755;0;0;0;0;.00nan;0;0
16591;185559;766;61;34;4;30;.882;3555000;0
16593;177356;762;0;0;0;0;.00nan;0;0
16593;188815;762;66;16;1;15;.938;3600000;0
16593;181910;1492;97;48;2;46;.958;3560000;0
16593;86343;1492;0;0;0;0;.00nan;0;0
16595;359;760;0;0;0;0;.00nan;0;0
16595;-1;760;69;37;5;32;.865;3600000;0
16595;207194;754;100;38;1;37;.974;3600000;0
16595;149119;754;0;0;0;0;.00nan;0;0
16597;222019;768;0;0;0;0;.00nan;0;0
16597;-1;768;94;23;0;23;1.000;3600000;0
16597;87758;3913;63;27;3;24;.889;3600000;0
16597;142810;3913;0;0;0;0;.00nan;0;0
16599;189264;4923;61;38;4;34;.895;3600000;0
16599;189581;758;0;0;0;0;.00nan;0;0
16599;179406;4923;0;0;0;0;.00nan;0;0
16599;176686;758;90;31;1;30;.968;3600000;0
16601;175757;1497;68;16;1;15;.938;3600000;0
16601;216807;1497;0;0;0;0;.00nan;0;0
16601;180188;4924;0;0;0;0;.00nan;0;0
16601;91194;4924;80;32;2;30;.938;3600000;0
16603;-1;772;89;30;1;29;.967;3600000;0
16603;81691;775;71;36;3;33;.917;3546000;0
16603;145463;772;0;0;0;0;.00nan;0;0
16603;146249;775;0;0;0;0;.00nan;0;0
16605;193545;911;0;0;0;0;.00nan;0;0
16605;186234;911;70;26;2;24;.923;3600000;0
16605;-1;2199;16;12;5;7;.583;1531000;0
16605;148691;2199;39;16;3;13;.813;2069000;0
16607;167629;746;0;0;0;0;.00nan;0;0
16607;164454;746;78;14;0;14;1.000;3600000;0
16607;174858;3730;86;34;2;32;.941;3577000;0
16607;149112;3730;0;0;0;0;.00nan;0;0
16609;174894;2545;0;0;0;0;.00nan;0;0
16609;175761;769;70;35;3;32;.914;3549000;0
16609;-1;769;0;0;0;0;.00nan;0;0
16609;94107;2545;96;40;2;38;.950;3600000;0
16611;164521;3721;92;36;2;34;.944;3600000;0
16611;174898;1503;0;0;0;0;.00nan;0;0
16611;201933;3721;0;0;0;0;.00nan;0;0
16611;196698;1503;23;22;5;17;.773;3600000;0
16613;199033;750;61;21;2;19;.905;3600000;0
16613;212428;750;0;0;0;0;.00nan;0;0
16613;190589;2197;0;0;0;0;.00nan;0;0
16613;82817;2197;70;31;3;28;.903;3598000;0
16615;174898;1503;88;33;1;32;.970;3900000;0
16615;175761;769;0;0;0;0;.00nan;0;0
16615;196698;1503;0;0;0;0;.00nan;0;0
16615;-1;769;89;38;1;37;.974;3900000;0
16617;166023;767;0;0;0;0;.00nan;0;0
16617;169618;766;74;45;5;40;.889;3600000;0
16617;185559;766;0;0;0;0;.00nan;0;0
16617;202839;767;86;25;1;24;.960;3600000;0
16619;193576;774;58;32;4;28;.875;3600000;0
16619;178116;759;51;16;2;14;.875;3600000;0
16619;94134;759;0;0;0;0;.00nan;0;0
16619;149191;774;0;0;0;0;.00nan;0;0
16621;166226;1093;0;0;0;0;.00nan;0;0
16621;180188;4924;72;32;3;29;.906;3600000;0
16621;63932;1093;51;28;4;24;.857;3548000;0
16621;91194;4924;0;0;0;0;.00nan;0;0
16623;189581;758;84;36;2;34;.944;3600000;0
16623;176686;758;0;0;0;0;.00nan;0;0
16623;87758;3913;0;0;0;0;.00nan;0;0
16623;142810;3913;47;29;4;25;.862;3551000;0
16625;167629;746;0;0;0;0;.00nan;0;0
16625;164454;746;73;33;3;30;.909;3600000;0
16625;174894;2545;71;40;4;36;.900;3549000;0
16625;94107;2545;0;0;0;0;.00nan;0;0
16627;177356;762;0;0;0;0;.00nan;0;0
16627;188815;762;61;39;4;35;.897;3600000;0
16627;-1;2199;0;0;0;0;.00nan;0;0
16627;148691;2199;77;19;1;18;.947;3600000;0
16629;199033;750;0;0;0;0;.00nan;0;0
16629;170530;755;59;28;4;24;.857;3600000;0
16629;180154;755;0;0;0;0;.00nan;0;0
16629;212428;750;96;31;1;30;.968;3600000;0
16631;1756;4989;0;0;0;0;.00nan;0;0
16631;174858;3730;0;0;0;0;.00nan;0;0
16631;190570;4989;47;23;4;19;.826;3900000;0
16631;149112;3730;88;46;4;42;.913;3900000;0
16633;193545;911;0;0;0;0;.00nan;0;0
16633;189264;4923;0;0;0;0;.00nan;0;0
16633;179406;4923;100;25;0;25;1.000;3900000;0
16633;186234;911;75;21;0;21;1.000;3900000;0
16635;222019;768;0;0;0;0;.00nan;0;0
16635;207194;754;64;43;5;38;.884;3600000;0
16635;-1;768;72;22;1;21;.955;3600000;0
16635;149119;754;0;0;0;0;.00nan;0;0
16637;359;760;64;28;3;25;.893;3600000;0
16637;-1;760;0;0;0;0;.00nan;0;0
16637;190589;2197;32;33;6;27;.818;2869000;0
16637;82817;2197;59;8;0;8;1.000;731000;0
16639;181910;1492;0;0;0;0;.00nan;0;0
16639;-1;772;0;0;0;0;.00nan;0;0
16639;86343;1492;81;37;2;35;.946;3600000;0
16639;145463;772;41;29;5;24;.828;3600000;0
16641;175757;1497;0;0;0;0;.00nan;0;0
16641;216807;1497;55;35;4;31;.886;3600000;0
16641;81691;775;0;0;0;0;.00nan;0;0
16641;146249;775;53;36;5;31;.861;3544000;0
16643;1756;4989;82;30;2;28;.933;3600000;0
16643;180188;4924;0;0;0;0;.00nan;0;0
16643;190570;4989;0;0;0;0;.00nan;0;0
16643;91194;4924;54;27;3;24;.889;3570000;0
16645;164521;3721;93;34;1;33;.971;3600000;0
16645;178116;759;0;0;0;0;.00nan;0;0
16645;201933;3721;0;0;0;0;.00nan;0;0
16645;94134;759;41;16;3;13;.813;3559000;0
16647;359;760;0;0;0;0;.00nan;0;0
16647;-1;760;47;25;4;21;.840;3513000;0
16647;175757;1497;76;32;2;30;.938;3600000;0
16647;216807;1497;0;0;0;0;.00nan;0;0
16649;222019;768;46;26;4;22;.846;3900000;0
16649;181910;1492;84;42;4;38;.905;3900000;0
16649;-1;768;0;0;0;0;.00nan;0;0
16649;86343;1492;0;0;0;0;.00nan;0;0
16651;174858;3730;83;35;2;33;.943;3900000;0
16651;190589;2197;0;0;0;0;.00nan;0;0
16651;82817;2197;68;27;2;25;.926;3900000;0
16651;149112;3730;0;0;0;0;.00nan;0;0
16653;167629;746;78;25;1;24;.960;3600000;0
16653;164454;746;0;0;0;0;.00nan;0;0
16653;-1;772;53;27;4;23;.852;3600000;0
16653;145463;772;0;0;0;0;.00nan;0;0
16655;189264;4923;0;0;0;0;.00nan;0;0
16655;179406;4923;79;27;1;26;.963;3600000;0
16655;207194;754;0;0;0;0;.00nan;0;0
16655;149119;754;87;38;2;36;.947;3558000;0
16657;199033;750;73;25;1;24;.960;3600000;0
16657;166226;1093;56;39;4;35;.897;3600000;0
16657;212428;750;0;0;0;0;.00nan;0;0
16657;63932;1093;0;0;0;0;.00nan;0;0
16659;166023;767;55;17;2;15;.882;3600000;0
16659;202839;767;0;0;0;0;.00nan;0;0
16659;87758;3913;77;36;3;33;.917;3549000;0
16659;142810;3913;0;0;0;0;.00nan;0;0
16661;193545;911;0;0;0;0;.00nan;0;0
16661;175761;769;59;25;3;22;.880;3600000;0
16661;186234;911;96;29;0;29;1.000;3600000;0
16661;-1;769;0;0;0;0;.00nan;0;0
16663;174894;2545;0;0;0;0;.00nan;0;0
16663;81691;775;61;21;2;19;.905;3900000;0
16663;94107;2545;70;23;2;21;.913;3900000;0
16663;146249;775;0;0;0;0;.00nan;0;0
16665;169618;766;0;0;0;0;.00nan;0;0
16665;189581;758;0;0;0;0;.00nan;0;0
16665;176686;758;91;22;1;21;.955;3900000;0
16665;185559;766;94;37;1;36;.973;3900000;0
16667;174898;1503;0;0;0;0;.00nan;0;0
16667;196698;1503;85;27;2;25;.926;3600000;0
16667;-1;2199;85;28;1;27;.964;3600000;0
16667;148691;2199;0;0;0;0;.00nan;0;0
16669;177356;762;61;23;2;21;.913;3600000;0
16669;188815;762;0;0;0;0;.00nan;0;0
16669;170530;755;0;0;0;0;.00nan;0;0
16669;180154;755;44;24;4;20;.833;3600000;0
16671;175761;769;0;0;0;0;.00nan;0;0
16671;-1;769;85;43;3;40;.930;3900000;0
16671;81691;775;0;0;0;0;.00nan;0;0
16671;146249;775;76;29;3;26;.897;3900000;0
16673;359;760;0;0;0;0;.00nan;0;0
16673;193545;911;0;0;0;0;.00nan;0;0
16673;-1;760;44;20;3;17;.850;3600000;0
16673;186234;911;39;30;5;25;.833;3558000;0
16675;164521;3721;0;0;0;0;.00nan;0;0
16675;178116;759;0;0;0;0;.00nan;0;0
16675;201933;3721;86;56;4;52;.929;3546000;0
16675;94134;759;67;18;2;16;.889;3600000;0
16677;177356;762;0;0;0;0;.00nan;0;0
16677;167629;746;0;0;0;0;.00nan;0;0
16677;164454;746;37;19;4;15;.789;3541000;0
16677;188815;762;91;34;2;32;.941;3600000;0
16679;189264;4923;0;0;0;0;.00nan;0;0
16679;179406;4923;100;26;0;26;1.000;3600000;0
16679;-1;772;0;0;0;0;.00nan;0;0
16679;145463;772;54;30;3;27;.900;3600000;0
16681;169618;766;51;30;4;26;.867;3757000;0
16681;190589;2197;79;41;3;38;.927;3757000;0
16681;185559;766;0;0;0;0;.00nan;0;0
16681;82817;2197;0;0;0;0;.00nan;0;0
16683;166023;767;0;0;0;0;.00nan;0;0
16683;174894;2545;31;36;7;29;.806;3600000;0
16683;202839;767;66;20;2;18;.900;3600000;0
16683;94107;2545;0;0;0;0;.00nan;0;0
16685;174858;3730;0;0;0;0;.00nan;0;0
16685;-1;2199;0;0;0;0;.00nan;0;0
16685;148691;2199;96;21;0;21;1.000;3600000;0
16685;149112;3730;55;34;4;30;.882;3600000;0
16687;1756;4989;0;0;0;0;.00nan;0;0
16687;174898;1503;66;30;3;27;.900;3716000;0
16687;190570;4989;92;35;2;33;.943;3716000;0
16687;196698;1503;0;0;0;0;.00nan;0;0
16689;193576;774;0;0;0;0;.00nan;0;0
16689;87758;3913;0;0;0;0;.00nan;0;0
16689;142810;3913;48;33;6;27;.818;3600000;0
16689;149191;774;99;23;0;23;1.000;3600000;0
16691;175757;1497;0;0;0;0;.00nan;0;0
16691;216807;1497;57;26;3;23;.885;3900000;0
16691;181910;1492;73;34;3;31;.912;3900000;0
16691;86343;1492;0;0;0;0;.00nan;0;0
16693;166226;1093;0;0;0;0;.00nan;0;0
16693;170530;755;0;0;0;0;.00nan;0;0
16693;180154;755;82;30;1;29;.967;3600000;0
16693;63932;1093;69;27;2;25;.926;3562000;0
16695;199033;750;0;0;0;0;.00nan;0;0
16695;212428;750;43;22;4;18;.818;3587000;0
16695;207194;754;74;28;2;26;.929;3600000;0
16695;149119;754;0;0;0;0;.00nan;0;0
16697;189581;758;56;28;3;25;.893;3600000;0
16697;176686;758;0;0;0;0;.00nan;0;0
16697;180188;4924;68;47;5;42;.894;3537000;0
16697;91194;4924;0;0;0;0;.00nan;0;0
16699;189581;758;0;0;0;0;.00nan;0;0
16699;176686;758;55;43;6;37;.860;3600000;0
16699;222019;768;0;0;0;0;.00nan;0;0
16699;-1;768;57;26;3;23;.885;3600000;0
16701;359;760;62;22;2;20;.909;3600000;0
16701;-1;760;0;0;0;0;.00nan;0;0
16701;87758;3913;48;23;4;19;.826;3592000;0
16701;142810;3913;0;0;0;0;.00nan;0;0
16703;175757;1497;65;28;3;25;.893;3600000;0
16703;175761;769;100;29;0;29;1.000;3600000;0
16703;216807;1497;0;0;0;0;.00nan;0;0
16703;-1;769;0;0;0;0;.00nan;0;0
16705;193576;774;0;0;0;0;.00nan;0;0
16705;166226;1093;74;40;4;36;.900;3600000;0
16705;63932;1093;0;0;0;0;.00nan;0;0
16705;149191;774;54;21;3;18;.857;3600000;0
16707;178116;759;77;24;1;23;.958;3544000;0
16707;81691;775;100;45;0;45;1.000;3600000;0
16707;94134;759;0;0;0;0;.00nan;0;0
16707;146249;775;0;0;0;0;.00nan;0;0
16709;164521;3721;90;26;1;25;.962;3600000;0
16709;174858;3730;53;33;4;29;.879;3600000;0
16709;201933;3721;0;0;0;0;.00nan;0;0
16709;149112;3730;0;0;0;0;.00nan;0;0
16711;177356;762;57;9;1;8;.889;3600000;0
16711;188815;762;0;0;0;0;.00nan;0;0
16711;181910;1492;0;0;0;0;.00nan;0;0
16711;86343;1492;62;36;3;33;.917;3560000;0
16713;189264;4923;0;0;0;0;.00nan;0;0
16713;174894;2545;0;0;0;0;.00nan;0;0
16713;179406;4923;62;19;1;18;.947;3600000;0
16713;94107;2545;75;38;4;34;.895;3600000;0
16715;170530;755;85;41;4;37;.902;3600000;0
16715;180154;755;0;0;0;0;.00nan;0;0
16715;-1;2199;0;0;0;0;.00nan;0;0
16715;148691;2199;71;21;1;20;.952;3600000;0
16717;167629;746;69;37;4;33;.892;3600000;0
16717;164454;746;0;0;0;0;.00nan;0;0
16717;-1;772;34;24;5;19;.792;3543000;0
16717;145463;772;0;0;0;0;.00nan;0;0
16719;180188;4924;0;0;0;0;.00nan;0;0
16719;190589;2197;0;0;0;0;.00nan;0;0
16719;82817;2197;87;33;2;31;.939;3600000;0
16719;91194;4924;47;27;4;23;.852;3579000;0
16721;199033;750;53;24;3;21;.875;3575000;0
16721;193545;911;71;22;1;21;.955;3600000;0
16721;212428;750;0;0;0;0;.00nan;0;0
16721;186234;911;0;0;0;0;.00nan;0;0
16723;1756;4989;86;34;3;31;.912;3600000;0
16723;174898;1503;0;0;0;0;.00nan;0;0
16723;190570;4989;0;0;0;0;.00nan;0;0
16723;196698;1503;66;33;4;29;.879;3568000;0
16725;166023;767;40;14;3;11;.786;3600000;0
16725;169618;766;0;0;0;0;.00nan;0;0
16725;185559;766;58;41;4;37;.902;3600000;0
16725;202839;767;0;0;0;0;.00nan;0;0
781;178116;759;0;0;0;0;.00nan;0;0
781;186234;911;0;0;0;0;.00nan;0;0
781;93756;759;65;25;2;23;.920;3868000;0
781;149048;911;69;39;3;36;.923;3868000;0
782;175761;769;0;0;0;0;.00nan;0;0
782;176686;746;0;0;0;0;.00nan;0;0
782;201947;746;59;29;4;25;.862;3600000;0
782;-1;769;37;33;5;28;.848;3589000;0
783;180177;768;78;22;1;21;.955;3600000;0
783;185559;768;0;0;0;0;.00nan;0;0
783;-1;772;0;0;0;0;.00nan;0;0
783;145463;772;58;23;2;21;.913;3600000;0
784;211572;3913;0;0;0;0;.00nan;0;0
784;180188;2199;0;0;0;0;.00nan;0;0
784;86343;2199;76;37;3;34;.919;5170000;0
784;142810;3913;90;45;2;43;.956;5170000;0
785;204272;750;56;21;3;18;.857;3582000;0
785;166023;767;0;0;0;0;.00nan;0;0
785;212428;750;0;0;0;0;.00nan;0;0
785;202839;767;91;37;2;35;.946;3600000;0
786;177356;762;0;0;0;0;.00nan;0;0
786;188815;762;53;27;4;23;.852;3566000;0
786;180154;775;54;16;2;14;.875;3600000;0
786;149280;775;0;0;0;0;.00nan;0;0
787;189264;4923;0;0;0;0;.00nan;0;0
787;179406;4923;79;29;1;28;.966;4372000;0
787;94107;4924;0;0;0;0;.00nan;0;0
787;148904;4924;85;37;2;35;.946;4372000;0
788;193576;774;0;0;0;0;.00nan;0;0
788;174898;1503;81;27;1;26;.963;3600000;0
788;196698;1503;0;0;0;0;.00nan;0;0
788;149191;774;68;28;2;26;.929;3550000;0
789;178116;759;0;0;0;0;.00nan;0;0
789;186234;911;51;10;1;9;.900;836000;0
789;93756;759;38;13;3;10;.769;3600000;0
789;149048;911;33;39;7;32;.821;2764000;0
790;175761;769;0;0;0;0;.00nan;0;0
790;176686;746;0;0;0;0;.00nan;0;0
790;201947;746;79;40;4;36;.900;3642000;0
790;-1;769;75;32;3;29;.906;3642000;0
791;180177;768;46;13;2;11;.846;3600000;0
791;185559;768;0;0;0;0;.00nan;0;0
791;-1;772;0;0;0;0;.00nan;0;0
791;145463;772;58;49;6;43;.878;3600000;0
792;211572;3913;0;0;0;0;.00nan;0;0
792;180188;2199;0;0;0;0;.00nan;0;0
792;86343;2199;72;27;2;25;.926;3578000;0
792;142810;3913;74;26;1;25;.962;3600000;0
793;204272;750;55;38;4;34;.895;3600000;0
793;166023;767;0;0;0;0;.00nan;0;0
793;212428;750;0;0;0;0;.00nan;0;0
793;202839;767;82;30;2;28;.933;3600000;0
794;177356;762;0;0;0;0;.00nan;0;0
794;188815;762;80;28;2;26;.929;3600000;0
794;180154;775;54;26;3;23;.885;3548000;0
794;149280;775;0;0;0;0;.00nan;0;0
795;189264;4923;0;0;0;0;.00nan;0;0
795;179406;4923;51;13;2;11;.846;3582000;0
795;94107;4924;0;0;0;0;.00nan;0;0
795;148904;4924;81;29;1;28;.966;3600000;0
796;193576;774;0;0;0;0;.00nan;0;0
796;174898;1503;83;23;1;22;.957;3600000;0
796;196698;1503;0;0;0;0;.00nan;0;0
796;149191;774;29;23;5;18;.783;3600000;0
797;178116;759;0;0;0;0;.00nan;0;0
797;186234;911;0;0;0;0;.00nan;0;0
797;93756;759;100;17;0;17;1.000;3600000;0
797;149048;911;59;33;4;29;.879;3600000;0
798;175761;769;0;0;0;0;.00nan;0;0
798;176686;746;0;0;0;0;.00nan;0;0
798;201947;746;73;10;0;10;1.000;3600000;0
798;-1;769;64;33;3;30;.909;3600000;0
799;180177;768;84;13;0;13;1.000;3600000;0
799;185559;768;0;0;0;0;.00nan;0;0
799;-1;772;0;0;0;0;.00nan;0;0
799;145463;772;88;41;2;39;.951;3541000;0
800;211572;3913;0;0;0;0;.00nan;0;0
800;180188;2199;0;0;0;0;.00nan;0;0
800;86343;2199;63;17;1;16;.941;3600000;0
800;142810;3913;80;34;2;32;.941;3588000;0
801;204272;750;41;30;5;25;.833;3600000;0
801;166023;767;0;0;0;0;.00nan;0;0
801;212428;750;0;0;0;0;.00nan;0;0
801;202839;767;66;24;2;22;.917;3600000;0
802;177356;762;0;0;0;0;.00nan;0;0
802;188815;762;65;27;2;25;.926;3524000;0
802;180154;775;99;16;0;16;1.000;3600000;0
802;149280;775;0;0;0;0;.00nan;0;0
803;189264;4923;0;0;0;0;.00nan;0;0
803;179406;4923;88;41;2;39;.951;3562000;0
803;94107;4924;0;0;0;0;.00nan;0;0
803;148904;4924;63;19;1;18;.947;3600000;0
804;193576;774;0;0;0;0;.00nan;0;0
804;174898;1503;81;28;2;26;.929;3588000;0
804;196698;1503;0;0;0;0;.00nan;0;0
804;149191;774;93;34;1;33;.971;3600000;0
805;178116;759;0;0;0;0;.00nan;0;0
805;186234;911;0;0;0;0;.00nan;0;0
805;93756;759;81;24;1;23;.958;3600000;0
805;149048;911;82;42;3;39;.929;3588000;0
806;175761;769;0;0;0;0;.00nan;0;0
806;176686;746;0;0;0;0;.00nan;0;0
806;201947;746;85;28;1;27;.964;3600000;0
806;-1;769;66;37;4;33;.892;3600000;0
807;180177;768;61;25;3;22;.880;3537000;0
807;185559;768;0;0;0;0;.00nan;0;0
807;-1;772;0;0;0;0;.00nan;0;0
807;145463;772;81;24;1;23;.958;3600000;0
808;211572;3913;0;0;0;0;.00nan;0;0
808;180188;2199;0;0;0;0;.00nan;0;0
808;86343;2199;100;22;0;22;1.000;3600000;0
808;142810;3913;89;37;1;36;.973;3547000;0
809;204272;750;79;38;2;36;.947;3600000;0
809;166023;767;0;0;0;0;.00nan;0;0
809;212428;750;0;0;0;0;.00nan;0;0
809;202839;767;87;26;1;25;.962;3600000;0
810;177356;762;0;0;0;0;.00nan;0;0
810;188815;762;45;35;5;30;.857;3550000;0
810;180154;775;48;17;3;14;.824;3600000;0
810;149280;775;0;0;0;0;.00nan;0;0
811;189264;4923;0;0;0;0;.00nan;0;0
811;179406;4923;66;27;2;25;.926;3587000;0
811;94107;4924;0;0;0;0;.00nan;0;0
811;148904;4924;91;23;0;23;1.000;3600000;0
812;193576;774;0;0;0;0;.00nan;0;0
812;174898;1503;56;25;3;22;.880;3600000;0
812;196698;1503;0;0;0;0;.00nan;0;0
812;149191;774;55;29;4;25;.862;3545000;0
927;175761;769;0;0;0;0;.00nan;0;0
927;176686;746;0;0;0;0;.00nan;0;0
927;201947;746;49;21;3;18;.857;3600000;0
927;-1;769;53;31;4;27;.871;3600000;0
928;180177;768;84;12;0;12;1.000;3600000;0
928;185559;768;0;0;0;0;.00nan;0;0
928;-1;772;0;0;0;0;.00nan;0;0
928;145463;772;82;43;3;40;.930;3600000;0
929;211572;3913;0;0;0;0;.00nan;0;0
929;180188;2199;0;0;0;0;.00nan;0;0
929;86343;2199;63;18;1;17;.944;3600000;0
929;142810;3913;88;44;4;40;.909;3600000;0
930;177356;762;0;0;0;0;.00nan;0;0
930;188815;762;68;23;2;21;.913;3589000;0
930;180154;775;67;18;1;17;.944;3600000;0
930;149280;775;0;0;0;0;.00nan;0;0
931;189264;4923;0;0;0;0;.00nan;0;0
931;179406;4923;82;26;2;24;.923;3600000;0
931;94107;4924;0;0;0;0;.00nan;0;0
931;148904;4924;64;29;3;26;.897;3600000;0
932;193576;774;0;0;0;0;.00nan;0;0
932;174898;1503;100;27;0;27;1.000;3600000;0
932;196698;1503;0;0;0;0;.00nan;0;0
932;149191;774;51;28;4;24;.857;3600000;0
979;211572;3913;0;0;0;0;.00nan;0;0
979;180188;2199;0;0;0;0;.00nan;0;0
979;86343;2199;94;51;2;49;.961;6311000;0
979;142810;3913;100;58;1;57;.983;6311000;0
980;189264;4923;0;0;0;0;.00nan;0;0
980;179406;4923;59;29;4;25;.862;3600000;0
980;94107;4924;0;0;0;0;.00nan;0;0
980;148904;4924;75;24;1;23;.958;3600000;0
1015;211572;3913;0;0;0;0;.00nan;0;0
1015;180188;2199;0;0;0;0;.00nan;0;0
1015;86343;2199;64;19;2;17;.895;3600000;0
1015;142810;3913;81;39;4;35;.897;3600000;0
1069;178116;759;0;0;0;0;.00nan;0;0
1069;93756;759;95;24;0;24;1.000;3600000;0
1069;94107;4924;0;0;0;0;.00nan;0;0
1069;148904;4924;76;26;1;25;.962;3557000;0
1070;180154;775;54;33;4;29;.879;3539000;0
1070;180177;768;61;18;2;16;.889;3600000;0
1070;185559;768;0;0;0;0;.00nan;0;0
1070;149280;775;0;0;0;0;.00nan;0;0
1071;166023;767;0;0;0;0;.00nan;0;0
1071;180188;2199;0;0;0;0;.00nan;0;0
1071;202839;767;46;23;4;19;.826;3600000;0
1071;86343;2199;76;22;1;21;.955;3600000;0
1072;174898;1503;42;21;4;17;.810;3600000;0
1072;176686;746;0;0;0;0;.00nan;0;0
1072;201947;746;63;16;1;15;.938;3600000;0
1072;196698;1503;0;0;0;0;.00nan;0;0
1073;178116;759;0;0;0;0;.00nan;0;0
1073;93756;759;80;29;1;28;.966;3600000;0
1073;94107;4924;0;0;0;0;.00nan;0;0
1073;148904;4924;66;25;2;23;.920;3599000;0
1074;180154;775;70;40;4;36;.900;3600000;0
1074;180177;768;60;11;1;10;.909;3600000;0
1074;185559;768;0;0;0;0;.00nan;0;0
1074;149280;775;0;0;0;0;.00nan;0;0
1075;166023;767;0;0;0;0;.00nan;0;0
1075;180188;2199;0;0;0;0;.00nan;0;0
1075;202839;767;63;29;3;26;.897;3570000;0
1075;86343;2199;71;22;1;21;.955;3600000;0
1076;174898;1503;81;38;3;35;.921;3600000;0
1076;176686;746;0;0;0;0;.00nan;0;0
1076;201947;746;89;14;0;14;1.000;3600000;0
1076;196698;1503;0;0;0;0;.00nan;0;0
1077;178116;759;0;0;0;0;.00nan;0;0
1077;93756;759;71;24;2;22;.917;3600000;0
1077;94107;4924;0;0;0;0;.00nan;0;0
1077;148904;4924;62;29;4;25;.862;3538000;0
1078;180154;775;87;37;2;35;.946;3597000;0
1078;180177;768;86;19;0;19;1.000;3600000;0
1078;185559;768;0;0;0;0;.00nan;0;0
1078;149280;775;0;0;0;0;.00nan;0;0
1079;166023;767;0;0;0;0;.00nan;0;0
1079;180188;2199;0;0;0;0;.00nan;0;0
1079;202839;767;72;29;2;27;.931;3600000;0
1079;86343;2199;59;29;3;26;.897;3600000;0
1080;174898;1503;37;31;6;25;.806;3600000;0
1080;176686;746;0;0;0;0;.00nan;0;0
1080;201947;746;71;25;2;23;.920;3600000;0
1080;196698;1503;0;0;0;0;.00nan;0;0
1081;178116;759;0;0;0;0;.00nan;0;0
1081;93756;759;68;17;1;16;.941;3600000;0
1081;94107;4924;0;0;0;0;.00nan;0;0
1081;148904;4924;83;45;4;41;.911;3600000;0
1082;180154;775;85;31;1;30;.968;3550000;0
1082;180177;768;100;25;0;25;1.000;3600000;0
1082;185559;768;0;0;0;0;.00nan;0;0
1082;149280;775;0;0;0;0;.00nan;0;0
1083;166023;767;0;0;0;0;.00nan;0;0
1083;180188;2199;0;0;0;0;.00nan;0;0
1083;202839;767;100;39;0;39;1.000;3600000;0
1083;86343;2199;67;23;2;21;.913;3517000;0
1084;174898;1503;68;24;3;21;.875;3720000;0
1084;176686;746;0;0;0;0;.00nan;0;0
1084;201947;746;72;29;2;27;.931;3720000;0
1084;196698;1503;0;0;0;0;.00nan;0;0
1489;166023;767;0;0;0;0;.00nan;0;0
1489;180188;2199;0;0;0;0;.00nan;0;0
1489;202839;767;70;22;2;20;.909;3600000;0
1489;86343;2199;58;25;3;22;.880;3551000;0
1496;166023;767;0;0;0;0;.00nan;0;0
1496;180188;2199;0;0;0;0;.00nan;0;0
1496;202839;767;78;21;1;20;.952;3600000;0
1496;86343;2199;52;21;3;18;.857;3571000;0
1542;178116;759;0;0;0;0;.00nan;0;0
1542;166023;767;0;0;0;0;.00nan;0;0
1542;202839;767;63;34;4;30;.882;3544000;0
1542;93756;759;50;20;3;17;.850;3600000;0
1543;176686;746;0;0;0;0;.00nan;0;0
1543;180177;768;51;25;3;22;.880;3600000;0
1543;201947;746;72;39;4;35;.897;3571000;0
1543;185559;768;0;0;0;0;.00nan;0;0
1544;178116;759;0;0;0;0;.00nan;0;0
1544;166023;767;0;0;0;0;.00nan;0;0
1544;202839;767;80;36;2;34;.944;3612000;0
1544;93756;759;70;28;3;25;.893;3583000;0
1545;176686;746;0;0;0;0;.00nan;0;0
1545;180177;768;90;38;2;36;.947;3600000;0
1545;201947;746;33;23;5;18;.783;3600000;0
1545;185559;768;0;0;0;0;.00nan;0;0
1546;178116;759;0;0;0;0;.00nan;0;0
1546;166023;767;0;0;0;0;.00nan;0;0
1546;202839;767;100;30;0;30;1.000;3600000;0
1546;93756;759;74;29;1;28;.966;3549000;0
1547;176686;746;0;0;0;0;.00nan;0;0
1547;180177;768;87;26;1;25;.962;3600000;0
1547;201947;746;68;32;3;29;.906;3526000;0
1547;-1;768;0;0;0;0;.00nan;0;0
1548;178116;759;0;0;0;0;.00nan;0;0
1548;166023;767;0;0;0;0;.00nan;0;0
1548;202839;767;84;39;3;36;.923;3600000;0
1548;93756;759;97;23;0;23;1.000;3600000;0
1549;176686;746;0;0;0;0;.00nan;0;0
1549;180177;768;59;12;1;11;.917;3600000;0
1549;201947;746;72;31;2;29;.935;3545000;0
1549;-1;768;0;0;0;0;.00nan;0;0
1849;178116;759;0;0;0;0;.00nan;0;0
1849;166023;767;0;0;0;0;.00nan;0;0
1849;202839;767;65;23;2;21;.913;3600000;0
1849;93756;759;50;18;3;15;.833;3556000;0
1852;178116;759;0;0;0;0;.00nan;0;0
1852;166023;767;0;0;0;0;.00nan;0;0
1852;202839;767;42;38;6;32;.842;4477000;0
1852;93756;759;39;29;5;24;.828;4477000;0
1881;178116;759;0;0;0;0;.00nan;0;0
1881;166023;767;0;0;0;0;.00nan;0;0
1881;202839;767;100;34;1;33;.971;3600000;0
1881;93756;759;58;29;3;26;.897;3547000;0
1927;166023;767;0;0;0;0;.00nan;0;0
1927;180177;768;100;24;0;24;1.000;3600000;0
1927;202839;767;65;39;4;35;.897;3600000;0
1927;-1;768;0;0;0;0;.00nan;0;0
1928;166023;767;0;0;0;0;.00nan;0;0
1928;180177;768;32;15;4;11;.733;3600000;0
1928;202839;767;88;32;1;31;.969;3600000;0
1928;-1;768;0;0;0;0;.00nan;0;0
1929;166023;767;0;0;0;0;.00nan;0;0
1929;180177;768;55;30;4;26;.867;3551000;0
1929;202839;767;84;31;2;29;.935;3600000;0
1929;-1;768;0;0;0;0;.00nan;0;0
1930;166023;767;0;0;0;0;.00nan;0;0
1930;180177;768;66;17;1;16;.941;3600000;0
1930;202839;767;82;38;3;35;.921;3558000;0
1930;-1;768;0;0;0;0;.00nan;0;0
2167;166023;767;0;0;0;0;.00nan;0;0
2167;180177;768;37;24;5;19;.792;3600000;0
2167;202839;767;98;33;2;31;.939;3600000;0
2167;-1;768;0;0;0;0;.00nan;0;0
2202;166023;767;0;0;0;0;.00nan;0;0
2202;222019;768;0;0;0;0;.00nan;0;0
2202;180177;768;50;37;5;32;.865;3600000;0
2202;202839;767;98;34;1;33;.971;3600000;0
16726;184159;583;86;20;0;20;1.000;3600000;0
16726;-1;585;84;39;3;36;.923;3600000;0
16726;66353;583;0;0;0;0;.00nan;0;0
16726;67454;585;0;0;0;0;.00nan;0;0
16727;6202;1918;0;0;0;0;.00nan;0;0
16727;179981;1918;44;27;4;23;.852;3600000;0
16727;185240;1928;0;0;0;0;.00nan;0;0
16727;-1;1928;99;39;1;38;.974;3600000;0
16728;14191;586;0;0;0;0;.00nan;0;0
16728;189944;563;0;0;0;0;.00nan;0;0
16728;174736;586;64;42;5;37;.881;3600000;0
16728;83199;563;23;36;8;28;.778;3600000;0
16729;184159;583;79;28;2;26;.929;3600000;0
16729;196525;584;78;40;3;37;.925;3554000;0
16729;66353;583;0;0;0;0;.00nan;0;0
16729;143879;584;0;0;0;0;.00nan;0;0
16730;208986;2287;51;25;3;22;.880;3600000;0
16730;-1;1922;52;27;4;23;.852;3600000;0
16730;90473;2287;0;0;0;0;.00nan;0;0
16730;160663;1922;0;0;0;0;.00nan;0;0
16731;11352;2277;100;50;2;48;.960;3600000;0
16731;11687;580;0;0;0;0;.00nan;0;0
16731;72514;2277;0;0;0;0;.00nan;0;0
16731;155917;580;38;16;3;13;.813;3549000;0
16732;195672;582;76;11;0;11;1.000;3600000;0
16732;216619;582;0;0;0;0;.00nan;0;0
16732;-1;567;0;0;0;0;.00nan;0;0
16732;155945;567;45;34;5;29;.853;3600000;0
16733;11687;580;84;47;4;43;.915;3600000;0
16733;189944;563;75;20;1;19;.950;3600000;0
16733;83199;563;0;0;0;0;.00nan;0;0
16733;155917;580;0;0;0;0;.00nan;0;0
16734;11352;2277;8;21;7;14;.667;2712000;0
16734;195672;582;43;16;3;13;.813;3600000;0
16734;216619;582;0;0;0;0;.00nan;0;0
16734;72514;2277;48;13;2;11;.846;888000;0
16735;-1;567;0;0;0;0;.00nan;0;0
16735;-1;585;55;40;5;35;.875;3600000;0
16735;67454;585;0;0;0;0;.00nan;0;0
16735;155945;567;59;14;1;13;.929;3600000;0
16736;185240;1928;0;0;0;0;.00nan;0;0
16736;-1;1928;86;42;3;39;.929;3600000;0
16736;-1;1922;0;0;0;0;.00nan;0;0
16736;160663;1922;49;36;5;31;.861;3589000;0
16737;6202;1918;0;0;0;0;.00nan;0;0
16737;14191;586;0;0;0;0;.00nan;0;0
16737;174736;586;57;24;3;21;.875;3721000;0
16737;179981;1918;84;43;4;39;.907;3721000;0
16738;189944;563;0;0;0;0;.00nan;0;0
16738;185240;1928;58;36;4;32;.889;2723000;0
16738;-1;1928;32;18;4;14;.778;877000;0
16738;83199;563;87;36;3;33;.917;3600000;0
16739;208986;2287;70;40;4;36;.900;3570000;0
16739;184159;583;59;29;3;26;.897;3600000;0
16739;66353;583;0;0;0;0;.00nan;0;0
16739;90473;2287;0;0;0;0;.00nan;0;0
16740;195672;582;82;26;1;25;.962;3600000;0
16740;216619;582;0;0;0;0;.00nan;0;0
16740;-1;585;79;30;2;28;.933;3590000;0
16740;67454;585;0;0;0;0;.00nan;0;0
16741;196525;584;100;40;1;39;.975;3900000;0
16741;-1;1922;87;36;1;35;.972;3900000;0
16741;143879;584;0;0;0;0;.00nan;0;0
16741;160663;1922;0;0;0;0;.00nan;0;0
16742;6202;1918;0;0;0;0;.00nan;0;0
16742;11352;2277;57;30;3;27;.900;3543000;0
16742;179981;1918;58;19;2;17;.895;3600000;0
16742;72514;2277;0;0;0;0;.00nan;0;0
16743;195672;582;58;21;2;19;.905;3600000;0
16743;216619;582;0;0;0;0;.00nan;0;0
16743;185240;1928;0;0;0;0;.00nan;0;0
16743;-1;1928;40;30;5;25;.833;3600000;0
16744;14191;586;0;0;0;0;.00nan;0;0
16744;174736;586;57;22;3;19;.864;3600000;0
16744;196525;584;88;48;4;44;.917;3600000;0
16744;143879;584;0;0;0;0;.00nan;0;0
16745;208986;2287;61;45;6;39;.867;3600000;0
16745;189944;563;0;0;0;0;.00nan;0;0
16745;83199;563;53;21;3;18;.857;3600000;0
16745;90473;2287;0;0;0;0;.00nan;0;0
16746;11687;580;71;27;2;25;.926;3600000;0
16746;184159;583;22;26;6;20;.769;3600000;0
16746;66353;583;0;0;0;0;.00nan;0;0
16746;155917;580;0;0;0;0;.00nan;0;0
16747;6202;1918;85;34;3;31;.912;3600000;0
16747;179981;1918;0;0;0;0;.00nan;0;0
16747;-1;585;0;0;0;0;.00nan;0;0
16747;67454;585;82;25;1;24;.960;3600000;0
16748;185240;1928;84;29;1;28;.966;3600000;0
16748;196525;584;61;26;4;22;.846;3600000;0
16748;-1;1928;0;0;0;0;.00nan;0;0
16748;143879;584;0;0;0;0;.00nan;0;0
16749;14191;586;45;22;4;18;.818;3600000;0
16749;174736;586;0;0;0;0;.00nan;0;0
16749;195672;582;48;32;5;27;.844;3583000;0
16749;216619;582;0;0;0;0;.00nan;0;0
16750;6202;1918;0;0;0;0;.00nan;0;0
16750;184159;583;0;0;0;0;.00nan;0;0
16750;179981;1918;81;48;4;44;.917;3900000;0
16750;66353;583;49;26;4;22;.846;3900000;0
16751;208986;2287;0;0;0;0;.00nan;0;0
16751;11352;2277;0;0;0;0;.00nan;0;0
16751;72514;2277;55;41;5;36;.878;3600000;0
16751;90473;2287;73;19;1;18;.947;3600000;0
16752;189944;563;64;31;3;28;.903;3853000;0
16752;-1;1922;74;36;3;33;.917;3900000;0
16752;83199;563;0;0;0;0;.00nan;0;0
16752;160663;1922;0;0;0;0;.00nan;0;0
16753;11687;580;80;24;1;23;.958;3600000;0
16753;-1;567;0;0;0;0;.00nan;0;0
16753;155917;580;0;0;0;0;.00nan;0;0
16753;155945;567;51;19;2;17;.895;3576000;0
16754;14191;586;0;0;0;0;.00nan;0;0
16754;174736;586;58;16;2;14;.875;3595000;0
16754;185240;1928;0;0;0;0;.00nan;0;0
16754;-1;1928;100;39;1;38;.974;3600000;0
16755;189944;563;0;0;0;0;.00nan;0;0
16755;196525;584;78;43;4;39;.907;3745000;0
16755;83199;563;61;39;5;34;.872;3745000;0
16755;143879;584;0;0;0;0;.00nan;0;0
16756;14191;586;0;0;0;0;.00nan;0;0
16756;189944;563;0;0;0;0;.00nan;0;0
16756;174736;586;91;33;1;32;.970;3600000;0
16756;83199;563;67;30;3;27;.900;3540000;0
16757;185240;1928;57;24;3;21;.875;3614000;0
16757;-1;1928;0;0;0;0;.00nan;0;0
16757;-1;585;75;30;2;28;.933;3614000;0
16757;67454;585;0;0;0;0;.00nan;0;0
16758;11352;2277;85;45;3;42;.933;3900000;0
16758;184159;583;42;19;3;16;.842;3900000;0
16758;66353;583;0;0;0;0;.00nan;0;0
16758;72514;2277;0;0;0;0;.00nan;0;0
16759;208986;2287;24;20;5;15;.750;3600000;0
16759;196525;584;79;35;2;33;.943;3600000;0
16759;90473;2287;0;0;0;0;.00nan;0;0
16759;143879;584;0;0;0;0;.00nan;0;0
16760;11687;580;74;32;2;30;.938;3600000;0
16760;-1;567;0;0;0;0;.00nan;0;0
16760;155917;580;0;0;0;0;.00nan;0;0
16760;155945;567;57;28;3;25;.893;3600000;0
16761;6202;1918;0;0;0;0;.00nan;0;0
16761;179981;1918;79;53;5;48;.906;3570000;0
16761;-1;1922;53;28;4;24;.857;3600000;0
16761;160663;1922;0;0;0;0;.00nan;0;0
16762;11352;2277;78;40;3;37;.925;3600000;0
16762;195672;582;46;26;4;22;.846;3564000;0
16762;216619;582;0;0;0;0;.00nan;0;0
16762;72514;2277;0;0;0;0;.00nan;0;0
16763;189944;563;62;32;4;28;.875;3572000;0
16763;-1;1922;0;0;0;0;.00nan;0;0
16763;83199;563;0;0;0;0;.00nan;0;0
16763;160663;1922;61;29;3;26;.897;3600000;0
16764;14191;586;56;21;3;18;.857;3703000;0
16764;174736;586;0;0;0;0;.00nan;0;0
16764;-1;585;0;0;0;0;.00nan;0;0
16764;67454;585;57;36;4;32;.889;3703000;0
16765;208986;2287;0;0;0;0;.00nan;0;0
16765;11687;580;0;0;0;0;.00nan;0;0
16765;90473;2287;61;37;4;33;.892;3542000;0
16765;155917;580;90;32;2;30;.938;3600000;0
16766;184159;583;0;0;0;0;.00nan;0;0
16766;-1;567;65;24;2;22;.917;3600000;0
16766;66353;583;40;34;5;29;.853;3600000;0
16766;155945;567;0;0;0;0;.00nan;0;0
16767;208986;2287;1;12;7;5;.417;2073000;0
16767;-1;585;100;35;0;35;1.000;3600000;0
16767;67454;585;0;0;0;0;.00nan;0;0
16767;90473;2287;53;9;1;8;.889;1527000;0
16768;14191;586;0;0;0;0;.00nan;0;0
16768;174736;586;81;36;2;34;.944;3600000;0
16768;-1;1922;93;53;3;50;.943;3600000;0
16768;160663;1922;0;0;0;0;.00nan;0;0
16769;195672;582;100;34;0;34;1.000;3600000;0
16769;216619;582;0;0;0;0;.00nan;0;0
16769;196525;584;77;32;2;30;.938;3528000;0
16769;143879;584;0;0;0;0;.00nan;0;0
16770;6202;1918;0;0;0;0;.00nan;0;0
16770;189944;563;0;0;0;0;.00nan;0;0
16770;179981;1918;66;52;6;46;.885;3600000;0
16770;83199;563;48;22;4;18;.818;3600000;0
16771;208986;2287;40;21;4;17;.810;2400000;0
16771;185240;1928;0;0;0;0;.00nan;0;0
16771;-1;1928;27;28;6;22;.786;3548000;0
16771;90473;2287;64;10;0;10;1.000;1200000;0
16772;189944;563;62;36;5;31;.861;3600000;0
16772;195672;582;30;10;3;7;.700;296000;0
16772;216619;582;71;40;4;36;.900;3222000;0
16772;83199;563;0;0;0;0;.00nan;0;0
16773;14191;586;0;0;0;0;.00nan;0;0
16773;184159;583;59;41;5;36;.878;3600000;0
16773;174736;586;82;26;1;25;.962;3600000;0
16773;66353;583;0;0;0;0;.00nan;0;0
16774;11352;2277;65;41;4;37;.902;3600000;0
16774;-1;585;70;24;2;22;.917;3600000;0
16774;67454;585;0;0;0;0;.00nan;0;0
16774;72514;2277;0;0;0;0;.00nan;0;0
16775;11687;580;55;30;4;26;.867;3600000;0
16775;-1;1922;48;45;6;39;.867;3590000;0
16775;155917;580;0;0;0;0;.00nan;0;0
16775;160663;1922;0;0;0;0;.00nan;0;0
16776;6202;1918;0;0;0;0;.00nan;0;0
16776;179981;1918;42;35;5;30;.857;3575000;0
16776;196525;584;60;24;3;21;.875;3600000;0
16776;143879;584;0;0;0;0;.00nan;0;0
16777;195672;582;55;31;4;27;.871;3600000;0
16777;216619;582;0;0;0;0;.00nan;0;0
16777;149262;567;0;0;0;0;.00nan;0;0
16777;155945;567;65;31;3;28;.903;3600000;0
16778;184159;583;0;0;0;0;.00nan;0;0
16778;185240;1928;65;22;2;20;.909;3600000;0
16778;-1;1928;0;0;0;0;.00nan;0;0
16778;66353;583;36;32;5;27;.844;3600000;0
16779;208986;2287;87;48;3;45;.938;3600000;0
16779;-1;1922;0;0;0;0;.00nan;0;0
16779;90473;2287;0;0;0;0;.00nan;0;0
16779;160663;1922;58;20;2;18;.900;3600000;0
16780;11352;2277;83;61;5;56;.918;3600000;0
16780;196525;584;28;30;6;24;.800;3549000;0
16780;-1;584;0;0;0;0;.00nan;0;0
16780;72514;2277;0;0;0;0;.00nan;0;0
16781;208986;2287;89;35;1;34;.971;3600000;0
16781;14191;586;0;0;0;0;.00nan;0;0
16781;174736;586;99;29;0;29;1.000;3600000;0
16781;90473;2287;0;0;0;0;.00nan;0;0
16782;195672;582;49;31;5;26;.839;3652000;0
16782;216619;582;0;0;0;0;.00nan;0;0
16782;-1;585;33;14;4;10;.714;3652000;0
16782;67454;585;0;0;0;0;.00nan;0;0
16783;208986;2287;0;0;0;0;.00nan;0;0
16783;189944;563;97;33;2;31;.939;3600000;0
16783;83199;563;0;0;0;0;.00nan;0;0
16783;90473;2287;50;26;4;22;.846;3546000;0
16784;11352;2277;49;36;5;31;.861;3600000;0
16784;185240;1928;0;0;0;0;.00nan;0;0
16784;-1;1928;63;26;2;24;.923;3600000;0
16784;72514;2277;0;0;0;0;.00nan;0;0
16785;-1;1922;78;47;4;43;.915;3600000;0
16785;149262;567;84;24;1;23;.958;3600000;0
16785;155945;567;0;0;0;0;.00nan;0;0
16785;160663;1922;0;0;0;0;.00nan;0;0
16786;6202;1918;0;0;0;0;.00nan;0;0
16786;184159;583;83;31;2;29;.935;3600000;0
16786;179981;1918;59;35;4;31;.886;3555000;0
16786;66353;583;0;0;0;0;.00nan;0;0
16787;195672;582;0;0;0;0;.00nan;0;0
16787;216619;582;40;26;5;21;.808;3600000;0
16787;196525;584;87;31;1;30;.968;3600000;0
16787;-1;584;0;0;0;0;.00nan;0;0
16788;14191;586;0;0;0;0;.00nan;0;0
16788;174736;586;82;23;1;22;.957;3600000;0
16788;149262;567;29;19;4;15;.789;774000;0
16788;155945;567;37;24;4;20;.833;2826000;0
16789;208986;2287;48;32;5;27;.844;3600000;0
16789;11687;580;72;19;1;18;.947;3600000;0
16789;90473;2287;0;0;0;0;.00nan;0;0
16789;155917;580;0;0;0;0;.00nan;0;0
16790;185240;1928;70;34;3;31;.912;3575000;0
16790;-1;1928;0;0;0;0;.00nan;0;0
16790;-1;585;77;24;1;23;.958;3600000;0
16790;67454;585;0;0;0;0;.00nan;0;0
16791;6202;1918;42;42;7;35;.833;3600000;0
16791;184159;583;0;0;0;0;.00nan;0;0
16791;179981;1918;0;0;0;0;.00nan;0;0
16791;66353;583;61;23;2;21;.913;3600000;0
16792;208986;2287;57;17;2;15;.882;3600000;0
16792;11352;2277;62;36;4;32;.889;3585000;0
16792;72514;2277;0;0;0;0;.00nan;0;0
16792;90473;2287;0;0;0;0;.00nan;0;0
16793;196525;584;52;24;3;21;.875;3900000;0
16793;-1;584;0;0;0;0;.00nan;0;0
16793;-1;585;83;38;3;35;.921;3900000;0
16793;67454;585;0;0;0;0;.00nan;0;0
16794;11352;2277;74;38;3;35;.921;3776000;0
16794;-1;1922;74;30;2;28;.933;3776000;0
16794;72514;2277;0;0;0;0;.00nan;0;0
16794;160663;1922;0;0;0;0;.00nan;0;0
16795;189944;563;0;0;0;0;.00nan;0;0
16795;185240;1928;0;0;0;0;.00nan;0;0
16795;-1;1928;63;23;2;21;.913;3600000;0
16795;83199;563;58;34;5;29;.853;3600000;0
16796;208986;2287;58;37;4;33;.892;3525000;0
16796;195672;582;57;18;2;16;.889;3600000;0
16796;216619;582;0;0;0;0;.00nan;0;0
16796;90473;2287;0;0;0;0;.00nan;0;0
16797;189944;563;73;33;3;30;.909;3577000;0
16797;-1;585;70;34;2;32;.941;3600000;0
16797;67454;585;0;0;0;0;.00nan;0;0
16797;83199;563;0;0;0;0;.00nan;0;0
16798;11687;580;100;41;2;39;.951;3600000;0
16798;14191;586;0;0;0;0;.00nan;0;0
16798;174736;586;49;21;3;18;.857;3559000;0
16798;155917;580;0;0;0;0;.00nan;0;0
16799;11352;2277;63;19;1;18;.947;1786000;0
16799;72514;2277;26;26;6;20;.769;1814000;0
16799;149262;567;50;21;3;18;.857;3600000;0
16799;155945;567;0;0;0;0;.00nan;0;0
16800;6202;1918;0;0;0;0;.00nan;0;0
16800;179981;1918;88;36;2;34;.944;3600000;0
16800;196525;584;83;37;3;34;.919;3549000;0
16800;-1;584;0;0;0;0;.00nan;0;0
16801;185240;1928;0;0;0;0;.00nan;0;0
16801;196525;584;0;0;0;0;.00nan;0;0
16801;-1;1928;77;35;3;32;.914;3600000;0
16801;-1;584;51;33;5;28;.848;3514000;0
16802;184159;583;66;35;4;31;.886;3544000;0
16802;195672;582;63;29;3;26;.897;3600000;0
16802;216619;582;0;0;0;0;.00nan;0;0
16802;66353;583;0;0;0;0;.00nan;0;0
16803;11687;580;0;0;0;0;.00nan;0;0
16803;-1;585;0;0;0;0;.00nan;0;0
16803;67454;585;90;42;2;40;.952;3544000;0
16803;155917;580;70;16;1;15;.938;3600000;0
16804;14191;586;94;31;2;29;.935;3600000;0
16804;174736;586;0;0;0;0;.00nan;0;0
16804;-1;1922;23;4;3;1;.250;377000;0
16804;160663;1922;59;39;4;35;.897;3223000;0
16805;208986;2287;0;0;0;0;.00nan;0;0
16805;90473;2287;80;34;2;32;.941;3900000;0
16805;149262;567;80;27;2;25;.926;3900000;0
16805;155945;567;0;0;0;0;.00nan;0;0
16806;14191;586;0;0;0;0;.00nan;0;0
16806;174736;586;80;27;2;25;.926;3600000;0
16806;-1;1922;42;35;6;29;.829;3106000;0
16806;160663;1922;55;6;0;6;1.000;494000;0
16807;184159;583;77;32;3;29;.906;3572000;0
16807;66353;583;0;0;0;0;.00nan;0;0
16807;149262;567;78;25;1;24;.960;3600000;0
16807;155945;567;0;0;0;0;.00nan;0;0
16808;189944;563;0;0;0;0;.00nan;0;0
16808;-1;585;55;44;6;38;.864;3600000;0
16808;67454;585;0;0;0;0;.00nan;0;0
16808;83199;563;72;27;2;25;.926;3600000;0
16809;11352;2277;90;54;4;50;.926;3544000;0
16809;189944;563;45;18;3;15;.833;3600000;0
16809;72514;2277;0;0;0;0;.00nan;0;0
16809;83199;563;0;0;0;0;.00nan;0;0
16810;6202;1918;0;0;0;0;.00nan;0;0
16810;179981;1918;95;41;1;40;.976;3900000;0
16810;149262;567;81;23;1;22;.957;3900000;0
16810;155945;567;0;0;0;0;.00nan;0;0
16811;6202;1918;83;43;4;39;.907;3529000;0
16811;195672;582;60;21;2;19;.905;3600000;0
16811;216619;582;0;0;0;0;.00nan;0;0
16811;179981;1918;0;0;0;0;.00nan;0;0
16812;11352;2277;69;16;1;15;.938;1404000;0
16812;14191;586;0;0;0;0;.00nan;0;0
16812;174736;586;58;25;3;22;.880;3600000;0
16812;72514;2277;25;27;6;21;.778;2196000;0
16813;208986;2287;45;38;6;32;.842;3600000;0
16813;-1;585;30;13;4;9;.692;1110000;0
16813;67454;585;35;19;4;15;.789;2428000;0
16813;90473;2287;0;0;0;0;.00nan;0;0
16814;11687;580;71;36;3;33;.917;3900000;0
16814;185240;1928;0;0;0;0;.00nan;0;0
16814;-1;1928;76;32;3;29;.906;3900000;0
16814;155917;580;0;0;0;0;.00nan;0;0
16815;184159;583;60;24;3;21;.875;3600000;0
16815;196525;584;60;37;5;32;.865;3566000;0
16815;-1;584;0;0;0;0;.00nan;0;0
16815;66353;583;0;0;0;0;.00nan;0;0
16816;184159;583;0;0;0;0;.00nan;0;0
16816;189944;563;0;0;0;0;.00nan;0;0
16816;66353;583;86;36;2;34;.944;3600000;0
16816;83199;563;50;26;4;22;.846;3594000;0
16817;11687;580;0;0;0;0;.00nan;0;0
16817;185240;1928;83;40;3;37;.925;3600000;0
16817;-1;1928;0;0;0;0;.00nan;0;0
16817;155917;580;35;19;4;15;.789;3544000;0
16818;-1;585;75;33;3;30;.909;3590000;0
16818;-1;1922;82;30;1;29;.967;3600000;0
16818;67454;585;0;0;0;0;.00nan;0;0
16818;160663;1922;0;0;0;0;.00nan;0;0
16819;208986;2287;0;0;0;0;.00nan;0;0
16819;196525;584;0;0;0;0;.00nan;0;0
16819;-1;584;33;21;4;17;.810;3600000;0
16819;90473;2287;37;29;5;24;.828;3553000;0
16820;14191;586;38;23;5;18;.783;3515000;0
16820;174736;586;0;0;0;0;.00nan;0;0
16820;149262;567;72;31;3;28;.903;3600000;0
16820;155945;567;0;0;0;0;.00nan;0;0
16821;196525;584;67;37;3;34;.919;3539000;0
16821;62829;584;0;0;0;0;.00nan;0;0
16821;149262;567;76;22;1;21;.955;3600000;0
16821;155945;567;0;0;0;0;.00nan;0;0
16822;11687;580;49;25;4;21;.840;3600000;0
16822;195672;582;0;0;0;0;.00nan;0;0
16822;216619;582;100;44;1;43;.977;3600000;0
16822;155917;580;0;0;0;0;.00nan;0;0
16823;6202;1918;0;0;0;0;.00nan;0;0
16823;14191;586;0;0;0;0;.00nan;0;0
16823;174736;586;49;20;3;17;.850;3564000;0
16823;179981;1918;100;52;2;50;.962;3600000;0
16824;185240;1928;0;0;0;0;.00nan;0;0
16824;-1;1928;89;28;1;27;.964;3600000;0
16824;-1;1922;40;29;5;24;.828;3600000;0
16824;160663;1922;0;0;0;0;.00nan;0;0
16825;184159;583;76;27;2;25;.926;3600000;0
16825;-1;585;55;25;3;22;.880;3600000;0
16825;66353;583;0;0;0;0;.00nan;0;0
16825;67454;585;0;0;0;0;.00nan;0;0
16826;11352;2277;91;39;2;37;.949;3551000;0
16826;11687;580;79;11;0;11;1.000;3600000;0
16826;72514;2277;0;0;0;0;.00nan;0;0
16826;155917;580;0;0;0;0;.00nan;0;0
16827;195672;582;43;32;6;26;.813;3600000;0
16827;216619;582;0;0;0;0;.00nan;0;0
16827;-1;1922;0;0;0;0;.00nan;0;0
16827;160663;1922;51;38;5;33;.868;3600000;0
16828;189944;563;36;20;4;16;.800;3900000;0
16828;83199;563;0;0;0;0;.00nan;0;0
16828;149262;567;70;15;0;15;1.000;2354000;0
16828;155945;567;59;32;4;28;.875;1546000;0
16829;14191;586;0;0;0;0;.00nan;0;0
16829;174736;586;51;17;3;14;.824;3900000;0
16829;196525;584;0;0;0;0;.00nan;0;0
16829;62829;584;87;49;3;46;.939;3900000;0
16830;208986;2287;49;25;5;20;.800;3756000;0
16830;195672;582;47;28;4;24;.857;3756000;0
16830;216619;582;0;0;0;0;.00nan;0;0
16830;90473;2287;0;0;0;0;.00nan;0;0
16831;11687;580;71;38;4;34;.895;3900000;0
16831;189944;563;0;0;0;0;.00nan;0;0
16831;83199;563;56;30;4;26;.867;3900000;0
16831;155917;580;0;0;0;0;.00nan;0;0
16832;6202;1918;0;0;0;0;.00nan;0;0
16832;179981;1918;88;52;4;48;.923;3600000;0
16832;185240;1928;0;0;0;0;.00nan;0;0
16832;-1;1928;42;27;5;22;.815;3574000;0
16833;185240;1928;0;0;0;0;.00nan;0;0
16833;-1;1928;71;38;4;34;.895;3600000;0
16833;-1;1922;0;0;0;0;.00nan;0;0
16833;160663;1922;45;36;6;30;.833;3565000;0
16834;208986;2287;45;38;6;32;.842;3359000;0
16834;90473;2287;49;2;0;2;1.000;241000;0
16834;149262;567;90;50;3;47;.940;3600000;0
16834;155945;567;0;0;0;0;.00nan;0;0
16835;11687;580;68;29;3;26;.897;3816000;0
16835;196525;584;67;29;4;25;.862;3816000;0
16835;62829;584;0;0;0;0;.00nan;0;0
16835;155917;580;0;0;0;0;.00nan;0;0
16836;184159;583;72;30;2;28;.933;3600000;0
16836;-1;1922;71;37;4;33;.892;3568000;0
16836;66353;583;0;0;0;0;.00nan;0;0
16836;160663;1922;0;0;0;0;.00nan;0;0
16837;189944;563;45;21;4;17;.810;3533000;0
16837;196525;584;70;23;2;21;.913;3600000;0
16837;62829;584;0;0;0;0;.00nan;0;0
16837;83199;563;0;0;0;0;.00nan;0;0
16838;208986;2287;74;35;3;32;.914;3600000;0
16838;185240;1928;0;0;0;0;.00nan;0;0
16838;-1;1928;97;22;0;22;1.000;3600000;0
16838;90473;2287;0;0;0;0;.00nan;0;0
16839;11352;2277;47;41;5;36;.878;3600000;0
16839;14191;586;0;0;0;0;.00nan;0;0
16839;174736;586;51;27;4;23;.852;3600000;0
16839;72514;2277;0;0;0;0;.00nan;0;0
16840;11687;580;65;32;3;29;.906;3600000;0
16840;184159;583;46;4;1;3;.750;412000;0
16840;66353;583;25;25;6;19;.760;3188000;0
16840;155917;580;0;0;0;0;.00nan;0;0
16841;6202;1918;0;0;0;0;.00nan;0;0
16841;195672;582;49;24;3;21;.875;3600000;0
16841;216619;582;0;0;0;0;.00nan;0;0
16841;179981;1918;55;35;4;31;.886;3572000;0
16842;-1;1922;0;0;0;0;.00nan;0;0
16842;149262;567;20;10;4;6;.600;1071000;0
16842;155945;567;53;10;1;9;.900;2529000;0
16842;160663;1922;57;32;3;29;.906;3600000;0
16843;11352;2277;69;41;4;37;.902;3600000;0
16843;185240;1928;0;0;0;0;.00nan;0;0
16843;-1;1928;67;21;1;20;.952;3600000;0
16843;72514;2277;0;0;0;0;.00nan;0;0
16844;208986;2287;0;0;0;0;.00nan;0;0
16844;14191;586;89;20;0;20;1.000;3600000;0
16844;174736;586;0;0;0;0;.00nan;0;0
16844;90473;2287;56;38;5;33;.868;3600000;0
16845;11687;580;0;0;0;0;.00nan;0;0
16845;189944;563;0;0;0;0;.00nan;0;0
16845;83199;563;75;29;2;27;.931;3600000;0
16845;155917;580;64;38;4;34;.895;3549000;0
16846;6202;1918;0;0;0;0;.00nan;0;0
16846;195672;582;33;22;5;17;.773;3514000;0
16846;216619;582;0;0;0;0;.00nan;0;0
16846;179981;1918;77;40;3;37;.925;3600000;0
16847;-1;585;20;15;5;10;.667;2245000;0
16847;67454;585;28;12;4;8;.667;1355000;0
16847;149262;567;20;27;6;21;.778;3600000;0
16847;155945;567;0;0;0;0;.00nan;0;0
16848;11352;2277;70;35;3;32;.914;3900000;0
16848;195672;582;0;0;0;0;.00nan;0;0
16848;216619;582;58;28;3;25;.893;3900000;0
16848;72514;2277;0;0;0;0;.00nan;0;0
16849;11352;2277;0;0;0;0;.00nan;0;0
16849;196525;584;89;26;1;25;.962;3600000;0
16849;62829;584;0;0;0;0;.00nan;0;0
16849;72514;2277;79;40;3;37;.925;3599000;0
16850;6202;1918;0;0;0;0;.00nan;0;0
16850;179981;1918;97;30;1;29;.967;3600000;0
16850;-1;1922;0;0;0;0;.00nan;0;0
16850;160663;1922;65;21;2;19;.905;3574000;0
16851;185240;1928;0;0;0;0;.00nan;0;0
16851;196525;584;0;0;0;0;.00nan;0;0
16851;-1;1928;75;22;1;21;.955;3600000;0
16851;62829;584;79;31;2;29;.935;3543000;0
16852;14191;586;0;0;0;0;.00nan;0;0
16852;174736;586;67;15;1;14;.933;3600000;0
16852;195672;582;80;35;2;33;.943;3577000;0
16852;216619;582;0;0;0;0;.00nan;0;0
16853;189944;563;100;30;0;30;1.000;3600000;0
16853;-1;585;0;0;0;0;.00nan;0;0
16853;67454;585;82;35;2;33;.943;3557000;0
16853;83199;563;0;0;0;0;.00nan;0;0
16854;184159;583;59;26;3;23;.885;3600000;0
16854;185240;1928;75;32;2;30;.938;3202000;0
16854;-1;1928;27;7;3;4;.571;380000;0
16854;66353;583;0;0;0;0;.00nan;0;0
16855;6202;1918;0;0;0;0;.00nan;0;0
16855;208986;2287;81;34;2;32;.941;3600000;0
16855;179981;1918;72;38;4;34;.895;3600000;0
16855;90473;2287;0;0;0;0;.00nan;0;0
16856;11687;580;69;33;3;30;.909;3569000;0
16856;-1;1922;89;39;2;37;.949;3600000;0
16856;155917;580;0;0;0;0;.00nan;0;0
16856;160663;1922;0;0;0;0;.00nan;0;0
16857;11352;2277;72;41;3;38;.927;3600000;0
16857;72514;2277;0;0;0;0;.00nan;0;0
16857;149262;567;0;0;0;0;.00nan;0;0
16857;155945;567;29;16;4;12;.750;3593000;0
16858;14191;586;100;32;1;31;.969;3600000;0
16858;184159;583;71;40;4;36;.900;3600000;0
16858;174736;586;0;0;0;0;.00nan;0;0
16858;66353;583;0;0;0;0;.00nan;0;0
16859;6202;1918;0;0;0;0;.00nan;0;0
16859;208986;2287;0;0;0;0;.00nan;0;0
16859;179981;1918;75;34;3;31;.912;3600000;0
16859;90473;2287;100;25;0;25;1.000;3600000;0
16860;11687;580;0;0;0;0;.00nan;0;0
16860;-1;585;86;32;1;31;.969;3600000;0
16860;67454;585;0;0;0;0;.00nan;0;0
16860;155917;580;70;30;3;27;.900;3578000;0
16861;196525;584;85;39;2;37;.949;3600000;0
16861;62829;584;0;0;0;0;.00nan;0;0
16861;149262;567;40;24;4;20;.833;3591000;0
16861;155945;567;0;0;0;0;.00nan;0;0
16862;11352;2277;73;48;5;43;.896;3600000;0
16862;11687;580;52;16;2;14;.875;3600000;0
16862;72514;2277;0;0;0;0;.00nan;0;0
16862;155917;580;0;0;0;0;.00nan;0;0
16863;11352;2277;57;24;2;22;.917;3900000;0
16863;196525;584;70;22;2;20;.909;3900000;0
16863;62829;584;0;0;0;0;.00nan;0;0
16863;72514;2277;0;0;0;0;.00nan;0;0
16864;195672;582;64;24;2;22;.917;3900000;0
16864;216619;582;0;0;0;0;.00nan;0;0
16864;-1;1922;59;29;2;27;.931;3900000;0
16864;160663;1922;0;0;0;0;.00nan;0;0
16865;189944;563;42;25;4;21;.840;3600000;0
16865;185240;1928;0;0;0;0;.00nan;0;0
16865;-1;1928;62;43;5;38;.884;3585000;0
16865;83199;563;0;0;0;0;.00nan;0;0
16866;208986;2287;0;0;0;0;.00nan;0;0
16866;184159;583;26;6;3;3;.500;515000;0
16866;66353;583;65;21;2;19;.905;3052000;0
16866;90473;2287;69;30;3;27;.900;3600000;0
16867;11687;580;100;27;0;27;1.000;3600000;0
16867;-1;585;45;32;5;27;.844;3600000;0
16867;67454;585;0;0;0;0;.00nan;0;0
16867;155917;580;0;0;0;0;.00nan;0;0
16868;6202;1918;0;0;0;0;.00nan;0;0
16868;179981;1918;54;43;5;38;.884;3576000;0
16868;149262;567;57;29;3;26;.897;3600000;0
16868;155945;567;0;0;0;0;.00nan;0;0
16869;14191;586;0;0;0;0;.00nan;0;0
16869;189944;563;44;5;1;4;.800;285000;0
16869;174736;586;66;31;4;27;.871;3600000;0
16869;83199;563;45;40;6;34;.850;3315000;0
16870;208986;2287;47;15;2;13;.867;3600000;0
16870;11352;2277;64;40;5;35;.875;3600000;0
16870;72514;2277;0;0;0;0;.00nan;0;0
16870;90473;2287;0;0;0;0;.00nan;0;0
16871;11687;580;100;25;0;25;1.000;3600000;0
16871;195672;582;0;0;0;0;.00nan;0;0
16871;216619;582;75;27;1;26;.963;3600000;0
16871;155917;580;0;0;0;0;.00nan;0;0
16872;196525;584;65;24;2;22;.917;3900000;0
16872;-1;1922;0;0;0;0;.00nan;0;0
16872;62829;584;0;0;0;0;.00nan;0;0
16872;160663;1922;74;33;2;31;.939;3900000;0
16873;6202;1918;57;24;3;21;.875;2813000;0
16873;179981;1918;17;6;4;2;.333;787000;0
16873;149262;567;0;0;0;0;.00nan;0;0
16873;155945;567;49;33;4;29;.879;3600000;0
16874;208986;2287;49;36;5;31;.861;3538000;0
16874;-1;585;72;29;3;26;.897;3600000;0
16874;67454;585;0;0;0;0;.00nan;0;0
16874;90473;2287;0;0;0;0;.00nan;0;0
16875;184159;583;44;24;4;20;.833;3600000;0
16875;196525;584;87;32;1;31;.969;3600000;0
16875;62829;584;0;0;0;0;.00nan;0;0
16875;66353;583;0;0;0;0;.00nan;0;0
16876;11687;580;67;17;1;16;.941;3600000;0
16876;-1;1922;30;20;5;15;.750;2067000;0
16876;155917;580;0;0;0;0;.00nan;0;0
16876;160663;1922;55;11;1;10;.909;1533000;0
16877;6202;1918;48;16;2;14;.875;1406000;0
16877;184159;583;100;44;1;43;.977;3600000;0
16877;179981;1918;15;20;6;14;.700;2194000;0
16877;66353;583;0;0;0;0;.00nan;0;0
16878;14191;586;0;0;0;0;.00nan;0;0
16878;174736;586;66;16;1;15;.938;3600000;0
16878;149262;567;57;26;3;23;.885;3560000;0
16878;155945;567;0;0;0;0;.00nan;0;0
16879;195672;582;67;24;2;22;.917;3572000;0
16879;216619;582;0;0;0;0;.00nan;0;0
16879;185240;1928;0;0;0;0;.00nan;0;0
16879;-1;1928;78;27;1;26;.963;3600000;0
16880;208986;2287;68;32;3;29;.906;3551000;0
16880;189944;563;0;0;0;0;.00nan;0;0
16880;83199;563;67;22;2;20;.909;3600000;0
16880;90473;2287;0;0;0;0;.00nan;0;0
16881;11352;2277;55;38;5;33;.868;3520000;0
16881;-1;1922;48;19;3;16;.842;3600000;0
16881;72514;2277;0;0;0;0;.00nan;0;0
16881;160663;1922;0;0;0;0;.00nan;0;0
16882;6202;1918;0;0;0;0;.00nan;0;0
16882;179981;1918;69;42;4;38;.905;3900000;0
16882;-1;585;0;0;0;0;.00nan;0;0
16882;67454;585;45;25;4;21;.840;3900000;0
16883;14191;586;42;21;4;17;.810;3900000;0
16883;174736;586;0;0;0;0;.00nan;0;0
16883;196525;584;83;51;4;47;.922;3900000;0
16883;62829;584;0;0;0;0;.00nan;0;0
16884;184159;583;100;30;0;30;1.000;3900000;0
16884;195672;582;0;0;0;0;.00nan;0;0
16884;216619;582;96;40;0;40;1.000;3900000;0
16884;66353;583;0;0;0;0;.00nan;0;0
16885;6202;1918;0;0;0;0;.00nan;0;0
16885;11352;2277;0;0;0;0;.00nan;0;0
16885;179981;1918;92;31;1;30;.968;3600000;0
16885;72514;2277;55;31;4;27;.871;3600000;0
16886;208986;2287;0;0;0;0;.00nan;0;0
16886;11687;580;0;0;0;0;.00nan;0;0
16886;90473;2287;49;28;4;24;.857;3574000;0
16886;155917;580;63;20;2;18;.900;3600000;0
16887;-1;585;95;38;1;37;.974;3600000;0
16887;-1;1922;0;0;0;0;.00nan;0;0
16887;67454;585;0;0;0;0;.00nan;0;0
16887;160663;1922;45;21;4;17;.810;3600000;0
16888;185240;1928;0;0;0;0;.00nan;0;0
16888;-1;1928;68;27;2;25;.926;3550000;0
16888;149262;567;0;0;0;0;.00nan;0;0
16888;155945;567;76;25;1;24;.960;3600000;0
16889;11352;2277;67;30;3;27;.900;3600000;0
16889;184159;583;47;25;4;21;.840;3548000;0
16889;66353;583;0;0;0;0;.00nan;0;0
16889;72514;2277;0;0;0;0;.00nan;0;0
16890;195672;582;0;0;0;0;.00nan;0;0
16890;216619;582;62;29;3;26;.897;3900000;0
16890;149262;567;60;29;3;26;.897;3900000;0
16890;155945;567;0;0;0;0;.00nan;0;0
16891;11352;2277;59;30;3;27;.900;3692000;0
16891;-1;585;59;32;4;28;.875;3692000;0
16891;67454;585;0;0;0;0;.00nan;0;0
16891;72514;2277;0;0;0;0;.00nan;0;0
16892;6202;1918;0;0;0;0;.00nan;0;0
16892;189944;563;62;27;4;23;.852;3600000;0
16892;179981;1918;100;50;2;48;.960;3600000;0
16892;83199;563;0;0;0;0;.00nan;0;0
16893;14191;586;0;0;0;0;.00nan;0;0
16893;174736;586;89;29;2;27;.931;3900000;0
16893;185240;1928;0;0;0;0;.00nan;0;0
16893;-1;1928;78;32;2;30;.938;3900000;0
16894;11352;2277;0;0;0;0;.00nan;0;0
16894;-1;585;0;0;0;0;.00nan;0;0
16894;67454;585;78;21;1;20;.952;3600000;0
16894;72514;2277;90;49;4;45;.918;3600000;0
16895;208986;2287;51;31;4;27;.871;3600000;0
16895;-1;1922;53;34;5;29;.853;3591000;0
16895;90473;2287;0;0;0;0;.00nan;0;0
16895;160663;1922;0;0;0;0;.00nan;0;0
16896;11687;580;47;28;4;24;.857;3600000;0
16896;196525;584;63;19;1;18;.947;3600000;0
16896;62829;584;0;0;0;0;.00nan;0;0
16896;155917;580;0;0;0;0;.00nan;0;0
16897;184159;583;60;38;4;34;.895;3578000;0
16897;66353;583;0;0;0;0;.00nan;0;0
16897;149262;567;0;0;0;0;.00nan;0;0
16897;155945;567;63;28;3;25;.893;3600000;0
16898;14191;586;67;13;1;12;.923;3600000;0
16898;174736;586;0;0;0;0;.00nan;0;0
16898;185240;1928;0;0;0;0;.00nan;0;0
16898;-1;1928;58;36;4;32;.889;3600000;0
16899;184159;583;64;26;2;24;.923;3600000;0
16899;195672;582;52;26;4;22;.846;3534000;0
16899;216619;582;0;0;0;0;.00nan;0;0
16899;66353;583;0;0;0;0;.00nan;0;0
16900;208986;2287;0;0;0;0;.00nan;0;0
16900;-1;1922;0;0;0;0;.00nan;0;0
16900;90473;2287;99;40;1;39;.975;3600000;0
16900;160663;1922;61;30;3;27;.900;3573000;0
16901;11687;580;0;0;0;0;.00nan;0;0
16901;196525;584;0;0;0;0;.00nan;0;0
16901;62829;584;83;39;2;37;.949;3600000;0
16901;155917;580;82;17;0;17;1.000;3600000;0
16902;6202;1918;0;0;0;0;.00nan;0;0
16902;189944;563;0;0;0;0;.00nan;0;0
16902;179981;1918;83;41;3;38;.927;3600000;0
16902;83199;563;55;16;2;14;.875;3600000;0
16903;11687;580;0;0;0;0;.00nan;0;0
16903;149262;567;59;29;3;26;.897;3589000;0
16903;155917;580;63;23;2;21;.913;3600000;0
16903;155945;567;0;0;0;0;.00nan;0;0
16904;14191;586;0;0;0;0;.00nan;0;0
16904;184159;583;83;41;3;38;.927;3518000;0
16904;174736;586;88;27;1;26;.963;3600000;0
16904;66353;583;0;0;0;0;.00nan;0;0
16905;189944;563;0;0;0;0;.00nan;0;0
16905;83199;563;47;30;5;25;.833;3867000;0
16905;149262;567;0;0;0;0;.00nan;0;0
16905;155945;567;74;45;4;41;.911;3867000;0
16906;11352;2277;32;27;6;21;.778;3600000;0
16906;185240;1928;0;0;0;0;.00nan;0;0
16906;-1;1928;75;25;1;24;.960;3600000;0
16906;72514;2277;0;0;0;0;.00nan;0;0
16907;14191;586;31;20;5;15;.750;3700000;0
16907;174736;586;0;0;0;0;.00nan;0;0
16907;-1;585;59;35;4;31;.886;3714000;0
16907;67454;585;0;0;0;0;.00nan;0;0
16908;196525;584;100;40;1;39;.975;3600000;0
16908;-1;1922;76;30;2;28;.933;3600000;0
16908;62829;584;0;0;0;0;.00nan;0;0
16908;160663;1922;0;0;0;0;.00nan;0;0
16909;6202;1918;0;0;0;0;.00nan;0;0
16909;208986;2287;56;20;3;17;.850;3600000;0
16909;179981;1918;54;35;5;30;.857;3600000;0
16909;90473;2287;0;0;0;0;.00nan;0;0
16910;189944;563;100;23;0;23;1.000;3600000;0
16910;195672;582;68;26;2;24;.923;3517000;0
16910;216619;582;0;0;0;0;.00nan;0;0
16910;83199;563;0;0;0;0;.00nan;0;0
16911;11687;580;38;20;4;16;.800;3600000;0
16911;-1;1922;0;0;0;0;.00nan;0;0
16911;155917;580;0;0;0;0;.00nan;0;0
16911;160663;1922;26;20;5;15;.750;3554000;0
16912;185240;1928;0;0;0;0;.00nan;0;0
16912;-1;1928;70;26;1;25;.962;3600000;0
16912;-1;585;0;0;0;0;.00nan;0;0
16912;67454;585;97;46;2;44;.957;3566000;0
16913;6202;1918;85;31;2;29;.935;3563000;0
16913;208986;2287;0;0;0;0;.00nan;0;0
16913;179981;1918;0;0;0;0;.00nan;0;0
16913;90473;2287;76;25;1;24;.960;3600000;0
16914;11687;580;91;17;0;17;1.000;3600000;0
16914;185240;1928;0;0;0;0;.00nan;0;0
16914;-1;1928;95;34;1;33;.971;3588000;0
16914;155917;580;0;0;0;0;.00nan;0;0
16915;208986;2287;71;41;3;38;.927;3600000;0
16915;189944;563;50;15;2;13;.867;3600000;0
16915;83199;563;0;0;0;0;.00nan;0;0
16915;90473;2287;0;0;0;0;.00nan;0;0
16916;11687;580;75;45;4;41;.911;3600000;0
16916;14191;586;0;0;0;0;.00nan;0;0
16916;174736;586;72;15;1;14;.933;3600000;0
16916;155917;580;0;0;0;0;.00nan;0;0
16917;195672;582;59;32;4;28;.875;3553000;0
16917;216619;582;0;0;0;0;.00nan;0;0
16917;-1;585;66;23;3;20;.870;3600000;0
16917;67454;585;0;0;0;0;.00nan;0;0
16918;189944;563;0;0;0;0;.00nan;0;0
16918;-1;1922;80;32;2;30;.938;3578000;0
16918;83199;563;100;30;0;30;1.000;3600000;0
16918;160663;1922;0;0;0;0;.00nan;0;0
16919;196525;584;62;35;4;31;.886;3575000;0
16919;-1;585;0;0;0;0;.00nan;0;0
16919;62829;584;0;0;0;0;.00nan;0;0
16919;67454;585;80;30;2;28;.933;3600000;0
16920;11352;2277;48;27;4;23;.852;3589000;0
16920;185240;1928;44;20;3;17;.850;3600000;0
16920;-1;1928;0;0;0;0;.00nan;0;0
16920;72514;2277;0;0;0;0;.00nan;0;0
16921;14191;586;0;0;0;0;.00nan;0;0
16921;184159;583;82;53;5;48;.906;3600000;0
16921;174736;586;73;16;1;15;.938;3600000;0
16921;66353;583;0;0;0;0;.00nan;0;0
16922;6202;1918;0;0;0;0;.00nan;0;0
16922;11687;580;35;29;6;23;.793;3600000;0
16922;179981;1918;100;26;0;26;1.000;3600000;0
16922;155917;580;0;0;0;0;.00nan;0;0
16923;208986;2287;50;38;6;32;.842;3600000;0
16923;90473;2287;0;0;0;0;.00nan;0;0
16923;149262;567;59;22;3;19;.864;3600000;0
16923;155945;567;0;0;0;0;.00nan;0;0
16924;208986;2287;0;0;0;0;.00nan;0;0
16924;195672;582;0;0;0;0;.00nan;0;0
16924;216619;582;54;16;2;14;.875;3600000;0
16924;90473;2287;67;38;3;35;.921;3566000;0
16925;11352;2277;0;0;0;0;.00nan;0;0
16925;189944;563;0;0;0;0;.00nan;0;0
16925;72514;2277;96;54;3;51;.944;3600000;0
16925;83199;563;76;8;0;8;1.000;3600000;0
16926;6202;1918;0;0;0;0;.00nan;0;0
16926;179981;1918;77;45;4;41;.911;3600000;0
16926;185240;1928;0;0;0;0;.00nan;0;0
16926;-1;1928;60;23;2;21;.913;3600000;0
16927;-1;585;0;0;0;0;.00nan;0;0
16927;67454;585;88;44;2;42;.955;3600000;0
16927;149262;567;0;0;0;0;.00nan;0;0
16927;155945;567;48;15;3;12;.800;3557000;0
16928;184159;583;82;20;0;20;1.000;3900000;0
16928;-1;1922;0;0;0;0;.00nan;0;0
16928;66353;583;0;0;0;0;.00nan;0;0
16928;160663;1922;100;29;0;29;1.000;3900000;0
16929;184159;583;77;34;2;32;.941;3600000;0
16929;189944;563;0;0;0;0;.00nan;0;0
16929;66353;583;0;0;0;0;.00nan;0;0
16929;83199;563;52;17;3;14;.824;3543000;0
16930;196525;584;24;5;3;2;.400;419000;0
16930;62829;584;59;28;3;25;.893;3181000;0
16930;149262;567;0;0;0;0;.00nan;0;0
16930;155945;567;100;23;0;23;1.000;3600000;0
16931;208986;2287;56;31;4;27;.871;3573000;0
16931;185240;1928;0;0;0;0;.00nan;0;0
16931;-1;1928;59;24;3;21;.875;3600000;0
16931;90473;2287;0;0;0;0;.00nan;0;0
16932;189944;563;66;22;2;20;.909;3600000;0
16932;-1;585;100;27;0;27;1.000;3600000;0
16932;67454;585;0;0;0;0;.00nan;0;0
16932;83199;563;0;0;0;0;.00nan;0;0
16933;6202;1918;0;0;0;0;.00nan;0;0
16933;14191;586;0;0;0;0;.00nan;0;0
16933;174736;586;79;25;1;24;.960;3600000;0
16933;179981;1918;86;51;4;47;.922;3600000;0
16934;189944;563;0;0;0;0;.00nan;0;0
16934;83199;563;93;33;1;32;.970;3600000;0
16934;149262;567;0;0;0;0;.00nan;0;0
16934;155945;567;86;33;2;31;.939;3572000;0
16935;195672;582;73;25;2;23;.920;3600000;0
16935;216619;582;0;0;0;0;.00nan;0;0
16935;185240;1928;0;0;0;0;.00nan;0;0
16935;-1;1928;56;18;3;15;.833;3562000;0
16936;11352;2277;80;33;2;31;.939;3884000;0
16936;11687;580;69;27;3;24;.889;3884000;0
16936;72514;2277;0;0;0;0;.00nan;0;0
16936;155917;580;0;0;0;0;.00nan;0;0
16937;208986;2287;73;38;3;35;.921;3600000;0
16937;-1;585;96;28;0;28;1.000;3600000;0
16937;67454;585;0;0;0;0;.00nan;0;0
16937;90473;2287;0;0;0;0;.00nan;0;0
16938;6202;1918;0;0;0;0;.00nan;0;0
16938;179981;1918;45;31;5;26;.839;3570000;0
16938;196525;584;51;29;4;25;.862;3600000;0
16938;62829;584;0;0;0;0;.00nan;0;0
16939;185240;1928;66;36;4;32;.889;3900000;0
16939;-1;1928;0;0;0;0;.00nan;0;0
16939;149262;567;51;31;4;27;.871;3900000;0
16939;155945;567;0;0;0;0;.00nan;0;0
16940;14191;586;0;0;0;0;.00nan;0;0
16940;174736;586;57;11;1;10;.909;3600000;0
16940;195672;582;0;0;0;0;.00nan;0;0
16940;216619;582;55;25;3;22;.880;3551000;0
16941;11352;2277;0;0;0;0;.00nan;0;0
16941;184159;583;63;26;3;23;.885;3545000;0
16941;66353;583;0;0;0;0;.00nan;0;0
16941;72514;2277;74;29;2;27;.931;3600000;0
16942;6202;1918;0;0;0;0;.00nan;0;0
16942;11687;580;0;0;0;0;.00nan;0;0
16942;179981;1918;59;39;6;33;.846;3600000;0
16942;155917;580;82;22;1;21;.955;3600000;0
16943;-1;585;51;31;4;27;.871;3572000;0
16943;-1;1922;0;0;0;0;.00nan;0;0
16943;67454;585;0;0;0;0;.00nan;0;0
16943;160663;1922;60;24;3;21;.875;3600000;0
16944;6202;1918;0;0;0;0;.00nan;0;0
16944;189944;563;0;0;0;0;.00nan;0;0
16944;179981;1918;75;38;4;34;.895;3600000;0
16944;83199;563;82;25;1;24;.960;3600000;0
16945;184159;583;69;14;1;13;.929;3600000;0
16945;196525;584;70;39;4;35;.897;3600000;0
16945;62829;584;0;0;0;0;.00nan;0;0
16945;66353;583;0;0;0;0;.00nan;0;0
16946;195672;582;49;24;4;20;.833;3600000;0
16946;216619;582;0;0;0;0;.00nan;0;0
16946;149262;567;0;0;0;0;.00nan;0;0
16946;155945;567;60;15;1;14;.933;3600000;0
16947;6127;586;0;0;0;0;.00nan;0;0
16947;11352;2277;79;37;3;34;.919;3572000;0
16947;174736;586;47;10;2;8;.800;3600000;0
16947;72514;2277;0;0;0;0;.00nan;0;0
16948;6127;586;66;27;3;24;.889;3900000;0
16948;174736;586;0;0;0;0;.00nan;0;0
16948;195672;582;86;42;3;39;.929;3880000;0
16948;216619;582;0;0;0;0;.00nan;0;0
16949;189944;563;0;0;0;0;.00nan;0;0
16949;196525;584;30;10;3;7;.700;476000;0
16949;62829;584;56;26;3;23;.885;3124000;0
16949;83199;563;67;32;3;29;.906;3600000;0
16950;185240;1928;0;0;0;0;.00nan;0;0
16950;-1;1928;65;26;2;24;.923;3537000;0
16950;149262;567;0;0;0;0;.00nan;0;0
16950;155945;567;100;31;0;31;1.000;3600000;0
16951;208986;2287;79;39;4;35;.897;3600000;0
16951;184159;583;93;20;0;20;1.000;3600000;0
16951;66353;583;0;0;0;0;.00nan;0;0
16951;90473;2287;0;0;0;0;.00nan;0;0
16952;11352;2277;0;0;0;0;.00nan;0;0
16952;-1;585;0;0;0;0;.00nan;0;0
16952;67454;585;52;16;2;14;.875;3600000;0
16952;72514;2277;79;37;3;34;.919;3555000;0
16953;6202;1918;0;0;0;0;.00nan;0;0
16953;11687;580;92;28;1;27;.964;3848000;0
16953;179981;1918;92;37;2;35;.946;3848000;0
16953;155917;580;0;0;0;0;.00nan;0;0
16954;189944;563;77;29;3;26;.897;3900000;0
16954;195672;582;0;0;0;0;.00nan;0;0
16954;216619;582;73;28;3;25;.893;3900000;0
16954;83199;563;0;0;0;0;.00nan;0;0
16955;11687;580;0;0;0;0;.00nan;0;0
16955;185240;1928;67;35;3;32;.914;3520000;0
16955;-1;1928;0;0;0;0;.00nan;0;0
16955;155917;580;58;11;1;10;.909;3600000;0
16956;184159;583;69;30;3;27;.900;3583000;0
16956;-1;585;49;13;2;11;.846;3600000;0
16956;66353;583;0;0;0;0;.00nan;0;0
16956;67454;585;0;0;0;0;.00nan;0;0
16957;-1;1922;64;23;2;21;.913;3847000;0
16957;149262;567;74;33;3;30;.909;3847000;0
16957;155945;567;0;0;0;0;.00nan;0;0
16957;160663;1922;0;0;0;0;.00nan;0;0
16958;6202;1918;0;0;0;0;.00nan;0;0
16958;179981;1918;84;41;3;38;.927;3568000;0
16958;196525;584;88;26;1;25;.962;3600000;0
16958;62829;584;0;0;0;0;.00nan;0;0
16959;11352;2277;100;45;1;44;.978;3600000;0
16959;196525;584;64;30;3;27;.900;3530000;0
16959;62829;584;0;0;0;0;.00nan;0;0
16959;72514;2277;0;0;0;0;.00nan;0;0
16960;184159;583;60;32;4;28;.875;3528000;0
16960;195672;582;64;19;2;17;.895;3600000;0
16960;216619;582;0;0;0;0;.00nan;0;0
16960;66353;583;0;0;0;0;.00nan;0;0
16961;6127;586;63;20;2;18;.900;3600000;0
16961;208986;2287;66;47;5;42;.894;3600000;0
16961;174736;586;0;0;0;0;.00nan;0;0
16961;90473;2287;0;0;0;0;.00nan;0;0
16962;185240;1928;0;0;0;0;.00nan;0;0
16962;196525;584;0;0;0;0;.00nan;0;0
16962;-1;1928;42;24;4;20;.833;3553000;0
16962;62829;584;88;35;2;33;.943;3600000;0
16963;184159;583;0;0;0;0;.00nan;0;0
16963;185240;1928;71;32;3;29;.906;3555000;0
16963;-1;1928;0;0;0;0;.00nan;0;0
16963;66353;583;68;22;2;20;.909;3600000;0
16964;11352;2277;99;44;2;42;.955;3600000;0
16964;189944;563;0;0;0;0;.00nan;0;0
16964;72514;2277;0;0;0;0;.00nan;0;0
16964;83199;563;48;20;3;17;.850;3545000;0
16965;11687;580;86;18;0;18;1.000;3600000;0
16965;195672;582;63;31;3;28;.903;3600000;0
16965;216619;582;0;0;0;0;.00nan;0;0
16965;155917;580;0;0;0;0;.00nan;0;0
16966;6202;1918;54;23;3;20;.870;3600000;0
16966;179981;1918;0;0;0;0;.00nan;0;0
16966;-1;585;59;17;1;16;.941;3600000;0
16966;67454;585;0;0;0;0;.00nan;0;0
16967;-1;1922;82;32;1;31;.969;3600000;0
16967;149262;567;0;0;0;0;.00nan;0;0
16967;155945;567;71;22;2;20;.909;3591000;0
16967;160663;1922;0;0;0;0;.00nan;0;0
16968;195672;582;0;0;0;0;.00nan;0;0
16968;216619;582;76;31;3;28;.903;3600000;0
16968;-1;1922;0;0;0;0;.00nan;0;0
16968;160663;1922;32;25;5;20;.800;3574000;0
16969;6127;586;45;26;3;23;.885;3600000;0
16969;11687;580;24;26;6;20;.769;2335000;0
16969;174736;586;0;0;0;0;.00nan;0;0
16969;155917;580;40;15;3;12;.800;1265000;0
16970;184159;583;90;44;2;42;.955;3600000;0
16970;189944;563;48;18;3;15;.833;3549000;0
16970;66353;583;0;0;0;0;.00nan;0;0
16970;83199;563;0;0;0;0;.00nan;0;0
16971;11352;2277;97;45;1;44;.978;3600000;0
16971;72514;2277;0;0;0;0;.00nan;0;0
16971;149262;567;98;22;0;22;1.000;3600000;0
16971;155945;567;0;0;0;0;.00nan;0;0
16972;208986;2287;71;35;3;32;.914;3900000;0
16972;196525;584;76;29;3;26;.897;3900000;0
16972;62829;584;0;0;0;0;.00nan;0;0
16972;90473;2287;0;0;0;0;.00nan;0;0
16973;6202;1918;0;0;0;0;.00nan;0;0
16973;179981;1918;91;22;0;22;1.000;3600000;0
16973;-1;585;0;0;0;0;.00nan;0;0
16973;67454;585;49;22;4;18;.818;3600000;0
16974;208986;2287;33;29;6;23;.793;3686000;0
16974;185240;1928;0;0;0;0;.00nan;0;0
16974;-1;1928;48;32;5;27;.844;3686000;0
16974;90473;2287;0;0;0;0;.00nan;0;0
16975;6127;586;56;19;2;17;.895;3600000;0
16975;208986;2287;0;0;0;0;.00nan;0;0
16975;174736;586;0;0;0;0;.00nan;0;0
16975;90473;2287;68;47;5;42;.894;3600000;0
16976;196525;584;27;18;5;13;.722;3600000;0
16976;-1;585;87;41;2;39;.951;3600000;0
16976;62829;584;0;0;0;0;.00nan;0;0
16976;67454;585;0;0;0;0;.00nan;0;0
16977;6202;1918;0;0;0;0;.00nan;0;0
16977;11687;580;60;17;3;14;.824;3600000;0
16977;179981;1918;62;42;5;37;.881;3600000;0
16977;155917;580;0;0;0;0;.00nan;0;0
16978;6202;1918;60;32;3;29;.906;3600000;0
16978;195672;582;0;0;0;0;.00nan;0;0
16978;216619;582;47;26;4;22;.846;3588000;0
16978;179981;1918;0;0;0;0;.00nan;0;0
16979;184159;583;30;15;5;10;.667;1167000;0
16979;189944;563;0;0;0;0;.00nan;0;0
16979;66353;583;21;27;6;21;.778;2433000;0
16979;83199;563;56;32;4;28;.875;3600000;0
16980;185240;1928;0;0;0;0;.00nan;0;0
16980;-1;1928;81;20;1;19;.950;3600000;0
16980;-1;585;40;32;6;26;.813;3277000;0
16980;67454;585;48;0;0;0;.00nan;323000;0
16981;11352;2277;84;36;3;33;.917;3715000;0
16981;-1;1922;44;11;2;9;.818;3715000;0
16981;72514;2277;0;0;0;0;.00nan;0;0
16981;160663;1922;0;0;0;0;.00nan;0;0
16982;196525;584;75;27;1;26;.963;3600000;0
16982;62829;584;0;0;0;0;.00nan;0;0
16982;149262;567;69;34;3;31;.912;3600000;0
16982;155945;567;0;0;0;0;.00nan;0;0
16983;184159;583;100;36;0;36;1.000;3600000;0
16983;185240;1928;50;34;4;30;.882;3600000;0
16983;-1;1928;0;0;0;0;.00nan;0;0
16983;66353;583;0;0;0;0;.00nan;0;0
16984;6127;586;79;25;1;24;.960;3600000;0
16984;174736;586;0;0;0;0;.00nan;0;0
16984;-1;585;0;0;0;0;.00nan;0;0
16984;67454;585;30;31;6;25;.806;3600000;0
16985;208986;2287;49;18;3;15;.833;3600000;0
16985;11352;2277;53;30;4;26;.867;3567000;0
16985;72514;2277;0;0;0;0;.00nan;0;0
16985;90473;2287;0;0;0;0;.00nan;0;0
16986;195672;582;65;29;3;26;.897;3553000;0
16986;216619;582;0;0;0;0;.00nan;0;0
16986;196525;584;0;0;0;0;.00nan;0;0
16986;62829;584;87;35;2;33;.943;3600000;0
16987;6202;1918;0;0;0;0;.00nan;0;0
16987;179981;1918;70;23;2;21;.913;3900000;0
16987;149262;567;0;0;0;0;.00nan;0;0
16987;155945;567;71;26;2;24;.923;3900000;0
16988;196525;584;51;38;5;33;.868;3550000;0
16988;-1;1922;65;17;2;15;.882;3600000;0
16988;62829;584;0;0;0;0;.00nan;0;0
16988;160663;1922;0;0;0;0;.00nan;0;0
16989;11687;580;0;0;0;0;.00nan;0;0
16989;13065;580;41;29;5;24;.828;3600000;0
16989;-1;585;73;29;2;27;.931;3600000;0
16989;67454;585;0;0;0;0;.00nan;0;0
16990;189944;563;0;0;0;0;.00nan;0;0
16990;185240;1928;0;0;0;0;.00nan;0;0
16990;-1;1928;83;49;4;45;.918;3540000;0
16990;83199;563;62;21;2;19;.905;3600000;0
16991;6127;586;92;18;0;18;1.000;3600000;0
16991;174736;586;0;0;0;0;.00nan;0;0
16991;-1;1922;55;52;6;46;.885;3344000;0
16991;160663;1922;47;6;1;5;.833;256000;0
16992;208986;2287;38;24;5;19;.792;3600000;0
16992;195672;582;0;0;0;0;.00nan;0;0
16992;216619;582;95;34;2;32;.941;3600000;0
16992;90473;2287;0;0;0;0;.00nan;0;0
16993;11687;580;0;0;0;0;.00nan;0;0
16993;13065;580;58;16;2;14;.875;3600000;0
16993;184159;583;54;28;3;25;.893;3596000;0
16993;66353;583;0;0;0;0;.00nan;0;0
16994;196525;584;32;18;4;14;.778;3582000;0
16994;-1;585;0;0;0;0;.00nan;0;0
16994;62829;584;0;0;0;0;.00nan;0;0
16994;67454;585;76;41;3;38;.927;3600000;0
16995;6202;1918;0;0;0;0;.00nan;0;0
16995;11352;2277;46;22;3;19;.864;3600000;0
16995;179981;1918;78;27;2;25;.926;3600000;0
16995;72514;2277;0;0;0;0;.00nan;0;0
16996;11687;580;0;0;0;0;.00nan;0;0
16996;13065;580;64;32;3;29;.906;3554000;0
16996;189944;563;0;0;0;0;.00nan;0;0
16996;83199;563;71;23;2;21;.913;3600000;0
16997;6127;586;33;24;5;19;.792;3600000;0
16997;174736;586;0;0;0;0;.00nan;0;0
16997;185240;1928;0;0;0;0;.00nan;0;0
16997;-1;1928;96;37;2;35;.946;3600000;0
16998;184159;583;65;10;0;10;1.000;770000;0
16998;66353;583;23;25;6;19;.760;2830000;0
16998;149262;567;82;28;1;27;.964;3600000;0
16998;155945;567;0;0;0;0;.00nan;0;0
16999;195672;582;40;35;6;29;.829;3600000;0
16999;216619;582;0;0;0;0;.00nan;0;0
16999;-1;1922;0;0;0;0;.00nan;0;0
16999;160663;1922;79;33;2;31;.939;3600000;0
17000;6202;1918;63;30;3;27;.900;3900000;0
17000;11352;2277;89;45;3;42;.933;3900000;0
17000;179981;1918;0;0;0;0;.00nan;0;0
17000;72514;2277;0;0;0;0;.00nan;0;0
17001;11687;580;0;0;0;0;.00nan;0;0
17001;13065;580;48;27;4;23;.852;3600000;0
17001;149262;567;63;18;1;17;.944;2489000;0
17001;155945;567;18;8;4;4;.500;1089000;0
17002;6127;586;78;28;1;27;.964;3900000;0
17002;174736;586;0;0;0;0;.00nan;0;0
17002;149262;567;99;41;1;40;.976;3900000;0
17002;155945;567;0;0;0;0;.00nan;0;0
17003;11352;2277;100;41;0;41;1.000;3600000;0
17003;195672;582;0;0;0;0;.00nan;0;0
17003;216619;582;53;11;1;10;.909;3544000;0
17003;72514;2277;0;0;0;0;.00nan;0;0
17004;184159;583;81;31;2;29;.935;3600000;0
17004;-1;1922;100;30;0;30;1.000;3600000;0
17004;66353;583;0;0;0;0;.00nan;0;0
17004;160663;1922;0;0;0;0;.00nan;0;0
17005;208986;2287;72;36;3;33;.917;3900000;0
17005;196525;584;0;0;0;0;.00nan;0;0
17005;62829;584;70;30;3;27;.900;3900000;0
17005;90473;2287;0;0;0;0;.00nan;0;0
17006;195672;582;80;36;2;34;.944;3627000;0
17006;216619;582;0;0;0;0;.00nan;0;0
17006;185240;1928;0;0;0;0;.00nan;0;0
17006;-1;1928;89;34;1;33;.971;3627000;0
17007;189944;563;0;0;0;0;.00nan;0;0
17007;-1;1922;79;33;2;31;.939;3555000;0
17007;83199;563;64;18;1;17;.944;3600000;0
17007;160663;1922;0;0;0;0;.00nan;0;0
17008;6127;586;75;11;0;11;1.000;3600000;0
17008;11352;2277;76;51;5;46;.902;3600000;0
17008;174736;586;0;0;0;0;.00nan;0;0
17008;72514;2277;0;0;0;0;.00nan;0;0
17009;208986;2287;0;0;0;0;.00nan;0;0
17009;184159;583;47;24;3;21;.875;3514000;0
17009;66353;583;0;0;0;0;.00nan;0;0
17009;90473;2287;76;20;1;19;.950;3600000;0
17010;195672;582;0;0;0;0;.00nan;0;0
17010;216619;582;44;29;4;25;.862;3600000;0
17010;196525;584;70;24;1;23;.958;3600000;0
17010;62829;584;0;0;0;0;.00nan;0;0
17011;11352;2277;72;47;4;43;.915;3514000;0
17011;189944;563;65;20;2;18;.900;3600000;0
17011;72514;2277;0;0;0;0;.00nan;0;0
17011;83199;563;0;0;0;0;.00nan;0;0
17012;184159;583;19;9;4;5;.556;800000;0
17012;-1;585;43;29;5;24;.828;3600000;0
17012;66353;583;53;20;2;18;.900;2762000;0
17012;67454;585;0;0;0;0;.00nan;0;0
17013;6127;586;97;25;0;25;1.000;3600000;0
17013;11687;580;0;0;0;0;.00nan;0;0
17013;13065;580;45;21;3;18;.857;3600000;0
17013;174736;586;0;0;0;0;.00nan;0;0
17014;6202;1918;0;0;0;0;.00nan;0;0
17014;179981;1918;74;32;3;29;.906;3515000;0
17014;-1;1922;0;0;0;0;.00nan;0;0
17014;160663;1922;84;25;1;24;.960;3600000;0
17015;185240;1928;0;0;0;0;.00nan;0;0
17015;-1;1928;88;44;3;41;.932;3555000;0
17015;149262;567;0;0;0;0;.00nan;0;0
17015;155945;567;60;11;1;10;.909;3600000;0
17016;-1;585;49;19;3;16;.842;3594000;0
17016;67454;585;0;0;0;0;.00nan;0;0
17016;149262;567;78;26;1;25;.962;3600000;0
17016;155945;567;0;0;0;0;.00nan;0;0
17017;-1;585;0;0;0;0;.00nan;0;0
17017;-1;1922;48;36;5;31;.861;3600000;0
17017;67454;585;93;28;1;27;.964;3600000;0
17017;160663;1922;0;0;0;0;.00nan;0;0
17018;11352;2277;74;31;3;28;.903;3660000;0
17018;-1;1922;0;0;0;0;.00nan;0;0
17018;72514;2277;0;0;0;0;.00nan;0;0
17018;160663;1922;62;21;2;19;.905;3660000;0
17019;11687;580;0;0;0;0;.00nan;0;0
17019;13065;580;40;28;5;23;.821;3600000;0
17019;195672;582;73;30;2;28;.933;3600000;0
17019;216619;582;0;0;0;0;.00nan;0;0
17020;184159;583;75;42;4;38;.905;3543000;0
17020;-1;1922;58;18;2;16;.889;3600000;0
17020;66353;583;0;0;0;0;.00nan;0;0
17020;160663;1922;0;0;0;0;.00nan;0;0
17021;6127;586;46;27;4;23;.852;3600000;0
17021;174736;586;0;0;0;0;.00nan;0;0
17021;196525;584;0;0;0;0;.00nan;0;0
17021;62829;584;99;49;2;47;.959;3600000;0
17022;6202;1918;0;0;0;0;.00nan;0;0
17022;179981;1918;87;39;3;36;.923;3600000;0
17022;185240;1928;0;0;0;0;.00nan;0;0
17022;-1;1928;66;40;4;36;.900;3572000;0
17023;189944;563;0;0;0;0;.00nan;0;0
17023;83199;563;37;28;5;23;.821;3540000;0
17023;149262;567;0;0;0;0;.00nan;0;0
17023;155945;567;57;30;3;27;.900;3600000;0
17024;189944;563;76;35;3;32;.914;3600000;0
17024;195672;582;0;0;0;0;.00nan;0;0
17024;216619;582;58;30;4;26;.867;3568000;0
17024;83199;563;0;0;0;0;.00nan;0;0
17025;11352;2277;100;39;1;38;.974;3600000;0
17025;184159;583;59;19;2;17;.895;3582000;0
17025;66353;583;0;0;0;0;.00nan;0;0
17025;72514;2277;0;0;0;0;.00nan;0;0
17026;208986;2287;73;31;2;29;.935;3600000;0
17026;90473;2287;0;0;0;0;.00nan;0;0
17026;149262;567;56;26;4;22;.846;3531000;0
17026;155945;567;0;0;0;0;.00nan;0;0
17027;11687;580;60;4;0;4;1.000;739000;0
17027;13065;580;60;44;6;38;.864;2861000;0
17027;196525;584;73;29;3;26;.897;3600000;0
17027;62829;584;0;0;0;0;.00nan;0;0
17028;6127;586;75;24;1;23;.958;3600000;0
17028;174736;586;0;0;0;0;.00nan;0;0
17028;-1;585;0;0;0;0;.00nan;0;0
17028;67454;585;76;26;2;24;.923;3597000;0
17029;6127;586;62;23;2;21;.913;3900000;0
17029;189944;563;0;0;0;0;.00nan;0;0
17029;174736;586;0;0;0;0;.00nan;0;0
17029;83199;563;92;39;2;37;.949;3900000;0
17030;11687;580;0;0;0;0;.00nan;0;0
17030;13065;580;68;27;2;25;.926;3583000;0
17030;184159;583;96;28;1;27;.964;3600000;0
17030;66353;583;0;0;0;0;.00nan;0;0
17031;6202;1918;0;0;0;0;.00nan;0;0
17031;179981;1918;55;39;5;34;.872;3600000;0
17031;-1;1922;65;26;3;23;.885;3600000;0
17031;160663;1922;0;0;0;0;.00nan;0;0
17032;195672;582;69;40;4;36;.900;3900000;0
17032;216619;582;0;0;0;0;.00nan;0;0
17032;-1;585;0;0;0;0;.00nan;0;0
17032;67454;585;46;26;4;22;.846;3869000;0
17033;185240;1928;0;0;0;0;.00nan;0;0
17033;-1;1928;86;33;2;31;.939;3600000;0
17033;-1;1922;0;0;0;0;.00nan;0;0
17033;160663;1922;67;34;4;30;.882;3517000;0
17034;6127;586;82;29;2;27;.931;3600000;0
17034;6202;1918;0;0;0;0;.00nan;0;0
17034;174736;586;0;0;0;0;.00nan;0;0
17034;179981;1918;81;47;4;43;.915;3573000;0
17035;208986;2287;82;42;2;40;.952;3900000;0
17035;11687;580;0;0;0;0;.00nan;0;0
17035;13065;580;76;30;2;28;.933;3900000;0
17035;90473;2287;0;0;0;0;.00nan;0;0
17036;189944;563;0;0;0;0;.00nan;0;0
17036;196525;584;0;0;0;0;.00nan;0;0
17036;62829;584;24;24;5;19;.792;3600000;0
17036;83199;563;63;24;2;22;.917;3600000;0
17037;11352;2277;44;40;6;34;.850;3600000;0
17037;72514;2277;0;0;0;0;.00nan;0;0
17037;149262;567;0;0;0;0;.00nan;0;0
17037;155945;567;93;16;0;16;1.000;3600000;0
17039;11687;580;0;0;0;0;.00nan;0;0
17039;189944;563;52;34;5;29;.853;3631000;0
17039;83199;563;0;0;0;0;.00nan;0;0
17039;155917;580;62;38;4;34;.895;3631000;0
17041;6202;1918;0;0;0;0;.00nan;0;0
17041;11352;2277;81;28;1;27;.964;3600000;0
17041;179981;1918;47;26;4;22;.846;3600000;0
17041;72514;2277;0;0;0;0;.00nan;0;0
17043;196525;584;68;19;1;18;.947;3600000;0
17043;-1;585;52;37;5;32;.865;3600000;0
17043;67454;585;0;0;0;0;.00nan;0;0
17043;143879;584;0;0;0;0;.00nan;0;0
17045;-1;567;0;0;0;0;.00nan;0;0
17045;-1;1922;63;30;3;27;.900;3567000;0
17045;155945;567;97;38;2;36;.947;3600000;0
17045;160663;1922;0;0;0;0;.00nan;0;0
17047;174736;586;48;16;3;13;.813;3544000;0
17047;185240;1928;0;0;0;0;.00nan;0;0
17047;-1;1928;79;32;2;30;.938;3600000;0
17047;64923;586;0;0;0;0;.00nan;0;0
17049;208986;2287;48;38;6;32;.842;3030000;0
17049;184159;583;72;23;1;22;.957;3600000;0
17049;66353;583;0;0;0;0;.00nan;0;0
17049;90473;2287;51;2;0;2;1.000;570000;0
17051;11352;2277;0;0;0;0;.00nan;0;0
17051;185240;1928;81;23;1;22;.957;3600000;0
17051;-1;1928;0;0;0;0;.00nan;0;0
17051;72514;2277;69;35;3;32;.914;3589000;0
17053;6202;1918;89;36;1;35;.972;3600000;0
17053;179981;1918;0;0;0;0;.00nan;0;0
17053;-1;567;33;13;3;10;.769;3542000;0
17053;155945;567;0;0;0;0;.00nan;0;0
17055;11687;580;86;29;2;27;.931;3600000;0
17055;-1;585;0;0;0;0;.00nan;0;0
17055;67454;585;76;33;3;30;.909;3560000;0
17055;155917;580;0;0;0;0;.00nan;0;0
17057;189944;563;0;0;0;0;.00nan;0;0
17057;196525;584;0;0;0;0;.00nan;0;0
17057;83199;563;84;37;2;35;.946;3600000;0
17057;143879;584;68;24;3;21;.875;3583000;0
17059;208986;2287;67;46;4;42;.913;3600000;0
17059;174736;586;0;0;0;0;.00nan;0;0
17059;64923;586;41;17;3;14;.824;3600000;0
17059;90473;2287;0;0;0;0;.00nan;0;0
17061;184159;583;0;0;0;0;.00nan;0;0
17061;195672;582;60;25;2;23;.920;3600000;0
17061;216619;582;0;0;0;0;.00nan;0;0
17061;66353;583;72;21;1;20;.952;3600000;0
17063;208986;2287;76;27;1;26;.963;3900000;0
17063;-1;585;64;16;1;15;.938;3900000;0
17063;67454;585;0;0;0;0;.00nan;0;0
17063;90473;2287;0;0;0;0;.00nan;0;0
17065;11687;580;0;0;0;0;.00nan;0;0
17065;184159;583;56;18;2;16;.889;3900000;0
17065;66353;583;0;0;0;0;.00nan;0;0
17065;155917;580;79;32;2;30;.938;3900000;0
17067;6202;1918;0;0;0;0;.00nan;0;0
17067;174736;586;64;14;1;13;.929;3600000;0
17067;179981;1918;94;46;3;43;.935;3568000;0
17067;64923;586;0;0;0;0;.00nan;0;0
17069;11352;2277;46;39;6;33;.846;3600000;0
17069;195672;582;47;11;2;9;.818;3600000;0
17069;216619;582;0;0;0;0;.00nan;0;0
17069;72514;2277;0;0;0;0;.00nan;0;0
17071;196525;584;44;38;6;32;.842;3600000;0
17071;-1;567;0;0;0;0;.00nan;0;0
17071;143879;584;0;0;0;0;.00nan;0;0
17071;155945;567;66;22;2;20;.909;3600000;0
17073;185240;1928;0;0;0;0;.00nan;0;0
17073;-1;1928;69;31;3;28;.903;3600000;0
17073;-1;1922;65;39;5;34;.872;3538000;0
17073;160663;1922;0;0;0;0;.00nan;0;0
17075;11687;580;82;25;1;24;.960;3600000;0
17075;196525;584;65;29;3;26;.897;3517000;0
17075;143879;584;0;0;0;0;.00nan;0;0
17075;155917;580;0;0;0;0;.00nan;0;0
17077;195672;582;0;0;0;0;.00nan;0;0
17077;216619;582;57;24;3;21;.875;3600000;0
17077;-1;585;0;0;0;0;.00nan;0;0
17077;67454;585;45;39;6;33;.846;3600000;0
17079;11352;2277;39;21;4;17;.810;1488000;0
17079;189944;563;0;0;0;0;.00nan;0;0
17079;72514;2277;32;22;5;17;.773;2112000;0
17079;83199;563;74;20;1;19;.950;3600000;0
17081;174736;586;0;0;0;0;.00nan;0;0
17081;185240;1928;80;32;2;30;.938;3544000;0
17081;-1;1928;0;0;0;0;.00nan;0;0
17081;64923;586;67;21;1;20;.952;3600000;0
17083;208986;2287;0;0;0;0;.00nan;0;0
17083;-1;1922;0;0;0;0;.00nan;0;0
17083;90473;2287;70;35;3;32;.914;3563000;0
17083;160663;1922;53;16;2;14;.875;3600000;0
17085;6202;1918;82;31;1;30;.968;3600000;0
17085;179981;1918;0;0;0;0;.00nan;0;0
17085;-1;567;76;37;3;34;.919;3593000;0
17085;155945;567;0;0;0;0;.00nan;0;0
17087;184159;583;70;27;2;25;.926;3600000;0
17087;-1;1922;52;27;5;22;.815;3600000;0
17087;66353;583;0;0;0;0;.00nan;0;0
17087;160663;1922;0;0;0;0;.00nan;0;0
17089;185240;1928;0;0;0;0;.00nan;0;0
17089;196525;584;40;37;6;31;.838;3600000;0
17089;-1;1928;74;33;3;30;.909;3600000;0
17089;143879;584;0;0;0;0;.00nan;0;0
17091;11352;2277;86;35;2;33;.943;3600000;0
17091;-1;567;0;0;0;0;.00nan;0;0
17091;72514;2277;0;0;0;0;.00nan;0;0
17091;155945;567;43;25;4;21;.840;3552000;0
17093;11687;580;0;0;0;0;.00nan;0;0
17093;-1;585;67;30;3;27;.900;3562000;0
17093;67454;585;0;0;0;0;.00nan;0;0
17093;155917;580;76;22;1;21;.955;3600000;0
17095;208986;2287;94;36;1;35;.972;3873000;0
17095;189944;563;0;0;0;0;.00nan;0;0
17095;83199;563;85;36;1;35;.972;3900000;0
17095;90473;2287;0;0;0;0;.00nan;0;0
17097;174736;586;28;16;4;12;.750;2359000;0
17097;195672;582;50;20;3;17;.850;3600000;0
17097;216619;582;0;0;0;0;.00nan;0;0
17097;64923;586;18;9;4;5;.556;1241000;0
17099;208986;2287;0;0;0;0;.00nan;0;0
17099;11687;580;77;9;0;9;1.000;3600000;0
17099;90473;2287;78;38;3;35;.921;3600000;0
17099;155917;580;0;0;0;0;.00nan;0;0
17101;6202;1918;0;0;0;0;.00nan;0;0
17101;195672;582;0;0;0;0;.00nan;0;0
17101;216619;582;54;26;3;23;.885;3600000;0
17101;179981;1918;52;27;4;23;.852;3587000;0
17103;14191;586;0;0;0;0;.00nan;0;0
17103;174736;586;61;23;2;21;.913;3600000;0
17103;-1;567;67;34;3;31;.912;3600000;0
17103;155945;567;0;0;0;0;.00nan;0;0
17105;184159;583;0;0;0;0;.00nan;0;0
17105;185240;1928;74;39;3;36;.923;3592000;0
17105;-1;1928;0;0;0;0;.00nan;0;0
17105;66353;583;70;30;2;28;.933;3600000;0
17107;196525;584;45;36;5;31;.861;3530000;0
17107;-1;585;0;0;0;0;.00nan;0;0
17107;67454;585;49;16;3;13;.813;3600000;0
17107;143879;584;0;0;0;0;.00nan;0;0
17109;189944;563;58;28;3;25;.893;3600000;0
17109;-1;1922;0;0;0;0;.00nan;0;0
17109;83199;563;0;0;0;0;.00nan;0;0
17109;160663;1922;77;44;4;40;.909;3600000;0
17111;11687;580;38;20;4;16;.800;3600000;0
17111;189944;563;0;0;0;0;.00nan;0;0
17111;83199;563;32;23;5;18;.783;3546000;0
17111;155917;580;0;0;0;0;.00nan;0;0
17113;195672;582;76;26;2;24;.923;3600000;0
17113;216619;582;0;0;0;0;.00nan;0;0
17113;-1;585;56;32;4;28;.875;3519000;0
17113;67454;585;0;0;0;0;.00nan;0;0
17115;14191;586;0;0;0;0;.00nan;0;0
17115;174736;586;52;23;3;20;.870;3576000;0
17115;-1;567;0;0;0;0;.00nan;0;0
17115;155945;567;83;24;1;23;.958;3600000;0
17117;208986;2287;78;34;3;31;.912;3600000;0
17117;-1;1922;0;0;0;0;.00nan;0;0
17117;90473;2287;0;0;0;0;.00nan;0;0
17117;160663;1922;48;32;5;27;.844;3576000;0
17119;11352;2277;77;33;3;30;.909;3600000;0
17119;196525;584;35;17;4;13;.765;3563000;0
17119;72514;2277;0;0;0;0;.00nan;0;0
17119;143879;584;0;0;0;0;.00nan;0;0
17121;6202;1918;0;0;0;0;.00nan;0;0
17121;179981;1918;90;41;3;38;.927;3567000;0
17121;185240;1928;0;0;0;0;.00nan;0;0
17121;-1;1928;80;31;2;29;.935;3600000;0
1187;195672;582;52;30;4;26;.867;3600000;0
1187;216619;582;0;0;0;0;.00nan;0;0
1187;196525;584;38;29;6;23;.793;3514000;0
1187;62829;584;0;0;0;0;.00nan;0;0
1188;184159;583;68;22;2;20;.909;3582000;0
1188;-1;1922;72;18;1;17;.944;3600000;0
1188;66353;583;0;0;0;0;.00nan;0;0
1188;160663;1922;0;0;0;0;.00nan;0;0
1189;195672;582;52;32;4;28;.875;3562000;0
1189;216619;582;0;0;0;0;.00nan;0;0
1189;196525;584;56;19;2;17;.895;3600000;0
1189;62829;584;0;0;0;0;.00nan;0;0
1190;184159;583;53;22;3;19;.864;3600000;0
1190;-1;1922;85;31;2;29;.935;3600000;0
1190;66353;583;0;0;0;0;.00nan;0;0
1190;160663;1922;0;0;0;0;.00nan;0;0
1313;195672;582;64;26;3;23;.885;3600000;0
1313;216619;582;0;0;0;0;.00nan;0;0
1313;196525;584;63;34;4;30;.882;3562000;0
1313;62829;584;0;0;0;0;.00nan;0;0
1382;6127;586;36;18;4;14;.778;3578000;0
1382;174736;586;0;0;0;0;.00nan;0;0
1382;195672;582;96;51;3;48;.941;3600000;0
1382;216619;582;0;0;0;0;.00nan;0;0
1383;-1;585;76;43;3;40;.930;3521000;0
1383;67454;585;0;0;0;0;.00nan;0;0
1383;149262;567;0;0;0;0;.00nan;0;0
1383;155945;567;80;25;1;24;.960;3600000;0
1384;11687;580;0;0;0;0;.00nan;0;0
1384;13065;580;59;28;3;25;.893;4768000;0
1384;185240;1928;0;0;0;0;.00nan;0;0
1384;-1;1928;68;36;4;32;.889;4768000;0
1385;189944;563;0;0;0;0;.00nan;0;0
1385;-1;1922;89;40;3;37;.925;3600000;0
1385;83199;563;55;39;5;34;.872;3537000;0
1385;160663;1922;0;0;0;0;.00nan;0;0
1386;6127;586;63;21;2;19;.905;3600000;0
1386;174736;586;0;0;0;0;.00nan;0;0
1386;195672;582;26;35;7;28;.800;3600000;0
1386;216619;582;0;0;0;0;.00nan;0;0
1387;-1;585;82;31;2;29;.935;3841000;0
1387;67454;585;0;0;0;0;.00nan;0;0
1387;149262;567;84;31;1;30;.968;3841000;0
1387;155945;567;0;0;0;0;.00nan;0;0
1388;11687;580;0;0;0;0;.00nan;0;0
1388;13065;580;42;27;4;23;.852;3600000;0
1388;185240;1928;0;0;0;0;.00nan;0;0
1388;-1;1928;99;30;1;29;.967;3600000;0
1389;189944;563;0;0;0;0;.00nan;0;0
1389;-1;1922;59;35;4;31;.886;3600000;0
1389;83199;563;81;26;1;25;.962;3600000;0
1389;160663;1922;0;0;0;0;.00nan;0;0
1390;6127;586;70;32;3;29;.906;3583000;0
1390;174736;586;0;0;0;0;.00nan;0;0
1390;195672;582;76;28;2;26;.929;3600000;0
1390;216619;582;0;0;0;0;.00nan;0;0
1391;-1;585;46;33;5;28;.848;3600000;0
1391;67454;585;0;0;0;0;.00nan;0;0
1391;149262;567;100;34;0;34;1.000;3600000;0
1391;155945;567;0;0;0;0;.00nan;0;0
1392;11687;580;0;0;0;0;.00nan;0;0
1392;13065;580;82;27;1;26;.963;3600000;0
1392;185240;1928;0;0;0;0;.00nan;0;0
1392;-1;1928;65;39;4;35;.897;3600000;0
1393;189944;563;0;0;0;0;.00nan;0;0
1393;-1;1922;72;28;2;26;.929;3572000;0
1393;83199;563;92;28;1;27;.964;3600000;0
1393;160663;1922;0;0;0;0;.00nan;0;0
1586;6127;586;77;10;0;10;1.000;3600000;0
1586;174736;586;0;0;0;0;.00nan;0;0
1586;195672;582;61;39;4;35;.897;3600000;0
1586;216619;582;0;0;0;0;.00nan;0;0
1587;11687;580;0;0;0;0;.00nan;0;0
1587;13065;580;63;32;3;29;.906;3592000;0
1587;185240;1928;0;0;0;0;.00nan;0;0
1587;-1;1928;79;31;2;29;.935;3600000;0
1588;189944;563;0;0;0;0;.00nan;0;0
1588;-1;1922;60;37;4;33;.892;3600000;0
1588;83199;563;83;25;1;24;.960;3600000;0
1588;160663;1922;0;0;0;0;.00nan;0;0
1631;6127;586;63;14;1;13;.929;3600000;0
1631;174736;586;0;0;0;0;.00nan;0;0
1631;195672;582;24;35;7;28;.800;3600000;0
1631;216619;582;0;0;0;0;.00nan;0;0
1632;11687;580;0;0;0;0;.00nan;0;0
1632;13065;580;83;34;2;32;.941;3617000;0
1632;185240;1928;0;0;0;0;.00nan;0;0
1632;-1;1928;65;30;3;27;.900;3617000;0
1772;6127;586;68;32;3;29;.906;3600000;0
1772;11687;580;0;0;0;0;.00nan;0;0
1772;13065;580;41;31;5;26;.839;3566000;0
1772;174736;586;0;0;0;0;.00nan;0;0
1773;189944;563;63;18;2;16;.889;3773000;0
1773;83199;563;0;0;0;0;.00nan;0;0
1773;149262;567;96;37;1;36;.973;3773000;0
1773;155945;567;0;0;0;0;.00nan;0;0
1774;6127;586;44;16;3;13;.813;3600000;0
1774;11687;580;0;0;0;0;.00nan;0;0
1774;13065;580;80;47;4;43;.915;3584000;0
1774;174736;586;0;0;0;0;.00nan;0;0
1775;189944;563;79;36;3;33;.917;3600000;0
1775;83199;563;0;0;0;0;.00nan;0;0
1775;149262;567;93;34;2;32;.941;3600000;0
1775;155945;567;0;0;0;0;.00nan;0;0
1776;6127;586;89;50;3;47;.940;5527000;0
1776;11687;580;0;0;0;0;.00nan;0;0
1776;13065;580;85;41;2;39;.951;5527000;0
1776;174736;586;0;0;0;0;.00nan;0;0
1777;189944;563;65;27;3;24;.889;3600000;0
1777;83199;563;0;0;0;0;.00nan;0;0
1777;149262;567;43;28;5;23;.821;3572000;0
1777;155945;567;0;0;0;0;.00nan;0;0
1897;6127;586;66;24;2;22;.917;3600000;0
1897;11687;580;0;0;0;0;.00nan;0;0
1897;13065;580;56;30;4;26;.867;3530000;0
1897;174736;586;0;0;0;0;.00nan;0;0
1898;189944;563;29;22;5;17;.773;3550000;0
1898;83199;563;0;0;0;0;.00nan;0;0
1898;149262;567;78;42;4;38;.905;3600000;0
1898;155945;567;0;0;0;0;.00nan;0;0
1949;11687;580;42;3;1;2;.667;319000;0
1949;13065;580;32;37;7;30;.811;3281000;0
1949;189944;563;86;28;1;27;.964;3600000;0
1949;83199;563;0;0;0;0;.00nan;0;0
1950;6127;586;51;22;3;19;.864;3565000;0
1950;174736;586;0;0;0;0;.00nan;0;0
1950;149262;567;76;26;1;25;.962;3600000;0
1950;155945;567;0;0;0;0;.00nan;0;0
1951;6127;586;63;22;2;20;.909;3600000;0
1951;174736;586;0;0;0;0;.00nan;0;0
1951;149262;567;25;34;7;27;.794;3600000;0
1951;155945;567;0;0;0;0;.00nan;0;0
1952;6127;586;66;20;2;18;.900;3600000;0
1952;174736;586;0;0;0;0;.00nan;0;0
1952;149262;567;52;34;5;29;.853;3600000;0
1952;155945;567;0;0;0;0;.00nan;0;0
1953;6127;586;76;20;1;19;.950;3600000;0
1953;174736;586;0;0;0;0;.00nan;0;0
1953;149262;567;29;30;6;24;.800;3600000;0
1953;155945;567;0;0;0;0;.00nan;0;0
2170;6127;586;72;28;2;26;.929;3600000;0
2170;174736;586;0;0;0;0;.00nan;0;0
2170;149262;567;43;27;4;23;.852;3573000;0
2170;155945;567;0;0;0;0;.00nan;0;0
17122;193341;1838;91;40;2;38;.950;3600000;0
17122;-1;633;23;35;6;29;.829;3600000;0
17122;-1;633;0;0;0;0;.00nan;0;0
17122;-1;1838;0;0;0;0;.00nan;0;0
17123;-1;1813;85;38;2;36;.947;3600000;0
17123;-1;649;0;0;0;0;.00nan;0;0
17123;-1;1813;0;0;0;0;.00nan;0;0
17123;85947;649;76;20;1;19;.950;3600000;0
17124;214281;1809;31;12;4;8;.667;861000;0
17124;164404;1809;82;42;3;39;.929;2739000;0
17124;195761;651;63;20;3;17;.850;3600000;0
17124;-1;651;0;0;0;0;.00nan;0;0
17125;-1;1825;66;34;4;30;.882;3600000;0
17125;-1;646;0;0;0;0;.00nan;0;0
17125;-1;646;93;26;1;25;.962;3600000;0
17125;-1;1825;0;0;0;0;.00nan;0;0
17126;177631;1818;92;31;1;30;.968;3600000;0
17126;-1;4538;54;10;1;9;.900;1492000;0
17126;211456;4538;13;18;6;12;.667;2108000;0
17126;156632;1818;0;0;0;0;.00nan;0;0
17127;8942;638;0;0;0;0;.00nan;0;0
17127;193687;703;65;25;3;22;.880;3600000;0
17127;214635;703;0;0;0;0;.00nan;0;0
17127;-1;638;47;31;4;27;.871;3551000;0
17128;-1;1835;99;34;1;33;.971;3600000;0
17128;174806;648;0;0;0;0;.00nan;0;0
17128;-1;1835;0;0;0;0;.00nan;0;0
17128;72747;648;45;17;3;14;.824;3557000;0
17129;193687;703;88;32;1;31;.969;3600000;0
17129;214635;703;0;0;0;0;.00nan;0;0
17129;-1;1813;70;25;2;23;.920;3599000;0
17129;-1;1813;0;0;0;0;.00nan;0;0
17130;193341;1838;68;32;3;29;.906;3600000;0
17130;-1;4538;93;20;0;20;1.000;3600000;0
17130;211456;4538;0;0;0;0;.00nan;0;0
17130;-1;1838;0;0;0;0;.00nan;0;0
17131;-1;1825;97;50;2;48;.960;3540000;0
17131;195761;651;76;8;0;8;1.000;3600000;0
17131;-1;651;0;0;0;0;.00nan;0;0
17131;-1;1825;0;0;0;0;.00nan;0;0
17132;174806;648;0;0;0;0;.00nan;0;0
17132;-1;633;61;35;4;31;.886;3513000;0
17132;-1;633;0;0;0;0;.00nan;0;0
17132;72747;648;60;21;2;19;.905;3600000;0
17133;8942;638;52;41;6;35;.854;2731000;0
17133;-1;1835;41;30;5;25;.833;3600000;0
17133;-1;638;68;18;1;17;.944;869000;0
17133;-1;1835;0;0;0;0;.00nan;0;0
17134;214281;1809;84;47;3;44;.936;5027000;0
17134;177631;1818;89;47;2;45;.957;5027000;0
17134;164404;1809;0;0;0;0;.00nan;0;0
17134;156632;1818;0;0;0;0;.00nan;0;0
17135;-1;649;0;0;0;0;.00nan;0;0
17135;-1;646;0;0;0;0;.00nan;0;0
17135;-1;646;58;23;2;21;.913;3600000;0
17135;85947;649;44;28;4;24;.857;3561000;0
17136;193341;1838;0;0;0;0;.00nan;0;0
17136;193687;703;92;51;4;47;.922;3560000;0
17136;214635;703;0;0;0;0;.00nan;0;0
17136;-1;1838;61;20;2;18;.900;3600000;0
17137;-1;1825;58;28;3;25;.893;3600000;0
17137;-1;1813;48;24;4;20;.833;3549000;0
17137;-1;1813;0;0;0;0;.00nan;0;0
17137;-1;1825;0;0;0;0;.00nan;0;0
17138;195761;651;38;26;5;21;.808;3600000;0
17138;-1;633;45;34;6;28;.824;3286000;0
17138;-1;633;54;4;0;4;1.000;314000;0
17138;-1;651;0;0;0;0;.00nan;0;0
17139;214281;1809;0;0;0;0;.00nan;0;0
17139;164404;1809;80;30;2;28;.933;3561000;0
17139;-1;646;0;0;0;0;.00nan;0;0
17139;-1;646;89;32;1;31;.969;3600000;0
17140;177631;1818;83;32;2;30;.938;3598000;0
17140;-1;1835;76;19;1;18;.947;3600000;0
17140;-1;1835;0;0;0;0;.00nan;0;0
17140;156632;1818;0;0;0;0;.00nan;0;0
17141;8942;638;97;41;2;39;.951;3600000;0
17141;-1;649;0;0;0;0;.00nan;0;0
17141;-1;638;0;0;0;0;.00nan;0;0
17141;85947;649;79;25;1;24;.960;3600000;0
17142;-1;4538;96;29;0;29;1.000;3600000;0
17142;174806;648;0;0;0;0;.00nan;0;0
17142;211456;4538;0;0;0;0;.00nan;0;0
17142;72747;648;40;22;4;18;.818;3600000;0
17143;193687;703;100;43;1;42;.977;3600000;0
17143;214635;703;0;0;0;0;.00nan;0;0
17143;195761;651;54;15;2;13;.867;3544000;0
17143;-1;651;0;0;0;0;.00nan;0;0
17144;8942;638;40;30;5;25;.833;3600000;0
17144;-1;4538;71;27;3;24;.889;3600000;0
17144;211456;4538;0;0;0;0;.00nan;0;0
17144;-1;638;0;0;0;0;.00nan;0;0
17145;-1;1825;94;51;3;48;.941;4486000;0
17145;174806;648;0;0;0;0;.00nan;0;0
17145;-1;1825;0;0;0;0;.00nan;0;0
17145;72747;648;71;24;2;22;.917;4486000;0
17146;-1;633;22;19;6;13;.684;2536000;0
17146;-1;633;55;10;1;9;.900;1027000;0
17146;-1;646;35;32;6;26;.813;3600000;0
17146;-1;646;0;0;0;0;.00nan;0;0
17147;193341;1838;59;18;2;16;.889;3600000;0
17147;-1;1835;63;39;4;35;.897;3543000;0
17147;-1;1838;0;0;0;0;.00nan;0;0
17147;-1;1835;0;0;0;0;.00nan;0;0
17148;177631;1818;14;14;5;9;.643;1121000;0
17148;-1;649;0;0;0;0;.00nan;0;0
17148;85947;649;38;28;5;23;.821;3600000;0
17148;156632;1818;40;23;4;19;.826;2479000;0
17149;214281;1809;61;27;2;25;.926;3546000;0
17149;164404;1809;0;0;0;0;.00nan;0;0
17149;-1;1813;82;28;1;27;.964;3600000;0
17149;-1;1813;0;0;0;0;.00nan;0;0
17150;193687;703;72;43;4;39;.907;3600000;0
17150;214635;703;0;0;0;0;.00nan;0;0
17150;-1;4538;78;28;1;27;.964;3600000;0
17150;211456;4538;0;0;0;0;.00nan;0;0
17151;214281;1809;0;0;0;0;.00nan;0;0
17151;193341;1838;83;38;2;36;.947;5545000;0
17151;164404;1809;81;50;3;47;.940;5545000;0
17151;-1;1838;0;0;0;0;.00nan;0;0
17152;177631;1818;74;39;3;36;.923;3600000;0
17152;-1;1813;87;26;1;25;.962;3600000;0
17152;-1;1813;0;0;0;0;.00nan;0;0
17152;156632;1818;0;0;0;0;.00nan;0;0
17153;-1;1835;86;42;2;40;.952;4278000;0
17153;195761;651;75;24;1;23;.958;4278000;0
17153;-1;651;0;0;0;0;.00nan;0;0
17153;-1;1835;0;0;0;0;.00nan;0;0
17154;8942;638;0;0;0;0;.00nan;0;0
17154;-1;1825;81;31;1;30;.968;3600000;0
17154;-1;638;67;34;3;31;.912;3551000;0
17154;-1;1825;0;0;0;0;.00nan;0;0
17155;174806;648;31;6;3;3;.500;364000;0
17155;-1;646;0;0;0;0;.00nan;0;0
17155;-1;646;78;32;2;30;.938;3600000;0
17155;72747;648;31;26;5;21;.808;3236000;0
17156;-1;633;90;50;3;47;.940;3555000;0
17156;-1;633;0;0;0;0;.00nan;0;0
17156;-1;649;0;0;0;0;.00nan;0;0
17156;85947;649;61;25;2;23;.920;3600000;0
17157;-1;4538;80;43;4;39;.907;3631000;0
17157;211456;4538;0;0;0;0;.00nan;0;0
17157;195761;651;77;17;0;17;1.000;3066000;0
17157;-1;651;30;7;3;4;.571;565000;0
17158;193341;1838;65;35;4;31;.886;3600000;0
17158;-1;646;0;0;0;0;.00nan;0;0
17158;-1;646;85;30;1;29;.967;3600000;0
17158;-1;1838;0;0;0;0;.00nan;0;0
17159;193687;703;51;28;4;24;.857;3808000;0
17159;214635;703;0;0;0;0;.00nan;0;0
17159;-1;1825;45;20;3;17;.850;3808000;0
17159;-1;1825;0;0;0;0;.00nan;0;0
17160;-1;633;0;0;0;0;.00nan;0;0
17160;-1;633;80;43;3;40;.930;3803000;0
17160;-1;1813;50;23;4;19;.826;3803000;0
17160;-1;1813;0;0;0;0;.00nan;0;0
17161;177631;1818;0;0;0;0;.00nan;0;0
17161;174806;648;0;0;0;0;.00nan;0;0
17161;72747;648;79;38;3;35;.921;3586000;0
17161;156632;1818;69;23;2;21;.913;3600000;0
17162;-1;1835;52;18;2;16;.889;3576000;0
17162;-1;649;0;0;0;0;.00nan;0;0
17162;-1;1835;0;0;0;0;.00nan;0;0
17162;85947;649;85;30;1;29;.967;3600000;0
17163;214281;1809;95;28;1;27;.964;3600000;0
17163;8942;638;57;26;4;22;.846;3600000;0
17163;164404;1809;0;0;0;0;.00nan;0;0
17163;-1;638;0;0;0;0;.00nan;0;0
17164;193687;703;63;23;2;21;.913;3557000;0
17164;214635;703;0;0;0;0;.00nan;0;0
17164;-1;1835;76;25;1;24;.960;3600000;0
17164;-1;1835;0;0;0;0;.00nan;0;0
17165;-1;1813;0;0;0;0;.00nan;0;0
17165;-1;646;0;0;0;0;.00nan;0;0
17165;-1;646;67;24;2;22;.917;3600000;0
17165;-1;1813;75;22;1;21;.955;3600000;0
17166;177631;1818;27;34;7;27;.794;3600000;0
17166;195761;651;0;0;0;0;.00nan;0;0
17166;-1;651;98;28;1;27;.964;3600000;0
17166;156632;1818;0;0;0;0;.00nan;0;0
17167;-1;1825;30;10;3;7;.700;589000;0
17167;-1;633;77;30;2;28;.933;3600000;0
17167;-1;633;0;0;0;0;.00nan;0;0
17167;-1;1825;72;33;3;30;.909;3011000;0
17168;8942;638;31;39;7;32;.821;2943000;0
17168;174806;648;0;0;0;0;.00nan;0;0
17168;-1;638;54;4;0;4;1.000;657000;0
17168;72747;648;46;20;3;17;.850;3600000;0
17169;214281;1809;0;0;0;0;.00nan;0;0
17169;164404;1809;48;37;5;32;.865;3570000;0
17169;-1;4538;56;31;4;27;.871;3600000;0
17169;211456;4538;0;0;0;0;.00nan;0;0
17170;193341;1838;63;38;4;34;.895;4123000;0
17170;-1;649;0;0;0;0;.00nan;0;0
17170;-1;1838;0;0;0;0;.00nan;0;0
17170;85947;649;56;33;5;28;.848;4123000;0
17171;214281;1809;65;30;3;27;.900;3600000;0
17171;193687;703;61;49;6;43;.878;3600000;0
17171;214635;703;0;0;0;0;.00nan;0;0
17171;164404;1809;0;0;0;0;.00nan;0;0
17172;193341;1838;47;23;4;19;.826;3600000;0
17172;174806;648;0;0;0;0;.00nan;0;0
17172;-1;1838;0;0;0;0;.00nan;0;0
17172;72747;648;73;26;1;25;.962;3600000;0
17173;195761;651;0;0;0;0;.00nan;0;0
17173;-1;1813;46;33;5;28;.848;3566000;0
17173;-1;651;48;19;3;16;.842;3600000;0
17173;-1;1813;0;0;0;0;.00nan;0;0
17174;177631;1818;59;28;4;24;.857;3756000;0
17174;-1;1825;67;37;3;34;.919;3756000;0
17174;-1;1825;0;0;0;0;.00nan;0;0
17174;156632;1818;0;0;0;0;.00nan;0;0
17175;-1;1835;84;23;1;22;.957;3600000;0
17175;-1;633;76;38;3;35;.921;3577000;0
17175;-1;633;0;0;0;0;.00nan;0;0
17175;-1;1835;0;0;0;0;.00nan;0;0
17176;8942;638;0;0;0;0;.00nan;0;0
17176;-1;638;96;44;2;42;.955;3600000;0
17176;-1;646;0;0;0;0;.00nan;0;0
17176;-1;646;93;25;0;25;1.000;3600000;0
17177;-1;4538;67;34;3;31;.912;3575000;0
17177;211456;4538;0;0;0;0;.00nan;0;0
17177;-1;649;0;0;0;0;.00nan;0;0
17177;85947;649;57;18;2;16;.889;3600000;0
17178;-1;4538;0;0;0;0;.00nan;0;0
17178;211456;4538;72;29;1;28;.966;3630000;0
17178;-1;633;92;50;2;48;.960;3630000;0
17178;-1;633;0;0;0;0;.00nan;0;0
17179;8942;638;41;10;2;8;.800;559000;0
17179;195761;651;0;0;0;0;.00nan;0;0
17179;-1;638;75;56;6;50;.893;3041000;0
17179;-1;651;57;27;4;23;.852;3600000;0
17180;193687;703;63;48;6;42;.875;3600000;0
17180;214635;703;0;0;0;0;.00nan;0;0
17180;-1;646;0;0;0;0;.00nan;0;0
17180;-1;646;69;21;1;20;.952;3600000;0
17181;193341;1838;48;24;4;20;.833;3544000;0
17181;177631;1818;0;0;0;0;.00nan;0;0
17181;-1;1838;0;0;0;0;.00nan;0;0
17181;156632;1818;72;30;2;28;.933;3600000;0
17182;-1;1835;88;17;0;17;1.000;3600000;0
17182;-1;1825;42;38;6;32;.842;3600000;0
17182;-1;1835;0;0;0;0;.00nan;0;0
17182;-1;1825;0;0;0;0;.00nan;0;0
17183;214281;1809;0;0;0;0;.00nan;0;0
17183;164404;1809;65;35;4;31;.886;3851000;0
17183;-1;649;0;0;0;0;.00nan;0;0
17183;85947;649;61;27;3;24;.889;3851000;0
17184;174806;648;22;4;3;1;.250;151000;0
17184;-1;1813;54;23;3;20;.870;3600000;0
17184;-1;1813;0;0;0;0;.00nan;0;0
17184;72747;648;46;39;5;34;.872;3449000;0
17185;214281;1809;67;40;4;36;.900;4427000;0
17185;164404;1809;0;0;0;0;.00nan;0;0
17185;195761;651;48;34;5;29;.853;4427000;0
17185;-1;651;0;0;0;0;.00nan;0;0
17186;193687;703;75;19;1;18;.947;3600000;0
17186;214635;703;0;0;0;0;.00nan;0;0
17186;174806;648;0;0;0;0;.00nan;0;0
17186;72747;648;70;26;2;24;.923;3576000;0
17187;193341;1838;92;37;2;35;.946;3600000;0
17187;195761;651;0;0;0;0;.00nan;0;0
17187;-1;651;38;18;4;14;.778;3578000;0
17187;-1;1838;0;0;0;0;.00nan;0;0
17188;177631;1818;100;24;0;24;1.000;3600000;0
17188;-1;646;46;31;4;27;.871;3600000;0
17188;-1;646;0;0;0;0;.00nan;0;0
17188;156632;1818;0;0;0;0;.00nan;0;0
17189;-1;1825;87;40;3;37;.925;3570000;0
17189;-1;649;0;0;0;0;.00nan;0;0
17189;-1;1825;0;0;0;0;.00nan;0;0
17189;85947;649;79;31;2;29;.935;3600000;0
17190;214281;1809;67;44;5;39;.886;3600000;0
17190;164404;1809;0;0;0;0;.00nan;0;0
17190;-1;633;73;34;3;31;.912;3600000;0
17190;-1;633;0;0;0;0;.00nan;0;0
17191;-1;1835;64;19;2;17;.895;3600000;0
17191;-1;4538;72;30;3;27;.900;3600000;0
17191;211456;4538;0;0;0;0;.00nan;0;0
17191;-1;1835;0;0;0;0;.00nan;0;0
17192;8942;638;29;39;7;32;.821;3600000;0
17192;-1;1813;57;20;2;18;.900;3600000;0
17192;-1;638;0;0;0;0;.00nan;0;0
17192;-1;1813;0;0;0;0;.00nan;0;0
17193;193341;1838;63;18;2;16;.889;3600000;0
17193;8942;638;28;7;3;4;.571;598000;0
17193;-1;638;70;27;2;25;.926;3002000;0
17193;-1;1838;0;0;0;0;.00nan;0;0
17194;-1;4538;55;22;3;19;.864;3564000;0
17194;211456;4538;0;0;0;0;.00nan;0;0
17194;-1;646;0;0;0;0;.00nan;0;0
17194;-1;646;71;27;2;25;.926;3600000;0
17195;-1;1835;61;25;3;22;.880;3549000;0
17195;-1;1813;0;0;0;0;.00nan;0;0
17195;-1;1813;80;32;2;30;.938;3600000;0
17195;-1;1835;0;0;0;0;.00nan;0;0
17196;177631;1818;74;16;1;15;.938;3600000;0
17196;-1;633;97;50;2;48;.960;3563000;0
17196;-1;633;0;0;0;0;.00nan;0;0
17196;156632;1818;0;0;0;0;.00nan;0;0
17197;214281;1809;0;0;0;0;.00nan;0;0
17197;164404;1809;94;19;0;19;1.000;3600000;0
17197;-1;1825;52;37;5;32;.865;3600000;0
17197;-1;1825;0;0;0;0;.00nan;0;0
17198;174806;648;68;34;3;31;.912;3566000;0
17198;195761;651;63;26;2;24;.923;3600000;0
17198;-1;651;0;0;0;0;.00nan;0;0
17198;72747;648;0;0;0;0;.00nan;0;0
17199;193687;703;61;39;5;34;.872;3600000;0
17199;214635;703;0;0;0;0;.00nan;0;0
17199;-1;649;0;0;0;0;.00nan;0;0
17199;85947;649;39;22;4;18;.818;3600000;0
17200;193341;1838;40;19;3;16;.842;4306000;0
17200;-1;1825;45;24;4;20;.833;4306000;0
17200;-1;1838;0;0;0;0;.00nan;0;0
17200;-1;1825;0;0;0;0;.00nan;0;0
17201;-1;4538;56;35;4;31;.886;4761000;0
17201;211456;4538;0;0;0;0;.00nan;0;0
17201;-1;1813;73;30;3;27;.900;4761000;0
17201;-1;1813;0;0;0;0;.00nan;0;0
17202;195761;651;0;0;0;0;.00nan;0;0
17202;-1;649;0;0;0;0;.00nan;0;0
17202;-1;651;96;15;0;15;1.000;3600000;0
17202;85947;649;46;37;6;31;.838;3600000;0
17203;-1;1835;62;21;2;19;.905;3600000;0
17203;-1;646;0;0;0;0;.00nan;0;0
17203;-1;646;55;40;5;35;.875;3600000;0
17203;-1;1835;0;0;0;0;.00nan;0;0
17204;8942;638;0;0;0;0;.00nan;0;0
17204;-1;633;0;0;0;0;.00nan;0;0
17204;-1;633;48;24;3;21;.875;3600000;0
17204;-1;638;85;18;0;18;1.000;3600000;0
17205;177631;1818;84;25;1;24;.960;3600000;0
17205;193687;703;82;35;3;32;.914;3582000;0
17205;214635;703;0;0;0;0;.00nan;0;0
17205;156632;1818;0;0;0;0;.00nan;0;0
17206;214281;1809;49;2;0;2;1.000;344000;0
17206;164404;1809;40;36;6;30;.833;3256000;0
17206;174806;648;0;0;0;0;.00nan;0;0
17206;72747;648;55;24;3;21;.875;3600000;0
17207;8942;638;0;0;0;0;.00nan;0;0
17207;193687;703;0;0;0;0;.00nan;0;0
17207;214635;703;75;25;1;24;.960;3600000;0
17207;-1;638;52;33;4;29;.879;3600000;0
17208;177631;1818;63;38;4;34;.895;3528000;0
17208;-1;4538;58;18;2;16;.889;3600000;0
17208;211456;4538;0;0;0;0;.00nan;0;0
17208;156632;1818;0;0;0;0;.00nan;0;0
17209;-1;1825;100;30;0;30;1.000;3600000;0
17209;-1;646;0;0;0;0;.00nan;0;0
17209;-1;646;92;28;2;26;.929;3590000;0
17209;-1;1825;0;0;0;0;.00nan;0;0
17210;193341;1838;59;26;3;23;.885;3600000;0
17210;-1;633;38;37;6;31;.838;3600000;0
17210;-1;633;0;0;0;0;.00nan;0;0
17210;-1;1838;0;0;0;0;.00nan;0;0
17211;-1;1835;46;29;4;25;.862;3600000;0
17211;174806;648;0;0;0;0;.00nan;0;0
17211;-1;1835;0;0;0;0;.00nan;0;0
17211;72747;648;30;27;5;22;.815;3557000;0
17212;-1;1813;61;33;4;29;.879;3600000;0
17212;-1;649;0;0;0;0;.00nan;0;0
17212;-1;1813;0;0;0;0;.00nan;0;0
17212;85947;649;44;35;5;30;.857;3572000;0
17213;193341;1838;77;33;2;31;.939;3600000;0
17213;193687;703;73;36;3;33;.917;3580000;0
17213;214635;703;0;0;0;0;.00nan;0;0
17213;-1;1838;0;0;0;0;.00nan;0;0
17214;-1;4538;72;26;2;24;.923;3600000;0
17214;174806;648;0;0;0;0;.00nan;0;0
17214;211456;4538;0;0;0;0;.00nan;0;0
17214;72747;648;36;21;4;17;.810;3515000;0
17215;-1;1825;76;41;3;38;.927;3590000;0
17215;-1;1813;67;19;1;18;.947;3600000;0
17215;-1;1813;0;0;0;0;.00nan;0;0
17215;-1;1825;0;0;0;0;.00nan;0;0
17216;195761;651;0;0;0;0;.00nan;0;0
17216;-1;633;68;38;4;34;.895;3600000;0
17216;-1;633;0;0;0;0;.00nan;0;0
17216;-1;651;66;20;1;19;.950;3600000;0
17217;177631;1818;71;39;4;35;.897;5365000;0
17217;-1;1835;93;51;3;48;.941;5365000;0
17217;-1;1835;0;0;0;0;.00nan;0;0
17217;156632;1818;0;0;0;0;.00nan;0;0
17218;214281;1809;66;28;2;26;.929;3600000;0
17218;164404;1809;0;0;0;0;.00nan;0;0
17218;-1;646;0;0;0;0;.00nan;0;0
17218;-1;646;60;32;3;29;.906;3554000;0
17219;8942;638;31;33;7;26;.788;3600000;0
17219;-1;649;0;0;0;0;.00nan;0;0
17219;-1;638;0;0;0;0;.00nan;0;0
17219;85947;649;96;24;1;23;.958;3600000;0
17220;193341;1838;0;0;0;0;.00nan;0;0
17220;-1;1835;64;41;5;36;.878;3600000;0
17220;-1;1838;91;24;0;24;1.000;3600000;0
17220;-1;1835;0;0;0;0;.00nan;0;0
17221;214281;1809;0;0;0;0;.00nan;0;0
17221;164404;1809;91;61;4;57;.934;4013000;0
17221;-1;1813;51;20;3;17;.850;4013000;0
17221;-1;1813;0;0;0;0;.00nan;0;0
17222;193687;703;51;38;5;33;.868;3600000;0
17222;214635;703;0;0;0;0;.00nan;0;0
17222;195761;651;90;30;1;29;.967;3600000;0
17222;-1;651;0;0;0;0;.00nan;0;0
17223;-1;633;97;57;3;54;.947;3572000;0
17223;-1;633;0;0;0;0;.00nan;0;0
17223;-1;646;68;17;1;16;.941;3600000;0
17223;-1;646;0;0;0;0;.00nan;0;0
17224;177631;1818;72;29;2;27;.931;3600000;0
17224;-1;649;0;0;0;0;.00nan;0;0
17224;85947;649;84;38;3;35;.921;3596000;0
17224;156632;1818;0;0;0;0;.00nan;0;0
17225;8942;638;0;0;0;0;.00nan;0;0
17225;-1;4538;42;28;4;24;.857;3600000;0
17225;211456;4538;0;0;0;0;.00nan;0;0
17225;-1;638;100;27;0;27;1.000;3600000;0
17226;-1;1825;38;37;7;30;.811;2820000;0
17226;174806;648;52;34;4;30;.882;3600000;0
17226;-1;1825;46;4;1;3;.750;780000;0
17226;72747;648;0;0;0;0;.00nan;0;0
17227;193341;1838;0;0;0;0;.00nan;0;0
17227;-1;1813;100;40;2;38;.950;3600000;0
17227;-1;1838;66;32;4;28;.875;3583000;0
17227;-1;1813;0;0;0;0;.00nan;0;0
17228;193687;703;56;31;4;27;.871;3600000;0
17228;214635;703;0;0;0;0;.00nan;0;0
17228;-1;4538;56;12;1;11;.917;3600000;0
17228;211456;4538;0;0;0;0;.00nan;0;0
17229;174806;648;57;29;3;26;.897;3600000;0
17229;-1;646;0;0;0;0;.00nan;0;0
17229;-1;646;70;44;4;40;.909;3547000;0
17229;72747;648;0;0;0;0;.00nan;0;0
17230;8942;638;0;0;0;0;.00nan;0;0
17230;-1;1825;54;33;4;29;.879;3561000;0
17230;-1;638;51;25;3;22;.880;3600000;0
17230;160906;1825;0;0;0;0;.00nan;0;0
17231;-1;633;88;34;3;31;.912;3600000;0
17231;-1;633;0;0;0;0;.00nan;0;0
17231;-1;649;41;16;3;13;.813;3201000;0
17231;85947;649;32;11;3;8;.727;399000;0
17232;177631;1818;76;25;2;23;.920;3600000;0
17232;-1;1813;76;39;3;36;.923;3600000;0
17232;-1;1813;0;0;0;0;.00nan;0;0
17232;156632;1818;0;0;0;0;.00nan;0;0
17233;-1;1835;76;30;2;28;.933;3600000;0
17233;195761;651;67;30;3;27;.900;3554000;0
17233;-1;651;0;0;0;0;.00nan;0;0
17233;-1;1835;0;0;0;0;.00nan;0;0
17234;214281;1809;62;32;3;29;.906;3571000;0
17234;193341;1838;71;20;1;19;.950;3600000;0
17234;164404;1809;0;0;0;0;.00nan;0;0
17234;-1;1838;0;0;0;0;.00nan;0;0
17235;193687;703;47;19;3;16;.842;3600000;0
17235;214635;703;0;0;0;0;.00nan;0;0
17235;-1;1825;55;43;6;37;.860;3600000;0
17235;160906;1825;0;0;0;0;.00nan;0;0
17236;193341;1838;24;10;4;6;.600;904000;0
17236;-1;646;0;0;0;0;.00nan;0;0
17236;-1;646;39;28;5;23;.821;3600000;0
17236;-1;1838;49;13;2;11;.846;2646000;0
17237;-1;633;52;34;6;28;.824;3239000;0
17237;-1;633;46;7;1;6;.857;361000;0
17237;-1;1813;0;0;0;0;.00nan;0;0
17237;-1;1813;62;31;3;28;.903;3600000;0
17238;-1;4538;65;39;4;35;.897;3589000;0
17238;211456;4538;0;0;0;0;.00nan;0;0
17238;195761;651;0;0;0;0;.00nan;0;0
17238;-1;651;65;25;2;23;.920;3600000;0
17239;214281;1809;0;0;0;0;.00nan;0;0
17239;8942;638;33;35;7;28;.800;3600000;0
17239;164404;1809;100;44;0;44;1.000;3600000;0
17239;-1;638;0;0;0;0;.00nan;0;0
17240;177631;1818;70;19;1;18;.947;3553000;0
17240;174806;648;100;31;0;31;1.000;3600000;0
17240;72747;648;0;0;0;0;.00nan;0;0
17240;156632;1818;0;0;0;0;.00nan;0;0
17241;-1;1835;61;30;4;26;.867;4534000;0
17241;-1;649;73;37;3;34;.919;4534000;0
17241;-1;1835;0;0;0;0;.00nan;0;0
17241;85947;649;0;0;0;0;.00nan;0;0
17242;193341;1838;54;39;5;34;.872;3531000;0
17242;-1;649;0;0;0;0;.00nan;0;0
17242;-1;1838;0;0;0;0;.00nan;0;0
17242;85947;649;71;32;3;29;.906;3600000;0
17243;214281;1809;50;14;2;12;.857;3600000;0
17243;164404;1809;0;0;0;0;.00nan;0;0
17243;-1;4538;53;26;3;23;.885;3563000;0
17243;211456;4538;0;0;0;0;.00nan;0;0
17244;-1;1825;52;24;3;21;.875;3600000;0
17244;-1;633;76;40;4;36;.900;3574000;0
17244;-1;633;0;0;0;0;.00nan;0;0
17244;160906;1825;0;0;0;0;.00nan;0;0
17245;177631;1818;79;44;3;41;.932;3972000;0
17245;195761;651;52;17;2;15;.882;3972000;0
17245;-1;651;0;0;0;0;.00nan;0;0
17245;156632;1818;0;0;0;0;.00nan;0;0
17246;193687;703;59;29;4;25;.862;3577000;0
17246;214635;703;0;0;0;0;.00nan;0;0
17246;-1;1835;72;33;3;30;.909;3600000;0
17246;-1;1835;0;0;0;0;.00nan;0;0
17247;8942;638;94;42;2;40;.952;3600000;0
17247;174806;648;49;27;3;24;.889;3548000;0
17247;-1;638;0;0;0;0;.00nan;0;0
17247;72747;648;0;0;0;0;.00nan;0;0
17248;193687;703;84;27;1;26;.963;3600000;0
17248;214635;703;0;0;0;0;.00nan;0;0
17248;-1;633;78;40;3;37;.925;3564000;0
17248;-1;633;0;0;0;0;.00nan;0;0
17249;193341;1838;61;33;2;31;.939;4486000;0
17249;-1;1813;91;48;3;45;.938;4486000;0
17249;-1;1838;0;0;0;0;.00nan;0;0
17249;-1;1813;0;0;0;0;.00nan;0;0
17250;195761;651;0;0;0;0;.00nan;0;0
17250;-1;651;84;35;2;33;.943;3600000;0
17250;-1;646;0;0;0;0;.00nan;0;0
17250;-1;646;25;37;7;30;.811;3600000;0
17251;-1;1825;85;41;3;38;.927;3600000;0
17251;-1;4538;13;6;4;2;.333;880000;0
17251;211456;4538;56;15;2;13;.867;2720000;0
17251;160906;1825;0;0;0;0;.00nan;0;0
17252;177631;1818;57;21;3;18;.857;3600000;0
17252;8942;638;0;0;0;0;.00nan;0;0
17252;-1;638;51;39;6;33;.846;3600000;0
17252;156632;1818;0;0;0;0;.00nan;0;0
17253;214281;1809;0;0;0;0;.00nan;0;0
17253;164404;1809;78;29;2;27;.931;3592000;0
17253;-1;1835;84;26;1;25;.962;3600000;0
17253;-1;1835;0;0;0;0;.00nan;0;0
17254;174806;648;73;40;4;36;.900;3538000;0
17254;-1;649;0;0;0;0;.00nan;0;0
17254;72747;648;0;0;0;0;.00nan;0;0
17254;85947;649;66;28;3;25;.893;3600000;0
17255;-1;1813;79;32;2;30;.938;4183000;0
17255;-1;646;87;41;3;38;.927;4183000;0
17255;-1;646;0;0;0;0;.00nan;0;0
17255;-1;1813;0;0;0;0;.00nan;0;0
17256;-1;1835;33;9;3;6;.667;539000;0
17256;195761;651;24;23;6;17;.739;2895000;0
17256;-1;651;44;4;1;3;.750;705000;0
17256;-1;1835;65;23;2;21;.913;3061000;0
17257;-1;4538;0;0;0;0;.00nan;0;0
17257;211456;4538;60;22;2;20;.909;3600000;0
17257;-1;649;0;0;0;0;.00nan;0;0
17257;85947;649;24;34;7;27;.794;3600000;0
17258;195761;651;86;28;2;26;.929;3600000;0
17258;-1;1813;37;32;5;27;.844;3600000;0
17258;-1;651;0;0;0;0;.00nan;0;0
17258;-1;1813;0;0;0;0;.00nan;0;0
17259;8942;638;91;45;3;42;.933;4213000;0
17259;-1;638;0;0;0;0;.00nan;0;0
17259;-1;646;0;0;0;0;.00nan;0;0
17259;-1;646;49;28;4;24;.857;4195000;0
17260;177631;1818;70;28;3;25;.893;3820000;0
17260;-1;1825;76;30;2;28;.933;3820000;0
17260;156632;1818;0;0;0;0;.00nan;0;0
17260;160906;1825;0;0;0;0;.00nan;0;0
17261;-1;1835;55;34;4;30;.882;5018000;0
17261;-1;633;63;48;5;43;.896;5018000;0
17261;-1;633;0;0;0;0;.00nan;0;0
17261;-1;1835;0;0;0;0;.00nan;0;0
17262;214281;1809;51;31;4;27;.871;3558000;0
17262;193687;703;89;38;2;36;.947;3600000;0
17262;214635;703;0;0;0;0;.00nan;0;0
17262;164404;1809;0;0;0;0;.00nan;0;0
17263;193341;1838;37;27;5;22;.815;3582000;0
17263;174806;648;54;15;2;13;.867;3600000;0
17263;-1;1838;0;0;0;0;.00nan;0;0
17263;72747;648;0;0;0;0;.00nan;0;0
17264;193687;703;55;28;3;25;.893;3600000;0
17264;214635;703;0;0;0;0;.00nan;0;0
17264;-1;646;0;0;0;0;.00nan;0;0
17264;-1;646;45;29;5;24;.828;3516000;0
17265;193341;1838;0;0;0;0;.00nan;0;0
17265;177631;1818;75;20;1;19;.950;3600000;0
17265;-1;1838;42;39;6;33;.846;3600000;0
17265;156632;1818;0;0;0;0;.00nan;0;0
17266;174806;648;0;0;0;0;.00nan;0;0
17266;-1;1813;0;0;0;0;.00nan;0;0
17266;-1;1813;71;22;1;21;.955;3634000;0
17266;72747;648;78;25;2;23;.920;3634000;0
17267;-1;1835;47;20;3;17;.850;3549000;0
17267;-1;1825;0;0;0;0;.00nan;0;0
17267;-1;1835;0;0;0;0;.00nan;0;0
17267;160906;1825;86;34;2;32;.941;3600000;0
17268;-1;4538;91;25;1;24;.960;3600000;0
17268;211456;4538;0;0;0;0;.00nan;0;0
17268;-1;633;0;0;0;0;.00nan;0;0
17268;-1;633;77;35;2;33;.943;3549000;0
17269;8942;638;77;44;4;40;.909;3600000;0
17269;195761;651;0;0;0;0;.00nan;0;0
17269;-1;638;0;0;0;0;.00nan;0;0
17269;-1;651;80;34;2;32;.941;3600000;0
17270;214281;1809;74;33;2;31;.939;4007000;0
17270;164404;1809;0;0;0;0;.00nan;0;0
17270;-1;649;0;0;0;0;.00nan;0;0
17270;85947;649;83;27;1;26;.963;4007000;0
17271;-1;1825;37;28;5;23;.821;3600000;0
17271;-1;4538;76;27;1;26;.963;3600000;0
17271;211456;4538;0;0;0;0;.00nan;0;0
17271;160906;1825;0;0;0;0;.00nan;0;0
17272;195761;651;69;19;1;18;.947;3600000;0
17272;-1;651;0;0;0;0;.00nan;0;0
17272;-1;646;62;42;5;37;.881;3600000;0
17272;-1;646;0;0;0;0;.00nan;0;0
17273;193687;703;29;23;5;18;.783;3600000;0
17273;214635;703;0;0;0;0;.00nan;0;0
17273;-1;633;27;35;7;28;.800;2840000;0
17273;-1;633;34;11;3;8;.727;760000;0
17274;177631;1818;68;28;3;25;.893;3829000;0
17274;8942;638;0;0;0;0;.00nan;0;0
17274;-1;638;76;34;2;32;.941;3829000;0
17274;156632;1818;0;0;0;0;.00nan;0;0
17275;214281;1809;0;0;0;0;.00nan;0;0
17275;164404;1809;60;32;4;28;.875;3555000;0
17275;-1;1835;0;0;0;0;.00nan;0;0
17275;-1;1835;71;32;3;29;.906;3600000;0
17276;174806;648;46;26;4;22;.846;3539000;0
17276;-1;649;0;0;0;0;.00nan;0;0
17276;72747;648;0;0;0;0;.00nan;0;0
17276;85947;649;87;28;2;26;.929;3600000;0
17277;193341;1838;80;55;4;51;.927;4599000;0
17277;195761;651;0;0;0;0;.00nan;0;0
17277;-1;651;78;47;3;44;.936;4591000;0
17277;-1;1838;0;0;0;0;.00nan;0;0
17278;-1;1835;59;31;4;27;.871;3600000;0
17278;-1;4538;62;44;5;39;.886;3600000;0
17278;211456;4538;0;0;0;0;.00nan;0;0
17278;-1;1835;0;0;0;0;.00nan;0;0
17279;8942;638;78;41;4;37;.902;3600000;0
17279;-1;1813;77;22;1;21;.955;3600000;0
17279;-1;638;0;0;0;0;.00nan;0;0
17279;-1;1813;0;0;0;0;.00nan;0;0
17280;177631;1818;0;0;0;0;.00nan;0;0
17280;-1;646;41;26;4;22;.846;3545000;0
17280;-1;646;0;0;0;0;.00nan;0;0
17280;156632;1818;73;32;2;30;.938;3600000;0
17281;214281;1809;67;38;4;34;.895;3600000;0
17281;164404;1809;0;0;0;0;.00nan;0;0
17281;-1;633;29;28;6;22;.786;3304000;0
17281;-1;633;54;4;0;4;1.000;231000;0
17282;193687;703;57;35;5;30;.857;3550000;0
17282;214635;703;0;0;0;0;.00nan;0;0
17282;174806;648;0;0;0;0;.00nan;0;0
17282;72747;648;64;29;3;26;.897;3600000;0
17283;-1;1825;90;48;3;45;.938;3600000;0
17283;-1;649;0;0;0;0;.00nan;0;0
17283;85947;649;35;24;5;19;.792;3534000;0
17283;160906;1825;0;0;0;0;.00nan;0;0
17284;193687;703;82;34;2;32;.941;3600000;0
17284;214635;703;0;0;0;0;.00nan;0;0
17284;-1;649;0;0;0;0;.00nan;0;0
17284;85947;649;100;31;0;31;1.000;3600000;0
17285;174806;648;61;23;3;20;.870;3600000;0
17285;195761;651;59;38;5;33;.868;3534000;0
17285;-1;651;0;0;0;0;.00nan;0;0
17285;72747;648;0;0;0;0;.00nan;0;0
17286;-1;4538;49;22;3;19;.864;3545000;0
17286;211456;4538;0;0;0;0;.00nan;0;0
17286;-1;646;0;0;0;0;.00nan;0;0
17286;-1;646;80;33;2;31;.939;3600000;0
17287;214281;1809;0;0;0;0;.00nan;0;0
17287;164404;1809;51;34;5;29;.853;3600000;0
17287;-1;1825;81;27;1;26;.963;3600000;0
17287;160906;1825;0;0;0;0;.00nan;0;0
17288;177631;1818;66;15;1;14;.933;3600000;0
17288;-1;633;83;37;2;35;.946;3544000;0
17288;-1;633;0;0;0;0;.00nan;0;0
17288;156632;1818;0;0;0;0;.00nan;0;0
17289;-1;1835;75;29;2;27;.931;3600000;0
17289;-1;1813;20;23;6;17;.739;1982000;0
17289;-1;1813;50;8;1;7;.875;1618000;0
17289;-1;1835;0;0;0;0;.00nan;0;0
17290;193341;1838;0;0;0;0;.00nan;0;0
17290;8942;638;0;0;0;0;.00nan;0;0
17290;-1;638;79;36;3;33;.917;3593000;0
17290;-1;1838;59;18;2;16;.889;3600000;0
17291;177631;1818;56;27;3;24;.889;3600000;0
17291;193687;703;33;19;4;15;.789;1501000;0
17291;214635;703;54;15;1;14;.933;2099000;0
17291;156632;1818;0;0;0;0;.00nan;0;0
17292;-1;4538;0;0;0;0;.00nan;0;0
17292;211456;4538;77;29;2;27;.931;3543000;0
17292;-1;1813;85;33;1;32;.970;3600000;0
17292;-1;1813;0;0;0;0;.00nan;0;0
17293;193341;1838;73;34;3;31;.912;3600000;0
17293;-1;1825;45;27;4;23;.852;3600000;0
17293;-1;1838;0;0;0;0;.00nan;0;0
17293;160906;1825;0;0;0;0;.00nan;0;0
17294;-1;1835;90;37;1;36;.973;3600000;0
17294;-1;646;50;12;2;10;.833;2619000;0
17294;-1;646;12;11;5;6;.545;981000;0
17294;-1;1835;0;0;0;0;.00nan;0;0
17295;8942;638;55;37;5;32;.865;3600000;0
17295;-1;633;68;25;2;23;.920;3600000;0
17295;-1;633;0;0;0;0;.00nan;0;0
17295;-1;638;0;0;0;0;.00nan;0;0
17296;214281;1809;29;14;4;10;.714;926000;0
17296;164404;1809;76;28;2;26;.929;2674000;0
17296;174806;648;0;0;0;0;.00nan;0;0
17296;72747;648;68;17;1;16;.941;3600000;0
17297;195761;651;0;0;0;0;.00nan;0;0
17297;-1;649;54;7;1;6;.857;981000;0
17297;-1;651;44;35;6;29;.829;3730000;0
17297;85947;649;34;31;6;25;.806;2749000;0
17298;193341;1838;54;25;3;22;.880;3580000;0
17298;-1;4538;66;26;2;24;.923;3600000;0
17298;211456;4538;0;0;0;0;.00nan;0;0
17298;-1;1838;0;0;0;0;.00nan;0;0
17299;193687;703;78;39;4;35;.897;3596000;0
17299;214635;703;0;0;0;0;.00nan;0;0
17299;-1;1813;100;39;2;37;.949;3600000;0
17299;-1;1813;0;0;0;0;.00nan;0;0
17300;-1;1825;40;32;5;27;.844;3600000;0
17300;195761;651;65;28;3;25;.893;3600000;0
17300;-1;651;0;0;0;0;.00nan;0;0
17300;160906;1825;0;0;0;0;.00nan;0;0
17301;-1;649;0;0;0;0;.00nan;0;0
17301;-1;646;37;11;3;8;.727;573000;0
17301;-1;646;82;28;2;26;.929;3325000;0
17301;85947;649;76;42;4;38;.905;3898000;0
17302;214281;1809;0;0;0;0;.00nan;0;0
17302;177631;1818;70;35;3;32;.914;3543000;0
17302;164404;1809;72;27;2;25;.926;3600000;0
17302;156632;1818;0;0;0;0;.00nan;0;0
17303;8942;638;0;0;0;0;.00nan;0;0
17303;-1;1835;81;25;1;24;.960;3600000;0
17303;-1;638;68;32;3;29;.906;3600000;0
17303;-1;1835;0;0;0;0;.00nan;0;0
17304;174806;648;72;22;1;21;.955;3600000;0
17304;-1;633;71;40;5;35;.875;3600000;0
17304;-1;633;0;0;0;0;.00nan;0;0
17304;72747;648;0;0;0;0;.00nan;0;0
17305;193687;703;40;34;6;28;.824;2062000;0
17305;214635;703;51;9;1;8;.889;1538000;0
17305;-1;1813;53;30;4;26;.867;3600000;0
17305;-1;1813;0;0;0;0;.00nan;0;0
17306;193341;1838;33;22;4;18;.818;3600000;0
17306;-1;4538;100;25;0;25;1.000;3600000;0
17306;211456;4538;0;0;0;0;.00nan;0;0
17306;-1;1838;0;0;0;0;.00nan;0;0
17307;-1;1825;76;49;4;45;.918;4927000;0
17307;195761;651;0;0;0;0;.00nan;0;0
17307;-1;651;99;51;3;48;.941;4927000;0
17307;160906;1825;0;0;0;0;.00nan;0;0
17308;174806;648;0;0;0;0;.00nan;0;0
17308;-1;633;43;37;6;31;.838;3192000;0
17308;-1;633;51;10;1;9;.900;408000;0
17308;72747;648;66;17;1;16;.941;3600000;0
17309;8942;638;57;47;6;41;.872;3164000;0
17309;-1;1835;34;19;4;15;.789;3600000;0
17309;-1;638;55;4;0;4;1.000;398000;0
17309;-1;1835;0;0;0;0;.00nan;0;0
17310;214281;1809;100;31;0;31;1.000;3600000;0
17310;177631;1818;87;26;1;25;.962;3600000;0
17310;164404;1809;0;0;0;0;.00nan;0;0
17310;156632;1818;0;0;0;0;.00nan;0;0
17311;-1;649;0;0;0;0;.00nan;0;0
17311;-1;646;0;0;0;0;.00nan;0;0
17311;-1;646;72;26;1;25;.962;3600000;0
17311;85947;649;73;50;5;45;.900;3600000;0
17312;193341;1838;61;19;1;18;.947;3600000;0
17312;-1;633;86;49;3;46;.939;3586000;0
17312;-1;633;0;0;0;0;.00nan;0;0
17312;-1;1838;0;0;0;0;.00nan;0;0
17313;-1;1813;0;0;0;0;.00nan;0;0
17313;-1;649;0;0;0;0;.00nan;0;0
17313;-1;1813;59;32;3;29;.906;4954000;0
17313;85947;649;76;47;4;43;.915;4954000;0
17314;214281;1809;74;46;5;41;.891;3600000;0
17314;164404;1809;0;0;0;0;.00nan;0;0
17314;195761;651;100;40;1;39;.975;3600000;0
17314;-1;651;0;0;0;0;.00nan;0;0
17315;-1;1825;100;28;0;28;1.000;3600000;0
17315;-1;646;55;25;3;22;.880;3600000;0
17315;-1;646;0;0;0;0;.00nan;0;0
17315;160906;1825;0;0;0;0;.00nan;0;0
17316;177631;1818;77;23;1;22;.957;3600000;0
17316;-1;4538;65;24;2;22;.917;3561000;0
17316;211456;4538;0;0;0;0;.00nan;0;0
17316;156632;1818;0;0;0;0;.00nan;0;0
17317;8942;638;0;0;0;0;.00nan;0;0
17317;193687;703;83;41;3;38;.927;4947000;0
17317;214635;703;0;0;0;0;.00nan;0;0
17317;-1;638;91;43;4;39;.907;4947000;0
17318;-1;1835;53;26;4;22;.846;3600000;0
17318;174806;648;41;29;5;24;.828;3574000;0
17318;-1;1835;0;0;0;0;.00nan;0;0
17318;72747;648;0;0;0;0;.00nan;0;0
17319;193687;703;94;37;2;35;.946;3578000;0
17319;214635;703;0;0;0;0;.00nan;0;0
17319;195761;651;0;0;0;0;.00nan;0;0
17319;-1;651;72;20;1;19;.950;3600000;0
17320;8942;638;81;34;2;32;.941;3600000;0
17320;-1;4538;55;30;3;27;.900;3598000;0
17320;211456;4538;0;0;0;0;.00nan;0;0
17320;-1;638;0;0;0;0;.00nan;0;0
17321;-1;1825;66;37;4;33;.892;3695000;0
17321;174806;648;92;22;1;21;.955;2588000;0
17321;72747;648;24;13;4;9;.692;1107000;0
17321;160906;1825;0;0;0;0;.00nan;0;0
17322;-1;633;88;38;2;36;.947;3600000;0
17322;-1;633;0;0;0;0;.00nan;0;0
17322;-1;646;29;21;5;16;.762;3600000;0
17322;-1;646;0;0;0;0;.00nan;0;0
17323;193341;1838;77;50;4;46;.920;3600000;0
17323;-1;1835;60;13;1;12;.923;3600000;0
17323;-1;1838;0;0;0;0;.00nan;0;0
17323;-1;1835;0;0;0;0;.00nan;0;0
17324;214281;1809;0;0;0;0;.00nan;0;0
17324;164404;1809;54;26;3;23;.885;3573000;0
17324;-1;1813;78;25;1;24;.960;3600000;0
17324;-1;1813;0;0;0;0;.00nan;0;0
17325;177631;1818;41;35;5;30;.857;5107000;0
17325;-1;649;0;0;0;0;.00nan;0;0
17325;85947;649;79;51;4;47;.922;5107000;0
17325;156632;1818;0;0;0;0;.00nan;0;0
17326;193341;1838;0;0;0;0;.00nan;0;0
17326;193687;703;76;25;1;24;.960;3550000;0
17326;214635;703;0;0;0;0;.00nan;0;0
17326;-1;1838;100;30;0;30;1.000;3600000;0
17327;-1;1825;16;9;4;5;.556;893000;0
17327;227177;1813;0;0;0;0;.00nan;0;0
17327;-1;1813;51;35;5;30;.857;3600000;0
17327;160906;1825;69;24;2;22;.917;2707000;0
17328;195761;651;61;29;4;25;.862;3890000;0
17328;-1;633;92;51;5;46;.902;3890000;0
17328;-1;633;0;0;0;0;.00nan;0;0
17328;-1;651;0;0;0;0;.00nan;0;0
17329;214281;1809;0;0;0;0;.00nan;0;0
17329;164404;1809;66;37;4;33;.892;3600000;0
17329;-1;646;70;15;1;14;.933;3600000;0
17329;-1;646;0;0;0;0;.00nan;0;0
17330;177631;1818;0;0;0;0;.00nan;0;0
17330;-1;1835;86;30;2;28;.933;3515000;0
17330;-1;1835;0;0;0;0;.00nan;0;0
17330;156632;1818;100;36;0;36;1.000;3600000;0
17331;8942;638;0;0;0;0;.00nan;0;0
17331;-1;649;0;0;0;0;.00nan;0;0
17331;-1;638;75;32;2;30;.938;3600000;0
17331;85947;649;63;26;3;23;.885;3600000;0
17332;-1;4538;32;26;5;21;.808;3600000;0
17332;174806;648;26;26;6;20;.769;3161000;0
17332;211456;4538;0;0;0;0;.00nan;0;0
17332;72747;648;48;0;0;0;.00nan;419000;0
17333;-1;4538;24;28;6;22;.786;2501000;0
17333;211456;4538;54;13;1;12;.923;1063000;0
17333;195761;651;0;0;0;0;.00nan;0;0
17333;-1;651;49;30;5;25;.833;3600000;0
17334;193341;1838;0;0;0;0;.00nan;0;0
17334;-1;646;0;0;0;0;.00nan;0;0
17334;-1;646;60;23;2;21;.913;3600000;0
17334;-1;1838;71;34;3;31;.912;3585000;0
17335;193687;703;60;23;3;20;.870;3572000;0
17335;214635;703;0;0;0;0;.00nan;0;0
17335;-1;1825;0;0;0;0;.00nan;0;0
17335;160906;1825;95;33;1;32;.970;3600000;0
17336;227177;1813;0;0;0;0;.00nan;0;0
17336;-1;633;65;19;2;17;.895;3545000;0
17336;-1;633;0;0;0;0;.00nan;0;0
17336;-1;1813;74;19;1;18;.947;3600000;0
17337;177631;1818;0;0;0;0;.00nan;0;0
17337;174806;648;0;0;0;0;.00nan;0;0
17337;72747;648;34;30;6;24;.800;3600000;0
17337;156632;1818;58;24;3;21;.875;3600000;0
17338;-1;1835;57;40;5;35;.875;3600000;0
17338;-1;649;0;0;0;0;.00nan;0;0
17338;-1;1835;0;0;0;0;.00nan;0;0
17338;85947;649;54;24;3;21;.875;3600000;0
17339;214281;1809;95;23;0;23;1.000;3600000;0
17339;8942;638;92;41;3;38;.927;3600000;0
17339;164404;1809;0;0;0;0;.00nan;0;0
17339;-1;638;0;0;0;0;.00nan;0;0
17340;193687;703;41;28;4;24;.857;5057000;0
17340;214635;703;0;0;0;0;.00nan;0;0
17340;-1;4538;57;42;5;37;.881;5057000;0
17340;211456;4538;0;0;0;0;.00nan;0;0
17341;214281;1809;51;42;6;36;.857;3592000;0
17341;193341;1838;47;28;4;24;.857;3600000;0
17341;164404;1809;0;0;0;0;.00nan;0;0
17341;-1;1838;0;0;0;0;.00nan;0;0
17342;177631;1818;83;33;2;31;.939;4290000;0
17342;227177;1813;0;0;0;0;.00nan;0;0
17342;-1;1813;100;38;1;37;.974;4290000;0
17342;156632;1818;0;0;0;0;.00nan;0;0
17343;-1;1835;100;45;2;43;.956;3735000;0
17343;195761;651;82;31;3;28;.903;3735000;0
17343;-1;651;0;0;0;0;.00nan;0;0
17343;-1;1835;0;0;0;0;.00nan;0;0
17344;8942;638;0;0;0;0;.00nan;0;0
17344;-1;1825;67;37;3;34;.919;5495000;0
17344;-1;638;70;44;4;40;.909;5495000;0
17344;160906;1825;0;0;0;0;.00nan;0;0
17345;174806;648;48;21;4;17;.810;3600000;0
17345;-1;646;0;0;0;0;.00nan;0;0
17345;-1;646;47;41;7;34;.829;3600000;0
17345;72747;648;0;0;0;0;.00nan;0;0
17346;-1;633;97;45;2;43;.956;4100000;0
17346;-1;633;0;0;0;0;.00nan;0;0
17346;-1;649;0;0;0;0;.00nan;0;0
17346;85947;649;58;32;3;29;.906;4100000;0
17347;-1;4538;0;0;0;0;.00nan;0;0
17347;211456;4538;41;15;3;12;.800;3600000;0
17347;-1;633;60;36;4;32;.889;3550000;0
17347;-1;633;0;0;0;0;.00nan;0;0
17348;8942;638;28;34;6;28;.824;2279000;0
17348;195761;651;0;0;0;0;.00nan;0;0
17348;-1;638;68;14;0;14;1.000;1321000;0
17348;-1;651;51;15;2;13;.867;3600000;0
17349;193687;703;100;38;0;38;1.000;3600000;0
17349;214635;703;0;0;0;0;.00nan;0;0
17349;-1;646;64;19;1;18;.947;3562000;0
17349;-1;646;0;0;0;0;.00nan;0;0
17350;193341;1838;65;25;2;23;.920;4066000;0
17350;177631;1818;91;35;1;34;.971;4066000;0
17350;-1;1838;0;0;0;0;.00nan;0;0
17350;156632;1818;0;0;0;0;.00nan;0;0
17351;-1;1835;0;0;0;0;.00nan;0;0
17351;-1;1825;84;38;3;35;.921;3600000;0
17351;-1;1835;62;36;5;31;.861;3586000;0
17351;160906;1825;0;0;0;0;.00nan;0;0
17352;214281;1809;0;0;0;0;.00nan;0;0
17352;164404;1809;79;52;5;47;.904;3774000;0
17352;-1;649;0;0;0;0;.00nan;0;0
17352;85947;649;52;29;4;25;.862;3795000;0
17353;174806;648;0;0;0;0;.00nan;0;0
17353;227177;1813;0;0;0;0;.00nan;0;0
17353;-1;1813;96;43;2;41;.953;3596000;0
17353;72747;648;78;23;1;22;.957;3600000;0
17354;193341;1838;75;24;1;23;.958;2513000;0
17354;-1;1813;63;28;3;25;.893;3600000;0
17354;-1;1838;31;18;4;14;.778;1073000;0
17354;-1;1813;0;0;0;0;.00nan;0;0
17355;-1;1825;100;33;0;33;1.000;3600000;0
17355;-1;4538;56;19;2;17;.895;3517000;0
17355;211456;4538;0;0;0;0;.00nan;0;0
17355;160906;1825;0;0;0;0;.00nan;0;0
17356;195761;651;57;20;3;17;.850;3600000;0
17356;-1;651;0;0;0;0;.00nan;0;0
17356;-1;646;0;0;0;0;.00nan;0;0
17356;-1;646;77;49;4;45;.918;3600000;0
17357;193687;703;61;19;2;17;.895;3600000;0
17357;214635;703;0;0;0;0;.00nan;0;0
17357;-1;633;0;0;0;0;.00nan;0;0
17357;-1;633;97;49;3;46;.939;3563000;0
17358;177631;1818;79;26;1;25;.962;3600000;0
17358;8942;638;0;0;0;0;.00nan;0;0
17358;-1;638;86;36;2;34;.944;3559000;0
17358;156632;1818;0;0;0;0;.00nan;0;0
17359;214281;1809;90;39;3;36;.923;3567000;0
17359;164404;1809;0;0;0;0;.00nan;0;0
17359;-1;1835;56;15;2;13;.867;3600000;0
17359;-1;1835;0;0;0;0;.00nan;0;0
17360;174806;648;79;32;1;31;.969;3600000;0
17360;-1;649;0;0;0;0;.00nan;0;0
17360;72747;648;0;0;0;0;.00nan;0;0
17360;85947;649;82;34;2;32;.941;3600000;0
17361;193687;703;0;0;0;0;.00nan;0;0
17361;214635;703;63;24;2;22;.917;3579000;0
17361;-1;1835;89;29;1;28;.966;3600000;0
17361;-1;1835;0;0;0;0;.00nan;0;0
17362;-1;1813;0;0;0;0;.00nan;0;0
17362;-1;646;0;0;0;0;.00nan;0;0
17362;-1;646;74;33;2;31;.939;3600000;0
17362;-1;1813;28;27;6;21;.778;3600000;0
17363;177631;1818;43;39;6;33;.846;3169000;0
17363;195761;651;0;0;0;0;.00nan;0;0
17363;-1;651;54;19;2;17;.895;3600000;0
17363;156632;1818;48;10;1;9;.900;431000;0
17364;-1;1825;78;25;2;23;.920;3600000;0
17364;-1;633;71;31;3;28;.903;3557000;0
17364;-1;633;0;0;0;0;.00nan;0;0
17364;160906;1825;0;0;0;0;.00nan;0;0
17365;8942;638;100;37;0;37;1.000;3600000;0
17365;174806;648;0;0;0;0;.00nan;0;0
17365;-1;638;0;0;0;0;.00nan;0;0
17365;72747;648;62;26;3;23;.885;3600000;0
17366;214281;1809;0;0;0;0;.00nan;0;0
17366;164404;1809;51;24;4;20;.833;3600000;0
17366;-1;4538;40;26;5;21;.808;3561000;0
17366;211456;4538;0;0;0;0;.00nan;0;0
17367;193341;1838;66;33;4;29;.879;3573000;0
17367;-1;649;0;0;0;0;.00nan;0;0
17367;-1;1838;0;0;0;0;.00nan;0;0
17367;85947;649;70;25;2;23;.920;3600000;0
17368;214281;1809;69;31;3;28;.903;3600000;0
17368;193687;703;50;25;4;21;.840;3561000;0
17368;214635;703;0;0;0;0;.00nan;0;0
17368;164404;1809;0;0;0;0;.00nan;0;0
17369;193341;1838;0;0;0;0;.00nan;0;0
17369;8942;638;38;32;6;26;.813;3084000;0
17369;-1;638;53;2;0;2;1.000;516000;0
17369;-1;1838;83;20;1;19;.950;3600000;0
17370;-1;4538;56;23;3;20;.870;3600000;0
17370;211456;4538;0;0;0;0;.00nan;0;0
17370;-1;646;0;0;0;0;.00nan;0;0
17370;-1;646;52;28;4;24;.857;3544000;0
17371;-1;1835;67;32;4;28;.875;3588000;0
17371;-1;1813;54;22;3;19;.864;3600000;0
17371;-1;1813;0;0;0;0;.00nan;0;0
17371;-1;1835;0;0;0;0;.00nan;0;0
17372;177631;1818;53;22;3;19;.864;3600000;0
17372;-1;633;72;39;4;35;.897;3600000;0
17372;-1;633;0;0;0;0;.00nan;0;0
17372;156632;1818;0;0;0;0;.00nan;0;0
17373;214281;1809;65;28;3;25;.893;3600000;0
17373;164404;1809;0;0;0;0;.00nan;0;0
17373;-1;1825;79;38;4;34;.895;3575000;0
17373;160906;1825;0;0;0;0;.00nan;0;0
17374;174806;648;62;35;3;32;.914;3596000;0
17374;195761;651;69;27;2;25;.926;3600000;0
17374;-1;651;0;0;0;0;.00nan;0;0
17374;72747;648;0;0;0;0;.00nan;0;0
17375;193687;703;18;30;7;23;.767;3551000;0
17375;214635;703;0;0;0;0;.00nan;0;0
17375;-1;649;0;0;0;0;.00nan;0;0
17375;85947;649;44;30;5;25;.833;3600000;0
17376;193687;703;58;35;4;31;.886;3534000;0
17376;214635;703;0;0;0;0;.00nan;0;0
17376;174806;648;0;0;0;0;.00nan;0;0
17376;72747;648;62;22;2;20;.909;3600000;0
17377;193341;1838;48;43;5;38;.884;3561000;0
17377;195761;651;0;0;0;0;.00nan;0;0
17377;-1;651;39;19;4;15;.789;3600000;0
17377;-1;1838;0;0;0;0;.00nan;0;0
17378;177631;1818;30;16;4;12;.750;793000;0
17378;-1;646;69;26;3;23;.885;3600000;0
17378;-1;646;0;0;0;0;.00nan;0;0
17378;156632;1818;63;32;3;29;.906;2807000;0
17379;-1;1825;87;50;4;46;.920;4095000;0
17379;-1;649;0;0;0;0;.00nan;0;0
17379;85947;649;44;21;3;18;.857;4095000;0
17379;160906;1825;0;0;0;0;.00nan;0;0
17380;214281;1809;54;33;4;29;.879;3573000;0
17380;164404;1809;0;0;0;0;.00nan;0;0
17380;-1;633;82;31;2;29;.935;3600000;0
17380;-1;633;0;0;0;0;.00nan;0;0
17381;-1;1835;100;27;0;27;1.000;3600000;0
17381;-1;4538;62;25;2;23;.920;3570000;0
17381;211456;4538;0;0;0;0;.00nan;0;0
17381;-1;1835;0;0;0;0;.00nan;0;0
17382;8942;638;0;0;0;0;.00nan;0;0
17382;-1;1813;37;21;4;17;.810;3577000;0
17382;-1;638;89;43;2;41;.953;3600000;0
17382;-1;1813;0;0;0;0;.00nan;0;0
17383;193341;1838;35;34;6;28;.824;2843000;0
17383;174806;648;50;23;3;20;.870;3600000;0
17383;-1;1838;60;6;0;6;1.000;757000;0
17383;72747;648;0;0;0;0;.00nan;0;0
17384;195761;651;57;20;2;18;.900;3546000;0
17384;-1;1813;100;38;1;37;.974;3600000;0
17384;-1;651;0;0;0;0;.00nan;0;0
17384;-1;1813;0;0;0;0;.00nan;0;0
17385;177631;1818;63;20;2;18;.900;3600000;0
17385;-1;1825;0;0;0;0;.00nan;0;0
17385;156632;1818;0;0;0;0;.00nan;0;0
17385;160906;1825;55;28;3;25;.893;3600000;0
17386;-1;1835;57;16;2;14;.875;3600000;0
17386;-1;633;88;52;3;49;.942;3589000;0
17386;-1;633;0;0;0;0;.00nan;0;0
17386;-1;1835;0;0;0;0;.00nan;0;0
17387;8942;638;0;0;0;0;.00nan;0;0
17387;-1;638;92;40;2;38;.950;3578000;0
17387;-1;646;0;0;0;0;.00nan;0;0
17387;-1;646;88;20;0;20;1.000;3600000;0
17388;-1;4538;68;49;5;44;.898;3600000;0
17388;211456;4538;0;0;0;0;.00nan;0;0
17388;-1;649;0;0;0;0;.00nan;0;0
17388;85947;649;46;22;4;18;.818;3600000;0
17389;8942;638;76;41;3;38;.927;3558000;0
17389;193687;703;91;27;1;26;.963;3600000;0
17389;214635;703;0;0;0;0;.00nan;0;0
17389;-1;638;0;0;0;0;.00nan;0;0
17390;177631;1818;42;30;5;25;.833;3594000;0
17390;-1;4538;0;0;0;0;.00nan;0;0
17390;211456;4538;58;27;3;24;.889;3600000;0
17390;156632;1818;0;0;0;0;.00nan;0;0
17391;-1;1825;46;32;5;27;.844;3600000;0
17391;-1;646;0;0;0;0;.00nan;0;0
17391;-1;646;38;29;6;23;.793;3585000;0
17391;160906;1825;0;0;0;0;.00nan;0;0
17392;193341;1838;73;17;0;17;1.000;1526000;0
17392;-1;633;53;24;3;21;.875;3600000;0
17392;-1;633;0;0;0;0;.00nan;0;0
17392;-1;1838;18;18;5;13;.722;2072000;0
17393;-1;1835;71;20;1;19;.950;3600000;0
17393;174806;648;0;0;0;0;.00nan;0;0
17393;-1;1835;0;0;0;0;.00nan;0;0
17393;72747;648;67;32;3;29;.906;3523000;0
17394;214281;1809;0;0;0;0;.00nan;0;0
17394;164404;1809;71;50;5;45;.900;3600000;0
17394;195761;651;78;24;1;23;.958;3600000;0
17394;-1;651;0;0;0;0;.00nan;0;0
17395;-1;1813;85;39;2;37;.949;3587000;0
17395;-1;649;0;0;0;0;.00nan;0;0
17395;-1;1813;0;0;0;0;.00nan;0;0
17395;85947;649;90;16;0;16;1.000;3600000;0
17396;193341;1838;81;34;2;32;.941;3600000;0
17396;-1;1825;20;32;7;25;.781;2251000;0
17396;-1;1838;0;0;0;0;.00nan;0;0
17396;160906;1825;43;13;2;11;.846;1349000;0
17397;-1;4538;53;30;3;27;.900;3600000;0
17397;211456;4538;0;0;0;0;.00nan;0;0
17397;-1;1813;0;0;0;0;.00nan;0;0
17397;-1;1813;58;22;2;20;.909;3600000;0
17398;195761;651;0;0;0;0;.00nan;0;0
17398;-1;649;0;0;0;0;.00nan;0;0
17398;-1;651;77;28;2;26;.929;3600000;0
17398;85947;649;41;30;5;25;.833;3600000;0
17399;-1;1835;43;34;6;28;.824;3570000;0
17399;-1;646;54;33;4;29;.879;3600000;0
17399;-1;646;0;0;0;0;.00nan;0;0
17399;-1;1835;0;0;0;0;.00nan;0;0
17400;177631;1818;0;0;0;0;.00nan;0;0
17400;193687;703;57;27;3;24;.889;3575000;0
17400;214635;703;0;0;0;0;.00nan;0;0
17400;156632;1818;69;18;1;17;.944;3600000;0
17401;8942;638;60;24;3;21;.875;4211000;0
17401;-1;633;69;33;2;31;.939;4211000;0
17401;-1;633;0;0;0;0;.00nan;0;0
17401;-1;638;0;0;0;0;.00nan;0;0
17402;214281;1809;57;43;5;38;.884;3600000;0
17402;164404;1809;0;0;0;0;.00nan;0;0
17402;174806;648;0;0;0;0;.00nan;0;0
17402;72747;648;46;18;3;15;.833;3600000;0
17403;193341;1838;0;0;0;0;.00nan;0;0
17403;-1;1835;100;34;0;34;1.000;3600000;0
17403;-1;1838;49;35;5;30;.857;3600000;0
17403;-1;1835;0;0;0;0;.00nan;0;0
17404;214281;1809;85;43;3;40;.930;3724000;0
17404;164404;1809;0;0;0;0;.00nan;0;0
17404;-1;1813;54;17;2;15;.882;3687000;0
17404;-1;1813;0;0;0;0;.00nan;0;0
17405;193687;703;90;49;4;45;.918;3719000;0
17405;214635;703;0;0;0;0;.00nan;0;0
17405;195761;651;41;24;5;19;.792;3715000;0
17405;-1;651;0;0;0;0;.00nan;0;0
17406;-1;633;99;47;1;46;.979;3600000;0
17406;-1;633;0;0;0;0;.00nan;0;0
17406;-1;646;0;0;0;0;.00nan;0;0
17406;-1;646;52;24;3;21;.875;3559000;0
17407;177631;1818;24;24;6;18;.750;2127000;0
17407;-1;649;0;0;0;0;.00nan;0;0
17407;85947;649;45;30;5;25;.833;3600000;0
17407;156632;1818;38;13;3;10;.769;1473000;0
17408;8942;638;0;0;0;0;.00nan;0;0
17408;-1;4538;44;25;4;21;.840;3586000;0
17408;211456;4538;0;0;0;0;.00nan;0;0
17408;-1;638;82;33;2;31;.939;3600000;0
17409;-1;1825;70;39;4;35;.897;3592000;0
17409;174806;648;69;29;2;27;.931;3600000;0
17409;72747;648;0;0;0;0;.00nan;0;0
17409;160906;1825;0;0;0;0;.00nan;0;0
17410;193341;1838;87;35;2;33;.943;3590000;0
17410;193687;703;84;28;1;27;.964;3600000;0
17410;214635;703;0;0;0;0;.00nan;0;0
17410;-1;1838;0;0;0;0;.00nan;0;0
17411;-1;4538;0;0;0;0;.00nan;0;0
17411;174806;648;0;0;0;0;.00nan;0;0
17411;211456;4538;68;22;2;20;.909;3600000;0
17411;72747;648;41;40;6;34;.850;3600000;0
17412;-1;1825;87;47;4;43;.915;3781000;0
17412;-1;1813;52;23;3;20;.870;3781000;0
17412;-1;1813;0;0;0;0;.00nan;0;0
17412;160906;1825;0;0;0;0;.00nan;0;0
17413;195761;651;0;0;0;0;.00nan;0;0
17413;-1;633;32;40;7;33;.825;3253000;0
17413;-1;633;48;0;0;0;.00nan;347000;0
17413;-1;651;82;22;1;21;.955;3600000;0
17414;177631;1818;71;33;4;29;.879;3751000;0
17414;-1;1835;60;40;5;35;.875;3751000;0
17414;-1;1835;0;0;0;0;.00nan;0;0
17414;156632;1818;0;0;0;0;.00nan;0;0
17415;214281;1809;0;0;0;0;.00nan;0;0
17415;164404;1809;64;32;3;29;.906;3600000;0
17415;-1;646;0;0;0;0;.00nan;0;0
17415;-1;646;100;37;0;37;1.000;3600000;0
17416;8942;638;22;11;4;7;.636;837000;0
17416;-1;649;0;0;0;0;.00nan;0;0
17416;-1;638;66;24;2;22;.917;2763000;0
17416;85947;649;67;17;1;16;.941;3600000;0
17417;193687;703;87;38;3;35;.921;3667000;0
17417;214635;703;0;0;0;0;.00nan;0;0
17417;-1;4538;45;27;4;23;.852;3667000;0
17417;211456;4538;0;0;0;0;.00nan;0;0
17418;174806;648;0;0;0;0;.00nan;0;0
17418;-1;646;0;0;0;0;.00nan;0;0
17418;-1;646;94;32;1;31;.969;3600000;0
17418;72747;648;67;33;3;30;.909;3566000;0
17419;8942;638;0;0;0;0;.00nan;0;0
17419;-1;1825;83;35;2;33;.943;3600000;0
17419;-1;638;34;29;5;24;.828;3600000;0
17419;160906;1825;0;0;0;0;.00nan;0;0
17420;-1;633;0;0;0;0;.00nan;0;0
17420;-1;633;77;37;2;35;.946;3545000;0
17420;-1;649;0;0;0;0;.00nan;0;0
17420;85947;649;70;17;1;16;.941;3600000;0
17421;177631;1818;100;29;0;29;1.000;3600000;0
17421;-1;1813;92;35;1;34;.971;3557000;0
17421;-1;1813;0;0;0;0;.00nan;0;0
17421;156632;1818;0;0;0;0;.00nan;0;0
17422;214281;1809;69;32;2;30;.938;3851000;0
17422;193341;1838;62;32;3;29;.906;3851000;0
17422;164404;1809;0;0;0;0;.00nan;0;0
17422;-1;1838;0;0;0;0;.00nan;0;0
17423;193687;703;60;33;4;29;.879;6194000;0
17423;214635;703;0;0;0;0;.00nan;0;0
17423;-1;633;100;61;3;58;.951;6194000;0
17423;-1;633;0;0;0;0;.00nan;0;0
17424;193341;1838;0;0;0;0;.00nan;0;0
17424;-1;1813;0;0;0;0;.00nan;0;0
17424;-1;1838;79;29;3;26;.897;3600000;0
17424;-1;1813;54;23;4;19;.826;3594000;0
17425;195761;651;86;35;2;33;.943;3600000;0
17425;-1;651;0;0;0;0;.00nan;0;0
17425;-1;646;0;0;0;0;.00nan;0;0
17425;-1;646;65;40;4;36;.900;3567000;0
17426;-1;1825;58;40;5;35;.875;3600000;0
17426;-1;4538;100;21;0;21;1.000;3600000;0
17426;211456;4538;0;0;0;0;.00nan;0;0
17426;160906;1825;0;0;0;0;.00nan;0;0
17427;177631;1818;99;26;0;26;1.000;3600000;0
17427;8942;638;42;20;3;17;.850;3600000;0
17427;-1;638;0;0;0;0;.00nan;0;0
17427;156632;1818;0;0;0;0;.00nan;0;0
17428;214281;1809;88;29;1;28;.966;3600000;0
17428;164404;1809;0;0;0;0;.00nan;0;0
17428;-1;1835;56;20;2;18;.900;3544000;0
17428;-1;1835;0;0;0;0;.00nan;0;0
17429;174806;648;0;0;0;0;.00nan;0;0
17429;-1;649;47;24;3;21;.875;3555000;0
17429;72747;648;62;18;2;16;.889;3600000;0
17429;85947;649;0;0;0;0;.00nan;0;0
17430;193341;1838;36;30;5;25;.833;2184000;0
17430;-1;649;0;0;0;0;.00nan;0;0
17430;-1;1838;66;10;0;10;1.000;1416000;0
17430;85947;649;90;32;1;31;.969;3600000;0
17431;214281;1809;0;0;0;0;.00nan;0;0
17431;164404;1809;79;44;4;40;.909;3600000;0
17431;-1;4538;91;29;1;28;.966;3600000;0
17431;211456;4538;0;0;0;0;.00nan;0;0
17432;-1;1813;75;31;2;29;.935;3970000;0
17432;-1;646;62;28;3;25;.893;3970000;0
17432;-1;646;0;0;0;0;.00nan;0;0
17432;-1;1813;0;0;0;0;.00nan;0;0
17433;-1;1825;57;32;4;28;.875;3540000;0
17433;-1;633;54;24;3;21;.875;3600000;0
17433;-1;633;0;0;0;0;.00nan;0;0
17433;160906;1825;0;0;0;0;.00nan;0;0
17434;177631;1818;0;0;0;0;.00nan;0;0
17434;195761;651;0;0;0;0;.00nan;0;0
17434;-1;651;66;20;2;18;.900;3600000;0
17434;156632;1818;47;31;4;27;.871;3545000;0
17435;193687;703;68;32;3;29;.906;3600000;0
17435;214635;703;0;0;0;0;.00nan;0;0
17435;-1;1835;44;6;1;5;.833;1011000;0
17435;-1;1835;23;24;6;18;.750;2589000;0
17436;8942;638;0;0;0;0;.00nan;0;0
17436;174806;648;69;26;2;24;.923;4483000;0
17436;-1;638;92;52;3;49;.942;4483000;0
17436;72747;648;0;0;0;0;.00nan;0;0
17437;193687;703;76;42;4;38;.905;3600000;0
17437;214635;703;0;0;0;0;.00nan;0;0
17437;-1;646;0;0;0;0;.00nan;0;0
17437;-1;646;89;33;1;32;.970;3600000;0
17438;193341;1838;0;0;0;0;.00nan;0;0
17438;177631;1818;67;42;4;38;.905;4662000;0
17438;-1;1838;96;52;3;49;.942;4662000;0
17438;156632;1818;0;0;0;0;.00nan;0;0
17439;-1;1835;70;25;2;23;.920;3600000;0
17439;-1;1825;83;43;3;40;.930;3600000;0
17439;-1;1835;0;0;0;0;.00nan;0;0
17439;160906;1825;0;0;0;0;.00nan;0;0
17440;-1;4538;78;23;1;22;.957;3600000;0
17440;211456;4538;0;0;0;0;.00nan;0;0
17440;-1;633;68;38;4;34;.895;3600000;0
17440;-1;633;0;0;0;0;.00nan;0;0
17441;8942;638;39;40;6;34;.850;3600000;0
17441;195761;651;54;27;4;23;.852;3600000;0
17441;-1;638;0;0;0;0;.00nan;0;0
17441;-1;651;0;0;0;0;.00nan;0;0
17442;214281;1809;74;39;3;36;.923;3600000;0
17442;164404;1809;0;0;0;0;.00nan;0;0
17442;-1;649;0;0;0;0;.00nan;0;0
17442;85947;649;39;9;2;7;.778;3600000;0
17443;-1;4538;48;34;5;29;.853;3600000;0
17443;211456;4538;0;0;0;0;.00nan;0;0
17443;-1;649;0;0;0;0;.00nan;0;0
17443;85947;649;71;27;2;25;.926;3600000;0
17444;195761;651;0;0;0;0;.00nan;0;0
17444;-1;1813;24;20;5;15;.750;2076000;0
17444;-1;651;53;21;3;18;.857;3600000;0
17444;-1;1813;43;12;2;10;.833;1524000;0
17445;8942;638;0;0;0;0;.00nan;0;0
17445;-1;638;66;54;6;48;.889;3600000;0
17445;-1;646;67;17;1;16;.941;3600000;0
17445;-1;646;0;0;0;0;.00nan;0;0
17446;177631;1818;92;22;0;22;1.000;3600000;0
17446;-1;1825;83;43;3;40;.930;3600000;0
17446;156632;1818;0;0;0;0;.00nan;0;0
17446;160906;1825;0;0;0;0;.00nan;0;0
17447;-1;1835;77;28;2;26;.929;3600000;0
17447;-1;633;46;31;5;26;.839;3600000;0
17447;-1;633;0;0;0;0;.00nan;0;0
17447;-1;1835;0;0;0;0;.00nan;0;0
17448;214281;1809;0;0;0;0;.00nan;0;0
17448;193687;703;56;34;5;29;.853;3600000;0
17448;214635;703;0;0;0;0;.00nan;0;0
17448;164404;1809;74;31;2;29;.935;3600000;0
17449;193341;1838;55;33;5;28;.848;3551000;0
17449;174806;648;0;0;0;0;.00nan;0;0
17449;-1;1838;0;0;0;0;.00nan;0;0
17449;72747;648;75;35;4;31;.886;3600000;0
17450;174806;648;0;0;0;0;.00nan;0;0
17450;-1;1813;32;26;5;21;.808;3600000;0
17450;-1;1813;0;0;0;0;.00nan;0;0
17450;72747;648;78;24;1;23;.958;3600000;0
17451;193687;703;64;29;4;25;.862;3600000;0
17451;214635;703;0;0;0;0;.00nan;0;0
17451;-1;1825;93;34;1;33;.971;3600000;0
17451;160906;1825;0;0;0;0;.00nan;0;0
17452;193341;1838;0;0;0;0;.00nan;0;0
17452;-1;646;57;31;5;26;.839;3600000;0
17452;-1;646;0;0;0;0;.00nan;0;0
17452;-1;1838;52;32;6;26;.813;3600000;0
17453;-1;633;41;40;6;34;.850;3600000;0
17453;-1;633;0;0;0;0;.00nan;0;0
17453;-1;1813;64;15;1;14;.933;3600000;0
17453;-1;1813;0;0;0;0;.00nan;0;0
17454;-1;4538;35;18;4;14;.778;879000;0
17454;211456;4538;95;37;2;35;.946;2721000;0
17454;195761;651;65;22;2;20;.909;3600000;0
17454;-1;651;0;0;0;0;.00nan;0;0
17455;214281;1809;77;24;1;23;.958;3600000;0
17455;8942;638;63;24;2;22;.917;3555000;0
17455;164404;1809;0;0;0;0;.00nan;0;0
17455;-1;638;0;0;0;0;.00nan;0;0
17456;177631;1818;100;47;2;45;.957;3600000;0
17456;174806;648;0;0;0;0;.00nan;0;0
17456;72747;648;70;44;5;39;.886;3600000;0
17456;156632;1818;0;0;0;0;.00nan;0;0
17457;-1;1835;34;40;7;33;.825;3025000;0
17457;-1;649;0;0;0;0;.00nan;0;0
17457;-1;1835;59;5;0;5;1.000;575000;0
17457;85947;649;100;34;0;34;1.000;3600000;0
17458;193687;703;48;35;5;30;.857;3600000;0
17458;214635;703;0;0;0;0;.00nan;0;0
17458;-1;649;0;0;0;0;.00nan;0;0
17458;85947;649;48;24;4;20;.833;3600000;0
17459;174806;648;0;0;0;0;.00nan;0;0
17459;195761;651;0;0;0;0;.00nan;0;0
17459;-1;651;68;30;3;27;.900;4110000;0
17459;72747;648;69;39;4;35;.897;4110000;0
17460;-1;4538;58;20;2;18;.900;3596000;0
17460;211456;4538;0;0;0;0;.00nan;0;0
17460;-1;646;95;38;1;37;.974;3600000;0
17460;-1;646;0;0;0;0;.00nan;0;0
17461;214281;1809;0;0;0;0;.00nan;0;0
17461;164404;1809;72;34;3;31;.912;3600000;0
17461;-1;1825;0;0;0;0;.00nan;0;0
17461;160906;1825;87;35;2;33;.943;3600000;0
17462;177631;1818;27;19;5;14;.737;3600000;0
17462;-1;633;83;40;3;37;.925;3600000;0
17462;-1;633;0;0;0;0;.00nan;0;0
17462;156632;1818;0;0;0;0;.00nan;0;0
17463;-1;1835;70;30;2;28;.933;3600000;0
17463;-1;1813;45;26;4;22;.846;3600000;0
17463;-1;1813;0;0;0;0;.00nan;0;0
17463;-1;1835;0;0;0;0;.00nan;0;0
17464;193341;1838;11;28;8;20;.714;3600000;0
17464;8942;638;0;0;0;0;.00nan;0;0
17464;-1;638;67;40;4;36;.900;3600000;0
17464;-1;1838;0;0;0;0;.00nan;0;0
17465;193341;1838;0;0;0;0;.00nan;0;0
17465;195761;651;78;26;1;25;.962;3600000;0
17465;-1;651;0;0;0;0;.00nan;0;0
17465;-1;1838;74;46;4;42;.913;3600000;0
17466;-1;4538;58;35;5;30;.857;3600000;0
17466;211456;4538;0;0;0;0;.00nan;0;0
17466;-1;1835;0;0;0;0;.00nan;0;0
17466;156545;1835;84;30;1;29;.967;3600000;0
17467;8942;638;27;34;7;27;.794;3185000;0
17467;-1;1813;0;0;0;0;.00nan;0;0
17467;-1;638;45;5;1;4;.800;415000;0
17467;-1;1813;62;33;3;30;.909;3600000;0
17468;177631;1818;0;0;0;0;.00nan;0;0
17468;-1;646;0;0;0;0;.00nan;0;0
17468;-1;646;74;21;1;20;.952;3600000;0
17468;156632;1818;57;26;3;23;.885;3600000;0
17469;214281;1809;58;28;3;25;.893;3871000;0
17469;164404;1809;0;0;0;0;.00nan;0;0
17469;-1;633;64;35;4;31;.886;3871000;0
17469;-1;633;0;0;0;0;.00nan;0;0
17470;193687;703;64;35;4;31;.886;3600000;0
17470;214635;703;0;0;0;0;.00nan;0;0
17470;174806;648;87;17;0;17;1.000;3600000;0
17470;72747;648;0;0;0;0;.00nan;0;0
17471;-1;1825;25;10;4;6;.600;422000;0
17471;-1;649;0;0;0;0;.00nan;0;0
17471;85947;649;71;19;1;18;.947;3600000;0
17471;160906;1825;73;21;1;20;.952;3178000;0
17472;193341;1838;68;26;2;24;.923;3600000;0
17472;-1;4538;60;33;4;29;.879;3519000;0
17472;211456;4538;0;0;0;0;.00nan;0;0
17472;-1;1838;0;0;0;0;.00nan;0;0
17473;193687;703;77;30;3;27;.900;3921000;0
17473;214635;703;0;0;0;0;.00nan;0;0
17473;-1;1813;57;23;2;21;.913;3921000;0
17473;-1;1813;0;0;0;0;.00nan;0;0
17474;-1;1825;37;30;6;24;.800;3576000;0
17474;195761;651;51;27;4;23;.852;3600000;0
17474;-1;651;0;0;0;0;.00nan;0;0
17474;160906;1825;0;0;0;0;.00nan;0;0
17475;-1;649;0;0;0;0;.00nan;0;0
17475;-1;646;53;3;0;3;1.000;711000;0
17475;-1;646;32;26;6;20;.769;2889000;0
17475;85947;649;67;31;3;28;.903;3600000;0
17476;214281;1809;53;29;4;25;.862;3600000;0
17476;177631;1818;89;20;0;20;1.000;3600000;0
17476;164404;1809;0;0;0;0;.00nan;0;0
17476;156632;1818;0;0;0;0;.00nan;0;0
17477;8942;638;0;0;0;0;.00nan;0;0
17477;-1;1835;76;19;1;18;.947;3600000;0
17477;-1;638;54;26;3;23;.885;3578000;0
17477;156545;1835;0;0;0;0;.00nan;0;0
17478;174806;648;77;20;1;19;.950;3600000;0
17478;-1;633;62;42;6;36;.857;3600000;0
17478;-1;633;0;0;0;0;.00nan;0;0
17478;72747;648;0;0;0;0;.00nan;0;0
17479;177631;1818;93;36;1;35;.972;3600000;0
17479;193687;703;62;44;5;39;.886;3600000;0
17479;214635;703;0;0;0;0;.00nan;0;0
17479;156632;1818;0;0;0;0;.00nan;0;0
17480;-1;4538;41;33;5;28;.848;3600000;0
17480;211456;4538;0;0;0;0;.00nan;0;0
17480;-1;1813;54;18;3;15;.833;2432000;0
17480;-1;1813;24;13;4;9;.692;1096000;0
17481;193341;1838;70;29;2;27;.931;4624000;0
17481;-1;1825;68;34;3;31;.912;4624000;0
17481;-1;1838;0;0;0;0;.00nan;0;0
17481;160906;1825;0;0;0;0;.00nan;0;0
17482;8942;638;23;28;6;22;.786;2589000;0
17482;-1;633;68;28;3;25;.893;3600000;0
17482;-1;633;0;0;0;0;.00nan;0;0
17482;-1;638;50;7;1;6;.857;1011000;0
17483;-1;1835;32;31;6;25;.806;2199000;0
17483;-1;646;44;12;2;10;.833;1786000;0
17483;-1;646;13;19;6;13;.684;1764000;0
17483;156545;1835;52;8;1;7;.875;1401000;0
17484;214281;1809;0;0;0;0;.00nan;0;0
17484;164404;1809;96;27;0;27;1.000;3600000;0
17484;174806;648;0;0;0;0;.00nan;0;0
17484;72747;648;60;21;2;19;.905;3516000;0
17485;195761;651;84;15;0;15;1.000;3600000;0
17485;-1;649;0;0;0;0;.00nan;0;0
17485;-1;651;0;0;0;0;.00nan;0;0
17485;85947;649;94;44;1;43;.977;3576000;0
17487;-1;4538;51;38;5;33;.868;3545000;0
17487;211456;4538;0;0;0;0;.00nan;0;0
17487;195761;651;59;27;3;24;.889;3600000;0
17487;-1;651;0;0;0;0;.00nan;0;0
17489;174806;648;0;0;0;0;.00nan;0;0
17489;-1;633;57;40;5;35;.875;3600000;0
17489;-1;633;0;0;0;0;.00nan;0;0
17489;72747;648;82;15;0;15;1.000;3600000;0
17491;177631;1818;75;37;4;33;.892;3514000;0
17491;-1;646;0;0;0;0;.00nan;0;0
17491;-1;646;81;35;2;33;.943;3600000;0
17491;156632;1818;0;0;0;0;.00nan;0;0
17493;8942;638;0;0;0;0;.00nan;0;0
17493;-1;1825;64;19;2;17;.895;3600000;0
17493;-1;638;59;44;6;38;.864;3600000;0
17493;-1;1825;0;0;0;0;.00nan;0;0
17495;214281;1809;59;32;3;29;.906;3600000;0
17495;193341;1838;72;24;2;22;.917;3600000;0
17495;164404;1809;0;0;0;0;.00nan;0;0
17495;-1;1838;0;0;0;0;.00nan;0;0
17497;193687;703;75;33;2;31;.939;3600000;0
17497;214635;703;0;0;0;0;.00nan;0;0
17497;-1;1813;85;40;3;37;.925;3519000;0
17497;-1;1813;0;0;0;0;.00nan;0;0
17499;-1;1835;65;33;4;29;.879;3600000;0
17499;-1;649;0;0;0;0;.00nan;0;0
17499;-1;1835;0;0;0;0;.00nan;0;0
17499;85947;649;42;31;5;26;.839;3559000;0
17501;-1;633;92;46;3;43;.935;3574000;0
17501;-1;633;0;0;0;0;.00nan;0;0
17501;-1;649;0;0;0;0;.00nan;0;0
17501;85947;649;62;20;2;18;.900;3600000;0
17503;8942;638;0;0;0;0;.00nan;0;0
17503;195761;651;0;0;0;0;.00nan;0;0
17503;-1;638;71;30;2;28;.933;3600000;0
17503;-1;651;87;31;1;30;.968;3600000;0
17505;-1;1825;77;45;4;41;.911;3521000;0
17505;-1;4538;55;16;2;14;.875;3600000;0
17505;211456;4538;0;0;0;0;.00nan;0;0
17505;-1;1825;0;0;0;0;.00nan;0;0
17507;214281;1809;87;41;2;39;.951;3600000;0
17507;164404;1809;0;0;0;0;.00nan;0;0
17507;174806;648;0;0;0;0;.00nan;0;0
17507;72747;648;37;22;4;18;.818;3521000;0
17509;193341;1838;0;0;0;0;.00nan;0;0
17509;-1;1835;86;34;2;32;.941;3600000;0
17509;-1;1838;53;24;3;21;.875;3572000;0
17509;-1;1835;0;0;0;0;.00nan;0;0
17511;177631;1818;68;24;2;22;.917;3600000;0
17511;193687;703;50;31;4;27;.871;3569000;0
17511;214635;703;0;0;0;0;.00nan;0;0
17511;156632;1818;0;0;0;0;.00nan;0;0
17513;-1;1813;74;37;4;33;.892;3600000;0
17513;-1;646;0;0;0;0;.00nan;0;0
17513;-1;646;30;23;5;18;.783;3546000;0
17513;-1;1813;0;0;0;0;.00nan;0;0
17515;-1;633;0;0;0;0;.00nan;0;0
17515;-1;633;77;43;4;39;.907;3560000;0
17515;-1;1813;0;0;0;0;.00nan;0;0
17515;-1;1813;62;24;3;21;.875;3600000;0
17517;193687;703;100;41;1;40;.976;3600000;0
17517;214635;703;0;0;0;0;.00nan;0;0
17517;-1;1835;52;4;0;4;1.000;743000;0
17517;-1;1835;40;27;6;21;.778;2857000;0
17519;8942;638;69;37;3;34;.919;3858000;0
17519;195761;651;65;27;2;25;.926;3858000;0
17519;-1;638;0;0;0;0;.00nan;0;0
17519;-1;651;0;0;0;0;.00nan;0;0
17521;-1;1825;0;0;0;0;.00nan;0;0
17521;-1;4538;0;0;0;0;.00nan;0;0
17521;211456;4538;78;26;1;25;.962;3600000;0
17521;-1;1825;95;50;4;46;.920;3600000;0
17523;193341;1838;59;36;4;32;.889;3600000;0
17523;-1;649;23;27;6;21;.778;2764000;0
17523;-1;1838;0;0;0;0;.00nan;0;0
17523;85947;649;52;8;1;7;.875;836000;0
17525;214281;1809;0;0;0;0;.00nan;0;0
17525;164404;1809;100;25;0;25;1.000;3600000;0
17525;174806;648;81;34;2;32;.941;3576000;0
17525;72747;648;0;0;0;0;.00nan;0;0
17527;177631;1818;0;0;0;0;.00nan;0;0
17527;-1;646;12;19;6;13;.684;3589000;0
17527;-1;646;0;0;0;0;.00nan;0;0
17527;156632;1818;68;31;4;27;.871;3600000;0
17529;193341;1838;0;0;0;0;.00nan;0;0
17529;-1;649;0;0;0;0;.00nan;0;0
17529;-1;1838;83;29;2;27;.931;3600000;0
17529;85947;649;54;25;3;22;.880;3544000;0
17531;214281;1809;57;5;0;5;1.000;514000;0
17531;164404;1809;34;31;6;25;.806;3086000;0
17531;195761;651;0;0;0;0;.00nan;0;0
17531;-1;651;82;26;1;25;.962;3600000;0
17533;177631;1818;66;29;3;26;.897;3600000;0
17533;193687;703;56;30;4;26;.867;3578000;0
17533;214635;703;0;0;0;0;.00nan;0;0
17533;156632;1818;0;0;0;0;.00nan;0;0
17535;8942;638;51;32;5;27;.844;3600000;0
17535;-1;1813;73;43;4;39;.907;3600000;0
17535;-1;638;0;0;0;0;.00nan;0;0
17535;-1;1813;0;0;0;0;.00nan;0;0
17537;-1;4538;47;33;5;28;.848;3600000;0
17537;174806;648;0;0;0;0;.00nan;0;0
17537;211456;4538;0;0;0;0;.00nan;0;0
17537;72747;648;66;26;2;24;.923;3600000;0
17539;-1;1835;71;21;1;20;.952;3600000;0
17539;-1;633;56;23;2;21;.913;3566000;0
17539;-1;633;0;0;0;0;.00nan;0;0
17539;-1;1835;0;0;0;0;.00nan;0;0
17541;-1;1825;52;44;6;38;.864;3600000;0
17541;-1;646;0;0;0;0;.00nan;0;0
17541;-1;646;65;15;1;14;.933;3600000;0
17541;-1;1825;0;0;0;0;.00nan;0;0
17543;214281;1809;69;35;4;31;.886;3600000;0
17543;164404;1809;0;0;0;0;.00nan;0;0
17543;-1;646;93;19;0;19;1.000;3600000;0
17543;-1;646;0;0;0;0;.00nan;0;0
17545;8942;638;0;0;0;0;.00nan;0;0
17545;-1;649;49;21;3;18;.857;3834000;0
17545;-1;638;63;43;4;39;.907;3834000;0
17545;85947;649;0;0;0;0;.00nan;0;0
17547;193341;1838;70;28;3;25;.893;3600000;0
17547;-1;1813;0;0;0;0;.00nan;0;0
17547;-1;1838;0;0;0;0;.00nan;0;0
17547;-1;1813;49;15;2;13;.867;3600000;0
17549;-1;1825;0;0;0;0;.00nan;0;0
17549;-1;633;0;0;0;0;.00nan;0;0
17549;-1;633;84;18;0;18;1.000;3600000;0
17549;-1;1825;77;32;3;29;.906;3600000;0
17551;193687;703;77;32;2;30;.938;3600000;0
17551;214635;703;0;0;0;0;.00nan;0;0
17551;-1;4538;63;14;1;13;.929;1461000;0
17551;211456;4538;53;26;4;22;.846;2139000;0
17553;-1;1835;71;32;3;29;.906;3201000;0
17553;195761;651;73;36;3;33;.917;3600000;0
17553;-1;651;0;0;0;0;.00nan;0;0
17553;-1;1835;21;3;3;0;.000;399000;0
17555;177631;1818;64;30;3;27;.900;3549000;0
17555;174806;648;72;27;2;25;.926;3600000;0
17555;72747;648;0;0;0;0;.00nan;0;0
17555;156632;1818;0;0;0;0;.00nan;0;0
17557;-1;1835;25;31;6;25;.806;3579000;0
17557;-1;4538;57;32;5;27;.844;3600000;0
17557;211456;4538;0;0;0;0;.00nan;0;0
17557;-1;1835;0;0;0;0;.00nan;0;0
17559;214281;1809;72;43;4;39;.907;3600000;0
17559;164404;1809;0;0;0;0;.00nan;0;0
17559;174806;648;0;0;0;0;.00nan;0;0
17559;72747;648;83;25;1;24;.960;3600000;0
17561;193341;1838;70;24;2;22;.917;3600000;0
17561;193687;703;36;30;5;25;.833;2277000;0
17561;214635;703;47;9;1;8;.889;1323000;0
17561;-1;1838;0;0;0;0;.00nan;0;0
17563;195761;651;0;0;0;0;.00nan;0;0
17563;-1;651;80;33;2;31;.939;3600000;0
17563;-1;646;58;34;4;30;.882;3542000;0
17563;-1;646;0;0;0;0;.00nan;0;0
17565;-1;633;0;0;0;0;.00nan;0;0
17565;-1;633;67;35;4;31;.886;3593000;0
17565;-1;1813;60;23;2;21;.913;3600000;0
17565;-1;1813;0;0;0;0;.00nan;0;0
17567;8942;638;0;0;0;0;.00nan;0;0
17567;-1;649;0;0;0;0;.00nan;0;0
17567;-1;638;100;50;2;48;.960;3600000;0
17567;85947;649;62;26;3;23;.885;3546000;0
17569;177631;1818;94;38;3;35;.921;5114000;0
17569;-1;1825;89;45;2;43;.956;5114000;0
17569;-1;1825;0;0;0;0;.00nan;0;0
17569;156632;1818;0;0;0;0;.00nan;0;0
17571;195761;651;62;19;2;17;.895;3600000;0
17571;-1;633;34;41;7;34;.829;3600000;0
17571;-1;633;0;0;0;0;.00nan;0;0
17571;-1;651;0;0;0;0;.00nan;0;0
17573;193341;1838;0;0;0;0;.00nan;0;0
17573;-1;649;33;23;5;18;.783;4137000;0
17573;-1;1838;64;37;4;33;.892;4137000;0
17573;85947;649;0;0;0;0;.00nan;0;0
17575;8942;638;52;43;7;36;.837;3600000;0
17575;-1;1835;0;0;0;0;.00nan;0;0
17575;-1;638;0;0;0;0;.00nan;0;0
17575;-1;1835;78;30;1;29;.967;3600000;0
17577;177631;1818;0;0;0;0;.00nan;0;0
17577;-1;1813;0;0;0;0;.00nan;0;0
17577;-1;1813;59;26;3;23;.885;3600000;0
17577;156632;1818;35;29;5;24;.828;3548000;0
17579;214281;1809;0;0;0;0;.00nan;0;0
17579;193687;703;69;26;2;24;.923;3600000;0
17579;214635;703;0;0;0;0;.00nan;0;0
17579;164404;1809;54;32;4;28;.875;3600000;0
17581;174806;648;58;24;3;21;.875;3600000;0
17581;-1;646;0;0;0;0;.00nan;0;0
17581;-1;646;77;32;2;30;.938;3600000;0
17581;72747;648;0;0;0;0;.00nan;0;0
17583;-1;1825;0;0;0;0;.00nan;0;0
17583;-1;4538;0;0;0;0;.00nan;0;0
17583;211456;4538;99;18;0;18;1.000;3600000;0
17583;-1;1825;54;32;4;28;.875;3600000;0
1016;-1;1825;63;25;2;23;.920;3549000;0
1016;174806;648;0;0;0;0;.00nan;0;0
1016;72747;648;81;28;1;27;.964;3600000;0
1016;160906;1825;0;0;0;0;.00nan;0;0
1017;193341;1838;66;22;1;21;.955;3600000;0
1017;-1;4538;94;33;2;31;.939;3574000;0
1017;211456;4538;0;0;0;0;.00nan;0;0
1017;-1;1838;0;0;0;0;.00nan;0;0
1018;-1;1825;98;37;1;36;.973;3576000;0
1018;174806;648;0;0;0;0;.00nan;0;0
1018;72747;648;83;17;0;17;1.000;3600000;0
1018;160906;1825;0;0;0;0;.00nan;0;0
1019;193341;1838;79;29;1;28;.966;3600000;0
1019;-1;4538;55;32;4;28;.875;3600000;0
1019;211456;4538;0;0;0;0;.00nan;0;0
1019;-1;1838;0;0;0;0;.00nan;0;0
1138;193341;1838;43;42;6;36;.857;3028000;0
1138;195761;651;53;23;3;20;.870;3600000;0
1138;-1;651;0;0;0;0;.00nan;0;0
1138;-1;1838;51;10;1;9;.900;572000;0
1139;-1;649;0;0;0;0;.00nan;0;0
1139;-1;646;0;0;0;0;.00nan;0;0
1139;-1;646;68;24;2;22;.917;3801000;0
1139;85947;649;83;24;1;23;.958;3801000;0
1140;177631;1818;59;34;4;30;.882;3600000;0
1140;-1;1813;73;21;1;20;.952;3600000;0
1140;-1;1813;0;0;0;0;.00nan;0;0
1140;156632;1818;0;0;0;0;.00nan;0;0
1141;-1;1835;88;30;1;29;.967;3728000;0
1141;174806;648;0;0;0;0;.00nan;0;0
1141;72747;648;78;34;2;32;.941;3728000;0
1141;156545;1835;0;0;0;0;.00nan;0;0
1142;193341;1838;75;17;0;17;1.000;1246000;0
1142;195761;651;43;23;4;19;.826;3600000;0
1142;-1;651;0;0;0;0;.00nan;0;0
1142;-1;1838;27;34;7;27;.794;2354000;0
1143;-1;649;0;0;0;0;.00nan;0;0
1143;-1;646;0;0;0;0;.00nan;0;0
1143;-1;646;67;21;1;20;.952;3600000;0
1143;85947;649;87;35;2;33;.943;3600000;0
1144;177631;1818;78;23;1;22;.957;3600000;0
1144;-1;1813;72;33;2;31;.939;3575000;0
1144;-1;1813;0;0;0;0;.00nan;0;0
1144;156632;1818;0;0;0;0;.00nan;0;0
1145;-1;1835;96;20;0;20;1.000;3600000;0
1145;174806;648;0;0;0;0;.00nan;0;0
1145;72747;648;83;25;1;24;.960;3581000;0
1145;156545;1835;0;0;0;0;.00nan;0;0
1146;193341;1838;48;42;6;36;.857;3600000;0
1146;195761;651;72;28;2;26;.929;3600000;0
1146;-1;651;0;0;0;0;.00nan;0;0
1146;-1;1838;0;0;0;0;.00nan;0;0
1147;-1;649;0;0;0;0;.00nan;0;0
1147;-1;646;41;10;2;8;.800;507000;0
1147;-1;646;36;39;6;33;.846;3093000;0
1147;85947;649;67;19;1;18;.947;3600000;0
1148;177631;1818;65;27;3;24;.889;3600000;0
1148;-1;1813;40;24;4;20;.833;3600000;0
1148;-1;1813;0;0;0;0;.00nan;0;0
1148;156632;1818;0;0;0;0;.00nan;0;0
1149;-1;1835;86;49;4;45;.918;3600000;0
1149;174806;648;0;0;0;0;.00nan;0;0
1149;72747;648;67;21;1;20;.952;3600000;0
1149;156545;1835;0;0;0;0;.00nan;0;0
1150;193341;1838;72;37;3;34;.919;3578000;0
1150;195761;651;78;28;2;26;.929;3600000;0
1150;-1;651;0;0;0;0;.00nan;0;0
1150;-1;1838;0;0;0;0;.00nan;0;0
1151;-1;649;0;0;0;0;.00nan;0;0
1151;-1;646;68;29;3;26;.897;4200000;0
1151;-1;646;0;0;0;0;.00nan;0;0
1151;85947;649;70;32;3;29;.906;4200000;0
1152;177631;1818;72;19;1;18;.947;3600000;0
1152;-1;1813;64;35;4;31;.886;3600000;0
1152;-1;1813;0;0;0;0;.00nan;0;0
1152;156632;1818;0;0;0;0;.00nan;0;0
1153;-1;1835;73;32;2;30;.938;4189000;0
1153;174806;648;0;0;0;0;.00nan;0;0
1153;72747;648;95;36;2;34;.944;4200000;0
1153;156545;1835;0;0;0;0;.00nan;0;0
1463;-1;649;0;0;0;0;.00nan;0;0
1463;-1;646;60;30;3;27;.900;3541000;0
1463;-1;646;0;0;0;0;.00nan;0;0
1463;85947;649;68;19;2;17;.895;3600000;0
1464;177631;1818;53;18;2;16;.889;3600000;0
1464;-1;1813;72;40;3;37;.925;3543000;0
1464;-1;1813;0;0;0;0;.00nan;0;0
1464;156632;1818;0;0;0;0;.00nan;0;0
1465;-1;1835;58;22;3;19;.864;3600000;0
1465;174806;648;0;0;0;0;.00nan;0;0
1465;72747;648;46;27;5;22;.815;3583000;0
1465;156545;1835;0;0;0;0;.00nan;0;0
1497;-1;1835;90;28;1;27;.964;3600000;0
1497;174806;648;0;0;0;0;.00nan;0;0
1497;72747;648;59;22;2;20;.909;3584000;0
1497;156545;1835;0;0;0;0;.00nan;0;0
1550;177631;1818;63;25;2;23;.920;3756000;0
1550;195761;651;89;42;3;39;.929;3756000;0
1550;-1;651;0;0;0;0;.00nan;0;0
1550;156632;1818;0;0;0;0;.00nan;0;0
1551;-1;1835;57;34;4;30;.882;3516000;0
1551;-1;649;0;0;0;0;.00nan;0;0
1551;85947;649;91;36;2;34;.944;3600000;0
1551;156545;1835;0;0;0;0;.00nan;0;0
1552;177631;1818;100;38;1;37;.974;3600000;0
1552;195761;651;52;23;3;20;.870;3539000;0
1552;-1;651;0;0;0;0;.00nan;0;0
1552;156632;1818;0;0;0;0;.00nan;0;0
1553;-1;1835;48;31;5;26;.839;3600000;0
1553;-1;649;0;0;0;0;.00nan;0;0
1553;85947;649;100;26;0;26;1.000;3600000;0
1553;156545;1835;0;0;0;0;.00nan;0;0
1554;177631;1818;32;24;5;19;.792;1837000;0
1554;195761;651;73;28;2;26;.929;3600000;0
1554;-1;651;0;0;0;0;.00nan;0;0
1554;156632;1818;72;19;1;18;.947;1763000;0
1555;-1;1835;76;35;3;32;.914;4200000;0
1555;-1;649;0;0;0;0;.00nan;0;0
1555;85947;649;70;35;3;32;.914;4200000;0
1555;156545;1835;0;0;0;0;.00nan;0;0
1556;177631;1818;73;26;2;24;.923;3600000;0
1556;195761;651;61;40;5;35;.875;3600000;0
1556;-1;651;0;0;0;0;.00nan;0;0
1556;156632;1818;0;0;0;0;.00nan;0;0
1557;-1;1835;85;35;2;33;.943;3600000;0
1557;-1;649;0;0;0;0;.00nan;0;0
1557;85947;649;49;28;4;24;.857;3559000;0
1557;156545;1835;0;0;0;0;.00nan;0;0
1809;177631;1818;82;32;3;29;.906;3600000;0
1809;195761;651;43;34;5;29;.853;3561000;0
1809;-1;651;0;0;0;0;.00nan;0;0
1809;156632;1818;0;0;0;0;.00nan;0;0
1810;-1;1835;79;44;3;41;.932;3591000;0
1810;-1;649;0;0;0;0;.00nan;0;0
1810;85947;649;97;43;2;41;.953;3600000;0
1810;156545;1835;0;0;0;0;.00nan;0;0
1850;-1;1835;94;48;2;46;.958;3550000;0
1850;-1;649;0;0;0;0;.00nan;0;0
1850;85947;649;71;18;1;17;.944;3600000;0
1850;156545;1835;0;0;0;0;.00nan;0;0
1874;177631;1818;47;15;3;12;.800;3600000;0
1874;-1;649;0;0;0;0;.00nan;0;0
1874;85947;649;38;25;5;20;.800;3542000;0
1874;156632;1818;0;0;0;0;.00nan;0;0
1875;177631;1818;83;34;2;32;.941;3600000;0
1875;-1;649;0;0;0;0;.00nan;0;0
1875;85947;649;63;32;3;29;.906;3541000;0
1875;156632;1818;0;0;0;0;.00nan;0;0
1876;177631;1818;44;23;5;18;.783;3521000;0
1876;-1;649;0;0;0;0;.00nan;0;0
1876;85947;649;80;47;4;43;.915;3600000;0
1876;156632;1818;0;0;0;0;.00nan;0;0
1877;177631;1818;35;44;7;37;.841;3549000;0
1877;-1;649;0;0;0;0;.00nan;0;0
1877;85947;649;54;32;5;27;.844;3600000;0
1877;156632;1818;0;0;0;0;.00nan;0;0
2010;177631;1818;60;32;4;28;.875;3552000;0
2010;-1;649;0;0;0;0;.00nan;0;0
2010;85947;649;79;37;3;34;.919;3600000;0
2010;156632;1818;0;0;0;0;.00nan;0;0
2102;177631;1818;56;18;2;16;.889;3600000;0
2102;-1;649;0;0;0;0;.00nan;0;0
2102;85947;649;33;25;5;20;.800;3600000;0
2102;156632;1818;0;0;0;0;.00nan;0;0
2147;177631;1818;77;24;1;23;.958;3600000;0
2147;-1;649;0;0;0;0;.00nan;0;0
2147;85947;649;78;34;3;31;.912;3551000;0
2147;156632;1818;0;0;0;0;.00nan;0;0
17584;175063;2508;100;61;4;57;.934;3900000;0
17584;216934;845;0;0;0;0;.00nan;0;0
17584;-1;845;51;33;4;29;.879;3900000;0
17584;239842;2508;0;0;0;0;.00nan;0;0
17585;-1;2517;59;26;3;23;.885;3600000;0
17585;61292;2517;0;0;0;0;.00nan;0;0
17585;148069;844;44;30;4;26;.867;3547000;0
17585;152266;844;0;0;0;0;.00nan;0;0
17586;206474;2493;0;0;0;0;.00nan;0;0
17586;211690;2493;46;24;3;21;.875;3600000;0
17586;47791;843;0;0;0;0;.00nan;0;0
17586;78223;843;56;31;4;27;.871;3589000;0
17587;805;835;80;23;1;22;.957;3600000;0
17587;73098;2488;75;35;2;33;.943;3600000;0
17587;94240;835;0;0;0;0;.00nan;0;0
17587;239841;2488;0;0;0;0;.00nan;0;0
17588;-1;841;71;30;2;28;.933;3600000;0
17588;180311;841;0;0;0;0;.00nan;0;0
17588;-1;846;88;50;3;47;.940;3555000;0
17588;147962;846;0;0;0;0;.00nan;0;0
17589;216934;845;0;0;0;0;.00nan;0;0
17589;47791;843;0;0;0;0;.00nan;0;0
17589;-1;845;49;26;4;22;.846;3600000;0
17589;78223;843;73;26;1;25;.962;3600000;0
17590;206474;2493;0;0;0;0;.00nan;0;0
17590;211690;2493;45;36;5;31;.861;3600000;0
17590;148069;844;0;0;0;0;.00nan;0;0
17590;152266;844;66;21;2;19;.905;3600000;0
17591;175063;2508;81;36;2;34;.944;3900000;0
17591;-1;841;0;0;0;0;.00nan;0;0
17591;180311;841;57;15;2;13;.867;3900000;0
17591;239842;2508;0;0;0;0;.00nan;0;0
17592;-1;846;61;26;4;22;.846;3577000;0
17592;73098;2488;65;20;2;18;.900;3600000;0
17592;147962;846;0;0;0;0;.00nan;0;0
17592;239841;2488;0;0;0;0;.00nan;0;0
17593;805;835;54;19;2;17;.895;3900000;0
17593;-1;2517;74;36;3;33;.917;3900000;0
17593;61292;2517;0;0;0;0;.00nan;0;0
17593;94240;835;0;0;0;0;.00nan;0;0
17594;-1;846;77;42;4;38;.905;3600000;0
17594;147962;846;0;0;0;0;.00nan;0;0
17594;148069;844;0;0;0;0;.00nan;0;0
17594;152266;844;54;26;3;23;.885;3600000;0
17595;805;835;72;28;2;26;.929;3519000;0
17595;47791;843;0;0;0;0;.00nan;0;0
17595;78223;843;88;18;0;18;1.000;3600000;0
17595;94240;835;0;0;0;0;.00nan;0;0
17596;-1;2517;67;38;4;34;.895;3600000;0
17596;206474;2493;0;0;0;0;.00nan;0;0
17596;211690;2493;48;32;5;27;.844;3600000;0
17596;61292;2517;0;0;0;0;.00nan;0;0
17597;216934;845;0;0;0;0;.00nan;0;0
17597;-1;841;0;0;0;0;.00nan;0;0
17597;180311;841;75;27;2;25;.926;3900000;0
17597;-1;845;79;30;2;28;.933;3900000;0
17598;175063;2508;78;44;4;40;.909;3600000;0
17598;73098;2488;0;0;0;0;.00nan;0;0
17598;239841;2488;77;27;2;25;.926;3600000;0
17598;239842;2508;0;0;0;0;.00nan;0;0
17599;175063;2508;95;41;2;39;.951;3900000;0
17599;47791;843;0;0;0;0;.00nan;0;0
17599;78223;843;66;27;2;25;.926;3900000;0
17599;239842;2508;0;0;0;0;.00nan;0;0
17600;73098;2488;47;27;4;23;.852;3600000;0
17600;148069;844;0;0;0;0;.00nan;0;0
17600;152266;844;77;22;1;21;.955;3600000;0
17600;239841;2488;0;0;0;0;.00nan;0;0
17601;-1;2517;57;34;4;30;.882;3600000;0
17601;-1;841;0;0;0;0;.00nan;0;0
17601;180311;841;62;35;5;30;.857;3580000;0
17601;61292;2517;0;0;0;0;.00nan;0;0
17602;805;835;0;0;0;0;.00nan;0;0
17602;206474;2493;0;0;0;0;.00nan;0;0
17602;211690;2493;74;32;2;30;.938;3600000;0
17602;94240;835;49;24;3;21;.875;3584000;0
17603;216934;845;0;0;0;0;.00nan;0;0
17603;-1;846;0;0;0;0;.00nan;0;0
17603;-1;845;68;22;2;20;.909;3900000;0
17603;147962;846;75;38;2;36;.947;3900000;0
17604;175063;2508;85;49;3;46;.939;3873000;0
17604;148069;844;49;24;4;20;.833;3873000;0
17604;152266;844;0;0;0;0;.00nan;0;0
17604;239842;2508;0;0;0;0;.00nan;0;0
17605;-1;2517;51;28;4;24;.857;3549000;0
17605;216934;845;52;23;3;20;.870;3600000;0
17605;-1;845;0;0;0;0;.00nan;0;0
17605;61292;2517;0;0;0;0;.00nan;0;0
17606;47791;843;0;0;0;0;.00nan;0;0
17606;73098;2488;37;27;5;22;.815;3900000;0
17606;78223;843;40;28;5;23;.821;3900000;0
17606;239841;2488;0;0;0;0;.00nan;0;0
17607;805;835;71;25;2;23;.920;3600000;0
17607;-1;841;0;0;0;0;.00nan;0;0
17607;180311;841;55;39;5;34;.872;3600000;0
17607;94240;835;0;0;0;0;.00nan;0;0
17608;206474;2493;61;9;0;9;1.000;1023000;0
17608;211690;2493;26;28;7;21;.750;2577000;0
17608;-1;846;73;30;3;27;.900;3600000;0
17608;147962;846;0;0;0;0;.00nan;0;0
17609;805;835;61;33;4;29;.879;3592000;0
17609;94240;835;0;0;0;0;.00nan;0;0
17609;148069;844;0;0;0;0;.00nan;0;0
17609;152266;844;56;24;3;21;.875;3600000;0
17610;175063;2508;63;37;4;33;.892;3578000;0
17610;206474;2493;57;18;2;16;.889;3600000;0
17610;211690;2493;0;0;0;0;.00nan;0;0
17610;239842;2508;0;0;0;0;.00nan;0;0
17611;-1;841;55;28;3;25;.893;3600000;0
17611;180311;841;0;0;0;0;.00nan;0;0
17611;47791;843;0;0;0;0;.00nan;0;0
17611;78223;843;100;33;0;33;1.000;3600000;0
17612;216934;845;0;0;0;0;.00nan;0;0
17612;-1;845;42;26;4;22;.846;3600000;0
17612;73098;2488;59;24;2;22;.917;3183000;0
17612;239841;2488;25;6;3;3;.500;417000;0
17613;206474;2493;0;0;0;0;.00nan;0;0
17613;211690;2493;55;28;3;25;.893;3546000;0
17613;216934;845;0;0;0;0;.00nan;0;0
17613;-1;845;83;30;2;28;.933;3600000;0
17614;-1;2517;72;20;2;18;.900;3900000;0
17614;175063;2508;97;42;2;40;.952;3900000;0
17614;61292;2517;0;0;0;0;.00nan;0;0
17614;239842;2508;0;0;0;0;.00nan;0;0
17615;-1;843;0;0;0;0;.00nan;0;0
17615;78223;843;67;27;3;24;.889;3600000;0
17615;148069;844;53;27;4;23;.852;3543000;0
17615;152266;844;0;0;0;0;.00nan;0;0
17616;-1;841;0;0;0;0;.00nan;0;0
17616;180311;841;71;26;2;24;.923;3580000;0
17616;73098;2488;99;32;1;31;.969;3600000;0
17616;239841;2488;0;0;0;0;.00nan;0;0
17617;805;835;0;0;0;0;.00nan;0;0
17617;-1;846;64;36;4;32;.889;3542000;0
17617;94240;835;67;30;2;28;.933;3600000;0
17617;147962;846;0;0;0;0;.00nan;0;0
17618;-1;841;0;0;0;0;.00nan;0;0
17618;180311;841;50;29;4;25;.862;3900000;0
17618;148069;844;0;0;0;0;.00nan;0;0
17618;152266;844;69;33;4;29;.879;3900000;0
17619;-1;2517;62;21;2;19;.905;3600000;0
17619;-1;843;0;0;0;0;.00nan;0;0
17619;61292;2517;0;0;0;0;.00nan;0;0
17619;78223;843;65;31;4;27;.871;3530000;0
17620;805;835;100;23;0;23;1.000;3600000;0
17620;216934;845;0;0;0;0;.00nan;0;0
17620;-1;845;80;42;4;38;.905;3600000;0
17620;94240;835;0;0;0;0;.00nan;0;0
17621;175063;2508;72;34;3;31;.912;3600000;0
17621;-1;846;30;30;6;24;.800;3600000;0
17621;147962;846;0;0;0;0;.00nan;0;0
17621;239842;2508;0;0;0;0;.00nan;0;0
17622;216934;845;41;28;4;24;.857;3600000;0
17622;-1;845;0;0;0;0;.00nan;0;0
17622;148069;844;53;37;5;32;.865;3559000;0
17622;152266;844;0;0;0;0;.00nan;0;0
17623;-1;846;27;27;6;21;.778;3563000;0
17623;-1;843;0;0;0;0;.00nan;0;0
17623;78223;843;42;26;4;22;.846;3600000;0
17623;147962;846;0;0;0;0;.00nan;0;0
17624;206474;2493;0;0;0;0;.00nan;0;0
17624;211690;2493;58;39;5;34;.872;3600000;0
17624;-1;841;48;27;4;23;.852;3600000;0
17624;180311;841;0;0;0;0;.00nan;0;0
17625;-1;2517;99;37;1;36;.973;3600000;0
17625;61292;2517;0;0;0;0;.00nan;0;0
17625;73098;2488;64;27;3;24;.889;3587000;0
17625;239841;2488;0;0;0;0;.00nan;0;0
17626;175063;2508;63;48;6;42;.875;3600000;0
17626;216934;845;0;0;0;0;.00nan;0;0
17626;-1;845;72;22;2;20;.909;3600000;0
17626;239842;2508;0;0;0;0;.00nan;0;0
17627;206474;2493;40;33;6;27;.818;3600000;0
17627;211690;2493;0;0;0;0;.00nan;0;0
17627;-1;843;0;0;0;0;.00nan;0;0
17627;78223;843;76;35;3;32;.914;3600000;0
17628;-1;841;0;0;0;0;.00nan;0;0
17628;180311;841;84;28;1;27;.964;3600000;0
17628;-1;846;37;30;6;24;.800;3201000;0
17628;147962;846;51;3;0;3;1.000;399000;0
17629;805;835;67;19;1;18;.947;3600000;0
17629;73098;2488;0;0;0;0;.00nan;0;0
17629;94240;835;0;0;0;0;.00nan;0;0
17629;239841;2488;67;30;3;27;.900;3564000;0
17630;-1;2517;76;23;1;22;.957;3600000;0
17630;61292;2517;0;0;0;0;.00nan;0;0
17630;148069;844;0;0;0;0;.00nan;0;0
17630;152266;844;36;29;5;24;.828;3600000;0
17631;805;835;36;15;4;11;.733;3600000;0
17631;175063;2508;63;53;7;46;.868;3600000;0
17631;94240;835;0;0;0;0;.00nan;0;0
17631;239842;2508;0;0;0;0;.00nan;0;0
17632;206474;2493;0;0;0;0;.00nan;0;0
17632;211690;2493;94;37;2;35;.946;3600000;0
17632;148069;844;41;23;4;19;.826;3515000;0
17632;152266;844;0;0;0;0;.00nan;0;0
17633;216934;845;0;0;0;0;.00nan;0;0
17633;-1;843;0;0;0;0;.00nan;0;0
17633;-1;845;79;31;2;29;.935;3530000;0
17633;78223;843;85;21;0;21;1.000;3600000;0
17634;805;835;0;0;0;0;.00nan;0;0
17634;-1;2517;97;49;3;46;.939;3600000;0
17634;61292;2517;0;0;0;0;.00nan;0;0
17634;94240;835;68;17;1;16;.941;3600000;0
17635;-1;846;0;0;0;0;.00nan;0;0
17635;73098;2488;53;29;4;25;.862;3900000;0
17635;147962;846;95;44;4;40;.909;3900000;0
17635;239841;2488;0;0;0;0;.00nan;0;0
17636;175063;2508;57;32;4;28;.875;3544000;0
17636;-1;841;0;0;0;0;.00nan;0;0
17636;180311;841;54;15;2;13;.867;3600000;0
17636;239842;2508;0;0;0;0;.00nan;0;0
17637;175063;2508;81;42;3;39;.929;3600000;0
17637;73098;2488;25;20;5;15;.750;3550000;0
17637;239841;2488;0;0;0;0;.00nan;0;0
17637;239842;2508;0;0;0;0;.00nan;0;0
17638;-1;2517;86;29;1;28;.966;3600000;0
17638;206474;2493;0;0;0;0;.00nan;0;0
17638;211690;2493;56;33;4;29;.879;3600000;0
17638;61292;2517;0;0;0;0;.00nan;0;0
17639;805;835;88;19;0;19;1.000;3600000;0
17639;-1;843;0;0;0;0;.00nan;0;0
17639;78223;843;96;41;3;38;.927;3600000;0
17639;94240;835;0;0;0;0;.00nan;0;0
17640;-1;846;0;0;0;0;.00nan;0;0
17640;147962;846;53;18;2;16;.889;3600000;0
17640;148069;844;44;3;1;2;.667;341000;0
17640;152266;844;51;43;6;37;.860;3259000;0
17641;175063;2508;62;44;6;38;.864;3600000;0
17641;148069;844;62;29;3;26;.897;3600000;0
17641;152266;844;0;0;0;0;.00nan;0;0
17641;239842;2508;0;0;0;0;.00nan;0;0
17642;206474;2493;0;0;0;0;.00nan;0;0
17642;211690;2493;91;27;1;26;.963;3600000;0
17642;-1;846;0;0;0;0;.00nan;0;0
17642;147962;846;66;38;3;35;.921;3600000;0
17643;805;835;47;14;2;12;.857;3600000;0
17643;-1;841;0;0;0;0;.00nan;0;0
17643;180311;841;78;45;4;41;.911;3553000;0
17643;94240;835;0;0;0;0;.00nan;0;0
17644;-1;843;0;0;0;0;.00nan;0;0
17644;73098;2488;0;0;0;0;.00nan;0;0
17644;78223;843;63;34;3;31;.912;3569000;0
17644;239841;2488;70;29;2;27;.931;3600000;0
17645;-1;2517;83;38;3;35;.921;3665000;0
17645;216934;845;0;0;0;0;.00nan;0;0
17645;-1;845;65;26;2;24;.923;3665000;0
17645;61292;2517;0;0;0;0;.00nan;0;0
17646;175063;2508;87;48;3;45;.938;3582000;0
17646;206474;2493;0;0;0;0;.00nan;0;0
17646;211690;2493;61;14;1;13;.929;3600000;0
17646;239842;2508;0;0;0;0;.00nan;0;0
17647;-1;841;0;0;0;0;.00nan;0;0
17647;180311;841;80;24;1;23;.958;3900000;0
17647;-1;843;0;0;0;0;.00nan;0;0
17647;78223;843;94;26;1;25;.962;3900000;0
17648;805;835;75;26;2;24;.923;3600000;0
17648;94240;835;0;0;0;0;.00nan;0;0
17648;148069;844;0;0;0;0;.00nan;0;0
17648;152266;844;45;29;5;24;.828;3600000;0
17649;-1;2517;66;38;4;34;.895;3693000;0
17649;-1;846;35;27;5;22;.815;3693000;0
17649;61292;2517;0;0;0;0;.00nan;0;0
17649;147962;846;0;0;0;0;.00nan;0;0
17650;-1;843;0;0;0;0;.00nan;0;0
17650;78223;843;73;32;3;29;.906;3626000;0
17650;148069;844;70;27;2;25;.926;3658000;0
17650;152266;844;0;0;0;0;.00nan;0;0
17651;206474;2493;79;27;1;26;.963;3600000;0
17651;211690;2493;0;0;0;0;.00nan;0;0
17651;216934;845;0;0;0;0;.00nan;0;0
17651;-1;845;70;27;2;25;.926;3562000;0
17652;-1;841;79;31;2;29;.935;3600000;0
17652;180311;841;0;0;0;0;.00nan;0;0
17652;73098;2488;73;42;3;39;.929;3549000;0
17652;239841;2488;0;0;0;0;.00nan;0;0
17653;-1;2517;86;18;0;18;1.000;3600000;0
17653;175063;2508;97;41;1;40;.976;3546000;0
17653;61292;2517;0;0;0;0;.00nan;0;0
17653;239842;2508;0;0;0;0;.00nan;0;0
17654;805;835;48;22;3;19;.864;3550000;0
17654;-1;846;0;0;0;0;.00nan;0;0
17654;94240;835;0;0;0;0;.00nan;0;0
17654;147962;846;99;41;2;39;.951;3600000;0
17655;175063;2508;0;0;0;0;.00nan;0;0
17655;-1;846;0;0;0;0;.00nan;0;0
17655;147962;846;52;32;4;28;.875;3600000;0
17655;239842;2508;73;31;3;28;.903;3600000;0
17656;-1;2517;72;36;4;32;.889;3600000;0
17656;-1;843;31;34;6;28;.824;3600000;0
17656;61292;2517;0;0;0;0;.00nan;0;0
17656;78223;843;0;0;0;0;.00nan;0;0
17657;-1;841;0;0;0;0;.00nan;0;0
17657;180311;841;58;28;3;25;.893;3600000;0
17657;148069;844;0;0;0;0;.00nan;0;0
17657;152266;844;47;27;4;23;.852;3600000;0
17658;206474;2493;0;0;0;0;.00nan;0;0
17658;211690;2493;89;27;1;26;.963;3600000;0
17658;73098;2488;0;0;0;0;.00nan;0;0
17658;239841;2488;80;30;2;28;.933;3560000;0
17659;805;835;0;0;0;0;.00nan;0;0
17659;216934;845;0;0;0;0;.00nan;0;0
17659;-1;845;89;32;1;31;.969;3582000;0
17659;94240;835;95;21;0;21;1.000;3600000;0
17660;216934;845;77;31;2;29;.935;3737000;0
17660;-1;845;0;0;0;0;.00nan;0;0
17660;148069;844;85;40;3;37;.925;3737000;0
17660;152266;844;0;0;0;0;.00nan;0;0
17661;206474;2493;0;0;0;0;.00nan;0;0
17661;211690;2493;51;26;3;23;.885;3600000;0
17661;-1;841;0;0;0;0;.00nan;0;0
17661;180311;841;93;43;2;41;.953;3600000;0
17662;-1;2517;57;37;4;33;.892;3550000;0
17662;61292;2517;0;0;0;0;.00nan;0;0
17662;73098;2488;68;35;3;32;.914;3600000;0
17662;239841;2488;0;0;0;0;.00nan;0;0
17663;805;835;0;0;0;0;.00nan;0;0
17663;175063;2508;41;34;6;28;.824;2764000;0
17663;94240;835;65;16;2;14;.875;3600000;0
17663;239842;2508;47;6;1;5;.833;836000;0
17664;-1;846;36;18;4;14;.778;3600000;0
17664;-1;843;0;0;0;0;.00nan;0;0
17664;78223;843;85;41;3;38;.927;3600000;0
17664;147962;846;0;0;0;0;.00nan;0;0
17665;216934;845;0;0;0;0;.00nan;0;0
17665;-1;846;0;0;0;0;.00nan;0;0
17665;-1;845;80;34;2;32;.941;3600000;0
17665;147962;846;69;30;3;27;.900;3588000;0
17666;175063;2508;59;29;4;25;.862;3600000;0
17666;-1;843;0;0;0;0;.00nan;0;0
17666;78223;843;64;17;1;16;.941;3600000;0
17666;239842;2508;0;0;0;0;.00nan;0;0
17667;805;835;100;37;0;37;1.000;3600000;0
17667;206474;2493;72;32;2;30;.938;3562000;0
17667;211690;2493;0;0;0;0;.00nan;0;0
17667;94240;835;0;0;0;0;.00nan;0;0
17668;-1;2517;16;30;7;23;.767;3302000;0
17668;-1;841;53;7;1;6;.857;1198000;0
17668;180311;841;32;28;6;22;.786;2516000;0
17668;61292;2517;53;8;1;7;.875;412000;0
17669;73098;2488;65;25;2;23;.920;3600000;0
17669;148069;844;0;0;0;0;.00nan;0;0
17669;152266;844;42;36;5;31;.861;3600000;0
17669;239841;2488;0;0;0;0;.00nan;0;0
17670;175063;2508;50;48;7;41;.854;3600000;0
17670;-1;846;0;0;0;0;.00nan;0;0
17670;147962;846;42;16;3;13;.813;3600000;0
17670;239842;2508;0;0;0;0;.00nan;0;0
17671;175063;2508;70;60;6;54;.900;3600000;0
17671;206474;2493;0;0;0;0;.00nan;0;0
17671;211690;2493;57;16;2;14;.875;3600000;0
17671;239842;2508;0;0;0;0;.00nan;0;0
17672;805;835;96;38;2;36;.947;3600000;0
17672;94240;835;0;0;0;0;.00nan;0;0
17672;148069;844;75;32;3;29;.906;3570000;0
17672;152266;844;0;0;0;0;.00nan;0;0
17673;216934;845;0;0;0;0;.00nan;0;0
17673;-1;843;0;0;0;0;.00nan;0;0
17673;-1;845;61;31;4;27;.871;3600000;0
17673;78223;843;70;45;5;40;.889;3546000;0
17674;-1;841;82;29;1;28;.966;3600000;0
17674;180311;841;0;0;0;0;.00nan;0;0
17674;73098;2488;68;34;3;31;.912;3531000;0
17674;239841;2488;0;0;0;0;.00nan;0;0
17675;-1;2517;89;34;1;33;.971;3600000;0
17675;-1;846;49;19;3;16;.842;3528000;0
17675;61292;2517;0;0;0;0;.00nan;0;0
17675;147962;846;0;0;0;0;.00nan;0;0
17676;216934;845;60;31;4;27;.871;3600000;0
17676;-1;841;0;0;0;0;.00nan;0;0
17676;180311;841;73;35;3;32;.914;3600000;0
17676;-1;845;0;0;0;0;.00nan;0;0
17677;206474;2493;0;0;0;0;.00nan;0;0
17677;211690;2493;66;25;2;23;.920;3600000;0
17677;148069;844;0;0;0;0;.00nan;0;0
17677;152266;844;75;43;4;39;.907;3600000;0
17678;-1;843;0;0;0;0;.00nan;0;0
17678;73098;2488;0;0;0;0;.00nan;0;0
17678;78223;843;67;38;4;34;.895;3592000;0
17678;239841;2488;67;17;1;16;.941;3600000;0
17679;805;835;73;26;2;24;.923;3900000;0
17679;-1;2517;73;32;2;30;.938;3900000;0
17679;61292;2517;0;0;0;0;.00nan;0;0
17679;94240;835;0;0;0;0;.00nan;0;0
17680;-1;841;0;0;0;0;.00nan;0;0
17680;180311;841;73;26;2;24;.923;3900000;0
17680;-1;846;0;0;0;0;.00nan;0;0
17680;147962;846;83;39;2;37;.949;3900000;0
17681;216934;845;55;4;0;4;1.000;388000;0
17681;-1;845;56;44;6;38;.864;3212000;0
17681;73098;2488;86;39;3;36;.923;3600000;0
17681;239841;2488;0;0;0;0;.00nan;0;0
17682;-1;843;0;0;0;0;.00nan;0;0
17682;78223;843;64;23;2;21;.913;3546000;0
17682;148069;844;0;0;0;0;.00nan;0;0
17682;152266;844;100;36;1;35;.972;3600000;0
17683;805;835;72;35;3;32;.914;3573000;0
17683;-1;841;64;21;2;19;.905;3600000;0
17683;180311;841;0;0;0;0;.00nan;0;0
17683;94240;835;0;0;0;0;.00nan;0;0
17684;-1;2517;99;15;0;15;1.000;3600000;0
17684;175063;2508;79;41;3;38;.927;3600000;0
17684;61292;2517;0;0;0;0;.00nan;0;0
17684;239842;2508;0;0;0;0;.00nan;0;0
17685;206474;2493;0;0;0;0;.00nan;0;0
17685;211690;2493;99;41;1;40;.976;3600000;0
17685;-1;846;45;24;3;21;.875;3522000;0
17685;147962;846;0;0;0;0;.00nan;0;0
17686;805;835;65;30;4;26;.867;3600000;0
17686;216934;845;0;0;0;0;.00nan;0;0
17686;-1;845;92;38;1;37;.974;3600000;0
17686;94240;835;0;0;0;0;.00nan;0;0
17687;175063;2508;83;42;3;39;.929;3600000;0
17687;-1;843;0;0;0;0;.00nan;0;0
17687;78223;843;39;25;5;20;.800;3528000;0
17687;239842;2508;0;0;0;0;.00nan;0;0
17688;-1;2517;61;34;4;30;.882;3600000;0
17688;61292;2517;0;0;0;0;.00nan;0;0
17688;148069;844;74;30;2;28;.933;3600000;0
17688;152266;844;0;0;0;0;.00nan;0;0
17689;206474;2493;0;0;0;0;.00nan;0;0
17689;211690;2493;85;32;2;30;.938;3600000;0
17689;-1;841;0;0;0;0;.00nan;0;0
17689;180311;841;73;34;3;31;.912;3600000;0
17690;-1;846;0;0;0;0;.00nan;0;0
17690;73098;2488;0;0;0;0;.00nan;0;0
17690;147962;846;66;32;3;29;.906;3554000;0
17690;239841;2488;72;25;2;23;.920;3600000;0
17691;216934;845;0;0;0;0;.00nan;0;0
17691;-1;845;100;34;0;34;1.000;3600000;0
17691;148069;844;0;0;0;0;.00nan;0;0
17691;152266;844;55;26;4;22;.846;3600000;0
17692;-1;841;0;0;0;0;.00nan;0;0
17692;180311;841;69;37;4;33;.892;3551000;0
17692;-1;843;87;39;3;36;.923;3600000;0
17692;78223;843;0;0;0;0;.00nan;0;0
17693;-1;2517;53;38;4;34;.895;3563000;0
17693;206474;2493;0;0;0;0;.00nan;0;0
17693;211690;2493;71;29;2;27;.931;3600000;0
17693;61292;2517;0;0;0;0;.00nan;0;0
17694;805;835;94;15;0;15;1.000;3600000;0
17694;73098;2488;48;29;4;25;.862;3600000;0
17694;94240;835;0;0;0;0;.00nan;0;0
17694;239841;2488;0;0;0;0;.00nan;0;0
17695;175063;2508;55;47;6;41;.872;3600000;0
17695;-1;846;61;21;2;19;.905;3600000;0
17695;147962;846;0;0;0;0;.00nan;0;0
17695;239842;2508;0;0;0;0;.00nan;0;0
17696;206474;2493;0;0;0;0;.00nan;0;0
17696;211690;2493;54;22;3;19;.864;3600000;0
17696;73098;2488;0;0;0;0;.00nan;0;0
17696;239841;2488;99;24;0;24;1.000;3600000;0
17697;216934;845;0;0;0;0;.00nan;0;0
17697;-1;846;53;34;5;29;.853;3548000;0
17697;-1;845;66;26;3;23;.885;3600000;0
17697;147962;846;0;0;0;0;.00nan;0;0
17698;175063;2508;57;43;6;37;.860;3600000;0
17698;148069;844;0;0;0;0;.00nan;0;0
17698;152266;844;52;24;3;21;.875;3600000;0
17698;239842;2508;0;0;0;0;.00nan;0;0
17699;805;835;85;25;1;24;.960;3900000;0
17699;-1;843;0;0;0;0;.00nan;0;0
17699;78223;843;76;26;1;25;.962;3900000;0
17699;94240;835;0;0;0;0;.00nan;0;0
17700;206474;2493;0;0;0;0;.00nan;0;0
17700;211690;2493;72;24;2;22;.917;3600000;0
17700;73098;2488;0;0;0;0;.00nan;0;0
17700;239841;2488;22;29;6;23;.793;3600000;0
17701;-1;2517;54;41;5;36;.878;3600000;0
17701;-1;841;66;29;2;27;.931;3600000;0
17701;180311;841;0;0;0;0;.00nan;0;0
17701;61292;2517;0;0;0;0;.00nan;0;0
17702;-1;846;61;28;3;25;.893;3600000;0
17702;147962;846;0;0;0;0;.00nan;0;0
17702;148069;844;54;25;4;21;.840;3544000;0
17702;152266;844;0;0;0;0;.00nan;0;0
17703;206474;2493;63;25;2;23;.920;3900000;0
17703;211690;2493;0;0;0;0;.00nan;0;0
17703;-1;843;0;0;0;0;.00nan;0;0
17703;78223;843;76;29;2;27;.931;3900000;0
17704;216934;845;0;0;0;0;.00nan;0;0
17704;-1;841;0;0;0;0;.00nan;0;0
17704;180311;841;67;28;2;26;.929;3600000;0
17704;-1;845;24;27;6;21;.778;3600000;0
17705;-1;2517;0;0;0;0;.00nan;0;0
17705;61292;2517;77;30;3;27;.900;3867000;0
17705;73098;2488;88;34;2;32;.941;3874000;0
17705;239841;2488;0;0;0;0;.00nan;0;0
17706;805;835;56;10;1;9;.900;3600000;0
17706;175063;2508;96;47;2;45;.957;3591000;0
17706;94240;835;0;0;0;0;.00nan;0;0
17706;239842;2508;0;0;0;0;.00nan;0;0
17707;73098;2488;0;0;0;0;.00nan;0;0
17707;148069;844;47;30;4;26;.867;3600000;0
17707;152266;844;0;0;0;0;.00nan;0;0
17707;239841;2488;33;26;6;20;.769;3522000;0
17708;805;835;69;36;4;32;.889;3554000;0
17708;206474;2493;57;22;2;20;.909;3600000;0
17708;211690;2493;0;0;0;0;.00nan;0;0
17708;94240;835;0;0;0;0;.00nan;0;0
17709;-1;2517;78;26;2;24;.923;3600000;0
17709;216934;845;0;0;0;0;.00nan;0;0
17709;-1;845;62;31;3;28;.903;3600000;0
17709;61292;2517;0;0;0;0;.00nan;0;0
17710;-1;846;0;0;0;0;.00nan;0;0
17710;-1;843;0;0;0;0;.00nan;0;0
17710;78223;843;97;29;0;29;1.000;3600000;0
17710;147962;846;74;39;3;36;.923;3600000;0
17711;175063;2508;36;34;6;28;.824;2537000;0
17711;-1;841;51;19;2;17;.895;3600000;0
17711;180311;841;0;0;0;0;.00nan;0;0
17711;239842;2508;48;9;1;8;.889;1063000;0
17712;206474;2493;0;0;0;0;.00nan;0;0
17712;211690;2493;39;22;4;18;.818;3600000;0
17712;216934;845;70;29;2;27;.931;3600000;0
17712;-1;845;0;0;0;0;.00nan;0;0
17713;-1;2517;68;33;3;30;.909;3600000;0
17713;-1;843;0;0;0;0;.00nan;0;0
17713;61292;2517;0;0;0;0;.00nan;0;0
17713;78223;843;58;33;4;29;.879;3600000;0
17714;-1;841;0;0;0;0;.00nan;0;0
17714;180311;841;82;36;2;34;.944;3555000;0
17714;148069;844;0;0;0;0;.00nan;0;0
17714;152266;844;100;26;0;26;1.000;3600000;0
17715;175063;2508;83;41;2;39;.951;3600000;0
17715;73098;2488;22;19;5;14;.737;3600000;0
17715;239841;2488;0;0;0;0;.00nan;0;0
17715;239842;2508;0;0;0;0;.00nan;0;0
17716;805;835;0;0;0;0;.00nan;0;0
17716;-1;846;67;39;4;35;.897;3600000;0
17716;94240;835;70;23;1;22;.957;3600000;0
17716;147962;846;0;0;0;0;.00nan;0;0
17717;805;835;78;21;1;20;.952;3600000;0
17717;206474;2493;82;39;3;36;.923;3586000;0
17717;211690;2493;0;0;0;0;.00nan;0;0
17717;94240;835;0;0;0;0;.00nan;0;0
17718;-1;2517;86;24;1;23;.958;3600000;0
17718;175063;2508;68;45;5;40;.889;3600000;0
17718;61292;2517;0;0;0;0;.00nan;0;0
17718;239842;2508;0;0;0;0;.00nan;0;0
17719;-1;841;0;0;0;0;.00nan;0;0
17719;180311;841;79;44;3;41;.932;3900000;0
17719;148069;844;78;39;3;36;.923;3900000;0
17719;152266;844;0;0;0;0;.00nan;0;0
17720;216934;845;0;0;0;0;.00nan;0;0
17720;-1;843;0;0;0;0;.00nan;0;0
17720;-1;845;75;28;1;27;.964;3570000;0
17720;78223;843;100;34;0;34;1.000;3600000;0
17721;-1;846;89;29;2;27;.931;3600000;0
17721;73098;2488;34;26;5;21;.808;3600000;0
17721;147962;846;0;0;0;0;.00nan;0;0
17721;239841;2488;0;0;0;0;.00nan;0;0
17722;175063;2508;42;48;9;39;.813;3131000;0
17722;216934;845;0;0;0;0;.00nan;0;0
17722;-1;845;36;11;3;8;.727;3600000;0
17722;239842;2508;66;8;0;8;1.000;469000;0
17723;206474;2493;81;35;2;33;.943;3900000;0
17723;211690;2493;0;0;0;0;.00nan;0;0
17723;-1;846;59;27;2;25;.926;3900000;0
17723;147962;846;0;0;0;0;.00nan;0;0
17724;805;835;51;21;3;18;.857;3900000;0
17724;-1;841;83;39;3;36;.923;3900000;0
17724;180311;841;0;0;0;0;.00nan;0;0
17724;94240;835;0;0;0;0;.00nan;0;0
17725;73098;2488;0;0;0;0;.00nan;0;0
17725;148069;844;0;0;0;0;.00nan;0;0
17725;152266;844;49;30;5;25;.833;3550000;0
17725;239841;2488;59;32;4;28;.875;3600000;0
17726;-1;2517;53;30;4;26;.867;3514000;0
17726;-1;843;0;0;0;0;.00nan;0;0
17726;61292;2517;0;0;0;0;.00nan;0;0
17726;78223;843;76;33;2;31;.939;3600000;0
17727;216934;845;0;0;0;0;.00nan;0;0
17727;-1;845;73;24;1;23;.958;3600000;0
17727;73098;2488;0;0;0;0;.00nan;0;0
17727;239841;2488;56;31;4;27;.871;3600000;0
17728;-1;2517;52;27;3;24;.889;3582000;0
17728;61292;2517;0;0;0;0;.00nan;0;0
17728;148069;844;95;38;1;37;.974;3600000;0
17728;152266;844;0;0;0;0;.00nan;0;0
17729;216934;845;46;33;6;27;.818;3315000;0
17729;-1;846;60;30;3;27;.900;3600000;0
17729;-1;845;58;7;0;7;1.000;285000;0
17729;147962;846;0;0;0;0;.00nan;0;0
17730;805;835;54;28;4;24;.857;3600000;0
17730;-1;843;0;0;0;0;.00nan;0;0
17730;78223;843;65;29;3;26;.897;3600000;0
17730;94240;835;0;0;0;0;.00nan;0;0
17731;175063;2508;45;40;6;34;.850;3600000;0
17731;-1;841;54;16;2;14;.875;3600000;0
17731;180311;841;0;0;0;0;.00nan;0;0
17731;239842;2508;0;0;0;0;.00nan;0;0
17732;206474;2493;63;34;4;30;.882;3634000;0
17732;211690;2493;0;0;0;0;.00nan;0;0
17732;73098;2488;66;34;3;31;.912;3634000;0
17732;239841;2488;0;0;0;0;.00nan;0;0
17733;175063;2508;87;45;2;43;.956;3900000;0
17733;73098;2488;0;0;0;0;.00nan;0;0
17733;239841;2488;59;22;2;20;.909;3900000;0
17733;239842;2508;0;0;0;0;.00nan;0;0
17734;-1;843;0;0;0;0;.00nan;0;0
17734;78223;843;85;33;2;31;.939;3600000;0
17734;148069;844;0;0;0;0;.00nan;0;0
17734;152266;844;70;33;3;30;.909;3575000;0
17735;-1;2517;66;27;3;24;.889;3900000;0
17735;206474;2493;0;0;0;0;.00nan;0;0
17735;211690;2493;62;33;3;30;.909;3900000;0
17735;61292;2517;0;0;0;0;.00nan;0;0
17736;805;835;64;24;2;22;.917;3600000;0
17736;216934;845;0;0;0;0;.00nan;0;0
17736;-1;845;74;43;4;39;.907;3523000;0
17736;94240;835;0;0;0;0;.00nan;0;0
17737;-1;841;67;22;2;20;.909;3600000;0
17737;180311;841;0;0;0;0;.00nan;0;0
17737;-1;846;0;0;0;0;.00nan;0;0
17737;147962;846;75;37;3;34;.919;3600000;0
17738;216934;845;0;0;0;0;.00nan;0;0
17738;-1;845;70;34;3;31;.912;3600000;0
17738;148069;844;53;36;5;31;.861;3531000;0
17738;152266;844;0;0;0;0;.00nan;0;0
17739;175063;2508;54;45;6;39;.867;3600000;0
17739;-1;843;0;0;0;0;.00nan;0;0
17739;78223;843;87;30;1;29;.967;3600000;0
17739;239842;2508;0;0;0;0;.00nan;0;0
17740;206474;2493;0;0;0;0;.00nan;0;0
17740;211690;2493;58;34;4;30;.882;3561000;0
17740;-1;841;0;0;0;0;.00nan;0;0
17740;180311;841;85;35;2;33;.943;3600000;0
17741;805;835;73;30;3;27;.900;3638000;0
17741;73098;2488;68;27;2;25;.926;3638000;0
17741;94240;835;0;0;0;0;.00nan;0;0
17741;239841;2488;0;0;0;0;.00nan;0;0
17742;-1;2517;53;23;3;20;.870;3590000;0
17742;-1;846;77;33;2;31;.939;3600000;0
17742;61292;2517;0;0;0;0;.00nan;0;0
17742;147962;846;0;0;0;0;.00nan;0;0
17743;216934;845;47;33;4;29;.879;3566000;0
17743;-1;845;0;0;0;0;.00nan;0;0
17743;73098;2488;0;0;0;0;.00nan;0;0
17743;239841;2488;54;23;3;20;.870;3600000;0
17744;206474;2493;81;37;3;34;.919;3586000;0
17744;211690;2493;0;0;0;0;.00nan;0;0
17744;-1;843;0;0;0;0;.00nan;0;0
17744;78223;843;90;31;2;29;.935;3600000;0
17745;-1;2517;80;23;1;22;.957;3600000;0
17745;-1;841;72;39;4;35;.897;3600000;0
17745;180311;841;0;0;0;0;.00nan;0;0
17745;61292;2517;0;0;0;0;.00nan;0;0
17746;805;835;0;0;0;0;.00nan;0;0
17746;175063;2508;72;48;5;43;.896;3600000;0
17746;94240;835;77;21;1;20;.952;3600000;0
17746;239842;2508;0;0;0;0;.00nan;0;0
17747;-1;846;0;0;0;0;.00nan;0;0
17747;147962;846;51;38;5;33;.868;3594000;0
17747;148069;844;60;28;3;25;.893;3600000;0
17747;152266;844;0;0;0;0;.00nan;0;0
17748;175063;2508;77;54;5;49;.907;3576000;0
17748;206474;2493;0;0;0;0;.00nan;0;0
17748;211690;2493;64;21;2;19;.905;3600000;0
17748;239842;2508;0;0;0;0;.00nan;0;0
17749;805;835;75;27;2;25;.926;3600000;0
17749;94240;835;0;0;0;0;.00nan;0;0
17749;148069;844;0;0;0;0;.00nan;0;0
17749;152266;844;81;44;3;41;.932;3544000;0
17750;-1;846;0;0;0;0;.00nan;0;0
17750;-1;843;64;28;3;25;.893;3600000;0
17750;78223;843;0;0;0;0;.00nan;0;0
17750;147962;846;55;30;4;26;.867;3574000;0
17751;5565;2488;48;29;4;25;.862;3546000;0
17751;-1;841;93;30;2;28;.933;3600000;0
17751;180311;841;0;0;0;0;.00nan;0;0
17751;73098;2488;0;0;0;0;.00nan;0;0
17752;-1;2517;67;40;5;35;.875;3600000;0
17752;216934;845;0;0;0;0;.00nan;0;0
17752;-1;845;92;33;1;32;.970;3600000;0
17752;61292;2517;0;0;0;0;.00nan;0;0
17753;216934;845;0;0;0;0;.00nan;0;0
17753;-1;841;97;36;1;35;.972;3600000;0
17753;180311;841;0;0;0;0;.00nan;0;0
17753;-1;845;57;35;5;30;.857;3600000;0
17754;5565;2488;60;37;5;32;.865;3600000;0
17754;-1;843;0;0;0;0;.00nan;0;0
17754;73098;2488;0;0;0;0;.00nan;0;0
17754;78223;843;71;19;1;18;.947;3600000;0
17755;805;835;81;22;1;21;.955;3600000;0
17755;-1;2517;54;30;4;26;.867;3600000;0
17755;61292;2517;0;0;0;0;.00nan;0;0
17755;94240;835;0;0;0;0;.00nan;0;0
17756;175063;2508;100;34;0;34;1.000;3600000;0
17756;-1;846;0;0;0;0;.00nan;0;0
17756;147962;846;75;24;1;23;.958;3569000;0
17756;239842;2508;0;0;0;0;.00nan;0;0
17757;175063;2508;32;41;7;34;.829;3048000;0
17757;216934;845;0;0;0;0;.00nan;0;0
17757;-1;845;74;25;1;24;.960;3600000;0
17757;239842;2508;39;1;1;0;.000;552000;0
17758;206474;2493;0;0;0;0;.00nan;0;0
17758;211690;2493;63;36;4;32;.889;3600000;0
17758;148069;844;0;0;0;0;.00nan;0;0
17758;152266;844;68;24;2;22;.917;3600000;0
17759;175063;2508;61;28;3;25;.893;3900000;0
17759;148069;844;0;0;0;0;.00nan;0;0
17759;152266;844;65;22;3;19;.864;3900000;0
17759;239842;2508;0;0;0;0;.00nan;0;0
17760;206474;2493;44;23;4;19;.826;3900000;0
17760;211690;2493;0;0;0;0;.00nan;0;0
17760;216934;845;0;0;0;0;.00nan;0;0
17760;-1;845;86;53;4;49;.925;3900000;0
17761;-1;841;63;34;4;30;.882;3600000;0
17761;180311;841;0;0;0;0;.00nan;0;0
17761;-1;843;0;0;0;0;.00nan;0;0
17761;78223;843;56;23;3;20;.870;3600000;0
17762;5565;2488;52;25;4;21;.840;3572000;0
17762;-1;2517;74;34;3;31;.912;3600000;0
17762;61292;2517;0;0;0;0;.00nan;0;0
17762;73098;2488;0;0;0;0;.00nan;0;0
17763;805;835;96;34;1;33;.971;3600000;0
17763;-1;846;0;0;0;0;.00nan;0;0
17763;94240;835;0;0;0;0;.00nan;0;0
17763;147962;846;79;35;2;33;.943;3575000;0
17764;216934;845;100;28;0;28;1.000;3600000;0
17764;-1;843;0;0;0;0;.00nan;0;0
17764;-1;845;0;0;0;0;.00nan;0;0
17764;78223;843;56;24;3;21;.875;3600000;0
17765;805;835;65;24;3;21;.875;3600000;0
17765;206474;2493;0;0;0;0;.00nan;0;0
17765;211690;2493;85;40;2;38;.950;3600000;0
17765;94240;835;0;0;0;0;.00nan;0;0
17766;-1;841;59;26;3;23;.885;3900000;0
17766;180311;841;0;0;0;0;.00nan;0;0
17766;148069;844;0;0;0;0;.00nan;0;0
17766;152266;844;85;42;3;39;.929;3900000;0
17767;5565;2488;99;36;1;35;.972;3600000;0
17767;-1;846;0;0;0;0;.00nan;0;0
17767;73098;2488;0;0;0;0;.00nan;0;0
17767;147962;846;68;40;4;36;.900;3600000;0
17768;-1;2517;69;26;2;24;.923;3900000;0
17768;175063;2508;76;28;2;26;.929;3900000;0
17768;61292;2517;0;0;0;0;.00nan;0;0
17768;239842;2508;0;0;0;0;.00nan;0;0
17769;-1;2517;100;24;0;24;1.000;3600000;0
17769;-1;846;97;37;1;36;.973;3600000;0
17769;61292;2517;0;0;0;0;.00nan;0;0
17769;147962;846;0;0;0;0;.00nan;0;0
17770;5565;2488;100;27;0;27;1.000;3600000;0
17770;73098;2488;0;0;0;0;.00nan;0;0
17770;148069;844;0;0;0;0;.00nan;0;0
17770;152266;844;77;26;2;24;.923;3591000;0
17771;-1;2517;52;43;6;37;.860;3600000;0
17771;-1;843;0;0;0;0;.00nan;0;0
17771;61292;2517;0;0;0;0;.00nan;0;0
17771;78223;843;44;13;2;11;.846;3600000;0
17772;805;835;64;24;2;22;.917;3600000;0
17772;-1;841;91;30;1;29;.967;3600000;0
17772;180311;841;0;0;0;0;.00nan;0;0
17772;94240;835;0;0;0;0;.00nan;0;0
17773;206474;2493;80;36;3;33;.917;3588000;0
17773;211690;2493;0;0;0;0;.00nan;0;0
17773;-1;846;0;0;0;0;.00nan;0;0
17773;147962;846;60;19;2;17;.895;3600000;0
17774;175063;2508;97;43;2;41;.953;3600000;0
17774;216934;845;44;19;3;16;.842;3580000;0
17774;-1;845;0;0;0;0;.00nan;0;0
17774;239842;2508;0;0;0;0;.00nan;0;0
17775;206474;2493;0;0;0;0;.00nan;0;0
17775;211690;2493;53;25;3;22;.880;3555000;0
17775;148069;844;0;0;0;0;.00nan;0;0
17775;152266;844;74;32;2;30;.938;3600000;0
17776;216934;845;0;0;0;0;.00nan;0;0
17776;-1;841;49;25;4;21;.840;3600000;0
17776;180311;841;0;0;0;0;.00nan;0;0
17776;-1;845;46;32;5;27;.844;3553000;0
17777;5565;2488;31;8;3;5;.625;587000;0
17777;-1;843;0;0;0;0;.00nan;0;0
17777;73098;2488;60;31;3;28;.903;2959000;0
17777;78223;843;59;39;4;35;.897;3600000;0
17778;805;835;56;30;3;27;.900;3563000;0
17778;-1;2517;0;0;0;0;.00nan;0;0
17778;61292;2517;73;21;1;20;.952;3600000;0
17778;94240;835;0;0;0;0;.00nan;0;0
17779;206474;2493;0;0;0;0;.00nan;0;0
17779;211690;2493;37;23;4;19;.826;3600000;0
17779;216934;845;61;29;3;26;.897;3600000;0
17779;-1;845;0;0;0;0;.00nan;0;0
17780;175063;2508;55;30;5;25;.833;2197000;0
17780;148069;844;0;0;0;0;.00nan;0;0
17780;152266;844;61;24;2;22;.917;3600000;0
17780;239842;2508;42;17;3;14;.824;1403000;0
17781;-1;841;0;0;0;0;.00nan;0;0
17781;180311;841;58;30;4;26;.867;3587000;0
17781;-1;843;0;0;0;0;.00nan;0;0
17781;78223;843;61;26;3;23;.885;3600000;0
17782;5565;2488;42;25;4;21;.840;3600000;0
17782;-1;2517;76;38;3;35;.921;3600000;0
17782;61292;2517;0;0;0;0;.00nan;0;0
17782;73098;2488;0;0;0;0;.00nan;0;0
17783;805;835;63;14;1;13;.929;3600000;0
17783;-1;846;54;35;5;30;.857;3600000;0
17783;-1;846;0;0;0;0;.00nan;0;0
17783;94240;835;0;0;0;0;.00nan;0;0
17784;175063;2508;100;36;1;35;.972;3600000;0
17784;-1;841;23;4;3;1;.250;516000;0
17784;180311;841;56;35;5;30;.857;3084000;0
17784;239842;2508;0;0;0;0;.00nan;0;0
17785;-1;2517;57;28;4;24;.857;3768000;0
17785;61292;2517;0;0;0;0;.00nan;0;0
17785;148069;844;0;0;0;0;.00nan;0;0
17785;152266;844;80;34;3;31;.912;3768000;0
17786;5565;2488;62;46;5;41;.891;3558000;0
17786;206474;2493;69;38;4;34;.895;3600000;0
17786;211690;2493;0;0;0;0;.00nan;0;0
17786;73098;2488;0;0;0;0;.00nan;0;0
17787;805;835;65;20;2;18;.900;3600000;0
17787;-1;843;0;0;0;0;.00nan;0;0
17787;78223;843;63;47;5;42;.894;3600000;0
17787;94240;835;0;0;0;0;.00nan;0;0
17788;216934;845;0;0;0;0;.00nan;0;0
17788;-1;846;63;17;2;15;.882;3600000;0
17788;-1;846;0;0;0;0;.00nan;0;0
17788;-1;845;81;36;3;33;.917;3600000;0
17789;805;835;34;23;5;18;.783;3600000;0
17789;216934;845;56;11;1;10;.909;1054000;0
17789;-1;845;41;33;6;27;.818;2540000;0
17789;94240;835;0;0;0;0;.00nan;0;0
17790;-1;843;0;0;0;0;.00nan;0;0
17790;78223;843;69;28;2;26;.929;3600000;0
17790;148069;844;0;0;0;0;.00nan;0;0
17790;152266;844;79;35;3;32;.914;3600000;0
17791;-1;841;0;0;0;0;.00nan;0;0
17791;180311;841;64;31;3;28;.903;3600000;0
17791;-1;846;63;33;4;29;.879;3600000;0
17791;-1;846;0;0;0;0;.00nan;0;0
17792;5565;2488;56;23;3;20;.870;3600000;0
17792;175063;2508;81;46;4;42;.913;3571000;0
17792;73098;2488;0;0;0;0;.00nan;0;0
17792;239842;2508;0;0;0;0;.00nan;0;0
17793;-1;2517;76;45;4;41;.911;3565000;0
17793;206474;2493;62;31;3;28;.903;3600000;0
17793;211690;2493;0;0;0;0;.00nan;0;0
17793;61292;2517;0;0;0;0;.00nan;0;0
17794;175063;2508;57;43;5;38;.884;3600000;0
17794;-1;843;0;0;0;0;.00nan;0;0
17794;78223;843;72;23;2;21;.913;3600000;0
17794;239842;2508;0;0;0;0;.00nan;0;0
17795;216934;845;48;37;6;31;.838;3600000;0
17795;-1;845;0;0;0;0;.00nan;0;0
17795;148069;844;81;31;2;29;.935;3600000;0
17795;152266;844;0;0;0;0;.00nan;0;0
17796;206474;2493;0;0;0;0;.00nan;0;0
17796;211690;2493;77;35;2;33;.943;3900000;0
17796;-1;841;88;38;2;36;.947;3900000;0
17796;180311;841;0;0;0;0;.00nan;0;0
17797;805;835;63;21;2;19;.905;3600000;0
17797;5565;2488;72;33;3;30;.909;3588000;0
17797;73098;2488;0;0;0;0;.00nan;0;0
17797;94240;835;0;0;0;0;.00nan;0;0
17798;-1;2517;86;31;1;30;.968;3600000;0
17798;-1;846;48;24;3;21;.875;3547000;0
17798;-1;846;0;0;0;0;.00nan;0;0
17798;61292;2517;0;0;0;0;.00nan;0;0
17799;805;835;46;24;4;20;.833;3600000;0
17799;175063;2508;76;46;5;41;.891;3595000;0
17799;94240;835;0;0;0;0;.00nan;0;0
17799;239842;2508;0;0;0;0;.00nan;0;0
17800;-1;846;71;29;2;27;.931;3600000;0
17800;-1;846;0;0;0;0;.00nan;0;0
17800;148069;844;0;0;0;0;.00nan;0;0
17800;152266;844;43;34;5;29;.853;3600000;0
17801;206474;2493;0;0;0;0;.00nan;0;0
17801;211690;2493;67;42;5;37;.881;3600000;0
17801;-1;843;0;0;0;0;.00nan;0;0
17801;78223;843;69;25;2;23;.920;3600000;0
17802;5565;2488;79;25;1;24;.960;3600000;0
17802;216934;845;80;35;2;33;.943;3543000;0
17802;-1;845;0;0;0;0;.00nan;0;0
17802;73098;2488;0;0;0;0;.00nan;0;0
17803;-1;2517;71;36;3;33;.917;3600000;0
17803;-1;841;0;0;0;0;.00nan;0;0
17803;180311;841;57;35;4;31;.886;3600000;0
17803;61292;2517;0;0;0;0;.00nan;0;0
17804;-1;2517;45;30;4;26;.867;3586000;0
17804;216934;845;55;29;3;26;.897;3600000;0
17804;-1;845;0;0;0;0;.00nan;0;0
17804;61292;2517;0;0;0;0;.00nan;0;0
17805;175063;2508;92;56;4;52;.929;3600000;0
17805;206474;2493;53;17;2;15;.882;3600000;0
17805;211690;2493;0;0;0;0;.00nan;0;0
17805;239842;2508;0;0;0;0;.00nan;0;0
17806;5565;2488;50;50;7;43;.860;3600000;0
17806;-1;841;68;29;3;26;.897;3600000;0
17806;180311;841;0;0;0;0;.00nan;0;0
17806;73098;2488;0;0;0;0;.00nan;0;0
17807;805;835;0;0;0;0;.00nan;0;0
17807;94240;835;89;24;1;23;.958;3900000;0
17807;148069;844;79;28;1;27;.964;3900000;0
17807;152266;844;0;0;0;0;.00nan;0;0
17808;-1;846;56;35;5;30;.857;3600000;0
17808;-1;846;0;0;0;0;.00nan;0;0
17808;-1;843;0;0;0;0;.00nan;0;0
17808;78223;843;54;30;4;26;.867;3600000;0
17810;805;835;73;26;2;24;.923;3600000;0
17810;47791;843;0;0;0;0;.00nan;0;0
17810;78223;843;63;34;3;31;.912;3600000;0
17810;94240;835;0;0;0;0;.00nan;0;0
17812;216934;845;0;0;0;0;.00nan;0;0
17812;-1;845;78;31;3;28;.903;3579000;0
17812;148069;844;0;0;0;0;.00nan;0;0
17812;152266;844;73;25;1;24;.960;3600000;0
17814;175063;2508;76;57;6;51;.895;2892000;0
17814;-1;841;0;0;0;0;.00nan;0;0
17814;180311;841;47;16;3;13;.813;3600000;0
17814;239842;2508;56;16;1;15;.938;708000;0
17816;206474;2493;0;0;0;0;.00nan;0;0
17816;211690;2493;90;46;2;44;.957;3900000;0
17816;73098;2488;53;11;2;9;.818;3900000;0
17816;239841;2488;0;0;0;0;.00nan;0;0
17818;-1;2517;62;17;2;15;.882;3600000;0
17818;-1;846;70;46;5;41;.891;3600000;0
17818;61292;2517;0;0;0;0;.00nan;0;0
17818;147962;846;0;0;0;0;.00nan;0;0
17820;206474;2493;76;32;2;30;.938;3900000;0
17820;211690;2493;0;0;0;0;.00nan;0;0
17820;-1;841;90;35;2;33;.943;3900000;0
17820;180311;841;0;0;0;0;.00nan;0;0
17822;-1;846;0;0;0;0;.00nan;0;0
17822;73098;2488;0;0;0;0;.00nan;0;0
17822;147962;846;72;27;2;25;.926;3600000;0
17822;239841;2488;33;26;5;21;.808;3600000;0
17824;-1;2517;0;0;0;0;.00nan;0;0
17824;175063;2508;0;0;0;0;.00nan;0;0
17824;61292;2517;56;14;2;12;.857;3600000;0
17824;239842;2508;60;51;6;45;.882;3600000;0
17826;47791;843;99;51;2;49;.961;3900000;0
17826;78223;843;0;0;0;0;.00nan;0;0
17826;148069;844;53;18;2;16;.889;3900000;0
17826;152266;844;0;0;0;0;.00nan;0;0
17828;805;835;0;0;0;0;.00nan;0;0
17828;216934;845;100;45;1;44;.978;3900000;0
17828;-1;845;0;0;0;0;.00nan;0;0
17828;94240;835;76;26;1;25;.962;3900000;0
17830;175063;2508;73;46;4;42;.913;3585000;0
17830;216934;845;0;0;0;0;.00nan;0;0
17830;-1;845;63;23;2;21;.913;3600000;0
17830;239842;2508;0;0;0;0;.00nan;0;0
17832;-1;2517;55;25;3;22;.880;3600000;0
17832;-1;841;0;0;0;0;.00nan;0;0
17832;180311;841;48;28;4;24;.857;3545000;0
17832;61292;2517;0;0;0;0;.00nan;0;0
17834;206474;2493;0;0;0;0;.00nan;0;0
17834;211690;2493;77;42;5;37;.881;3546000;0
17834;73098;2488;47;24;4;20;.833;3600000;0
17834;239841;2488;0;0;0;0;.00nan;0;0
17836;805;835;66;22;2;20;.909;3600000;0
17836;94240;835;0;0;0;0;.00nan;0;0
17836;148069;844;0;0;0;0;.00nan;0;0
17836;152266;844;71;38;4;34;.895;3556000;0
17838;-1;846;76;44;4;40;.909;3600000;0
17838;47791;843;0;0;0;0;.00nan;0;0
17838;78223;843;55;40;5;35;.875;3561000;0
17838;147962;846;0;0;0;0;.00nan;0;0
17840;805;835;0;0;0;0;.00nan;0;0
17840;-1;846;0;0;0;0;.00nan;0;0
17840;94240;835;57;20;2;18;.900;3600000;0
17840;147962;846;27;32;7;25;.781;3600000;0
17842;-1;2517;0;0;0;0;.00nan;0;0
17842;61292;2517;88;37;2;35;.946;3600000;0
17842;73098;2488;0;0;0;0;.00nan;0;0
17842;239841;2488;73;39;3;36;.923;3600000;0
17844;-1;841;77;38;4;34;.895;3600000;0
17844;180311;841;0;0;0;0;.00nan;0;0
17844;47791;843;89;30;1;29;.967;3600000;0
17844;78223;843;0;0;0;0;.00nan;0;0
17846;175063;2508;21;3;3;0;.000;518000;0
17846;148069;844;64;18;1;17;.944;3600000;0
17846;152266;844;0;0;0;0;.00nan;0;0
17846;239842;2508;71;45;4;41;.911;3082000;0
17848;206474;2493;76;30;2;28;.933;3600000;0
17848;211690;2493;0;0;0;0;.00nan;0;0
17848;216934;845;45;26;4;22;.846;3553000;0
17848;-1;845;0;0;0;0;.00nan;0;0
17850;216934;845;0;0;0;0;.00nan;0;0
17850;47791;843;0;0;0;0;.00nan;0;0
17850;-1;845;71;22;1;21;.955;3600000;0
17850;78223;843;65;33;3;30;.909;3516000;0
17852;-1;2517;71;27;1;26;.963;3547000;0
17852;61292;2517;0;0;0;0;.00nan;0;0
17852;148069;844;0;0;0;0;.00nan;0;0
17852;152266;844;100;27;0;27;1.000;3600000;0
17854;805;835;69;21;2;19;.905;3600000;0
17854;175063;2508;76;44;4;40;.909;3567000;0
17854;94240;835;0;0;0;0;.00nan;0;0
17854;239842;2508;0;0;0;0;.00nan;0;0
17856;-1;846;44;23;4;19;.826;3600000;0
17856;73098;2488;87;18;0;18;1.000;3600000;0
17856;147962;846;0;0;0;0;.00nan;0;0
17856;239841;2488;0;0;0;0;.00nan;0;0
17858;206474;2493;0;0;0;0;.00nan;0;0
17858;211690;2493;85;29;1;28;.966;3600000;0
17858;-1;841;0;0;0;0;.00nan;0;0
17858;180311;841;70;33;3;30;.909;3541000;0
17860;-1;846;0;0;0;0;.00nan;0;0
17860;73098;2488;46;26;5;21;.808;3600000;0
17860;147962;846;99;38;1;37;.974;3600000;0
17860;239841;2488;0;0;0;0;.00nan;0;0
17862;-1;2517;0;0;0;0;.00nan;0;0
17862;-1;841;47;26;4;22;.846;3600000;0
17862;180311;841;0;0;0;0;.00nan;0;0
17862;61292;2517;100;31;0;31;1.000;3600000;0
17864;805;835;0;0;0;0;.00nan;0;0
17864;216934;845;49;23;3;20;.870;3558000;0
17864;-1;845;0;0;0;0;.00nan;0;0
17864;94240;835;69;28;2;26;.929;3600000;0
17866;175063;2508;68;35;3;32;.914;3600000;0
17866;206474;2493;23;21;5;16;.762;3515000;0
17866;211690;2493;0;0;0;0;.00nan;0;0
17866;239842;2508;0;0;0;0;.00nan;0;0
17868;47791;843;97;38;1;37;.974;3900000;0
17868;78223;843;0;0;0;0;.00nan;0;0
17868;148069;844;0;0;0;0;.00nan;0;0
17868;152266;844;100;38;1;37;.974;3900000;0
17870;-1;2517;0;0;0;0;.00nan;0;0
17870;216934;845;0;0;0;0;.00nan;0;0
17870;-1;845;73;26;1;25;.962;3600000;0
17870;61292;2517;34;28;6;22;.786;3600000;0
17872;206474;2493;0;0;0;0;.00nan;0;0
17872;211690;2493;58;31;3;28;.903;3586000;0
17872;148069;844;54;21;2;19;.905;3600000;0
17872;152266;844;0;0;0;0;.00nan;0;0
17874;175063;2508;89;29;1;28;.966;3600000;0
17874;-1;846;45;15;2;13;.867;3555000;0
17874;147962;846;0;0;0;0;.00nan;0;0
17874;239842;2508;0;0;0;0;.00nan;0;0
17876;805;835;73;26;2;24;.923;3600000;0
17876;73098;2488;62;11;0;11;1.000;678000;0
17876;94240;835;0;0;0;0;.00nan;0;0
17876;239841;2488;38;34;6;28;.824;2922000;0
17878;-1;841;95;21;0;21;1.000;3600000;0
17878;180311;841;0;0;0;0;.00nan;0;0
17878;47791;843;0;0;0;0;.00nan;0;0
17878;78223;843;48;27;5;22;.815;3600000;0
580;805;835;48;23;4;19;.826;3529000;0
580;5565;2488;73;28;2;26;.929;3600000;0
580;73098;2488;0;0;0;0;.00nan;0;0
580;94240;835;0;0;0;0;.00nan;0;0
581;-1;843;0;0;0;0;.00nan;0;0
581;78223;843;78;23;1;22;.957;3600000;0
581;148069;844;0;0;0;0;.00nan;0;0
581;152266;844;93;44;2;42;.955;3571000;0
582;216934;845;0;0;0;0;.00nan;0;0
582;-1;841;0;0;0;0;.00nan;0;0
582;180311;841;51;27;4;23;.852;3545000;0
582;-1;845;59;25;3;22;.880;3600000;0
583;-1;2517;69;29;3;26;.897;3600000;0
583;206474;2493;50;2;0;2;1.000;351000;0
583;211690;2493;45;40;6;34;.850;3249000;0
583;61292;2517;0;0;0;0;.00nan;0;0
584;805;835;81;22;1;21;.955;3600000;0
584;5565;2488;60;28;3;25;.893;3513000;0
584;73098;2488;0;0;0;0;.00nan;0;0
584;94240;835;0;0;0;0;.00nan;0;0
585;-1;843;0;0;0;0;.00nan;0;0
585;78223;843;38;26;5;21;.808;3600000;0
585;148069;844;0;0;0;0;.00nan;0;0
585;152266;844;74;28;2;26;.929;3600000;0
586;216934;845;0;0;0;0;.00nan;0;0
586;-1;841;0;0;0;0;.00nan;0;0
586;180311;841;79;30;3;27;.900;3600000;0
586;-1;845;63;39;4;35;.897;3571000;0
587;-1;2517;57;41;5;36;.878;3600000;0
587;206474;2493;0;0;0;0;.00nan;0;0
587;211690;2493;76;10;0;10;1.000;3600000;0
587;61292;2517;0;0;0;0;.00nan;0;0
588;805;835;71;22;3;19;.864;3600000;0
588;5565;2488;31;29;7;22;.759;3600000;0
588;73098;2488;0;0;0;0;.00nan;0;0
588;94240;835;0;0;0;0;.00nan;0;0
589;-1;843;0;0;0;0;.00nan;0;0
589;78223;843;90;36;1;35;.972;3600000;0
589;148069;844;0;0;0;0;.00nan;0;0
589;152266;844;41;23;4;19;.826;3600000;0
590;216934;845;0;0;0;0;.00nan;0;0
590;-1;841;35;26;5;21;.808;2447000;0
590;180311;841;32;15;4;11;.733;1153000;0
590;-1;845;61;33;4;29;.879;3600000;0
591;-1;2517;65;22;2;20;.909;3969000;0
591;206474;2493;0;0;0;0;.00nan;0;0
591;211690;2493;91;43;3;40;.930;3969000;0
591;61292;2517;0;0;0;0;.00nan;0;0
592;805;835;46;26;4;22;.846;3556000;0
592;5565;2488;67;35;3;32;.914;3600000;0
592;73098;2488;0;0;0;0;.00nan;0;0
592;94240;835;0;0;0;0;.00nan;0;0
593;-1;843;0;0;0;0;.00nan;0;0
593;78223;843;51;26;3;23;.885;3568000;0
593;148069;844;0;0;0;0;.00nan;0;0
593;152266;844;57;12;1;11;.917;3600000;0
594;216934;845;0;0;0;0;.00nan;0;0
594;-1;841;0;0;0;0;.00nan;0;0
594;180311;841;100;22;0;22;1.000;3600000;0
594;-1;845;89;39;1;38;.974;3594000;0
595;-1;2517;47;34;5;29;.853;3514000;0
595;206474;2493;0;0;0;0;.00nan;0;0
595;211690;2493;45;22;3;19;.864;3600000;0
595;61292;2517;0;0;0;0;.00nan;0;0
701;805;835;87;31;1;30;.968;3600000;0
701;5565;2488;52;33;5;28;.848;3600000;0
701;73098;2488;0;0;0;0;.00nan;0;0
701;94240;835;0;0;0;0;.00nan;0;0
702;-1;843;0;0;0;0;.00nan;0;0
702;78223;843;80;31;2;29;.935;3600000;0
702;148069;844;0;0;0;0;.00nan;0;0
702;152266;844;39;27;5;22;.815;3600000;0
703;216934;845;0;0;0;0;.00nan;0;0
703;-1;841;0;0;0;0;.00nan;0;0
703;180311;841;82;33;2;31;.939;3600000;0
703;-1;845;77;27;1;26;.963;3600000;0
704;-1;2517;88;30;1;29;.967;3600000;0
704;206474;2493;0;0;0;0;.00nan;0;0
704;211690;2493;56;23;2;21;.913;3547000;0
704;61292;2517;0;0;0;0;.00nan;0;0
729;805;835;63;32;4;28;.875;3562000;0
729;5565;2488;86;38;3;35;.921;3600000;0
729;73098;2488;0;0;0;0;.00nan;0;0
729;94240;835;0;0;0;0;.00nan;0;0
730;-1;843;0;0;0;0;.00nan;0;0
730;78223;843;86;34;2;32;.941;4141000;0
730;148069;844;0;0;0;0;.00nan;0;0
730;152266;844;84;48;3;45;.938;4170000;0
731;216934;845;0;0;0;0;.00nan;0;0
731;-1;841;0;0;0;0;.00nan;0;0
731;180311;841;74;44;5;39;.886;3532000;0
731;-1;845;43;26;4;22;.846;3600000;0
732;-1;2517;99;40;1;39;.975;3600000;0
732;206474;2493;0;0;0;0;.00nan;0;0
732;211690;2493;33;15;3;12;.800;3567000;0
732;61292;2517;0;0;0;0;.00nan;0;0
741;805;835;54;29;4;25;.862;3600000;0
741;5565;2488;5;23;7;16;.696;3031000;0
741;73098;2488;50;1;0;1;1.000;569000;0
741;94240;835;0;0;0;0;.00nan;0;0
744;805;835;59;19;2;17;.895;3517000;0
744;216934;845;0;0;0;0;.00nan;0;0
744;-1;845;92;20;0;20;1.000;3600000;0
744;94240;835;0;0;0;0;.00nan;0;0
745;-1;2517;46;24;4;20;.833;3556000;0
745;-1;843;0;0;0;0;.00nan;0;0
745;61292;2517;0;0;0;0;.00nan;0;0
745;78223;843;89;34;2;32;.941;3600000;0
746;805;835;67;33;4;29;.879;3600000;0
746;216934;845;0;0;0;0;.00nan;0;0
746;-1;845;74;21;1;20;.952;3600000;0
746;94240;835;0;0;0;0;.00nan;0;0
747;-1;2517;58;48;5;43;.896;4690000;0
747;-1;843;0;0;0;0;.00nan;0;0
747;61292;2517;0;0;0;0;.00nan;0;0
747;78223;843;46;22;4;18;.818;4690000;0
748;805;835;100;29;0;29;1.000;3600000;0
748;216934;845;0;0;0;0;.00nan;0;0
748;-1;845;77;31;3;28;.903;3600000;0
748;94240;835;0;0;0;0;.00nan;0;0
749;-1;2517;100;39;0;39;1.000;3600000;0
749;-1;843;0;0;0;0;.00nan;0;0
749;61292;2517;0;0;0;0;.00nan;0;0
749;78223;843;68;32;4;28;.875;3600000;0
750;805;835;66;33;3;30;.909;4237000;0
750;216934;845;0;0;0;0;.00nan;0;0
750;-1;845;79;28;2;26;.929;4237000;0
750;94240;835;0;0;0;0;.00nan;0;0
751;-1;2517;86;33;2;31;.939;3600000;0
751;-1;843;0;0;0;0;.00nan;0;0
751;61292;2517;0;0;0;0;.00nan;0;0
751;78223;843;47;27;4;23;.852;3522000;0
830;805;835;64;25;2;23;.920;3600000;0
830;216934;845;0;0;0;0;.00nan;0;0
830;-1;845;40;30;5;25;.833;3600000;0
830;94240;835;0;0;0;0;.00nan;0;0
831;-1;2517;56;27;3;24;.889;3576000;0
831;-1;843;0;0;0;0;.00nan;0;0
831;61292;2517;0;0;0;0;.00nan;0;0
831;78223;843;87;34;2;32;.941;3600000;0
852;805;835;76;29;2;27;.931;3556000;0
852;216934;845;0;0;0;0;.00nan;0;0
852;-1;845;78;11;0;11;1.000;3600000;0
852;94240;835;0;0;0;0;.00nan;0;0
853;-1;2517;36;17;4;13;.765;1117000;0
853;-1;843;0;0;0;0;.00nan;0;0
853;61292;2517;19;18;5;13;.722;2483000;0
853;78223;843;68;29;2;27;.931;3600000;0
919;216934;845;0;0;0;0;.00nan;0;0
919;-1;843;0;0;0;0;.00nan;0;0
919;-1;845;56;24;3;21;.875;3600000;0
919;78223;843;74;42;4;38;.905;3544000;0
920;216934;845;88;29;1;28;.966;3053000;0
920;-1;843;0;0;0;0;.00nan;0;0
920;-1;845;22;5;3;2;.400;465000;0
920;78223;843;79;37;2;35;.946;3600000;0
921;216934;845;0;0;0;0;.00nan;0;0
921;-1;843;0;0;0;0;.00nan;0;0
921;-1;845;61;32;3;29;.906;3948000;0
921;78223;843;81;32;2;30;.938;3948000;0
922;216934;845;0;0;0;0;.00nan;0;0
922;-1;843;0;0;0;0;.00nan;0;0
922;-1;845;43;25;4;21;.840;3600000;0
922;78223;843;70;30;3;27;.900;3600000;0
1085;216934;845;0;0;0;0;.00nan;0;0
1085;-1;843;0;0;0;0;.00nan;0;0
1085;-1;845;75;42;3;39;.929;4178000;0
1085;78223;843;99;40;2;38;.950;4178000;0
17879;167036;1475;0;0;0;0;.00nan;0;0
17879;7332;1869;0;0;0;0;.00nan;0;0
17879;191698;1869;76;45;5;40;.889;3600000;0
17879;73973;1475;67;22;2;20;.909;3600000;0
17880;8035;522;68;42;4;38;.905;3600000;0
17880;8426;2193;0;0;0;0;.00nan;0;0
17880;68627;2193;54;14;2;12;.857;3600000;0
17880;155474;522;0;0;0;0;.00nan;0;0
17881;206007;1481;21;25;6;19;.760;3600000;0
17881;221690;1481;0;0;0;0;.00nan;0;0
17881;143063;1877;0;0;0;0;.00nan;0;0
17881;143479;1877;100;38;1;37;.974;3600000;0
17882;9455;1477;70;28;2;26;.929;3546000;0
17882;185059;2173;91;36;1;35;.972;3600000;0
17882;64271;2173;0;0;0;0;.00nan;0;0
17882;84287;1477;0;0;0;0;.00nan;0;0
17883;177504;3922;90;53;3;50;.943;3657000;0
17883;174589;523;38;18;4;14;.778;3657000;0
17883;179830;523;0;0;0;0;.00nan;0;0
17883;143507;3922;0;0;0;0;.00nan;0;0
17884;174581;524;65;24;2;22;.917;3546000;0
17884;80859;524;0;0;0;0;.00nan;0;0
17884;89998;1854;0;0;0;0;.00nan;0;0
17884;152464;1854;71;20;1;19;.950;3600000;0
17885;83983;4560;0;0;0;0;.00nan;0;0
17885;151590;1871;56;10;1;9;.900;3600000;0
17885;152480;1871;0;0;0;0;.00nan;0;0
17885;159851;4560;98;47;3;44;.936;3578000;0
17886;168651;1871;80;30;2;28;.933;3600000;0
17886;169226;1475;77;42;4;38;.905;3515000;0
17886;73973;1475;0;0;0;0;.00nan;0;0
17886;151590;1871;0;0;0;0;.00nan;0;0
17887;206007;1481;73;20;1;19;.950;3600000;0
17887;221690;1481;0;0;0;0;.00nan;0;0
17887;185059;2173;80;38;2;36;.947;3600000;0
17887;64271;2173;0;0;0;0;.00nan;0;0
17888;174589;523;76;20;1;19;.950;3600000;0
17888;179830;523;0;0;0;0;.00nan;0;0
17888;143063;1877;0;0;0;0;.00nan;0;0
17888;143479;1877;58;35;4;31;.886;3600000;0
17889;8035;522;100;24;0;24;1.000;3600000;0
17889;174581;524;0;0;0;0;.00nan;0;0
17889;86686;524;44;29;4;25;.862;3600000;0
17889;155474;522;0;0;0;0;.00nan;0;0
17890;8426;2193;63;15;1;14;.933;3600000;0
17890;68627;2193;0;0;0;0;.00nan;0;0
17890;83983;4560;65;46;5;41;.891;3600000;0
17890;159851;4560;0;0;0;0;.00nan;0;0
17891;179151;1869;0;0;0;0;.00nan;0;0
17891;191698;1869;65;29;3;26;.897;3557000;0
17891;89998;1854;73;28;2;26;.929;3600000;0
17891;152464;1854;0;0;0;0;.00nan;0;0
17892;177504;3922;70;44;5;39;.886;3600000;0
17892;9455;1477;30;26;6;20;.769;3542000;0
17892;84287;1477;0;0;0;0;.00nan;0;0
17892;143507;3922;0;0;0;0;.00nan;0;0
17893;169226;1475;83;16;0;16;1.000;3600000;0
17893;73973;1475;0;0;0;0;.00nan;0;0
17893;143063;1877;0;0;0;0;.00nan;0;0
17893;143479;1877;58;39;5;34;.872;3600000;0
17894;8035;522;72;50;6;44;.880;3600000;0
17894;168651;1871;58;11;1;10;.909;3600000;0
17894;151590;1871;0;0;0;0;.00nan;0;0
17894;155474;522;0;0;0;0;.00nan;0;0
17895;206007;1481;67;25;2;23;.920;3600000;0
17895;179151;1869;32;17;4;13;.765;3526000;0
17895;221690;1481;0;0;0;0;.00nan;0;0
17895;191698;1869;0;0;0;0;.00nan;0;0
17896;8426;2193;56;27;3;24;.889;3600000;0
17896;9455;1477;47;38;6;32;.842;3600000;0
17896;68627;2193;0;0;0;0;.00nan;0;0
17896;84287;1477;0;0;0;0;.00nan;0;0
17897;174581;524;0;0;0;0;.00nan;0;0
17897;174589;523;43;9;2;7;.778;3600000;0
17897;179830;523;0;0;0;0;.00nan;0;0
17897;86686;524;98;49;3;46;.939;3558000;0
17898;177504;3922;0;0;0;0;.00nan;0;0
17898;185059;2173;0;0;0;0;.00nan;0;0
17898;64271;2173;92;41;2;39;.951;3900000;0
17898;143507;3922;51;17;2;15;.882;3900000;0
17899;83983;4560;78;41;4;37;.902;3564000;0
17899;89998;1854;50;13;2;11;.846;3600000;0
17899;152464;1854;0;0;0;0;.00nan;0;0
17899;159851;4560;0;0;0;0;.00nan;0;0
17900;177504;3922;96;38;1;37;.974;3900000;0
17900;168651;1871;80;24;1;23;.958;3900000;0
17900;143507;3922;0;0;0;0;.00nan;0;0
17900;151590;1871;0;0;0;0;.00nan;0;0
17901;174589;523;78;22;1;21;.955;3600000;0
17901;185059;2173;68;36;3;33;.917;3562000;0
17901;179830;523;0;0;0;0;.00nan;0;0
17901;64271;2173;0;0;0;0;.00nan;0;0
17902;8035;522;55;38;5;33;.868;3600000;0
17902;143063;1877;0;0;0;0;.00nan;0;0
17902;143479;1877;75;19;1;18;.947;3600000;0
17902;155474;522;0;0;0;0;.00nan;0;0
17903;9455;1477;77;27;2;25;.926;3600000;0
17903;174581;524;0;0;0;0;.00nan;0;0
17903;84287;1477;0;0;0;0;.00nan;0;0
17903;86686;524;59;36;4;32;.889;3571000;0
17904;8426;2193;38;34;6;28;.824;2606000;0
17904;206007;1481;85;30;1;29;.967;3600000;0
17904;221690;1481;0;0;0;0;.00nan;0;0
17904;68627;2193;72;11;0;11;1.000;994000;0
17905;179151;1869;73;18;1;17;.944;3600000;0
17905;191698;1869;0;0;0;0;.00nan;0;0
17905;83983;4560;62;32;3;29;.906;3535000;0
17905;159851;4560;0;0;0;0;.00nan;0;0
17906;169226;1475;73;28;3;25;.893;3900000;0
17906;73973;1475;0;0;0;0;.00nan;0;0
17906;89998;1854;72;37;3;34;.919;3900000;0
17906;152464;1854;0;0;0;0;.00nan;0;0
17907;8426;2193;63;39;4;35;.897;3600000;0
17907;169226;1475;91;22;0;22;1.000;3600000;0
17907;68627;2193;0;0;0;0;.00nan;0;0
17907;73973;1475;0;0;0;0;.00nan;0;0
17908;8035;522;61;19;2;17;.895;3544000;0
17908;83983;4560;0;0;0;0;.00nan;0;0
17908;155474;522;0;0;0;0;.00nan;0;0
17908;159851;4560;96;35;1;34;.971;3600000;0
17909;185059;2173;0;0;0;0;.00nan;0;0
17909;64271;2173;41;40;6;34;.850;3514000;0
17909;143063;1877;0;0;0;0;.00nan;0;0
17909;143479;1877;60;31;4;27;.871;3600000;0
17910;206007;1481;86;37;3;34;.919;3858000;0
17910;221690;1481;0;0;0;0;.00nan;0;0
17910;89998;1854;0;0;0;0;.00nan;0;0
17910;152464;1854;69;22;2;20;.909;3858000;0
17911;9455;1477;0;0;0;0;.00nan;0;0
17911;179151;1869;59;31;4;27;.871;3517000;0
17911;191698;1869;0;0;0;0;.00nan;0;0
17911;84287;1477;95;39;2;37;.949;3600000;0
17912;168651;1871;54;31;4;27;.871;3600000;0
17912;174589;523;0;0;0;0;.00nan;0;0
17912;179830;523;100;25;0;25;1.000;3600000;0
17912;151590;1871;0;0;0;0;.00nan;0;0
17913;177504;3922;72;26;2;24;.923;3600000;0
17913;174581;524;62;7;0;7;1.000;472000;0
17913;86686;524;36;26;6;20;.769;3128000;0
17913;143507;3922;0;0;0;0;.00nan;0;0
17914;168651;1871;56;22;3;19;.864;3600000;0
17914;206007;1481;47;33;5;28;.848;3556000;0
17914;221690;1481;0;0;0;0;.00nan;0;0
17914;151590;1871;0;0;0;0;.00nan;0;0
17915;9455;1477;100;29;0;29;1.000;3600000;0
17915;84287;1477;0;0;0;0;.00nan;0;0
17915;143063;1877;0;0;0;0;.00nan;0;0
17915;143479;1877;60;40;5;35;.875;3600000;0
17916;174581;524;97;23;0;23;1.000;3600000;0
17916;185059;2173;90;32;2;30;.938;3572000;0
17916;64271;2173;0;0;0;0;.00nan;0;0
17916;86686;524;0;0;0;0;.00nan;0;0
17917;177504;3922;100;36;1;35;.972;3600000;0
17917;8426;2193;34;20;4;16;.800;3600000;0
17917;68627;2193;0;0;0;0;.00nan;0;0
17917;143507;3922;0;0;0;0;.00nan;0;0
17918;179151;1869;78;48;4;44;.917;3600000;0
17918;174589;523;0;0;0;0;.00nan;0;0
17918;179830;523;86;24;1;23;.958;3600000;0
17918;191698;1869;0;0;0;0;.00nan;0;0
17919;8035;522;64;33;3;30;.909;3900000;0
17919;89998;1854;57;15;3;12;.800;3900000;0
17919;152464;1854;0;0;0;0;.00nan;0;0
17919;155474;522;0;0;0;0;.00nan;0;0
17920;169226;1475;54;16;2;14;.875;3600000;0
17920;73973;1475;0;0;0;0;.00nan;0;0
17920;83983;4560;83;50;4;46;.920;3567000;0
17920;159851;4560;0;0;0;0;.00nan;0;0
17921;8035;522;58;37;5;32;.865;3600000;0
17921;179151;1869;0;0;0;0;.00nan;0;0
17921;191698;1869;73;9;0;9;1.000;3600000;0
17921;155474;522;0;0;0;0;.00nan;0;0
17922;168651;1871;100;18;0;18;1.000;3600000;0
17922;185059;2173;61;41;5;36;.878;3600000;0
17922;64271;2173;0;0;0;0;.00nan;0;0
17922;151590;1871;0;0;0;0;.00nan;0;0
17923;8426;2193;54;9;1;8;.889;3600000;0
17923;174581;524;55;40;5;35;.875;3600000;0
17923;68627;2193;0;0;0;0;.00nan;0;0
17923;86686;524;0;0;0;0;.00nan;0;0
17924;169226;1475;41;22;4;18;.818;3600000;0
17924;206007;1481;0;0;0;0;.00nan;0;0
17924;221690;1481;95;35;1;34;.971;3600000;0
17924;73973;1475;0;0;0;0;.00nan;0;0
17925;9455;1477;74;30;2;28;.933;3715000;0
17925;84287;1477;0;0;0;0;.00nan;0;0
17925;89998;1854;0;0;0;0;.00nan;0;0
17925;152464;1854;89;50;3;47;.940;3715000;0
17926;174589;523;55;20;2;18;.900;3523000;0
17926;179830;523;0;0;0;0;.00nan;0;0
17926;83983;4560;0;0;0;0;.00nan;0;0
17926;159851;4560;100;43;0;43;1.000;3600000;0
17927;177504;3922;0;0;0;0;.00nan;0;0
17927;143063;1877;0;0;0;0;.00nan;0;0
17927;143479;1877;82;28;1;27;.964;3600000;0
17927;143507;3922;44;26;4;22;.846;3600000;0
17928;8035;522;91;31;1;30;.968;3577000;0
17928;169226;1475;92;19;0;19;1.000;3600000;0
17928;73973;1475;0;0;0;0;.00nan;0;0
17928;155474;522;0;0;0;0;.00nan;0;0
17929;9455;1477;97;31;1;30;.968;3600000;0
17929;168651;1871;67;29;3;26;.897;3600000;0
17929;84287;1477;0;0;0;0;.00nan;0;0
17929;151590;1871;0;0;0;0;.00nan;0;0
17930;174581;524;0;0;0;0;.00nan;0;0
17930;86686;524;61;21;2;19;.905;3600000;0
17930;143063;1877;69;37;4;33;.892;3581000;0
17930;143479;1877;0;0;0;0;.00nan;0;0
17931;8426;2193;73;30;3;27;.900;3600000;0
17931;185059;2173;81;48;4;44;.917;3565000;0
17931;64271;2173;0;0;0;0;.00nan;0;0
17931;68627;2193;0;0;0;0;.00nan;0;0
17932;177504;3922;62;37;4;33;.892;3600000;0
17932;179151;1869;71;48;6;42;.875;3516000;0
17932;191698;1869;0;0;0;0;.00nan;0;0
17932;143507;3922;0;0;0;0;.00nan;0;0
17933;174589;523;85;15;0;15;1.000;3600000;0
17933;179830;523;0;0;0;0;.00nan;0;0
17933;89998;1854;34;34;6;28;.824;3600000;0
17933;152464;1854;0;0;0;0;.00nan;0;0
17934;206007;1481;75;26;2;24;.923;3600000;0
17934;221690;1481;0;0;0;0;.00nan;0;0
17934;83983;4560;22;26;6;20;.769;3600000;0
17934;159851;4560;0;0;0;0;.00nan;0;0
17935;8035;522;57;5;0;5;1.000;614000;0
17935;206007;1481;48;21;3;18;.857;3600000;0
17935;221690;1481;0;0;0;0;.00nan;0;0
17935;155474;522;45;29;4;25;.862;2946000;0
17936;179151;1869;40;25;4;21;.840;3600000;0
17936;185059;2173;0;0;0;0;.00nan;0;0
17936;191698;1869;0;0;0;0;.00nan;0;0
17936;64271;2173;81;39;3;36;.923;3600000;0
17937;168651;1871;69;27;2;25;.926;3600000;0
17937;174581;524;0;0;0;0;.00nan;0;0
17937;86686;524;99;42;1;41;.976;3600000;0
17937;151590;1871;0;0;0;0;.00nan;0;0
17938;8426;2193;80;15;0;15;1.000;3600000;0
17938;68627;2193;0;0;0;0;.00nan;0;0
17938;143063;1877;0;0;0;0;.00nan;0;0
17938;143479;1877;97;36;2;34;.944;3574000;0
17939;9455;1477;0;0;0;0;.00nan;0;0
17939;83983;4560;83;40;3;37;.925;2633000;0
17939;84287;1477;72;32;3;29;.906;3600000;0
17939;159851;4560;9;10;5;5;.500;967000;0
17940;169226;1475;40;38;6;32;.842;3600000;0
17940;174589;523;68;21;1;20;.952;3600000;0
17940;179830;523;0;0;0;0;.00nan;0;0
17940;73973;1475;0;0;0;0;.00nan;0;0
17941;177504;3922;88;43;2;41;.953;3569000;0
17941;89998;1854;0;0;0;0;.00nan;0;0
17941;143507;3922;0;0;0;0;.00nan;0;0
17941;152464;1854;76;23;1;22;.957;3600000;0
17942;177504;3922;78;53;4;49;.925;3563000;0
17942;169226;1475;42;17;3;14;.824;3600000;0
17942;73973;1475;0;0;0;0;.00nan;0;0
17942;143507;3922;0;0;0;0;.00nan;0;0
17943;168651;1871;0;0;0;0;.00nan;0;0
17943;143063;1877;0;0;0;0;.00nan;0;0
17943;143479;1877;84;34;2;32;.941;3600000;0
17943;151590;1871;80;32;1;31;.969;3600000;0
17944;8035;522;98;42;1;41;.976;3600000;0
17944;174589;523;93;27;0;27;1.000;3600000;0
17944;179830;523;0;0;0;0;.00nan;0;0
17944;155474;522;0;0;0;0;.00nan;0;0
17945;9455;1477;63;32;4;28;.875;3600000;0
17945;206007;1481;59;27;3;24;.889;3600000;0
17945;221690;1481;0;0;0;0;.00nan;0;0
17945;84287;1477;0;0;0;0;.00nan;0;0
17946;8426;2193;54;16;2;14;.875;3600000;0
17946;179151;1869;0;0;0;0;.00nan;0;0
17946;191698;1869;37;41;7;34;.829;3600000;0
17946;68627;2193;0;0;0;0;.00nan;0;0
17947;185059;2173;0;0;0;0;.00nan;0;0
17947;64271;2173;84;39;2;37;.949;3600000;0
17947;89998;1854;38;15;4;11;.733;3600000;0
17947;152464;1854;0;0;0;0;.00nan;0;0
17948;174581;524;0;0;0;0;.00nan;0;0
17948;83983;4560;62;38;4;34;.895;3579000;0
17948;86686;524;45;11;2;9;.818;3600000;0
17948;159851;4560;0;0;0;0;.00nan;0;0
17949;8035;522;56;33;4;29;.879;3592000;0
17949;185059;2173;55;17;2;15;.882;3600000;0
17949;64271;2173;0;0;0;0;.00nan;0;0
17949;155474;522;0;0;0;0;.00nan;0;0
17950;89998;1854;0;0;0;0;.00nan;0;0
17950;143063;1877;80;22;1;21;.955;3600000;0
17950;143479;1877;0;0;0;0;.00nan;0;0
17950;152464;1854;36;12;3;9;.750;3577000;0
17951;179151;1869;92;21;0;21;1.000;3600000;0
17951;174581;524;0;0;0;0;.00nan;0;0
17951;191698;1869;0;0;0;0;.00nan;0;0
17951;86686;524;71;29;2;27;.931;3552000;0
17952;8426;2193;0;0;0;0;.00nan;0;0
17952;168651;1871;48;43;6;37;.860;3527000;0
17952;68627;2193;66;34;4;30;.882;3600000;0
17952;151590;1871;0;0;0;0;.00nan;0;0
17953;9455;1477;90;55;3;52;.945;3600000;0
17953;169226;1475;58;19;2;17;.895;3600000;0
17953;73973;1475;0;0;0;0;.00nan;0;0
17953;84287;1477;0;0;0;0;.00nan;0;0
17954;206007;1481;34;32;6;26;.813;2242000;0
17954;174589;523;59;14;1;13;.929;3600000;0
17954;221690;1481;97;29;0;29;1.000;1358000;0
17954;179830;523;0;0;0;0;.00nan;0;0
17955;177504;3922;69;30;4;26;.867;3600000;0
17955;83983;4560;0;0;0;0;.00nan;0;0
17955;143507;3922;0;0;0;0;.00nan;0;0
17955;159851;4560;85;25;1;24;.960;3600000;0
17956;169226;1475;83;22;1;21;.955;3600000;0
17956;185059;2173;85;37;2;35;.946;3600000;0
17956;64271;2173;0;0;0;0;.00nan;0;0
17956;73973;1475;0;0;0;0;.00nan;0;0
17957;177504;3922;70;16;1;15;.938;3600000;0
17957;8035;522;92;39;2;37;.949;3545000;0
17957;143507;3922;0;0;0;0;.00nan;0;0
17957;155474;522;0;0;0;0;.00nan;0;0
17958;184049;524;0;0;0;0;.00nan;0;0
17958;206007;1481;66;25;2;23;.920;3600000;0
17958;221690;1481;0;0;0;0;.00nan;0;0
17958;86686;524;72;23;1;22;.957;3600000;0
17959;168651;1871;36;33;6;27;.818;3557000;0
17959;179151;1869;62;30;4;26;.867;3221000;0
17959;191698;1869;56;3;0;3;1.000;379000;0
17959;151590;1871;0;0;0;0;.00nan;0;0
17960;9455;1477;0;0;0;0;.00nan;0;0
17960;174589;523;0;0;0;0;.00nan;0;0
17960;179830;523;19;17;5;12;.706;3540000;0
17960;84287;1477;99;50;3;47;.940;3600000;0
17961;8426;2193;43;16;3;13;.813;3600000;0
17961;68627;2193;0;0;0;0;.00nan;0;0
17961;89998;1854;71;35;4;31;.886;3573000;0
17961;152464;1854;0;0;0;0;.00nan;0;0
17962;83983;4560;100;33;0;33;1.000;3600000;0
17962;143063;1877;0;0;0;0;.00nan;0;0
17962;143479;1877;50;24;3;21;.875;3600000;0
17962;159851;4560;0;0;0;0;.00nan;0;0
17963;168651;1871;75;22;1;21;.955;3600000;0
17963;89998;1854;0;0;0;0;.00nan;0;0
17963;151590;1871;0;0;0;0;.00nan;0;0
17963;152464;1854;96;38;2;36;.947;3557000;0
17964;185059;2173;0;0;0;0;.00nan;0;0
17964;64271;2173;78;34;2;32;.941;3600000;0
17964;83983;4560;62;33;3;30;.909;3558000;0
17964;159851;4560;0;0;0;0;.00nan;0;0
17965;179151;1869;69;30;3;27;.900;3900000;0
17965;191698;1869;0;0;0;0;.00nan;0;0
17965;143063;1877;0;0;0;0;.00nan;0;0
17965;143479;1877;67;38;3;35;.921;3900000;0
17966;184049;524;93;31;1;30;.968;2625000;0
17966;169226;1475;54;18;2;16;.889;3600000;0
17966;73973;1475;0;0;0;0;.00nan;0;0
17966;86686;524;28;16;4;12;.750;975000;0
17967;8426;2193;82;30;1;29;.967;3600000;0
17967;174589;523;51;29;4;25;.862;2123000;0
17967;179830;523;41;6;2;4;.667;1477000;0
17967;68627;2193;0;0;0;0;.00nan;0;0
17968;8035;522;83;38;3;35;.921;3578000;0
17968;9455;1477;0;0;0;0;.00nan;0;0
17968;84287;1477;53;18;2;16;.889;3600000;0
17968;155474;522;0;0;0;0;.00nan;0;0
17969;177504;3922;73;26;1;25;.962;3900000;0
17969;206007;1481;84;29;1;28;.966;3900000;0
17969;221690;1481;0;0;0;0;.00nan;0;0
17969;143507;3922;0;0;0;0;.00nan;0;0
17970;168651;1871;35;17;4;13;.765;3600000;0
17970;83983;4560;90;59;5;54;.915;3600000;0
17970;151590;1871;0;0;0;0;.00nan;0;0
17970;159851;4560;0;0;0;0;.00nan;0;0
17971;9455;1477;0;0;0;0;.00nan;0;0
17971;185059;2173;68;41;4;37;.902;3600000;0
17971;64271;2173;0;0;0;0;.00nan;0;0
17971;84287;1477;84;34;2;32;.941;3600000;0
17972;206007;1481;59;28;3;25;.893;3689000;0
17972;221690;1481;0;0;0;0;.00nan;0;0
17972;143063;1877;73;27;2;25;.926;3689000;0
17972;143479;1877;0;0;0;0;.00nan;0;0
17973;184049;524;0;0;0;0;.00nan;0;0
17973;86686;524;69;33;3;30;.909;3561000;0
17973;89998;1854;79;24;1;23;.958;3600000;0
17973;152464;1854;0;0;0;0;.00nan;0;0
17974;8035;522;89;40;3;37;.925;3900000;0
17974;8426;2193;49;23;3;20;.870;3900000;0
17974;68627;2193;0;0;0;0;.00nan;0;0
17974;155474;522;0;0;0;0;.00nan;0;0
17975;169226;1475;63;16;1;15;.938;3600000;0
17975;179151;1869;67;42;4;38;.905;3600000;0
17975;191698;1869;0;0;0;0;.00nan;0;0
17975;73973;1475;0;0;0;0;.00nan;0;0
17976;177504;3922;100;66;1;65;.985;3900000;0
17976;174589;523;74;21;1;20;.952;3900000;0
17976;179830;523;0;0;0;0;.00nan;0;0
17976;143507;3922;0;0;0;0;.00nan;0;0
17977;168651;1871;62;29;4;25;.862;3600000;0
17977;169226;1475;73;21;1;20;.952;3600000;0
17977;73973;1475;0;0;0;0;.00nan;0;0
17977;151590;1871;0;0;0;0;.00nan;0;0
17978;8035;522;80;23;1;22;.957;3600000;0
17978;184049;524;0;0;0;0;.00nan;0;0
17978;86686;524;41;27;5;22;.815;3600000;0
17978;155474;522;0;0;0;0;.00nan;0;0
17979;206007;1481;0;0;0;0;.00nan;0;0
17979;221690;1481;76;24;1;23;.958;3600000;0
17979;185059;2173;83;45;4;41;.911;3600000;0
17979;64271;2173;0;0;0;0;.00nan;0;0
17980;177504;3922;46;34;6;28;.824;3600000;0
17980;9455;1477;0;0;0;0;.00nan;0;0
17980;84287;1477;79;34;3;31;.912;3600000;0
17980;143507;3922;0;0;0;0;.00nan;0;0
17981;174589;523;60;16;1;15;.938;3600000;0
17981;179830;523;0;0;0;0;.00nan;0;0
17981;143063;1877;0;0;0;0;.00nan;0;0
17981;143479;1877;67;44;5;39;.886;3600000;0
17982;179151;1869;80;23;1;22;.957;3600000;0
17982;191698;1869;0;0;0;0;.00nan;0;0
17982;89998;1854;0;0;0;0;.00nan;0;0
17982;152464;1854;43;19;3;16;.842;3534000;0
17983;8426;2193;61;18;2;16;.889;3600000;0
17983;68627;2193;0;0;0;0;.00nan;0;0
17983;83983;4560;0;0;0;0;.00nan;0;0
17983;159851;4560;56;56;7;49;.875;3600000;0
17984;8035;522;98;46;1;45;.978;3595000;0
17984;168651;1871;86;18;0;18;1.000;3600000;0
17984;151590;1871;0;0;0;0;.00nan;0;0
17984;155474;522;0;0;0;0;.00nan;0;0
17985;177504;3922;49;21;3;18;.857;3572000;0
17985;185059;2173;0;0;0;0;.00nan;0;0
17985;64271;2173;100;52;2;50;.962;3600000;0
17985;143507;3922;0;0;0;0;.00nan;0;0
17986;169226;1475;74;28;2;26;.929;3600000;0
17986;73973;1475;0;0;0;0;.00nan;0;0
17986;143063;1877;76;44;4;40;.909;3600000;0
17986;143479;1877;0;0;0;0;.00nan;0;0
17987;184049;524;99;37;1;36;.973;3600000;0
17987;174589;523;42;11;2;9;.818;3547000;0
17987;179830;523;0;0;0;0;.00nan;0;0
17987;86686;524;0;0;0;0;.00nan;0;0
17988;8426;2193;72;32;2;30;.938;3600000;0
17988;9455;1477;52;3;0;3;1.000;278000;0
17988;68627;2193;0;0;0;0;.00nan;0;0
17988;84287;1477;62;52;6;46;.885;3322000;0
17989;206007;1481;78;28;1;27;.964;3572000;0
17989;179151;1869;94;19;0;19;1.000;3600000;0
17989;221690;1481;0;0;0;0;.00nan;0;0
17989;191698;1869;0;0;0;0;.00nan;0;0
17990;83983;4560;40;2;1;1;.500;359000;0
17990;89998;1854;87;15;0;15;1.000;3600000;0
17990;152464;1854;0;0;0;0;.00nan;0;0
17990;159851;4560;58;42;6;36;.857;3241000;0
17991;169226;1475;45;19;3;16;.842;3600000;0
17991;73973;1475;0;0;0;0;.00nan;0;0
17991;89998;1854;0;0;0;0;.00nan;0;0
17991;152464;1854;61;38;4;34;.895;3585000;0
17992;8035;522;48;24;4;20;.833;3900000;0
17992;143063;1877;0;0;0;0;.00nan;0;0
17992;143479;1877;51;32;4;28;.875;3900000;0
17992;155474;522;0;0;0;0;.00nan;0;0
17993;8426;2193;57;11;1;10;.909;3600000;0
17993;206007;1481;30;15;4;11;.733;1126000;0
17993;221690;1481;84;32;1;31;.969;2474000;0
17993;68627;2193;0;0;0;0;.00nan;0;0
17994;9455;1477;77;15;0;15;1.000;3600000;0
17994;184049;524;0;0;0;0;.00nan;0;0
17994;84287;1477;0;0;0;0;.00nan;0;0
17994;86686;524;83;33;2;31;.939;3532000;0
17995;174589;523;0;0;0;0;.00nan;0;0
17995;185059;2173;90;68;6;62;.912;3600000;0
17995;179830;523;75;13;0;13;1.000;3600000;0
17995;64271;2173;0;0;0;0;.00nan;0;0
17996;177504;3922;77;32;2;30;.938;3600000;0
17996;168651;1871;34;16;3;13;.813;3593000;0
17996;143507;3922;0;0;0;0;.00nan;0;0
17996;151590;1871;0;0;0;0;.00nan;0;0
17997;179151;1869;85;16;0;16;1.000;3600000;0
17997;191698;1869;0;0;0;0;.00nan;0;0
17997;83983;4560;63;41;4;37;.902;3600000;0
17997;159851;4560;0;0;0;0;.00nan;0;0
17998;168651;1871;71;30;2;28;.933;3900000;0
17998;174589;523;0;0;0;0;.00nan;0;0
17998;179830;523;66;26;2;24;.923;3900000;0
17998;151590;1871;0;0;0;0;.00nan;0;0
17999;185059;2173;24;29;6;23;.793;2885000;0
17999;64271;2173;58;6;0;6;1.000;715000;0
17999;143063;1877;81;28;2;26;.929;3600000;0
17999;143479;1877;0;0;0;0;.00nan;0;0
18000;177504;3922;54;24;3;21;.875;3796000;0
18000;184049;524;0;0;0;0;.00nan;0;0
18000;86686;524;93;44;2;42;.955;3796000;0
18000;143507;3922;0;0;0;0;.00nan;0;0
18001;8426;2193;41;31;5;26;.839;3600000;0
18001;169226;1475;100;33;0;33;1.000;3600000;0
18001;68627;2193;0;0;0;0;.00nan;0;0
18001;73973;1475;0;0;0;0;.00nan;0;0
18002;9455;1477;36;22;5;17;.773;3535000;0
18002;179151;1869;48;21;3;18;.857;3600000;0
18002;191698;1869;0;0;0;0;.00nan;0;0
18002;84287;1477;0;0;0;0;.00nan;0;0
18003;206007;1481;84;29;1;28;.966;3600000;0
18003;221690;1481;0;0;0;0;.00nan;0;0
18003;89998;1854;62;22;2;20;.909;3570000;0
18003;152464;1854;0;0;0;0;.00nan;0;0
18004;8035;522;76;31;2;29;.935;3600000;0
18004;83983;4560;52;23;3;20;.870;3565000;0
18004;155474;522;0;0;0;0;.00nan;0;0
18004;159851;4560;0;0;0;0;.00nan;0;0
18005;169226;1475;0;0;0;0;.00nan;0;0
18005;73973;1475;79;12;0;12;1.000;3600000;0
18005;83983;4560;31;3;2;1;.333;802000;0
18005;159851;4560;52;43;6;37;.860;2798000;0
18006;8035;522;69;18;1;17;.944;1387000;0
18006;89998;1854;0;0;0;0;.00nan;0;0
18006;152464;1854;77;27;2;25;.926;3600000;0
18006;155474;522;30;28;6;22;.786;2213000;0
18007;184049;524;0;0;0;0;.00nan;0;0
18007;185059;2173;0;0;0;0;.00nan;0;0
18007;64271;2173;63;21;2;19;.905;3558000;0
18007;86686;524;89;27;1;26;.963;3600000;0
18008;168651;1871;66;24;2;22;.917;3634000;0
18008;206007;1481;0;0;0;0;.00nan;0;0
18008;221690;1481;100;38;1;37;.974;3634000;0
18008;151590;1871;0;0;0;0;.00nan;0;0
18009;9455;1477;0;0;0;0;.00nan;0;0
18009;84287;1477;84;31;2;29;.935;3600000;0
18009;143063;1877;0;0;0;0;.00nan;0;0
18009;143479;1877;36;29;5;24;.828;3600000;0
18010;179151;1869;73;47;5;42;.894;3600000;0
18010;174589;523;0;0;0;0;.00nan;0;0
18010;179830;523;90;15;0;15;1.000;3600000;0
18010;191698;1869;0;0;0;0;.00nan;0;0
18011;177504;3922;0;0;0;0;.00nan;0;0
18011;8426;2193;74;21;1;20;.952;3673000;0
18011;68627;2193;0;0;0;0;.00nan;0;0
18011;143507;3922;100;41;0;41;1.000;3673000;0
18012;169226;1475;82;21;1;20;.952;3900000;0
18012;206007;1481;100;45;1;44;.978;3900000;0
18012;221690;1481;0;0;0;0;.00nan;0;0
18012;73973;1475;0;0;0;0;.00nan;0;0
18013;168651;1871;53;21;3;18;.857;3600000;0
18013;185059;2173;26;29;6;23;.793;2474000;0
18013;64271;2173;54;7;1;6;.857;1126000;0
18013;151590;1871;0;0;0;0;.00nan;0;0
18014;177504;3922;0;0;0;0;.00nan;0;0
18014;143063;1877;62;27;3;24;.889;3529000;0
18014;143479;1877;0;0;0;0;.00nan;0;0
18014;143507;3922;83;31;1;30;.968;3600000;0
18015;8426;2193;54;39;5;34;.872;3552000;0
18015;184049;524;0;0;0;0;.00nan;0;0
18015;68627;2193;0;0;0;0;.00nan;0;0
18015;86686;524;58;32;4;28;.875;3600000;0
18016;8035;522;52;24;3;21;.875;3519000;0
18016;179151;1869;88;31;1;30;.968;3600000;0
18016;191698;1869;0;0;0;0;.00nan;0;0
18016;155474;522;0;0;0;0;.00nan;0;0
18017;9455;1477;0;0;0;0;.00nan;0;0
18017;84287;1477;25;28;6;22;.786;3600000;0
18017;89998;1854;71;16;1;15;.938;3600000;0
18017;152464;1854;0;0;0;0;.00nan;0;0
18018;174589;523;0;0;0;0;.00nan;0;0
18018;179830;523;55;9;2;7;.778;3600000;0
18018;83983;4560;97;65;3;62;.954;3600000;0
18018;159851;4560;0;0;0;0;.00nan;0;0
18019;8035;522;50;41;6;35;.854;3600000;0
18019;169226;1475;69;18;1;17;.944;3600000;0
18019;73973;1475;0;0;0;0;.00nan;0;0
18019;155474;522;0;0;0;0;.00nan;0;0
18020;8426;2193;48;24;4;20;.833;3600000;0
18020;185059;2173;100;40;1;39;.975;3600000;0
18020;64271;2173;0;0;0;0;.00nan;0;0
18020;68627;2193;0;0;0;0;.00nan;0;0
18021;184049;524;49;33;4;29;.879;3600000;0
18021;86686;524;0;0;0;0;.00nan;0;0
18021;143063;1877;0;0;0;0;.00nan;0;0
18021;143479;1877;97;29;0;29;1.000;3600000;0
18022;206007;1481;54;19;2;17;.895;3600000;0
18022;221690;1481;0;0;0;0;.00nan;0;0
18022;83983;4560;44;34;5;29;.853;3600000;0
18022;159851;4560;0;0;0;0;.00nan;0;0
18023;9455;1477;33;17;4;13;.765;1070000;0
18023;168651;1871;72;37;3;34;.919;3600000;0
18023;84287;1477;50;22;3;19;.864;2530000;0
18023;151590;1871;0;0;0;0;.00nan;0;0
18024;174589;523;85;32;1;31;.969;3647000;0
18024;89998;1854;74;29;2;27;.931;3647000;0
18024;152464;1854;0;0;0;0;.00nan;0;0
18024;155529;523;0;0;0;0;.00nan;0;0
18025;177504;3922;0;0;0;0;.00nan;0;0
18025;179151;1869;87;34;2;32;.941;3900000;0
18025;191698;1869;0;0;0;0;.00nan;0;0
18025;143507;3922;88;31;2;29;.935;3900000;0
18026;169226;1475;93;41;2;39;.951;3550000;0
18026;174589;523;0;0;0;0;.00nan;0;0
18026;73973;1475;0;0;0;0;.00nan;0;0
18026;155529;523;80;26;1;25;.962;3600000;0
18027;168651;1871;70;18;1;17;.944;3600000;0
18027;184049;524;0;0;0;0;.00nan;0;0
18027;86686;524;92;40;2;38;.950;3578000;0
18027;151590;1871;0;0;0;0;.00nan;0;0
18028;8426;2193;60;14;1;13;.929;3600000;0
18028;68627;2193;0;0;0;0;.00nan;0;0
18028;143063;1877;0;0;0;0;.00nan;0;0
18028;143479;1877;89;49;4;45;.918;3600000;0
18029;8035;522;64;42;5;37;.881;3600000;0
18029;206007;1481;79;15;0;15;1.000;3600000;0
18029;221690;1481;0;0;0;0;.00nan;0;0
18029;155474;522;0;0;0;0;.00nan;0;0
18030;179151;1869;0;0;0;0;.00nan;0;0
18030;185059;2173;31;32;7;25;.781;3221000;0
18030;191698;1869;75;29;2;27;.931;3600000;0
18030;64271;2173;48;7;1;6;.857;379000;0
18031;177504;3922;85;33;2;31;.939;3900000;0
18031;89998;1854;0;0;0;0;.00nan;0;0
18031;143507;3922;0;0;0;0;.00nan;0;0
18031;152464;1854;82;35;2;33;.943;3900000;0
18032;9455;1477;39;15;3;12;.800;3003000;0
18032;83983;4560;36;48;8;40;.833;3663000;0
18032;84287;1477;21;8;4;4;.500;660000;0
18032;159851;4560;0;0;0;0;.00nan;0;0
18033;185059;2173;0;0;0;0;.00nan;0;0
18033;64271;2173;14;31;8;23;.742;3600000;0
18033;89998;1854;79;20;1;19;.950;3600000;0
18033;152464;1854;0;0;0;0;.00nan;0;0
18034;168651;1871;67;19;1;18;.947;3600000;0
18034;143063;1877;74;34;3;31;.912;3519000;0
18034;143479;1877;0;0;0;0;.00nan;0;0
18034;151590;1871;0;0;0;0;.00nan;0;0
18035;184049;524;0;0;0;0;.00nan;0;0
18035;83983;4560;56;28;3;25;.893;3532000;0
18035;86686;524;93;34;1;33;.971;3600000;0
18035;159851;4560;0;0;0;0;.00nan;0;0
18036;8426;2193;0;0;0;0;.00nan;0;0
18036;179151;1869;47;25;4;21;.840;3513000;0
18036;191698;1869;0;0;0;0;.00nan;0;0
18036;68627;2193;62;22;2;20;.909;3600000;0
18037;9455;1477;79;33;2;31;.939;3655000;0
18037;206007;1481;74;23;1;22;.957;3655000;0
18037;221690;1481;0;0;0;0;.00nan;0;0
18037;84287;1477;0;0;0;0;.00nan;0;0
18038;8035;522;92;60;2;58;.967;3802000;0
18038;174589;523;0;0;0;0;.00nan;0;0
18038;155474;522;0;0;0;0;.00nan;0;0
18038;155529;523;71;21;1;20;.952;3802000;0
18039;177504;3922;76;42;4;38;.905;3112000;0
18039;169226;1475;77;11;0;11;1.000;3600000;0
18039;73973;1475;0;0;0;0;.00nan;0;0
18039;143507;3922;34;13;3;10;.769;488000;0
18040;9455;1477;0;0;0;0;.00nan;0;0
18040;169226;1475;61;28;3;25;.893;3600000;0
18040;73973;1475;0;0;0;0;.00nan;0;0
18040;84287;1477;73;52;5;47;.904;3591000;0
18041;8426;2193;72;37;4;33;.892;3798000;0
18041;168651;1871;68;33;3;30;.909;3798000;0
18041;68627;2193;0;0;0;0;.00nan;0;0
18041;151590;1871;0;0;0;0;.00nan;0;0
18042;8035;522;77;36;3;33;.917;3900000;0
18042;185059;2173;0;0;0;0;.00nan;0;0
18042;64271;2173;50;23;3;20;.870;3900000;0
18042;155474;522;0;0;0;0;.00nan;0;0
18043;206007;1481;70;43;4;39;.907;3600000;0
18043;174589;523;0;0;0;0;.00nan;0;0
18043;221690;1481;0;0;0;0;.00nan;0;0
18043;155529;523;73;10;0;10;1.000;3600000;0
18044;184049;524;0;0;0;0;.00nan;0;0
18044;179151;1869;57;16;2;14;.875;3655000;0
18044;191698;1869;0;0;0;0;.00nan;0;0
18044;86686;524;65;32;3;29;.906;3655000;0
18045;89998;1854;0;0;0;0;.00nan;0;0
18045;143063;1877;0;0;0;0;.00nan;0;0
18045;143479;1877;76;33;2;31;.939;3900000;0
18045;152464;1854;57;14;2;12;.857;3900000;0
18046;177504;3922;53;31;4;27;.871;3600000;0
18046;83983;4560;0;0;0;0;.00nan;0;0
18046;143507;3922;0;0;0;0;.00nan;0;0
18046;159851;4560;90;41;1;40;.976;3600000;0
18047;168651;1871;47;24;4;20;.833;3837000;0
18047;179151;1869;85;53;5;48;.906;3837000;0
18047;191698;1869;0;0;0;0;.00nan;0;0
18047;151590;1871;0;0;0;0;.00nan;0;0
18048;169226;1475;54;11;1;10;.909;3600000;0
18048;185059;2173;95;48;3;45;.938;3569000;0
18048;64271;2173;0;0;0;0;.00nan;0;0
18048;73973;1475;0;0;0;0;.00nan;0;0
18049;83983;4560;91;36;1;35;.972;3900000;0
18049;143063;1877;80;26;1;25;.962;3900000;0
18049;143479;1877;0;0;0;0;.00nan;0;0
18049;159851;4560;0;0;0;0;.00nan;0;0
18050;184049;524;100;29;1;28;.966;3600000;0
18050;206007;1481;55;19;2;17;.895;3553000;0
18050;221690;1481;0;0;0;0;.00nan;0;0
18050;86686;524;0;0;0;0;.00nan;0;0
18051;8426;2193;65;29;3;26;.897;3600000;0
18051;68627;2193;0;0;0;0;.00nan;0;0
18051;89998;1854;100;34;0;34;1.000;3600000;0
18051;152464;1854;0;0;0;0;.00nan;0;0
18052;9455;1477;77;44;4;40;.909;3593000;0
18052;174589;523;0;0;0;0;.00nan;0;0
18052;84287;1477;0;0;0;0;.00nan;0;0
18052;155529;523;57;24;3;21;.875;3600000;0
18053;177504;3922;64;33;4;29;.879;3512000;0
18053;8035;522;70;23;2;21;.913;3600000;0
18053;143507;3922;0;0;0;0;.00nan;0;0
18053;155474;522;0;0;0;0;.00nan;0;0
18054;184049;524;0;0;0;0;.00nan;0;0
18054;169226;1475;83;24;1;23;.958;3545000;0
18054;73973;1475;0;0;0;0;.00nan;0;0
18054;86686;524;100;26;0;26;1.000;3600000;0
18055;8035;522;93;44;1;43;.977;3600000;0
18055;9455;1477;0;0;0;0;.00nan;0;0
18055;84287;1477;56;24;3;21;.875;3548000;0
18055;155474;522;0;0;0;0;.00nan;0;0
18056;177504;3922;78;37;3;34;.919;3600000;0
18056;206007;1481;0;0;0;0;.00nan;0;0
18056;221690;1481;68;20;1;19;.950;3600000;0
18056;143507;3922;0;0;0;0;.00nan;0;0
18057;179151;1869;67;17;1;16;.941;3600000;0
18057;191698;1869;0;0;0;0;.00nan;0;0
18057;143063;1877;0;0;0;0;.00nan;0;0
18057;143479;1877;75;37;2;35;.946;3595000;0
18058;8426;2193;52;26;3;23;.885;3600000;0
18058;174589;523;0;0;0;0;.00nan;0;0
18058;68627;2193;0;0;0;0;.00nan;0;0
18058;155529;523;88;23;0;23;1.000;3600000;0
18059;168651;1871;50;31;4;27;.871;3900000;0
18059;89998;1854;59;32;4;28;.875;3888000;0
18059;151590;1871;0;0;0;0;.00nan;0;0
18059;152464;1854;0;0;0;0;.00nan;0;0
18060;185059;2173;90;42;2;40;.952;3600000;0
18060;64271;2173;0;0;0;0;.00nan;0;0
18060;83983;4560;0;0;0;0;.00nan;0;0
18060;159851;4560;60;26;3;23;.885;3574000;0
18061;169226;1475;73;20;1;19;.950;3600000;0
18061;179151;1869;67;49;5;44;.898;3600000;0
18061;191698;1869;0;0;0;0;.00nan;0;0
18061;73973;1475;0;0;0;0;.00nan;0;0
18062;8035;522;64;50;6;44;.880;3308000;0
18062;8426;2193;56;12;1;11;.917;3600000;0
18062;68627;2193;0;0;0;0;.00nan;0;0
18062;155474;522;56;5;0;5;1.000;292000;0
18063;206007;1481;64;22;2;20;.909;3582000;0
18063;221690;1481;0;0;0;0;.00nan;0;0
18063;143063;1877;0;0;0;0;.00nan;0;0
18063;143479;1877;100;39;1;38;.974;3600000;0
18064;9455;1477;80;22;1;21;.955;3600000;0
18064;185059;2173;43;33;5;28;.848;3600000;0
18064;64271;2173;0;0;0;0;.00nan;0;0
18064;84287;1477;0;0;0;0;.00nan;0;0
18065;177504;3922;83;30;2;28;.933;3853000;0
18065;174589;523;0;0;0;0;.00nan;0;0
18065;143507;3922;0;0;0;0;.00nan;0;0
18065;155529;523;85;23;1;22;.957;3853000;0
18066;184049;524;0;0;0;0;.00nan;0;0
18066;86686;524;76;27;3;24;.889;3808000;0
18066;89998;1854;64;26;2;24;.923;3808000;0
18066;152464;1854;0;0;0;0;.00nan;0;0
18067;168651;1871;48;20;3;17;.850;3669000;0
18067;83983;4560;73;36;4;32;.889;3669000;0
18067;151590;1871;0;0;0;0;.00nan;0;0
18067;159851;4560;0;0;0;0;.00nan;0;0
18068;168651;1871;85;32;1;31;.969;3900000;0
18068;169226;1475;82;26;1;25;.962;3900000;0
18068;73973;1475;0;0;0;0;.00nan;0;0
18068;151590;1871;0;0;0;0;.00nan;0;0
18069;206007;1481;70;24;1;23;.958;3600000;0
18069;221690;1481;0;0;0;0;.00nan;0;0
18069;185059;2173;75;38;4;34;.895;3600000;0
18069;64271;2173;0;0;0;0;.00nan;0;0
18070;174589;523;0;0;0;0;.00nan;0;0
18070;143063;1877;81;45;4;41;.911;3600000;0
18070;143479;1877;0;0;0;0;.00nan;0;0
18070;155529;523;75;9;0;9;1.000;3600000;0
18071;8035;522;88;33;1;32;.970;3600000;0
18071;184049;524;0;0;0;0;.00nan;0;0
18071;86686;524;78;36;3;33;.917;3594000;0
18071;155474;522;0;0;0;0;.00nan;0;0
18072;8426;2193;0;0;0;0;.00nan;0;0
18072;68627;2193;89;27;1;26;.963;3600000;0
18072;83983;4560;80;49;5;44;.898;3600000;0
18072;159851;4560;0;0;0;0;.00nan;0;0
18073;179151;1869;92;41;2;39;.951;3600000;0
18073;191698;1869;0;0;0;0;.00nan;0;0
18073;89998;1854;78;32;3;29;.906;3552000;0
18073;152464;1854;0;0;0;0;.00nan;0;0
18074;177504;3922;0;0;0;0;.00nan;0;0
18074;9455;1477;0;0;0;0;.00nan;0;0
18074;84287;1477;52;25;3;22;.880;3900000;0
18074;143507;3922;77;32;3;29;.906;3900000;0
18075;169226;1475;59;15;1;14;.933;3600000;0
18075;73973;1475;0;0;0;0;.00nan;0;0
18075;143063;1877;0;0;0;0;.00nan;0;0
18075;143479;1877;98;64;3;61;.953;3600000;0
18076;8035;522;79;36;3;33;.917;3900000;0
18076;168651;1871;57;27;3;24;.889;3900000;0
18076;151590;1871;0;0;0;0;.00nan;0;0
18076;155474;522;0;0;0;0;.00nan;0;0
18077;206007;1481;76;43;4;39;.907;3600000;0
18077;179151;1869;81;31;1;30;.968;3600000;0
18077;221690;1481;0;0;0;0;.00nan;0;0
18077;191698;1869;0;0;0;0;.00nan;0;0
18078;8426;2193;43;30;6;24;.800;2789000;0
18078;9455;1477;34;34;6;28;.824;2587000;0
18078;68627;2193;56;4;0;4;1.000;811000;0
18078;84287;1477;47;7;1;6;.857;974000;0
18079;184049;524;0;0;0;0;.00nan;0;0
18079;174589;523;0;0;0;0;.00nan;0;0
18079;86686;524;73;34;3;31;.912;3600000;0
18079;155529;523;59;12;1;11;.917;3600000;0
18080;177504;3922;95;38;2;36;.947;3600000;0
18080;185059;2173;56;30;4;26;.867;3515000;0
18080;64271;2173;0;0;0;0;.00nan;0;0
18080;143507;3922;0;0;0;0;.00nan;0;0
18081;83983;4560;0;0;0;0;.00nan;0;0
18081;89998;1854;0;0;0;0;.00nan;0;0
18081;152464;1854;47;12;2;10;.833;3600000;0
18081;159851;4560;62;46;5;41;.891;3600000;0
18082;177504;3922;0;0;0;0;.00nan;0;0
18082;168651;1871;64;22;2;20;.909;3900000;0
18082;143507;3922;94;36;2;34;.944;3900000;0
18082;151590;1871;0;0;0;0;.00nan;0;0
18083;174589;523;0;0;0;0;.00nan;0;0
18083;185059;2173;0;0;0;0;.00nan;0;0
18083;64271;2173;43;40;6;34;.850;3600000;0
18083;155529;523;43;11;2;9;.818;3600000;0
18084;8035;522;58;32;4;28;.875;3600000;0
18084;143063;1877;90;26;1;25;.962;3600000;0
18084;143479;1877;0;0;0;0;.00nan;0;0
18084;155474;522;0;0;0;0;.00nan;0;0
18085;9455;1477;0;0;0;0;.00nan;0;0
18085;184049;524;97;41;2;39;.951;3572000;0
18085;84287;1477;74;23;1;22;.957;3600000;0
18085;86686;524;0;0;0;0;.00nan;0;0
18086;8426;2193;68;16;1;15;.938;3900000;0
18086;206007;1481;100;34;1;33;.971;3900000;0
18086;221690;1481;0;0;0;0;.00nan;0;0
18086;68627;2193;0;0;0;0;.00nan;0;0
18087;179151;1869;71;18;1;17;.944;3600000;0
18087;191698;1869;0;0;0;0;.00nan;0;0
18087;83983;4560;89;44;2;42;.955;3600000;0
18087;159851;4560;0;0;0;0;.00nan;0;0
18088;169226;1475;80;31;1;30;.968;3600000;0
18088;73973;1475;0;0;0;0;.00nan;0;0
18088;89998;1854;0;0;0;0;.00nan;0;0
18088;152464;1854;33;44;8;36;.818;3600000;0
18089;8426;2193;86;44;3;41;.932;3600000;0
18089;169226;1475;100;28;0;28;1.000;3600000;0
18089;68627;2193;0;0;0;0;.00nan;0;0
18089;73973;1475;0;0;0;0;.00nan;0;0
18090;8035;522;62;20;2;18;.900;3600000;0
18090;83983;4560;43;22;4;18;.818;3600000;0
18090;155474;522;0;0;0;0;.00nan;0;0
18090;159851;4560;0;0;0;0;.00nan;0;0
18091;185059;2173;55;15;3;12;.800;3600000;0
18091;64271;2173;0;0;0;0;.00nan;0;0
18091;143063;1877;0;0;0;0;.00nan;0;0
18091;143479;1877;52;37;5;32;.865;3576000;0
18092;206007;1481;0;0;0;0;.00nan;0;0
18092;221690;1481;82;36;2;34;.944;3600000;0
18092;89998;1854;0;0;0;0;.00nan;0;0
18092;152464;1854;17;21;6;15;.714;3600000;0
18093;9455;1477;76;34;3;31;.912;3900000;0
18093;179151;1869;66;29;3;26;.897;3900000;0
18093;191698;1869;0;0;0;0;.00nan;0;0
18093;84287;1477;0;0;0;0;.00nan;0;0
18094;168651;1871;58;35;4;31;.886;3585000;0
18094;174589;523;0;0;0;0;.00nan;0;0
18094;151590;1871;0;0;0;0;.00nan;0;0
18094;155529;523;68;20;2;18;.900;3600000;0
18095;177504;3922;0;0;0;0;.00nan;0;0
18095;184049;524;0;0;0;0;.00nan;0;0
18095;86686;524;92;27;1;26;.963;3576000;0
18095;143507;3922;100;28;0;28;1.000;3600000;0
18096;168651;1871;0;0;0;0;.00nan;0;0
18096;206007;1481;39;39;6;33;.846;3600000;0
18096;221690;1481;0;0;0;0;.00nan;0;0
18096;151590;1871;53;19;2;17;.895;3600000;0
18097;9455;1477;0;0;0;0;.00nan;0;0
18097;84287;1477;85;27;2;25;.926;3900000;0
18097;143063;1877;82;31;2;29;.935;3900000;0
18097;143479;1877;0;0;0;0;.00nan;0;0
18098;184049;524;0;0;0;0;.00nan;0;0
18098;185059;2173;68;26;2;24;.923;3599000;0
18098;64271;2173;0;0;0;0;.00nan;0;0
18098;86686;524;92;38;1;37;.974;3600000;0
18099;177504;3922;0;0;0;0;.00nan;0;0
18099;8426;2193;38;23;4;19;.826;3559000;0
18099;68627;2193;0;0;0;0;.00nan;0;0
18099;143507;3922;79;41;3;38;.927;3600000;0
18100;179151;1869;44;35;6;29;.829;1997000;0
18100;174589;523;0;0;0;0;.00nan;0;0
18100;191698;1869;61;16;1;15;.938;1603000;0
18100;155529;523;70;16;1;15;.938;3600000;0
18101;8035;522;72;31;2;29;.935;3600000;0
18101;89998;1854;0;0;0;0;.00nan;0;0
18101;152464;1854;70;17;1;16;.941;3600000;0
18101;155474;522;0;0;0;0;.00nan;0;0
18102;169226;1475;85;17;0;17;1.000;3600000;0
18102;73973;1475;0;0;0;0;.00nan;0;0
18102;83983;4560;97;61;3;58;.951;3600000;0
18102;159851;4560;0;0;0;0;.00nan;0;0
18103;8035;522;67;28;2;26;.929;3600000;0
18103;179151;1869;53;22;3;19;.864;3551000;0
18103;191698;1869;0;0;0;0;.00nan;0;0
18103;155474;522;0;0;0;0;.00nan;0;0
18104;168651;1871;74;16;1;15;.938;3600000;0
18104;185059;2173;43;22;4;18;.818;2202000;0
18104;64271;2173;54;15;2;13;.867;1398000;0
18104;151590;1871;0;0;0;0;.00nan;0;0
18105;8426;2193;96;19;0;19;1.000;3600000;0
18105;184049;524;0;0;0;0;.00nan;0;0
18105;68627;2193;0;0;0;0;.00nan;0;0
18105;86686;524;93;45;2;43;.956;3541000;0
18106;169226;1475;31;19;4;15;.789;3555000;0
18106;206007;1481;99;43;2;41;.953;3600000;0
18106;221690;1481;0;0;0;0;.00nan;0;0
18106;73973;1475;0;0;0;0;.00nan;0;0
18107;9455;1477;75;35;3;32;.914;3555000;0
18107;84287;1477;0;0;0;0;.00nan;0;0
18107;89998;1854;82;29;2;27;.931;3600000;0
18107;152464;1854;0;0;0;0;.00nan;0;0
18108;174589;523;0;0;0;0;.00nan;0;0
18108;83983;4560;88;60;4;56;.933;3600000;0
18108;155529;523;61;15;1;14;.933;3600000;0
18108;159851;4560;0;0;0;0;.00nan;0;0
18109;177504;3922;73;24;2;22;.917;3600000;0
18109;143063;1877;0;0;0;0;.00nan;0;0
18109;143479;1877;50;29;4;25;.862;3563000;0
18109;143507;3922;0;0;0;0;.00nan;0;0
18110;8035;522;64;36;4;32;.889;2293000;0
18110;169226;1475;100;23;0;23;1.000;3600000;0
18110;73973;1475;0;0;0;0;.00nan;0;0
18110;155474;522;45;13;2;11;.846;1307000;0
18111;9455;1477;0;0;0;0;.00nan;0;0
18111;168651;1871;82;25;2;23;.920;3600000;0
18111;84287;1477;85;52;5;47;.904;3600000;0
18111;151590;1871;0;0;0;0;.00nan;0;0
18112;184049;524;0;0;0;0;.00nan;0;0
18112;86686;524;88;32;1;31;.969;3556000;0
18112;143063;1877;100;33;0;33;1.000;3600000;0
18112;143479;1877;0;0;0;0;.00nan;0;0
18113;8426;2193;84;27;1;26;.963;3600000;0
18113;185059;2173;98;55;2;53;.964;3600000;0
18113;64271;2173;0;0;0;0;.00nan;0;0
18113;68627;2193;0;0;0;0;.00nan;0;0
18114;177504;3922;89;34;2;32;.941;3624000;0
18114;179151;1869;0;0;0;0;.00nan;0;0
18114;191698;1869;99;26;1;25;.962;3624000;0
18114;143507;3922;0;0;0;0;.00nan;0;0
18115;174589;523;0;0;0;0;.00nan;0;0
18115;89998;1854;0;0;0;0;.00nan;0;0
18115;152464;1854;82;47;5;42;.894;3600000;0
18115;155529;523;91;35;2;33;.943;3600000;0
18116;206007;1481;47;24;4;20;.833;3600000;0
18116;221690;1481;0;0;0;0;.00nan;0;0
18116;83983;4560;54;51;7;44;.863;3600000;0
18116;159851;4560;0;0;0;0;.00nan;0;0
18117;8035;522;90;41;2;39;.951;3564000;0
18117;206007;1481;100;29;0;29;1.000;3600000;0
18117;221690;1481;0;0;0;0;.00nan;0;0
18117;155474;522;0;0;0;0;.00nan;0;0
18118;179151;1869;66;21;2;19;.905;3600000;0
18118;185059;2173;0;0;0;0;.00nan;0;0
18118;191698;1869;0;0;0;0;.00nan;0;0
18118;64271;2173;73;40;4;36;.900;3570000;0
18119;168651;1871;69;21;2;19;.905;3900000;0
18119;184049;524;0;0;0;0;.00nan;0;0
18119;86686;524;89;38;2;36;.947;3900000;0
18119;151590;1871;0;0;0;0;.00nan;0;0
18120;8426;2193;49;22;4;18;.818;3600000;0
18120;68627;2193;0;0;0;0;.00nan;0;0
18120;143063;1877;36;33;6;27;.818;3547000;0
18120;143479;1877;0;0;0;0;.00nan;0;0
18121;9455;1477;98;29;0;29;1.000;3600000;0
18121;83983;4560;0;0;0;0;.00nan;0;0
18121;84287;1477;0;0;0;0;.00nan;0;0
18121;159851;4560;81;46;3;43;.935;3600000;0
18122;169226;1475;58;43;6;37;.860;3326000;0
18122;174589;523;0;0;0;0;.00nan;0;0
18122;73973;1475;48;0;0;0;.00nan;274000;0
18122;155529;523;57;24;3;21;.875;3600000;0
18123;177504;3922;0;0;0;0;.00nan;0;0
18123;89998;1854;55;20;2;18;.900;3900000;0
18123;143507;3922;76;34;2;32;.941;3900000;0
18123;152464;1854;0;0;0;0;.00nan;0;0
18124;177504;3922;35;33;6;27;.818;2273000;0
18124;169226;1475;65;17;1;16;.941;3600000;0
18124;73973;1475;0;0;0;0;.00nan;0;0
18124;143507;3922;65;25;2;23;.920;1327000;0
18125;168651;1871;81;23;1;22;.957;3600000;0
18125;143063;1877;0;0;0;0;.00nan;0;0
18125;143479;1877;51;30;6;24;.800;3600000;0
18125;151590;1871;0;0;0;0;.00nan;0;0
18126;8035;522;64;42;5;37;.881;3600000;0
18126;174589;523;0;0;0;0;.00nan;0;0
18126;155474;522;0;0;0;0;.00nan;0;0
18126;155529;523;42;19;4;15;.789;3600000;0
18127;9455;1477;71;24;2;22;.917;3600000;0
18127;206007;1481;62;38;4;34;.895;3514000;0
18127;221690;1481;0;0;0;0;.00nan;0;0
18127;84287;1477;0;0;0;0;.00nan;0;0
18128;8426;2193;30;23;5;18;.783;3589000;0
18128;179151;1869;68;39;4;35;.897;3600000;0
18128;191698;1869;0;0;0;0;.00nan;0;0
18128;68627;2193;0;0;0;0;.00nan;0;0
18129;185059;2173;69;29;2;27;.931;3600000;0
18129;64271;2173;0;0;0;0;.00nan;0;0
18129;89998;1854;0;0;0;0;.00nan;0;0
18129;152464;1854;49;25;4;21;.840;3600000;0
18130;184049;524;66;30;3;27;.900;3547000;0
18130;83983;4560;65;24;2;22;.917;3600000;0
18130;86686;524;0;0;0;0;.00nan;0;0
18130;159851;4560;0;0;0;0;.00nan;0;0
18131;8035;522;62;22;2;20;.909;3600000;0
18131;185059;2173;59;37;4;33;.892;3529000;0
18131;64271;2173;0;0;0;0;.00nan;0;0
18131;155474;522;0;0;0;0;.00nan;0;0
18132;89998;1854;51;24;3;21;.875;3514000;0
18132;143063;1877;91;31;1;30;.968;3600000;0
18132;143479;1877;0;0;0;0;.00nan;0;0
18132;152464;1854;0;0;0;0;.00nan;0;0
18133;184049;524;0;0;0;0;.00nan;0;0
18133;179151;1869;96;38;2;36;.947;3900000;0
18133;191698;1869;0;0;0;0;.00nan;0;0
18133;86686;524;71;27;2;25;.926;3900000;0
18134;8426;2193;0;0;0;0;.00nan;0;0
18134;168651;1871;89;26;1;25;.962;3600000;0
18134;68627;2193;73;30;3;27;.900;3571000;0
18134;151590;1871;0;0;0;0;.00nan;0;0
18135;9455;1477;0;0;0;0;.00nan;0;0
18135;169226;1475;93;27;1;26;.963;3600000;0
18135;73973;1475;0;0;0;0;.00nan;0;0
18135;84287;1477;58;41;5;36;.878;3600000;0
18136;206007;1481;98;56;3;53;.946;3600000;0
18136;174589;523;0;0;0;0;.00nan;0;0
18136;221690;1481;0;0;0;0;.00nan;0;0
18136;155529;523;82;14;0;14;1.000;3600000;0
18137;177504;3922;0;0;0;0;.00nan;0;0
18137;83983;4560;0;0;0;0;.00nan;0;0
18137;143507;3922;87;18;0;18;1.000;3600000;0
18137;159851;4560;93;34;1;33;.971;3593000;0
18138;169226;1475;61;12;1;11;.917;3600000;0
18138;185059;2173;48;36;6;30;.833;2916000;0
18138;64271;2173;52;7;1;6;.857;684000;0
18138;73973;1475;0;0;0;0;.00nan;0;0
18139;177504;3922;0;0;0;0;.00nan;0;0
18139;8035;522;88;36;2;34;.944;3600000;0
18139;143507;3922;59;26;3;23;.885;3600000;0
18139;155474;522;0;0;0;0;.00nan;0;0
18140;184049;524;0;0;0;0;.00nan;0;0
18140;206007;1481;92;18;0;18;1.000;3600000;0
18140;221690;1481;0;0;0;0;.00nan;0;0
18140;86686;524;83;29;1;28;.966;3577000;0
18141;168651;1871;49;29;4;25;.862;3600000;0
18141;179151;1869;21;10;4;6;.600;971000;0
18141;191698;1869;56;16;2;14;.875;2629000;0
18141;151590;1871;0;0;0;0;.00nan;0;0
18142;9455;1477;0;0;0;0;.00nan;0;0
18142;174589;523;0;0;0;0;.00nan;0;0
18142;84287;1477;49;33;5;28;.848;3600000;0
18142;155529;523;81;27;1;26;.963;3600000;0
18143;8426;2193;26;6;3;3;.500;339000;0
18143;68627;2193;81;30;2;28;.933;3261000;0
18143;89998;1854;0;0;0;0;.00nan;0;0
18143;152464;1854;77;28;2;26;.929;3600000;0
18144;83983;4560;89;33;1;32;.970;3600000;0
18144;143063;1877;0;0;0;0;.00nan;0;0
18144;143479;1877;65;22;2;20;.909;3599000;0
18144;159851;4560;0;0;0;0;.00nan;0;0
18145;168651;1871;78;24;1;23;.958;3600000;0
18145;89998;1854;86;50;4;46;.920;3600000;0
18145;151590;1871;0;0;0;0;.00nan;0;0
18145;152464;1854;0;0;0;0;.00nan;0;0
18146;185059;2173;0;0;0;0;.00nan;0;0
18146;64271;2173;99;19;0;19;1.000;3600000;0
18146;83983;4560;49;32;5;27;.844;3600000;0
18146;159851;4560;0;0;0;0;.00nan;0;0
18147;179151;1869;46;14;2;12;.857;3600000;0
18147;191698;1869;0;0;0;0;.00nan;0;0
18147;143063;1877;0;0;0;0;.00nan;0;0
18147;143479;1877;69;33;3;30;.909;3549000;0
18148;184049;524;77;42;3;39;.929;3570000;0
18148;169226;1475;52;13;2;11;.846;3600000;0
18148;73973;1475;0;0;0;0;.00nan;0;0
18148;86686;524;0;0;0;0;.00nan;0;0
18149;8426;2193;81;32;1;31;.969;3900000;0
18149;174589;523;0;0;0;0;.00nan;0;0
18149;68627;2193;0;0;0;0;.00nan;0;0
18149;155529;523;82;25;1;24;.960;3900000;0
18150;8035;522;69;43;5;38;.884;3600000;0
18150;9455;1477;88;18;0;18;1.000;3600000;0
18150;84287;1477;0;0;0;0;.00nan;0;0
18150;155474;522;0;0;0;0;.00nan;0;0
18151;177504;3922;0;0;0;0;.00nan;0;0
18151;206007;1481;91;32;1;31;.969;3600000;0
18151;221690;1481;0;0;0;0;.00nan;0;0
18151;143507;3922;64;32;3;29;.906;3580000;0
18152;168651;1871;69;7;0;7;1.000;3600000;0
18152;83983;4560;97;53;3;50;.943;3600000;0
18152;151590;1871;0;0;0;0;.00nan;0;0
18152;159851;4560;0;0;0;0;.00nan;0;0
18153;9455;1477;97;24;0;24;1.000;3600000;0
18153;185059;2173;0;0;0;0;.00nan;0;0
18153;64271;2173;70;29;2;27;.931;3560000;0
18153;84287;1477;0;0;0;0;.00nan;0;0
18154;206007;1481;54;15;2;13;.867;3600000;0
18154;221690;1481;0;0;0;0;.00nan;0;0
18154;143063;1877;70;36;4;32;.889;3558000;0
18154;143479;1877;0;0;0;0;.00nan;0;0
18155;184049;524;0;0;0;0;.00nan;0;0
18155;86686;524;81;34;2;32;.941;3600000;0
18155;89998;1854;100;21;0;21;1.000;3600000;0
18155;152464;1854;0;0;0;0;.00nan;0;0
18156;8035;522;59;45;5;40;.889;3531000;0
18156;8426;2193;52;25;3;22;.880;3600000;0
18156;68627;2193;0;0;0;0;.00nan;0;0
18156;155474;522;0;0;0;0;.00nan;0;0
18157;169226;1475;59;32;4;28;.875;3600000;0
18157;179151;1869;0;0;0;0;.00nan;0;0
18157;191698;1869;99;34;1;33;.971;3600000;0
18157;73973;1475;0;0;0;0;.00nan;0;0
18158;177504;3922;91;39;2;37;.949;3600000;0
18158;174589;523;0;0;0;0;.00nan;0;0
18158;143507;3922;0;0;0;0;.00nan;0;0
18158;155529;523;93;17;0;17;1.000;3600000;0
18159;168651;1871;78;32;2;30;.938;3600000;0
18159;169226;1475;93;36;1;35;.972;3600000;0
18159;73973;1475;0;0;0;0;.00nan;0;0
18159;151590;1871;0;0;0;0;.00nan;0;0
18160;8035;522;43;18;3;15;.833;3558000;0
18160;184049;524;72;27;2;25;.926;3600000;0
18160;86686;524;0;0;0;0;.00nan;0;0
18160;155474;522;0;0;0;0;.00nan;0;0
18161;206007;1481;94;31;1;30;.968;3900000;0
18161;221690;1481;0;0;0;0;.00nan;0;0
18161;185059;2173;90;37;1;36;.973;3900000;0
18161;64271;2173;0;0;0;0;.00nan;0;0
18162;177504;3922;64;42;5;37;.881;3525000;0
18162;9455;1477;62;29;3;26;.897;3600000;0
18162;84287;1477;0;0;0;0;.00nan;0;0
18162;143507;3922;0;0;0;0;.00nan;0;0
18163;174589;523;0;0;0;0;.00nan;0;0
18163;143063;1877;0;0;0;0;.00nan;0;0
18163;143479;1877;85;50;4;46;.920;3600000;0
18163;155529;523;78;8;0;8;1.000;3600000;0
18164;179151;1869;72;36;3;33;.917;3547000;0
18164;191698;1869;0;0;0;0;.00nan;0;0
18164;89998;1854;74;24;1;23;.958;3600000;0
18164;152464;1854;0;0;0;0;.00nan;0;0
18165;8426;2193;78;15;0;15;1.000;3600000;0
18165;68627;2193;0;0;0;0;.00nan;0;0
18165;83983;4560;0;0;0;0;.00nan;0;0
18165;159851;4560;83;41;4;37;.902;3600000;0
18166;8035;522;91;52;4;48;.923;3600000;0
18166;168651;1871;77;19;1;18;.947;3600000;0
18166;151590;1871;0;0;0;0;.00nan;0;0
18166;155474;522;0;0;0;0;.00nan;0;0
18167;177504;3922;0;0;0;0;.00nan;0;0
18167;185059;2173;0;0;0;0;.00nan;0;0
18167;64271;2173;91;36;2;34;.944;3600000;0
18167;143507;3922;64;26;3;23;.885;3547000;0
18168;169226;1475;82;16;0;16;1.000;3600000;0
18168;73973;1475;0;0;0;0;.00nan;0;0
18168;143063;1877;89;62;6;56;.903;3600000;0
18168;143479;1877;0;0;0;0;.00nan;0;0
18169;184049;524;0;0;0;0;.00nan;0;0
18169;174589;523;0;0;0;0;.00nan;0;0
18169;86686;524;37;28;5;23;.821;3600000;0
18169;155529;523;80;26;1;25;.962;3600000;0
18170;8426;2193;56;39;5;34;.872;3900000;0
18170;9455;1477;77;51;5;46;.902;3900000;0
18170;68627;2193;0;0;0;0;.00nan;0;0
18170;84287;1477;0;0;0;0;.00nan;0;0
18171;206007;1481;68;26;3;23;.885;3566000;0
18171;179151;1869;71;28;2;26;.929;3600000;0
18171;221690;1481;0;0;0;0;.00nan;0;0
18171;191698;1869;0;0;0;0;.00nan;0;0
18172;83983;4560;0;0;0;0;.00nan;0;0
18172;89998;1854;0;0;0;0;.00nan;0;0
18172;152464;1854;90;18;0;18;1.000;3600000;0
18172;159851;4560;75;34;3;31;.912;3600000;0
18173;169226;1475;100;26;0;26;1.000;3600000;0
18173;73973;1475;0;0;0;0;.00nan;0;0
18173;89998;1854;0;0;0;0;.00nan;0;0
18173;152464;1854;67;21;2;19;.905;3536000;0
18174;8035;522;64;24;2;22;.917;3600000;0
18174;143063;1877;68;32;3;29;.906;3581000;0
18174;143479;1877;0;0;0;0;.00nan;0;0
18174;155474;522;0;0;0;0;.00nan;0;0
18175;8426;2193;66;29;3;26;.897;3600000;0
18175;206007;1481;98;26;0;26;1.000;3600000;0
18175;221690;1481;0;0;0;0;.00nan;0;0
18175;68627;2193;0;0;0;0;.00nan;0;0
18176;9455;1477;70;35;4;31;.886;3569000;0
18176;184049;524;73;30;3;27;.900;3600000;0
18176;84287;1477;0;0;0;0;.00nan;0;0
18176;86686;524;0;0;0;0;.00nan;0;0
18177;174589;523;0;0;0;0;.00nan;0;0
18177;185059;2173;60;47;6;41;.872;3600000;0
18177;64271;2173;0;0;0;0;.00nan;0;0
18177;155529;523;98;24;0;24;1.000;3600000;0
18178;177504;3922;77;33;2;31;.939;3600000;0
18178;168651;1871;63;31;3;28;.903;3600000;0
18178;143507;3922;0;0;0;0;.00nan;0;0
18178;151590;1871;0;0;0;0;.00nan;0;0
18179;179151;1869;100;30;0;30;1.000;3600000;0
18179;191698;1869;0;0;0;0;.00nan;0;0
18179;83983;4560;98;46;2;44;.957;3578000;0
18179;159851;4560;0;0;0;0;.00nan;0;0
18180;168651;1871;77;32;2;30;.938;3649000;0
18180;174589;523;0;0;0;0;.00nan;0;0
18180;151590;1871;0;0;0;0;.00nan;0;0
18180;155529;523;81;22;1;21;.955;3649000;0
18181;185059;2173;66;25;2;23;.920;3600000;0
18181;64271;2173;0;0;0;0;.00nan;0;0
18181;143063;1877;51;25;4;21;.840;3567000;0
18181;143479;1877;0;0;0;0;.00nan;0;0
18182;177504;3922;43;17;3;14;.824;3600000;0
18182;184049;524;82;32;2;30;.938;3600000;0
18182;86686;524;0;0;0;0;.00nan;0;0
18182;143507;3922;0;0;0;0;.00nan;0;0
18183;8426;2193;57;33;3;30;.909;3900000;0
18183;169226;1475;62;32;3;29;.906;3900000;0
18183;68627;2193;0;0;0;0;.00nan;0;0
18183;73973;1475;0;0;0;0;.00nan;0;0
18184;9455;1477;49;30;5;25;.833;3600000;0
18184;179151;1869;85;28;1;27;.964;3600000;0
18184;191698;1869;0;0;0;0;.00nan;0;0
18184;84287;1477;0;0;0;0;.00nan;0;0
18185;206007;1481;73;46;5;41;.891;3600000;0
18185;221690;1481;0;0;0;0;.00nan;0;0
18185;89998;1854;25;28;6;22;.786;3570000;0
18185;152464;1854;0;0;0;0;.00nan;0;0
18186;8035;522;68;20;2;18;.900;3900000;0
18186;83983;4560;96;42;2;40;.952;3900000;0
18186;155474;522;0;0;0;0;.00nan;0;0
18186;159851;4560;0;0;0;0;.00nan;0;0
18187;169226;1475;0;0;0;0;.00nan;0;0
18187;73973;1475;59;15;1;14;.933;3600000;0
18187;83983;4560;89;25;0;25;1.000;1441000;0
18187;159851;4560;42;38;6;32;.842;2159000;0
18188;8035;522;0;0;0;0;.00nan;0;0
18188;89998;1854;0;0;0;0;.00nan;0;0
18188;152464;1854;71;7;0;7;1.000;3600000;0
18188;155474;522;45;29;4;25;.862;3600000;0
18189;184049;524;76;25;2;23;.920;3600000;0
18189;185059;2173;38;38;6;32;.842;3600000;0
18189;64271;2173;0;0;0;0;.00nan;0;0
18189;86686;524;0;0;0;0;.00nan;0;0
18190;168651;1871;59;31;4;27;.871;3551000;0
18190;206007;1481;74;38;3;35;.921;3600000;0
18190;221690;1481;0;0;0;0;.00nan;0;0
18190;151590;1871;0;0;0;0;.00nan;0;0
18191;9455;1477;74;33;2;31;.939;3551000;0
18191;84287;1477;0;0;0;0;.00nan;0;0
18191;143063;1877;76;23;1;22;.957;3600000;0
18191;143479;1877;0;0;0;0;.00nan;0;0
18192;179151;1869;38;20;4;16;.800;1069000;0
18192;174589;523;45;23;4;19;.826;3600000;0
18192;191698;1869;65;28;3;25;.893;2531000;0
18192;155529;523;0;0;0;0;.00nan;0;0
18193;177504;3922;92;37;2;35;.946;3900000;0
18193;8426;2193;74;27;2;25;.926;3900000;0
18193;68627;2193;0;0;0;0;.00nan;0;0
18193;143507;3922;0;0;0;0;.00nan;0;0
18194;169226;1475;90;32;2;30;.938;3900000;0
18194;206007;1481;96;52;2;50;.962;3900000;0
18194;221690;1481;0;0;0;0;.00nan;0;0
18194;73973;1475;0;0;0;0;.00nan;0;0
18195;168651;1871;67;19;1;18;.947;3600000;0
18195;185059;2173;91;46;2;44;.957;3585000;0
18195;64271;2173;0;0;0;0;.00nan;0;0
18195;151590;1871;0;0;0;0;.00nan;0;0
18196;177504;3922;0;0;0;0;.00nan;0;0
18196;143063;1877;74;28;3;25;.893;3564000;0
18196;143479;1877;0;0;0;0;.00nan;0;0
18196;143507;3922;73;32;2;30;.938;3600000;0
18197;8426;2193;0;0;0;0;.00nan;0;0
18197;184049;524;0;0;0;0;.00nan;0;0
18197;68627;2193;63;21;2;19;.905;3600000;0
18197;86686;524;94;47;3;44;.936;3551000;0
18198;8035;522;66;26;2;24;.923;3600000;0
18198;179151;1869;71;21;1;20;.952;3600000;0
18198;191698;1869;0;0;0;0;.00nan;0;0
18198;155474;522;0;0;0;0;.00nan;0;0
18199;9455;1477;97;33;1;32;.970;3624000;0
18199;84287;1477;0;0;0;0;.00nan;0;0
18199;89998;1854;75;28;2;26;.929;3624000;0
18199;152464;1854;0;0;0;0;.00nan;0;0
18200;174589;523;0;0;0;0;.00nan;0;0
18200;83983;4560;34;44;7;37;.841;2919000;0
18200;155529;523;65;14;1;13;.929;3600000;0
18200;159851;4560;66;8;0;8;1.000;681000;0
18201;8035;522;94;39;2;37;.949;3701000;0
18201;169226;1475;75;22;1;21;.955;3701000;0
18201;73973;1475;0;0;0;0;.00nan;0;0
18201;155474;522;0;0;0;0;.00nan;0;0
18202;8426;2193;31;15;4;11;.733;3809000;0
18202;185059;2173;0;0;0;0;.00nan;0;0
18202;64271;2173;60;45;5;40;.889;3809000;0
18202;68627;2193;0;0;0;0;.00nan;0;0
18203;184049;524;0;0;0;0;.00nan;0;0
18203;86686;524;100;29;0;29;1.000;3600000;0
18203;143063;1877;0;0;0;0;.00nan;0;0
18203;143479;1877;83;39;2;37;.949;3568000;0
18204;206007;1481;0;0;0;0;.00nan;0;0
18204;221690;1481;59;26;3;23;.885;3589000;0
18204;83983;4560;82;29;1;28;.966;3600000;0
18204;159851;4560;0;0;0;0;.00nan;0;0
18205;9455;1477;79;28;1;27;.964;3600000;0
18205;168651;1871;45;23;4;19;.826;3600000;0
18205;84287;1477;0;0;0;0;.00nan;0;0
18205;151590;1871;0;0;0;0;.00nan;0;0
18206;174589;523;0;0;0;0;.00nan;0;0
18206;89998;1854;0;0;0;0;.00nan;0;0
18206;152464;1854;98;19;0;19;1.000;3600000;0
18206;155529;523;50;33;5;28;.848;3600000;0
18207;177504;3922;100;26;0;26;1.000;3600000;0
18207;179151;1869;81;31;3;28;.903;3600000;0
18207;191698;1869;0;0;0;0;.00nan;0;0
18207;143507;3922;0;0;0;0;.00nan;0;0
18208;169226;1475;97;33;1;32;.970;3600000;0
18208;174589;523;0;0;0;0;.00nan;0;0
18208;73973;1475;0;0;0;0;.00nan;0;0
18208;155529;523;74;21;2;19;.905;3600000;0
18209;168651;1871;81;32;3;29;.906;3900000;0
18209;184049;524;0;0;0;0;.00nan;0;0
18209;86686;524;92;46;3;43;.935;3900000;0
18209;151590;1871;0;0;0;0;.00nan;0;0
18210;8426;2193;43;23;4;19;.826;3584000;0
18210;68627;2193;0;0;0;0;.00nan;0;0
18210;143063;1877;0;0;0;0;.00nan;0;0
18210;143479;1877;66;35;3;32;.914;3600000;0
18211;8035;522;97;29;1;28;.966;3600000;0
18211;206007;1481;55;30;4;26;.867;3600000;0
18211;221690;1481;0;0;0;0;.00nan;0;0
18211;155474;522;0;0;0;0;.00nan;0;0
18212;177504;3922;81;39;3;36;.923;3538000;0
18212;89998;1854;0;0;0;0;.00nan;0;0
18212;143507;3922;0;0;0;0;.00nan;0;0
18212;152464;1854;87;30;1;29;.967;3600000;0
18213;9455;1477;52;22;3;19;.864;3600000;0
18213;83983;4560;20;23;6;17;.739;2611000;0
18213;84287;1477;0;0;0;0;.00nan;0;0
18213;159851;4560;47;12;2;10;.833;989000;0
18214;179151;1869;95;36;2;34;.944;3600000;0
18214;185059;2173;54;28;4;24;.857;3566000;0
18214;191698;1869;0;0;0;0;.00nan;0;0
18214;64271;2173;0;0;0;0;.00nan;0;0
18215;185059;2173;59;34;4;30;.882;3600000;0
18215;64271;2173;0;0;0;0;.00nan;0;0
18215;89998;1854;84;34;2;32;.941;3600000;0
18215;152464;1854;0;0;0;0;.00nan;0;0
18216;168651;1871;67;16;1;15;.938;3600000;0
18216;143063;1877;97;45;3;42;.933;3520000;0
18216;143479;1877;0;0;0;0;.00nan;0;0
18216;151590;1871;0;0;0;0;.00nan;0;0
18217;184049;524;0;0;0;0;.00nan;0;0
18217;83983;4560;84;31;1;30;.968;3600000;0
18217;86686;524;36;25;5;20;.800;3600000;0
18217;159851;4560;0;0;0;0;.00nan;0;0
18218;8426;2193;65;24;2;22;.917;3600000;0
18218;179151;1869;83;46;4;42;.913;3600000;0
18218;191698;1869;0;0;0;0;.00nan;0;0
18218;68627;2193;0;0;0;0;.00nan;0;0
18219;9455;1477;86;18;0;18;1.000;3600000;0
18219;206007;1481;98;43;1;42;.977;3600000;0
18219;221690;1481;0;0;0;0;.00nan;0;0
18219;84287;1477;0;0;0;0;.00nan;0;0
18220;8035;522;92;48;3;45;.938;3900000;0
18220;174589;523;0;0;0;0;.00nan;0;0
18220;155474;522;0;0;0;0;.00nan;0;0
18220;155529;523;45;17;3;14;.824;3900000;0
18221;177504;3922;66;42;5;37;.881;3600000;0
18221;169226;1475;71;19;1;18;.947;3600000;0
18221;73973;1475;0;0;0;0;.00nan;0;0
18221;143507;3922;0;0;0;0;.00nan;0;0
18222;9455;1477;69;39;4;35;.897;3600000;0
18222;169226;1475;100;28;0;28;1.000;3600000;0
18222;73973;1475;0;0;0;0;.00nan;0;0
18222;84287;1477;0;0;0;0;.00nan;0;0
18223;8426;2193;53;28;4;24;.857;3600000;0
18223;168651;1871;51;22;3;19;.864;3600000;0
18223;68627;2193;0;0;0;0;.00nan;0;0
18223;151590;1871;0;0;0;0;.00nan;0;0
18224;8035;522;69;19;1;18;.947;3562000;0
18224;185059;2173;100;38;0;38;1.000;3600000;0
18224;64271;2173;0;0;0;0;.00nan;0;0
18224;155474;522;0;0;0;0;.00nan;0;0
18225;206007;1481;59;26;3;23;.885;3589000;0
18225;174589;523;0;0;0;0;.00nan;0;0
18225;221690;1481;0;0;0;0;.00nan;0;0
18225;155529;523;68;22;2;20;.909;3600000;0
18226;184049;524;0;0;0;0;.00nan;0;0
18226;179151;1869;59;17;2;15;.882;3900000;0
18226;191698;1869;0;0;0;0;.00nan;0;0
18226;86686;524;98;49;2;47;.959;3900000;0
18227;89998;1854;74;25;2;23;.920;3900000;0
18227;143063;1877;0;0;0;0;.00nan;0;0
18227;143479;1877;93;39;2;37;.949;3900000;0
18227;152464;1854;0;0;0;0;.00nan;0;0
18228;177504;3922;49;23;3;20;.870;3900000;0
18228;83983;4560;0;0;0;0;.00nan;0;0
18228;143507;3922;0;0;0;0;.00nan;0;0
18228;159851;4560;83;38;3;35;.921;3900000;0
18229;168651;1871;97;20;0;20;1.000;3600000;0
18229;179151;1869;66;34;3;31;.912;3600000;0
18229;191698;1869;0;0;0;0;.00nan;0;0
18229;151590;1871;0;0;0;0;.00nan;0;0
18230;169226;1475;59;12;1;11;.917;3600000;0
18230;185059;2173;23;13;4;9;.692;698000;0
18230;64271;2173;97;52;3;49;.942;2902000;0
18230;73973;1475;0;0;0;0;.00nan;0;0
18231;83983;4560;76;38;2;36;.947;3900000;0
18231;143063;1877;66;23;2;21;.913;3892000;0
18231;143479;1877;0;0;0;0;.00nan;0;0
18231;159851;4560;0;0;0;0;.00nan;0;0
18232;184049;524;80;38;3;35;.921;3559000;0
18232;206007;1481;77;20;1;19;.950;3600000;0
18232;221690;1481;0;0;0;0;.00nan;0;0
18232;86686;524;0;0;0;0;.00nan;0;0
18233;8426;2193;57;30;4;26;.867;3600000;0
18233;68627;2193;0;0;0;0;.00nan;0;0
18233;89998;1854;0;0;0;0;.00nan;0;0
18233;152464;1854;81;22;1;21;.955;3600000;0
18234;9455;1477;0;0;0;0;.00nan;0;0
18234;174589;523;0;0;0;0;.00nan;0;0
18234;84287;1477;54;41;6;35;.854;3544000;0
18234;155529;523;59;26;4;22;.846;3600000;0
18235;177504;3922;0;0;0;0;.00nan;0;0
18235;8035;522;78;28;1;27;.964;3600000;0
18235;143507;3922;59;27;3;24;.889;3523000;0
18235;155474;522;0;0;0;0;.00nan;0;0
18236;184049;524;38;18;4;14;.778;977000;0
18236;169226;1475;34;17;4;13;.765;3600000;0
18236;73973;1475;0;0;0;0;.00nan;0;0
18236;86686;524;82;36;3;33;.917;2623000;0
18237;8035;522;61;33;4;29;.879;3900000;0
18237;9455;1477;80;34;4;30;.882;3900000;0
18237;84287;1477;0;0;0;0;.00nan;0;0
18237;155474;522;0;0;0;0;.00nan;0;0
18238;177504;3922;0;0;0;0;.00nan;0;0
18238;206007;1481;0;0;0;0;.00nan;0;0
18238;221690;1481;73;33;3;30;.909;3545000;0
18238;143507;3922;74;21;2;19;.905;3600000;0
18239;179151;1869;87;29;1;28;.966;3550000;0
18239;191698;1869;0;0;0;0;.00nan;0;0
18239;143063;1877;0;0;0;0;.00nan;0;0
18239;143479;1877;100;39;0;39;1.000;3600000;0
18240;8426;2193;60;34;4;30;.882;3550000;0
18240;174589;523;0;0;0;0;.00nan;0;0
18240;68627;2193;0;0;0;0;.00nan;0;0
18240;155529;523;75;30;2;28;.933;3600000;0
18241;168651;1871;74;22;1;21;.955;3600000;0
18241;89998;1854;56;32;4;28;.875;3600000;0
18241;151590;1871;0;0;0;0;.00nan;0;0
18241;152464;1854;0;0;0;0;.00nan;0;0
18242;185059;2173;66;32;3;29;.906;3554000;0
18242;64271;2173;0;0;0;0;.00nan;0;0
18242;83983;4560;0;0;0;0;.00nan;0;0
18242;159851;4560;66;26;2;24;.923;3600000;0
18244;177504;3922;94;43;1;42;.977;3600000;0
18244;174589;523;62;18;2;16;.889;3587000;0
18244;179830;523;0;0;0;0;.00nan;0;0
18244;143507;3922;0;0;0;0;.00nan;0;0
18246;167036;1475;67;24;2;22;.917;3600000;0
18246;73973;1475;0;0;0;0;.00nan;0;0
18246;89998;1854;71;46;6;40;.870;3600000;0
18246;152464;1854;0;0;0;0;.00nan;0;0
18248;8426;2193;68;20;1;19;.950;3600000;0
18248;68627;2193;0;0;0;0;.00nan;0;0
18248;143063;1877;56;5;0;5;1.000;345000;0
18248;143479;1877;65;49;6;43;.878;3255000;0
18250;9455;1477;26;7;3;4;.571;325000;0
18250;174581;524;93;30;1;29;.967;3600000;0
18250;80859;524;0;0;0;0;.00nan;0;0
18250;84287;1477;70;33;3;30;.909;3275000;0
18252;206007;1481;0;0;0;0;.00nan;0;0
18252;221690;1481;67;18;1;17;.944;3600000;0
18252;83983;4560;55;38;5;33;.868;2072000;0
18252;159851;4560;59;16;1;15;.938;1528000;0
18254;8035;522;50;17;2;15;.882;3564000;0
18254;185059;2173;77;20;1;19;.950;3600000;0
18254;64271;2173;0;0;0;0;.00nan;0;0
18254;155474;522;0;0;0;0;.00nan;0;0
18256;7332;1869;0;0;0;0;.00nan;0;0
18256;191698;1869;75;22;1;21;.955;3600000;0
18256;151590;1871;0;0;0;0;.00nan;0;0
18256;152480;1871;53;28;3;25;.893;3515000;0
18258;7332;1869;70;30;2;28;.933;3900000;0
18258;174589;523;0;0;0;0;.00nan;0;0
18258;179830;523;99;36;2;34;.944;3900000;0
18258;191698;1869;0;0;0;0;.00nan;0;0
18260;167036;1475;0;0;0;0;.00nan;0;0
18260;73973;1475;48;11;2;9;.818;3600000;0
18260;83983;4560;0;0;0;0;.00nan;0;0
18260;159851;4560;88;48;3;45;.938;3600000;0
18262;9455;1477;90;15;0;15;1.000;3600000;0
18262;84287;1477;0;0;0;0;.00nan;0;0
18262;89998;1854;0;0;0;0;.00nan;0;0
18262;152464;1854;74;35;3;32;.914;3600000;0
18264;8035;522;0;0;0;0;.00nan;0;0
18264;174581;524;0;0;0;0;.00nan;0;0
18264;80859;524;65;25;2;23;.920;3565000;0
18264;155474;522;79;25;1;24;.960;3600000;0
18266;177504;3922;85;25;1;24;.960;2984000;0
18266;143507;3922;37;19;4;15;.789;916000;0
18266;151590;1871;35;24;5;19;.792;3900000;0
18266;152480;1871;0;0;0;0;.00nan;0;0
18268;8426;2193;0;0;0;0;.00nan;0;0
18268;185059;2173;0;0;0;0;.00nan;0;0
18268;64271;2173;39;40;7;33;.825;3600000;0
18268;68627;2193;60;23;3;20;.870;3600000;0
18270;206007;1481;66;25;2;23;.920;3600000;0
18270;221690;1481;0;0;0;0;.00nan;0;0
18270;143063;1877;84;42;4;38;.905;3600000;0
18270;143479;1877;0;0;0;0;.00nan;0;0
18272;177504;3922;86;29;1;28;.966;3600000;0
18272;9455;1477;71;28;2;26;.929;3600000;0
18272;84287;1477;0;0;0;0;.00nan;0;0
18272;143507;3922;0;0;0;0;.00nan;0;0
18274;174581;524;77;42;4;38;.905;3544000;0
18274;80859;524;0;0;0;0;.00nan;0;0
18274;151590;1871;0;0;0;0;.00nan;0;0
18274;152480;1871;60;21;2;19;.905;3600000;0
18276;83983;4560;33;22;5;17;.773;3600000;0
18276;143063;1877;81;31;2;29;.935;3600000;0
18276;143479;1877;0;0;0;0;.00nan;0;0
18276;159851;4560;0;0;0;0;.00nan;0;0
18278;167036;1475;53;15;2;13;.867;3900000;0
18278;206007;1481;0;0;0;0;.00nan;0;0
18278;221690;1481;98;55;2;53;.964;3900000;0
18278;73973;1475;0;0;0;0;.00nan;0;0
18280;8426;2193;62;24;2;22;.917;3600000;0
18280;68627;2193;0;0;0;0;.00nan;0;0
18280;89998;1854;61;45;5;40;.889;3600000;0
18280;152464;1854;0;0;0;0;.00nan;0;0
18282;7332;1869;61;33;4;29;.879;2620000;0
18282;174589;523;77;14;0;14;1.000;3600000;0
18282;179830;523;0;0;0;0;.00nan;0;0
18282;191698;1869;40;20;4;16;.800;980000;0
18284;8035;522;88;18;0;18;1.000;3600000;0
18284;185059;2173;75;26;1;25;.962;3600000;0
18284;64271;2173;0;0;0;0;.00nan;0;0
18284;155474;522;0;0;0;0;.00nan;0;0
18286;167036;1475;0;0;0;0;.00nan;0;0
18286;177504;3922;52;2;0;2;1.000;355000;0
18286;73973;1475;54;23;3;20;.870;3600000;0
18286;143507;3922;38;34;6;28;.824;3245000;0
18288;8035;522;58;42;6;36;.857;3600000;0
18288;151590;1871;83;24;1;23;.958;3600000;0
18288;152480;1871;0;0;0;0;.00nan;0;0
18288;155474;522;0;0;0;0;.00nan;0;0
18290;185059;2173;52;17;2;15;.882;2616000;0
18290;64271;2173;22;13;4;9;.692;984000;0
18290;89998;1854;0;0;0;0;.00nan;0;0
18290;152464;1854;70;33;3;30;.909;3600000;0
18292;7332;1869;0;0;0;0;.00nan;0;0
18292;8426;2193;0;0;0;0;.00nan;0;0
18292;191698;1869;54;33;4;29;.879;3687000;0
18292;68627;2193;41;30;5;25;.833;3687000;0
18294;174589;523;64;25;3;22;.880;3900000;0
18294;179830;523;0;0;0;0;.00nan;0;0
18294;143063;1877;0;0;0;0;.00nan;0;0
18294;143479;1877;97;55;3;52;.945;3900000;0
18296;206007;1481;49;23;4;19;.826;3567000;0
18296;174581;524;0;0;0;0;.00nan;0;0
18296;221690;1481;0;0;0;0;.00nan;0;0
18296;80859;524;66;32;3;29;.906;3600000;0
18298;9455;1477;0;0;0;0;.00nan;0;0
18298;83983;4560;0;0;0;0;.00nan;0;0
18298;84287;1477;73;20;1;19;.950;3600000;0
18298;159851;4560;86;51;3;48;.941;3561000;0
18300;8426;2193;76;10;0;10;1.000;3600000;0
18300;68627;2193;0;0;0;0;.00nan;0;0
18300;83983;4560;0;0;0;0;.00nan;0;0
18300;159851;4560;84;47;3;44;.936;3600000;0
18302;8035;522;96;37;1;36;.973;3600000;0
18302;185059;2173;57;22;3;19;.864;3557000;0
18302;64271;2173;0;0;0;0;.00nan;0;0
18302;155474;522;0;0;0;0;.00nan;0;0
18304;167036;1475;0;0;0;0;.00nan;0;0
18304;177504;3922;45;30;5;25;.833;3600000;0
18304;73973;1475;88;33;1;32;.970;3600000;0
18304;143507;3922;0;0;0;0;.00nan;0;0
18306;9455;1477;70;27;3;24;.889;3544000;0
18306;84287;1477;0;0;0;0;.00nan;0;0
18306;89998;1854;81;33;2;31;.939;3600000;0
18306;152464;1854;0;0;0;0;.00nan;0;0
18308;206007;1481;0;0;0;0;.00nan;0;0
18308;174581;524;100;25;0;25;1.000;3600000;0
18308;221690;1481;68;28;2;26;.929;3533000;0
18308;80859;524;0;0;0;0;.00nan;0;0
18310;143063;1877;76;29;1;28;.966;3558000;0
18310;143479;1877;0;0;0;0;.00nan;0;0
18310;151590;1871;100;33;0;33;1.000;3600000;0
18310;152480;1871;0;0;0;0;.00nan;0;0
18312;7332;1869;0;0;0;0;.00nan;0;0
18312;174589;523;0;0;0;0;.00nan;0;0
18312;179830;523;55;13;2;11;.846;3600000;0
18312;191698;1869;56;31;4;27;.871;3581000;0
18314;167036;1475;0;0;0;0;.00nan;0;0
18314;7332;1869;53;31;4;27;.871;2488000;0
18314;191698;1869;26;14;4;10;.714;1112000;0
18314;73973;1475;65;27;2;25;.926;3600000;0
18316;9455;1477;46;33;5;28;.848;3600000;0
18316;174581;524;95;40;2;38;.950;3600000;0
18316;80859;524;0;0;0;0;.00nan;0;0
18316;84287;1477;0;0;0;0;.00nan;0;0
18318;174589;523;63;24;2;22;.917;3542000;0
18318;179830;523;0;0;0;0;.00nan;0;0
18318;89998;1854;0;0;0;0;.00nan;0;0
18318;152464;1854;93;41;1;40;.976;3600000;0
18320;177504;3922;100;24;0;24;1.000;3600000;0
18320;185059;2173;54;44;6;38;.864;3600000;0
18320;64271;2173;0;0;0;0;.00nan;0;0
18320;143507;3922;0;0;0;0;.00nan;0;0
18322;8426;2193;57;12;1;11;.917;3600000;0
18322;68627;2193;0;0;0;0;.00nan;0;0
18322;83983;4560;0;0;0;0;.00nan;0;0
18322;159851;4560;85;46;3;43;.935;3600000;0
18324;8035;522;100;24;0;24;1.000;3600000;0
18324;143063;1877;0;0;0;0;.00nan;0;0
18324;143479;1877;87;29;1;28;.966;3600000;0
18324;155474;522;0;0;0;0;.00nan;0;0
18326;206007;1481;22;35;7;28;.800;2567000;0
18326;221690;1481;59;8;0;8;1.000;1033000;0
18326;151590;1871;84;13;0;13;1.000;3600000;0
18326;152480;1871;0;0;0;0;.00nan;0;0
18328;206007;1481;0;0;0;0;.00nan;0;0
18328;174581;524;0;0;0;0;.00nan;0;0
18328;221690;1481;82;25;1;24;.960;3600000;0
18328;80859;524;83;34;2;32;.941;3571000;0
18330;7332;1869;0;0;0;0;.00nan;0;0
18330;185059;2173;0;0;0;0;.00nan;0;0
18330;191698;1869;80;32;2;30;.938;3900000;0
18330;64271;2173;65;27;2;25;.926;3900000;0
18332;83983;4560;80;41;3;38;.927;3600000;0
18332;89998;1854;59;13;2;11;.846;3600000;0
18332;152464;1854;0;0;0;0;.00nan;0;0
18332;159851;4560;0;0;0;0;.00nan;0;0
18334;167036;1475;58;13;1;12;.923;3600000;0
18334;73973;1475;0;0;0;0;.00nan;0;0
18334;143063;1877;75;41;5;36;.878;3600000;0
18334;143479;1877;0;0;0;0;.00nan;0;0
18336;174589;523;0;0;0;0;.00nan;0;0
18336;179830;523;47;24;4;20;.833;3576000;0
18336;151590;1871;78;33;2;31;.939;3600000;0
18336;152480;1871;0;0;0;0;.00nan;0;0
18338;8426;2193;0;0;0;0;.00nan;0;0
18338;9455;1477;0;0;0;0;.00nan;0;0
18338;68627;2193;90;20;0;20;1.000;3600000;0
18338;84287;1477;82;48;4;44;.917;3600000;0
18340;177504;3922;78;26;1;25;.962;3588000;0
18340;8035;522;100;31;0;31;1.000;3600000;0
18340;143507;3922;0;0;0;0;.00nan;0;0
18340;155474;522;0;0;0;0;.00nan;0;0
981;9455;1477;42;25;4;21;.840;3600000;0
981;174589;523;0;0;0;0;.00nan;0;0
981;84287;1477;0;0;0;0;.00nan;0;0
981;155529;523;70;20;1;19;.950;3600000;0
982;169226;1475;51;31;4;27;.871;3518000;0
982;73973;1475;0;0;0;0;.00nan;0;0
982;89998;1854;0;0;0;0;.00nan;0;0
982;152464;1854;73;29;2;27;.931;3600000;0
983;168651;1871;36;34;6;28;.824;3752000;0
983;179151;1869;68;41;5;36;.878;3736000;0
983;191698;1869;0;0;0;0;.00nan;0;0
983;151590;1871;0;0;0;0;.00nan;0;0
984;8426;2193;42;23;4;19;.826;3600000;0
984;206007;1481;100;42;1;41;.976;3600000;0
984;221690;1481;0;0;0;0;.00nan;0;0
984;68627;2193;0;0;0;0;.00nan;0;0
985;9455;1477;60;49;6;43;.878;3051000;0
985;174589;523;0;0;0;0;.00nan;0;0
985;84287;1477;54;7;0;7;1.000;549000;0
985;155529;523;94;19;0;19;1.000;3600000;0
986;169226;1475;94;37;2;35;.946;3600000;0
986;73973;1475;0;0;0;0;.00nan;0;0
986;89998;1854;29;26;6;20;.769;3068000;0
986;152464;1854;45;5;1;4;.800;532000;0
987;168651;1871;82;28;1;27;.964;3600000;0
987;179151;1869;89;40;3;37;.925;3562000;0
987;191698;1869;0;0;0;0;.00nan;0;0
987;151590;1871;0;0;0;0;.00nan;0;0
988;8426;2193;62;24;3;21;.875;3600000;0
988;206007;1481;100;37;1;36;.973;3600000;0
988;221690;1481;0;0;0;0;.00nan;0;0
988;68627;2193;0;0;0;0;.00nan;0;0
989;9455;1477;59;39;5;34;.872;3580000;0
989;174589;523;0;0;0;0;.00nan;0;0
989;84287;1477;0;0;0;0;.00nan;0;0
989;155529;523;45;21;4;17;.810;3600000;0
990;169226;1475;100;35;0;35;1.000;3600000;0
990;73973;1475;0;0;0;0;.00nan;0;0
990;89998;1854;55;25;3;22;.880;3600000;0
990;152464;1854;0;0;0;0;.00nan;0;0
991;168651;1871;44;24;4;20;.833;3545000;0
991;179151;1869;79;36;3;33;.917;3600000;0
991;191698;1869;0;0;0;0;.00nan;0;0
991;151590;1871;0;0;0;0;.00nan;0;0
992;8426;2193;83;32;1;31;.969;5306000;0
992;206007;1481;92;65;2;63;.969;5306000;0
992;221690;1481;0;0;0;0;.00nan;0;0
992;68627;2193;0;0;0;0;.00nan;0;0
1213;169226;1475;52;27;3;24;.889;3543000;0
1213;73973;1475;0;0;0;0;.00nan;0;0
1213;89998;1854;70;26;2;24;.923;3600000;0
1213;152464;1854;0;0;0;0;.00nan;0;0
1214;168651;1871;48;33;5;28;.848;3600000;0
1214;179151;1869;100;26;0;26;1.000;3600000;0
1214;191698;1869;0;0;0;0;.00nan;0;0
1214;151590;1871;0;0;0;0;.00nan;0;0
1215;8426;2193;80;13;0;13;1.000;3600000;0
1215;206007;1481;71;37;2;35;.946;3575000;0
1215;221690;1481;0;0;0;0;.00nan;0;0
1215;68627;2193;0;0;0;0;.00nan;0;0
1314;169226;1475;61;14;1;13;.929;3600000;0
1314;73973;1475;0;0;0;0;.00nan;0;0
1314;89998;1854;71;25;2;23;.920;3554000;0
1314;152464;1854;0;0;0;0;.00nan;0;0
1315;8426;2193;27;23;5;18;.783;3600000;0
1315;206007;1481;71;36;4;32;.889;3600000;0
1315;221690;1481;0;0;0;0;.00nan;0;0
1315;68627;2193;0;0;0;0;.00nan;0;0
1396;179151;1869;84;54;5;49;.907;3600000;0
1396;174589;523;0;0;0;0;.00nan;0;0
1396;191698;1869;0;0;0;0;.00nan;0;0
1396;155529;523;84;16;0;16;1.000;3600000;0
1397;169226;1475;86;15;0;15;1.000;3600000;0
1397;206007;1481;76;39;4;35;.897;3600000;0
1397;221690;1481;0;0;0;0;.00nan;0;0
1397;73973;1475;0;0;0;0;.00nan;0;0
1398;179151;1869;88;51;3;48;.941;3810000;0
1398;174589;523;0;0;0;0;.00nan;0;0
1398;191698;1869;0;0;0;0;.00nan;0;0
1398;155529;523;46;24;4;20;.833;3810000;0
1399;169226;1475;61;30;4;26;.867;3526000;0
1399;206007;1481;95;38;2;36;.947;3600000;0
1399;221690;1481;0;0;0;0;.00nan;0;0
1399;73973;1475;0;0;0;0;.00nan;0;0
1400;179151;1869;82;38;3;35;.921;3600000;0
1400;174589;523;62;9;0;9;1.000;2382000;0
1400;191698;1869;0;0;0;0;.00nan;0;0
1400;155529;523;30;15;4;11;.733;1183000;0
1401;169226;1475;100;21;0;21;1.000;3600000;0
1401;206007;1481;28;13;4;9;.692;1766000;0
1401;221690;1481;59;27;3;24;.889;1834000;0
1401;73973;1475;0;0;0;0;.00nan;0;0
1402;179151;1869;100;55;4;51;.927;4428000;0
1402;174589;523;0;0;0;0;.00nan;0;0
1402;191698;1869;0;0;0;0;.00nan;0;0
1402;155529;523;57;37;5;32;.865;4428000;0
1403;169226;1475;60;34;4;30;.882;3548000;0
1403;206007;1481;76;36;3;33;.917;3600000;0
1403;221690;1481;0;0;0;0;.00nan;0;0
1403;73973;1475;0;0;0;0;.00nan;0;0
1612;179151;1869;78;42;3;39;.929;3600000;0
1612;174589;523;0;0;0;0;.00nan;0;0
1612;191698;1869;0;0;0;0;.00nan;0;0
1612;155529;523;100;18;0;18;1.000;3600000;0
1613;169226;1475;57;18;2;16;.889;3600000;0
1613;206007;1481;89;41;3;38;.927;3600000;0
1613;221690;1481;0;0;0;0;.00nan;0;0
1613;73973;1475;0;0;0;0;.00nan;0;0
1669;179151;1869;55;28;4;24;.857;3600000;0
1669;174589;523;0;0;0;0;.00nan;0;0
1669;191698;1869;0;0;0;0;.00nan;0;0
1669;155529;523;97;38;1;37;.974;3600000;0
1670;169226;1475;66;22;2;20;.909;3780000;0
1670;206007;1481;99;43;1;42;.977;3780000;0
1670;221690;1481;0;0;0;0;.00nan;0;0
1670;73973;1475;0;0;0;0;.00nan;0;0
1785;179151;1869;63;33;3;30;.909;3600000;0
1785;174589;523;0;0;0;0;.00nan;0;0
1785;191698;1869;0;0;0;0;.00nan;0;0
1785;155529;523;96;22;0;22;1.000;3600000;0
1786;169226;1475;54;29;4;25;.862;3555000;0
1786;206007;1481;94;39;2;37;.949;3600000;0
1786;221690;1481;0;0;0;0;.00nan;0;0
1786;73973;1475;0;0;0;0;.00nan;0;0
1824;206007;1481;70;29;3;26;.897;3544000;0
1824;174589;523;0;0;0;0;.00nan;0;0
1824;221690;1481;0;0;0;0;.00nan;0;0
1824;155529;523;56;18;2;16;.889;3600000;0
1825;206007;1481;27;34;7;27;.794;3282000;0
1825;174589;523;0;0;0;0;.00nan;0;0
1825;221690;1481;54;5;0;5;1.000;318000;0
1825;155529;523;93;17;0;17;1.000;3600000;0
1826;206007;1481;65;38;4;34;.895;4215000;0
1826;174589;523;0;0;0;0;.00nan;0;0
1826;221690;1481;0;0;0;0;.00nan;0;0
1826;155529;523;54;24;3;21;.875;4215000;0
1827;206007;1481;100;29;0;29;1.000;3600000;0
1827;174589;523;0;0;0;0;.00nan;0;0
1827;221690;1481;0;0;0;0;.00nan;0;0
1827;155529;523;71;18;1;17;.944;3577000;0
1978;206007;1481;60;35;4;31;.886;3600000;0
1978;174589;523;0;0;0;0;.00nan;0;0
1978;221690;1481;0;0;0;0;.00nan;0;0
1978;155529;523;86;25;1;24;.960;3600000;0
18341;203759;1927;0;0;0;0;.00nan;0;0
18341;206136;1927;76;23;1;22;.957;3600000;0
18341;-1;4794;30;15;4;11;.733;1635000;0
18341;197059;4794;29;28;6;22;.786;1965000;0
18342;206110;1923;56;34;5;29;.853;3516000;0
18342;-1;1923;0;0;0;0;.00nan;0;0
18342;53966;1925;74;31;3;28;.903;3600000;0
18342;89223;1925;0;0;0;0;.00nan;0;0
18343;166545;1935;0;0;0;0;.00nan;0;0
18343;-1;1935;48;23;4;19;.826;3796000;0
18343;239843;5013;95;48;3;45;.938;3787000;0
18343;239844;5013;0;0;0;0;.00nan;0;0
18344;163361;1934;54;37;5;32;.865;2873000;0
18344;178950;1934;19;9;4;5;.556;727000;0
18344;-1;2284;68;20;1;19;.950;3600000;0
18344;160661;2284;0;0;0;0;.00nan;0;0
18345;224720;1930;0;0;0;0;.00nan;0;0
18345;9597;2632;0;0;0;0;.00nan;0;0
18345;216592;2632;91;49;2;47;.959;3600000;0
18345;-1;1930;56;29;3;26;.897;3544000;0
18346;224720;1930;0;0;0;0;.00nan;0;0
18346;-1;1930;42;30;5;25;.833;3838000;0
18346;239843;5013;0;0;0;0;.00nan;0;0
18346;239844;5013;28;29;6;23;.793;3838000;0
18347;11438;2557;62;15;1;14;.933;3600000;0
18347;-1;2557;0;0;0;0;.00nan;0;0
18347;53966;1925;60;42;4;38;.905;3600000;0
18347;89223;1925;0;0;0;0;.00nan;0;0
18348;164323;579;0;0;0;0;.00nan;0;0
18348;206110;1923;44;40;6;34;.850;3600000;0
18348;190423;579;98;20;0;20;1.000;3600000;0
18348;-1;1923;0;0;0;0;.00nan;0;0
18349;166545;1935;51;28;4;24;.857;3900000;0
18349;9597;2632;0;0;0;0;.00nan;0;0
18349;-1;1935;0;0;0;0;.00nan;0;0
18349;216592;2632;61;43;4;39;.907;3900000;0
18350;163361;1934;0;0;0;0;.00nan;0;0
18350;164323;579;0;0;0;0;.00nan;0;0
18350;178950;1934;83;38;4;34;.895;3600000;0
18350;190423;579;49;33;5;28;.848;3544000;0
18351;163361;1934;64;33;4;29;.879;3600000;0
18351;11438;2557;19;31;7;24;.774;3600000;0
18351;178950;1934;0;0;0;0;.00nan;0;0
18351;-1;2557;0;0;0;0;.00nan;0;0
18352;-1;2284;53;25;3;22;.880;3600000;0
18352;160661;2284;0;0;0;0;.00nan;0;0
18352;239843;5013;28;34;7;27;.794;2592000;0
18352;239844;5013;63;22;3;19;.864;1008000;0
18353;-1;4794;0;0;0;0;.00nan;0;0
18353;197059;4794;69;31;2;29;.935;3868000;0
18353;239843;5013;70;29;3;26;.897;3861000;0
18353;239844;5013;0;0;0;0;.00nan;0;0
18354;164323;579;0;0;0;0;.00nan;0;0
18354;11438;2557;0;0;0;0;.00nan;0;0
18354;190423;579;64;34;3;31;.912;3600000;0
18354;-1;2557;45;23;4;19;.826;3575000;0
18355;166545;1935;56;61;8;53;.869;3294000;0
18355;-1;1935;41;4;1;3;.750;240000;0
18355;-1;2284;46;6;1;5;.833;1476000;0
18355;160661;2284;16;22;6;16;.727;2124000;0
18356;9597;2632;55;13;1;12;.923;1001000;0
18356;206110;1923;48;16;3;13;.813;3600000;0
18356;216592;2632;34;34;6;28;.824;2599000;0
18356;-1;1923;0;0;0;0;.00nan;0;0
18357;224720;1930;0;0;0;0;.00nan;0;0
18357;-1;1930;88;38;3;35;.921;3600000;0
18357;53966;1925;41;30;5;25;.833;3600000;0
18357;89223;1925;0;0;0;0;.00nan;0;0
18358;203759;1927;35;6;2;4;.667;555000;0
18358;206136;1927;35;25;5;20;.800;3045000;0
18358;53966;1925;0;0;0;0;.00nan;0;0
18358;89223;1925;74;34;2;32;.941;3600000;0
18359;164323;579;75;29;2;27;.931;3600000;0
18359;206110;1923;0;0;0;0;.00nan;0;0
18359;190423;579;0;0;0;0;.00nan;0;0
18359;-1;1923;55;27;4;23;.852;3557000;0
18360;166545;1935;83;48;3;45;.938;3900000;0
18360;164323;579;0;0;0;0;.00nan;0;0
18360;-1;1935;0;0;0;0;.00nan;0;0
18360;190423;579;88;40;3;37;.925;3900000;0
18361;224720;1930;0;0;0;0;.00nan;0;0
18361;203759;1927;0;0;0;0;.00nan;0;0
18361;206136;1927;65;38;4;34;.895;3600000;0
18361;-1;1930;99;37;1;36;.973;3600000;0
18362;9597;2632;66;39;4;35;.897;2747000;0
18362;216592;2632;25;14;4;10;.714;853000;0
18362;239843;5013;71;38;3;35;.921;3600000;0
18362;239844;5013;0;0;0;0;.00nan;0;0
18363;11438;2557;72;37;4;33;.892;3600000;0
18363;-1;2284;65;38;5;33;.868;3580000;0
18363;-1;2557;0;0;0;0;.00nan;0;0
18363;160661;2284;0;0;0;0;.00nan;0;0
18364;-1;4794;28;8;3;5;.625;973000;0
18364;197059;4794;1;24;10;14;.583;2627000;0
18364;53966;1925;70;36;3;33;.917;3600000;0
18364;89223;1925;0;0;0;0;.00nan;0;0
18365;11438;2557;0;0;0;0;.00nan;0;0
18365;-1;2557;21;25;6;19;.760;3574000;0
18365;239843;5013;0;0;0;0;.00nan;0;0
18365;239844;5013;52;34;5;29;.853;3600000;0
18366;166545;1935;66;34;3;31;.912;3600000;0
18366;224720;1930;0;0;0;0;.00nan;0;0
18366;-1;1935;0;0;0;0;.00nan;0;0
18366;-1;1930;48;28;4;24;.857;3578000;0
18367;163361;1934;0;0;0;0;.00nan;0;0
18367;9597;2632;0;0;0;0;.00nan;0;0
18367;178950;1934;80;34;2;32;.941;3600000;0
18367;216592;2632;47;41;6;35;.854;3600000;0
18368;206110;1923;53;27;4;23;.852;3600000;0
18368;-1;4794;0;0;0;0;.00nan;0;0
18368;197059;4794;30;29;6;23;.793;3569000;0
18368;-1;1923;0;0;0;0;.00nan;0;0
18369;224720;1930;0;0;0;0;.00nan;0;0
18369;-1;1930;95;40;2;38;.950;3900000;0
18369;-1;4794;0;0;0;0;.00nan;0;0
18369;197059;4794;78;28;2;26;.929;3900000;0
18370;53966;1925;71;24;1;23;.958;3600000;0
18370;89223;1925;0;0;0;0;.00nan;0;0
18370;239843;5013;43;27;4;23;.852;3600000;0
18370;239844;5013;0;0;0;0;.00nan;0;0
18371;9597;2632;0;0;0;0;.00nan;0;0
18371;216592;2632;48;31;5;26;.839;3600000;0
18371;-1;2284;66;18;1;17;.944;3600000;0
18371;160661;2284;0;0;0;0;.00nan;0;0
18372;9597;2632;0;0;0;0;.00nan;0;0
18372;216592;2632;91;31;1;30;.968;3600000;0
18372;-1;4794;0;0;0;0;.00nan;0;0
18372;197059;4794;62;21;2;19;.905;3547000;0
18373;166545;1935;71;40;3;37;.925;3600000;0
18373;11438;2557;17;19;6;13;.684;3600000;0
18373;-1;1935;0;0;0;0;.00nan;0;0
18373;-1;2557;0;0;0;0;.00nan;0;0
18374;206110;1923;42;23;5;18;.783;3123000;0
18374;-1;1923;52;7;1;6;.857;652000;0
18374;239843;5013;0;0;0;0;.00nan;0;0
18374;239844;5013;40;31;5;26;.839;3775000;0
18375;203759;1927;0;0;0;0;.00nan;0;0
18375;163361;1934;88;50;5;45;.900;3600000;0
18375;178950;1934;0;0;0;0;.00nan;0;0
18375;206136;1927;58;19;2;17;.895;3600000;0
18376;224720;1930;0;0;0;0;.00nan;0;0
18376;-1;1930;69;43;4;39;.907;3600000;0
18376;-1;2284;34;23;5;18;.783;3579000;0
18376;160661;2284;0;0;0;0;.00nan;0;0
18377;203759;1927;0;0;0;0;.00nan;0;0
18377;164323;579;0;0;0;0;.00nan;0;0
18377;206136;1927;53;18;2;16;.889;3600000;0
18377;190423;579;54;40;5;35;.875;3600000;0
18378;166545;1935;92;42;3;39;.929;3900000;0
18378;203759;1927;0;0;0;0;.00nan;0;0
18378;-1;1935;0;0;0;0;.00nan;0;0
18378;206136;1927;80;31;3;28;.903;3900000;0
18379;9597;2632;0;0;0;0;.00nan;0;0
18379;216592;2632;62;56;6;50;.893;3600000;0
18379;53966;1925;51;19;2;17;.895;3600000;0
18379;89223;1925;0;0;0;0;.00nan;0;0
18380;163361;1934;0;0;0;0;.00nan;0;0
18380;11438;2557;0;0;0;0;.00nan;0;0
18380;178950;1934;48;44;6;38;.864;3554000;0
18380;-1;2557;44;22;4;18;.818;3600000;0
18381;206110;1923;63;39;5;34;.872;3900000;0
18381;-1;2284;45;26;5;21;.808;3900000;0
18381;-1;1923;0;0;0;0;.00nan;0;0
18381;160661;2284;0;0;0;0;.00nan;0;0
18382;166545;1935;0;0;0;0;.00nan;0;0
18382;164323;579;0;0;0;0;.00nan;0;0
18382;-1;1935;49;31;4;27;.871;3900000;0
18382;190423;579;71;38;4;34;.895;3900000;0
18383;9597;2632;74;25;2;23;.920;3900000;0
18383;206110;1923;0;0;0;0;.00nan;0;0
18383;216592;2632;0;0;0;0;.00nan;0;0
18383;-1;1923;72;24;2;22;.917;3900000;0
18384;224720;1930;0;0;0;0;.00nan;0;0
18384;163361;1934;60;32;3;29;.906;3600000;0
18384;178950;1934;0;0;0;0;.00nan;0;0
18384;-1;1930;74;19;1;18;.947;3600000;0
18385;-1;4794;54;5;0;5;1.000;474000;0
18385;197059;4794;26;24;6;18;.750;3116000;0
18385;-1;2284;0;0;0;0;.00nan;0;0
18385;160661;2284;53;34;4;30;.882;3600000;0
18386;203759;1927;0;0;0;0;.00nan;0;0
18386;206136;1927;45;21;4;17;.810;3600000;0
18386;239843;5013;50;35;5;30;.857;3552000;0
18386;239844;5013;0;0;0;0;.00nan;0;0
18387;11438;2557;88;17;0;17;1.000;3600000;0
18387;-1;4794;0;0;0;0;.00nan;0;0
18387;197059;4794;71;43;5;38;.884;3600000;0
18387;-1;2557;0;0;0;0;.00nan;0;0
18388;224720;1930;0;0;0;0;.00nan;0;0
18388;164323;579;69;34;4;30;.882;3600000;0
18388;-1;1930;44;36;6;30;.833;3525000;0
18388;190423;579;0;0;0;0;.00nan;0;0
18389;206110;1923;56;29;4;25;.862;3553000;0
18389;-1;4794;0;0;0;0;.00nan;0;0
18389;197059;4794;58;29;3;26;.897;3600000;0
18389;-1;1923;0;0;0;0;.00nan;0;0
18390;203759;1927;0;0;0;0;.00nan;0;0
18390;206136;1927;51;21;3;18;.857;3600000;0
18390;239843;5013;57;37;4;33;.892;3563000;0
18390;239844;5013;0;0;0;0;.00nan;0;0
18391;9597;2632;0;0;0;0;.00nan;0;0
18391;216592;2632;83;36;2;34;.944;3521000;0
18391;53966;1925;0;0;0;0;.00nan;0;0
18391;85507;1925;97;20;0;20;1.000;3600000;0
18392;224720;1930;0;0;0;0;.00nan;0;0
18392;11438;2557;79;24;1;23;.958;3600000;0
18392;-1;1930;86;36;2;34;.944;3592000;0
18392;-1;2557;0;0;0;0;.00nan;0;0
18393;166545;1935;0;0;0;0;.00nan;0;0
18393;-1;1935;76;46;4;42;.913;3600000;0
18393;-1;2284;17;22;6;16;.727;3520000;0
18393;160661;2284;0;0;0;0;.00nan;0;0
18394;203759;1927;25;36;7;29;.806;3600000;0
18394;11438;2557;0;0;0;0;.00nan;0;0
18394;206136;1927;0;0;0;0;.00nan;0;0
18394;-1;2557;74;24;2;22;.917;3600000;0
18395;164323;579;0;0;0;0;.00nan;0;0
18395;190423;579;92;39;2;37;.949;3600000;0
18395;53966;1925;0;0;0;0;.00nan;0;0
18395;85507;1925;60;40;4;36;.900;3538000;0
18396;166545;1935;55;20;3;17;.850;3600000;0
18396;-1;1935;0;0;0;0;.00nan;0;0
18396;-1;4794;23;12;4;8;.667;1438000;0
18396;197059;4794;46;25;4;21;.840;2162000;0
18397;206110;1923;0;0;0;0;.00nan;0;0
18397;-1;1923;80;37;3;34;.919;3577000;0
18397;53966;1925;0;0;0;0;.00nan;0;0
18397;85507;1925;69;15;1;14;.933;3600000;0
18398;203759;1927;0;0;0;0;.00nan;0;0
18398;163361;1934;0;0;0;0;.00nan;0;0
18398;178950;1934;27;39;7;32;.821;3600000;0
18398;206136;1927;69;25;2;23;.920;3600000;0
18399;-1;2284;54;21;3;18;.857;3600000;0
18399;160661;2284;0;0;0;0;.00nan;0;0
18399;239843;5013;49;15;2;13;.867;1351000;0
18399;239844;5013;16;20;6;14;.700;2249000;0
18400;166545;1935;0;0;0;0;.00nan;0;0
18400;11438;2557;75;23;2;21;.913;3600000;0
18400;-1;1935;66;40;4;36;.900;3546000;0
18400;-1;2557;0;0;0;0;.00nan;0;0
18401;224720;1930;0;0;0;0;.00nan;0;0
18401;206110;1923;39;31;5;26;.839;3575000;0
18401;-1;1930;69;28;3;25;.893;3600000;0
18401;-1;1923;0;0;0;0;.00nan;0;0
18402;163361;1934;0;0;0;0;.00nan;0;0
18402;178950;1934;89;52;4;48;.923;3900000;0
18402;-1;4794;0;0;0;0;.00nan;0;0
18402;197059;4794;60;37;4;33;.892;3900000;0
18403;224720;1930;0;0;0;0;.00nan;0;0
18403;-1;1930;74;33;2;31;.939;3600000;0
18403;53966;1925;60;7;0;7;1.000;1026000;0
18403;85507;1925;32;28;6;22;.786;2574000;0
18404;224720;1930;0;0;0;0;.00nan;0;0
18404;-1;1930;67;21;2;19;.905;3600000;0
18404;-1;4794;0;0;0;0;.00nan;0;0
18404;197059;4794;37;33;6;27;.818;3600000;0
18405;11438;2557;52;29;4;25;.862;3600000;0
18405;-1;2284;38;32;6;26;.813;3585000;0
18405;-1;2557;0;0;0;0;.00nan;0;0
18405;160661;2284;0;0;0;0;.00nan;0;0
18406;166545;1935;0;0;0;0;.00nan;0;0
18406;203759;1927;0;0;0;0;.00nan;0;0
18406;-1;1935;52;32;4;28;.875;3600000;0
18406;206136;1927;100;37;1;36;.973;3600000;0
18407;203759;1927;50;24;3;21;.875;3900000;0
18407;164323;579;0;0;0;0;.00nan;0;0
18407;206136;1927;0;0;0;0;.00nan;0;0
18407;190423;579;100;40;3;37;.925;3900000;0
18408;163361;1934;0;0;0;0;.00nan;0;0
18408;178950;1934;62;37;4;33;.892;3559000;0
18408;239843;5013;71;24;2;22;.917;3600000;0
18408;239844;5013;0;0;0;0;.00nan;0;0
18409;11438;2557;0;0;0;0;.00nan;0;0
18409;206110;1923;52;30;4;26;.867;3104000;0
18409;-1;2557;71;18;2;16;.889;3600000;0
18409;-1;1923;40;9;3;6;.667;496000;0
18410;224720;1930;0;0;0;0;.00nan;0;0
18410;9597;2632;0;0;0;0;.00nan;0;0
18410;216592;2632;55;35;4;31;.886;3600000;0
18410;-1;1930;79;20;1;19;.950;3600000;0
18411;163361;1934;71;24;2;22;.917;3599000;0
18411;178950;1934;0;0;0;0;.00nan;0;0
18411;-1;4794;0;0;0;0;.00nan;0;0
18411;197059;4794;100;25;0;25;1.000;3600000;0
18412;-1;2284;16;20;6;14;.700;3147000;0
18412;53966;1925;0;0;0;0;.00nan;0;0
18412;85507;1925;31;41;8;33;.805;3561000;0
18412;160661;2284;45;4;1;3;.750;453000;0
18413;166545;1935;87;35;2;33;.943;3600000;0
18413;-1;1935;0;0;0;0;.00nan;0;0
18413;239843;5013;28;8;3;5;.625;229000;0
18413;239844;5013;47;27;4;23;.852;3371000;0
18414;203759;1927;0;0;0;0;.00nan;0;0
18414;206136;1927;87;38;3;35;.921;3600000;0
18414;-1;2284;36;25;5;20;.800;3515000;0
18414;160661;2284;0;0;0;0;.00nan;0;0
18415;166545;1935;0;0;0;0;.00nan;0;0
18415;-1;1935;98;22;0;22;1.000;3600000;0
18415;53966;1925;0;0;0;0;.00nan;0;0
18415;85507;1925;52;37;5;32;.865;3600000;0
18416;163361;1934;0;0;0;0;.00nan;0;0
18416;178950;1934;85;24;1;23;.958;3600000;0
18416;206110;1923;54;24;3;21;.875;3600000;0
18416;-1;1923;0;0;0;0;.00nan;0;0
18417;9597;2632;0;0;0;0;.00nan;0;0
18417;11438;2557;68;21;2;19;.905;3718000;0
18417;216592;2632;81;38;3;35;.921;3718000;0
18417;-1;2557;0;0;0;0;.00nan;0;0
18418;224720;1930;57;19;3;16;.842;3178000;0
18418;164323;579;46;14;2;12;.857;1379000;0
18418;-1;1930;27;5;3;2;.400;422000;0
18418;190423;579;40;34;5;29;.853;2212000;0
18419;-1;4794;0;0;0;0;.00nan;0;0
18419;197059;4794;62;33;3;30;.909;3600000;0
18419;-1;2284;53;3;0;3;1.000;884000;0
18419;160661;2284;14;19;6;13;.684;2716000;0
18420;53966;1925;0;0;0;0;.00nan;0;0
18420;85507;1925;60;29;3;26;.897;3600000;0
18420;239843;5013;45;28;5;23;.821;3600000;0
18420;239844;5013;0;0;0;0;.00nan;0;0
18421;164323;579;0;0;0;0;.00nan;0;0
18421;11438;2557;0;0;0;0;.00nan;0;0
18421;190423;579;49;27;4;23;.852;3594000;0
18421;-1;2557;89;30;2;28;.933;3600000;0
18422;9597;2632;57;6;0;6;1.000;451000;0
18422;216592;2632;68;55;6;49;.891;3149000;0
18422;-1;2284;79;24;1;23;.958;3600000;0
18422;160661;2284;0;0;0;0;.00nan;0;0
18423;164323;579;0;0;0;0;.00nan;0;0
18423;190423;579;37;32;6;26;.813;3597000;0
18423;-1;4794;51;20;3;17;.850;3600000;0
18423;197059;4794;0;0;0;0;.00nan;0;0
18424;166545;1935;0;0;0;0;.00nan;0;0
18424;-1;1935;48;33;5;28;.848;3570000;0
18424;53966;1925;0;0;0;0;.00nan;0;0
18424;85507;1925;67;28;3;25;.893;3600000;0
18425;9597;2632;0;0;0;0;.00nan;0;0
18425;11438;2557;59;19;2;17;.895;3600000;0
18425;216592;2632;59;44;5;39;.886;3600000;0
18425;-1;2557;0;0;0;0;.00nan;0;0
18426;163361;1934;51;2;0;2;1.000;437000;0
18426;178950;1934;59;39;4;35;.897;3163000;0
18426;239843;5013;20;24;6;18;.750;3599000;0
18426;239844;5013;0;0;0;0;.00nan;0;0
18427;164323;579;42;30;5;25;.833;3600000;0
18427;190423;579;0;0;0;0;.00nan;0;0
18427;239843;5013;48;29;4;25;.862;3270000;0
18427;239844;5013;28;9;3;6;.667;305000;0
18428;166545;1935;53;32;4;28;.875;3600000;0
18428;-1;1935;0;0;0;0;.00nan;0;0
18428;206110;1923;20;9;4;5;.556;1107000;0
18428;-1;1923;68;31;2;29;.935;2446000;0
18429;9597;2632;0;0;0;0;.00nan;0;0
18429;164323;579;0;0;0;0;.00nan;0;0
18429;216592;2632;88;41;3;38;.927;3900000;0
18429;190423;579;57;29;3;26;.897;3900000;0
18430;-1;4794;0;0;0;0;.00nan;0;0
18430;197059;4794;84;49;3;46;.939;3573000;0
18430;53966;1925;0;0;0;0;.00nan;0;0
18430;85507;1925;52;22;2;20;.909;3600000;0
18431;203759;1927;0;0;0;0;.00nan;0;0
18431;9597;2632;0;0;0;0;.00nan;0;0
18431;206136;1927;93;36;3;33;.917;3900000;0
18431;216592;2632;95;43;3;40;.930;3900000;0
18432;224720;1930;0;0;0;0;.00nan;0;0
18432;206110;1923;78;34;2;32;.941;3560000;0
18432;-1;1930;85;26;1;25;.962;3600000;0
18432;-1;1923;0;0;0;0;.00nan;0;0
18433;203759;1927;65;29;2;27;.931;3545000;0
18433;206110;1923;0;0;0;0;.00nan;0;0
18433;206136;1927;0;0;0;0;.00nan;0;0
18433;-1;1923;97;37;1;36;.973;3600000;0
18434;11438;2557;35;31;6;25;.806;3579000;0
18434;-1;2557;0;0;0;0;.00nan;0;0
18434;239843;5013;0;0;0;0;.00nan;0;0
18434;239844;5013;63;34;4;30;.882;3600000;0
18435;164323;579;0;0;0;0;.00nan;0;0
18435;190423;579;75;28;2;26;.929;3600000;0
18435;-1;2284;54;38;5;33;.868;3600000;0
18435;160661;2284;0;0;0;0;.00nan;0;0
18436;166545;1935;73;23;2;21;.913;3600000;0
18436;163361;1934;0;0;0;0;.00nan;0;0
18436;-1;1935;0;0;0;0;.00nan;0;0
18436;178950;1934;38;41;6;35;.854;3600000;0
18437;203759;1927;0;0;0;0;.00nan;0;0
18437;206136;1927;44;21;3;18;.857;3900000;0
18437;-1;4794;0;0;0;0;.00nan;0;0
18437;197059;4794;67;33;3;30;.909;3900000;0
18438;166545;1935;38;32;6;26;.813;3600000;0
18438;163361;1934;0;0;0;0;.00nan;0;0
18438;-1;1935;0;0;0;0;.00nan;0;0
18438;178950;1934;81;36;2;34;.944;3600000;0
18439;206110;1923;98;57;3;54;.947;3546000;0
18439;-1;2284;78;19;1;18;.947;3600000;0
18439;-1;1923;0;0;0;0;.00nan;0;0
18439;160661;2284;0;0;0;0;.00nan;0;0
18440;11438;2557;62;35;4;31;.886;3600000;0
18440;-1;2557;0;0;0;0;.00nan;0;0
18440;53966;1925;0;0;0;0;.00nan;0;0
18440;85507;1925;49;38;5;33;.868;3571000;0
18441;163361;1934;87;37;3;34;.919;3596000;0
18441;164323;579;0;0;0;0;.00nan;0;0
18441;178950;1934;0;0;0;0;.00nan;0;0
18441;190423;579;81;33;2;31;.939;3600000;0
18442;9597;2632;0;0;0;0;.00nan;0;0
18442;216592;2632;40;38;6;32;.842;3564000;0
18442;239843;5013;56;35;5;30;.857;3600000;0
18442;239844;5013;0;0;0;0;.00nan;0;0
18443;166545;1935;0;0;0;0;.00nan;0;0
18443;224720;1930;0;0;0;0;.00nan;0;0
18443;-1;1935;43;28;5;23;.821;3600000;0
18443;-1;1930;52;24;3;21;.875;3600000;0
18444;164323;579;24;26;6;20;.769;3561000;0
18444;190423;579;0;0;0;0;.00nan;0;0
18444;-1;4794;0;0;0;0;.00nan;0;0
18444;197059;4794;47;33;5;28;.848;3600000;0
18445;11438;2557;65;15;1;14;.933;3600000;0
18445;206110;1923;62;35;4;31;.886;3600000;0
18445;-1;2557;0;0;0;0;.00nan;0;0
18445;-1;1923;0;0;0;0;.00nan;0;0
18446;9597;2632;0;0;0;0;.00nan;0;0
18446;216592;2632;89;36;2;34;.944;3600000;0
18446;-1;4794;0;0;0;0;.00nan;0;0
18446;197059;4794;21;43;9;34;.791;3600000;0
18447;163361;1934;0;0;0;0;.00nan;0;0
18447;178950;1934;64;23;2;21;.913;3553000;0
18447;-1;2284;97;26;0;26;1.000;3600000;0
18447;160661;2284;0;0;0;0;.00nan;0;0
18448;166545;1935;44;24;4;20;.833;3552000;0
18448;-1;1935;0;0;0;0;.00nan;0;0
18448;-1;4794;78;38;3;35;.921;3600000;0
18448;197059;4794;0;0;0;0;.00nan;0;0
18449;203759;1927;0;0;0;0;.00nan;0;0
18449;11438;2557;0;0;0;0;.00nan;0;0
18449;206136;1927;70;33;3;30;.909;3566000;0
18449;-1;2557;69;20;1;19;.950;3600000;0
18450;163361;1934;0;0;0;0;.00nan;0;0
18450;178950;1934;85;42;3;39;.929;3596000;0
18450;53966;1925;0;0;0;0;.00nan;0;0
18450;85507;1925;51;18;2;16;.889;3600000;0
18451;9597;2632;0;0;0;0;.00nan;0;0
18451;164323;579;42;25;4;21;.840;2449000;0
18451;216592;2632;38;38;6;32;.842;3600000;0
18451;190423;579;23;11;4;7;.636;1151000;0
18452;224720;1930;0;0;0;0;.00nan;0;0
18452;-1;1930;40;32;6;26;.813;3600000;0
18452;239843;5013;80;40;3;37;.925;3600000;0
18452;239844;5013;0;0;0;0;.00nan;0;0
18453;164323;579;0;0;0;0;.00nan;0;0
18453;190423;579;81;34;2;32;.941;3600000;0
18453;53966;1925;0;0;0;0;.00nan;0;0
18453;85507;1925;67;40;5;35;.875;3600000;0
18454;203759;1927;51;42;5;37;.881;3600000;0
18454;206136;1927;0;0;0;0;.00nan;0;0
18454;-1;2284;71;19;1;18;.947;3600000;0
18454;160661;2284;0;0;0;0;.00nan;0;0
18455;224720;1930;0;0;0;0;.00nan;0;0
18455;203759;1927;0;0;0;0;.00nan;0;0
18455;206136;1927;22;22;5;17;.773;3900000;0
18455;-1;1930;57;40;5;35;.875;3900000;0
18456;164323;579;58;10;1;9;.900;712000;0
18456;190423;579;35;43;7;36;.837;2888000;0
18456;-1;2284;56;27;3;24;.889;3600000;0
18456;160661;2284;0;0;0;0;.00nan;0;0
18457;11438;2557;78;18;1;17;.944;3600000;0
18457;-1;4794;0;0;0;0;.00nan;0;0
18457;197059;4794;84;34;2;32;.941;3567000;0
18457;-1;2557;0;0;0;0;.00nan;0;0
18458;-1;2284;95;20;0;20;1.000;3600000;0
18458;53966;1925;0;0;0;0;.00nan;0;0
18458;85507;1925;83;36;2;34;.944;3551000;0
18458;160661;2284;0;0;0;0;.00nan;0;0
18459;206110;1923;26;31;6;25;.806;3570000;0
18459;-1;1923;0;0;0;0;.00nan;0;0
18459;67626;5013;43;28;5;23;.821;3600000;0
18459;239843;5013;0;0;0;0;.00nan;0;0
18460;163361;1934;0;0;0;0;.00nan;0;0
18460;9597;2632;0;0;0;0;.00nan;0;0
18460;178950;1934;71;28;3;25;.893;3900000;0
18460;216592;2632;69;32;3;29;.906;3900000;0
18461;203759;1927;0;0;0;0;.00nan;0;0
18461;9597;2632;60;33;3;30;.909;3600000;0
18461;206136;1927;100;21;0;21;1.000;3600000;0
18461;216592;2632;0;0;0;0;.00nan;0;0
18462;166545;1935;32;38;7;31;.816;3900000;0
18462;-1;1935;0;0;0;0;.00nan;0;0
18462;206110;1923;55;7;1;6;.857;1125000;0
18462;-1;1923;34;33;6;27;.818;2775000;0
18463;224720;1930;0;0;0;0;.00nan;0;0
18463;163361;1934;19;36;8;28;.778;3900000;0
18463;178950;1934;0;0;0;0;.00nan;0;0
18463;-1;1930;1;24;8;16;.667;3900000;0
18464;-1;4794;0;0;0;0;.00nan;0;0
18464;197059;4794;62;27;3;24;.889;3600000;0
18464;67626;5013;57;35;6;29;.829;3600000;0
18464;239843;5013;0;0;0;0;.00nan;0;0
18465;166545;1935;0;0;0;0;.00nan;0;0
18465;9597;2632;0;0;0;0;.00nan;0;0
18465;-1;1935;38;20;4;16;.800;3600000;0
18465;216592;2632;62;48;6;42;.875;3572000;0
18466;163361;1934;0;0;0;0;.00nan;0;0
18466;178950;1934;71;46;5;41;.891;3600000;0
18466;53966;1925;0;0;0;0;.00nan;0;0
18466;85507;1925;70;7;0;7;1.000;3600000;0
18467;224720;1930;73;19;1;18;.947;1643000;0
18467;11438;2557;100;25;0;25;1.000;3600000;0
18467;-1;1930;10;28;7;21;.750;1957000;0
18467;-1;2557;0;0;0;0;.00nan;0;0
18468;203759;1927;0;0;0;0;.00nan;0;0
18468;206110;1923;68;47;5;42;.894;3600000;0
18468;206136;1927;63;24;2;22;.917;3600000;0
18468;-1;1923;0;0;0;0;.00nan;0;0
18469;203759;1927;0;0;0;0;.00nan;0;0
18469;206136;1927;70;30;2;28;.933;3900000;0
18469;53966;1925;0;0;0;0;.00nan;0;0
18469;85507;1925;74;29;2;27;.931;3900000;0
18470;164323;579;0;0;0;0;.00nan;0;0
18470;190423;579;49;18;3;15;.833;3600000;0
18470;67626;5013;59;37;5;32;.865;3600000;0
18470;239843;5013;0;0;0;0;.00nan;0;0
18471;163361;1934;84;40;3;37;.925;3600000;0
18471;178950;1934;0;0;0;0;.00nan;0;0
18471;206110;1923;0;0;0;0;.00nan;0;0
18471;-1;1923;44;33;5;28;.848;3516000;0
18472;224720;1930;67;23;2;21;.913;2446000;0
18472;-1;1930;30;19;4;15;.789;1154000;0
18472;-1;2284;63;22;2;20;.909;3600000;0
18472;160661;2284;0;0;0;0;.00nan;0;0
18473;203759;1927;0;0;0;0;.00nan;0;0
18473;206136;1927;75;34;3;31;.912;3600000;0
18473;-1;4794;55;6;0;6;1.000;1263000;0
18473;197059;4794;49;29;4;25;.862;2302000;0
18474;166545;1935;0;0;0;0;.00nan;0;0
18474;-1;1935;69;25;2;23;.920;3900000;0
18474;67626;5013;91;38;2;36;.947;3900000;0
18474;239843;5013;0;0;0;0;.00nan;0;0
18475;224720;1930;0;0;0;0;.00nan;0;0
18475;9597;2632;65;11;0;11;1.000;722000;0
18475;216592;2632;40;37;7;30;.811;2878000;0
18475;-1;1930;100;27;0;27;1.000;3600000;0
18476;-1;4794;0;0;0;0;.00nan;0;0
18476;197059;4794;67;32;4;28;.875;3900000;0
18476;67626;5013;48;21;4;17;.810;3900000;0
18476;239843;5013;0;0;0;0;.00nan;0;0
18477;206110;1923;100;42;1;41;.976;3600000;0
18477;-1;1923;0;0;0;0;.00nan;0;0
18477;53966;1925;0;0;0;0;.00nan;0;0
18477;85507;1925;59;33;4;29;.879;3600000;0
18478;163361;1934;56;2;0;2;1.000;416000;0
18478;11438;2557;29;20;5;15;.750;3600000;0
18478;178950;1934;53;44;6;38;.864;3138000;0
18478;-1;2557;0;0;0;0;.00nan;0;0
18479;166545;1935;43;27;5;22;.815;3514000;0
18479;224720;1930;0;0;0;0;.00nan;0;0
18479;-1;1935;0;0;0;0;.00nan;0;0
18479;-1;1930;70;34;3;31;.912;3600000;0
18480;11438;2557;0;0;0;0;.00nan;0;0
18480;-1;2557;69;24;2;22;.917;3600000;0
18480;53966;1925;0;0;0;0;.00nan;0;0
18480;85507;1925;30;27;6;21;.778;3600000;0
18481;166545;1935;0;0;0;0;.00nan;0;0
18481;203759;1927;0;0;0;0;.00nan;0;0
18481;-1;1935;77;39;2;37;.949;3900000;0
18481;206136;1927;73;22;2;20;.909;3900000;0
18482;164323;579;0;0;0;0;.00nan;0;0
18482;190423;579;94;56;4;52;.929;3744000;0
18482;-1;2284;44;16;3;13;.813;3744000;0
18482;160661;2284;0;0;0;0;.00nan;0;0
18483;9597;2632;0;0;0;0;.00nan;0;0
18483;216592;2632;63;30;3;27;.900;3600000;0
18483;-1;4794;46;25;4;21;.840;3575000;0
18483;197059;4794;0;0;0;0;.00nan;0;0
18484;9597;2632;0;0;0;0;.00nan;0;0
18484;216592;2632;70;40;4;36;.900;3900000;0
18484;67626;5013;45;25;4;21;.840;3900000;0
18484;239843;5013;0;0;0;0;.00nan;0;0
18485;163361;1934;0;0;0;0;.00nan;0;0
18485;164323;579;73;26;2;24;.923;3600000;0
18485;178950;1934;73;38;3;35;.921;3581000;0
18485;190423;579;0;0;0;0;.00nan;0;0
18486;206110;1923;81;48;4;44;.917;3600000;0
18486;-1;2284;0;0;0;0;.00nan;0;0
18486;-1;1923;0;0;0;0;.00nan;0;0
18486;160661;2284;83;21;1;20;.952;3600000;0
18487;224720;1930;0;0;0;0;.00nan;0;0
18487;203759;1927;0;0;0;0;.00nan;0;0
18487;206136;1927;50;22;3;19;.864;3600000;0
18487;-1;1930;38;42;7;35;.833;3600000;0
18488;206110;1923;62;41;5;36;.878;3600000;0
18488;-1;1923;0;0;0;0;.00nan;0;0
18488;53966;1925;0;0;0;0;.00nan;0;0
18488;85507;1925;100;27;1;26;.963;3600000;0
18489;166545;1935;29;15;4;11;.733;1726000;0
18489;9597;2632;0;0;0;0;.00nan;0;0
18489;-1;1935;48;21;3;18;.857;1790000;0
18489;216592;2632;74;44;5;39;.886;3600000;0
18490;163361;1934;28;36;7;29;.806;2213000;0
18490;178950;1934;64;21;2;19;.905;1387000;0
18490;-1;2284;57;26;3;23;.885;3600000;0
18490;160661;2284;0;0;0;0;.00nan;0;0
18491;164323;579;53;23;3;20;.870;3065000;0
18491;11438;2557;56;18;2;16;.889;3600000;0
18491;190423;579;38;12;3;9;.750;535000;0
18491;-1;2557;0;0;0;0;.00nan;0;0
18492;166545;1935;0;0;0;0;.00nan;0;0
18492;-1;1935;72;23;1;22;.957;3600000;0
18492;-1;4794;62;27;3;24;.889;2692000;0
18492;197059;4794;31;19;4;15;.789;908000;0
18493;163361;1934;0;0;0;0;.00nan;0;0
18493;178950;1934;84;38;2;36;.947;3600000;0
18493;206110;1923;0;0;0;0;.00nan;0;0
18493;-1;1923;33;17;4;13;.765;3588000;0
18494;224720;1930;45;28;4;24;.857;3900000;0
18494;9597;2632;0;0;0;0;.00nan;0;0
18494;216592;2632;79;50;4;46;.920;3900000;0
18494;-1;1930;0;0;0;0;.00nan;0;0
18495;203759;1927;0;0;0;0;.00nan;0;0
18495;206136;1927;52;22;3;19;.864;3513000;0
18495;67626;5013;99;43;1;42;.977;3600000;0
18495;239843;5013;0;0;0;0;.00nan;0;0
18496;164323;579;0;0;0;0;.00nan;0;0
18496;190423;579;72;29;2;27;.931;3600000;0
18496;53966;1925;49;1;0;1;1.000;252000;0
18496;85507;1925;48;39;6;33;.846;3348000;0
18497;11438;2557;0;0;0;0;.00nan;0;0
18497;-1;2284;31;27;6;21;.778;2295000;0
18497;-1;2557;80;40;3;37;.925;3600000;0
18497;160661;2284;42;4;1;3;.750;1305000;0
18498;203759;1927;0;0;0;0;.00nan;0;0
18498;206136;1927;86;33;1;32;.970;3600000;0
18498;-1;4794;0;0;0;0;.00nan;0;0
18498;197059;4794;70;52;5;47;.904;3600000;0
18499;166545;1935;0;0;0;0;.00nan;0;0
18499;-1;1935;54;33;4;29;.879;3900000;0
18499;67626;5013;50;29;4;25;.862;3900000;0
18499;239843;5013;0;0;0;0;.00nan;0;0
18500;11438;2557;63;22;2;20;.909;3600000;0
18500;206110;1923;29;26;6;20;.769;2102000;0
18500;-1;2557;0;0;0;0;.00nan;0;0
18500;-1;1923;50;16;2;14;.875;1498000;0
18501;163361;1934;10;14;6;8;.571;1145000;0
18501;178950;1934;68;21;1;20;.952;2455000;0
18501;-1;2284;54;16;2;14;.875;3600000;0
18501;160661;2284;0;0;0;0;.00nan;0;0
18502;224720;1930;0;0;0;0;.00nan;0;0
18502;-1;1930;79;27;2;25;.926;3600000;0
18502;-1;4794;0;0;0;0;.00nan;0;0
18502;197059;4794;56;43;5;38;.884;3600000;0
18503;203759;1927;0;0;0;0;.00nan;0;0
18503;9597;2632;0;0;0;0;.00nan;0;0
18503;206136;1927;38;24;4;20;.833;3588000;0
18503;216592;2632;59;28;3;25;.893;3600000;0
18504;224720;1930;0;0;0;0;.00nan;0;0
18504;-1;1930;69;35;4;31;.886;3545000;0
18504;67626;5013;70;34;3;31;.912;3600000;0
18504;239843;5013;0;0;0;0;.00nan;0;0
18505;164323;579;0;0;0;0;.00nan;0;0
18505;206110;1923;77;30;2;28;.933;3600000;0
18505;190423;579;57;21;3;18;.857;3553000;0
18505;-1;1923;0;0;0;0;.00nan;0;0
18506;163361;1934;0;0;0;0;.00nan;0;0
18506;178950;1934;86;53;4;49;.925;3565000;0
18506;53966;1925;0;0;0;0;.00nan;0;0
18506;85507;1925;51;19;3;16;.842;3600000;0
18507;-1;2284;69;24;2;22;.917;3600000;0
18507;53966;1925;0;0;0;0;.00nan;0;0
18507;85507;1925;54;33;4;29;.879;3600000;0
18507;160661;2284;0;0;0;0;.00nan;0;0
18508;164323;579;0;0;0;0;.00nan;0;0
18508;11438;2557;56;17;2;15;.882;3600000;0
18508;190423;579;65;38;3;35;.921;3589000;0
18508;-1;2557;0;0;0;0;.00nan;0;0
18510;164323;579;0;0;0;0;.00nan;0;0
18510;11438;2557;42;22;4;18;.818;3569000;0
18510;190423;579;66;25;2;23;.920;3600000;0
18510;-1;2557;0;0;0;0;.00nan;0;0
18512;166545;1935;0;0;0;0;.00nan;0;0
18512;-1;1935;53;33;4;29;.879;3576000;0
18512;-1;2284;46;20;3;17;.850;3600000;0
18512;160661;2284;0;0;0;0;.00nan;0;0
18514;224720;1930;0;0;0;0;.00nan;0;0
18514;9597;2632;0;0;0;0;.00nan;0;0
18514;216592;2632;56;31;4;27;.871;3600000;0
18514;-1;1930;54;18;2;16;.889;3600000;0
18516;206110;1923;92;40;2;38;.950;3600000;0
18516;-1;1923;0;0;0;0;.00nan;0;0
18516;53966;1925;0;0;0;0;.00nan;0;0
18516;89223;1925;78;50;3;47;.940;3543000;0
18518;203759;1927;0;0;0;0;.00nan;0;0
18518;206136;1927;36;27;5;22;.815;3600000;0
18518;-1;4794;50;10;1;9;.900;610000;0
18518;197059;4794;39;34;6;28;.824;2904000;0
18520;163361;1934;0;0;0;0;.00nan;0;0
18520;178950;1934;100;32;0;32;1.000;3600000;0
18520;239843;5013;0;0;0;0;.00nan;0;0
18520;239844;5013;72;39;4;35;.897;3600000;0
18522;224720;1930;0;0;0;0;.00nan;0;0
18522;-1;1930;74;27;2;25;.926;3600000;0
18522;239843;5013;61;40;5;35;.875;3600000;0
18522;239844;5013;0;0;0;0;.00nan;0;0
18524;206110;1923;0;0;0;0;.00nan;0;0
18524;-1;4794;29;26;6;20;.769;3642000;0
18524;197059;4794;0;0;0;0;.00nan;0;0
18524;-1;1923;46;32;5;27;.844;3642000;0
18526;163361;1934;37;34;6;28;.824;2181000;0
18526;178950;1934;29;23;5;18;.783;1419000;0
18526;-1;2284;0;0;0;0;.00nan;0;0
18526;160661;2284;45;11;2;9;.818;3600000;0
18528;203759;1927;59;26;3;23;.885;3600000;0
18528;11438;2557;0;0;0;0;.00nan;0;0
18528;206136;1927;0;0;0;0;.00nan;0;0
18528;-1;2557;30;28;6;22;.786;3544000;0
18530;166545;1935;100;35;0;35;1.000;3900000;0
18530;9597;2632;95;31;0;31;1.000;3900000;0
18530;-1;1935;0;0;0;0;.00nan;0;0
18530;216592;2632;0;0;0;0;.00nan;0;0
18532;164323;579;61;27;3;24;.889;3600000;0
18532;190423;579;0;0;0;0;.00nan;0;0
18532;53966;1925;63;36;4;32;.889;3600000;0
18532;89223;1925;0;0;0;0;.00nan;0;0
18534;163361;1934;59;44;5;39;.886;3600000;0
18534;11438;2557;91;20;0;20;1.000;3600000;0
18534;178950;1934;0;0;0;0;.00nan;0;0
18534;-1;2557;0;0;0;0;.00nan;0;0
18536;166545;1935;48;40;7;33;.825;3600000;0
18536;-1;1935;0;0;0;0;.00nan;0;0
18536;53966;1925;65;35;4;31;.886;3600000;0
18536;89223;1925;0;0;0;0;.00nan;0;0
18538;203759;1927;0;0;0;0;.00nan;0;0
18538;206110;1923;92;35;1;34;.971;3600000;0
18538;206136;1927;62;33;3;30;.909;3572000;0
18538;-1;1923;0;0;0;0;.00nan;0;0
18540;224720;1930;0;0;0;0;.00nan;0;0
18540;-1;1930;20;28;6;22;.786;3600000;0
18540;-1;2284;56;13;1;12;.923;3600000;0
18540;160661;2284;0;0;0;0;.00nan;0;0
18542;164323;579;0;0;0;0;.00nan;0;0
18542;190423;579;45;36;6;30;.833;3557000;0
18542;-1;4794;0;0;0;0;.00nan;0;0
18542;197059;4794;37;21;4;17;.810;3600000;0
18544;9597;2632;30;24;5;19;.792;3537000;0
18544;216592;2632;0;0;0;0;.00nan;0;0
18544;239843;5013;87;41;3;38;.927;3600000;0
18544;239844;5013;0;0;0;0;.00nan;0;0
18546;9597;2632;0;0;0;0;.00nan;0;0
18546;206110;1923;0;0;0;0;.00nan;0;0
18546;216592;2632;59;33;4;29;.879;3600000;0
18546;-1;1923;32;24;5;19;.792;3562000;0
18548;164323;579;84;27;1;26;.963;3600000;0
18548;190423;579;0;0;0;0;.00nan;0;0
18548;239843;5013;53;2;0;2;1.000;393000;0
18548;239844;5013;25;29;6;23;.793;3207000;0
18550;11438;2557;0;0;0;0;.00nan;0;0
18550;-1;2557;66;30;2;28;.933;3600000;0
18550;53966;1925;0;0;0;0;.00nan;0;0
18550;89223;1925;71;35;3;32;.914;3600000;0
18552;166545;1935;0;0;0;0;.00nan;0;0
18552;-1;1935;81;37;2;35;.946;3600000;0
18552;-1;2284;0;0;0;0;.00nan;0;0
18552;160661;2284;60;29;3;26;.897;3547000;0
18554;224720;1930;0;0;0;0;.00nan;0;0
18554;-1;1930;43;39;6;33;.846;3600000;0
18554;-1;4794;34;36;7;29;.806;3582000;0
18554;197059;4794;0;0;0;0;.00nan;0;0
18556;203759;1927;94;38;2;36;.947;3600000;0
18556;163361;1934;0;0;0;0;.00nan;0;0
18556;178950;1934;44;27;5;22;.815;3600000;0
18556;206136;1927;0;0;0;0;.00nan;0;0
602;164323;579;0;0;0;0;.00nan;0;0
602;11438;2557;63;28;4;24;.857;3553000;0
602;190423;579;55;27;3;24;.889;3600000;0
602;-1;2557;0;0;0;0;.00nan;0;0
603;-1;2284;30;25;6;19;.760;2550000;0
603;53966;1925;0;0;0;0;.00nan;0;0
603;85507;1925;76;22;2;20;.909;3600000;0
603;160661;2284;37;6;2;4;.667;1050000;0
604;224720;1930;0;0;0;0;.00nan;0;0
604;203759;1927;0;0;0;0;.00nan;0;0
604;206136;1927;50;35;5;30;.857;3600000;0
604;-1;1930;73;36;3;33;.917;3600000;0
605;11438;2557;64;26;3;23;.885;3900000;0
605;-1;2557;0;0;0;0;.00nan;0;0
605;53966;1925;0;0;0;0;.00nan;0;0
605;85507;1925;67;32;3;29;.906;3900000;0
606;203759;1927;0;0;0;0;.00nan;0;0
606;164323;579;0;0;0;0;.00nan;0;0
606;206136;1927;30;26;5;21;.808;3600000;0
606;190423;579;12;26;7;19;.731;3514000;0
607;224720;1930;0;0;0;0;.00nan;0;0
607;-1;1930;54;32;5;27;.844;3600000;0
607;-1;2284;54;26;4;22;.846;3600000;0
607;160661;2284;0;0;0;0;.00nan;0;0
608;203759;1927;0;0;0;0;.00nan;0;0
608;11438;2557;67;31;3;28;.903;3600000;0
608;206136;1927;71;38;4;34;.895;3544000;0
608;-1;2557;0;0;0;0;.00nan;0;0
609;224720;1930;0;0;0;0;.00nan;0;0
609;-1;1930;73;44;4;40;.909;3600000;0
609;53966;1925;52;13;2;11;.846;2711000;0
609;85507;1925;18;8;4;4;.500;800000;0
610;164323;579;0;0;0;0;.00nan;0;0
610;190423;579;46;36;5;31;.861;3600000;0
610;-1;2284;65;20;2;18;.900;3600000;0
610;160661;2284;0;0;0;0;.00nan;0;0
611;224720;1930;65;16;1;15;.938;1706000;0
611;11438;2557;69;28;2;26;.929;3600000;0
611;-1;1930;2;18;7;11;.611;1894000;0
611;-1;2557;0;0;0;0;.00nan;0;0
612;203759;1927;0;0;0;0;.00nan;0;0
612;206136;1927;69;27;2;25;.926;3600000;0
612;-1;2284;77;37;3;34;.919;3589000;0
612;160661;2284;0;0;0;0;.00nan;0;0
613;164323;579;0;0;0;0;.00nan;0;0
613;190423;579;34;35;6;29;.829;3600000;0
613;53966;1925;0;0;0;0;.00nan;0;0
613;85507;1925;73;32;3;29;.906;3600000;0
614;11438;2557;43;30;5;25;.833;3600000;0
614;-1;2284;84;25;1;24;.960;3600000;0
614;-1;2557;0;0;0;0;.00nan;0;0
614;160661;2284;0;0;0;0;.00nan;0;0
615;224720;1930;0;0;0;0;.00nan;0;0
615;164323;579;62;45;4;41;.911;3900000;0
615;-1;1930;63;38;4;34;.895;3900000;0
615;190423;579;0;0;0;0;.00nan;0;0
616;203759;1927;54;31;4;27;.871;3049000;0
616;206136;1927;33;11;3;8;.727;551000;0
616;53966;1925;0;0;0;0;.00nan;0;0
616;85507;1925;56;18;2;16;.889;3600000;0
617;164323;579;0;0;0;0;.00nan;0;0
617;11438;2557;0;0;0;0;.00nan;0;0
617;190423;579;71;28;2;26;.929;3600000;0
617;-1;2557;45;34;5;29;.853;3600000;0
618;-1;2284;60;36;4;32;.889;3545000;0
618;53966;1925;0;0;0;0;.00nan;0;0
618;85507;1925;66;25;3;22;.880;3600000;0
618;160661;2284;0;0;0;0;.00nan;0;0
619;224720;1930;0;0;0;0;.00nan;0;0
619;203759;1927;0;0;0;0;.00nan;0;0
619;206136;1927;46;27;4;23;.852;3600000;0
619;-1;1930;97;22;0;22;1.000;3600000;0
620;11438;2557;1;18;7;11;.611;3559000;0
620;-1;2557;0;0;0;0;.00nan;0;0
620;53966;1925;0;0;0;0;.00nan;0;0
620;85507;1925;63;34;4;30;.882;3600000;0
621;203759;1927;82;43;3;40;.930;3600000;0
621;164323;579;0;0;0;0;.00nan;0;0
621;206136;1927;0;0;0;0;.00nan;0;0
621;190423;579;18;24;6;18;.750;3600000;0
622;224720;1930;0;0;0;0;.00nan;0;0
622;-1;1930;49;32;5;27;.844;3600000;0
622;-1;2284;63;16;1;15;.938;3600000;0
622;160661;2284;0;0;0;0;.00nan;0;0
623;203759;1927;61;19;1;18;.947;1713000;0
623;11438;2557;55;29;4;25;.862;3600000;0
623;206136;1927;19;24;7;17;.708;1887000;0
623;-1;2557;0;0;0;0;.00nan;0;0
624;224720;1930;0;0;0;0;.00nan;0;0
624;-1;1930;30;20;5;15;.750;3600000;0
624;53966;1925;0;0;0;0;.00nan;0;0
624;85507;1925;77;40;4;36;.900;3600000;0
625;164323;579;29;12;4;8;.667;696000;0
625;190423;579;44;44;7;37;.841;2904000;0
625;-1;2284;53;21;3;18;.857;3600000;0
625;160661;2284;0;0;0;0;.00nan;0;0
626;224720;1930;0;0;0;0;.00nan;0;0
626;11438;2557;16;22;7;15;.682;2219000;0
626;-1;1930;79;25;2;23;.920;3600000;0
626;-1;2557;51;7;1;6;.857;1381000;0
627;203759;1927;0;0;0;0;.00nan;0;0
627;206136;1927;65;34;4;30;.882;3518000;0
627;-1;2284;82;26;2;24;.923;3600000;0
627;160661;2284;0;0;0;0;.00nan;0;0
628;164323;579;0;0;0;0;.00nan;0;0
628;190423;579;41;40;5;35;.875;3600000;0
628;53966;1925;0;0;0;0;.00nan;0;0
628;85507;1925;43;11;2;9;.818;3600000;0
629;11438;2557;0;0;0;0;.00nan;0;0
629;-1;2284;68;48;4;44;.917;3900000;0
629;-1;2557;37;23;4;19;.826;3900000;0
629;160661;2284;0;0;0;0;.00nan;0;0
630;224720;1930;0;0;0;0;.00nan;0;0
630;164323;579;0;0;0;0;.00nan;0;0
630;-1;1930;53;21;2;19;.905;3600000;0
630;190423;579;53;29;4;25;.862;3563000;0
631;203759;1927;12;18;6;12;.667;1905000;0
631;206136;1927;18;20;6;14;.700;1695000;0
631;53966;1925;0;0;0;0;.00nan;0;0
631;85507;1925;52;36;5;31;.861;3600000;0
632;166545;1935;20;8;4;4;.500;1086000;0
632;-1;1935;55;13;2;11;.846;2514000;0
632;206110;1923;38;50;8;42;.840;3240000;0
632;-1;1923;53;3;0;3;1.000;281000;0
633;-1;4794;0;0;0;0;.00nan;0;0
633;197059;4794;42;18;3;15;.833;3600000;0
633;67626;5013;38;38;6;32;.842;3600000;0
633;239843;5013;0;0;0;0;.00nan;0;0
634;163361;1934;0;0;0;0;.00nan;0;0
634;9597;2632;0;0;0;0;.00nan;0;0
634;178950;1934;77;22;1;21;.955;3600000;0
634;216592;2632;51;33;4;29;.879;3600000;0
635;166545;1935;0;0;0;0;.00nan;0;0
635;-1;1935;63;23;2;21;.913;3600000;0
635;-1;4794;0;0;0;0;.00nan;0;0
635;197059;4794;77;39;4;35;.897;3557000;0
636;163361;1934;0;0;0;0;.00nan;0;0
636;178950;1934;91;51;3;48;.941;3596000;0
636;206110;1923;74;27;2;25;.926;3600000;0
636;-1;1923;0;0;0;0;.00nan;0;0
637;9597;2632;53;25;3;22;.880;2796000;0
637;216592;2632;23;14;4;10;.714;804000;0
637;67626;5013;68;24;2;22;.917;3600000;0
637;239843;5013;0;0;0;0;.00nan;0;0
638;166545;1935;55;20;2;18;.900;3600000;0
638;163361;1934;0;0;0;0;.00nan;0;0
638;-1;1935;0;0;0;0;.00nan;0;0
638;178950;1934;55;37;5;32;.865;3600000;0
639;9597;2632;0;0;0;0;.00nan;0;0
639;216592;2632;52;39;6;33;.846;3600000;0
639;-1;4794;0;0;0;0;.00nan;0;0
639;197059;4794;84;29;2;27;.931;3600000;0
640;206110;1923;43;24;4;20;.833;2188000;0
640;-1;1923;41;9;2;7;.778;1412000;0
640;67626;5013;71;30;2;28;.933;3600000;0
640;239843;5013;0;0;0;0;.00nan;0;0
641;166545;1935;0;0;0;0;.00nan;0;0
641;9597;2632;38;18;4;14;.778;1488000;0
641;-1;1935;54;33;4;29;.879;3600000;0
641;216592;2632;17;23;6;17;.739;2112000;0
642;163361;1934;0;0;0;0;.00nan;0;0
642;178950;1934;81;31;2;29;.935;3600000;0
642;67626;5013;80;39;3;36;.923;3551000;0
642;239843;5013;0;0;0;0;.00nan;0;0
643;206110;1923;48;28;5;23;.821;3564000;0
643;-1;4794;69;37;4;33;.892;3600000;0
643;197059;4794;0;0;0;0;.00nan;0;0
643;-1;1923;0;0;0;0;.00nan;0;0
644;166545;1935;62;25;3;22;.880;3600000;0
644;-1;1935;0;0;0;0;.00nan;0;0
644;67626;5013;43;32;5;27;.844;3600000;0
644;239843;5013;0;0;0;0;.00nan;0;0
645;9597;2632;0;0;0;0;.00nan;0;0
645;206110;1923;0;0;0;0;.00nan;0;0
645;216592;2632;68;31;2;29;.935;3600000;0
645;-1;1923;19;22;6;16;.727;3600000;0
646;163361;1934;0;0;0;0;.00nan;0;0
646;178950;1934;67;28;2;26;.929;3852000;0
646;-1;4794;0;0;0;0;.00nan;0;0
646;197059;4794;60;29;3;26;.897;3852000;0
647;166545;1935;0;0;0;0;.00nan;0;0
647;-1;1935;96;40;1;39;.975;3600000;0
647;206110;1923;35;29;6;23;.793;3030000;0
647;-1;1923;38;7;2;5;.714;570000;0
648;-1;4794;0;0;0;0;.00nan;0;0
648;197059;4794;5;23;7;16;.696;3542000;0
648;67626;5013;45;26;5;21;.808;3600000;0
648;239843;5013;0;0;0;0;.00nan;0;0
649;163361;1934;0;0;0;0;.00nan;0;0
649;9597;2632;0;0;0;0;.00nan;0;0
649;178950;1934;91;37;2;35;.946;3552000;0
649;216592;2632;92;39;1;38;.974;3600000;0
650;166545;1935;78;35;2;33;.943;3600000;0
650;-1;1935;0;0;0;0;.00nan;0;0
650;-1;4794;0;0;0;0;.00nan;0;0
650;197059;4794;62;36;3;33;.917;3545000;0
651;163361;1934;0;0;0;0;.00nan;0;0
651;178950;1934;60;30;3;27;.900;3600000;0
651;206110;1923;47;37;5;32;.865;3552000;0
651;-1;1923;0;0;0;0;.00nan;0;0
652;9597;2632;51;38;6;32;.842;3190000;0
652;216592;2632;59;5;0;5;1.000;410000;0
652;67626;5013;10;24;7;17;.708;3594000;0
652;239843;5013;0;0;0;0;.00nan;0;0
653;166545;1935;0;0;0;0;.00nan;0;0
653;163361;1934;0;0;0;0;.00nan;0;0
653;-1;1935;70;27;2;25;.926;3600000;0
653;178950;1934;82;49;5;44;.898;3600000;0
654;9597;2632;0;0;0;0;.00nan;0;0
654;216592;2632;32;33;6;27;.818;3600000;0
654;-1;4794;0;0;0;0;.00nan;0;0
654;197059;4794;80;33;3;30;.909;3600000;0
655;206110;1923;0;0;0;0;.00nan;0;0
655;-1;1923;52;23;3;20;.870;3600000;0
655;67626;5013;32;36;7;29;.806;3600000;0
655;239843;5013;0;0;0;0;.00nan;0;0
656;166545;1935;48;25;4;21;.840;3600000;0
656;9597;2632;58;18;2;16;.889;1420000;0
656;-1;1935;0;0;0;0;.00nan;0;0
656;216592;2632;58;34;5;29;.853;2180000;0
657;163361;1934;0;0;0;0;.00nan;0;0
657;178950;1934;37;30;5;25;.833;3600000;0
657;67626;5013;66;13;0;13;1.000;732000;0
657;239843;5013;54;45;7;38;.844;2868000;0
658;206110;1923;15;22;6;16;.727;2655000;0
658;-1;4794;0;0;0;0;.00nan;0;0
658;197059;4794;70;37;3;34;.919;3600000;0
658;-1;1923;57;6;0;6;1.000;945000;0
659;166545;1935;0;0;0;0;.00nan;0;0
659;-1;1935;95;21;0;21;1.000;3600000;0
659;67626;5013;29;28;6;22;.786;3007000;0
659;239843;5013;57;8;1;7;.875;593000;0
660;9597;2632;0;0;0;0;.00nan;0;0
660;206110;1923;93;42;2;40;.952;3900000;0
660;216592;2632;72;31;2;29;.935;3900000;0
660;-1;1923;0;0;0;0;.00nan;0;0
661;163361;1934;0;0;0;0;.00nan;0;0
661;178950;1934;91;35;2;33;.943;3600000;0
661;-1;4794;0;0;0;0;.00nan;0;0
661;197059;4794;58;27;3;24;.889;3558000;0
1285;163361;1934;0;0;0;0;.00nan;0;0
1285;11438;2557;88;17;0;17;1.000;3600000;0
1285;178950;1934;58;46;6;40;.870;3600000;0
1285;-1;2557;0;0;0;0;.00nan;0;0
1286;166545;1935;0;0;0;0;.00nan;0;0
1286;-1;1935;43;37;6;31;.838;3578000;0
1286;-1;2284;65;29;4;25;.862;3600000;0
1286;160661;2284;0;0;0;0;.00nan;0;0
1287;164323;579;0;0;0;0;.00nan;0;0
1287;190423;579;78;32;2;30;.938;3600000;0
1287;53966;1925;0;0;0;0;.00nan;0;0
1287;85507;1925;49;34;5;29;.853;3600000;0
1288;224720;1930;0;0;0;0;.00nan;0;0
1288;203759;1927;0;0;0;0;.00nan;0;0
1288;206136;1927;56;23;3;20;.870;3557000;0
1288;-1;1930;91;32;1;31;.969;3600000;0
1289;163361;1934;38;26;6;20;.769;2684000;0
1289;11438;2557;87;31;2;29;.935;3600000;0
1289;178950;1934;47;22;4;18;.818;916000;0
1289;-1;2557;0;0;0;0;.00nan;0;0
1290;166545;1935;85;34;2;32;.941;3600000;0
1290;-1;1935;0;0;0;0;.00nan;0;0
1290;-1;2284;45;27;4;23;.852;3528000;0
1290;160661;2284;0;0;0;0;.00nan;0;0
1291;164323;579;0;0;0;0;.00nan;0;0
1291;190423;579;69;31;3;28;.903;3600000;0
1291;53966;1925;0;0;0;0;.00nan;0;0
1291;85507;1925;42;25;5;20;.800;3517000;0
1292;224720;1930;0;0;0;0;.00nan;0;0
1292;203759;1927;0;0;0;0;.00nan;0;0
1292;206136;1927;55;40;5;35;.875;3564000;0
1292;-1;1930;48;20;3;17;.850;3600000;0
1293;163361;1934;0;0;0;0;.00nan;0;0
1293;11438;2557;76;26;2;24;.923;3600000;0
1293;178950;1934;60;31;3;28;.903;3543000;0
1293;-1;2557;0;0;0;0;.00nan;0;0
1294;166545;1935;52;30;4;26;.867;3534000;0
1294;-1;1935;0;0;0;0;.00nan;0;0
1294;-1;2284;82;44;3;41;.932;3600000;0
1294;160661;2284;0;0;0;0;.00nan;0;0
1295;164323;579;0;0;0;0;.00nan;0;0
1295;190423;579;66;43;6;37;.860;3600000;0
1295;53966;1925;0;0;0;0;.00nan;0;0
1295;85507;1925;68;30;3;27;.900;3600000;0
1296;224720;1930;0;0;0;0;.00nan;0;0
1296;203759;1927;0;0;0;0;.00nan;0;0
1296;206136;1927;60;26;3;23;.885;3600000;0
1296;-1;1930;41;31;6;25;.806;3600000;0
1567;166545;1935;24;29;6;23;.793;2642000;0
1567;-1;1935;57;7;0;7;1.000;946000;0
1567;-1;2284;53;32;5;27;.844;3600000;0
1567;160661;2284;0;0;0;0;.00nan;0;0
1568;164323;579;0;0;0;0;.00nan;0;0
1568;190423;579;78;42;4;38;.905;3590000;0
1568;53966;1925;0;0;0;0;.00nan;0;0
1568;85507;1925;63;26;3;23;.885;3600000;0
1569;224720;1930;0;0;0;0;.00nan;0;0
1569;203759;1927;0;0;0;0;.00nan;0;0
1569;206136;1927;65;32;3;29;.906;3600000;0
1569;-1;1930;44;25;4;21;.840;3547000;0
1614;164323;579;49;1;0;1;1.000;276000;0
1614;190423;579;55;57;7;50;.877;3324000;0
1614;53966;1925;0;0;0;0;.00nan;0;0
1614;85507;1925;37;17;4;13;.765;3600000;0
1615;224720;1930;0;0;0;0;.00nan;0;0
1615;203759;1927;0;0;0;0;.00nan;0;0
1615;206136;1927;7;33;9;24;.727;3536000;0
1615;-1;1930;30;33;7;26;.788;3600000;0
1671;224720;1930;0;0;0;0;.00nan;0;0
1671;11438;2557;62;28;3;25;.893;3600000;0
1671;-1;1930;80;34;2;32;.941;3600000;0
1671;-1;2557;0;0;0;0;.00nan;0;0
1672;-1;2284;22;5;3;2;.400;281000;0
1672;53966;1925;0;0;0;0;.00nan;0;0
1672;85507;1925;87;29;1;28;.966;3600000;0
1672;160661;2284;56;27;4;23;.852;3319000;0
1673;224720;1930;0;0;0;0;.00nan;0;0
1673;11438;2557;74;23;1;22;.957;3600000;0
1673;-1;1930;67;26;2;24;.923;3559000;0
1673;-1;2557;0;0;0;0;.00nan;0;0
1674;-1;2284;25;11;4;7;.636;872000;0
1674;53966;1925;0;0;0;0;.00nan;0;0
1674;85507;1925;54;35;5;30;.857;3600000;0
1674;160661;2284;27;21;5;16;.762;2728000;0
1675;224720;1930;0;0;0;0;.00nan;0;0
1675;11438;2557;62;35;4;31;.886;3553000;0
1675;-1;1930;57;23;3;20;.870;3600000;0
1675;-1;2557;0;0;0;0;.00nan;0;0
1676;-1;2284;30;21;5;16;.762;1723000;0
1676;53966;1925;0;0;0;0;.00nan;0;0
1676;85507;1925;54;27;3;24;.889;3600000;0
1676;160661;2284;42;16;3;13;.813;1877000;0
1931;224720;1930;0;0;0;0;.00nan;0;0
1931;11438;2557;67;41;4;37;.902;4523000;0
1931;-1;1930;61;36;5;31;.861;4523000;0
1931;-1;2557;0;0;0;0;.00nan;0;0
1954;224720;1930;0;0;0;0;.00nan;0;0
1954;11438;2557;95;31;1;30;.968;3600000;0
1954;-1;1930;63;35;4;31;.886;3600000;0
1954;-1;2557;0;0;0;0;.00nan;0;0
1992;11438;2557;87;34;2;32;.941;3600000;0
1992;-1;2557;0;0;0;0;.00nan;0;0
1992;53966;1925;0;0;0;0;.00nan;0;0
1992;85507;1925;49;16;3;13;.813;3564000;0
1993;11438;2557;83;32;2;30;.938;3569000;0
1993;-1;2557;0;0;0;0;.00nan;0;0
1993;53966;1925;0;0;0;0;.00nan;0;0
1993;85507;1925;83;30;1;29;.967;3600000;0
1994;11438;2557;78;38;3;35;.921;3600000;0
1994;-1;2557;0;0;0;0;.00nan;0;0
1994;53966;1925;0;0;0;0;.00nan;0;0
1994;85507;1925;75;36;4;32;.889;3542000;0
2251;11438;2557;45;49;6;43;.878;5045000;0
2251;-1;2557;0;0;0;0;.00nan;0;0
2251;53966;1925;0;0;0;0;.00nan;0;0
2251;85507;1925;52;38;5;33;.868;5045000;0
2295;11438;2557;64;22;2;20;.909;3619000;0
2295;-1;2557;0;0;0;0;.00nan;0;0
2295;53966;1925;0;0;0;0;.00nan;0;0
2295;85507;1925;74;30;3;27;.900;3590000;0
18557;193486;2161;0;0;0;0;.00nan;0;0
18557;177771;2163;69;23;1;22;.957;2647000;0
18557;165350;2161;61;26;2;24;.923;3600000;0
18557;161081;2163;9;8;5;3;.375;953000;0
18558;-1;2164;58;29;3;26;.897;3600000;0
18558;-1;4840;100;25;0;25;1.000;3600000;0
18558;-1;2164;0;0;0;0;.00nan;0;0
18558;-1;4840;0;0;0;0;.00nan;0;0
18559;21607;2162;0;0;0;0;.00nan;0;0
18559;-1;2162;88;49;3;46;.939;3600000;0
18559;196495;2158;74;11;0;11;1.000;3600000;0
18559;85984;2158;0;0;0;0;.00nan;0;0
18560;193486;2161;66;19;1;18;.947;3600000;0
18560;177771;2163;0;0;0;0;.00nan;0;0
18560;165350;2161;0;0;0;0;.00nan;0;0
18560;161081;2163;93;38;2;36;.947;3600000;0
18561;-1;2164;0;0;0;0;.00nan;0;0
18561;-1;4840;71;33;3;30;.909;3600000;0
18561;-1;2164;100;29;0;29;1.000;3600000;0
18561;-1;4840;0;0;0;0;.00nan;0;0
18562;21607;2162;63;45;5;40;.889;2913000;0
18562;-1;2162;28;16;4;12;.750;687000;0
18562;196495;2158;49;6;1;5;.833;3600000;0
18562;85984;2158;0;0;0;0;.00nan;0;0
18563;21607;2162;0;0;0;0;.00nan;0;0
18563;-1;2162;80;36;2;34;.944;3563000;0
18563;-1;2164;0;0;0;0;.00nan;0;0
18563;-1;2164;97;31;1;30;.968;3600000;0
18564;193486;2161;97;46;3;43;.935;3600000;0
18564;165350;2161;0;0;0;0;.00nan;0;0
18564;-1;4840;0;0;0;0;.00nan;0;0
18564;-1;4840;35;25;5;20;.800;3533000;0
18565;177771;2163;0;0;0;0;.00nan;0;0
18565;196495;2158;78;29;2;27;.931;3600000;0
18565;85984;2158;0;0;0;0;.00nan;0;0
18565;161081;2163;62;50;6;44;.880;3600000;0
18566;21607;2162;82;27;1;26;.963;3545000;0
18566;-1;2162;0;0;0;0;.00nan;0;0
18566;-1;2164;0;0;0;0;.00nan;0;0
18566;-1;2164;100;26;0;26;1.000;3600000;0
18567;193486;2161;63;29;2;27;.931;3596000;0
18567;165350;2161;0;0;0;0;.00nan;0;0
18567;-1;4840;81;27;1;26;.963;3600000;0
18567;-1;4840;0;0;0;0;.00nan;0;0
18568;177771;2163;0;0;0;0;.00nan;0;0
18568;196495;2158;0;0;0;0;.00nan;0;0
18568;85984;2158;85;10;0;10;1.000;3600000;0
18568;161081;2163;62;43;5;38;.884;3600000;0
18569;177771;2163;0;0;0;0;.00nan;0;0
18569;21607;2162;0;0;0;0;.00nan;0;0
18569;-1;2162;57;34;5;29;.853;3560000;0
18569;161081;2163;62;32;3;29;.906;3600000;0
18570;-1;4840;55;33;4;29;.879;2143000;0
18570;196495;2158;0;0;0;0;.00nan;0;0
18570;-1;4840;46;24;4;20;.833;1457000;0
18570;85984;2158;63;16;1;15;.938;3600000;0
18571;177771;2163;97;30;0;30;1.000;3600000;0
18571;21607;2162;0;0;0;0;.00nan;0;0
18571;-1;2162;56;34;5;29;.853;3600000;0
18571;161081;2163;0;0;0;0;.00nan;0;0
18572;-1;4840;0;0;0;0;.00nan;0;0
18572;196495;2158;76;11;0;11;1.000;3600000;0
18572;-1;4840;87;53;4;49;.925;3600000;0
18572;85984;2158;0;0;0;0;.00nan;0;0
18573;-1;2164;0;0;0;0;.00nan;0;0
18573;196495;2158;61;20;2;18;.900;3600000;0
18573;-1;2164;86;58;5;53;.914;3600000;0
18573;85984;2158;0;0;0;0;.00nan;0;0
18574;177771;2163;72;31;2;29;.935;3900000;0
18574;21607;2162;0;0;0;0;.00nan;0;0
18574;-1;2162;81;38;2;36;.947;3900000;0
18574;161081;2163;0;0;0;0;.00nan;0;0
18575;-1;2164;31;11;4;7;.636;689000;0
18575;196495;2158;0;0;0;0;.00nan;0;0
18575;-1;2164;35;34;6;28;.824;2911000;0
18575;85984;2158;70;20;1;19;.950;3600000;0
18576;177771;2163;0;0;0;0;.00nan;0;0
18576;21607;2162;0;0;0;0;.00nan;0;0
18576;-1;2162;74;26;2;24;.923;3600000;0
18576;161081;2163;66;31;3;28;.903;3600000;0
18577;193486;2161;66;33;4;29;.879;3646000;0
18577;165350;2161;0;0;0;0;.00nan;0;0
18577;-1;2164;0;0;0;0;.00nan;0;0
18577;-1;2164;94;47;3;44;.936;3646000;0
18578;21607;2162;0;0;0;0;.00nan;0;0
18578;-1;2162;79;23;1;22;.957;3600000;0
18578;-1;4840;54;30;4;26;.867;3600000;0
18578;-1;4840;0;0;0;0;.00nan;0;0
18579;177771;2163;0;0;0;0;.00nan;0;0
18579;196495;2158;79;12;0;12;1.000;3600000;0
18579;85984;2158;0;0;0;0;.00nan;0;0
18579;161081;2163;87;53;4;49;.925;3600000;0
18580;193486;2161;0;0;0;0;.00nan;0;0
18580;165350;2161;56;27;3;24;.889;3900000;0
18580;-1;2164;64;34;3;31;.912;3900000;0
18580;-1;2164;0;0;0;0;.00nan;0;0
18581;-1;2162;49;42;6;36;.857;3579000;0
18581;175423;2162;0;0;0;0;.00nan;0;0
18581;-1;4840;0;0;0;0;.00nan;0;0
18581;-1;4840;81;40;4;36;.900;3600000;0
18582;177771;2163;0;0;0;0;.00nan;0;0
18582;196495;2158;61;12;1;11;.917;3600000;0
18582;85984;2158;0;0;0;0;.00nan;0;0
18582;161081;2163;91;59;5;54;.915;3600000;0
18583;-1;2162;70;22;2;20;.909;3900000;0
18583;175423;2162;0;0;0;0;.00nan;0;0
18583;-1;2164;0;0;0;0;.00nan;0;0
18583;-1;2164;75;38;2;36;.947;3900000;0
18584;-1;4840;89;89;7;82;.921;3600000;0
18584;196495;2158;60;11;1;10;.909;3600000;0
18584;-1;4840;0;0;0;0;.00nan;0;0
18584;85984;2158;0;0;0;0;.00nan;0;0
18585;193486;2161;71;35;3;32;.914;3541000;0
18585;177771;2163;0;0;0;0;.00nan;0;0
18585;165350;2161;0;0;0;0;.00nan;0;0
18585;161081;2163;94;31;1;30;.968;3600000;0
18586;-1;2162;0;0;0;0;.00nan;0;0
18586;175423;2162;91;32;1;31;.969;3600000;0
18586;-1;2164;25;23;5;18;.783;3600000;0
18586;-1;2164;0;0;0;0;.00nan;0;0
18587;-1;4840;4;23;8;15;.652;916000;0
18587;196495;2158;0;0;0;0;.00nan;0;0
18587;-1;4840;52;44;6;38;.864;2684000;0
18587;85984;2158;94;21;0;21;1.000;3600000;0
18588;193486;2161;0;0;0;0;.00nan;0;0
18588;177771;2163;0;0;0;0;.00nan;0;0
18588;165350;2161;60;39;4;35;.897;3600000;0
18588;161081;2163;86;30;1;29;.967;3600000;0
18589;193486;2161;88;41;2;39;.951;3752000;0
18589;165350;2161;0;0;0;0;.00nan;0;0
18589;-1;2162;81;25;1;24;.960;3752000;0
18589;175423;2162;0;0;0;0;.00nan;0;0
18590;-1;2164;0;0;0;0;.00nan;0;0
18590;196495;2158;0;0;0;0;.00nan;0;0
18590;-1;2164;88;64;4;60;.938;3595000;0
18590;85984;2158;41;11;3;8;.727;3600000;0
18591;177771;2163;0;0;0;0;.00nan;0;0
18591;-1;4840;78;21;1;20;.952;3600000;0
18591;-1;4840;0;0;0;0;.00nan;0;0
18591;161081;2163;62;28;3;25;.893;3580000;0
18592;193486;2161;83;23;1;22;.957;3600000;0
18592;165350;2161;0;0;0;0;.00nan;0;0
18592;-1;2162;85;42;3;39;.929;3600000;0
18592;175423;2162;0;0;0;0;.00nan;0;0
18593;-1;2164;52;10;1;9;.900;617000;0
18593;196495;2158;59;19;2;17;.895;3600000;0
18593;-1;2164;40;36;6;30;.833;2983000;0
18593;85984;2158;0;0;0;0;.00nan;0;0
18594;177771;2163;0;0;0;0;.00nan;0;0
18594;-1;4840;81;29;1;28;.966;3600000;0
18594;-1;4840;0;0;0;0;.00nan;0;0
18594;161081;2163;64;34;4;30;.882;3600000;0
18595;193486;2161;42;37;6;31;.838;2938000;0
18595;165350;2161;56;7;0;7;1.000;662000;0
18595;196495;2158;62;19;2;17;.895;3600000;0
18595;85984;2158;0;0;0;0;.00nan;0;0
18596;177771;2163;0;0;0;0;.00nan;0;0
18596;-1;2164;71;36;2;34;.944;3600000;0
18596;-1;2164;0;0;0;0;.00nan;0;0
18596;161081;2163;96;33;1;32;.970;3600000;0
18597;-1;2162;67;27;3;24;.889;3767000;0
18597;175423;2162;0;0;0;0;.00nan;0;0
18597;-1;4840;80;33;2;31;.939;3767000;0
18597;-1;4840;0;0;0;0;.00nan;0;0
18598;193486;2161;0;0;0;0;.00nan;0;0
18598;165350;2161;56;44;5;39;.886;3600000;0
18598;196495;2158;0;0;0;0;.00nan;0;0
18598;85984;2158;44;10;2;8;.800;3600000;0
18599;177771;2163;92;38;2;36;.947;3600000;0
18599;-1;2164;50;1;0;1;1.000;391000;0
18599;-1;2164;33;31;6;25;.806;3209000;0
18599;161081;2163;0;0;0;0;.00nan;0;0
18600;-1;2162;0;0;0;0;.00nan;0;0
18600;175423;2162;89;34;2;32;.941;3569000;0
18600;-1;4840;0;0;0;0;.00nan;0;0
18600;-1;4840;81;26;1;25;.962;3600000;0
18601;193486;2161;74;33;3;30;.909;3670000;0
18601;165350;2161;0;0;0;0;.00nan;0;0
18601;-1;4840;0;0;0;0;.00nan;0;0
18601;-1;4840;69;32;4;28;.875;3670000;0
18602;-1;2162;98;45;2;43;.956;3553000;0
18602;175423;2162;0;0;0;0;.00nan;0;0
18602;196495;2158;82;14;0;14;1.000;3600000;0
18602;85984;2158;0;0;0;0;.00nan;0;0
18603;177771;2163;0;0;0;0;.00nan;0;0
18603;-1;2164;0;0;0;0;.00nan;0;0
18603;-1;2164;62;36;4;32;.889;3600000;0
18603;161081;2163;73;19;1;18;.947;3600000;0
18604;193486;2161;0;0;0;0;.00nan;0;0
18604;165350;2161;86;34;1;33;.971;3600000;0
18604;-1;4840;90;38;2;36;.947;3600000;0
18604;-1;4840;0;0;0;0;.00nan;0;0
18605;-1;2162;66;51;6;45;.882;3348000;0
18605;175423;2162;49;2;0;2;1.000;252000;0
18605;196495;2158;50;15;2;13;.867;3600000;0
18605;85984;2158;0;0;0;0;.00nan;0;0
18606;177771;2163;65;29;2;27;.931;3600000;0
18606;-1;2164;77;35;4;31;.886;3593000;0
18606;-1;2164;0;0;0;0;.00nan;0;0
18606;161081;2163;0;0;0;0;.00nan;0;0
18607;-1;2164;0;0;0;0;.00nan;0;0
18607;-1;4840;78;32;2;30;.938;3600000;0
18607;-1;2164;84;31;1;30;.968;3600000;0
18607;-1;4840;0;0;0;0;.00nan;0;0
18608;193486;2161;86;47;2;45;.957;3553000;0
18608;165350;2161;0;0;0;0;.00nan;0;0
18608;196495;2158;66;12;1;11;.917;3600000;0
18608;85984;2158;0;0;0;0;.00nan;0;0
18609;-1;2164;88;33;2;31;.939;3753000;0
18609;-1;4840;0;0;0;0;.00nan;0;0
18609;-1;2164;0;0;0;0;.00nan;0;0
18609;-1;4840;62;26;3;23;.885;3753000;0
18610;193486;2161;0;0;0;0;.00nan;0;0
18610;165350;2161;66;48;5;43;.896;3600000;0
18610;196495;2158;0;0;0;0;.00nan;0;0
18610;85984;2158;82;25;1;24;.960;3600000;0
18611;193486;2161;55;27;3;24;.889;3512000;0
18611;165350;2161;0;0;0;0;.00nan;0;0
18611;-1;2164;99;45;1;44;.978;3600000;0
18611;-1;2164;0;0;0;0;.00nan;0;0
18612;177771;2163;0;0;0;0;.00nan;0;0
18612;-1;4840;59;32;3;29;.906;3900000;0
18612;-1;4840;0;0;0;0;.00nan;0;0
18612;161081;2163;83;50;3;47;.940;3900000;0
18613;193486;2161;0;0;0;0;.00nan;0;0
18613;165350;2161;65;30;3;27;.900;3600000;0
18613;-1;2164;61;44;5;39;.886;3514000;0
18613;-1;2164;0;0;0;0;.00nan;0;0
18614;177771;2163;93;37;3;34;.919;3600000;0
18614;-1;4840;84;29;1;28;.966;2531000;0
18614;-1;4840;16;8;4;4;.500;985000;0
18614;161081;2163;0;0;0;0;.00nan;0;0
18615;193486;2161;72;36;3;33;.917;3600000;0
18615;165350;2161;0;0;0;0;.00nan;0;0
18615;-1;2162;0;0;0;0;.00nan;0;0
18615;175423;2162;100;30;0;30;1.000;3600000;0
18616;-1;4840;57;47;6;41;.872;3600000;0
18616;212440;4840;0;0;0;0;.00nan;0;0
18616;196495;2158;69;22;1;21;.955;3600000;0
18616;85984;2158;0;0;0;0;.00nan;0;0
18617;177771;2163;0;0;0;0;.00nan;0;0
18617;-1;2164;0;0;0;0;.00nan;0;0
18617;-1;2164;82;28;1;27;.964;3600000;0
18617;161081;2163;74;39;3;36;.923;3573000;0
18618;193486;2161;0;0;0;0;.00nan;0;0
18618;165350;2161;39;30;5;25;.833;3600000;0
18618;-1;2162;0;0;0;0;.00nan;0;0
18618;175423;2162;75;32;2;30;.938;3600000;0
18619;-1;4840;0;0;0;0;.00nan;0;0
18619;212440;4840;89;72;5;67;.931;3600000;0
18619;196495;2158;82;12;0;12;1.000;3600000;0
18619;85984;2158;0;0;0;0;.00nan;0;0
18620;177771;2163;81;31;1;30;.968;3600000;0
18620;-1;2164;61;27;3;24;.889;3513000;0
18620;-1;2164;0;0;0;0;.00nan;0;0
18620;161081;2163;0;0;0;0;.00nan;0;0
18621;177771;2163;0;0;0;0;.00nan;0;0
18621;-1;2162;0;0;0;0;.00nan;0;0
18621;175423;2162;72;28;2;26;.929;3600000;0
18621;161081;2163;54;33;4;29;.879;3588000;0
18622;193486;2161;59;38;5;33;.868;3600000;0
18622;165350;2161;0;0;0;0;.00nan;0;0
18622;196495;2158;83;27;1;26;.963;3600000;0
18622;85984;2158;0;0;0;0;.00nan;0;0
18623;177771;2163;83;36;3;33;.917;3900000;0
18623;-1;2162;0;0;0;0;.00nan;0;0
18623;175423;2162;90;42;3;39;.929;3900000;0
18623;161081;2163;0;0;0;0;.00nan;0;0
18624;193486;2161;0;0;0;0;.00nan;0;0
18624;165350;2161;90;43;2;41;.953;3587000;0
18624;196495;2158;66;18;1;17;.944;3600000;0
18624;85984;2158;0;0;0;0;.00nan;0;0
18625;193486;2161;70;30;2;28;.933;3589000;0
18625;165350;2161;0;0;0;0;.00nan;0;0
18625;-1;2162;0;0;0;0;.00nan;0;0
18625;175423;2162;83;28;1;27;.964;3600000;0
18626;-1;2164;0;0;0;0;.00nan;0;0
18626;196495;2158;90;18;0;18;1.000;3600000;0
18626;-1;2164;94;50;3;47;.940;3600000;0
18626;85984;2158;0;0;0;0;.00nan;0;0
18627;177771;2163;0;0;0;0;.00nan;0;0
18627;-1;4840;62;15;1;14;.933;3164000;0
18627;212440;4840;15;6;4;2;.333;436000;0
18627;161081;2163;100;30;0;30;1.000;3600000;0
18628;193486;2161;0;0;0;0;.00nan;0;0
18628;165350;2161;69;31;3;28;.903;3612000;0
18628;-1;2162;0;0;0;0;.00nan;0;0
18628;175423;2162;80;32;2;30;.938;3612000;0
18629;-1;2164;78;62;6;56;.903;3600000;0
18629;196495;2158;60;13;1;12;.923;3600000;0
18629;-1;2164;0;0;0;0;.00nan;0;0
18629;85984;2158;0;0;0;0;.00nan;0;0
18630;177771;2163;0;0;0;0;.00nan;0;0
18630;-1;4840;0;0;0;0;.00nan;0;0
18630;212440;4840;78;38;3;35;.921;3600000;0
18630;161081;2163;95;21;0;21;1.000;3600000;0
18631;193486;2161;59;16;1;15;.938;3600000;0
18631;165350;2161;0;0;0;0;.00nan;0;0
18631;-1;2164;0;0;0;0;.00nan;0;0
18631;-1;2164;52;33;4;29;.879;3600000;0
18632;-1;2162;0;0;0;0;.00nan;0;0
18632;175423;2162;85;33;2;31;.939;3600000;0
18632;-1;4840;0;0;0;0;.00nan;0;0
18632;212440;4840;73;45;4;41;.911;3577000;0
18633;177771;2163;0;0;0;0;.00nan;0;0
18633;196495;2158;49;9;2;7;.778;3697000;0
18633;85984;2158;0;0;0;0;.00nan;0;0
18633;161081;2163;92;66;3;63;.955;3697000;0
18634;193486;2161;0;0;0;0;.00nan;0;0
18634;165350;2161;81;31;1;30;.968;3600000;0
18634;-1;2164;73;30;2;28;.933;3572000;0
18634;-1;2164;0;0;0;0;.00nan;0;0
18635;-1;2162;0;0;0;0;.00nan;0;0
18635;175423;2162;51;16;2;14;.875;3600000;0
18635;-1;4840;0;0;0;0;.00nan;0;0
18635;212440;4840;57;51;7;44;.863;3600000;0
18636;177771;2163;94;66;5;61;.924;3600000;0
18636;196495;2158;70;17;1;16;.941;3600000;0
18636;85984;2158;0;0;0;0;.00nan;0;0
18636;161081;2163;0;0;0;0;.00nan;0;0
18637;193486;2161;27;26;6;20;.769;2839000;0
18637;165350;2161;49;9;1;8;.889;733000;0
18637;-1;4840;60;21;2;19;.905;2569000;0
18637;212440;4840;24;10;4;6;.600;1031000;0
18638;177771;2163;0;0;0;0;.00nan;0;0
18638;-1;2164;0;0;0;0;.00nan;0;0
18638;-1;2164;89;33;2;31;.939;3600000;0
18638;161081;2163;61;30;4;26;.867;3575000;0
18639;-1;2162;0;0;0;0;.00nan;0;0
18639;175423;2162;71;40;3;37;.925;3600000;0
18639;196495;2158;80;30;1;29;.967;3600000;0
18639;85984;2158;0;0;0;0;.00nan;0;0
18640;193486;2161;0;0;0;0;.00nan;0;0
18640;165350;2161;39;27;4;23;.852;3600000;0
18640;-1;4840;0;0;0;0;.00nan;0;0
18640;212440;4840;78;27;1;26;.963;3600000;0
18641;177771;2163;78;40;4;36;.900;3522000;0
18641;-1;2164;71;26;2;24;.923;3600000;0
18641;-1;2164;0;0;0;0;.00nan;0;0
18641;161081;2163;0;0;0;0;.00nan;0;0
18642;-1;2162;0;0;0;0;.00nan;0;0
18642;175423;2162;100;37;0;37;1.000;3600000;0
18642;196495;2158;55;23;3;20;.870;3600000;0
18642;85984;2158;0;0;0;0;.00nan;0;0
18643;193486;2161;83;29;3;26;.897;3900000;0
18643;165350;2161;0;0;0;0;.00nan;0;0
18643;-1;2164;0;0;0;0;.00nan;0;0
18643;-1;2164;69;28;3;25;.893;3900000;0
18644;-1;2162;0;0;0;0;.00nan;0;0
18644;175423;2162;67;48;5;43;.896;3600000;0
18644;196495;2158;74;8;0;8;1.000;3600000;0
18644;85984;2158;0;0;0;0;.00nan;0;0
18645;177771;2163;0;0;0;0;.00nan;0;0
18645;-1;4840;0;0;0;0;.00nan;0;0
18645;212440;4840;94;32;1;31;.969;3900000;0
18645;161081;2163;94;34;1;33;.971;3900000;0
18646;193486;2161;0;0;0;0;.00nan;0;0
18646;165350;2161;75;20;1;19;.950;3600000;0
18646;-1;2164;56;40;5;35;.875;3600000;0
18646;-1;2164;0;0;0;0;.00nan;0;0
18647;-1;2162;0;0;0;0;.00nan;0;0
18647;175423;2162;67;30;3;27;.900;3600000;0
18647;196495;2158;72;11;0;11;1.000;3600000;0
18647;85984;2158;0;0;0;0;.00nan;0;0
18648;177771;2163;92;44;3;41;.932;3848000;0
18648;-1;4840;0;0;0;0;.00nan;0;0
18648;212440;4840;54;19;2;17;.895;3848000;0
18648;161081;2163;0;0;0;0;.00nan;0;0
18649;-1;2162;0;0;0;0;.00nan;0;0
18649;175423;2162;73;22;1;21;.955;3600000;0
18649;-1;2164;0;0;0;0;.00nan;0;0
18649;-1;2164;61;42;5;37;.881;3600000;0
18650;-1;4840;0;0;0;0;.00nan;0;0
18650;212440;4840;98;55;3;52;.945;3600000;0
18650;196495;2158;54;14;2;12;.857;3600000;0
18650;85984;2158;0;0;0;0;.00nan;0;0
18651;193486;2161;50;29;3;26;.897;3573000;0
18651;177771;2163;0;0;0;0;.00nan;0;0
18651;165350;2161;0;0;0;0;.00nan;0;0
18651;161081;2163;99;48;2;46;.958;3600000;0
18652;-1;2162;0;0;0;0;.00nan;0;0
18652;175423;2162;75;22;1;21;.955;3600000;0
18652;-1;2164;58;29;3;26;.897;3564000;0
18652;-1;2164;0;0;0;0;.00nan;0;0
18653;-1;4840;0;0;0;0;.00nan;0;0
18653;212440;4840;98;59;2;57;.966;3568000;0
18653;196495;2158;0;0;0;0;.00nan;0;0
18653;85984;2158;84;12;0;12;1.000;3600000;0
18654;193486;2161;0;0;0;0;.00nan;0;0
18654;177771;2163;91;38;2;36;.947;3900000;0
18654;165350;2161;58;23;2;21;.913;3900000;0
18654;161081;2163;0;0;0;0;.00nan;0;0
18655;193486;2161;0;0;0;0;.00nan;0;0
18655;165350;2161;81;25;2;23;.920;3600000;0
18655;-1;2162;0;0;0;0;.00nan;0;0
18655;175423;2162;70;33;3;30;.909;3578000;0
18656;-1;2164;0;0;0;0;.00nan;0;0
18656;-1;4840;0;0;0;0;.00nan;0;0
18656;212440;4840;100;26;0;26;1.000;3600000;0
18656;-1;2164;85;33;2;31;.939;3600000;0
18657;193486;2161;46;34;5;29;.853;3575000;0
18657;165350;2161;0;0;0;0;.00nan;0;0
18657;-1;2162;0;0;0;0;.00nan;0;0
18657;175423;2162;57;37;4;33;.892;3600000;0
18658;-1;2164;62;21;2;19;.905;3600000;0
18658;-1;4840;0;0;0;0;.00nan;0;0
18658;212440;4840;89;42;3;39;.929;3545000;0
18658;-1;2164;0;0;0;0;.00nan;0;0
18659;193486;2161;47;19;3;16;.842;3600000;0
18659;177771;2163;33;21;4;17;.810;1711000;0
18659;165350;2161;0;0;0;0;.00nan;0;0
18659;161081;2163;10;15;6;9;.600;1889000;0
18660;-1;2162;84;30;2;28;.933;3600000;0
18660;175423;2162;0;0;0;0;.00nan;0;0
18660;-1;4840;0;0;0;0;.00nan;0;0
18660;212440;4840;66;31;3;28;.903;3600000;0
18661;-1;2164;0;0;0;0;.00nan;0;0
18661;196495;2158;0;0;0;0;.00nan;0;0
18661;-1;2164;98;49;2;47;.959;3900000;0
18661;85984;2158;60;13;2;11;.846;3900000;0
18662;193486;2161;0;0;0;0;.00nan;0;0
18662;177771;2163;0;0;0;0;.00nan;0;0
18662;165350;2161;71;28;3;25;.893;3543000;0
18662;161081;2163;84;36;2;34;.944;3600000;0
18663;-1;2162;0;0;0;0;.00nan;0;0
18663;175423;2162;79;29;2;27;.931;3600000;0
18663;-1;4840;55;24;3;21;.875;3600000;0
18663;212440;4840;0;0;0;0;.00nan;0;0
18664;-1;2164;89;62;4;58;.935;3559000;0
18664;196495;2158;42;15;3;12;.800;3600000;0
18664;-1;2164;0;0;0;0;.00nan;0;0
18664;85984;2158;0;0;0;0;.00nan;0;0
18665;-1;2162;49;17;2;15;.882;3545000;0
18665;175423;2162;0;0;0;0;.00nan;0;0
18665;-1;2164;0;0;0;0;.00nan;0;0
18665;-1;2164;85;27;1;26;.963;3600000;0
18666;193486;2161;75;33;2;31;.939;3620000;0
18666;165350;2161;0;0;0;0;.00nan;0;0
18666;-1;4840;0;0;0;0;.00nan;0;0
18666;212440;4840;89;43;3;40;.930;3620000;0
18667;177771;2163;64;29;2;27;.931;1495000;0
18667;196495;2158;61;17;2;15;.882;3600000;0
18667;85984;2158;0;0;0;0;.00nan;0;0
18667;161081;2163;35;39;7;32;.821;2105000;0
18668;-1;2162;0;0;0;0;.00nan;0;0
18668;175423;2162;82;23;1;22;.957;3600000;0
18668;-1;2164;98;52;2;50;.962;3600000;0
18668;-1;2164;0;0;0;0;.00nan;0;0
18669;193486;2161;0;0;0;0;.00nan;0;0
18669;165350;2161;46;28;3;25;.893;3900000;0
18669;-1;4840;0;0;0;0;.00nan;0;0
18669;212440;4840;55;22;3;19;.864;3900000;0
18670;177771;2163;0;0;0;0;.00nan;0;0
18670;196495;2158;0;0;0;0;.00nan;0;0
18670;85984;2158;51;9;1;8;.889;3558000;0
18670;161081;2163;100;45;0;45;1.000;3600000;0
18671;193486;2161;83;41;3;38;.927;3600000;0
18671;165350;2161;0;0;0;0;.00nan;0;0
18671;196495;2158;68;15;1;14;.933;3600000;0
18671;85984;2158;0;0;0;0;.00nan;0;0
18672;-1;2164;0;0;0;0;.00nan;0;0
18672;-1;4840;0;0;0;0;.00nan;0;0
18672;212440;4840;50;25;3;22;.880;3545000;0
18672;-1;2164;100;39;1;38;.974;3600000;0
18673;177771;2163;0;0;0;0;.00nan;0;0
18673;-1;2162;46;20;3;17;.850;3600000;0
18673;175423;2162;0;0;0;0;.00nan;0;0
18673;161081;2163;100;35;0;35;1.000;3600000;0
18674;193486;2161;0;0;0;0;.00nan;0;0
18674;165350;2161;70;55;5;50;.909;3600000;0
18674;196495;2158;57;9;1;8;.889;3600000;0
18674;85984;2158;0;0;0;0;.00nan;0;0
18675;-1;2164;0;0;0;0;.00nan;0;0
18675;-1;4840;86;27;2;25;.926;3876000;0
18675;212440;4840;0;0;0;0;.00nan;0;0
18675;-1;2164;98;36;1;35;.972;3876000;0
18676;177771;2163;0;0;0;0;.00nan;0;0
18676;-1;2162;0;0;0;0;.00nan;0;0
18676;175423;2162;100;27;0;27;1.000;3600000;0
18676;161081;2163;57;39;5;34;.872;3600000;0
18678;193486;2161;78;32;4;28;.875;3600000;0
18678;177771;2163;0;0;0;0;.00nan;0;0
18678;165350;2161;0;0;0;0;.00nan;0;0
18678;161081;2163;95;31;1;30;.968;3600000;0
18680;-1;4840;0;0;0;0;.00nan;0;0
18680;196495;2158;63;22;2;20;.909;3600000;0
18680;-1;4840;69;53;6;47;.887;3600000;0
18680;85984;2158;0;0;0;0;.00nan;0;0
18682;21607;2162;0;0;0;0;.00nan;0;0
18682;-1;2162;61;31;3;28;.903;3559000;0
18682;-1;2164;0;0;0;0;.00nan;0;0
18682;-1;2164;84;30;2;28;.933;3600000;0
18684;-1;4840;68;57;6;51;.895;3137000;0
18684;196495;2158;0;0;0;0;.00nan;0;0
18684;-1;4840;40;10;2;8;.800;463000;0
18684;85984;2158;50;7;1;6;.857;3600000;0
18686;177771;2163;88;58;4;54;.931;3559000;0
18686;21607;2162;53;22;3;19;.864;3600000;0
18686;-1;2162;0;0;0;0;.00nan;0;0
18686;161081;2163;0;0;0;0;.00nan;0;0
18688;193486;2161;0;0;0;0;.00nan;0;0
18688;165350;2161;77;30;2;28;.933;3600000;0
18688;-1;2164;66;42;4;38;.905;3515000;0
18688;-1;2164;0;0;0;0;.00nan;0;0
18690;177771;2163;0;0;0;0;.00nan;0;0
18690;-1;2164;94;31;1;30;.968;3600000;0
18690;-1;2164;0;0;0;0;.00nan;0;0
18690;161081;2163;59;28;3;25;.893;3530000;0
18692;21607;2162;0;0;0;0;.00nan;0;0
18692;-1;2162;80;81;7;74;.914;3600000;0
18692;196495;2158;75;11;0;11;1.000;3600000;0
18692;85984;2158;0;0;0;0;.00nan;0;0
18694;193486;2161;90;38;1;37;.974;3600000;0
18694;165350;2161;0;0;0;0;.00nan;0;0
18694;-1;4840;0;0;0;0;.00nan;0;0
18694;-1;4840;41;22;4;18;.818;3600000;0
18696;193486;2161;0;0;0;0;.00nan;0;0
18696;165350;2161;88;43;2;41;.953;3596000;0
18696;196495;2158;64;15;1;14;.933;3600000;0
18696;85984;2158;0;0;0;0;.00nan;0;0
18698;21607;2162;74;31;2;29;.935;3900000;0
18698;-1;2162;0;0;0;0;.00nan;0;0
18698;-1;4840;80;31;2;29;.935;3900000;0
18698;-1;4840;0;0;0;0;.00nan;0;0
18700;177771;2163;76;26;1;25;.962;3600000;0
18700;-1;2164;0;0;0;0;.00nan;0;0
18700;-1;2164;58;27;3;24;.889;3525000;0
18700;161081;2163;0;0;0;0;.00nan;0;0
18702;-1;2164;41;37;6;31;.838;3572000;0
18702;-1;4840;0;0;0;0;.00nan;0;0
18702;-1;2164;0;0;0;0;.00nan;0;0
18702;-1;4840;34;21;5;16;.762;3600000;0
18704;193486;2161;69;25;1;24;.960;3600000;0
18704;177771;2163;0;0;0;0;.00nan;0;0
18704;165350;2161;0;0;0;0;.00nan;0;0
18704;161081;2163;48;40;6;34;.850;3600000;0
18706;21607;2162;0;0;0;0;.00nan;0;0
18706;-1;2162;95;72;4;68;.944;3600000;0
18706;196495;2158;0;0;0;0;.00nan;0;0
18706;85984;2158;89;11;0;11;1.000;3600000;0
18708;-1;2164;58;20;2;18;.900;1052000;0
18708;196495;2158;60;12;2;10;.833;3600000;0
18708;-1;2164;59;57;7;50;.877;2548000;0
18708;85984;2158;0;0;0;0;.00nan;0;0
18710;193486;2161;0;0;0;0;.00nan;0;0
18710;177771;2163;70;51;5;46;.902;3600000;0
18710;165350;2161;64;21;1;20;.952;3600000;0
18710;161081;2163;0;0;0;0;.00nan;0;0
18712;21607;2162;84;39;2;37;.949;3892000;0
18712;-1;2162;0;0;0;0;.00nan;0;0
18712;-1;4840;90;38;2;36;.947;3900000;0
18712;-1;4840;0;0;0;0;.00nan;0;0
1779;193486;2161;92;54;4;50;.926;3600000;0
1779;165350;2161;0;0;0;0;.00nan;0;0
1779;196495;2158;42;13;3;10;.769;3600000;0
1779;85984;2158;0;0;0;0;.00nan;0;0
1780;177771;2163;0;0;0;0;.00nan;0;0
1780;-1;2162;0;0;0;0;.00nan;0;0
1780;175423;2162;60;16;1;15;.938;3600000;0
1780;161081;2163;79;33;2;31;.939;3544000;0
1781;193486;2161;88;53;3;50;.943;3585000;0
1781;165350;2161;0;0;0;0;.00nan;0;0
1781;196495;2158;70;18;1;17;.944;3600000;0
1781;85984;2158;0;0;0;0;.00nan;0;0
1782;177771;2163;0;0;0;0;.00nan;0;0
1782;-1;2162;0;0;0;0;.00nan;0;0
1782;175423;2162;65;20;2;18;.900;3600000;0
1782;161081;2163;93;45;3;42;.933;3600000;0
1955;-1;2162;0;0;0;0;.00nan;0;0
1955;175423;2162;87;53;3;50;.943;3580000;0
1955;196495;2158;61;12;1;11;.917;3600000;0
1955;85984;2158;0;0;0;0;.00nan;0;0
1956;-1;2162;0;0;0;0;.00nan;0;0
1956;175423;2162;48;35;5;30;.857;3600000;0
1956;196495;2158;63;15;1;14;.933;3600000;0
1956;85984;2158;0;0;0;0;.00nan;0;0
1957;-1;2162;0;0;0;0;.00nan;0;0
1957;175423;2162;70;43;4;39;.907;3554000;0
1957;196495;2158;61;20;2;18;.900;3600000;0
1957;85984;2158;0;0;0;0;.00nan;0;0
18713;168001;3795;0;0;0;0;.00nan;0;0
18713;170294;3797;100;47;0;47;1.000;3600000;0
18713;196445;3797;0;0;0;0;.00nan;0;0
18713;85709;3795;66;33;3;30;.909;3600000;0
18714;168089;3796;0;0;0;0;.00nan;0;0
18714;173279;4635;73;33;3;30;.909;3600000;0
18714;-1;4635;0;0;0;0;.00nan;0;0
18714;91413;3796;100;38;0;38;1.000;3600000;0
18715;168001;3795;0;0;0;0;.00nan;0;0
18715;196456;3798;51;40;6;34;.850;3074000;0
18715;85709;3795;48;17;3;14;.824;3600000;0
18715;94615;3798;56;5;0;5;1.000;526000;0
18716;170294;3797;86;52;5;47;.904;3600000;0
18716;196445;3797;0;0;0;0;.00nan;0;0
18716;59231;3800;0;0;0;0;.00nan;0;0
18716;152717;3800;84;29;1;28;.966;3600000;0
18717;168089;3796;0;0;0;0;.00nan;0;0
18717;59231;3800;0;0;0;0;.00nan;0;0
18717;91413;3796;81;26;1;25;.962;3600000;0
18717;152717;3800;59;34;6;28;.824;3600000;0
18718;173279;4635;50;32;4;28;.875;3543000;0
18718;196456;3798;94;39;2;37;.949;3600000;0
18718;-1;4635;0;0;0;0;.00nan;0;0
18718;85709;3798;0;0;0;0;.00nan;0;0
18719;168001;3795;38;32;6;26;.813;3600000;0
18719;168089;3796;0;0;0;0;.00nan;0;0
18719;-1;3795;0;0;0;0;.00nan;0;0
18719;91413;3796;81;41;3;38;.927;3600000;0
18720;170294;3797;43;33;5;28;.848;3554000;0
18720;196445;3797;0;0;0;0;.00nan;0;0
18720;59231;3800;0;0;0;0;.00nan;0;0
18720;152717;3800;43;24;4;20;.833;3600000;0
18721;196456;3798;0;0;0;0;.00nan;0;0
18721;59231;3800;98;36;2;34;.944;3600000;0
18721;85709;3798;67;38;4;34;.895;3522000;0
18721;152717;3800;0;0;0;0;.00nan;0;0
18722;170294;3797;96;34;2;32;.941;3600000;0
18722;201661;4635;0;0;0;0;.00nan;0;0
18722;-1;4635;44;26;4;22;.846;3545000;0
18722;78845;3797;0;0;0;0;.00nan;0;0
18723;168001;3795;100;36;1;35;.972;3600000;0
18723;168089;3796;0;0;0;0;.00nan;0;0
18723;-1;3795;0;0;0;0;.00nan;0;0
18723;91413;3796;39;23;5;18;.783;3600000;0
18724;201661;4635;66;30;4;26;.867;3600000;0
18724;-1;4635;0;0;0;0;.00nan;0;0
18724;59231;3800;0;0;0;0;.00nan;0;0
18724;152717;3800;42;30;5;25;.833;3600000;0
18725;170294;3797;99;39;1;38;.974;3600000;0
18725;196456;3798;19;10;4;6;.600;778000;0
18725;78845;3797;0;0;0;0;.00nan;0;0
18725;85709;3798;55;26;3;23;.885;2822000;0
18726;168089;3796;94;36;1;35;.972;3600000;0
18726;201661;4635;92;44;3;41;.932;3567000;0
18726;-1;4635;0;0;0;0;.00nan;0;0
18726;91413;3796;0;0;0;0;.00nan;0;0
18727;170294;3797;66;30;3;27;.900;3567000;0
18727;196456;3798;83;33;2;31;.939;3600000;0
18727;78845;3797;0;0;0;0;.00nan;0;0
18727;85709;3798;0;0;0;0;.00nan;0;0
18728;168001;3795;0;0;0;0;.00nan;0;0
18728;-1;3795;66;33;4;29;.879;3600000;0
18728;59231;3800;0;0;0;0;.00nan;0;0
18728;152717;3800;42;32;5;27;.844;3584000;0
18729;168089;3796;0;0;0;0;.00nan;0;0
18729;170294;3797;70;44;5;39;.886;3545000;0
18729;78845;3797;0;0;0;0;.00nan;0;0
18729;91413;3796;56;32;4;28;.875;3600000;0
18730;201661;4635;80;38;3;35;.921;3600000;0
18730;-1;4635;0;0;0;0;.00nan;0;0
18730;59231;3800;72;44;4;40;.909;3548000;0
18730;152717;3800;0;0;0;0;.00nan;0;0
18731;168001;3795;75;26;1;25;.962;3600000;0
18731;196456;3798;0;0;0;0;.00nan;0;0
18731;-1;3795;0;0;0;0;.00nan;0;0
18731;85709;3798;72;39;3;36;.923;3540000;0
18732;170294;3797;80;34;3;31;.912;3600000;0
18732;196456;3798;61;34;4;30;.882;3600000;0
18732;78845;3797;0;0;0;0;.00nan;0;0
18732;85709;3798;0;0;0;0;.00nan;0;0
18733;168089;3796;0;0;0;0;.00nan;0;0
18733;196456;3798;90;34;2;32;.941;3900000;0
18733;85709;3798;0;0;0;0;.00nan;0;0
18733;91413;3796;96;45;2;43;.956;3900000;0
18734;168001;3795;27;34;7;27;.794;3600000;0
18734;-1;3795;0;0;0;0;.00nan;0;0
18734;59231;3800;0;0;0;0;.00nan;0;0
18734;152717;3800;70;29;2;27;.931;3600000;0
18735;170294;3797;83;39;3;36;.923;3600000;0
18735;201661;4635;49;28;4;24;.857;3600000;0
18735;-1;4635;0;0;0;0;.00nan;0;0
18735;78845;3797;0;0;0;0;.00nan;0;0
18736;168089;3796;0;0;0;0;.00nan;0;0
18736;201661;4635;0;0;0;0;.00nan;0;0
18736;-1;4635;74;49;5;44;.898;3883000;0
18736;91413;3796;59;27;4;23;.852;3883000;0
18737;168089;3796;0;0;0;0;.00nan;0;0
18737;59231;3800;0;0;0;0;.00nan;0;0
18737;91413;3796;91;33;1;32;.970;3600000;0
18737;152717;3800;79;29;2;27;.931;3600000;0
18738;170294;3798;87;40;3;37;.925;3673000;0
18738;201661;4635;83;40;4;36;.900;3673000;0
18738;196456;3798;0;0;0;0;.00nan;0;0
18738;-1;4635;0;0;0;0;.00nan;0;0
18739;168001;3795;0;0;0;0;.00nan;0;0
18739;-1;3795;94;39;1;38;.974;3600000;0
18739;78815;3797;0;0;0;0;.00nan;0;0
18739;78845;3797;32;48;9;39;.813;3600000;0
18740;170294;3798;96;50;2;48;.960;3900000;0
18740;196456;3798;0;0;0;0;.00nan;0;0
18740;59231;3800;78;24;2;22;.917;3900000;0
18740;152717;3800;0;0;0;0;.00nan;0;0
18741;168001;3795;41;29;4;25;.862;3548000;0
18741;201661;4635;90;41;3;38;.927;3600000;0
18741;-1;4635;0;0;0;0;.00nan;0;0
18741;-1;3795;0;0;0;0;.00nan;0;0
18742;2059;3797;62;33;4;29;.879;3600000;0
18742;168089;3796;0;0;0;0;.00nan;0;0
18742;78845;3797;0;0;0;0;.00nan;0;0
18742;91413;3796;53;45;6;39;.867;3600000;0
18743;2059;3797;82;45;4;41;.911;3600000;0
18743;170294;3798;60;43;6;37;.860;3591000;0
18743;196456;3798;0;0;0;0;.00nan;0;0
18743;78845;3797;0;0;0;0;.00nan;0;0
18744;168089;3796;0;0;0;0;.00nan;0;0
18744;59231;3800;0;0;0;0;.00nan;0;0
18744;91413;3796;47;29;4;25;.862;3600000;0
18744;152717;3800;91;28;1;27;.964;3600000;0
18745;168089;3796;53;3;0;3;1.000;437000;0
18745;170294;3798;64;30;5;25;.833;3600000;0
18745;196456;3798;0;0;0;0;.00nan;0;0
18745;91413;3796;48;38;6;32;.842;3109000;0
18746;168001;3795;0;0;0;0;.00nan;0;0
18746;201661;4635;78;45;4;41;.911;3579000;0
18746;-1;4635;0;0;0;0;.00nan;0;0
18746;-1;3795;63;22;2;20;.909;3600000;0
18747;2059;3797;17;27;7;20;.741;3285000;0
18747;59231;3800;52;16;2;14;.875;3600000;0
18747;78845;3797;35;5;2;3;.600;315000;0
18747;152717;3800;0;0;0;0;.00nan;0;0
18748;168089;3796;0;0;0;0;.00nan;0;0
18748;201661;4635;0;0;0;0;.00nan;0;0
18748;-1;4635;40;21;4;17;.810;3543000;0
18748;91413;3796;77;34;3;31;.912;3600000;0
18749;2059;3797;35;39;7;32;.821;3600000;0
18749;170294;3798;80;38;3;35;.921;3600000;0
18749;196456;3798;0;0;0;0;.00nan;0;0
18749;78845;3797;0;0;0;0;.00nan;0;0
18750;201661;4635;51;30;5;25;.833;3600000;0
18750;-1;4635;0;0;0;0;.00nan;0;0
18750;59231;3800;68;49;6;43;.878;3549000;0
18750;152717;3800;0;0;0;0;.00nan;0;0
18751;168001;3795;0;0;0;0;.00nan;0;0
18751;168089;3796;0;0;0;0;.00nan;0;0
18751;-1;3795;39;24;4;20;.833;3600000;0
18751;91413;3796;74;25;1;24;.960;3600000;0
18752;170294;3798;80;35;3;32;.914;3600000;0
18752;196456;3798;0;0;0;0;.00nan;0;0
18752;59231;3800;0;0;0;0;.00nan;0;0
18752;152717;3800;99;35;1;34;.971;3600000;0
18753;168001;3795;0;0;0;0;.00nan;0;0
18753;201661;4635;26;14;4;10;.714;1183000;0
18753;-1;4635;57;26;3;23;.885;2417000;0
18753;-1;3795;69;29;2;27;.931;3600000;0
18754;168089;3796;0;0;0;0;.00nan;0;0
18754;170294;3798;7;25;8;17;.680;1602000;0
18754;196456;3798;46;29;4;25;.862;1998000;0
18754;91413;3796;76;32;2;30;.938;3600000;0
18755;2059;3797;68;29;3;26;.897;3704000;0
18755;201661;4635;71;33;4;29;.879;3704000;0
18755;-1;4635;0;0;0;0;.00nan;0;0
18755;78845;3797;0;0;0;0;.00nan;0;0
18756;168001;3795;0;0;0;0;.00nan;0;0
18756;-1;3795;76;36;3;33;.917;3600000;0
18756;59231;3800;22;25;6;19;.760;3600000;0
18756;152717;3800;0;0;0;0;.00nan;0;0
18757;2059;3797;41;33;6;27;.818;2386000;0
18757;168001;3795;49;6;1;5;.833;832000;0
18757;-1;3795;26;24;6;18;.750;2768000;0
18757;78845;3797;52;17;2;15;.882;1214000;0
18758;168001;3795;67;30;3;27;.900;3600000;0
18758;170294;3798;48;37;6;31;.838;3124000;0
18758;196456;3798;53;3;0;3;1.000;476000;0
18758;-1;3795;0;0;0;0;.00nan;0;0
18759;2059;3797;94;35;1;34;.971;3600000;0
18759;168089;3796;0;0;0;0;.00nan;0;0
18759;78845;3797;0;0;0;0;.00nan;0;0
18759;91413;3796;73;36;3;33;.917;3533000;0
18760;201661;4635;78;46;5;41;.891;3600000;0
18760;-1;4635;0;0;0;0;.00nan;0;0
18760;59231;3800;76;24;1;23;.958;3600000;0
18760;152717;3800;0;0;0;0;.00nan;0;0
18761;168089;3796;0;0;0;0;.00nan;0;0
18761;201661;4635;0;0;0;0;.00nan;0;0
18761;-1;4635;74;31;2;29;.935;3556000;0
18761;91413;3796;83;32;1;31;.969;3600000;0
18762;170294;3798;0;0;0;0;.00nan;0;0
18762;196456;3798;89;17;0;17;1.000;3600000;0
18762;59231;3800;0;0;0;0;.00nan;0;0
18762;152717;3800;25;32;8;24;.750;3600000;0
18763;168089;3796;0;0;0;0;.00nan;0;0
18763;59231;3800;61;33;4;29;.879;3600000;0
18763;91413;3796;66;27;3;24;.889;3600000;0
18763;152717;3800;0;0;0;0;.00nan;0;0
18764;170294;3798;57;39;5;34;.872;3600000;0
18764;201661;4635;62;22;2;20;.909;3600000;0
18764;196456;3798;0;0;0;0;.00nan;0;0
18764;-1;4635;0;0;0;0;.00nan;0;0
18765;2059;3797;77;36;2;34;.944;3600000;0
18765;168001;3795;0;0;0;0;.00nan;0;0
18765;-1;3795;52;38;5;33;.868;3600000;0
18765;78845;3797;0;0;0;0;.00nan;0;0
18766;168001;3795;84;36;4;32;.889;3588000;0
18766;168089;3796;70;28;2;26;.929;3600000;0
18766;-1;3795;0;0;0;0;.00nan;0;0
18766;91413;3796;0;0;0;0;.00nan;0;0
18767;170294;3798;0;0;0;0;.00nan;0;0
18767;196456;3798;98;49;2;47;.959;3555000;0
18767;59231;3800;0;0;0;0;.00nan;0;0
18767;152717;3800;79;25;1;24;.960;3600000;0
18768;170294;3798;43;39;6;33;.846;3024000;0
18768;201661;4635;53;35;6;29;.829;3900000;0
18768;196456;3798;53;4;0;4;1.000;876000;0
18768;-1;4635;0;0;0;0;.00nan;0;0
18769;168001;3795;0;0;0;0;.00nan;0;0
18769;-1;3795;54;36;5;31;.861;3539000;0
18769;59231;3800;78;31;3;28;.903;3600000;0
18769;152717;3800;0;0;0;0;.00nan;0;0
18770;2059;3797;85;53;5;48;.906;3600000;0
18770;168089;3796;0;0;0;0;.00nan;0;0
18770;78845;3797;0;0;0;0;.00nan;0;0
18770;91413;3796;91;34;1;33;.971;3600000;0
18771;168089;3796;56;26;3;23;.885;3600000;0
18771;59231;3800;0;0;0;0;.00nan;0;0
18771;91413;3796;0;0;0;0;.00nan;0;0
18771;152717;3800;58;31;4;27;.871;3600000;0
18772;2059;3797;70;43;4;39;.907;3895000;0
18772;168001;3795;0;0;0;0;.00nan;0;0
18772;-1;3795;76;36;3;33;.917;3897000;0
18772;78845;3797;0;0;0;0;.00nan;0;0
18773;168089;3796;0;0;0;0;.00nan;0;0
18773;170294;3798;29;30;6;24;.800;3229000;0
18773;196456;3798;55;5;0;5;1.000;371000;0
18773;91413;3796;58;29;3;26;.897;3600000;0
18774;168001;3795;0;0;0;0;.00nan;0;0
18774;201661;4635;52;46;8;38;.826;3600000;0
18774;-1;4635;0;0;0;0;.00nan;0;0
18774;-1;3795;66;35;3;32;.914;3600000;0
18775;2059;3797;0;0;0;0;.00nan;0;0
18775;59231;3800;75;33;3;30;.909;3600000;0
18775;78845;3797;58;32;4;28;.875;3554000;0
18775;152717;3800;0;0;0;0;.00nan;0;0
18776;173279;4635;41;31;7;24;.774;2426000;0
18776;201661;4635;62;9;0;9;1.000;1174000;0
18776;59231;3800;0;0;0;0;.00nan;0;0
18776;152717;3800;77;35;2;33;.943;3600000;0
18777;173279;4635;60;40;5;35;.875;3600000;0
18777;170294;3798;0;0;0;0;.00nan;0;0
18777;201661;4635;0;0;0;0;.00nan;0;0
18777;196456;3798;85;30;2;28;.933;3600000;0
18778;2059;3797;58;21;2;19;.905;3590000;0
18778;168001;3795;0;0;0;0;.00nan;0;0
18778;-1;3795;79;25;1;24;.960;3600000;0
18778;78845;3797;0;0;0;0;.00nan;0;0
18779;168089;3796;0;0;0;0;.00nan;0;0
18779;59231;3800;0;0;0;0;.00nan;0;0
18779;91413;3796;89;36;1;35;.972;3600000;0
18779;152717;3800;58;36;5;31;.861;3600000;0
18780;168001;3795;95;37;1;36;.973;3600000;0
18780;173279;4635;89;43;2;41;.953;3579000;0
18780;201661;4635;0;0;0;0;.00nan;0;0
18780;-1;3795;0;0;0;0;.00nan;0;0
18781;168089;3796;62;14;1;13;.929;1486000;0
18781;59231;3800;81;28;2;26;.929;3600000;0
18781;91413;3796;20;24;6;18;.750;2114000;0
18781;152717;3800;0;0;0;0;.00nan;0;0
18782;162846;3795;58;28;3;25;.893;3296000;0
18782;168001;3795;15;6;4;2;.333;304000;0
18782;170294;3798;59;33;4;29;.879;3600000;0
18782;196456;3798;0;0;0;0;.00nan;0;0
18783;2059;3797;86;34;2;32;.941;3600000;0
18783;173279;4635;93;37;1;36;.973;3600000;0
18783;201661;4635;0;0;0;0;.00nan;0;0
18783;78845;3797;0;0;0;0;.00nan;0;0
18784;13337;3796;33;23;5;18;.783;3538000;0
18784;168089;3796;0;0;0;0;.00nan;0;0
18784;170294;3798;0;0;0;0;.00nan;0;0
18784;196456;3798;83;44;3;41;.932;3600000;0
18785;2059;3797;58;30;4;26;.867;3661000;0
18785;173279;4635;0;0;0;0;.00nan;0;0
18785;78845;3797;0;0;0;0;.00nan;0;0
18785;91413;4635;64;27;3;24;.889;3661000;0
18786;162846;3795;0;0;0;0;.00nan;0;0
18786;168001;3795;74;26;2;24;.923;3600000;0
18786;59231;3800;47;32;5;27;.844;3600000;0
18786;152717;3800;0;0;0;0;.00nan;0;0
18787;170294;3798;29;36;7;29;.806;3147000;0
18787;196456;3798;55;3;0;3;1.000;453000;0
18787;59231;3800;0;0;0;0;.00nan;0;0
18787;152717;3800;75;38;4;34;.895;3600000;0
18788;162846;3795;0;0;0;0;.00nan;0;0
18788;168001;3795;88;31;1;30;.968;3600000;0
18788;173279;4635;0;0;0;0;.00nan;0;0
18788;91413;4635;48;38;6;32;.842;3600000;0
18789;2059;3797;0;0;0;0;.00nan;0;0
18789;13337;3796;78;41;4;37;.902;3600000;0
18789;168089;3796;0;0;0;0;.00nan;0;0
18789;78845;3797;35;28;6;22;.786;3593000;0
18790;2059;3797;46;23;4;19;.826;1987000;0
18790;162846;3795;0;0;0;0;.00nan;0;0
18790;168001;3795;72;26;3;23;.885;3600000;0
18790;78845;3797;52;13;2;11;.846;1613000;0
18791;2059;3797;59;39;6;33;.846;3900000;0
18791;170294;3798;0;0;0;0;.00nan;0;0
18791;196456;3798;45;36;6;30;.833;3900000;0
18791;78845;3797;0;0;0;0;.00nan;0;0
18792;173279;4635;0;0;0;0;.00nan;0;0
18792;59231;3800;26;34;7;27;.794;3600000;0
18792;91413;4635;62;28;3;25;.893;3600000;0
18792;152717;3800;0;0;0;0;.00nan;0;0
18793;162846;3795;0;0;0;0;.00nan;0;0
18793;168001;3795;43;29;5;24;.828;3544000;0
18793;170294;3798;79;34;3;31;.912;3600000;0
18793;196456;3798;0;0;0;0;.00nan;0;0
18794;168001;3795;0;0;0;0;.00nan;0;0
18794;13337;3796;74;24;2;22;.917;3569000;0
18794;168089;3796;0;0;0;0;.00nan;0;0
18794;-1;3795;99;42;1;41;.976;3600000;0
18795;13337;3796;71;35;3;32;.914;3600000;0
18795;168089;3796;0;0;0;0;.00nan;0;0
18795;170294;3798;0;0;0;0;.00nan;0;0
18795;196456;3798;25;38;8;30;.789;3600000;0
18796;168001;3795;0;0;0;0;.00nan;0;0
18796;-1;3795;77;29;2;27;.931;3600000;0
18796;59231;3800;0;0;0;0;.00nan;0;0
18796;152717;3800;69;32;4;28;.875;3563000;0
18797;2059;3797;65;34;4;30;.882;3600000;0
18797;173279;4635;76;32;2;30;.938;2494000;0
18797;78845;3797;0;0;0;0;.00nan;0;0
18797;91413;4635;22;12;4;8;.667;1082000;0
18798;2059;3797;0;0;0;0;.00nan;0;0
18798;173279;4635;0;0;0;0;.00nan;0;0
18798;78845;3797;58;38;5;33;.868;3655000;0
18798;91413;4635;62;34;4;30;.882;3655000;0
18799;170294;3798;12;19;6;13;.684;1889000;0
18799;196456;3798;62;16;1;15;.938;1675000;0
18799;59231;3800;67;43;6;37;.860;3600000;0
18799;152717;3800;0;0;0;0;.00nan;0;0
18800;13337;3796;81;28;2;26;.929;3600000;0
18800;168089;3796;0;0;0;0;.00nan;0;0
18800;170294;3798;0;0;0;0;.00nan;0;0
18800;196456;3798;39;30;5;25;.833;3600000;0
18801;168001;3795;0;0;0;0;.00nan;0;0
18801;173279;4635;0;0;0;0;.00nan;0;0
18801;-1;3795;71;23;1;22;.957;3600000;0
18801;91413;4635;90;44;3;41;.932;3600000;0
18802;2059;3797;26;11;4;7;.636;741000;0
18802;59231;3800;0;0;0;0;.00nan;0;0
18802;78845;3797;58;18;2;16;.889;2859000;0
18802;152717;3800;10;26;7;19;.731;3600000;0
18803;168001;3795;0;0;0;0;.00nan;0;0
18803;170294;3798;71;27;2;25;.926;3600000;0
18803;196456;3798;0;0;0;0;.00nan;0;0
18803;-1;3795;67;52;5;47;.904;3600000;0
18804;13337;3796;0;0;0;0;.00nan;0;0
18804;168089;3796;41;22;4;18;.818;3600000;0
18804;173279;4635;0;0;0;0;.00nan;0;0
18804;91413;4635;90;34;1;33;.971;3600000;0
18805;2059;3797;80;31;2;29;.935;3600000;0
18805;59231;3800;58;37;5;32;.865;3600000;0
18805;78845;3797;0;0;0;0;.00nan;0;0
18805;152717;3800;0;0;0;0;.00nan;0;0
18806;2059;3797;46;30;5;25;.833;3567000;0
18806;13337;3796;57;35;4;31;.886;3600000;0
18806;168089;3796;0;0;0;0;.00nan;0;0
18806;78845;3797;0;0;0;0;.00nan;0;0
18807;170294;3798;92;47;4;43;.915;3724000;0
18807;196456;3798;0;0;0;0;.00nan;0;0
18807;59231;3800;0;0;0;0;.00nan;0;0
18807;152717;3800;59;24;3;21;.875;3724000;0
18808;2059;3797;0;0;0;0;.00nan;0;0
18808;168001;3795;0;0;0;0;.00nan;0;0
18808;-1;3795;75;27;2;25;.926;3600000;0
18808;78845;3797;94;39;3;36;.923;3593000;0
18809;13337;3796;0;0;0;0;.00nan;0;0
18809;168089;3796;57;21;2;19;.905;3600000;0
18809;173279;4635;35;20;4;16;.800;1324000;0
18809;91413;4635;31;26;6;20;.769;2276000;0
18810;168001;3795;0;0;0;0;.00nan;0;0
18810;13337;3796;48;38;5;33;.868;3569000;0
18810;168089;3796;0;0;0;0;.00nan;0;0
18810;-1;3795;88;39;3;36;.923;3600000;0
18811;2059;3797;21;21;6;15;.714;2514000;0
18811;59231;3800;30;6;3;3;.500;432000;0
18811;78845;3797;52;3;0;3;1.000;1054000;0
18811;152717;3800;68;25;2;23;.920;3168000;0
18812;173279;4635;0;0;0;0;.00nan;0;0
18812;170294;3798;0;0;0;0;.00nan;0;0
18812;196456;3798;39;22;4;18;.818;3600000;0
18812;91413;4635;58;49;6;43;.878;3573000;0
18813;168001;3795;0;0;0;0;.00nan;0;0
18813;13337;3796;0;0;0;0;.00nan;0;0
18813;168089;3796;28;30;6;24;.800;3600000;0
18813;-1;3795;73;32;2;30;.938;3600000;0
18814;173279;4635;0;0;0;0;.00nan;0;0
18814;170294;3798;58;29;3;26;.897;3600000;0
18814;196456;3798;0;0;0;0;.00nan;0;0
18814;91413;4635;52;34;5;29;.853;3535000;0
18815;13337;3796;59;29;4;25;.862;3525000;0
18815;168089;3796;0;0;0;0;.00nan;0;0
18815;173279;4635;0;0;0;0;.00nan;0;0
18815;91413;4635;98;37;2;35;.946;3600000;0
18816;168001;3795;0;0;0;0;.00nan;0;0
18816;-1;3795;72;26;3;23;.885;3600000;0
18816;59231;3800;0;0;0;0;.00nan;0;0
18816;152717;3800;64;39;4;35;.897;3549000;0
18817;2059;3797;82;43;4;39;.907;3600000;0
18817;170294;3798;88;29;1;28;.966;3600000;0
18817;196456;3798;0;0;0;0;.00nan;0;0
18817;78845;3797;0;0;0;0;.00nan;0;0
18818;2059;3797;0;0;0;0;.00nan;0;0
18818;13337;3796;0;0;0;0;.00nan;0;0
18818;168089;3796;69;24;2;22;.917;3600000;0
18818;78845;3797;86;45;4;41;.911;3547000;0
18819;173279;4635;68;18;1;17;.944;3600000;0
18819;59231;3800;51;30;4;26;.867;3600000;0
18819;91413;4635;0;0;0;0;.00nan;0;0
18819;152717;3800;0;0;0;0;.00nan;0;0
18820;168001;3795;33;4;2;2;.500;268000;0
18820;170294;3798;0;0;0;0;.00nan;0;0
18820;196456;3798;58;28;4;24;.857;3600000;0
18820;-1;3795;31;42;7;35;.833;3332000;0
18822;168001;3795;0;0;0;0;.00nan;0;0
18822;196456;3798;45;27;4;23;.852;3594000;0
18822;85709;3795;64;25;3;22;.880;3600000;0
18822;94615;3798;0;0;0;0;.00nan;0;0
18824;173279;4635;81;26;2;24;.923;3600000;0
18824;170294;3797;61;34;4;30;.882;3578000;0
18824;196445;3797;0;0;0;0;.00nan;0;0
18824;-1;4635;0;0;0;0;.00nan;0;0
18826;168089;3796;0;0;0;0;.00nan;0;0
18826;59231;3800;59;6;0;6;1.000;1590000;0
18826;91413;3796;47;33;6;27;.818;3857000;0
18826;152717;3800;19;16;5;11;.688;2267000;0
18828;170294;3797;0;0;0;0;.00nan;0;0
18828;196445;3797;52;36;4;32;.889;3554000;0
18828;196456;3798;0;0;0;0;.00nan;0;0
18828;94615;3798;65;23;2;21;.913;3600000;0
18830;168089;3796;60;26;3;23;.885;3600000;0
18830;173279;4635;0;0;0;0;.00nan;0;0
18830;-1;4635;77;47;4;43;.915;3561000;0
18830;91413;3796;0;0;0;0;.00nan;0;0
18832;168001;3795;100;26;0;26;1.000;3600000;0
18832;59231;3800;67;39;4;35;.897;3600000;0
18832;85709;3795;0;0;0;0;.00nan;0;0
18832;152717;3800;0;0;0;0;.00nan;0;0
18834;168001;3795;55;38;5;33;.868;3554000;0
18834;168089;3796;0;0;0;0;.00nan;0;0
18834;85709;3795;0;0;0;0;.00nan;0;0
18834;91413;3796;62;27;3;24;.889;3600000;0
18836;170294;3797;57;39;4;35;.897;3865000;0
18836;196445;3797;0;0;0;0;.00nan;0;0
18836;196456;3798;98;51;3;48;.941;3865000;0
18836;94615;3798;0;0;0;0;.00nan;0;0
18838;173279;4635;60;38;4;34;.895;3600000;0
18838;-1;4635;0;0;0;0;.00nan;0;0
18838;59231;3800;0;0;0;0;.00nan;0;0
18838;152717;3800;36;33;6;27;.818;3579000;0
18840;173279;4635;66;34;4;30;.882;3600000;0
18840;196456;3798;43;34;5;29;.853;3568000;0
18840;-1;4635;0;0;0;0;.00nan;0;0
18840;94615;3798;0;0;0;0;.00nan;0;0
18842;168089;3796;49;1;0;1;1.000;255000;0
18842;59231;3800;0;0;0;0;.00nan;0;0
18842;91413;3796;51;39;6;33;.846;3308000;0
18842;152717;3800;62;30;4;26;.867;3600000;0
18844;168001;3795;0;0;0;0;.00nan;0;0
18844;170294;3797;40;29;5;24;.828;3600000;0
18844;196445;3797;0;0;0;0;.00nan;0;0
18844;85709;3795;65;38;4;34;.895;3600000;0
18846;168001;3795;48;32;5;27;.844;3600000;0
18846;196456;3798;0;0;0;0;.00nan;0;0
18846;85709;3795;0;0;0;0;.00nan;0;0
18846;94615;3798;77;31;2;29;.935;3600000;0
18848;173279;4635;0;0;0;0;.00nan;0;0
18848;-1;4635;84;43;3;40;.930;3900000;0
18848;59231;3800;61;33;3;30;.909;3900000;0
18848;152717;3800;0;0;0;0;.00nan;0;0
18850;168089;3796;48;24;4;20;.833;3900000;0
18850;170294;3797;0;0;0;0;.00nan;0;0
18850;196445;3797;56;27;4;23;.852;3900000;0
18850;91413;3796;0;0;0;0;.00nan;0;0
18852;168001;3795;0;0;0;0;.00nan;0;0
18852;196456;3798;92;44;2;42;.955;3600000;0
18852;85709;3795;58;30;3;27;.900;3598000;0
18852;94615;3798;0;0;0;0;.00nan;0;0
18854;170294;3797;46;34;5;29;.853;3600000;0
18854;196445;3797;0;0;0;0;.00nan;0;0
18854;59231;3800;0;0;0;0;.00nan;0;0
18854;152717;3800;93;43;4;39;.907;3600000;0
18856;168089;3796;59;12;1;11;.917;1316000;0
18856;173279;4635;63;38;4;34;.895;3600000;0
18856;-1;4635;0;0;0;0;.00nan;0;0
18856;91413;3796;40;26;5;21;.808;2284000;0
1502;173279;4635;0;0;0;0;.00nan;0;0
1502;59231;3800;0;0;0;0;.00nan;0;0
1502;91413;4635;71;38;4;34;.895;3569000;0
1502;152717;3800;63;22;2;20;.909;3600000;0
1503;2059;3797;70;41;5;36;.878;3866000;0
1503;170294;3798;42;30;6;24;.800;3866000;0
1503;196456;3798;0;0;0;0;.00nan;0;0
1503;78845;3797;0;0;0;0;.00nan;0;0
1504;173279;4635;0;0;0;0;.00nan;0;0
1504;59231;3800;0;0;0;0;.00nan;0;0
1504;91413;4635;70;40;5;35;.875;3570000;0
1504;152717;3800;75;36;3;33;.917;3600000;0
1505;2059;3797;58;15;2;13;.867;3600000;0
1505;170294;3798;72;46;5;41;.891;3600000;0
1505;196456;3798;0;0;0;0;.00nan;0;0
1505;78845;3797;0;0;0;0;.00nan;0;0
1506;173279;4635;0;0;0;0;.00nan;0;0
1506;59231;3800;0;0;0;0;.00nan;0;0
1506;91413;4635;100;34;1;33;.971;3600000;0
1506;152717;3800;72;30;3;27;.900;3558000;0
1507;2059;3797;56;33;4;29;.879;3593000;0
1507;170294;3798;67;29;3;26;.897;3600000;0
1507;196456;3798;0;0;0;0;.00nan;0;0
1507;78845;3797;0;0;0;0;.00nan;0;0
1508;173279;4635;0;0;0;0;.00nan;0;0
1508;59231;3800;0;0;0;0;.00nan;0;0
1508;91413;4635;57;33;4;29;.879;3676000;0
1508;152717;3800;75;33;3;30;.909;3676000;0
1509;2059;3797;68;39;4;35;.897;3595000;0
1509;170294;3798;70;30;2;28;.933;3600000;0
1509;196456;3798;0;0;0;0;.00nan;0;0
1509;78845;3797;0;0;0;0;.00nan;0;0
1787;173279;4635;0;0;0;0;.00nan;0;0
1787;59231;3800;0;0;0;0;.00nan;0;0
1787;91413;4635;78;32;3;29;.906;3600000;0
1787;152717;3800;41;31;6;25;.806;3600000;0
1788;2059;3797;37;34;6;28;.824;1948000;0
1788;170294;3798;75;24;1;23;.958;3600000;0
1788;196456;3798;0;0;0;0;.00nan;0;0
1788;78845;3797;75;15;0;15;1.000;1652000;0
1828;173279;4635;0;0;0;0;.00nan;0;0
1828;59231;3800;0;0;0;0;.00nan;0;0
1828;91413;4635;82;41;3;38;.927;3600000;0
1828;152717;3800;71;24;2;22;.917;3600000;0
1829;2059;3797;55;33;4;29;.879;3600000;0
1829;170294;3798;100;30;0;30;1.000;3600000;0
1829;196456;3798;0;0;0;0;.00nan;0;0
1829;78845;3797;0;0;0;0;.00nan;0;0
1853;168001;3795;0;0;0;0;.00nan;0;0
1853;170294;3798;61;32;4;28;.875;3587000;0
1853;196456;3798;0;0;0;0;.00nan;0;0
1853;-1;3795;78;30;2;28;.933;3600000;0
1854;13337;3796;97;36;2;34;.944;3600000;0
1854;168089;3796;0;0;0;0;.00nan;0;0
1854;59231;3800;0;0;0;0;.00nan;0;0
1854;152717;3800;70;33;4;29;.879;3525000;0
1855;168001;3795;0;0;0;0;.00nan;0;0
1855;170294;3798;45;23;4;19;.826;3557000;0
1855;196456;3798;0;0;0;0;.00nan;0;0
1855;-1;3795;80;35;2;33;.943;3600000;0
1856;13337;3796;22;20;5;15;.750;2212000;0
1856;168089;3796;57;5;0;5;1.000;1359000;0
1856;59231;3800;0;0;0;0;.00nan;0;0
1856;152717;3800;76;44;4;40;.909;3600000;0
1857;168001;3795;0;0;0;0;.00nan;0;0
1857;170294;3798;84;30;2;28;.933;3600000;0
1857;196456;3798;0;0;0;0;.00nan;0;0
1857;-1;3795;42;16;3;13;.813;3561000;0
1858;13337;3796;71;27;2;25;.926;3600000;0
1858;168089;3796;0;0;0;0;.00nan;0;0
1858;59231;3800;0;0;0;0;.00nan;0;0
1858;152717;3800;85;53;5;48;.906;3600000;0
1859;168001;3795;0;0;0;0;.00nan;0;0
1859;170294;3798;97;25;0;25;1.000;3600000;0
1859;196456;3798;0;0;0;0;.00nan;0;0
1859;-1;3795;72;43;4;39;.907;3600000;0
1860;13337;3796;82;37;2;35;.946;3987000;0
1860;168089;3796;0;0;0;0;.00nan;0;0
1860;59231;3800;0;0;0;0;.00nan;0;0
1860;152717;3800;70;28;3;25;.893;3987000;0
2037;168001;3795;0;0;0;0;.00nan;0;0
2037;170294;3798;78;32;2;30;.938;3600000;0
2037;196456;3798;0;0;0;0;.00nan;0;0
2037;-1;3795;51;24;3;21;.875;3541000;0
2038;13337;3796;24;21;5;16;.762;3600000;0
2038;168089;3796;0;0;0;0;.00nan;0;0
2038;59231;3800;0;0;0;0;.00nan;0;0
2038;152717;3800;90;41;2;39;.951;3600000;0
2138;168001;3795;0;0;0;0;.00nan;0;0
2138;170294;3798;15;25;7;18;.720;2415000;0
2138;196456;3798;44;18;3;15;.833;1185000;0
2138;-1;3795;64;14;1;13;.929;3600000;0
2139;13337;3796;59;36;5;31;.861;3600000;0
2139;168089;3796;0;0;0;0;.00nan;0;0
2139;59231;3800;0;0;0;0;.00nan;0;0
2139;152717;3800;74;53;7;46;.868;3591000;0
2168;168001;3795;0;0;0;0;.00nan;0;0
2168;170294;3798;34;30;5;25;.833;3600000;0
2168;196456;3798;0;0;0;0;.00nan;0;0
2168;-1;3795;93;21;0;21;1.000;3600000;0
2171;168001;3795;0;0;0;0;.00nan;0;0
2171;13337;3796;61;21;2;19;.905;3600000;0
2171;168089;3796;0;0;0;0;.00nan;0;0
2171;-1;3795;34;23;5;18;.783;3600000;0
2172;168001;3795;56;6;0;6;1.000;455000;0
2172;13337;3796;33;21;5;16;.762;3600000;0
2172;168089;3796;0;0;0;0;.00nan;0;0
2172;-1;3795;23;26;6;20;.769;3113000;0
2173;168001;3795;0;0;0;0;.00nan;0;0
2173;13337;3796;28;29;6;23;.793;2838000;0
2173;168089;3796;63;5;0;5;1.000;762000;0
2173;-1;3795;82;37;3;34;.919;3600000;0
2174;168001;3795;0;0;0;0;.00nan;0;0
2174;13337;3796;98;35;1;34;.971;3600000;0
2174;168089;3796;0;0;0;0;.00nan;0;0
2174;-1;3795;51;39;5;34;.872;3600000;0
2400;168001;3795;0;0;0;0;.00nan;0;0
2400;13337;3796;44;31;5;26;.839;3571000;0
2400;168089;3796;0;0;0;0;.00nan;0;0
2400;-1;3795;75;35;3;32;.914;3600000;0
2464;168001;3795;0;0;0;0;.00nan;0;0
2464;13337;3796;36;26;6;20;.769;3600000;0
2464;168089;3796;0;0;0;0;.00nan;0;0
2464;-1;3795;90;43;2;41;.953;3600000;0
2485;168001;3795;52;35;5;30;.857;3146000;0
2485;13337;3796;19;20;6;14;.700;2550000;0
2485;168089;3796;46;5;1;4;.800;1050000;0
2485;-1;3795;24;6;3;3;.500;407000;0
18857;4127;1429;19;24;6;18;.750;3056000;0
18857;185136;1440;0;0;0;0;.00nan;0;0
18857;187263;1440;89;50;3;47;.940;3600000;0
18857;-1;1429;53;3;0;3;1.000;544000;0
18858;4127;1429;31;30;6;24;.800;3106000;0
18858;184437;1443;82;13;0;13;1.000;3600000;0
18858;-1;1429;60;8;0;8;1.000;494000;0
18858;80682;1443;0;0;0;0;.00nan;0;0
18859;1765;1427;0;0;0;0;.00nan;0;0
18859;165030;1453;50;48;7;41;.854;3600000;0
18859;169438;1427;50;14;2;12;.857;3600000;0
18859;195618;1453;0;0;0;0;.00nan;0;0
18860;2037;4961;65;16;1;15;.938;1439000;0
18860;-1;4961;20;30;6;24;.800;2161000;0
18860;157903;1430;61;21;2;19;.905;3600000;0
18860;157929;1430;0;0;0;0;.00nan;0;0
18861;9524;1422;29;7;3;4;.571;499000;0
18861;195566;1425;0;0;0;0;.00nan;0;0
18861;216525;1422;66;29;2;27;.931;3101000;0
18861;64230;1425;88;36;2;34;.944;3600000;0
18862;182561;1426;0;0;0;0;.00nan;0;0
18862;185124;4742;0;0;0;0;.00nan;0;0
18862;148391;1426;31;23;5;18;.783;3600000;0
18862;157845;4742;28;27;6;21;.778;3579000;0
18863;182561;1426;55;25;3;22;.880;3600000;0
18863;185136;1440;65;18;1;17;.944;1263000;0
18863;187263;1440;40;39;6;33;.846;2337000;0
18863;148391;1426;0;0;0;0;.00nan;0;0
18864;1765;1427;0;0;0;0;.00nan;0;0
18864;165030;1453;84;36;2;34;.944;3900000;0
18864;169438;1427;61;25;2;23;.920;3900000;0
18864;195618;1453;0;0;0;0;.00nan;0;0
18865;2037;4961;0;0;0;0;.00nan;0;0
18865;9524;1422;54;28;4;24;.857;3600000;0
18865;-1;4961;39;27;5;22;.815;3581000;0
18865;216525;1422;0;0;0;0;.00nan;0;0
18866;185124;4742;0;0;0;0;.00nan;0;0
18866;157845;4742;70;30;2;28;.933;3900000;0
18866;157903;1430;57;23;2;21;.913;3900000;0
18866;157929;1430;0;0;0;0;.00nan;0;0
18867;184437;1443;72;24;2;22;.917;3600000;0
18867;195566;1425;0;0;0;0;.00nan;0;0
18867;64230;1425;92;61;5;56;.918;3600000;0
18867;80682;1443;0;0;0;0;.00nan;0;0
18868;185136;1440;0;0;0;0;.00nan;0;0
18868;187263;1440;57;29;3;26;.897;3900000;0
18868;157903;1430;0;0;0;0;.00nan;0;0
18868;157929;1430;81;45;3;42;.933;3900000;0
18869;165030;1453;98;51;2;49;.961;3600000;0
18869;184437;1443;74;10;0;10;1.000;3600000;0
18869;195618;1453;0;0;0;0;.00nan;0;0
18869;80682;1443;0;0;0;0;.00nan;0;0
18870;1765;1427;0;0;0;0;.00nan;0;0
18870;4127;1429;62;28;3;25;.893;3568000;0
18870;169438;1427;90;37;1;36;.973;3600000;0
18870;-1;1429;0;0;0;0;.00nan;0;0
18871;9524;1422;56;22;3;19;.864;3600000;0
18871;216525;1422;0;0;0;0;.00nan;0;0
18871;185124;4742;0;0;0;0;.00nan;0;0
18871;157845;4742;50;39;5;34;.872;3583000;0
18872;182561;1426;44;14;2;12;.857;3600000;0
18872;148391;1426;0;0;0;0;.00nan;0;0
18872;157903;1430;54;40;5;35;.875;3600000;0
18872;157929;1430;0;0;0;0;.00nan;0;0
18873;2037;4961;0;0;0;0;.00nan;0;0
18873;-1;4961;74;40;5;35;.875;3600000;0
18873;195566;1425;0;0;0;0;.00nan;0;0
18873;64230;1425;79;26;2;24;.923;3600000;0
18874;1765;1427;0;0;0;0;.00nan;0;0
18874;169438;1427;90;56;3;53;.946;3575000;0
18874;184437;1443;50;15;2;13;.867;3600000;0
18874;80682;1443;0;0;0;0;.00nan;0;0
18875;195566;1425;0;0;0;0;.00nan;0;0
18875;185136;1440;0;0;0;0;.00nan;0;0
18875;187263;1440;63;34;3;31;.912;3564000;0
18875;64230;1425;80;25;1;24;.960;3600000;0
18876;4127;1429;0;0;0;0;.00nan;0;0
18876;165030;1453;48;33;4;29;.879;3569000;0
18876;195618;1453;0;0;0;0;.00nan;0;0
18876;-1;1429;61;18;2;16;.889;3600000;0
18877;2037;4961;86;36;1;35;.972;3900000;0
18877;182561;1426;84;26;1;25;.962;3900000;0
18877;-1;4961;0;0;0;0;.00nan;0;0
18877;148391;1426;0;0;0;0;.00nan;0;0
18878;9524;1422;0;0;0;0;.00nan;0;0
18878;216525;1422;26;22;5;17;.773;3600000;0
18878;185124;4742;0;0;0;0;.00nan;0;0
18878;157845;4742;79;30;2;28;.933;3600000;0
18879;165030;1453;35;30;6;24;.800;3068000;0
18879;195618;1453;56;3;0;3;1.000;532000;0
18879;185124;4742;39;1;1;0;.000;653000;0
18879;157845;4742;27;25;6;19;.760;2932000;0
18880;1765;1427;0;0;0;0;.00nan;0;0
18880;169438;1427;56;29;3;26;.897;3600000;0
18880;157903;1430;38;24;5;19;.792;3517000;0
18880;157929;1430;0;0;0;0;.00nan;0;0
18881;4127;1429;59;27;4;23;.852;3591000;0
18881;195566;1425;0;0;0;0;.00nan;0;0
18881;-1;1429;0;0;0;0;.00nan;0;0
18881;64230;1425;73;28;2;26;.929;3600000;0
18882;9524;1422;26;13;4;9;.692;718000;0
18882;184437;1443;37;19;4;15;.789;3600000;0
18882;216525;1422;69;37;3;34;.919;2882000;0
18882;80682;1443;0;0;0;0;.00nan;0;0
18883;2037;4961;55;12;1;11;.917;527000;0
18883;182561;1426;55;18;2;16;.889;3600000;0
18883;-1;4961;52;43;6;37;.860;3073000;0
18883;148391;1426;0;0;0;0;.00nan;0;0
18884;184437;1443;66;22;2;20;.909;3900000;0
18884;185136;1440;0;0;0;0;.00nan;0;0
18884;187263;1440;98;56;2;54;.964;3900000;0
18884;80682;1443;0;0;0;0;.00nan;0;0
18885;1765;1427;41;30;5;25;.833;3600000;0
18885;169438;1427;0;0;0;0;.00nan;0;0
18885;157903;1430;0;0;0;0;.00nan;0;0
18885;157929;1430;76;31;2;29;.935;3600000;0
18886;2037;4961;58;15;1;14;.933;850000;0
18886;4127;1429;0;0;0;0;.00nan;0;0
18886;-1;4961;33;31;6;25;.806;2750000;0
18886;-1;1429;59;33;4;29;.879;3600000;0
18887;165030;1453;55;28;4;24;.857;3600000;0
18887;195618;1453;0;0;0;0;.00nan;0;0
18887;185124;4742;44;30;5;25;.833;3599000;0
18887;157845;4742;0;0;0;0;.00nan;0;0
18888;9524;1422;77;33;2;31;.939;3515000;0
18888;195566;1425;0;0;0;0;.00nan;0;0
18888;216525;1422;0;0;0;0;.00nan;0;0
18888;64230;1425;97;20;0;20;1.000;3600000;0
18889;2037;4961;96;31;0;31;1.000;2517000;0
18889;-1;4961;22;12;4;8;.667;1083000;0
18889;184437;1443;72;23;2;21;.913;3600000;0
18889;80682;1443;0;0;0;0;.00nan;0;0
18890;4127;1429;65;43;4;39;.907;3600000;0
18890;185136;1440;0;0;0;0;.00nan;0;0
18890;187263;1440;85;33;2;31;.939;3600000;0
18890;-1;1429;0;0;0;0;.00nan;0;0
18891;165030;1453;68;27;2;25;.926;3600000;0
18891;195618;1453;0;0;0;0;.00nan;0;0
18891;157903;1430;46;19;3;16;.842;3522000;0
18891;157929;1430;0;0;0;0;.00nan;0;0
18892;195566;1425;0;0;0;0;.00nan;0;0
18892;185124;4742;0;0;0;0;.00nan;0;0
18892;64230;1425;69;34;3;31;.912;3900000;0
18892;157845;4742;51;24;3;21;.875;3900000;0
18893;2037;4961;0;0;0;0;.00nan;0;0
18893;9524;1422;0;0;0;0;.00nan;0;0
18893;-1;4961;60;36;5;31;.861;3840000;0
18893;-1;1422;66;34;4;30;.882;3840000;0
18894;1765;1427;0;0;0;0;.00nan;0;0
18894;182561;1426;61;25;2;23;.920;3600000;0
18894;169438;1427;75;30;3;27;.900;3600000;0
18894;148391;1426;0;0;0;0;.00nan;0;0
18895;9524;1422;0;0;0;0;.00nan;0;0
18895;184437;1443;64;19;2;17;.895;3600000;0
18895;-1;1422;17;46;9;37;.804;3600000;0
18895;80682;1443;0;0;0;0;.00nan;0;0
18896;165030;1453;42;29;5;24;.828;3600000;0
18896;195618;1453;0;0;0;0;.00nan;0;0
18896;157903;1430;0;0;0;0;.00nan;0;0
18896;157929;1430;61;28;3;25;.893;3600000;0
18897;1765;1427;0;0;0;0;.00nan;0;0
18897;169438;1427;66;27;2;25;.926;3550000;0
18897;185124;4742;0;0;0;0;.00nan;0;0
18897;157845;4742;99;37;1;36;.973;3600000;0
18898;182561;1426;72;27;2;25;.926;3558000;0
18898;4127;1429;0;0;0;0;.00nan;0;0
18898;-1;1429;78;26;1;25;.962;3600000;0
18898;148391;1426;0;0;0;0;.00nan;0;0
18899;195566;1425;49;26;4;22;.846;3600000;0
18899;185136;1440;46;37;6;31;.838;3600000;0
18899;187263;1440;0;0;0;0;.00nan;0;0
18899;64230;1425;0;0;0;0;.00nan;0;0
18900;182561;1426;48;18;3;15;.833;3600000;0
18900;165030;1453;82;31;2;29;.935;3600000;0
18900;195618;1453;0;0;0;0;.00nan;0;0
18900;148391;1426;0;0;0;0;.00nan;0;0
18901;1765;1427;29;8;3;5;.625;529000;0
18901;169438;1427;86;37;2;35;.946;3071000;0
18901;184437;1443;89;27;1;26;.963;3600000;0
18901;80682;1443;0;0;0;0;.00nan;0;0
18902;9524;1422;0;0;0;0;.00nan;0;0
18902;-1;1422;91;31;2;29;.935;3600000;0
18902;157903;1430;53;23;3;20;.870;3548000;0
18902;157929;1430;0;0;0;0;.00nan;0;0
18903;2037;4961;0;0;0;0;.00nan;0;0
18903;-1;4961;51;26;4;22;.846;3600000;0
18903;195566;1425;0;0;0;0;.00nan;0;0
18903;64230;1425;89;33;1;32;.970;3600000;0
18904;4127;1429;55;27;4;23;.852;3900000;0
18904;185124;4742;0;0;0;0;.00nan;0;0
18904;-1;1429;0;0;0;0;.00nan;0;0
18904;157845;4742;48;33;4;29;.879;3900000;0
18905;184437;1443;0;0;0;0;.00nan;0;0
18905;185136;1440;23;28;7;21;.750;1076000;0
18905;187263;1440;65;64;7;57;.891;2524000;0
18905;80682;1443;66;6;0;6;1.000;3600000;0
18906;2037;4961;0;0;0;0;.00nan;0;0
18906;4127;1429;0;0;0;0;.00nan;0;0
18906;-1;4961;72;32;4;28;.875;3600000;0
18906;-1;1429;68;23;2;21;.913;3600000;0
18907;1765;1427;0;0;0;0;.00nan;0;0
18907;9524;1422;0;0;0;0;.00nan;0;0
18907;169438;1427;63;22;2;20;.909;3600000;0
18907;-1;1422;65;28;3;25;.893;3600000;0
18908;182561;1426;0;0;0;0;.00nan;0;0
18908;165030;1453;65;42;5;37;.881;3566000;0
18908;195618;1453;0;0;0;0;.00nan;0;0
18908;148391;1426;65;30;3;27;.900;3600000;0
18909;195566;1425;0;0;0;0;.00nan;0;0
18909;64230;1425;69;28;3;25;.893;3600000;0
18909;157903;1430;0;0;0;0;.00nan;0;0
18909;157929;1430;58;29;4;25;.862;3600000;0
18910;1765;1427;50;1;0;1;1.000;624000;0
18910;169438;1427;41;42;6;36;.857;2976000;0
18910;185124;4742;0;0;0;0;.00nan;0;0
18910;157845;4742;57;24;3;21;.875;3600000;0
18911;184437;1443;0;0;0;0;.00nan;0;0
18911;185124;4742;60;9;0;9;1.000;609000;0
18911;80682;1443;52;16;2;14;.875;3600000;0
18911;157845;4742;39;42;6;36;.857;2991000;0
18912;2037;4961;0;0;0;0;.00nan;0;0
18912;165030;1453;74;27;3;24;.889;3655000;0
18912;-1;4961;93;33;2;31;.939;3655000;0
18912;195618;1453;0;0;0;0;.00nan;0;0
18913;195566;1425;79;23;1;22;.957;2673000;0
18913;64230;1425;21;10;4;6;.600;927000;0
18913;157903;1430;53;30;4;26;.867;3600000;0
18913;157929;1430;0;0;0;0;.00nan;0;0
18914;9524;1422;0;0;0;0;.00nan;0;0
18914;-1;1422;66;29;3;26;.897;3600000;0
18914;185136;1440;36;6;2;4;.667;677000;0
18914;187263;1440;25;28;6;22;.786;2923000;0
18915;182561;1426;54;12;2;10;.833;3600000;0
18915;4127;1429;68;38;4;34;.895;3589000;0
18915;-1;1429;0;0;0;0;.00nan;0;0
18915;148391;1426;0;0;0;0;.00nan;0;0
18916;9524;1422;0;0;0;0;.00nan;0;0
18916;-1;1422;67;24;2;22;.917;3600000;0
18916;185136;1440;0;0;0;0;.00nan;0;0
18916;187263;1440;61;31;3;28;.903;3600000;0
18917;1765;1427;0;0;0;0;.00nan;0;0
18917;169438;1427;69;29;2;27;.931;3600000;0
18917;195566;1425;0;0;0;0;.00nan;0;0
18917;64230;1425;50;28;4;24;.857;3599000;0
18918;4127;1429;0;0;0;0;.00nan;0;0
18918;-1;1429;37;21;4;17;.810;3551000;0
18918;157903;1430;0;0;0;0;.00nan;0;0
18918;157929;1430;66;26;2;24;.923;3600000;0
18919;2037;4961;71;30;3;27;.900;3578000;0
18919;165030;1453;73;25;2;23;.920;3600000;0
18919;-1;4961;0;0;0;0;.00nan;0;0
18919;195618;1453;0;0;0;0;.00nan;0;0
18920;182561;1426;74;21;1;20;.952;3600000;0
18920;185124;4742;47;28;4;24;.857;3600000;0
18920;148391;1426;0;0;0;0;.00nan;0;0
18920;157845;4742;0;0;0;0;.00nan;0;0
18921;4127;1429;90;37;2;35;.946;3600000;0
18921;195566;1425;0;0;0;0;.00nan;0;0
18921;-1;1429;0;0;0;0;.00nan;0;0
18921;64230;1425;49;26;4;22;.846;3576000;0
18922;165030;1453;76;22;1;21;.955;3600000;0
18922;195618;1453;0;0;0;0;.00nan;0;0
18922;185136;1440;0;0;0;0;.00nan;0;0
18922;187263;1440;59;42;5;37;.881;3600000;0
18923;184437;1443;65;18;2;16;.889;3600000;0
18923;80682;1443;0;0;0;0;.00nan;0;0
18923;157903;1430;30;39;7;32;.821;2480000;0
18923;157929;1430;39;19;4;15;.789;1120000;0
18924;1765;1427;0;0;0;0;.00nan;0;0
18924;4127;1429;65;32;4;28;.875;3600000;0
18924;169438;1427;43;31;5;26;.839;3600000;0
18924;-1;1429;0;0;0;0;.00nan;0;0
18925;2037;4961;0;0;0;0;.00nan;0;0
18925;-1;4961;86;29;1;28;.966;3600000;0
18925;185124;4742;0;0;0;0;.00nan;0;0
18925;157845;4742;63;25;2;23;.920;3559000;0
18926;182561;1426;33;17;4;13;.765;2081000;0
18926;9524;1422;0;0;0;0;.00nan;0;0
18926;-1;1422;79;26;2;24;.923;3600000;0
18926;148391;1426;38;11;3;8;.727;1519000;0
18927;4127;1429;84;47;4;43;.915;2831000;0
18927;184437;1443;0;0;0;0;.00nan;0;0
18927;-1;1429;17;14;5;9;.643;769000;0
18927;80682;1443;56;23;2;21;.913;3600000;0
18928;185136;1440;0;0;0;0;.00nan;0;0
18928;187263;1440;74;33;2;31;.939;3900000;0
18928;157903;1430;0;0;0;0;.00nan;0;0
18928;157929;1430;59;21;2;19;.905;3900000;0
18929;2037;4961;0;0;0;0;.00nan;0;0
18929;-1;4961;57;31;4;27;.871;3591000;0
18929;185124;4742;58;22;3;19;.864;3600000;0
18929;157845;4742;0;0;0;0;.00nan;0;0
18930;182561;1426;61;34;5;29;.853;3600000;0
18930;9524;1422;66;27;2;25;.926;3600000;0
18930;-1;1422;0;0;0;0;.00nan;0;0
18930;148391;1426;0;0;0;0;.00nan;0;0
18931;1765;1427;0;0;0;0;.00nan;0;0
18931;169438;1427;81;29;2;27;.931;3600000;0
18931;195566;1425;0;0;0;0;.00nan;0;0
18931;64230;1425;58;33;4;29;.879;3577000;0
18932;182561;1426;71;24;2;22;.917;3600000;0
18932;148391;1426;0;0;0;0;.00nan;0;0
18932;157903;1430;37;23;5;18;.783;3600000;0
18932;157929;1430;0;0;0;0;.00nan;0;0
18933;184437;1443;57;24;3;21;.875;3600000;0
18933;195566;1425;0;0;0;0;.00nan;0;0
18933;64230;1425;49;29;5;24;.828;3600000;0
18933;80682;1443;0;0;0;0;.00nan;0;0
18934;4127;1429;44;30;5;25;.833;3600000;0
18934;165030;1453;77;30;2;28;.933;3600000;0
18934;195618;1453;0;0;0;0;.00nan;0;0
18934;-1;1429;0;0;0;0;.00nan;0;0
18935;1765;1427;0;0;0;0;.00nan;0;0
18935;2037;4961;0;0;0;0;.00nan;0;0
18935;-1;4961;71;31;2;29;.935;3546000;0
18935;169438;1427;97;29;1;28;.966;3600000;0
18936;185124;4742;0;0;0;0;.00nan;0;0
18936;185136;1440;0;0;0;0;.00nan;0;0
18936;187263;1440;52;33;4;29;.879;3569000;0
18936;157845;4742;64;20;2;18;.900;3600000;0
18937;182561;1426;0;0;0;0;.00nan;0;0
18937;9524;1422;0;0;0;0;.00nan;0;0
18937;-1;1422;85;35;2;33;.943;3600000;0
18937;148391;1426;61;39;4;35;.897;3515000;0
18938;165030;1453;45;22;5;17;.773;3600000;0
18938;195618;1453;0;0;0;0;.00nan;0;0
18938;185136;1440;0;0;0;0;.00nan;0;0
18938;187263;1440;86;45;4;41;.911;3600000;0
18939;1765;1427;73;32;3;29;.906;3600000;0
18939;2037;4961;0;0;0;0;.00nan;0;0
18939;-1;4961;59;30;4;26;.867;3579000;0
18939;169438;1427;0;0;0;0;.00nan;0;0
18940;4127;1429;96;44;3;41;.932;3600000;0
18940;184437;1443;0;0;0;0;.00nan;0;0
18940;-1;1429;0;0;0;0;.00nan;0;0
18940;80682;1443;81;13;0;13;1.000;3600000;0
18941;9524;1422;62;32;3;29;.906;3600000;0
18941;-1;1422;0;0;0;0;.00nan;0;0
18941;157903;1430;40;24;4;20;.833;3549000;0
18941;157929;1430;0;0;0;0;.00nan;0;0
18942;195566;1425;54;23;3;20;.870;3600000;0
18942;185124;4742;30;39;7;32;.821;2944000;0
18942;64230;1425;0;0;0;0;.00nan;0;0
18942;157845;4742;54;9;1;8;.889;656000;0
18943;165030;1453;99;43;1;42;.977;3600000;0
18943;195566;1425;0;0;0;0;.00nan;0;0
18943;195618;1453;0;0;0;0;.00nan;0;0
18943;64230;1425;45;20;3;17;.850;3565000;0
18944;1765;1427;0;0;0;0;.00nan;0;0
18944;169438;1427;65;46;5;41;.891;3600000;0
18944;184437;1443;0;0;0;0;.00nan;0;0
18944;80682;1443;60;12;1;11;.917;3600000;0
18945;4127;1429;77;32;2;30;.938;3600000;0
18945;-1;1429;0;0;0;0;.00nan;0;0
18945;157903;1430;28;15;4;11;.733;3587000;0
18945;157929;1430;0;0;0;0;.00nan;0;0
18946;9524;1422;0;0;0;0;.00nan;0;0
18946;-1;1422;86;24;1;23;.958;3600000;0
18946;185124;4742;36;13;3;10;.769;1003000;0
18946;157845;4742;8;19;6;13;.684;2597000;0
18947;182561;1426;25;6;3;3;.500;409000;0
18947;185136;1440;0;0;0;0;.00nan;0;0
18947;187263;1440;64;31;3;28;.903;3600000;0
18947;148391;1426;62;16;1;15;.938;3138000;0
18948;184437;1443;53;17;2;15;.882;3600000;0
18948;80682;1443;0;0;0;0;.00nan;0;0
18948;157903;1430;0;0;0;0;.00nan;0;0
18948;157929;1430;54;48;6;42;.875;3600000;0
18949;185124;4742;0;0;0;0;.00nan;0;0
18949;185136;1440;0;0;0;0;.00nan;0;0
18949;187263;1440;60;35;4;31;.886;3600000;0
18949;157845;4742;64;21;1;20;.952;3600000;0
18950;4127;1429;0;0;0;0;.00nan;0;0
18950;9524;1422;80;35;3;32;.914;3532000;0
18950;-1;1422;0;0;0;0;.00nan;0;0
18950;-1;1429;76;21;1;20;.952;3600000;0
18951;2037;4961;0;0;0;0;.00nan;0;0
18951;182561;1426;56;31;4;27;.871;3600000;0
18951;-1;4961;81;32;2;30;.938;3600000;0
18951;148391;1426;0;0;0;0;.00nan;0;0
18952;165030;1453;26;27;6;21;.778;2912000;0
18952;195566;1425;48;17;3;14;.824;3600000;0
18952;195618;1453;51;11;1;10;.909;688000;0
18952;64230;1425;0;0;0;0;.00nan;0;0
18953;165030;1453;51;36;5;31;.861;3600000;0
18953;195618;1453;0;0;0;0;.00nan;0;0
18953;185124;4742;0;0;0;0;.00nan;0;0
18953;157845;4742;71;30;2;28;.933;3600000;0
18954;1765;1427;0;0;0;0;.00nan;0;0
18954;169438;1427;66;25;2;23;.920;3600000;0
18954;185136;1440;0;0;0;0;.00nan;0;0
18954;187263;1440;85;57;6;51;.895;3600000;0
18955;2037;4961;0;0;0;0;.00nan;0;0
18955;-1;4961;91;36;2;34;.944;3600000;0
18955;157903;1430;67;38;4;34;.895;3514000;0
18955;157929;1430;0;0;0;0;.00nan;0;0
18956;4127;1429;71;37;4;33;.892;3600000;0
18956;9524;1422;0;0;0;0;.00nan;0;0
18956;-1;1422;88;19;0;19;1.000;3600000;0
18956;-1;1429;0;0;0;0;.00nan;0;0
18957;182561;1426;25;17;4;13;.765;834000;0
18957;184437;1443;67;7;0;7;1.000;3600000;0
18957;80682;1443;0;0;0;0;.00nan;0;0
18957;148391;1426;43;35;6;29;.829;2766000;0
18958;165030;1453;59;48;7;41;.854;3600000;0
18958;184437;1443;58;7;1;6;.857;3600000;0
18958;195618;1453;0;0;0;0;.00nan;0;0
18958;80682;1443;0;0;0;0;.00nan;0;0
18959;4127;1429;0;0;0;0;.00nan;0;0
18959;185136;1440;0;0;0;0;.00nan;0;0
18959;187263;1440;68;26;2;24;.923;3600000;0
18959;-1;1429;50;26;3;23;.885;3545000;0
18960;2037;4961;0;0;0;0;.00nan;0;0
18960;-1;4961;65;35;4;31;.886;3576000;0
18960;157903;1430;0;0;0;0;.00nan;0;0
18960;157929;1430;57;23;3;20;.870;3600000;0
18961;9524;1422;0;0;0;0;.00nan;0;0
18961;-1;1422;42;20;4;16;.800;3573000;0
18961;185124;4742;62;24;2;22;.917;3600000;0
18961;157845;4742;0;0;0;0;.00nan;0;0
18962;182561;1426;88;44;2;42;.955;3600000;0
18962;195566;1425;0;0;0;0;.00nan;0;0
18962;64230;1425;75;27;1;26;.963;3600000;0
18962;148391;1426;0;0;0;0;.00nan;0;0
18963;9524;1422;0;0;0;0;.00nan;0;0
18963;165030;1453;74;38;3;35;.921;3600000;0
18963;195618;1453;0;0;0;0;.00nan;0;0
18963;-1;1422;77;21;1;20;.952;3600000;0
18964;2037;4961;0;0;0;0;.00nan;0;0
18964;-1;4961;75;45;4;41;.911;3600000;0
18964;185136;1440;0;0;0;0;.00nan;0;0
18964;187263;1440;68;20;1;19;.950;3600000;0
18965;1765;1427;50;2;0;2;1.000;462000;0
18965;169438;1427;25;24;6;18;.750;3138000;0
18965;157903;1430;77;25;1;24;.960;3600000;0
18965;157929;1430;0;0;0;0;.00nan;0;0
18966;182561;1426;49;17;2;15;.882;3586000;0
18966;185124;4742;0;0;0;0;.00nan;0;0
18966;148391;1426;0;0;0;0;.00nan;0;0
18966;157845;4742;100;33;0;33;1.000;3600000;0
18967;184437;1443;73;21;1;20;.952;3600000;0
18967;195566;1425;0;0;0;0;.00nan;0;0
18967;64230;1425;95;44;3;41;.932;3600000;0
18967;80682;1443;0;0;0;0;.00nan;0;0
18968;182561;1426;0;0;0;0;.00nan;0;0
18968;184437;1443;0;0;0;0;.00nan;0;0
18968;80682;1443;48;18;3;15;.833;3600000;0
18968;148391;1426;46;41;5;36;.878;3594000;0
18969;1765;1427;67;32;3;29;.906;3900000;0
18969;169438;1427;0;0;0;0;.00nan;0;0
18969;157903;1430;0;0;0;0;.00nan;0;0
18969;157929;1430;67;28;3;25;.893;3900000;0
18970;4127;1429;50;21;3;18;.857;3600000;0
18970;185124;4742;0;0;0;0;.00nan;0;0
18970;-1;1429;0;0;0;0;.00nan;0;0
18970;157845;4742;32;36;6;30;.833;3553000;0
18971;2037;4961;0;0;0;0;.00nan;0;0
18971;-1;4961;71;42;3;39;.929;3579000;0
18971;185136;1440;0;0;0;0;.00nan;0;0
18971;187263;1440;63;20;2;18;.900;3600000;0
18972;9524;1422;73;29;2;27;.931;3600000;0
18972;165030;1453;54;27;3;24;.889;3567000;0
18972;195618;1453;0;0;0;0;.00nan;0;0
18972;-1;1422;0;0;0;0;.00nan;0;0
18973;2037;4961;0;0;0;0;.00nan;0;0
18973;165030;1453;62;44;5;39;.886;3541000;0
18973;-1;4961;43;16;3;13;.813;3600000;0
18973;195618;1453;0;0;0;0;.00nan;0;0
18974;1765;1427;0;0;0;0;.00nan;0;0
18974;169438;1427;43;35;6;29;.829;3600000;0
18974;195566;1425;0;0;0;0;.00nan;0;0
18974;64230;1425;51;17;2;15;.882;3600000;0
18975;185124;4742;52;25;3;22;.880;3178000;0
18975;157845;4742;22;4;3;1;.250;422000;0
18975;157903;1430;95;19;0;19;1.000;3600000;0
18975;157929;1430;0;0;0;0;.00nan;0;0
18976;4127;1429;38;22;5;17;.773;3600000;0
18976;185136;1440;62;11;0;11;1.000;1127000;0
18976;187263;1440;22;22;6;16;.727;2446000;0
18976;-1;1429;0;0;0;0;.00nan;0;0
18977;182561;1426;31;35;6;29;.829;3600000;0
18977;9524;1422;0;0;0;0;.00nan;0;0
18977;-1;1422;63;31;3;28;.903;3600000;0
18977;148391;1426;0;0;0;0;.00nan;0;0
18978;1765;1427;47;56;9;47;.839;3348000;0
18978;169438;1427;54;5;0;5;1.000;252000;0
18978;184437;1443;62;20;2;18;.900;3600000;0
18978;80682;1443;0;0;0;0;.00nan;0;0
18979;185136;1440;86;37;2;35;.946;3559000;0
18979;187263;1440;0;0;0;0;.00nan;0;0
18979;157903;1430;76;21;1;20;.952;3600000;0
18979;157929;1430;0;0;0;0;.00nan;0;0
18980;2037;4961;0;0;0;0;.00nan;0;0
18980;165030;1453;75;37;3;34;.919;3599000;0
18980;-1;4961;72;33;2;31;.939;3600000;0
18980;195618;1453;0;0;0;0;.00nan;0;0
18981;182561;1426;65;35;5;30;.857;3600000;0
18981;185124;4742;36;26;5;21;.808;3023000;0
18981;148391;1426;0;0;0;0;.00nan;0;0
18981;157845;4742;31;8;3;5;.625;577000;0
18982;4127;1429;0;0;0;0;.00nan;0;0
18982;195566;1425;0;0;0;0;.00nan;0;0
18982;-1;1429;100;39;2;37;.949;3600000;0
18982;64230;1425;51;23;4;19;.826;3534000;0
18983;4127;1429;87;36;2;34;.944;3600000;0
18983;165030;1453;52;26;3;23;.885;3559000;0
18983;195618;1453;0;0;0;0;.00nan;0;0
18983;-1;1429;0;0;0;0;.00nan;0;0
18984;184437;1443;73;10;0;10;1.000;3600000;0
18984;80682;1443;0;0;0;0;.00nan;0;0
18984;157903;1430;0;0;0;0;.00nan;0;0
18984;157929;1430;62;35;5;30;.857;3600000;0
18985;1765;1427;0;0;0;0;.00nan;0;0
18985;182561;1426;64;23;2;21;.913;3603000;0
18985;169438;1427;85;39;3;36;.923;3635000;0
18985;148391;1426;0;0;0;0;.00nan;0;0
18986;2037;4961;0;0;0;0;.00nan;0;0
18986;-1;4961;41;21;4;17;.810;3572000;0
18986;195566;1425;0;0;0;0;.00nan;0;0
18986;64230;1425;68;30;3;27;.900;3600000;0
18987;184437;1443;83;17;0;17;1.000;3600000;0
18987;195566;1425;0;0;0;0;.00nan;0;0
18987;64230;1425;64;52;6;46;.885;3600000;0
18987;80682;1443;0;0;0;0;.00nan;0;0
18988;165030;1453;74;29;2;27;.931;3600000;0
18988;195618;1453;0;0;0;0;.00nan;0;0
18988;185136;1440;0;0;0;0;.00nan;0;0
18988;187263;1440;65;37;4;33;.892;3529000;0
18989;1765;1427;0;0;0;0;.00nan;0;0
18989;182561;1426;72;37;3;34;.919;3553000;0
18989;169438;1427;88;30;1;29;.967;3600000;0
18989;148391;1426;0;0;0;0;.00nan;0;0
18990;4127;1429;0;0;0;0;.00nan;0;0
18990;9524;1422;0;0;0;0;.00nan;0;0
18990;-1;1422;80;31;2;29;.935;3600000;0
18990;-1;1429;37;27;5;22;.815;3600000;0
18991;2037;4961;0;0;0;0;.00nan;0;0
18991;-1;4961;37;30;5;25;.833;3600000;0
18991;185124;4742;0;0;0;0;.00nan;0;0
18991;157845;4742;78;26;1;25;.962;3600000;0
18992;1765;1427;0;0;0;0;.00nan;0;0
18992;169438;1427;77;21;1;20;.952;3600000;0
18992;185136;1440;0;0;0;0;.00nan;0;0
18992;187263;1440;98;57;2;55;.965;3560000;0
18993;165030;1453;41;31;5;26;.839;3600000;0
18993;195618;1453;0;0;0;0;.00nan;0;0
18993;157903;1430;100;23;0;23;1.000;3600000;0
18993;157929;1430;0;0;0;0;.00nan;0;0
18994;1765;1427;77;20;2;18;.900;3600000;0
18994;169438;1427;0;0;0;0;.00nan;0;0
18994;185136;1440;0;0;0;0;.00nan;0;0
18994;187263;1440;47;34;5;29;.853;3600000;0
18995;2037;4961;0;0;0;0;.00nan;0;0
18995;9524;1422;0;0;0;0;.00nan;0;0
18995;-1;4961;100;29;0;29;1.000;3600000;0
18995;-1;1422;70;21;1;20;.952;3548000;0
18996;184437;1443;81;15;0;15;1.000;3600000;0
18996;185124;4742;0;0;0;0;.00nan;0;0
18996;80682;1443;0;0;0;0;.00nan;0;0
18996;157845;4742;95;37;1;36;.973;3566000;0
18997;182561;1426;88;34;1;33;.971;3600000;0
18997;195566;1425;0;0;0;0;.00nan;0;0
18997;64230;1425;35;40;7;33;.825;3600000;0
18997;148391;1426;0;0;0;0;.00nan;0;0
18998;2037;4961;39;32;5;27;.844;1823000;0
18998;-1;4961;27;25;6;19;.760;1777000;0
18998;184437;1443;40;9;2;7;.778;3600000;0
18998;80682;1443;0;0;0;0;.00nan;0;0
18999;185124;4742;0;0;0;0;.00nan;0;0
18999;185136;1440;0;0;0;0;.00nan;0;0
18999;187263;1440;81;41;3;38;.927;3793000;0
18999;157845;4742;55;27;4;23;.852;3793000;0
19000;1765;1427;0;0;0;0;.00nan;0;0
19000;9524;1422;0;0;0;0;.00nan;0;0
19000;169438;1427;68;47;5;42;.894;3900000;0
19000;-1;1422;56;29;5;24;.828;3900000;0
19001;182561;1426;51;28;4;24;.857;3600000;0
19001;165030;1453;24;43;9;34;.791;3600000;0
19001;195618;1453;0;0;0;0;.00nan;0;0
19001;148391;1426;0;0;0;0;.00nan;0;0
19002;182561;1426;87;17;0;17;1.000;3600000;0
19002;165030;1453;0;0;0;0;.00nan;0;0
19002;195618;1453;71;56;5;51;.911;3600000;0
19002;148391;1426;0;0;0;0;.00nan;0;0
19003;4127;1429;94;32;1;31;.969;3600000;0
19003;-1;1429;0;0;0;0;.00nan;0;0
19003;157903;1430;63;41;5;36;.878;3600000;0
19003;157929;1430;0;0;0;0;.00nan;0;0
19004;2037;4961;0;0;0;0;.00nan;0;0
19004;-1;4961;78;63;5;58;.921;3600000;0
19004;184437;1443;71;5;0;5;1.000;3600000;0
19004;80682;1443;0;0;0;0;.00nan;0;0
19005;9524;1422;48;26;4;22;.846;3600000;0
19005;-1;1422;0;0;0;0;.00nan;0;0
19005;185136;1440;0;0;0;0;.00nan;0;0
19005;187263;1440;47;43;6;37;.860;3588000;0
19006;1765;1427;0;0;0;0;.00nan;0;0
19006;169438;1427;37;31;6;25;.806;3600000;0
19006;195566;1425;0;0;0;0;.00nan;0;0
19006;64230;1425;68;23;2;21;.913;3600000;0
19007;4127;1429;57;40;5;35;.875;3600000;0
19007;-1;1429;0;0;0;0;.00nan;0;0
19007;157903;1430;0;0;0;0;.00nan;0;0
19007;157929;1430;48;14;2;12;.857;3600000;0
19008;195566;1425;0;0;0;0;.00nan;0;0
19008;185124;4742;0;0;0;0;.00nan;0;0
19008;64230;1425;83;29;1;28;.966;3830000;0
19008;157845;4742;81;34;2;32;.941;3830000;0
19009;165030;1453;40;47;7;40;.851;3600000;0
19009;184437;1443;88;14;0;14;1.000;3600000;0
19009;195618;1453;0;0;0;0;.00nan;0;0
19009;80682;1443;0;0;0;0;.00nan;0;0
19010;1765;1427;0;0;0;0;.00nan;0;0
19010;169438;1427;64;26;2;24;.923;3600000;0
19010;185124;4742;47;3;1;2;.667;529000;0
19010;157845;4742;31;41;7;34;.829;3071000;0
19011;2037;4961;0;0;0;0;.00nan;0;0
19011;4127;1429;38;15;3;12;.800;3600000;0
19011;-1;4961;84;27;1;26;.963;3600000;0
19011;-1;1429;0;0;0;0;.00nan;0;0
19012;9524;1422;0;0;0;0;.00nan;0;0
19012;195566;1425;0;0;0;0;.00nan;0;0
19012;-1;1422;42;25;4;21;.840;3600000;0
19012;64230;1425;91;32;1;31;.969;3600000;0
19013;182561;1426;64;17;1;16;.941;3600000;0
19013;148391;1426;0;0;0;0;.00nan;0;0
19013;157903;1430;48;21;3;18;.857;3565000;0
19013;157929;1430;0;0;0;0;.00nan;0;0
19014;165030;1453;89;54;4;50;.926;3600000;0
19014;184437;1443;77;11;0;11;1.000;3600000;0
19014;195618;1453;0;0;0;0;.00nan;0;0
19014;80682;1443;0;0;0;0;.00nan;0;0
19015;1765;1427;99;25;0;25;1.000;3600000;0
19015;169438;1427;0;0;0;0;.00nan;0;0
19015;185124;4742;84;27;1;26;.963;3568000;0
19015;157845;4742;0;0;0;0;.00nan;0;0
19016;9524;1422;0;0;0;0;.00nan;0;0
19016;-1;1422;49;31;6;25;.806;3600000;0
19016;185136;1440;0;0;0;0;.00nan;0;0
19016;187263;1440;42;52;8;44;.846;3574000;0
19017;182561;1426;0;0;0;0;.00nan;0;0
19017;148391;1426;57;24;3;21;.875;3600000;0
19017;157903;1430;48;34;6;28;.824;3600000;0
19017;157929;1430;0;0;0;0;.00nan;0;0
19018;2037;4961;0;0;0;0;.00nan;0;0
19018;4127;1429;66;23;2;21;.913;3600000;0
19018;-1;4961;42;29;6;23;.793;3600000;0
19018;-1;1429;0;0;0;0;.00nan;0;0
19019;1765;1427;74;30;2;28;.933;3512000;0
19019;4127;1429;100;33;0;33;1.000;3600000;0
19019;169438;1427;0;0;0;0;.00nan;0;0
19019;-1;1429;0;0;0;0;.00nan;0;0
19020;185124;4742;0;0;0;0;.00nan;0;0
19020;157845;4742;30;26;6;20;.769;3600000;0
19020;157903;1430;0;0;0;0;.00nan;0;0
19020;157929;1430;61;31;3;28;.903;3600000;0
19021;9524;1422;0;0;0;0;.00nan;0;0
19021;165030;1453;45;42;6;36;.857;3569000;0
19021;195618;1453;0;0;0;0;.00nan;0;0
19021;-1;1422;55;23;4;19;.826;3600000;0
19022;2037;4961;0;0;0;0;.00nan;0;0
19022;182561;1426;50;20;3;17;.850;3673000;0
19022;-1;4961;61;28;4;24;.857;3673000;0
19022;148391;1426;0;0;0;0;.00nan;0;0
19023;195566;1425;0;0;0;0;.00nan;0;0
19023;185136;1440;0;0;0;0;.00nan;0;0
19023;187263;1440;60;39;4;35;.897;3600000;0
19023;64230;1425;95;23;0;23;1.000;3600000;0
19024;182561;1426;0;0;0;0;.00nan;0;0
19024;184437;1443;54;9;1;8;.889;3600000;0
19024;80682;1443;0;0;0;0;.00nan;0;0
19024;148391;1426;69;52;6;46;.885;3600000;0
19025;195566;1425;0;0;0;0;.00nan;0;0
19025;185136;1440;0;0;0;0;.00nan;0;0
19025;187263;1440;90;44;3;41;.932;3789000;0
19025;64230;1425;76;23;2;21;.913;3789000;0
19026;1765;1427;0;0;0;0;.00nan;0;0
19026;4127;1429;0;0;0;0;.00nan;0;0
19026;169438;1427;80;28;1;27;.964;3600000;0
19026;-1;1429;68;33;3;30;.909;3594000;0
19027;2037;4961;0;0;0;0;.00nan;0;0
19027;-1;4961;57;34;4;30;.882;3600000;0
19027;185124;4742;0;0;0;0;.00nan;0;0
19027;157845;4742;82;19;0;19;1.000;3600000;0
19028;9524;1422;0;0;0;0;.00nan;0;0
19028;165030;1453;100;42;1;41;.976;3600000;0
19028;195618;1453;0;0;0;0;.00nan;0;0
19028;-1;1422;60;21;2;19;.905;3570000;0
19029;1765;1427;0;0;0;0;.00nan;0;0
19029;9524;1422;0;0;0;0;.00nan;0;0
19029;169438;1427;53;42;6;36;.857;3600000;0
19029;-1;1422;64;17;1;16;.941;3600000;0
19030;9524;1422;0;0;0;0;.00nan;0;0
19030;165030;1453;38;31;5;26;.839;3600000;0
19030;195618;1453;0;0;0;0;.00nan;0;0
19030;-1;1422;59;30;4;26;.867;3600000;0
19031;195566;1425;0;0;0;0;.00nan;0;0
19031;64230;1425;86;25;1;24;.960;3600000;0
19031;157903;1430;56;23;3;20;.870;3524000;0
19031;157929;1430;0;0;0;0;.00nan;0;0
19032;2037;4961;0;0;0;0;.00nan;0;0
19032;-1;4961;60;21;3;18;.857;3900000;0
19032;185136;1440;0;0;0;0;.00nan;0;0
19032;187263;1440;75;38;3;35;.921;3900000;0
19033;4127;1429;61;19;1;18;.947;3600000;0
19033;185124;4742;0;0;0;0;.00nan;0;0
19033;-1;1429;0;0;0;0;.00nan;0;0
19033;157845;4742;45;37;5;32;.865;3600000;0
19034;182561;1426;19;25;6;19;.760;2199000;0
19034;184437;1443;82;12;0;12;1.000;3600000;0
19034;80682;1443;0;0;0;0;.00nan;0;0
19034;148391;1426;83;28;1;27;.964;1401000;0
19035;2037;4961;0;0;0;0;.00nan;0;0
19035;-1;4961;86;53;5;48;.906;3600000;0
19035;184437;1443;52;10;2;8;.800;3600000;0
19035;80682;1443;0;0;0;0;.00nan;0;0
19036;185136;1440;9;17;6;11;.647;2298000;0
19036;187263;1440;66;25;3;22;.880;1302000;0
19036;157903;1430;0;0;0;0;.00nan;0;0
19036;157929;1430;16;21;6;15;.714;3600000;0
19037;1765;1427;0;0;0;0;.00nan;0;0
19037;165030;1453;49;52;9;43;.827;3600000;0
19037;169438;1427;57;14;2;12;.857;3600000;0
19037;195618;1453;0;0;0;0;.00nan;0;0
19038;182561;1426;55;31;4;27;.871;3600000;0
19038;4127;1429;73;28;2;26;.929;3600000;0
19038;-1;1429;0;0;0;0;.00nan;0;0
19038;148391;1426;0;0;0;0;.00nan;0;0
19039;195566;1425;0;0;0;0;.00nan;0;0
19039;185124;4742;33;34;6;28;.824;3003000;0
19039;64230;1425;67;18;1;17;.944;3600000;0
19039;157845;4742;27;9;3;6;.667;597000;0
19040;1765;1427;0;0;0;0;.00nan;0;0
19040;165030;1453;86;50;4;46;.920;3732000;0
19040;169438;1427;49;20;3;17;.850;3732000;0
19040;195618;1453;0;0;0;0;.00nan;0;0
19041;184437;1443;89;17;0;17;1.000;3600000;0
19041;185136;1440;0;0;0;0;.00nan;0;0
19041;187263;1440;51;46;6;40;.870;3600000;0
19041;80682;1443;0;0;0;0;.00nan;0;0
19042;2037;4961;0;0;0;0;.00nan;0;0
19042;-1;4961;37;42;7;35;.833;3600000;0
19042;157903;1430;86;30;1;29;.967;3600000;0
19042;157929;1430;0;0;0;0;.00nan;0;0
19043;9524;1422;0;0;0;0;.00nan;0;0
19043;-1;1422;62;24;2;22;.917;3900000;0
19043;185124;4742;0;0;0;0;.00nan;0;0
19043;157845;4742;82;31;2;29;.935;3900000;0
19044;182561;1426;71;28;2;26;.929;3600000;0
19044;195566;1425;0;0;0;0;.00nan;0;0
19044;64230;1425;44;22;4;18;.818;3595000;0
19044;148391;1426;0;0;0;0;.00nan;0;0
19045;184437;1443;48;7;1;6;.857;3600000;0
19045;185136;1440;0;0;0;0;.00nan;0;0
19045;187263;1440;97;68;4;64;.941;3600000;0
19045;80682;1443;0;0;0;0;.00nan;0;0
19046;4127;1429;72;22;1;21;.955;3600000;0
19046;165030;1453;47;30;5;25;.833;3600000;0
19046;195618;1453;0;0;0;0;.00nan;0;0
19046;-1;1429;0;0;0;0;.00nan;0;0
19047;2037;4961;51;23;3;20;.870;3600000;0
19047;-1;4961;0;0;0;0;.00nan;0;0
19047;157903;1430;0;0;0;0;.00nan;0;0
19047;157929;1430;62;32;4;28;.875;3543000;0
19048;9524;1422;72;36;3;33;.917;3578000;0
19048;-1;1422;0;0;0;0;.00nan;0;0
19048;185124;4742;0;0;0;0;.00nan;0;0
19048;157845;4742;62;16;1;15;.938;3600000;0
19049;182561;1426;0;0;0;0;.00nan;0;0
19049;195566;1425;60;32;4;28;.875;3600000;0
19049;64230;1425;0;0;0;0;.00nan;0;0
19049;148391;1426;39;29;5;24;.828;3558000;0
19050;1765;1427;0;0;0;0;.00nan;0;0
19050;169438;1427;67;23;2;21;.913;3600000;0
19050;157903;1430;32;30;6;24;.800;3181000;0
19050;157929;1430;52;5;0;5;1.000;419000;0
19051;4127;1429;53;33;4;29;.879;3552000;0
19051;-1;1429;0;0;0;0;.00nan;0;0
19051;157903;1430;77;38;3;35;.921;3600000;0
19051;157929;1430;0;0;0;0;.00nan;0;0
19052;185124;4742;0;0;0;0;.00nan;0;0
19052;185136;1440;34;21;4;17;.810;2117000;0
19052;187263;1440;35;16;4;12;.750;1483000;0
19052;157845;4742;49;27;4;23;.852;3600000;0
19053;182561;1426;50;22;4;18;.818;3600000;0
19053;9524;1422;0;0;0;0;.00nan;0;0
19053;-1;1422;34;33;7;26;.788;3600000;0
19053;148391;1426;0;0;0;0;.00nan;0;0
19054;184437;1443;62;16;2;14;.875;3600000;0
19054;195566;1425;0;0;0;0;.00nan;0;0
19054;64230;1425;82;54;5;49;.907;3600000;0
19054;80682;1443;0;0;0;0;.00nan;0;0
19055;184437;1443;0;0;0;0;.00nan;0;0
19055;195566;1425;54;9;1;8;.889;835000;0
19055;64230;1425;57;45;6;39;.867;2765000;0
19055;80682;1443;36;30;6;24;.800;3600000;0
19056;9524;1422;0;0;0;0;.00nan;0;0
19056;165030;1453;61;41;5;36;.878;2352000;0
19056;195618;1453;44;10;2;8;.800;1248000;0
19056;-1;1422;85;29;1;28;.966;3600000;0
19057;182561;1426;0;0;0;0;.00nan;0;0
19057;185136;1440;66;12;0;12;1.000;954000;0
19057;187263;1440;27;23;6;17;.739;2646000;0
19057;148391;1426;70;28;2;26;.929;3600000;0
19058;4127;1429;0;0;0;0;.00nan;0;0
19058;185124;4742;0;0;0;0;.00nan;0;0
19058;-1;1429;43;29;4;25;.862;3563000;0
19058;157845;4742;51;23;3;20;.870;3600000;0
19059;1765;1427;0;0;0;0;.00nan;0;0
19059;2037;4961;0;0;0;0;.00nan;0;0
19059;-1;4961;74;33;2;31;.939;3600000;0
19059;169438;1427;29;23;5;18;.783;3600000;0
19060;184437;1443;59;19;2;17;.895;3600000;0
19060;185124;4742;21;16;5;11;.688;1062000;0
19060;80682;1443;0;0;0;0;.00nan;0;0
19060;157845;4742;18;31;7;24;.774;2538000;0
19061;165030;1453;33;26;5;21;.808;2089000;0
19061;195566;1425;0;0;0;0;.00nan;0;0
19061;195618;1453;35;13;3;10;.769;1511000;0
19061;64230;1425;84;36;2;34;.944;3600000;0
19062;1765;1427;57;29;3;26;.897;3600000;0
19062;2037;4961;0;0;0;0;.00nan;0;0
19062;-1;4961;34;35;6;29;.829;3600000;0
19062;169438;1427;0;0;0;0;.00nan;0;0
19063;9524;1422;0;0;0;0;.00nan;0;0
19063;-1;1422;59;26;2;24;.923;3600000;0
19063;157903;1430;91;44;3;41;.932;3564000;0
19063;157929;1430;0;0;0;0;.00nan;0;0
19064;182561;1426;68;24;2;22;.917;3600000;0
19064;4127;1429;26;27;6;21;.778;2599000;0
19064;-1;1429;66;11;0;11;1.000;1001000;0
19064;148391;1426;0;0;0;0;.00nan;0;0
19065;165030;1453;100;25;0;25;1.000;3600000;0
19065;195618;1453;0;0;0;0;.00nan;0;0
19065;185136;1440;0;0;0;0;.00nan;0;0
19065;187263;1440;81;33;1;32;.970;3589000;0
19066;4127;1429;73;18;1;17;.944;3600000;0
19066;-1;1429;0;0;0;0;.00nan;0;0
19066;157903;1430;0;0;0;0;.00nan;0;0
19066;157929;1430;53;25;3;22;.880;3596000;0
19067;2037;4961;0;0;0;0;.00nan;0;0
19067;182561;1426;0;0;0;0;.00nan;0;0
19067;-1;4961;63;35;3;32;.914;3600000;0
19067;148391;1426;34;27;5;22;.815;3514000;0
19068;184437;1443;63;12;1;11;.917;3600000;0
19068;185124;4742;0;0;0;0;.00nan;0;0
19068;80682;1443;0;0;0;0;.00nan;0;0
19068;157845;4742;88;49;2;47;.959;3600000;0
19069;9524;1422;90;33;1;32;.970;3600000;0
19069;195566;1425;0;0;0;0;.00nan;0;0
19069;-1;1422;0;0;0;0;.00nan;0;0
19069;64230;1425;66;22;2;20;.909;3594000;0
19070;9524;1422;58;12;1;11;.917;1248000;0
19070;184437;1443;71;20;1;19;.950;3600000;0
19070;-1;1422;21;31;7;24;.774;2352000;0
19070;80682;1443;0;0;0;0;.00nan;0;0
19071;165030;1453;61;30;3;27;.900;3578000;0
19071;195618;1453;0;0;0;0;.00nan;0;0
19071;157903;1430;73;20;1;19;.950;3600000;0
19071;157929;1430;0;0;0;0;.00nan;0;0
19072;185124;4742;0;0;0;0;.00nan;0;0
19072;185136;1440;0;0;0;0;.00nan;0;0
19072;187263;1440;83;23;1;22;.957;3600000;0
19072;157845;4742;50;23;3;20;.870;3585000;0
19073;1765;1427;0;0;0;0;.00nan;0;0
19073;182561;1426;61;24;2;22;.917;3600000;0
19073;169438;1427;44;36;5;31;.861;3600000;0
19073;148391;1426;0;0;0;0;.00nan;0;0
19074;4127;1429;64;39;5;34;.872;3600000;0
19074;195566;1425;0;0;0;0;.00nan;0;0
19074;-1;1429;0;0;0;0;.00nan;0;0
19074;64230;1425;71;24;2;22;.917;3600000;0
19075;1765;1427;63;41;5;36;.878;3600000;0
19075;169438;1427;0;0;0;0;.00nan;0;0
19075;195566;1425;0;0;0;0;.00nan;0;0
19075;64230;1425;100;30;0;30;1.000;3600000;0
19076;182561;1426;0;0;0;0;.00nan;0;0
19076;148391;1426;64;19;2;17;.895;3600000;0
19076;157903;1430;0;0;0;0;.00nan;0;0
19076;157929;1430;65;30;4;26;.867;3516000;0
19077;4127;1429;97;34;1;33;.971;3600000;0
19077;184437;1443;53;18;3;15;.833;3530000;0
19077;-1;1429;0;0;0;0;.00nan;0;0
19077;80682;1443;0;0;0;0;.00nan;0;0
19078;2037;4961;0;0;0;0;.00nan;0;0
19078;-1;4961;61;37;4;33;.892;3600000;0
19078;185136;1440;0;0;0;0;.00nan;0;0
19078;187263;1440;77;25;1;24;.960;3600000;0
19079;165030;1453;71;38;3;35;.921;3520000;0
19079;195618;1453;0;0;0;0;.00nan;0;0
19079;185124;4742;66;19;1;18;.947;3600000;0
19079;157845;4742;0;0;0;0;.00nan;0;0
19080;185124;4742;0;0;0;0;.00nan;0;0
19080;185136;1440;0;0;0;0;.00nan;0;0
19080;187263;1440;74;35;3;32;.914;3600000;0
19080;157845;4742;46;12;2;10;.833;3600000;0
19081;165030;1453;72;52;7;45;.865;3600000;0
19081;184437;1443;37;6;2;4;.667;3600000;0
19081;195618;1453;0;0;0;0;.00nan;0;0
19081;80682;1443;0;0;0;0;.00nan;0;0
19082;1765;1427;0;0;0;0;.00nan;0;0
19082;4127;1429;85;29;1;28;.966;3600000;0
19082;169438;1427;71;28;2;26;.929;3561000;0
19082;-1;1429;0;0;0;0;.00nan;0;0
19083;2037;4961;0;0;0;0;.00nan;0;0
19083;-1;4961;54;31;4;27;.871;3600000;0
19083;195566;1425;0;0;0;0;.00nan;0;0
19083;64230;1425;84;33;1;32;.970;3600000;0
19084;9524;1422;0;0;0;0;.00nan;0;0
19084;-1;1422;40;23;5;18;.783;3600000;0
19084;157903;1430;90;33;1;32;.970;3600000;0
19084;157929;1430;0;0;0;0;.00nan;0;0
19085;182561;1426;80;15;0;15;1.000;3600000;0
19085;185136;1440;0;0;0;0;.00nan;0;0
19085;187263;1440;98;48;2;46;.958;3582000;0
19085;148391;1426;0;0;0;0;.00nan;0;0
19086;184437;1443;67;18;1;17;.944;3600000;0
19086;185136;1440;0;0;0;0;.00nan;0;0
19086;187263;1440;96;58;3;55;.948;3600000;0
19086;80682;1443;0;0;0;0;.00nan;0;0
19087;1765;1427;77;26;1;25;.962;3600000;0
19087;4127;1429;50;31;4;27;.871;3600000;0
19087;169438;1427;0;0;0;0;.00nan;0;0
19087;-1;1429;0;0;0;0;.00nan;0;0
19088;2037;4961;0;0;0;0;.00nan;0;0
19088;-1;4961;37;35;6;29;.829;3600000;0
19088;185124;4742;0;0;0;0;.00nan;0;0
19088;157845;4742;65;25;2;23;.920;3600000;0
19089;9524;1422;66;24;2;22;.917;3600000;0
19089;-1;1422;0;0;0;0;.00nan;0;0
19089;157903;1430;0;0;0;0;.00nan;0;0
19089;157929;1430;70;38;4;34;.895;3600000;0
19090;165030;1453;67;24;2;22;.917;3600000;0
19090;195566;1425;0;0;0;0;.00nan;0;0
19090;195618;1453;0;0;0;0;.00nan;0;0
19090;64230;1425;81;23;1;22;.957;3600000;0
19091;1765;1427;0;0;0;0;.00nan;0;0
19091;165030;1453;71;46;6;40;.870;3544000;0
19091;169438;1427;32;16;4;12;.750;3600000;0
19091;195618;1453;0;0;0;0;.00nan;0;0
19092;185136;1440;0;0;0;0;.00nan;0;0
19092;187263;1440;61;39;5;34;.872;3661000;0
19092;157903;1430;38;26;5;21;.808;2214000;0
19092;157929;1430;57;9;1;8;.889;1447000;0
19093;4127;1429;73;20;1;19;.950;3600000;0
19093;185124;4742;0;0;0;0;.00nan;0;0
19093;-1;1429;0;0;0;0;.00nan;0;0
19093;157845;4742;57;18;2;16;.889;3556000;0
19094;2037;4961;0;0;0;0;.00nan;0;0
19094;9524;1422;0;0;0;0;.00nan;0;0
19094;-1;4961;36;42;7;35;.833;3600000;0
19094;-1;1422;45;33;5;28;.848;3600000;0
19095;182561;1426;77;26;1;25;.962;3600000;0
19095;195566;1425;0;0;0;0;.00nan;0;0
19095;64230;1425;84;30;2;28;.933;3600000;0
19095;148391;1426;0;0;0;0;.00nan;0;0
19096;182561;1426;62;33;4;29;.879;3600000;0
19096;184437;1443;69;15;1;14;.933;3600000;0
19096;80682;1443;0;0;0;0;.00nan;0;0
19096;148391;1426;0;0;0;0;.00nan;0;0
19097;9524;1422;81;27;1;26;.963;3600000;0
19097;-1;1422;0;0;0;0;.00nan;0;0
19097;185136;1440;0;0;0;0;.00nan;0;0
19097;187263;1440;55;40;5;35;.875;3600000;0
19098;1765;1427;50;18;3;15;.833;3600000;0
19098;2037;4961;0;0;0;0;.00nan;0;0
19098;-1;4961;73;41;4;37;.902;3548000;0
19098;169438;1427;0;0;0;0;.00nan;0;0
19099;4127;1429;0;0;0;0;.00nan;0;0
19099;165030;1453;89;29;1;28;.966;3600000;0
19099;195618;1453;0;0;0;0;.00nan;0;0
19099;-1;1429;25;16;5;11;.688;3600000;0
19100;195566;1425;0;0;0;0;.00nan;0;0
19100;64230;1425;75;20;1;19;.950;3600000;0
19100;157903;1430;23;5;3;2;.400;136000;0
19100;157929;1430;75;40;4;36;.900;3464000;0
19101;165030;1453;0;0;0;0;.00nan;0;0
19101;195618;1453;49;29;4;25;.862;3518000;0
19101;185124;4742;0;0;0;0;.00nan;0;0
19101;157845;4742;65;23;2;21;.913;3600000;0
19102;2037;4961;0;0;0;0;.00nan;0;0
19102;-1;4961;65;22;3;19;.864;3900000;0
19102;185136;1440;0;0;0;0;.00nan;0;0
19102;187263;1440;54;25;3;22;.880;3884000;0
19103;195566;1425;0;0;0;0;.00nan;0;0
19103;64230;1425;54;23;3;20;.870;3600000;0
19103;157903;1430;44;31;5;26;.839;3567000;0
19103;157929;1430;0;0;0;0;.00nan;0;0
19104;1765;1427;0;0;0;0;.00nan;0;0
19104;9524;1422;0;0;0;0;.00nan;0;0
19104;169438;1427;57;33;4;29;.879;3900000;0
19104;-1;1422;61;30;4;26;.867;3896000;0
19105;182561;1426;67;41;4;37;.902;3600000;0
19105;184437;1443;26;24;5;19;.792;3578000;0
19105;80682;1443;0;0;0;0;.00nan;0;0
19105;148391;1426;0;0;0;0;.00nan;0;0
19106;165030;1453;100;45;2;43;.956;3600000;0
19106;184437;1443;32;9;3;6;.667;3546000;0
19106;195618;1453;0;0;0;0;.00nan;0;0
19106;80682;1443;0;0;0;0;.00nan;0;0
19107;1765;1427;0;0;0;0;.00nan;0;0
19107;182561;1426;0;0;0;0;.00nan;0;0
19107;169438;1427;45;32;4;28;.875;3600000;0
19107;148391;1426;100;23;0;23;1.000;3600000;0
19108;4127;1429;35;28;5;23;.821;3600000;0
19108;185136;1440;56;4;0;4;1.000;592000;0
19108;187263;1440;28;35;7;28;.800;2956000;0
19108;-1;1429;0;0;0;0;.00nan;0;0
19109;2037;4961;48;0;0;0;.00nan;259000;0
19109;9524;1422;61;33;4;29;.879;3600000;0
19109;-1;4961;34;31;6;25;.806;3278000;0
19109;-1;1422;0;0;0;0;.00nan;0;0
19110;195566;1425;0;0;0;0;.00nan;0;0
19110;185124;4742;40;22;4;18;.818;2099000;0
19110;64230;1425;47;26;4;22;.846;3600000;0
19110;157845;4742;53;18;2;16;.889;1423000;0
19111;1765;1427;0;0;0;0;.00nan;0;0
19111;169438;1427;41;25;4;21;.840;3695000;0
19111;185136;1440;0;0;0;0;.00nan;0;0
19111;187263;1440;61;44;5;39;.886;3695000;0
19112;184437;1443;51;15;2;13;.867;3600000;0
19112;80682;1443;0;0;0;0;.00nan;0;0
19112;157903;1430;64;56;6;50;.893;3600000;0
19112;157929;1430;0;0;0;0;.00nan;0;0
19113;4127;1429;63;37;4;33;.892;3635000;0
19113;9524;1422;0;0;0;0;.00nan;0;0
19113;-1;1422;75;31;3;28;.903;3635000;0
19113;-1;1429;0;0;0;0;.00nan;0;0
19114;182561;1426;0;0;0;0;.00nan;0;0
19114;165030;1453;81;58;5;53;.914;3600000;0
19114;195618;1453;0;0;0;0;.00nan;0;0
19114;148391;1426;71;20;1;19;.950;3600000;0
19115;2037;4961;58;19;1;18;.947;1435000;0
19115;-1;4961;21;23;6;17;.739;2165000;0
19115;195566;1425;0;0;0;0;.00nan;0;0
19115;64230;1425;82;15;0;15;1.000;3600000;0
19116;184437;1443;0;0;0;0;.00nan;0;0
19116;80682;1443;79;13;0;13;1.000;3600000;0
19116;157903;1430;22;34;7;27;.794;2446000;0
19116;157929;1430;22;25;6;19;.760;1154000;0
19117;1765;1427;0;0;0;0;.00nan;0;0
19117;169438;1427;52;34;5;29;.853;3551000;0
19117;185136;1440;0;0;0;0;.00nan;0;0
19117;187263;1440;61;28;3;25;.893;3600000;0
19118;4127;1429;0;0;0;0;.00nan;0;0
19118;9524;1422;54;19;2;17;.895;3545000;0
19118;-1;1422;0;0;0;0;.00nan;0;0
19118;-1;1429;92;28;0;28;1.000;3600000;0
19119;2037;4961;0;0;0;0;.00nan;0;0
19119;165030;1453;81;35;3;32;.914;3600000;0
19119;-1;4961;92;21;0;21;1.000;3600000;0
19119;195618;1453;0;0;0;0;.00nan;0;0
19120;195566;1425;0;0;0;0;.00nan;0;0
19120;185124;4742;0;0;0;0;.00nan;0;0
19120;64230;1425;52;28;4;24;.857;3600000;0
19120;157845;4742;67;51;6;45;.882;3535000;0
19121;2037;4961;42;4;1;3;.750;247000;0
19121;-1;4961;75;52;6;46;.885;3353000;0
19121;184437;1443;0;0;0;0;.00nan;0;0
19121;80682;1443;74;12;0;12;1.000;3600000;0
19122;165030;1453;66;35;5;30;.857;3523000;0
19122;195618;1453;0;0;0;0;.00nan;0;0
19122;185136;1440;0;0;0;0;.00nan;0;0
19122;187263;1440;97;51;3;48;.941;3600000;0
19123;1765;1427;0;0;0;0;.00nan;0;0
19123;169438;1427;79;34;2;32;.941;3600000;0
19123;157903;1430;22;24;6;18;.750;2897000;0
19123;157929;1430;52;4;0;4;1.000;703000;0
19124;4127;1429;0;0;0;0;.00nan;0;0
19124;195566;1425;0;0;0;0;.00nan;0;0
19124;-1;1429;54;33;4;29;.879;3577000;0
19124;64230;1425;52;23;3;20;.870;3600000;0
19125;9524;1422;0;0;0;0;.00nan;0;0
19125;184437;1443;0;0;0;0;.00nan;0;0
19125;-1;1422;89;43;3;40;.930;3584000;0
19125;80682;1443;72;17;1;16;.941;3600000;0
19126;182561;1426;52;13;1;12;.923;3600000;0
19126;185124;4742;0;0;0;0;.00nan;0;0
19126;148391;1426;0;0;0;0;.00nan;0;0
19126;157845;4742;54;43;5;38;.884;3600000;0
19127;182561;1426;0;0;0;0;.00nan;0;0
19127;185136;1440;78;51;3;48;.941;3703000;0
19127;187263;1440;0;0;0;0;.00nan;0;0
19127;148391;1426;68;24;2;22;.917;3673000;0
19128;1765;1427;26;37;8;29;.784;2498000;0
19128;169438;1427;43;4;1;3;.750;1102000;0
19128;184437;1443;52;16;2;14;.875;3600000;0
19128;80682;1443;0;0;0;0;.00nan;0;0
19129;2037;4961;0;0;0;0;.00nan;0;0
19129;4127;1429;61;25;3;22;.880;3574000;0
19129;-1;4961;88;40;2;38;.950;3600000;0
19129;-1;1429;0;0;0;0;.00nan;0;0
19130;185124;4742;62;32;3;29;.906;3900000;0
19130;157845;4742;0;0;0;0;.00nan;0;0
19130;157903;1430;0;0;0;0;.00nan;0;0
19130;157929;1430;61;24;3;21;.875;3900000;0
19131;9524;1422;55;24;4;20;.833;3600000;0
19131;195566;1425;0;0;0;0;.00nan;0;0
19131;-1;1422;0;0;0;0;.00nan;0;0
19131;64230;1425;57;39;5;34;.872;3552000;0
19132;182561;1426;70;24;2;22;.917;3600000;0
19132;165030;1453;49;34;5;29;.853;3600000;0
19132;195618;1453;0;0;0;0;.00nan;0;0
19132;148391;1426;0;0;0;0;.00nan;0;0
19133;4127;1429;73;22;1;21;.955;3600000;0
19133;185136;1440;0;0;0;0;.00nan;0;0
19133;187263;1440;96;40;2;38;.950;3563000;0
19133;-1;1429;0;0;0;0;.00nan;0;0
19134;2037;4961;0;0;0;0;.00nan;0;0
19134;-1;4961;86;65;6;59;.908;3600000;0
19134;184437;1443;58;13;1;12;.923;3600000;0
19134;80682;1443;0;0;0;0;.00nan;0;0
19135;1765;1427;0;0;0;0;.00nan;0;0
19135;169438;1427;76;10;0;10;1.000;3600000;0
19135;185124;4742;0;0;0;0;.00nan;0;0
19135;157845;4742;60;40;5;35;.875;3600000;0
19136;9524;1422;0;0;0;0;.00nan;0;0
19136;195566;1425;0;0;0;0;.00nan;0;0
19136;-1;1422;89;33;2;31;.939;3600000;0
19136;64230;1425;54;37;6;31;.838;3600000;0
19137;182561;1426;0;0;0;0;.00nan;0;0
19137;148391;1426;58;23;3;20;.870;3569000;0
19137;157903;1430;97;37;2;35;.946;3600000;0
19137;157929;1430;0;0;0;0;.00nan;0;0
19138;9524;1422;95;48;2;46;.958;3900000;0
19138;184437;1443;73;22;2;20;.909;3900000;0
19138;-1;1422;0;0;0;0;.00nan;0;0
19138;80682;1443;0;0;0;0;.00nan;0;0
19139;1765;1427;0;0;0;0;.00nan;0;0
19139;169438;1427;78;13;0;13;1.000;3600000;0
19139;185124;4742;67;25;2;23;.920;3591000;0
19139;157845;4742;0;0;0;0;.00nan;0;0
19140;165030;1453;75;45;4;41;.911;3549000;0
19140;195618;1453;0;0;0;0;.00nan;0;0
19140;157903;1430;0;0;0;0;.00nan;0;0
19140;157929;1430;76;37;3;34;.919;3600000;0
19141;2037;4961;0;0;0;0;.00nan;0;0
19141;4127;1429;0;0;0;0;.00nan;0;0
19141;-1;4961;92;33;2;31;.939;3900000;0
19141;-1;1429;68;27;2;25;.926;3900000;0
19142;195566;1425;0;0;0;0;.00nan;0;0
19142;185136;1440;0;0;0;0;.00nan;0;0
19142;187263;1440;77;44;4;40;.909;3600000;0
19142;64230;1425;60;16;2;14;.875;3600000;0
19143;1765;1427;0;0;0;0;.00nan;0;0
19143;9524;1422;0;0;0;0;.00nan;0;0
19143;169438;1427;78;26;1;25;.962;3600000;0
19143;-1;1422;30;32;6;26;.813;3600000;0
19144;4127;1429;49;41;6;35;.854;2774000;0
19144;184437;1443;75;22;1;21;.955;3600000;0
19144;-1;1429;63;13;0;13;1.000;826000;0
19144;80682;1443;0;0;0;0;.00nan;0;0
19145;165030;1453;75;50;5;45;.900;3600000;0
19145;195566;1425;0;0;0;0;.00nan;0;0
19145;195618;1453;0;0;0;0;.00nan;0;0
19145;64230;1425;68;25;2;23;.920;3600000;0
19146;185124;4742;0;0;0;0;.00nan;0;0
19146;157845;4742;72;30;3;27;.900;3900000;0
19146;157903;1430;95;47;3;44;.936;3900000;0
19146;157929;1430;0;0;0;0;.00nan;0;0
19147;9524;1422;62;19;2;17;.895;3600000;0
19147;-1;1422;0;0;0;0;.00nan;0;0
19147;185136;1440;50;1;0;1;1.000;548000;0
19147;187263;1440;33;47;8;39;.830;3052000;0
19148;2037;4961;50;17;2;15;.882;1551000;0
19148;182561;1426;92;25;0;25;1.000;3600000;0
19148;-1;4961;46;35;6;29;.829;2049000;0
19148;148391;1426;0;0;0;0;.00nan;0;0
19149;1765;1427;0;0;0;0;.00nan;0;0
19149;169438;1427;52;17;2;15;.882;3600000;0
19149;185136;1440;48;0;0;0;.00nan;274000;0
19149;187263;1440;53;41;6;35;.854;3326000;0
19150;182561;1426;82;25;1;24;.960;3600000;0
19150;4127;1429;55;28;3;25;.893;3553000;0
19150;-1;1429;0;0;0;0;.00nan;0;0
19150;148391;1426;0;0;0;0;.00nan;0;0
19151;2037;4961;0;0;0;0;.00nan;0;0
19151;-1;4961;52;35;4;31;.886;3582000;0
19151;157903;1430;0;0;0;0;.00nan;0;0
19151;157929;1430;42;18;3;15;.833;3600000;0
19152;184437;1443;0;0;0;0;.00nan;0;0
19152;185124;4742;59;58;7;51;.879;3600000;0
19152;80682;1443;47;22;3;19;.864;3600000;0
19152;157845;4742;0;0;0;0;.00nan;0;0
19153;165030;1453;64;33;3;30;.909;3600000;0
19153;195566;1425;0;0;0;0;.00nan;0;0
19153;195618;1453;0;0;0;0;.00nan;0;0
19153;64230;1425;88;29;1;28;.966;3600000;0
19155;2037;4961;0;0;0;0;.00nan;0;0
19155;182561;1426;65;22;2;20;.909;3900000;0
19155;-1;4961;83;43;2;41;.953;3900000;0
19155;148391;1426;0;0;0;0;.00nan;0;0
19157;195566;1425;0;0;0;0;.00nan;0;0
19157;64230;1425;58;29;4;25;.862;3900000;0
19157;157903;1430;64;39;4;35;.897;3900000;0
19157;157929;1430;0;0;0;0;.00nan;0;0
19159;1765;1427;0;0;0;0;.00nan;0;0
19159;9524;1422;93;31;2;29;.935;3900000;0
19159;169438;1427;73;32;2;30;.938;3900000;0
19159;216525;1422;0;0;0;0;.00nan;0;0
19161;4127;1429;68;42;5;37;.881;3600000;0
19161;184437;1443;86;29;1;28;.966;3600000;0
19161;-1;1429;0;0;0;0;.00nan;0;0
19161;80682;1443;0;0;0;0;.00nan;0;0
19163;165030;1453;85;37;3;34;.919;3900000;0
19163;195618;1453;0;0;0;0;.00nan;0;0
19163;185124;4742;0;0;0;0;.00nan;0;0
19163;157845;4742;64;29;3;26;.897;3900000;0
19165;182561;1426;41;28;5;23;.821;3600000;0
19165;4127;1429;70;23;1;22;.957;3600000;0
19165;-1;1429;0;0;0;0;.00nan;0;0
19165;148391;1426;0;0;0;0;.00nan;0;0
19167;2037;4961;55;17;2;15;.882;1506000;0
19167;-1;4961;19;28;6;22;.786;2094000;0
19167;184437;1443;64;20;2;18;.900;3600000;0
19167;80682;1443;0;0;0;0;.00nan;0;0
19169;185124;4742;73;17;0;17;1.000;2945000;0
19169;157845;4742;38;13;3;10;.769;582000;0
19169;157903;1430;0;0;0;0;.00nan;0;0
19169;157929;1430;94;32;1;31;.969;3600000;0
19171;195566;1425;0;0;0;0;.00nan;0;0
19171;185136;1440;52;16;2;14;.875;1370000;0
19171;187263;1440;48;31;6;25;.806;2230000;0
19171;64230;1425;51;24;4;20;.833;3600000;0
19173;1765;1427;0;0;0;0;.00nan;0;0
19173;9524;1422;47;32;5;27;.844;3900000;0
19173;169438;1427;68;46;5;41;.891;3900000;0
19173;216525;1422;0;0;0;0;.00nan;0;0
19175;9524;1422;0;0;0;0;.00nan;0;0
19175;184437;1443;0;0;0;0;.00nan;0;0
19175;216525;1422;82;38;3;35;.921;3900000;0
19175;80682;1443;44;17;3;14;.824;3900000;0
19177;185136;1440;0;0;0;0;.00nan;0;0
19177;187263;1440;41;48;7;41;.854;3600000;0
19177;157903;1430;33;25;5;20;.800;3600000;0
19177;157929;1430;0;0;0;0;.00nan;0;0
19179;2037;4961;78;22;1;21;.955;2685000;0
19179;4127;1429;0;0;0;0;.00nan;0;0
19179;-1;4961;22;13;4;9;.692;915000;0
19179;-1;1429;64;21;2;19;.905;3600000;0
19181;165030;1453;58;28;3;25;.893;3548000;0
19181;195566;1425;0;0;0;0;.00nan;0;0
19181;195618;1453;0;0;0;0;.00nan;0;0
19181;64230;1425;82;31;2;29;.935;3600000;0
19183;1765;1427;49;35;5;30;.857;3529000;0
19183;182561;1426;0;0;0;0;.00nan;0;0
19183;169438;1427;0;0;0;0;.00nan;0;0
19183;148391;1426;67;34;3;31;.912;3600000;0
19185;4127;1429;54;54;7;47;.870;3600000;0
19185;184437;1443;38;15;4;11;.733;3600000;0
19185;-1;1429;0;0;0;0;.00nan;0;0
19185;80682;1443;0;0;0;0;.00nan;0;0
19187;1765;1427;0;0;0;0;.00nan;0;0
19187;169438;1427;67;20;1;19;.950;3600000;0
19187;157903;1430;0;0;0;0;.00nan;0;0
19187;157929;1430;46;32;5;27;.844;3600000;0
19189;9524;1422;52;16;2;14;.875;3600000;0
19189;195566;1425;0;0;0;0;.00nan;0;0
19189;216525;1422;0;0;0;0;.00nan;0;0
19189;64230;1425;73;34;3;31;.912;3598000;0
19191;165030;1453;19;23;6;17;.739;3600000;0
19191;195618;1453;0;0;0;0;.00nan;0;0
19191;185124;4742;0;0;0;0;.00nan;0;0
19191;157845;4742;86;36;1;35;.972;3600000;0
19193;2037;4961;0;0;0;0;.00nan;0;0
19193;182561;1426;54;27;4;23;.852;3900000;0
19193;-1;4961;64;36;4;32;.889;3900000;0
19193;148391;1426;0;0;0;0;.00nan;0;0
19195;182561;1426;0;0;0;0;.00nan;0;0
19195;9524;1422;0;0;0;0;.00nan;0;0
19195;216525;1422;38;39;7;32;.821;3526000;0
19195;148391;1426;44;31;5;26;.839;3600000;0
19197;184437;1443;63;12;1;11;.917;3600000;0
19197;185136;1440;0;0;0;0;.00nan;0;0
19197;187263;1440;60;51;6;45;.882;3600000;0
19197;80682;1443;0;0;0;0;.00nan;0;0
19199;4127;1429;0;0;0;0;.00nan;0;0
19199;185124;4742;37;24;5;19;.792;3668000;0
19199;-1;1429;46;29;4;25;.862;3668000;0
19199;157845;4742;0;0;0;0;.00nan;0;0
19201;2037;4961;82;31;1;30;.968;3900000;0
19201;-1;4961;0;0;0;0;.00nan;0;0
19201;195566;1425;0;0;0;0;.00nan;0;0
19201;64230;1425;80;22;1;21;.955;3900000;0
19203;1765;1427;62;32;3;29;.906;3600000;0
19203;169438;1427;0;0;0;0;.00nan;0;0
19203;157903;1430;100;29;0;29;1.000;3600000;0
19203;157929;1430;0;0;0;0;.00nan;0;0
19205;2037;4961;0;0;0;0;.00nan;0;0
19205;-1;4961;43;30;5;25;.833;3600000;0
19205;195566;1425;0;0;0;0;.00nan;0;0
19205;64230;1425;67;18;2;16;.889;3600000;0
19207;185124;4742;0;0;0;0;.00nan;0;0
19207;185136;1440;0;0;0;0;.00nan;0;0
19207;187263;1440;92;40;2;38;.950;3600000;0
19207;157845;4742;52;28;3;25;.893;3550000;0
19209;182561;1426;68;28;3;25;.893;3600000;0
19209;165030;1453;56;34;4;30;.882;3557000;0
19209;195618;1453;0;0;0;0;.00nan;0;0
19209;148391;1426;0;0;0;0;.00nan;0;0
19211;4127;1429;47;32;5;27;.844;2269000;0
19211;184437;1443;77;10;0;10;1.000;3600000;0
19211;-1;1429;56;22;2;20;.909;1331000;0
19211;80682;1443;0;0;0;0;.00nan;0;0
19213;9524;1422;100;26;0;26;1.000;3600000;0
19213;216525;1422;0;0;0;0;.00nan;0;0
19213;157903;1430;70;35;3;32;.914;3600000;0
19213;157929;1430;0;0;0;0;.00nan;0;0
19215;195566;1425;0;0;0;0;.00nan;0;0
19215;185136;1440;0;0;0;0;.00nan;0;0
19215;187263;1440;65;28;2;26;.929;3570000;0
19215;64230;1425;71;21;1;20;.952;3600000;0
19217;9524;1422;64;26;3;23;.885;3600000;0
19217;165030;1453;55;33;4;29;.879;3580000;0
19217;195618;1453;0;0;0;0;.00nan;0;0
19217;216525;1422;0;0;0;0;.00nan;0;0
19219;1765;1427;0;0;0;0;.00nan;0;0
19219;169438;1427;84;16;0;16;1.000;3600000;0
19219;185124;4742;0;0;0;0;.00nan;0;0
19219;157845;4742;91;44;2;42;.955;3543000;0
19221;2037;4961;56;33;4;29;.879;1343000;0
19221;182561;1426;0;0;0;0;.00nan;0;0
19221;-1;4961;33;30;6;24;.800;2257000;0
19221;148391;1426;67;8;0;8;1.000;3600000;0
19223;184437;1443;85;11;0;11;1.000;3600000;0
19223;80682;1443;0;0;0;0;.00nan;0;0
19223;157903;1430;34;20;4;16;.800;1272000;0
19223;157929;1430;33;35;6;29;.829;2328000;0
1882;184437;1443;63;22;2;20;.909;3600000;0
1882;185124;4742;0;0;0;0;.00nan;0;0
1882;80682;1443;0;0;0;0;.00nan;0;0
1882;157845;4742;60;49;6;43;.878;3600000;0
1883;195566;1425;0;0;0;0;.00nan;0;0
1883;64230;1425;69;23;3;20;.870;3642000;0
1883;157903;1430;61;36;4;32;.889;3642000;0
1883;157929;1430;0;0;0;0;.00nan;0;0
1884;4127;1429;66;29;3;26;.897;3900000;0
1884;9524;1422;0;0;0;0;.00nan;0;0
1884;-1;1422;47;24;3;21;.875;3900000;0
1884;-1;1429;0;0;0;0;.00nan;0;0
1885;1765;1427;0;0;0;0;.00nan;0;0
1885;182561;1426;83;24;1;23;.958;3600000;0
1885;169438;1427;75;38;3;35;.921;3560000;0
1885;148391;1426;0;0;0;0;.00nan;0;0
1932;4127;1429;42;40;6;34;.850;2797000;0
1932;184437;1443;57;21;3;18;.857;3600000;0
1932;-1;1429;63;12;0;12;1.000;803000;0
1932;80682;1443;0;0;0;0;.00nan;0;0
1933;182561;1426;28;25;6;19;.760;2767000;0
1933;195566;1425;0;0;0;0;.00nan;0;0
1933;64230;1425;59;30;3;27;.900;3600000;0
1933;148391;1426;47;3;1;2;.667;833000;0
1979;184437;1443;55;8;1;7;.875;3600000;0
1979;195566;1425;0;0;0;0;.00nan;0;0
1979;64230;1425;76;45;5;40;.889;3600000;0
1979;80682;1443;0;0;0;0;.00nan;0;0
